filename;TotalPeopleInBurst;MaximumChangeBurstLate;NumberOfChanges;MaxPeopleInBurst;TotalBurstSizeLate;NumberOfChangeBurstsLate;NumberOfChangesLate;NumberOfChangesEarly;MaxChurnInBurst;MaximumChangeBurstEarly;NumberOfChangeBurstsEarly;TimeFirstBurst;TotalChurnInBurst;ChurnTotal;MaximumChangeBurst;NumberOfConsecutiveChangesEarly;NumberOfConsecutiveChangesLate;TotalBurstSizeEarly;TotalBurstSize;TimeMaxBurst;NumberOfConsecutiveChanges;TimeLastBurst;NumberOfChangeBursts;PeopleTotal;
org.eclipse.ui.views.bookmarkexplorer;1;0;2;1;0;0;0;2;0;0;1;2208;0;4;2;1;0;2;2;2208;1;2208;1;1;
org.eclipse.update.internal.operations;1;1;11;1;2;2;2;9;136;2;8;825;573;77;2;1;0;9;11;825;1;6336;10;2;
org.eclipse.pde.internal.core.schema;2;1;5;1;2;2;2;3;455;1;3;1124;665;63;1;0;0;3;5;1124;0;6336;5;3;
org.eclipse.jdt.internal.compiler.classfmt;2;0;8;1;0;0;0;8;39;1;8;25;100;39;1;0;0;8;8;25;0;4254;8;4;
org.eclipse.jdt.internal.core.hierarchy;0;1;28;0;3;3;3;25;615;3;21;61;1963;2;3;4;0;25;28;61;4;6073;24;1;
org.eclipse.team.internal.ui.wizards;1;1;12;1;6;6;6;6;1413;2;5;987;1614;72;2;1;0;6;12;987;1;6337;11;1;
org.eclipse.ui.externaltools.internal.program.launchConfigurations;2;0;13;1;0;0;0;13;64;2;12;219;188;89;2;1;0;13;13;1813;1;2120;12;3;
org.eclipse.jdi;0;1;5;0;2;2;2;3;7;2;2;1296;16;0;2;1;0;3;5;4264;1;5680;4;0;
org.eclipse.debug.ui;0;1;12;0;2;2;2;10;322;2;9;265;507;0;2;1;0;10;12;265;1;6336;11;0;
org.eclipse.core.internal.localstore;1;0;4;1;1;1;1;3;6233;2;2;93;6264;347;2;1;0;3;4;93;1;5146;3;2;
org.eclipse.ui.internal.intro.impl.parts;1;1;7;1;7;7;7;0;46;0;0;5305;78;10;1;0;0;0;7;5305;0;5867;7;1;
org.eclipse.pde.internal.build.builder;2;0;18;1;1;1;1;17;1478;2;15;447;1867;21;2;2;0;17;18;447;2;5145;16;2;
org.eclipse.osgi.framework.eventmgr;3;0;5;1;1;1;1;4;493;2;3;3013;1070;390;2;1;0;4;5;3013;1;5646;4;4;
org.eclipse.jdt.internal.junit.wizards;1;1;9;1;3;3;3;6;209;2;5;160;452;2;2;1;0;6;9;160;1;6340;8;2;
org.eclipse.core.resources.team;1;0;4;1;1;1;1;3;190;2;2;4994;222;84;2;1;0;3;4;4994;1;5146;3;1;
org.eclipse.search2.internal.ui.text;1;2;16;1;9;8;9;7;121;1;7;3474;421;4;2;0;1;7;16;5815;1;6116;15;1;
org.eclipse.update.core;1;1;5;1;2;2;2;3;283;2;2;0;784;578;2;1;0;3;5;0;1;6336;4;2;
org.eclipse.ui.externaltools.internal.launchConfigurations;0;1;35;0;3;3;3;32;262;2;30;33;1284;0;2;2;0;32;35;321;2;5694;33;0;
org.eclipse.ui.commands;2;1;17;1;2;2;2;15;979;3;13;1065;4441;373;3;2;0;15;17;4952;2;5444;15;3;
org.eclipse.debug.internal.core.sourcelookup.containers;2;0;7;2;1;1;1;6;121;3;2;3678;151;52;3;4;0;6;7;3678;4;5672;3;2;
org.eclipse.core.internal.indexing;2;0;3;1;1;1;1;2;1830;0;1;178;1865;281;2;1;0;2;3;178;1;5146;2;2;
org.eclipse.core.internal.plugins;2;1;9;1;3;3;3;6;344;2;5;3013;626;8;2;1;0;6;9;3013;1;6340;8;2;
org.eclipse.compare.internal;0;1;8;0;2;2;2;6;202;1;6;257;598;0;1;0;0;6;8;257;0;6354;8;1;
org.eclipse.compare.structuremergeviewer;0;0;3;0;0;0;0;3;24;1;3;257;51;0;1;0;0;3;3;257;0;3938;3;0;
org.eclipse.team.internal.ccvs.core.client;1;0;6;1;0;0;0;6;109;1;6;712;211;11;1;0;0;6;6;712;0;2461;6;1;
org.eclipse.jdt.core;1;1;14;1;2;2;2;12;361;1;12;13;824;12;1;0;0;12;14;13;0;5871;14;1;
org.eclipse.swt.ole.win32;0;1;5;0;2;2;2;3;161;1;3;707;199;0;1;0;0;3;5;707;0;6352;5;0;
org.eclipse.jdt.internal.debug.ui.jres;2;0;9;1;0;0;0;9;221;4;5;1035;553;20;4;4;0;9;9;1035;4;4849;5;2;
org.eclipse.jface.text.templates.persistence;0;1;5;0;2;2;2;3;14;2;2;4627;31;0;2;1;0;3;5;4627;1;6353;4;0;
org.eclipse.search.internal.ui;1;1;10;1;4;4;4;6;105;1;6;119;301;2;1;0;0;6;10;119;0;6340;10;1;
org.eclipse.jdt.internal.ui.javaeditor.selectionactions;0;1;4;0;3;3;3;1;25;0;1;4897;44;0;1;0;0;1;4;4897;0;6340;4;0;
org.eclipse.pde.internal.ui.preferences;2;2;16;1;8;7;8;8;108;1;8;217;480;14;2;0;1;8;16;6113;1;6336;15;2;
org.eclipse.jdt.internal.formatter;1;0;6;1;0;0;0;6;1018;2;5;535;1084;28;2;1;0;6;6;535;1;3560;5;3;
org.eclipse.jdt.internal.corext.dom.fragments;2;1;6;1;3;3;3;3;16;2;2;1309;35;9;2;1;0;3;6;1309;1;6340;5;2;
org.eclipse.compare.contentmergeviewer;1;0;2;1;0;0;0;2;8;1;2;1289;16;2;1;0;0;2;2;1289;0;3935;2;1;
org.eclipse.team.internal.ui.preferences;0;0;6;0;1;1;1;5;464;2;4;987;533;0;2;1;0;5;6;987;1;6337;5;0;
org.eclipse.jdt.internal.debug.eval.ast.engine;0;0;3;0;0;0;0;3;41;1;3;1240;50;0;1;0;0;3;3;1240;0;2497;3;0;
org.eclipse.team.internal.ccvs.ui.subscriber;2;1;19;1;3;3;3;16;1049;2;15;709;3921;378;2;1;0;16;19;709;1;5508;18;2;
org.eclipse.pde.internal.ui.parts;1;1;4;1;2;2;2;2;184;1;2;648;260;108;1;0;0;2;4;648;0;6336;4;2;
org.eclipse.search.internal.ui.util;1;1;9;1;3;3;3;6;88;2;5;611;158;2;2;1;0;6;9;611;1;6340;8;1;
org.eclipse.swt.program;4;2;14;1;4;3;4;10;989;2;9;445;1362;1248;2;1;1;10;14;4333;2;6352;12;4;
org.eclipse.debug.internal.core;2;1;22;1;7;7;7;15;194;2;12;243;867;45;2;3;0;15;22;1657;3;6336;19;4;
org.osgi.service.prefs;0;0;2;0;2;1;2;0;0;0;0;5484;0;0;2;0;1;0;2;5484;1;5484;1;0;
org.osgi.service.url;0;0;3;0;1;1;1;2;9;0;1;3013;9;0;2;1;0;2;3;3013;1;5536;2;0;
org.eclipse.jface.text.link;0;1;7;0;4;4;4;3;226;2;2;4214;311;0;2;1;0;3;7;4214;1;6340;6;0;
org.eclipse.jdt.internal.codeassist.select;0;0;8;0;0;0;0;8;366;2;7;69;486;0;2;1;0;8;8;991;1;3560;7;0;
org.eclipse.ui.forms.widgets;1;0;12;1;1;1;1;11;1454;2;10;4068;2763;134;2;1;0;11;12;4068;1;6044;11;2;
org.eclipse.team.internal.ui.registry;0;1;6;0;2;2;2;4;324;2;3;2493;375;0;2;1;0;4;6;2493;1;6337;5;0;
org.eclipse.help;1;1;11;1;3;3;3;8;456;1;8;663;662;146;1;0;0;8;11;663;0;6337;11;1;
org.eclipse.update.internal.search;2;1;10;1;2;2;2;8;30;2;6;825;99;23;2;2;0;8;10;825;2;6336;8;3;
org.eclipse.jdt.internal.eval;1;0;8;1;1;1;1;7;1664;2;6;13;2332;2;2;1;0;7;8;1855;1;5916;7;1;
org.eclipse.jdt.internal.debug.core;0;0;8;0;1;1;1;7;32;1;7;363;94;0;1;0;0;7;8;363;0;6336;8;0;
org.eclipse.pde.internal.ui.model.plugin;2;2;11;1;6;5;6;5;535;2;4;4438;1238;14;2;1;1;5;11;4438;2;6336;9;2;
org.eclipse.osgi.service.pluginconversion;0;2;3;0;3;2;3;0;7;0;0;5277;7;0;2;0;1;0;3;5321;1;5321;2;0;
org.eclipse.jdt.core.search;1;1;10;1;2;2;2;8;105;2;7;61;211;88;2;1;0;8;10;75;1;5676;9;3;
org.eclipse.jdt.internal.ui.preferences;1;2;60;1;16;13;16;44;465;3;40;170;3007;305;3;4;3;44;60;3955;7;6340;53;2;
org.eclipse.jdt.internal.debug.ui.breakpoints;0;0;2;0;0;0;0;2;1;0;1;3093;1;0;2;1;0;2;2;3093;1;3093;1;0;
org.eclipse.pde.internal.core.plugin;3;1;21;1;5;5;5;16;347;1;16;368;1587;310;1;0;0;16;21;368;0;6336;21;3;
org.eclipse.ui.contentassist;0;5;8;0;8;4;8;0;36;0;0;5177;58;0;5;0;4;0;8;5177;4;6334;4;0;
org.eclipse.jdt.internal.core.dom.rewrite;2;1;6;1;2;2;2;4;1457;2;3;4802;1567;393;2;1;0;4;6;4802;1;5510;5;3;
org.eclipse.ui.themes;0;0;2;0;1;1;1;1;169;0;1;4423;169;0;1;0;0;1;2;4423;0;5247;2;0;
org.eclipse.jdt.internal.ui.text.folding;1;2;3;1;3;2;3;0;26;0;0;5440;26;6;2;0;1;0;3;5440;1;6340;2;1;
org.eclipse.jdt.internal.ui.refactoring.nls.search;2;1;9;1;5;5;5;4;63;2;3;1309;168;91;2;1;0;4;9;1309;1;6340;8;5;
org.eclipse.pde.internal.build.tasks;2;0;9;1;1;1;1;8;816;2;7;447;4226;163;2;1;0;8;9;447;1;6340;8;2;
org.eclipse.ui.internal.texteditor.quickdiff.compare.rangedifferencer;1;1;5;1;2;2;2;3;152;2;2;1644;207;38;2;1;0;3;5;1644;1;6340;4;3;
org.eclipse.jdt.internal.ui.refactoring.contentassist;3;2;18;2;5;4;5;13;234;2;10;3648;758;422;2;3;1;13;18;3648;4;6340;14;3;
org.eclipse.pde.internal.ui.view;2;1;8;1;3;3;3;5;74;2;4;368;164;28;2;1;0;5;8;368;1;6336;7;2;
org.eclipse.ui.texteditor.templates;0;1;5;0;3;3;3;2;46;0;1;4627;78;0;2;1;0;2;5;4627;1;6340;4;0;
org.eclipse.pde.internal.runtime.registry;2;0;5;1;1;1;1;4;1177;1;4;831;2477;194;1;0;0;4;5;831;0;6336;5;2;
org.eclipse.core.runtime.jobs;0;1;24;0;5;5;5;19;2337;2;18;320;6259;0;2;1;0;19;24;320;1;5688;23;0;
org.eclipse.ant.internal.ui.editor.formatter;1;1;13;1;6;6;6;7;420;3;5;3916;1553;145;3;2;0;7;13;3916;2;5901;11;1;
org.eclipse.jdt.internal.ui.wizards.dialogfields;1;1;4;1;2;2;2;2;115;1;2;1235;229;2;1;0;0;2;4;1235;0;6340;4;1;
org.eclipse.team.internal.ui.synchronize.actions;0;0;6;0;1;1;1;5;994;2;4;2535;1515;0;2;1;0;5;6;2535;1;6337;5;0;
org.eclipse.help.internal.search;1;1;10;1;3;3;3;7;832;2;6;1740;1363;53;2;1;0;7;10;1740;1;6337;9;1;
org.eclipse.team.internal.ccvs.ui.merge;0;0;4;0;0;0;0;4;39;2;3;790;63;0;2;1;0;4;4;790;1;2632;3;0;
org.eclipse.team.internal.ui;0;1;10;0;4;4;4;6;172;1;6;790;538;0;1;0;0;6;10;790;0;6337;10;0;
org.eclipse.help.browser;0;1;4;0;2;2;2;2;57;1;2;1740;65;0;1;0;0;2;4;1740;0;6337;4;0;
org.eclipse.debug.ui.sourcelookup;1;0;3;1;0;0;0;3;12;2;2;4953;12;36;2;1;0;3;3;4953;1;4970;2;2;
org.eclipse.ui.internal.commands;2;0;33;1;1;1;1;32;4494;2;27;535;11414;4003;2;5;0;32;33;535;5;6338;28;3;
org.eclipse.team.internal.core;1;1;8;1;3;3;3;5;935;1;5;790;1010;293;1;0;0;5;8;790;0;6336;8;2;
org.eclipse.pde.internal.ui.editor.plugin.rows;0;2;9;0;9;7;9;0;66;0;0;5431;151;0;2;0;2;0;9;5431;2;6336;7;0;
org.eclipse.jdt.launching.sourcelookup.containers;0;0;3;0;0;0;0;3;8;2;2;4971;8;0;2;1;0;3;3;4971;1;5091;2;0;
org.eclipse.search2.internal.ui;0;4;36;0;18;14;18;18;242;2;16;3474;1646;0;4;2;4;18;36;5401;6;6140;30;0;
org.eclipse.jdt.internal.ui.filters;1;0;5;1;1;1;1;4;42;1;4;147;127;118;1;0;0;4;5;147;0;6340;5;3;
org.eclipse.ui.internal.ide.misc;1;0;2;1;0;0;0;2;0;0;1;2264;0;28;2;1;0;2;2;2264;1;2264;1;4;
org.eclipse.pde.internal.ui.editor.plugin;1;2;4;1;4;3;4;0;578;0;0;5431;896;44;2;0;1;0;4;5431;1;6336;3;2;
org.eclipse.ui.internal.misc;0;1;9;0;2;2;2;7;42;1;7;173;93;0;1;0;0;7;9;173;0;6338;9;0;
org.eclipse.jdt.internal.corext.refactoring.structure;1;2;55;1;12;10;12;43;348;2;41;42;3245;2;2;2;2;43;55;1952;4;6340;51;2;
org.eclipse.jdt.internal.compiler.env;1;0;5;1;0;0;0;5;30;2;4;85;53;2;2;1;0;5;5;85;1;4017;4;1;
org.eclipse.jdt.internal.compiler.lookup;1;0;17;1;1;1;1;16;264;3;11;10;848;2;3;5;0;16;17;10;5;5871;12;1;
org.eclipse.help.internal.model;0;0;3;0;1;1;1;2;60;0;1;3513;60;0;2;1;0;2;3;3513;1;5827;2;0;
org.eclipse.jdt.internal.compiler.util;1;0;4;1;0;0;0;4;18;1;4;259;36;30;1;0;0;4;4;259;0;3560;4;2;
org.eclipse.osgi.framework.stats;0;1;4;0;2;2;2;2;165;0;1;3013;181;0;2;1;0;2;4;3013;1;6337;3;0;
org.eclipse.core.internal.refresh;0;1;7;0;2;2;2;5;107;2;4;3681;207;0;2;1;0;5;7;3681;1;5275;6;0;
org.eclipse.help.internal.webapp.servlet;1;1;9;1;3;3;3;6;721;1;6;106;1942;417;1;0;0;6;9;106;0;6337;9;1;
org.eclipse.jdt.internal.ui.typehierarchy;1;1;18;1;2;2;2;16;245;2;14;435;652;2;2;2;0;16;18;435;2;6340;16;1;
org.eclipse.ui.internal.commands.ws;1;0;3;1;1;1;1;2;40;0;1;4896;40;42;2;1;0;2;3;4896;1;6338;2;3;
org.eclipse.update.internal.configurator;1;0;20;1;1;1;1;19;2045;2;17;3243;2805;13;2;2;0;19;20;3243;2;5616;18;1;
org.eclipse.ui.internal.progress;1;1;29;1;2;2;2;27;355;2;23;320;2799;128;2;4;0;27;29;320;4;5595;25;2;
org.eclipse.jdt.internal.junit.ui;2;0;7;1;1;1;1;6;340;1;6;185;508;8;1;0;0;6;7;185;0;6340;7;3;
org.eclipse.ant.internal.ui.views.actions;1;1;5;1;2;2;2;3;29;2;2;1811;31;0;2;1;0;3;5;1811;1;6039;4;1;
org.eclipse.jdt.internal.debug.core.refactoring;3;1;10;1;2;2;2;8;178;2;7;3750;474;206;2;1;0;8;10;3750;1;6339;9;3;
org.eclipse.jdt.internal.compiler.problem;0;0;15;0;1;1;1;14;82;2;13;13;400;0;2;1;0;14;15;13;1;5615;14;0;
org.eclipse.ui.branding;2;1;3;1;2;2;2;1;18;0;1;4428;23;23;1;0;0;1;3;4428;0;6321;3;2;
org.eclipse.search.ui.text;0;1;7;0;5;5;5;2;421;1;2;3474;766;0;1;0;0;2;7;3474;0;6340;7;0;
org.eclipse.ui.editors.text;1;1;13;1;3;3;3;10;791;1;10;677;1856;49;1;0;0;10;13;677;0;6340;13;2;
org.eclipse.ui.internal.actions;0;0;4;0;2;1;2;2;82;1;2;1774;97;0;2;0;1;2;4;5802;1;5802;3;0;
org.eclipse.ui.wizards.newresource;1;0;4;1;0;0;0;4;19;2;3;1511;21;0;2;1;0;4;4;1511;1;2631;3;1;
org.eclipse.jface.text.templates;3;1;9;1;4;4;4;5;196;2;4;4258;459;335;2;1;0;5;9;4258;1;6340;8;3;
org.eclipse.jdi.internal.spy;0;0;3;0;0;0;0;3;20;1;3;566;27;0;1;0;0;3;3;566;0;2497;3;0;
org.eclipse.jface.action;5;2;26;2;5;4;5;21;1833;2;19;1;2922;480;2;2;1;21;26;1;3;6338;23;6;
org.eclipse.pde.internal.core.ifeature;2;1;4;1;2;2;2;2;78;0;1;4203;146;21;2;1;0;2;4;4203;1;6336;3;2;
org.eclipse.team.internal.core.streams;1;0;5;1;1;1;1;4;68;1;4;866;139;41;1;0;0;4;5;866;0;6336;5;2;
org.eclipse.team.internal.ccvs.ui.operations;2;1;14;1;3;3;3;11;602;2;10;276;2503;128;2;1;0;11;14;276;1;6337;13;2;
org.eclipse.jdt.internal.compiler;0;0;12;0;1;1;1;11;88;1;11;24;286;0;1;0;0;11;12;24;0;5916;12;0;
org.eclipse.jdt.internal.codeassist;1;0;23;1;0;0;0;23;140;2;22;69;502;2;2;1;0;23;23;3039;1;3560;22;1;
org.eclipse.swt.internal.carbon;2;2;27;1;3;2;3;24;622;2;22;82;944;140;2;2;1;24;27;82;3;5614;24;2;
org.eclipse.ui.internal.ide.update;0;0;1;0;1;1;1;0;0;0;0;5789;0;0;1;0;0;0;1;5789;0;5789;1;0;
org.eclipse.ui.internal.gestures;1;0;3;1;0;0;0;3;127;2;2;1721;193;0;2;1;0;3;3;1721;1;2824;2;1;
org.eclipse.update.internal.ui.model;0;0;9;0;0;0;0;9;90;2;8;200;373;4;2;1;0;9;9;200;1;900;8;1;
com.sun.jdi;1;0;2;1;0;0;0;2;28;0;1;4267;28;4;2;1;0;2;2;4267;1;4267;1;1;
org.eclipse.ui.texteditor.quickdiff;0;2;6;0;4;3;4;2;18;0;1;1644;31;0;2;1;1;2;6;1644;2;6340;4;0;
org.eclipse.swt.internal.motif;1;0;5;1;0;0;0;5;2889;2;4;16;4505;20;2;1;0;5;5;16;1;825;4;2;
org.eclipse.core.internal.model;3;1;6;1;4;4;4;2;82;0;1;3013;99;61;2;1;0;2;6;3013;1;6340;5;3;
org.eclipse.ant.internal.core;0;0;9;0;1;1;1;8;34;1;8;283;143;0;1;0;0;8;9;283;0;5879;9;0;
org.eclipse.swt.internal.ole.win32;2;0;3;1;0;0;0;3;91;1;3;2246;99;10;1;0;0;3;3;2246;0;2915;3;2;
org.eclipse.update.internal.ui;0;0;14;0;0;0;0;14;116;2;12;460;438;0;2;2;0;14;14;772;2;4949;12;0;
org.eclipse.swt.events;0;0;5;0;1;1;1;4;183;2;3;1;225;0;2;1;0;4;5;1;1;6352;4;0;
org.eclipse.jdt.internal.ui.text.template.preferences;0;1;6;0;3;3;3;3;8;2;2;4258;22;0;2;1;0;3;6;4258;1;6340;5;0;
org.eclipse.help.ui.internal.search;0;1;9;0;2;2;2;7;486;3;4;1738;764;0;3;3;0;7;9;1738;3;5827;6;0;
org.eclipse.help.internal.context;1;1;8;1;2;2;2;6;285;1;6;1175;505;247;1;0;0;6;8;1175;0;6337;8;1;
org.eclipse.team.internal.ui.synchronize;1;0;10;1;1;1;1;9;1136;2;8;2535;3376;1418;2;1;0;9;10;2535;1;5436;9;2;
org.eclipse.jface.text.contentassist;1;3;17;1;4;2;4;13;556;2;12;679;1911;52;3;1;2;13;17;6353;3;6353;14;1;
org.eclipse.pde.internal.ui.wizards.templates;3;2;9;1;4;3;4;5;808;1;5;368;1255;185;2;0;1;5;9;5208;1;6336;8;3;
org.eclipse.pde.internal.ui.editor.build;0;1;15;0;3;3;3;12;1487;3;7;1727;3701;0;3;5;0;12;15;1767;5;6336;10;0;
org.eclipse.core.internal.expressions;1;0;4;1;1;1;1;3;130;2;2;4108;234;8;2;1;0;3;4;4108;1;6340;3;1;
org.eclipse.pde.internal.ui.editor.context;0;2;4;0;4;3;4;0;40;0;0;5431;42;0;2;0;1;0;4;5431;1;6336;3;0;
org.eclipse.osgi.service.datalocation;0;2;11;0;7;6;7;4;335;1;4;4672;653;0;2;0;1;4;11;5505;1;5925;10;0;
org.eclipse.jface.util;0;0;8;0;1;1;1;7;274;2;6;179;414;0;2;1;0;7;8;179;1;6338;7;0;
org.eclipse.jdt.internal.compiler.impl;0;0;14;0;1;1;1;13;604;2;11;13;1234;0;2;2;0;13;14;1070;2;5587;12;0;
org.eclipse.swt.widgets;1;1;15;1;2;2;2;13;4368;3;9;0;5747;551;3;4;0;13;15;16;4;6352;11;5;
org.eclipse.ui.internal.activities;3;1;10;1;2;2;2;8;1147;2;7;2444;2583;440;2;1;0;8;10;2444;1;6338;9;4;
org.eclipse.ui.internal.intro.impl.model.loader;0;2;5;0;5;4;5;0;89;0;0;5115;161;0;2;0;1;0;5;5115;1;5314;4;0;
org.eclipse.jdt.internal.corext.dom;2;1;19;1;2;2;2;17;292;2;16;42;1007;399;2;1;0;17;19;1574;1;6340;18;4;
org.eclipse.ui.views.navigator;2;0;3;1;0;0;0;3;22;2;2;2208;22;37;2;1;0;3;3;2208;1;3308;2;4;
org.eclipse.osgi.framework.debug;0;1;8;0;4;4;4;4;248;1;4;3013;390;0;1;0;0;4;8;3013;0;6337;8;0;
org.eclipse.pde.ui.internal.samples;0;1;7;0;4;4;4;3;240;2;2;4523;661;0;2;1;0;3;7;4523;1;6336;6;0;
org.eclipse.team.internal.ui.actions;0;1;5;0;2;2;2;3;302;1;3;990;326;0;1;0;0;3;5;990;0;6337;5;0;
org.eclipse.ui.internal.texteditor;0;1;7;0;3;3;3;4;102;2;3;2544;229;0;2;1;0;4;7;2544;1;6340;6;0;
org.eclipse.jface.contentassist;1;2;5;1;5;3;5;0;273;0;0;5181;347;20;2;0;2;0;5;5181;2;6340;3;1;
org.eclipse.core.internal.preferences;0;1;18;0;6;6;6;12;331;3;10;4351;1251;0;3;2;0;12;18;4351;2;5755;16;0;
org.eclipse.team.internal.ccvs.ssh;0;0;3;0;0;0;0;3;38;2;2;161;40;8;2;1;0;3;3;1541;1;1541;2;1;
org.eclipse.jdt.internal.corext.refactoring.changes;1;1;8;1;2;2;2;6;783;2;5;443;1212;2;2;1;0;6;8;443;1;6340;7;1;
org.eclipse.pde.core.build;0;1;4;0;2;2;2;2;174;1;2;3986;207;0;1;0;0;2;4;3986;0;6336;4;0;
org.eclipse.jdt.internal.ui.text;1;1;19;1;2;2;2;17;1209;1;17;122;2491;205;1;0;0;17;19;122;0;6340;19;3;
org.eclipse.ant.internal.ui.preferences;1;1;31;1;3;3;3;28;1036;2;25;1811;2653;424;2;3;0;28;31;1811;3;5802;28;1;
org.eclipse.osgi.framework.internal.protocol.reference;0;1;5;0;3;3;3;2;61;1;2;3013;97;0;1;0;0;2;5;3013;0;6337;5;0;
org.eclipse.swt.browser;2;0;8;1;1;1;1;7;494;2;5;1654;1411;19;2;2;0;7;8;1654;2;6352;6;2;
org.eclipse.jdt.internal.ui.viewsupport;1;0;4;1;1;1;1;3;67;2;2;435;142;6;2;1;0;3;4;505;1;6340;3;2;
org.eclipse.jdt.internal.ui.util;0;0;3;0;1;1;1;2;34;1;2;1386;45;0;1;0;0;2;3;1386;0;6340;3;0;
org.eclipse.jdt.internal.corext.refactoring.sef;0;0;7;0;1;1;1;6;135;1;6;882;180;0;1;0;0;6;7;882;0;6340;7;0;
org.eclipse.osgi.framework.adaptor;4;1;5;1;2;2;2;3;277;2;2;3013;338;99;2;1;0;3;5;3013;1;6337;4;4;
org.eclipse.osgi.framework.internal.reliablefile;0;1;7;0;3;3;3;4;1084;2;3;3013;1669;0;2;1;0;4;7;3013;1;5856;6;0;
org.eclipse.jdt.core.dom.rewrite;2;2;12;1;5;4;5;7;110;2;6;4711;316;26;2;1;1;7;12;4802;2;5404;10;3;
org.eclipse.ant.core;0;1;16;0;2;2;2;14;243;2;11;0;495;0;2;3;0;14;16;642;3;6335;13;0;
org.eclipse.core.internal.registry;0;1;12;0;5;5;5;7;5618;2;6;2105;8942;0;2;1;0;7;12;2105;1;5760;11;0;
org.eclipse.jface.text.source;2;1;15;1;5;5;5;10;592;1;10;682;1797;207;1;0;0;10;15;682;0;6361;15;3;
org.eclipse.jdt.internal.ui.search;3;0;9;1;1;1;1;8;633;2;7;274;1915;908;2;1;0;8;9;274;1;5396;8;4;
org.eclipse.jdt.internal.ui.refactoring.reorg;3;0;12;1;1;1;1;11;294;2;8;1047;532;473;2;3;0;11;12;1047;3;6340;9;5;
org.eclipse.swt.layout;0;0;6;0;1;1;1;5;109;2;4;398;196;0;2;1;0;5;6;3461;1;6352;5;0;
org.eclipse.pde.core;2;1;6;1;3;3;3;3;597;2;2;2229;807;39;2;1;0;3;6;2229;1;6336;5;2;
org.eclipse.jdt.internal.ui.macbundler;1;0;2;1;0;0;0;2;0;0;1;3622;0;0;2;1;0;2;2;3622;1;3622;1;1;
org.eclipse.ui.forms.editor;0;1;16;0;5;5;5;11;384;2;10;4068;712;0;2;1;0;11;16;4068;1;6336;15;0;
org.eclipse.swt.dnd;0;0;2;0;0;0;0;2;50;0;1;0;50;223;2;1;0;2;2;0;1;0;1;5;
org.eclipse.ant.internal.ui.views.elements;1;0;2;1;0;0;0;2;0;0;1;1811;0;0;2;1;0;2;2;1811;1;1811;1;1;
org.eclipse.jdt.internal.debug.eval;0;0;0;0;0;0;0;0;0;0;0;-1;0;0;0;0;0;0;0;-1;0;-1;0;0;
org.eclipse.osgi.service.resolver;0;1;16;0;7;7;7;9;147;2;8;3013;507;0;2;1;0;9;16;3013;1;6337;15;0;
org.eclipse.jdt.internal.corext.util;1;0;9;1;1;1;1;8;90;1;8;170;363;2;1;0;0;8;9;170;0;6340;9;2;
org.eclipse.jface.text;2;1;5;1;2;2;2;3;1144;1;3;186;1710;334;1;0;0;3;5;186;0;6359;5;3;
org.eclipse.ui.internal.layout;1;0;2;1;0;0;0;2;0;1;2;5000;0;9;1;0;0;2;2;5000;0;5003;2;1;
org.eclipse.core.runtime;0;1;9;0;2;2;2;7;8470;1;7;54;17584;0;1;0;0;7;9;54;0;6340;9;0;
org.eclipse.ant.internal.ui.dtd;1;0;2;1;0;0;0;2;0;0;1;1811;0;0;2;1;0;2;2;1811;1;1811;1;1;
org.eclipse.jdt.ui;1;1;15;1;4;4;4;11;94;2;10;500;439;7;2;1;0;11;15;2908;1;6340;14;2;
org.eclipse.jdt.debug.eval;0;0;2;0;2;1;2;0;6;0;0;6335;6;0;2;0;1;0;2;6335;1;6335;1;0;
org.eclipse.ui.views.framelist;1;0;2;1;0;0;0;2;0;0;1;2208;0;0;2;1;0;2;2;2208;1;2208;1;1;
org.eclipse.jdt.internal.compiler.flow;0;0;5;0;0;0;0;5;31;2;4;148;71;0;2;1;0;5;5;148;1;3560;4;0;
org.eclipse.ui.internal.intro.impl;0;2;15;0;15;14;15;0;16;0;0;5115;83;0;2;0;1;0;15;5746;1;6167;14;0;
org.eclipse.ui.help;0;0;2;0;0;0;0;2;3;1;2;1;5;0;1;0;0;2;2;1;0;1223;2;0;
org.eclipse.ui.forms;1;0;5;1;1;1;1;4;184;2;3;4068;280;217;2;1;0;4;5;4068;1;6336;4;1;
org.eclipse.pde.internal.core.ibundle;0;2;3;0;3;2;3;0;54;0;0;5445;54;0;2;0;1;0;3;5445;1;6336;2;0;
org.eclipse.ui.wizards.datatransfer;1;0;3;1;0;0;0;3;6;2;2;1511;6;83;2;1;0;3;3;1511;1;1539;2;3;
org.eclipse.jdt.internal.junit.runner;2;0;4;1;1;1;1;3;28;2;2;1359;34;30;2;1;0;3;4;1359;1;6340;3;2;
org.eclipse.search2.internal.ui.basic.views;0;1;5;0;2;2;2;3;29;2;2;3474;53;0;2;1;0;3;5;3474;1;6340;4;0;
org.eclipse.jdt.internal.corext;0;0;2;0;1;1;1;1;8;0;1;3536;8;0;1;0;0;1;2;3536;0;6340;2;0;
org.eclipse.ui.internal.ide.registry;1;0;2;1;0;0;0;2;0;0;1;2264;0;10;2;1;0;2;2;2264;1;2264;1;4;
org.eclipse.ui.keys;0;1;18;0;2;2;2;16;1577;2;14;1294;5641;0;2;2;0;16;18;1294;2;6338;16;0;
org.eclipse.core.runtime.content;3;2;13;1;9;8;9;4;273;2;3;4574;659;58;2;1;1;4;13;4574;2;6128;11;3;
org.eclipse.jdt.launching.sourcelookup;0;0;10;0;1;1;1;9;156;2;8;347;607;0;2;1;0;9;10;811;1;6336;9;0;
org.eclipse.jdt.core.formatter;0;0;8;0;1;1;1;7;8;2;6;2178;22;0;2;1;0;7;8;2225;1;6077;7;0;
org.eclipse.jdt.internal.debug.ui.launcher;4;0;12;1;1;1;1;11;366;2;10;112;579;570;2;1;0;11;12;124;1;6336;11;5;
org.eclipse.core.variables;1;0;2;1;0;0;0;2;0;0;1;2514;0;6;2;1;0;2;2;2514;1;2514;1;3;
org.eclipse.jdt.internal.ui.refactoring.nls;2;2;10;1;3;2;3;7;1300;1;7;42;1814;54;2;0;1;7;10;5375;1;5401;9;3;
org.eclipse.ui.texteditor;3;1;14;1;3;3;3;11;1007;1;11;227;2192;1229;1;0;0;11;14;227;0;6340;14;4;
org.eclipse.team.internal.ccvs.core.connection;1;0;5;1;0;0;0;5;24;1;5;276;39;8;1;0;0;5;5;276;0;2097;5;1;
org.eclipse.pde.internal.runtime;0;1;10;0;2;2;2;8;32;2;6;831;91;0;2;2;0;8;10;831;2;6336;8;0;
org.eclipse.ui.internal.dialogs;2;1;15;1;7;7;7;8;210;2;7;94;804;847;2;1;0;8;15;94;1;6338;14;4;
org.eclipse.jdt.internal.codeassist.impl;0;0;12;0;0;0;0;12;105;1;12;69;212;0;1;0;0;12;12;69;0;3560;12;0;
org.eclipse.core.internal.dependencies;3;1;5;1;3;3;3;2;634;0;1;3013;1105;226;2;1;0;2;5;3013;1;5529;4;4;
org.eclipse.jdt.internal.ui.text.javadoc;1;0;7;1;1;1;1;6;47;1;6;583;125;45;1;0;0;6;7;583;0;6340;7;5;
org.eclipse.update.internal.ui.preferences;0;1;12;0;3;3;3;9;159;3;7;460;621;0;3;2;0;9;12;962;2;6336;10;0;
org.eclipse.pde.internal.core.isite;2;1;4;1;2;2;2;2;44;1;2;2311;123;25;1;0;0;2;4;2311;0;6336;4;2;
org.eclipse.ui.internal.cheatsheets.data;1;1;9;1;5;5;5;4;546;2;3;4428;1058;880;2;1;0;4;9;4428;1;5759;8;1;
org.eclipse.debug.ui.console;0;0;3;0;0;0;0;3;6;1;3;977;12;14;1;0;0;3;3;977;0;1579;3;2;
org.eclipse.core.internal.content;0;1;10;0;5;5;5;5;658;2;4;4574;1253;0;2;1;0;5;10;4574;1;5733;9;0;
org.eclipse.jdt.internal.core;1;0;12;1;0;0;0;12;1112;2;11;13;2947;163;2;1;0;12;12;13;1;3560;11;4;
org.eclipse.pde.internal.ui.wizards;1;1;8;1;2;2;2;6;90;1;6;867;135;28;1;0;0;6;8;867;0;6336;8;2;
org.eclipse.jdt.internal.compiler.ast;3;0;8;1;1;1;1;7;4089;2;6;13;5697;378;2;1;0;7;8;13;1;5608;7;4;
org.eclipse.ui.internal.ide.dialogs;1;0;2;1;0;0;0;2;0;0;1;2264;0;140;2;1;0;2;2;2264;1;2264;1;4;
org.eclipse.debug.internal.ui.stringsubstitution;3;0;10;1;0;0;0;10;26;2;9;2046;133;52;2;1;0;10;10;2046;1;4781;9;4;
org.eclipse.jdt.ui.actions;1;1;20;1;4;4;4;16;389;2;14;7;1399;13;2;2;0;16;20;591;2;6340;18;2;
org.eclipse.help.internal.webapp.data;1;1;11;1;3;3;3;8;714;2;5;95;1783;48;2;3;0;8;11;95;3;6337;8;1;
org.eclipse.swt.internal.accessibility.gtk;4;0;5;1;1;1;1;4;282;2;3;1214;477;92;2;1;0;4;5;1214;1;6352;4;4;
org.eclipse.pde.internal.ui.wizards.exports;0;1;16;0;4;4;4;12;743;2;11;94;3125;0;2;1;0;12;16;94;1;6336;15;0;
org.eclipse.jdt.internal.debug.ui.display;0;1;13;0;3;3;3;10;226;2;9;1152;328;0;2;1;0;10;13;4870;1;6336;12;0;
com.sun.jdi.request;0;0;2;0;0;0;0;2;4;1;2;1290;8;0;1;0;0;2;2;1290;0;1318;2;0;
org.eclipse.team.internal.ccvs.core.client.listeners;1;1;6;1;2;2;2;4;38;1;4;784;103;132;1;0;0;4;6;784;0;6337;6;2;
org.eclipse.jdt.debug.ui;0;1;6;0;2;2;2;4;8;1;4;670;36;0;1;0;0;4;6;670;0;6336;6;0;
org.eclipse.osgi.framework.internal.core;3;2;14;1;5;4;5;9;9627;2;8;3013;13877;861;2;1;1;9;14;3013;2;5625;12;5;
org.eclipse.osgi.framework.log;0;1;4;0;2;2;2;2;15;1;2;3879;25;0;1;0;0;2;4;3879;0;5249;4;0;
org.eclipse.jdt.internal.corext.refactoring.code;1;1;36;1;10;10;10;26;715;3;23;48;2674;2;3;3;0;26;36;1952;3;6340;33;1;
org.eclipse.ui.internal.texteditor.quickdiff;0;1;6;0;2;2;2;4;52;2;3;1644;84;0;2;1;0;4;6;1644;1;6340;5;0;
org.eclipse.ant.internal.ui.dtd.schema;0;0;2;0;0;0;0;2;0;0;1;1811;0;0;2;1;0;2;2;1811;1;1811;1;0;
org.eclipse.jdt.debug.ui.launchConfigurations;0;1;9;0;2;2;2;7;81;1;7;112;196;0;1;0;0;7;9;112;0;6336;9;0;
org.eclipse.jdi.internal;1;0;7;1;0;0;0;7;1016;2;6;566;1682;18;2;1;0;7;7;566;1;4267;6;2;
org.eclipse.ui.views.contentoutline;0;2;3;0;3;2;3;0;12;0;0;5339;18;0;2;0;1;0;3;6338;1;6338;2;0;
org.eclipse.pde.internal.core.site;2;1;5;1;2;2;2;3;198;1;3;2229;568;32;1;0;0;3;5;2229;0;6336;5;3;
org.eclipse.jdt.internal.core.search.matching;0;1;28;0;2;2;2;26;3602;2;23;69;8763;0;2;3;0;26;28;69;3;6141;25;0;
org.eclipse.jdt.internal.debug.ui;1;0;7;1;1;1;1;6;90;1;6;82;192;284;1;0;0;6;7;82;0;6336;7;4;
org.eclipse.jdt.internal.ui;1;1;27;1;4;4;4;23;48;2;22;155;149;2;2;1;0;23;27;2844;1;6340;26;1;
org.eclipse.pde.internal;0;1;4;0;2;2;2;2;18;0;1;4203;38;0;2;1;0;2;4;4203;1;6336;3;0;
org.eclipse.pde.internal.ui.editor.site;2;2;9;1;5;4;5;4;1962;1;4;584;3832;20;2;0;1;4;9;5682;1;6336;8;2;
org.eclipse.ui.progress;0;2;11;0;5;4;5;6;110;1;6;972;285;0;2;0;1;6;11;5208;1;6338;10;0;
org.eclipse.text.edits;0;0;6;0;1;1;1;5;1005;2;4;1986;1794;0;2;1;0;5;6;1986;1;6340;5;0;
org.eclipse.ant.internal.ui.model;1;1;21;1;3;3;3;18;40;2;15;1811;222;41;2;3;0;18;21;1811;3;5602;18;1;
org.eclipse.ui.internal.intro.impl.util;1;2;7;1;7;6;7;0;240;0;0;5115;324;98;2;0;1;0;7;5115;1;5760;6;1;
org.eclipse.jdt.internal.ui.dialogs;0;1;18;0;5;5;5;13;316;3;11;502;1150;0;3;2;0;13;18;502;2;6340;16;0;
org.eclipse.ant.internal.ui.editor.text;1;0;4;1;1;1;1;3;8;2;2;1811;15;153;2;1;0;3;4;1811;1;6336;3;1;
org.eclipse.ant.internal.ui.dtd.util;1;0;3;1;0;0;0;3;17;2;2;1811;17;17;2;1;0;3;3;1811;1;3615;2;1;
org.eclipse.ui.internal.cheatsheets.views;1;1;14;1;6;6;6;8;1037;2;7;4428;3994;202;2;1;0;8;14;4428;1;5944;13;1;
org.eclipse.pde.internal.ui.wizards.imports;0;1;22;0;5;5;5;17;1680;1;17;95;3217;0;1;0;0;17;22;95;0;6336;22;0;
org.eclipse.ui.part;2;0;4;1;1;1;1;3;34;2;2;1;76;84;2;1;0;3;4;1;1;6338;3;4;
org.osgi.service.packageadmin;2;0;3;1;1;1;1;2;149;0;1;3013;149;3;2;1;0;2;3;3013;1;5536;2;2;
org.eclipse.help.internal.base.util;0;1;8;0;4;4;4;4;41;2;3;1747;75;0;2;1;0;4;8;1747;1;6337;7;0;
org.eclipse.core.internal.utils;1;1;4;1;2;2;2;2;2108;1;2;179;2170;59;1;0;0;2;4;179;0;5146;4;1;
org.eclipse.pde.internal.core.build;1;1;6;1;2;2;2;4;125;1;4;368;313;19;1;0;0;4;6;368;0;5780;6;1;
org.eclipse.pde.internal.ui.elements;2;1;2;1;2;2;2;0;4;0;0;5782;6;6;1;0;0;0;2;5782;0;6336;2;2;
org.eclipse.jface.preference;2;1;12;1;2;2;2;10;2370;2;8;1;2511;39;2;2;0;10;12;1;2;6338;10;2;
org.eclipse.jdt.launching;0;1;10;0;2;2;2;8;85;1;8;112;228;0;1;0;0;8;10;112;0;6336;10;0;
org.eclipse.core.expressions;0;0;4;0;1;1;1;3;38;2;2;4108;64;0;2;1;0;3;4;4108;1;5184;3;0;
org.eclipse.ant.internal.ui.launchConfigurations;1;2;16;1;6;5;6;10;185;2;8;1811;529;155;2;2;1;10;16;1811;3;6336;13;3;
org.eclipse.jdt.ui.wizards;2;1;8;1;3;3;3;5;35;1;5;451;110;27;1;0;0;5;8;451;0;6340;8;2;
org.eclipse.help.internal.protocols;0;1;9;0;3;3;3;6;232;1;6;1010;476;0;1;0;0;6;9;1010;0;6337;9;0;
org.eclipse.help.ui.internal.workingset;1;1;8;1;2;2;2;6;758;2;4;1738;1101;546;2;2;0;6;8;1738;2;6337;6;1;
org.eclipse.jdt.internal.corext.refactoring.rename;1;1;36;1;10;10;10;26;310;2;25;42;2844;132;2;1;0;26;36;1953;1;6340;35;3;
org.eclipse.core.internal.dtree;1;0;3;1;1;1;1;2;6075;0;1;178;6134;561;2;1;0;2;3;178;1;5146;2;2;
org.eclipse.jdt.internal.ui.preferences.formatter;1;0;12;1;0;0;0;12;1893;2;11;3103;4938;26;2;1;0;12;12;3103;1;4790;11;1;
org.eclipse.core.internal.variables;0;0;6;0;1;1;1;5;68;2;4;2514;178;0;2;1;0;5;6;2514;1;5520;5;0;
org.eclipse.jface.wizard;0;0;5;0;0;0;0;5;12;2;4;1;24;0;2;1;0;5;5;1;1;5087;4;0;
org.eclipse.pde.internal.runtime.logview;0;1;29;0;2;2;2;27;1109;4;21;798;1998;0;4;6;0;27;29;831;6;6336;23;0;
org.eclipse.search.internal.core;0;0;1;0;1;1;1;0;2;0;0;6340;2;0;1;0;0;0;1;6340;0;6340;1;0;
org.eclipse.ant.internal.core.ant;0;1;19;0;2;2;2;17;99;1;17;148;586;0;1;0;0;17;19;148;0;5743;19;1;
org.eclipse.jdt.internal.ui.refactoring.code;0;2;14;0;4;3;4;10;80;1;10;130;241;0;2;0;1;10;14;5353;1;6340;13;0;
org.eclipse.swt.internal.image;0;0;1;0;0;0;0;1;12;0;1;125;12;0;1;0;0;1;1;125;0;125;1;1;
org.eclipse.debug.internal.ui.views.console;1;0;5;1;0;0;0;5;134;2;4;550;214;2;2;1;0;5;5;550;1;1415;4;2;
org.eclipse.core.boot;0;2;11;0;4;3;4;7;123;2;6;3013;295;0;2;1;1;7;11;3013;2;6340;9;0;
org.eclipse.ant.internal.ui.editor.utils;0;1;26;0;7;7;7;19;272;2;18;1811;1086;0;2;1;0;19;26;3661;1;5924;25;0;
org.eclipse.ant.internal.ui.console;0;0;8;0;1;1;1;7;25;2;5;1811;56;0;2;2;0;7;8;1811;2;5700;6;0;
org.eclipse.update.operations;1;2;9;1;4;3;4;5;215;2;4;825;382;101;2;1;1;5;9;825;2;6336;7;1;
org.osgi.util.tracker;2;1;5;1;4;4;4;1;641;0;1;5079;757;757;1;0;0;1;5;5079;0;5734;5;2;
org.eclipse.pde.internal.ui.search;2;1;7;1;2;2;2;5;180;1;5;1;393;80;1;0;0;5;7;1;0;6336;7;3;
org.eclipse.jdt.internal.ui.refactoring;3;0;18;1;1;1;1;17;3786;1;17;363;4842;226;1;0;0;17;18;363;0;6340;18;3;
org.eclipse.jdt.internal.ui.callhierarchy;2;1;8;1;2;2;2;6;305;2;5;155;742;34;2;1;0;6;8;155;1;6340;7;3;
org.eclipse.jdt.internal.ui.wizards;0;1;7;0;2;2;2;5;408;1;5;451;574;0;1;0;0;5;7;451;0;6340;7;0;
org.eclipse.core.internal.properties;1;0;5;1;1;1;1;4;1789;1;4;93;2169;290;1;0;0;4;5;93;0;5146;5;2;
org.eclipse.jdt.internal.ui.actions;2;1;7;1;3;3;3;4;78;1;4;363;123;115;1;0;0;4;7;363;0;6340;7;3;
org.eclipse.update.internal.ui.properties;2;1;8;1;3;3;3;5;90;2;4;825;218;51;2;1;0;5;8;825;1;6336;7;2;
org.eclipse.update.internal.scheduler;0;1;20;0;2;2;2;18;102;2;17;979;323;0;2;1;0;18;20;1195;1;6336;19;0;
org.eclipse.ltk.internal.ui.refactoring.util;0;0;3;0;0;0;0;3;420;2;2;4965;420;0;2;1;0;3;3;4965;1;5083;2;0;
org.eclipse.jdt.internal.corext.callhierarchy;2;0;11;1;1;1;1;10;138;2;8;155;412;223;2;2;0;10;11;155;2;6340;9;4;
org.eclipse.pde.ui.templates;2;2;15;1;6;5;6;9;1195;1;9;1111;2968;854;2;0;1;9;15;5208;1;6336;14;3;
org.eclipse.pde.internal.ui.wizards.extension;2;2;12;1;8;6;8;4;336;1;4;648;913;437;2;0;2;4;12;5229;2;6336;10;3;
org.eclipse.jdt.internal.ui.javadocexport;1;0;8;1;0;0;0;8;190;2;7;661;436;746;2;1;0;8;8;661;1;4412;7;4;
org.eclipse.jdt.internal.corext.refactoring.nls.changes;0;1;12;0;4;4;4;8;104;1;8;130;297;0;1;0;0;8;12;130;0;6340;12;0;
org.eclipse.compare.rangedifferencer;0;0;2;0;0;0;0;2;8;1;2;257;10;0;1;0;0;2;2;257;0;3938;2;0;
org.eclipse.ui.cheatsheets;0;0;7;0;0;0;0;7;177;2;4;4428;376;0;2;3;0;7;7;4428;3;4653;4;0;
org.eclipse.search.internal.core.text;0;1;8;0;3;3;3;5;165;2;4;122;726;0;2;1;0;5;8;122;1;6340;7;1;
org.eclipse.jdt.internal.ui.dnd;0;1;2;0;2;2;2;0;14;0;0;5682;18;0;1;0;0;0;2;5682;0;6340;2;0;
org.eclipse.update.internal.configurator.branding;1;1;9;1;3;3;3;6;31;2;5;4502;80;84;2;1;0;6;9;4502;1;6336;8;1;
org.eclipse.debug.internal.core.memory;1;0;2;1;2;1;2;0;0;0;0;5254;0;0;2;0;1;0;2;5254;1;5254;1;1;
org.eclipse.ui.internal.intro.impl.model;0;2;5;0;5;4;5;0;290;0;0;5115;559;0;2;0;1;0;5;5115;1;5314;4;1;
org.eclipse.help.ui.internal.browser.embedded;0;1;7;0;2;2;2;5;471;1;5;2898;935;0;1;0;0;5;7;2898;0;5490;7;0;
org.eclipse.pde.internal.ui.wizards.plugin;0;1;5;0;2;2;2;3;736;2;2;3840;1321;0;2;1;0;3;5;3840;1;6336;4;0;
org.eclipse.team.ui;0;2;15;0;5;4;5;10;195;2;9;790;502;0;2;1;1;10;15;790;2;6333;13;0;
org.eclipse.jface.text.information;1;1;4;1;3;3;3;1;72;0;1;692;126;24;1;0;0;1;4;692;0;6352;4;2;
org.eclipse.pde.internal.ui.launcher;0;1;16;0;2;2;2;14;2907;2;13;368;5242;0;2;1;0;14;16;368;1;6336;15;0;
org.eclipse.debug.internal.ui.views.registers;1;0;2;1;0;0;0;2;0;0;1;4348;0;0;2;1;0;2;2;4348;1;4348;1;1;
org.eclipse.ui.internal.forms.widgets;0;0;3;0;1;1;1;2;54;0;1;5044;54;0;2;1;0;2;3;5044;1;6336;2;0;
org.eclipse.debug.internal.ui;0;1;20;0;4;4;4;16;72;2;15;134;520;0;2;1;0;16;20;2308;1;6336;19;2;
org.eclipse.ui.views.markers.internal;3;1;6;1;2;2;2;4;2080;2;3;2208;2362;128;2;1;0;4;6;2208;1;6338;5;7;
org.eclipse.swt.internal.photon;0;0;4;0;0;0;0;4;3662;1;4;447;3709;0;1;0;0;4;4;447;0;921;4;1;
org.eclipse.ui.internal.forms;1;0;3;1;1;1;1;2;14;0;1;5044;14;4;2;1;0;2;3;5044;1;6336;2;1;
org.eclipse.pde.internal.ui.build;2;1;11;1;8;8;8;3;153;2;2;3840;504;111;2;1;0;3;11;3840;1;6336;10;2;
org.eclipse.ui.internal.util;0;0;11;0;1;1;1;10;109;1;10;1220;264;0;1;0;0;10;11;1220;0;6338;11;1;
org.eclipse.jdt.internal.launching;0;1;11;0;2;2;2;9;93;2;8;307;307;71;2;1;0;9;11;3279;1;6336;10;3;
org.eclipse.pde.internal.ui.wizards.tools;0;1;6;0;4;4;4;2;146;0;1;3840;229;0;2;1;0;2;6;3840;1;6336;5;0;
org.eclipse.help.ui.internal.util;0;1;4;0;3;3;3;1;28;0;1;2732;64;0;1;0;0;1;4;2732;0;6337;4;0;
org.eclipse.jdt.core.eval;0;0;6;0;1;1;1;5;66;2;4;991;96;0;2;1;0;5;6;991;1;5871;5;0;
org.eclipse.ui.internal.console;1;0;4;1;0;0;0;4;166;3;2;1988;168;42;3;2;0;4;4;1988;2;2024;2;1;
org.eclipse.ant.internal.ui.antsupport.logger;0;0;13;0;1;1;1;12;20;3;10;1811;75;0;3;2;0;12;13;1811;2;6336;11;0;
org.eclipse.ui.internal.keys;2;0;26;1;0;0;0;26;804;2;23;1714;2090;52;2;3;0;26;26;1714;3;3350;23;3;
org.eclipse.jdt.internal.corext.refactoring.typeconstraints;2;0;9;1;1;1;1;8;373;2;7;42;848;84;2;1;0;8;9;42;1;6340;8;2;
org.eclipse.jdt.internal.junit.util;1;1;3;1;2;2;2;1;18;0;1;3424;43;10;1;0;0;1;3;3424;0;6340;3;2;
org.eclipse.jdt.ui.refactoring;0;1;4;0;3;3;3;1;103;0;1;4976;141;0;1;0;0;1;4;4976;0;6363;4;0;
org.eclipse.jface.window;0;2;15;0;4;3;4;11;125;2;10;851;355;0;2;1;1;11;15;3238;2;6338;13;0;
org.eclipse.jface.text.reconciler;0;1;7;0;3;3;3;4;59;1;4;708;159;0;1;0;0;4;7;708;0;6359;7;0;
org.eclipse.team.ui.synchronize;2;1;11;1;3;3;3;8;1295;2;7;2535;2947;188;2;1;0;8;11;2535;1;5508;10;2;
org.eclipse.team.internal.ccvs.ui.console;0;1;5;0;2;2;2;3;110;2;2;4609;126;0;2;1;0;3;5;4609;1;6337;4;0;
org.eclipse.pde.internal.core.search;0;0;4;0;1;1;1;3;19;1;3;368;30;0;1;0;0;3;4;368;0;6336;4;0;
org.eclipse.search.ui;3;1;14;1;5;5;5;9;379;2;8;1519;1282;269;2;1;0;9;14;2888;1;6340;13;3;
org.eclipse.jdt.internal.ui.browsing;1;2;9;1;4;3;4;5;70;2;4;227;285;50;2;1;1;5;9;227;2;6340;7;1;
org.eclipse.jface.text.formatter;3;1;12;1;3;3;3;9;501;1;9;472;1590;141;1;0;0;9;12;472;0;6357;12;3;
org.eclipse.core.resources.refresh;0;0;3;0;0;0;0;3;12;2;2;3681;18;0;2;1;0;3;3;3681;1;5066;2;0;
org.eclipse.team.internal.ccvs.ui;2;0;6;1;0;0;0;6;362;1;6;81;538;494;1;0;0;6;6;81;0;2381;6;2;
org.eclipse.team.core.synchronize;0;1;6;0;3;3;3;3;1463;2;2;4045;1724;0;2;1;0;3;6;4045;1;6336;5;0;
org.eclipse.debug.internal.ui.views.launch;0;2;56;0;23;22;23;33;711;2;30;122;3162;0;2;3;1;33;56;3831;4;6227;52;0;
org.eclipse.update.internal.security;1;1;5;1;2;2;2;3;36;2;2;890;56;2;2;1;0;3;5;890;1;6336;4;1;
org.eclipse.debug.core.sourcelookup;1;0;5;1;1;1;1;4;155;2;3;4949;216;151;2;1;0;4;5;4949;1;5109;4;1;
org.eclipse.update.internal.ui.servlets;0;0;5;0;0;0;0;5;119;1;5;717;127;0;1;0;0;5;5;717;0;900;5;0;
org.eclipse.ui.internal.intro;0;0;6;0;0;0;0;6;77;2;5;3632;149;0;2;1;0;6;6;3632;1;4825;5;0;
org.eclipse.swt.graphics;2;1;19;1;5;5;5;14;381;3;11;0;1566;1195;3;3;0;14;19;472;3;6352;16;6;
org.eclipse.swt.internal.gnome;0;0;4;0;1;1;1;3;23;1;3;4333;27;0;1;0;0;3;4;4333;0;6352;4;0;
org.eclipse.jface.text.source.projection;0;1;9;0;4;4;4;5;484;2;4;4516;1240;0;2;1;0;5;9;4516;1;6362;8;0;
org.osgi.service.permissionadmin;0;0;2;0;1;1;1;1;3;0;1;3013;3;0;1;0;0;1;2;3013;0;5536;2;0;
org.eclipse.pde.internal.core.feature;0;1;6;0;2;2;2;4;280;2;3;2229;486;0;2;1;0;4;6;2229;1;6336;5;0;
org.eclipse.ui.internal.intro.impl.swt;0;2;13;0;13;11;13;0;251;0;0;5714;924;0;2;0;2;0;13;5714;2;6280;11;0;
org.eclipse.help.internal.util;1;1;11;1;3;3;3;8;196;1;8;1010;462;21;1;0;0;8;11;1010;0;6337;11;1;
org.eclipse.jdt.internal.debug.ui.console;0;1;7;0;2;2;2;5;153;2;4;2119;188;0;2;1;0;5;7;2119;1;6037;6;0;
org.eclipse.swt.printing;1;1;9;1;2;2;2;7;115;2;6;0;205;12;2;1;0;7;9;0;1;6352;8;1;
org.eclipse.core.filebuffers;2;1;13;1;6;6;6;7;237;2;6;1522;790;187;2;1;0;7;13;1522;1;6340;12;2;
org.eclipse.help.internal.standalone;0;1;5;0;2;2;2;3;414;2;2;1740;760;0;2;1;0;3;5;1740;1;6337;4;0;
org.eclipse.ui.activities;3;1;23;1;2;2;2;21;627;2;19;2240;2043;64;2;2;0;21;23;2240;2;6338;21;3;
org.eclipse.ui.actions;0;1;8;0;3;3;3;5;120;2;4;1;402;76;2;1;0;5;8;1;1;6338;7;2;
org.eclipse.jdt.internal.corext.refactoring.tagging;0;0;3;0;1;1;1;2;8;0;1;1125;8;0;2;1;0;2;3;1125;1;6340;2;0;
org.eclipse.ui.internal.cheatsheets.dialogs;0;0;4;0;1;1;1;3;17;1;3;4428;35;0;1;0;0;3;4;4428;0;5738;4;0;
org.eclipse.jdt.internal.debug.ui.classpath;2;0;5;1;0;0;0;5;103;2;4;2691;121;101;2;1;0;5;5;2691;1;4973;4;3;
org.eclipse.help.internal.browser.macosx;0;1;5;0;3;3;3;2;47;1;2;1740;91;0;1;0;0;2;5;1740;0;6337;5;0;
org.eclipse.debug.core.model;2;0;9;1;1;1;1;8;168;2;7;1175;294;28;2;1;0;8;9;1538;1;5108;8;3;
org.eclipse.jdi.internal.event;3;0;5;1;1;1;1;4;8;1;4;791;22;10;1;0;0;4;5;791;0;6336;5;3;
org.eclipse.ui.internal.ide.model;1;0;3;1;0;0;0;3;7;2;2;2264;7;9;2;1;0;3;3;2264;1;2616;2;4;
org.eclipse.jdt.core.dom;2;1;19;1;4;4;4;15;10490;2;14;69;27044;495;2;1;0;15;19;69;1;5335;18;6;
org.eclipse.swt.awt;3;1;9;1;6;6;6;3;123;2;2;3012;222;64;2;1;0;3;9;3012;1;6352;8;3;
org.eclipse.jdt.internal.core.builder;1;0;14;1;0;0;0;14;102;2;12;13;253;72;2;2;0;14;14;108;2;4887;12;2;
org.eclipse.pde.internal.ui.editor.text;0;1;4;0;2;2;2;2;64;0;1;3795;64;0;2;1;0;2;4;3795;1;6336;3;0;
org.eclipse.update.internal.ui.wizards;1;0;10;1;1;1;1;9;4076;1;9;196;5449;16;1;0;0;9;10;196;0;6336;10;2;
org.eclipse.ui.dialogs;0;0;3;0;0;0;0;3;8;2;2;1;14;332;2;1;0;3;3;1;1;394;2;4;
org.eclipse.core.internal.jobs;2;1;56;1;4;4;4;52;6087;3;46;320;17523;7;3;6;0;52;56;2823;6;6220;50;2;
com.sun.jdi.connect;2;0;3;1;0;0;0;3;12;1;3;1290;14;14;1;0;0;3;3;1290;0;4267;3;2;
org.eclipse.pde.internal.ui.model.build;0;1;8;0;8;8;8;0;97;0;0;5258;287;0;1;0;0;0;8;5258;0;6336;8;0;
org.eclipse.swt;0;2;30;0;8;7;8;22;832;2;20;1;1377;0;2;2;1;22;30;955;3;6352;27;0;
org.eclipse.ui.console;1;0;2;1;0;0;0;2;0;0;1;1988;0;11;2;1;0;2;2;1988;1;1988;1;3;
org.eclipse.jdt.internal.debug.ui.monitors;0;1;5;0;2;2;2;3;69;1;3;206;157;0;1;0;0;3;5;206;0;6336;5;0;
com.sun.jdi.event;0;0;0;0;0;0;0;0;0;0;0;-1;0;0;0;0;0;0;0;-1;0;-1;0;0;
org.eclipse.pde.core.plugin;3;1;10;1;4;4;4;6;885;2;5;2184;1627;80;2;1;0;6;10;2184;1;6336;9;3;
org.eclipse.jdt.internal.corext.refactoring;0;1;8;0;2;2;2;6;201;1;6;42;275;0;1;0;0;6;8;42;0;6340;8;0;
org.eclipse.jdt.internal.ui.infoviews;0;1;11;0;3;3;3;8;537;2;7;724;1094;0;2;1;0;8;11;724;1;6340;10;0;
org.eclipse.jdt.internal.core.util;2;0;12;1;1;1;1;11;1500;1;11;13;2427;21;1;0;0;11;12;13;0;5916;12;4;
org.eclipse.jdt.internal.compiler.parser.diagnose;0;0;6;0;0;0;0;6;178;2;5;764;232;0;2;1;0;6;6;764;1;3560;5;0;
org.eclipse.debug.ui.actions;1;1;10;1;3;3;3;7;82;1;7;205;186;0;1;0;0;7;10;205;0;5496;10;1;
org.eclipse.pde.internal.ui.editor.schema;2;1;6;1;3;3;3;3;1447;1;3;217;1891;14;1;0;0;3;6;217;0;6336;6;2;
org.eclipse.jdt.internal.ui.text.spelling.engine;0;0;3;0;1;1;1;2;32;0;1;3930;32;0;2;1;0;2;3;3930;1;6340;2;0;
org.eclipse.help.internal;1;1;7;1;3;3;3;4;230;1;4;1781;367;167;1;0;0;4;7;1781;0;6337;7;1;
org.eclipse.jdt.core.jdom;2;0;6;1;1;1;1;5;68;1;5;969;151;8;1;0;0;5;6;969;0;5584;6;2;
org.eclipse.ltk.internal.ui.refactoring;1;1;7;1;2;2;2;5;96;2;4;4845;265;110;2;1;0;5;7;4845;1;6340;6;1;
org.eclipse.jdt.internal.ui.refactoring.sef;0;0;7;0;1;1;1;6;45;1;6;1309;58;0;1;0;0;6;7;1309;0;6340;7;0;
org.eclipse.ui.forms.events;1;0;6;1;1;1;1;5;152;2;4;4068;217;45;2;1;0;5;6;4068;1;6336;5;1;
org.eclipse.jdt.internal.corext.refactoring.participants;0;1;13;0;3;3;3;10;158;2;9;825;622;0;2;1;0;10;13;825;1;6340;12;0;
org.eclipse.core.internal.boot;0;1;10;0;3;3;3;7;1056;2;6;3013;1188;2;2;1;0;7;10;3013;1;5543;9;2;
org.eclipse.update.internal.ui.security;0;1;9;0;2;2;2;7;259;1;7;635;445;0;1;0;0;7;9;635;0;6336;9;0;
org.eclipse.jface.operation;0;1;4;0;3;3;3;1;50;0;1;2242;95;0;1;0;0;1;4;2242;0;6338;4;0;
com.sun.jdi.connect.spi;0;0;2;0;0;0;0;2;0;0;1;4267;0;0;2;1;0;2;2;4267;1;4267;1;0;
org.eclipse.jdt.internal.core.index;0;0;5;0;0;0;0;5;1088;2;4;3384;1132;0;2;1;0;5;5;3384;1;4449;4;0;
org.eclipse.jdt.internal.core.jdom;1;0;7;1;1;1;1;6;109;2;5;89;254;8;2;1;0;6;7;89;1;5584;6;1;
org.eclipse.team.internal.ui.dialogs;0;0;5;0;0;0;0;5;1063;2;4;987;1089;0;2;1;0;5;5;987;1;2747;4;0;
org.eclipse.jdt.internal.ui.text.spelling;2;1;8;1;2;2;2;6;41;2;5;3930;143;2;2;1;0;6;8;3930;1;6340;7;2;
org.eclipse.search.internal.ui.text;2;0;14;1;1;1;1;13;1268;1;13;122;1856;315;1;0;0;13;14;122;0;6340;14;2;
org.eclipse.swt.custom;1;0;12;1;1;1;1;11;2480;2;9;1;3564;148;2;2;0;11;12;1;2;6352;10;2;
org.eclipse.jdt.internal.ui.text.correction;0;1;21;0;4;4;4;17;624;1;17;85;3456;0;1;0;0;17;21;85;0;6340;21;0;
org.eclipse.pde.internal.build.ant;1;1;10;1;4;4;4;6;1644;2;5;447;8321;12;2;1;0;6;10;447;1;6097;9;1;
org.eclipse.debug.internal.ui.preferences;0;1;14;0;4;4;4;10;75;1;10;110;263;0;1;0;0;10;14;110;0;5407;14;0;
org.eclipse.pde.internal.core.ischema;1;0;3;1;1;1;1;2;42;0;1;4203;58;40;2;1;0;2;3;4203;1;6336;2;3;
org.eclipse.ui.internal.presentations.r21;0;2;3;0;3;2;3;0;2;0;0;6075;2;0;2;0;1;0;3;6075;1;6338;2;0;
org.eclipse.team.internal.ccvs.ui.wizards;2;0;8;1;1;1;1;7;1063;2;6;276;2233;458;2;1;0;7;8;276;1;6337;7;2;
org.eclipse.jdt.internal.junit.launcher;0;1;12;0;4;4;4;8;78;1;8;185;222;0;1;0;0;8;12;185;0;6340;12;0;
org.eclipse.jdt.internal.corext.template.java;0;1;13;0;2;2;2;11;349;2;10;664;1086;0;2;1;0;11;13;4258;1;6340;12;0;
org.eclipse.osgi.framework.internal.protocol;0;1;6;0;2;2;2;4;712;2;3;3013;771;0;2;1;0;4;6;3013;1;6337;5;0;
org.eclipse.debug.internal.core.sourcelookup;1;0;7;1;0;0;0;7;166;2;6;3678;319;5;2;1;0;7;7;3678;1;4952;6;2;
org.eclipse.jdt.ui.text.folding;1;1;3;1;3;3;3;0;4;0;0;5440;8;8;1;0;0;0;3;5440;0;6340;3;1;
org.eclipse.core.internal.filebuffers;2;1;11;1;7;7;7;4;284;2;3;1522;917;20;2;1;0;4;11;1522;1;6340;10;2;
org.eclipse.ui.internal.ide;0;1;14;0;3;3;3;11;261;2;10;1499;635;0;2;1;0;11;14;1654;1;6341;13;0;
org.eclipse.swt.internal.win32;2;0;16;1;0;0;0;16;172;2;13;13;264;33;2;3;0;16;16;13;3;2915;13;4;
org.eclipse.ui;0;0;6;0;0;0;0;6;48;2;5;1;88;210;2;1;0;6;6;1;1;2433;5;5;
org.eclipse.jdt.internal.debug.ui.sourcelookup;0;0;4;0;0;0;0;4;20;2;3;4167;39;0;2;1;0;4;4;4167;1;4971;3;0;
org.eclipse.team.internal.ccvs.core.resources;2;0;10;1;1;1;1;9;519;2;8;276;924;121;2;1;0;9;10;276;1;6337;9;2;
org.eclipse.jdt.internal.corext.refactoring.util;1;0;7;1;1;1;1;6;62;1;6;328;145;0;1;0;0;6;7;328;0;5162;7;1;
org.eclipse.update.internal.model;0;1;11;0;4;4;4;7;317;2;6;890;572;0;2;1;0;7;11;890;1;6336;10;0;
org.eclipse.ui.internal.cheatsheets.actions;1;1;8;1;2;2;2;6;77;2;4;4428;180;77;2;2;0;6;8;4428;2;5738;6;1;
org.eclipse.ant.internal.ui.editor.templates;1;1;10;1;7;7;7;3;161;2;2;4810;285;0;2;1;0;3;10;4810;1;5901;9;1;
org.eclipse.osgi.framework.adaptor.core;2;1;5;1;2;2;2;3;585;2;2;4336;622;435;2;1;0;3;5;4336;1;5232;4;2;
org.eclipse.ui.internal.intro.impl.presentations;0;2;28;0;28;23;28;0;336;0;0;5115;1857;0;2;0;5;0;28;5115;5;6188;23;0;
org.eclipse.osgi.framework.console;0;2;6;0;4;3;4;2;115;1;2;3013;124;0;2;0;1;2;6;5116;1;6337;5;0;
org.eclipse.jdi.internal.connect;0;0;5;0;1;1;1;4;16;1;4;149;32;0;1;0;0;4;5;149;0;6336;5;0;
org.eclipse.pde.internal.builders;0;1;10;0;3;3;3;7;566;2;6;910;1278;0;2;1;0;7;10;910;1;6336;9;0;
org.eclipse.core.internal.resources.refresh.win32;1;0;3;1;0;0;0;3;54;2;2;3695;54;17;2;1;0;3;3;3695;1;4925;2;1;
org.eclipse.ui.internal;1;0;8;1;0;0;0;8;6565;2;7;45;6878;578;2;1;0;8;8;45;1;3150;7;9;
org.osgi.framework;2;0;3;1;1;1;1;2;941;0;1;3013;941;113;2;1;0;2;3;3013;1;5536;2;3;
org.eclipse.team.internal.ccvs.core.util;0;0;9;0;1;1;1;8;238;1;8;276;386;0;1;0;0;8;9;276;0;6337;9;0;
org.eclipse.ui.internal.contexts.ws;0;0;2;0;1;1;1;1;6;0;1;4953;6;0;1;0;0;1;2;4953;0;6338;2;0;
org.eclipse.pde.internal.ui.ant;0;0;3;0;1;1;1;2;24;1;2;2571;28;0;1;0;0;2;3;2571;0;6336;3;0;
org.eclipse.jdt.internal.corext.refactoring.nls;3;1;17;1;10;10;10;7;2447;1;7;122;5101;71;1;0;0;7;17;122;0;6340;17;3;
org.eclipse.pde.internal.ui.editor;2;1;12;1;3;3;3;9;1173;2;8;368;1421;30;2;1;0;9;12;2754;1;6336;11;3;
org.eclipse.jdt.internal.ui.packageview;0;0;4;0;1;1;1;3;41;1;3;130;123;0;1;0;0;3;4;130;0;6340;4;0;
org.eclipse.help.standalone;0;1;5;0;4;4;4;1;160;0;1;1740;183;0;1;0;0;1;5;1740;0;6337;5;0;
org.eclipse.core.resources;0;0;7;0;1;1;1;6;12801;2;5;44;14111;0;2;1;0;6;7;44;1;5146;6;0;
org.eclipse.jdt.internal.compiler.batch;0;0;7;0;1;1;1;6;120;2;5;259;163;0;2;1;0;6;7;259;1;5340;6;0;
org.eclipse.debug.internal.ui.views.breakpoints;0;1;19;0;5;5;5;14;116;3;11;1581;394;0;3;3;0;14;19;1591;3;6336;16;0;
org.eclipse.core.runtime.model;3;2;7;1;4;3;4;3;312;2;2;3013;420;55;2;1;1;3;7;3013;2;6340;5;3;
org.eclipse.osgi.service.environment;0;1;5;0;3;3;3;2;8;1;2;3147;26;0;1;0;0;2;5;3147;0;6337;5;0;
org.eclipse.ui.externaltools.internal.model;0;0;6;0;1;1;1;5;169;1;5;33;254;0;1;0;0;5;6;33;0;5487;6;0;
org.eclipse.osgi.framework.util;1;1;8;1;3;3;3;5;566;1;5;3013;611;1;1;0;0;5;8;3013;0;5803;8;1;
org.eclipse.ui.console.actions;0;1;6;0;2;2;2;4;14;2;3;1988;45;0;2;1;0;4;6;1988;1;6336;5;0;
org.eclipse.pde.ui;2;1;6;1;4;4;4;2;307;0;1;3986;501;85;2;1;0;2;6;3986;1;6336;5;2;
org.eclipse.help.internal.toc;0;1;6;0;2;2;2;4;551;1;4;600;777;0;1;0;0;4;6;600;0;6337;6;0;
org.eclipse.pde.internal.core.bundle;2;1;8;1;5;5;5;3;191;2;2;2184;380;118;2;1;0;3;8;2184;1;6336;7;3;
org.eclipse.tomcat.internal;0;0;9;0;1;1;1;8;510;3;6;105;595;0;3;2;0;8;9;487;2;6337;7;0;
org.eclipse.ui.internal.presentations;5;1;14;1;5;5;5;9;472;2;8;4469;577;349;2;1;0;9;14;4569;1;5492;13;7;
org.eclipse.core.resources.ant;0;0;3;0;1;1;1;2;455;0;1;5082;486;0;2;1;0;2;3;5082;1;5146;2;0;
org.eclipse.ui.model;0;0;5;0;0;0;0;5;550;1;5;1;797;0;1;0;0;5;5;1;0;4235;5;0;
org.eclipse.jdi.hcr;0;0;0;0;0;0;0;0;0;0;0;-1;0;0;0;0;0;0;0;-1;0;-1;0;0;
org.eclipse.jdt.internal.core.eval;0;0;8;0;0;0;0;8;78;2;7;13;171;0;2;1;0;8;8;2095;1;3606;7;0;
org.eclipse.jdt.internal.core.search.processing;0;0;3;0;0;0;0;3;12;2;2;2840;14;0;2;1;0;3;3;2840;1;3560;2;0;
org.eclipse.debug.internal.ui.views;0;0;4;0;0;0;0;4;7;1;4;2178;13;0;1;0;0;4;4;2178;0;3594;4;0;
org.eclipse.ant.internal.ui.editor.model;1;1;12;1;2;2;2;10;72;2;9;3661;294;0;2;1;0;10;12;3661;1;5923;11;1;
org.eclipse.pde.internal.ui.util;1;1;4;1;2;2;2;2;6;1;2;368;13;6;1;0;0;2;4;368;0;6336;4;1;
org.eclipse.jdt.internal.corext.refactoring.code.flow;1;0;5;1;1;1;1;4;38;2;2;189;96;16;2;2;0;4;5;189;2;6340;3;2;
org.eclipse.update.standalone;1;1;11;1;7;7;7;4;586;2;3;825;1078;62;2;1;0;4;11;825;1;6336;10;1;
org.eclipse.compare.internal.merge;0;2;3;0;3;2;3;0;8;0;0;5165;8;0;2;0;1;0;3;5165;1;5199;2;0;
org.eclipse.jdt.internal.debug.ui.snippeteditor;1;1;9;1;4;4;4;5;216;1;5;596;282;0;1;0;0;5;9;596;0;5898;9;2;
org.eclipse.update.configurator;2;1;4;1;3;3;3;1;18;0;1;3014;44;37;1;0;0;1;4;3014;0;5518;4;2;
org.eclipse.jdt.internal.ui.text.template.contentassist;1;1;13;1;3;3;3;10;70;3;8;4258;220;2;3;2;0;10;13;4258;2;6340;11;2;
org.eclipse.core.internal.resources;2;0;4;1;1;1;1;3;18956;1;3;44;20098;2655;1;0;0;3;4;44;0;5146;4;2;
org.eclipse.debug.internal.ui.views.expression;0;0;7;0;1;1;1;6;80;1;6;307;169;0;1;0;0;6;7;307;0;6336;7;1;
org.eclipse.osgi.internal.resolver;2;1;12;1;3;3;3;9;482;2;8;3013;1218;117;2;1;0;9;12;3013;1;5536;11;4;
org.eclipse.help.internal.webapp;0;1;5;0;3;3;3;2;39;1;2;401;90;0;1;0;0;2;5;401;0;6337;5;0;
org.eclipse.jface.dialogs;1;1;12;1;6;6;6;6;4146;2;5;1;4536;33;2;1;0;6;12;1;1;5615;11;2;
org.eclipse.ui.application;0;2;10;0;3;2;3;7;509;2;6;1259;661;0;2;1;1;7;10;1259;2;6338;8;0;
org.eclipse.update.search;1;1;7;1;2;2;2;5;89;2;4;825;195;15;2;1;0;5;7;825;1;6336;6;2;
org.eclipse.pde.internal.ui.model.bundle;0;2;10;0;10;9;10;0;72;0;0;5425;217;0;2;0;1;0;10;5425;1;6336;9;0;
org.eclipse.core.internal.runtime;0;1;12;0;2;2;2;10;6430;1;10;44;13903;0;1;0;0;10;12;44;0;5150;12;0;
org.eclipse.update.core.model;0;1;6;0;3;3;3;3;122;2;2;0;338;0;2;1;0;3;6;0;1;6336;5;0;
org.eclipse.jface.text.rules;1;1;7;1;2;2;2;5;129;2;4;1521;293;2;2;1;0;5;7;1521;1;6340;6;1;
org.eclipse.core.runtime.preferences;2;2;16;1;4;3;4;12;198;2;11;4033;732;61;2;1;1;12;16;4033;2;6340;14;2;
org.eclipse.osgi.framework.internal.defaultadaptor;6;2;32;2;8;7;8;24;1286;2;20;3013;3533;1723;2;4;1;24;32;3013;5;6098;27;6;
org.eclipse.swt.internal.mozilla;2;1;5;1;2;2;2;3;677;2;2;1654;687;463;2;1;0;3;5;1654;1;6342;4;2;
org.eclipse.jdt.internal.compiler.codegen;1;1;10;1;2;2;2;8;2830;3;6;25;3248;2;3;2;0;8;10;146;2;5940;8;1;
org.eclipse.team.internal.core.subscribers;1;1;7;1;2;2;2;5;1335;2;4;3550;1369;74;2;1;0;5;7;3550;1;6336;6;2;
org.eclipse.ltk.internal.core.refactoring;1;1;4;1;2;2;2;2;26;0;1;4845;48;69;2;1;0;2;4;4845;1;6340;3;1;
org.eclipse.ltk.core.refactoring;1;1;6;1;3;3;3;3;219;2;2;4845;633;38;2;1;0;3;6;4845;1;6338;5;1;
org.eclipse.debug.internal.ui.actions;2;0;9;1;0;0;0;9;124;2;8;134;243;13;2;1;0;9;9;976;1;2555;8;3;
org.eclipse.pde.internal.ui;2;1;18;1;5;5;5;13;260;1;13;368;615;174;1;0;0;13;18;368;0;6336;18;2;
org.eclipse.jdi.internal.request;0;1;5;0;3;3;3;2;17;1;2;1240;31;0;1;0;0;2;5;1240;0;6336;5;0;
org.eclipse.core.runtime.adaptor;3;1;45;1;2;2;2;43;791;2;38;3013;3628;180;2;5;0;43;45;3013;5;6133;40;3;
org.eclipse.jdt.internal.debug.ui.propertypages;2;0;4;1;1;1;1;3;30;2;2;1358;39;2;2;1;0;3;4;1358;1;5581;3;2;
org.eclipse.team.internal.ccvs.ui.repo;2;1;12;1;4;4;4;8;315;2;7;68;778;46;2;1;0;8;12;68;1;6337;11;2;
org.eclipse.jdt.internal.ui.javaeditor;1;0;20;1;1;1;1;19;620;2;17;500;2237;26;2;2;0;19;20;500;2;6340;18;1;
org.eclipse.ltk.core.refactoring.participants;1;1;7;1;4;4;4;3;614;2;2;4845;1359;315;2;1;0;3;7;4845;1;6351;6;1;
org.eclipse.jdt.internal.corext.javadoc;1;0;3;1;1;1;1;2;91;1;2;1309;104;2;1;0;0;2;3;1309;0;6340;3;1;
org.eclipse.ui.internal.registry;4;1;8;1;2;2;2;6;336;2;5;830;833;1170;2;1;0;6;8;830;1;6338;7;6;
org.eclipse.team.internal.ccvs.ui.actions;0;0;8;0;1;1;1;7;112;2;6;228;500;0;2;1;0;7;8;241;1;6337;7;0;
org.eclipse.jdt.internal.core.search.indexing;0;1;15;0;2;2;2;13;1550;2;12;91;2437;0;2;1;0;13;15;91;1;6099;14;0;
org.eclipse.debug.internal.ui.launchConfigurations;2;2;26;1;4;3;4;22;525;2;21;309;1762;16;2;1;1;22;26;4836;2;5206;24;2;
org.eclipse.pde.internal.ui.wizards.feature;0;1;6;0;4;4;4;2;587;0;1;3840;844;0;2;1;0;2;6;3840;1;6336;5;0;
org.eclipse.jdt.internal.ui.compare;2;1;12;1;3;3;3;9;281;1;9;187;941;18;1;0;0;9;12;187;0;6340;12;2;
org.eclipse.team.internal.ccvs.ssh2;2;1;4;1;2;2;2;2;200;0;1;4825;202;11;2;1;0;2;4;4825;1;6337;3;2;
org.eclipse.jdt.ui.text.java;0;1;6;0;2;2;2;4;71;2;3;1232;148;0;2;1;0;4;6;1232;1;6322;5;0;
org.eclipse.help.internal.workingset;1;1;4;1;2;2;2;2;371;0;1;1740;427;195;2;1;0;2;4;1740;1;6337;3;1;
org.eclipse.ui.internal.intro.impl.html;1;2;3;1;3;2;3;0;8;0;0;5115;8;2;2;0;1;0;3;5115;1;5314;2;1;
org.eclipse.jdt.internal.junit.refactoring;0;0;3;0;1;1;1;2;40;0;1;5041;40;0;2;1;0;2;3;5041;1;6340;2;0;
org.eclipse.jdt.internal.formatter.align;0;0;17;0;0;0;0;17;31;1;17;535;189;0;1;0;0;17;17;535;0;3996;17;0;
org.eclipse.jdt.internal.debug.core.breakpoints;1;0;5;1;0;0;0;5;124;1;5;347;206;2;1;0;0;5;5;347;0;2740;5;1;
org.eclipse.jdt.core.compiler;0;1;31;0;6;6;6;25;79;2;21;13;560;0;2;4;0;25;31;13;4;5853;27;0;
org.eclipse.jdt.internal.corext.refactoring.base;2;0;5;1;1;1;1;4;33;2;3;882;54;26;2;1;0;4;5;882;1;6340;4;3;
org.eclipse.help.internal.appserver;0;1;12;0;3;3;3;9;177;2;8;105;629;0;2;1;0;9;12;4616;1;5827;11;0;
org.eclipse.core.internal.watson;1;0;4;1;1;1;1;3;3291;2;2;178;3357;149;2;1;0;3;4;178;1;5146;3;1;
org.eclipse.jdt.ui.search;0;1;8;0;6;6;6;2;87;0;1;5075;146;0;2;1;0;2;8;5075;1;6334;7;0;
org.eclipse.ltk.ui.refactoring;1;1;12;1;6;6;6;6;754;1;6;4845;1192;2;1;0;0;6;12;4845;0;6323;12;1;
org.eclipse.jdt.internal.ui.workingsets;1;0;4;1;1;1;1;3;81;2;2;951;127;5;2;1;0;3;4;951;1;6340;3;1;
org.eclipse.swt.internal;0;0;28;0;1;1;1;27;41;2;26;0;212;0;2;1;0;27;28;0;1;6352;27;0;
org.eclipse.ant.internal.ui.editor;1;2;63;1;20;17;20;43;327;2;39;1811;2735;120;2;4;3;43;63;1811;7;6019;56;1;
org.eclipse.compare;1;0;6;1;0;0;0;6;245;1;6;257;309;9;1;0;0;6;6;257;0;3935;6;1;
org.eclipse.ui.externaltools.internal.ui;0;1;32;0;3;3;3;29;431;2;26;33;1567;0;2;3;0;29;32;33;3;6151;29;0;
org.eclipse.jdt.core.util;2;0;5;1;0;0;0;5;886;1;5;132;941;140;1;0;0;5;5;132;0;4843;5;2;
org.eclipse.ui.views.tasklist;1;0;2;1;0;0;0;2;0;0;1;2208;0;12;2;1;0;2;2;2208;1;2208;1;3;
org.eclipse.pde.internal.core;1;1;17;1;2;2;2;15;1588;2;13;18;2656;13;2;2;0;15;17;2229;2;6336;15;2;
org.eclipse.jdt.internal.ui.wizards.buildpaths;2;0;6;1;1;1;1;5;70;1;5;451;176;578;1;0;0;5;6;451;0;6340;6;4;
org.eclipse.update.internal.ui.parts;1;0;4;1;1;1;1;3;32;1;3;807;50;7;1;0;0;3;4;807;0;6336;4;1;
org.eclipse.help.ui.internal;0;1;9;0;3;3;3;6;700;2;5;1776;1383;0;2;1;0;6;9;1776;1;6337;8;0;
org.eclipse.ui.internal.intro.impl.model.viewer;0;1;2;0;2;2;2;0;2;0;0;5115;2;0;1;0;0;0;2;5115;0;5314;2;0;
org.eclipse.ui.internal.dnd;0;0;4;0;0;0;0;4;614;2;3;3677;614;0;2;1;0;4;4;3677;1;4015;3;0;
org.eclipse.ant.internal.ui.views;1;0;5;1;1;1;1;4;8;2;3;1811;11;0;2;1;0;4;5;1811;1;6336;4;1;
org.eclipse.jface.viewers;0;0;3;0;0;0;0;3;16;2;2;1;24;5;2;1;0;3;3;1;1;1293;2;3;
org.eclipse.ui.internal.activities.ws;0;0;4;0;1;1;1;3;18;2;2;3066;18;2;2;1;0;3;4;3066;1;5874;3;2;
org.eclipse.ui.editors.text.templates;0;1;3;0;3;3;3;0;18;0;0;5360;30;0;1;0;0;0;3;5360;0;6340;3;0;
org.eclipse.ui.internal.themes;1;0;8;1;1;1;1;7;945;2;5;3684;2420;226;2;2;0;7;8;3684;2;5274;6;2;
org.eclipse.ant.internal.ui.editor.derived;1;0;2;1;0;0;0;2;0;0;1;1811;0;9;2;1;0;2;2;1811;1;1811;1;1;
org.eclipse.jdt.ui.text;0;1;13;0;4;4;4;9;62;1;9;505;212;0;1;0;0;9;13;505;0;6356;13;0;
org.eclipse.ui.intro.config;0;2;6;0;6;5;6;0;120;0;0;5277;174;0;2;0;1;0;6;5277;1;6343;5;0;
org.eclipse.jdt.internal.debug.ui.actions;1;0;6;1;1;1;1;5;234;1;5;174;319;51;1;0;0;5;6;174;0;5620;6;4;
org.eclipse.swt.tools.internal;1;0;3;1;0;0;0;3;3;2;2;4175;3;43;2;1;0;3;3;4175;1;4269;2;2;
org.eclipse.update.configuration;1;0;2;1;0;0;0;2;25;0;1;890;25;4;2;1;0;2;2;890;1;890;1;1;
org.eclipse.team.internal.ccvs.ui.model;1;0;4;1;0;0;0;4;595;2;3;66;773;216;2;1;0;4;4;66;1;1065;3;2;
org.eclipse.jdt.internal.ui.text.comment;3;1;16;1;3;3;3;13;1822;2;11;1589;5214;488;2;2;0;13;16;1589;2;6340;14;3;
org.eclipse.jdt.internal.codeassist.complete;2;0;10;1;0;0;0;10;500;2;9;13;701;31;2;1;0;10;10;13;1;3560;9;2;
org.eclipse.swt.internal.gtk;3;0;38;1;1;1;1;37;1757;3;34;15;6011;112;3;3;0;37;38;1102;3;6352;35;6;
org.eclipse.debug.internal.ui.views.variables;0;0;22;0;0;0;0;22;164;2;19;228;624;41;2;3;0;22;22;670;3;4425;19;1;
org.eclipse.pde.internal.ui.model;0;1;9;0;6;6;6;3;70;2;2;4438;208;0;2;1;0;3;9;4438;1;6336;8;0;
org.eclipse.jdi.internal.jdwp;0;0;2;0;0;0;0;2;7;1;2;215;10;0;1;0;0;2;2;215;0;4267;2;0;
org.eclipse.update.internal.mirror;0;1;13;0;3;3;3;10;204;2;9;1566;597;0;2;1;0;10;13;1566;1;6336;12;0;
org.eclipse.pde.internal.build.site;0;1;14;0;5;5;5;9;800;2;8;447;1084;0;2;1;0;9;14;447;1;5702;13;0;
org.eclipse.jface.internal.text.link.contentassist;2;1;4;1;2;2;2;2;24;0;1;4214;32;2;2;1;0;2;4;4214;1;6340;3;2;
org.eclipse.team.internal.ccvs.core.syncinfo;0;1;9;0;2;2;2;7;108;1;7;276;286;0;1;0;0;7;9;276;0;6337;9;0;
org.eclipse.jdt.ui.jarpackager;1;1;8;1;6;6;6;2;51;1;2;394;141;2;1;0;0;2;8;394;0;6340;8;1;
org.eclipse.pde.internal.core.util;0;1;8;0;4;4;4;4;20;1;4;2184;57;0;1;0;0;4;8;2184;0;6336;8;0;
org.eclipse.jdt.internal.corext.refactoring.reorg;2;1;21;1;3;3;3;18;394;1;18;130;963;2;1;0;0;18;21;130;0;6340;21;2;
org.eclipse.help.ui.internal.browser;0;1;7;0;3;3;3;4;34;1;4;460;120;0;1;0;0;4;7;460;0;6337;7;0;
org.eclipse.debug.core.sourcelookup.containers;1;0;6;1;1;1;1;5;107;4;2;4949;183;2;4;3;0;5;6;4949;3;5109;3;1;
org.eclipse.ui.ide;0;2;27;0;8;7;8;19;118;4;15;1511;495;0;4;4;1;19;27;1670;5;6338;22;0;
org.eclipse.ant.internal.ui.antsupport;0;0;4;0;0;0;0;4;0;3;2;1811;0;0;3;2;0;4;4;1811;2;3744;2;0;
org.eclipse.ui.internal.presentations.r21.widgets;0;0;2;0;2;1;2;0;0;0;0;6075;0;0;2;0;1;0;2;6075;1;6075;1;0;
org.eclipse.debug.internal.ui.sourcelookup.browsers;0;0;7;0;0;0;0;7;41;2;6;3770;121;0;2;1;0;7;7;3770;1;4970;6;0;
org.eclipse.jdt.junit;2;1;2;1;2;2;2;0;6;0;0;5112;8;8;1;0;0;0;2;5112;0;6340;2;2;
org.eclipse.jdt.internal.debug.eval.ast.instructions;1;0;4;1;0;0;0;4;52;1;4;363;83;21;1;0;0;4;4;363;0;2497;4;2;
org.eclipse.ant.internal.ui.datatransfer;0;0;2;0;0;0;0;2;0;0;1;4809;0;0;2;1;0;2;2;4809;1;4809;1;0;
org.eclipse.jdt.internal.launching.macosx;0;0;8;0;0;0;0;8;220;1;8;134;603;0;1;0;0;8;8;134;0;3622;8;0;
org.eclipse.ui.internal.cheatsheets.registry;0;0;5;0;1;1;1;4;85;2;3;4428;125;0;2;1;0;4;5;4428;1;5759;4;0;
org.eclipse.help.internal.base;0;1;19;0;5;5;5;14;412;3;11;1747;937;0;3;3;0;14;19;1747;3;6337;16;0;
org.eclipse.jdt.internal.debug.core.hcr;0;0;2;0;0;0;0;2;3;1;2;215;5;0;1;0;0;2;2;215;0;307;2;0;
org.eclipse.jface.resource;1;0;9;1;1;1;1;8;200;1;8;34;552;0;1;0;0;8;9;34;0;6338;9;1;
org.eclipse.team.core.variants;2;1;4;1;2;2;2;2;174;0;1;4349;186;10;2;1;0;2;4;4349;1;6336;3;2;
org.eclipse.ui.presentations;2;1;4;1;2;2;2;2;81;0;1;4469;106;213;2;1;0;2;4;4469;1;5672;3;6;
org.eclipse.update.internal.ui.views;0;1;15;0;2;2;2;13;1583;1;13;350;2229;0;1;0;0;13;15;350;0;6336;15;0;
org.eclipse.update.internal.core;2;1;11;1;3;3;3;8;489;1;8;460;1423;383;1;0;0;8;11;460;0;6336;11;3;
org.eclipse.jdt.internal.corext.codemanipulation;0;0;13;0;1;1;1;12;123;2;10;239;488;0;2;2;0;12;13;243;2;6340;11;0;
org.eclipse.ui.intro;0;1;8;0;3;3;3;5;182;1;5;3541;352;0;1;0;0;5;8;3541;0;5533;8;0;
org.eclipse.team.core;0;1;11;0;4;4;4;7;209;1;7;276;736;0;1;0;0;7;11;276;0;6336;11;0;
org.eclipse.team.core.subscribers;2;1;6;1;3;3;3;3;363;2;2;3966;542;83;2;1;0;3;6;3966;1;6336;5;2;
org.eclipse.jdt.internal.ui.refactoring.actions;3;0;11;1;1;1;1;10;279;2;9;42;677;319;2;1;0;10;11;42;1;6340;10;3;
org.eclipse.jdt.internal.ui.text.java.hover;2;1;9;1;2;2;2;7;197;1;7;600;362;674;1;0;0;7;9;600;0;6340;9;4;
org.eclipse.ui.internal.editors.text;3;1;13;1;2;2;2;11;271;1;11;849;1004;1257;1;0;0;11;13;849;0;6340;13;3;
org.eclipse.ui.internal.editors.quickdiff;0;1;19;0;6;6;6;13;236;1;13;1214;802;0;1;0;0;13;19;1214;0;6340;19;0;
org.eclipse.jdt.internal.debug.core.model;0;1;13;0;2;2;2;11;320;2;10;173;829;0;2;1;0;11;13;173;1;5757;12;0;
org.eclipse.ui.internal.ide.actions;0;0;2;0;0;0;0;2;0;0;1;2264;0;25;2;1;0;2;2;2264;1;2264;1;1;
org.eclipse.pde.internal.ui.editor.feature;3;1;13;1;4;4;4;9;2425;1;9;217;3950;215;1;0;0;9;13;217;0;6336;13;3;
org.eclipse.jdt.internal.debug.core.logicalstructures;1;0;3;1;0;0;0;3;8;2;2;2647;8;15;2;1;0;3;3;2647;1;2709;2;2;
org.eclipse.pde.internal.build;0;1;15;0;3;3;3;12;2186;2;11;447;12245;0;2;1;0;12;15;447;1;6083;14;0;
org.eclipse.compare.internal.patch;1;0;5;1;0;0;0;5;23;2;4;257;63;2;2;1;0;5;5;257;1;3938;4;1;
org.eclipse.pde.internal.build.packager;0;1;12;0;5;5;5;7;65;2;6;447;252;0;2;1;0;7;12;447;1;5754;11;0;
org.eclipse.debug.internal.ui.sourcelookup;1;0;2;1;0;0;0;2;0;0;1;3770;0;234;2;1;0;2;2;3770;1;3770;1;3;
org.eclipse.jdt.internal.core.search;1;0;6;1;0;0;0;6;223;1;6;259;256;129;1;0;0;6;6;259;0;3560;6;1;
org.eclipse.jdt.debug.core;2;0;8;1;1;1;1;7;51;1;7;7;159;116;1;0;0;7;8;7;0;6336;8;4;
org.eclipse.ui.internal.cheatsheets;1;1;6;1;3;3;3;3;91;2;2;4428;137;0;2;1;0;3;6;4428;1;5944;5;1;
org.eclipse.ui.internal.decorators;0;1;7;0;3;3;3;4;125;1;4;596;275;0;1;0;0;4;7;596;0;6338;7;0;
org.eclipse.pde.internal.ui.wizards.site;2;1;10;1;9;9;9;1;562;0;1;3840;697;71;1;0;0;1;10;3840;0;6336;10;2;
org.eclipse.swt.accessibility;0;0;12;0;0;0;0;12;990;3;9;0;3114;0;3;3;0;12;12;1102;3;2729;9;1;
org.eclipse.help.ui.internal.ide;0;1;8;0;3;3;3;5;120;2;4;1778;174;0;2;1;0;5;8;1778;1;6337;7;0;
org.eclipse.debug.core;0;1;27;0;7;7;7;20;141;1;20;151;813;0;1;0;0;20;27;151;0;5803;27;0;
org.eclipse.jdt.internal.corext.refactoring.surround;0;0;4;0;1;1;1;3;21;1;3;218;39;0;1;0;0;3;4;218;0;6340;4;0;
org.eclipse.ui.internal.contexts;4;1;22;1;2;2;2;20;856;3;17;1220;2652;1743;3;3;0;20;22;1400;3;6338;19;4;
org.eclipse.ui.internal.about;0;2;3;0;3;2;3;0;4;0;0;5483;4;0;2;0;1;0;3;5483;1;6338;2;0;
org.eclipse.ui.externaltools.internal.variables;0;0;4;0;0;0;0;4;8;1;4;2082;16;0;1;0;0;4;4;2082;0;2515;4;0;
org.eclipse.ui.contexts;0;1;23;0;2;2;2;21;820;2;17;1119;2247;0;2;4;0;21;23;1119;4;6338;19;0;
org.eclipse.debug.internal.ui.views.memory;1;2;3;1;3;2;3;0;169;0;0;5254;169;18;2;0;1;0;3;5254;1;5364;2;2;
org.eclipse.pde.internal.junit.runtime;0;0;4;0;1;1;1;3;23;2;2;1453;45;0;2;1;0;3;4;1453;1;6039;3;0;
org.eclipse.ui.views.properties;0;0;3;0;0;0;0;3;8;2;2;1;8;505;2;1;0;3;3;1;1;2208;2;3;
org.eclipse.team.internal.ccvs.core;0;0;15;0;0;0;0;15;57;1;15;276;195;68;1;0;0;15;15;276;0;2181;15;2;
org.eclipse.jdt.internal.ui.jarpackager;1;0;7;1;1;1;1;6;39;1;6;239;165;2;1;0;0;6;7;239;0;6340;7;1;
org.eclipse.core.internal.events;2;1;29;1;11;11;11;18;2852;2;16;1477;5540;60;2;2;0;18;29;1477;2;6265;27;2;
org.eclipse.jdt.internal.ui.text.java;0;1;26;0;9;9;9;17;562;2;16;546;1473;0;2;1;0;17;26;546;1;6340;25;0;
org.eclipse.jdt.internal.corext.textmanipulation;0;0;5;0;1;1;1;4;212;1;4;456;241;0;1;0;0;4;5;456;0;6340;5;0;
org.eclipse.jface.text.presentation;0;1;3;0;2;2;2;1;137;0;1;1511;163;0;1;0;0;1;3;1511;0;6352;3;0;
org.eclipse.ant.internal.ui.editor.outline;1;0;4;1;1;1;1;3;147;2;2;1811;163;0;2;1;0;3;4;1811;1;6336;3;1;
org.eclipse.jdt.internal.compiler.parser;0;1;50;0;6;6;6;44;2338;4;36;13;7844;0;4;8;0;44;50;2118;8;6162;42;0;
org.eclipse.jface.text.projection;1;0;6;1;1;1;1;5;262;2;4;4516;565;505;2;1;0;5;6;4516;1;6301;5;2;
org.eclipse.help.internal.browser;1;1;5;1;2;2;2;3;258;2;2;1740;350;63;2;1;0;3;5;1740;1;6337;4;1;
