filename;TotalPeopleInBurst;MaximumChangeBurstLate;NumberOfChanges;MaxPeopleInBurst;TotalBurstSizeLate;NumberOfChangeBurstsLate;NumberOfChangesLate;NumberOfChangesEarly;MaxChurnInBurst;MaximumChangeBurstEarly;NumberOfChangeBurstsEarly;TimeFirstBurst;TotalChurnInBurst;ChurnTotal;MaximumChangeBurst;NumberOfConsecutiveChangesEarly;NumberOfConsecutiveChangesLate;TotalBurstSizeEarly;TotalBurstSize;TimeMaxBurst;NumberOfConsecutiveChanges;TimeLastBurst;NumberOfChangeBursts;PeopleTotal;
org.eclipse.jface.text.information;0;0;3;0;1;1;1;2;40;0;1;1435;40;0;2;1;0;2;3;1435;1;4838;2;0;
org.eclipse.team.ui;0;2;7;0;3;2;3;4;102;2;3;1978;124;0;2;1;1;4;7;1978;2;4632;5;0;
org.eclipse.pde.internal.ui.launcher;1;3;18;1;12;7;12;6;188;2;5;3579;433;0;3;1;5;6;18;4449;6;4635;12;1;
org.eclipse.ui.views.bookmarkexplorer;4;0;9;1;0;0;0;9;88;2;8;257;200;28;2;1;0;9;9;257;1;3725;8;5;
org.eclipse.debug.internal.ui;3;0;32;1;1;1;1;31;486;5;26;187;1727;31;5;5;0;31;32;2346;5;4567;27;4;
org.eclipse.pde.internal.core.schema;1;0;4;1;1;1;1;3;202;2;2;3591;210;53;2;1;0;3;4;3591;1;4340;3;1;
org.eclipse.swt.internal.photon;2;0;3;1;1;1;1;2;168;0;1;2069;168;66;2;1;0;2;3;2069;1;4701;2;2;
org.eclipse.jdt.internal.compiler.classfmt;2;0;20;1;1;1;1;19;2323;4;12;455;6337;287;4;7;0;19;20;1039;7;4062;13;2;
org.eclipse.jdt.internal.core.hierarchy;0;1;17;0;2;2;2;15;1999;4;10;455;3224;0;4;5;0;15;17;1039;5;4165;12;0;
org.eclipse.jdt.internal.ui.text.link;0;0;2;0;0;0;0;2;0;0;1;1720;0;0;2;1;0;2;2;1720;1;1720;1;0;
org.eclipse.jdt.internal.launching;1;3;21;1;11;9;11;10;884;2;9;2022;1601;24;3;1;2;10;21;4210;3;4451;18;1;
org.eclipse.jdt.core.eval;0;2;6;0;3;2;3;3;584;2;2;455;646;0;2;1;1;3;6;455;2;4836;4;0;
org.eclipse.help.ui.internal.util;1;0;2;1;2;1;2;0;0;0;0;4439;0;0;2;0;1;0;2;4439;1;4439;1;1;
org.eclipse.jdt.internal.junit.util;1;0;2;1;0;0;0;2;0;1;2;3171;0;0;1;0;0;2;2;3171;0;3247;2;1;
org.eclipse.jdi;0;0;7;0;0;0;0;7;25;2;5;187;53;0;2;2;0;7;7;187;2;3667;5;0;
org.eclipse.jface.window;0;1;14;0;5;5;5;9;89;2;8;257;241;0;2;1;0;9;14;257;1;4547;13;0;
org.eclipse.jface.text.reconciler;3;1;6;1;2;2;2;4;94;2;3;257;272;65;2;1;0;4;6;257;1;4838;5;3;
org.eclipse.debug.ui;1;1;18;1;3;3;3;15;253;2;14;187;777;9;2;1;0;15;18;187;1;4653;17;2;
org.eclipse.core.internal.localstore;2;0;15;1;1;1;1;14;5744;3;11;12;6618;99;3;3;0;14;15;327;3;4214;12;2;
org.eclipse.jface.text.formatter;3;0;5;1;0;0;0;5;505;2;4;257;941;6;2;1;0;5;5;257;1;1066;4;3;
org.eclipse.search.ui;2;0;4;1;0;0;0;4;75;2;3;15;137;10;2;1;0;4;4;15;1;1434;3;2;
org.eclipse.jdt.internal.ui.browsing;3;5;81;1;32;19;32;49;246;4;30;2878;2504;86;5;19;13;49;81;4014;32;4626;49;3;
org.eclipse.jdt.internal.junit.wizards;0;0;2;0;0;0;0;2;0;0;1;3527;0;0;2;1;0;2;2;3527;1;3527;1;0;
org.eclipse.core.resources.team;0;0;5;0;0;0;0;5;863;3;3;3195;932;0;3;2;0;5;5;3243;2;3360;3;0;
org.eclipse.pde.internal.ui.editor.manifest;1;0;2;1;0;0;0;2;0;0;1;3579;0;46;2;1;0;2;2;3579;1;3579;1;1;
org.eclipse.team.internal.ccvs.ui;1;2;55;1;20;17;20;35;780;3;25;1978;6039;347;3;10;3;35;55;2737;13;4707;42;3;
org.eclipse.update.core;2;0;27;1;0;0;0;27;2690;3;21;1423;5602;342;3;6;0;27;27;1423;6;3697;21;2;
org.eclipse.debug.internal.ui.views.launch;0;2;15;0;15;13;15;0;2110;0;0;3975;2412;0;2;0;2;0;15;3975;2;4709;13;0;
org.eclipse.update.internal.security;0;1;16;0;3;3;3;13;288;2;12;3122;1091;0;2;1;0;13;16;3122;1;4626;15;0;
org.eclipse.core.internal.indexing;3;0;8;1;1;1;1;7;11444;2;6;12;19128;1914;2;1;0;7;8;12;1;4214;7;4;
org.eclipse.core.internal.plugins;3;2;16;1;8;7;8;8;13146;2;7;12;15671;106;2;1;1;8;16;12;2;4552;14;3;
org.eclipse.compare.internal;1;0;4;1;0;0;0;4;333;2;3;14;559;25;2;1;0;4;4;14;1;761;3;2;
org.eclipse.swt.ole.win32;2;0;4;1;1;1;1;3;215;2;2;106;299;27;2;1;0;3;4;106;1;4701;3;3;
org.eclipse.team.internal.ccvs.core.client;2;1;20;2;2;2;2;18;2639;2;15;2572;5154;198;2;3;0;18;20;2572;3;4111;17;2;
org.eclipse.jdt.core;2;2;17;1;6;4;6;11;9913;4;7;455;13834;53;4;4;2;11;17;3872;6;4058;11;2;
org.eclipse.compare.structuremergeviewer;0;0;3;0;0;0;0;3;73;2;2;14;73;0;2;1;0;3;3;14;1;329;2;0;
org.eclipse.swt.graphics;2;1;6;1;2;2;2;4;3589;2;3;106;6155;145;2;1;0;4;6;106;1;4701;5;6;
org.eclipse.search.internal.ui;2;1;13;1;4;4;4;9;274;2;7;15;1291;42;2;2;0;9;13;15;2;4161;11;2;
org.eclipse.pde.internal.ui.preferences;0;1;9;0;2;2;2;7;99;3;5;3579;157;0;3;2;0;7;9;3579;2;4435;7;0;
org.eclipse.compare.contentmergeviewer;1;0;3;1;0;0;0;3;126;2;2;14;126;5;2;1;0;3;3;14;1;329;2;1;
org.eclipse.jdt.internal.debug.eval.ast.engine;1;0;5;1;0;0;0;5;525;1;5;3329;597;0;1;0;0;5;5;3329;0;3645;5;1;
org.eclipse.search.internal.ui.util;2;0;6;1;0;0;0;6;107;2;5;15;191;31;2;1;0;6;6;15;1;1400;5;2;
org.eclipse.pde.internal.ui.parts;1;0;2;1;0;0;0;2;0;0;1;3579;0;0;2;1;0;2;2;3579;1;3579;1;1;
org.eclipse.pde.internal.core.feature;0;0;3;0;1;1;1;2;445;0;1;3591;445;0;2;1;0;2;3;3591;1;3994;2;1;
org.eclipse.debug.internal.core;0;0;16;0;0;0;0;16;425;2;13;187;1415;0;2;3;0;16;16;187;3;2390;13;0;
org.eclipse.swt.program;0;1;21;0;3;3;3;18;1710;2;17;106;1968;0;2;1;0;18;21;106;1;4701;20;0;
org.eclipse.help.internal.util;1;0;3;1;0;0;0;3;14;2;2;1420;14;59;2;1;0;3;3;1420;1;3609;2;2;
org.eclipse.swt.printing;0;1;6;0;2;2;2;4;531;2;3;106;736;0;2;1;0;4;6;106;1;4701;5;0;
org.eclipse.ui.actions;4;0;11;1;1;1;1;10;762;2;9;257;1317;335;2;1;0;10;11;257;1;4146;10;6;
org.eclipse.jdt.internal.corext.refactoring.tagging;1;0;2;1;0;0;0;2;0;0;1;1939;0;0;2;1;0;2;2;1939;1;1939;1;1;
org.eclipse.update.internal.ui.search;0;0;2;0;0;0;0;2;0;0;1;3537;0;37;2;1;0;2;2;3537;1;3537;1;1;
org.eclipse.debug.core.model;2;0;9;1;0;0;0;9;272;2;8;187;776;136;2;1;0;9;9;187;1;3474;8;3;
org.eclipse.jdt.internal.codeassist.select;1;0;11;1;1;1;1;10;1590;4;6;455;2640;22;4;4;0;10;11;1039;4;4062;7;2;
org.eclipse.jdi.internal.event;2;0;5;1;0;0;0;5;299;2;4;187;573;64;2;1;0;5;5;187;1;3670;4;2;
org.eclipse.help;0;0;9;0;1;1;1;8;53;2;7;1420;158;0;2;1;0;8;9;1420;1;3938;8;0;
org.eclipse.jdt.core.dom;2;2;8;1;3;2;3;5;865;2;4;2669;3212;236;2;1;1;5;8;2669;2;4452;6;3;
org.eclipse.jdt.internal.eval;0;0;8;0;1;1;1;7;15153;2;6;455;15987;0;2;1;0;7;8;455;1;4062;7;0;
org.eclipse.pde.internal.ui.editor.text;0;0;3;0;1;1;1;2;76;0;1;3579;76;0;2;1;0;2;3;3579;1;4588;2;1;
org.eclipse.jdt.internal.core.builder;3;2;17;2;8;6;8;9;580;2;7;2979;1485;21;2;2;2;9;17;2979;4;4666;13;3;
org.eclipse.jdt.internal.debug.core;0;0;18;0;0;0;0;18;196;2;15;187;642;0;2;3;0;18;18;187;3;3108;15;0;
org.eclipse.update.internal.ui.wizards;1;2;42;1;9;7;9;33;314;2;30;1570;1464;50;2;3;2;33;42;1570;5;4715;37;1;
org.eclipse.jdt.core.search;0;2;8;0;4;3;4;4;287;2;3;455;406;0;2;1;1;4;8;455;2;4606;6;0;
org.eclipse.ui.dialogs;4;0;7;1;0;0;0;7;879;2;5;257;974;223;2;2;0;7;7;257;2;3733;5;8;
com.sun.jdi.connect;2;0;3;1;0;0;0;3;100;2;2;2704;100;59;2;1;0;3;3;2704;1;3033;2;2;
org.eclipse.jdt.internal.ui.preferences;3;4;59;1;22;14;22;37;659;4;31;15;3390;559;4;6;8;37;59;128;14;4706;45;5;
org.eclipse.team.core.sync;0;0;7;0;1;1;1;6;134;3;2;2019;248;0;3;4;0;6;7;2019;4;4707;3;0;
org.eclipse.pde.internal.core.plugin;1;0;5;1;1;1;1;4;60;2;3;3591;62;0;2;1;0;4;5;3591;1;4555;4;1;
org.eclipse.swt;0;2;17;0;6;4;6;11;407;2;8;106;1081;0;2;3;2;11;17;106;5;4701;12;0;
com.sun.jdi.event;2;0;3;1;0;0;0;3;159;2;2;2704;159;28;2;1;0;3;3;2704;1;3040;2;2;
org.eclipse.pde.core.plugin;1;0;4;1;2;1;2;2;986;0;1;3591;986;169;2;1;1;2;4;3591;2;4751;2;1;
org.eclipse.jdt.internal.ui.javaeditor.structureselection;0;1;9;0;2;2;2;7;25;3;4;3188;115;0;3;3;0;7;9;3188;3;4630;6;0;
org.eclipse.jdt.internal.ui.refactoring.nls.search;0;0;3;0;0;0;0;3;31;2;2;1922;31;0;2;1;0;3;3;1922;1;3530;2;0;
org.eclipse.jdt.internal.corext.refactoring;0;0;4;0;0;0;0;4;20;2;3;1939;31;0;2;1;0;4;4;1939;1;3825;3;0;
org.eclipse.pde.internal.build.tasks;0;0;7;0;1;1;1;6;30;2;4;3509;50;0;2;2;0;6;7;3509;2;4273;5;0;
org.eclipse.jdt.internal.core.util;2;2;22;1;12;8;12;10;1923;5;5;455;4929;35;5;5;4;10;22;3629;9;4520;13;2;
org.eclipse.pde.internal.ui.view;1;0;2;1;0;0;0;2;0;0;1;3579;0;3;2;1;0;2;2;3579;1;3579;1;1;
org.eclipse.debug.ui.actions;0;0;5;0;1;1;1;4;10;1;4;2397;22;0;1;0;0;4;5;2397;0;4374;5;0;
org.eclipse.pde.internal.ui.editor.schema;1;0;3;1;0;0;0;3;48;2;2;3579;48;2;2;1;0;3;3;3579;1;3591;2;1;
org.eclipse.pde.internal.runtime.registry;0;0;3;0;1;1;1;2;117;0;1;1434;117;0;2;1;0;2;3;1434;1;4369;2;0;
org.eclipse.help.internal;0;0;7;0;0;0;0;7;137;2;6;1420;207;0;2;1;0;7;7;3048;1;3609;6;0;
org.eclipse.help.ui.internal.browser.hpux;0;1;2;0;2;2;2;0;2;0;0;4209;2;0;1;0;0;0;2;4209;0;4439;2;0;
org.eclipse.jdt.core.jdom;2;0;6;1;2;1;2;4;1631;2;3;455;1969;154;2;1;1;4;6;455;2;4058;4;2;
org.eclipse.jdt.internal.ui.wizards.dialogfields;0;0;10;0;1;1;1;9;542;2;8;15;1327;0;2;1;0;9;10;15;1;4426;9;0;
org.eclipse.jdt.internal.ui.refactoring.sef;0;3;15;0;5;3;5;10;64;2;9;1453;268;0;3;1;2;10;15;4396;3;4421;12;0;
org.eclipse.core.internal.boot;2;0;9;1;1;1;1;8;9452;2;7;12;11042;212;2;1;0;8;9;12;1;4214;8;2;
org.eclipse.help.internal.search;3;2;13;2;3;2;3;10;462;3;8;2318;1039;749;3;2;1;10;13;2318;3;4433;10;3;
org.eclipse.team.internal.ccvs.ui.merge;0;1;13;0;3;3;3;10;220;2;8;2641;391;0;2;2;0;10;13;2641;2;4829;11;0;
org.eclipse.jface.operation;2;0;3;1;0;0;0;3;15;2;2;257;15;10;2;1;0;3;3;257;1;457;2;2;
org.eclipse.update.internal.ui.security;0;0;9;0;1;1;1;8;562;2;6;3122;897;0;2;2;0;8;9;3122;2;4430;7;0;
org.eclipse.jdt.internal.core.index;2;1;6;1;2;2;2;4;105;2;3;455;131;17;2;1;0;4;6;455;1;4063;5;2;
org.eclipse.team.internal.ui;1;1;12;1;3;3;3;9;65;2;8;1978;173;366;2;1;0;9;12;1978;1;4164;11;2;
org.eclipse.jdt.internal.core.jdom;0;3;15;0;5;3;5;10;8746;2;8;455;9194;0;3;2;2;10;15;3959;4;4063;11;0;
org.eclipse.search.internal.ui.text;0;0;16;0;0;0;0;16;47;2;14;15;288;0;2;2;0;16;16;15;2;1272;14;0;
org.eclipse.swt.custom;3;0;11;2;1;1;1;10;3290;3;7;106;6388;2777;3;3;0;10;11;2876;3;4701;8;10;
org.eclipse.jdt.internal.ui.text.correction;1;0;10;1;2;1;2;8;332;2;6;3306;1099;6;2;2;1;8;10;3306;3;4452;7;1;
org.eclipse.team.internal.core;1;0;3;1;1;1;1;2;2;0;1;3762;2;0;2;1;0;2;3;3762;1;4571;2;1;
org.eclipse.pde.internal.build.ant;0;0;5;0;1;1;1;4;248;2;2;3194;256;0;2;2;0;4;5;3194;2;4273;3;0;
org.eclipse.debug.internal.ui.preferences;0;2;3;0;3;2;3;0;90;0;0;3975;90;0;2;0;1;0;3;3975;1;4207;2;0;
org.eclipse.pde.internal.core.ischema;1;0;2;1;0;0;0;2;0;0;1;3591;0;3;2;1;0;2;2;3591;1;3591;1;1;
org.eclipse.webdav.dom;3;0;6;1;1;1;1;5;10834;2;4;12;12551;343;2;1;0;5;6;12;1;4211;5;3;
org.eclipse.team.internal.webdav.core;1;2;11;1;11;6;11;0;305;0;0;4073;835;10;2;0;5;0;11;4073;5;4362;6;2;
org.eclipse.jdt.internal.ui.filters;0;0;2;0;2;1;2;0;0;0;0;4211;0;0;2;0;1;0;2;4211;1;4211;1;0;
org.eclipse.team.internal.ccvs.ui.wizards;0;0;7;0;1;1;1;6;815;2;4;1978;1389;0;2;2;0;6;7;1978;2;3957;5;0;
org.eclipse.update.ui.forms.internal.engine;1;0;7;1;1;1;1;6;186;2;5;2745;649;0;2;1;0;6;7;2745;1;4365;6;1;
org.eclipse.jdt.internal.junit.launcher;0;2;7;0;3;2;3;4;134;2;3;3171;323;0;2;1;1;4;7;3171;2;4451;5;0;
org.eclipse.jdt.internal.corext.template.java;0;0;4;0;1;1;1;3;277;2;2;2784;443;0;2;1;0;3;4;2784;1;4186;3;0;
org.eclipse.help.ui.internal.browser.solaris;0;0;3;0;1;1;1;2;13;1;2;2429;15;0;1;0;0;2;3;2429;0;4439;3;0;
org.eclipse.ui.internal.misc;2;0;6;1;0;0;0;6;201;2;4;257;238;246;2;2;0;6;6;257;2;2674;4;4;
org.eclipse.jdt.internal.compiler.env;0;0;4;0;1;1;1;3;211;2;2;455;306;0;2;1;0;3;4;455;1;4062;3;0;
org.eclipse.jdt.internal.corext.refactoring.structure;1;0;10;1;0;0;0;10;178;2;8;2270;614;0;2;2;0;10;10;2270;2;3569;8;1;
org.eclipse.jdt.internal.compiler.lookup;0;0;5;0;1;1;1;4;15899;2;3;455;16736;0;2;1;0;4;5;455;1;4062;4;0;
org.eclipse.swt.internal.win32;2;0;3;1;1;1;1;2;390;0;1;2069;390;69;2;1;0;2;3;2069;1;4701;2;2;
org.eclipse.help.ui.internal.browser.win32;0;0;2;0;2;1;2;0;0;0;0;4427;0;0;2;0;1;0;2;4427;1;4427;1;0;
org.eclipse.ui;2;1;12;1;2;2;2;10;326;2;8;257;741;321;2;2;0;10;12;257;2;4043;10;8;
org.eclipse.jdt.internal.compiler.util;0;0;13;0;1;1;1;12;1978;4;7;455;2313;0;4;5;0;12;13;1039;5;4062;8;0;
org.eclipse.team.internal.ccvs.core.resources;0;1;41;0;2;2;2;39;2070;5;28;1978;6166;0;5;11;0;39;41;2032;11;4569;30;0;
org.eclipse.jdt.internal.corext.refactoring.util;0;0;11;0;0;0;0;11;37;2;9;1939;79;0;2;2;0;11;11;2928;2;3504;9;0;
org.eclipse.webdav.http.client;2;0;8;1;1;1;1;7;7180;2;6;12;8899;92;2;1;0;7;8;12;1;4211;7;2;
org.eclipse.update.internal.model;1;0;4;1;1;1;1;3;133;0;1;3027;137;205;3;2;0;3;4;3027;2;4615;2;1;
org.eclipse.jdt.internal.ui.typehierarchy;0;2;32;0;8;7;8;24;423;2;20;15;2992;0;2;4;1;24;32;15;5;4361;27;0;
org.eclipse.jdt.internal.junit.ui;1;0;2;1;0;0;0;2;0;0;1;3171;0;0;2;1;0;2;2;3171;1;3171;1;1;
org.eclipse.jdt.internal.compiler.problem;0;0;4;0;1;1;1;3;5674;2;2;455;5835;0;2;1;0;3;4;455;1;4062;3;0;
org.eclipse.pde.internal.builders;0;0;4;0;1;1;1;3;455;2;2;3631;470;0;2;1;0;3;4;3631;1;4733;3;0;
org.eclipse.jdi.internal.connect;0;0;8;0;1;1;1;7;194;2;5;187;488;0;2;2;0;7;8;187;2;4423;6;0;
org.eclipse.ui.internal;2;0;3;1;0;0;0;3;2663;2;2;257;2663;1222;2;1;0;3;3;257;1;457;2;9;
org.eclipse.team.internal.ccvs.core.util;2;0;7;1;1;1;1;6;564;2;5;1978;821;264;2;1;0;6;7;1978;1;3920;6;2;
org.eclipse.ui.editors.text;3;0;4;1;0;0;0;4;360;2;3;257;548;943;2;1;0;4;4;257;1;1066;3;4;
org.eclipse.webdav;2;0;5;1;1;1;1;4;4004;2;3;1635;6130;147;2;1;0;4;5;1635;1;4211;4;2;
org.eclipse.help.ui.internal.browser.aix;2;0;3;1;1;1;1;2;13;1;2;2429;15;15;1;0;0;2;3;2429;0;4439;3;2;
org.eclipse.team.internal.ui.sync;0;0;6;0;2;1;2;4;1017;2;2;2054;1459;0;2;2;1;4;6;2054;3;4005;3;0;
org.eclipse.ui.wizards.newresource;2;0;12;1;1;1;1;11;96;2;10;257;269;74;2;1;0;11;12;257;1;4429;11;3;
org.eclipse.jdt.internal.corext.refactoring.nls;0;0;3;0;0;0;0;3;14;2;2;1939;14;0;2;1;0;3;3;1939;1;2137;2;0;
org.eclipse.pde.internal.ui.editor;0;0;2;0;0;0;0;2;0;0;1;3579;0;0;2;1;0;2;2;3579;1;3579;1;0;
org.eclipse.jface.action;2;0;3;1;0;0;0;3;169;2;2;257;169;103;2;1;0;3;3;257;1;457;2;5;
org.eclipse.jdi.internal.spy;0;0;4;0;0;0;0;4;24;2;3;187;43;0;2;1;0;4;4;187;1;3040;3;1;
org.eclipse.pde.internal.core.ifeature;0;0;2;0;0;0;0;2;0;0;1;3591;0;0;2;1;0;2;2;3591;1;3591;1;0;
org.eclipse.jdt.internal.ui.packageview;0;0;6;0;1;1;1;5;172;2;4;15;369;0;2;1;0;5;6;15;1;4160;5;0;
org.eclipse.team.internal.core.streams;1;0;2;1;2;1;2;0;0;0;0;4169;0;0;2;0;1;0;2;4169;1;4169;1;1;
org.eclipse.jdt.internal.compiler;2;0;18;1;1;1;1;17;38826;4;10;455;65771;34;4;7;0;17;18;868;7;4062;11;2;
org.eclipse.help.standalone;0;0;3;0;1;1;1;2;196;1;2;3270;198;0;1;0;0;2;3;3270;0;4427;3;0;
org.eclipse.jdt.internal.codeassist;0;0;11;0;1;1;1;10;13872;4;6;455;21032;0;4;4;0;10;11;1039;4;4062;7;0;
org.eclipse.swt.internal.carbon;0;2;4;0;4;3;4;0;109;0;0;4147;145;0;2;0;1;0;4;4147;1;4701;3;0;
org.eclipse.jdt.internal.corext.template;1;0;3;1;0;0;0;3;9;2;2;2784;9;0;2;1;0;3;3;2784;1;2932;2;1;
org.eclipse.jdt.internal.compiler.batch;0;0;19;0;1;1;1;18;1139;4;11;455;2342;0;4;7;0;18;19;1039;7;4061;12;0;
org.eclipse.webdav.internal.kernel;2;0;6;1;1;1;1;5;9444;2;4;12;15488;415;2;1;0;5;6;12;1;4211;5;2;
org.eclipse.core.resources;2;0;8;1;1;1;1;7;495;2;6;12;825;179;2;1;0;7;8;12;1;4214;7;2;
org.eclipse.update.internal.ui.model;1;0;3;1;0;0;0;3;41;2;2;2797;41;16;2;1;0;3;3;2797;1;2994;2;1;
org.eclipse.debug.internal.ui.views.breakpoints;0;2;4;0;4;3;4;0;278;0;0;3975;291;0;2;0;1;0;4;3975;1;4423;3;0;
com.sun.jdi;2;0;3;1;0;0;0;3;600;2;2;2704;600;103;2;1;0;3;3;2704;1;3033;2;2;
org.eclipse.core.runtime.model;0;0;6;0;1;1;1;5;3726;2;4;12;4468;0;2;1;0;5;6;12;1;4214;5;0;
org.eclipse.swt.internal.motif;2;0;3;1;1;1;1;2;186;0;1;2069;186;36;2;1;0;2;3;2069;1;4701;2;2;
org.eclipse.pde.ui;0;0;3;0;1;1;1;2;97;0;1;3579;97;0;2;1;0;2;3;3579;1;4752;2;0;
org.eclipse.help.internal.toc;1;0;3;1;0;0;0;3;14;2;2;1857;14;38;2;1;0;3;3;1857;1;3609;2;2;
org.eclipse.ant.internal.core;0;2;12;0;4;3;4;8;508;3;5;3365;894;0;3;3;1;8;12;3489;4;4404;8;0;
org.eclipse.swt.internal.ole.win32;2;0;4;1;1;1;1;3;294;1;3;106;298;24;1;0;0;3;4;106;0;4701;4;2;
org.eclipse.tomcat.internal;0;0;4;0;1;1;1;3;36;2;2;3285;40;0;2;1;0;3;4;3285;1;4435;3;0;
org.eclipse.core.resources.ant;2;0;5;1;1;1;1;4;51;2;3;3509;126;109;2;1;0;4;5;3509;1;4214;4;2;
org.eclipse.team.internal.ftp.target;0;4;10;0;10;6;10;0;197;0;0;4241;583;0;4;0;4;0;10;4241;4;4636;6;0;
org.eclipse.update.internal.ui;0;1;31;0;10;10;10;21;163;2;20;1428;521;0;2;1;0;21;31;2172;1;4772;30;0;
org.eclipse.swt.events;2;0;4;1;1;1;1;3;246;2;2;106;427;58;2;1;0;3;4;106;1;4701;3;4;
org.eclipse.ui.model;0;0;3;0;0;0;0;3;86;2;2;257;86;0;2;1;0;3;3;257;1;457;2;0;
org.eclipse.help.ui.internal.browser.linux;0;0;3;0;1;1;1;2;17;1;2;2429;21;0;1;0;0;2;3;2429;0;4439;3;0;
org.eclipse.help.internal.context;0;0;10;0;0;0;0;10;150;1;10;1675;347;0;1;0;0;10;10;1675;0;3609;10;0;
org.eclipse.jdt.internal.core.eval;0;2;10;0;3;2;3;7;610;2;6;455;808;0;2;1;1;7;10;455;2;4063;8;0;
org.eclipse.help.ui.internal.search;0;0;7;0;1;1;1;6;313;2;4;2429;337;0;2;2;0;6;7;2429;2;4439;5;0;
org.eclipse.jdi.hcr;0;0;3;0;0;0;0;3;60;2;2;187;60;0;2;1;0;3;3;187;1;366;2;0;
org.eclipse.debug.internal.ui.views;0;0;11;0;1;1;1;10;62;1;10;2328;130;0;1;0;0;10;11;2328;0;3975;11;0;
org.eclipse.jdt.internal.core.search.processing;0;0;7;0;1;1;1;6;33;1;6;455;86;0;1;0;0;6;7;455;0;4063;7;0;
org.eclipse.jface.text.contentassist;3;0;4;1;0;0;0;4;1437;2;3;257;1502;73;2;1;0;4;4;257;1;1066;3;4;
org.eclipse.team.internal.ftp;0;1;3;0;3;3;3;0;11;0;0;4169;15;0;1;0;0;0;3;4169;0;4327;3;0;
org.eclipse.pde.internal.ui.wizards.templates;1;0;3;1;0;0;0;3;408;2;2;3579;408;17;2;1;0;3;3;3579;1;3840;2;1;
org.eclipse.pde.internal.ui.util;1;0;2;1;0;0;0;2;0;0;1;3579;0;0;2;1;0;2;2;3579;1;3579;1;1;
org.eclipse.jdt.internal.corext.refactoring.code.flow;1;0;4;1;0;0;0;4;1501;2;3;1939;1946;33;2;1;0;4;4;1939;1;3106;3;1;
org.eclipse.pde.internal.ui.editor.build;0;0;2;0;0;0;0;2;0;0;1;3579;0;0;2;1;0;2;2;3579;1;3579;1;0;
org.eclipse.pde.internal.ui.codegen;0;0;3;0;0;0;0;3;2;2;2;3579;2;0;2;1;0;3;3;3579;1;3591;2;0;
org.eclipse.ui.internal.model;2;0;3;1;0;0;0;3;87;2;2;257;87;179;2;1;0;3;3;257;1;457;2;5;
org.eclipse.jdt.internal.debug.ui.snippeteditor;1;2;14;1;4;3;4;10;128;2;8;1915;420;0;2;2;1;10;14;1915;3;4402;11;2;
org.eclipse.core.internal.resources;2;0;12;1;1;1;1;11;22793;2;10;12;27302;369;2;1;0;11;12;12;1;4213;11;2;
org.eclipse.jface.util;2;0;4;1;0;0;0;4;196;2;3;257;216;5;2;1;0;4;4;257;1;3642;3;2;
org.eclipse.debug.internal.ui.views.expression;0;2;5;0;5;4;5;0;388;0;0;3975;405;0;2;0;1;0;5;3975;1;4327;4;0;
org.eclipse.jdt.internal.compiler.impl;2;0;13;1;1;1;1;12;5538;4;7;455;13088;150;4;5;0;12;13;1039;5;4062;8;2;
org.eclipse.swt.widgets;3;1;15;1;2;2;2;13;17450;2;12;106;22427;434;2;1;0;13;15;106;1;4701;14;9;
org.eclipse.webdav.internal.authentication;0;1;7;0;2;2;2;5;3416;2;4;12;6028;0;2;1;0;5;7;12;1;4266;6;0;
org.eclipse.jdt.internal.corext.dom;0;0;4;0;0;0;0;4;36;2;3;2876;48;0;2;1;0;4;4;2876;1;3585;3;0;
org.eclipse.ui.externaltools.internal.core;1;2;4;1;4;3;4;0;38;0;0;4090;62;98;2;0;1;0;4;4090;1;4729;3;2;
org.eclipse.ui.views.navigator;3;2;23;1;3;2;3;20;2227;2;16;257;5032;10;2;4;1;20;23;257;5;4067;18;3;
org.eclipse.jface.dialogs;2;0;5;1;0;0;0;5;97;2;4;257;122;78;2;1;0;5;5;257;1;1155;4;5;
org.eclipse.team.internal.ui.actions;0;0;2;0;2;1;2;0;0;0;0;4020;0;0;2;0;1;0;2;4020;1;4020;1;0;
org.eclipse.jdt.internal.ui.reorg;2;1;32;1;3;3;3;29;586;2;26;132;1416;118;2;3;0;29;32;1338;3;4621;29;3;
org.eclipse.team.internal.ccvs.ssh;1;0;4;1;0;0;0;4;2552;2;3;1978;3902;2456;2;1;0;4;4;1978;1;3102;3;1;
org.eclipse.core.internal.runtime;2;1;9;1;3;3;3;6;5366;2;5;12;5883;232;2;1;0;6;9;12;1;4266;8;4;
org.eclipse.update.core.model;2;0;12;1;0;0;0;12;2342;2;9;2409;3514;602;2;3;0;12;12;2409;3;3796;9;2;
org.eclipse.jface.text.rules;3;0;4;1;0;0;0;4;714;2;3;257;820;107;2;1;0;4;4;257;1;1066;3;4;
org.eclipse.jdt.internal.corext.refactoring.changes;0;0;4;0;0;0;0;4;81;2;3;1939;93;98;2;1;0;4;4;1939;1;3646;3;1;
org.eclipse.pde.core.build;0;0;4;0;2;1;2;2;150;0;1;3591;150;0;2;1;1;2;4;3591;2;4751;2;0;
org.eclipse.jdt.internal.ui.text;0;0;10;0;0;0;0;10;159;2;7;15;483;0;2;3;0;10;10;15;3;3873;7;0;
org.eclipse.webdav.internal.kernel.utils;0;0;5;0;1;1;1;4;1460;2;3;12;1716;0;2;1;0;4;5;12;1;4211;4;0;
org.eclipse.jdt.internal.ui.viewsupport;1;0;10;1;0;0;0;10;192;2;8;15;408;39;2;2;0;10;10;15;2;2016;8;3;
org.eclipse.jdt.internal.compiler.codegen;0;1;18;0;3;3;3;15;18168;4;11;455;24819;0;4;4;0;15;18;1039;4;4421;14;0;
org.eclipse.jdt.internal.ui.util;2;0;8;1;0;0;0;8;260;2;7;15;533;264;2;1;0;8;8;15;1;2935;7;4;
org.eclipse.jdt.internal.corext.refactoring.sef;0;0;6;0;0;0;0;6;282;2;4;1939;403;0;2;2;0;6;6;1939;2;3150;4;0;
org.eclipse.debug.internal.ui.actions;1;0;10;1;0;0;0;10;562;2;8;2382;935;227;2;2;0;10;10;2382;2;3730;8;4;
org.eclipse.pde.internal.ui;0;1;11;0;4;4;4;7;208;3;5;3579;365;0;3;2;0;7;11;3579;2;4588;9;0;
org.eclipse.ant.core;0;1;8;0;4;4;4;4;120;2;3;3387;231;0;2;1;0;4;8;3575;1;4572;7;0;
org.eclipse.jdi.internal.request;4;1;11;1;2;2;2;9;314;2;7;187;859;35;2;2;0;9;11;187;2;4630;9;4;
org.eclipse.jface.text.source;4;0;7;1;1;1;1;6;921;2;5;257;1675;653;2;1;0;6;7;257;1;4838;6;6;
org.eclipse.jdt.internal.ui.javaeditor;2;1;16;1;2;2;2;14;551;3;10;15;2391;239;3;4;0;14;16;3101;4;4213;12;7;
org.eclipse.team.internal.ui.target;1;2;10;1;10;7;10;0;352;0;0;4149;946;12;2;0;3;0;10;4149;3;4636;7;3;
org.eclipse.jdt.internal.corext.javadoc;0;0;3;0;1;1;1;2;6;0;1;2495;6;0;2;1;0;2;3;2495;1;4400;2;0;
org.eclipse.ui.internal.registry;3;0;7;1;0;0;0;7;551;2;6;257;1340;1049;2;1;0;7;7;257;1;3270;6;5;
org.eclipse.team.internal.ccvs.ui.actions;2;1;20;1;2;2;2;18;528;2;15;1978;1897;163;2;3;0;18;20;1978;3;4021;17;3;
org.eclipse.debug.internal.ui.launchConfigurations;0;3;117;0;27;19;27;90;743;4;50;2161;7611;0;4;40;8;90;117;2161;48;4630;69;0;
org.eclipse.jdt.internal.core.search.indexing;2;1;20;1;2;2;2;18;4057;4;14;455;5975;123;4;4;0;18;20;1039;4;4063;16;3;
org.eclipse.jdt.internal.ui.compare;3;1;16;1;3;3;3;13;474;2;10;15;1830;391;2;3;0;13;16;15;3;4621;13;3;
org.eclipse.jdt.internal.ui.search;0;0;17;0;1;1;1;16;121;2;13;15;599;0;2;3;0;16;17;15;3;4627;14;1;
org.eclipse.swt.layout;0;1;8;0;2;2;2;6;255;2;4;106;447;0;2;2;0;6;8;106;2;4701;6;0;
org.eclipse.pde.core;0;0;4;0;2;1;2;2;326;0;1;3591;326;0;2;1;1;2;4;3591;2;4751;2;0;
org.eclipse.update.internal.ui.pages;0;0;3;0;0;0;0;3;33;2;2;3537;33;0;2;1;0;3;3;3537;1;3662;2;1;
org.eclipse.swt.dnd;2;1;5;1;2;2;2;3;1090;2;2;106;1900;773;2;1;0;3;5;106;1;4701;4;4;
org.eclipse.jdt.internal.debug.core.breakpoints;0;0;7;0;1;1;1;6;746;3;4;2517;1339;0;3;2;0;6;7;2517;2;4768;5;0;
org.eclipse.jdt.core.compiler;0;2;16;0;3;2;3;13;527;7;6;3071;1040;0;7;7;1;13;16;3080;8;4419;8;0;
org.eclipse.jdt.internal.corext.refactoring.base;2;1;6;1;3;3;3;3;62;2;2;1939;130;86;2;1;0;3;6;1939;1;4189;5;3;
org.eclipse.jdt.internal.debug.eval;0;0;4;0;0;0;0;4;15;1;4;1675;30;0;1;0;0;4;4;1675;0;3677;4;0;
org.eclipse.core.internal.watson;1;0;5;1;1;1;1;4;4448;2;3;12;4823;373;2;1;0;4;5;12;1;4214;4;1;
org.eclipse.jdt.internal.corext.util;0;1;11;0;2;2;2;9;431;2;7;1930;555;0;2;2;0;9;11;3827;2;4602;9;0;
org.eclipse.jface.text;4;0;5;1;1;1;1;4;6211;2;3;257;6622;1654;2;1;0;4;5;257;1;4377;4;4;
org.eclipse.jdt.internal.ui.workingsets;0;0;3;0;1;1;1;2;5;0;1;3834;5;0;2;1;0;2;3;3834;1;4466;2;0;
org.eclipse.core.runtime;4;1;7;1;2;2;2;5;10244;2;4;12;11024;456;2;1;0;5;7;12;1;4552;6;5;
org.eclipse.swt.internal;2;1;18;1;2;2;2;16;120;2;14;106;358;17;2;2;0;16;18;106;2;4701;16;2;
org.eclipse.jdt.ui;3;1;20;1;2;2;2;18;1144;2;16;15;1555;204;2;2;0;18;20;15;2;4810;18;4;
org.eclipse.compare;1;0;7;1;0;0;0;7;256;2;5;14;420;10;2;2;0;7;7;14;2;329;5;1;
org.eclipse.ui.externaltools.internal.ui;1;2;3;1;3;2;3;0;13;0;0;4090;13;84;2;0;1;0;3;4090;1;4123;2;2;
org.eclipse.jdt.debug.eval;0;0;13;0;1;1;1;12;372;2;11;1675;679;0;2;1;0;12;13;1675;1;4423;12;0;
org.eclipse.ui.views.framelist;2;0;3;1;1;1;1;2;10;0;1;3498;10;4;2;1;0;2;3;3498;1;4609;2;2;
org.eclipse.jdt.internal.compiler.flow;0;0;14;0;1;1;1;13;1812;4;9;455;3754;0;4;4;0;13;14;1039;4;4062;10;0;
org.eclipse.jdt.core.util;2;1;6;1;4;4;4;2;436;0;1;3629;832;41;2;1;0;2;6;3629;1;4573;5;2;
org.eclipse.pde.internal.ui.wizards.project;0;0;3;0;0;0;0;3;42;2;2;3579;42;0;2;1;0;3;3;3579;1;3607;2;0;
org.eclipse.pde.internal.core;1;0;2;1;0;0;0;2;0;0;1;3591;0;0;2;1;0;2;2;3591;1;3591;1;1;
org.eclipse.ui.views.tasklist;4;0;10;1;1;1;1;9;617;2;8;257;1121;63;2;1;0;9;10;257;1;4269;9;5;
org.eclipse.ui.help;0;0;6;0;0;0;0;6;24;2;5;257;46;0;2;1;0;6;6;257;1;3156;5;0;
org.eclipse.ui.wizards.datatransfer;0;0;3;0;0;0;0;3;1022;2;2;257;1022;4;2;1;0;3;3;257;1;457;2;1;
org.eclipse.jdt.internal.junit.runner;0;0;4;0;1;1;1;3;30;2;2;3171;32;0;2;1;0;3;4;3171;1;4341;3;0;
org.eclipse.jdt.internal.ui.wizards.buildpaths;3;0;15;1;1;1;1;14;494;3;9;15;1768;46;3;5;0;14;15;218;5;4083;10;5;
org.eclipse.jdt.internal.corext;1;0;3;1;1;1;1;2;4;0;1;2327;4;6;2;1;0;2;3;2327;1;4400;2;2;
org.eclipse.help.ui.internal;0;0;2;0;2;1;2;0;0;0;0;4439;0;0;2;0;1;0;2;4439;1;4439;1;0;
org.eclipse.update.internal.ui.parts;1;0;4;1;1;1;1;3;0;2;2;1460;0;0;2;1;0;3;4;1460;1;4108;3;1;
org.eclipse.update.internal.ui.win32.views;1;2;3;1;3;2;3;0;71;0;0;4127;71;0;2;0;1;0;3;4127;1;4217;2;1;
org.eclipse.jface.viewers;3;0;4;1;0;0;0;4;779;2;3;257;853;216;2;1;0;4;4;257;1;620;3;4;
org.eclipse.jdt.launching.sourcelookup;0;2;8;0;4;3;4;4;541;3;2;2372;814;0;3;2;1;4;8;2372;3;4406;5;0;
org.eclipse.update.internal.ui.forms;2;1;5;1;2;2;2;3;115;2;2;3662;174;144;2;1;0;3;5;3662;1;4610;4;2;
org.eclipse.jdt.internal.debug.ui.launcher;1;0;3;1;1;1;1;2;9;0;1;1915;9;14;2;1;0;2;3;1915;1;4423;2;2;
org.eclipse.jdt.internal.ui.refactoring.nls;0;0;4;0;1;1;1;3;102;0;1;1922;175;0;3;2;0;3;4;1922;2;4043;2;0;
org.eclipse.ui.texteditor;3;0;5;1;0;0;0;5;5132;2;4;257;6641;1517;2;1;0;5;5;257;1;1320;4;5;
org.eclipse.help.servlet;1;1;11;1;2;2;2;9;143;3;7;2409;575;15;3;2;0;9;11;2409;2;4630;9;2;
org.eclipse.pde.internal.runtime;0;0;3;0;1;1;1;2;73;0;1;1434;73;0;2;1;0;2;3;1434;1;4425;2;0;
org.eclipse.team.internal.ccvs.core.connection;0;0;8;0;1;1;1;7;355;2;5;1978;538;0;2;2;0;7;8;1978;2;4169;6;0;
org.eclipse.jdt.internal.codeassist.impl;0;0;16;0;1;1;1;15;1776;4;11;455;2091;0;4;4;0;15;16;1039;4;4062;12;0;
org.eclipse.ui.internal.dialogs;4;0;19;1;1;1;1;18;819;2;15;257;1612;599;2;3;0;18;19;257;3;4082;16;7;
org.eclipse.jdt.ui.text;0;0;7;0;1;1;1;6;81;2;5;15;168;0;2;1;0;6;7;15;1;4810;6;0;
org.eclipse.update.internal.ui.preferences;0;1;6;0;5;5;5;1;55;0;1;3572;101;0;1;0;0;1;6;3572;0;4610;6;0;
org.eclipse.jdt.internal.ui.text.javadoc;0;0;6;0;0;0;0;6;19;2;5;15;47;0;2;1;0;6;6;15;1;770;5;0;
org.eclipse.jdt.internal.debug.ui.actions;1;1;19;1;2;2;2;17;161;2;13;1915;546;27;2;4;0;17;19;1915;4;4410;15;2;
org.eclipse.update.configuration;2;0;6;1;1;1;1;5;589;2;4;2994;888;405;2;1;0;5;6;2994;1;4687;5;2;
org.eclipse.ui.externaltools.internal.ui.ant;0;1;3;0;3;3;3;0;43;0;0;4124;63;0;1;0;0;0;3;4124;0;4367;3;0;
org.eclipse.team.internal.ccvs.ui.model;3;0;7;1;0;0;0;7;491;2;6;1978;990;129;2;1;0;7;7;1978;1;3610;6;3;
org.eclipse.webdav.internal.utils;0;1;7;0;3;3;3;4;280;1;4;12;635;0;1;0;0;4;7;12;0;4651;7;0;
org.eclipse.jdt.internal.codeassist.complete;2;0;10;1;1;1;1;9;3841;4;5;455;4966;131;4;4;0;9;10;1039;4;4062;6;2;
org.eclipse.swt.internal.gtk;2;2;8;1;3;2;3;5;1595;2;4;2107;1985;9;2;1;1;5;8;2107;2;4701;6;2;
org.eclipse.team.internal.core.target;2;2;6;1;6;4;6;0;998;0;0;4010;1078;238;2;0;2;0;6;4010;2;4636;4;3;
org.eclipse.jdt.internal.core.index.impl;2;1;11;1;2;2;2;9;2949;4;5;455;4081;320;4;4;0;9;11;1039;4;4063;7;2;
org.eclipse.jdt.internal.core;2;0;11;1;1;1;1;10;30149;4;6;455;58020;2124;4;4;0;10;11;1039;4;4063;7;3;
org.eclipse.pde.internal.ui.wizards;1;0;2;1;0;0;0;2;0;0;1;3579;0;0;2;1;0;2;2;3579;1;3579;1;1;
org.eclipse.jdt.internal.compiler.ast;2;1;12;1;3;3;3;9;29828;2;8;455;47885;356;2;1;0;9;12;455;1;4421;11;2;
org.eclipse.jdt.ui.actions;1;2;14;1;7;6;7;7;1219;2;5;3533;2538;306;2;2;1;7;14;3533;3;4770;11;3;
org.eclipse.update.ui.forms.internal;1;0;2;1;0;0;0;2;0;0;1;2470;0;323;2;1;0;2;2;2470;1;2470;1;1;
org.eclipse.debug.internal.ui.views.variables;0;2;3;0;3;2;3;0;2432;0;0;3975;2432;0;2;0;1;0;3;3975;1;4003;2;0;
org.eclipse.jdi.internal.jdwp;2;0;5;1;0;0;0;5;183;2;4;187;254;13;2;1;0;5;5;187;1;3040;4;2;
com.sun.jdi.request;2;0;3;1;0;0;0;3;189;2;2;2704;189;26;2;1;0;3;3;2704;1;3040;2;2;
org.eclipse.jdt.internal.debug.ui.display;0;0;16;0;1;1;1;15;214;2;13;1915;555;0;2;2;0;15;16;1915;2;4007;14;0;
org.eclipse.team.internal.ccvs.core.client.listeners;0;0;7;0;0;0;0;7;459;2;6;2572;536;0;2;1;0;7;7;2572;1;3610;6;0;
org.eclipse.jdt.debug.ui;0;2;7;0;3;2;3;4;37;1;4;2813;75;0;2;0;1;4;7;3959;1;4659;6;0;
org.eclipse.jdt.internal.corext.refactoring.code;1;1;25;1;4;4;4;21;605;2;18;1939;2140;1011;2;3;0;21;25;1939;3;4427;22;2;
org.eclipse.team.internal.ccvs.core.syncinfo;0;0;11;0;0;0;0;11;103;1;11;2690;161;0;1;0;0;11;11;2690;0;3610;11;0;
org.eclipse.jdt.ui.jarpackager;2;1;14;1;4;4;4;10;907;3;6;3529;1269;47;3;4;0;10;14;3529;4;4852;10;2;
org.eclipse.help.ui.internal.browser;1;1;6;1;2;2;2;4;9;2;3;2429;21;2;2;1;0;4;6;2429;1;4439;5;1;
org.eclipse.jdt.internal.corext.refactoring.reorg;0;1;17;0;2;2;2;15;283;2;14;1939;999;0;2;1;0;15;17;1939;1;4212;16;0;
org.eclipse.team.internal.ccvs.ui.sync;0;2;20;0;5;4;5;15;594;3;13;2231;1278;0;3;2;1;15;20;2231;3;4455;17;0;
org.eclipse.jdt.debug.ui.launchConfigurations;3;6;13;2;13;7;13;0;153;0;0;4098;343;299;6;0;6;0;13;4214;6;4409;7;3;
org.eclipse.jdi.internal;3;0;13;2;0;0;0;13;685;2;11;187;1992;395;2;2;0;13;13;187;2;3670;11;3;
org.eclipse.ui.views.contentoutline;0;0;8;0;0;0;0;8;69;2;7;257;100;0;2;1;0;8;8;257;1;2641;7;0;
org.eclipse.jdt.internal.ui.text.template;0;0;7;0;0;0;0;7;379;2;6;1469;723;0;2;1;0;7;7;1469;1;3589;6;0;
org.eclipse.jdt.internal.core.search.matching;2;1;7;1;2;2;2;5;9692;2;4;455;11388;702;2;1;0;5;7;455;1;4165;6;3;
org.eclipse.help.ui.browser;0;0;5;0;0;0;0;5;10;2;4;2429;20;0;2;1;0;5;5;2429;1;3609;4;0;
org.eclipse.jdt.internal.debug.ui;0;0;7;0;0;0;0;7;30;2;6;1915;83;0;2;1;0;7;7;1915;1;3852;6;1;
org.eclipse.jdt.internal.ui;1;2;31;1;5;4;5;26;162;2;21;15;567;134;2;5;1;26;31;15;6;4641;25;5;
org.eclipse.jdt.internal.debug.eval.ast.instructions;3;0;7;1;0;0;0;7;1104;2;5;3421;1843;51;2;2;0;7;7;3421;2;3670;5;3;
org.eclipse.pde.internal;0;0;2;0;0;0;0;2;0;0;1;3631;0;0;2;1;0;2;2;3631;1;3631;1;0;
org.eclipse.jdt.internal.debug.core.hcr;2;0;5;1;0;0;0;5;365;3;3;2517;435;37;3;2;0;5;5;2517;2;2683;3;2;
org.eclipse.jface.resource;2;0;6;1;0;0;0;6;49;2;5;257;106;15;2;1;0;6;6;257;1;3607;5;2;
org.eclipse.jdt.internal.ui.dialogs;2;0;6;1;0;0;0;6;122;2;5;15;241;467;2;1;0;6;6;15;1;1272;5;8;
org.eclipse.ui.part;4;0;6;1;0;0;0;6;236;2;5;257;438;226;2;1;0;6;6;257;1;1779;5;6;
org.eclipse.pde.internal.ui.wizards.imports;0;2;15;0;10;8;10;5;339;2;3;3579;692;0;2;2;2;5;15;3579;4;4568;11;0;
org.eclipse.pde.internal.core.build;1;0;3;1;1;1;1;2;10;0;1;3591;10;0;2;1;0;2;3;3591;1;4568;2;1;
org.eclipse.core.internal.utils;0;0;5;0;1;1;1;4;2142;2;3;12;2461;0;2;1;0;4;5;12;1;4214;4;0;
org.eclipse.update.internal.ui.views;2;2;17;1;8;7;8;9;504;2;6;3537;809;677;2;3;1;9;17;3537;4;4771;13;2;
org.eclipse.update.internal.core;0;2;16;0;3;2;3;13;504;3;11;1428;2892;80;3;2;1;13;16;1638;3;4408;13;2;
org.eclipse.pde.internal.ui.elements;1;0;2;1;0;0;0;2;0;0;1;3579;0;0;2;1;0;2;2;3579;1;3579;1;1;
org.eclipse.jface.preference;2;0;6;1;1;1;1;5;124;2;4;257;144;194;2;1;0;5;6;257;1;4449;5;4;
org.eclipse.jdt.launching;1;2;11;1;7;6;7;4;158;2;3;2022;506;855;2;1;1;4;11;2022;2;4650;9;3;
org.eclipse.jdt.internal.corext.codemanipulation;2;0;10;1;0;0;0;10;158;2;7;1937;305;628;2;3;0;10;10;1955;3;2232;7;4;
org.eclipse.jdt.ui.wizards;0;1;25;0;5;5;5;20;527;3;17;15;957;0;3;3;0;20;25;1272;3;4852;22;0;
org.eclipse.help.internal.protocols;2;0;7;1;0;0;0;7;39;3;5;2694;80;123;3;2;0;7;7;2694;2;3776;5;2;
org.eclipse.team.core;2;0;3;1;1;1;1;2;293;1;2;2864;295;19;1;0;0;2;3;2864;0;4571;3;2;
org.eclipse.team.internal.ftp.client;1;2;3;1;3;2;3;0;2;0;0;4169;2;0;2;0;1;0;3;4169;1;4285;2;1;
org.eclipse.jdt.internal.corext.refactoring.rename;1;0;8;1;0;0;0;8;306;2;7;1939;753;164;2;1;0;8;8;1939;1;3678;7;1;
org.eclipse.core.internal.dtree;0;0;5;0;1;1;1;4;6930;2;3;12;11451;0;2;1;0;4;5;12;1;4214;4;0;
org.eclipse.jdt.internal.ui.refactoring.actions;0;1;20;0;5;5;5;15;222;2;13;1258;654;0;2;2;0;15;20;1342;2;4563;18;0;
org.eclipse.webdav.client;3;0;6;1;1;1;1;5;8058;2;4;12;14819;1080;2;1;0;5;6;12;1;4211;5;3;
org.eclipse.jdt.internal.ui.text.java.hover;0;0;13;0;1;1;1;12;220;2;11;15;386;0;2;1;0;12;13;3166;1;4167;12;0;
org.eclipse.jface.wizard;0;0;5;0;0;0;0;5;78;2;4;257;124;0;2;1;0;5;5;257;1;2325;4;0;
org.eclipse.team.internal.ftp.ui;0;2;5;0;5;4;5;0;19;0;0;4250;34;0;2;0;1;0;5;4628;1;4628;4;0;
org.eclipse.search.internal.core;0;0;3;0;0;0;0;3;9;1;3;15;17;0;1;0;0;3;3;15;0;1434;3;0;
org.eclipse.pde.internal.runtime.logview;0;0;3;0;0;0;0;3;61;2;2;1434;61;0;2;1;0;3;3;1434;1;3877;2;1;
org.eclipse.jdt.internal.debug.core.model;3;0;7;2;1;1;1;6;163;4;3;2517;244;186;4;3;0;6;7;2517;3;4423;4;3;
org.eclipse.ant.internal.core.ant;0;2;20;0;12;9;12;8;802;3;4;3489;1166;0;3;4;3;8;20;3489;7;4631;13;0;
org.eclipse.pde.internal.ui.editor.feature;1;1;9;1;3;3;3;6;355;3;4;3579;970;0;3;2;0;6;9;3579;2;4592;7;1;
org.eclipse.pde.internal.build;0;2;70;0;22;18;22;48;3817;3;37;245;11695;0;3;11;4;48;70;256;15;4438;55;0;
org.eclipse.compare.internal.patch;1;0;3;1;1;1;1;2;16;0;1;2876;16;39;2;1;0;2;3;2876;1;4570;2;2;
org.eclipse.jdt.internal.ui.refactoring.code;0;1;16;0;2;2;2;14;123;3;11;15;230;0;3;3;0;14;16;192;3;4146;13;0;
org.eclipse.debug.internal.ui.views.console;0;2;6;0;6;5;6;0;2451;0;0;3975;2478;0;2;0;1;0;6;3975;1;4568;5;0;
org.eclipse.swt.internal.image;2;0;4;1;1;1;1;3;256;2;2;106;460;58;2;1;0;3;4;106;1;4701;3;2;
org.eclipse.core.boot;0;1;16;0;4;4;4;12;1722;2;11;12;2538;0;2;1;0;12;16;2802;1;4705;15;0;
org.eclipse.pde.internal.ui.feature;0;0;2;0;0;0;0;2;0;0;1;3579;0;0;2;1;0;2;2;3579;1;3579;1;0;
org.eclipse.team.internal.webdav.ui;0;3;17;0;17;10;17;0;132;0;0;4073;303;0;3;0;7;0;17;4149;7;4628;10;0;
org.eclipse.jdt.internal.core.search;2;1;7;1;2;2;2;5;1870;2;4;455;2213;20;2;1;0;5;7;455;1;4063;6;2;
org.eclipse.jdt.debug.core;1;0;14;1;1;1;1;13;186;3;11;187;740;54;3;2;0;13;14;187;2;4423;12;1;
org.eclipse.jdt.internal.ui.refactoring;0;1;9;0;3;3;3;6;124;2;5;15;228;40;2;1;0;6;9;15;1;4076;8;3;
org.eclipse.swt.accessibility;0;0;6;0;1;1;1;5;392;2;3;2781;568;0;2;2;0;5;6;2781;2;4701;4;0;
org.eclipse.jdt.internal.ui.wizards;1;0;12;1;1;1;1;11;215;2;7;15;472;32;2;4;0;11;12;15;4;4450;8;3;
org.eclipse.jdt.internal.ui.refactoring.changes;0;0;4;0;0;0;0;4;6;1;4;157;10;0;1;0;0;4;4;157;0;1939;4;0;
org.eclipse.debug.core;2;1;34;1;3;3;3;31;306;3;23;187;1982;210;3;8;0;31;34;1725;8;4650;26;3;
org.eclipse.jdt.internal.corext.refactoring.surround;0;2;10;0;4;3;4;6;188;2;5;2327;279;0;2;1;1;6;10;2327;2;4421;8;0;
org.eclipse.jdt.internal.ui.actions;0;1;18;0;2;2;2;16;69;2;15;15;405;0;2;1;0;16;18;15;1;4648;17;1;
org.eclipse.core.internal.properties;3;1;10;1;2;2;2;8;1946;2;7;12;2492;544;2;1;0;8;10;12;1;4632;9;3;
org.eclipse.jdt.internal.formatter.impl;0;0;15;0;1;1;1;14;588;4;9;455;1572;0;4;5;0;14;15;1039;5;4062;10;0;
org.eclipse.update.internal.ui.properties;1;0;2;1;0;0;0;2;0;0;1;3537;0;0;2;1;0;2;2;3537;1;3537;1;1;
org.eclipse.ui.views.properties;2;0;3;1;0;0;0;3;267;2;2;257;267;75;2;1;0;3;3;257;1;457;2;4;
org.eclipse.team.internal.ccvs.core;0;1;19;0;2;2;2;17;4136;2;15;1978;7156;0;2;2;0;17;19;1978;2;4111;17;0;
org.eclipse.jdt.internal.ui.jarpackager;0;0;35;0;0;0;0;35;729;3;24;239;4290;0;3;11;0;35;35;239;11;3529;24;0;
org.eclipse.pde.ui.templates;0;0;5;0;1;1;1;4;1095;2;3;3819;1527;0;2;1;0;4;5;3819;1;4752;4;0;
org.eclipse.pde.internal.ui.wizards.extension;0;0;5;0;1;1;1;4;79;2;3;3579;87;0;2;1;0;4;5;3579;1;4551;4;0;
org.eclipse.core.internal.events;1;0;5;1;1;1;1;4;4784;2;3;12;5163;212;2;1;0;4;5;12;1;4214;4;2;
org.eclipse.jdt.internal.ui.text.java;0;0;4;0;0;0;0;4;58;2;3;15;67;0;2;1;0;4;4;15;1;770;3;0;
org.eclipse.jdt.internal.corext.refactoring.nls.changes;0;1;5;0;2;2;2;3;27;2;2;1939;54;0;2;1;0;3;5;1939;1;4598;4;0;
org.eclipse.jdt.internal.ui.javadocexport;0;0;6;0;0;0;0;6;1143;2;5;2878;2121;0;2;1;0;6;6;2878;1;3589;5;0;
org.eclipse.compare.rangedifferencer;0;0;3;0;0;0;0;3;20;2;2;14;20;0;2;1;0;3;3;14;1;329;2;0;
org.eclipse.search.internal.core.text;2;0;4;1;1;1;1;3;58;2;2;15;103;300;2;1;0;3;4;15;1;4034;3;3;
org.eclipse.jdt.internal.corext.textmanipulation;1;0;4;1;0;0;0;4;98;2;3;2137;122;157;2;1;0;4;4;2137;1;2327;3;1;
org.eclipse.jface.text.presentation;3;0;4;1;0;0;0;4;59;2;3;257;74;36;2;1;0;4;4;257;1;1066;3;3;
org.eclipse.jdt.internal.ui.dnd;0;0;4;0;1;1;1;3;38;2;2;15;40;0;2;1;0;3;4;15;1;4400;3;0;
org.eclipse.jdt.internal.compiler.parser;2;0;30;1;1;1;1;29;22598;4;24;455;46866;34;4;5;0;29;30;1039;5;4062;25;2;
