filename;TotalPeopleInBurst;MaximumChangeBurstLate;NumberOfChanges;MaxPeopleInBurst;TotalBurstSizeLate;NumberOfChangeBurstsLate;NumberOfChangesLate;NumberOfChangesEarly;MaxChurnInBurst;MaximumChangeBurstEarly;NumberOfChangeBurstsEarly;TimeFirstBurst;TotalChurnInBurst;ChurnTotal;MaximumChangeBurst;NumberOfConsecutiveChangesEarly;NumberOfConsecutiveChangesLate;TotalBurstSizeEarly;TotalBurstSize;TimeMaxBurst;NumberOfConsecutiveChanges;TimeLastBurst;NumberOfChangeBursts;PeopleTotal;
org.eclipse.jface.text.information;0;0;3;0;0;0;1;2;0;0;1;1435;0;0;2;1;0;2;2;1435;1;1435;1;0;
org.eclipse.team.ui;0;0;7;0;2;1;3;4;8;0;1;1978;8;0;2;1;1;2;4;1978;2;4632;2;0;
org.eclipse.pde.internal.ui.launcher;1;3;18;1;9;4;12;6;188;0;1;3579;247;0;3;1;5;2;11;4449;6;4635;5;1;
org.eclipse.ui.views.bookmarkexplorer;1;0;9;1;0;0;0;9;0;0;1;257;0;28;2;1;0;2;2;257;1;257;1;5;
org.eclipse.debug.internal.ui;1;0;32;1;0;0;1;31;176;5;2;187;176;31;5;5;0;7;7;2346;5;2346;2;4;
org.eclipse.pde.internal.core.schema;1;0;4;1;0;0;1;3;0;0;1;3591;0;53;2;1;0;2;2;3591;1;3591;1;1;
org.eclipse.swt.internal.photon;1;0;3;1;0;0;1;2;0;0;1;2069;0;66;2;1;0;2;2;2069;1;2069;1;2;
org.eclipse.jdt.internal.compiler.classfmt;1;0;20;1;0;0;1;19;1644;4;4;455;2675;287;4;7;0;11;11;1039;7;1224;4;2;
org.eclipse.jdt.internal.core.hierarchy;0;0;17;0;0;0;2;15;1999;4;3;455;2177;0;4;5;0;8;8;1039;5;1039;3;0;
org.eclipse.jdt.internal.ui.text.link;0;0;2;0;0;0;0;2;0;0;1;1720;0;0;2;1;0;2;2;1720;1;1720;1;0;
org.eclipse.jdt.internal.launching;0;0;21;0;3;1;11;10;200;0;1;2022;200;24;3;1;2;2;5;4210;3;4210;2;1;
org.eclipse.jdt.core.eval;0;0;6;0;2;1;3;3;54;0;1;455;54;0;2;1;1;2;4;455;2;4058;2;0;
org.eclipse.help.ui.internal.util;1;0;2;1;2;1;2;0;0;0;0;4439;0;0;2;0;1;0;2;4439;1;4439;1;1;
org.eclipse.jdt.internal.junit.util;0;0;2;0;0;0;0;2;0;0;0;-1;0;0;0;0;0;0;0;-1;0;-1;0;1;
org.eclipse.jdi;0;0;7;0;0;0;0;7;25;2;2;187;25;0;2;2;0;4;4;187;2;2720;2;0;
org.eclipse.jface.window;0;0;14;0;0;0;5;9;0;0;1;257;0;0;2;1;0;2;2;257;1;257;1;0;
org.eclipse.jface.text.reconciler;1;0;6;1;0;0;2;4;0;0;1;257;0;65;2;1;0;2;2;257;1;257;1;3;
org.eclipse.debug.ui;0;0;18;0;0;0;3;15;0;0;1;187;0;9;2;1;0;2;2;187;1;187;1;2;
org.eclipse.core.internal.localstore;2;0;15;1;0;0;1;14;309;3;2;12;309;99;3;3;0;5;5;327;3;327;2;2;
org.eclipse.jface.text.formatter;1;0;5;1;0;0;0;5;0;0;1;257;0;6;2;1;0;2;2;257;1;257;1;3;
org.eclipse.search.ui;1;0;4;1;0;0;0;4;0;0;1;15;0;10;2;1;0;2;2;15;1;15;1;2;
org.eclipse.jdt.internal.ui.browsing;3;5;81;1;22;9;32;49;246;4;14;2878;1562;86;5;19;13;33;55;4014;32;4626;23;3;
org.eclipse.jdt.internal.junit.wizards;0;0;2;0;0;0;0;2;0;0;1;3527;0;0;2;1;0;2;2;3527;1;3527;1;0;
org.eclipse.core.resources.team;0;0;5;0;0;0;0;5;863;0;1;3243;863;0;3;2;0;3;3;3243;2;3243;1;0;
org.eclipse.pde.internal.ui.editor.manifest;1;0;2;1;0;0;0;2;0;0;1;3579;0;46;2;1;0;2;2;3579;1;3579;1;1;
org.eclipse.team.internal.ccvs.ui;1;2;55;1;6;3;20;35;232;3;8;1978;1232;347;3;10;3;18;24;2737;13;4363;11;3;
org.eclipse.update.core;1;0;27;1;0;0;0;27;733;3;4;1423;1448;342;3;6;0;10;10;1423;6;3589;4;2;
org.eclipse.debug.internal.ui.views.launch;0;2;15;0;4;2;15;0;96;0;0;3975;96;0;2;0;2;0;4;3975;2;4400;2;0;
org.eclipse.update.internal.security;0;0;16;0;0;0;3;13;0;0;1;3122;0;0;2;1;0;2;2;3122;1;3122;1;0;
org.eclipse.core.internal.indexing;1;0;8;1;0;0;1;7;0;0;1;12;0;1914;2;1;0;2;2;12;1;12;1;4;
org.eclipse.core.internal.plugins;2;0;16;1;2;1;8;8;867;0;1;12;867;106;2;1;1;2;4;12;2;4212;2;3;
org.eclipse.compare.internal;1;0;4;1;0;0;0;4;0;0;1;14;0;25;2;1;0;2;2;14;1;14;1;2;
org.eclipse.swt.ole.win32;1;0;4;1;0;0;1;3;0;0;1;106;0;27;2;1;0;2;2;106;1;106;1;3;
org.eclipse.team.internal.ccvs.core.client;2;0;20;2;0;0;2;18;867;2;3;2572;1073;198;2;3;0;6;6;2572;3;3206;3;2;
org.eclipse.jdt.core;2;2;17;1;4;2;6;11;2387;4;2;455;2926;53;4;4;2;6;10;3872;6;4058;4;2;
org.eclipse.compare.structuremergeviewer;0;0;3;0;0;0;0;3;0;0;1;14;0;0;2;1;0;2;2;14;1;14;1;0;
org.eclipse.swt.graphics;1;0;6;1;0;0;2;4;0;0;1;106;0;145;2;1;0;2;2;106;1;106;1;6;
org.eclipse.search.internal.ui;1;0;13;1;0;0;4;9;8;2;2;15;8;42;2;2;0;4;4;15;2;675;2;2;
org.eclipse.pde.internal.ui.preferences;0;0;9;0;0;0;2;7;2;0;1;3579;2;0;3;2;0;3;3;3579;2;3579;1;0;
org.eclipse.compare.contentmergeviewer;1;0;3;1;0;0;0;3;0;0;1;14;0;5;2;1;0;2;2;14;1;14;1;1;
org.eclipse.jdt.internal.debug.eval.ast.engine;0;0;5;0;0;0;0;5;0;0;0;-1;0;0;0;0;0;0;0;-1;0;-1;0;1;
org.eclipse.search.internal.ui.util;1;0;6;1;0;0;0;6;0;0;1;15;0;31;2;1;0;2;2;15;1;15;1;2;
org.eclipse.pde.internal.ui.parts;1;0;2;1;0;0;0;2;0;0;1;3579;0;0;2;1;0;2;2;3579;1;3579;1;1;
org.eclipse.pde.internal.core.feature;0;0;3;0;0;0;1;2;0;0;1;3591;0;0;2;1;0;2;2;3591;1;3591;1;1;
org.eclipse.debug.internal.core;0;0;16;0;0;0;0;16;315;2;3;187;374;0;2;3;0;6;6;187;3;2366;3;0;
org.eclipse.swt.program;0;0;21;0;0;0;3;18;0;0;1;106;0;0;2;1;0;2;2;106;1;106;1;0;
org.eclipse.help.internal.util;1;0;3;1;0;0;0;3;0;0;1;1420;0;59;2;1;0;2;2;1420;1;1420;1;2;
org.eclipse.swt.printing;0;0;6;0;0;0;2;4;0;0;1;106;0;0;2;1;0;2;2;106;1;106;1;0;
org.eclipse.ui.actions;1;0;11;1;0;0;1;10;0;0;1;257;0;335;2;1;0;2;2;257;1;257;1;6;
org.eclipse.jdt.internal.corext.refactoring.tagging;1;0;2;1;0;0;0;2;0;0;1;1939;0;0;2;1;0;2;2;1939;1;1939;1;1;
org.eclipse.update.internal.ui.search;0;0;2;0;0;0;0;2;0;0;1;3537;0;37;2;1;0;2;2;3537;1;3537;1;1;
org.eclipse.debug.core.model;1;0;9;1;0;0;0;9;0;0;1;187;0;136;2;1;0;2;2;187;1;187;1;3;
org.eclipse.jdt.internal.codeassist.select;0;0;11;0;0;0;1;10;462;4;2;455;462;22;4;4;0;6;6;1039;4;1039;2;2;
org.eclipse.jdi.internal.event;1;0;5;1;0;0;0;5;0;0;1;187;0;64;2;1;0;2;2;187;1;187;1;2;
org.eclipse.help;0;0;9;0;0;0;1;8;0;0;1;1420;0;0;2;1;0;2;2;1420;1;1420;1;0;
org.eclipse.jdt.core.dom;1;0;8;1;2;1;3;5;865;0;1;2669;865;236;2;1;1;2;4;2669;2;4452;2;3;
org.eclipse.jdt.internal.eval;0;0;8;0;0;0;1;7;0;0;1;455;0;0;2;1;0;2;2;455;1;455;1;0;
org.eclipse.pde.internal.ui.editor.text;0;0;3;0;0;0;1;2;0;0;1;3579;0;0;2;1;0;2;2;3579;1;3579;1;1;
org.eclipse.jdt.internal.core.builder;3;2;17;2;4;2;8;9;580;2;2;2979;768;21;2;2;2;4;8;2979;4;4666;4;3;
org.eclipse.jdt.internal.debug.core;0;0;18;0;0;0;0;18;196;2;3;187;230;0;2;3;0;6;6;187;3;2223;3;0;
org.eclipse.update.internal.ui.wizards;1;2;42;1;4;2;9;33;255;2;3;1570;344;50;2;3;2;6;10;1570;5;4294;5;1;
org.eclipse.jdt.core.search;0;0;8;0;2;1;4;4;77;0;1;455;77;0;2;1;1;2;4;455;2;4058;2;0;
org.eclipse.ui.dialogs;2;0;7;1;0;0;0;7;37;2;2;257;37;223;2;2;0;4;4;257;2;3733;2;8;
com.sun.jdi.connect;1;0;3;1;0;0;0;3;0;0;1;2704;0;59;2;1;0;2;2;2704;1;2704;1;2;
org.eclipse.jdt.internal.ui.preferences;1;4;59;1;12;4;22;37;230;4;4;15;804;559;4;6;8;10;22;128;14;4419;8;5;
org.eclipse.team.core.sync;0;0;7;0;0;0;1;6;134;3;2;2019;169;0;3;4;0;6;6;2019;4;2053;2;0;
org.eclipse.pde.internal.core.plugin;1;0;5;1;0;0;1;4;0;0;1;3591;0;0;2;1;0;2;2;3591;1;3591;1;1;
org.eclipse.swt;0;2;17;0;4;2;6;11;407;2;3;106;468;0;2;3;2;6;10;106;5;4571;5;0;
com.sun.jdi.event;1;0;3;1;0;0;0;3;0;0;1;2704;0;28;2;1;0;2;2;2704;1;2704;1;2;
org.eclipse.pde.core.plugin;1;0;4;1;2;1;2;2;986;0;1;3591;986;169;2;1;1;2;4;3591;2;4751;2;1;
org.eclipse.jdt.internal.ui.javaeditor.structureselection;0;0;9;0;0;0;2;7;25;3;2;3188;49;0;3;3;0;5;5;3188;3;3567;2;0;
org.eclipse.jdt.internal.ui.refactoring.nls.search;0;0;3;0;0;0;0;3;0;0;1;1922;0;0;2;1;0;2;2;1922;1;1922;1;0;
org.eclipse.jdt.internal.corext.refactoring;0;0;4;0;0;0;0;4;0;0;1;1939;0;0;2;1;0;2;2;1939;1;1939;1;0;
org.eclipse.pde.internal.build.tasks;0;0;7;0;0;0;1;6;8;2;2;3509;8;0;2;2;0;4;4;3509;2;3571;2;0;
org.eclipse.jdt.internal.core.util;2;2;22;1;8;4;12;10;1471;5;2;455;2334;35;5;5;4;7;15;3629;9;4421;6;2;
org.eclipse.pde.internal.ui.view;1;0;2;1;0;0;0;2;0;0;1;3579;0;3;2;1;0;2;2;3579;1;3579;1;1;
org.eclipse.debug.ui.actions;0;0;5;0;0;0;1;4;0;0;0;-1;0;0;0;0;0;0;0;-1;0;-1;0;0;
org.eclipse.pde.internal.ui.editor.schema;1;0;3;1;0;0;0;3;0;0;1;3579;0;2;2;1;0;2;2;3579;1;3579;1;1;
org.eclipse.pde.internal.runtime.registry;0;0;3;0;0;0;1;2;0;0;1;1434;0;0;2;1;0;2;2;1434;1;1434;1;0;
org.eclipse.help.internal;0;0;7;0;0;0;0;7;31;0;1;3048;31;0;2;1;0;2;2;3048;1;3048;1;0;
org.eclipse.help.ui.internal.browser.hpux;0;0;2;0;0;0;2;0;0;0;0;-1;0;0;0;0;0;0;0;-1;0;-1;0;0;
org.eclipse.jdt.core.jdom;2;0;6;1;2;1;2;4;185;0;1;455;185;154;2;1;1;2;4;455;2;4058;2;2;
org.eclipse.jdt.internal.ui.wizards.dialogfields;0;0;10;0;0;0;1;9;0;0;1;15;0;0;2;1;0;2;2;15;1;15;1;0;
org.eclipse.jdt.internal.ui.refactoring.sef;0;0;15;0;3;1;5;10;51;0;1;2876;95;0;3;1;2;2;5;4396;3;4396;2;0;
org.eclipse.core.internal.boot;0;0;9;0;0;0;1;8;0;0;1;12;0;212;2;1;0;2;2;12;1;12;1;2;
org.eclipse.help.internal.search;2;0;13;2;2;1;3;10;462;0;1;2318;462;749;3;2;1;3;5;2318;3;4000;2;3;
org.eclipse.team.internal.ccvs.ui.merge;0;0;13;0;0;0;3;10;57;2;2;2641;57;0;2;2;0;4;4;2641;2;3023;2;0;
org.eclipse.jface.operation;1;0;3;1;0;0;0;3;0;0;1;257;0;10;2;1;0;2;2;257;1;257;1;2;
org.eclipse.update.internal.ui.security;0;0;9;0;0;0;1;8;562;2;2;3122;562;0;2;2;0;4;4;3122;2;3205;2;0;
org.eclipse.jdt.internal.core.index;1;0;6;1;0;0;2;4;0;0;1;455;0;17;2;1;0;2;2;455;1;455;1;2;
org.eclipse.team.internal.ui;1;0;12;1;0;0;3;9;0;0;1;1978;0;366;2;1;0;2;2;1978;1;1978;1;2;
org.eclipse.jdt.internal.core.jdom;0;0;15;0;3;1;5;10;144;2;2;455;152;0;3;2;2;4;7;3959;4;3959;3;0;
org.eclipse.search.internal.ui.text;0;0;16;0;0;0;0;16;44;2;2;15;44;0;2;2;0;4;4;15;2;1000;2;0;
org.eclipse.swt.custom;3;0;11;2;0;0;1;10;1228;3;2;106;1228;2777;3;3;0;5;5;2876;3;2876;2;10;
org.eclipse.jdt.internal.ui.text.correction;1;0;10;1;2;1;2;8;332;2;2;3306;414;6;2;2;1;4;6;3306;3;4452;3;1;
org.eclipse.team.internal.core;1;0;3;1;0;0;1;2;0;0;1;3762;0;0;2;1;0;2;2;3762;1;3762;1;1;
org.eclipse.pde.internal.build.ant;0;0;5;0;0;0;1;4;8;2;2;3194;8;0;2;2;0;4;4;3194;2;3571;2;0;
org.eclipse.debug.internal.ui.preferences;0;0;3;0;2;1;3;0;0;0;0;3975;0;0;2;0;1;0;2;3975;1;3975;1;0;
org.eclipse.pde.internal.core.ischema;1;0;2;1;0;0;0;2;0;0;1;3591;0;3;2;1;0;2;2;3591;1;3591;1;1;
org.eclipse.webdav.dom;1;0;6;1;0;0;1;5;0;0;1;12;0;343;2;1;0;2;2;12;1;12;1;3;
org.eclipse.team.internal.webdav.core;1;2;11;1;10;5;11;0;305;0;0;4073;720;10;2;0;5;0;10;4073;5;4362;5;2;
org.eclipse.jdt.internal.ui.filters;0;0;2;0;2;1;2;0;0;0;0;4211;0;0;2;0;1;0;2;4211;1;4211;1;0;
org.eclipse.team.internal.ccvs.ui.wizards;0;0;7;0;0;0;1;6;815;2;2;1978;815;0;2;2;0;4;4;1978;2;2577;2;0;
org.eclipse.update.ui.forms.internal.engine;0;0;7;0;0;0;1;6;0;0;1;2745;0;0;2;1;0;2;2;2745;1;2745;1;1;
org.eclipse.jdt.internal.junit.launcher;0;0;7;0;2;1;3;4;19;0;1;3171;19;0;2;1;1;2;4;3171;2;4451;2;0;
org.eclipse.jdt.internal.corext.template.java;0;0;4;0;0;0;1;3;0;0;1;2784;0;0;2;1;0;2;2;2784;1;2784;1;0;
org.eclipse.help.ui.internal.browser.solaris;0;0;3;0;0;0;1;2;0;0;0;-1;0;0;0;0;0;0;0;-1;0;-1;0;0;
org.eclipse.ui.internal.misc;1;0;6;1;0;0;0;6;12;2;2;257;12;246;2;2;0;4;4;257;2;2674;2;4;
org.eclipse.jdt.internal.compiler.env;0;0;4;0;0;0;1;3;0;0;1;455;0;0;2;1;0;2;2;455;1;455;1;0;
org.eclipse.jdt.internal.corext.refactoring.structure;1;0;10;1;0;0;0;10;155;2;2;2270;155;0;2;2;0;4;4;2270;2;2630;2;1;
org.eclipse.jdt.internal.compiler.lookup;0;0;5;0;0;0;1;4;0;0;1;455;0;0;2;1;0;2;2;455;1;455;1;0;
org.eclipse.swt.internal.win32;1;0;3;1;0;0;1;2;0;0;1;2069;0;69;2;1;0;2;2;2069;1;2069;1;2;
org.eclipse.help.ui.internal.browser.win32;0;0;2;0;2;1;2;0;0;0;0;4427;0;0;2;0;1;0;2;4427;1;4427;1;0;
org.eclipse.ui;1;0;12;1;0;0;2;10;16;2;2;257;16;321;2;2;0;4;4;257;2;3774;2;8;
org.eclipse.jdt.internal.compiler.util;0;0;13;0;0;0;1;12;1978;4;3;455;2122;0;4;5;0;8;8;1039;5;1039;3;0;
org.eclipse.team.internal.ccvs.core.resources;0;0;41;0;0;0;2;39;708;5;8;1978;1359;0;5;11;0;19;19;2032;11;3574;8;0;
org.eclipse.jdt.internal.corext.refactoring.util;0;0;11;0;0;0;0;11;37;2;2;2928;47;0;2;2;0;4;4;2928;2;3185;2;0;
org.eclipse.webdav.http.client;1;0;8;1;0;0;1;7;0;0;1;12;0;92;2;1;0;2;2;12;1;12;1;2;
org.eclipse.update.internal.model;1;0;4;1;0;0;1;3;133;0;1;3027;133;205;3;2;0;3;3;3027;2;3027;1;1;
org.eclipse.jdt.internal.ui.typehierarchy;0;0;32;0;2;1;8;24;208;2;4;15;381;0;2;4;1;8;10;15;5;3967;5;0;
org.eclipse.jdt.internal.junit.ui;1;0;2;1;0;0;0;2;0;0;1;3171;0;0;2;1;0;2;2;3171;1;3171;1;1;
org.eclipse.jdt.internal.compiler.problem;0;0;4;0;0;0;1;3;0;0;1;455;0;0;2;1;0;2;2;455;1;455;1;0;
org.eclipse.pde.internal.builders;0;0;4;0;0;0;1;3;0;0;1;3631;0;0;2;1;0;2;2;3631;1;3631;1;0;
org.eclipse.jdi.internal.connect;0;0;8;0;0;0;1;7;194;2;2;187;194;0;2;2;0;4;4;187;2;3670;2;0;
org.eclipse.ui.internal;1;0;3;1;0;0;0;3;0;0;1;257;0;1222;2;1;0;2;2;257;1;257;1;9;
org.eclipse.team.internal.ccvs.core.util;1;0;7;1;0;0;1;6;0;0;1;1978;0;264;2;1;0;2;2;1978;1;1978;1;2;
org.eclipse.ui.editors.text;1;0;4;1;0;0;0;4;0;0;1;257;0;943;2;1;0;2;2;257;1;257;1;4;
org.eclipse.webdav;1;0;5;1;0;0;1;4;0;0;1;1635;0;147;2;1;0;2;2;1635;1;1635;1;2;
org.eclipse.help.ui.internal.browser.aix;0;0;3;0;0;0;1;2;0;0;0;-1;0;15;0;0;0;0;0;-1;0;-1;0;2;
org.eclipse.team.internal.ui.sync;0;0;6;0;2;1;2;4;1017;2;2;2054;1459;0;2;2;1;4;6;2054;3;4005;3;0;
org.eclipse.ui.wizards.newresource;1;0;12;1;0;0;1;11;0;0;1;257;0;74;2;1;0;2;2;257;1;257;1;3;
org.eclipse.jdt.internal.corext.refactoring.nls;0;0;3;0;0;0;0;3;0;0;1;1939;0;0;2;1;0;2;2;1939;1;1939;1;0;
org.eclipse.pde.internal.ui.editor;0;0;2;0;0;0;0;2;0;0;1;3579;0;0;2;1;0;2;2;3579;1;3579;1;0;
org.eclipse.jface.action;1;0;3;1;0;0;0;3;0;0;1;257;0;103;2;1;0;2;2;257;1;257;1;5;
org.eclipse.jdi.internal.spy;0;0;4;0;0;0;0;4;0;0;1;187;0;0;2;1;0;2;2;187;1;187;1;1;
org.eclipse.pde.internal.core.ifeature;0;0;2;0;0;0;0;2;0;0;1;3591;0;0;2;1;0;2;2;3591;1;3591;1;0;
org.eclipse.jdt.internal.ui.packageview;0;0;6;0;0;0;1;5;0;0;1;15;0;0;2;1;0;2;2;15;1;15;1;0;
org.eclipse.team.internal.core.streams;1;0;2;1;2;1;2;0;0;0;0;4169;0;0;2;0;1;0;2;4169;1;4169;1;1;
org.eclipse.jdt.internal.compiler;1;0;18;1;0;0;1;17;38826;4;3;455;39546;34;4;7;0;10;10;868;7;1039;3;2;
org.eclipse.help.standalone;0;0;3;0;0;0;1;2;0;0;0;-1;0;0;0;0;0;0;0;-1;0;-1;0;0;
org.eclipse.jdt.internal.codeassist;0;0;11;0;0;0;1;10;13872;4;2;455;13872;0;4;4;0;6;6;1039;4;1039;2;0;
org.eclipse.swt.internal.carbon;0;0;4;0;2;1;4;0;0;0;0;4147;0;0;2;0;1;0;2;4147;1;4147;1;0;
org.eclipse.jdt.internal.corext.template;1;0;3;1;0;0;0;3;0;0;1;2784;0;0;2;1;0;2;2;2784;1;2784;1;1;
org.eclipse.jdt.internal.compiler.batch;0;0;19;0;0;0;1;18;1139;4;3;455;1295;0;4;7;0;10;10;1039;7;3104;3;0;
org.eclipse.webdav.internal.kernel;1;0;6;1;0;0;1;5;0;0;1;12;0;415;2;1;0;2;2;12;1;12;1;2;
org.eclipse.core.resources;1;0;8;1;0;0;1;7;0;0;1;12;0;179;2;1;0;2;2;12;1;12;1;2;
org.eclipse.update.internal.ui.model;1;0;3;1;0;0;0;3;0;0;1;2797;0;16;2;1;0;2;2;2797;1;2797;1;1;
org.eclipse.debug.internal.ui.views.breakpoints;0;0;4;0;2;1;4;0;0;0;0;3975;0;0;2;0;1;0;2;3975;1;3975;1;0;
com.sun.jdi;1;0;3;1;0;0;0;3;0;0;1;2704;0;103;2;1;0;2;2;2704;1;2704;1;2;
org.eclipse.core.runtime.model;0;0;6;0;0;0;1;5;0;0;1;12;0;0;2;1;0;2;2;12;1;12;1;0;
org.eclipse.swt.internal.motif;1;0;3;1;0;0;1;2;0;0;1;2069;0;36;2;1;0;2;2;2069;1;2069;1;2;
org.eclipse.pde.ui;0;0;3;0;0;0;1;2;0;0;1;3579;0;0;2;1;0;2;2;3579;1;3579;1;0;
org.eclipse.help.internal.toc;1;0;3;1;0;0;0;3;0;0;1;1857;0;38;2;1;0;2;2;1857;1;1857;1;2;
org.eclipse.ant.internal.core;0;0;12;0;2;1;4;8;508;3;2;3489;780;0;3;3;1;5;7;3489;4;4142;3;0;
org.eclipse.swt.internal.ole.win32;0;0;4;0;0;0;1;3;0;0;0;-1;0;24;0;0;0;0;0;-1;0;-1;0;2;
org.eclipse.tomcat.internal;0;0;4;0;0;0;1;3;0;0;1;3285;0;0;2;1;0;2;2;3285;1;3285;1;0;
org.eclipse.core.resources.ant;1;0;5;1;0;0;1;4;0;0;1;3509;0;109;2;1;0;2;2;3509;1;3509;1;2;
org.eclipse.team.internal.ftp.target;0;4;10;0;6;2;10;0;197;0;0;4241;333;0;4;0;4;0;6;4241;4;4261;2;0;
org.eclipse.update.internal.ui;0;0;31;0;0;0;10;21;13;0;1;2172;13;0;2;1;0;2;2;2172;1;2172;1;0;
org.eclipse.swt.events;1;0;4;1;0;0;1;3;0;0;1;106;0;58;2;1;0;2;2;106;1;106;1;4;
org.eclipse.ui.model;0;0;3;0;0;0;0;3;0;0;1;257;0;0;2;1;0;2;2;257;1;257;1;0;
org.eclipse.help.ui.internal.browser.linux;0;0;3;0;0;0;1;2;0;0;0;-1;0;0;0;0;0;0;0;-1;0;-1;0;0;
org.eclipse.help.internal.context;0;0;10;0;0;0;0;10;0;0;0;-1;0;0;0;0;0;0;0;-1;0;-1;0;0;
org.eclipse.jdt.internal.core.eval;0;0;10;0;2;1;3;7;42;0;1;455;42;0;2;1;1;2;4;455;2;3959;2;0;
org.eclipse.help.ui.internal.search;0;0;7;0;0;0;1;6;313;2;2;2429;313;0;2;2;0;4;4;2429;2;3074;2;0;
org.eclipse.jdi.hcr;0;0;3;0;0;0;0;3;0;0;1;187;0;0;2;1;0;2;2;187;1;187;1;0;
org.eclipse.debug.internal.ui.views;0;0;11;0;0;0;1;10;0;0;0;-1;0;0;0;0;0;0;0;-1;0;-1;0;0;
org.eclipse.jdt.internal.core.search.processing;0;0;7;0;0;0;1;6;0;0;0;-1;0;0;0;0;0;0;0;-1;0;-1;0;0;
org.eclipse.jface.text.contentassist;1;0;4;1;0;0;0;4;0;0;1;257;0;73;2;1;0;2;2;257;1;257;1;4;
org.eclipse.team.internal.ftp;0;0;3;0;0;0;3;0;0;0;0;-1;0;0;0;0;0;0;0;-1;0;-1;0;0;
org.eclipse.pde.internal.ui.wizards.templates;1;0;3;1;0;0;0;3;0;0;1;3579;0;17;2;1;0;2;2;3579;1;3579;1;1;
org.eclipse.pde.internal.ui.util;1;0;2;1;0;0;0;2;0;0;1;3579;0;0;2;1;0;2;2;3579;1;3579;1;1;
org.eclipse.jdt.internal.corext.refactoring.code.flow;1;0;4;1;0;0;0;4;0;0;1;1939;0;33;2;1;0;2;2;1939;1;1939;1;1;
org.eclipse.pde.internal.ui.editor.build;0;0;2;0;0;0;0;2;0;0;1;3579;0;0;2;1;0;2;2;3579;1;3579;1;0;
org.eclipse.pde.internal.ui.codegen;0;0;3;0;0;0;0;3;0;0;1;3579;0;0;2;1;0;2;2;3579;1;3579;1;0;
org.eclipse.ui.internal.model;1;0;3;1;0;0;0;3;0;0;1;257;0;179;2;1;0;2;2;257;1;257;1;5;
org.eclipse.jdt.internal.debug.ui.snippeteditor;1;0;14;1;2;1;4;10;56;2;2;1915;66;0;2;2;1;4;6;1915;3;4402;3;2;
org.eclipse.core.internal.resources;1;0;12;1;0;0;1;11;0;0;1;12;0;369;2;1;0;2;2;12;1;12;1;2;
org.eclipse.jface.util;1;0;4;1;0;0;0;4;0;0;1;257;0;5;2;1;0;2;2;257;1;257;1;2;
org.eclipse.debug.internal.ui.views.expression;0;0;5;0;2;1;5;0;0;0;0;3975;0;0;2;0;1;0;2;3975;1;3975;1;0;
org.eclipse.jdt.internal.compiler.impl;1;0;13;1;0;0;1;12;5082;4;3;455;5148;150;4;5;0;8;8;1039;5;1039;3;2;
org.eclipse.swt.widgets;1;0;15;1;0;0;2;13;0;0;1;106;0;434;2;1;0;2;2;106;1;106;1;9;
org.eclipse.webdav.internal.authentication;0;0;7;0;0;0;2;5;0;0;1;12;0;0;2;1;0;2;2;12;1;12;1;0;
org.eclipse.jdt.internal.corext.dom;0;0;4;0;0;0;0;4;0;0;1;2876;0;0;2;1;0;2;2;2876;1;2876;1;0;
org.eclipse.ui.externaltools.internal.core;1;0;4;1;2;1;4;0;0;0;0;4090;0;98;2;0;1;0;2;4090;1;4090;1;2;
org.eclipse.ui.views.navigator;2;0;23;1;2;1;3;20;2227;2;4;257;4198;10;2;4;1;8;10;257;5;4067;5;3;
org.eclipse.jface.dialogs;1;0;5;1;0;0;0;5;0;0;1;257;0;78;2;1;0;2;2;257;1;257;1;5;
org.eclipse.team.internal.ui.actions;0;0;2;0;2;1;2;0;0;0;0;4020;0;0;2;0;1;0;2;4020;1;4020;1;0;
org.eclipse.jdt.internal.ui.reorg;0;0;32;0;0;0;3;29;74;2;3;1338;112;118;2;3;0;6;6;1338;3;2014;3;3;
org.eclipse.team.internal.ccvs.ssh;1;0;4;1;0;0;0;4;0;0;1;1978;0;2456;2;1;0;2;2;1978;1;1978;1;1;
org.eclipse.core.internal.runtime;1;0;9;1;0;0;3;6;0;0;1;12;0;232;2;1;0;2;2;12;1;12;1;4;
org.eclipse.update.core.model;2;0;12;1;0;0;0;12;606;2;3;2409;826;602;2;3;0;6;6;2409;3;3528;3;2;
org.eclipse.jface.text.rules;1;0;4;1;0;0;0;4;0;0;1;257;0;107;2;1;0;2;2;257;1;257;1;4;
org.eclipse.jdt.internal.corext.refactoring.changes;0;0;4;0;0;0;0;4;0;0;1;1939;0;98;2;1;0;2;2;1939;1;1939;1;1;
org.eclipse.pde.core.build;0;0;4;0;2;1;2;2;150;0;1;3591;150;0;2;1;1;2;4;3591;2;4751;2;0;
org.eclipse.jdt.internal.ui.text;0;0;10;0;0;0;0;10;159;2;3;15;299;0;2;3;0;6;6;15;3;2848;3;0;
org.eclipse.webdav.internal.kernel.utils;0;0;5;0;0;0;1;4;0;0;1;12;0;0;2;1;0;2;2;12;1;12;1;0;
org.eclipse.jdt.internal.ui.viewsupport;0;0;10;0;0;0;0;10;192;2;2;15;192;39;2;2;0;4;4;15;2;1718;2;3;
org.eclipse.jdt.internal.compiler.codegen;0;0;18;0;0;0;3;15;4132;4;2;455;4132;0;4;4;0;6;6;1039;4;1039;2;0;
org.eclipse.jdt.internal.ui.util;1;0;8;1;0;0;0;8;0;0;1;15;0;264;2;1;0;2;2;15;1;15;1;4;
org.eclipse.jdt.internal.corext.refactoring.sef;0;0;6;0;0;0;0;6;92;2;2;1939;92;0;2;2;0;4;4;1939;2;2133;2;0;
org.eclipse.debug.internal.ui.actions;1;0;10;1;0;0;0;10;6;2;2;2382;6;227;2;2;0;4;4;2382;2;3679;2;4;
org.eclipse.pde.internal.ui;0;0;11;0;0;0;4;7;52;0;1;3579;52;0;3;2;0;3;3;3579;2;3579;1;0;
org.eclipse.ant.core;0;0;8;0;0;0;4;4;25;0;1;3575;25;0;2;1;0;2;2;3575;1;3575;1;0;
org.eclipse.jdi.internal.request;2;0;11;1;0;0;2;9;101;2;2;187;101;35;2;2;0;4;4;187;2;3670;2;4;
org.eclipse.jface.text.source;1;0;7;1;0;0;1;6;0;0;1;257;0;653;2;1;0;2;2;257;1;257;1;6;
org.eclipse.jdt.internal.ui.javaeditor;0;0;16;0;0;0;2;14;130;3;3;15;250;239;3;4;0;7;7;3101;4;3588;3;7;
org.eclipse.team.internal.ui.target;0;2;10;0;6;3;10;0;352;0;0;4149;446;12;2;0;3;0;6;4149;3;4401;3;3;
org.eclipse.jdt.internal.corext.javadoc;0;0;3;0;0;0;1;2;0;0;1;2495;0;0;2;1;0;2;2;2495;1;2495;1;0;
org.eclipse.ui.internal.registry;1;0;7;1;0;0;0;7;0;0;1;257;0;1049;2;1;0;2;2;257;1;257;1;5;
org.eclipse.team.internal.ccvs.ui.actions;0;0;20;0;0;0;2;18;26;2;3;1978;33;163;2;3;0;6;6;1978;3;2726;3;3;
org.eclipse.debug.internal.ui.launchConfigurations;0;3;117;0;15;7;27;90;743;4;25;2161;5075;0;4;40;8;65;80;2161;48;4401;32;0;
org.eclipse.jdt.internal.core.search.indexing;1;0;20;1;0;0;2;18;756;4;2;455;756;123;4;4;0;6;6;1039;4;1039;2;3;
org.eclipse.jdt.internal.ui.compare;2;0;16;1;0;0;3;13;474;2;3;15;570;391;2;3;0;6;6;15;3;2153;3;3;
org.eclipse.jdt.internal.ui.search;0;0;17;0;0;0;1;16;121;2;3;15;151;0;2;3;0;6;6;15;3;3760;3;1;
org.eclipse.swt.layout;0;0;8;0;0;0;2;6;255;2;2;106;255;0;2;2;0;4;4;106;2;2881;2;0;
org.eclipse.pde.core;0;0;4;0;2;1;2;2;326;0;1;3591;326;0;2;1;1;2;4;3591;2;4751;2;0;
org.eclipse.update.internal.ui.pages;0;0;3;0;0;0;0;3;0;0;1;3537;0;0;2;1;0;2;2;3537;1;3537;1;1;
org.eclipse.swt.dnd;1;0;5;1;0;0;2;3;0;0;1;106;0;773;2;1;0;2;2;106;1;106;1;4;
org.eclipse.jdt.internal.debug.core.breakpoints;0;0;7;0;0;0;1;6;62;0;1;2517;62;0;3;2;0;3;3;2517;2;2517;1;0;
org.eclipse.jdt.core.compiler;0;0;16;0;2;1;3;13;283;7;2;3080;415;0;7;7;1;9;11;3080;8;4419;3;0;
org.eclipse.jdt.internal.corext.refactoring.base;1;0;6;1;0;0;3;3;0;0;1;1939;0;86;2;1;0;2;2;1939;1;1939;1;3;
org.eclipse.jdt.internal.debug.eval;0;0;4;0;0;0;0;4;0;0;0;-1;0;0;0;0;0;0;0;-1;0;-1;0;0;
org.eclipse.core.internal.watson;1;0;5;1;0;0;1;4;0;0;1;12;0;373;2;1;0;2;2;12;1;12;1;1;
org.eclipse.jdt.internal.corext.util;0;0;11;0;0;0;2;9;431;2;2;3827;466;0;2;2;0;4;4;3827;2;3870;2;0;
org.eclipse.jface.text;1;0;5;1;0;0;1;4;0;0;1;257;0;1654;2;1;0;2;2;257;1;257;1;4;
org.eclipse.jdt.internal.ui.workingsets;0;0;3;0;0;0;1;2;0;0;1;3834;0;0;2;1;0;2;2;3834;1;3834;1;0;
org.eclipse.core.runtime;1;0;7;1;0;0;2;5;0;0;1;12;0;456;2;1;0;2;2;12;1;12;1;5;
org.eclipse.swt.internal;0;0;18;0;0;0;2;16;55;2;2;106;55;17;2;2;0;4;4;106;2;1499;2;2;
org.eclipse.jdt.ui;2;0;20;1;0;0;2;18;68;2;2;15;68;204;2;2;0;4;4;15;2;1705;2;4;
org.eclipse.compare;1;0;7;1;0;0;0;7;256;2;2;14;256;10;2;2;0;4;4;14;2;77;2;1;
org.eclipse.ui.externaltools.internal.ui;1;0;3;1;2;1;3;0;0;0;0;4090;0;84;2;0;1;0;2;4090;1;4090;1;2;
org.eclipse.jdt.debug.eval;0;0;13;0;0;0;1;12;0;0;1;1675;0;0;2;1;0;2;2;1675;1;1675;1;0;
org.eclipse.ui.views.framelist;1;0;3;1;0;0;1;2;0;0;1;3498;0;4;2;1;0;2;2;3498;1;3498;1;2;
org.eclipse.jdt.internal.compiler.flow;0;0;14;0;0;0;1;13;120;4;2;455;120;0;4;4;0;6;6;1039;4;1039;2;0;
org.eclipse.jdt.core.util;1;0;6;1;0;0;4;2;0;0;1;3629;0;41;2;1;0;2;2;3629;1;3629;1;2;
org.eclipse.pde.internal.ui.wizards.project;0;0;3;0;0;0;0;3;0;0;1;3579;0;0;2;1;0;2;2;3579;1;3579;1;0;
org.eclipse.pde.internal.core;1;0;2;1;0;0;0;2;0;0;1;3591;0;0;2;1;0;2;2;3591;1;3591;1;1;
org.eclipse.ui.views.tasklist;1;0;10;1;0;0;1;9;0;0;1;257;0;63;2;1;0;2;2;257;1;257;1;5;
org.eclipse.ui.help;0;0;6;0;0;0;0;6;0;0;1;257;0;0;2;1;0;2;2;257;1;257;1;0;
org.eclipse.ui.wizards.datatransfer;0;0;3;0;0;0;0;3;0;0;1;257;0;4;2;1;0;2;2;257;1;257;1;1;
org.eclipse.jdt.internal.junit.runner;0;0;4;0;0;0;1;3;0;0;1;3171;0;0;2;1;0;2;2;3171;1;3171;1;0;
org.eclipse.jdt.internal.ui.wizards.buildpaths;1;0;15;1;0;0;1;14;494;3;4;15;939;46;3;5;0;9;9;218;5;218;4;5;
org.eclipse.jdt.internal.corext;1;0;3;1;0;0;1;2;0;0;1;2327;0;6;2;1;0;2;2;2327;1;2327;1;2;
org.eclipse.help.ui.internal;0;0;2;0;2;1;2;0;0;0;0;4439;0;0;2;0;1;0;2;4439;1;4439;1;0;
org.eclipse.update.internal.ui.parts;1;0;4;1;0;0;1;3;0;0;1;1460;0;0;2;1;0;2;2;1460;1;1460;1;1;
org.eclipse.update.internal.ui.win32.views;1;0;3;1;2;1;3;0;0;0;0;4127;0;0;2;0;1;0;2;4127;1;4127;1;1;
org.eclipse.jface.viewers;1;0;4;1;0;0;0;4;0;0;1;257;0;216;2;1;0;2;2;257;1;257;1;4;
org.eclipse.jdt.launching.sourcelookup;0;0;8;0;2;1;4;4;541;0;1;2372;669;0;3;2;1;3;5;2372;3;4173;2;0;
org.eclipse.update.internal.ui.forms;1;0;5;1;0;0;2;3;16;0;1;3662;16;144;2;1;0;2;2;3662;1;3662;1;2;
org.eclipse.jdt.internal.debug.ui.launcher;1;0;3;1;0;0;1;2;0;0;1;1915;0;14;2;1;0;2;2;1915;1;1915;1;2;
org.eclipse.jdt.internal.ui.refactoring.nls;0;0;4;0;0;0;1;3;102;0;1;1922;102;0;3;2;0;3;3;1922;2;1922;1;0;
org.eclipse.ui.texteditor;1;0;5;1;0;0;0;5;0;0;1;257;0;1517;2;1;0;2;2;257;1;257;1;5;
org.eclipse.help.servlet;0;0;11;0;0;0;2;9;143;0;1;2409;143;15;3;2;0;3;3;2409;2;2409;1;2;
org.eclipse.pde.internal.runtime;0;0;3;0;0;0;1;2;0;0;1;1434;0;0;2;1;0;2;2;1434;1;1434;1;0;
org.eclipse.team.internal.ccvs.core.connection;0;0;8;0;0;0;1;7;2;2;2;1978;2;0;2;2;0;4;4;1978;2;2956;2;0;
org.eclipse.jdt.internal.codeassist.impl;0;0;16;0;0;0;1;15;42;4;2;1039;82;0;4;4;0;6;6;1039;4;1939;2;0;
org.eclipse.ui.internal.dialogs;1;0;19;1;0;0;1;18;41;2;3;257;72;599;2;3;0;6;6;257;3;2300;3;7;
org.eclipse.jdt.ui.text;0;0;7;0;0;0;1;6;0;0;1;15;0;0;2;1;0;2;2;15;1;15;1;0;
org.eclipse.update.internal.ui.preferences;0;0;6;0;0;0;5;1;0;0;0;-1;0;0;0;0;0;0;0;-1;0;-1;0;0;
org.eclipse.jdt.internal.ui.text.javadoc;0;0;6;0;0;0;0;6;0;0;1;15;0;0;2;1;0;2;2;15;1;15;1;0;
org.eclipse.jdt.internal.debug.ui.actions;1;0;19;1;0;0;2;17;85;2;4;1915;137;27;2;4;0;8;8;1915;4;3796;4;2;
org.eclipse.update.configuration;1;0;6;1;0;0;1;5;0;0;1;2994;0;405;2;1;0;2;2;2994;1;2994;1;2;
org.eclipse.ui.externaltools.internal.ui.ant;0;0;3;0;0;0;3;0;0;0;0;-1;0;0;0;0;0;0;0;-1;0;-1;0;0;
org.eclipse.team.internal.ccvs.ui.model;1;0;7;1;0;0;0;7;0;0;1;1978;0;129;2;1;0;2;2;1978;1;1978;1;3;
org.eclipse.webdav.internal.utils;0;0;7;0;0;0;3;4;0;0;0;-1;0;0;0;0;0;0;0;-1;0;-1;0;0;
org.eclipse.jdt.internal.codeassist.complete;1;0;10;1;0;0;1;9;564;4;2;455;564;131;4;4;0;6;6;1039;4;1039;2;2;
org.eclipse.swt.internal.gtk;2;0;8;1;2;1;3;5;279;0;1;2107;279;9;2;1;1;2;4;2107;2;4701;2;2;
org.eclipse.team.internal.core.target;1;2;6;1;4;2;6;0;30;0;0;4010;30;238;2;0;2;0;4;4010;2;4636;2;3;
org.eclipse.jdt.internal.core.index.impl;1;0;11;1;0;0;2;9;276;4;2;455;276;320;4;4;0;6;6;1039;4;1039;2;2;
org.eclipse.jdt.internal.core;1;0;11;1;0;0;1;10;18240;4;2;455;18240;2124;4;4;0;6;6;1039;4;1039;2;3;
org.eclipse.pde.internal.ui.wizards;1;0;2;1;0;0;0;2;0;0;1;3579;0;0;2;1;0;2;2;3579;1;3579;1;1;
org.eclipse.jdt.internal.compiler.ast;1;0;12;1;0;0;3;9;0;0;1;455;0;356;2;1;0;2;2;455;1;455;1;2;
org.eclipse.jdt.ui.actions;0;0;14;0;2;1;7;7;569;2;2;3533;901;306;2;2;1;4;6;3533;3;4115;3;3;
org.eclipse.update.ui.forms.internal;1;0;2;1;0;0;0;2;0;0;1;2470;0;323;2;1;0;2;2;2470;1;2470;1;1;
org.eclipse.debug.internal.ui.views.variables;0;0;3;0;2;1;3;0;0;0;0;3975;0;0;2;0;1;0;2;3975;1;3975;1;0;
org.eclipse.jdi.internal.jdwp;1;0;5;1;0;0;0;5;0;0;1;187;0;13;2;1;0;2;2;187;1;187;1;2;
com.sun.jdi.request;1;0;3;1;0;0;0;3;0;0;1;2704;0;26;2;1;0;2;2;2704;1;2704;1;2;
org.eclipse.jdt.internal.debug.ui.display;0;0;16;0;0;0;1;15;134;2;2;1915;134;0;2;2;0;4;4;1915;2;3322;2;0;
org.eclipse.team.internal.ccvs.core.client.listeners;0;0;7;0;0;0;0;7;0;0;1;2572;0;0;2;1;0;2;2;2572;1;2572;1;0;
org.eclipse.jdt.debug.ui;0;0;7;0;2;1;3;4;14;0;0;3959;14;0;2;0;1;0;2;3959;1;3959;1;0;
org.eclipse.jdt.internal.corext.refactoring.code;1;0;25;1;0;0;4;21;331;2;3;1939;409;1011;2;3;0;6;6;1939;3;3827;3;2;
org.eclipse.team.internal.ccvs.core.syncinfo;0;0;11;0;0;0;0;11;0;0;0;-1;0;0;0;0;0;0;0;-1;0;-1;0;0;
org.eclipse.jdt.ui.jarpackager;1;0;14;1;0;0;4;10;242;3;3;3529;315;47;3;4;0;7;7;3529;4;3788;3;2;
org.eclipse.help.ui.internal.browser;1;0;6;1;0;0;2;4;0;0;1;2429;0;2;2;1;0;2;2;2429;1;2429;1;1;
org.eclipse.jdt.internal.corext.refactoring.reorg;0;0;17;0;0;0;2;15;0;0;1;1939;0;0;2;1;0;2;2;1939;1;1939;1;0;
org.eclipse.team.internal.ccvs.ui.sync;0;0;20;0;2;1;5;15;594;0;1;2231;618;0;3;2;1;3;5;2231;3;4005;2;0;
org.eclipse.jdt.debug.ui.launchConfigurations;2;6;13;2;8;2;13;0;153;0;0;4098;195;299;6;0;6;0;8;4214;6;4214;2;3;
org.eclipse.jdi.internal;2;0;13;1;0;0;0;13;685;2;2;187;685;395;2;2;0;4;4;187;2;3670;2;3;
org.eclipse.ui.views.contentoutline;0;0;8;0;0;0;0;8;0;0;1;257;0;0;2;1;0;2;2;257;1;257;1;0;
org.eclipse.jdt.internal.ui.text.template;0;0;7;0;0;0;0;7;0;0;1;1469;0;0;2;1;0;2;2;1469;1;1469;1;0;
org.eclipse.jdt.internal.core.search.matching;1;0;7;1;0;0;2;5;0;0;1;455;0;702;2;1;0;2;2;455;1;455;1;3;
org.eclipse.help.ui.browser;0;0;5;0;0;0;0;5;0;0;1;2429;0;0;2;1;0;2;2;2429;1;2429;1;0;
org.eclipse.jdt.internal.debug.ui;0;0;7;0;0;0;0;7;0;0;1;1915;0;0;2;1;0;2;2;1915;1;1915;1;1;
org.eclipse.jdt.internal.ui;1;0;31;1;2;1;5;26;128;2;5;15;277;134;2;5;1;10;12;15;6;4630;6;5;
org.eclipse.jdt.internal.debug.eval.ast.instructions;2;0;7;1;0;0;0;7;308;2;2;3421;308;51;2;2;0;4;4;3421;2;3670;2;3;
org.eclipse.pde.internal;0;0;2;0;0;0;0;2;0;0;1;3631;0;0;2;1;0;2;2;3631;1;3631;1;0;
org.eclipse.jdt.internal.debug.core.hcr;0;0;5;0;0;0;0;5;11;0;1;2517;11;37;3;2;0;3;3;2517;2;2517;1;2;
org.eclipse.jface.resource;1;0;6;1;0;0;0;6;0;0;1;257;0;15;2;1;0;2;2;257;1;257;1;2;
org.eclipse.jdt.internal.ui.dialogs;1;0;6;1;0;0;0;6;0;0;1;15;0;467;2;1;0;2;2;15;1;15;1;8;
org.eclipse.ui.part;1;0;6;1;0;0;0;6;0;0;1;257;0;226;2;1;0;2;2;257;1;257;1;6;
org.eclipse.pde.internal.ui.wizards.imports;0;2;15;0;4;2;10;5;120;2;2;3579;188;0;2;2;2;4;8;3579;4;4409;4;0;
org.eclipse.pde.internal.core.build;1;0;3;1;0;0;1;2;0;0;1;3591;0;0;2;1;0;2;2;3591;1;3591;1;1;
org.eclipse.core.internal.utils;0;0;5;0;0;0;1;4;0;0;1;12;0;0;2;1;0;2;2;12;1;12;1;0;
org.eclipse.update.internal.ui.views;1;0;17;1;2;1;8;9;123;2;3;3537;152;677;2;3;1;6;8;3537;4;4771;4;2;
org.eclipse.update.internal.core;0;0;16;0;2;1;3;13;435;0;1;1638;748;80;3;2;1;3;5;1638;3;4349;2;2;
org.eclipse.pde.internal.ui.elements;1;0;2;1;0;0;0;2;0;0;1;3579;0;0;2;1;0;2;2;3579;1;3579;1;1;
org.eclipse.jface.preference;1;0;6;1;0;0;1;5;0;0;1;257;0;194;2;1;0;2;2;257;1;257;1;4;
org.eclipse.jdt.launching;1;0;11;1;2;1;7;4;29;0;1;2022;29;855;2;1;1;2;4;2022;2;4567;2;3;
org.eclipse.jdt.internal.corext.codemanipulation;2;0;10;1;0;0;0;10;158;2;3;1955;228;628;2;3;0;6;6;1955;3;2232;3;4;
org.eclipse.jdt.ui.wizards;0;0;25;0;0;0;5;20;125;3;2;95;197;0;3;3;0;5;5;1272;3;1272;2;0;
org.eclipse.help.internal.protocols;1;0;7;1;0;0;0;7;2;0;1;2694;2;123;3;2;0;3;3;2694;2;2694;1;2;
org.eclipse.team.core;0;0;3;0;0;0;1;2;0;0;0;-1;0;19;0;0;0;0;0;-1;0;-1;0;2;
org.eclipse.team.internal.ftp.client;1;0;3;1;2;1;3;0;0;0;0;4169;0;0;2;0;1;0;2;4169;1;4169;1;1;
org.eclipse.jdt.internal.corext.refactoring.rename;0;0;8;0;0;0;0;8;0;0;1;1939;0;164;2;1;0;2;2;1939;1;1939;1;1;
org.eclipse.core.internal.dtree;0;0;5;0;0;0;1;4;0;0;1;12;0;0;2;1;0;2;2;12;1;12;1;0;
org.eclipse.jdt.internal.ui.refactoring.actions;0;0;20;0;0;0;5;15;30;2;2;1342;42;0;2;2;0;4;4;1342;2;3826;2;0;
org.eclipse.webdav.client;1;0;6;1;0;0;1;5;0;0;1;12;0;1080;2;1;0;2;2;12;1;12;1;3;
org.eclipse.jdt.internal.ui.text.java.hover;0;0;13;0;0;0;1;12;7;0;1;3166;7;0;2;1;0;2;2;3166;1;3166;1;0;
org.eclipse.jface.wizard;0;0;5;0;0;0;0;5;0;0;1;257;0;0;2;1;0;2;2;257;1;257;1;0;
org.eclipse.team.internal.ftp.ui;0;0;5;0;2;1;5;0;8;0;0;4628;8;0;2;0;1;0;2;4628;1;4628;1;0;
org.eclipse.search.internal.core;0;0;3;0;0;0;0;3;0;0;0;-1;0;0;0;0;0;0;0;-1;0;-1;0;0;
org.eclipse.pde.internal.runtime.logview;0;0;3;0;0;0;0;3;0;0;1;1434;0;0;2;1;0;2;2;1434;1;1434;1;1;
org.eclipse.jdt.internal.debug.core.model;2;0;7;2;0;0;1;6;163;0;1;2517;163;186;4;3;0;4;4;2517;3;2517;1;3;
org.eclipse.ant.internal.core.ant;0;2;20;0;6;3;12;8;802;3;3;3489;1136;0;3;4;3;7;13;3489;7;4436;6;0;
org.eclipse.pde.internal.ui.editor.feature;0;0;9;0;0;0;3;6;355;0;1;3579;355;0;3;2;0;3;3;3579;2;3579;1;1;
org.eclipse.pde.internal.build;0;2;70;0;8;4;22;48;649;3;8;245;1895;0;3;11;4;19;27;256;15;4364;12;0;
org.eclipse.compare.internal.patch;1;0;3;1;0;0;1;2;0;0;1;2876;0;39;2;1;0;2;2;2876;1;2876;1;2;
org.eclipse.jdt.internal.ui.refactoring.code;0;0;16;0;0;0;2;14;123;3;2;192;128;0;3;3;0;5;5;192;3;408;2;0;
org.eclipse.debug.internal.ui.views.console;0;0;6;0;2;1;6;0;0;0;0;3975;0;0;2;0;1;0;2;3975;1;3975;1;0;
org.eclipse.swt.internal.image;1;0;4;1;0;0;1;3;0;0;1;106;0;58;2;1;0;2;2;106;1;106;1;2;
org.eclipse.core.boot;0;0;16;0;0;0;4;12;16;0;1;2802;16;0;2;1;0;2;2;2802;1;2802;1;0;
org.eclipse.pde.internal.ui.feature;0;0;2;0;0;0;0;2;0;0;1;3579;0;0;2;1;0;2;2;3579;1;3579;1;0;
org.eclipse.team.internal.webdav.ui;0;3;17;0;11;4;17;0;132;0;0;4149;235;0;3;0;7;0;11;4149;7;4628;4;0;
org.eclipse.jdt.internal.core.search;1;0;7;1;0;0;2;5;0;0;1;455;0;20;2;1;0;2;2;455;1;455;1;2;
org.eclipse.jdt.debug.core;0;0;14;0;0;0;1;13;10;0;1;187;10;54;3;2;0;3;3;187;2;187;1;1;
org.eclipse.jdt.internal.ui.refactoring;0;0;9;0;0;0;3;6;0;0;1;15;0;40;2;1;0;2;2;15;1;15;1;3;
org.eclipse.swt.accessibility;0;0;6;0;0;0;1;5;392;2;2;2781;392;0;2;2;0;4;4;2781;2;3007;2;0;
org.eclipse.jdt.internal.ui.wizards;1;0;12;1;0;0;1;11;215;2;4;15;300;32;2;4;0;8;8;15;4;3088;4;3;
org.eclipse.jdt.internal.ui.refactoring.changes;0;0;4;0;0;0;0;4;0;0;0;-1;0;0;0;0;0;0;0;-1;0;-1;0;0;
org.eclipse.debug.core;1;0;34;1;0;0;3;31;306;3;7;187;1160;210;3;8;0;15;15;1725;8;3634;7;3;
org.eclipse.jdt.internal.corext.refactoring.surround;0;0;10;0;2;1;4;6;14;0;1;2327;14;0;2;1;1;2;4;2327;2;4421;2;0;
org.eclipse.jdt.internal.ui.actions;0;0;18;0;0;0;2;16;0;0;1;15;0;0;2;1;0;2;2;15;1;15;1;1;
org.eclipse.core.internal.properties;0;0;10;0;0;0;2;8;0;0;1;12;0;544;2;1;0;2;2;12;1;12;1;3;
org.eclipse.jdt.internal.formatter.impl;0;0;15;0;0;0;1;14;588;4;3;869;720;0;4;5;0;8;8;1039;5;1039;3;0;
org.eclipse.update.internal.ui.properties;1;0;2;1;0;0;0;2;0;0;1;3537;0;0;2;1;0;2;2;3537;1;3537;1;1;
org.eclipse.ui.views.properties;1;0;3;1;0;0;0;3;0;0;1;257;0;75;2;1;0;2;2;257;1;257;1;4;
org.eclipse.team.internal.ccvs.core;0;0;19;0;0;0;2;17;574;2;2;1978;574;0;2;2;0;4;4;1978;2;2049;2;0;
org.eclipse.jdt.internal.ui.jarpackager;0;0;35;0;0;0;0;35;498;3;6;239;821;0;3;11;0;17;17;239;11;2131;6;0;
org.eclipse.pde.ui.templates;0;0;5;0;0;0;1;4;0;0;1;3819;0;0;2;1;0;2;2;3819;1;3819;1;0;
org.eclipse.pde.internal.ui.wizards.extension;0;0;5;0;0;0;1;4;0;0;1;3579;0;0;2;1;0;2;2;3579;1;3579;1;0;
org.eclipse.core.internal.events;1;0;5;1;0;0;1;4;0;0;1;12;0;212;2;1;0;2;2;12;1;12;1;2;
org.eclipse.jdt.internal.ui.text.java;0;0;4;0;0;0;0;4;0;0;1;15;0;0;2;1;0;2;2;15;1;15;1;0;
org.eclipse.jdt.internal.corext.refactoring.nls.changes;0;0;5;0;0;0;2;3;0;0;1;1939;0;0;2;1;0;2;2;1939;1;1939;1;0;
org.eclipse.jdt.internal.ui.javadocexport;0;0;6;0;0;0;0;6;0;0;1;2878;0;0;2;1;0;2;2;2878;1;2878;1;0;
org.eclipse.compare.rangedifferencer;0;0;3;0;0;0;0;3;0;0;1;14;0;0;2;1;0;2;2;14;1;14;1;0;
org.eclipse.search.internal.core.text;1;0;4;1;0;0;1;3;0;0;1;15;0;300;2;1;0;2;2;15;1;15;1;3;
org.eclipse.jdt.internal.corext.textmanipulation;1;0;4;1;0;0;0;4;0;0;1;2137;0;157;2;1;0;2;2;2137;1;2137;1;1;
org.eclipse.jface.text.presentation;1;0;4;1;0;0;0;4;0;0;1;257;0;36;2;1;0;2;2;257;1;257;1;3;
org.eclipse.jdt.internal.ui.dnd;0;0;4;0;0;0;1;3;0;0;1;15;0;0;2;1;0;2;2;15;1;15;1;0;
org.eclipse.jdt.internal.compiler.parser;1;0;30;1;0;0;1;29;15054;4;3;455;15104;34;4;5;0;8;8;1039;5;3415;3;2;
