filename;TotalPeopleInBurst;MaximumChangeBurstLate;NumberOfChanges;MaxPeopleInBurst;TotalBurstSizeLate;NumberOfChangeBurstsLate;NumberOfChangesLate;NumberOfChangesEarly;MaxChurnInBurst;MaximumChangeBurstEarly;NumberOfChangeBurstsEarly;TimeFirstBurst;TotalChurnInBurst;ChurnTotal;MaximumChangeBurst;NumberOfConsecutiveChangesEarly;NumberOfConsecutiveChangesLate;TotalBurstSizeEarly;TotalBurstSize;TimeMaxBurst;NumberOfConsecutiveChanges;TimeLastBurst;NumberOfChangeBursts;PeopleTotal;
/org.eclipse.jdt.debug/eval/org/eclipse/jdt/internal/debug/eval/ast/engine/InstructionSequence.java;1;0;2;1;0;0;0;2;0;1;2;3329;0;0;1;0;0;2;2;3329;0;3421;2;1;
/org.eclipse.debug.ui/ui/org/eclipse/debug/internal/ui/actions/CopyVariablesToClipboardActionDelegate.java;1;0;9;1;0;0;0;9;17;2;8;2382;45;45;2;1;0;9;9;3679;1;3730;8;1;
/org.eclipse.debug.ui/ui/org/eclipse/debug/internal/ui/PixelConverter.java;2;0;2;1;1;1;1;1;15;0;1;3266;15;15;1;0;0;1;2;3266;0;4567;2;2;
/org.eclipse.ui/Eclipse UI Standard Components/org/eclipse/ui/wizards/datatransfer/IImportStructureProvider.java;2;0;2;1;0;0;0;2;5;1;2;257;5;5;1;0;0;2;2;257;0;457;2;2;
/org.eclipse.jdt.debug.ui/ui/org/eclipse/jdt/internal/debug/ui/actions/ExceptionBreakpointFilterEditor.java;4;1;15;1;2;2;2;13;43;2;10;3030;141;141;2;3;0;13;15;3149;3;4410;12;4;
/org.eclipse.pde.ui/src/org/eclipse/pde/internal/base/model/IModelChangedEvent.java;2;0;3;1;0;0;0;3;13;1;3;1434;13;13;1;0;0;3;3;1434;0;3039;3;2;
/org.eclipse.scripting/src/org/eclipse/scripting/internal/uirenderer/XGRXmlElement.java;1;0;1;1;0;0;0;1;0;0;1;1424;0;0;1;0;0;1;1;1424;0;1424;1;1;
/org.eclipse.jdt.debug.tests/testprograms/ThrowsNPE.java;3;1;3;1;2;2;2;1;11;0;1;3719;14;14;1;0;0;1;3;3719;0;4571;3;3;
/org.eclipse.swt/Eclipse SWT Printing/gtk/org/eclipse/swt/printing/Printer.java;3;1;3;1;2;2;2;1;6;0;1;2107;10;10;1;0;0;1;3;2107;0;4701;3;3;
/org.eclipse.jdt.ui.tests.refactoring/resources/RenameVirtualMethodInClass/testFail22/in/A.java;1;0;1;1;0;0;0;1;0;0;1;49;0;0;1;0;0;1;1;49;0;49;1;1;
/org.eclipse.jdt.ui.tests.refactoring/resources/RenameType/test56/out/B.java;1;0;1;1;0;0;0;1;0;0;1;1547;0;0;1;0;0;1;1;1547;0;1547;1;1;
/org.eclipse.team.ui/src/org/eclipse/team/internal/ui/target/GetAction.java;4;2;9;1;9;8;9;0;178;0;0;4155;224;224;2;0;1;0;9;4401;1;4636;8;4;
/org.eclipse.pde.ui/Eclipse PDE UI/org/eclipse/pde/internal/OverlayIcon.java;2;0;5;2;0;0;0;5;12;3;3;267;12;12;3;2;0;5;5;324;2;1434;3;2;
/org.eclipse.jdt.ui.tests/ui/com/ibm/jdt/internal/ui/dialogs/tests/MultiElementListSelectorTest.java;1;0;3;1;0;0;0;3;4;1;3;255;4;4;1;0;0;3;3;255;0;522;3;1;
/org.eclipse.jdt.ui.tests.refactoring/resources/ExtractMethodWorkSpace/ExtractMethodTests/validSelection/A_test272.java;2;1;3;1;2;2;2;1;0;0;1;49;0;0;1;0;0;1;3;49;0;4419;3;2;
/org.eclipse.pde.ui/src/org/eclipse/pde/internal/ui/PDEPlugin.java;1;1;10;1;4;4;4;6;176;2;5;3579;312;312;2;1;0;6;10;3579;1;4588;9;1;
/org.eclipse.jdt.ui.tests.refactoring/resources/MoveMembers/test13/out/A.java;1;0;1;1;0;0;0;1;0;0;1;2738;0;0;1;0;0;1;1;2738;0;2738;1;1;
/org.eclipse.swt/Eclipse SWT/gtk1x/org/eclipse/swt/widgets/Caret.java;4;1;4;1;2;2;2;2;30;1;2;2107;37;37;1;0;0;2;4;2107;0;4701;4;4;
/org.eclipse.swt.tests/JUnit Tests/org/eclipse/swt/tests/junit/Test_org_eclipse_swt_dnd_TransferData.java;2;0;2;1;1;1;1;1;6;0;1;1792;6;6;1;0;0;1;2;1792;0;4706;2;2;
/org.eclipse.jdt.ui.tests.refactoring/resources/RenameType/testFail70/in/A.java;1;0;1;1;0;0;0;1;0;0;1;49;0;0;1;0;0;1;1;49;0;49;1;1;
/org.eclipse.jdt.debug.tests/tests/org/eclipse/jdt/debug/tests/core/DeferredBreakpointTests.java;3;1;5;1;4;4;4;1;42;0;1;3701;95;95;1;0;0;1;5;3701;0;4571;5;3;
/org.eclipse.update.ui/src/org/eclipse/update/internal/ui/model/UpdateSearchSite.java;1;0;3;1;0;0;0;3;6;1;3;2797;6;6;1;0;0;3;3;2797;0;3537;3;1;
/org.eclipse.jdt.core/search/org/eclipse/jdt/internal/core/index/impl/JarFileDocument.java;2;1;10;1;2;2;2;8;74;4;5;455;182;182;4;3;0;8;10;1039;3;4063;7;2;
/org.eclipse.search/search/org/eclipse/search/internal/ui/text/ResourcePathSorter.java;1;0;4;1;0;0;0;4;20;1;4;1117;37;37;1;0;0;4;4;1117;0;1272;4;1;
/org.eclipse.scripting/src/org/eclipse/scripting/internal/RegistryWriter.java;1;0;1;1;0;0;0;1;0;0;1;1424;0;0;1;0;0;1;1;1424;0;1424;1;1;
/org.eclipse.ui/Eclipse UI/org/eclipse/ui/internal/dialogs/CreateProjectWizard.java;2;0;5;1;1;1;1;4;13;1;4;3211;33;33;1;0;0;4;5;3211;0;4082;5;2;
/org.eclipse.team.ftp/src/org/eclipse/team/internal/ftp/Policy.java;1;1;5;1;5;5;5;0;11;0;0;4169;29;29;1;0;0;0;5;4169;0;4573;5;1;
/org.eclipse.ui/Eclipse UI/org/eclipse/ui/internal/dialogs/StartupPreferencePage.java;2;1;2;1;2;2;2;0;41;0;0;4149;41;41;1;0;0;0;2;4149;0;4608;2;2;
/org.eclipse.jdt.ui.tests.refactoring/resources/SafeDeleteType/testFail5/in/A.java;1;0;1;1;0;0;0;1;0;0;1;49;0;0;1;0;0;1;1;49;0;49;1;1;
/org.eclipse.compare/compare/org/eclipse/patch/PatchWizard.java;1;0;4;1;0;0;0;4;27;1;4;1419;42;42;1;0;0;4;4;1419;0;1516;4;1;
/org.eclipse.update.core/src/org/eclipse/update/internal/core/DefaultFeature.java;1;0;1;1;0;0;0;1;0;0;1;2448;0;0;1;0;0;1;1;2448;0;2448;1;1;
/org.eclipse.jdt.debug/jdi/org/eclipse/jdi/internal/TypeImpl.java;3;0;12;2;0;0;0;12;111;1;12;187;230;230;1;0;0;12;12;187;0;3678;12;3;
/org.eclipse.jdt.ui.tests.refactoring/resources/RenameParameters/canRename/A_test15_out.java;1;0;1;1;0;0;0;1;0;0;1;233;0;0;1;0;0;1;1;233;0;233;1;1;
/org.eclipse.jdt.ui.tests.refactoring/resources/ExtractMethodWorkSpace/ExtractMethodTests/try_out/A_test455.java;2;1;4;1;2;2;2;2;10;1;2;511;12;12;1;0;0;2;4;511;0;4419;4;2;
/org.eclipse.search/search/org/eclipse/search/internal/core/text/TypedResourceVisitor.java;2;0;5;1;1;1;1;4;44;1;4;15;58;58;1;0;0;4;5;15;0;4034;5;2;
/org.eclipse.jdt.debug/jdi interfaces/com/sun/jdi/request/InvalidRequestStateException.java;2;0;2;1;0;0;0;2;4;1;2;2704;4;4;1;0;0;2;2;2704;0;3040;2;2;
/org.eclipse.jdt.core/model/org/eclipse/jdt/internal/core/builder/impl/JCUNode.java;1;0;10;1;0;0;0;10;16;4;6;455;34;34;4;4;0;10;10;1039;4;2808;6;1;
/org.eclipse.swt/Eclipse SWT/motif/org/eclipse/swt/widgets/ColorDialog.java;5;1;11;1;3;3;3;8;230;1;8;106;495;495;1;0;0;8;11;106;0;4701;11;5;
/org.eclipse.pde.runtime/Eclipse PDE Runtime/org/eclipse/pde/internal/runtime/logview/LogView.java;2;0;3;1;0;0;0;3;4;1;3;267;4;4;1;0;0;3;3;267;0;1434;3;2;
/org.eclipse.pde.ui/templates/editor/java/NonRuleBasedDamagerRepairer.java;1;0;2;1;1;1;1;1;4;0;1;3870;4;4;1;0;0;1;2;3870;0;4316;2;1;
/org.eclipse.core.runtime/src/org/eclipse/core/runtime/QualifiedName.java;4;1;6;1;2;2;2;4;206;1;4;12;235;235;1;0;0;4;6;12;0;4552;6;4;
/org.eclipse.update/Eclipse Update/org/eclipse/update/internal/ui/JarVerificationDialog.java;2;0;4;1;0;0;0;4;319;1;4;108;323;323;1;0;0;4;4;108;0;1424;4;2;
/org.eclipse.swt.examples.controls/src/org/eclipse/swt/examples/controls/ProgressBarTab.java;2;0;2;1;0;0;0;2;0;1;2;391;0;0;1;0;0;2;2;391;0;611;2;2;
/org.eclipse.jdt.ui/ui refactoring/org/eclipse/jdt/internal/ui/refactoring/RefactoringWizardDialog.java;3;1;7;1;3;3;3;4;44;1;4;15;88;88;1;0;0;4;7;15;0;4076;7;3;
/org.eclipse.ui/Eclipse UI Standard Components/org/eclipse/ui/views/properties/IPropertySheetPage.java;2;0;2;1;0;0;0;2;5;1;2;257;5;5;1;0;0;2;2;257;0;457;2;2;
/org.eclipse.team.cvs.core/src/org/eclipse/team/internal/ccvs/core/client/AbstractStructureVisitor.java;2;1;19;2;2;2;2;17;168;2;15;2572;391;391;2;2;0;17;19;3089;2;4111;17;2;
/org.eclipse.team.ftp/src/org/eclipse/team/internal/ftp/client/Util.java;2;1;4;1;4;4;4;0;257;0;0;4169;276;276;1;0;0;0;4;4169;0;4731;4;2;
/org.eclipse.jdt.ui.tests.refactoring/resources/DeleteSourceReference/test14/in/A.java;1;0;1;1;0;0;0;1;0;0;1;2859;0;0;1;0;0;1;1;2859;0;2859;1;1;
/org.eclipse.jdt.debug/jdi interfaces/com/sun/jdi/Accessible.java;2;0;2;1;0;0;0;2;4;1;2;2704;4;4;1;0;0;2;2;2704;0;3033;2;2;
/org.eclipse.jdt.ui.tests.refactoring/resources/ExtractMethodWorkSpace/ExtractMethodTests/locals_in/A_test560.java;1;1;3;1;2;2;2;1;24;0;1;1236;24;24;1;0;0;1;3;1236;0;4419;3;1;
/org.eclipse.core.tests.runtime/src/org/eclipse/core/tests/internal/runtimetests/SampleOFR.java;1;0;2;1;0;0;0;2;10;1;2;3611;10;10;1;0;0;2;2;3611;0;3678;2;1;
/org.eclipse.vcm.tests.core.cvs/src/org/eclipse/vcm/tests/core/cvs/AllTests.java;2;0;2;1;0;0;0;2;2;1;2;1688;2;2;1;0;0;2;2;1688;0;1978;2;2;
/org.eclipse.team.examples.filesystem/src/org/eclipse/team/examples/filesystem/Policy.java;1;0;1;1;1;1;1;0;0;0;0;4674;0;0;1;0;0;0;1;4674;0;4674;1;1;
/org.eclipse.pde.ui/Eclipse PDE UI/org/eclipse/pde/internal/editor/schema/EnumerationRestrictionPage.java;2;0;5;2;0;0;0;5;12;3;3;267;12;12;3;2;0;5;5;324;2;1434;3;2;
/org.eclipse.jdt.ui.tests.refactoring/resources/PullUp/testFail7/in/A.java;1;0;1;1;0;0;0;1;0;0;1;2406;0;0;1;0;0;1;1;2406;0;2406;1;1;
/org.eclipse.swt.examples.controls/org/eclipse/swt/examples/controls/RangeTab.java;2;0;3;1;0;0;0;3;161;1;3;513;161;161;1;0;0;3;3;513;0;970;3;2;
/org.eclipse.pde.build/src/org/eclipse/pde/internal/build/ModelScriptGenerator.java;1;0;1;1;0;0;0;1;0;0;1;2939;0;0;1;0;0;1;1;2939;0;2939;1;1;
/org.eclipse.jdt.debug/jdi/org/eclipse/jdi/internal/PrimitiveTypeImpl.java;2;0;4;1;0;0;0;4;12;1;4;187;28;28;1;0;0;4;4;187;0;3678;4;2;
/org.eclipse.jdt.ui.tests.refactoring/resources/ExtractMethodWorkSpace/ExtractMethodTests/semicolon_out/A_test402.java;2;1;3;1;2;2;2;1;0;0;1;49;0;0;1;0;0;1;3;49;0;4419;3;2;
/org.eclipse.swt/Eclipse SWT PI/win32/org/eclipse/swt/internal/win32/DRAWITEMSTRUCT.java;2;0;2;1;1;1;1;1;6;0;1;2069;6;6;1;0;0;1;2;2069;0;4701;2;2;
/org.eclipse.swt/Eclipse SWT/gtk1x/org/eclipse/swt/widgets/Slider.java;4;0;5;1;1;1;1;4;12;1;4;2107;29;29;1;0;0;4;5;2107;0;4701;5;4;
/org.eclipse.team.cvs.core/src/org/eclipse/team/internal/ccvs/core/streams/ProgressMonitorInputStream.java;2;0;2;1;1;1;1;1;0;0;1;3574;0;0;1;0;0;1;2;3574;0;4169;2;2;
/org.eclipse.jdt.ui.tests.refactoring/resources/PullUp/test10/out/A.java;1;0;1;1;0;0;0;1;0;0;1;2406;0;0;1;0;0;1;1;2406;0;2406;1;1;
/org.eclipse.jdt.debug/model/org/eclipse/jdt/internal/debug/core/JDILocalVariable.java;4;0;15;1;0;0;0;15;34;2;14;187;156;156;2;1;0;15;15;1471;1;2517;14;4;
/org.eclipse.vcm.core.cvs/src/org/eclipse/vcm/internal/core/ccvs/requests/ILogListener.java;3;0;4;1;0;0;0;4;11;1;4;0;23;23;1;0;0;4;4;0;0;1240;4;3;
/org.eclipse.ui/Eclipse UI/org/eclipse/ui/internal/ActionExpression.java;1;0;3;1;0;0;0;3;70;2;2;2033;84;84;2;1;0;3;3;2033;1;2235;2;1;
/org.eclipse.team.cvs.ui/src/org/eclipse/team/internal/ccvs/ui/merge/VersionsElement.java;2;0;3;1;0;0;0;3;9;1;3;2641;9;9;1;0;0;3;3;2641;0;3577;3;2;
/org.eclipse.jdt.ui/ui/org/eclipse/jdt/internal/ui/snippeteditor/ISnippetStateChangedListener.java;2;0;3;1;0;0;0;3;9;1;3;15;9;9;1;0;0;3;3;15;0;1916;3;2;
/org.eclipse.ui/Eclipse UI/org/eclipse/ui/IWorkingSetManager.java;1;1;8;1;2;2;2;6;17;2;5;3494;60;60;2;1;0;6;8;3774;1;4043;7;1;
/org.eclipse.pde.ui/src/org/eclipse/pde/internal/core/ifeature/IFeatureInfo.java;1;0;2;1;0;0;0;2;0;1;2;3591;0;0;1;0;0;2;2;3591;0;3607;2;1;
/org.eclipse.swt/Eclipse SWT/photon/org/eclipse/swt/internal/photon/PgMap_t.java;2;0;3;1;0;0;0;3;6;1;3;106;6;6;1;0;0;3;3;106;0;2069;3;2;
/org.eclipse.pde.core/src/org/eclipse/pde/internal/core/IEnvironmentVariables.java;1;0;1;1;0;0;0;1;0;0;1;3591;0;0;1;0;0;1;1;3591;0;3591;1;1;
/org.eclipse.jdt.debug/jdi interfaces/com/sun/jdi/request/EventRequest.java;2;0;2;1;0;0;0;2;6;1;2;2704;6;6;1;0;0;2;2;2704;0;3040;2;2;
/org.eclipse.jdt.debug/jdi/org/eclipse/jdi/internal/request/EventRequestManagerImpl.java;4;1;10;1;2;2;2;8;53;1;8;187;112;112;1;0;0;8;10;187;0;4630;10;4;
/org.eclipse.search/search/org/eclipse/search/internal/ui/SearchPlugin.java;2;1;12;1;4;4;4;8;49;2;7;15;182;182;2;1;0;8;12;675;1;4161;11;2;
/org.eclipse.pde.ui/Eclipse PDE UI/org/eclipse/pde/internal/component/NewComponentProjectWizard.java;2;0;8;2;0;0;0;8;15;3;6;267;36;36;3;2;0;8;8;324;2;1434;6;2;
/org.eclipse.pde.build/src/org/eclipse/pde/internal/build/tasks/FetchTask.java;1;0;3;1;0;0;0;3;122;1;3;3018;122;122;1;0;0;3;3;3018;0;3509;3;1;
/org.eclipse.update.core/src/org/eclipse/update/internal/core/DefaultImport.java;2;0;2;1;0;0;0;2;0;1;2;1710;0;0;1;0;0;2;2;1710;0;2583;2;2;
/org.eclipse.pde.ui/src/org/eclipse/pde/internal/model/plugin/PluginExtensionPoint.java;1;0;2;1;0;0;0;2;0;1;2;3136;0;0;1;0;0;2;2;3136;0;3579;2;1;
/org.eclipse.scripting/src/org/eclipse/scripting/internal/uirenderer/ScriptWizard.java;1;0;1;1;0;0;0;1;0;0;1;1424;0;0;1;0;0;1;1;1424;0;1424;1;1;
/org.eclipse.update.core/src/org/eclipse/update/internal/core/URLSite.java;1;0;17;1;0;0;0;17;29;2;14;1451;201;201;2;3;0;17;17;1451;3;1791;14;1;
/org.eclipse.jdt.debug.ui/ui/org/eclipse/jdt/internal/debug/ui/launcher/RunJavaApplicationAction.java;1;1;2;1;2;2;2;0;0;0;0;3952;0;0;1;0;0;0;2;3952;0;4367;2;1;
/org.eclipse.help/src/org/eclipse/help/internal/protocols/URLHandler.java;2;0;3;1;0;0;0;3;5;1;3;2773;7;7;1;0;0;3;3;2773;0;3439;3;2;
/org.eclipse.jdt.ui/ui refactoring/org/eclipse/jdt/internal/ui/refactoring/undo/RedoRefactoringAction.java;3;0;8;1;0;0;0;8;13;1;8;15;47;47;1;0;0;8;8;15;0;1360;8;3;
/org.eclipse.swt.tests/JUnit Tests/org/eclipse/swt/tests/junit/Test_org_eclipse_swt_custom_BidiSegmentEvent.java;2;0;2;1;1;1;1;1;6;0;1;1792;6;6;1;0;0;1;2;1792;0;4706;2;2;
/org.eclipse.jdt.core/model/org/eclipse/jdt/core/eval/ICodeSnippetRequestor.java;3;2;5;1;3;2;3;2;160;1;2;455;188;188;2;0;1;2;5;4058;1;4836;4;3;
/org.eclipse.jdt.ui.tests/JUnit/junit/samples/VectorTest.java;2;0;2;1;0;0;0;2;0;1;2;49;0;0;1;0;0;2;2;49;0;1186;2;2;
/org.eclipse.pde.core/src/org/eclipse/pde/core/IModelChangedListener.java;1;0;3;1;2;1;2;1;16;0;1;3591;16;16;2;0;1;1;3;4751;1;4751;2;1;
/org.eclipse.pde.ui/src/org/eclipse/pde/internal/ui/editor/schema/CompositorPropertySource.java;1;0;2;1;0;0;0;2;2;1;2;3579;2;2;1;0;0;2;2;3579;0;3591;2;1;
/org.eclipse.jdt.launching/launching/org/eclipse/jdt/internal/launching/StandardSourcePathProvider.java;1;1;2;1;2;2;2;0;0;0;0;4126;0;0;1;0;0;0;2;4126;0;4168;2;1;
/org.eclipse.team.cvs.ui/src/org/eclipse/team/internal/ccvs/ui/model/CVSAdapterFactory.java;3;0;6;1;0;0;0;6;90;1;6;1978;139;139;1;0;0;6;6;1978;0;3610;6;3;
/org.eclipse.jdt.ui/ui/org/eclipse/jdt/internal/ui/reorg/SourceReferenceAction.java;3;1;16;2;3;3;3;13;54;2;11;2003;236;236;2;2;0;13;16;2003;2;4621;14;3;
/org.eclipse.ui/Eclipse UI/org/eclipse/ui/internal/CloseEditorAction.java;4;0;6;1;0;0;0;6;30;2;5;257;46;46;2;1;0;6;6;3212;1;3212;5;4;
/org.eclipse.pde.ui/src/org/eclipse/pde/internal/editor/manifest/PluginUndoManager.java;1;0;4;1;0;0;0;4;10;1;4;2851;13;13;1;0;0;4;4;2851;0;3579;4;1;
/org.eclipse.core.boot/src/org/eclipse/core/internal/boot/Policy.java;2;0;6;1;1;1;1;5;182;1;5;303;251;251;1;0;0;5;6;303;0;4214;6;2;
/org.eclipse.jdt.ui/ui/org/eclipse/jdt/internal/ui/text/correction/ReorgCorrectionsSubProcessor.java;3;0;7;2;2;1;2;5;50;2;4;3570;108;108;2;1;1;5;7;3570;2;4452;5;3;
/org.eclipse.core.boot/src/org/eclipse/core/internal/boot/update/ILogEntryProperty.java;2;0;3;1;0;0;0;3;7;1;3;12;7;7;1;0;0;3;3;12;0;2726;3;2;
/org.eclipse.jdt.core/model/org/eclipse/jdt/internal/core/SourceFieldElementInfo.java;2;0;3;1;1;1;1;2;93;1;2;455;113;113;1;0;0;2;3;455;0;4063;3;2;
/org.eclipse.pde.ui/src/org/eclipse/pde/internal/ui/wizards/imports/PluginImportOperation.java;1;2;14;1;10;9;10;4;147;2;3;3579;462;462;2;1;1;4;14;3631;2;4568;12;1;
/org.eclipse.jdt.core/compiler/org/eclipse/jdt/internal/compiler/parser/Scanner.java;2;0;29;1;1;1;1;28;4972;4;25;455;9419;9419;4;3;0;28;29;1039;3;4062;26;2;
/org.eclipse.jdt.core/compiler/org/eclipse/jdt/internal/compiler/util/CompoundNameVector.java;2;0;3;1;1;1;1;2;15;1;2;1764;17;17;1;0;0;2;3;1764;0;4062;3;2;
/org.eclipse.jdt.core/search/org/eclipse/jdt/internal/core/search/matching/MatchLocatorParser.java;3;1;22;1;2;2;2;20;366;4;16;455;1039;1039;4;4;0;20;22;1039;4;4165;18;3;
/org.eclipse.core.tests.resources/src/org/eclipse/core/tests/resources/session/TestSaveWithClosedProject.java;2;0;3;1;0;0;0;3;108;1;3;2390;118;118;1;0;0;3;3;2390;0;3475;3;2;
/org.eclipse.jdt.debug/jdi/org/eclipse/jdi/internal/jdwp/JdwpReplyPacket.java;3;0;4;1;0;0;0;4;12;1;4;187;25;25;1;0;0;4;4;187;0;3040;4;3;
/org.eclipse.ui/Eclipse JFace/org/eclipse/jface/viewers/Viewer.java;3;0;3;1;0;0;0;3;31;1;3;257;36;36;1;0;0;3;3;257;0;620;3;3;
/org.eclipse.jdt.ui/ui/org/eclipse/jdt/internal/ui/dialogs/TypedElementSelectionValidator.java;3;0;4;1;0;0;0;4;8;1;4;15;10;10;1;0;0;4;4;15;0;1254;4;3;
/org.eclipse.jdt.core/model/org/eclipse/jdt/internal/core/builder/impl/DependencyGraph.java;1;0;11;1;0;0;0;11;447;4;7;455;599;599;4;4;0;11;11;1039;4;2808;7;1;
/org.eclipse.jdt.debug/eval/org/eclipse/jdt/internal/debug/eval/ast/engine/NoOp.java;1;0;2;1;0;0;0;2;0;1;2;3329;0;0;1;0;0;2;2;3329;0;3421;2;1;
/org.eclipse.jdt.ui.tests/ui/org/eclipse/jdt/ui/tests/TypeRefTest.java;2;0;4;1;0;0;0;4;6;2;3;522;9;9;2;1;0;4;4;1186;1;1186;3;2;
/org.eclipse.swt/Eclipse SWT/motif/org/eclipse/swt/widgets/Label.java;10;1;21;1;4;4;4;17;393;2;15;106;937;937;2;2;0;17;21;1099;2;4701;19;10;
/org.eclipse.scripting/Eclipse Scripting/org/eclipse/scripting/Renderer.java;2;0;5;1;0;0;0;5;20;1;5;133;30;30;1;0;0;5;5;133;0;1424;5;2;
/org.eclipse.ui/Eclipse UI Text Editor/org/eclipse/ui/texteditor/BasicMarkerUpdater.java;3;0;4;1;0;0;0;4;28;1;4;257;38;38;1;0;0;4;4;257;0;1320;4;3;
/org.eclipse.jdt.ui.tests.refactoring/resources/ExtractMethodWorkSpace/ExtractMethodTests/try_out/A_test461.java;1;1;3;1;2;2;2;1;32;0;1;2634;32;32;1;0;0;1;3;2634;0;4419;3;1;
/org.eclipse.pde.core/src/org/eclipse/pde/internal/core/feature/FeatureImport.java;1;0;2;1;1;1;1;1;25;0;1;3591;25;25;1;0;0;1;2;3591;0;3994;2;1;
/org.eclipse.pde.core/src/org/eclipse/pde/internal/core/PluginModelDelta.java;1;0;1;1;0;0;0;1;0;0;1;3591;0;0;1;0;0;1;1;3591;0;3591;1;1;
/org.eclipse.help.tests/src/org/eclipse/help/tests/base/TestLogFile.java;1;0;2;1;0;0;0;2;4;1;2;1805;4;4;1;0;0;2;2;1805;0;1857;2;1;
/org.eclipse.core.tests.resources/src/org/eclipse/core/tests/resources/regression/IProjectTest.java;3;0;4;1;1;1;1;3;422;1;3;1794;447;447;1;0;0;3;4;1794;0;4516;4;3;
/org.eclipse.swt/Eclipse SWT/win32/org/eclipse/swt/graphics/Device.java;6;1;7;2;2;2;2;5;64;2;4;106;90;90;2;1;0;5;7;1608;1;4701;6;6;
/org.eclipse.swt/Eclipse SWT/photon/org/eclipse/swt/widgets/Header.java;2;0;4;1;0;0;0;4;10;1;4;106;16;16;1;0;0;4;4;106;0;1088;4;2;
/org.eclipse.ui/Eclipse JFace Text/org/eclipse/jface/text/ITextHover.java;4;0;4;1;1;1;1;3;7;1;3;257;15;15;1;0;0;3;4;257;0;4377;4;4;
/org.eclipse.jdt.ui/ui/org/eclipse/jdt/internal/ui/util/TypeRefLabelProvider.java;3;0;5;1;0;0;0;5;33;1;5;15;45;45;1;0;0;5;5;15;0;1258;5;3;
/org.eclipse.jdt.ui.tests.refactoring/resources/ExtractMethodWorkSpace/ExtractMethodTests/expression_in/A_test604.java;2;1;3;1;2;2;2;1;14;0;1;239;14;14;1;0;0;1;3;239;0;4419;3;2;
/org.eclipse.ui/Eclipse UI/org/eclipse/ui/internal/QuickStartAction.java;4;2;10;1;5;4;5;5;92;1;5;257;256;256;2;0;1;5;10;4823;1;4823;9;4;
/org.eclipse.jdt.ui/ui/org/eclipse/jdt/ui/actions/IJavaEditorActionDefinitionIds.java;3;1;3;1;3;3;3;0;268;0;0;4116;269;269;1;0;0;0;3;4116;0;4770;3;3;
/org.eclipse.jdt.core/model/org/eclipse/jdt/internal/core/RenameResourceElementsOperation.java;3;0;10;1;1;1;1;9;86;4;6;455;121;121;4;3;0;9;10;1039;3;4063;7;3;
/org.eclipse.jdt.ui/ui/org/eclipse/jdt/internal/ui/reorg/PasteSourceReferencesFromClipboardAction.java;2;2;10;2;3;2;3;7;75;2;6;3222;155;155;2;1;1;7;10;3826;2;4621;8;2;
/org.eclipse.jdt.ui/ui/org/eclipse/jdt/internal/ui/text/java/JavaTextMessages.java;1;0;1;1;0;0;0;1;0;0;1;770;0;0;1;0;0;1;1;770;0;770;1;1;
/org.eclipse.jdt.ui/core refactoring/org/eclipse/jdt/internal/corext/refactoring/UndoManager.java;1;1;3;1;2;2;2;1;53;0;1;1939;57;57;1;0;0;1;3;1939;0;4379;3;1;
/org.eclipse.jdt.debug/jdi/org/eclipse/jdi/internal/LongValueImpl.java;2;0;4;1;0;0;0;4;19;1;4;187;37;37;1;0;0;4;4;187;0;3670;4;2;
/org.eclipse.team.tests.cvs.core/src/org/eclipse/team/tests/ccvs/ui/logformatter/LogFormatterUIMain.java;1;0;1;1;0;0;0;1;0;0;1;3452;0;0;1;0;0;1;1;3452;0;3452;1;1;
/org.eclipse.jdt.ui.tests.refactoring/resources/ExtractMethodWorkSpace/ExtractMethodTests/invalidSelection/A_test147.java;1;1;3;1;2;2;2;1;32;0;1;887;32;32;1;0;0;1;3;887;0;4419;3;1;
/org.eclipse.jdt.ui/ui refactoring/org/eclipse/jdt/internal/ui/refactoring/ErrorWizardPage.java;4;1;23;1;5;5;5;18;415;3;15;15;858;858;3;3;0;18;23;408;3;4621;20;4;
/org.eclipse.pde.ui/Eclipse PDE UI/org/eclipse/pde/internal/editor/schema/SchemaAdapterFactory.java;2;0;5;2;0;0;0;5;12;3;3;267;12;12;3;2;0;5;5;324;2;1434;3;2;
/org.eclipse.jdt.ui/ui/org/eclipse/jdt/internal/ui/viewsupport/JavaProblemMarkerFilter.java;1;0;2;1;0;0;0;2;0;1;2;1010;0;0;1;0;0;2;2;1010;0;1048;2;1;
/org.eclipse.compare/compare/org/eclipse/compare/internal/ShowPseudoConflicts.java;2;0;3;1;0;0;0;3;5;1;3;14;7;7;1;0;0;3;3;14;0;761;3;2;
/org.eclipse.help.ui/Eclipse Help UI/org/eclipse/help/internal/ui/ElementLabelProvider.java;2;0;4;1;0;0;0;4;14;1;4;136;21;21;1;0;0;4;4;136;0;1420;4;2;
/org.eclipse.jdt.ui.tests.refactoring/test cases/org/eclipse/jdt/ui/tests/refactoring/SurroundWithTests.java;1;1;7;1;2;2;2;5;22;1;5;2327;56;56;1;0;0;5;7;2327;0;4424;7;1;
/org.eclipse.jdt.ui.tests.refactoring/resources/ExtractMethodWorkSpace/ExtractMethodTests/validSelection/A_test233.java;2;1;3;1;2;2;2;1;0;0;1;49;0;0;1;0;0;1;3;49;0;4419;3;2;
/org.eclipse.ui/Eclipse UI/org/eclipse/ui/internal/dialogs/InternalErrorDialog.java;2;0;7;1;1;1;1;6;44;1;6;2795;65;65;1;0;0;6;7;2795;0;4431;7;2;
/org.eclipse.jdt.ui.tests.refactoring/test cases/org/eclipse/jdt/ui/tests/actions/DeleteSourceReferenceActionTests.java;1;2;10;1;5;4;5;5;114;2;4;2857;210;210;2;1;1;5;10;2857;2;4383;8;1;
/org.eclipse.core.tests.runtime/src/org/eclipse/core/tests/internal/plugins/CircularTest.java;4;0;4;1;1;1;1;3;186;1;3;1794;198;198;1;0;0;3;4;1794;0;4449;4;4;
/org.eclipse.jdt.core/search/org/eclipse/jdt/internal/core/index/impl/CodeByteStream.java;2;0;3;1;1;1;1;2;251;1;2;455;267;267;1;0;0;2;3;455;0;4063;3;2;
/org.eclipse.swt/Eclipse SWT PI/motif/org/eclipse/swt/internal/motif/XImage.java;2;0;2;1;1;1;1;1;6;0;1;2069;6;6;1;0;0;1;2;2069;0;4701;2;2;
/org.eclipse.jdt.ui.tests.refactoring/resources/PullUp/test8/out/A.java;1;0;1;1;0;0;0;1;0;0;1;2406;0;0;1;0;0;1;1;2406;0;2406;1;1;
/org.eclipse.pde.ui/src/org/eclipse/pde/internal/ui/launcher/RuntimeWorkbenchShortcut.java;1;3;9;1;9;5;9;0;18;0;0;4413;26;26;3;0;4;0;9;4449;4;4635;5;1;
/org.eclipse.jdt.core/search/org/eclipse/jdt/internal/core/search/matching/SuperTypeReferencePattern.java;3;0;15;1;1;1;1;14;768;4;10;455;1641;1641;4;4;0;14;15;1039;4;4063;11;3;
/org.eclipse.jdt.launching/launching/org/eclipse/jdt/internal/launching/JRERuntimeClasspathEntryResolver.java;2;3;8;1;8;6;8;0;29;0;0;4087;87;87;3;0;2;0;8;4210;2;4451;6;2;
/org.eclipse.ant.ui/src/org/eclipse/ant/internal/ui/toolscripts/ChooseToolScriptPage.java;1;0;3;1;0;0;0;3;48;2;2;2933;48;48;2;1;0;3;3;2933;1;2979;2;1;
/org.eclipse.swt/Eclipse SWT Custom Widgets/common/org/eclipse/swt/custom/DisplayRenderer.java;2;0;3;1;1;1;1;2;490;1;2;3105;497;497;1;0;0;2;3;3105;0;4701;3;2;
/org.eclipse.scripting/src/org/eclipse/scripting/internal/IXGRElementContainer.java;1;0;1;1;0;0;0;1;0;0;1;1424;0;0;1;0;0;1;1;1424;0;1424;1;1;
/org.eclipse.core.resources/src/org/eclipse/core/internal/utils/Sorter.java;1;0;4;1;1;1;1;3;124;1;3;12;144;144;1;0;0;3;4;12;0;4214;4;1;
/org.eclipse.jdt.ui.tests.refactoring/resources/MoveMembers/testFail23/in/A.java;1;0;1;1;0;0;0;1;0;0;1;2928;0;0;1;0;0;1;1;2928;0;2928;1;1;
/org.eclipse.jdt.debug.ui/ui/org/eclipse/jdt/internal/debug/ui/launcher/ZipTreeNode.java;1;0;1;1;1;1;1;0;0;0;0;4101;0;0;1;0;0;0;1;4101;0;4101;1;1;
/org.eclipse.jdt.core/codeassist/org/eclipse/jdt/internal/codeassist/complete/CompletionOnExplicitConstructorCall.java;2;0;9;1;1;1;1;8;72;4;5;455;194;194;4;3;0;8;9;1039;3;4062;6;2;
/org.eclipse.team.tests.cvs.core/src/org/eclipse/team/tests/ccvs/core/cvsresources/AllTestsCVSResources.java;1;0;3;1;0;0;0;3;3;1;3;3287;5;5;1;0;0;3;3;3287;0;3323;3;1;
/org.eclipse.help/Eclipse Help/org/eclipse/help/internal/util/DocResources.java;3;0;7;1;0;0;0;7;167;1;7;135;226;226;1;0;0;7;7;135;0;1085;7;3;
/org.eclipse.ui/Eclipse UI/org/eclipse/ui/internal/SaveAction.java;4;0;6;1;0;0;0;6;38;2;5;257;58;58;2;1;0;6;6;3212;1;3212;5;4;
/org.eclipse.ui/Eclipse JFace/org/eclipse/jface/viewers/IInputProvider.java;2;0;2;1;0;0;0;2;5;1;2;257;5;5;1;0;0;2;2;257;0;457;2;2;
/org.eclipse.update.tests.core/src/org/eclipse/update/tests/api/DefaultFeature.java;2;0;4;1;0;0;0;4;147;1;4;2546;171;171;1;0;0;4;4;2546;0;2994;4;2;
/org.eclipse.jdt.ui/core refactoring/org/eclipse/jdt/internal/core/refactoring/changes/CopyCompilationUnitChange.java;2;0;4;1;0;0;0;4;77;1;4;1108;77;77;1;0;0;4;4;1108;0;1939;4;2;
/org.eclipse.update.core/src/org/eclipse/update/internal/core/Writer.java;1;0;7;1;0;0;0;7;171;1;7;1948;231;231;1;0;0;7;7;1948;0;3796;7;1;
/org.eclipse.jdt.ui/ui debug/org/eclipse/jdt/internal/debug/ui/AccessWatchpointToggleAction.java;2;0;5;1;0;0;0;5;11;1;5;965;15;15;1;0;0;5;5;965;0;1916;5;2;
/org.eclipse.compare/compare/org/eclipse/compare/internal/patch/LineReader.java;1;0;2;1;1;1;1;1;15;0;1;2876;15;15;1;0;0;1;2;2876;0;4570;2;1;
/org.eclipse.jdt.ui/ui refactoring/org/eclipse/jdt/internal/ui/nls/ExternalizeWizard.java;1;0;2;1;0;0;0;2;0;1;2;1913;0;0;1;0;0;2;2;1913;0;1922;2;1;
/org.eclipse.team.cvs.core/src/org/eclipse/team/internal/ccvs/core/resources/api/FolderProperties.java;3;0;3;1;0;0;0;3;243;1;3;1978;243;243;1;0;0;3;3;1978;0;2156;3;3;
/org.eclipse.pde.build/src/org/eclipse/pde/internal/build/FetchTask.java;2;0;4;1;0;0;0;4;6;1;4;1331;11;11;1;0;0;4;4;1331;0;3089;4;2;
/org.eclipse.jdt.ui.tests.refactoring/resources/RenameType/testFail67/in/A.java;1;0;1;1;0;0;0;1;0;0;1;49;0;0;1;0;0;1;1;49;0;49;1;1;
/org.eclipse.jdt.ui/core refactoring/org/eclipse/jdt/internal/corext/refactoring/rename/RenameJavaProjectRefactoring.java;2;0;7;1;0;0;0;7;38;1;7;1939;105;105;1;0;0;7;7;1939;0;3678;7;2;
/org.eclipse.jdt.ui.tests.refactoring/resources/RenameTemp/canRename/A_test13_in.java;1;0;2;1;0;0;0;2;2;1;2;1625;2;2;1;0;0;2;2;1625;0;1652;2;1;
/org.eclipse.jdt.ui/ui/org/eclipse/jdt/internal/ui/packageview/IFrameSource.java;1;0;3;1;0;0;0;3;4;1;3;213;4;4;1;0;0;3;3;213;0;390;3;1;
/org.eclipse.jdt.debug.ui/ui/org/eclipse/jdt/internal/debug/ui/JDIAttachLauncherWizard.java;2;0;5;1;0;0;0;5;37;1;5;1915;49;49;1;0;0;5;5;1915;0;3634;5;2;
/org.eclipse.pde.ui/Eclipse PDE UI/org/eclipse/pde/internal/editor/IOpenablePropertySource.java;2;0;5;2;0;0;0;5;12;3;3;267;12;12;3;2;0;5;5;324;2;1434;3;2;
/org.eclipse.swt/Eclipse SWT/photon/org/eclipse/swt/graphics/GC.java;7;3;25;1;8;5;8;17;824;2;16;106;2099;2099;3;1;3;17;25;4188;4;4701;21;7;
/org.eclipse.jdt.ui.tests.refactoring/resources/MoveCU/test/in/p/A.java;2;0;2;1;0;0;0;2;0;1;2;49;0;0;1;0;0;2;2;49;0;2769;2;2;
/org.eclipse.jdt.ui.tests.refactoring/resources/RenameType/test8/in/A.java;1;0;1;1;0;0;0;1;0;0;1;49;0;0;1;0;0;1;1;49;0;49;1;1;
/org.eclipse.swt/Eclipse SWT OLE Win32/win32/org/eclipse/swt/internal/ole/win32/IPersist.java;2;0;3;1;0;0;0;3;5;1;3;106;5;5;1;0;0;3;3;106;0;2069;3;2;
/org.eclipse.jdt.debug/jdi interfaces/com/sun/jdi/event/AccessWatchpointEvent.java;2;0;2;1;0;0;0;2;6;1;2;2704;6;6;1;0;0;2;2;2704;0;3040;2;2;
/org.eclipse.pde.ui/src/org/eclipse/pde/internal/ui/view/PluginsDragAdapter.java;1;0;1;1;0;0;0;1;0;0;1;3579;0;0;1;0;0;1;1;3579;0;3579;1;1;
/org.eclipse.jdt.ui/ui/org/eclipse/jdt/internal/ui/wizards/buildpaths/CPListElementSorter.java;3;0;5;1;1;1;1;4;34;1;4;224;42;42;1;0;0;4;5;224;0;4083;5;3;
/org.eclipse.core.resources/src/org/eclipse/core/internal/indexing/Reservation.java;2;0;4;1;1;1;1;3;100;1;3;448;127;127;1;0;0;3;4;448;0;4214;4;2;
/org.eclipse.help/Eclipse Help/org/eclipse/help/internal/util/HelpVisitor.java;2;0;3;1;0;0;0;3;7;1;3;135;7;7;1;0;0;3;3;135;0;978;3;2;
/org.eclipse.jdt.core/model/org/eclipse/jdt/core/IClasspathContainer.java;2;2;11;1;6;5;6;5;84;4;2;3850;114;114;4;3;1;5;11;3872;4;4058;7;2;
/org.eclipse.debug.ui/ui/org/eclipse/debug/internal/ui/views/variables/VariablesViewEventHandler.java;1;1;4;1;4;4;4;0;132;0;0;3975;156;156;1;0;0;0;4;3975;0;4404;4;1;
/org.eclipse.swt/Eclipse SWT PI/photon/org/eclipse/swt/internal/photon/PhCursorInfo_t.java;2;0;2;1;1;1;1;1;6;0;1;2069;6;6;1;0;0;1;2;2069;0;4701;2;2;
/org.eclipse.jdt.ui/ui/org/eclipse/jdt/internal/ui/reorg/DeleteSourceReferencesAction.java;3;2;26;2;5;4;5;21;82;2;17;2003;599;599;2;4;1;21;26;2003;5;4643;21;3;
/org.eclipse.jdt.core/search/org/eclipse/jdt/internal/core/search/matching/AndPattern.java;2;0;3;1;1;1;1;2;169;1;2;455;196;196;1;0;0;2;3;455;0;4063;3;2;
/org.eclipse.update.core/src/org/eclipse/update/internal/model/SiteLocalModel.java;2;0;3;1;1;1;1;2;6;0;1;3027;10;10;2;1;0;2;3;3027;1;4615;2;2;
/org.eclipse.vcm.core.cvs.ssh/src/org/eclipse/vcm/internal/core/ccvs/ssh/Blowfish.java;2;0;3;1;0;0;0;3;149;1;3;111;153;153;1;0;0;3;3;111;0;298;3;2;
/org.eclipse.jdt.ui.tests.refactoring/resources/RenameType/test33/out/A.java;1;0;2;1;0;0;0;2;0;1;2;49;0;0;1;0;0;2;2;49;0;522;2;1;
/org.eclipse.jdt.debug/jdi interfaces/com/sun/jdi/event/LocatableEvent.java;2;0;2;1;0;0;0;2;7;1;2;2704;7;7;1;0;0;2;2;2704;0;3040;2;2;
/org.eclipse.swt/Eclipse SWT/gtk1x/org/eclipse/swt/widgets/Text.java;4;0;5;2;1;1;1;4;6;2;3;2107;19;19;2;1;0;4;5;2107;1;4701;4;4;
/org.eclipse.ui.examples.javaeditor/Java Editor Example/org/eclipse/ui/examples/javaeditor/JavaActionContributor.java;1;0;2;1;0;0;0;2;0;0;1;1066;0;0;2;1;0;2;2;1066;1;1066;1;1;
/org.eclipse.jdt.ui.tests.refactoring/test cases/org/eclipse/jdt/ui/tests/refactoring/MySetup.java;2;0;2;1;0;0;0;2;3;1;2;1896;3;3;1;0;0;2;2;1896;0;2017;2;2;
/org.eclipse.debug.core/core/org/eclipse/debug/core/model/IRegister.java;2;0;4;1;0;0;0;4;7;1;4;1950;13;13;1;0;0;4;4;1950;0;3474;4;2;
/org.eclipse.jdt.ui/core refactoring/org/eclipse/jdt/core/refactoring/methods/RenameParametersRefactoring.java;1;0;9;1;0;0;0;9;16;2;5;233;34;34;2;4;0;9;9;233;4;408;5;1;
/org.eclipse.jdt.debug.tests/testprograms/org/eclipse/debug/tests/targets/Watchpoint.java;2;0;2;1;1;1;1;1;14;0;1;3719;14;14;1;0;0;1;2;3719;0;4571;2;2;
/org.eclipse.jdt.ui/ui/org/eclipse/jdt/internal/ui/snippeteditor/SnippetMessages.java;2;0;2;1;0;0;0;2;0;1;2;762;0;0;1;0;0;2;2;762;0;1916;2;2;
/org.eclipse.ui/Eclipse UI/org/eclipse/ui/actions/ShowMenuAction.java;1;0;2;1;0;0;0;2;0;1;2;1832;0;0;1;0;0;2;2;1832;0;1863;2;1;
/org.eclipse.pde.ui/templates/view/java/SampleView.java;1;0;4;1;0;0;0;4;50;1;4;3388;53;53;1;0;0;4;4;3388;0;3425;4;1;
/org.eclipse.search/search/org/eclipse/search/internal/ui/text/ReplaceAction.java;1;1;3;1;3;3;3;0;76;0;0;4147;78;78;1;0;0;0;3;4147;0;4763;3;1;
/org.eclipse.vcm.ui.cvs/src/org/eclipse/vcm/internal/ui/ccvs/NewRepositoryConnectionAction.java;1;0;1;1;0;0;0;1;0;0;1;419;0;0;1;0;0;1;1;419;0;419;1;1;
/org.eclipse.swt.tests/JUnit Tests/org/eclipse/swt/tests/junit/Test_org_eclipse_swt_custom_LineBackgroundEvent.java;2;0;2;1;1;1;1;1;6;0;1;1792;6;6;1;0;0;1;2;1792;0;4706;2;2;
/org.eclipse.ui/Eclipse JFace Text/org/eclipse/jface/text/TypedPosition.java;3;0;3;1;0;0;0;3;22;1;3;257;27;27;1;0;0;3;3;257;0;1066;3;3;
/org.eclipse.jdt.debug/eval/org/eclipse/jdt/internal/debug/eval/ast/engine/JavaObjectRuntimeContext.java;1;0;1;1;0;0;0;1;0;0;1;3645;0;0;1;0;0;1;1;3645;0;3645;1;1;
/org.eclipse.ui/Eclipse JFace Text/org/eclipse/jface/text/contentassist/IContentAssistProcessor.java;3;0;3;1;0;0;0;3;19;1;3;257;24;24;1;0;0;3;3;257;0;1066;3;3;
/org.eclipse.help/src/org/eclipse/help/internal/search/SearchQuery.java;3;2;12;1;3;2;3;9;233;1;9;2318;310;310;2;0;1;9;12;4000;1;4433;11;3;
/org.eclipse.jdt.ui/ui refactoring/org/eclipse/jdt/internal/ui/refactoring/CheckConditionsOperation.java;2;0;5;1;1;1;1;4;5;1;4;15;15;15;1;0;0;4;5;15;0;4400;5;2;
/org.eclipse.compare/compare/org/eclipse/compare/contentmergeviewer/IMergeViewerContentProvider.java;1;0;2;1;0;0;0;2;5;1;2;14;5;5;1;0;0;2;2;14;0;329;2;1;
/org.eclipse.swt/Eclipse SWT PI/win32/org/eclipse/swt/internal/win32/NMREBARCHEVRON.java;2;0;2;1;1;1;1;1;6;0;1;3398;6;6;1;0;0;1;2;3398;0;4701;2;2;
/org.eclipse.jdt.ui/ui refactoring/org/eclipse/jdt/internal/ui/refactoring/IChangeElementChildrenCreator.java;1;0;2;1;0;0;0;2;2;1;2;1800;2;2;1;0;0;2;2;1800;0;1939;2;1;
/org.eclipse.jdt.debug.tests/test programs/GotNewName.java;1;0;2;1;0;0;0;2;0;1;2;3701;0;0;1;0;0;2;2;3701;0;3719;2;1;
/org.eclipse.swt/Eclipse SWT/win32/org/eclipse/swt/widgets/Caret.java;6;2;10;1;4;3;4;6;51;1;6;106;127;127;2;0;1;6;10;4557;1;4701;9;6;
/org.eclipse.jdt.ui.tests.refactoring/resources/SelectionAnalyzerWorkSpace/SelectionAnalyzerTests/selection/A_test1.java;1;0;1;1;0;0;0;1;0;0;1;1368;0;0;1;0;0;1;1;1368;0;1368;1;1;
/org.eclipse.scripting/src/org/eclipse/scripting/internal/uirenderer/IScriptContributionNode.java;1;0;1;1;0;0;0;1;0;0;1;1424;0;0;1;0;0;1;1;1424;0;1424;1;1;
/org.eclipse.jdt.ui.tests.refactoring/resources/SelectionAnalyzerWorkSpace/SelectionAnalyzerTests/invalidSelection/A_test144.java;2;0;2;1;0;0;0;2;0;1;2;1368;0;0;1;0;0;2;2;1368;0;2139;2;2;
/org.eclipse.webdav/src/kernel/org/eclipse/webdav/internal/kernel/StateToken.java;3;0;6;1;1;1;1;5;248;1;5;12;493;493;1;0;0;5;6;12;0;4211;6;3;
/org.eclipse.jdt.ui/core refactoring/org/eclipse/jdt/internal/core/refactoring/cus/RenameCompilationUnitRefactoring.java;3;0;12;1;0;0;0;12;149;2;11;408;258;258;2;1;0;12;12;408;1;1342;11;3;
/org.eclipse.help/src/org/eclipse/help/internal/ContextImpl.java;2;0;2;1;0;0;0;2;0;1;2;1420;0;0;1;0;0;2;2;1420;0;1675;2;2;
/org.eclipse.jdt.debug/jdi interfaces/com/sun/jdi/connect/Connector.java;2;0;2;1;0;0;0;2;42;1;2;2704;42;42;1;0;0;2;2;2704;0;3033;2;2;
/org.eclipse.swt/Eclipse SWT Drag and Drop/win32/org/eclipse/swt/dnd/Transfer.java;2;1;5;1;2;2;2;3;106;1;3;106;155;155;1;0;0;3;5;106;0;4701;5;2;
/org.eclipse.pde.runtime/Eclipse PDE Runtime/org/eclipse/pde/internal/runtime/registry/RegistryBrowserLabelProvider.java;2;0;3;1;0;0;0;3;4;1;3;267;4;4;1;0;0;3;3;267;0;1434;3;2;
/org.eclipse.scripting/src/org/eclipse/scripting/internal/uirenderer/XGRElementUISwtLabel.java;1;0;1;1;0;0;0;1;0;0;1;1424;0;0;1;0;0;1;1;1424;0;1424;1;1;
/org.eclipse.ui/Eclipse JFace/org/eclipse/jface/preference/IntegerFieldEditor.java;3;0;5;1;1;1;1;4;14;1;4;257;25;25;1;0;0;4;5;257;0;4449;5;3;
/org.eclipse.jdt.core/model/org/eclipse/jdt/internal/core/builder/IncompleteClassPathException.java;2;0;3;1;1;1;1;2;9;1;2;2979;9;9;1;0;0;2;3;2979;0;4007;3;2;
/org.eclipse.swt/Eclipse SWT PI/motif/org/eclipse/swt/internal/motif/XFocusChangeEvent.java;2;0;2;1;1;1;1;1;6;0;1;2069;6;6;1;0;0;1;2;2069;0;4701;2;2;
/org.eclipse.jdt.junit/src/org/eclipse/jdt/internal/junit/ui/TestRunInfo.java;1;0;1;1;0;0;0;1;0;0;1;3171;0;0;1;0;0;1;1;3171;0;3171;1;1;
/org.eclipse.help/src/org/eclipse/help/internal/protocols/PluginURL.java;2;0;4;1;0;0;0;4;4;1;4;3095;8;8;1;0;0;4;4;3095;0;3776;4;2;
/org.eclipse.jdt.ui.tests.refactoring/resources/RenameMethodInInterface/test45/out/A.java;1;0;1;1;0;0;0;1;0;0;1;548;0;0;1;0;0;1;1;548;0;548;1;1;
/org.eclipse.jdt.ui/core refactoring/org/eclipse/jdt/internal/core/refactoring/util/Selection.java;1;0;4;1;0;0;0;4;49;1;4;1236;53;53;1;0;0;4;4;1236;0;1939;4;1;
/org.eclipse.ui/Eclipse UI/org/eclipse/ui/internal/KeyBindingService.java;2;0;10;1;0;0;0;10;554;2;9;3055;1108;1108;2;1;0;10;10;3267;1;3450;9;2;
/org.eclipse.core.resources/src/org/eclipse/core/internal/properties/PropertyManager.java;4;1;9;1;2;2;2;7;350;1;7;12;498;498;1;0;0;7;9;12;0;4632;9;4;
/org.eclipse.scripting/src/org/eclipse/scripting/internal/uirenderer/XGRNode.java;1;0;1;1;0;0;0;1;0;0;1;1424;0;0;1;0;0;1;1;1424;0;1424;1;1;
/org.eclipse.scripting/src/org/eclipse/scripting/internal/uirenderer/XGRResources.java;1;0;1;1;0;0;0;1;0;0;1;1424;0;0;1;0;0;1;1;1424;0;1424;1;1;
/org.eclipse.team.core/src/org/eclipse/team/core/sync/LocalSyncElement.java;3;0;6;2;1;1;1;5;110;3;2;2019;160;160;3;3;0;5;6;2053;3;4707;3;3;
/org.eclipse.jdt.ui.tests.refactoring/resources/RenameTemp/canRename/A_test1_in.java;1;0;2;1;0;0;0;2;2;1;2;1625;2;2;1;0;0;2;2;1625;0;1652;2;1;
/org.eclipse.team.cvs.core/src/org/eclipse/team/internal/ccvs/core/ICVSFolder.java;2;1;8;1;2;2;2;6;122;1;6;3012;236;236;1;0;0;6;8;3012;0;4111;8;2;
/org.eclipse.jdt.ui.tests/JUnit/junit/tests/NotVoidTestCase.java;2;0;2;1;0;0;0;2;0;1;2;49;0;0;1;0;0;2;2;49;0;1186;2;2;
/org.eclipse.jdt.ui.tests.refactoring/resources/RenameMethodInInterface/test17/in/A.java;2;0;2;1;0;0;0;2;4;1;2;49;4;4;1;0;0;2;2;49;0;1297;2;2;
/org.eclipse.pde.ui/src/org/eclipse/pde/internal/base/IPluginContentWizard.java;2;0;3;1;0;0;0;3;2;1;3;1434;2;2;1;0;0;3;3;1434;0;3039;3;2;
/org.eclipse.swt.tests/JUnit Tests/org/eclipse/swt/tests/junit/Test_org_eclipse_swt_events_TreeEvent.java;2;0;2;1;1;1;1;1;6;0;1;1792;6;6;1;0;0;1;2;1792;0;4706;2;2;
/org.eclipse.ui.tests/Eclipse UI Tests/org/eclipse/ui/tests/api/IEditorActionDelegateTest.java;2;0;4;1;0;0;0;4;26;1;4;1456;30;30;1;0;0;4;4;1456;0;2785;4;2;
/org.eclipse.update.core/src/org/eclipse/update/core/IVerificationResult.java;2;0;11;2;0;0;0;11;317;3;8;3233;610;610;3;3;0;11;11;3574;3;3697;8;2;
/org.eclipse.jdt.core/compiler/org/eclipse/jdt/internal/compiler/parser/SourceTypeConverter.java;2;0;14;1;1;1;1;13;3264;4;9;455;5576;5576;4;4;0;13;14;1039;4;4062;10;2;
/org.eclipse.jdt.ui.tests.refactoring/resources/RenameParameters/canRename/A_in.java;1;0;1;1;0;0;0;1;0;0;1;233;0;0;1;0;0;1;1;233;0;233;1;1;
/org.eclipse.jdt.core/model/org/eclipse/jdt/core/IInitializer.java;2;1;4;1;2;2;2;2;20;1;2;455;37;37;1;0;0;2;4;455;0;4061;4;2;
/org.eclipse.jdt.core/compiler/org/eclipse/jdt/internal/compiler/impl/IntConstant.java;2;0;12;1;1;1;1;11;90;4;7;455;239;239;4;4;0;11;12;1039;4;4062;8;2;
/org.eclipse.core.tests.resources/src/org/eclipse/core/tests/internal/watson/PhantomComparator.java;3;0;4;1;1;1;1;3;162;1;3;1794;185;185;1;0;0;3;4;1794;0;4516;4;3;
/org.eclipse.pde.ui/src/org/eclipse/pde/internal/launcher/WorkbenchLauncherAdvancedTab.java;1;0;5;1;0;0;0;5;51;2;4;2868;59;59;2;1;0;5;5;3089;1;3089;4;1;
/org.eclipse.ui/Eclipse UI Standard Components/org/eclipse/ui/wizards/datatransfer/DataTransferTestStub.java;2;0;2;1;0;0;0;2;0;1;2;1034;0;0;1;0;0;2;2;1034;0;1302;2;2;
/org.eclipse.jdt.ui.tests.refactoring/resources/ExtractMethodWorkSpace/ExtractMethodTests/invalidSelection/A_test047.java;2;1;4;1;2;2;2;2;2;1;2;49;2;2;1;0;0;2;4;49;0;4419;4;2;
/org.eclipse.vcm.core.cvs.ssh/src/org/eclipse/vcm/internal/core/ccvs/ssh/SSHPlugin.java;2;0;2;1;0;0;0;2;10;1;2;197;10;10;1;0;0;2;2;197;0;298;2;2;
/org.eclipse.debug.ui/ui/org/eclipse/debug/internal/ui/AbstractRemoveAction.java;2;0;2;1;0;0;0;2;0;1;2;2347;0;0;1;0;0;2;2;2347;0;2382;2;2;
/org.eclipse.jdt.ui/ui/org/eclipse/jdt/internal/ui/IJavaUIStatus.java;2;0;3;1;0;0;0;3;5;1;3;15;5;5;1;0;0;3;3;15;0;1312;3;2;
/org.eclipse.jdt.ui/ui/org/eclipse/jdt/internal/ui/text/template/TemplateVariableDialog.java;1;0;2;1;0;0;0;2;0;1;2;1816;0;0;1;0;0;2;2;1816;0;1929;2;1;
/org.eclipse.jdt.ui/ui/org/eclipse/jdt/internal/ui/wizards/buildpaths/ArchiveFileFilter.java;1;0;3;1;0;0;0;3;24;1;3;1256;26;26;1;0;0;3;3;1256;0;3572;3;1;
/org.eclipse.jdt.ui.tests.refactoring/resources/RenameType/testIllegalTypeName4/in/A.java;1;0;1;1;0;0;0;1;0;0;1;49;0;0;1;0;0;1;1;49;0;49;1;1;
/org.eclipse.debug.ui/ui/org/eclipse/debug/internal/ui/launchConfigurations/LaunchHistoryPreferencePage.java;3;1;12;1;2;2;2;10;62;2;8;3132;167;167;2;2;0;10;12;3132;2;3975;10;3;
/org.eclipse.jdt.ui/ui/org/eclipse/jdt/internal/ui/text/correction/JavaCorrectionAssistant.java;1;0;2;1;0;0;0;2;15;1;2;3306;15;15;1;0;0;2;2;3306;0;3507;2;1;
/org.eclipse.jdt.ui.tests.refactoring/resources/MoveMembers/test8/in/A.java;1;0;1;1;0;0;0;1;0;0;1;2738;0;0;1;0;0;1;1;2738;0;2738;1;1;
/org.eclipse.swt.tests/JUnit Tests/org/eclipse/swt/tests/junit/Test_org_eclipse_swt_dnd_FileTransfer.java;2;0;2;1;1;1;1;1;6;0;1;1792;6;6;1;0;0;1;2;1792;0;4706;2;2;
/org.eclipse.help/src/org/eclipse/help/internal/contributors/xml1_0/ContributionFactory.java;1;0;2;1;0;0;0;2;0;1;2;1675;0;0;1;0;0;2;2;1675;0;2217;2;1;
/org.eclipse.swt/Eclipse SWT PI/win32/org/eclipse/swt/internal/win32/POINT.java;2;0;2;1;1;1;1;1;6;0;1;2069;6;6;1;0;0;1;2;2069;0;4701;2;2;
/org.eclipse.team.cvs.ui/src/org/eclipse/team/internal/ccvs/ui/model/CVSRemoteFilePropertySource.java;2;0;5;1;0;0;0;5;75;2;4;3053;95;95;2;1;0;5;5;3791;1;3791;4;2;
/org.eclipse.help/src/org/eclipse/help/internal/contributions/Contribution.java;2;0;3;1;0;0;0;3;3;1;3;1420;3;3;1;0;0;3;3;1420;0;1675;3;2;
/org.eclipse.jdt.debug.tests/tests/org/eclipse/jdt/debug/tests/core/EventSetTests.java;3;1;4;1;3;3;3;1;21;0;1;3701;27;27;1;0;0;1;4;3701;0;4571;4;3;
/org.eclipse.jdt.debug.ui/ui/org/eclipse/jdt/internal/debug/ui/JavaLocalApplicationLaunchConfigurationHelper.java;2;0;6;1;0;0;0;6;150;1;6;2885;221;221;1;0;0;6;6;2885;0;3055;6;2;
/org.eclipse.team.cvs.ui/src/org/eclipse/team/internal/ccvs/ui/sync/MergeAction.java;3;2;19;2;5;4;5;14;139;2;13;2231;334;334;2;1;1;14;19;2231;2;4455;17;3;
/org.eclipse.jdt.ui.tests.refactoring/resources/RenameVirtualMethodInClass/test1/out/A.java;1;0;1;1;0;0;0;1;0;0;1;49;0;0;1;0;0;1;1;49;0;49;1;1;
/org.eclipse.pde.ui/src/org/eclipse/pde/internal/editor/manifest/JavaAttributeWizardPage.java;2;0;7;1;0;0;0;7;4;1;7;1434;8;8;1;0;0;7;7;1434;0;3579;7;2;
/org.eclipse.help/Eclipse Help/org/eclipse/help/internal/contributors/xml/XMLContributor.java;4;0;6;1;0;0;0;6;20;1;6;135;43;43;1;0;0;6;6;135;0;1420;6;4;
/org.eclipse.jdt.junit/src/org/eclipse/jdt/internal/junit/ui/HierarchyRunView.java;2;1;4;1;2;2;2;2;64;1;2;3171;86;86;1;0;0;2;4;3171;0;4276;4;2;
/org.eclipse.pde.ui/src/org/eclipse/pde/internal/ui/elements/DefaultTableProvider.java;1;0;1;1;0;0;0;1;0;0;1;3579;0;0;1;0;0;1;1;3579;0;3579;1;1;
/org.eclipse.jdt.ui.tests.refactoring/resources/SelectionAnalyzerWorkSpace/SelectionAnalyzerTests/invalidSelection/A_test113.java;1;0;1;1;0;0;0;1;0;0;1;1368;0;0;1;0;0;1;1;1368;0;1368;1;1;
/org.eclipse.swt.examples.controls/src/org/eclipse/swt/examples/controls/ButtonTab.java;2;0;2;1;0;0;0;2;0;1;2;391;0;0;1;0;0;2;2;391;0;611;2;2;
/org.eclipse.jdt.debug.ui/ui/org/eclipse/jdt/internal/debug/ui/actions/ActionMessages.java;1;0;2;1;0;0;0;2;5;1;2;1934;9;9;1;0;0;2;2;1934;0;2023;2;1;
/org.eclipse.vcm.core.cvs/src/org/eclipse/vcm/internal/core/ccvs/client/MessageHandler.java;3;0;3;1;0;0;0;3;6;1;3;0;10;10;1;0;0;3;3;0;0;1098;3;3;
/org.eclipse.core.boot/src/org/eclipse/core/internal/boot/update/ProductDescriptorModel.java;4;0;9;2;0;0;0;9;142;3;7;12;221;221;3;2;0;9;9;324;2;2726;7;4;
/org.eclipse.jdt.ui.tests.refactoring/resources/ExtractTemp/canExtract/A_test26_in.java;1;0;1;1;0;0;0;1;0;0;1;2913;0;0;1;0;0;1;1;2913;0;2913;1;1;
/org.eclipse.pde.ui/src/org/eclipse/pde/internal/launcher/WorkbenchLauncherWizardAdvancedPage.java;1;0;21;1;0;0;0;21;432;2;19;2560;1473;1473;2;2;0;21;21;2766;2;3579;19;1;
/org.eclipse.jdt.ui.tests.refactoring/resources/ExtractMethodWorkSpace/ExtractMethodTests/branch_out/A_test751.java;1;1;4;1;2;2;2;2;34;1;2;1851;35;35;1;0;0;2;4;1851;0;4419;4;1;
/org.eclipse.jdt.ui.tests.refactoring/resources/RenameVariables/canRename/A_test11_in.java;1;0;2;1;0;0;0;2;0;1;2;724;0;0;1;0;0;2;2;724;0;1665;2;1;
/org.eclipse.jdt.ui/core refactoring/org/eclipse/jdt/internal/core/refactoring/changes/ReorgUtils.java;1;0;2;1;0;0;0;2;0;1;2;1108;0;0;1;0;0;2;2;1108;0;1257;2;1;
/org.eclipse.jdt.ui.tests.refactoring/resources/DeleteSourceReferenceEdit/A_testField4_out.java;1;0;1;1;0;0;0;1;0;0;1;2857;0;0;1;0;0;1;1;2857;0;2857;1;1;
/org.eclipse.jdt.core/model/org/eclipse/jdt/core/IBufferChangedListener.java;3;2;6;2;4;2;4;2;14;1;2;455;35;35;2;0;2;2;6;4058;2;4421;4;3;
/org.eclipse.swt/Eclipse SWT/common/org/eclipse/swt/internal/image/LEDataOutputStream.java;2;0;3;1;1;1;1;2;7;1;2;106;13;13;1;0;0;2;3;106;0;4701;3;2;
/org.eclipse.ui/Eclipse UI/org/eclipse/ui/dialogs/FilteredList.java;1;0;2;1;0;0;0;2;4;1;2;3733;4;4;1;0;0;2;2;3733;0;3740;2;1;
/org.eclipse.pde.ui/src/org/eclipse/pde/internal/ui/wizards/templates/AbstractTemplateSection.java;1;0;3;1;0;0;0;3;18;1;3;3579;18;18;1;0;0;3;3;3579;0;3819;3;1;
/org.eclipse.jdt.ui/core refactoring/org/eclipse/jdt/internal/corext/refactoring/code/flow/ThrowFlowInfo.java;1;0;3;1;0;0;0;3;10;1;3;1939;15;15;1;0;0;3;3;1939;0;3106;3;1;
/org.eclipse.ui/Eclipse UI/org/eclipse/ui/actions/OpenFileAction.java;5;0;10;1;1;1;1;9;30;1;9;257;92;92;1;0;0;9;10;257;0;4146;10;5;
/org.eclipse.swt/Eclipse SWT/win32/org/eclipse/swt/widgets/Tracker.java;6;2;25;2;9;7;9;16;318;3;12;106;1019;1019;3;4;2;16;25;1736;6;4701;19;6;
/org.eclipse.swt/Eclipse SWT/gtk/org/eclipse/swt/widgets/TableItem.java;5;1;16;2;6;6;6;10;469;2;9;2107;1133;1133;2;1;0;10;16;3209;1;4701;15;5;
/org.eclipse.jdt.ui.tests.refactoring/resources/ReorderParameters/canReorder/A_test1_out.java;1;0;3;1;0;0;0;3;0;1;3;724;0;0;1;0;0;3;3;724;0;2270;3;1;
/org.eclipse.ui/Eclipse UI Standard Components/org/eclipse/ui/views/navigator/CopyProjectOperation.java;2;0;5;1;2;1;2;3;2;1;3;2830;5;5;2;0;1;3;5;4207;1;4207;4;2;
/org.eclipse.pde.ui/src/org/eclipse/pde/internal/launcher/WorkbenchLauncherDelegate.java;1;0;14;1;0;0;0;14;46;2;13;2593;107;107;2;1;0;14;14;3346;1;3579;13;1;
/org.eclipse.jdt.ui/ui refactoring/org/eclipse/jdt/internal/ui/refactoring/MoveInputPage.java;1;0;1;1;0;0;0;1;0;0;1;1108;0;0;1;0;0;1;1;1108;0;1108;1;1;
/org.eclipse.pde.ui/src/org/eclipse/pde/internal/model/build/WorkspaceBuildModel.java;2;0;4;1;0;0;0;4;29;1;4;1434;33;33;1;0;0;4;4;1434;0;3579;4;2;
/org.eclipse.pde.ui/src/org/eclipse/pde/internal/ui/model/ifeature/IVersonable.java;1;0;2;1;0;0;0;2;0;1;2;3579;0;0;1;0;0;2;2;3579;0;3591;2;1;
/org.eclipse.scripting/src/org/eclipse/scripting/internal/IXGRElementEventGeneratorOnLoad.java;1;0;1;1;0;0;0;1;0;0;1;1424;0;0;1;0;0;1;1;1424;0;1424;1;1;
/org.eclipse.ui/Eclipse UI Text Editor/org/eclipse/ui/texteditor/MarkerUpdater.java;3;0;3;1;0;0;0;3;5;1;3;257;8;8;1;0;0;3;3;257;0;1066;3;3;
/org.eclipse.debug.core/core/org/eclipse/debug/core/IBreakpointFactory.java;2;0;3;1;0;0;0;3;23;1;3;831;23;23;1;0;0;3;3;831;0;1118;3;2;
/org.eclipse.pde.ui/Eclipse PDE UI/org/eclipse/pde/internal/editor/manifest/ManifestFormOutlinePage.java;2;0;6;2;0;0;0;6;12;3;4;267;16;16;3;2;0;6;6;324;2;1434;4;2;
/org.eclipse.swt/Eclipse SWT/common_j2me/org/eclipse/swt/internal/SWTEventObject.java;2;1;3;1;2;2;2;1;6;0;1;1561;11;11;1;0;0;1;3;1561;0;4701;3;2;
/org.eclipse.jdt.core/search/org/eclipse/jdt/internal/core/index/impl/SimpleIndexBlock.java;2;0;3;1;1;1;1;2;55;1;2;455;73;73;1;0;0;2;3;455;0;4063;3;2;
/org.eclipse.jdt.ui/ui/org/eclipse/jdt/internal/ui/launcher/OpenOnVariableAction.java;3;0;5;1;0;0;0;5;16;1;5;15;34;34;1;0;0;5;5;15;0;1916;5;3;
/org.eclipse.jdt.junit/src/org/eclipse/jdt/internal/junit/ui/CounterPanel.java;2;0;5;1;1;1;1;4;23;1;4;3171;33;33;1;0;0;4;5;3171;0;4232;5;2;
/org.eclipse.jdt.debug/model/org/eclipse/jdt/internal/debug/core/model/JDIModificationVariable.java;3;0;6;2;1;1;1;5;5;3;3;2517;13;13;3;2;0;5;6;2517;2;4423;4;3;
/org.eclipse.jdt.ui.tests.refactoring/resources/AbstractField/can/A_test2_out.java;1;0;1;1;0;0;0;1;0;0;1;751;0;0;1;0;0;1;1;751;0;751;1;1;
/org.eclipse.jdt.ui.tests.refactoring/resources/ExtractMethodWorkSpace/ExtractMethodTests/invalidSelection/A_test123.java;1;1;3;1;3;3;3;0;0;0;0;4188;0;0;1;0;0;0;3;4188;0;4419;3;1;
/org.eclipse.scripting/src/org/eclipse/scripting/internal/uirenderer/XGRWidgetRegistry.java;1;0;1;1;0;0;0;1;0;0;1;1424;0;0;1;0;0;1;1;1424;0;1424;1;1;
/org.eclipse.ui.tests/Eclipse JFace Tests/org/eclipse/jface/tests/viewers/interactive/Sorter.java;1;0;1;1;0;0;0;1;0;0;1;1488;0;0;1;0;0;1;1;1488;0;1488;1;1;
/org.eclipse.jdt.ui.tests.refactoring/resources/RenameTemp/canRename/A_test25_in.java;1;0;2;1;0;0;0;2;2;1;2;1625;2;2;1;0;0;2;2;1625;0;1652;2;1;
/org.eclipse.jdt.core/model/org/eclipse/jdt/internal/core/jdom/DOMBuilder.java;2;3;14;1;5;3;5;9;1379;2;8;455;1577;1577;3;1;2;9;14;3959;3;4063;11;2;
/org.eclipse.jdt.ui/core refactoring/org/eclipse/jdt/core/refactoring/methods/RenameMethodRefactoring.java;1;0;10;1;0;0;0;10;30;2;8;15;87;87;2;2;0;10;10;106;2;408;8;1;
/org.eclipse.jdt.ui/core refactoring/org/eclipse/jdt/internal/core/refactoring/code/ExtractMethodRefactoring.java;4;0;16;1;0;0;0;16;264;2;13;408;471;471;2;3;0;16;16;418;3;1939;13;4;
/org.eclipse.pde.ui/src/org/eclipse/pde/internal/forms/HyperlinkHandler.java;2;0;3;1;0;0;0;3;1;1;3;1434;1;1;1;0;0;3;3;1434;0;2470;3;2;
/org.eclipse.vcm.core.cvs/src/org/eclipse/vcm/internal/core/ccvs/utils/EmptyEnumeration.java;2;0;2;1;0;0;0;2;9;1;2;0;9;9;1;0;0;2;2;0;0;298;2;2;
/org.eclipse.team.cvs.core/src/org/eclipse/team/internal/ccvs/core/IResourceStateChangeListener.java;2;0;4;1;0;0;0;4;39;1;4;3193;67;67;1;0;0;4;4;3193;0;3701;4;2;
/org.eclipse.jdt.ui/ui/org/eclipse/jdt/internal/ui/actions/ActionUtil.java;2;1;4;1;2;2;2;2;69;1;2;3533;72;72;1;0;0;2;4;3533;0;4648;4;2;
/org.eclipse.jdt.ui/core refactoring/org/eclipse/jdt/internal/corext/refactoring/surround/SurroundWithTryCatchAnalyzer.java;2;2;9;2;4;3;4;5;84;1;5;2327;157;157;2;0;1;5;9;4421;1;4421;8;2;
/org.eclipse.ui/Eclipse UI/org/eclipse/ui/internal/model/WorkbenchFolder.java;2;0;2;1;0;0;0;2;5;1;2;257;5;5;1;0;0;2;2;257;0;457;2;2;
/org.eclipse.jdt.debug.ui/ui/org/eclipse/jdt/internal/debug/ui/snippeteditor/SelectImportsDialog.java;2;1;11;1;4;4;4;7;56;2;6;3330;169;169;2;1;0;7;11;3796;1;4410;10;2;
/org.eclipse.jdt.ui.tests.refactoring/resources/RenameType/testFail29/in/A.java;1;0;1;1;0;0;0;1;0;0;1;49;0;0;1;0;0;1;1;49;0;49;1;1;
/org.eclipse.jdt.ui.tests.refactoring/resources/MoveMembers/test11/out/A.java;1;0;1;1;0;0;0;1;0;0;1;2738;0;0;1;0;0;1;1;2738;0;2738;1;1;
/org.eclipse.swt/Eclipse SWT OLE Win32/win32/org/eclipse/swt/internal/ole/win32/IEnumSTATSTG.java;2;0;3;1;0;0;0;3;5;1;3;106;5;5;1;0;0;3;3;106;0;2069;3;2;
/org.eclipse.jdt.ui/core refactoring/org/eclipse/jdt/internal/core/refactoring/cus/CompilationUnitRefactoring.java;2;0;4;1;0;0;0;4;2;1;4;408;4;4;1;0;0;4;4;408;0;1342;4;2;
/org.eclipse.jdt.ui/core refactoring/org/eclipse/jdt/internal/core/refactoring/util/ParentProvider.java;1;0;2;1;0;0;0;2;0;1;2;1462;0;0;1;0;0;2;2;1462;0;1939;2;1;
/org.eclipse.jdt.core/search/org/eclipse/jdt/internal/core/search/SubTypeSearchJob.java;3;1;14;1;2;2;2;12;143;4;9;455;228;228;4;3;0;12;14;1039;3;4063;11;3;
/org.eclipse.team.core/src/org/eclipse/team/internal/core/target/TargetProvider.java;2;0;2;2;2;1;2;0;20;0;0;4636;20;20;2;0;1;0;2;4636;1;4636;1;2;
/org.eclipse.debug.ui/ui/org/eclipse/debug/internal/ui/launchConfigurations/LaunchConfigurationManager.java;4;2;18;1;18;16;18;0;108;0;0;3975;392;392;2;0;2;0;18;4367;2;4630;16;4;
/org.eclipse.pde.ui/src/org/eclipse/pde/internal/ui/view/CopyToClipboardAction.java;1;0;1;1;0;0;0;1;0;0;1;3579;0;0;1;0;0;1;1;3579;0;3579;1;1;
/org.eclipse.team.cvs.ui/src/org/eclipse/team/internal/ccvs/ui/CVSUIPlugin.java;4;2;65;3;20;17;20;45;296;4;32;1978;913;913;4;13;3;45;65;2049;16;4707;49;4;
/org.eclipse.jdt.ui.tests/ui/org/eclipse/jdt/ui/tests/text/HTML2TextReaderTester.java;1;0;1;1;1;1;1;0;9;0;0;4643;9;9;1;0;0;0;1;4643;0;4643;1;1;
/org.eclipse.ui/Eclipse UI/org/eclipse/ui/internal/ObjectPluginAction.java;3;0;3;1;0;0;0;3;23;1;3;257;28;28;1;0;0;3;3;257;0;2235;3;3;
/org.eclipse.ui/Eclipse JFace Text/org/eclipse/jface/text/AbstractDocument.java;4;1;9;1;3;3;3;6;907;1;6;257;1187;1187;1;0;0;6;9;257;0;4838;9;4;
/org.eclipse.webdav/src/client/org/eclipse/webdav/http/client/HttpClient.java;3;0;6;1;1;1;1;5;2306;1;5;12;3532;3532;1;0;0;5;6;12;0;4211;6;3;
/org.eclipse.scripting/src/org/eclipse/scripting/internal/uirenderer/XGRElementUISwtTableRow.java;1;0;1;1;0;0;0;1;0;0;1;1424;0;0;1;0;0;1;1;1424;0;1424;1;1;
/org.eclipse.jdt.ui.tests.refactoring/resources/RenameTemp/canRename/A_test32_in.java;1;0;2;1;0;0;0;2;2;1;2;1625;2;2;1;0;0;2;2;1625;0;1652;2;1;
/org.eclipse.swt.examples.launcher/src/org/eclipse/swt/examples/launcher/ItemTreeNode.java;3;0;3;1;1;1;1;2;73;1;2;513;79;79;1;0;0;2;3;513;0;4705;3;3;
/org.eclipse.jdt.ui/ui/org/eclipse/jdt/internal/ui/text/template/Template.java;1;0;9;1;0;0;0;9;20;1;9;1469;73;73;1;0;0;9;9;1469;0;2784;9;1;
/org.eclipse.jdt.ui/core refactoring/org/eclipse/jdt/internal/core/refactoring/DebugUtils.java;3;0;4;1;0;0;0;4;54;1;4;15;59;59;1;0;0;4;4;15;0;1939;4;3;
/org.eclipse.jdt.debug.tests/tests/org/eclipse/jdt/debug/tests/core/StaticVariableTests.java;3;1;4;1;3;3;3;1;19;0;1;3701;26;26;1;0;0;1;4;3701;0;4571;4;3;
/org.eclipse.jdt.ui.tests.refactoring/resources/RenameNonPrivateField/test15/out/A.java;1;0;1;1;0;0;0;1;0;0;1;1274;0;0;1;0;0;1;1;1274;0;1274;1;1;
/org.eclipse.pde.core/src/org/eclipse/pde/internal/core/plugin/AbstractPluginModelBase.java;1;0;4;1;1;1;1;3;13;1;3;3591;15;15;1;0;0;3;4;3591;0;4555;4;1;
/org.eclipse.jdt.launching/launching/org/eclipse/jdt/launching/IVMConnector.java;2;2;9;2;7;6;7;2;29;1;2;3401;115;115;2;0;1;2;9;4567;1;4650;8;2;
/org.eclipse.jdt.core/model/org/eclipse/jdt/core/ICodeCompletionRequestor.java;2;1;10;1;3;3;3;7;485;1;7;455;886;886;1;0;0;7;10;455;0;4450;10;2;
/org.eclipse.jdt.ui/ui/org/eclipse/jdt/internal/ui/javaeditor/ProblemPosition.java;1;0;2;1;0;0;0;2;0;1;2;3166;0;0;1;0;0;2;2;3166;0;3418;2;1;
/org.eclipse.jdt.core/compiler/org/eclipse/jdt/internal/compiler/env/IConstants.java;2;0;3;1;1;1;1;2;15;1;2;455;23;23;1;0;0;2;3;455;0;4062;3;2;
/org.eclipse.jdt.core/codeassist/org/eclipse/jdt/internal/codeassist/complete/CompletionOnMethodReturnType.java;3;1;3;1;3;3;3;0;3;0;0;3953;4;4;1;0;0;0;3;3953;0;4421;3;3;
/org.eclipse.jdt.ui.tests.refactoring/resources/ExtractMethodWorkSpace/ExtractMethodTests/return_out/A_test715.java;1;1;3;1;2;2;2;1;36;0;1;923;36;36;1;0;0;1;3;923;0;4419;3;1;
/org.eclipse.jdt.debug.ui/ui/org/eclipse/jdt/internal/debug/ui/actions/OpenOnVariableAction.java;1;0;5;1;1;1;1;4;16;1;4;2384;22;22;1;0;0;4;5;2384;0;4552;5;1;
/org.eclipse.team.ui/src/org/eclipse/team/internal/ui/actions/ConfigureProjectAction.java;1;0;1;1;1;1;1;0;0;0;0;4020;0;0;1;0;0;0;1;4020;0;4020;1;1;
/org.eclipse.jdt.ui/ui/org/eclipse/jdt/internal/ui/browsing/TypesView.java;3;1;10;1;2;2;2;8;27;2;7;2878;81;81;2;1;0;8;10;2910;1;4211;9;3;
/org.eclipse.jdt.junit/src/org/eclipse/jdt/internal/junit/wizards/MethodStubsSelectionButtonGroup.java;1;0;1;1;0;0;0;1;0;0;1;3527;0;0;1;0;0;1;1;3527;0;3527;1;1;
/org.eclipse.swt/Eclipse SWT PI/motif/org/eclipse/swt/internal/motif/XSetWindowAttributes.java;2;0;2;1;1;1;1;1;6;0;1;2069;6;6;1;0;0;1;2;2069;0;4701;2;2;
/org.eclipse.ui/Eclipse UI/org/eclipse/ui/model/WorkbenchViewerSorter.java;2;0;2;1;0;0;0;2;5;1;2;257;5;5;1;0;0;2;2;257;0;457;2;2;
/org.eclipse.jdt.core/compiler/org/eclipse/jdt/internal/compiler/lookup/TypeConstants.java;2;0;12;1;1;1;1;11;197;4;7;455;408;408;4;4;0;11;12;1039;4;4062;8;2;
/org.eclipse.jdt.ui/core extension/org/eclipse/jdt/internal/corext/template/ContextType.java;1;0;2;1;0;0;0;2;9;1;2;2784;9;9;1;0;0;2;2;2784;0;2932;2;1;
/org.eclipse.pde.ui/Eclipse PDE UI/org/eclipse/pde/internal/elements/ListContentProvider.java;2;0;5;2;0;0;0;5;12;3;3;267;12;12;3;2;0;5;5;324;2;1434;3;2;
/org.eclipse.jdt.debug.tests/tests/org/eclipse/jdt/debug/tests/eval/StaticFieldValueTests.java;2;1;3;1;3;3;3;0;17;0;0;4447;19;19;1;0;0;0;3;4447;0;4571;3;2;
/org.eclipse.jdt.ui.tests.refactoring/resources/RenameParameters/canRename/A_test29_out.java;2;0;2;1;0;0;0;2;8;1;2;233;8;8;1;0;0;2;2;233;0;952;2;2;
/org.eclipse.jdt.ui/ui/org/eclipse/jdt/internal/ui/search/FindReadReferencesInHierarchyAction.java;1;2;6;1;4;3;4;2;31;1;2;1707;54;54;2;0;1;2;6;4140;1;4140;5;1;
/org.eclipse.core.resources/src/org/eclipse/core/internal/properties/PropertyStore.java;4;1;9;1;2;2;2;7;884;1;7;12;1121;1121;1;0;0;7;9;12;0;4214;9;4;
/org.eclipse.jdt.junit/Eclipse JUnit/org/eclipse/jdt/junit/util/EmptyPerspective.java;3;0;3;1;0;0;0;3;2;1;3;1511;2;2;1;0;0;3;3;1511;0;1996;3;3;
/org.eclipse.help.ui/Eclipse Help UI/org/eclipse/help/internal/ui/NavigationViewer.java;3;0;8;1;0;0;0;8;21;1;8;136;60;60;1;0;0;8;8;136;0;1420;8;3;
/org.eclipse.vcm.core/src/org/eclipse/vcm/internal/core/adapter/IVersionInfo.java;2;0;3;1;0;0;0;3;7;1;3;199;9;9;1;0;0;3;3;199;0;983;3;2;
/org.eclipse.jdt.ui/core refactoring/org/eclipse/jdt/internal/core/refactoring/rename/RenameTypeASTAnalyzer.java;2;0;5;1;0;0;0;5;81;2;4;1342;87;87;2;1;0;5;5;1910;1;1939;4;2;
/org.eclipse.jdt.ui/ui/org/eclipse/jdt/internal/ui/text/java/JavaReconcilingStrategy.java;3;1;16;1;6;6;6;10;137;2;9;15;487;487;2;1;0;10;16;3166;1;4599;15;3;
/org.eclipse.swt/Eclipse SWT OLE Win32/win32/org/eclipse/swt/internal/ole/win32/IEnum.java;2;0;3;1;0;0;0;3;5;1;3;106;5;5;1;0;0;3;3;106;0;2069;3;2;
/org.eclipse.pde.ui/src/org/eclipse/pde/internal/base/model/plugin/IPluginExtension.java;2;0;2;1;0;0;0;2;0;1;2;1434;0;0;1;0;0;2;2;1434;0;3039;2;2;
/org.eclipse.jdt.ui/core refactoring/org/eclipse/jdt/internal/core/refactoring/rename/RenamePrivateMethodRefactoring.java;2;0;4;1;0;0;0;4;24;1;4;1342;25;25;1;0;0;4;4;1342;0;1939;4;2;
/org.eclipse.swt/Eclipse SWT/gtk1x/org/eclipse/swt/widgets/Menu.java;3;0;3;1;1;1;1;2;6;1;2;2107;10;10;1;0;0;2;3;2107;0;4701;3;3;
/org.eclipse.jdt.ui.tests.refactoring/resources/SelectionAnalyzerWorkSpace/SelectionAnalyzerTests/validSelection/A_test122_.java;1;0;1;1;0;0;0;1;0;0;1;2139;0;0;1;0;0;1;1;2139;0;2139;1;1;
/org.eclipse.swt/Eclipse SWT/common/org/eclipse/swt/SWTException.java;5;0;6;1;1;1;1;5;34;1;5;106;89;89;1;0;0;5;6;106;0;4701;6;5;
/org.eclipse.jdt.ui/ui/org/eclipse/jdt/ui/PreferencesConstants.java;3;0;4;3;4;1;4;0;84;0;0;4181;84;84;4;0;3;0;4;4181;3;4181;1;3;
/org.eclipse.jdt.ui/ui/org/eclipse/jdt/internal/ui/text/correction/NameMatcher.java;3;0;7;2;0;0;0;7;91;3;5;3306;111;111;3;2;0;7;7;3528;2;3789;5;3;
/org.eclipse.ui/Eclipse UI/org/eclipse/ui/internal/SubActionBars.java;5;0;6;1;0;0;0;6;32;1;6;257;86;86;1;0;0;6;6;257;0;3484;6;5;
/org.eclipse.pde.ui/Eclipse PDE UI/org/eclipse/pde/internal/base/schema/ISchema.java;2;0;5;2;0;0;0;5;12;3;3;267;12;12;3;2;0;5;5;324;2;1434;3;2;
/org.eclipse.jdt.debug.ui/ui/org/eclipse/jdt/internal/debug/ui/launcher/VMLabelProvider.java;1;0;2;1;1;1;1;1;2;0;1;1915;2;2;1;0;0;1;2;1915;0;4423;2;1;
/org.eclipse.ui/Eclipse UI Standard Components/org/eclipse/ui/views/properties/ResourcePropertySource.java;2;0;2;1;0;0;0;2;14;1;2;257;14;14;1;0;0;2;2;257;0;457;2;2;
/org.eclipse.jdt.ui.tests.refactoring/resources/ExtractMethodWorkSpace/ExtractMethodTests/invalidSelection/A_test072.java;2;1;3;1;2;2;2;1;0;0;1;49;0;0;1;0;0;1;3;49;0;4419;3;2;
/org.eclipse.team.tests.cvs.core/src/org/eclipse/team/tests/ccvs/core/compatible/ReferenceException.java;2;0;2;1;0;0;0;2;0;1;2;2536;0;0;1;0;0;2;2;2536;0;3089;2;2;
/org.eclipse.update.ui/src/org/eclipse/update/ui/model/ModelObject.java;1;0;2;1;0;0;0;2;0;1;2;1477;0;0;1;0;0;2;2;1477;0;1526;2;1;
/org.eclipse.jdt.ui.tests.refactoring/resources/RenamePrivateMethod/test20/in/A.java;1;0;1;1;0;0;0;1;0;0;1;49;0;0;1;0;0;1;1;49;0;49;1;1;
/org.eclipse.jdt.ui.tests.refactoring/resources/ExtractMethodWorkSpace/ExtractMethodTests/T10245.java;1;1;3;1;2;2;2;1;0;0;1;3168;0;0;1;0;0;1;3;3168;0;4419;3;1;
/org.eclipse.jdt.ui.tests.refactoring/resources/RenameMethodInInterface/testFail41/in/A.java;1;0;1;1;0;0;0;1;0;0;1;49;0;0;1;0;0;1;1;49;0;49;1;1;
/org.eclipse.jdt.ui/ui/org/eclipse/jdt/internal/ui/launcher/VMPreferencePage.java;4;0;26;1;0;0;0;26;346;3;20;15;1045;1045;3;6;0;26;26;411;6;1916;20;4;
/org.eclipse.jdt.core/compiler/org/eclipse/jdt/internal/compiler/ast/TryStatement.java;2;1;25;1;3;3;3;22;804;4;17;455;1959;1959;4;5;0;22;25;1039;5;4421;20;2;
/org.eclipse.jdt.ui.tests.refactoring/resources/RenameParameters/canRename/A_test0_in.java;1;0;1;1;0;0;0;1;0;0;1;233;0;0;1;0;0;1;1;233;0;233;1;1;
/org.eclipse.jdt.ui.tests.refactoring/resources/RenameNonPrivateField/test10/in/A.java;1;0;1;1;0;0;0;1;0;0;1;49;0;0;1;0;0;1;1;49;0;49;1;1;
/org.eclipse.team.cvs.ui/src/org/eclipse/team/internal/ccvs/ui/AutoManagePreferencePage.java;1;0;1;1;0;0;0;1;0;0;1;3340;0;0;1;0;0;1;1;3340;0;3340;1;1;
/org.eclipse.jdt.ui.tests.refactoring/resources/RenameType/test50/out/B.java;1;0;1;1;0;0;0;1;0;0;1;522;0;0;1;0;0;1;1;522;0;522;1;1;
/org.eclipse.ui/Eclipse UI/org/eclipse/ui/internal/IActionSetContributionItem.java;2;0;2;1;0;0;0;2;4;1;2;457;4;4;1;0;0;2;2;457;0;620;2;2;
/org.eclipse.jdt.ui.tests.refactoring/resources/PullUp/test5/out/B.java;1;0;1;1;0;0;0;1;0;0;1;2406;0;0;1;0;0;1;1;2406;0;2406;1;1;
/org.eclipse.update.core/src/org/eclipse/update/core/IFeatureReference.java;2;0;10;1;1;1;1;9;102;2;8;1744;202;202;2;1;0;9;10;3571;1;4424;9;2;
/org.eclipse.ant.ui/src/org/eclipse/ant/internal/ui/AntLaunchDialogContentProvider.java;2;0;4;2;0;0;0;4;58;3;2;276;58;58;3;2;0;4;4;296;2;296;2;2;
/org.eclipse.update.ui/src/org/eclipse/update/internal/ui/search/DriveSearchSettings.java;1;0;1;1;0;0;0;1;0;0;1;3537;0;0;1;0;0;1;1;3537;0;3537;1;1;
/org.eclipse.vcm.core.cvs/src/org/eclipse/vcm/internal/core/ccvs/requests/ICheckedInListener.java;2;0;2;1;0;0;0;2;25;1;2;0;25;25;1;0;0;2;2;0;0;298;2;2;
/org.eclipse.swt.tests/JUnit Tests/org/eclipse/swt/tests/junit/Test_org_eclipse_swt_widgets_MenuItem.java;2;0;2;1;1;1;1;1;6;0;1;1792;6;6;1;0;0;1;2;1792;0;4706;2;2;
/org.eclipse.pde.ui/src/org/eclipse/pde/internal/ui/editor/manifest/RuntimeForm.java;1;0;1;1;0;0;0;1;0;0;1;3579;0;0;1;0;0;1;1;3579;0;3579;1;1;
/org.eclipse.jdt.ui.tests.refactoring/resources/ExtractMethodWorkSpace/ExtractMethodTests/wiki_out/A_test2002.java;1;1;4;1;2;2;2;2;32;1;2;1236;34;34;1;0;0;2;4;1236;0;4419;4;1;
/org.eclipse.jdt.ui/ui/org/eclipse/jdt/internal/ui/wizards/dialogfields/DialogField.java;3;0;9;1;1;1;1;8;90;1;8;15;133;133;1;0;0;8;9;15;0;4426;9;3;
/org.eclipse.ui/Eclipse UI/org/eclipse/ui/internal/ILayoutContainer.java;2;0;3;1;0;0;0;3;8;1;3;257;13;13;1;0;0;3;3;257;0;1915;3;2;
/org.eclipse.jdt.ui/core extension/org/eclipse/jdt/internal/corext/template/ITemplateEditor.java;1;0;1;1;0;0;0;1;0;0;1;2784;0;0;1;0;0;1;1;2784;0;2784;1;1;
/org.eclipse.jdt.ui/ui debug/org/eclipse/jdt/internal/debug/ui/JDIAttachLauncherWizardPage.java;4;0;9;1;0;0;0;9;74;1;9;15;126;126;1;0;0;9;9;15;0;1916;9;4;
/org.eclipse.ui/Eclipse UI/org/eclipse/ui/IMarkerActionFilter.java;3;0;3;1;0;0;0;3;12;1;3;257;17;17;1;0;0;3;3;257;0;721;3;3;
/org.eclipse.jdt.core/dom/org/eclipse/jdt/core/dom/Assignment.java;2;2;7;1;3;2;3;4;44;1;4;2669;79;79;2;0;1;4;7;4452;1;4452;6;2;
/org.eclipse.swt/Eclipse SWT Custom Widgets/common/org/eclipse/swt/custom/TableTreeItem.java;4;2;11;2;3;2;3;8;312;3;6;106;524;524;3;2;1;8;11;2876;3;4701;8;4;
/org.eclipse.swt/Eclipse SWT PI/motif/org/eclipse/swt/internal/motif/Visual.java;2;0;2;1;1;1;1;1;6;0;1;2069;6;6;1;0;0;1;2;2069;0;4701;2;2;
/org.eclipse.debug.ui/ui/org/eclipse/debug/internal/ui/preferences/DebugActionGroupsLabelProvider.java;2;1;2;1;2;2;2;0;3;0;0;3975;3;3;1;0;0;0;2;3975;0;4207;2;2;
/org.eclipse.vcm.ui/src/org/eclipse/vcm/internal/ui/RemoteTextEditor.java;2;0;2;2;0;0;0;2;0;0;1;1;0;0;2;1;0;2;2;1;1;1;1;2;
/org.eclipse.jdt.ui/core refactoring/org/eclipse/jdt/internal/core/refactoring/code/flow/FlowAnalyzer.java;1;0;4;1;0;0;0;4;63;1;4;1236;72;72;1;0;0;4;4;1236;0;1939;4;1;
/org.eclipse.pde.ui/Eclipse PDE UI/org/eclipse/pde/internal/editor/manifest/ExtensionsPropertySheet.java;2;0;6;2;0;0;0;6;12;3;4;267;14;14;3;2;0;6;6;324;2;1434;4;2;
/org.eclipse.jdt.core/compiler/org/eclipse/jdt/internal/compiler/ConfigurableOption.java;2;0;17;1;1;1;1;16;4068;4;10;455;7346;7346;4;6;0;16;17;868;6;4062;11;2;
/org.eclipse.core.boot/src/org/eclipse/core/internal/boot/update/UpdateManagerConstants.java;3;0;5;1;0;0;0;5;30;1;5;12;41;41;1;0;0;5;5;12;0;2726;5;3;
/org.eclipse.team.cvs.core/src/org/eclipse/team/internal/ccvs/core/commands/Log.java;3;0;3;1;0;0;0;3;74;1;3;1978;74;74;1;0;0;3;3;1978;0;2607;3;3;
/org.eclipse.jdt.ui.tests.refactoring/resources/ReorderParameters/canReorder/A_test1_in.java;1;0;3;1;0;0;0;3;0;1;3;724;0;0;1;0;0;3;3;724;0;2270;3;1;
/org.eclipse.team.cvs.core/src/org/eclipse/team/internal/ccvs/core/client/Log.java;2;0;6;1;0;0;0;6;21;1;6;2572;43;43;1;0;0;6;6;2572;0;3533;6;2;
/org.eclipse.core.boot/src/org/eclipse/core/internal/boot/update/IInstallable.java;3;0;4;1;0;0;0;4;8;1;4;12;15;15;1;0;0;4;4;12;0;2726;4;3;
/org.eclipse.jdt.ui/ui/org/eclipse/jdt/internal/ui/actions/AbstractOpenWizardWorkbenchAction.java;1;0;3;1;0;0;0;3;4;1;3;15;4;4;1;0;0;3;3;15;0;433;3;1;
/org.eclipse.swt.examples.paint/src/org/eclipse/swt/examples/paint/PaintSurface.java;4;0;8;2;1;1;1;7;69;5;3;513;77;77;5;4;0;7;8;609;4;4705;4;4;
/org.eclipse.jdt.ui.tests.refactoring/test cases/org/eclipse/jdt/ui/tests/refactoring/infra/TextRangeUtil.java;2;0;2;1;0;0;0;2;3;1;2;2481;3;3;1;0;0;2;2;2481;0;3188;2;2;
/org.eclipse.swt/Eclipse SWT/win32/org/eclipse/swt/widgets/Control.java;10;2;68;3;13;10;13;55;162;3;41;106;1497;1497;3;14;3;55;68;1193;17;4846;51;10;
/org.eclipse.core.tests.runtime/src/org/eclipse/core/tests/internal/plugins/FragmentResolveTest_8.java;3;0;4;1;0;0;0;4;1052;1;4;1819;1069;1069;1;0;0;4;4;1819;0;3476;4;3;
/org.eclipse.jdt.core/model/org/eclipse/jdt/internal/core/DeltaProcessor.java;3;4;98;3;32;22;32;66;1538;4;48;455;5939;5939;4;18;10;66;98;1039;28;4721;70;3;
/org.eclipse.help/src/org/eclipse/help/internal/topics/TopicsMap.java;2;0;2;1;0;0;0;2;0;1;2;1675;0;0;1;0;0;2;2;1675;0;1804;2;2;
/org.eclipse.core.resources/src/org/eclipse/core/internal/indexing/ReservationTable.java;2;0;3;1;1;1;1;2;86;1;2;448;101;101;1;0;0;2;3;448;0;4214;3;2;
/org.eclipse.ui.tests/Eclipse UI Tests/org/eclipse/ui/tests/internal/EditorActionBarsTest.java;2;0;4;1;1;1;1;3;53;1;3;1500;57;57;1;0;0;3;4;1500;0;4277;4;2;
/org.eclipse.help/src/org/eclipse/help/internal/toc/TocNode.java;2;0;2;1;0;0;0;2;2;1;2;1857;2;2;1;0;0;2;2;1857;0;3609;2;2;
/org.eclipse.jdt.ui.tests.refactoring/resources/ExtractMethodWorkSpace/ExtractMethodTests/locals_in/A_test523.java;1;1;3;1;2;2;2;1;38;0;1;2684;38;38;1;0;0;1;3;2684;0;4419;3;1;
/org.eclipse.pde.ui/src/org/eclipse/pde/core/IEditable.java;1;0;2;1;0;0;0;2;0;1;2;3579;0;0;1;0;0;2;2;3579;0;3607;2;1;
/org.eclipse.jdt.junit/Eclipse JUnit/org/eclipse/jdt/internal/junit/ui/HierarchyRunView.java;2;0;6;1;0;0;0;6;384;1;6;2007;406;406;1;0;0;6;6;2007;0;3313;6;2;
/org.eclipse.jdt.ui/ui/org/eclipse/jdt/ui/IPackagesViewPart.java;3;1;5;1;2;2;2;3;18;1;3;15;37;37;1;0;0;3;5;15;0;4810;5;3;
/org.eclipse.pde.ui/Eclipse PDE UI/org/eclipse/pde/internal/base/IBasePluginWizard.java;2;0;5;2;0;0;0;5;12;3;3;267;12;12;3;2;0;5;5;324;2;1434;3;2;
/org.eclipse.swt/Eclipse SWT/win32/org/eclipse/swt/widgets/Group.java;8;2;17;1;4;3;4;13;76;1;13;106;233;233;2;0;1;13;17;4557;1;4701;16;8;
/org.eclipse.jdt.ui/core refactoring/org/eclipse/jdt/internal/corext/refactoring/code/ExtractMethodRefactoring.java;4;1;24;1;4;4;4;20;327;2;18;1939;906;906;2;2;0;20;24;3811;2;4427;22;4;
/org.eclipse.core.resources/src/org/eclipse/core/internal/utils/Convert.java;2;0;5;1;1;1;1;4;198;2;3;1014;319;319;2;1;0;4;5;1014;1;4214;4;2;
/org.eclipse.swt.examples.paint/org/eclipse/swt/examples/paint/ContainerFigure.java;3;0;4;2;1;1;1;3;149;2;2;566;149;149;2;1;0;3;4;609;1;4024;3;3;
/org.eclipse.jdt.ui/ui/org/eclipse/jdt/internal/ui/launcher/SourceLookupPropertyPage.java;4;0;13;1;0;0;0;13;193;1;13;15;359;359;1;0;0;13;13;15;0;1916;13;4;
/org.eclipse.jdt.debug/jdi/org/eclipse/jdi/internal/jdwp/JdwpReferenceTypeID.java;2;0;3;1;0;0;0;3;12;1;3;187;13;13;1;0;0;3;3;187;0;3040;3;2;
/org.eclipse.jdt.core/model/org/eclipse/jdt/internal/core/builder/ISearchListener.java;1;0;4;1;0;0;0;4;44;1;4;455;55;55;1;0;0;4;4;455;0;2808;4;1;
/org.eclipse.ui/Eclipse UI/org/eclipse/ui/internal/PerspectiveListenerList.java;4;0;5;1;1;1;1;4;46;1;4;257;77;77;1;0;0;4;5;257;0;4363;5;4;
/org.eclipse.pde.core/src/org/eclipse/pde/internal/core/ifeature/IFeatureURL.java;1;0;1;1;0;0;0;1;0;0;1;3591;0;0;1;0;0;1;1;3591;0;3591;1;1;
/org.eclipse.pde/src/org/eclipse/pde/internal/BaseProject.java;1;0;1;1;0;0;0;1;0;0;1;3631;0;0;1;0;0;1;1;3631;0;3631;1;1;
/org.eclipse.jdt.ui.tests.refactoring/resources/RenameVirtualMethodInClass/testFail2/in/A.java;1;0;1;1;0;0;0;1;0;0;1;49;0;0;1;0;0;1;1;49;0;49;1;1;
/org.eclipse.jdt.ui/ui/org/eclipse/jdt/internal/ui/dialogs/StatusInfo.java;2;0;5;1;0;0;0;5;109;1;5;15;193;193;1;0;0;5;5;15;0;1272;5;2;
/org.eclipse.swt/Eclipse SWT PI/gtk/org/eclipse/swt/internal/gtk/GtkEditable.java;1;0;3;1;0;0;0;3;8;1;3;2107;8;8;1;0;0;3;3;2107;0;3869;3;1;
/org.eclipse.team.core/src/org/eclipse/team/internal/core/target/UrlUtil.java;4;1;6;1;6;6;6;0;23;0;0;4176;56;56;1;0;0;0;6;4176;0;4424;6;4;
/org.eclipse.jdt.core/model/org/eclipse/jdt/internal/core/builder/impl/FieldImplSWH.java;1;0;3;1;0;0;0;3;163;1;3;455;163;163;1;0;0;3;3;455;0;2808;3;1;
/org.eclipse.jdt.core/model/org/eclipse/jdt/internal/core/CompletionRequestorWrapper.java;3;0;15;1;1;1;1;14;293;1;14;455;753;753;1;0;0;14;15;455;0;4063;15;3;
/org.eclipse.jdt.core/dom/org/eclipse/jdt/core/dom/VariableDeclarationStatement.java;2;1;6;1;2;2;2;4;14;1;4;2669;36;36;1;0;0;4;6;2669;0;4453;6;2;
/org.eclipse.jdt.ui/ui/org/eclipse/jdt/internal/ui/wizards/buildpaths/ZipTreeNode.java;1;0;1;1;0;0;0;1;0;0;1;1258;0;0;1;0;0;1;1;1258;0;1258;1;1;
/org.eclipse.swt/Eclipse SWT PI/gtk/org/eclipse/swt/internal/gtk/GtkTargetEntry.java;2;2;6;1;3;2;3;3;24;1;3;3605;53;53;2;0;1;3;6;4701;1;4701;5;2;
/org.eclipse.vcm.tests.core.cvs/src/org/eclipse/vcm/tests/core/cvs/ModulesTest.java;1;0;1;1;0;0;0;1;0;0;1;1688;0;0;1;0;0;1;1;1688;0;1688;1;1;
/org.eclipse.jdt.ui.tests.refactoring/resources/RenamePrivateMethod/test24/out/A.java;1;0;1;1;0;0;0;1;0;0;1;49;0;0;1;0;0;1;1;49;0;49;1;1;
/org.eclipse.jdt.ui/ui/org/eclipse/jdt/internal/ui/wizards/dialogfields/ComboDialogField.java;1;0;3;1;0;0;0;3;13;1;3;1416;24;24;1;0;0;3;3;1416;0;3084;3;1;
/org.eclipse.ui/Eclipse JFace/org/eclipse/jface/action/SubStatusLineManager.java;2;0;2;1;0;0;0;2;5;1;2;257;5;5;1;0;0;2;2;257;0;457;2;2;
/org.eclipse.ant.core/src/plugin/org/eclipse/ant/internal/core/AntCorePreferences.java;1;0;1;1;0;0;0;1;0;0;1;3475;0;0;1;0;0;1;1;3475;0;3475;1;1;
/org.eclipse.core.target/src/org/eclipse/core/target/ITargetStatus.java;2;0;7;1;1;1;1;6;130;1;6;12;187;187;1;0;0;6;7;12;0;4196;7;2;
/org.eclipse.pde.ui/src/org/eclipse/pde/internal/wizards/project/PluginClassCodeGenerator.java;2;0;4;1;0;0;0;4;2;1;4;1434;3;3;1;0;0;4;4;1434;0;3579;4;2;
/org.eclipse.jdt.ui.tests.refactoring/resources/ExtractMethodWorkSpace/ExtractMethodTests/invalidSelection/A_test095.java;2;1;3;1;2;2;2;1;0;0;1;49;0;0;1;0;0;1;3;49;0;4419;3;2;
/org.eclipse.jdt.ui/ui debug/org/eclipse/jdt/internal/debug/ui/OpenOnConsoleTypeAction.java;2;0;4;1;0;0;0;4;4;1;4;1534;7;7;1;0;0;4;4;1534;0;1916;4;2;
/org.eclipse.swt/Eclipse SWT/gtk1x/org/eclipse/swt/graphics/Region.java;3;0;3;1;1;1;1;2;10;1;2;2107;16;16;1;0;0;2;3;2107;0;4701;3;3;
/org.eclipse.jdt.ui.tests.refactoring/resources/RenameMethodInInterface/testFail36/in/A.java;1;0;1;1;0;0;0;1;0;0;1;49;0;0;1;0;0;1;1;49;0;49;1;1;
/org.eclipse.ui.examples.javaeditor/Java Editor Example/org/eclipse/ui/examples/javaeditor/javadoc/JavaDocScanner.java;1;0;2;1;0;0;0;2;0;0;1;1066;0;0;2;1;0;2;2;1066;1;1066;1;1;
/org.eclipse.vcm.core.cvs/src/org/eclipse/vcm/internal/core/ccvs/requests/Status.java;3;0;3;1;0;0;0;3;8;1;3;0;14;14;1;0;0;3;3;0;0;1098;3;3;
/org.eclipse.jdt.core/model/org/eclipse/jdt/core/IMethod.java;3;1;9;1;4;4;4;5;172;1;5;455;281;281;1;0;0;5;9;455;0;4450;9;3;
/org.eclipse.jdt.junit/Eclipse JUnit/org/eclipse/jdt/internal/junit/oldlauncher/JUnitLauncher.java;2;0;2;1;0;0;0;2;0;1;2;2861;0;0;1;0;0;2;2;2861;0;3205;2;2;
/org.eclipse.jdt.core/search/org/eclipse/jdt/internal/core/index/impl/LRUCache.java;2;1;10;1;2;2;2;8;116;4;5;455;170;170;4;3;0;8;10;1039;3;4063;7;2;
/org.eclipse.jdt.ui.tests.refactoring/resources/RenamePackage/test2/out/fred/A.java;1;0;1;1;0;0;0;1;0;0;1;49;0;0;1;0;0;1;1;49;0;49;1;1;
/org.eclipse.pde.core/src/org/eclipse/pde/core/plugin/IPluginBase.java;1;0;3;1;2;1;2;1;176;0;1;3591;176;176;2;0;1;1;3;4751;1;4751;2;1;
/org.eclipse.ui/Eclipse JFace/org/eclipse/jface/viewers/CheckStateChangedEvent.java;2;0;2;1;0;0;0;2;5;1;2;257;5;5;1;0;0;2;2;257;0;457;2;2;
/org.eclipse.pde.ui/src/org/eclipse/pde/internal/core/plugin/ExternalPluginModel.java;1;0;2;1;0;0;0;2;0;1;2;3579;0;0;1;0;0;2;2;3579;0;3607;2;1;
/org.eclipse.update/src/org/eclipse/update/internal/core/ISessionDefiner.java;1;0;1;1;0;0;0;1;0;0;1;1424;0;0;1;0;0;1;1;1424;0;1424;1;1;
/org.eclipse.core.runtime/src/org/eclipse/core/runtime/IStatus.java;3;0;4;1;1;1;1;3;316;1;3;12;338;338;1;0;0;3;4;12;0;4214;4;3;
/org.eclipse.ui/Eclipse JFace Text/org/eclipse/jface/text/BadPositionCategoryException.java;3;0;3;1;0;0;0;3;5;1;3;257;6;6;1;0;0;3;3;257;0;1066;3;3;
/org.eclipse.core.tests.resources/src/org/eclipse/core/tests/internal/builders/MultiProjectBuildTest.java;3;0;6;1;0;0;0;6;460;2;5;1794;472;472;2;1;0;6;6;3415;1;3415;5;3;
/org.eclipse.jdt.ui/core refactoring/org/eclipse/jdt/core/refactoring/text/ITextBuffer.java;1;0;3;1;0;0;0;3;5;1;3;15;5;5;1;0;0;3;3;15;0;408;3;1;
/org.eclipse.jdt.ui.tests.refactoring/resources/RenameMethodInInterface/test46/in/A.java;1;0;1;1;0;0;0;1;0;0;1;1274;0;0;1;0;0;1;1;1274;0;1274;1;1;
/org.eclipse.jdt.ui.tests.refactoring/resources/RenameMethodInInterface/test28/in/A.java;1;0;1;1;0;0;0;1;0;0;1;49;0;0;1;0;0;1;1;49;0;49;1;1;
/org.eclipse.jdt.ui/ui/org/eclipse/jdt/internal/ui/text/template/TemplateEditor.java;1;0;4;1;0;0;0;4;50;2;3;1655;50;50;2;1;0;4;4;1666;1;1720;3;1;
/org.eclipse.pde.ui/src/org/eclipse/pde/internal/editor/NullUndoManager.java;1;0;4;1;0;0;0;4;1;1;4;2851;2;2;1;0;0;4;4;2851;0;3579;4;1;
/org.eclipse.core.tests.runtime/src/org/eclipse/core/tests/internal/plugins/PluginResolveTest_18.java;3;0;3;1;0;0;0;3;110;1;3;1794;120;120;1;0;0;3;3;1794;0;3476;3;3;
/org.eclipse.pde.ui/src/org/eclipse/pde/internal/editor/text/ColorManager.java;2;0;2;1;0;0;0;2;0;1;2;1434;0;0;1;0;0;2;2;1434;0;3579;2;2;
/org.eclipse.jdt.debug/jdi/org/eclipse/jdi/internal/jdwp/JdwpArrayID.java;2;0;3;1;0;0;0;3;12;1;3;187;13;13;1;0;0;3;3;187;0;3040;3;2;
/org.eclipse.jdt.ui.tests.refactoring/resources/RenamePrivateField/test0/in/A.java;1;0;1;1;0;0;0;1;0;0;1;49;0;0;1;0;0;1;1;49;0;49;1;1;
/org.eclipse.swt/Eclipse SWT/gtk/org/eclipse/swt/widgets/FontDialog.java;4;1;12;1;3;3;3;9;161;1;9;2107;279;279;1;0;0;9;12;2107;0;4701;12;4;
/org.eclipse.team.ftp/src/org/eclipse/team/internal/ftp/client/FTPProxyLocation.java;1;0;1;1;1;1;1;0;0;0;0;4285;0;0;1;0;0;0;1;4285;0;4285;1;1;
/org.eclipse.team.tests.cvs.core/src/org/eclipse/team/tests/ccvs/core/EclipseCVSClient.java;2;0;5;1;1;1;1;4;98;2;3;3086;127;127;2;1;0;4;5;3086;1;4545;4;2;
/org.eclipse.compare/compare/org/eclipse/compare/internal/patch/Hunk.java;1;0;2;1;0;0;0;2;11;1;2;2876;11;11;1;0;0;2;2;2876;0;2928;2;1;
/org.eclipse.jdt.core/model/org/eclipse/jdt/internal/core/WorkingCopyElementInfo.java;2;0;5;1;1;1;1;4;16;2;3;455;24;24;2;1;0;4;5;3084;1;4063;4;2;
/org.eclipse.pde.ui/src/org/eclipse/pde/internal/editor/feature/FeatureSpecSection.java;1;0;5;1;0;0;0;5;44;1;5;2951;71;71;1;0;0;5;5;2951;0;3579;5;1;
/org.eclipse.jdt.ui.tests.refactoring/resources/DeleteSourceReference/test3/out/A.java;1;0;1;1;0;0;0;1;0;0;1;2857;0;0;1;0;0;1;1;2857;0;2857;1;1;
/org.eclipse.jdt.ui/core refactoring/org/eclipse/jdt/internal/core/refactoring/nls/NLSLine.java;2;0;2;1;0;0;0;2;0;1;2;1922;0;0;1;0;0;2;2;1922;0;1939;2;2;
/org.eclipse.swt.examples/Eclipse SWT Examples/common/org/eclipse/swt/examples/controlexample/TreeTab.java;1;0;2;1;0;0;0;2;0;1;2;107;0;0;1;0;0;2;2;107;0;611;2;1;
/org.eclipse.jdt.ui.tests.refactoring/resources/ExtractMethodWorkSpace/ExtractMethodTests/locals_out/A_test537.java;1;1;4;1;2;2;2;2;6;1;2;922;8;8;1;0;0;2;4;922;0;4419;4;1;
/org.eclipse.jdt.core/model/org/eclipse/jdt/internal/core/builder/impl/BatchImageBuilder.java;1;0;13;1;0;0;0;13;206;4;9;455;311;311;4;4;0;13;13;1039;4;2808;9;1;
/org.eclipse.pde.ui/src/org/eclipse/pde/internal/forms/renamed/Form.java;1;0;2;1;0;0;0;2;0;1;2;2470;0;0;1;0;0;2;2;2470;0;2691;2;1;
/org.eclipse.ui.tests/Eclipse UI Tests/org/eclipse/ui/tests/dialogs/UIAutomatedSuite.java;2;0;2;1;0;0;0;2;9;1;2;1113;9;9;1;0;0;2;2;1113;0;1344;2;2;
/org.eclipse.swt/Eclipse SWT/motif/org/eclipse/swt/widgets/List.java;9;1;15;1;5;5;5;10;1323;2;9;106;2889;2889;2;1;0;10;15;2064;1;4701;14;9;
/org.eclipse.jdt.core/compiler/org/eclipse/jdt/internal/compiler/HierarchyResolver.java;2;0;25;1;0;0;0;25;606;4;19;455;1690;1690;4;6;0;25;25;1039;6;2790;19;2;
/org.eclipse.jdt.ui.tests.refactoring/test cases/org/eclipse/jdt/ui/tests/refactoring/RenameFieldTests.java;2;0;2;1;0;0;0;2;6;1;2;1896;6;6;1;0;0;2;2;1896;0;1913;2;2;
/org.eclipse.update.ui/src/org/eclipse/update/internal/ui/parts/AboutInfo.java;1;0;1;1;1;1;1;0;0;0;0;4108;0;0;1;0;0;0;1;4108;0;4108;1;1;
/org.eclipse.jdt.ui.tests.refactoring/resources/RenameType/testIllegalTypeName6/in/A.java;1;0;1;1;0;0;0;1;0;0;1;49;0;0;1;0;0;1;1;49;0;49;1;1;
/org.eclipse.ui/Eclipse UI/org/eclipse/ui/internal/WorkbenchWindow.java;8;3;59;3;20;14;20;39;306;3;31;257;1492;1492;3;8;6;39;59;3122;14;4647;45;8;
/org.eclipse.jdt.ui.tests.refactoring/resources/RenameType/testFail65/in/A.java;1;0;1;1;0;0;0;1;0;0;1;49;0;0;1;0;0;1;1;49;0;49;1;1;
/org.eclipse.core.boot/src/org/eclipse/core/internal/boot/ResourceEnumeration.java;2;0;5;1;1;1;1;4;148;1;4;12;211;211;1;0;0;4;5;12;0;4214;5;2;
/org.eclipse.update.core/src/org/eclipse/update/internal/core/SiteStatusAnalyzer.java;1;2;3;1;3;2;3;0;30;0;0;4349;42;42;2;0;1;0;3;4349;1;4408;2;1;
/org.eclipse.core.tests.runtime/src/org/eclipse/core/tests/internal/plugins/LibraryLookupTests.java;1;0;2;1;0;0;0;2;0;1;2;2448;0;0;1;0;0;2;2;2448;0;2499;2;1;
/org.eclipse.pde.ui/src/org/eclipse/pde/internal/editor/manifest/ManifestForm.java;2;0;10;1;0;0;0;10;185;1;10;1434;264;264;1;0;0;10;10;1434;0;3579;10;2;
/org.eclipse.jdt.ui.tests.refactoring/resources/RenameParameters/cannotRename/A_testFail7.java;1;0;1;1;0;0;0;1;0;0;1;233;0;0;1;0;0;1;1;233;0;233;1;1;
/org.eclipse.core.resources/src/org/eclipse/core/internal/events/ResourceChangeListenerList.java;1;0;4;1;1;1;1;3;448;1;3;12;471;471;1;0;0;3;4;12;0;4214;4;1;
/org.eclipse.debug.ui/ui/org/eclipse/debug/internal/ui/DebugSelectionProvider.java;1;0;3;1;0;0;0;3;5;2;2;2263;5;5;2;1;0;3;3;2263;1;2291;2;1;
/org.eclipse.jdt.ui.tests.refactoring/resources/SelectionAnalyzerWorkSpace/SelectionAnalyzerTests/invalidSelection/A_test061.java;1;0;1;1;0;0;0;1;0;0;1;1368;0;0;1;0;0;1;1;1368;0;1368;1;1;
/org.eclipse.pde.ui/Eclipse PDE UI/org/eclipse/pde/internal/base/model/plugin/IJarsModelFactory.java;2;0;5;2;0;0;0;5;12;3;3;267;12;12;3;2;0;5;5;324;2;1434;3;2;
/org.eclipse.jdt.ui/ui/org/eclipse/jdt/internal/ui/jarpackager/IJarPackageWizardPage.java;2;0;6;1;0;0;0;6;9;1;6;239;31;31;1;0;0;6;6;239;0;3529;6;2;
/org.eclipse.pde.build/src/org/eclipse/pde/internal/build/ant/FileSet.java;1;0;4;1;1;1;1;3;18;2;2;3194;20;20;2;1;0;3;4;3571;1;4273;3;1;
/org.eclipse.jdt.core/model/org/eclipse/jdt/internal/core/builder/impl/ProjectResourceCopier.java;1;0;14;1;0;0;0;14;424;4;10;455;509;509;4;4;0;14;14;1039;4;2808;10;1;
/org.eclipse.team.cvs.ui/src/org/eclipse/team/internal/ccvs/ui/merge/MergeWizardStartPage.java;3;1;12;1;3;3;3;9;44;2;8;2641;118;118;2;1;0;9;12;3023;1;4829;11;3;
/org.eclipse.jdt.ui.tests.refactoring/resources/StructureSelectionAction/A_test15.java;1;0;1;1;0;0;0;1;0;0;1;2139;0;0;1;0;0;1;1;2139;0;2139;1;1;
/org.eclipse.jdt.ui/core refactoring/org/eclipse/jdt/internal/corext/refactoring/rename/RenamePrivateMethodRefactoring.java;2;1;12;1;2;2;2;10;37;2;9;1939;93;93;2;1;0;10;12;3185;1;4401;11;2;
/org.eclipse.help/src/org/eclipse/help/internal/navigation/XMLGenerator.java;2;0;2;1;0;0;0;2;0;1;2;1420;0;0;1;0;0;2;2;1420;0;1675;2;2;
/org.eclipse.swt/Eclipse SWT PI/win32/org/eclipse/swt/internal/ole/win32/COSERVERINFO.java;2;0;2;1;1;1;1;1;6;0;1;2069;6;6;1;0;0;1;2;2069;0;4701;2;2;
/org.eclipse.swt/Eclipse SWT/carbon/org/eclipse/swt/widgets/List.java;3;1;4;1;4;4;4;0;57;0;0;4147;80;80;1;0;0;0;4;4147;0;4701;4;3;
/org.eclipse.pde.ui/src/org/eclipse/pde/internal/ui/wizards/templates/AbstractNewPluginTemplateWizard.java;1;0;4;1;0;0;0;4;82;1;4;3579;83;83;1;0;0;4;4;3579;0;3840;4;1;
/org.eclipse.jdt.debug.ui/ui/org/eclipse/jdt/internal/debug/ui/launcher/OpenTypeAction.java;2;0;3;1;0;0;0;3;2;1;3;1915;2;2;1;0;0;3;3;1915;0;2384;3;2;
/org.eclipse.core.resources/src/org/eclipse/core/internal/resources/ResourceException.java;3;0;5;1;1;1;1;4;162;1;4;12;244;244;1;0;0;4;5;12;0;4213;5;3;
/org.eclipse.jdt.ui.tests.refactoring/resources/RenameVirtualMethodInClass/test15/out/A.java;1;0;1;1;0;0;0;1;0;0;1;49;0;0;1;0;0;1;1;49;0;49;1;1;
/org.eclipse.jdt.ui.tests.refactoring/resources/RenameType/test45/out/A.java;1;0;2;1;0;0;0;2;0;1;2;49;0;0;1;0;0;2;2;49;0;522;2;1;
/org.eclipse.jdt.ui.tests.refactoring/resources/ExtractTemp/canExtract/A_test11_in.java;1;0;1;1;0;0;0;1;0;0;1;2481;0;0;1;0;0;1;1;2481;0;2481;1;1;
/org.eclipse.debug.ui/ui/org/eclipse/debug/internal/ui/views/DebugWindowSelectionProvider.java;2;0;5;2;0;0;0;5;20;3;3;2325;26;26;3;2;0;5;5;2325;2;3186;3;2;
/org.eclipse.jdt.ui.tests.refactoring/resources/RenameType/testFail88/in/A.java;1;0;1;1;0;0;0;1;0;0;1;49;0;0;1;0;0;1;1;49;0;49;1;1;
/org.eclipse.jdt.ui/ui/org/eclipse/jdt/internal/ui/search/FindWriteReferencesInWorkingSetAction.java;1;2;9;1;4;3;4;5;52;1;5;1707;96;96;2;0;1;5;9;4140;1;4140;8;1;
/org.eclipse.pde.ui/src/org/eclipse/pde/internal/component/BuildPluginWizard.java;2;0;2;1;0;0;0;2;0;1;2;1434;0;0;1;0;0;2;2;1434;0;2951;2;2;
/org.eclipse.help.ui.win32/src/org/eclipse/help/ui/internal/browser/win32/IDocumentCompleteListener.java;1;0;1;1;1;1;1;0;0;0;0;4427;0;0;1;0;0;0;1;4427;0;4427;1;1;
/org.eclipse.ui/Eclipse UI/org/eclipse/ui/INullSelectionListener.java;2;0;2;1;0;0;0;2;3;1;2;2235;3;3;1;0;0;2;2;2235;0;2732;2;2;
/org.eclipse.ui.tests/Benchmark Tests/org/eclipse/ui/tests/benchmarks/OpenCloseTest.java;1;0;1;1;0;0;0;1;0;0;1;2979;0;0;1;0;0;1;1;2979;0;2979;1;1;
/org.eclipse.jdt.ui.tests.refactoring/resources/MoveCU/testFail7/in/p/B.java;2;0;2;1;0;0;0;2;0;1;2;49;0;0;1;0;0;2;2;49;0;2769;2;2;
/org.eclipse.ui.tests/Eclipse UI Tests/org/eclipse/ui/tests/propertysheet/PropertySheetAuto.java;3;0;5;1;0;0;0;5;26;1;5;1396;34;34;1;0;0;5;5;1396;0;2785;5;3;
/org.eclipse.swt/Eclipse SWT PI/gtk1x/org/eclipse/swt/internal/gtk/GdkColor.java;2;0;2;1;1;1;1;1;3;0;1;2107;3;3;1;0;0;1;2;2107;0;4701;2;2;
/org.eclipse.pde.ui/src/org/eclipse/pde/model/plugin/IPluginExtensionPoint.java;1;0;2;1;0;0;0;2;0;1;2;3039;0;0;1;0;0;2;2;3039;0;3579;2;1;
/org.eclipse.help/src/org/eclipse/help/internal/toc/DirectoryToc.java;1;0;1;1;0;0;0;1;0;0;1;3766;0;0;1;0;0;1;1;3766;0;3766;1;1;
/org.eclipse.help.tests/src/org/eclipse/help/tests/appserver/AllHelpAppserverTests.java;1;0;1;1;0;0;0;1;0;0;1;2881;0;0;1;0;0;1;1;2881;0;2881;1;1;
/org.eclipse.jdt.ui.tests.refactoring/resources/RenamePackage/testFail1/in/r/p1/A.java;1;0;1;1;0;0;0;1;0;0;1;1258;0;0;1;0;0;1;1;1258;0;1258;1;1;
/org.eclipse.jdt.core/codeassist/org/eclipse/jdt/internal/codeassist/ICompletionRequestor.java;1;0;7;1;0;0;0;7;509;1;7;455;1535;1535;1;0;0;7;7;455;0;1803;7;1;
/org.eclipse.jdt.junit/src/org/eclipse/jdt/internal/junit/launcher/JUnitLaunchShortcut.java;1;2;3;1;3;2;3;0;11;0;0;4370;13;13;2;0;1;0;3;4451;1;4451;2;1;
/org.eclipse.update.core/src/org/eclipse/update/internal/core/SiteTypeFactory.java;1;0;5;1;0;0;0;5;9;1;5;2251;18;18;1;0;0;5;5;2251;0;3796;5;1;
/org.eclipse.jdt.ui.tests.refactoring/resources/ExtractTemp/canExtract/A_test4_out.java;1;0;1;1;0;0;0;1;0;0;1;2481;0;0;1;0;0;1;1;2481;0;2481;1;1;
/org.eclipse.pde.ui/src/org/eclipse/pde/internal/wizards/extension/NewExtensionPointWizard.java;2;0;4;1;0;0;0;4;34;1;4;1434;36;36;1;0;0;4;4;1434;0;3579;4;2;
/org.eclipse.scripting/src/org/eclipse/scripting/internal/uirenderer/XGRElementUISwtTextArea.java;1;0;1;1;0;0;0;1;0;0;1;1424;0;0;1;0;0;1;1;1424;0;1424;1;1;
/org.eclipse.ui.tests/Eclipse UI Tests/org/eclipse/ui/tests/internal/ExtendedTextEditor.java;1;0;1;1;0;0;0;1;0;0;1;2236;0;0;1;0;0;1;1;2236;0;2236;1;1;
/org.eclipse.compare/compare/org/eclipse/compare/internal/patch/Diff.java;1;0;2;1;0;0;0;2;11;1;2;2876;11;11;1;0;0;2;2;2876;0;2928;2;1;
/org.eclipse.pde.ui/src/org/eclipse/pde/internal/base/schema/ISchemaElement.java;2;0;2;1;0;0;0;2;0;1;2;1434;0;0;1;0;0;2;2;1434;0;3579;2;2;
/org.eclipse.pde.ui/src/org/eclipse/pde/internal/ui/editor/schema/NewElementAction.java;1;0;2;1;0;0;0;2;2;1;2;3579;2;2;1;0;0;2;2;3579;0;3591;2;1;
/org.eclipse.jdt.debug/jdi interfaces/com/sun/jdi/TypeComponent.java;2;0;2;1;0;0;0;2;10;1;2;2704;10;10;1;0;0;2;2;2704;0;3033;2;2;
/org.eclipse.core.resources/src/org/eclipse/core/internal/resources/IMarkerSetElement.java;2;0;4;1;1;1;1;3;20;1;3;12;41;41;1;0;0;3;4;12;0;4213;4;2;
/org.eclipse.scripting/src/org/eclipse/scripting/internal/views/ScriptUIEditorWhitespaceDetector.java;1;0;1;1;0;0;0;1;0;0;1;1424;0;0;1;0;0;1;1;1424;0;1424;1;1;
/org.eclipse.jdt.ui.tests.refactoring/resources/SelectionAnalyzerWorkSpace/SelectionAnalyzerTests/invalidSelection/A_test013.java;1;0;1;1;0;0;0;1;0;0;1;1368;0;0;1;0;0;1;1;1368;0;1368;1;1;
/org.eclipse.ui/Eclipse UI Tool Script/org/eclipse/toolscript/core/internal/ToolScriptContext.java;1;2;9;1;9;5;9;0;188;0;0;3976;378;378;2;0;4;0;9;3976;4;4083;5;1;
/org.eclipse.jdt.debug.ui/ui/org/eclipse/jdt/internal/debug/ui/actions/ToggleFilterAction.java;3;1;11;2;2;2;2;9;85;2;7;1915;198;198;2;2;0;9;11;2328;2;3933;9;3;
/org.eclipse.jdt.core/compiler/org/eclipse/jdt/internal/compiler/ast/InnerTypeDeclaration.java;2;1;4;1;2;2;2;2;14;1;2;455;22;22;1;0;0;2;4;455;0;4421;4;2;
/org.eclipse.jdt.ui/ui debug/org/eclipse/jdt/internal/debug/ui/ShowFinalFieldsAction.java;2;0;5;1;0;0;0;5;16;1;5;15;31;31;1;0;0;5;5;15;0;1916;5;2;
/org.eclipse.jdt.core/model/org/eclipse/jdt/internal/core/builder/NameEnvironment.java;3;2;16;2;8;6;8;8;64;1;8;2979;352;352;2;0;2;8;16;4063;2;4666;14;3;
/org.eclipse.jdt.ui.tests.refactoring/resources/PullUpMethods/testFail10/in/B.java;1;0;2;1;0;0;0;2;0;1;2;2156;0;0;1;0;0;2;2;2156;0;2406;2;1;
/org.eclipse.update.ui/src/org/eclipse/update/internal/ui/forms/MyComputerForm.java;2;1;4;1;2;2;2;2;5;1;2;3662;10;10;1;0;0;2;4;3662;0;4610;4;2;
/org.eclipse.update.core/src/org/eclipse/update/internal/core/FeatureTypeFactory.java;1;0;4;1;0;0;0;4;96;1;4;2251;106;106;1;0;0;4;4;2251;0;3697;4;1;
/org.eclipse.update/src/org/eclipse/update/internal/core/UMSessionManagerOperation.java;1;0;1;1;0;0;0;1;0;0;1;1424;0;0;1;0;0;1;1;1424;0;1424;1;1;
/org.eclipse.pde.ui/src/org/eclipse/pde/internal/ui/wizards/extension/BaseExtensionPointMainPage.java;1;0;4;1;1;1;1;3;79;1;3;3579;83;83;1;0;0;3;4;3579;0;4551;4;1;
/org.eclipse.jdt.ui.tests.refactoring/resources/ExtractMethodWorkSpace/ExtractMethodTests/expression_in/A_test608.java;2;1;3;1;2;2;2;1;0;0;1;376;0;0;1;0;0;1;3;376;0;4419;3;2;
/org.eclipse.ui/Eclipse UI Standard Components/org/eclipse/ui/views/properties/PropertySheetViewer.java;5;0;9;1;1;1;1;8;1924;1;8;257;2031;2031;1;0;0;8;9;257;0;4385;9;5;
/org.eclipse.jdt.ui.tests.refactoring/resources/RenameVariables/canRename/A_test2_in.java;1;0;2;1;0;0;0;2;0;1;2;724;0;0;1;0;0;2;2;724;0;1665;2;1;
/org.eclipse.jdt.ui/ui refactoring/org/eclipse/jdt/internal/ui/refactoring/PullUpInputPage.java;2;1;17;1;5;5;5;12;84;2;11;2406;325;325;2;1;0;12;17;3323;1;4722;16;2;
/org.eclipse.update/src/org/eclipse/update/internal/ui/JarVerifier.java;1;0;1;1;0;0;0;1;0;0;1;1424;0;0;1;0;0;1;1;1424;0;1424;1;1;
/org.eclipse.update.tests.core/src/org/eclipse/update/tests/api/TestSiteAPI.java;2;1;9;1;2;2;2;7;21;2;6;1531;50;50;2;1;0;7;9;1638;1;3914;8;2;
/org.eclipse.swt/Eclipse SWT Drag and Drop/carbon/org/eclipse/swt/dnd/TransferData.java;4;1;5;1;5;5;5;0;27;0;0;4147;38;38;1;0;0;0;5;4147;0;4701;5;4;
/org.eclipse.jdt.ui.tests.refactoring/resources/InlineTemp/canInline/A_test21_in.java;1;0;1;1;1;1;1;0;0;0;0;4403;0;0;1;0;0;0;1;4403;0;4403;1;1;
/org.eclipse.jdt.ui.tests.refactoring/test cases/org/eclipse/jdt/ui/tests/refactoring/SefTestSetup.java;2;0;4;1;1;1;1;3;6;1;3;2155;9;9;1;0;0;3;4;2155;0;4081;4;2;
/org.eclipse.swt/Eclipse SWT/common/org/eclipse/swt/graphics/ImageData.java;6;1;19;2;2;2;2;17;3627;4;11;106;4435;4435;4;6;0;17;19;747;6;4701;13;6;
/org.eclipse.pde.build/src/org/eclipse/pde/internal/build/ModelBuildScriptGenerator.java;7;2;69;1;22;18;22;47;1492;3;38;245;5443;5443;3;9;4;47;69;256;13;4438;56;7;
/org.eclipse.team.cvs.core/src/org/eclipse/team/internal/ccvs/core/response/custom/DiffMessageHandler.java;2;0;3;1;0;0;0;3;102;1;3;1992;102;102;1;0;0;3;3;1992;0;2607;3;2;
/org.eclipse.scripting/Eclipse Scripting/org/eclipse/scripting/internal/uirenderer/XGRElementUISwtRadioButton.java;2;0;6;1;0;0;0;6;42;1;6;133;57;57;1;0;0;6;6;133;0;1424;6;2;
/org.eclipse.pde.ui/src/org/eclipse/pde/internal/base/model/feature/IVersonable.java;1;0;3;1;0;0;0;3;3;1;3;2951;3;3;1;0;0;3;3;2951;0;3579;3;1;
/org.eclipse.jdt.launching/launching/org/eclipse/jdt/launching/IRuntimeClasspathProvider.java;1;2;4;1;4;3;4;0;33;0;0;4126;41;41;2;0;1;0;4;4126;1;4650;3;1;
/org.eclipse.swt.examples.paint/org/eclipse/swt/examples/paint/EllipseFigure.java;4;0;5;2;1;1;1;4;65;2;3;566;76;76;2;1;0;4;5;609;1;4024;4;4;
/org.eclipse.team.tests.cvs.core/src/org/eclipse/team/tests/ccvs/ui/ICriteria.java;1;0;1;1;0;0;0;1;0;0;1;2977;0;0;1;0;0;1;1;2977;0;2977;1;1;
/org.eclipse.vcm.ui/src/org/eclipse/vcm/internal/ui/model/ResourceEditionElement.java;4;0;6;1;0;0;0;6;22;2;5;1;54;54;2;1;0;6;6;237;1;1273;5;4;
/org.eclipse.jdt.core/model/org/eclipse/jdt/core/util/IBytecodeVisitor.java;2;1;5;1;4;4;4;1;18;0;1;3629;36;36;1;0;0;1;5;3629;0;4573;5;2;
/org.eclipse.jdt.core/codeassist/org/eclipse/jdt/internal/codeassist/select/SelectionOnFieldType.java;2;0;2;1;1;1;1;1;14;0;1;2525;14;14;1;0;0;1;2;2525;0;4062;2;2;
/org.eclipse.core.runtime/src/org/eclipse/core/runtime/CoreException.java;3;0;6;1;1;1;1;5;156;1;5;12;224;224;1;0;0;5;6;12;0;4214;6;3;
/org.eclipse.vcm.core.cvs/src/org/eclipse/vcm/internal/core/ccvs/client/IRequestContext.java;3;0;4;1;0;0;0;4;10;1;4;0;20;20;1;0;0;4;4;0;0;1627;4;3;
/org.eclipse.pde.ui/src/org/eclipse/pde/internal/feature/FeatureJarWizardPage.java;1;0;6;1;0;0;0;6;30;2;5;2951;36;36;2;1;0;6;6;3102;1;3113;5;1;
/org.eclipse.jdt.core/model/org/eclipse/jdt/core/util/IModifierConstants.java;2;1;4;1;3;3;3;1;18;0;1;3629;34;34;1;0;0;1;4;3629;0;4573;4;2;
/org.eclipse.help/src/org/eclipse/help/internal/contributions/xml1_0/HelpContribution.java;2;0;6;1;0;0;0;6;30;1;6;1675;38;38;1;0;0;6;6;1675;0;2217;6;2;
/org.eclipse.jdt.ui/core refactoring/org/eclipse/jdt/core/refactoring/ICompositeChange.java;1;0;3;1;0;0;0;3;5;1;3;15;5;5;1;0;0;3;3;15;0;408;3;1;
/org.eclipse.pde.ui/src/org/eclipse/pde/internal/forms/renamed/FormButton.java;1;0;2;1;0;0;0;2;0;1;2;2470;0;0;1;0;0;2;2;2470;0;2691;2;1;
/org.eclipse.jdt.ui/ui debug/org/eclipse/jdt/internal/debug/ui/JavaBreakpointPropertySource.java;2;0;2;1;0;0;0;2;0;1;2;1330;0;0;1;0;0;2;2;1330;0;1916;2;2;
/org.eclipse.jdt.ui.tests.refactoring/resources/RenameMethodInInterface/test14/in/A.java;1;0;1;1;0;0;0;1;0;0;1;49;0;0;1;0;0;1;1;49;0;49;1;1;
/org.eclipse.jdt.debug/jdi interfaces/com/sun/jdi/request/MethodEntryRequest.java;2;0;2;1;0;0;0;2;12;1;2;2704;12;12;1;0;0;2;2;2704;0;3040;2;2;
/org.eclipse.jdt.ui.tests.refactoring/resources/RenameTemp/canRename/A_test43_out.java;1;0;1;1;0;0;0;1;0;0;1;3322;0;0;1;0;0;1;1;3322;0;3322;1;1;
/org.eclipse.jdt.debug/model/org/eclipse/jdt/debug/core/ISnippetSupportLineBreakpoint.java;2;0;3;1;0;0;0;3;12;1;3;1035;12;12;1;0;0;3;3;1035;0;1639;3;2;
/org.eclipse.jdt.ui.tests.refactoring/resources/ExtractMethodWorkSpace/ExtractMethodTests/semicolon_in/A_test410.java;1;1;3;1;2;2;2;1;4;0;1;1236;4;4;1;0;0;1;3;1236;0;4419;3;1;
/org.eclipse.swt/Eclipse SWT/photon/org/eclipse/swt/widgets/SelectableItemWidget.java;2;0;5;1;0;0;0;5;48;1;5;106;82;82;1;0;0;5;5;106;0;1028;5;2;
/org.eclipse.jdt.ui.tests.refactoring/resources/RenameMethodInInterface/test5/out/A.java;1;0;1;1;0;0;0;1;0;0;1;49;0;0;1;0;0;1;1;49;0;49;1;1;
/org.eclipse.search/search/org/eclipse/search/internal/ui/RemoveResultAction.java;2;1;9;1;2;2;2;7;20;1;7;15;103;103;1;0;0;7;9;15;0;4747;9;2;
/org.eclipse.jdt.ui/ui/org/eclipse/jdt/internal/ui/search/WorkingSetsComparator.java;1;0;1;1;0;0;0;1;0;0;1;3760;0;0;1;0;0;1;1;3760;0;3760;1;1;
/org.eclipse.jdt.debug/model/org/eclipse/jdt/internal/debug/core/JDIVoidType.java;2;0;2;1;0;0;0;2;0;1;2;1700;0;0;1;0;0;2;2;1700;0;2517;2;2;
/org.eclipse.ui/Eclipse UI/org/eclipse/ui/internal/SetPageAction.java;4;0;4;1;0;0;0;4;8;1;4;257;10;10;1;0;0;4;4;257;0;3050;4;4;
/org.eclipse.jdt.ui.tests.refactoring/resources/MoveMembers/testFail4/in/A.java;1;0;1;1;0;0;0;1;0;0;1;2738;0;0;1;0;0;1;1;2738;0;2738;1;1;
/org.eclipse.help/src/org/eclipse/help/internal/context/ContextContributionParser.java;2;0;3;1;0;0;0;3;6;1;3;2217;6;6;1;0;0;3;3;2217;0;2829;3;2;
/org.eclipse.update.ui/src/org/eclipse/update/internal/ui/manager/InfoGroup.java;3;0;11;1;0;0;0;11;20;2;10;1703;73;73;2;1;0;11;11;2434;1;2781;10;3;
/org.eclipse.ui.examples.javaeditor/Java Editor Example/org/eclipse/ui/examples/javaeditor/util/JavaColorProvider.java;1;0;2;1;0;0;0;2;0;0;1;1066;0;0;2;1;0;2;2;1066;1;1066;1;1;
/org.eclipse.swt.examples/Eclipse SWT Examples/common/org/eclipse/swt/examples/controlexample/TextTab.java;1;0;2;1;0;0;0;2;0;1;2;107;0;0;1;0;0;2;2;107;0;611;2;1;
/org.eclipse.swt.examples.paint/org/eclipse/swt/examples/paint/TextFigure.java;3;0;4;2;1;1;1;3;93;2;2;586;93;93;2;1;0;3;4;609;1;4024;3;3;
/org.eclipse.pde.ui/src/org/eclipse/pde/internal/ui/editor/feature/IncludedFeaturesSection.java;1;1;3;1;3;3;3;0;4;0;0;3982;6;6;1;0;0;0;3;3982;0;4592;3;1;
/org.eclipse.debug.ui/ui/org/eclipse/debug/internal/ui/ShowVariableDetailPaneAction.java;3;0;6;1;0;0;0;6;15;1;6;1738;22;22;1;0;0;6;6;1738;0;2382;6;3;
/org.eclipse.swt/Eclipse SWT PI/gtk/org/eclipse/swt/internal/gtk/GtkCombo.java;2;0;5;1;2;1;2;3;20;1;3;2107;32;32;2;0;1;3;5;4701;1;4701;4;2;
/org.eclipse.jdt.ui/core refactoring/org/eclipse/jdt/internal/core/refactoring/nls/NLSMessages.java;2;0;2;1;0;0;0;2;0;1;2;1923;0;0;1;0;0;2;2;1923;0;1939;2;2;
/org.eclipse.swt/Eclipse SWT Program/motif_j2se/org/eclipse/swt/program/Program.java;1;0;1;1;0;0;0;1;0;0;1;1387;0;0;1;0;0;1;1;1387;0;1387;1;1;
/org.eclipse.jdt.junit/Eclipse JUnit/org/eclipse/jdt/junit/util/ArrayUtil.java;2;0;2;1;0;0;0;2;0;1;2;1511;0;0;1;0;0;2;2;1511;0;1996;2;2;
/org.eclipse.pde.ui/src/org/eclipse/pde/internal/model/component/ComponentURL.java;2;0;2;1;0;0;0;2;0;1;2;1434;0;0;1;0;0;2;2;1434;0;2951;2;2;
/org.eclipse.jdt.ui/core refactoring/org/eclipse/jdt/internal/corext/refactoring/changes/DeleteFromClasspathChange.java;2;0;3;1;0;0;0;3;12;1;3;1939;15;15;1;0;0;3;3;1939;0;3646;3;2;
/org.eclipse.debug.core/core/org/eclipse/debug/internal/core/ListenerList.java;3;0;6;1;0;0;0;6;50;1;6;187;81;81;1;0;0;6;6;187;0;1763;6;3;
/org.eclipse.pde.ui/src/org/eclipse/pde/internal/base/IExtensionWizard.java;2;0;3;1;0;0;0;3;8;1;3;1434;8;8;1;0;0;3;3;1434;0;3039;3;2;
/org.eclipse.vcm.core/src/org/eclipse/vcm/internal/core/VCMEvent.java;3;0;3;1;0;0;0;3;2;1;3;109;4;4;1;0;0;3;3;109;0;1240;3;3;
/org.eclipse.ui/Eclipse UI/org/eclipse/ui/part/PluginTransferData.java;2;0;2;1;0;0;0;2;5;1;2;257;5;5;1;0;0;2;2;257;0;457;2;2;
/org.eclipse.jdt.debug/jdi/org/eclipse/jdi/internal/jdwp/JdwpObjectID.java;2;0;3;1;0;0;0;3;12;1;3;187;13;13;1;0;0;3;3;187;0;3040;3;2;
/org.eclipse.jdt.core/model/org/eclipse/jdt/internal/core/util/Disassembler.java;3;2;18;2;12;8;12;6;352;3;3;3629;997;997;3;3;4;6;18;3629;7;4520;11;3;
/org.eclipse.pde.ui/src/org/eclipse/pde/internal/ui/editor/SystemFileStorage.java;1;0;1;1;0;0;0;1;0;0;1;3579;0;0;1;0;0;1;1;3579;0;3579;1;1;
/org.eclipse.ui/Eclipse UI Standard Components/org/eclipse/ui/views/framelist/GoIntoAction.java;2;0;2;1;1;1;1;1;2;0;1;3498;2;2;1;0;0;1;2;3498;0;4609;2;2;
/org.eclipse.update.core/src/org/eclipse/update/core/model/ParsingException.java;2;0;7;2;0;0;0;7;10;2;6;2803;21;21;2;1;0;7;7;3571;1;3571;6;2;
/org.eclipse.jdt.debug/jdi/org/eclipse/jdi/internal/event/ThreadStartEventImpl.java;2;0;4;1;0;0;0;4;17;1;4;187;31;31;1;0;0;4;4;187;0;3670;4;2;
/org.eclipse.jdt.debug/jdi interfaces/com/sun/jdi/FloatType.java;2;0;2;1;0;0;0;2;6;1;2;2704;6;6;1;0;0;2;2;2704;0;3033;2;2;
/org.eclipse.update.ui/src/org/eclipse/update/internal/ui/wizards/NewUpdatesWizardPage.java;2;2;5;1;5;4;5;0;131;0;0;4294;148;148;2;0;1;0;5;4294;1;4715;4;2;
/org.eclipse.pde.ui/src/org/eclipse/pde/internal/editor/text/IPDEColorConstants.java;2;0;2;1;0;0;0;2;0;1;2;1434;0;0;1;0;0;2;2;1434;0;3579;2;2;
/org.eclipse.ui/Eclipse JFace Text/org/eclipse/jface/text/source/AnnotationModel.java;4;0;6;1;1;1;1;5;105;1;5;257;163;163;1;0;0;5;6;257;0;4838;6;4;
/org.eclipse.jdt.debug.tests/testprograms/CompileError.java;2;1;2;1;2;2;2;0;11;0;0;4299;11;11;1;0;0;0;2;4299;0;4571;2;2;
/org.eclipse.jdt.launching/launching/org/eclipse/jdt/launching/sourcelookup/DirectorySourceLocation.java;1;2;7;1;4;3;4;3;114;2;2;2372;162;162;2;1;1;3;7;2372;2;4406;5;1;
/org.eclipse.swt/Eclipse SWT/photon/org/eclipse/swt/widgets/TreeItem.java;2;0;5;1;0;0;0;5;298;1;5;106;726;726;1;0;0;5;5;106;0;1028;5;2;
/org.eclipse.swt/Eclipse SWT/photon/org/eclipse/swt/internal/photon/PtFileSelectionInfo_t.java;2;0;3;1;0;0;0;3;6;1;3;106;6;6;1;0;0;3;3;106;0;2069;3;2;
/org.eclipse.update.ui.forms/src/org/eclipse/update/ui/forms/internal/engine/IParagraph.java;1;0;6;1;1;1;1;5;7;1;5;2745;13;13;1;0;0;5;6;2745;0;4365;6;1;
/org.eclipse.jdt.ui/ui/org/eclipse/jdt/internal/ui/wizards/buildpaths/VisibilityWorkbookPage.java;1;0;3;1;0;0;0;3;10;1;3;1384;10;10;1;0;0;3;3;1384;0;1548;3;1;
/org.eclipse.jdt.core/model/org/eclipse/jdt/internal/core/OpenableElementInfo.java;2;0;3;1;1;1;1;2;16;1;2;455;20;20;1;0;0;2;3;455;0;4063;3;2;
/org.eclipse.ui/Eclipse UI/org/eclipse/ui/IWorkbenchPartReference.java;2;1;3;1;3;3;3;0;46;0;0;4063;66;66;1;0;0;0;3;4063;0;4258;3;2;
/org.eclipse.swt/Eclipse SWT/win32/org/eclipse/swt/internal/win32/TRACKMOUSEEVENT.java;2;0;3;1;0;0;0;3;4;1;3;106;4;4;1;0;0;3;3;106;0;2069;3;2;
/org.eclipse.jdt.debug/jdi interfaces/com/sun/jdi/VMOutOfMemoryException.java;2;0;2;1;0;0;0;2;4;1;2;2704;4;4;1;0;0;2;2;2704;0;3033;2;2;
/org.eclipse.ui/Eclipse JFace/org/eclipse/jface/preference/FieldEditor.java;2;0;2;1;0;0;0;2;5;1;2;257;5;5;1;0;0;2;2;257;0;457;2;2;
/org.eclipse.pde.ui/src/org/eclipse/pde/internal/component/BuildComponentJarAction.java;2;0;2;1;0;0;0;2;0;1;2;1434;0;0;1;0;0;2;2;1434;0;2951;2;2;
/org.eclipse.swt.examples/org/eclipse/swt/examples/javaviewer/JavaViewer.java;4;0;5;1;1;1;1;4;180;1;4;513;250;250;1;0;0;4;5;513;0;4024;5;4;
/org.eclipse.team.cvs.core/src/org/eclipse/team/internal/ccvs/core/syncinfo/ICacheLoader.java;1;0;2;1;0;0;0;2;0;1;2;2690;0;0;1;0;0;2;2;2690;0;3125;2;1;
/org.eclipse.pde.build/src/org/eclipse/pde/internal/build/antwrappers/Echo.java;2;0;2;1;0;0;0;2;0;1;2;2859;0;0;1;0;0;2;2;2859;0;2900;2;2;
/org.eclipse.pde.build/src/org/eclipse/pde/internal/build/FragmentScriptGenerator.java;1;0;1;1;0;0;0;1;0;0;1;2945;0;0;1;0;0;1;1;2945;0;2945;1;1;
/org.eclipse.team.tests.cvs.core/src/org/eclipse/team/tests/ccvs/ui/benchmark/BenchmarkTestSetup.java;1;0;1;1;0;0;0;1;0;0;1;2977;0;0;1;0;0;1;1;2977;0;2977;1;1;
/org.eclipse.jdt.ui.tests.refactoring/resources/RenameMethodInInterface/test10/out/A.java;1;0;1;1;0;0;0;1;0;0;1;49;0;0;1;0;0;1;1;49;0;49;1;1;
/org.eclipse.jdt.debug/model/org/eclipse/jdt/internal/debug/core/JavaBreakpointFactory.java;2;0;3;1;0;0;0;3;41;1;3;831;41;41;1;0;0;3;3;831;0;1118;3;2;
/org.eclipse.jdt.ui.tests.refactoring/resources/ExtractMethodWorkSpace/ExtractMethodTests/try_in/A_test451.java;2;1;3;1;2;2;2;1;20;0;1;65;20;20;1;0;0;1;3;65;0;4419;3;2;
/org.eclipse.vcm.core/src/org/eclipse/vcm/internal/core/base/ISubscriber.java;4;0;4;1;0;0;0;4;60;1;4;0;71;71;1;0;0;4;4;0;0;1349;4;4;
/org.eclipse.ui/Eclipse UI/org/eclipse/ui/PartInitException.java;2;0;2;1;0;0;0;2;5;1;2;257;5;5;1;0;0;2;2;257;0;457;2;2;
/org.eclipse.pde.ui/src/org/eclipse/pde/internal/wizards/project/DefaultCodeGenerationPage.java;2;0;8;1;0;0;0;8;1018;2;7;1434;1039;1039;2;1;0;8;8;2691;1;3240;7;2;
/org.eclipse.scripting/Eclipse Scripting/org/eclipse/scripting/internal/IXGRDataNodeXml.java;1;0;3;1;0;0;0;3;4;1;3;133;4;4;1;0;0;3;3;133;0;1424;3;1;
/org.eclipse.search/search/org/eclipse/search/internal/ui/util/MessageLine.java;2;0;5;1;0;0;0;5;18;1;5;15;31;31;1;0;0;5;5;15;0;1400;5;2;
/org.eclipse.team.cvs.ui/src/org/eclipse/team/internal/ccvs/ui/CVSMoveDeleteHook.java;3;0;14;1;1;1;1;13;116;2;10;3402;254;254;2;3;0;13;14;3402;3;4007;11;3;
/org.eclipse.jdt.ui.tests.refactoring/resources/PullUpMethods/test8/out/A.java;1;0;4;1;0;0;0;4;5;1;4;2156;9;9;1;0;0;4;4;2156;0;2406;4;1;
/org.eclipse.jdt.ui.tests.refactoring/resources/ExtractMethodWorkSpace/ExtractMethodTests/error_out/A_test800.java;1;1;3;1;2;2;2;1;0;0;1;3220;0;0;1;0;0;1;3;3220;0;4419;3;1;
/org.eclipse.jdt.ui/core extension/org/eclipse/jdt/internal/corext/util/IOCloser.java;1;0;1;1;1;1;1;0;0;0;0;4602;0;0;1;0;0;0;1;4602;0;4602;1;1;
/org.eclipse.swt.examples/org/eclipse/swt/examples/fileviewer/FileDisplayInfo.java;2;0;3;2;0;0;0;3;1;2;2;554;1;1;2;1;0;3;3;609;1;609;2;2;
/org.eclipse.swt.tests/JUnit Tests/org/eclipse/swt/tests/junit/Test_org_eclipse_swt_graphics_Point.java;2;0;2;1;1;1;1;1;6;0;1;1792;6;6;1;0;0;1;2;1792;0;4706;2;2;
/org.eclipse.team.cvs.ui/src/org/eclipse/team/internal/ccvs/ui/actions/ConfigureTagsFromRepoView.java;2;1;6;1;2;2;2;4;116;1;4;3545;141;141;1;0;0;4;6;3545;0;4021;6;2;
/org.eclipse.jdt.ui.tests.refactoring/test cases/org/eclipse/jdt/ui/tests/refactoring/RefactoringScannerTests.java;2;0;5;1;0;0;0;5;14;1;5;1896;26;26;1;0;0;5;5;1896;0;3481;5;2;
/org.eclipse.ui.examples.javaeditor/Eclipse Java Editor Example/org/eclipse/ui/examples/javaeditor/JavaDocumentProvider.java;1;0;1;1;0;0;0;1;0;0;1;1067;0;0;1;0;0;1;1;1067;0;1067;1;1;
/org.eclipse.jdt.debug/jdi/org/eclipse/jdi/hcr/OperationRefusedException.java;1;0;2;1;0;0;0;2;12;1;2;187;12;12;1;0;0;2;2;187;0;366;2;1;
/org.eclipse.help/webapps/examples/WEB-INF/classes/validators/DebugValidator.java;1;0;2;1;0;0;0;2;0;1;2;1882;0;0;1;0;0;2;2;1882;0;1930;2;1;
/org.eclipse.help/src/org/eclipse/help/internal/contributors/TopicContributor.java;2;0;2;1;0;0;0;2;0;1;2;1420;0;0;1;0;0;2;2;1420;0;1675;2;2;
/org.eclipse.swt/Eclipse SWT PI/win32/org/eclipse/swt/internal/ole/win32/IOleWindow.java;2;0;2;1;1;1;1;1;6;0;1;2069;6;6;1;0;0;1;2;2069;0;4701;2;2;
/org.eclipse.jdt.ui.tests.refactoring/resources/RenameTemp/canRename/A_test18_in.java;1;0;2;1;0;0;0;2;2;1;2;1625;2;2;1;0;0;2;2;1625;0;1652;2;1;
/org.eclipse.ui/Eclipse UI/org/eclipse/ui/internal/dialogs/DecoratorsPreferencePage.java;4;3;15;2;8;6;8;7;180;2;6;3505;416;416;3;1;2;7;15;3955;3;4626;12;4;
/org.eclipse.team.core/src/org/eclipse/team/core/sync/ILocalSyncElement.java;3;1;9;2;5;5;5;4;28;2;3;2019;127;127;2;1;0;4;9;2019;1;4707;8;3;
/org.eclipse.jdt.debug.ui/ui/org/eclipse/jdt/internal/debug/ui/launcher/MainTab.java;2;0;11;1;0;0;0;11;581;2;10;2180;878;878;2;1;0;11;11;2254;1;2586;10;2;
/org.eclipse.jdt.ui.tests.refactoring/resources/RenameType/test5/in/A.java;1;0;1;1;0;0;0;1;0;0;1;49;0;0;1;0;0;1;1;49;0;49;1;1;
/org.eclipse.jdt.core/compiler/org/eclipse/jdt/internal/compiler/lookup/BindingIds.java;2;0;3;1;1;1;1;2;15;1;2;455;20;20;1;0;0;2;3;455;0;4062;3;2;
/org.eclipse.swt.examples.paint/src/org/eclipse/swt/examples/paint/SolidPolygonFigure.java;3;0;4;2;1;1;1;3;67;2;2;586;73;73;2;1;0;3;4;609;1;4705;3;3;
/org.eclipse.debug.core/core/org/eclipse/debug/core/DebugPlugin.java;4;1;38;2;3;3;3;35;190;3;28;187;1100;1100;3;7;0;35;38;1725;7;4650;31;4;
/org.eclipse.pde.ui/Eclipse PDE UI/org/eclipse/pde/internal/schema/AbstractSchemaDescriptor.java;2;0;5;2;0;0;0;5;12;3;3;267;12;12;3;2;0;5;5;324;2;1434;3;2;
/org.eclipse.jdt.debug/eval/org/eclipse/jdt/internal/debug/eval/ast/ASTAPIEvaluationEngine.java;2;0;4;2;0;0;0;4;363;2;3;3329;363;363;2;1;0;4;4;3355;1;3386;3;2;
/org.eclipse.swt/Eclipse SWT/motif/org/eclipse/swt/internal/motif/XInputEvent.java;2;0;3;1;0;0;0;3;4;1;3;106;4;4;1;0;0;3;3;106;0;2069;3;2;
/org.eclipse.jdt.ui.tests.refactoring/resources/ExtractMethodWorkSpace/ExtractMethodTests/return_in/A_test725.java;1;1;3;1;2;2;2;1;34;0;1;2684;34;34;1;0;0;1;3;2684;0;4419;3;1;
/org.eclipse.ui.tests/Eclipse UI Tests/org/eclipse/ui/tests/dialogs/UIInteractiveSuite.java;2;0;2;1;0;0;0;2;9;1;2;1113;9;9;1;0;0;2;2;1113;0;1344;2;2;
/org.eclipse.swt/Eclipse SWT/common/org/eclipse/swt/graphics/ImageLoaderEvent.java;5;0;7;1;1;1;1;6;6;1;6;106;24;24;1;0;0;6;7;106;0;4701;7;5;
/org.eclipse.ui/Eclipse UI/org/eclipse/ui/internal/dialogs/PerspectivesPreferencePage.java;7;2;16;2;4;3;4;12;868;1;12;257;1253;1253;2;0;1;12;16;4144;1;4166;15;7;
/org.eclipse.swt.examples.paint/src/org/eclipse/swt/examples/paint/PaintTool.java;3;0;3;1;1;1;1;2;13;1;2;513;19;19;1;0;0;2;3;513;0;4705;3;3;
/org.eclipse.jdt.ui/ui/org/eclipse/jdt/internal/ui/dialogs/MainTypeSelectionDialog.java;8;0;16;1;1;1;1;15;102;3;12;15;274;274;3;3;0;15;16;1256;3;4358;13;8;
/org.eclipse.jdt.core/model/org/eclipse/jdt/internal/core/builder/IDeltaKey.java;1;0;4;1;0;0;0;4;19;1;4;455;27;27;1;0;0;4;4;455;0;2808;4;1;
/org.eclipse.help.ui.win32/src/org/eclipse/help/ui/internal/browser/win32/WebBrowser.java;2;1;3;1;3;3;3;0;15;0;0;4427;19;19;1;0;0;0;3;4427;0;4607;3;2;
/org.eclipse.jdt.ui.tests.refactoring/resources/SelectionAnalyzerWorkSpace/SelectionAnalyzerTests/invalidSelection/A_test131.java;2;0;3;1;0;0;0;3;0;1;3;1368;0;0;1;0;0;3;3;1368;0;2327;3;2;
/org.eclipse.team.tests.cvs.core/src/org/eclipse/team/tests/ccvs/core/compatible/CompatibleTestSetup.java;2;0;5;1;0;0;0;5;21;1;5;2536;31;31;1;0;0;5;5;2536;0;3610;5;2;
/org.eclipse.pde.ui/Eclipse PDE UI/org/eclipse/pde/internal/preferences/CheckOption.java;2;0;6;2;0;0;0;6;12;3;4;267;14;14;3;2;0;6;6;324;2;1434;4;2;
/org.eclipse.pde.runtime/src/org/eclipse/pde/internal/runtime/logview/StatusPropertyPage.java;2;0;2;1;0;0;0;2;0;1;2;1434;0;0;1;0;0;2;2;1434;0;3877;2;2;
/org.eclipse.jdt.ui.tests.refactoring/resources/ReorderParameters/canReorder/A_test7_out.java;1;0;4;1;0;0;0;4;2;2;3;724;2;2;2;1;0;4;4;724;1;2270;3;1;
/org.eclipse.help/Eclipse Help/org/eclipse/help/internal/server/TempURL.java;3;0;6;1;0;0;0;6;8;1;6;135;21;21;1;0;0;6;6;135;0;1420;6;3;
/org.eclipse.jdt.ui.tests.refactoring/test cases/org/eclipse/jdt/ui/tests/refactoring/NullRefactoring.java;1;0;2;1;0;0;0;2;8;1;2;1896;8;8;1;0;0;2;2;1896;0;1939;2;1;
/org.eclipse.jdt.ui.tests/JUnit/junit/swingui/TestTreeModel.java;2;0;2;1;0;0;0;2;0;1;2;49;0;0;1;0;0;2;2;49;0;1186;2;2;
/org.eclipse.help/src/org/eclipse/help/internal/contributors/InfosetsContributor.java;2;0;2;1;0;0;0;2;0;1;2;1420;0;0;1;0;0;2;2;1420;0;1675;2;2;
/org.eclipse.swt.tests/JUnit Tests/org/eclipse/swt/tests/junit/Test_org_eclipse_swt_events_FocusAdapter.java;2;0;2;1;1;1;1;1;6;0;1;1792;6;6;1;0;0;1;2;1792;0;4706;2;2;
/org.eclipse.ui/Eclipse JFace/org/eclipse/jface/window/Window.java;5;1;13;1;5;5;5;8;89;1;8;257;178;178;1;0;0;8;13;257;0;4547;13;5;
/org.eclipse.pde.ui/src/org/eclipse/pde/internal/ui/view/FileAdapterPropertySource.java;1;0;1;1;0;0;0;1;0;0;1;3579;0;0;1;0;0;1;1;3579;0;3579;1;1;
/org.eclipse.swt/Eclipse SWT PI/gtk1x/org/eclipse/swt/internal/gtk/GtkCombo.java;2;0;2;1;1;1;1;1;3;0;1;2107;3;3;1;0;0;1;2;2107;0;4701;2;2;
/org.eclipse.jdt.ui.tests.refactoring/resources/MoveMembers/test23/in/B.java;1;0;1;1;0;0;0;1;0;0;1;2928;0;0;1;0;0;1;1;2928;0;2928;1;1;
/org.eclipse.jdt.ui.tests.refactoring/test cases/org/eclipse/jdt/ui/tests/actions/PasteResourcesFromClipboardActionTest.java;2;2;11;2;4;3;4;7;41;2;6;3168;116;116;2;1;1;7;11;3826;2;4275;9;2;
/org.eclipse.ui/Eclipse UI/org/eclipse/ui/internal/WorkingSetRegistry.java;1;0;1;1;0;0;0;1;0;0;1;3332;0;0;1;0;0;1;1;3332;0;3332;1;1;
/org.eclipse.webdav/src/client/org/eclipse/webdav/client/ResponseInputStream.java;3;0;5;1;1;1;1;4;98;1;4;12;140;140;1;0;0;4;5;12;0;4211;5;3;
/org.eclipse.swt.tests/JUnit Tests/org/eclipse/swt/tests/junit/Test_org_eclipse_swt_graphics_FontMetrics.java;2;0;2;1;1;1;1;1;6;0;1;1792;6;6;1;0;0;1;2;1792;0;4706;2;2;
/org.eclipse.jdt.ui.tests.refactoring/resources/DeleteSourceReferenceEdit/A_test1_in.java;1;0;1;1;0;0;0;1;0;0;1;2857;0;0;1;0;0;1;1;2857;0;2857;1;1;
/org.eclipse.jdt.ui.tests.refactoring/resources/SelectionAnalyzerWorkSpace/SelectionAnalyzerTests/validSelection/A_test143_.java;1;0;1;1;0;0;0;1;0;0;1;2139;0;0;1;0;0;1;1;2139;0;2139;1;1;
/org.eclipse.jdt.debug/eval/org/eclipse/jdt/debug/eval/ast/model/IArrayType.java;1;0;2;1;0;0;0;2;0;1;2;3329;0;0;1;0;0;2;2;3329;0;3421;2;1;
/org.eclipse.jdt.core/compiler/org/eclipse/jdt/internal/compiler/parser/RecoveredType.java;3;1;23;1;4;4;4;19;870;4;16;455;1092;1092;4;3;0;19;23;1039;3;4187;20;3;
/org.eclipse.jdt.ui.tests.refactoring/resources/RenameMethodInInterface/testFail0/in/A.java;1;0;1;1;0;0;0;1;0;0;1;49;0;0;1;0;0;1;1;49;0;49;1;1;
/org.eclipse.jdt.ui.tests.refactoring/resources/RenameStaticMethod/test8/out/A.java;1;0;1;1;0;0;0;1;0;0;1;49;0;0;1;0;0;1;1;49;0;49;1;1;
/org.eclipse.ui/Eclipse JFace/org/eclipse/jface/action/GroupMarker.java;2;0;2;1;0;0;0;2;5;1;2;257;5;5;1;0;0;2;2;257;0;457;2;2;
/org.eclipse.jdt.ui/core extension/org/eclipse/jdt/internal/corext/codemanipulation/AddUnimplementedMethodsOperation.java;2;0;3;1;0;0;0;3;42;1;3;2137;46;46;1;0;0;3;3;2137;0;2246;3;2;
/org.eclipse.vcm.core.cvs/src/org/eclipse/vcm/internal/core/ccvs/client/ModuleExpansionHandler.java;3;0;3;1;0;0;0;3;13;1;3;0;19;19;1;0;0;3;3;0;0;1277;3;3;
/org.eclipse.jdt.ui.tests.refactoring/resources/SelectionAnalyzerWorkSpace/SelectionAnalyzerTests/invalidSelection/A_test105.java;1;0;1;1;0;0;0;1;0;0;1;1368;0;0;1;0;0;1;1;1368;0;1368;1;1;
/org.eclipse.team.ui/src/org/eclipse/team/internal/ui/actions/DeleteAction.java;2;1;2;1;2;2;2;0;0;0;0;4020;0;0;1;0;0;0;2;4020;0;4155;2;2;
/org.eclipse.jdt.ui/ui/org/eclipse/jdt/internal/ui/util/SWTUtil.java;4;0;6;1;0;0;0;6;70;1;6;1310;219;219;1;0;0;6;6;1310;0;2935;6;4;
/org.eclipse.update.ui/src/org/eclipse/update/ui/internal/parts/MultiPageEditor.java;1;0;2;1;0;0;0;2;0;0;1;1426;0;0;2;1;0;2;2;1426;1;1426;1;1;
/org.eclipse.pde.ui/Eclipse PDE UI/org/eclipse/pde/internal/editor/component/ComponentSourcePage.java;2;0;5;2;0;0;0;5;12;3;3;267;12;12;3;2;0;5;5;324;2;1434;3;2;
/org.eclipse.ui/Eclipse JFace Text/org/eclipse/jface/text/rules/NumberRule.java;3;0;3;1;0;0;0;3;30;1;3;257;35;35;1;0;0;3;3;257;0;1066;3;3;
/org.eclipse.help.ui.win32/src/org/eclipse/help/ui/internal/browser/win32/IEStore.java;1;0;1;1;1;1;1;0;0;0;0;4427;0;0;1;0;0;0;1;4427;0;4427;1;1;
/org.eclipse.help/src/org/eclipse/help/topics/IDescriptor.java;1;0;3;1;0;0;0;3;4;1;3;1675;4;4;1;0;0;3;3;1675;0;1694;3;1;
/org.eclipse.update.ui.forms/src/org/eclipse/update/ui/forms/IFormPage.java;1;0;2;1;0;0;0;2;0;1;2;1423;0;0;1;0;0;2;2;1423;0;2474;2;1;
/org.eclipse.jdt.ui.tests.refactoring/resources/AbstractField/can/A_test5_out.java;1;0;1;1;0;0;0;1;0;0;1;751;0;0;1;0;0;1;1;751;0;751;1;1;
/org.eclipse.team.tests.cvs.core/src/org/eclipse/team/tests/ccvs/ui/logformatter/PrintTextDiffVisitor.java;2;0;2;1;0;0;0;2;4;1;2;3452;4;4;1;0;0;2;2;3452;0;3873;2;2;
/org.eclipse.pde.ui/src/org/eclipse/pde/internal/ui/editor/build/BuildEditorContributor.java;1;0;1;1;0;0;0;1;0;0;1;3579;0;0;1;0;0;1;1;3579;0;3579;1;1;
/org.eclipse.jdt.ui.tests.refactoring/resources/MoveMembers/testFail7/in/B.java;1;0;1;1;0;0;0;1;0;0;1;2738;0;0;1;0;0;1;1;2738;0;2738;1;1;
/org.eclipse.help/src/org/eclipse/help/internal/topics/INavigationNode.java;2;0;2;1;0;0;0;2;0;1;2;1675;0;0;1;0;0;2;2;1675;0;1857;2;2;
/org.eclipse.ui/Eclipse JFace/org/eclipse/jface/operation/AccumulatingProgressMonitor.java;2;0;2;1;0;0;0;2;5;1;2;257;5;5;1;0;0;2;2;257;0;457;2;2;
/org.eclipse.pde.ui/src/org/eclipse/pde/internal/core/PluginModelDelta.java;1;0;2;1;0;0;0;2;0;1;2;3445;0;0;1;0;0;2;2;3445;0;3607;2;1;
/org.eclipse.vcm.core.cvs/src/org/eclipse/vcm/internal/core/ccvs/utils/ResourceUtil.java;3;0;3;1;0;0;0;3;5;1;3;0;8;8;1;0;0;3;3;0;0;298;3;3;
/org.eclipse.swt.tests/JUnit Tests/org/eclipse/swt/tests/junit/Test_org_eclipse_swt_custom_StyledText.java;5;2;11;1;4;3;4;7;335;1;7;1792;1197;1197;2;0;1;7;11;3957;1;4706;10;5;
/org.eclipse.scripting/src/org/eclipse/scripting/internal/views/ScriptUIEditorLabelProvider.java;1;0;1;1;0;0;0;1;0;0;1;1424;0;0;1;0;0;1;1;1424;0;1424;1;1;
/org.eclipse.ui/Eclipse UI Standard Components/org/eclipse/ui/views/tasklist/CopyTaskAction.java;2;0;7;1;1;1;1;6;15;1;6;2830;40;40;1;0;0;6;7;2830;0;4269;7;2;
/org.eclipse.jdt.ui.tests.refactoring/resources/ExtractMethodWorkSpace/ExtractMethodTests/return_in/A_test724.java;1;1;3;1;2;2;2;1;36;0;1;2684;36;36;1;0;0;1;3;2684;0;4419;3;1;
/org.eclipse.ui/Eclipse UI/org/eclipse/ui/actions/OpenWithMenu.java;5;0;12;1;0;0;0;12;88;2;11;257;274;274;2;1;0;12;12;2419;1;3799;11;5;
/org.eclipse.swt/Eclipse SWT/gtk/org/eclipse/swt/widgets/ColorDialog.java;6;1;12;2;5;5;5;7;165;2;6;2107;308;308;2;1;0;7;12;3511;1;4701;11;6;
/org.eclipse.swt.examples.paint/src/org/eclipse/swt/examples/paint/Figure.java;3;0;4;2;1;1;1;3;110;2;2;566;116;116;2;1;0;3;4;609;1;4705;3;3;
/org.eclipse.swt/Eclipse SWT Drag and Drop/motif/org/eclipse/swt/dnd/Clipboard.java;4;2;10;1;7;6;7;3;83;1;3;106;263;263;2;0;1;3;10;4824;1;4824;9;4;
/org.eclipse.ui.tests/Eclipse UI Tests/org/eclipse/ui/tests/adaptable/AdaptableTestSuite.java;1;0;1;1;0;0;0;1;0;0;1;2863;0;0;1;0;0;1;1;2863;0;2863;1;1;
/org.eclipse.jdt.ui/ui/org/eclipse/jdt/internal/ui/codemanipulation/OrganizeImportsOperation.java;4;0;21;2;0;0;0;21;361;2;19;15;776;776;2;2;0;21;21;1313;2;2016;19;4;
/org.eclipse.jdt.core/search/org/eclipse/jdt/core/search/IJavaSearchConstants.java;3;2;9;1;4;3;4;5;56;1;5;455;144;144;2;0;1;5;9;4058;1;4606;8;3;
/org.eclipse.team.cvs.ui/src/org/eclipse/team/internal/ccvs/ui/actions/CheckoutAsAction.java;3;1;19;2;5;5;5;14;180;2;13;2577;403;403;2;1;0;14;19;2726;1;4256;18;3;
/org.eclipse.jdt.ui.tests.refactoring/resources/RenameNonPrivateField/testBug5821/out/A.java;1;0;1;1;0;0;0;1;0;0;1;2096;0;0;1;0;0;1;1;2096;0;2096;1;1;
/org.eclipse.jdt.ui.tests.refactoring/resources/RenamePackage/test4/out/q/A.java;1;0;1;1;0;0;0;1;0;0;1;1258;0;0;1;0;0;1;1;1258;0;1258;1;1;
/org.eclipse.jdt.ui.tests.refactoring/resources/RenameVirtualMethodInClass/test34/out/A.java;1;0;1;1;1;1;1;0;0;0;0;4465;0;0;1;0;0;0;1;4465;0;4465;1;1;
/org.eclipse.swt/Eclipse SWT OLE Win32/win32/org/eclipse/swt/ole/win32/OleEvent.java;2;0;3;1;1;1;1;2;8;1;2;106;14;14;1;0;0;2;3;106;0;4701;3;2;
/org.eclipse.pde.ui/src/org/eclipse/pde/internal/wizards/templates/ChoiceOption.java;1;0;4;1;0;0;0;4;20;2;3;3415;30;30;2;1;0;4;4;3415;1;3579;3;1;
/org.eclipse.pde.core/src/org/eclipse/pde/core/plugin/IPluginElement.java;1;0;3;1;2;1;2;1;74;0;1;3591;74;74;2;0;1;1;3;4751;1;4751;2;1;
/org.eclipse.scripting/Eclipse Scripting/org/eclipse/scripting/internal/views/ScriptUIEditorEnvironment.java;1;0;3;1;0;0;0;3;7;1;3;133;7;7;1;0;0;3;3;133;0;1424;3;1;
/org.eclipse.jdt.ui/core refactoring/org/eclipse/jdt/internal/corext/refactoring/util/DebugUtils.java;1;0;2;1;0;0;0;2;2;1;2;3357;2;2;1;0;0;2;2;3357;0;3504;2;1;
/org.eclipse.swt/Eclipse SWT/photon/org/eclipse/swt/widgets/Combo.java;7;1;16;1;5;5;5;11;547;2;9;106;814;814;2;2;0;11;16;2833;2;4701;14;7;
/org.eclipse.ui.examples.propertysheet/Eclipse UI Examples PropertySheet/org/eclipse/ui/examples/propertysheet/GroupElement.java;2;0;2;1;0;0;0;2;6;1;2;931;6;6;1;0;0;2;2;931;0;946;2;2;
/org.eclipse.swt/Eclipse SWT/win32/org/eclipse/swt/widgets/ProgressBar.java;7;2;10;1;4;3;4;6;28;1;6;106;81;81;2;0;1;6;10;4557;1;4701;9;7;
/org.eclipse.jdt.core/model/org/eclipse/jdt/core/IElementChangedListener.java;2;1;6;1;3;3;3;3;20;1;3;455;65;65;1;0;0;3;6;455;0;4421;6;2;
/org.eclipse.core.resources/src/org/eclipse/core/internal/localstore/HistoryStoreEntry.java;3;0;7;1;1;1;1;6;346;1;6;12;391;391;1;0;0;6;7;12;0;4214;7;3;
/org.eclipse.swt/Eclipse SWT PI/gtk/org/eclipse/swt/internal/gtk/GDKPIXBUF.java;1;0;3;1;0;0;0;3;9;1;3;2107;9;9;1;0;0;3;3;2107;0;3252;3;1;
/org.eclipse.jdt.ui.tests.refactoring/test cases/org/eclipse/jdt/ui/nls/tests/OrderedMapTester.java;1;0;2;1;0;0;0;2;0;1;2;1939;0;0;1;0;0;2;2;1939;0;2015;2;1;
/org.eclipse.pde.ui/Eclipse PDE UI/org/eclipse/pde/internal/editor/manifest/FragmentManifestEditor.java;2;0;5;2;0;0;0;5;12;3;3;267;12;12;3;2;0;5;5;324;2;1434;3;2;
/org.eclipse.pde.ui/src/org/eclipse/pde/internal/base/model/feature/IFeatureModelFactory.java;1;0;6;1;0;0;0;6;20;3;4;2951;30;30;3;2;0;6;6;2951;2;3579;4;1;
/org.eclipse.team.cvs.core/src/org/eclipse/team/internal/ccvs/core/response/custom/ILogListener.java;3;0;3;1;0;0;0;3;2;1;3;1978;2;2;1;0;0;3;3;1978;0;2607;3;3;
/org.eclipse.jdt.junit/Eclipse JUnit/org/eclipse/jdt/junit/internal/util/AccessibilityTestPass.java;2;0;2;1;0;0;0;2;0;1;2;1511;0;0;1;0;0;2;2;1511;0;1996;2;2;
/org.eclipse.webdav/src/client/org/eclipse/webdav/http/client/BufferPool.java;2;0;4;1;1;1;1;3;142;1;3;12;171;171;1;0;0;3;4;12;0;4211;4;2;
/org.eclipse.ui/Eclipse UI Text Editor/org/eclipse/ui/texteditor/DeleteLineAction.java;1;2;3;1;3;2;3;0;29;0;0;4209;55;55;2;0;1;0;3;4209;1;4838;2;1;
/org.eclipse.ui/Eclipse JFace Text/org/eclipse/jface/text/IViewportListener.java;3;0;3;1;1;1;1;2;5;1;2;257;9;9;1;0;0;2;3;257;0;4853;3;3;
/org.eclipse.swt.examples.paint/src/org/eclipse/swt/examples/paint/FilledRectangleTool.java;2;0;2;1;0;0;0;2;0;1;2;391;0;0;1;0;0;2;2;391;0;611;2;2;
/org.eclipse.pde.ui/src/org/eclipse/pde/internal/ui/PDELabelProvider.java;1;1;8;1;5;5;5;3;41;1;3;3579;140;140;1;0;0;3;8;3579;0;4751;8;1;
/org.eclipse.jdt.ui/core refactoring/org/eclipse/jdt/internal/core/refactoring/types/RenameTypeASTAnalyzer.java;2;0;6;1;0;0;0;6;55;1;6;408;62;62;1;0;0;6;6;408;0;1342;6;2;
/org.eclipse.team.tests.cvs.core/src/org/eclipse/team/tests/ccvs/ui/logformatter/MergeRunsVisitor.java;1;0;2;1;0;0;0;2;5;1;2;2977;5;5;1;0;0;2;2;2977;0;3452;2;1;
/org.eclipse.ui/Eclipse UI/org/eclipse/ui/internal/ActionSetActionBars.java;3;1;7;1;2;2;2;5;38;1;5;457;78;78;1;0;0;5;7;457;0;4404;7;3;
/org.eclipse.swt/Eclipse SWT OLE Win32/win32/org/eclipse/swt/internal/ole/win32/IEnumFORMATETC.java;2;0;3;1;0;0;0;3;5;1;3;106;5;5;1;0;0;3;3;106;0;2069;3;2;
/org.eclipse.jdt.ui.tests.refactoring/resources/SelectionAnalyzerWorkSpace/SelectionAnalyzerTests/invalidSelection/A_test093.java;2;0;2;1;0;0;0;2;0;1;2;1368;0;0;1;0;0;2;2;1368;0;2139;2;2;
/org.eclipse.core.resources/src/org/eclipse/core/internal/indexing/SpaceMapPage.java;3;0;6;1;1;1;1;5;206;1;5;12;348;348;1;0;0;5;6;12;0;4214;6;3;
/org.eclipse.jdt.core/model/org/eclipse/jdt/internal/core/newbuilder/WorkQueue.java;1;0;3;1;0;0;0;3;2;1;3;1764;2;2;1;0;0;3;3;1764;0;2979;3;1;
/org.eclipse.ui.externaltools/External Tools/org/eclipse/ui/externaltools/internal/ui/AntTypesPage.java;1;0;1;1;1;1;1;0;0;0;0;4123;0;0;1;0;0;0;1;4123;0;4123;1;1;
/org.eclipse.pde.ui/src/org/eclipse/pde/internal/ui/parts/SharedPart.java;1;0;1;1;0;0;0;1;0;0;1;3579;0;0;1;0;0;1;1;3579;0;3579;1;1;
/org.eclipse.jdt.debug.ui/ui/org/eclipse/jdt/internal/debug/ui/actions/ObjectActionDelegate.java;1;0;2;1;1;1;1;1;45;0;1;2844;45;45;1;0;0;1;2;2844;0;4552;2;1;
/org.eclipse.scripting/Eclipse Scripting/org/eclipse/scripting/internal/views/ScriptUIEditorXmlElement.java;2;0;4;1;0;0;0;4;47;1;4;133;54;54;1;0;0;4;4;133;0;1424;4;2;
/org.eclipse.jdt.ui.tests.refactoring/resources/ExtractMethodWorkSpace/ExtractMethodTests/validSelection/A_test350.java;2;1;3;1;2;2;2;1;12;0;1;254;12;12;1;0;0;1;3;254;0;4419;3;2;
/org.eclipse.jdt.debug/jdi interfaces/com/sun/jdi/request/MethodExitRequest.java;2;0;2;1;0;0;0;2;12;1;2;2704;12;12;1;0;0;2;2;2704;0;3040;2;2;
/org.eclipse.jdt.core/model/org/eclipse/jdt/internal/core/DeleteElementsOperation.java;3;1;15;1;3;3;3;12;234;4;9;455;362;362;4;3;0;12;15;1039;3;4424;12;3;
/org.eclipse.jdt.ui/ui refactoring/org/eclipse/jdt/internal/ui/nls/ListDialog.java;1;0;2;1;0;0;0;2;0;1;2;1913;0;0;1;0;0;2;2;1913;0;1922;2;1;
/org.eclipse.update.ui/src/org/eclipse/update/ui/internal/parts/UpdateFormPage.java;1;0;2;1;0;0;0;2;0;0;1;1426;0;0;2;1;0;2;2;1426;1;1426;1;1;
/org.eclipse.ui/Eclipse UI/org/eclipse/ui/internal/dialogs/NewWizardSelectionPage.java;4;0;4;1;0;0;0;4;9;1;4;257;18;18;1;0;0;4;4;257;0;3029;4;4;
/org.eclipse.core.resources/src/org/eclipse/core/internal/indexing/IndexedStoreContext.java;3;0;6;1;1;1;1;5;336;1;5;12;624;624;1;0;0;5;6;12;0;4214;6;3;
/org.eclipse.jdt.junit/Eclipse JUnit/org/eclipse/jdt/junit/internal/TestRunnerUIutils.java;2;0;2;1;0;0;0;2;0;1;2;1531;0;0;1;0;0;2;2;1531;0;2007;2;2;
/org.eclipse.jdt.debug.ui/ui/org/eclipse/jdt/internal/debug/ui/JavaEvaluationEngineManager.java;3;0;5;1;0;0;0;5;14;1;5;3595;39;39;1;0;0;5;5;3595;0;3852;5;3;
/org.eclipse.pde.core/src/org/eclipse/pde/internal/core/schema/SchemaElement.java;1;0;3;1;1;1;1;2;17;1;2;3591;25;25;1;0;0;2;3;3591;0;4340;3;1;
/org.eclipse.jdt.core/model/org/eclipse/jdt/internal/core/jdom/SimpleDOMBuilder.java;2;1;15;1;3;3;3;12;518;4;9;455;616;616;4;3;0;12;15;1039;3;4127;12;2;
/org.eclipse.jdt.debug.tests/tests/org/eclipse/jdt/debug/tests/eval/NestedTypeFieldValue_58.java;2;1;3;1;3;3;3;0;12;0;0;4447;14;14;1;0;0;0;3;4447;0;4571;3;2;
/org.eclipse.jdt.ui.tests.refactoring/resources/RenameVirtualMethodInClass/testFail6/in/A.java;1;0;1;1;0;0;0;1;0;0;1;49;0;0;1;0;0;1;1;49;0;49;1;1;
/org.eclipse.swt/Eclipse SWT PI/gtk1x/org/eclipse/swt/internal/gtk/GtkHBox.java;2;0;2;1;1;1;1;1;3;0;1;2107;3;3;1;0;0;1;2;2107;0;4701;2;2;
/org.eclipse.help/src/org/eclipse/help/internal/protocols/livehelp/LiveHelpURLConnection.java;1;0;2;1;0;0;0;2;0;1;2;2683;0;0;1;0;0;2;2;2683;0;2694;2;1;
/org.eclipse.debug.ui/ui/org/eclipse/debug/internal/ui/preferences/DebugPreferencesMessages.java;1;0;1;1;1;1;1;0;0;0;0;4207;0;0;1;0;0;0;1;4207;0;4207;1;1;
/org.eclipse.vcm.core.cvs/src/org/eclipse/vcm/internal/core/ccvs/utils/DirectoryEntryIterator.java;3;0;3;1;0;0;0;3;67;1;3;0;75;75;1;0;0;3;3;0;0;1499;3;3;
/org.eclipse.jdt.debug.ui/ui/org/eclipse/jdt/internal/debug/ui/actions/AbstractManageBreakpointAction.java;1;1;2;1;2;2;2;0;0;0;0;3935;0;0;1;0;0;0;2;3935;0;4025;2;1;
/org.eclipse.vcm.core/src/org/eclipse/vcm/internal/core/TeamStream.java;4;0;4;1;0;0;0;4;8;1;4;0;20;20;1;0;0;4;4;0;0;297;4;4;
/org.eclipse.jdt.ui.tests.refactoring/resources/RenameParameters/canRename/A_test33_in.java;1;0;1;1;0;0;0;1;0;0;1;1288;0;0;1;0;0;1;1;1288;0;1288;1;1;
/org.eclipse.jdt.debug/eval/org/eclipse/jdt/internal/debug/eval/model/IPrimitiveValue.java;2;0;2;1;0;0;0;2;0;1;2;3555;0;0;1;0;0;2;2;3555;0;3645;2;2;
/org.eclipse.ui/Eclipse JFace Text/org/eclipse/jface/text/contentassist/AdditionalInfoController.java;2;0;6;1;1;1;1;5;46;1;5;1435;130;130;1;0;0;5;6;1435;0;4838;6;2;
/org.eclipse.jdt.debug/eval/org/eclipse/jdt/debug/eval/ast/model/IClassType.java;1;0;2;1;0;0;0;2;0;1;2;3329;0;0;1;0;0;2;2;3329;0;3421;2;1;
/org.eclipse.team.tests.cvs.core/src/org/eclipse/team/tests/ccvs/ui/logformatter/LogEntryContainer.java;1;0;1;1;0;0;0;1;0;0;1;2977;0;0;1;0;0;1;1;2977;0;2977;1;1;
/org.eclipse.swt/Eclipse SWT/photon/org/eclipse/swt/graphics/Region.java;5;1;8;1;3;3;3;5;169;1;5;106;218;218;1;0;0;5;8;106;0;4701;8;5;
/org.eclipse.swt.examples/Eclipse SWT Examples/common/org/eclipse/swt/examples/controlexample/ShellTab.java;1;0;2;1;0;0;0;2;0;1;2;107;0;0;1;0;0;2;2;107;0;611;2;1;
/org.eclipse.jdt.ui.tests.refactoring/resources/RenameVirtualMethodInClass/test11/out/A.java;1;0;1;1;0;0;0;1;0;0;1;49;0;0;1;0;0;1;1;49;0;49;1;1;
/org.eclipse.swt.tests/JUnit Tests/org/eclipse/swt/tests/junit/Test_org_eclipse_swt_custom_CTabFolderListener.java;2;0;2;1;1;1;1;1;6;0;1;1792;6;6;1;0;0;1;2;1792;0;4706;2;2;
/org.eclipse.swt/Eclipse SWT/common/org/eclipse/swt/internal/image/JPEGArithmeticConditioningTable.java;2;0;3;1;1;1;1;2;6;1;2;106;10;10;1;0;0;2;3;106;0;4701;3;2;
/org.eclipse.jdt.ui.tests.refactoring/resources/AbstractField/cannot/A_testFail0.java;1;0;1;1;0;0;0;1;0;0;1;751;0;0;1;0;0;1;1;751;0;751;1;1;
/org.eclipse.team.cvs.ui/src/org/eclipse/team/internal/ccvs/ui/DetailsDialog.java;1;2;4;1;4;3;4;0;13;0;0;3957;15;15;2;0;1;0;4;3957;1;4284;3;1;
/org.eclipse.pde.ui/src/org/eclipse/pde/internal/ui/model/ifeature/IFeatureObject.java;1;0;2;1;0;0;0;2;0;1;2;3579;0;0;1;0;0;2;2;3579;0;3591;2;1;
/org.eclipse.ui/Eclipse UI Text Editor/org/eclipse/ui/editors/text/TextEditorMessages.java;1;0;1;1;0;0;0;1;0;0;1;1066;0;0;1;0;0;1;1;1066;0;1066;1;1;
/org.eclipse.vcm.core.cvs/src/org/eclipse/vcm/internal/core/ccvs/UpdatedListener.java;4;0;9;1;0;0;0;9;70;1;9;326;96;96;1;0;0;9;9;326;0;1722;9;4;
/org.eclipse.swt.examples/src/org/eclipse/swt/examples/explorer/FileDisplayInfo.java;1;0;1;1;0;0;0;1;0;0;1;548;0;0;1;0;0;1;1;548;0;548;1;1;
/org.eclipse.jdt.ui/ui/org/eclipse/jdt/internal/ui/text/template/CodeIndentator.java;2;0;6;1;0;0;0;6;15;1;6;1493;24;24;1;0;0;6;6;1493;0;2784;6;2;
/org.eclipse.swt.examples.paint/src/org/eclipse/swt/examples/paint/RectangleFigure.java;4;0;5;2;1;1;1;4;64;2;3;566;81;81;2;1;0;4;5;609;1;4705;4;4;
/org.eclipse.jdt.ui.tests.refactoring/resources/MoveMembers/test17/out/B.java;1;0;2;1;0;0;0;2;3;1;2;2738;3;3;1;0;0;2;2;2738;0;3188;2;1;
/org.eclipse.jdt.debug/eval/org/eclipse/jdt/internal/debug/eval/ast/engine/AndOperator.java;1;0;2;1;0;0;0;2;0;1;2;3329;0;0;1;0;0;2;2;3329;0;3421;2;1;
/org.eclipse.jdt.core/compiler/org/eclipse/jdt/internal/compiler/ast/LocalDeclaration.java;2;1;9;1;2;2;2;7;318;1;7;455;663;663;1;0;0;7;9;455;0;4062;9;2;
/org.eclipse.ui/Eclipse UI Standard Components/org/eclipse/ui/views/navigator/ResourceNavigatorActionGroup.java;3;2;6;1;3;2;3;3;187;1;3;3451;210;210;2;0;1;3;6;4067;1;4067;5;3;
/org.eclipse.jdt.launching/launching/org/eclipse/jdt/internal/launching/JREContainer.java;1;1;5;1;5;5;5;0;10;0;0;4008;20;20;1;0;0;0;5;4008;0;4531;5;1;
/org.eclipse.pde.ui/src/org/eclipse/pde/internal/core/feature/FeatureObject.java;1;0;4;1;0;0;0;4;10;2;3;3579;12;12;2;1;0;4;4;3579;1;3607;3;1;
/org.eclipse.jdt.junit/Eclipse JUnit/org/eclipse/jdt/junit/internal/ApplicationWizard.java;2;0;2;1;0;0;0;2;0;1;2;1531;0;0;1;0;0;2;2;1531;0;2007;2;2;
/org.eclipse.pde.ui/src/org/eclipse/pde/internal/ui/wizards/extension/NewExtensionMainPage.java;1;0;2;1;0;0;0;2;2;1;2;3579;2;2;1;0;0;2;2;3579;0;3819;2;1;
/org.eclipse.jdt.ui/ui/org/eclipse/jdt/internal/ui/IJavaHelpContextIds.java;10;2;31;2;5;4;5;26;134;2;22;411;398;398;2;4;1;26;31;411;5;4641;26;10;
/org.eclipse.webdav/src/client/org/eclipse/webdav/client/URLTool.java;4;0;6;1;1;1;1;5;1022;1;5;12;2011;2011;1;0;0;5;6;12;0;4211;6;4;
/org.eclipse.jdt.ui/ui/org/eclipse/jdt/internal/ui/jarpackager/ConfirmSaveModifiedResourcesDialog.java;4;1;5;2;2;2;2;3;234;2;2;3377;256;256;2;1;0;3;5;3570;1;4630;4;4;
/org.eclipse.jdt.ui.tests.refactoring/resources/MoveMembers/test0/out/A.java;1;0;1;1;0;0;0;1;0;0;1;2738;0;0;1;0;0;1;1;2738;0;2738;1;1;
/org.eclipse.ant.core/src/org/eclipse/ant/internal/core/old/EclipseAnt.java;1;0;1;1;0;0;0;1;0;0;1;3270;0;0;1;0;0;1;1;3270;0;3270;1;1;
/org.eclipse.update.core/src/org/eclipse/update/internal/core/URLDecoder.java;1;0;2;1;0;0;0;2;0;1;2;2743;0;0;1;0;0;2;2;2743;0;2791;2;1;
/org.eclipse.core.tests.runtime/src/org/eclipse/core/tests/runtime/BenchPath.java;3;0;4;1;0;0;0;4;264;1;4;1794;479;479;1;0;0;4;4;1794;0;3476;4;3;
/org.eclipse.pde.runtime/Eclipse PDE Runtime/org/eclipse/pde/internal/runtime/PDERuntimePlugin.java;2;0;4;1;0;0;0;4;4;1;4;267;6;6;1;0;0;4;4;267;0;1434;4;2;
/org.eclipse.ui.tests/Eclipse JFace Tests/org/eclipse/jface/tests/viewers/interactive/ResetSorterAction.java;1;0;1;1;0;0;0;1;0;0;1;1488;0;0;1;0;0;1;1;1488;0;1488;1;1;
/org.eclipse.core.tests.resources/src/org/eclipse/core/tests/resources/usecase/ConcurrencyTest.java;3;0;3;1;0;0;0;3;132;1;3;1794;142;142;1;0;0;3;3;1794;0;3475;3;3;
/org.eclipse.jdt.ui/core refactoring/org/eclipse/jdt/internal/core/refactoring/changes/TextBufferChange.java;1;0;3;1;0;0;0;3;4;2;2;1800;4;4;2;1;0;3;3;1937;1;1937;2;1;
/org.eclipse.debug.core/core/org/eclipse/debug/core/model/IThread.java;3;0;9;1;1;1;1;8;53;1;8;187;126;126;1;0;0;8;9;187;0;4652;9;3;
/org.eclipse.jdt.ui/ui refactoring/org/eclipse/jdt/internal/ui/refactoring/ExtractTempInputPage.java;1;1;7;1;2;2;2;5;31;2;4;2480;59;59;2;1;0;5;7;2875;1;4630;6;1;
/org.eclipse.jdt.ui/ui/org/eclipse/jdt/internal/ui/dialogs/ElementTreeSelectionDialog.java;5;0;18;2;1;1;1;17;155;3;13;15;398;398;3;4;0;17;18;1254;4;4015;14;5;
/org.eclipse.scripting/src/org/eclipse/scripting/internal/views/ScriptUIEditorTreeViewerDropAdapter.java;1;0;1;1;0;0;0;1;0;0;1;1424;0;0;1;0;0;1;1;1424;0;1424;1;1;
/org.eclipse.swt/Eclipse SWT/common_j2se/org/eclipse/swt/internal/SerializableCompatibility.java;2;0;2;1;1;1;1;1;6;0;1;1434;6;6;1;0;0;1;2;1434;0;4701;2;2;
/org.eclipse.ui/Eclipse JFace Text/org/eclipse/jface/text/source/IAnnotationModel.java;4;0;4;1;1;1;1;3;66;1;3;257;73;73;1;0;0;3;4;257;0;4853;4;4;
/org.eclipse.core.tests.resources/src/org/eclipse/core/tests/internal/properties/PropertyManagerTest.java;3;1;7;1;3;3;3;4;426;1;4;1794;681;681;1;0;0;4;7;1794;0;4633;7;3;
/org.eclipse.jdt.ui/ui/org/eclipse/jdt/ui/OverrideIndicatorLabelDecorator.java;2;1;4;1;4;4;4;0;36;0;0;4044;48;48;1;0;0;0;4;4044;0;4810;4;2;
/org.eclipse.jdt.debug/jdi interfaces/com/sun/jdi/ObjectReference.java;2;0;2;1;0;0;0;2;17;1;2;2704;17;17;1;0;0;2;2;2704;0;3033;2;2;
/org.eclipse.scripting/src/org/eclipse/scripting/internal/uirenderer/XGRElementUISwtCompositePanel.java;1;0;1;1;0;0;0;1;0;0;1;1424;0;0;1;0;0;1;1;1424;0;1424;1;1;
/org.eclipse.pde.build/src/org/eclipse/pde/internal/build/IPDECoreConstants.java;1;0;9;1;0;0;0;9;60;2;7;2896;70;70;2;2;0;9;9;3154;2;3672;7;1;
/org.eclipse.jdt.ui/ui/org/eclipse/jdt/internal/ui/launcher/LauncherLabelProvider.java;2;0;3;1;0;0;0;3;5;1;3;15;5;5;1;0;0;3;3;15;0;1607;3;2;
/org.eclipse.swt/Eclipse SWT/common/org/eclipse/swt/widgets/Event.java;3;1;4;1;2;2;2;2;9;1;2;106;21;21;1;0;0;2;4;106;0;4701;4;3;
/org.eclipse.jdt.ui.tests.refactoring/resources/SelectionAnalyzerWorkSpace/SelectionAnalyzerTests/validSelection/A_test201.java;1;0;1;1;0;0;0;1;0;0;1;1368;0;0;1;0;0;1;1;1368;0;1368;1;1;
/org.eclipse.pde.ui/src/org/eclipse/pde/internal/ui/wizards/extension/GenericExtensionWizard.java;1;0;1;1;0;0;0;1;0;0;1;3579;0;0;1;0;0;1;1;3579;0;3579;1;1;
/org.eclipse.pde.ui/src/org/eclipse/pde/ui/templates/BaseOptionTemplateSection.java;1;0;3;1;1;1;1;2;126;1;2;3840;154;154;1;0;0;2;3;3840;0;4752;3;1;
/org.eclipse.pde.ui/Eclipse PDE UI/org/eclipse/pde/internal/schema/SchemaCompositor.java;2;0;6;2;0;0;0;6;12;3;4;267;13;13;3;2;0;6;6;324;2;1434;4;2;
/org.eclipse.jdt.ui.tests.refactoring/resources/ExtractTemp/canExtract/A_test36_out.java;1;0;1;1;0;0;0;1;0;0;1;3355;0;0;1;0;0;1;1;3355;0;3355;1;1;
/org.eclipse.jdt.core/dom/org/eclipse/jdt/core/dom/MethodDeclaration.java;3;1;12;2;3;3;3;9;24;2;7;2669;111;111;2;2;0;9;12;2877;2;4453;10;3;
/org.eclipse.jdt.debug/jdi/org/eclipse/jdi/internal/connect/SocketListeningConnectorImpl.java;2;0;7;1;1;1;1;6;19;1;6;187;68;68;1;0;0;6;7;187;0;4423;7;2;
/org.eclipse.jdt.ui.tests.refactoring/resources/RenameVariables/cannotRename/A_testFail4.java;1;0;2;1;0;0;0;2;0;1;2;724;0;0;1;0;0;2;2;724;0;1665;2;1;
/org.eclipse.debug.ui/ui/org/eclipse/debug/internal/ui/views/ExpressionViewEventHandler.java;3;0;11;2;1;1;1;10;27;2;8;2346;98;98;2;2;0;10;11;2346;2;3975;9;3;
/org.eclipse.jdt.debug/eval/org/eclipse/jdt/internal/debug/eval/ast/engine/ArrayInitializerInstruction.java;1;0;3;1;0;0;0;3;2;1;3;3329;2;2;1;0;0;3;3;3329;0;3421;3;1;
/org.eclipse.jdt.debug.tests/testprograms/EvalNestedTypeTests.java;2;1;2;1;2;2;2;0;11;0;0;4447;11;11;1;0;0;0;2;4447;0;4571;2;2;
/org.eclipse.help/Eclipse Help/org/eclipse/help/internal/contributions/Insert.java;3;0;4;1;0;0;0;4;7;1;4;135;9;9;1;0;0;4;4;135;0;1420;4;3;
/org.eclipse.swt.examples.paint/src/org/eclipse/swt/examples/paint/SimplePaintSession.java;2;0;2;1;0;0;0;2;0;1;2;391;0;0;1;0;0;2;2;391;0;611;2;2;
/org.eclipse.jdt.ui.tests.refactoring/resources/MoveMembers/testFail3/in/B.java;1;0;1;1;0;0;0;1;0;0;1;2738;0;0;1;0;0;1;1;2738;0;2738;1;1;
/org.eclipse.core.resources/src/org/eclipse/core/internal/resources/WorkspaceTreeReader_0.java;3;0;4;1;1;1;1;3;20;1;3;182;46;46;1;0;0;3;4;182;0;4213;4;3;
/org.eclipse.jdt.core/model/org/eclipse/jdt/internal/core/util/ClassFileAttribute.java;2;1;4;1;2;2;2;2;19;0;1;3629;35;35;2;1;0;2;4;3629;1;4422;3;2;
/org.eclipse.jdt.ui.tests.refactoring/resources/ExtractMethodWorkSpace/ExtractMethodTests/invalidSelection/A_test085.java;2;1;3;1;2;2;2;1;0;0;1;49;0;0;1;0;0;1;3;49;0;4419;3;2;
/org.eclipse.jdt.ui/core refactoring/org/eclipse/jdt/internal/corext/refactoring/ASTEndVisitAdapter.java;2;0;2;1;0;0;0;2;0;1;2;1939;0;0;1;0;0;2;2;1939;0;3087;2;2;
/org.eclipse.jdt.core/search/org/eclipse/jdt/internal/core/index/impl/IndexerOutput.java;2;0;3;1;1;1;1;2;17;1;2;455;25;25;1;0;0;2;3;455;0;4063;3;2;
/org.eclipse.pde.ui/src/org/eclipse/pde/internal/editor/feature/FeatureForm.java;1;0;6;1;0;0;0;6;19;2;5;2951;33;33;2;1;0;6;6;2951;1;3579;5;1;
/org.eclipse.jdt.ui.tests.refactoring/resources/ExtractTemp/cannotExtract/A_testFail7.java;1;0;1;1;0;0;0;1;0;0;1;2820;0;0;1;0;0;1;1;2820;0;2820;1;1;
/org.eclipse.ui/Eclipse UI/org/eclipse/ui/IPageLayout.java;4;0;13;2;2;1;2;11;44;2;9;257;208;208;2;2;1;11;13;2739;3;4451;10;4;
/org.eclipse.core.resources/src/org/eclipse/core/internal/resources/MarkerSnapshotReader_1.java;2;0;8;1;1;1;1;7;206;1;7;158;274;274;1;0;0;7;8;158;0;4213;8;2;
/org.eclipse.swt/Eclipse SWT Drag and Drop/gtk1x/org/eclipse/swt/dnd/TextTransfer.java;2;0;2;1;0;0;0;2;0;1;2;2107;0;0;1;0;0;2;2;2107;0;3127;2;2;
/org.eclipse.update.ui/src/org/eclipse/update/internal/ui/parts/PropertyWebForm.java;1;0;2;1;0;0;0;2;0;1;2;2107;0;0;1;0;0;2;2;2107;0;3662;2;1;
/org.eclipse.jdt.core/model/org/eclipse/jdt/internal/core/builder/IProblemDetail.java;1;0;3;1;0;0;0;3;11;1;3;455;11;11;1;0;0;3;3;455;0;2808;3;1;
/org.eclipse.ui/Eclipse JFace/org/eclipse/jface/operation/ModalContext.java;3;0;5;1;2;1;2;3;29;1;3;257;55;55;2;0;1;3;5;4450;1;4450;4;3;
/org.eclipse.jdt.ui/core refactoring/org/eclipse/jdt/internal/core/refactoring/changes/DeleteFolderChange.java;2;0;5;1;0;0;0;5;14;1;5;1108;21;21;1;0;0;5;5;1108;0;1939;5;2;
/org.eclipse.jdt.debug/model/org/eclipse/jdt/internal/debug/core/breakpoints/JavaMethodEntryBreakpoint.java;3;0;6;2;1;1;1;5;442;2;4;2517;587;587;2;1;0;5;6;2517;1;4768;5;3;
/org.eclipse.core.tests.resources/src/org/eclipse/core/tests/internal/localstore/LocalSyncTest.java;3;0;6;1;1;1;1;5;296;1;5;1794;332;332;1;0;0;5;6;1794;0;4516;6;3;
/org.eclipse.help/webapps/examples/WEB-INF/jsp/applet/Clock2.java;1;0;2;1;0;0;0;2;0;1;2;1882;0;0;1;0;0;2;2;1882;0;1930;2;1;
/org.eclipse.pde.ui/src/org/eclipse/pde/internal/base/model/plugin/IPluginLibrary.java;2;0;3;1;0;0;0;3;23;1;3;1434;23;23;1;0;0;3;3;1434;0;3039;3;2;
/org.eclipse.vcm.ui.cvs/src/org/eclipse/vcm/internal/ui/ccvs/ModuleAliasCategory.java;1;0;3;1;0;0;0;3;163;1;3;1424;211;211;1;0;0;3;3;1424;0;1578;3;1;
/org.eclipse.scripting/src/org/eclipse/scripting/internal/uirenderer/XGRElementUISwtHorizontalRule.java;1;0;1;1;0;0;0;1;0;0;1;1424;0;0;1;0;0;1;1;1424;0;1424;1;1;
/org.eclipse.help/src/org/eclipse/help/topics/ITopics.java;2;0;4;1;0;0;0;4;14;1;4;1675;24;24;1;0;0;4;4;1675;0;1804;4;2;
/org.eclipse.jdt.core/model/org/eclipse/jdt/internal/core/builder/impl/UnmodifiedBuilderType.java;1;0;10;1;0;0;0;10;94;4;6;455;112;112;4;4;0;10;10;1039;4;2808;6;1;
/org.eclipse.ui/Eclipse UI Text Editor/org/eclipse/ui/texteditor/ITextEditor.java;4;0;4;1;1;1;1;3;138;1;3;257;170;170;1;0;0;3;4;257;0;4838;4;4;
/org.eclipse.core.boot/src/org/eclipse/core/internal/boot/update/XmlLiteReader.java;2;0;3;1;0;0;0;3;7;1;3;12;7;7;1;0;0;3;3;12;0;2726;3;2;
/org.eclipse.webdav/src/client/org/eclipse/webdav/client/WorkspaceHandle.java;3;0;5;1;1;1;1;4;126;1;4;12;237;237;1;0;0;4;5;12;0;4211;5;3;
/org.eclipse.jdt.ui/ui/org/eclipse/jdt/internal/ui/preferences/JavaEditorPreferencePage.java;8;4;52;3;22;15;22;30;573;2;29;191;2331;2331;4;1;7;30;52;4181;8;4706;44;8;
/org.eclipse.jdt.ui.tests.refactoring/resources/RenameTemp/canRename/A_test15_out.java;1;0;1;1;0;0;0;1;0;0;1;1625;0;0;1;0;0;1;1;1625;0;1625;1;1;
/org.eclipse.pde.ui/src/org/eclipse/pde/internal/ui/PluginProject.java;1;0;2;1;0;0;0;2;0;1;2;3579;0;0;1;0;0;2;2;3579;0;3607;2;1;
/org.eclipse.jdt.core/model/org/eclipse/jdt/internal/core/BufferManager.java;3;1;10;1;3;3;3;7;354;1;7;455;678;678;1;0;0;7;10;455;0;4381;10;3;
/org.eclipse.pde.ui/src/org/eclipse/pde/internal/ui/editor/manifest/ResourceAttributeValue.java;1;0;2;1;0;0;0;2;2;1;2;3579;2;2;1;0;0;2;2;3579;0;3591;2;1;
/org.eclipse.jdt.core/compiler/org/eclipse/jdt/internal/compiler/flow/FlowInfo.java;2;0;12;1;1;1;1;11;143;4;8;455;191;191;4;3;0;11;12;1039;3;4062;9;2;
/org.eclipse.swt/Eclipse SWT/carbon/org/eclipse/swt/widgets/WidgetTable.java;3;1;3;1;3;3;3;0;6;0;0;4147;8;8;1;0;0;0;3;4147;0;4701;3;3;
/org.eclipse.jdt.ui/ui/org/eclipse/jdt/internal/ui/text/BufferedDocumentScanner.java;1;0;1;1;0;0;0;1;0;0;1;3873;0;0;1;0;0;1;1;3873;0;3873;1;1;
/org.eclipse.ui.externaltools/Ant Builder/org/eclipse/ui/externaltools/internal/ui/ant/NullBuildLogger.java;1;0;1;1;1;1;1;0;0;0;0;4462;0;0;1;0;0;0;1;4462;0;4462;1;1;
/org.eclipse.core.runtime/src/org/eclipse/core/internal/runtime/PlatformLogWriter.java;2;1;12;1;3;3;3;9;540;1;9;1817;1144;1144;1;0;0;9;12;1817;0;4266;12;2;
/org.eclipse.jdt.ui.tests.refactoring/test cases/org/eclipse/jdt/ui/tests/refactoring/RenameNonPrivateFieldTests.java;2;1;8;1;2;2;2;6;17;1;6;1896;51;51;1;0;0;6;8;1896;0;4763;8;2;
/org.eclipse.jdt.ui/ui/org/eclipse/jdt/internal/ui/viewsupport/IJavaProblemListener.java;1;0;2;1;0;0;0;2;0;1;2;1010;0;0;1;0;0;2;2;1010;0;1256;2;1;
/org.eclipse.help.ui.win32/src/org/eclipse/help/ui/internal/browser/win32/ICommandStateChangedListener.java;1;0;1;1;1;1;1;0;0;0;0;4427;0;0;1;0;0;0;1;4427;0;4427;1;1;
/org.eclipse.team.cvs.ui/src/org/eclipse/team/internal/ccvs/ui/merge/MergeWizard.java;3;0;9;1;0;0;0;9;40;2;8;2641;120;120;2;1;0;9;9;3577;1;3746;8;3;
/org.eclipse.jdt.ui.tests.refactoring/resources/InlineTemp/canInline/A_test15_out.java;1;0;1;1;0;0;0;1;0;0;1;3048;0;0;1;0;0;1;1;3048;0;3048;1;1;
/org.eclipse.jdt.ui.tests.refactoring/resources/MoveMembers/test24/in/B.java;1;0;1;1;0;0;0;1;0;0;1;2928;0;0;1;0;0;1;1;2928;0;2928;1;1;
/org.eclipse.pde.ui/Eclipse PDE UI/org/eclipse/pde/internal/builders/ISchemaTransformer.java;2;0;5;2;0;0;0;5;12;3;3;267;12;12;3;2;0;5;5;324;2;1434;3;2;
/org.eclipse.jdt.debug/eval/org/eclipse/jdt/internal/debug/eval/ast/instructions/PrefixPlusPlusOperator.java;3;0;6;1;0;0;0;6;20;1;6;3421;32;32;1;0;0;6;6;3421;0;3677;6;3;
/org.eclipse.jdt.ui/core refactoring/org/eclipse/jdt/internal/core/refactoring/changes/DeleteSourceManipulationChange.java;2;0;4;1;0;0;0;4;14;1;4;1108;22;22;1;0;0;4;4;1108;0;1939;4;2;
/org.eclipse.jdt.debug/jdi/org/eclipse/jdi/internal/PrimitiveValueImpl.java;2;0;4;1;0;0;0;4;17;1;4;187;33;33;1;0;0;4;4;187;0;3678;4;2;
/org.eclipse.team.tests.cvs.core/src/org/eclipse/team/tests/ccvs/core/compatible/AllTests.java;2;0;2;1;0;0;0;2;0;1;2;2536;0;0;1;0;0;2;2;2536;0;3250;2;2;
/org.eclipse.jdt.ui/core refactoring/org/eclipse/jdt/internal/corext/refactoring/base/RefactoringStatusCodes.java;1;0;1;1;1;1;1;0;0;0;0;4189;0;0;1;0;0;0;1;4189;0;4189;1;1;
/org.eclipse.pde.ui/src/org/eclipse/pde/internal/editor/schema/SchemaEditorContributor.java;2;0;2;1;0;0;0;2;0;1;2;1434;0;0;1;0;0;2;2;1434;0;3579;2;2;
/org.eclipse.jdt.ui.tests.refactoring/resources/ExtractTemp/cannotExtract/A_testFail18.java;1;0;1;1;0;0;0;1;0;0;1;3414;0;0;1;0;0;1;1;3414;0;3414;1;1;
/org.eclipse.jdt.ui/ui/org/eclipse/jdt/internal/ui/viewsupport/StatusBarUpdater.java;3;0;12;1;0;0;0;12;155;2;11;15;299;299;2;1;0;12;12;1718;1;2016;11;3;
/org.eclipse.pde.ui/templates/multiPageEditor/java/$editorClassName$.java;1;0;1;1;0;0;0;1;0;0;1;3442;0;0;1;0;0;1;1;3442;0;3442;1;1;
/org.eclipse.jdt.ui.tests/refactoring/experiments/ReorderParametersTests.java;1;0;2;1;0;0;0;2;0;1;2;1342;0;0;1;0;0;2;2;1342;0;1895;2;1;
/org.eclipse.jdt.ui.tests.refactoring/resources/ExtractTemp/canExtract/A_test37_out.java;1;1;2;1;2;2;2;0;16;0;0;3995;16;16;1;0;0;0;2;3995;0;4002;2;1;
/org.eclipse.jdt.ui/ui/org/eclipse/jdt/internal/ui/javaeditor/LinePainter.java;2;1;11;2;2;2;2;9;130;3;6;3087;353;353;3;3;0;9;11;3101;3;4213;8;2;
/org.eclipse.jdt.ui/ui/org/eclipse/jdt/internal/ui/text/HTMLPrinter.java;2;0;7;1;1;1;1;6;33;1;6;1384;86;86;1;0;0;6;7;1384;0;4632;7;2;
/org.eclipse.jdt.ui.tests.refactoring/test cases/org/eclipse/jdt/ui/tests/refactoring/ExtractMethodTests.java;2;1;25;1;3;3;3;22;87;3;17;1896;421;421;3;5;0;22;25;3736;5;4424;20;2;
/org.eclipse.ui/Eclipse UI/org/eclipse/ui/part/ViewPart.java;2;0;2;1;0;0;0;2;5;1;2;257;5;5;1;0;0;2;2;257;0;457;2;2;
/org.eclipse.jdt.ui.tests.refactoring/resources/SelectionAnalyzerWorkSpace/SelectionAnalyzerTests/invalidSelection/A_test051.java;1;0;1;1;0;0;0;1;0;0;1;1368;0;0;1;0;0;1;1;1368;0;1368;1;1;
/org.eclipse.jdt.ui/core refactoring/org/eclipse/jdt/internal/corext/refactoring/rename/LineEndDeleteTextEdit.java;1;0;2;1;0;0;0;2;0;1;2;2015;0;0;1;0;0;2;2;2015;0;2062;2;1;
/org.eclipse.swt/Eclipse SWT PI/photon/org/eclipse/swt/internal/photon/PtTreeCallback_t.java;2;0;2;1;1;1;1;1;6;0;1;2780;6;6;1;0;0;1;2;2780;0;4701;2;2;
/org.eclipse.pde.ui/Eclipse PDE UI/org/eclipse/pde/internal/editor/ModifiedTextPropertyDescriptor.java;2;0;6;2;0;0;0;6;12;3;4;267;14;14;3;2;0;6;6;324;2;1434;4;2;
/org.eclipse.core.resources/src/org/eclipse/core/internal/watson/IDeltaVisitor.java;1;0;4;1;1;1;1;3;52;1;3;12;73;73;1;0;0;3;4;12;0;4214;4;1;
/org.eclipse.compare/compare/org/eclipse/patch/PreviewPatchPage.java;1;0;4;1;0;0;0;4;47;1;4;1419;55;55;1;0;0;4;4;1419;0;1516;4;1;
/org.eclipse.swt/Eclipse SWT/win32/org/eclipse/swt/widgets/Accessible.java;1;0;1;1;0;0;0;1;0;0;1;2810;0;0;1;0;0;1;1;2810;0;2810;1;1;
/org.eclipse.debug.core/core/org/eclipse/debug/core/model/IMemoryBlockRetrieval.java;3;0;4;1;1;1;1;3;9;1;3;1963;17;17;1;0;0;3;4;1963;0;4651;4;3;
/org.eclipse.pde.core/src/org/eclipse/pde/internal/core/ModelEntry.java;1;0;1;1;0;0;0;1;0;0;1;3591;0;0;1;0;0;1;1;3591;0;3591;1;1;
/org.eclipse.team.cvs.ui/src/org/eclipse/team/internal/ccvs/ui/model/CVSRootFolderElement.java;1;0;3;1;0;0;0;3;49;1;3;3545;53;53;1;0;0;3;3;3545;0;3610;3;1;
/org.eclipse.pde.ui/src/org/eclipse/pde/internal/model/AbstractPluginModelBase.java;2;0;8;1;0;0;0;8;13;1;8;1434;35;35;1;0;0;8;8;1434;0;3136;8;2;
/org.eclipse.core.tests.harness/src/org/eclipse/core/tests/harness/CancelingProgressMonitor.java;3;0;3;1;1;1;1;2;20;1;2;1794;30;30;1;0;0;2;3;1794;0;4516;3;3;
/org.eclipse.pde.ui/Eclipse PDE UI/org/eclipse/pde/internal/editor/manifest/DependencyGraph.java;2;0;5;2;0;0;0;5;12;3;3;267;12;12;3;2;0;5;5;324;2;1434;3;2;
/org.eclipse.swt.examples/Eclipse SWT Examples/common/org/eclipse/swt/examples/controlexample/TableTab.java;1;0;2;1;0;0;0;2;0;1;2;107;0;0;1;0;0;2;2;107;0;611;2;1;
/org.eclipse.compare/compare/org/eclipse/compare/internal/patch/InputPatchPage.java;2;0;7;1;1;1;1;6;17;1;6;2876;36;36;1;0;0;6;7;2876;0;3914;7;2;
/org.eclipse.jdt.ui/ui/org/eclipse/jdt/internal/ui/compare/PropertiesStructureCreator.java;3;1;10;1;3;3;3;7;298;2;6;15;527;527;2;1;0;7;10;771;1;4621;9;3;
/org.eclipse.jdt.ui.tests.refactoring/resources/RenameType/test34/in/A.java;1;0;1;1;0;0;0;1;0;0;1;49;0;0;1;0;0;1;1;49;0;49;1;1;
/org.eclipse.jdt.launching.j9/j9/org/eclipse/jdt/internal/launching/j9/J9LaunchingPlugin.java;3;0;3;1;1;1;1;2;4;1;2;3314;6;6;1;0;0;2;3;3314;0;3914;3;3;
/org.eclipse.swt.examples.paint/org/eclipse/swt/examples/paint/Figure.java;3;0;4;2;1;1;1;3;110;2;2;566;110;110;2;1;0;3;4;609;1;4024;3;3;
/org.eclipse.jdt.ui.tests.refactoring/resources/ExtractMethodWorkSpace/ExtractMethodTests/return_out/A_test701.java;1;1;3;1;2;2;2;1;14;0;1;887;14;14;1;0;0;1;3;887;0;4419;3;1;
/org.eclipse.vcm.ui/src/org/eclipse/vcm/internal/ui/svrevents/ServerEventsContentProvider.java;1;0;1;1;0;0;0;1;0;0;1;951;0;0;1;0;0;1;1;951;0;951;1;1;
/org.eclipse.jdt.ui.tests.refactoring/resources/RenameType/testNoOp/in/A.java;1;0;1;1;0;0;0;1;0;0;1;49;0;0;1;0;0;1;1;49;0;49;1;1;
/org.eclipse.swt/Eclipse SWT/win32/org/eclipse/swt/internal/win32/MENUINFO.java;2;0;3;1;0;0;0;3;5;1;3;106;5;5;1;0;0;3;3;106;0;2069;3;2;
/org.eclipse.team.webdav/src/org/eclipse/team/internal/webdav/core/Policy.java;3;2;6;2;6;5;6;0;44;0;0;4155;86;86;2;0;1;0;6;4209;1;4370;5;3;
/org.eclipse.jdt.ui.tests.refactoring/resources/RenameTemp/canRename/A_test47_out.java;1;0;1;1;1;1;1;0;0;0;0;4400;0;0;1;0;0;0;1;4400;0;4400;1;1;
/org.eclipse.jdt.ui/core extension/org/eclipse/jdt/internal/corext/util/TypeInfoRequestor.java;1;0;1;1;0;0;0;1;0;0;1;2820;0;0;1;0;0;1;1;2820;0;2820;1;1;
/org.eclipse.swt/Eclipse SWT PI/photon/org/eclipse/swt/internal/photon/FontDetails.java;2;0;2;1;1;1;1;1;6;0;1;2069;6;6;1;0;0;1;2;2069;0;4701;2;2;
/org.eclipse.scripting/src/org/eclipse/scripting/internal/uirenderer/XGRElementUISwtCheckBox.java;1;0;1;1;0;0;0;1;0;0;1;1424;0;0;1;0;0;1;1;1424;0;1424;1;1;
/org.eclipse.jdt.debug/model/org/eclipse/jdt/internal/debug/core/model/JDIDebugModelMessages.java;1;0;1;1;0;0;0;1;0;0;1;2523;0;0;1;0;0;1;1;2523;0;2523;1;1;
/org.eclipse.help/Eclipse Help/org/eclipse/help/internal/contributions/xml/HelpContext.java;3;0;5;1;0;0;0;5;56;1;5;135;80;80;1;0;0;5;5;135;0;1420;5;3;
/org.eclipse.team.cvs.ui/src/org/eclipse/team/internal/ccvs/ui/model/Tag.java;3;0;6;2;0;0;0;6;37;2;5;1997;41;41;2;1;0;6;6;2049;1;2126;5;3;
/org.eclipse.ui/Eclipse UI Text Editor/org/eclipse/ui/texteditor/FindReplaceAction.java;5;1;7;1;3;3;3;4;201;1;4;257;321;321;1;0;0;4;7;257;0;4838;7;5;
/org.eclipse.core.tests.runtime/src/org/eclipse/core/tests/internal/runtimetests/SampleOPB.java;1;0;2;1;0;0;0;2;10;1;2;3611;10;10;1;0;0;2;2;3611;0;3678;2;1;
/org.eclipse.team.core/src/org/eclipse/team/internal/simpleAccess/SimpleAccessOperations.java;1;0;1;1;0;0;0;1;0;0;1;3257;0;0;1;0;0;1;1;3257;0;3257;1;1;
/org.eclipse.jdt.junit/Eclipse JUnit/org/eclipse/jdt/internal/junit/ui/JUnitBaseLauncherDelegate.java;2;0;6;1;0;0;0;6;89;1;6;2143;151;151;1;0;0;6;6;2143;0;3313;6;2;
/org.eclipse.jdt.ui.tests.refactoring/resources/ReorderParameters/canReorder/A_test12_in.java;1;0;3;1;0;0;0;3;0;1;3;724;0;0;1;0;0;3;3;724;0;2270;3;1;
/org.eclipse.core.runtime/src/org/eclipse/core/runtime/model/PluginDescriptorModel.java;3;0;7;1;1;1;1;6;212;1;6;12;477;477;1;0;0;6;7;12;0;4214;7;3;
/org.eclipse.swt.examples.paint/org/eclipse/swt/examples/paint/Meta.java;1;0;1;1;0;0;0;1;0;0;1;513;0;0;1;0;0;1;1;513;0;513;1;1;
/org.eclipse.jdt.ui.tests.refactoring/resources/PullUp/test10/in/A.java;1;0;1;1;0;0;0;1;0;0;1;2406;0;0;1;0;0;1;1;2406;0;2406;1;1;
/org.eclipse.debug.ui/ui/org/eclipse/debug/internal/ui/actions/ShowTypesAction.java;2;0;5;1;1;1;1;4;4;1;4;2382;11;11;1;0;0;4;5;2382;0;3933;5;2;
/org.eclipse.jdt.core/search/org/eclipse/jdt/internal/core/index/impl/MergeFactory.java;2;0;5;1;1;1;1;4;147;1;4;455;202;202;1;0;0;4;5;455;0;4063;5;2;
/org.eclipse.jdt.ui/ui/org/eclipse/jdt/internal/ui/reorg/ReorgSupport.java;3;0;6;1;0;0;0;6;24;1;6;15;47;47;1;0;0;6;6;15;0;1258;6;3;
/org.eclipse.webdav/src/kernel/org/eclipse/webdav/internal/kernel/WebDAVPropertyValues.java;2;0;5;1;1;1;1;4;68;1;4;12;131;131;1;0;0;4;5;12;0;4211;5;2;
/org.eclipse.jdt.ui/ui refactoring/org/eclipse/jdt/internal/ui/refactoring/CreateChangeOperation.java;3;0;10;1;1;1;1;9;26;1;9;15;62;62;1;0;0;9;10;15;0;4400;10;3;
/org.eclipse.jdt.ui.tests.refactoring/resources/SelectionAnalyzerWorkSpace/SelectionAnalyzerTests/validSelection/A_test250.java;1;0;1;1;0;0;0;1;0;0;1;1368;0;0;1;0;0;1;1;1368;0;1368;1;1;
/org.eclipse.jdt.core/model/org/eclipse/jdt/core/util/OpcodeStringValues.java;2;1;5;1;3;3;3;2;408;1;2;3629;443;443;1;0;0;2;5;3629;0;4836;5;2;
/org.eclipse.help/Eclipse Help/org/eclipse/help/internal/navigation/XMLGenerator.java;3;0;7;1;0;0;0;7;52;1;7;135;116;116;1;0;0;7;7;135;0;1420;7;3;
/org.eclipse.jdt.ui/core refactoring/org/eclipse/jdt/internal/corext/refactoring/rename/RenameParametersRefactoring.java;2;0;4;1;0;0;0;4;2;1;4;1939;4;4;1;0;0;4;4;1939;0;2630;4;2;
/org.eclipse.scripting/src/org/eclipse/scripting/internal/views/ScriptDevelopmentWizardPageConfirmation.java;1;0;1;1;0;0;0;1;0;0;1;1424;0;0;1;0;0;1;1;1424;0;1424;1;1;
/org.eclipse.jdt.ui/core refactoring/org/eclipse/jdt/internal/corext/refactoring/util/SelectionAnalyzer.java;2;0;6;1;0;0;0;6;22;1;6;1939;54;54;1;0;0;6;6;1939;0;3084;6;2;
/org.eclipse.jdt.ui/ui/org/eclipse/jdt/internal/ui/packageview/MembersFilterAction.java;2;0;3;1;0;0;0;3;2;1;3;2267;2;2;1;0;0;3;3;2267;0;3151;3;2;
/org.eclipse.jdt.ui.tests.refactoring/resources/MoveCU/test0/out/p1/A.java;2;0;3;1;0;0;0;3;1;1;3;49;1;1;1;0;0;3;3;49;0;2769;3;2;
/org.eclipse.swt/Eclipse SWT OLE Win32/win32/org/eclipse/swt/ole/win32/OlePropertyDescription.java;2;0;3;1;1;1;1;2;6;1;2;106;12;12;1;0;0;2;3;106;0;4701;3;2;
/org.eclipse.swt/Eclipse SWT OLE Win32/win32/org/eclipse/swt/ole/win32/OleEventTable.java;3;0;4;1;1;1;1;3;7;1;3;106;15;15;1;0;0;3;4;106;0;4701;4;3;
/org.eclipse.help/Eclipse Help/org/eclipse/help/internal/contributors/xml/ContributionFactory.java;3;0;4;1;0;0;0;4;7;1;4;135;9;9;1;0;0;4;4;135;0;1420;4;3;
/org.eclipse.scripting/Eclipse Scripting/org/eclipse/scripting/internal/IXGRElementUILayoutElement.java;1;0;3;1;0;0;0;3;4;1;3;133;4;4;1;0;0;3;3;133;0;1424;3;1;
/org.eclipse.jdt.ui.tests.refactoring/resources/ExtractMethodWorkSpace/ExtractMethodTests/locals_out/A_test562.java;1;1;4;1;2;2;2;2;36;1;2;1236;38;38;1;0;0;2;4;1236;0;4419;4;1;
/org.eclipse.debug.ui/ui/org/eclipse/debug/internal/ui/AbstractRemoveAllAction.java;2;0;2;1;0;0;0;2;0;1;2;2347;0;0;1;0;0;2;2;2347;0;2382;2;2;
/org.eclipse.jdt.core/compiler/org/eclipse/jdt/internal/compiler/flow/InsideSubRoutineFlowContext.java;2;0;4;1;1;1;1;3;33;1;3;455;75;75;1;0;0;3;4;455;0;4062;4;2;
/org.eclipse.team.cvs.core/src/org/eclipse/team/internal/ccvs/core/resources/RemoteManagedFile.java;2;0;2;1;0;0;0;2;0;1;2;1978;0;0;1;0;0;2;2;1978;0;2036;2;2;
/org.eclipse.ui.tests/Eclipse JFace Tests/org/eclipse/jface/tests/viewers/interactive/TestSelectionAction.java;1;0;1;1;0;0;0;1;0;0;1;1488;0;0;1;0;0;1;1;1488;0;1488;1;1;
/org.eclipse.jdt.ui/ui/org/eclipse/jdt/internal/ui/text/correction/UnknownVariableEvaluator.java;1;0;4;1;0;0;0;4;23;2;3;3469;34;34;2;1;0;4;4;3528;1;3528;3;1;
/org.eclipse.debug.ui/ui/org/eclipse/debug/internal/ui/views/VariablesViewer.java;3;1;9;2;2;2;2;7;172;2;5;2720;220;220;2;2;0;7;9;3362;2;3975;7;3;
/org.eclipse.pde.ui/Eclipse PDE UI/org/eclipse/pde/internal/model/PluginImport.java;2;0;6;2;0;0;0;6;12;3;4;267;16;16;3;2;0;6;6;324;2;1434;4;2;
/org.eclipse.pde.junit/Pde JUnit/org/eclipse/pde/internal/junit/ui/CoreTestApplication.java;2;0;2;1;0;0;0;2;0;1;2;2399;0;0;1;0;0;2;2;2399;0;3205;2;2;
/org.eclipse.jdt.debug/eval/org/eclipse/jdt/internal/debug/eval/model/EvaluationArrayType.java;2;0;3;1;0;0;0;3;3;1;3;3421;3;3;1;0;0;3;3;3421;0;3645;3;2;
/org.eclipse.pde.ui/src/org/eclipse/pde/internal/ui/editor/feature/PluginSection.java;1;1;8;1;3;3;3;5;43;2;4;3579;85;85;2;1;0;5;8;3579;1;4592;7;1;
/org.eclipse.pde.ui/src/org/eclipse/pde/internal/wizards/templates/NewWizardTemplate.java;1;0;2;1;0;0;0;2;0;1;2;3442;0;0;1;0;0;2;2;3442;0;3579;2;1;
/org.eclipse.pde.ui/src/org/eclipse/pde/internal/core/builders/SourceDOMParser.java;1;0;2;1;0;0;0;2;0;1;2;3579;0;0;1;0;0;2;2;3579;0;3607;2;1;
/org.eclipse.swt/Eclipse SWT Drag and Drop/carbon/org/eclipse/swt/dnd/Clipboard.java;4;2;8;1;8;7;8;0;81;0;0;4147;263;263;2;0;1;0;8;4824;1;4824;7;4;
/org.eclipse.jdt.debug.ui/ui/org/eclipse/jdt/internal/debug/ui/DebugErrorDialog.java;2;0;4;1;0;0;0;4;27;1;4;2223;47;47;1;0;0;4;4;2223;0;3329;4;2;
/org.eclipse.jdt.ui.tests.refactoring/resources/RenameMethodInInterface/test13/in/A.java;2;0;2;1;0;0;0;2;0;1;2;49;0;0;1;0;0;2;2;49;0;1258;2;2;
/org.eclipse.jdt.ui/ui/org/eclipse/jdt/internal/ui/text/java/ExperimentalResultCollector.java;4;0;12;2;0;0;0;12;445;3;9;1921;513;513;3;3;0;12;12;3640;3;3640;9;4;
/org.eclipse.jdt.core/compiler/org/eclipse/jdt/internal/compiler/ast/ForStatement.java;2;1;17;1;2;2;2;15;505;4;12;455;1247;1247;4;3;0;15;17;1039;3;4421;14;2;
/org.eclipse.pde.ui/src/org/eclipse/pde/internal/core/builders/ManifestConsistencyChecker.java;1;0;2;1;0;0;0;2;0;1;2;3579;0;0;1;0;0;2;2;3579;0;3607;2;1;
/org.eclipse.jdt.ui.tests.refactoring/resources/DeleteSourceReference/test1/out/A.java;1;0;1;1;0;0;0;1;0;0;1;2857;0;0;1;0;0;1;1;2857;0;2857;1;1;
/org.eclipse.jdt.debug/jdi interfaces/com/sun/jdi/Bootstrap.java;3;0;4;1;0;0;0;4;16;2;3;2704;23;23;2;1;0;4;4;2757;1;3033;3;3;
/org.eclipse.pde.ui/Eclipse PDE UI/org/eclipse/pde/internal/base/model/plugin/IPluginLibrary.java;2;0;5;2;0;0;0;5;12;3;3;267;12;12;3;2;0;5;5;324;2;1434;3;2;
/org.eclipse.swt/Eclipse SWT/common/org/eclipse/swt/internal/image/GIFFileFormat.java;3;0;4;1;1;1;1;3;26;1;3;106;39;39;1;0;0;3;4;106;0;4701;4;3;
/org.eclipse.help/src/org/eclipse/help/internal/toc/Topic.java;2;0;4;1;0;0;0;4;13;1;4;1857;28;28;1;0;0;4;4;1857;0;3697;4;2;
/org.eclipse.swt/Eclipse SWT/gtk1x/org/eclipse/swt/widgets/ToolBar.java;4;0;4;1;1;1;1;3;12;1;3;2107;20;20;1;0;0;3;4;2107;0;4701;4;4;
/org.eclipse.swt.examples.paint/src/org/eclipse/swt/examples/paint/EllipseFigure.java;4;0;5;2;1;1;1;4;65;2;3;566;82;82;2;1;0;4;5;609;1;4705;4;4;
/org.eclipse.pde.ui/templates/editor/java/TagRule.java;1;0;2;1;1;1;1;1;4;0;1;3812;4;4;1;0;0;1;2;3812;0;4316;2;1;
/org.eclipse.jdt.ui/core refactoring/org/eclipse/jdt/internal/core/refactoring/base/ChangeAbortException.java;4;0;4;1;0;0;0;4;9;1;4;408;13;13;1;0;0;4;4;408;0;1939;4;4;
/org.eclipse.jdt.ui.tests.refactoring/resources/RenameType/testFail12/in/A.java;1;0;1;1;0;0;0;1;0;0;1;49;0;0;1;0;0;1;1;49;0;49;1;1;
/org.eclipse.pde.build/src/plugin/org/eclipse/pde/internal/core/BuildScriptGenerator.java;1;0;1;1;0;0;0;1;0;0;1;3475;0;0;1;0;0;1;1;3475;0;3475;1;1;
/org.eclipse.help.ui/Eclipse Help UI/org/eclipse/help/internal/ui/HyperlinkHandler.java;2;0;3;1;0;0;0;3;7;1;3;136;7;7;1;0;0;3;3;136;0;1420;3;2;
/org.eclipse.debug.ui/ui/org/eclipse/debug/ui/IDebugViewAdapter.java;3;0;9;2;0;0;0;9;20;2;8;187;54;54;2;1;0;9;9;187;1;3309;8;3;
/org.eclipse.jdt.ui.tests.refactoring/resources/RenameType/testIllegalInnerClass/in/A.java;1;0;1;1;0;0;0;1;0;0;1;49;0;0;1;0;0;1;1;49;0;49;1;1;
/org.eclipse.jdt.debug/model/org/eclipse/jdt/internal/debug/core/JDIDebugTarget.java;4;0;66;2;0;0;0;66;897;5;49;187;4253;4253;5;17;0;66;66;1484;17;2517;49;4;
/org.eclipse.pde.ui/src/org/eclipse/pde/internal/ui/wizards/project/PluginSelectionDialog.java;1;0;2;1;0;0;0;2;5;1;2;3579;5;5;1;0;0;2;2;3579;0;3607;2;1;
/org.eclipse.jdt.ui/core refactoring/org/eclipse/jdt/internal/core/refactoring/util/TextChangeManager.java;1;0;2;1;0;0;0;2;0;1;2;1800;0;0;1;0;0;2;2;1800;0;1939;2;1;
/org.eclipse.swt/Eclipse SWT OLE Win32/win32/org/eclipse/swt/ole/win32/OlePropertyChangeSink.java;2;0;3;1;1;1;1;2;10;1;2;106;16;16;1;0;0;2;3;106;0;4701;3;2;
/org.eclipse.jdt.core/model/org/eclipse/jdt/internal/core/builder/DeltaKey.java;1;0;11;1;0;0;0;11;230;4;7;455;285;285;4;4;0;11;11;1039;4;2808;7;1;
/org.eclipse.core.resources/src/org/eclipse/core/internal/resources/ProjectNatureDescriptor.java;1;0;3;1;1;1;1;2;29;1;2;3075;47;47;1;0;0;2;3;3075;0;4213;3;1;
/org.eclipse.update.ui/src/org/eclipse/update/internal/ui/wizards/InstallWizard.java;3;2;41;1;9;8;9;32;148;2;30;1570;661;661;2;2;1;32;41;2434;3;4715;38;3;
/org.eclipse.ui/Eclipse UI/org/eclipse/ui/IWorkbenchActionConstants.java;7;1;15;1;4;4;4;11;176;3;8;257;436;436;3;3;0;11;15;2049;3;4431;12;7;
/org.eclipse.core.tests.runtime/src/org/eclipse/core/tests/internal/runtimetests/SampleKPR.java;1;0;2;1;0;0;0;2;10;1;2;3611;10;10;1;0;0;2;2;3611;0;3678;2;1;
/org.eclipse.scripting/Eclipse Scripting/org/eclipse/scripting/internal/uirenderer/XGRNodePresentation.java;2;0;6;1;0;0;0;6;100;1;6;133;156;156;1;0;0;6;6;133;0;1424;6;2;
/org.eclipse.jdt.debug/jdi/org/eclipse/jdi/internal/JDIMessages.java;1;0;1;1;0;0;0;1;0;0;1;3678;0;0;1;0;0;1;1;3678;0;3678;1;1;
/org.eclipse.jdt.core/antadapter/JDTCompilerAdapter.java;1;1;3;1;2;2;2;1;5;0;1;3765;5;5;1;0;0;1;3;3765;0;4125;3;1;
/org.eclipse.ant.ui/src/org/eclipse/ant/internal/ui/AntLaunchDialogLabelProvider.java;2;0;3;2;0;0;0;3;20;2;2;276;20;20;2;1;0;3;3;296;1;296;2;2;
/org.eclipse.jdt.ui.tests.refactoring/resources/RenameParameters/cannotRename/A_testFail4.java;1;0;1;1;0;0;0;1;0;0;1;233;0;0;1;0;0;1;1;233;0;233;1;1;
/org.eclipse.jdt.junit/Eclipse JUnit/org/eclipse/jdt/junit/internal/TestRunner.java;3;0;4;1;0;0;0;4;471;1;4;1511;500;500;1;0;0;4;4;1511;0;2007;4;3;
/org.eclipse.jdt.ui.tests.refactoring/resources/SelectionAnalyzerWorkSpace/SelectionAnalyzerTests/invalidSelection/A_test108.java;1;0;1;1;0;0;0;1;0;0;1;1368;0;0;1;0;0;1;1;1368;0;1368;1;1;
/org.eclipse.ui/Eclipse JFace/org/eclipse/jface/dialogs/ProgressMonitorDialog.java;3;0;4;1;0;0;0;4;31;1;4;257;37;37;1;0;0;4;4;257;0;1155;4;3;
/org.eclipse.jdt.ui.tests.refactoring/resources/ExtractTemp/canExtract/A_test6_out.java;1;0;1;1;0;0;0;1;0;0;1;2481;0;0;1;0;0;1;1;2481;0;2481;1;1;
/org.eclipse.jdt.junit/Eclipse JUnit/org/eclipse/jdt/junit/internal/PreferencePage.java;3;0;4;1;0;0;0;4;316;1;4;1511;363;363;1;0;0;4;4;1511;0;2007;4;3;
/org.eclipse.jdt.core/model/org/eclipse/jdt/core/util/IMethodInfo.java;2;2;8;1;6;5;6;2;38;0;1;3629;99;99;2;1;1;2;8;3629;2;4573;6;2;
/org.eclipse.jdt.ui/core refactoring/org/eclipse/jdt/internal/corext/refactoring/sef/EncapsulatePrefixAccess.java;1;0;2;1;0;0;0;2;2;1;2;2876;2;2;1;0;0;2;2;2876;0;3150;2;1;
/org.eclipse.pde.ui/Eclipse PDE UI/org/eclipse/pde/internal/editor/manifest/ExtensionPointSection.java;2;0;6;2;0;0;0;6;12;3;4;267;13;13;3;2;0;6;6;324;2;1434;4;2;
/org.eclipse.core.target/src/org/eclipse/core/target/ITargetDefinition.java;1;0;4;1;1;1;1;3;80;1;3;681;105;105;1;0;0;3;4;681;0;4196;4;1;
/org.eclipse.swt/Eclipse SWT/gtk1x/org/eclipse/swt/widgets/Label.java;3;0;3;1;1;1;1;2;6;1;2;2107;10;10;1;0;0;2;3;2107;0;4701;3;3;
/org.eclipse.core.resources/src/org/eclipse/core/resources/team/IMoveDeleteHook.java;1;0;5;1;0;0;0;5;863;3;3;3195;932;932;3;2;0;5;5;3243;2;3360;3;1;
/org.eclipse.pde.ui/src/org/eclipse/pde/internal/base/model/component/IComponent.java;2;0;2;1;0;0;0;2;0;1;2;1434;0;0;1;0;0;2;2;1434;0;2951;2;2;
/org.eclipse.help.ui/src/org/eclipse/help/internal/ui/util/HelpPreferencePage.java;2;0;9;1;0;0;0;9;229;1;9;1420;468;468;1;0;0;9;9;1420;0;3762;9;2;
/org.eclipse.pde.ui/Eclipse PDE UI/org/eclipse/pde/internal/forms/IFormWorkbook.java;2;0;5;2;0;0;0;5;12;3;3;267;12;12;3;2;0;5;5;324;2;1434;3;2;
/org.eclipse.ui/Eclipse UI/org/eclipse/ui/internal/registry/ActionDefinitionRegistry.java;2;0;4;1;0;0;0;4;13;1;4;3055;31;31;1;0;0;4;4;3055;0;3270;4;2;
/org.eclipse.jdt.ui/ui/org/eclipse/jdt/internal/ui/javaeditor/InternalClassFileEditorInput.java;2;0;2;1;0;0;0;2;4;1;2;1685;4;4;1;0;0;2;2;1685;0;1841;2;2;
/org.eclipse.core.tests.harness/src/org/eclipse/core/tests/harness/WorkspaceSessionTest.java;2;0;5;2;1;1;1;4;122;2;3;2289;134;134;2;1;0;4;5;3419;1;4516;4;2;
/org.eclipse.pde.ui/Eclipse PDE UI/org/eclipse/pde/internal/preferences/AdvancedTracingPreferencePage.java;2;0;5;2;0;0;0;5;12;3;3;267;12;12;3;2;0;5;5;324;2;1434;3;2;
/org.eclipse.jdt.ui.tests.refactoring/resources/RenameType/test36/in/A.java;1;0;1;1;0;0;0;1;0;0;1;49;0;0;1;0;0;1;1;49;0;49;1;1;
/org.eclipse.core.tests.runtime/src/org/eclipse/core/tests/runtime/PreferencesTest.java;3;0;3;1;1;1;1;2;85;1;2;3506;106;106;1;0;0;2;3;3506;0;4772;3;3;
/org.eclipse.jdt.ui/core refactoring/org/eclipse/jdt/internal/core/refactoring/methods/RenameParametersRefactoring.java;3;0;12;1;0;0;0;12;159;3;9;408;268;268;3;3;0;12;12;408;3;1342;9;3;
/org.eclipse.pde.ui/Eclipse PDE UI/org/eclipse/pde/internal/base/model/plugin/IJars.java;2;0;5;2;0;0;0;5;12;3;3;267;12;12;3;2;0;5;5;324;2;1434;3;2;
/org.eclipse.pde.build/src_ant/org/eclipse/pde/internal/build/tasks/PluginLocationTask.java;1;0;6;1;1;1;1;5;19;2;4;3509;23;23;2;1;0;5;6;3571;1;4082;5;1;
/org.eclipse.jdt.debug/eval/org/eclipse/jdt/internal/debug/eval/ast/instructions/PushInt.java;2;0;3;1;0;0;0;3;2;1;3;3421;4;4;1;0;0;3;3;3421;0;3677;3;2;
/org.eclipse.pde.ui/src/org/eclipse/pde/internal/forms/renamed/FormSection.java;1;0;2;1;0;0;0;2;0;1;2;2470;0;0;1;0;0;2;2;2470;0;2691;2;1;
/org.eclipse.jdt.ui.tests.refactoring/resources/ExtractMethodWorkSpace/ExtractMethodTests/invalidSelection/A_test052.java;2;1;3;1;2;2;2;1;0;0;1;49;0;0;1;0;0;1;3;49;0;4419;3;2;
/org.eclipse.core.tests.runtime/src/org/eclipse/core/tests/internal/plugins/PluginResolveTest_15.java;3;0;3;1;0;0;0;3;124;1;3;1794;134;134;1;0;0;3;3;1794;0;3476;3;3;
/org.eclipse.scripting/src/org/eclipse/scripting/internal/ScriptRunnerExtended.java;1;0;1;1;0;0;0;1;0;0;1;1424;0;0;1;0;0;1;1;1424;0;1424;1;1;
/org.eclipse.jdt.ui.tests.refactoring/resources/SafeDeleteType/testFail14/in/A.java;1;0;1;1;0;0;0;1;0;0;1;49;0;0;1;0;0;1;1;49;0;49;1;1;
/org.eclipse.pde.ui/src/org/eclipse/pde/internal/TargetPlatformManager.java;1;0;3;1;0;0;0;3;2;1;3;2750;2;2;1;0;0;3;3;2750;0;3103;3;1;
/org.eclipse.jdt.debug/jdi/org/eclipse/jdi/internal/request/ModificationWatchpointRequestImpl.java;2;0;4;1;0;0;0;4;12;1;4;187;25;25;1;0;0;4;4;187;0;3670;4;2;
/org.eclipse.jdt.ui.tests.refactoring/resources/RenameType/testFail39/in/A.java;1;0;1;1;0;0;0;1;0;0;1;49;0;0;1;0;0;1;1;49;0;49;1;1;
/org.eclipse.jdt.ui.tests.refactoring/resources/PullUp/testFail3/in/A.java;1;0;1;1;0;0;0;1;0;0;1;2406;0;0;1;0;0;1;1;2406;0;2406;1;1;
/org.eclipse.pde.ui/src/org/eclipse/pde/core/IModelChangedEvent.java;1;0;2;1;0;0;0;2;0;1;2;3579;0;0;1;0;0;2;2;3579;0;3607;2;1;
/org.eclipse.jdt.ui/core refactoring/org/eclipse/jdt/internal/corext/refactoring/reorg/INewNameQuery.java;1;0;1;1;1;1;1;0;0;0;0;4212;0;0;1;0;0;0;1;4212;0;4212;1;1;
/org.eclipse.update.tests.core/src/org/eclipse/update/tests/types/TestSiteType.java;2;0;8;1;0;0;0;8;70;1;8;2276;119;119;1;0;0;8;8;2276;0;3107;8;2;
/org.eclipse.jdt.debug.tests/tests/org/eclipse/jdt/debug/tests/eval/FloatAssignmentOperatorsTests.java;2;2;3;2;3;2;3;0;18;0;0;4447;20;20;2;0;1;0;3;4447;1;4571;2;2;
/org.eclipse.ui/Eclipse UI Standard Components/org/eclipse/ui/wizards/datatransfer/IDataTransferHelpContextIds.java;2;0;2;1;0;0;0;2;10;1;2;620;10;10;1;0;0;2;2;620;0;732;2;2;
/org.eclipse.help.ui/Eclipse Help UI/org/eclipse/help/internal/ui/IHelpUIConstants.java;2;0;5;2;0;0;0;5;8;2;4;136;16;16;2;1;0;5;5;323;1;1420;4;2;
/org.eclipse.ui/Eclipse UI/org/eclipse/ui/internal/misc/CheckboxTreeAndListGroup.java;4;0;5;1;0;0;0;5;5;1;5;257;10;10;1;0;0;5;5;257;0;2681;5;4;
/org.eclipse.search/search/org/eclipse/search/internal/ui/ShowOtherSearchesAction.java;1;0;2;1;0;0;0;2;0;1;2;15;0;0;1;0;0;2;2;15;0;78;2;1;
/org.eclipse.jdt.ui.tests.refactoring/resources/DeleteSourceReference/test16/out/A.java;1;0;1;1;1;1;1;0;0;0;0;4018;0;0;1;0;0;0;1;4018;0;4018;1;1;
/org.eclipse.vcm.ui/src/org/eclipse/vcm/internal/ui/SimpleContentProvider.java;2;0;2;1;0;0;0;2;5;1;2;1;5;5;1;0;0;2;2;1;0;298;2;2;
/org.eclipse.jdt.ui.tests.refactoring/resources/ExtractMethodWorkSpace/ExtractMethodTests/return_out/A_test719.java;1;1;3;1;2;2;2;1;30;0;1;1236;30;30;1;0;0;1;3;1236;0;4419;3;1;
/org.eclipse.pde.ui/Eclipse PDE UI/org/eclipse/pde/internal/base/model/plugin/IPluginElement.java;2;0;5;2;0;0;0;5;12;3;3;267;12;12;3;2;0;5;5;324;2;1434;3;2;
/org.eclipse.ui/Eclipse UI/org/eclipse/ui/internal/dialogs/WorkbenchEditorsDialog.java;4;1;10;1;2;2;2;8;159;1;8;1745;537;537;1;0;0;8;10;1745;0;4609;10;4;
/org.eclipse.swt.examples/org/eclipse/swt/examples/controlexample/TextTab.java;5;2;8;1;4;3;4;4;159;1;4;513;445;445;2;0;1;4;8;3914;1;4024;7;5;
/org.eclipse.swt/Eclipse SWT PI/win32/org/eclipse/swt/internal/ole/win32/CAUUID.java;2;0;2;1;1;1;1;1;6;0;1;2069;6;6;1;0;0;1;2;2069;0;4701;2;2;
/org.eclipse.team.cvs.core/src/org/eclipse/team/internal/ccvs/core/connection/ExtConnection.java;2;0;5;1;1;1;1;4;78;1;4;2956;92;92;1;0;0;4;5;2956;0;4169;5;2;
/org.eclipse.help.ui/src/org/eclipse/help/internal/ui/util/Util.java;2;0;2;1;0;0;0;2;0;1;2;1420;0;0;1;0;0;2;2;1420;0;1675;2;2;
/org.eclipse.swt/Eclipse SWT/common_j2me/org/eclipse/swt/internal/CloneableCompatibility.java;2;0;2;1;1;1;1;1;6;0;1;1434;6;6;1;0;0;1;2;1434;0;4701;2;2;
/org.eclipse.core.target/src/org/eclipse/core/internal/target/TargetVisitor.java;2;0;4;1;0;0;0;4;6;1;4;12;8;8;1;0;0;4;4;12;0;753;4;2;
/org.eclipse.compare/compare/org/eclipse/patch/LineReader.java;1;0;2;1;0;0;0;2;0;1;2;1419;0;0;1;0;0;2;2;1419;0;1516;2;1;
/org.eclipse.ui/Eclipse UI Text Editor/org/eclipse/ui/texteditor/FindReplaceDialog.java;7;1;19;1;5;5;5;14;345;1;14;257;1166;1166;1;0;0;14;19;257;0;4838;19;7;
/org.eclipse.help/src/org/eclipse/help/internal/search/SearchProgressMonitor.java;1;0;1;1;1;1;1;0;0;0;0;4008;0;0;1;0;0;0;1;4008;0;4008;1;1;
/org.eclipse.swt/Eclipse SWT/common_j2me/org/eclipse/swt/internal/SerializableCompatability.java;1;0;1;1;0;0;0;1;0;0;1;1378;0;0;1;0;0;1;1;1378;0;1378;1;1;
/org.eclipse.ui/Eclipse UI Tool Script/org/eclipse/toolscript/ui/internal/AntTargetContentProvider.java;1;1;2;1;2;2;2;0;0;0;0;4041;0;0;1;0;0;0;2;4041;0;4087;2;1;
/org.eclipse.debug.ui/ui/org/eclipse/debug/internal/ui/DelegatingModelPresentation.java;4;0;36;2;1;1;1;35;216;3;31;187;892;892;3;4;0;35;36;2346;4;4423;32;4;
/org.eclipse.ui/Eclipse UI/org/eclipse/ui/dialogs/TwoArrayQuickSorter.java;1;0;2;1;0;0;0;2;1;1;2;3733;1;1;1;0;0;2;2;3733;0;3740;2;1;
/org.eclipse.pde.ui/src/org/eclipse/pde/internal/ui/editor/IPDEEditorPage.java;1;0;1;1;0;0;0;1;0;0;1;3579;0;0;1;0;0;1;1;3579;0;3579;1;1;
/org.eclipse.pde.ui/src/org/eclipse/pde/internal/ui/wizards/imports/UpdateBuildpathWizardPage.java;1;0;2;1;0;0;0;2;25;1;2;3579;25;25;1;0;0;2;2;3579;0;3607;2;1;
/org.eclipse.jdt.ui.tests.refactoring/resources/RenameType/test21/out/B.java;1;0;1;1;0;0;0;1;0;0;1;522;0;0;1;0;0;1;1;522;0;522;1;1;
/org.eclipse.ui/Eclipse JFace/org/eclipse/jface/viewers/DecoratingLabelProvider.java;3;0;9;1;2;1;2;7;307;1;7;257;788;788;2;0;1;7;9;3956;1;3956;8;3;
/org.eclipse.update/src/org/eclipse/update/internal/ui/UMWizardPageURLInstall.java;1;0;1;1;0;0;0;1;0;0;1;1424;0;0;1;0;0;1;1;1424;0;1424;1;1;
/org.eclipse.jdt.ui/ui/org/eclipse/jdt/internal/ui/reorg/CopyAction.java;7;0;16;2;0;0;0;16;235;2;15;15;342;342;2;1;0;16;16;1257;1;3222;15;7;
/org.eclipse.debug.ui/ui/org/eclipse/debug/internal/ui/ConsoleOutputTextStore.java;4;0;5;1;1;1;1;4;12;1;4;187;19;19;1;0;0;4;5;187;0;3975;5;4;
/org.eclipse.update.core/src/org/eclipse/update/core/model/SiteLocalModel.java;1;0;6;1;0;0;0;6;17;1;6;2764;29;29;1;0;0;6;6;2764;0;3027;6;1;
/org.eclipse.update.examples/src/org/eclipse/update/examples/ExamplesPlugin.java;1;0;2;1;0;0;0;2;0;1;2;1424;0;0;1;0;0;2;2;1424;0;2583;2;1;
/org.eclipse.jdt.ui.tests.refactoring/resources/SurroundWithWorkSpace/SurroundWithTests/trycatch_in/TestSimple.java;1;0;1;1;0;0;0;1;0;0;1;2327;0;0;1;0;0;1;1;2327;0;2327;1;1;
/org.eclipse.swt.examples/org/eclipse/swt/examples/controlexample/ButtonTab.java;5;1;7;1;3;3;3;4;307;1;4;513;570;570;1;0;0;4;7;513;0;4024;7;5;
/org.eclipse.ui.tests/Eclipse UI Tests/org/eclipse/ui/tests/dialogs/DataTransferTestStub.java;1;0;1;1;0;0;0;1;0;0;1;1274;0;0;1;0;0;1;1;1274;0;1274;1;1;
/org.eclipse.ui/Eclipse UI/org/eclipse/ui/IKeyBindingService.java;2;0;5;1;0;0;0;5;17;2;4;3055;29;29;2;1;0;5;5;3267;1;3307;4;2;
/org.eclipse.swt.examples.paint/org/eclipse/swt/examples/paint/Assert.java;1;0;1;1;0;0;0;1;0;0;1;513;0;0;1;0;0;1;1;513;0;513;1;1;
/org.eclipse.team.core/src/org/eclipse/team/core/IIgnoreInfo.java;2;0;3;1;1;1;1;2;17;1;2;2864;19;19;1;0;0;2;3;2864;0;4571;3;2;
/org.eclipse.help/src/org/eclipse/help/internal/context/HelpContextTopic.java;2;0;4;1;0;0;0;4;50;1;4;1675;56;56;1;0;0;4;4;1675;0;2791;4;2;
/org.eclipse.jdt.core/model/org/eclipse/jdt/core/IClasspathEntry.java;3;2;20;1;6;5;6;14;206;3;11;455;639;639;3;3;1;14;20;1434;4;4493;16;3;
/org.eclipse.jdt.ui/ui/org/eclipse/jdt/internal/ui/packageview/WorkingSetFilter.java;2;0;3;1;0;0;0;3;8;1;3;1693;8;8;1;0;0;3;3;1693;0;3835;3;2;
/org.eclipse.jdt.debug/eval/org/eclipse/jdt/internal/debug/eval/model/EvaluationThread.java;2;0;3;1;0;0;0;3;1;1;3;3421;1;1;1;0;0;3;3;3421;0;3645;3;2;
/org.eclipse.jdt.ui/ui/org/eclipse/jdt/internal/ui/wizards/buildpaths/ClasspathContainerDescriptor.java;2;1;3;1;3;3;3;0;2;0;0;4117;4;4;1;0;0;0;3;4117;0;4621;3;2;
/org.eclipse.jdt.junit/src/org/eclipse/jdt/internal/junit/oldlauncher/JUnitLaunchWizardPage.java;2;0;2;1;0;0;0;2;0;1;2;3171;0;0;1;0;0;2;2;3171;0;3638;2;2;
/org.eclipse.pde.ui/Eclipse PDE UI/org/eclipse/pde/internal/elements/NamedElement.java;2;0;5;2;0;0;0;5;12;3;3;267;12;12;3;2;0;5;5;324;2;1434;3;2;
/org.eclipse.vcm.core/src/org/eclipse/vcm/internal/core/VersionHandle.java;3;0;3;1;0;0;0;3;6;1;3;0;8;8;1;0;0;3;3;0;0;297;3;3;
/org.eclipse.jdt.core/model/org/eclipse/jdt/internal/core/util/InnerClassesAttributeEntry.java;2;1;4;1;3;3;3;1;18;0;1;3629;46;46;1;0;0;1;4;3629;0;4422;4;2;
/org.eclipse.ui/Eclipse UI Standard Components/org/eclipse/ui/views/tasklist/SelectAllTasksAction.java;3;0;3;1;1;1;1;2;16;1;2;257;21;21;1;0;0;2;3;257;0;4608;3;3;
/org.eclipse.swt/Eclipse SWT Printing/gtk/org/eclipse/swt/printing/PrintDialog.java;3;1;5;1;3;3;3;2;286;1;2;2107;331;331;1;0;0;2;5;2107;0;4701;5;3;
/org.eclipse.swt/Eclipse SWT Program/motif_j2me/org/eclipse/swt/program/Program.java;1;0;1;1;0;0;0;1;0;0;1;1387;0;0;1;0;0;1;1;1387;0;1387;1;1;
/org.eclipse.core.runtime/src/org/eclipse/core/runtime/IAdapterFactory.java;4;0;5;1;1;1;1;4;94;1;4;12;117;117;1;0;0;4;5;12;0;4214;5;4;
/org.eclipse.jdt.ui.tests.refactoring/resources/RenameNonPrivateField/test2/in/A.java;2;0;2;1;0;0;0;2;2;1;2;49;2;2;1;0;0;2;2;49;0;1297;2;2;
/org.eclipse.help/src/org/eclipse/help/internal/protocols/HelpURLFactory.java;2;0;3;1;0;0;0;3;2;1;3;3095;4;4;1;0;0;3;3;3095;0;3776;3;2;
/org.eclipse.update.ui.forms/src/org/eclipse/update/ui/forms/TableData.java;1;0;5;1;0;0;0;5;5;1;5;1541;8;8;1;0;0;5;5;1541;0;2474;5;1;
/org.eclipse.help/Eclipse Help/org/eclipse/help/internal/server/PluginURL.java;4;0;13;2;0;0;0;13;174;2;12;135;642;642;2;1;0;13;13;1085;1;1420;12;4;
/org.eclipse.ui.tests/Eclipse JFace Tests/org/eclipse/jface/tests/viewers/interactive/AddElementAction.java;1;0;1;1;0;0;0;1;0;0;1;1488;0;0;1;0;0;1;1;1488;0;1488;1;1;
/org.eclipse.jdt.debug.tests/test plugin/org/eclipse/jdt/debug/testplugin/TestWorkbench.java;2;0;3;1;1;1;1;2;40;1;2;3701;58;58;1;0;0;2;3;3701;0;4328;3;2;
/org.eclipse.core.tests.runtime/src/org/eclipse/core/tests/internal/runtimetests/SampleOPR.java;1;0;2;1;0;0;0;2;10;1;2;3611;10;10;1;0;0;2;2;3611;0;3678;2;1;
/org.eclipse.jdt.ui/core extension/org/eclipse/jdt/internal/corext/codegeneration/ImportsStructure.java;2;0;4;1;0;0;0;4;20;2;2;2016;21;21;2;2;0;4;4;2016;2;2133;2;2;
/org.eclipse.vcm.core/src/org/eclipse/vcm/internal/core/base/ITeamStream.java;2;0;2;1;0;0;0;2;5;1;2;0;5;5;1;0;0;2;2;0;0;297;2;2;
/org.eclipse.update.ui/src/org/eclipse/update/internal/ui/search/SearchResultSite.java;1;0;3;1;0;0;0;3;8;1;3;3657;12;12;1;0;0;3;3;3657;0;3740;3;1;
/org.eclipse.pde.core/src/org/eclipse/pde/internal/core/ICoreConstants.java;1;0;2;1;1;1;1;1;2;0;1;3607;2;2;1;0;0;1;2;3607;0;4409;2;1;
/org.eclipse.core.resources/src/org/eclipse/core/resources/IProjectNatureDescriptor.java;2;0;2;1;1;1;1;1;16;0;1;3075;16;16;1;0;0;1;2;3075;0;4214;2;2;
/org.eclipse.ui.examples.readmetool/Eclipse UI Examples Readme Tool/org/eclipse/ui/examples/readmetool/ReadmeDropActionDelegate.java;2;0;2;1;0;0;0;2;4;1;2;932;4;4;1;0;0;2;2;932;0;945;2;2;
/org.eclipse.jdt.ui.tests.refactoring/resources/MultiMove/test1/in/p1/A.java;1;0;1;1;0;0;0;1;0;0;1;1157;0;0;1;0;0;1;1;1157;0;1157;1;1;
/org.eclipse.core.tests.resources/src/org/eclipse/core/tests/internal/watson/TestElementComparator.java;3;0;4;1;1;1;1;3;140;1;3;1794;163;163;1;0;0;3;4;1794;0;4516;4;3;
/org.eclipse.swt.examples.paint/org/eclipse/swt/examples/paint/SolidPolygonFigure.java;3;0;4;2;1;1;1;3;67;2;2;586;67;67;2;1;0;3;4;609;1;4024;3;3;
/org.eclipse.ui/Eclipse JFace Text/org/eclipse/jface/text/IWidgetTokenKeeper.java;1;1;2;1;2;2;2;0;28;0;0;4423;28;28;1;0;0;0;2;4423;0;4838;2;1;
/org.eclipse.jdt.debug.ui/ui/org/eclipse/jdt/internal/debug/ui/IJavaDebugHelpContextIds.java;2;1;3;1;3;3;3;0;10;0;0;4126;15;15;1;0;0;0;3;4126;0;4382;3;2;
/org.eclipse.core.tests.resources/src/org/eclipse/core/tests/resources/AutomatedTests.java;3;0;3;1;1;1;1;2;62;1;2;1794;72;72;1;0;0;2;3;1794;0;4516;3;3;
/org.eclipse.jdt.ui.tests.refactoring/resources/MoveMembers/test6/out/A.java;1;0;1;1;0;0;0;1;0;0;1;2738;0;0;1;0;0;1;1;2738;0;2738;1;1;
/org.eclipse.update.core/src/org/eclipse/update/core/model/FeatureModelFactory.java;2;0;11;1;0;0;0;11;106;2;9;2409;270;270;2;2;0;11;11;3027;2;3796;9;2;
/org.eclipse.help/src/org/eclipse/help/internal/context/LinksResult.java;2;0;6;1;0;0;0;6;24;1;6;2572;48;48;1;0;0;6;6;2572;0;3609;6;2;
/org.eclipse.jdt.ui.tests.refactoring/resources/ExtractMethodWorkSpace/ExtractMethodTests/try_in/A_test460.java;1;1;4;1;2;2;2;2;52;1;2;1851;57;57;1;0;0;2;4;1851;0;4419;4;1;
/org.eclipse.jdt.ui.tests.refactoring/test cases/org/eclipse/jdt/ui/tests/changes/TrackPositionTest.java;1;0;1;1;0;0;0;1;0;0;1;3221;0;0;1;0;0;1;1;3221;0;3221;1;1;
/org.eclipse.update.ui/src/org/eclipse/update/internal/ui/search/SearchObject.java;2;1;17;1;10;10;10;7;237;4;4;3537;590;590;4;3;0;7;17;3657;3;4730;14;2;
/org.eclipse.jdt.ui.tests/JUnit/junit/tests/OverrideTestCase.java;2;0;2;1;0;0;0;2;0;1;2;49;0;0;1;0;0;2;2;49;0;1186;2;2;
/org.eclipse.jdt.ui.tests.refactoring/resources/RenameMethodInInterface/test39/out/A.java;1;0;1;1;0;0;0;1;0;0;1;49;0;0;1;0;0;1;1;49;0;49;1;1;
/org.eclipse.jdt.ui/core refactoring/org/eclipse/jdt/internal/core/refactoring/base/FileContext.java;1;0;2;1;0;0;0;2;0;1;2;1930;0;0;1;0;0;2;2;1930;0;1939;2;1;
/org.eclipse.swt/Eclipse SWT PI/motif/org/eclipse/swt/internal/motif/XExposeEvent.java;2;0;2;1;1;1;1;1;6;0;1;2069;6;6;1;0;0;1;2;2069;0;4701;2;2;
/org.eclipse.jdt.ui/ui/org/eclipse/jdt/internal/ui/text/correction/NewCUCompletionProposal.java;2;1;4;1;3;3;3;1;20;0;1;3737;24;24;1;0;0;1;4;3737;0;4621;4;2;
/org.eclipse.jdt.ui.tests.refactoring/resources/RenameMethodInInterface/test46/out/A.java;1;0;1;1;0;0;0;1;0;0;1;1274;0;0;1;0;0;1;1;1274;0;1274;1;1;
/org.eclipse.jdt.ui/ui/org/eclipse/jdt/internal/ui/reorg/ReorgActionFactory.java;2;1;7;2;3;3;3;4;37;3;2;3807;78;78;3;2;0;4;7;3826;2;4630;5;2;
/org.eclipse.jdt.junit/Eclipse JUnit/org/eclipse/jdt/internal/junit/ui/SocketUtil.java;2;0;3;1;0;0;0;3;6;1;3;2007;6;6;1;0;0;3;3;2007;0;3313;3;2;
/org.eclipse.jdt.ui.tests.refactoring/resources/MoveCU/testFail8/in/p1/B.java;2;0;2;1;0;0;0;2;0;1;2;49;0;0;1;0;0;2;2;49;0;2769;2;2;
/org.eclipse.jdt.ui/core extension/org/eclipse/jdt/internal/corext/template/DocumentTemplateContext.java;1;0;2;1;1;1;1;1;31;0;1;2784;31;31;1;0;0;1;2;2784;0;4186;2;1;
/org.eclipse.update.core/src/org/eclipse/update/internal/core/DefaultExecutableFeature.java;1;0;13;1;0;0;0;13;261;2;12;1451;488;488;2;1;0;13;13;1684;1;1791;12;1;
/org.eclipse.pde.ui/src/org/eclipse/pde/ui/templates/ITemplateSection.java;1;1;4;1;2;2;2;2;78;1;2;3819;102;102;1;0;0;2;4;3819;0;4752;4;1;
/org.eclipse.jdt.ui.tests.refactoring/resources/RenamePackage/test2/out/p1/A.java;1;0;1;1;0;0;0;1;0;0;1;49;0;0;1;0;0;1;1;49;0;49;1;1;
/org.eclipse.team.cvs.core/src/org/eclipse/team/internal/ccvs/core/client/Add.java;2;0;13;2;1;1;1;12;81;2;10;2572;161;161;2;2;0;12;13;2806;2;4424;11;2;
/org.eclipse.debug.ui/ui/org/eclipse/debug/ui/ILaunchConfigurationDialog.java;2;1;11;1;3;3;3;8;46;1;8;2254;115;115;1;0;0;8;11;2254;0;4653;11;2;
/org.eclipse.jdt.ui/ui/org/eclipse/jdt/internal/ui/actions/ContextMenuGroup.java;4;1;5;1;2;2;2;3;12;1;3;15;19;19;1;0;0;3;5;15;0;4140;5;4;
/org.eclipse.update.ui/src/org/eclipse/update/internal/ui/manager/LocalSiteForm.java;1;0;9;1;0;0;0;9;37;2;8;1889;78;78;2;1;0;9;9;2746;1;3662;8;1;
/org.eclipse.jdt.ui.tests.refactoring/test cases/org/eclipse/jdt/ui/tests/refactoring/MoveCUTests.java;2;0;2;1;0;0;0;2;0;1;2;1896;0;0;1;0;0;2;2;1896;0;2738;2;2;
/org.eclipse.swt/Eclipse SWT/motif/org/eclipse/swt/internal/motif/XMotionEvent.java;2;0;3;1;0;0;0;3;4;1;3;106;4;4;1;0;0;3;3;106;0;2069;3;2;
/org.eclipse.pde.ui/src/org/eclipse/pde/internal/core/feature/Feature.java;1;0;4;1;0;0;0;4;15;2;3;3579;17;17;2;1;0;4;4;3579;1;3607;3;1;
/org.eclipse.jdt.core/dom/org/eclipse/jdt/core/dom/ClassInstanceCreation.java;3;1;10;1;3;3;3;7;81;1;7;2669;204;204;1;0;0;7;10;2669;0;4453;10;3;
/org.eclipse.ui/Eclipse UI Standard Components/org/eclipse/ui/views/navigator/SelectionUtil.java;3;0;4;1;0;0;0;4;5;1;4;257;8;8;1;0;0;4;4;257;0;1832;4;3;
/org.eclipse.jdt.debug.tests/tests/org/eclipse/jdt/debug/tests/core/LocalVariableTests.java;3;1;5;1;4;4;4;1;21;0;1;3816;40;40;1;0;0;1;5;3816;0;4571;5;3;
/org.eclipse.pde.ui/src/org/eclipse/pde/internal/ui/launcher/WorkbenchLauncherDelegate.java;1;0;4;1;0;0;0;4;71;1;4;3579;74;74;1;0;0;4;4;3579;0;3634;4;1;
/org.eclipse.swt/Eclipse SWT Custom Widgets/common_j2se/org/eclipse/swt/custom/StackLayout.java;1;0;1;1;0;0;0;1;0;0;1;1378;0;0;1;0;0;1;1;1378;0;1378;1;1;
/org.eclipse.pde.ui/src/org/eclipse/pde/model/plugin/IPlugin.java;1;0;2;1;0;0;0;2;0;1;2;3039;0;0;1;0;0;2;2;3039;0;3579;2;1;
/org.eclipse.pde.ui/src/org/eclipse/pde/internal/core/build/ExternalBuildModel.java;1;0;2;1;0;0;0;2;0;1;2;3579;0;0;1;0;0;2;2;3579;0;3607;2;1;
/org.eclipse.pde.core/src/org/eclipse/pde/internal/core/SourceDOMParser.java;1;0;2;1;1;1;1;1;16;0;1;3631;16;16;1;0;0;1;2;3631;0;4238;2;1;
/org.eclipse.core.tests.runtime/src/org/eclipse/core/tests/internal/plugins/RegressionResolveTest_8.java;3;0;3;1;0;0;0;3;132;1;3;1794;142;142;1;0;0;3;3;1794;0;3476;3;3;
/org.eclipse.jdt.ui.tests.refactoring/resources/ReorderParameters/canReorder/A_test20_out.java;1;0;1;1;1;1;1;0;0;0;0;4400;0;0;1;0;0;0;1;4400;0;4400;1;1;
/org.eclipse.jdt.ui.tests.refactoring/resources/RenameType/testFail3/in/A.java;1;0;1;1;0;0;0;1;0;0;1;49;0;0;1;0;0;1;1;49;0;49;1;1;
/org.eclipse.update.ui/src/org/eclipse/update/internal/ui/manager/ControlSection.java;1;0;2;1;0;0;0;2;0;0;1;1457;0;0;2;1;0;2;2;1457;1;1457;1;1;
/org.eclipse.scripting/src/org/eclipse/scripting/internal/uirenderer/XGRPresentationModelAttribute.java;1;0;1;1;0;0;0;1;0;0;1;1424;0;0;1;0;0;1;1;1424;0;1424;1;1;
/org.eclipse.swt/Eclipse SWT PI/carbon/org/eclipse/swt/internal/carbon/MacUtil.java;3;1;3;1;3;3;3;0;104;0;0;4147;110;110;1;0;0;0;3;4147;0;4701;3;3;
/org.eclipse.jdt.debug.tests/testprograms/Breakpoints.java;2;0;2;1;1;1;1;1;17;0;1;3719;17;17;1;0;0;1;2;3719;0;4571;2;2;
/org.eclipse.jdt.ui/core refactoring/org/eclipse/jdt/internal/core/refactoring/fields/FieldRefactoring.java;2;0;4;1;0;0;0;4;13;1;4;408;16;16;1;0;0;4;4;408;0;1257;4;2;
/org.eclipse.core.tests.resources/src/org/eclipse/core/tests/resources/usecase/HistoryStorePerformanceTest.java;3;0;3;1;0;0;0;3;150;1;3;1794;160;160;1;0;0;3;3;1794;0;3475;3;3;
/org.eclipse.core.boot/src/org/eclipse/core/internal/boot/update/IProductDescriptor.java;3;0;4;1;0;0;0;4;8;1;4;12;15;15;1;0;0;4;4;12;0;2726;4;3;
/org.eclipse.help/webapps/examples/WEB-INF/classes/checkbox/CheckTest.java;1;0;2;1;0;0;0;2;0;1;2;1882;0;0;1;0;0;2;2;1882;0;1930;2;1;
/org.eclipse.swt.examples/src/org/eclipse/swt/examples/controlexample/ControlExample.java;4;0;8;1;1;1;1;7;238;1;7;513;345;345;1;0;0;7;8;513;0;4705;8;4;
/org.eclipse.update.ui.forms/src/org/eclipse/update/ui/forms/ExpandableGroup.java;1;0;9;1;0;0;0;9;54;1;9;1631;208;208;1;0;0;9;9;1631;0;2474;9;1;
/org.eclipse.team.ui/src/org/eclipse/team/internal/ui/TeamResourceDecorator.java;2;0;6;1;0;0;0;6;669;1;6;1978;709;709;1;0;0;6;6;1978;0;2513;6;2;
/org.eclipse.help/Eclipse Help/org/eclipse/help/internal/contributors/xml/XMLContextContributorCreator.java;2;0;3;1;0;0;0;3;7;1;3;135;7;7;1;0;0;3;3;135;0;1420;3;2;
/org.eclipse.webdav/src/interface/org/eclipse/webdav/dom/AssertionFailedException.java;2;0;4;1;1;1;1;3;66;1;3;12;93;93;1;0;0;3;4;12;0;4211;4;2;
/org.eclipse.vcm.ui/src/org/eclipse/vcm/internal/ui/sync/CommitAction.java;1;0;2;1;0;0;0;2;70;1;2;1505;70;70;1;0;0;2;2;1505;0;1515;2;1;
/org.eclipse.ui.tests/Eclipse UI Tests/org/eclipse/ui/tests/api/MockWorkbenchWindowActionDelegate.java;1;0;2;1;0;0;0;2;4;1;2;1080;4;4;1;0;0;2;2;1080;0;1098;2;1;
/org.eclipse.ui/Eclipse UI/org/eclipse/ui/internal/WWinPerspectiveService.java;4;0;4;1;0;0;0;4;18;1;4;257;27;27;1;0;0;4;4;257;0;3125;4;4;
/org.eclipse.core.resources/src/org/eclipse/core/internal/indexing/Page.java;3;0;6;1;1;1;1;5;152;1;5;12;252;252;1;0;0;5;6;12;0;4214;6;3;
/org.eclipse.help.ui/Eclipse Help UI/org/eclipse/help/internal/ui/EmbeddedHelpView.java;4;0;13;2;0;0;0;13;42;2;12;136;135;135;2;1;0;13;13;475;1;1420;12;4;
/org.eclipse.jdt.ui.tests.refactoring/resources/RenameMethodInInterface/testFail45/in/A.java;1;0;1;1;0;0;0;1;0;0;1;1258;0;0;1;0;0;1;1;1258;0;1258;1;1;
/org.eclipse.jdt.core/model/org/eclipse/jdt/core/ICorrectionRequestor.java;2;1;4;1;2;2;2;2;116;0;1;2675;128;128;2;1;0;2;4;2675;1;4061;3;2;
/org.eclipse.ui/Eclipse UI/org/eclipse/ui/internal/misc/ActivatorBar.java;2;0;2;1;0;0;0;2;5;1;2;257;5;5;1;0;0;2;2;257;0;457;2;2;
/org.eclipse.jdt.ui.tests.refactoring/resources/MultiMove/test1/out/p2/A.java;1;0;3;1;0;0;0;3;3;1;3;1157;5;5;1;0;0;3;3;1157;0;2682;3;1;
/org.eclipse.jdt.core/search/org/eclipse/jdt/internal/core/search/JavaSearchScope.java;3;1;21;1;2;2;2;19;308;3;16;455;1041;1041;3;3;0;19;21;1580;3;4063;18;3;
/org.eclipse.debug.ui/ui/org/eclipse/debug/internal/ui/DebugContentProvider.java;4;0;16;1;0;0;0;16;89;1;16;187;372;372;1;0;0;16;16;187;0;2312;16;4;
/org.eclipse.update.ui/src/org/eclipse/update/internal/ui/forms/UpdateSearchProgressMonitor.java;1;0;2;1;0;0;0;2;0;1;2;3662;0;0;1;0;0;2;2;3662;0;3749;2;1;
/org.eclipse.jdt.ui.tests.refactoring/resources/RenameType/test31/out/A.java;1;0;2;1;0;0;0;2;0;1;2;49;0;0;1;0;0;2;2;49;0;522;2;1;
/org.eclipse.ui/Eclipse JFace/org/eclipse/jface/preference/BooleanFieldEditor.java;3;0;3;1;1;1;1;2;5;1;2;257;6;6;1;0;0;2;3;257;0;4448;3;3;
/org.eclipse.jdt.ui/ui/org/eclipse/jdt/internal/ui/javadocexport/JavadocWizardPage.java;1;0;5;1;0;0;0;5;96;1;5;2878;153;153;1;0;0;5;5;2878;0;3589;5;1;
/org.eclipse.ui/Eclipse UI Standard Components/org/eclipse/ui/wizards/datatransfer/MinimizedFileSystemElement.java;2;0;2;1;0;0;0;2;4;1;2;257;4;4;1;0;0;2;2;257;0;457;2;2;
/org.eclipse.jdt.ui.tests.refactoring/resources/ExtractMethodWorkSpace/ExtractMethodTests/nested_out/A_test651.java;2;1;3;1;2;2;2;1;22;0;1;354;22;22;1;0;0;1;3;354;0;4419;3;2;
/org.eclipse.vcm.core/src/org/eclipse/vcm/internal/core/base/IRepository.java;2;0;2;1;0;0;0;2;6;1;2;0;6;6;1;0;0;2;2;0;0;297;2;2;
/org.eclipse.update.ui/src/org/eclipse/update/internal/transform/TransformFactory.java;1;0;2;1;0;0;0;2;0;1;2;1526;0;0;1;0;0;2;2;1526;0;1596;2;1;
/org.eclipse.vcm.core.cvs/src/org/eclipse/vcm/internal/core/ccvs/requests/MessageFileOutputHandler.java;3;0;4;1;0;0;0;4;13;1;4;0;18;18;1;0;0;4;4;0;0;1549;4;3;
/org.eclipse.jdt.debug/eval/org/eclipse/jdt/internal/debug/eval/ast/ASTCuToEvalSourceMapper.java;2;0;5;2;0;0;0;5;73;2;4;3344;79;79;2;1;0;5;5;3417;1;3417;4;2;
/org.eclipse.jdt.ui.tests.refactoring/resources/DeleteSourceReferenceEdit/A_testField4_in.java;1;0;1;1;0;0;0;1;0;0;1;2857;0;0;1;0;0;1;1;2857;0;2857;1;1;
/org.eclipse.ui/Eclipse JFace Text/org/eclipse/jface/text/PropagatingFontFieldEditor.java;2;0;4;1;1;1;1;3;125;1;3;1226;146;146;1;0;0;3;4;1226;0;4838;4;2;
/org.eclipse.swt/Eclipse SWT Printing/motif/org/eclipse/swt/printing/PrintDialog.java;3;1;6;1;3;3;3;3;286;1;3;106;473;473;1;0;0;3;6;106;0;4701;6;3;
/org.eclipse.jdt.debug.ui/ui/org/eclipse/jdt/internal/debug/ui/actions/JavaBreakpointPropertiesDialog.java;3;1;13;1;3;3;3;10;348;2;8;2700;816;816;2;2;0;10;13;2707;2;4450;11;3;
/org.eclipse.jdt.ui/core refactoring/org/eclipse/jdt/internal/corext/refactoring/structure/PullUpMethodRefactoring.java;1;0;4;1;0;0;0;4;48;1;4;2270;67;67;1;0;0;4;4;2270;0;2406;4;1;
/org.eclipse.swt/Eclipse SWT PI/win32/org/eclipse/swt/internal/win32/LOGPEN.java;2;0;2;1;1;1;1;1;6;0;1;2069;6;6;1;0;0;1;2;2069;0;4701;2;2;
/org.eclipse.pde.ui/src/org/eclipse/pde/internal/editor/XMLConfiguration.java;2;0;2;1;0;0;0;2;0;1;2;1434;0;0;1;0;0;2;2;1434;0;3579;2;2;
/org.eclipse.jdt.ui.tests.refactoring/resources/RenameMethodInInterface/test39/in/A.java;1;0;1;1;0;0;0;1;0;0;1;49;0;0;1;0;0;1;1;49;0;49;1;1;
/org.eclipse.jdt.ui/ui refactoring/org/eclipse/jdt/internal/ui/refactoring/actions/InlineTempAction.java;2;0;14;1;1;1;1;13;26;1;13;2015;125;125;1;0;0;13;14;2015;0;3970;14;2;
/org.eclipse.team.webdav/src/org/eclipse/team/internal/webdav/core/WebDavLocation.java;2;2;4;2;4;2;4;0;107;0;0;4113;123;123;2;0;2;0;4;4113;2;4128;2;2;
/org.eclipse.core.runtime/src/org/eclipse/core/runtime/ProgressMonitorWrapper.java;3;0;4;1;1;1;1;3;256;1;3;12;277;277;1;0;0;3;4;12;0;4214;4;3;
/org.eclipse.ui.examples.javaeditor/Eclipse Java Editor Example/org/eclipse/ui/examples/javaeditor/JavaContentOutlinePage.java;1;0;1;1;0;0;0;1;0;0;1;1067;0;0;1;0;0;1;1;1067;0;1067;1;1;
/org.eclipse.jdt.ui.vcm/vcm/org/eclipse/jdt/ui/vcm/TogglePackageViewVersionLabels.java;2;0;2;1;0;0;0;2;0;1;2;419;0;0;1;0;0;2;2;419;0;3627;2;2;
/org.eclipse.jdt.core/notes/r2.0/variable init/ClasspathVariableInitializer.java;1;0;1;1;0;0;0;1;0;0;1;3021;0;0;1;0;0;1;1;3021;0;3021;1;1;
/org.eclipse.jdt.ui/core refactoring/org/eclipse/jdt/internal/core/refactoring/changes/DeleteFileChange.java;2;0;4;1;0;0;0;4;18;1;4;1108;24;24;1;0;0;4;4;1108;0;1939;4;2;
/org.eclipse.swt/Eclipse SWT Custom Widgets/common_j2se/org/eclipse/swt/custom/TextChangingEvent.java;1;0;1;1;0;0;0;1;0;0;1;1378;0;0;1;0;0;1;1;1378;0;1378;1;1;
/org.eclipse.pde.ui/src/org/eclipse/pde/internal/ui/editor/feature/InfoForm.java;1;0;3;1;0;0;0;3;8;2;2;3579;10;10;2;1;0;3;3;3579;1;3591;2;1;
/org.eclipse.jdt.ui.tests.refactoring/resources/RenameParameters/canRename/A_test10_in.java;1;0;1;1;0;0;0;1;0;0;1;233;0;0;1;0;0;1;1;233;0;233;1;1;
/org.eclipse.jdt.ui.tests.refactoring/resources/InlineTemp/canInline/A_test11_out.java;1;0;1;1;0;0;0;1;0;0;1;2758;0;0;1;0;0;1;1;2758;0;2758;1;1;
/org.eclipse.webdav/src/kernel/org/eclipse/webdav/internal/kernel/DAV4JRuntimeException.java;2;0;5;1;1;1;1;4;208;1;4;12;232;232;1;0;0;4;5;12;0;4211;5;2;
/org.eclipse.help.ui/src/org/eclipse/help/internal/ui/HyperlinkAdapter.java;2;0;4;1;1;1;1;3;5;1;3;1420;7;7;1;0;0;3;4;1420;0;4439;4;2;
/org.eclipse.jdt.ui/core refactoring/org/eclipse/jdt/internal/corext/refactoring/Utils.java;2;0;2;1;0;0;0;2;0;1;2;1939;0;0;1;0;0;2;2;1939;0;3185;2;2;
/org.eclipse.jdt.ui/ui/org/eclipse/jdt/internal/ui/actions/OpenBrowserUtil.java;1;0;1;1;1;1;1;0;0;0;0;3967;0;0;1;0;0;0;1;3967;0;3967;1;1;
/org.eclipse.swt.examples.ole.win32/src/org/eclipse/swt/examples/ole/win32/OleBrowserView.java;3;0;4;1;1;1;1;3;363;1;3;513;378;378;1;0;0;3;4;513;0;4705;4;3;
/org.eclipse.jdt.ui.tests.refactoring/resources/RenameVariables/cannotRename/A_testFail10.java;1;0;2;1;0;0;0;2;0;1;2;724;0;0;1;0;0;2;2;724;0;1665;2;1;
/org.eclipse.ui.tests/Eclipse JFace Tests/org/eclipse/jface/tests/viewers/interactive/AddFilterAction.java;1;0;1;1;0;0;0;1;0;0;1;1488;0;0;1;0;0;1;1;1488;0;1488;1;1;
/org.eclipse.jdt.ui.tests.refactoring/resources/RenameType/testIllegalTypeName7/in/A.java;1;0;1;1;0;0;0;1;0;0;1;49;0;0;1;0;0;1;1;49;0;49;1;1;
/org.eclipse.core.tests.resources/src/org/eclipse/core/tests/resources/regression/PR_1GALH44_1Test.java;3;0;4;1;0;0;0;4;10;1;4;1794;14;14;1;0;0;4;4;1794;0;3287;4;3;
/org.eclipse.jdt.ui/ui debug/org/eclipse/jdt/internal/debug/ui/display/InspectAction.java;7;0;13;1;0;0;0;13;20;2;11;345;80;80;2;2;0;13;13;345;2;1916;11;7;
/org.eclipse.help/src/org/eclipse/help/internal/protocols/livehelp/Handler.java;1;0;2;1;0;0;0;2;0;1;2;2683;0;0;1;0;0;2;2;2683;0;2694;2;1;
/org.eclipse.jdt.core/compiler/org/eclipse/jdt/internal/compiler/parser/RecoveredMethod.java;3;1;23;1;5;5;5;18;596;4;15;455;905;905;4;3;0;18;23;1039;3;4187;20;3;
/org.eclipse.jdt.core/model/org/eclipse/jdt/internal/core/util/ClassFileStruct.java;3;2;4;2;3;2;3;1;18;0;1;3629;34;34;2;0;1;1;4;4421;1;4421;3;3;
/org.eclipse.jdt.ui.tests.refactoring/resources/RenameType/test6/out/A.java;1;0;2;1;0;0;0;2;0;1;2;49;0;0;1;0;0;2;2;49;0;522;2;1;
/org.eclipse.pde.core/src/org/eclipse/pde/internal/core/TracingOptionsManager.java;1;0;1;1;0;0;0;1;0;0;1;3591;0;0;1;0;0;1;1;3591;0;3591;1;1;
/org.eclipse.swt.tests/JUnit Tests/org/eclipse/swt/tests/junit/Test_org_eclipse_swt_events_MouseListener.java;2;0;2;1;1;1;1;1;6;0;1;1792;6;6;1;0;0;1;2;1792;0;4706;2;2;
/org.eclipse.jdt.debug.tests/tests/org/eclipse/jdt/debug/tests/eval/generator/NestedTypeTestGenerator.java;2;1;2;1;2;2;2;0;11;0;0;4447;11;11;1;0;0;0;2;4447;0;4454;2;2;
/org.eclipse.update.ui/src/org/eclipse/update/internal/ui/pages/MyComputerPage.java;1;0;2;1;0;0;0;2;3;1;2;3537;3;3;1;0;0;2;2;3537;0;3662;2;1;
/org.eclipse.pde.ui/src/org/eclipse/pde/internal/ui/editor/manifest/ExportSection.java;1;0;2;1;0;0;0;2;2;0;1;3579;2;2;2;1;0;2;2;3579;1;3579;1;1;
/org.eclipse.core.target/src/org/eclipse/core/target/IRemoteResource.java;1;0;4;1;0;0;0;4;15;3;2;666;15;15;3;2;0;4;4;666;2;713;2;1;
/org.eclipse.pde.ui/src/org/eclipse/pde/internal/editor/manifest/MatchSection.java;1;0;10;1;0;0;0;10;598;2;9;2477;640;640;2;1;0;10;10;2951;1;3579;9;1;
/org.eclipse.jdt.ui/ui/org/eclipse/jdt/internal/ui/text/correction/VariousEvaluations.java;2;0;3;2;0;0;0;3;2;2;2;3531;2;2;2;1;0;3;3;3569;1;3569;2;2;
/org.eclipse.jdt.ui/ui/org/eclipse/jdt/internal/ui/typehierarchy/TypeHierarchyViewer.java;7;2;31;2;8;7;8;23;111;2;21;15;446;446;2;2;1;23;31;866;3;4361;28;7;
/org.eclipse.core.target/src/org/eclipse/core/internal/target/webdav/PushPullTarget.java;2;0;9;1;1;1;1;8;1070;1;8;12;1551;1551;1;0;0;8;9;12;0;4196;9;2;
/org.eclipse.update/src/org/eclipse/update/internal/ui/UMDialogAction.java;1;0;1;1;0;0;0;1;0;0;1;1424;0;0;1;0;0;1;1;1424;0;1424;1;1;
/org.eclipse.ant.core/src/antlib/org/eclipse/ant/internal/core/ant/CommaPatternSet.java;1;0;1;1;0;0;0;1;0;0;1;3475;0;0;1;0;0;1;1;3475;0;3475;1;1;
/org.eclipse.ui.tests/Eclipse UI Tests/org/eclipse/ui/tests/api/IPageListenerTest.java;3;0;9;1;0;0;0;9;22;2;8;882;62;62;2;1;0;9;9;882;1;3068;8;3;
/org.eclipse.jdt.ui.tests.refactoring/resources/ReorderParameters/canReorder/A_test19_out.java;1;0;1;1;0;0;0;1;0;0;1;2406;0;0;1;0;0;1;1;2406;0;2406;1;1;
/org.eclipse.jdt.ui.tests.refactoring/resources/RenameVariables/canRename/A_test4_in.java;1;0;2;1;0;0;0;2;0;1;2;724;0;0;1;0;0;2;2;724;0;1665;2;1;
/org.eclipse.jdt.debug/eval/org/eclipse/jdt/internal/debug/eval/ast/instructions/MultiplyOperator.java;3;0;6;1;0;0;0;6;36;1;6;3421;48;48;1;0;0;6;6;3421;0;3677;6;3;
/org.eclipse.jdt.ui.tests.refactoring/resources/ExtractTemp/canExtract/A_test18_in.java;1;0;1;1;0;0;0;1;0;0;1;2481;0;0;1;0;0;1;1;2481;0;2481;1;1;
/org.eclipse.pde.ui/src/org/eclipse/pde/internal/builders/AbstractParser.java;1;0;3;1;0;0;0;3;75;1;3;2702;75;75;1;0;0;3;3;2702;0;2730;3;1;
/org.eclipse.team.cvs.ui/src/org/eclipse/team/internal/ccvs/ui/actions/MergeAction.java;2;0;4;1;1;1;1;3;24;1;3;2641;35;35;1;0;0;3;4;2641;0;3952;4;2;
/org.eclipse.jdt.ui/core refactoring/org/eclipse/jdt/internal/corext/refactoring/SearchResultGroup.java;2;0;3;1;0;0;0;3;11;1;3;1939;20;20;1;0;0;3;3;1939;0;3825;3;2;
/org.eclipse.pde.ui/src/org/eclipse/pde/internal/ui/editor/manifest/RuntimeSection.java;1;0;2;1;0;0;0;2;15;0;1;3579;15;15;2;1;0;2;2;3579;1;3579;1;1;
/org.eclipse.scripting/Eclipse Scripting/org/eclipse/scripting/internal/views/ScriptUIEditorAction.java;2;0;4;1;0;0;0;4;13;1;4;133;20;20;1;0;0;4;4;133;0;1424;4;2;
/org.eclipse.scripting/Eclipse Scripting/org/eclipse/scripting/internal/IXGRDataNode.java;1;0;3;1;0;0;0;3;4;1;3;133;4;4;1;0;0;3;3;133;0;1424;3;1;
/org.eclipse.pde.ui/src/org/eclipse/pde/internal/PDEPerspective.java;2;0;8;1;0;0;0;8;17;1;8;1434;27;27;1;0;0;8;8;1434;0;3579;8;2;
/org.eclipse.jdt.debug/jdi interfaces/com/sun/jdi/ThreadGroupReference.java;2;0;2;1;0;0;0;2;12;1;2;2704;12;12;1;0;0;2;2;2704;0;3033;2;2;
/org.eclipse.pde.ui/src/org/eclipse/pde/internal/wizards/templates/AbstractNewPluginTemplateWizard.java;1;0;2;1;0;0;0;2;0;1;2;3442;0;0;1;0;0;2;2;3442;0;3579;2;1;
/org.eclipse.pde.ui/src/org/eclipse/pde/internal/launcher/TracingLauncherTab.java;1;0;5;1;0;0;0;5;102;1;5;3121;106;106;1;0;0;5;5;3121;0;3579;5;1;
/org.eclipse.jdt.core/model/org/eclipse/jdt/internal/core/builder/impl/FieldCollaboratorIndictment.java;1;0;10;1;0;0;0;10;34;4;7;455;57;57;4;3;0;10;10;1039;3;2808;7;1;
/org.eclipse.core.resources/src/org/eclipse/core/internal/dtree/IComparator.java;1;0;4;1;1;1;1;3;46;1;3;12;67;67;1;0;0;3;4;12;0;4214;4;1;
/org.eclipse.jdt.debug/model/org/eclipse/jdt/internal/debug/core/hcr/JavaParseTreeBuilder.java;2;0;2;1;0;0;0;2;8;1;2;2585;8;8;1;0;0;2;2;2585;0;2683;2;2;
/org.eclipse.jdt.ui/ui/org/eclipse/jdt/internal/ui/search/GroupByKeyComputer.java;2;0;10;1;1;1;1;9;21;2;8;15;65;65;2;1;0;9;10;3760;1;4627;9;2;
/org.eclipse.pde.ui/src/org/eclipse/pde/internal/util/Choice.java;1;0;2;1;0;0;0;2;0;1;2;3103;0;0;1;0;0;2;2;3103;0;3579;2;1;
/org.eclipse.jdt.ui/ui/org/eclipse/jdt/internal/ui/snippeteditor/SnippetOpenHierarchyOnSelectionAction.java;5;0;5;1;0;0;0;5;37;1;5;1133;54;54;1;0;0;5;5;1133;0;1916;5;5;
/org.eclipse.team.cvs.core/src/org/eclipse/team/internal/ccvs/core/resources/api/ICVSResource.java;3;0;3;1;0;0;0;3;162;1;3;1978;162;162;1;0;0;3;3;1978;0;2156;3;3;
/org.eclipse.jdt.ui.tests.refactoring/resources/ExtractTemp/canExtract/A_test20_in.java;1;0;1;1;0;0;0;1;0;0;1;2498;0;0;1;0;0;1;1;2498;0;2498;1;1;
/org.eclipse.jdt.ui.tests.refactoring/resources/SelectionAnalyzerWorkSpace/SelectionAnalyzerTests/validSelection/A_test106_.java;2;0;2;1;0;0;0;2;0;1;2;2139;0;0;1;0;0;2;2;2139;0;2327;2;2;
/org.eclipse.jdt.ui/ui/org/eclipse/jdt/internal/ui/wizards/buildpaths/SourceAttachmentBlock.java;5;0;49;3;1;1;1;48;380;4;41;15;1999;1999;4;7;0;48;49;1254;7;4143;42;5;
/org.eclipse.jdt.ui.tests.refactoring/resources/PullUpMethods/test12/in/B.java;1;0;2;1;0;0;0;2;0;1;2;2212;0;0;1;0;0;2;2;2212;0;2406;2;1;
/org.eclipse.ui/Eclipse UI Tool Script/org/eclipse/toolscript/ui/internal/OutputStructureElement.java;1;1;2;1;2;2;2;0;0;0;0;4065;0;0;1;0;0;0;2;4065;0;4087;2;1;
/org.eclipse.pde.ui/src/org/eclipse/pde/internal/ui/editor/feature/RequiresSection.java;1;1;7;1;3;3;3;4;92;2;3;3579;149;149;2;1;0;4;7;3579;1;4592;6;1;
/org.eclipse.jdt.ui/core extension/org/eclipse/jdt/internal/corext/codegeneration/AddUnimplementedMethodsOperation.java;2;0;3;1;0;0;0;3;3;2;2;2016;3;3;2;1;0;3;3;2016;1;2137;2;2;
/org.eclipse.ant.core/src/plugin/org/eclipse/ant/core/AntCorePlugin.java;1;0;1;1;0;0;0;1;0;0;1;3475;0;0;1;0;0;1;1;3475;0;3475;1;1;
/org.eclipse.pde.ui/src/org/eclipse/pde/internal/ui/editor/manifest/NewElementAction.java;1;0;2;1;0;0;0;2;2;1;2;3579;2;2;1;0;0;2;2;3579;0;3591;2;1;
/org.eclipse.scripting/src/org/eclipse/scripting/internal/uirenderer/XGRElementUISwtScriptPreferencePage.java;1;0;1;1;0;0;0;1;0;0;1;1424;0;0;1;0;0;1;1;1424;0;1424;1;1;
/org.eclipse.jdt.ui/ui/org/eclipse/jdt/internal/ui/actions/GenerateGroup.java;4;1;7;1;2;2;2;5;20;1;5;15;40;40;1;0;0;5;7;15;0;3968;7;4;
/org.eclipse.jdt.ui/ui refactoring/org/eclipse/jdt/internal/ui/refactoring/actions/SelfEncapsulateFieldActionDelegate.java;3;0;5;1;0;0;0;5;7;1;5;1462;9;9;1;0;0;5;5;1462;0;3792;5;3;
/org.eclipse.core.tests.resources/src/org/eclipse/core/tests/internal/indexing/BasicObjectStoreTest.java;3;0;4;1;1;1;1;3;446;1;3;1794;458;458;1;0;0;3;4;1794;0;4516;4;3;
/org.eclipse.pde.ui/src/org/eclipse/pde/internal/editor/schema/ElementPropertySource.java;2;0;3;1;0;0;0;3;4;1;3;1434;4;4;1;0;0;3;3;1434;0;3579;3;2;
/org.eclipse.pde.ui/src/org/eclipse/pde/ui/templates/StringOption.java;1;0;2;1;1;1;1;1;51;0;1;3840;51;51;1;0;0;1;2;3840;0;4752;2;1;
/org.eclipse.update.ui.forms/src/org/eclipse/update/ui/forms/internal/FormEntry.java;1;0;2;1;0;0;0;2;4;0;1;2470;4;4;2;1;0;2;2;2470;1;2470;1;1;
/org.eclipse.ui/Eclipse UI/org/eclipse/ui/internal/WWinPluginPulldown.java;5;0;6;1;0;0;0;6;33;1;6;257;55;55;1;0;0;6;6;257;0;3840;6;5;
/org.eclipse.pde.ui/src/org/eclipse/pde/internal/model/NLResourceHelper.java;2;0;4;1;0;0;0;4;150;1;4;1434;187;187;1;0;0;4;4;1434;0;3579;4;2;
/org.eclipse.help.ui/src/org/eclipse/help/ui/internal/search/SearchFilteringOptions.java;2;0;6;1;1;1;1;5;166;2;4;2429;180;180;2;1;0;5;6;3074;1;4439;5;2;
/org.eclipse.jdt.ui.tests.refactoring/resources/ExtractTemp/cannotExtract/A_testFail8.java;1;0;1;1;0;0;0;1;0;0;1;2873;0;0;1;0;0;1;1;2873;0;2873;1;1;
/org.eclipse.jdt.ui.tests.refactoring/resources/RenameParameters/canRename/A_test3_in.java;1;0;1;1;0;0;0;1;0;0;1;233;0;0;1;0;0;1;1;233;0;233;1;1;
/org.eclipse.jdt.ui.tests.refactoring/resources/RenameNonPrivateField/test0/out/A.java;1;0;1;1;0;0;0;1;0;0;1;49;0;0;1;0;0;1;1;49;0;49;1;1;
/org.eclipse.jdt.ui.tests.refactoring/resources/RenameVirtualMethodInClass/test12/in/A.java;1;0;1;1;0;0;0;1;0;0;1;49;0;0;1;0;0;1;1;49;0;49;1;1;
/org.eclipse.swt/Eclipse SWT/common/org/eclipse/swt/widgets/EventTable.java;6;0;11;1;1;1;1;10;94;3;8;106;254;254;3;2;0;10;11;2269;2;4701;9;6;
/org.eclipse.core.tests.runtime/src/org/eclipse/core/tests/internal/runtimetests/SampleA.java;1;0;3;1;0;0;0;3;10;2;2;3605;13;13;2;1;0;3;3;3605;1;3678;2;1;
/org.eclipse.core.tests.runtime/src/org/eclipse/core/tests/internal/plugins/ConflictResolveTest_5.java;3;0;3;1;0;0;0;3;134;1;3;1794;144;144;1;0;0;3;3;1794;0;3476;3;3;
/org.eclipse.team.cvs.ui/src/org/eclipse/team/internal/ccvs/ui/model/CVSRemoteFolderPropertySource.java;2;0;3;1;0;0;0;3;10;1;3;3053;14;14;1;0;0;3;3;3053;0;3644;3;2;
/org.eclipse.swt.examples.paint/org/eclipse/swt/examples/paint/BasicPaintSession.java;3;0;3;1;1;1;1;2;10;1;2;513;10;10;1;0;0;2;3;513;0;4024;3;3;
/org.eclipse.jdt.ui/core refactoring/org/eclipse/jdt/internal/corext/refactoring/nls/changes/CreateFileChange.java;2;1;5;1;2;2;2;3;23;1;3;1939;50;50;1;0;0;3;5;1939;0;4598;5;2;
/org.eclipse.ui/Eclipse JFace Text/org/eclipse/jface/text/source/IAnnotationModelListener.java;2;0;2;1;0;0;0;2;5;1;2;257;5;5;1;0;0;2;2;257;0;457;2;2;
/org.eclipse.jdt.debug.ui/ui/org/eclipse/jdt/internal/debug/ui/snippeteditor/ScrapbookEventFilter.java;2;0;3;1;0;0;0;3;2;1;3;1915;2;2;1;0;0;3;3;1915;0;3492;3;2;
/org.eclipse.core.tests.runtime/src/org/eclipse/core/tests/runtime/PathTest.java;3;0;8;1;0;0;0;8;1290;1;8;1794;1384;1384;1;0;0;8;8;1794;0;3476;8;3;
/org.eclipse.pde.ui/templates/preferences/java/$pageClassName$.java;1;0;1;1;0;0;0;1;0;0;1;3442;0;0;1;0;0;1;1;3442;0;3442;1;1;
/org.eclipse.ant.core/src/org/eclipse/ant/internal/core/old/AntPlugin.java;1;0;1;1;0;0;0;1;0;0;1;3270;0;0;1;0;0;1;1;3270;0;3270;1;1;
/org.eclipse.team.cvs.core/src/org/eclipse/team/internal/ccvs/core/client/Version.java;1;1;6;1;2;2;2;4;39;2;3;3816;93;93;2;1;0;4;6;3816;1;4169;5;1;
/org.eclipse.team.tests.cvs.core/src/org/eclipse/team/tests/ccvs/ui/EclipseUITestHarnessApplication.java;1;0;2;1;0;0;0;2;58;1;2;2977;58;58;1;0;0;2;2;2977;0;3068;2;1;
/org.eclipse.jdt.ui.tests.refactoring/resources/ExtractMethodWorkSpace/ExtractMethodTests/locals_out/A_test561.java;1;1;4;1;2;2;2;2;34;1;2;1236;36;36;1;0;0;2;4;1236;0;4419;4;1;
/org.eclipse.pde.ui/src/org/eclipse/pde/internal/ui/editor/manifest/AlertSection.java;1;0;5;1;1;1;1;4;26;2;3;3579;35;35;2;1;0;4;5;3579;1;3914;4;1;
/org.eclipse.jdt.debug.ui/ui/org/eclipse/jdt/internal/debug/ui/actions/JavaBreakpointPropertiesRulerAction.java;1;0;2;1;0;0;0;2;2;1;2;3573;2;2;1;0;0;2;2;3573;0;3676;2;1;
/org.eclipse.webdav/src/kernel/org/eclipse/webdav/internal/kernel/WebDAVConstants.java;1;1;5;1;2;2;2;3;24;1;3;12;48;48;1;0;0;3;5;12;0;4228;5;1;
/org.eclipse.team.webdav/src/org/eclipse/team/internal/webdav/core/WebDavSiteFactory.java;3;1;4;1;4;4;4;0;37;0;0;4132;51;51;1;0;0;0;4;4132;0;4636;4;3;
/org.eclipse.help.ui/src/org/eclipse/help/ui/internal/browser/aix/NetscapeBrowserAdapter.java;2;0;3;1;1;1;1;2;13;1;2;2429;15;15;1;0;0;2;3;2429;0;4439;3;2;
/org.eclipse.pde.ui/Eclipse PDE UI/org/eclipse/pde/internal/model/WorkspaceFragmentModel.java;2;0;5;2;0;0;0;5;12;3;3;267;12;12;3;2;0;5;5;324;2;1434;3;2;
/org.eclipse.pde.core/src/org/eclipse/pde/internal/core/IModelProviderListener.java;1;0;1;1;0;0;0;1;0;0;1;3591;0;0;1;0;0;1;1;3591;0;3591;1;1;
/org.eclipse.pde.ui/src/org/eclipse/pde/internal/core/plugin/IdentifiablePluginObject.java;1;0;3;1;0;0;0;3;3;2;2;3579;3;3;2;1;0;3;3;3579;1;3607;2;1;
/org.eclipse.core.resources/src/org/eclipse/core/internal/localstore/CollectSyncStatusVisitor.java;2;0;5;1;1;1;1;4;64;1;4;3270;82;82;1;0;0;4;5;3270;0;4214;5;2;
/org.eclipse.jdt.ui/ui/org/eclipse/jdt/internal/ui/workingsets/JavaWorkingSetPageContentProvider.java;2;0;2;1;1;1;1;1;4;0;1;3834;4;4;1;0;0;1;2;3834;0;4466;2;2;
/org.eclipse.jdt.core/dom/org/eclipse/jdt/core/dom/CompilationUnit.java;3;2;17;1;5;4;5;12;42;2;11;2669;179;179;2;1;1;12;17;3410;2;4453;15;3;
/org.eclipse.jdt.debug.tests/tests/org/eclipse/jdt/debug/tests/eval/LocalVarValueTests.java;2;2;3;2;3;2;3;0;17;0;0;4447;19;19;2;0;1;0;3;4447;1;4571;2;2;
/org.eclipse.jdt.ui/ui/org/eclipse/jdt/internal/ui/typehierarchy/ToggleViewAction.java;2;0;7;1;0;0;0;7;32;1;7;15;100;100;1;0;0;7;7;15;0;3050;7;2;
/org.eclipse.pde.ui/src/org/eclipse/pde/internal/core/schema/AbstractSchemaDescriptor.java;1;0;3;1;0;0;0;3;2;1;3;3579;2;2;1;0;0;3;3;3579;0;3607;3;1;
/org.eclipse.jdt.debug/eval/org/eclipse/jdt/internal/debug/eval/ast/instructions/PushType.java;3;0;6;1;1;1;1;5;14;1;5;3421;26;26;1;0;0;5;6;3421;0;4423;6;3;
/org.eclipse.jdt.ui.tests.refactoring/resources/ExtractMethodWorkSpace/ExtractMethodTests/return_out/A_test726.java;1;1;4;1;2;2;2;2;52;1;2;2684;54;54;1;0;0;2;4;2684;0;4419;4;1;
/org.eclipse.ant.ui/src/org/eclipse/ant/ui/internal/toolscripts/ChooseToolScriptPage.java;1;0;2;1;0;0;0;2;0;1;2;2919;0;0;1;0;0;2;2;2919;0;2933;2;1;
/org.eclipse.jdt.ui.tests.refactoring/resources/RenameMethodInInterface/test26/out/A.java;1;0;1;1;0;0;0;1;0;0;1;49;0;0;1;0;0;1;1;49;0;49;1;1;
/org.eclipse.pde.ui/Eclipse PDE UI/org/eclipse/pde/internal/editor/manifest/ManifestEditorContributor.java;2;0;5;2;0;0;0;5;12;3;3;267;12;12;3;2;0;5;5;324;2;1434;3;2;
/org.eclipse.jdt.ui.tests.refactoring/resources/DeleteSourceReference/test7/out/A.java;1;0;1;1;0;0;0;1;0;0;1;2857;0;0;1;0;0;1;1;2857;0;2857;1;1;
/org.eclipse.update.ui/src/org/eclipse/update/internal/ui/manager/SearchResultSection.java;3;0;18;1;0;0;0;18;251;2;16;2224;529;529;2;2;0;18;18;2434;2;3657;16;3;
/org.eclipse.ui/Eclipse UI/org/eclipse/ui/IWorkbenchPartSite.java;5;0;7;1;0;0;0;7;39;2;6;257;107;107;2;1;0;7;7;2548;1;3633;6;5;
/org.eclipse.jdt.core/model/org/eclipse/jdt/internal/core/builder/impl/ModifiedBuilderType.java;1;0;10;1;0;0;0;10;444;4;6;455;462;462;4;4;0;10;10;1039;4;2808;6;1;
/org.eclipse.scripting/src/org/eclipse/scripting/internal/ScriptPlugin.java;1;0;1;1;0;0;0;1;0;0;1;1424;0;0;1;0;0;1;1;1424;0;1424;1;1;
/org.eclipse.jdt.ui/core refactoring/org/eclipse/jdt/internal/core/refactoring/code/flow/ConditionalFlowInfo.java;1;0;2;1;0;0;0;2;0;1;2;1236;0;0;1;0;0;2;2;1236;0;1939;2;1;
/org.eclipse.jdt.ui.tests.refactoring/resources/ExtractMethodWorkSpace/ExtractMethodTests/semicolon_out/A_test404.java;2;1;6;1;2;2;2;4;20;1;4;80;33;33;1;0;0;4;6;80;0;4419;6;2;
/org.eclipse.ui/Eclipse UI/org/eclipse/ui/internal/misc/Sorter.java;2;0;2;1;0;0;0;2;5;1;2;257;5;5;1;0;0;2;2;257;0;457;2;2;
/org.eclipse.jdt.ui/ui/org/eclipse/jdt/internal/ui/preferences/JavadocConfigurationBlock.java;4;2;9;2;8;7;8;1;27;0;1;3850;71;71;2;0;1;1;9;4562;1;4621;8;4;
/org.eclipse.jdt.core/model/org/eclipse/jdt/internal/core/builder/impl/ImageContextImpl.java;1;0;9;1;0;0;0;9;34;4;6;455;70;70;4;3;0;9;9;1039;3;2808;6;1;
/org.eclipse.jdt.core/compiler/org/eclipse/jdt/internal/compiler/ast/CompoundAssignment.java;2;1;14;1;2;2;2;12;244;4;9;455;585;585;4;3;0;12;14;1039;3;4421;11;2;
/org.eclipse.jdt.debug/eval/org/eclipse/jdt/internal/debug/eval/ast/instructions/SendStaticMessage.java;3;1;10;1;3;3;3;7;23;1;7;3421;57;57;1;0;0;7;10;3421;0;4423;10;3;
/org.eclipse.jdt.ui.tests.refactoring/resources/RenameVirtualMethodInClass/test13/out/A.java;1;0;1;1;0;0;0;1;0;0;1;49;0;0;1;0;0;1;1;49;0;49;1;1;
/org.eclipse.ui/Eclipse UI Standard Components/org/eclipse/ui/views/navigator/MainActionGroup.java;2;1;2;1;2;2;2;0;5;0;0;4067;5;5;1;0;0;0;2;4067;0;4261;2;2;
/org.eclipse.team.cvs.core/src/org/eclipse/team/internal/ccvs/core/client/Request.java;2;1;9;1;2;2;2;7;26;2;6;3452;63;63;2;1;0;7;9;3530;1;4769;8;2;
/org.eclipse.core.tests.harness/src/org/eclipse/core/tests/harness/EclipseTestHarnessApplication.java;3;1;5;1;2;2;2;3;288;1;3;1794;321;321;1;0;0;3;5;1794;0;4687;5;3;
/org.eclipse.ui/Eclipse JFace Text/org/eclipse/jface/text/TextHoveringController.java;4;0;7;1;0;0;0;7;69;1;7;257;200;200;1;0;0;7;7;257;0;1435;7;4;
/org.eclipse.vcm.core.cvs/src/org/eclipse/vcm/internal/core/ccvs/utils/DateUtil.java;2;0;3;1;0;0;0;3;15;2;2;101;15;15;2;1;0;3;3;292;1;292;2;2;
/org.eclipse.debug.ui/ui/org/eclipse/debug/internal/ui/views/expression/ExpressionViewEventHandler.java;1;1;3;1;3;3;3;0;194;0;0;3975;201;201;1;0;0;0;3;3975;0;4404;3;1;
/org.eclipse.jdt.core/compiler/org/eclipse/jdt/internal/compiler/lookup/ProblemFieldBinding.java;2;0;4;1;1;1;1;3;33;1;3;455;56;56;1;0;0;3;4;455;0;4062;4;2;
/org.eclipse.jdt.core/search/org/eclipse/jdt/internal/core/index/impl/IFileDocument.java;2;1;13;1;3;3;3;10;38;4;7;455;102;102;4;3;0;10;13;1039;3;4421;10;2;
/org.eclipse.jdt.core/model/org/eclipse/jdt/internal/core/IJavaElementRequestor.java;2;0;3;1;1;1;1;2;22;1;2;455;44;44;1;0;0;2;3;455;0;4063;3;2;
/org.eclipse.pde.ui/Eclipse PDE UI/org/eclipse/pde/internal/model/PluginExtension.java;2;0;7;2;0;0;0;7;12;3;5;267;16;16;3;2;0;7;7;324;2;1434;5;2;
/org.eclipse.swt.examples.controls/src/org/eclipse/swt/examples/controls/ToolBarTab.java;2;0;2;1;0;0;0;2;0;1;2;391;0;0;1;0;0;2;2;391;0;611;2;2;
/org.eclipse.jdt.ui/ui/org/eclipse/jdt/internal/ui/typehierarchy/ToggleOrientationAction.java;3;0;7;1;1;1;1;6;54;1;6;857;89;89;1;0;0;6;7;857;0;4630;7;3;
/org.eclipse.jdt.core/search/org/eclipse/jdt/internal/core/search/matching/OrPattern.java;3;0;15;1;1;1;1;14;378;4;10;455;659;659;4;4;0;14;15;1039;4;4063;11;3;
/org.eclipse.jdt.debug/jdi/org/eclipse/jdi/internal/IntegerTypeImpl.java;2;0;4;1;0;0;0;4;13;1;4;187;27;27;1;0;0;4;4;187;0;3670;4;2;
/org.eclipse.jdt.ui.tests.refactoring/resources/RenameType/test4/out/A.java;1;0;2;1;0;0;0;2;0;1;2;49;0;0;1;0;0;2;2;49;0;522;2;1;
/org.eclipse.swt/Eclipse SWT/common/org/eclipse/swt/events/MouseListener.java;4;0;5;1;1;1;1;4;6;1;4;106;20;20;1;0;0;4;5;106;0;4701;5;4;
/org.eclipse.jdt.ui/ui refactoring/org/eclipse/jdt/internal/ui/refactoring/actions/RenameTempAction.java;3;1;25;2;5;5;5;20;48;3;17;1665;226;226;3;3;0;20;25;1665;3;4563;22;3;
/org.eclipse.jdt.ui.tests.refactoring/resources/MoveMembers/test18/out/B.java;1;0;2;1;0;0;0;2;3;1;2;2738;3;3;1;0;0;2;2;2738;0;3188;2;1;
/org.eclipse.pde.ui/src/org/eclipse/pde/core/build/IBuildModelFactory.java;1;0;2;1;0;0;0;2;0;1;2;3579;0;0;1;0;0;2;2;3579;0;3607;2;1;
/org.eclipse.jdt.ui.tests.refactoring/resources/RenameStaticMethod/test2/in/A.java;1;0;1;1;0;0;0;1;0;0;1;49;0;0;1;0;0;1;1;49;0;49;1;1;
/org.eclipse.jdt.ui/ui/org/eclipse/jdt/internal/ui/search/IJavaSearchUIConstants.java;2;0;6;1;1;1;1;5;8;1;5;15;19;19;1;0;0;5;6;15;0;4148;6;2;
/org.eclipse.ui/Eclipse UI/org/eclipse/ui/internal/CTabPartDragDrop.java;2;0;3;1;0;0;0;3;11;1;3;257;16;16;1;0;0;3;3;257;0;1302;3;2;
/org.eclipse.core.resources/src/org/eclipse/core/resources/IFolder.java;2;0;8;1;1;1;1;7;490;1;7;12;636;636;1;0;0;7;8;12;0;4214;8;2;
/org.eclipse.swt/Eclipse SWT PI/win32/org/eclipse/swt/internal/win32/TBBUTTON.java;2;0;2;1;1;1;1;1;6;0;1;2069;6;6;1;0;0;1;2;2069;0;4701;2;2;
/org.eclipse.jdt.debug/eval/org/eclipse/jdt/internal/debug/eval/ast/instructions/PushThis.java;3;0;7;1;0;0;0;7;16;1;7;3421;41;41;1;0;0;7;7;3421;0;3833;7;3;
/org.eclipse.help/src/org/eclipse/help/internal/context/ContextsBuilder.java;1;0;2;1;0;0;0;2;15;1;2;2829;15;15;1;0;0;2;2;2829;0;3075;2;1;
/org.eclipse.jdt.ui/ui/org/eclipse/jdt/internal/ui/javadocexport/JavadocProjectContentProvider.java;4;1;8;1;4;4;4;4;17;1;4;2878;42;42;1;0;0;4;8;2878;0;4621;8;4;
/org.eclipse.jdt.core/model/org/eclipse/jdt/internal/core/hierarchy/HierarchyResolver.java;3;1;5;1;2;2;2;3;51;1;3;2790;80;80;1;0;0;3;5;2790;0;4165;5;3;
/org.eclipse.help/webapps/examples/WEB-INF/classes/examples/ShowSource.java;1;0;2;1;0;0;0;2;0;1;2;1882;0;0;1;0;0;2;2;1882;0;1930;2;1;
/org.eclipse.core.target/src/org/eclipse/core/internal/target/RemoteResource.java;1;0;3;1;0;0;0;3;25;2;2;668;25;25;2;1;0;3;3;668;1;713;2;1;
/org.eclipse.jdt.ui/core refactoring/org/eclipse/jdt/internal/corext/refactoring/nls/NLSUtil.java;2;1;3;1;2;2;2;1;2;0;1;2769;4;4;1;0;0;1;3;2769;0;4643;3;2;
/org.eclipse.search/search/org/eclipse/search/internal/ui/SearchDropDownAction.java;2;0;7;1;1;1;1;6;10;1;6;15;30;30;1;0;0;6;7;15;0;4619;7;2;
/org.eclipse.jdt.ui.tests.refactoring/resources/InlineTemp/canInline/A_test20_out.java;1;0;1;1;1;1;1;0;0;0;0;4165;0;0;1;0;0;0;1;4165;0;4165;1;1;
/org.eclipse.jdt.ui.tests.refactoring/resources/RenameType/testFail87/in/A.java;1;0;1;1;0;0;0;1;0;0;1;49;0;0;1;0;0;1;1;49;0;49;1;1;
/org.eclipse.jdt.ui/ui/org/eclipse/jdt/internal/ui/text/correction/UnknownTypeEvaluator.java;2;0;8;1;0;0;0;8;82;2;6;3309;138;138;2;2;0;8;8;3430;2;3528;6;2;
/org.eclipse.ui/Eclipse JFace/org/eclipse/jface/viewers/ITableLabelProvider.java;2;0;2;1;0;0;0;2;5;1;2;257;5;5;1;0;0;2;2;257;0;457;2;2;
/org.eclipse.jdt.ui.tests.refactoring/resources/RenameVirtualMethodInClass/test31/out/A.java;1;0;1;1;0;0;0;1;0;0;1;49;0;0;1;0;0;1;1;49;0;49;1;1;
/org.eclipse.jdt.debug/jdi/org/eclipse/jdi/Bootstrap.java;3;0;6;1;0;0;0;6;25;2;5;187;42;42;2;1;0;6;6;2720;1;3667;5;3;
/org.eclipse.jdt.ui/core refactoring/org/eclipse/jdt/core/refactoring/packages/RenamePackageChange.java;1;0;4;1;0;0;0;4;22;1;4;15;27;27;1;0;0;4;4;15;0;408;4;1;
/org.eclipse.pde.ui/src/org/eclipse/pde/internal/feature/BuildFeatureJarAction.java;1;0;2;1;0;0;0;2;0;1;2;3031;0;0;1;0;0;2;2;3031;0;3113;2;1;
/org.eclipse.jdt.ui.tests.refactoring/resources/RenamePackage/testFail4/in/p/A.java;2;0;2;1;0;0;0;2;0;1;2;49;0;0;1;0;0;2;2;49;0;1258;2;2;
/org.eclipse.pde.ui/Eclipse PDE UI/org/eclipse/pde/internal/editor/text/TagRule.java;2;0;5;2;0;0;0;5;12;3;3;267;12;12;3;2;0;5;5;324;2;1434;3;2;
/org.eclipse.pde.ui/src/org/eclipse/pde/internal/editor/manifest/ManifestFormOutlinePage.java;2;0;8;1;0;0;0;8;311;2;6;1434;333;333;2;2;0;8;8;3035;2;3579;6;2;
/org.eclipse.pde.ui/src/org/eclipse/pde/internal/TracingOptionsManager.java;2;0;6;1;0;0;0;6;293;1;6;1434;315;315;1;0;0;6;6;1434;0;3579;6;2;
/org.eclipse.team.ui/src/org/eclipse/team/internal/ui/sync/MergeAction.java;1;0;2;1;0;0;0;2;0;1;2;2054;0;0;1;0;0;2;2;2054;0;2231;2;1;
/org.eclipse.jdt.ui.tests.refactoring/resources/SurroundWithWorkSpace/SurroundWithTests/trycatch_out/TestWrappedLocal6.java;1;0;1;1;0;0;0;1;0;0;1;3870;0;0;1;0;0;1;1;3870;0;3870;1;1;
/org.eclipse.jdt.ui/ui/org/eclipse/jdt/internal/ui/javaeditor/PaintManager.java;1;0;5;1;1;1;1;4;21;1;4;3087;44;44;1;0;0;4;5;3087;0;4423;5;1;
/org.eclipse.jdt.junit/Eclipse JUnit/org/eclipse/jdt/internal/junit/ui/OpenEditorAtLineAction.java;2;0;2;1;0;0;0;2;0;1;2;2399;0;0;1;0;0;2;2;2399;0;3313;2;2;
/org.eclipse.swt/Eclipse SWT/win32/org/eclipse/swt/internal/win32/PAINTSTRUCT.java;2;0;3;1;0;0;0;3;5;1;3;106;5;5;1;0;0;3;3;106;0;2069;3;2;
/org.eclipse.swt.examples.launcher/src/org/eclipse/swt/examples/launcher/SplitLayout.java;3;0;3;1;1;1;1;2;12;1;2;581;17;17;1;0;0;2;3;581;0;4705;3;3;
/org.eclipse.jdt.ui/ui/org/eclipse/jdt/internal/ui/snippeteditor/RunInPackageAction.java;5;0;10;1;0;0;0;10;17;1;10;15;75;75;1;0;0;10;10;15;0;1916;10;5;
/org.eclipse.vcm.ui/src/org/eclipse/vcm/internal/ui/syncdialog/CatchupAction.java;2;0;2;1;0;0;0;2;0;1;2;1;0;0;1;0;0;2;2;1;0;68;2;2;
/org.eclipse.jdt.launching/launching/org/eclipse/jdt/launching/AbstractVMInstallType.java;1;1;7;1;6;6;6;1;8;0;1;2022;26;26;1;0;0;1;7;2022;0;4651;7;1;
/org.eclipse.pde.core/src/org/eclipse/pde/internal/core/schema/SchemaType.java;1;0;2;1;0;0;0;2;2;1;2;3591;2;2;1;0;0;2;2;3591;0;3607;2;1;
/org.eclipse.core.tests.resources/src/org/eclipse/core/tests/resources/perf/BenchWorkspace.java;3;0;3;1;0;0;0;3;256;1;3;1794;266;266;1;0;0;3;3;1794;0;3420;3;3;
/org.eclipse.jdt.ui.tests.refactoring/resources/RenameVirtualMethodInClass/test28/out/A.java;1;0;1;1;0;0;0;1;0;0;1;49;0;0;1;0;0;1;1;49;0;49;1;1;
/org.eclipse.ui/Eclipse UI/org/eclipse/ui/dialogs/ResourceSelectionDialog.java;5;0;5;1;0;0;0;5;30;1;5;257;52;52;1;0;0;5;5;257;0;3490;5;5;
/org.eclipse.jdt.ui/core refactoring/org/eclipse/jdt/internal/corext/refactoring/nls/NLSSubstitution.java;1;0;1;1;0;0;0;1;0;0;1;1939;0;0;1;0;0;1;1;1939;0;1939;1;1;
/org.eclipse.pde.ui/Eclipse PDE UI/org/eclipse/pde/internal/model/ExternalPluginModelBase.java;2;0;5;2;0;0;0;5;12;3;3;267;12;12;3;2;0;5;5;324;2;1434;3;2;
/org.eclipse.vcm.ui/src/org/eclipse/vcm/internal/ui/WorkbenchVCMException.java;2;0;2;1;0;0;0;2;5;1;2;1;5;5;1;0;0;2;2;1;0;298;2;2;
/org.eclipse.swt/Eclipse SWT/emulated/treetable/org/eclipse/swt/widgets/Header.java;5;1;7;1;3;3;3;4;673;1;4;1087;687;687;1;0;0;4;7;1087;0;4701;7;5;
/org.eclipse.swt.tests/JUnit Tests/org/eclipse/swt/tests/junit/Test_org_eclipse_swt_widgets_Button.java;2;0;2;1;1;1;1;1;6;0;1;1792;6;6;1;0;0;1;2;1792;0;4706;2;2;
/org.eclipse.pde.ui/src/org/eclipse/pde/internal/util/ArraySorter.java;1;0;2;1;0;0;0;2;0;1;2;2691;0;0;1;0;0;2;2;2691;0;3579;2;1;
/org.eclipse.jdt.debug/eval/org/eclipse/jdt/internal/debug/eval/ast/engine/PrefixPlusPlusOperator.java;1;0;3;1;0;0;0;3;2;1;3;3329;2;2;1;0;0;3;3;3329;0;3421;3;1;
/org.eclipse.vcm.core/src/org/eclipse/vcm/internal/core/adapter/IRepositoryAdapterFactory.java;2;0;2;1;0;0;0;2;6;1;2;0;6;6;1;0;0;2;2;0;0;297;2;2;
/org.eclipse.jdt.ui.tests.refactoring/resources/InlineTemp/canInline/A_test12_in.java;1;0;2;1;0;0;0;2;2;1;2;2758;2;2;1;0;0;2;2;2758;0;3048;2;1;
/org.eclipse.pde.ui/Eclipse PDE UI/org/eclipse/pde/internal/component/PluginListPage.java;2;0;5;2;0;0;0;5;12;3;3;267;12;12;3;2;0;5;5;324;2;1434;3;2;
/org.eclipse.jdt.ui.tests.refactoring/resources/RenamePackage/test2/in/r/A.java;1;0;1;1;0;0;0;1;0;0;1;1258;0;0;1;0;0;1;1;1258;0;1258;1;1;
/org.eclipse.help/src/org/eclipse/help/internal/topics/Anchor.java;2;0;3;1;0;0;0;3;29;1;3;1675;29;29;1;0;0;3;3;1675;0;1857;3;2;
/org.eclipse.update.core/src/org/eclipse/core/boot/IPlatformConfiguration.java;1;0;7;1;0;0;0;7;244;2;6;1993;635;635;2;1;0;7;7;2017;1;2315;6;1;
/org.eclipse.swt/Eclipse SWT/win32/org/eclipse/swt/graphics/GC.java;9;1;28;2;3;3;3;25;273;2;21;106;1254;1254;2;4;0;25;28;1085;4;4701;24;9;
/org.eclipse.swt/Eclipse SWT PI/win32/org/eclipse/swt/internal/win32/CREATESTRUCT.java;2;0;2;1;1;1;1;1;6;0;1;2069;6;6;1;0;0;1;2;2069;0;4701;2;2;
/org.eclipse.jdt.core/model/org/eclipse/jdt/internal/core/builder/IField.java;1;0;4;1;0;0;0;4;27;1;4;455;28;28;1;0;0;4;4;455;0;2808;4;1;
/org.eclipse.help.ui/Eclipse Help UI/org/eclipse/help/internal/ui/search/SearchFilteringOptions.java;2;0;4;1;0;0;0;4;33;1;4;136;40;40;1;0;0;4;4;136;0;1055;4;2;
/org.eclipse.jdt.ui.tests.refactoring/resources/RenamePrivateMethod/test14/in/A.java;1;0;1;1;0;0;0;1;0;0;1;49;0;0;1;0;0;1;1;49;0;49;1;1;
/org.eclipse.jdt.debug/eval/org/eclipse/jdt/internal/debug/eval/model/JavaObjectRuntimeContext.java;2;0;3;1;0;0;0;3;7;1;3;3421;7;7;1;0;0;3;3;3421;0;3645;3;2;
/org.eclipse.jdt.ui.tests.refactoring/resources/ExtractMethodWorkSpace/ExtractMethodTests/invalidSelection/A_test096.java;2;1;3;1;2;2;2;1;0;0;1;49;0;0;1;0;0;1;3;49;0;4419;3;2;
/org.eclipse.jdt.debug/eval/org/eclipse/jdt/internal/debug/eval/ast/EvaluationInterfaceType.java;1;0;3;1;0;0;0;3;144;1;3;3329;144;144;1;0;0;3;3;3329;0;3421;3;1;
/org.eclipse.ui/Eclipse UI/org/eclipse/ui/internal/MultiEditorInnerPane.java;1;0;2;1;1;1;1;1;7;0;1;3127;7;7;1;0;0;1;2;3127;0;4082;2;1;
/org.eclipse.swt/Eclipse SWT PI/win32/org/eclipse/swt/internal/win32/TRACKMOUSEEVENT.java;2;0;2;1;1;1;1;1;6;0;1;2069;6;6;1;0;0;1;2;2069;0;4701;2;2;
/org.eclipse.core.resources/src/org/eclipse/core/internal/localstore/FileSystemResourceManager.java;4;1;29;1;5;5;5;24;1207;2;21;12;2027;2027;2;3;0;24;29;327;3;4454;26;4;
/org.eclipse.ui/Eclipse UI Tool Script/org/eclipse/toolscript/ui/internal/ToolScriptEditDialog.java;1;2;11;1;11;8;11;0;448;0;0;3920;1140;1140;2;0;3;0;11;3953;3;4083;8;1;
/org.eclipse.jdt.ui/ui/org/eclipse/jdt/internal/ui/text/template/VariableEvaluator.java;1;0;6;1;0;0;0;6;16;1;6;1469;42;42;1;0;0;6;6;1469;0;2784;6;1;
/org.eclipse.pde.ui/Eclipse PDE UI/org/eclipse/pde/internal/editor/schema/SchemaForm.java;3;0;8;2;0;0;0;8;12;3;6;267;27;27;3;2;0;8;8;324;2;1434;6;3;
/org.eclipse.jdt.ui.tests.refactoring/resources/MoveMembers/test5/in/A.java;1;0;1;1;0;0;0;1;0;0;1;2738;0;0;1;0;0;1;1;2738;0;2738;1;1;
/org.eclipse.jdt.core/dom/org/eclipse/jdt/core/dom/ITypeBinding.java;2;2;6;1;3;2;3;3;57;1;3;2669;94;94;2;0;1;3;6;3959;1;4058;5;2;
/org.eclipse.jdt.ui/ui/org/eclipse/jdt/internal/ui/compare/JarStructureCreator.java;2;0;6;1;0;0;0;6;263;1;6;15;303;303;1;0;0;6;6;15;0;1959;6;2;
/org.eclipse.jdt.ui.tests.refactoring/resources/SelectionAnalyzerWorkSpace/SelectionAnalyzerTests/invalidSelection/A_test146.java;2;0;2;1;0;0;0;2;0;1;2;1368;0;0;1;0;0;2;2;1368;0;2139;2;2;
/org.eclipse.jdt.debug.ui/ui/org/eclipse/jdt/internal/debug/ui/snippeteditor/JavaSnippetViewerConfiguration.java;3;0;3;1;0;0;0;3;152;1;3;1915;187;187;1;0;0;3;3;1915;0;3634;3;3;
/org.eclipse.jdt.ui.tests.refactoring/resources/RenameVirtualMethodInClass/testFail1/in/A.java;1;0;1;1;0;0;0;1;0;0;1;49;0;0;1;0;0;1;1;49;0;49;1;1;
/org.eclipse.ui/Eclipse UI Standard Components/org/eclipse/ui/views/internal/navigator/RefactorActionContributionFactory.java;1;0;2;1;0;0;0;2;0;1;2;1757;0;0;1;0;0;2;2;1757;0;1830;2;1;
/org.eclipse.jdt.ui.tests.refactoring/resources/RenameParameters/canRename/A_test17_out.java;1;0;1;1;0;0;0;1;0;0;1;233;0;0;1;0;0;1;1;233;0;233;1;1;
/org.eclipse.swt/Eclipse SWT/win32/org/eclipse/swt/internal/win32/NMTOOLBAR.java;2;0;4;1;0;0;0;4;5;1;4;106;6;6;1;0;0;4;4;106;0;2069;4;2;
/org.eclipse.pde.ui/src/org/eclipse/pde/internal/feature/PluginListPage.java;1;0;7;1;0;0;0;7;155;2;6;2951;196;196;2;1;0;7;7;3035;1;3579;6;1;
/org.eclipse.swt/Eclipse SWT Drag and Drop/common/org/eclipse/swt/dnd/DNDEvent.java;2;0;3;1;1;1;1;2;7;1;2;106;13;13;1;0;0;2;3;106;0;4701;3;2;
/org.eclipse.scripting/src/org/eclipse/scripting/internal/views/ScriptDevelopmentPreferencePageWorkbenchPreferences.java;1;0;1;1;0;0;0;1;0;0;1;1424;0;0;1;0;0;1;1;1424;0;1424;1;1;
/org.eclipse.jdt.core/dom/org/eclipse/jdt/core/dom/IfStatement.java;2;1;6;1;2;2;2;4;27;1;4;2669;68;68;1;0;0;4;6;2669;0;4453;6;2;
/org.eclipse.jdt.debug/jdi interfaces/com/sun/jdi/event/ThreadStartEvent.java;2;0;2;1;0;0;0;2;8;1;2;2704;8;8;1;0;0;2;2;2704;0;3040;2;2;
/org.eclipse.core.tests.runtime/src/org/eclipse/core/tests/runtime/PlatformTest.java;3;0;4;1;0;0;0;4;332;1;4;1794;344;344;1;0;0;4;4;1794;0;3476;4;3;
/org.eclipse.jdt.ui.tests.refactoring/resources/ExtractTemp/canExtract/A_test13_out.java;1;0;1;1;0;0;0;1;0;0;1;2481;0;0;1;0;0;1;1;2481;0;2481;1;1;
/org.eclipse.update.ui/src/org/eclipse/update/ui/internal/model/PendingChange.java;1;0;2;1;0;0;0;2;0;1;2;2781;0;0;1;0;0;2;2;2781;0;2797;2;1;
/org.eclipse.core.resources/src/org/eclipse/core/internal/utils/Queue.java;2;0;5;1;1;1;1;4;386;1;4;12;419;419;1;0;0;4;5;12;0;4214;5;2;
/org.eclipse.help/src/org/eclipse/help/internal/search/IndexingOperation.java;3;1;7;1;2;2;2;5;112;1;5;2318;184;184;1;0;0;5;7;2318;0;4000;7;3;
/org.eclipse.core.resources/src/org/eclipse/core/internal/dtree/DeletedNode.java;2;0;6;1;1;1;1;5;238;2;4;12;439;439;2;1;0;5;6;1241;1;4214;5;2;
/org.eclipse.core.tests.runtime/src/org/eclipse/core/tests/internal/runtime/PlatformLogReader.java;1;0;1;1;1;1;1;0;0;0;0;4127;0;0;1;0;0;0;1;4127;0;4127;1;1;
/org.eclipse.jdt.ui.tests.refactoring/resources/ReorderParameters/canReorder/A_test16_in.java;1;0;1;1;0;0;0;1;0;0;1;2296;0;0;1;0;0;1;1;2296;0;2296;1;1;
/org.eclipse.swt/Eclipse SWT/win32/org/eclipse/swt/internal/win32/NMHDR.java;2;0;3;1;0;0;0;3;5;1;3;106;5;5;1;0;0;3;3;106;0;2069;3;2;
/org.eclipse.pde.ui/Eclipse PDE UI/org/eclipse/pde/internal/editor/jars/LibrarySection.java;2;0;6;2;0;0;0;6;12;3;4;267;13;13;3;2;0;6;6;324;2;1434;4;2;
/org.eclipse.jdt.ui/core refactoring/org/eclipse/jdt/internal/corext/refactoring/reorg/MoveCuUpdateCreator.java;2;0;16;1;1;1;1;15;270;1;15;1939;521;521;1;0;0;15;16;1939;0;3894;16;2;
/org.eclipse.pde.build/src_ant/org/eclipse/pde/internal/build/tasks/BuildManifestTask.java;1;0;6;1;1;1;1;5;30;2;4;3509;44;44;2;1;0;5;6;3571;1;4273;5;1;
/org.eclipse.ui.tests/Eclipse UI Tests/org/eclipse/ui/tests/zoom/ShowViewTest.java;1;0;1;1;0;0;0;1;0;0;1;3633;0;0;1;0;0;1;1;3633;0;3633;1;1;
/org.eclipse.ui/Eclipse UI Tool Script/org/eclipse/toolscript/ui/internal/AntTargetLabelProvider.java;1;1;2;1;2;2;2;0;0;0;0;4024;0;0;1;0;0;0;2;4024;0;4087;2;1;
/org.eclipse.ant.core/src/org/eclipse/ant/core/WorkspaceScanner.java;2;0;2;1;0;0;0;2;0;1;2;14;0;0;1;0;0;2;2;14;0;303;2;2;
/org.eclipse.jdt.ui.tests.refactoring/resources/ExtractTemp/cannotExtract/A_testFail15.java;1;0;1;1;0;0;0;1;0;0;1;2932;0;0;1;0;0;1;1;2932;0;2932;1;1;
/org.eclipse.help/src/org/eclipse/help/internal/contributors/xml/InfosetsContributionFactory.java;2;0;2;1;0;0;0;2;0;1;2;1420;0;0;1;0;0;2;2;1420;0;1675;2;2;
/org.eclipse.update.ui/src/org/eclipse/update/internal/ui/security/AuthorizationDatabase.java;2;0;4;1;1;1;1;3;20;1;3;3212;35;35;1;0;0;3;4;3212;0;4430;4;2;
/org.eclipse.jdt.debug.tests/tests/org/eclipse/jdt/debug/tests/eval/ShortAssignmentOperatorsTests.java;2;1;3;1;3;3;3;0;18;0;0;4447;20;20;1;0;0;0;3;4447;0;4571;3;2;
/org.eclipse.jdt.ui/ui debug/org/eclipse/jdt/internal/debug/ui/BreakpointLocationVerifier.java;2;0;4;1;0;0;0;4;8;1;4;15;14;14;1;0;0;4;4;15;0;1916;4;2;
/org.eclipse.jdt.junit/Eclipse JUnit/org/eclipse/jdt/internal/junit/launcher/JUnitLaunchConfigurationTab.java;2;0;3;1;0;0;0;3;1;1;3;3071;1;1;1;0;0;3;3;3071;0;3205;3;2;
/org.eclipse.pde.ui/src/org/eclipse/pde/internal/ui/parts/TreePart.java;1;0;1;1;0;0;0;1;0;0;1;3579;0;0;1;0;0;1;1;3579;0;3579;1;1;
/org.eclipse.pde.build/src/org/eclipse/pde/internal/build/IXMLConstants.java;1;2;31;1;15;13;15;16;140;2;13;2896;322;322;2;3;2;16;31;3150;5;4364;26;1;
/org.eclipse.jdt.junit/src/org/eclipse/jdt/internal/junit/wizards/NewTestSuiteCreationWizardPage.java;3;1;7;1;5;5;5;2;43;1;2;3527;66;66;1;0;0;2;7;3527;0;4742;7;3;
/org.eclipse.jdt.debug/jdi interfaces/com/sun/jdi/ShortValue.java;2;0;2;1;0;0;0;2;6;1;2;2704;6;6;1;0;0;2;2;2704;0;3033;2;2;
/org.eclipse.jdt.ui/core refactoring/org/eclipse/jdt/internal/core/refactoring/rename/RenameRefactoringASTAnalyzer.java;2;0;2;1;0;0;0;2;0;1;2;1911;0;0;1;0;0;2;2;1911;0;1939;2;2;
/org.eclipse.ui/Eclipse UI/org/eclipse/ui/internal/LightweightActionDescriptor.java;3;0;3;1;1;1;1;2;5;1;2;257;9;9;1;0;0;2;3;257;0;4283;3;3;
/org.eclipse.jdt.ui.tests.refactoring/resources/RenameType/test36/out/B.java;1;0;1;1;0;0;0;1;0;0;1;49;0;0;1;0;0;1;1;49;0;49;1;1;
/org.eclipse.team.cvs.core/src/org/eclipse/team/internal/ccvs/core/util/ServerDateFormat.java;3;0;7;1;0;0;0;7;100;1;7;1978;128;128;1;0;0;7;7;1978;0;3398;7;3;
/org.eclipse.jdt.core/dom/org/eclipse/jdt/core/dom/SwitchStatement.java;2;1;6;1;2;2;2;4;11;1;4;2669;35;35;1;0;0;4;6;2669;0;4453;6;2;
/org.eclipse.jdt.ui/core refactoring/org/eclipse/jdt/internal/core/refactoring/SourceRange.java;2;0;2;1;0;0;0;2;0;1;2;1576;0;0;1;0;0;2;2;1576;0;1939;2;2;
/org.eclipse.jdt.ui.tests.refactoring/resources/ExtractMethodWorkSpace/ExtractMethodTests/nested_out/A_test653.java;2;1;3;1;2;2;2;1;18;0;1;354;18;18;1;0;0;1;3;354;0;4419;3;2;
/org.eclipse.jdt.debug/jdi interfaces/com/sun/jdi/VirtualMachineManager.java;2;0;2;1;0;0;0;2;18;1;2;2704;18;18;1;0;0;2;2;2704;0;3033;2;2;
/org.eclipse.swt/Eclipse SWT Drag and Drop/gtk/org/eclipse/swt/dnd/Transfer.java;3;1;7;1;5;5;5;2;77;1;2;2107;159;159;1;0;0;2;7;2107;0;4830;7;3;
/org.eclipse.jdt.ui.tests.refactoring/resources/ExtractMethodWorkSpace/ExtractMethodTests/locals_out/A_test553.java;1;1;4;1;2;2;2;2;34;1;2;1236;35;35;1;0;0;2;4;1236;0;4419;4;1;
/org.eclipse.help/webapps/examples/WEB-INF/classes/examples/FooTag.java;1;0;2;1;0;0;0;2;0;1;2;1882;0;0;1;0;0;2;2;1882;0;1930;2;1;
/org.eclipse.pde.ui/Eclipse PDE UI/org/eclipse/pde/internal/base/schema/ISchemaDescriptor.java;2;0;5;2;0;0;0;5;12;3;3;267;12;12;3;2;0;5;5;324;2;1434;3;2;
/org.eclipse.pde.ui/src/org/eclipse/pde/internal/ui/wizards/templates/FieldData.java;1;0;2;1;0;0;0;2;17;1;2;3579;17;17;1;0;0;2;2;3579;0;3840;2;1;
/org.eclipse.webdav/src/kernel/org/eclipse/webdav/internal/kernel/SystemException.java;2;1;5;1;2;2;2;3;68;1;3;1635;120;120;1;0;0;3;5;1635;0;4460;5;2;
/org.eclipse.scripting/Eclipse Scripting/org/eclipse/scripting/internal/ScriptEngineException.java;1;0;3;1;0;0;0;3;4;1;3;133;4;4;1;0;0;3;3;133;0;1424;3;1;
/org.eclipse.pde.ui/src/org/eclipse/pde/internal/ui/editor/schema/SchemaForm.java;1;0;4;1;0;0;0;4;12;2;3;3579;16;16;2;1;0;4;4;3579;1;3802;3;1;
/org.eclipse.swt/Eclipse SWT/motif/org/eclipse/swt/graphics/FontData.java;5;1;11;1;3;3;3;8;166;2;7;106;300;300;2;1;0;8;11;1675;1;4701;10;5;
/org.eclipse.swt/Eclipse SWT/gtk1x/org/eclipse/swt/graphics/DefaultGtkStyle.java;2;0;2;1;1;1;1;1;6;0;1;2107;6;6;1;0;0;1;2;2107;0;4701;2;2;
/org.eclipse.team.cvs.ui/src/org/eclipse/team/internal/ccvs/ui/wizards/SetKeywordSubstitutionOperation.java;2;0;4;2;0;0;0;4;11;3;2;3206;11;11;3;2;0;4;4;3206;2;3251;2;2;
/org.eclipse.jdt.ui.tests.refactoring/resources/RenameType/test16/in/A.java;1;0;1;1;0;0;0;1;0;0;1;49;0;0;1;0;0;1;1;49;0;49;1;1;
/org.eclipse.swt/Eclipse SWT/photon/org/eclipse/swt/internal/photon/PhImage_t.java;2;0;3;1;0;0;0;3;6;1;3;106;6;6;1;0;0;3;3;106;0;2069;3;2;
/org.eclipse.pde.ui/src/org/eclipse/pde/internal/core/feature/FeaturePlugin.java;1;0;3;1;0;0;0;3;2;1;3;3579;2;2;1;0;0;3;3;3579;0;3607;3;1;
/org.eclipse.update.ui/src/org/eclipse/update/internal/ui/model/IConfiguredSiteContext.java;1;0;1;1;0;0;0;1;0;0;1;2994;0;0;1;0;0;1;1;2994;0;2994;1;1;
/org.eclipse.help.ui/src/org/eclipse/help/internal/ui/win32/NestedPrintDelegate.java;2;0;2;1;0;0;0;2;0;1;2;1420;0;0;1;0;0;2;2;1420;0;1675;2;2;
/org.eclipse.vcm.ui/src/org/eclipse/vcm/internal/ui/model/VCMModelElement.java;5;0;7;2;0;0;0;7;22;2;5;1;46;46;2;2;0;7;7;281;2;1578;5;5;
/org.eclipse.update.ui/src/org/eclipse/update/internal/ui/views/LocalSiteView.java;1;0;2;1;0;0;0;2;0;1;2;3537;0;0;1;0;0;2;2;3537;0;3561;2;1;
/org.eclipse.jdt.debug.ui/ui/org/eclipse/jdt/internal/debug/ui/snippeteditor/InspectAction.java;2;0;2;1;0;0;0;2;0;1;2;1915;0;0;1;0;0;2;2;1915;0;2813;2;2;
/org.eclipse.vcm.tests.core/src/org/eclipse/vcm/tests/core/VCMMagic.java;1;0;1;1;0;0;0;1;0;0;1;1688;0;0;1;0;0;1;1;1688;0;1688;1;1;
/org.eclipse.ui.externaltools/External Tools/org/eclipse/ui/externaltools/internal/ui/LogTreeLabelProvider.java;1;0;1;1;1;1;1;0;0;0;0;4123;0;0;1;0;0;0;1;4123;0;4123;1;1;
/org.eclipse.jdt.ui/ui/org/eclipse/jdt/internal/ui/preferences/JDKZipFieldEditor.java;1;0;3;1;0;0;0;3;5;1;3;15;5;5;1;0;0;3;3;15;0;416;3;1;
/org.eclipse.jdt.ui/ui/org/eclipse/jdt/internal/ui/search/FindWriteReferencesInHierarchyAction.java;1;2;6;1;4;3;4;2;31;1;2;1707;54;54;2;0;1;2;6;4140;1;4140;5;1;
/org.eclipse.jdt.ui.tests.refactoring/resources/InlineTemp/canInline/A_test19_in.java;1;0;1;1;0;0;0;1;0;0;1;3356;0;0;1;0;0;1;1;3356;0;3356;1;1;
/org.eclipse.jdt.ui/core refactoring/org/eclipse/jdt/internal/core/refactoring/nls/changes/CreateTextFileChange.java;2;0;2;1;0;0;0;2;0;1;2;1922;0;0;1;0;0;2;2;1922;0;1939;2;2;
/org.eclipse.jdt.ui/ui/org/eclipse/jdt/ui/actions/FindReadReferencesInWorkingSetAction.java;3;1;3;1;3;3;3;0;18;0;0;4141;22;22;1;0;0;0;3;4141;0;4770;3;3;
/org.eclipse.core.runtime/src/org/eclipse/core/internal/plugins/PluginDescriptor.java;5;2;31;2;8;7;8;23;1710;2;21;12;3119;3119;2;2;1;23;31;23;3;4552;28;5;
/org.eclipse.jdt.debug/eval/org/eclipse/jdt/internal/debug/eval/ast/engine/UnsignedRightShiftOperator.java;1;0;2;1;0;0;0;2;0;1;2;3329;0;0;1;0;0;2;2;3329;0;3421;2;1;
/org.eclipse.vcm.core/src/org/eclipse/vcm/internal/core/base/IMergeManager.java;2;0;2;1;0;0;0;2;5;1;2;0;5;5;1;0;0;2;2;0;0;297;2;2;
/org.eclipse.jdt.ui.tests.refactoring/resources/RenameVirtualMethodInClass/test17/in/A.java;1;0;1;1;0;0;0;1;0;0;1;49;0;0;1;0;0;1;1;49;0;49;1;1;
/org.eclipse.pde.ui/Eclipse PDE UI/org/eclipse/pde/internal/schema/SchemaEnumeration.java;2;0;6;2;0;0;0;6;12;3;4;267;13;13;3;2;0;6;6;324;2;1434;4;2;
/org.eclipse.swt/Eclipse SWT Custom Widgets/common/org/eclipse/swt/custom/TableTreeEditor.java;2;0;8;1;1;1;1;7;206;1;7;106;291;291;1;0;0;7;8;106;0;4701;8;2;
/org.eclipse.jdt.debug.tests/test plugin/org/eclipse/jdt/debug/testplugin/DebugElementKindEventWaiter.java;2;0;2;1;1;1;1;1;12;0;1;3701;12;12;1;0;0;1;2;3701;0;4328;2;2;
/org.eclipse.debug.ui/ui/org/eclipse/debug/internal/ui/actions/LaunchWithConfigurationAction.java;4;2;15;2;8;7;8;7;72;1;7;3362;389;389;2;0;1;7;15;4401;1;4401;14;4;
/org.eclipse.team.cvs.core/src/org/eclipse/team/internal/ccvs/core/requests/RequestSender.java;3;0;6;1;0;0;0;6;530;1;6;1978;1585;1585;1;0;0;6;6;1978;0;2607;6;3;
/org.eclipse.scripting/src/org/eclipse/scripting/internal/IXGRElementUIImageElement.java;1;0;1;1;0;0;0;1;0;0;1;1424;0;0;1;0;0;1;1;1424;0;1424;1;1;
/org.eclipse.ui/Eclipse UI Standard Components/org/eclipse/ui/views/bookmarkexplorer/BookmarkNavigator.java;4;0;8;1;0;0;0;8;67;1;8;257;134;134;1;0;0;8;8;257;0;3725;8;4;
/org.eclipse.swt/Eclipse SWT/motif/org/eclipse/swt/widgets/Caret.java;7;1;11;1;4;4;4;7;481;1;7;106;1099;1099;1;0;0;7;11;106;0;4701;11;7;
/org.eclipse.team.ui/src/org/eclipse/team/ui/sync/SyncView.java;3;1;10;1;2;2;2;8;32;1;8;2233;135;135;1;0;0;8;10;2233;0;4005;10;3;
/org.eclipse.jdt.ui.tests.refactoring/resources/PullUpMethods/testFail11/in/B.java;1;0;2;1;0;0;0;2;0;1;2;2156;0;0;1;0;0;2;2;2156;0;2406;2;1;
/org.eclipse.core.boot/src/org/eclipse/core/internal/boot/update/URLNamePairModel.java;2;0;3;1;0;0;0;3;7;1;3;12;7;7;1;0;0;3;3;12;0;2726;3;2;
/org.eclipse.update.ui/src/org/eclipse/update/internal/ui/model/DriveSearchSettings.java;1;0;2;1;0;0;0;2;0;1;2;2797;0;0;1;0;0;2;2;2797;0;3537;2;1;
/org.eclipse.swt/Eclipse SWT Drag and Drop/carbon/org/eclipse/swt/dnd/RTFTransfer.java;4;1;6;1;6;6;6;0;50;0;0;4147;74;74;1;0;0;0;6;4147;0;4824;6;4;
/org.eclipse.team.cvs.core/src/org/eclipse/team/internal/ccvs/core/resources/RemoteResource.java;3;0;29;2;0;0;0;29;269;4;24;1978;964;964;4;5;0;29;29;2049;5;3873;24;3;
/org.eclipse.jdt.ui/core refactoring/org/eclipse/jdt/internal/corext/refactoring/structure/MessageSendFinder.java;1;0;2;1;0;0;0;2;0;1;2;2737;0;0;1;0;0;2;2;2737;0;3065;2;1;
/org.eclipse.jdt.ui/ui debug/org/eclipse/jdt/internal/debug/ui/DropToFrameAction.java;2;0;4;1;0;0;0;4;14;1;4;15;22;22;1;0;0;4;4;15;0;1916;4;2;
/org.eclipse.swt.examples/src/org/eclipse/swt/examples/layoutexample/Tab.java;3;1;6;1;3;3;3;3;300;1;3;3420;326;326;1;0;0;3;6;3420;0;4705;6;3;
/org.eclipse.pde.core/src/org/eclipse/pde/internal/core/EntryFileAdapter.java;1;0;1;1;0;0;0;1;0;0;1;3591;0;0;1;0;0;1;1;3591;0;3591;1;1;
/org.eclipse.jdt.debug/jdi/org/eclipse/jdi/internal/InterfaceTypeImpl.java;2;0;4;1;0;0;0;4;24;1;4;187;46;46;1;0;0;4;4;187;0;3670;4;2;
/org.eclipse.jdt.ui/ui/org/eclipse/jdt/internal/ui/search/PotentialMatchDialog.java;1;0;4;1;1;1;1;3;23;1;3;3228;25;25;1;0;0;3;4;3228;0;4423;4;1;
/org.eclipse.core.resources/src/org/eclipse/core/resources/IWorkspace.java;4;1;25;1;5;5;5;20;2252;1;20;12;2674;2674;1;0;0;20;25;12;0;4632;25;4;
/org.eclipse.jdt.ui.tests.refactoring/resources/ExtractMethodWorkSpace/ExtractMethodTests/invalidSelection/A_test050.java;2;1;5;1;2;2;2;3;2;1;3;49;4;4;1;0;0;3;5;49;0;4419;5;2;
/org.eclipse.ui/Eclipse UI/org/eclipse/ui/internal/dialogs/MultiStepWizardDialog.java;1;0;8;1;0;0;0;8;66;3;6;3211;116;116;3;2;0;8;8;3227;2;3488;6;1;
/org.eclipse.jdt.debug.tests/tests/org/eclipse/jdt/debug/tests/core/MiscBreakpointsTests.java;2;2;5;1;5;4;5;0;67;0;0;4299;101;101;2;0;1;0;5;4310;1;4571;4;2;
/org.eclipse.jdt.ui.tests.refactoring/resources/RenameMethodInInterface/test16/out/A.java;2;0;2;1;0;0;0;2;2;1;2;49;2;2;1;0;0;2;2;49;0;1297;2;2;
/org.eclipse.pde.ui/src/org/eclipse/pde/internal/editor/schema/SchemaFormOutlinePage.java;2;0;5;1;0;0;0;5;274;2;4;1434;276;276;2;1;0;5;5;3035;1;3579;4;2;
/org.eclipse.jdt.ui.tests.refactoring/test cases/org/eclipse/jdt/ui/tests/refactoring/RenameMethodTests.java;2;0;2;1;0;0;0;2;10;1;2;1896;10;10;1;0;0;2;2;1896;0;1913;2;2;
/org.eclipse.jdt.ui/core refactoring/org/eclipse/jdt/internal/core/refactoring/base/IChangeExceptionHandler.java;2;0;2;1;0;0;0;2;0;1;2;408;0;0;1;0;0;2;2;408;0;1939;2;2;
/org.eclipse.jdt.debug.tests/testprograms/EvalArrayTests.java;2;1;2;1;2;2;2;0;70;0;0;4447;70;70;1;0;0;0;2;4447;0;4571;2;2;
/org.eclipse.pde.ui/src/org/eclipse/pde/internal/ui/editor/schema/ElementSection.java;1;0;4;1;1;1;1;3;22;2;2;3579;27;27;2;1;0;3;4;3579;1;4345;3;1;
/org.eclipse.core.tests.resources/src/org/eclipse/core/tests/resources/ISynchronizerTest.java;3;1;6;1;2;2;2;4;1660;2;3;1794;1707;1707;2;1;0;4;6;3415;1;4516;5;3;
/org.eclipse.pde.build/src/org/eclipse/pde/internal/build/Mkdir.java;3;0;5;1;0;0;0;5;32;1;5;1366;37;37;1;0;0;5;5;1366;0;3089;5;3;
/org.eclipse.jdt.ui.tests.refactoring/resources/RenameType/test27/out/A.java;1;0;2;1;0;0;0;2;0;1;2;49;0;0;1;0;0;2;2;49;0;522;2;1;
/org.eclipse.jdt.debug/model/org/eclipse/jdt/internal/debug/core/IJDIEventListener.java;3;0;5;1;0;0;0;5;20;1;5;1153;25;25;1;0;0;5;5;1153;0;3108;5;3;
/org.eclipse.jdt.ui/ui/org/eclipse/jdt/internal/ui/JavaTaskListAdapter.java;2;0;3;1;1;1;1;2;6;1;2;2199;11;11;1;0;0;2;3;2199;0;4181;3;2;
/org.eclipse.jdt.ui.tests.refactoring/resources/MoveMembers/test20/in/B.java;1;0;1;1;0;0;0;1;0;0;1;2738;0;0;1;0;0;1;1;2738;0;2738;1;1;
/org.eclipse.team.cvs.ui/src/org/eclipse/team/internal/ccvs/ui/ICVSUIConstants.java;3;1;34;2;9;9;9;25;120;2;21;1978;301;301;2;4;0;25;34;1995;4;4707;30;3;
/org.eclipse.pde.ui/src/org/eclipse/pde/model/plugin/IPluginModelFactory.java;1;0;2;1;0;0;0;2;0;1;2;3039;0;0;1;0;0;2;2;3039;0;3579;2;1;
/org.eclipse.jdt.ui.tests.refactoring/resources/RenamePrivateMethod/test0/out/A.java;1;0;1;1;0;0;0;1;0;0;1;49;0;0;1;0;0;1;1;49;0;49;1;1;
/org.eclipse.jdt.core/model/org/eclipse/jdt/core/util/ICodeAttribute.java;3;2;9;2;7;5;7;2;26;0;1;3629;86;86;2;1;2;2;9;3629;3;4573;6;3;
/org.eclipse.jdt.core/model/org/eclipse/jdt/internal/core/CommitWorkingCopyOperation.java;3;1;17;1;3;3;3;14;208;4;11;455;382;382;4;3;0;14;17;1039;3;4424;14;3;
/org.eclipse.jdt.ui/core refactoring/org/eclipse/jdt/core/refactoring/methods/RenameMethodASTAnalyzer.java;1;0;5;1;0;0;0;5;86;2;4;15;91;91;2;1;0;5;5;25;1;408;4;1;
/org.eclipse.jdt.core/model/org/eclipse/jdt/internal/core/builder/impl/ImageImplSWH.java;1;0;9;1;0;0;0;9;358;4;6;455;376;376;4;3;0;9;9;1039;3;2808;6;1;
/org.eclipse.team.core/src/org/eclipse/team/core/RepositoryProvider.java;4;1;19;2;8;8;8;11;276;2;10;3193;941;941;2;1;0;11;19;3223;1;4846;18;4;
/org.eclipse.ui/Eclipse JFace Text/org/eclipse/jface/text/GapTextStore.java;4;1;7;1;2;2;2;5;147;1;5;257;198;198;1;0;0;5;7;257;0;4853;7;4;
/org.eclipse.ui/Eclipse UI/org/eclipse/ui/dialogs/CheckedTreeSelectionDialog.java;1;0;3;1;1;1;1;2;32;1;2;3733;40;40;1;0;0;2;3;3733;0;4451;3;1;
/org.eclipse.jdt.core/dom/org/eclipse/jdt/core/dom/ArrayInitializer.java;2;0;4;1;0;0;0;4;9;1;4;2669;18;18;1;0;0;4;4;2669;0;3637;4;2;
/org.eclipse.team.cvs.ui/src/org/eclipse/team/internal/ccvs/ui/model/RemoteResourceElement.java;3;0;3;1;0;0;0;3;56;1;3;1978;58;58;1;0;0;3;3;1978;0;3610;3;3;
/org.eclipse.scripting/src/org/eclipse/scripting/internal/uirenderer/XGRPresentationModelElement.java;1;0;1;1;0;0;0;1;0;0;1;1424;0;0;1;0;0;1;1;1424;0;1424;1;1;
/org.eclipse.jdt.core/model/org/eclipse/jdt/internal/core/CreatePackageDeclarationOperation.java;3;1;11;1;2;2;2;9;181;4;6;455;236;236;4;3;0;9;11;1039;3;4063;8;3;
/org.eclipse.vcm.ui/src/org/eclipse/vcm/internal/ui/syncdialog/MergeAction.java;2;0;2;1;0;0;0;2;0;1;2;1;0;0;1;0;0;2;2;1;0;68;2;2;
/org.eclipse.core.tests.runtime/src/org/eclipse/core/tests/plugintests/CmdLineAndPluginLocalTest.java;1;0;1;1;1;1;1;0;0;0;0;4006;0;0;1;0;0;0;1;4006;0;4006;1;1;
/org.eclipse.swt.examples.ole.win32/org/eclipse/swt/examples/ole/win32/OleBrowserView.java;3;0;4;1;1;1;1;3;363;1;3;513;372;372;1;0;0;3;4;513;0;4024;4;3;
/org.eclipse.search/search/org/eclipse/search/internal/ui/util/ExtendedDialogWindow.java;2;1;7;1;2;2;2;5;26;1;5;15;67;67;1;0;0;5;7;15;0;4619;7;2;
/org.eclipse.jdt.ui/ui/org/eclipse/jdt/internal/ui/javaeditor/OverviewRuler.java;1;1;8;1;2;2;2;6;105;2;5;3324;174;174;2;1;0;6;8;3324;1;4423;7;1;
/org.eclipse.pde.ui/src/org/eclipse/pde/internal/editor/component/ReferenceForm.java;2;0;3;1;0;0;0;3;8;1;3;1434;8;8;1;0;0;3;3;1434;0;2951;3;2;
/org.eclipse.pde.ui/Eclipse PDE UI/org/eclipse/pde/internal/wizards/ListUtil.java;2;0;5;2;0;0;0;5;12;3;3;267;12;12;3;2;0;5;5;324;2;1434;3;2;
/org.eclipse.jdt.ui.tests/JUnit/junit/swingui/LoadingTestRunner.java;2;0;2;1;0;0;0;2;0;1;2;49;0;0;1;0;0;2;2;49;0;1186;2;2;
/org.eclipse.jdt.ui/ui/org/eclipse/jdt/internal/ui/packageview/Frame.java;1;0;3;1;0;0;0;3;4;1;3;213;4;4;1;0;0;3;3;213;0;390;3;1;
/org.eclipse.jdt.ui/core refactoring/org/eclipse/jdt/internal/corext/refactoring/rename/ProblemNodeFinder.java;1;0;1;1;0;0;0;1;0;0;1;3393;0;0;1;0;0;1;1;3393;0;3393;1;1;
/org.eclipse.ui/Eclipse UI Standard Components/org/eclipse/ui/views/navigator/IResourceNavigator.java;1;0;1;1;1;1;1;0;0;0;0;4067;0;0;1;0;0;0;1;4067;0;4067;1;1;
/org.eclipse.compare/compare/org/eclipse/compare/internal/AddFromHistoryDialog.java;2;1;9;1;5;5;5;4;349;1;4;14;626;626;1;0;0;4;9;14;0;4451;9;2;
/org.eclipse.jdt.ui/ui/org/eclipse/jdt/internal/ui/text/java/JavaAutoIndentStrategy.java;5;1;9;1;3;3;3;6;14;1;6;15;58;58;1;0;0;6;9;15;0;4401;9;5;
/org.eclipse.team.cvs.ui/src/org/eclipse/team/internal/ccvs/ui/CVSDecoration.java;2;0;3;1;1;1;1;2;129;1;2;2484;157;157;1;0;0;2;3;2484;0;4362;3;2;
/org.eclipse.pde.ui/src/org/eclipse/pde/internal/ui/editor/manifest/DetailExtensionSection.java;1;1;10;1;4;4;4;6;49;2;5;3579;97;97;2;1;0;6;10;3579;1;4567;9;1;
/org.eclipse.pde.ui/src/org/eclipse/pde/internal/wizards/templates/DefaultCodeGenerationPage.java;1;0;2;1;0;0;0;2;0;1;2;3240;0;0;1;0;0;2;2;3240;0;3579;2;1;
/org.eclipse.pde.core/src/org/eclipse/pde/internal/core/ischema/ISchemaEnumeration.java;1;0;1;1;0;0;0;1;0;0;1;3591;0;0;1;0;0;1;1;3591;0;3591;1;1;
/org.eclipse.help.ui/src/org/eclipse/help/ui/internal/browser/solaris/NetscapeFactory.java;2;0;4;1;1;1;1;3;20;1;3;2429;24;24;1;0;0;3;4;2429;0;4439;4;2;
/org.eclipse.core.boot/src/org/eclipse/core/internal/boot/PlatformConfiguration.java;3;2;32;2;17;16;17;15;4186;2;13;2285;9252;9252;2;2;1;15;32;2666;3;4687;29;3;
/org.eclipse.swt/Eclipse SWT/win32/org/eclipse/swt/widgets/Label.java;8;2;19;1;6;5;6;13;42;1;13;106;208;208;2;0;1;13;19;4557;1;4701;18;8;
/org.eclipse.update.core/src/org/eclipse/update/core/IInstallConfigurationChangedListener.java;1;0;7;1;0;0;0;7;14;2;6;1863;46;46;2;1;0;7;7;2098;1;3018;6;1;
/org.eclipse.jdt.ui.tests.refactoring/resources/ExtractMethodWorkSpace/ExtractMethodTests/locals_in/A_test527.java;1;1;3;1;2;2;2;1;46;0;1;2684;46;46;1;0;0;1;3;2684;0;4419;3;1;
/org.eclipse.debug.ui/ui/org/eclipse/debug/internal/ui/DebugActionGroupsLabelProvider.java;2;0;4;1;1;1;1;3;5;1;3;3257;7;7;1;0;0;3;4;3257;0;3975;4;2;
/org.eclipse.jdt.debug.tests/testprograms/MultiThreadedException.java;2;1;2;1;2;2;2;0;11;0;0;4308;11;11;1;0;0;0;2;4308;0;4571;2;2;
/org.eclipse.core.resources/src/org/eclipse/core/internal/resources/WorkspaceTreeReader.java;4;0;6;1;1;1;1;5;470;1;5;182;565;565;1;0;0;5;6;182;0;4213;6;4;
/org.eclipse.pde.ui/Eclipse PDE UI/org/eclipse/pde/internal/base/model/component/IComponentURLElement.java;2;0;5;2;0;0;0;5;12;3;3;267;12;12;3;2;0;5;5;324;2;1434;3;2;
/org.eclipse.jdt.ui/ui/org/eclipse/jdt/internal/ui/JavaElementAdapterFactory.java;3;0;11;1;1;1;1;10;42;2;9;15;128;128;2;1;0;10;11;329;1;4009;10;3;
/org.eclipse.jdt.ui/ui/org/eclipse/jdt/internal/ui/wizards/dialogfields/SelectionButtonDialogField.java;2;0;5;1;0;0;0;5;51;1;5;15;76;76;1;0;0;5;5;15;0;3084;5;2;
/org.eclipse.jdt.ui.tests/JUnit/junit/framework/AssertionFailedError.java;2;0;2;1;0;0;0;2;0;1;2;49;0;0;1;0;0;2;2;49;0;1186;2;2;
/org.eclipse.debug.ui/ui/org/eclipse/debug/internal/ui/RemoveBreakpointAction.java;3;0;11;1;0;0;0;11;27;1;11;187;102;102;1;0;0;11;11;187;0;2382;11;3;
/org.eclipse.core.tests.resources/src/org/eclipse/core/tests/resources/IFileTest.java;3;1;7;1;2;2;2;5;1538;1;5;1794;1731;1731;1;0;0;5;7;1794;0;4516;7;3;
/org.eclipse.jdt.ui/ui/org/eclipse/jdt/ui/actions/JavaSearchActionGroup.java;3;4;13;2;12;7;12;1;397;0;1;3716;787;787;4;0;5;1;13;4137;5;4770;8;3;
/org.eclipse.jdt.ui.tests.refactoring/resources/ExtractMethodWorkSpace/ExtractMethodTests/invalidSelection/A_test192.java;1;1;3;1;2;2;2;1;30;0;1;1851;30;30;1;0;0;1;3;1851;0;4419;3;1;
/org.eclipse.jdt.ui.tests.refactoring/resources/SelectionAnalyzerWorkSpace/SelectionAnalyzerTests/validSelection/A_test146_.java;1;0;1;1;0;0;0;1;0;0;1;2139;0;0;1;0;0;1;1;2139;0;2139;1;1;
/org.eclipse.ui.examples.readmetool/Eclipse UI Examples Readme Tool/org/eclipse/ui/examples/readmetool/DirtyStateContribution.java;2;0;2;1;0;0;0;2;6;1;2;932;6;6;1;0;0;2;2;932;0;945;2;2;
/org.eclipse.ui/Eclipse JFace Text/org/eclipse/jface/text/source/VerticalRulerHoveringController.java;4;0;5;1;0;0;0;5;64;1;5;257;73;73;1;0;0;5;5;257;0;1435;5;4;
/org.eclipse.jdt.ui.tests.refactoring/resources/ExtractMethodWorkSpace/ExtractMethodTests/invalidSelection/A_test170.java;2;1;3;1;2;2;2;1;0;0;1;511;0;0;1;0;0;1;3;511;0;4419;3;2;
/org.eclipse.jdt.ui.tests/JUnit/junit/samples/money/Money.java;2;0;2;1;0;0;0;2;0;1;2;49;0;0;1;0;0;2;2;49;0;1186;2;2;
/org.eclipse.update.tests.core/src/org/eclipse/update/tests/parser/TestSiteParse.java;2;1;29;1;7;7;7;22;123;2;20;1581;421;421;2;2;0;22;29;1638;2;4424;27;2;
/org.eclipse.jdt.ui.tests.refactoring/resources/RenameType/test51/out/C.java;1;0;1;1;0;0;0;1;0;0;1;49;0;0;1;0;0;1;1;49;0;49;1;1;
/org.eclipse.swt/Eclipse SWT/carbon/org/eclipse/swt/widgets/Text.java;4;1;5;1;5;5;5;0;66;0;0;4147;105;105;1;0;0;0;5;4147;0;4701;5;4;
/org.eclipse.ui/Eclipse JFace/org/eclipse/jface/preference/StringFieldEditor.java;5;1;7;1;2;2;2;5;26;1;5;257;40;40;1;0;0;5;7;257;0;4547;7;5;
/org.eclipse.team.ui/src/org/eclipse/team/ui/actions/CheckOutAction.java;2;0;8;1;1;1;1;7;136;1;7;1978;178;178;1;0;0;7;8;1978;0;4020;8;2;
/org.eclipse.jdt.ui.tests.refactoring/resources/SelectionAnalyzerWorkSpace/SelectionAnalyzerTests/invalidSelection/A_test030.java;1;0;1;1;0;0;0;1;0;0;1;1368;0;0;1;0;0;1;1;1368;0;1368;1;1;
/org.eclipse.ui.examples.javaeditor/Eclipse Java Editor Example/org/eclipse/ui/examples/javaeditor/java/JavaCodeScanner.java;1;0;1;1;0;0;0;1;0;0;1;1067;0;0;1;0;0;1;1;1067;0;1067;1;1;
/org.eclipse.webdav/src/interface/org/eclipse/webdav/dom/MultiStatus.java;3;0;5;1;1;1;1;4;310;1;4;12;374;374;1;0;0;4;5;12;0;4211;5;3;
/org.eclipse.jdt.core/model/org/eclipse/jdt/internal/core/Initializer.java;3;0;12;1;1;1;1;11;140;4;8;455;275;275;4;3;0;11;12;1039;3;4063;9;3;
/org.eclipse.jdt.ui/core refactoring/org/eclipse/jdt/internal/corext/refactoring/code/LineEndDeleteTextEdit.java;2;0;11;1;1;1;1;10;24;2;8;2062;62;62;2;2;0;10;11;2133;2;4000;9;2;
/org.eclipse.jdt.core/model/org/eclipse/jdt/internal/core/BasicCompilationUnit.java;2;1;14;1;3;3;3;11;123;4;8;455;289;289;4;3;0;11;14;1039;3;4063;11;2;
/org.eclipse.jdt.ui/nls/org/eclipse/jdt/internal/ui/nls/search/Properties.java;1;0;2;1;0;0;0;2;0;1;2;1880;0;0;1;0;0;2;2;1880;0;1913;2;1;
/org.eclipse.team.cvs.core/src/org/eclipse/team/internal/ccvs/core/resources/ICVSFolder.java;1;0;5;1;0;0;0;5;99;2;4;2156;106;106;2;1;0;5;5;2156;1;3089;4;1;
/org.eclipse.core.resources/src/org/eclipse/core/internal/watson/DefaultElementComparator.java;1;0;4;1;1;1;1;3;104;1;3;12;125;125;1;0;0;3;4;12;0;4214;4;1;
/org.eclipse.scripting/Eclipse Scripting/org/eclipse/scripting/internal/views/ScriptDevelopmentPreferencePageWorkbenchPreferences.java;2;0;5;1;0;0;0;5;12;1;5;133;21;21;1;0;0;5;5;133;0;1424;5;2;
/org.eclipse.pde.ui/src/org/eclipse/pde/internal/model/build/BuildObject.java;2;0;4;1;0;0;0;4;4;1;4;1434;6;6;1;0;0;4;4;1434;0;3579;4;2;
/org.eclipse.jdt.ui.tests.refactoring/resources/SelectionAnalyzerWorkSpace/SelectionAnalyzerTests/invalidSelection/A_test104.java;1;0;1;1;0;0;0;1;0;0;1;1368;0;0;1;0;0;1;1;1368;0;1368;1;1;
/org.eclipse.ui/Eclipse JFace/org/eclipse/jface/viewers/ICellModifier.java;3;0;3;1;1;1;1;2;16;1;2;257;21;21;1;0;0;2;3;257;0;4736;3;3;
/org.eclipse.pde.ui/templates/editor/java/XMLPartitionScanner.java;1;0;3;1;2;1;2;1;34;0;1;3812;34;34;2;0;1;1;3;4316;1;4316;2;1;
/org.eclipse.swt/Eclipse SWT/win32/org/eclipse/swt/internal/win32/DOCINFO.java;2;0;3;1;0;0;0;3;7;1;3;106;7;7;1;0;0;3;3;106;0;2069;3;2;
/org.eclipse.update.examples/src/org/eclipse/update/examples/freeform/FreeFormSiteFactory.java;2;0;4;1;0;0;0;4;49;2;3;3028;53;53;2;1;0;4;4;3570;1;3570;3;2;
/org.eclipse.ui/Eclipse UI/org/eclipse/ui/internal/LayoutTreeNode.java;3;0;7;1;1;1;1;6;166;1;6;257;293;293;1;0;0;6;7;257;0;4431;7;3;
/org.eclipse.pde.ui/src/org/eclipse/pde/internal/model/feature/FeatureObject.java;1;0;6;1;0;0;0;6;278;2;5;2951;288;288;2;1;0;6;6;2951;1;3579;5;1;
/org.eclipse.jdt.ui.tests.refactoring/resources/SefWorkSpace/SefTests/Y.java;1;0;1;1;0;0;0;1;0;0;1;2915;0;0;1;0;0;1;1;2915;0;2915;1;1;
/org.eclipse.ui/Eclipse UI Standard Components/org/eclipse/ui/wizards/datatransfer/FileSystemExportOperation.java;3;0;6;1;1;1;1;5;48;1;5;257;67;67;1;0;0;5;6;257;0;4329;6;3;
/org.eclipse.jdt.debug/eval/org/eclipse/jdt/internal/debug/eval/ast/instructions/UnsignedRightShiftOperator.java;3;0;7;1;1;1;1;6;36;1;6;3421;50;50;1;0;0;6;7;3421;0;3934;7;3;
/org.eclipse.jdt.ui.tests.refactoring/resources/MoveMembers/test23/out/B.java;1;0;1;1;0;0;0;1;0;0;1;2928;0;0;1;0;0;1;1;2928;0;2928;1;1;
/org.eclipse.debug.ui/ui/org/eclipse/debug/internal/ui/actions/ControlActionDelegate.java;2;0;8;2;0;0;0;8;71;2;7;2382;195;195;2;1;0;8;8;2589;1;2919;7;2;
/org.eclipse.jdt.debug.tests/test programs/org/eclipse/debug/tests/targets/InfiniteLoop.java;1;0;2;1;0;0;0;2;0;1;2;3701;0;0;1;0;0;2;2;3701;0;3719;2;1;
/org.eclipse.jdt.ui.tests.refactoring/resources/ExtractMethodWorkSpace/ExtractMethodTests/expression_in/A_test606.java;2;1;3;1;2;2;2;1;18;0;1;239;18;18;1;0;0;1;3;239;0;4419;3;2;
/org.eclipse.jdt.ui.tests.refactoring/resources/RenameType/test43/out/B.java;1;0;2;1;0;0;0;2;2;1;2;49;2;2;1;0;0;2;2;49;0;522;2;1;
/org.eclipse.jdt.debug/eval/org/eclipse/jdt/internal/debug/eval/ast/engine/XfixOperator.java;1;0;4;1;0;0;0;4;3;1;4;3329;5;5;1;0;0;4;4;3329;0;3421;4;1;
/org.eclipse.ui/Eclipse JFace Text/org/eclipse/jface/text/reconciler/MonoReconciler.java;2;1;4;1;2;2;2;2;72;1;2;1226;116;116;1;0;0;2;4;1226;0;4838;4;2;
/org.eclipse.jdt.ui.tests.refactoring/resources/RenameTemp/canRename/A_test0_in.java;1;0;2;1;0;0;0;2;2;1;2;1625;2;2;1;0;0;2;2;1625;0;1652;2;1;
/org.eclipse.update.ui/src/org/eclipse/update/internal/ui/search/SearchCategoryDescriptor.java;1;0;2;1;1;1;1;1;3;0;1;3553;3;3;1;0;0;1;2;3553;0;4288;2;1;
/org.eclipse.jdt.ui/ui/org/eclipse/jdt/internal/ui/reorg/JdtMoveAction.java;3;2;15;1;7;6;7;8;63;2;7;3222;239;239;2;1;1;8;15;3693;2;4630;13;3;
/org.eclipse.scripting/Eclipse Scripting/org/eclipse/scripting/internal/uirenderer/XGRWidgetRegistry.java;2;0;4;1;0;0;0;4;10;1;4;133;18;18;1;0;0;4;4;133;0;1424;4;2;
/org.eclipse.ui/Eclipse UI Standard Components/org/eclipse/ui/views/bookmarkexplorer/BookmarkContentProvider.java;3;0;3;1;0;0;0;3;5;1;3;257;7;7;1;0;0;3;3;257;0;620;3;3;
/org.eclipse.update.ui.forms/src/org/eclipse/update/ui/forms/internal/engine/HyperlinkSegment.java;1;0;5;1;2;1;2;3;46;2;2;2745;79;79;2;1;1;3;5;2745;2;4351;3;1;
/org.eclipse.jdt.debug.ui/ui/org/eclipse/jdt/internal/debug/ui/actions/JavaBreakpointPreferencePage.java;3;1;23;2;5;5;5;18;142;2;16;2707;573;573;2;2;0;18;23;2707;2;4527;21;3;
/org.eclipse.core.resources/src/org/eclipse/core/internal/indexing/ObjectStorePagePolicy.java;2;0;3;1;1;1;1;2;26;1;2;448;41;41;1;0;0;2;3;448;0;4214;3;2;
/org.eclipse.pde.ui/src/org/eclipse/pde/internal/editor/schema/SchemaSpecSection.java;1;0;3;1;0;0;0;3;3;1;3;3496;3;3;1;0;0;3;3;3496;0;3579;3;1;
/org.eclipse.jdt.core/codeassist/org/eclipse/jdt/internal/codeassist/select/SelectionOnSingleTypeReference.java;2;0;10;1;1;1;1;9;57;4;6;455;103;103;4;3;0;9;10;1039;3;4062;7;2;
/org.eclipse.scripting/src/org/eclipse/scripting/internal/ScriptLanguageDescriptor.java;1;0;1;1;0;0;0;1;0;0;1;1424;0;0;1;0;0;1;1;1424;0;1424;1;1;
/org.eclipse.jdt.core/dom/org/eclipse/jdt/core/dom/Javadoc.java;2;0;6;1;1;1;1;5;11;1;5;2669;24;24;1;0;0;5;6;2669;0;3942;6;2;
/org.eclipse.jdt.ui.tests.refactoring/resources/ExtractMethodWorkSpace/ExtractMethodTests/validSelection/A_test286.java;2;1;3;1;2;2;2;1;8;0;1;195;8;8;1;0;0;1;3;195;0;4419;3;2;
/org.eclipse.update.ui/src/org/eclipse/update/ui/internal/model/BackgroundProgressMonitor.java;1;0;4;1;0;0;0;4;107;2;3;1916;112;112;2;1;0;4;4;1916;1;2797;3;1;
/org.eclipse.jdt.ui/core refactoring/org/eclipse/jdt/internal/corext/refactoring/surround/SurroundWithTryCatchRefactoring.java;4;1;17;1;2;2;2;15;222;2;14;2327;466;466;2;1;0;15;17;3870;1;4000;16;4;
/org.eclipse.jdt.ui.tests.refactoring/resources/ExtractMethodWorkSpace/ExtractMethodTests/try_out/A_test450.java;2;1;6;1;2;2;2;4;28;1;4;65;35;35;1;0;0;4;6;65;0;4419;6;2;
/org.eclipse.pde.core/src/org/eclipse/pde/core/plugin/IPluginReference.java;1;0;4;1;2;1;2;2;52;1;2;3591;53;53;2;0;1;2;4;4751;1;4751;3;1;
/org.eclipse.jdt.ui.tests.refactoring/resources/SelectionAnalyzerWorkSpace/SelectionAnalyzerTests/validSelection/A_test249.java;1;0;1;1;0;0;0;1;0;0;1;1368;0;0;1;0;0;1;1;1368;0;1368;1;1;
/org.eclipse.jdt.debug/eval/org/eclipse/jdt/internal/debug/eval/ast/engine/PlusOperator.java;1;0;2;1;0;0;0;2;0;1;2;3329;0;0;1;0;0;2;2;3329;0;3421;2;1;
/org.eclipse.ui/Eclipse JFace Text/org/eclipse/jface/text/ITextViewerExtension.java;2;1;7;1;6;6;6;1;60;0;1;3592;126;126;1;0;0;1;7;3592;0;4838;7;2;
/org.eclipse.jdt.ui.tests.refactoring/resources/RenameParameters/canRename/A_test14_out.java;1;0;1;1;0;0;0;1;0;0;1;233;0;0;1;0;0;1;1;233;0;233;1;1;
/org.eclipse.team.ui/src/org/eclipse/team/internal/ui/target/GetAsAction.java;2;1;3;1;3;3;3;0;2;0;0;4256;4;4;1;0;0;0;3;4256;0;4636;3;2;
/org.eclipse.pde.ui/src/org/eclipse/pde/internal/launcher/AdvancedLauncherTab.java;1;0;7;1;0;0;0;7;85;1;7;3093;171;171;1;0;0;7;7;3093;0;3579;7;1;
/org.eclipse.ui/Eclipse UI Standard Components/org/eclipse/ui/wizards/datatransfer/WizardFileSystemExportPage1.java;3;0;3;1;0;0;0;3;45;1;3;257;46;46;1;0;0;3;3;257;0;2738;3;3;
/org.eclipse.jdt.core/compiler/org/eclipse/jdt/internal/compiler/ast/LongLiteralMinValue.java;2;1;4;1;2;2;2;2;41;1;2;455;56;56;1;0;0;2;4;455;0;4421;4;2;
/org.eclipse.jdt.ui/ui/org/eclipse/jdt/ui/wizards/NewPackageWizardPage.java;3;1;7;1;5;5;5;2;78;1;2;3089;107;107;1;0;0;2;7;3089;0;4852;7;3;
/org.eclipse.jdt.core/compiler/org/eclipse/jdt/internal/compiler/ast/ReturnStatement.java;2;1;18;1;2;2;2;16;443;4;11;455;558;558;4;5;0;16;18;1039;5;4421;13;2;
/org.eclipse.swt/Eclipse SWT/gtk/org/eclipse/swt/widgets/Text.java;6;3;31;2;13;11;13;18;289;2;14;2107;838;838;3;4;2;18;31;3957;6;4701;25;6;
/org.eclipse.help.ui/src/org/eclipse/help/internal/ui/IDocumentCompleteListener.java;2;0;4;1;0;0;0;4;8;1;4;1675;13;13;1;0;0;4;4;1675;0;3053;4;2;
/org.eclipse.pde.ui/src/org/eclipse/pde/internal/wizards/project/ConvertJavaToPDEProjectAction.java;2;0;3;1;0;0;0;3;91;1;3;1434;91;91;1;0;0;3;3;1434;0;3579;3;2;
/org.eclipse.team.ui/src/org/eclipse/team/ui/sync/SyncSet.java;2;0;6;1;1;1;1;5;65;1;5;2233;108;108;1;0;0;5;6;2233;0;4005;6;2;
/org.eclipse.jdt.ui.tests.refactoring/resources/SelectionAnalyzerWorkSpace/SelectionAnalyzerTests/validSelection/A_test247.java;1;0;1;1;0;0;0;1;0;0;1;1368;0;0;1;0;0;1;1;1368;0;1368;1;1;
/org.eclipse.jdt.debug.ui/ui/org/eclipse/jdt/internal/debug/ui/snippeteditor/JavaSnippetResultCollector.java;1;0;3;1;0;0;0;3;21;2;2;2620;21;21;2;1;0;3;3;2620;1;3517;2;1;
/org.eclipse.pde.ui/src/org/eclipse/pde/internal/editor/manifest/ManifestDependenciesPage.java;2;0;7;1;0;0;0;7;8;2;6;1434;16;16;2;1;0;7;7;2470;1;3579;6;2;
/org.eclipse.team.webdav/src/org/eclipse/team/internal/webdav/ui/TargetCreationWizard.java;1;1;2;1;2;2;2;0;0;0;0;4073;0;0;1;0;0;0;2;4073;0;4155;2;1;
/org.eclipse.ui/Eclipse JFace Text/org/eclipse/jface/text/reconciler/IReconcilingStrategy.java;3;0;3;1;0;0;0;3;28;1;3;257;33;33;1;0;0;3;3;257;0;1066;3;3;
/org.eclipse.jdt.ui/ui/org/eclipse/jdt/internal/ui/reorg/TypedSource.java;1;0;3;1;0;0;0;3;3;1;3;2064;5;5;1;0;0;3;3;2064;0;2212;3;1;
/org.eclipse.swt.examples.controls/src/org/eclipse/swt/examples/controls/ScrollableTab.java;2;0;2;1;0;0;0;2;0;1;2;391;0;0;1;0;0;2;2;391;0;611;2;2;
/org.eclipse.update/Eclipse Update/org/eclipse/update/internal/core/UMSessionManagerSession.java;2;0;4;1;0;0;0;4;6;1;4;108;10;10;1;0;0;4;4;108;0;1424;4;2;
/org.eclipse.jdt.ui/ui/org/eclipse/jdt/internal/ui/reorg/ResourceReorgSupport.java;3;0;7;1;0;0;0;7;10;1;7;15;33;33;1;0;0;7;7;15;0;1258;7;3;
/org.eclipse.ui/Eclipse UI Standard Components/org/eclipse/ui/wizards/newresource/BasicNewProjectResourceWizard.java;4;0;11;1;1;1;1;10;96;1;10;257;201;201;1;0;0;10;11;257;0;4429;11;4;
/org.eclipse.jdt.core/dom/org/eclipse/jdt/core/dom/SuperMethodInvocation.java;2;1;6;1;2;2;2;4;14;1;4;2669;43;43;1;0;0;4;6;2669;0;4453;6;2;
/org.eclipse.ui/Eclipse UI/org/eclipse/ui/internal/dialogs/FileSystemResourceExporter.java;2;0;2;1;0;0;0;2;5;1;2;257;5;5;1;0;0;2;2;257;0;457;2;2;
/org.eclipse.swt.examples/src/org/eclipse/swt/examples/addressbook/SearchDialog.java;4;0;4;1;1;1;1;3;196;1;3;513;203;203;1;0;0;3;4;513;0;4705;4;4;
/org.eclipse.swt/Eclipse SWT Custom Widgets/common/org/eclipse/swt/custom/LineStyleListener.java;4;0;6;1;1;1;1;5;7;1;5;106;23;23;1;0;0;5;6;106;0;4701;6;4;
/org.eclipse.jdt.debug.tests/tests/org/eclipse/jdt/debug/tests/eval/LocalVarAssignmentTests.java;2;2;3;2;3;2;3;0;17;0;0;4447;19;19;2;0;1;0;3;4447;1;4571;2;2;
/org.eclipse.search/search/org/eclipse/search/internal/ui/util/TypeFilteringDialog.java;1;0;7;1;0;0;0;7;12;2;6;1000;36;36;2;1;0;7;7;1000;1;3163;6;1;
/org.eclipse.jdt.ui/ui/org/eclipse/jdt/internal/ui/viewsupport/ErrorTickManager.java;1;0;3;1;0;0;0;3;197;2;2;1004;197;197;2;1;0;3;3;1004;1;1048;2;1;
/org.eclipse.ui/Eclipse UI Standard Components/org/eclipse/ui/views/navigator/WorkspaceActionGroup.java;1;0;4;1;1;1;1;3;66;1;3;3451;102;102;1;0;0;3;4;3451;0;4067;4;1;
/org.eclipse.pde.ui/src/org/eclipse/pde/internal/ui/parts/StructuredViewerPart.java;1;0;1;1;0;0;0;1;0;0;1;3579;0;0;1;0;0;1;1;3579;0;3579;1;1;
/org.eclipse.jdt.core/compiler/org/eclipse/jdt/core/compiler/IProblem.java;2;2;16;1;3;2;3;13;527;6;7;3071;899;899;6;6;1;13;16;3080;7;4419;9;2;
/org.eclipse.jdt.core/model/org/eclipse/jdt/internal/core/JavaProject.java;3;5;126;3;26;16;26;100;1344;5;69;455;7878;7878;5;31;10;100;126;3808;41;4568;85;3;
/org.eclipse.debug.ui/ui/org/eclipse/debug/internal/ui/ILaunchHistoryChangedListener.java;2;0;2;1;1;1;1;1;13;0;1;3875;13;13;1;0;0;1;2;3875;0;4567;2;2;
/org.eclipse.jdt.ui.tests.refactoring/resources/SefWorkSpace/SefTests/base_out/TestPrefixInt.java;1;0;1;1;0;0;0;1;0;0;1;2876;0;0;1;0;0;1;1;2876;0;2876;1;1;
/org.eclipse.update.core/src/org/eclipse/update/core/model/ModelObject.java;2;0;8;1;0;0;0;8;258;2;7;2409;440;440;2;1;0;8;8;2583;1;3591;7;2;
/org.eclipse.pde.ui/Eclipse PDE UI/org/eclipse/pde/internal/editor/manifest/PointGraphSection.java;2;0;6;2;0;0;0;6;12;3;4;267;14;14;3;2;0;6;6;324;2;1434;4;2;
/org.eclipse.team.tests.core/src/org/eclipse/team/tests/ftp/ClientTest.java;1;1;2;1;2;2;2;0;15;0;0;4169;23;23;1;0;0;0;2;4169;0;4186;2;1;
/org.eclipse.jdt.ui/ui/org/eclipse/jdt/internal/ui/packageview/PackageViewer.java;2;0;5;1;0;0;0;5;140;2;4;15;144;144;2;1;0;5;5;1004;1;1048;4;2;
/org.eclipse.swt/Eclipse SWT/motif/org/eclipse/swt/internal/motif/XtWidgetGeometry.java;2;0;3;1;0;0;0;3;4;1;3;106;4;4;1;0;0;3;3;106;0;2069;3;2;
/org.eclipse.swt/Eclipse SWT/gtk1x/org/eclipse/swt/widgets/Table.java;4;0;5;1;1;1;1;4;55;1;4;2107;86;86;1;0;0;4;5;2107;0;4701;5;4;
/org.eclipse.ui/Eclipse UI/org/eclipse/ui/internal/SavePerspectiveAction.java;5;0;5;1;0;0;0;5;43;1;5;257;70;70;1;0;0;5;5;257;0;3122;5;5;
/org.eclipse.pde.ui/src/org/eclipse/pde/internal/base/model/feature/IFeatureInstallHandler.java;1;0;3;1;0;0;0;3;6;1;3;2953;6;6;1;0;0;3;3;2953;0;3579;3;1;
/org.eclipse.pde.ui/src/org/eclipse/pde/internal/ui/util/ImageOverlayIcon.java;1;0;1;1;0;0;0;1;0;0;1;3579;0;0;1;0;0;1;1;3579;0;3579;1;1;
/org.eclipse.ui/Eclipse UI/org/eclipse/ui/internal/registry/WizardsRegistryReader.java;3;0;4;1;0;0;0;4;17;1;4;257;20;20;1;0;0;4;4;257;0;3720;4;3;
/org.eclipse.pde.ui/src/org/eclipse/pde/internal/codegen/StructuredJavaCodeGenerator.java;1;0;2;1;0;0;0;2;0;1;2;3240;0;0;1;0;0;2;2;3240;0;3579;2;1;
/org.eclipse.team.webdav/src/org/eclipse/team/internal/webdav/DavProvider.java;1;1;2;1;2;2;2;0;0;0;0;4023;0;0;1;0;0;0;2;4023;0;4073;2;1;
/org.eclipse.team.cvs.ui/src/org/eclipse/team/internal/ccvs/ui/HistoryView.java;3;2;50;2;9;7;9;41;190;4;33;1991;1407;1407;4;8;2;41;50;1991;10;4839;40;3;
/org.eclipse.pde.ui/Eclipse PDE UI/org/eclipse/pde/internal/base/schema/ISchemaEnumeration.java;2;0;5;2;0;0;0;5;12;3;3;267;12;12;3;2;0;5;5;324;2;1434;3;2;
/org.eclipse.core.resources/src/org/eclipse/core/internal/localstore/FileObject.java;1;0;1;1;0;0;0;1;0;0;1;653;0;0;1;0;0;1;1;653;0;653;1;1;
/org.eclipse.jdt.core/eval/org/eclipse/jdt/internal/eval/CodeSnippetConstantPool.java;2;0;13;1;1;1;1;12;3276;4;8;455;4730;4730;4;4;0;12;13;1039;4;4062;9;2;
/org.eclipse.core.tests.resources/src/org/eclipse/core/tests/internal/builders/AbstractBuilderTest.java;3;0;4;1;0;0;0;4;162;1;4;1794;182;182;1;0;0;4;4;1794;0;3420;4;3;
/org.eclipse.vcm.ui.cvs/src/org/eclipse/vcm/internal/ui/ccvs/FilteredProjectsCategory.java;1;0;2;1;0;0;0;2;18;1;2;1570;18;18;1;0;0;2;2;1570;0;1578;2;1;
/org.eclipse.update.ui.forms/src/org/eclipse/update/ui/forms/NoTabsWorkbook.java;1;0;2;1;0;0;0;2;0;1;2;1460;0;0;1;0;0;2;2;1460;0;2474;2;1;
/org.eclipse.core.target/src/org/eclipse/core/internal/target/ArrayEnumeration.java;1;0;4;1;1;1;1;3;94;1;3;12;115;115;1;0;0;3;4;12;0;4196;4;1;
/org.eclipse.jdt.ui.tests/ui/org/eclipse/jdt/ui/tests/UIInteractiveSuite.java;2;0;3;1;1;1;1;2;5;0;1;2182;9;9;2;1;0;2;3;2182;1;4426;2;2;
/org.eclipse.swt/Eclipse SWT Custom Widgets/common/org/eclipse/swt/custom/TableTree.java;4;3;19;1;7;5;7;12;206;2;10;106;504;504;3;2;2;12;19;4556;4;4701;15;4;
/org.eclipse.scripting/Eclipse Scripting/org/eclipse/scripting/internal/IXGRElementUIGridElement.java;2;0;4;1;0;0;0;4;6;1;4;133;10;10;1;0;0;4;4;133;0;1424;4;2;
/org.eclipse.jdt.debug.tests/tests/org/eclipse/jdt/debug/tests/core/InstanceVariableTests.java;3;1;6;1;4;4;4;2;34;1;2;3701;75;75;1;0;0;2;6;3701;0;4571;6;3;
/org.eclipse.jdt.ui.tests/JUnit/junit/util/TestSuiteLoader.java;2;0;2;1;0;0;0;2;0;1;2;49;0;0;1;0;0;2;2;49;0;1186;2;2;
/org.eclipse.ui/Eclipse UI/org/eclipse/ui/actions/OpenNewWindowMenu.java;3;0;3;1;0;0;0;3;13;1;3;257;14;14;1;0;0;3;3;257;0;3067;3;3;
/org.eclipse.ui/Eclipse UI/org/eclipse/ui/internal/ShowViewMenuAction.java;4;1;8;1;2;2;2;6;43;2;5;1915;91;91;2;1;0;6;8;3212;1;4608;7;4;
/org.eclipse.jdt.ui.tests.refactoring/resources/RenameParameters/canRename/A_test2_in.java;1;0;1;1;0;0;0;1;0;0;1;233;0;0;1;0;0;1;1;233;0;233;1;1;
/org.eclipse.swt/Eclipse SWT PI/motif/org/eclipse/swt/internal/motif/XFontStruct.java;2;0;2;1;1;1;1;1;6;0;1;2069;6;6;1;0;0;1;2;2069;0;4701;2;2;
/org.eclipse.vcm.ui/src/org/eclipse/vcm/internal/ui/syncdialog/TypedBufferedContent.java;2;0;2;1;0;0;0;2;0;1;2;1;0;0;1;0;0;2;2;1;0;68;2;2;
/org.eclipse.swt.examples.launcher/org/eclipse/swt/examples/launcher/URLHelper.java;1;0;1;1;0;0;0;1;0;0;1;513;0;0;1;0;0;1;1;513;0;513;1;1;
/org.eclipse.ui.tests/Eclipse JFace Tests/org/eclipse/jface/tests/viewers/StructuredItemViewerTest.java;1;0;2;1;0;0;0;2;10;1;2;1488;10;10;1;0;0;2;2;1488;0;2017;2;1;
/org.eclipse.ui/Eclipse UI/org/eclipse/ui/internal/ActionPresentation.java;2;0;3;1;0;0;0;3;12;1;3;257;21;21;1;0;0;3;3;257;0;3194;3;2;
/org.eclipse.jdt.core/codeassist/org/eclipse/jdt/internal/codeassist/select/SelectionOnExplicitConstructorCall.java;2;0;11;1;1;1;1;10;72;4;7;455;193;193;4;3;0;10;11;1039;3;4062;8;2;
/org.eclipse.update.ui.forms/src/org/eclipse/update/ui/forms/internal/IFormSelectionListener.java;1;0;1;1;0;0;0;1;0;0;1;2470;0;0;1;0;0;1;1;2470;0;2470;1;1;
/org.eclipse.swt/Eclipse SWT/motif/org/eclipse/swt/widgets/FontExtStyles.java;3;0;4;1;0;0;0;4;7;1;4;106;10;10;1;0;0;4;4;106;0;3006;4;3;
/org.eclipse.debug.ui/ui/org/eclipse/debug/ui/AbstractLaunchConfigurationTab.java;3;1;12;1;6;6;6;6;34;1;6;3086;161;161;1;0;0;6;12;3086;0;4349;12;3;
/org.eclipse.update.ui.forms/src/org/eclipse/update/ui/forms/internal/engine/IParagraphSegment.java;1;0;1;1;0;0;0;1;0;0;1;2745;0;0;1;0;0;1;1;2745;0;2745;1;1;
/org.eclipse.scripting/src/org/eclipse/scripting/ScriptAbstractPreferencePage.java;1;0;1;1;0;0;0;1;0;0;1;1424;0;0;1;0;0;1;1;1424;0;1424;1;1;
/org.eclipse.team.cvs.ui/src/org/eclipse/team/internal/ccvs/ui/sync/ToolTipMessageDialog.java;1;0;2;1;0;0;0;2;44;1;2;2251;44;44;1;0;0;2;2;2251;0;3102;2;1;
/org.eclipse.core.tests.resources/src/org/eclipse/core/tests/internal/watson/ElementTreeDeltaChainTest.java;3;0;3;1;1;1;1;2;312;1;2;1794;329;329;1;0;0;2;3;1794;0;4516;3;3;
/org.eclipse.core.tests.runtime/src/org/eclipse/core/tests/internal/plugins/FragmentResolveTest_11.java;2;0;2;1;0;0;0;2;10;1;2;3168;10;10;1;0;0;2;2;3168;0;3476;2;2;
/org.eclipse.jdt.debug.tests/tests/org/eclipse/jdt/debug/tests/core/MethodBreakpointTests.java;3;2;6;1;5;4;5;1;72;0;1;3701;113;113;2;0;1;1;6;4310;1;4454;5;3;
/org.eclipse.help.ui/src/org/eclipse/help/ui/internal/util/RuntimeErrorDialog.java;1;0;1;1;1;1;1;0;0;0;0;4439;0;0;1;0;0;0;1;4439;0;4439;1;1;
/org.eclipse.pde.ui/src/org/eclipse/pde/internal/editor/manifest/ExportSection.java;2;0;8;1;0;0;0;8;500;1;8;1434;534;534;1;0;0;8;8;1434;0;3579;8;2;
/org.eclipse.jdt.ui.tests.refactoring/resources/RenameType/test16/out/B.java;1;0;1;1;0;0;0;1;0;0;1;522;0;0;1;0;0;1;1;522;0;522;1;1;
/org.eclipse.debug.ui/ui/org/eclipse/debug/internal/ui/RemoveFromInspectorAction.java;2;0;6;1;0;0;0;6;10;1;6;187;28;28;1;0;0;6;6;187;0;2348;6;2;
/org.eclipse.pde.ui/src/org/eclipse/pde/internal/view/PluginsDragAdapter.java;1;0;2;1;0;0;0;2;0;1;2;3446;0;0;1;0;0;2;2;3446;0;3579;2;1;
/org.eclipse.team.cvs.ui/src/org/eclipse/team/internal/ccvs/ui/RepositoryManager.java;3;1;45;2;2;2;2;43;356;2;35;1997;1890;1890;2;8;0;43;45;2049;8;4121;37;3;
/org.eclipse.jdt.ui/core refactoring/org/eclipse/jdt/internal/corext/refactoring/util/ASTParentTrackingAdapter.java;3;0;5;1;0;0;0;5;26;1;5;1939;34;34;1;0;0;5;5;1939;0;3357;5;3;
/org.eclipse.webdav/src/interface/org/eclipse/webdav/IServer.java;2;0;4;1;1;1;1;3;918;1;3;1635;1394;1394;1;0;0;3;4;1635;0;4211;4;2;
/org.eclipse.pde.ui/src/org/eclipse/pde/internal/forms/renamed/FormText.java;1;0;2;1;0;0;0;2;0;1;2;2470;0;0;1;0;0;2;2;2470;0;2691;2;1;
/org.eclipse.pde.runtime/src/org/eclipse/pde/internal/runtime/registry/RegistryPropertySourceFactory.java;1;0;1;1;0;0;0;1;0;0;1;1434;0;0;1;0;0;1;1;1434;0;1434;1;1;
/org.eclipse.jdt.core/search/org/eclipse/jdt/internal/core/index/IDocument.java;2;1;3;1;2;2;2;1;14;0;1;455;16;16;1;0;0;1;3;455;0;4063;3;2;
/org.eclipse.swt.tests/JUnit Tests/org/eclipse/swt/tests/junit/Test_org_eclipse_swt_widgets_Event.java;2;0;2;1;1;1;1;1;6;0;1;1792;6;6;1;0;0;1;2;1792;0;4706;2;2;
/org.eclipse.pde.ui/src/org/eclipse/pde/internal/elements/DefaultContentProvider.java;2;0;2;1;0;0;0;2;0;1;2;1434;0;0;1;0;0;2;2;1434;0;3579;2;2;
/org.eclipse.jdt.ui/ui/org/eclipse/jdt/internal/ui/javaeditor/IPainter.java;1;0;3;1;0;0;0;3;10;1;3;3087;12;12;1;0;0;3;3;3087;0;3418;3;1;
/org.eclipse.jdt.debug.tests/test programs/Breakpoints.java;1;0;2;1;0;0;0;2;0;1;2;3701;0;0;1;0;0;2;2;3701;0;3719;2;1;
/org.eclipse.jdt.ui/ui/org/eclipse/jdt/internal/ui/javaeditor/SourceAttachmentDialog.java;1;0;1;1;1;1;1;0;0;0;0;4042;0;0;1;0;0;0;1;4042;0;4042;1;1;
/org.eclipse.vcm.ui/src/org/eclipse/vcm/internal/ui/merge/MergeWizard.java;4;0;7;2;0;0;0;7;21;2;6;1;32;32;2;1;0;7;7;297;1;573;6;4;
/org.eclipse.jdt.debug/model/org/eclipse/jdt/internal/debug/core/ITimeoutListener.java;2;0;4;1;0;0;0;4;5;1;4;187;6;6;1;0;0;4;4;187;0;2158;4;2;
/org.eclipse.jdt.ui.tests.refactoring/resources/StructureSelectionAction/A_test2.java;1;0;2;1;0;0;0;2;2;1;2;2139;2;2;1;0;0;2;2;2139;0;3020;2;1;
/org.eclipse.update.ui/src/org/eclipse/update/internal/ui/manager/FeatureSelectionForm.java;1;0;2;1;0;0;0;2;0;0;1;1457;0;0;2;1;0;2;2;1457;1;1457;1;1;
/org.eclipse.pde.ui/src/org/eclipse/pde/internal/model/jars/JarsModelFactory.java;2;0;2;1;0;0;0;2;0;1;2;1434;0;0;1;0;0;2;2;1434;0;2650;2;2;
/org.eclipse.jdt.ui/core refactoring/org/eclipse/jdt/internal/corext/refactoring/code/flow/MessageSendFlowInfo.java;1;0;2;1;0;0;0;2;11;1;2;2684;11;11;1;0;0;2;2;2684;0;3106;2;1;
/org.eclipse.jdt.core/model/org/eclipse/jdt/internal/core/PackageFragmentInfo.java;3;0;12;1;1;1;1;11;143;4;8;455;195;195;4;3;0;11;12;1039;3;4063;9;3;
/org.eclipse.ui/Eclipse UI/org/eclipse/ui/internal/Test.java;2;0;1;2;0;0;0;1;0;0;1;3156;0;0;1;0;0;1;1;3156;0;3156;1;2;
/org.eclipse.help.ui/src/org/eclipse/help/ui/internal/browser/win32/IEResources.java;1;0;3;1;1;1;1;2;126;1;2;2447;126;126;1;0;0;2;3;2447;0;4427;3;1;
/org.eclipse.vcm.ui/src/org/eclipse/vcm/internal/ui/actions/GlobalCatchupAction.java;2;0;2;1;0;0;0;2;0;1;2;1;0;0;1;0;0;2;2;1;0;161;2;2;
/org.eclipse.vcm.ui/src/org/eclipse/vcm/internal/ui/IProjectFilter.java;1;0;2;1;0;0;0;2;13;1;2;1424;13;13;1;0;0;2;2;1424;0;1436;2;1;
/org.eclipse.ui/Eclipse JFace Text/org/eclipse/jface/text/rules/MultiLineRule.java;3;0;3;1;0;0;0;3;5;1;3;257;8;8;1;0;0;3;3;257;0;1066;3;3;
/org.eclipse.jdt.debug/eval/org/eclipse/jdt/internal/debug/eval/ast/engine/ASTAPIVisitor.java;2;0;5;1;0;0;0;5;4360;1;5;3329;4480;4480;1;0;0;5;5;3329;0;3421;5;2;
/org.eclipse.team.cvs.ui/src/org/eclipse/team/internal/ccvs/ui/actions/RefreshFromLocalAction.java;2;0;4;1;0;0;0;4;20;1;4;2204;24;24;1;0;0;4;4;2204;0;2690;4;2;
/org.eclipse.jdt.ui/ui/org/eclipse/jdt/internal/ui/codemanipulation/IImportsStructure.java;2;0;4;1;0;0;0;4;14;1;4;144;18;18;1;0;0;4;4;144;0;2016;4;2;
/org.eclipse.pde.ui/src/org/eclipse/pde/internal/ui/editor/text/IColorManager.java;1;0;2;1;1;1;1;1;2;0;1;3579;2;2;1;0;0;1;2;3579;0;4588;2;1;
/org.eclipse.vcm.tests.core.cvs/src/org/eclipse/vcm/tests/core/cvs/CVSRepositoryLocationTest.java;2;0;2;1;0;0;0;2;51;1;2;1688;51;51;1;0;0;2;2;1688;0;1722;2;2;
/org.eclipse.vcm.ui/src/org/eclipse/vcm/internal/ui/syncdialog/ChangedVCMContainer.java;2;0;3;2;0;0;0;3;7;2;2;1;7;7;2;1;0;3;3;1;1;68;2;2;
/org.eclipse.swt/Eclipse SWT/motif/org/eclipse/swt/widgets/Scrollable.java;7;1;11;1;3;3;3;8;214;1;8;106;465;465;1;0;0;8;11;106;0;4701;11;7;
/org.eclipse.jdt.ui/core refactoring/org/eclipse/jdt/internal/corext/refactoring/util/WorkingCopyUtil.java;3;1;9;1;3;3;3;6;18;1;6;1939;57;57;1;0;0;6;9;1939;0;4400;9;3;
/org.eclipse.jdt.debug/eval/org/eclipse/jdt/internal/debug/eval/ast/engine/RemainderAssignmentOperator.java;1;0;2;1;0;0;0;2;0;1;2;3329;0;0;1;0;0;2;2;3329;0;3421;2;1;
/org.eclipse.jdt.launching/launching/org/eclipse/jdt/launching/PropertyChangeEvent.java;1;1;2;1;2;2;2;0;3;0;0;4168;3;3;1;0;0;0;2;4168;0;4191;2;1;
/org.eclipse.pde.ui/Eclipse PDE UI/org/eclipse/pde/internal/wizards/project/ProjectCodeGeneratorsPage.java;2;0;6;2;0;0;0;6;33;2;5;267;57;57;2;1;0;6;6;324;1;1434;5;2;
/org.eclipse.swt/Eclipse SWT/common/org/eclipse/swt/events/KeyAdapter.java;2;0;3;1;1;1;1;2;6;1;2;106;10;10;1;0;0;2;3;106;0;4701;3;2;
/org.eclipse.jdt.ui.tests/ui/com/ibm/jdt/internal/ui/dialogs/tests/StringInputDialogTest.java;1;0;3;1;0;0;0;3;4;1;3;255;4;4;1;0;0;3;3;255;0;522;3;1;
/org.eclipse.vcm.ui.cvs/src/org/eclipse/vcm/internal/ui/ccvs/FilterProjectsDialog.java;1;0;3;1;0;0;0;3;256;1;3;1147;256;256;1;0;0;3;3;1147;0;1387;3;1;
/org.eclipse.jdt.ui.tests.refactoring/resources/ExtractMethodWorkSpace/ExtractMethodTests/validSelection/A_test270.java;2;1;3;1;2;2;2;1;0;0;1;49;0;0;1;0;0;1;3;49;0;4419;3;2;
/org.eclipse.jdt.ui/core extension/org/eclipse/jdt/internal/corext/codemanipulation/PositionChecker.java;1;0;2;1;0;0;0;2;0;1;2;1983;0;0;1;0;0;2;2;1983;0;2133;2;1;
/org.eclipse.core.resources/src/org/eclipse/core/resources/IProjectNature.java;3;1;6;1;2;2;2;4;130;1;4;12;184;184;1;0;0;4;6;12;0;4214;6;3;
/org.eclipse.vcm.core/src/org/eclipse/vcm/internal/core/IVCMStatus.java;2;0;2;1;0;0;0;2;5;1;2;0;5;5;1;0;0;2;2;0;0;297;2;2;
/org.eclipse.swt/Eclipse SWT/gtk/org/eclipse/swt/widgets/ToolItem.java;6;1;34;2;14;14;14;20;344;3;15;2107;975;975;3;5;0;20;34;3629;5;4701;29;6;
/org.eclipse.jdt.ui.tests/refactoring/org/eclipse/jdt/refactoring/tests/AbstractSelectionTestCase.java;1;0;2;1;0;0;0;2;0;1;2;1368;0;0;1;0;0;2;2;1368;0;1896;2;1;
/org.eclipse.ui.externaltools/External Tools/org/eclipse/ui/externaltools/internal/ui/AntTreeLabelProvider.java;1;1;2;1;2;2;2;0;0;0;0;4090;0;0;1;0;0;0;2;4090;0;4145;2;1;
/org.eclipse.pde.ui/src/org/eclipse/pde/internal/ui/editor/manifest/PluginAdapterFactory.java;1;0;3;1;0;0;0;3;10;2;2;3579;12;12;2;1;0;3;3;3579;1;3591;2;1;
/org.eclipse.pde.ui/src/org/eclipse/pde/internal/ui/editor/manifest/ExtensionPointPropertySource.java;1;0;2;1;0;0;0;2;2;0;1;3579;2;2;2;1;0;2;2;3579;1;3579;1;1;
/org.eclipse.pde.ui/src/org/eclipse/pde/internal/ArraySorter.java;2;0;3;1;0;0;0;3;6;1;3;1434;6;6;1;0;0;3;3;1434;0;2691;3;2;
/org.eclipse.help.ui/Eclipse Help UI/org/eclipse/help/internal/ui/search/HelpSearchQuery.java;2;0;4;1;0;0;0;4;7;1;4;136;10;10;1;0;0;4;4;136;0;1055;4;2;
/org.eclipse.jdt.ui.vcm/vcm/org/eclipse/jdt/ui/vcm/JavaVCMLabelDecorator.java;3;0;4;1;0;0;0;4;15;1;4;419;17;17;1;0;0;4;4;419;0;3627;4;3;
/org.eclipse.pde.ui/src/org/eclipse/pde/internal/wizards/project/OpenProjectWizardAction.java;1;0;2;1;0;0;0;2;0;1;2;3403;0;0;1;0;0;2;2;3403;0;3579;2;1;
/org.eclipse.swt.tests/JUnit Tests/org/eclipse/swt/tests/junit/Test_org_eclipse_swt_custom_LineStyleListener.java;2;0;2;1;1;1;1;1;6;0;1;1792;6;6;1;0;0;1;2;1792;0;4706;2;2;
/org.eclipse.swt.examples.paint/src/org/eclipse/swt/examples/paint/MetaContainer.java;1;0;1;1;0;0;0;1;0;0;1;512;0;0;1;0;0;1;1;512;0;512;1;1;
/org.eclipse.swt/Eclipse SWT OLE Win32/win32/org/eclipse/swt/ole/win32/OleAutomation.java;2;1;7;1;3;3;3;4;142;1;4;106;202;202;1;0;0;4;7;106;0;4701;7;2;
/org.eclipse.jdt.ui/ui/org/eclipse/jdt/internal/ui/packageview/GotoTypeAction.java;6;0;14;2;1;1;1;13;24;2;11;281;107;107;2;2;0;13;14;281;2;4160;12;6;
/org.eclipse.jdt.core/model/org/eclipse/jdt/internal/core/builder/WorkQueue.java;3;0;3;2;2;1;2;1;19;0;1;2979;19;19;2;0;1;1;3;4063;1;4063;2;3;
/org.eclipse.update.ui/src/org/eclipse/update/ui/internal/model/AvailableUpdates.java;3;0;14;1;0;0;0;14;113;2;11;1905;252;252;2;3;0;14;14;1916;3;2797;11;3;
/org.eclipse.core.tests.runtime/src/org/eclipse/core/tests/internal/plugins/FragmentResolveTest_10.java;3;0;4;1;0;0;0;4;338;1;4;1819;350;350;1;0;0;4;4;1819;0;3476;4;3;
/org.eclipse.pde.ui/src/org/eclipse/pde/internal/wizards/WizardCollectionElement.java;2;0;3;1;0;0;0;3;2;1;3;1434;2;2;1;0;0;3;3;1434;0;3579;3;2;
/org.eclipse.vcm.core.cvs/src/org/eclipse/vcm/internal/core/ccvs/IUserInfo.java;3;0;3;1;0;0;0;3;32;1;3;0;37;37;1;0;0;3;3;0;0;1262;3;3;
/org.eclipse.jdt.ui/ui/org/eclipse/jdt/internal/ui/wizards/dialogfields/LayoutUtil.java;2;0;8;1;0;0;0;8;56;1;8;15;140;140;1;0;0;8;8;15;0;3084;8;2;
/org.eclipse.swt/Eclipse SWT/common/org/eclipse/swt/events/DisposeListener.java;4;0;5;1;1;1;1;4;6;1;4;106;18;18;1;0;0;4;5;106;0;4701;5;4;
/org.eclipse.pde.ui/src/org/eclipse/pde/internal/util/OverlayIcon.java;1;0;3;1;0;0;0;3;95;1;3;2691;95;95;1;0;0;3;3;2691;0;3579;3;1;
/org.eclipse.pde.ui/src/org/eclipse/pde/internal/editor/build/BuildEditorContributor.java;2;0;2;1;0;0;0;2;0;1;2;1434;0;0;1;0;0;2;2;1434;0;3579;2;2;
/org.eclipse.core.resources/src/org/eclipse/core/resources/ResourcesPlugin.java;3;1;11;1;2;2;2;9;318;1;9;12;423;423;1;0;0;9;11;12;0;4214;11;3;
/org.eclipse.core.tests.runtime/src/org/eclipse/core/tests/internal/plugins/PluginResolveTest_25.java;3;0;3;1;0;0;0;3;86;1;3;1794;96;96;1;0;0;3;3;1794;0;3476;3;3;
/org.eclipse.pde.ui/src/org/eclipse/pde/internal/model/Plugin.java;2;0;7;1;0;0;0;7;92;2;5;1434;116;116;2;2;0;7;7;2730;2;3134;5;2;
/org.eclipse.jdt.ui.tests.refactoring/resources/ExtractMethodWorkSpace/ExtractMethodTests/locals_out/A_test543.java;1;1;5;1;2;2;2;3;4;1;3;922;8;8;1;0;0;3;5;922;0;4419;5;1;
/org.eclipse.jdt.ui.tests.refactoring/resources/RenameNonPrivateField/test16/out/A.java;1;0;1;1;1;1;1;0;0;0;0;4742;0;0;1;0;0;0;1;4742;0;4742;1;1;
/org.eclipse.pde.ui/src/org/eclipse/pde/internal/editor/schema/NewCompositorAction.java;2;0;2;1;0;0;0;2;0;1;2;1434;0;0;1;0;0;2;2;1434;0;3579;2;2;
/org.eclipse.jdt.ui/core refactoring/org/eclipse/jdt/internal/core/refactoring/code/ExceptionAnalyzer.java;3;0;10;1;0;0;0;10;95;2;9;408;197;197;2;1;0;10;10;922;1;1939;9;3;
/org.eclipse.core.tests.runtime/src/org/eclipse/core/tests/internal/runtimetests/SampleGFR.java;1;0;2;1;0;0;0;2;10;1;2;3611;10;10;1;0;0;2;2;3611;0;3678;2;1;
/org.eclipse.jdt.ui/core refactoring/org/eclipse/jdt/internal/corext/refactoring/code/ImportAnalyzer.java;1;0;2;1;0;0;0;2;0;1;2;1939;0;0;1;0;0;2;2;1939;0;2137;2;1;
/org.eclipse.pde.build/src/plugin/org/eclipse/pde/internal/core/FetchScriptGenerator.java;1;0;1;1;0;0;0;1;0;0;1;3475;0;0;1;0;0;1;1;3475;0;3475;1;1;
/org.eclipse.jdt.ui.tests.refactoring/resources/ExtractMethodWorkSpace/ExtractMethodTests/invalidSelection/A_test093.java;2;1;3;1;2;2;2;1;0;0;1;49;0;0;1;0;0;1;3;49;0;4419;3;2;
/org.eclipse.swt.tests/JUnit Tests/org/eclipse/swt/tests/junit/Test_org_eclipse_swt_events_HelpEvent.java;2;0;2;1;1;1;1;1;6;0;1;1792;6;6;1;0;0;1;2;1792;0;4706;2;2;
/org.eclipse.jdt.ui.tests.refactoring/resources/RenameTemp/canRename/A_test46_out.java;1;0;1;1;0;0;0;1;0;0;1;3356;0;0;1;0;0;1;1;3356;0;3356;1;1;
/org.eclipse.swt/Eclipse SWT PI/win32/org/eclipse/swt/internal/win32/TOOLINFO.java;2;0;2;1;1;1;1;1;6;0;1;2069;6;6;1;0;0;1;2;2069;0;4701;2;2;
/org.eclipse.update.ui.forms/src/org/eclipse/update/ui/forms/IFormSelectionListener.java;1;0;2;1;0;0;0;2;0;1;2;1423;0;0;1;0;0;2;2;1423;0;2474;2;1;
/org.eclipse.pde.ui/Eclipse PDE UI/org/eclipse/pde/internal/elements/ElementList.java;2;0;5;2;0;0;0;5;12;3;3;267;12;12;3;2;0;5;5;324;2;1434;3;2;
/org.eclipse.help/src/org/eclipse/help/internal/topics/Link.java;1;0;2;1;0;0;0;2;0;1;2;1804;0;0;1;0;0;2;2;1804;0;1857;2;1;
/org.eclipse.jdt.ui.tests.refactoring/resources/RenameMethodInInterface/testFail7/in/A.java;1;0;1;1;0;0;0;1;0;0;1;49;0;0;1;0;0;1;1;49;0;49;1;1;
/org.eclipse.team.cvs.ui/src/org/eclipse/team/internal/ccvs/ui/HistoryFilterAction.java;2;0;2;1;1;1;1;1;98;0;1;3380;98;98;1;0;0;1;2;3380;0;4545;2;2;
/org.eclipse.pde.ui/src/org/eclipse/pde/model/IModelChangedListener.java;1;0;2;1;0;0;0;2;0;1;2;3039;0;0;1;0;0;2;2;3039;0;3579;2;1;
/org.eclipse.scripting/src/org/eclipse/scripting/internal/views/ScriptUIEditorSourceViewerConfiguration.java;1;0;1;1;0;0;0;1;0;0;1;1424;0;0;1;0;0;1;1;1424;0;1424;1;1;
/org.eclipse.pde.ui/src/org/eclipse/pde/internal/ui/editor/NullUndoManager.java;1;0;3;1;0;0;0;3;7;0;1;3579;7;7;3;2;0;3;3;3579;2;3579;1;1;
/org.eclipse.pde.runtime/src/org/eclipse/pde/internal/runtime/registry/PrerequisitePropertySource.java;2;0;2;1;1;1;1;1;117;0;1;1434;117;117;1;0;0;1;2;1434;0;4369;2;2;
/org.eclipse.jdt.ui/ui/org/eclipse/jdt/internal/ui/javadocexport/JavadocStandardWizardPage.java;3;2;7;2;5;4;5;2;78;1;2;3717;108;108;2;0;1;2;7;4400;1;4630;6;3;
/org.eclipse.jdt.ui/ui/org/eclipse/jdt/internal/ui/javaeditor/ISavePolicy.java;2;0;3;1;0;0;0;3;6;1;3;15;11;11;1;0;0;3;3;15;0;889;3;2;
/org.eclipse.jdt.ui.tests.refactoring/resources/ExtractTemp/canExtract/A_test12_in.java;1;0;1;1;0;0;0;1;0;0;1;2481;0;0;1;0;0;1;1;2481;0;2481;1;1;
/org.eclipse.pde.ui/src/org/eclipse/pde/internal/ui/editor/PDESourcePage.java;1;0;2;1;0;0;0;2;3;1;2;3579;3;3;1;0;0;2;2;3579;0;3802;2;1;
/org.eclipse.ui/Eclipse JFace/org/eclipse/jface/dialogs/IDialogConstants.java;4;0;4;1;0;0;0;4;38;1;4;257;44;44;1;0;0;4;4;257;0;3837;4;4;
/org.eclipse.pde.ui/src/org/eclipse/pde/internal/core/ifeature/IFeatureModelFactory.java;1;0;2;1;0;0;0;2;0;1;2;3591;0;0;1;0;0;2;2;3591;0;3607;2;1;
/org.eclipse.update.ui.forms/src/org/eclipse/update/ui/forms/internal/FormsPlugin.java;1;1;2;1;2;2;2;0;47;0;0;4217;47;47;1;0;0;0;2;4217;0;4370;2;1;
/org.eclipse.team.cvs.core/src/org/eclipse/team/internal/ccvs/core/client/ImportStructureVisitor.java;2;0;10;2;0;0;0;10;124;2;9;2572;185;185;2;1;0;10;10;3089;1;3610;9;2;
/org.eclipse.jdt.ui/ui refactoring/org/eclipse/jdt/internal/ui/nls/search/GroupByKeyComputer.java;1;0;2;1;0;0;0;2;0;1;2;1913;0;0;1;0;0;2;2;1913;0;1922;2;1;
/org.eclipse.jdt.debug/jdi/org/eclipse/jdi/internal/connect/SocketTransportImpl.java;2;0;6;1;0;0;0;6;17;1;6;187;40;40;1;0;0;6;6;187;0;3677;6;2;
/org.eclipse.jdt.ui.tests.refactoring/resources/MoveMembers/test10/in/B.java;1;0;1;1;0;0;0;1;0;0;1;2738;0;0;1;0;0;1;1;2738;0;2738;1;1;
/org.eclipse.swt/Eclipse SWT/common/org/eclipse/swt/events/ControlListener.java;4;0;5;1;1;1;1;4;6;1;4;106;18;18;1;0;0;4;5;106;0;4701;5;4;
/org.eclipse.jdt.ui.tests.refactoring/resources/RenameType/testFail2/in/A.java;1;0;1;1;0;0;0;1;0;0;1;49;0;0;1;0;0;1;1;49;0;49;1;1;
/org.eclipse.jdt.ui.tests.refactoring/resources/AbstractField/can/A_test0_in.java;1;0;1;1;0;0;0;1;0;0;1;751;0;0;1;0;0;1;1;751;0;751;1;1;
/org.eclipse.jdt.ui/core refactoring/org/eclipse/jdt/internal/core/nls/model/NLSHolder.java;1;0;2;1;0;0;0;2;0;1;2;1913;0;0;1;0;0;2;2;1913;0;1922;2;1;
/org.eclipse.jdt.ui/core refactoring/org/eclipse/jdt/internal/corext/refactoring/changes/TextFileChange.java;1;0;6;1;0;0;0;6;20;2;5;1939;55;55;2;1;0;6;6;2133;1;3590;5;1;
/org.eclipse.ui/Eclipse UI Text Editor/org/eclipse/ui/texteditor/MarkerAnnotation.java;4;1;7;1;3;3;3;4;169;1;4;257;242;242;1;0;0;4;7;257;0;4838;7;4;
/org.eclipse.scripting/src/org/eclipse/scripting/internal/IXGRElementEventGeneratorOnChange.java;1;0;1;1;0;0;0;1;0;0;1;1424;0;0;1;0;0;1;1;1424;0;1424;1;1;
/org.eclipse.swt/Eclipse SWT/motif/org/eclipse/swt/graphics/GC.java;9;1;21;1;4;4;4;17;924;1;17;106;1872;1872;1;0;0;17;21;106;0;4701;21;9;
/org.eclipse.update.core/src/org/eclipse/update/core/model/DefaultFeatureParser.java;2;1;30;1;8;8;8;22;1282;2;19;2409;4241;4241;2;3;0;22;30;2858;3;4468;27;2;
/org.eclipse.pde.junit/src/org/eclipse/pde/internal/junit/ui/CoreTestApplication.java;1;0;1;1;0;0;0;1;0;0;1;3171;0;0;1;0;0;1;1;3171;0;3171;1;1;
/org.eclipse.jdt.ui.tests.refactoring/resources/MoveMembers/test10/out/B.java;1;0;1;1;0;0;0;1;0;0;1;2738;0;0;1;0;0;1;1;2738;0;2738;1;1;
/org.eclipse.jdt.ui/ui/org/eclipse/jdt/internal/ui/launcher/J9DebugLauncher.java;1;0;8;1;0;0;0;8;23;2;7;15;50;50;2;1;0;8;8;218;1;323;7;1;
/org.eclipse.jdt.ui/ui/org/eclipse/jdt/internal/ui/reorg/PackageReorgSupport.java;3;0;7;1;0;0;0;7;14;2;6;15;36;36;2;1;0;7;7;25;1;1258;6;3;
/org.eclipse.team.cvs.core/src/org/eclipse/team/ccvs/core/CVSCommandOptions.java;2;0;2;1;0;0;0;2;0;1;2;2420;0;0;1;0;0;2;2;2420;0;2620;2;2;
/org.eclipse.team.core/src/org/eclipse/team/core/ITeamManager.java;2;0;3;1;0;0;0;3;277;1;3;1978;277;277;1;0;0;3;3;1978;0;3213;3;2;
/org.eclipse.core.tests.runtime/src/org/eclipse/core/tests/internal/plugins/PlatformURLPerformanceTestConnection.java;3;0;3;1;0;0;0;3;112;1;3;1794;122;122;1;0;0;3;3;1794;0;3476;3;3;
/org.eclipse.vcm.core/src/org/eclipse/vcm/internal/core/base/VCMPlugin.java;3;0;5;1;0;0;0;5;37;1;5;0;52;52;1;0;0;5;5;0;0;373;5;3;
/org.eclipse.jdt.debug/model/org/eclipse/jdt/internal/debug/core/EventDispatcher.java;3;0;23;2;1;1;1;22;151;2;20;187;722;722;2;2;0;22;23;1451;2;3941;21;3;
/org.eclipse.jdt.ui/ui/org/eclipse/jdt/internal/ui/javaeditor/JavaEditorMessages.java;3;0;5;1;0;0;0;5;9;1;5;759;21;21;1;0;0;5;5;759;0;3465;5;3;
/org.eclipse.swt/Eclipse SWT/gtk1x/org/eclipse/swt/widgets/MessageBox.java;5;0;5;1;1;1;1;4;484;1;4;2107;494;494;1;0;0;4;5;2107;0;4701;5;5;
/org.eclipse.compare/compare/org/eclipse/compare/structuremergeviewer/StructureDiffViewer.java;2;1;18;1;2;2;2;16;75;2;15;14;298;298;2;1;0;16;18;2681;1;4853;17;2;
/org.eclipse.ui/Eclipse UI Standard Components/org/eclipse/ui/wizards/newresource/BasicNewResourceWizard.java;3;0;5;1;1;1;1;4;50;1;4;257;74;74;1;0;0;4;5;257;0;4082;5;3;
/org.eclipse.jdt.ui/ui/org/eclipse/jdt/ui/actions/FindImplementorsAction.java;2;1;2;1;2;2;2;0;9;0;0;4141;9;9;1;0;0;0;2;4141;0;4770;2;2;
/org.eclipse.jdt.ui.tests.refactoring/test cases/org/eclipse/jdt/ui/tests/refactoring/UndoManagerTests.java;2;0;3;1;0;0;0;3;8;1;3;1896;12;12;1;0;0;3;3;1896;0;1939;3;2;
/org.eclipse.scripting/src/org/eclipse/scripting/internal/views/ScriptUIEditorDesigner.java;1;0;1;1;0;0;0;1;0;0;1;1424;0;0;1;0;0;1;1;1424;0;1424;1;1;
/org.eclipse.jdt.core/model/org/eclipse/jdt/internal/core/hierarchy/HierarchyType.java;2;0;2;1;1;1;1;1;19;0;1;2790;19;19;1;0;0;1;2;2790;0;4063;2;2;
/org.eclipse.update.ui/src/org/eclipse/update/ui/internal/manager/MainPage.java;1;0;2;1;0;0;0;2;0;0;1;1426;0;0;2;1;0;2;2;1426;1;1426;1;1;
/org.eclipse.ui/Eclipse UI Standard Components/org/eclipse/ui/views/bookmarkexplorer/BookmarkMessages.java;1;0;1;1;0;0;0;1;0;0;1;457;0;0;1;0;0;1;1;457;0;457;1;1;
/org.eclipse.swt/Eclipse SWT OLE Win32/win32/org/eclipse/swt/internal/ole/win32/DVTARGETDEVICE.java;2;0;3;1;0;0;0;3;5;1;3;106;5;5;1;0;0;3;3;106;0;2069;3;2;
/org.eclipse.jdt.ui.tests.refactoring/resources/ExtractMethodWorkSpace/ExtractMethodTests/validSelection/A_test249.java;2;1;3;1;2;2;2;1;8;0;1;195;8;8;1;0;0;1;3;195;0;4419;3;2;
/org.eclipse.swt/Eclipse SWT PI/motif/org/eclipse/swt/internal/motif/XWindowEvent.java;2;0;2;1;1;1;1;1;6;0;1;2069;6;6;1;0;0;1;2;2069;0;4701;2;2;
/org.eclipse.jdt.ui/core refactoring/org/eclipse/jdt/internal/core/refactoring/nls/Utils.java;2;0;2;1;0;0;0;2;0;1;2;1922;0;0;1;0;0;2;2;1922;0;1939;2;2;
/org.eclipse.scripting.examples/Eclipse Scripting Examples/org/eclipse/scripting/examples/ExcaliburStringScriptEventHandler.java;1;0;3;1;0;0;0;3;4;1;3;134;4;4;1;0;0;3;3;134;0;1424;3;1;
/org.eclipse.webdav/src/interface/org/eclipse/webdav/ILocator.java;2;0;4;1;1;1;1;3;134;1;3;1635;216;216;1;0;0;3;4;1635;0;4211;4;2;
/org.eclipse.jdt.ui/ui/org/eclipse/jdt/internal/ui/reorg/ListDialog.java;2;0;3;1;0;0;0;3;4;1;3;15;4;4;1;0;0;3;3;15;0;1258;3;2;
/org.eclipse.jdt.debug/jdi interfaces/com/sun/jdi/event/StepEvent.java;2;0;2;1;0;0;0;2;8;1;2;2704;8;8;1;0;0;2;2;2704;0;3040;2;2;
/org.eclipse.vcm.core.cvs/src/org/eclipse/vcm/internal/core/ccvs/requests/RemoveEntryHandler.java;3;0;3;1;0;0;0;3;13;1;3;0;19;19;1;0;0;3;3;0;0;298;3;3;
/org.eclipse.pde.ui/src/org/eclipse/pde/internal/wizards/project/ProjectCodeGeneratorsPage.java;2;0;9;1;0;0;0;9;403;2;8;1434;429;429;2;1;0;9;9;2691;1;3579;8;2;
/org.eclipse.scripting/src/org/eclipse/scripting/internal/IXGRReader.java;1;0;1;1;0;0;0;1;0;0;1;1424;0;0;1;0;0;1;1;1424;0;1424;1;1;
/org.eclipse.update/src/org/eclipse/update/internal/ui/UMPreferencePageSettings.java;1;0;1;1;0;0;0;1;0;0;1;1424;0;0;1;0;0;1;1;1424;0;1424;1;1;
/org.eclipse.jdt.debug/jdi interfaces/com/sun/jdi/NativeMethodException.java;2;0;2;1;0;0;0;2;7;1;2;2704;7;7;1;0;0;2;2;2704;0;3033;2;2;
/org.eclipse.pde.ui/src/org/eclipse/pde/internal/model/IModelProviderEvent.java;1;0;2;1;0;0;0;2;0;1;2;3136;0;0;1;0;0;2;2;3136;0;3579;2;1;
/org.eclipse.pde.ui/src/org/eclipse/pde/core/plugin/IPluginModel.java;1;0;3;1;0;0;0;3;4;2;2;3579;4;4;2;1;0;3;3;3579;1;3607;2;1;
/org.eclipse.pde.ui/src/org/eclipse/pde/internal/ui/launcher/WorkbenchLaunchConfigurationDelegate.java;1;2;17;1;12;11;12;5;113;1;5;3579;301;301;2;0;1;5;17;4333;1;4823;16;1;
/org.eclipse.swt/Eclipse SWT/win32/org/eclipse/swt/internal/win32/POINT.java;2;0;3;1;0;0;0;3;5;1;3;106;5;5;1;0;0;3;3;106;0;2069;3;2;
/org.eclipse.jdt.ui.tests.refactoring/resources/MoveMembers/test16/out/B.java;1;0;1;1;0;0;0;1;0;0;1;2738;0;0;1;0;0;1;1;2738;0;2738;1;1;
/org.eclipse.team.ftp/src/org/eclipse/team/internal/ftp/client/PortDataTransferManager.java;1;1;3;1;3;3;3;0;2;0;0;4169;2;2;1;0;0;0;3;4169;0;4573;3;1;
/org.eclipse.update.ui.forms/src/org/eclipse/update/ui/forms/HyperlinkAdapter.java;1;0;2;1;0;0;0;2;0;1;2;1423;0;0;1;0;0;2;2;1423;0;2474;2;1;
/org.eclipse.pde.build/src/org/eclipse/pde/internal/build/SourceBuildScriptGenerator.java;1;1;3;1;2;2;2;1;2;0;1;3672;2;2;1;0;0;1;3;3672;0;4082;3;1;
/org.eclipse.jdt.ui.tests.refactoring/resources/RenameVirtualMethodInClass/testFail28/in/A.java;1;0;1;1;0;0;0;1;0;0;1;49;0;0;1;0;0;1;1;49;0;49;1;1;
/org.eclipse.vcm.ui.cvs/src/org/eclipse/vcm/internal/ui/ccvs/FilterStreamMainPage.java;3;0;6;1;0;0;0;6;307;1;6;1057;680;680;1;0;0;6;6;1057;0;1578;6;3;
/org.eclipse.debug.ui/ui/org/eclipse/debug/internal/ui/actions/RelaunchHistoryLaunchAction.java;3;1;6;1;2;2;2;4;11;1;4;2382;22;22;1;0;0;4;6;2382;0;4423;6;3;
/org.eclipse.jdt.ui.tests.refactoring/resources/SurroundWithWorkSpace/SurroundWithTests/trycatch_out/TestExpression.java;1;0;1;1;0;0;0;1;0;0;1;3870;0;0;1;0;0;1;1;3870;0;3870;1;1;
/org.eclipse.jdt.ui.tests.refactoring/resources/ExtractMethodWorkSpace/ExtractMethodTests/nested_in/A_test654.java;1;1;3;1;2;2;2;1;16;0;1;2327;16;16;1;0;0;1;3;2327;0;4419;3;1;
/org.eclipse.jdt.debug.ui/ui/org/eclipse/jdt/internal/debug/ui/actions/BreakpointLocationVerifier.java;1;0;11;1;0;0;0;11;135;3;8;2056;296;296;3;3;0;11;11;2447;3;3568;8;1;
/org.eclipse.update.examples/src/org/eclipse/update/examples/SampleAction.java;1;0;2;1;0;0;0;2;0;1;2;1424;0;0;1;0;0;2;2;1424;0;2583;2;1;
/org.eclipse.jdt.ui.tests.refactoring/resources/RenameMethodInInterface/test6/out/A.java;1;0;1;1;0;0;0;1;0;0;1;49;0;0;1;0;0;1;1;49;0;49;1;1;
/org.eclipse.ui/Eclipse JFace Text/org/eclipse/jface/text/rules/DefaultPartitioner.java;1;0;3;1;1;1;1;2;35;1;2;3812;64;64;1;0;0;2;3;3812;0;4838;3;1;
/org.eclipse.jdt.ui.tests.refactoring/resources/PullUp/test19/out/A.java;1;0;2;1;2;1;2;0;6;0;0;4450;6;6;2;0;1;0;2;4450;1;4450;1;1;
/org.eclipse.scripting/src/org/eclipse/scripting/internal/ScriptToolkitUI.java;1;0;1;1;0;0;0;1;0;0;1;1424;0;0;1;0;0;1;1;1424;0;1424;1;1;
/org.eclipse.help/Eclipse Help/org/eclipse/help/internal/ContextImpl.java;2;0;3;1;0;0;0;3;7;1;3;135;7;7;1;0;0;3;3;135;0;1420;3;2;
/org.eclipse.jdt.core/search/org/eclipse/jdt/internal/core/index/impl/SimpleIndexInput.java;3;1;6;1;2;2;2;4;87;1;4;455;181;181;1;0;0;4;6;455;0;4063;6;3;
/org.eclipse.jdt.ui/core refactoring/org/eclipse/jdt/internal/corext/refactoring/structure/ModifyParametersRefactoring.java;1;0;3;1;0;0;0;3;38;1;3;2933;55;55;1;0;0;3;3;2933;0;3569;3;1;
/org.eclipse.jdt.core/model/org/eclipse/jdt/core/ClasspathContainerInitializer.java;2;2;7;1;4;3;4;3;33;2;2;3850;45;45;2;1;1;3;7;3872;2;4451;5;2;
/org.eclipse.jdt.debug.tests/testprograms/org/eclipse/debug/tests/targets/HitCountLooper.java;2;0;2;1;1;1;1;1;11;0;1;3719;11;11;1;0;0;1;2;3719;0;4571;2;2;
/org.eclipse.jdt.ui/ui/org/eclipse/jdt/internal/ui/packageview/PackageFrame.java;1;0;3;1;0;0;0;3;4;1;3;213;4;4;1;0;0;3;3;213;0;390;3;1;
/org.eclipse.jdt.ui/core refactoring/org/eclipse/jdt/internal/corext/refactoring/changes/TextBufferChange.java;1;0;3;1;0;0;0;3;18;2;2;1939;18;18;2;1;0;3;3;2133;1;2133;2;1;
/org.eclipse.team.ui/src/org/eclipse/team/internal/ui/sync/ChangedTeamContainer.java;2;0;5;2;2;1;2;3;30;2;2;2054;53;53;2;1;1;3;5;2231;2;4005;3;2;
/org.eclipse.swt/Eclipse SWT/carbon/org/eclipse/swt/widgets/Display.java;4;1;6;2;6;6;6;0;134;0;0;4147;275;275;1;0;0;0;6;4147;0;4701;6;4;
/org.eclipse.compare/compare/org/eclipse/compare/internal/DocLineComparator.java;2;0;9;1;0;0;0;9;108;1;9;14;203;203;1;0;0;9;9;14;0;3164;9;2;
/org.eclipse.jdt.ui.tests.refactoring/resources/InlineTemp/cannotInline/A_testFail11.java;1;0;1;1;1;1;1;0;0;0;0;4359;0;0;1;0;0;0;1;4359;0;4359;1;1;
/org.eclipse.pde.runtime/src/org/eclipse/pde/internal/runtime/registry/IPluginFolder.java;2;0;2;1;0;0;0;2;2;1;2;1434;2;2;1;0;0;2;2;1434;0;3178;2;2;
/org.eclipse.help.ui/src/org/eclipse/help/internal/ui/motif/WebBrowser.java;2;0;4;1;0;0;0;4;17;1;4;1420;34;34;1;0;0;4;4;1420;0;3030;4;2;
/org.eclipse.jdt.ui.tests.refactoring/resources/ExtractMethodWorkSpace/ExtractMethodTests/validSelection/A_test202.java;1;1;3;1;2;2;2;1;0;0;1;1236;0;0;1;0;0;1;3;1236;0;4419;3;1;
/org.eclipse.help/src/org/eclipse/help/internal/server/HelpHttpRequest.java;2;0;4;1;0;0;0;4;2;1;4;1420;3;3;1;0;0;4;4;1420;0;3095;4;2;
/org.eclipse.team.cvs.ui/src/org/eclipse/team/internal/ccvs/ui/wizards/CVSWizardPage.java;2;0;6;1;1;1;1;5;284;2;4;1978;400;400;2;1;0;5;6;2577;1;3957;5;2;
/org.eclipse.update.core/src/org/eclipse/update/core/InstallHandlerEntry.java;1;0;2;1;0;0;0;2;8;1;2;3398;8;8;1;0;0;2;2;3398;0;3568;2;1;
/org.eclipse.pde.runtime/Eclipse PDE Runtime/org/eclipse/pde/internal/runtime/PDERuntimePluginImages.java;2;0;5;1;0;0;0;5;73;1;5;267;91;91;1;0;0;5;5;267;0;1434;5;2;
/org.eclipse.team.tests.cvs.core/src/org/eclipse/team/tests/ccvs/ui/logformatter/PrintDiffMain.java;1;0;4;1;0;0;0;4;161;1;4;2977;188;188;1;0;0;4;4;2977;0;3452;4;1;
/org.eclipse.webdav/src/interface/org/eclipse/webdav/dom/ResponseBody.java;3;0;5;1;1;1;1;4;1078;1;4;12;1262;1262;1;0;0;4;5;12;0;4211;5;3;
/org.eclipse.scripting/src/org/eclipse/scripting/internal/IXGRDataChangedNotifier.java;1;0;1;1;0;0;0;1;0;0;1;1424;0;0;1;0;0;1;1;1424;0;1424;1;1;
/org.eclipse.team.cvs.ui/src/org/eclipse/team/internal/ccvs/ui/sync/CommitSyncAction.java;3;2;16;2;7;5;7;9;271;1;9;2828;415;415;2;0;2;9;16;4005;2;4455;14;3;
/org.eclipse.jdt.ui.tests/examples/org/eclipse/jdt/ui/examples/TabExample.java;2;0;3;1;1;1;1;2;18;1;2;1186;29;29;1;0;0;2;3;1186;0;4682;3;2;
/org.eclipse.jdt.ui.tests.refactoring/resources/RenameTemp/canRename/A_test0_out.java;1;0;2;1;0;0;0;2;2;1;2;1625;2;2;1;0;0;2;2;1625;0;1652;2;1;
/org.eclipse.swt/Eclipse SWT PI/motif/org/eclipse/swt/internal/motif/XEvent.java;2;0;2;1;1;1;1;1;6;0;1;2069;6;6;1;0;0;1;2;2069;0;4701;2;2;
/org.eclipse.jdt.ui/ui/org/eclipse/jdt/internal/ui/launcher/J9Launcher.java;1;0;6;1;0;0;0;6;19;2;5;15;37;37;2;1;0;6;6;218;1;323;5;1;
/org.eclipse.swt.tests/JUnit Tests/org/eclipse/swt/tests/junit/Test_org_eclipse_swt_graphics_GCData.java;2;0;2;1;1;1;1;1;6;0;1;1792;6;6;1;0;0;1;2;1792;0;4706;2;2;
/org.eclipse.core.resources/src/org/eclipse/core/internal/events/InternalBuilder.java;3;0;8;1;1;1;1;7;208;1;7;12;292;292;1;0;0;7;8;12;0;4430;8;3;
/org.eclipse.search/search/org/eclipse/search/ui/ISearchPageScoreComputer.java;2;0;3;1;0;0;0;3;8;1;3;15;11;11;1;0;0;3;3;15;0;1434;3;2;
/org.eclipse.swt/Eclipse SWT PI/carbon/org/eclipse/swt/internal/carbon/MacEvent.java;2;1;2;1;2;2;2;0;6;0;0;4147;6;6;1;0;0;0;2;4147;0;4701;2;2;
/org.eclipse.ui.tests/Eclipse UI Tests/org/eclipse/ui/tests/adaptable/ResourceAction.java;1;0;1;1;0;0;0;1;0;0;1;2863;0;0;1;0;0;1;1;2863;0;2863;1;1;
/org.eclipse.jdt.debug.ui/ui/org/eclipse/jdt/internal/debug/ui/IJDIStatusConstants.java;1;0;1;1;0;0;0;1;0;0;1;1915;0;0;1;0;0;1;1;1915;0;1915;1;1;
/org.eclipse.debug.ui/ui/org/eclipse/debug/internal/ui/ConsolePreferencePage.java;4;0;15;1;1;1;1;14;234;1;14;187;636;636;1;0;0;14;15;187;0;3975;15;4;
/org.eclipse.pde.ui/src/org/eclipse/pde/internal/model/ModelProviderEvent.java;1;0;2;1;0;0;0;2;0;1;2;3136;0;0;1;0;0;2;2;3136;0;3579;2;1;
/org.eclipse.help.ui/src/org/eclipse/help/ui/internal/browser/linux/MozillaFactory.java;2;0;4;1;1;1;1;3;23;1;3;2429;27;27;1;0;0;3;4;2429;0;4439;4;2;
/org.eclipse.debug.ui/ui/org/eclipse/debug/internal/ui/DebugSelectionManager.java;1;0;2;1;0;0;0;2;4;1;2;2263;4;4;1;0;0;2;2;2263;0;2291;2;1;
/org.eclipse.jdt.ui/core extension/org/eclipse/jdt/internal/corext/template/TemplateVariable.java;1;0;1;1;0;0;0;1;0;0;1;2784;0;0;1;0;0;1;1;2784;0;2784;1;1;
/org.eclipse.team.cvs.core/src/org/eclipse/team/ccvs/core/IRemoteResource.java;2;0;3;1;0;0;0;3;12;1;3;1978;12;12;1;0;0;3;3;1978;0;2049;3;2;
/org.eclipse.jdt.core/model/org/eclipse/jdt/internal/core/Member.java;3;0;7;1;1;1;1;6;300;3;4;455;430;430;3;2;0;6;7;3565;2;4063;5;3;
/org.eclipse.search/search/org/eclipse/search/internal/workingsets/WorkingSetSelectionDialog.java;1;0;10;1;0;0;0;10;10;1;10;1494;51;51;1;0;0;10;10;1494;0;3849;10;1;
/org.eclipse.team.cvs.ui/src/org/eclipse/team/internal/ccvs/ui/OverlayIcon.java;3;0;4;1;1;1;1;3;162;1;3;2484;265;265;1;0;0;3;4;2484;0;4362;4;3;
/org.eclipse.core.resources/src/org/eclipse/core/internal/localstore/CoreFileSystemLibrary.java;4;1;16;1;2;2;2;14;278;2;13;12;558;558;2;1;0;14;16;327;1;4388;15;4;
/org.eclipse.swt.examples.layouts/org/eclipse/swt/examples/layouts/LayoutPlugin.java;2;0;2;1;1;1;1;1;0;0;1;3451;0;0;1;0;0;1;2;3451;0;4024;2;2;
/org.eclipse.pde.ui/src/org/eclipse/pde/internal/model/plugin/PluginObject.java;1;0;2;1;0;0;0;2;0;1;2;3136;0;0;1;0;0;2;2;3136;0;3579;2;1;
/org.eclipse.jdt.ui/core refactoring/org/eclipse/jdt/internal/core/refactoring/packages/RenameProjectChange.java;1;0;1;1;0;0;0;1;0;0;1;988;0;0;1;0;0;1;1;988;0;988;1;1;
/org.eclipse.pde.ui/Eclipse PDE UI/org/eclipse/pde/internal/model/jars/JarsObject.java;2;0;5;2;0;0;0;5;12;3;3;267;12;12;3;2;0;5;5;324;2;1434;3;2;
/org.eclipse.jdt.core/compiler/org/eclipse/jdt/internal/compiler/IErrorHandlingPolicy.java;2;1;4;1;2;2;2;2;17;1;2;455;34;34;1;0;0;2;4;455;0;4421;4;2;
/org.eclipse.swt/Eclipse SWT/motif/org/eclipse/swt/graphics/DeviceData.java;3;1;4;1;2;2;2;2;6;1;2;106;14;14;1;0;0;2;4;106;0;4701;4;3;
/org.eclipse.jdt.ui.tests.refactoring/test cases/org/eclipse/jdt/ui/tests/refactoring/RenameResourceChangeTests.java;2;0;4;1;0;0;0;4;211;1;4;1896;223;223;1;0;0;4;4;1896;0;3326;4;2;
/org.eclipse.jdt.debug/jdi interfaces/com/sun/jdi/request/ModificationWatchpointRequest.java;2;0;2;1;0;0;0;2;6;1;2;2704;6;6;1;0;0;2;2;2704;0;3040;2;2;
/org.eclipse.swt/Eclipse SWT PI/win32/org/eclipse/swt/internal/win32/MENUITEMINFO.java;2;0;2;1;1;1;1;1;6;0;1;2069;6;6;1;0;0;1;2;2069;0;4701;2;2;
/org.eclipse.swt/Eclipse SWT PI/gtk/org/eclipse/swt/internal/gtk/GtkMenuItem.java;1;0;2;1;0;0;0;2;0;1;2;2107;0;0;1;0;0;2;2;2107;0;3209;2;1;
/org.eclipse.ui/Eclipse UI Text Editor/org/eclipse/ui/texteditor/MarkerRulerAction.java;5;1;11;1;4;4;4;7;386;1;7;257;570;570;1;0;0;7;11;257;0;4853;11;5;
/org.eclipse.jdt.core/model/org/eclipse/jdt/internal/core/builder/AbortIncrementalBuildException.java;1;0;1;1;1;1;1;0;0;0;0;4314;0;0;1;0;0;0;1;4314;0;4314;1;1;
/org.eclipse.update.ui/src/org/eclipse/update/internal/ui/forms/UpdateWebForm.java;1;0;5;1;1;1;1;4;29;1;4;3662;41;41;1;0;0;4;5;3662;0;4606;5;1;
/org.eclipse.swt/Eclipse SWT/motif/org/eclipse/swt/internal/motif/XEvent.java;2;0;3;1;0;0;0;3;4;1;3;106;4;4;1;0;0;3;3;106;0;2069;3;2;
/org.eclipse.jdt.ui/ui/org/eclipse/jdt/internal/ui/text/java/JavaStringDoubleClickSelector.java;1;0;1;1;0;0;0;1;0;0;1;2838;0;0;1;0;0;1;1;2838;0;2838;1;1;
/org.eclipse.swt/Eclipse SWT PI/win32/org/eclipse/swt/internal/win32/LVITEM.java;2;0;2;1;1;1;1;1;6;0;1;2069;6;6;1;0;0;1;2;2069;0;4701;2;2;
/org.eclipse.jdt.debug/jdi/org/eclipse/jdi/internal/ArrayReferenceImpl.java;2;0;5;1;0;0;0;5;30;1;5;187;70;70;1;0;0;5;5;187;0;3678;5;2;
/org.eclipse.webdav/src/kernel/org/eclipse/webdav/internal/kernel/DocumentFactoryImpl.java;2;0;3;1;0;0;0;3;5;1;3;12;5;5;1;0;0;3;3;12;0;1874;3;2;
/org.eclipse.jdt.ui/ui/org/eclipse/jdt/ui/actions/ProjectActionGroup.java;1;1;2;1;2;2;2;0;8;0;0;4019;8;8;1;0;0;0;2;4019;0;4770;2;1;
/org.eclipse.core.tests.runtime/src/org/eclipse/core/tests/internal/plugins/SoftPrereqTest_2.java;3;0;3;1;0;0;0;3;130;1;3;1794;140;140;1;0;0;3;3;1794;0;3476;3;3;
/org.eclipse.jdt.ui/ui/org/eclipse/jdt/internal/ui/wizards/NewSnippetFileWizardPage.java;2;0;2;1;1;1;1;1;4;0;1;3089;4;4;1;0;0;1;2;3089;0;4450;2;2;
/org.eclipse.jdt.ui/ui/org/eclipse/jdt/internal/ui/search/FindReferencesInHierarchyAction.java;1;2;5;1;4;3;4;1;31;0;1;1707;56;56;2;0;1;1;5;4140;1;4140;4;1;
/org.eclipse.update.ui/src/org/eclipse/update/internal/ui/manager/UpdateManagerInputFactory.java;1;0;2;1;0;0;0;2;0;1;2;1428;0;0;1;0;0;2;2;1428;0;1596;2;1;
/org.eclipse.scripting/Eclipse Scripting/org/eclipse/scripting/internal/IXGRElement.java;1;0;3;1;0;0;0;3;4;1;3;133;4;4;1;0;0;3;3;133;0;1424;3;1;
/org.eclipse.help.ui/src/org/eclipse/help/internal/ui/NavigationPage.java;2;0;2;1;0;0;0;2;0;1;2;1420;0;0;1;0;0;2;2;1420;0;1675;2;2;
/org.eclipse.jdt.ui.tests.refactoring/resources/RenameType/test40/out/B.java;1;0;1;1;0;0;0;1;0;0;1;49;0;0;1;0;0;1;1;49;0;49;1;1;
/org.eclipse.jdt.ui/ui debug/org/eclipse/jdt/internal/debug/ui/display/ClearDisplayAction.java;4;0;5;1;0;0;0;5;26;2;4;345;31;31;2;1;0;5;5;345;1;1916;4;4;
/org.eclipse.vcm.core.cvs/src/org/eclipse/vcm/internal/core/ccvs/IgnoreStream.java;2;0;2;1;0;0;0;2;5;1;2;0;5;5;1;0;0;2;2;0;0;298;2;2;
/org.eclipse.jdt.ui.tests.refactoring/resources/DeleteSourceReference/test11/in/A.java;1;0;1;1;0;0;0;1;0;0;1;2857;0;0;1;0;0;1;1;2857;0;2857;1;1;
/org.eclipse.jdt.ui.tests.refactoring/resources/ExtractMethodWorkSpace/ExtractMethodTests/try_out/A_test459.java;1;1;3;1;2;2;2;1;0;0;1;923;0;0;1;0;0;1;3;923;0;4419;3;1;
/org.eclipse.swt/Eclipse SWT/common/org/eclipse/swt/internal/image/PngIhdrChunk.java;3;0;4;1;1;1;1;3;12;1;3;106;21;21;1;0;0;3;4;106;0;4701;4;3;
/org.eclipse.ui/Eclipse UI/org/eclipse/ui/internal/registry/NewWizardsRegistryReader.java;5;0;8;1;0;0;0;8;242;1;8;257;350;350;1;0;0;8;8;257;0;3092;8;5;
/org.eclipse.update.core/src/org/eclipse/update/core/BaseInstallHandler.java;1;0;2;1;0;0;0;2;134;1;2;3398;134;134;1;0;0;2;2;3398;0;3529;2;1;
/org.eclipse.jdt.ui.tests.refactoring/resources/ExtractMethodWorkSpace/ExtractMethodTests/locals_in/A_test514.java;2;1;4;1;2;2;2;2;6;1;2;369;10;10;1;0;0;2;4;369;0;4419;4;2;
/org.eclipse.jdt.core/model/org/eclipse/jdt/internal/core/builder/impl/PrimitiveTypeHandleImplSWH.java;1;0;3;1;0;0;0;3;6;1;3;455;6;6;1;0;0;3;3;455;0;2808;3;1;
/org.eclipse.jdt.ui.tests.refactoring/resources/SelectionAnalyzerWorkSpace/SelectionAnalyzerTests/invalidSelection/A_test071.java;1;0;1;1;0;0;0;1;0;0;1;1368;0;0;1;0;0;1;1;1368;0;1368;1;1;
/org.eclipse.jdt.ui/core extension/org/eclipse/jdt/internal/corext/template/TemplateSet.java;3;0;5;1;1;1;1;4;18;1;4;2784;38;38;1;0;0;4;5;2784;0;4400;5;3;
/org.eclipse.jdt.ui/ui/org/eclipse/jdt/internal/ui/javaeditor/ToggleTextHoverAction.java;6;2;12;2;4;3;4;8;49;1;8;350;163;163;2;0;1;8;12;4182;1;4213;11;6;
/org.eclipse.jdt.ui.tests.refactoring/resources/DeleteSourceReference/A_testField0_in.java;1;0;2;1;0;0;0;2;0;1;2;2003;0;0;1;0;0;2;2;2003;0;2857;2;1;
/org.eclipse.scripting/src/org/eclipse/scripting/internal/uirenderer/XGRElementUISwtFieldSet.java;1;0;1;1;0;0;0;1;0;0;1;1424;0;0;1;0;0;1;1;1424;0;1424;1;1;
/org.eclipse.jdt.ui.tests.refactoring/resources/ExtractMethodWorkSpace/ExtractMethodTests/expression_out/A_test602.java;2;1;4;1;2;2;2;2;22;1;2;239;23;23;1;0;0;2;4;239;0;4419;4;2;
/org.eclipse.jdt.ui.tests.refactoring/resources/RenameType/testFail50/in/A.java;1;0;1;1;0;0;0;1;0;0;1;49;0;0;1;0;0;1;1;49;0;49;1;1;
/org.eclipse.jdt.ui/ui/org/eclipse/jdt/ui/JavaElementSorter.java;3;1;7;1;5;5;5;2;33;1;2;3120;80;80;1;0;0;2;7;3120;0;4810;7;3;
/org.eclipse.help.ui/src/org/eclipse/help/ui/internal/HyperlinkLabel.java;1;0;1;1;1;1;1;0;0;0;0;4439;0;0;1;0;0;0;1;4439;0;4439;1;1;
/org.eclipse.jdt.ui.tests.refactoring/resources/RenamePrivateMethod/test17/in/A.java;1;0;1;1;0;0;0;1;0;0;1;49;0;0;1;0;0;1;1;49;0;49;1;1;
/org.eclipse.jdt.ui.tests.refactoring/resources/RenameVariables/canRename/A_test3_out.java;1;0;2;1;0;0;0;2;0;1;2;724;0;0;1;0;0;2;2;724;0;1665;2;1;
/org.eclipse.pde.ui/src/org/eclipse/pde/internal/ui/util/AbstractOverlayIcon.java;1;0;1;1;0;0;0;1;0;0;1;3579;0;0;1;0;0;1;1;3579;0;3579;1;1;
/org.eclipse.pde.ui/src/org/eclipse/pde/internal/ui/editor/manifest/JavaAttributeCellEditor.java;1;0;3;1;1;1;1;2;3;1;2;3579;5;5;1;0;0;2;3;3579;0;4567;3;1;
/org.eclipse.swt/Eclipse SWT Program/win32/org/eclipse/swt/program/Program.java;6;0;10;1;1;1;1;9;110;1;9;106;213;213;1;0;0;9;10;106;0;4701;10;6;
/org.eclipse.jdt.ui.tests.refactoring/resources/RenameVariables/canRename/A_test31_out.java;1;0;2;1;0;0;0;2;0;1;2;724;0;0;1;0;0;2;2;724;0;1665;2;1;
/org.eclipse.jdt.ui.tests.refactoring/resources/SelectionAnalyzerWorkSpace/SelectionAnalyzerTests/validSelection/A_test280.java;1;0;1;1;0;0;0;1;0;0;1;1368;0;0;1;0;0;1;1;1368;0;1368;1;1;
/org.eclipse.jdt.ui.tests.refactoring/resources/ExtractMethodWorkSpace/ExtractMethodTests/return_out/A_test707.java;1;1;3;1;2;2;2;1;30;0;1;887;30;30;1;0;0;1;3;887;0;4419;3;1;
/org.eclipse.swt/Eclipse SWT PI/win32/org/eclipse/swt/internal/ole/win32/IProvideClassInfo.java;2;0;2;1;1;1;1;1;6;0;1;2069;6;6;1;0;0;1;2;2069;0;4701;2;2;
/org.eclipse.pde.ui/src/org/eclipse/pde/internal/ui/model/ifeature/IFeaturePlugin.java;1;0;3;1;0;0;0;3;3;2;2;3579;3;3;2;1;0;3;3;3579;1;3591;2;1;
/org.eclipse.jdt.core/dom/org/eclipse/jdt/core/dom/IMethodBinding.java;2;0;2;1;0;0;0;2;2;1;2;2669;2;2;1;0;0;2;2;2669;0;2702;2;2;
/org.eclipse.jdt.core/compiler/org/eclipse/jdt/internal/compiler/ast/ArrayQualifiedTypeReference.java;2;1;11;1;2;2;2;9;78;4;6;455;133;133;4;3;0;9;11;1039;3;4418;8;2;
/org.eclipse.help/webapps/examples/WEB-INF/classes/cal/Entry.java;1;0;2;1;0;0;0;2;0;1;2;1882;0;0;1;0;0;2;2;1882;0;1930;2;1;
/org.eclipse.jdt.core/compiler/org/eclipse/jdt/internal/compiler/parser/InvalidInputException.java;1;0;4;1;0;0;0;4;28;1;4;455;32;32;1;0;0;4;4;455;0;3525;4;1;
/org.eclipse.jdt.junit/Eclipse JUnit/org/eclipse/jdt/internal/junit/ui/RerunAction.java;2;0;2;1;0;0;0;2;0;1;2;2399;0;0;1;0;0;2;2;2399;0;3313;2;2;
/org.eclipse.jdt.core/compiler/org/eclipse/jdt/internal/compiler/ast/QualifiedThisReference.java;2;1;14;1;2;2;2;12;246;4;9;455;521;521;4;3;0;12;14;1039;3;4421;11;2;
/org.eclipse.swt/Eclipse SWT Drag and Drop/emulated/org/eclipse/swt/dnd/DragSource.java;3;1;6;1;5;5;5;1;113;0;1;3126;140;140;1;0;0;1;6;3126;0;4824;6;3;
/org.eclipse.pde.build/src/org/eclipse/pde/internal/build/SourceBuildScriptGeneratorApplication.java;1;0;2;1;1;1;1;1;0;0;1;3672;0;0;1;0;0;1;2;3672;0;4082;2;1;
/org.eclipse.jdt.ui.tests.refactoring/resources/ExtractTemp/canExtract/A_test39_in.java;1;0;1;1;1;1;1;0;0;0;0;4763;0;0;1;0;0;0;1;4763;0;4763;1;1;
/org.eclipse.jdt.debug.ui/ui/org/eclipse/jdt/internal/debug/ui/launcher/NameValuePairDialog.java;3;0;3;1;0;0;0;3;30;1;3;2643;33;33;1;0;0;3;3;2643;0;3634;3;3;
/org.eclipse.swt/Eclipse SWT Printing/carbon/org/eclipse/swt/printing/Printer.java;3;1;3;1;3;3;3;0;6;0;0;4147;8;8;1;0;0;0;3;4147;0;4701;3;3;
/org.eclipse.jdt.debug.ui/ui/org/eclipse/jdt/internal/debug/ui/JavaStepFilterPreferencePage.java;3;2;19;2;4;3;4;15;98;3;11;3108;231;231;3;4;1;15;19;3814;5;4410;14;3;
/org.eclipse.jdt.ui.tests.refactoring/resources/PullUpMethods/test2/in/A.java;1;0;2;1;0;0;0;2;0;1;2;2156;0;0;1;0;0;2;2;2156;0;2406;2;1;
/org.eclipse.swt/Eclipse SWT/common_j2se/org/eclipse/swt/internal/EventListenerCompatibility.java;2;0;2;1;0;0;0;2;0;1;2;1434;0;0;1;0;0;2;2;1434;0;1561;2;2;
/org.eclipse.pde.ui/src/org/eclipse/pde/model/build/IBuild.java;1;0;2;1;0;0;0;2;0;1;2;3039;0;0;1;0;0;2;2;3039;0;3579;2;1;
/org.eclipse.jdt.ui.tests.refactoring/resources/ExtractMethodWorkSpace/ExtractMethodTests/locals_in/A_test550.java;1;1;3;1;2;2;2;1;24;0;1;1236;24;24;1;0;0;1;3;1236;0;4419;3;1;
/org.eclipse.jdt.ui.tests.refactoring/resources/ExtractMethodWorkSpace/ExtractMethodTests/return_out/A_test722.java;1;1;3;1;2;2;2;1;26;0;1;2580;26;26;1;0;0;1;3;2580;0;4419;3;1;
/org.eclipse.jdt.debug/jdi interfaces/com/sun/jdi/StringReference.java;2;0;2;1;0;0;0;2;6;1;2;2704;6;6;1;0;0;2;2;2704;0;3033;2;2;
/org.eclipse.jdt.ui.tests.refactoring/resources/RenameType/test15/out/B.java;1;0;1;1;0;0;0;1;0;0;1;522;0;0;1;0;0;1;1;522;0;522;1;1;
/org.eclipse.jdt.ui.tests.refactoring/resources/RenamePackage/testFail6/in/p/A.java;2;0;2;1;0;0;0;2;0;1;2;49;0;0;1;0;0;2;2;49;0;1258;2;2;
/org.eclipse.jdt.ui/core refactoring/org/eclipse/jdt/internal/corext/refactoring/tagging/ITextUpdatingRefactoring.java;1;0;1;1;0;0;0;1;0;0;1;1939;0;0;1;0;0;1;1;1939;0;1939;1;1;
/org.eclipse.jdt.ui/ui/org/eclipse/jdt/internal/ui/javaeditor/ClassFileDocumentProvider.java;3;1;13;1;6;6;6;7;96;1;7;15;339;339;1;0;0;7;13;15;0;4742;13;3;
/org.eclipse.ui/Eclipse UI/org/eclipse/ui/internal/dialogs/WorkbenchWizardElement.java;3;0;3;1;0;0;0;3;72;1;3;257;77;77;1;0;0;3;3;257;0;2804;3;3;
/org.eclipse.jdt.core/dom/org/eclipse/jdt/core/dom/Statement.java;2;1;5;1;3;3;3;2;6;1;2;2669;12;12;1;0;0;2;5;2669;0;4058;5;2;
/org.eclipse.debug.core/core/org/eclipse/debug/internal/core/LaunchConfigurationWorkingCopy.java;4;0;23;2;1;1;1;22;171;2;20;1819;423;423;2;2;0;22;23;2366;2;4423;21;4;
/org.eclipse.jdt.ui.tests.refactoring/resources/PullUp/testFieldFail1/in/A.java;1;0;1;1;0;0;0;1;0;0;1;2406;0;0;1;0;0;1;1;2406;0;2406;1;1;
/org.eclipse.jdt.core/compiler/org/eclipse/jdt/internal/compiler/problem/AbortCompilationUnit.java;2;0;3;1;1;1;1;2;16;1;2;455;23;23;1;0;0;2;3;455;0;4062;3;2;
/org.eclipse.jdt.ui.tests.refactoring/resources/InlineTemp/canInline/A_in.java;1;0;1;1;0;0;0;1;0;0;1;2015;0;0;1;0;0;1;1;2015;0;2015;1;1;
/org.eclipse.jdt.ui.tests.refactoring/resources/ExtractMethodWorkSpace/ExtractMethodTests/D.java;1;1;4;1;2;2;2;2;58;1;2;1236;85;85;1;0;0;2;4;1236;0;4419;4;1;
/org.eclipse.ui/Eclipse JFace/org/eclipse/jface/viewers/ILabelProvider.java;2;0;2;1;0;0;0;2;5;1;2;257;5;5;1;0;0;2;2;257;0;457;2;2;
/org.eclipse.help/src/org/eclipse/help/internal/contributions/xml/HelpAction.java;2;0;2;1;0;0;0;2;0;1;2;1420;0;0;1;0;0;2;2;1420;0;1675;2;2;
/org.eclipse.team.core/src/org/eclipse/team/core/IFileTypeInfo.java;1;0;1;1;0;0;0;1;0;0;1;3458;0;0;1;0;0;1;1;3458;0;3458;1;1;
/org.eclipse.swt/Eclipse SWT/common/org/eclipse/swt/events/ShellAdapter.java;2;0;3;1;1;1;1;2;6;1;2;106;10;10;1;0;0;2;3;106;0;4701;3;2;
/org.eclipse.jdt.core/eval/org/eclipse/jdt/internal/eval/CodeSnippetScope.java;3;0;12;1;1;1;1;11;1537;2;9;455;2049;2049;2;2;0;11;12;1046;2;4062;10;3;
/org.eclipse.pde.ui/src/org/eclipse/pde/internal/ui/preferences/ExternalPluginsBlock.java;1;1;8;1;2;2;2;6;99;2;5;3579;157;157;2;1;0;6;8;3579;1;4435;7;1;
/org.eclipse.debug.ui/ui/org/eclipse/debug/internal/ui/DebugUIPlugin.java;4;4;112;3;9;6;9;103;900;5;71;187;5812;5812;5;32;3;103;112;2306;35;4433;77;4;
/org.eclipse.update.ui/src/org/eclipse/update/internal/ui/forms/MainForm.java;2;1;7;1;3;3;3;4;370;1;4;3662;392;392;1;0;0;4;7;3662;0;4610;7;2;
/org.eclipse.jdt.ui.tests.refactoring/resources/SelectionAnalyzerWorkSpace/SelectionAnalyzerTests/validSelection/A_test080_.java;1;0;1;1;0;0;0;1;0;0;1;2139;0;0;1;0;0;1;1;2139;0;2139;1;1;
/org.eclipse.jdt.debug.ui/ui/org/eclipse/jdt/internal/debug/ui/snippeteditor/ScrapbookMain1.java;1;0;1;1;0;0;0;1;0;0;1;1915;0;0;1;0;0;1;1;1915;0;1915;1;1;
/org.eclipse.team.tests.core/src/org/eclipse/team/tests/core/RemoteResourceTests.java;1;1;3;1;3;3;3;0;4;0;0;4326;8;8;1;0;0;0;3;4326;0;4636;3;1;
/org.eclipse.ui/Eclipse JFace/org/eclipse/jface/viewers/SelectionActivatedEvent.java;1;0;1;1;0;0;0;1;0;0;1;878;0;0;1;0;0;1;1;878;0;878;1;1;
/org.eclipse.jdt.ui.tests.refactoring/resources/SurroundWithWorkSpace/SurroundWithTests/trycatch_in/TestMultiLine.java;1;0;1;1;0;0;0;1;0;0;1;2327;0;0;1;0;0;1;1;2327;0;2327;1;1;
/org.eclipse.jdt.ui.tests/test plugin/org/eclipse/jdt/testplugin/core/TestPluginCoreLauncher.java;2;0;3;1;0;0;0;3;4;1;3;49;4;4;1;0;0;3;3;49;0;1186;3;2;
/org.eclipse.update/Eclipse Update/org/eclipse/update/internal/ui/UMWizardProductComponentUpdate.java;2;0;5;1;0;0;0;5;69;1;5;108;75;75;1;0;0;5;5;108;0;1424;5;2;
/org.eclipse.pde.core/src/org/eclipse/pde/internal/core/ModelProviderEvent.java;1;0;1;1;0;0;0;1;0;0;1;3591;0;0;1;0;0;1;1;3591;0;3591;1;1;
/org.eclipse.jdt.core/dom/org/eclipse/jdt/core/dom/ThrowStatement.java;2;1;6;1;2;2;2;4;12;1;4;2669;38;38;1;0;0;4;6;2669;0;4453;6;2;
/org.eclipse.vcm.core/src/org/eclipse/vcm/internal/core/StringMatcher.java;1;0;3;1;0;0;0;3;5;1;3;373;7;7;1;0;0;3;3;373;0;2216;3;1;
/org.eclipse.scripting/Eclipse Scripting/org/eclipse/scripting/internal/views/ScriptDevelopmentWizardPageActionType.java;2;0;4;1;0;0;0;4;19;1;4;133;36;36;1;0;0;4;4;133;0;1424;4;2;
/org.eclipse.core.runtime/src/org/eclipse/core/internal/plugins/InternalFactory.java;3;0;5;1;1;1;1;4;96;1;4;12;126;126;1;0;0;4;5;12;0;4213;5;3;
/org.eclipse.core.boot/src/org/eclipse/core/boot/IInstallInfo.java;3;0;5;1;0;0;0;5;8;1;5;12;19;19;1;0;0;5;5;12;0;2802;5;3;
/org.eclipse.pde.ui/Eclipse PDE UI/org/eclipse/pde/internal/model/PluginElement.java;2;0;7;2;0;0;0;7;12;3;5;267;16;16;3;2;0;7;7;324;2;1434;5;2;
/org.eclipse.pde.ui/src/org/eclipse/pde/internal/editor/feature/FeatureSourceOutlinePage.java;1;0;2;1;0;0;0;2;0;1;2;2951;0;0;1;0;0;2;2;2951;0;3579;2;1;
/org.eclipse.debug.ui/ui/org/eclipse/debug/internal/ui/RunHistoryMenuAction.java;1;0;2;1;0;0;0;2;0;1;2;2254;0;0;1;0;0;2;2;2254;0;2382;2;1;
/org.eclipse.jdt.ui.tests.refactoring/resources/ExtractTemp/canExtract/A_test0_out.java;1;0;1;1;0;0;0;1;0;0;1;2481;0;0;1;0;0;1;1;2481;0;2481;1;1;
/org.eclipse.ui/Eclipse UI Tool Script/org/eclipse/toolscript/ui/internal/AntLaunchWizard.java;1;3;7;1;7;4;7;0;121;0;0;4024;174;174;3;0;3;0;7;4083;3;4083;4;1;
/org.eclipse.jdt.ui.tests.refactoring/resources/SelectionAnalyzerWorkSpace/SelectionAnalyzerTests/invalidSelection/A_test020.java;1;0;1;1;0;0;0;1;0;0;1;1368;0;0;1;0;0;1;1;1368;0;1368;1;1;
/org.eclipse.jdt.debug.ui/ui/org/eclipse/jdt/internal/debug/ui/FilterLabelProvider.java;1;0;4;1;1;1;1;3;2;1;3;3030;6;6;1;0;0;3;4;3030;0;4410;4;1;
/org.eclipse.ant.core/src/org/eclipse/ant/internal/core/old/IAntRunnerListener.java;1;0;1;1;0;0;0;1;0;0;1;3270;0;0;1;0;0;1;1;3270;0;3270;1;1;
/org.eclipse.ui.tests/Eclipse JFace Tests/org/eclipse/jface/tests/viewers/StructuredSelectionTest.java;1;0;1;1;0;0;0;1;0;0;1;1488;0;0;1;0;0;1;1;1488;0;1488;1;1;
/org.eclipse.core.target/src/org/eclipse/core/internal/target/webdav/DateTime.java;1;0;4;1;1;1;1;3;226;1;3;12;263;263;1;0;0;3;4;12;0;4196;4;1;
/org.eclipse.pde.ui/src/org/eclipse/pde/internal/base/model/build/IBuildEntry.java;2;0;3;1;0;0;0;3;5;1;3;1434;5;5;1;0;0;3;3;1434;0;3039;3;2;
/org.eclipse.ui/Eclipse UI Standard Components/org/eclipse/ui/views/tasklist/MarkerType.java;3;0;3;1;1;1;1;2;5;1;2;257;7;7;1;0;0;2;3;257;0;4268;3;3;
/org.eclipse.jdt.debug/eval/org/eclipse/jdt/internal/debug/eval/ast/EvaluationPrimitiveValue.java;1;0;3;1;0;0;0;3;188;1;3;3329;188;188;1;0;0;3;3;3329;0;3421;3;1;
/org.eclipse.ui/Eclipse UI Standard Components/org/eclipse/ui/views/tasklist/TaskSorter.java;4;0;5;1;1;1;1;4;47;1;4;257;73;73;1;0;0;4;5;257;0;4269;5;4;
/org.eclipse.swt.tests/JUnit Tests/org/eclipse/swt/tests/junit/Test_org_eclipse_swt_graphics_Font.java;3;1;3;1;2;2;2;1;6;0;1;1792;12;12;1;0;0;1;3;1792;0;4706;3;3;
/org.eclipse.jdt.core/dom/org/eclipse/jdt/core/dom/SimpleType.java;2;1;8;1;2;2;2;6;11;1;6;2669;41;41;1;0;0;6;8;2669;0;4453;8;2;
/org.eclipse.debug.ui/ui/org/eclipse/debug/internal/ui/views/console/ConsoleViewer.java;3;1;5;2;5;5;5;0;392;0;0;3975;412;412;1;0;0;0;5;3975;0;4568;5;3;
/org.eclipse.jdt.ui/ui refactoring/org/eclipse/jdt/internal/ui/refactoring/actions/RefactoringStarter.java;2;1;7;1;2;2;2;5;31;1;5;2510;83;83;1;0;0;5;7;2510;0;4454;7;2;
/org.eclipse.team.ui/src/org/eclipse/team/internal/ui/actions/DeconfigureProjectAction.java;1;0;1;1;1;1;1;0;0;0;0;4020;0;0;1;0;0;0;1;4020;0;4020;1;1;
/org.eclipse.pde.ui/src/org/eclipse/pde/internal/forms/renamed/SectionChangeManager.java;1;0;2;1;0;0;0;2;0;1;2;2470;0;0;1;0;0;2;2;2470;0;2691;2;1;
/org.eclipse.jdt.launching/launching/org/eclipse/jdt/launching/IRuntimeClasspathEntryResolver.java;1;1;6;1;6;6;6;0;21;0;0;4087;61;61;1;0;0;0;6;4087;0;4650;6;1;
/org.eclipse.jdt.ui/ui/org/eclipse/jdt/internal/ui/typehierarchy/MethodsContentProvider.java;6;1;21;1;6;6;6;15;202;1;15;15;570;570;1;0;0;15;21;15;0;4621;21;6;
/org.eclipse.jdt.ui/core refactoring/org/eclipse/jdt/internal/core/refactoring/rename/RenameSourceFolderRefactoring.java;2;0;5;1;0;0;0;5;22;1;5;1342;46;46;1;0;0;5;5;1342;0;1939;5;2;
/org.eclipse.jdt.core/search/org/eclipse/jdt/internal/core/search/indexing/IndexRequest.java;2;1;4;1;2;2;2;2;14;1;2;2544;26;26;1;0;0;2;4;2544;0;4063;4;2;
/org.eclipse.core.tests.resources/src/org/eclipse/core/tests/internal/builders/SortBuilder.java;3;0;6;1;1;1;1;5;838;1;5;1794;988;988;1;0;0;5;6;1794;0;4451;6;3;
/org.eclipse.jdt.ui.tests.refactoring/test cases/org/eclipse/jdt/ui/tests/refactoring/RenameMethodInInterfaceTests.java;2;0;4;1;0;0;0;4;15;1;4;1896;31;31;1;0;0;4;4;1896;0;2299;4;2;
/org.eclipse.jdt.ui/core refactoring/org/eclipse/jdt/internal/corext/refactoring/ExtendedBuffer.java;2;0;5;1;1;1;1;4;6;1;4;1939;10;10;1;0;0;4;5;1939;0;3972;5;2;
/org.eclipse.jdt.ui.tests.refactoring/resources/ExtractMethodWorkSpace/ExtractMethodTests/Philippe.java;2;1;3;1;2;2;2;1;0;0;1;511;0;0;1;0;0;1;3;511;0;4419;3;2;
/org.eclipse.webdav/src/kernel/org/eclipse/webdav/internal/kernel/DocumentFactory.java;2;0;5;1;1;1;1;4;30;1;4;12;60;60;1;0;0;4;5;12;0;4211;5;2;
/org.eclipse.debug.ui/ui/org/eclipse/debug/internal/ui/DebugPreferencePage.java;4;1;36;2;3;3;3;33;54;2;26;187;300;300;2;7;0;33;36;2261;7;3975;29;4;
/org.eclipse.jdt.ui/ui/org/eclipse/jdt/internal/ui/text/correction/ChangeCorrectionProposal.java;4;2;13;1;4;3;4;9;40;1;9;3306;189;189;2;0;1;9;13;4451;1;4621;12;4;
/org.eclipse.jdt.core/search/org/eclipse/jdt/internal/core/search/matching/MatchingOpenableSet.java;2;0;2;1;1;1;1;1;14;0;1;1906;14;14;1;0;0;1;2;1906;0;4063;2;2;
/org.eclipse.vcm.core.cvs/src/org/eclipse/vcm/internal/core/ccvs/client/IResponseContext.java;2;0;2;1;0;0;0;2;10;1;2;0;10;10;1;0;0;2;2;0;0;298;2;2;
/org.eclipse.ui/Eclipse UI Standard Components/org/eclipse/ui/views/properties/TextPropertyDescriptor.java;2;0;2;1;0;0;0;2;5;1;2;257;5;5;1;0;0;2;2;257;0;457;2;2;
/org.eclipse.jdt.ui/core refactoring/org/eclipse/jdt/internal/corext/refactoring/util/JavaElementUtil.java;1;0;13;1;1;1;1;12;37;2;10;2270;122;122;2;2;0;12;13;2928;2;4120;11;1;
/org.eclipse.jdt.ui.tests.refactoring/resources/ExtractMethodWorkSpace/ExtractMethodTests/return_out/A_test710.java;1;1;3;1;2;2;2;1;28;0;1;887;28;28;1;0;0;1;3;887;0;4419;3;1;
/org.eclipse.core.tests.runtime/src/org/eclipse/core/tests/internal/plugins/RegressionResolveTest_5.java;3;0;3;1;0;0;0;3;132;1;3;1794;142;142;1;0;0;3;3;1794;0;3476;3;3;
/org.eclipse.jdt.ui.tests/test plugin/org/eclipse/jdt/testplugin/JavaTestSetup.java;2;0;3;1;0;0;0;3;21;1;3;49;25;25;1;0;0;3;3;49;0;1228;3;2;
/org.eclipse.jdt.ui.tests/test plugin/org/eclipse/jdt/testplugin/util/SizingTestPass.java;2;0;2;1;1;1;1;1;9;0;1;2180;9;9;1;0;0;1;2;2180;0;4682;2;2;
/org.eclipse.jdt.ui/core refactoring/org/eclipse/jdt/internal/corext/refactoring/util/JavaElementMapper.java;2;0;2;1;0;0;0;2;0;1;2;1939;0;0;1;0;0;2;2;1939;0;3087;2;2;
/org.eclipse.jdt.ui/nls/org/eclipse/jdt/internal/ui/nls/search/LineReader.java;1;0;2;1;0;0;0;2;0;1;2;1880;0;0;1;0;0;2;2;1880;0;1913;2;1;
/org.eclipse.pde.ui/src/org/eclipse/pde/internal/core/plugin/PluginParent.java;1;0;3;1;0;0;0;3;7;2;2;3579;7;7;2;1;0;3;3;3579;1;3607;2;1;
/org.eclipse.jdt.ui.tests.refactoring/resources/MoveMembers/test9/in/B.java;1;0;1;1;0;0;0;1;0;0;1;2738;0;0;1;0;0;1;1;2738;0;2738;1;1;
/org.eclipse.team.cvs.core/src/org/eclipse/team/internal/ccvs/core/util/ReplaceWithBaseVisitor.java;1;0;1;1;1;1;1;0;0;0;0;3920;0;0;1;0;0;0;1;3920;0;3920;1;1;
/org.eclipse.jdt.ui.tests.refactoring/resources/InlineTemp/canInline/A_test4_out.java;1;0;1;1;0;0;0;1;0;0;1;2015;0;0;1;0;0;1;1;2015;0;2015;1;1;
/org.eclipse.jdt.debug.ui/ui/org/eclipse/jdt/internal/debug/ui/launcher/VMStandin.java;3;2;6;1;3;2;3;3;4;1;3;1915;10;10;2;0;1;3;6;4020;1;4169;5;3;
/org.eclipse.update/src/org/eclipse/update/internal/core/UpdateManagerException.java;1;0;1;1;0;0;0;1;0;0;1;1424;0;0;1;0;0;1;1;1424;0;1424;1;1;
/org.eclipse.swt/Eclipse SWT Drag and Drop/gtk/org/eclipse/swt/dnd/ByteArrayTransfer.java;3;2;8;1;6;5;6;2;112;1;2;2107;214;214;2;0;1;2;8;4824;1;4824;7;3;
/org.eclipse.help/src/org/eclipse/help/internal/contributions/xml/HelpInsert.java;2;0;2;1;0;0;0;2;0;1;2;1420;0;0;1;0;0;2;2;1420;0;1675;2;2;
/org.eclipse.jdt.launching/launching/org/eclipse/jdt/internal/launching/JavaLaunchConfigurationUtils.java;3;1;8;1;5;5;5;3;70;1;3;3313;172;172;1;0;0;3;8;3313;0;4528;8;3;
/org.eclipse.ui/Eclipse UI Standard Components/org/eclipse/ui/views/properties/PropertyDescriptor.java;3;0;4;1;0;0;0;4;19;1;4;257;26;26;1;0;0;4;4;257;0;3029;4;3;
/org.eclipse.jdt.debug/jdi interfaces/com/sun/jdi/event/EventQueue.java;2;0;2;1;0;0;0;2;6;1;2;2704;6;6;1;0;0;2;2;2704;0;3040;2;2;
/org.eclipse.pde.ui/Eclipse PDE UI/org/eclipse/pde/internal/base/BuildPathUtil.java;2;0;8;2;0;0;0;8;83;3;6;267;112;112;3;2;0;8;8;324;2;1434;6;2;
/org.eclipse.pde.ui/src/org/eclipse/pde/internal/editor/build/VariableSection.java;2;0;8;1;0;0;0;8;362;2;7;1434;394;394;2;1;0;8;8;3035;1;3579;7;2;
/org.eclipse.debug.ui/ui/org/eclipse/debug/internal/ui/actions/ShowBreakpointsForModelAction.java;2;0;7;1;0;0;0;7;179;1;7;2382;209;209;1;0;0;7;7;2382;0;3532;7;2;
/org.eclipse.jdt.ui.tests.refactoring/resources/RenameVariables/canRename/A_test30_in.java;1;0;2;1;0;0;0;2;0;1;2;724;0;0;1;0;0;2;2;724;0;1665;2;1;
/org.eclipse.update.ui/src/org/eclipse/update/ui/internal/model/CategorizedFeature.java;1;0;6;1;0;0;0;6;18;1;6;1703;34;34;1;0;0;6;6;1703;0;2797;6;1;
/org.eclipse.ui/Eclipse UI/org/eclipse/ui/internal/dialogs/ProjectPerspectiveChoiceDialog.java;1;0;1;1;0;0;0;1;0;0;1;3487;0;0;1;0;0;1;1;3487;0;3487;1;1;
/org.eclipse.ui/Eclipse JFace/org/eclipse/jface/viewers/ISelectionProvider.java;3;0;3;1;0;0;0;3;5;1;3;257;7;7;1;0;0;3;3;257;0;1641;3;3;
/org.eclipse.pde.ui/Eclipse PDE UI/org/eclipse/pde/internal/base/schema/IDocumentSection.java;2;0;6;2;0;0;0;6;12;3;4;267;16;16;3;2;0;6;6;324;2;1434;4;2;
/org.eclipse.team.ui/src/org/eclipse/team/internal/ui/ConfigureProjectWizard.java;2;1;14;1;3;3;3;11;294;1;11;1978;438;438;1;0;0;11;14;1978;0;4164;14;2;
/org.eclipse.jdt.ui.tests.refactoring/resources/RenameTemp/canRename/A_test19_out.java;1;0;2;1;0;0;0;2;2;1;2;1625;2;2;1;0;0;2;2;1625;0;1652;2;1;
/org.eclipse.jdt.debug/jdi interfaces/com/sun/jdi/InvalidCodeIndexException.java;2;0;2;1;0;0;0;2;7;1;2;2704;7;7;1;0;0;2;2;2704;0;3033;2;2;
/org.eclipse.jdt.ui/core refactoring/org/eclipse/jdt/internal/corext/refactoring/SearchResult.java;2;0;3;1;0;0;0;3;15;1;3;1939;26;26;1;0;0;3;3;1939;0;3825;3;2;
/org.eclipse.help.ui/src/org/eclipse/help/ui/internal/browser/win32/IEStore.java;1;0;3;1;1;1;1;2;14;1;2;2447;14;14;1;0;0;2;3;2447;0;4427;3;1;
/org.eclipse.ui/Eclipse JFace/org/eclipse/jface/viewers/TableTreeViewer.java;3;1;5;1;2;2;2;3;6;1;3;257;21;21;1;0;0;3;5;257;0;4195;5;3;
/org.eclipse.jdt.debug.tests/tests/org/eclipse/jdt/debug/tests/eval/FieldValueTests.java;2;2;3;2;3;2;3;0;17;0;0;4447;19;19;2;0;1;0;3;4447;1;4571;2;2;
/org.eclipse.jdt.ui/core refactoring/org/eclipse/jdt/internal/core/refactoring/reorg/MoveCuUpdateCreator.java;2;0;5;1;0;0;0;5;28;1;5;1258;39;39;1;0;0;5;5;1258;0;1939;5;2;
/org.eclipse.update/Eclipse Update/org/eclipse/update/internal/ui/UMDialog.java;2;0;5;1;0;0;0;5;1250;1;5;108;1346;1346;1;0;0;5;5;108;0;1424;5;2;
/org.eclipse.jdt.ui/ui/org/eclipse/jdt/internal/ui/reorg/RenameSupport.java;2;0;5;1;0;0;0;5;31;1;5;15;41;41;1;0;0;5;5;15;0;1258;5;2;
/org.eclipse.team.cvs.ui/src/org/eclipse/team/internal/ccvs/ui/CVSResourceNode.java;3;0;7;1;1;1;1;6;182;1;6;2312;231;231;1;0;0;6;7;2312;0;3921;7;3;
/org.eclipse.swt/Eclipse SWT Custom Widgets/common_j2se/org/eclipse/swt/custom/CLabel.java;1;0;1;1;0;0;0;1;0;0;1;1378;0;0;1;0;0;1;1;1378;0;1378;1;1;
/org.eclipse.vcm.core/src/org/eclipse/vcm/internal/core/ShallowHandle.java;5;0;6;1;0;0;0;6;8;2;5;0;18;18;2;1;0;6;6;202;1;297;5;5;
/org.eclipse.search/search/org/eclipse/search/ui/IGroupByKeyComputer.java;2;0;4;1;0;0;0;4;9;1;4;15;14;14;1;0;0;4;4;15;0;1434;4;2;
/org.eclipse.jdt.debug/jdi/org/eclipse/jdi/internal/CharValueImpl.java;2;0;4;1;0;0;0;4;19;1;4;187;37;37;1;0;0;4;4;187;0;3670;4;2;
/org.eclipse.jdt.ui/ui/org/eclipse/jdt/internal/ui/viewsupport/MarkerErrorTickProvider.java;1;0;7;1;0;0;0;7;54;1;7;1241;78;78;1;0;0;7;7;1241;0;2581;7;1;
/org.eclipse.pde.ui/Eclipse PDE UI/org/eclipse/pde/internal/model/AbstractModel.java;2;0;6;2;0;0;0;6;12;3;4;267;13;13;3;2;0;6;6;324;2;1434;4;2;
/org.eclipse.debug.ui/ui/org/eclipse/debug/internal/ui/LazyModelPresentation.java;3;0;14;1;1;1;1;13;27;2;12;187;109;109;2;1;0;13;14;3362;1;4423;13;3;
/org.eclipse.pde.ui/src/org/eclipse/pde/internal/core/schema/ExternalSchemaDescriptor.java;1;0;2;1;0;0;0;2;0;1;2;3579;0;0;1;0;0;2;2;3579;0;3607;2;1;
/org.eclipse.swt.examples.controls/src/org/eclipse/swt/examples/controls/SashTab.java;2;0;2;1;0;0;0;2;0;1;2;391;0;0;1;0;0;2;2;391;0;611;2;2;
/org.eclipse.ui/Eclipse UI Standard Components/org/eclipse/ui/views/navigator/OpenActionContributionFactory.java;1;0;2;1;0;0;0;2;0;1;2;1726;0;0;1;0;0;2;2;1726;0;1757;2;1;
/org.eclipse.ui/Eclipse UI/org/eclipse/ui/internal/misc/PluginFileFinder.java;2;0;4;1;0;0;0;4;42;1;4;1100;43;43;1;0;0;4;4;1100;0;2741;4;2;
/org.eclipse.ui/Eclipse JFace/org/eclipse/jface/viewers/AbstractTreeViewer.java;4;0;10;1;1;1;1;9;32;2;8;257;105;105;2;1;0;9;10;3359;1;4195;9;4;
/org.eclipse.jdt.ui.tests/refactoring/org/eclipse/jdt/refactoring/tests/RenameStaticMethodTests.java;4;0;12;1;0;0;0;12;32;1;12;49;107;107;1;0;0;12;12;49;0;1896;12;4;
/org.eclipse.team.cvs.ui/src/org/eclipse/team/internal/ccvs/ui/sync/CVSSyncSet.java;3;1;6;1;6;6;6;0;66;0;0;4055;178;178;1;0;0;0;6;4055;0;4632;6;3;
/org.eclipse.jdt.ui/ui/org/eclipse/jdt/internal/ui/preferences/CorrectionMessages.java;1;0;1;1;0;0;0;1;0;0;1;3572;0;0;1;0;0;1;1;3572;0;3572;1;1;
/org.eclipse.help/webapps/examples/WEB-INF/classes/examples/ExampleTagBase.java;1;0;2;1;0;0;0;2;0;1;2;1882;0;0;1;0;0;2;2;1882;0;1930;2;1;
/org.eclipse.pde.ui/src/org/eclipse/pde/internal/editor/jars/JarsPage.java;2;0;3;1;0;0;0;3;4;1;3;1434;4;4;1;0;0;3;3;1434;0;2650;3;2;
/org.eclipse.jdt.ui.tests.refactoring/resources/RenameType/test3/out/B.java;1;0;1;1;0;0;0;1;0;0;1;522;0;0;1;0;0;1;1;522;0;522;1;1;
/org.eclipse.jdt.ui/core refactoring/org/eclipse/jdt/core/refactoring/Change.java;1;0;4;1;0;0;0;4;20;1;4;15;27;27;1;0;0;4;4;15;0;408;4;1;
/org.eclipse.jdt.ui.tests.refactoring/resources/RenameTemp/canRename/A_test21_out.java;1;0;2;1;0;0;0;2;2;1;2;1625;2;2;1;0;0;2;2;1625;0;1652;2;1;
/org.eclipse.pde.ui/src/org/eclipse/pde/internal/ui/wizards/StatusWizardPage.java;1;0;1;1;0;0;0;1;0;0;1;3579;0;0;1;0;0;1;1;3579;0;3579;1;1;
/org.eclipse.jdt.core/model/org/eclipse/jdt/internal/core/SourceMethodElementInfo.java;2;0;3;1;1;1;1;2;104;1;2;455;122;122;1;0;0;2;3;455;0;4063;3;2;
/org.eclipse.jdt.ui/nls/org/eclipse/jdt/internal/ui/nls/ExternalizeWizard.java;1;0;4;1;0;0;0;4;13;2;3;1880;23;23;2;1;0;4;4;1880;1;1913;3;1;
/org.eclipse.core.runtime/src/org/eclipse/core/runtime/model/InstallModel.java;4;0;6;1;0;0;0;6;386;1;6;82;428;428;1;0;0;6;6;82;0;3719;6;4;
/org.eclipse.jdt.core/compiler/org/eclipse/jdt/internal/compiler/ast/ConstructorDeclaration.java;2;1;24;1;3;3;3;21;515;4;17;455;1244;1244;4;4;0;21;24;1039;4;4421;20;2;
/org.eclipse.jdt.ui/ui/org/eclipse/jdt/internal/ui/browsing/ShowInEditorAction.java;2;0;2;1;1;1;1;1;0;0;1;2878;0;0;1;0;0;1;2;2878;0;4116;2;2;
/org.eclipse.webdav/src/kernel/org/eclipse/webdav/internal/kernel/EntityTag.java;3;0;6;1;1;1;1;5;314;1;5;12;616;616;1;0;0;5;6;12;0;4211;6;3;
/org.eclipse.swt/Eclipse SWT Custom Widgets/common_j2se/org/eclipse/swt/custom/StyledTextPrinter.java;1;0;1;1;0;0;0;1;0;0;1;1378;0;0;1;0;0;1;1;1378;0;1378;1;1;
/org.eclipse.pde.ui/src/org/eclipse/pde/internal/editor/SystemFileEditorInput.java;2;0;3;1;0;0;0;3;86;1;3;1434;86;86;1;0;0;3;3;1434;0;3579;3;2;
/org.eclipse.vcm.ui/src/org/eclipse/vcm/internal/ui/VersionSelectionDialog.java;4;0;15;2;0;0;0;15;51;3;11;1;211;211;3;4;0;15;15;1;4;1289;11;4;
/org.eclipse.jdt.ui/ui refactoring/org/eclipse/jdt/internal/ui/refactoring/actions/RefactoringGroup.java;4;0;47;2;0;0;0;47;177;3;39;15;1187;1187;3;8;0;47;47;1339;8;3791;39;4;
/org.eclipse.jdt.ui/core extension/org/eclipse/jdt/internal/corext/template/java/JavaDocContext.java;1;0;3;1;1;1;1;2;56;1;2;2784;75;75;1;0;0;2;3;2784;0;4186;3;1;
/org.eclipse.tomcat/src/org/eclipse/tomcat/internal/TomcatClassLoader.java;1;0;3;1;1;1;1;2;36;1;2;3285;38;38;1;0;0;2;3;3285;0;4435;3;1;
/org.eclipse.vcm.ui/src/org/eclipse/vcm/internal/ui/sync/IRepositoryDeltaCollector.java;1;0;2;1;0;0;0;2;5;1;2;48;5;5;1;0;0;2;2;48;0;298;2;1;
/org.eclipse.jdt.debug.ui/ui/org/eclipse/jdt/internal/debug/ui/actions/BreakpointSuspendPolicyToggleAction.java;1;0;1;1;1;1;1;0;0;0;0;4126;0;0;1;0;0;0;1;4126;0;4126;1;1;
/org.eclipse.jdt.ui.tests.refactoring/resources/DeleteSourceReferenceEdit/A_test2_out.java;1;0;1;1;0;0;0;1;0;0;1;2857;0;0;1;0;0;1;1;2857;0;2857;1;1;
/org.eclipse.jdt.core/compiler/org/eclipse/jdt/internal/compiler/problem/UnresolvedCompilationError.java;1;0;3;1;0;0;0;3;15;1;3;455;15;15;1;0;0;3;3;455;0;3081;3;1;
/org.eclipse.jdt.debug/eval/org/eclipse/jdt/internal/debug/eval/ast/EvaluationObject.java;1;0;3;1;0;0;0;3;154;1;3;3329;154;154;1;0;0;3;3;3329;0;3421;3;1;
/org.eclipse.compare/compare/org/eclipse/compare/internal/IStatusLine.java;1;0;2;1;0;0;0;2;0;1;2;2415;0;0;1;0;0;2;2;2415;0;2704;2;1;
/org.eclipse.jdt.ui.tests/JUnit/junit/swingui/TestRunner.java;2;0;2;1;0;0;0;2;0;1;2;49;0;0;1;0;0;2;2;49;0;1186;2;2;
/org.eclipse.pde.ui/src/org/eclipse/pde/internal/ui/TracingOptionsManager.java;1;0;2;1;0;0;0;2;0;1;2;3579;0;0;1;0;0;2;2;3579;0;3607;2;1;
/org.eclipse.pde.ui/Eclipse PDE UI/org/eclipse/pde/internal/base/model/plugin/IPluginModelBase.java;2;0;5;2;0;0;0;5;30;3;3;267;30;30;3;2;0;5;5;324;2;1434;3;2;
/org.eclipse.jdt.ui.tests.refactoring/resources/ExtractTemp/canExtract/A_test10_out.java;1;0;1;1;0;0;0;1;0;0;1;2481;0;0;1;0;0;1;1;2481;0;2481;1;1;
/org.eclipse.pde.ui/Eclipse PDE UI/org/eclipse/pde/internal/wizards/extension/PointSelectionPage.java;2;0;7;2;0;0;0;7;47;3;5;267;72;72;3;2;0;7;7;324;2;1434;5;2;
/org.eclipse.core.tests.runtime/src/org/eclipse/core/tests/internal/plugins/SoftPrereqTest_13.java;3;0;3;1;0;0;0;3;110;1;3;1794;120;120;1;0;0;3;3;1794;0;3476;3;3;
/org.eclipse.jdt.ui/core refactoring/org/eclipse/jdt/internal/corext/refactoring/changes/AddToClasspathChange.java;3;0;3;1;1;1;1;2;6;1;2;1939;8;8;1;0;0;2;3;1939;0;4163;3;3;
/org.eclipse.core.tests.resources/src/org/eclipse/core/tests/internal/localstore/FileSystemStoreTest.java;3;1;6;1;3;3;3;3;818;1;3;1794;864;864;1;0;0;3;6;1794;0;4772;6;3;
/org.eclipse.ui.examples.readmetool/Eclipse UI Examples Readme Tool/org/eclipse/ui/examples/readmetool/ReadmeCreationWizard.java;2;0;2;1;0;0;0;2;2;1;2;932;2;2;1;0;0;2;2;932;0;945;2;2;
/org.eclipse.jdt.ui/ui/org/eclipse/jdt/internal/ui/reorg/ClipboardActionUtil.java;3;1;8;1;3;3;3;5;98;1;5;3167;118;118;1;0;0;5;8;3167;0;4621;8;3;
/org.eclipse.jdt.junit/src/org/eclipse/jdt/internal/junit/wizards/NewTestCaseCreationWizardPage2.java;3;1;7;1;4;4;4;3;14;1;3;3527;34;34;1;0;0;3;7;3527;0;4634;7;3;
/org.eclipse.pde.ui/src/org/eclipse/pde/internal/ui/preferences/ComboFieldEditor.java;1;0;1;1;0;0;0;1;0;0;1;3579;0;0;1;0;0;1;1;3579;0;3579;1;1;
/org.eclipse.update.core/src/org/eclipse/update/examples/buildzip/Test.java;1;0;1;1;0;0;0;1;0;0;1;2472;0;0;1;0;0;1;1;2472;0;2472;1;1;
/org.eclipse.help/src/org/eclipse/help/internal/contributors/xml/XMLActionContributorCreator.java;2;0;2;1;0;0;0;2;0;1;2;1420;0;0;1;0;0;2;2;1420;0;1675;2;2;
/org.eclipse.team.tests.core/src/org/eclipse/team/tests/core/RepositoryProviderOtherSport.java;2;0;4;1;1;1;1;3;10;0;1;3271;10;10;3;2;0;3;4;3271;2;4545;2;2;
/org.eclipse.jdt.ui.tests.refactoring/resources/ExtractMethodWorkSpace/ExtractMethodTests/validSelection/A_test308.java;2;1;3;1;2;2;2;1;0;0;1;49;0;0;1;0;0;1;3;49;0;4419;3;2;
/org.eclipse.scripting/Eclipse Scripting/org/eclipse/scripting/internal/IXGRElementUIImageElement.java;1;0;3;1;0;0;0;3;4;1;3;133;4;4;1;0;0;3;3;133;0;1424;3;1;
/org.eclipse.jdt.debug/model/org/eclipse/jdt/internal/debug/core/model/JDIObjectValue.java;3;1;13;2;2;2;2;11;73;3;7;2517;180;180;3;4;0;11;13;2517;4;4423;9;3;
/org.eclipse.compare/compare/org/eclipse/compare/internal/TokenComparator.java;2;0;6;1;0;0;0;6;70;1;6;14;132;132;1;0;0;6;6;14;0;1225;6;2;
/org.eclipse.jdt.ui/ui/org/eclipse/jdt/internal/ui/actions/AddUnimplementedConstructorsAction.java;3;0;6;1;1;1;1;5;10;1;5;2157;18;18;1;0;0;5;6;2157;0;3968;6;3;
/org.eclipse.scripting/src/org/eclipse/scripting/internal/views/ScriptDevelopmentWizardPageResourceType.java;1;0;1;1;0;0;0;1;0;0;1;1424;0;0;1;0;0;1;1;1424;0;1424;1;1;
/org.eclipse.team.cvs.ui/src/org/eclipse/team/internal/ccvs/ui/TimeoutProgressMonitorDialog.java;1;0;1;1;0;0;0;1;0;0;1;3791;0;0;1;0;0;1;1;3791;0;3791;1;1;
/org.eclipse.ui/Eclipse JFace/org/eclipse/jface/viewers/TreeExpansionEvent.java;2;0;2;1;0;0;0;2;5;1;2;257;5;5;1;0;0;2;2;257;0;457;2;2;
/org.eclipse.pde.ui/src/org/eclipse/pde/internal/ui/wizards/templates/PopupMenuTemplate.java;1;0;5;1;1;1;1;4;152;1;4;3812;197;197;1;0;0;4;5;3812;0;4316;5;1;
/org.eclipse.swt/Eclipse SWT OLE Win32/win32/org/eclipse/swt/ole/win32/OleEventSink.java;2;0;4;1;1;1;1;3;146;1;3;106;157;157;1;0;0;3;4;106;0;4701;4;2;
/org.eclipse.jdt.debug/model/org/eclipse/jdt/debug/core/IJavaBreakpoint.java;2;0;11;1;1;1;1;10;93;1;10;1035;323;323;1;0;0;10;11;1035;0;4423;11;2;
/org.eclipse.pde.ui/src/org/eclipse/pde/internal/editor/schema/SchemaFormPage.java;2;0;4;1;0;0;0;4;4;1;4;1434;6;6;1;0;0;4;4;1434;0;3579;4;2;
/org.eclipse.jdt.debug.ui/ui/org/eclipse/jdt/internal/debug/ui/actions/OpenTypeAction.java;1;0;4;1;1;1;1;3;31;1;3;2384;45;45;1;0;0;3;4;2384;0;4552;4;1;
/org.eclipse.jdt.ui/ui refactoring/org/eclipse/jdt/internal/ui/refactoring/nls/FindStringsAction.java;2;0;14;2;0;0;0;14;86;2;12;1922;269;269;2;2;0;14;14;1922;2;3565;12;2;
/org.eclipse.ui.tests/Eclipse UI Tests/org/eclipse/ui/tests/api/IViewPartTest.java;1;0;1;1;0;0;0;1;0;0;1;1453;0;0;1;0;0;1;1;1453;0;1453;1;1;
/org.eclipse.team.cvs.core/src/org/eclipse/team/internal/ccvs/core/connection/CVSCommunicationException.java;2;0;3;1;1;1;1;2;92;1;2;1978;102;102;1;0;0;2;3;1978;0;4368;3;2;
/org.eclipse.pde.ui/src/org/eclipse/pde/internal/ui/editor/manifest/ManifestExtensionPointPage.java;1;0;1;1;0;0;0;1;0;0;1;3579;0;0;1;0;0;1;1;3579;0;3579;1;1;
/org.eclipse.jdt.ui.tests.refactoring/resources/RenamePackage/test1/in/p/A.java;2;0;2;1;0;0;0;2;0;1;2;49;0;0;1;0;0;2;2;49;0;1258;2;2;
/org.eclipse.debug.ui/ui/org/eclipse/debug/internal/ui/actions/ShowSupportedBreakpointsAction.java;2;1;4;1;2;2;2;2;16;1;2;3532;20;20;1;0;0;2;4;3532;0;4386;4;2;
/org.eclipse.scripting/src/org/eclipse/scripting/internal/views/ScriptDevelopmentPreferencePageWorkbenchExport.java;1;0;1;1;0;0;0;1;0;0;1;1424;0;0;1;0;0;1;1;1424;0;1424;1;1;
/org.eclipse.help/src/org/eclipse/help/internal/search/SearchHit.java;1;1;2;1;2;2;2;0;18;0;0;4000;18;18;1;0;0;0;2;4000;0;4043;2;1;
/org.eclipse.webdav/src/interface/org/eclipse/webdav/dom/LockDiscovery.java;3;0;5;1;1;1;1;4;204;1;4;12;254;254;1;0;0;4;5;12;0;4211;5;3;
/org.eclipse.ui.externaltools/External Tools/org/eclipse/ui/externaltools/internal/ui/AddTaskDialog.java;1;1;2;1;2;2;2;0;2;0;0;4123;2;2;1;0;0;0;2;4123;0;4426;2;1;
/org.eclipse.ui/Eclipse UI/org/eclipse/ui/internal/dialogs/PerspLabelProvider.java;5;0;5;1;0;0;0;5;73;1;5;257;115;115;1;0;0;5;5;257;0;3487;5;5;
/org.eclipse.core.runtime/src/org/eclipse/core/runtime/PluginVersionIdentifier.java;5;1;12;1;2;2;2;10;842;1;10;12;1327;1327;1;0;0;10;12;12;0;4455;12;5;
/org.eclipse.jdt.ui/ui/org/eclipse/jdt/internal/ui/util/SelectionUtil.java;2;0;5;1;0;0;0;5;35;1;5;15;55;55;1;0;0;5;5;15;0;1199;5;2;
/org.eclipse.jdt.ui/core refactoring/org/eclipse/jdt/internal/corext/refactoring/text/ITextBufferChangeCreator.java;1;0;2;1;0;0;0;2;0;1;2;1939;0;0;1;0;0;2;2;1939;0;2216;2;1;
/org.eclipse.help/Eclipse Help/org/eclipse/help/internal/server/AddressTest.java;2;0;3;1;0;0;0;3;7;1;3;135;7;7;1;0;0;3;3;135;0;1420;3;2;
/org.eclipse.swt/Eclipse SWT PI/gtk/org/eclipse/swt/internal/gtk/GdkEventButton.java;2;0;5;1;2;1;2;3;58;1;3;2107;65;65;2;0;1;3;5;4701;1;4701;4;2;
/org.eclipse.jdt.core/model/org/eclipse/jdt/internal/core/builder/impl/StateImpl.java;1;0;15;1;0;0;0;15;1200;4;11;455;3077;3077;4;4;0;15;15;1039;4;2808;11;1;
/org.eclipse.scripting/src/org/eclipse/scripting/internal/views/ScriptDevelopmentPreferencePageWorkbenchEditor.java;1;0;1;1;0;0;0;1;0;0;1;1424;0;0;1;0;0;1;1;1424;0;1424;1;1;
/org.eclipse.team.cvs.ui/src/org/eclipse/team/internal/ccvs/ui/IgnoreResourcesDialog.java;1;1;2;1;2;2;2;0;5;0;0;4021;5;5;1;0;0;0;2;4021;0;4425;2;1;
/org.eclipse.swt/Eclipse SWT/carbon/org/eclipse/swt/widgets/Button.java;3;2;5;1;5;4;5;0;61;0;0;4147;82;82;2;0;1;0;5;4605;1;4701;4;3;
/org.eclipse.webdav/src/interface/org/eclipse/webdav/dom/ActiveLock.java;4;0;6;1;1;1;1;5;518;1;5;12;643;643;1;0;0;5;6;12;0;4211;6;4;
/org.eclipse.vcm.core.cvs/src/org/eclipse/vcm/internal/core/ccvs/CVSModule.java;2;0;2;1;0;0;0;2;5;1;2;0;5;5;1;0;0;2;2;0;0;298;2;2;
/org.eclipse.jdt.ui.tests.refactoring/resources/SefWorkSpace/SefTests/object_in/TestSetterInInitialization.java;1;0;1;1;0;0;0;1;0;0;1;2876;0;0;1;0;0;1;1;2876;0;2876;1;1;
/org.eclipse.swt/Eclipse SWT/gtk/org/eclipse/swt/widgets/Tree.java;6;3;43;2;18;15;18;25;1047;3;19;2107;2521;2521;3;6;3;25;43;2274;9;4823;34;6;
/org.eclipse.vcm.core/src/org/eclipse/vcm/internal/core/base/IIgnoreInfo.java;1;0;1;1;0;0;0;1;0;0;1;373;0;0;1;0;0;1;1;373;0;373;1;1;
/org.eclipse.pde.ui/src/org/eclipse/pde/internal/ui/ischema/ISchemaObject.java;1;0;3;1;0;0;0;3;3;2;2;3579;3;3;2;1;0;3;3;3579;1;3591;2;1;
/org.eclipse.ui.tests/Eclipse UI Tests/org/eclipse/ui/tests/api/ListElement.java;1;0;4;1;0;0;0;4;34;2;3;1403;50;50;2;1;0;4;4;1403;1;2033;3;1;
/org.eclipse.jdt.debug/jdi interfaces/com/sun/jdi/Mirror.java;2;0;2;1;0;0;0;2;6;1;2;2704;6;6;1;0;0;2;2;2704;0;3033;2;2;
/org.eclipse.jdt.ui/ui/org/eclipse/jdt/internal/ui/search/SearchUtil.java;2;4;16;2;10;7;10;6;127;2;5;3318;325;325;4;1;3;6;16;4137;4;4627;12;2;
/org.eclipse.jdt.ui.tests.refactoring/resources/PullUp/test17/out/A.java;1;0;1;1;0;0;0;1;0;0;1;2406;0;0;1;0;0;1;1;2406;0;2406;1;1;
/org.eclipse.debug.ui/ui/org/eclipse/debug/internal/ui/actions/SelectAllVariablesAction.java;1;0;4;1;0;0;0;4;16;1;4;3178;22;22;1;0;0;4;4;3178;0;3730;4;1;
/org.eclipse.jdt.ui.tests.refactoring/resources/RenameNonPrivateField/testFail8/in/A.java;1;0;1;1;0;0;0;1;0;0;1;49;0;0;1;0;0;1;1;49;0;49;1;1;
/org.eclipse.swt/Eclipse SWT Drag and Drop/carbon/org/eclipse/swt/dnd/Transfer.java;4;1;6;1;6;6;6;0;57;0;0;4147;127;127;1;0;0;0;6;4147;0;4830;6;4;
/org.eclipse.jdt.ui/ui/org/eclipse/jdt/internal/ui/wizards/dialogfields/StringButtonDialogField.java;2;0;6;1;0;0;0;6;40;1;6;15;68;68;1;0;0;6;6;15;0;3084;6;2;
/org.eclipse.swt.tests/JUnit Tests/org/eclipse/swt/tests/junit/Test_org_eclipse_swt_events_KeyEvent.java;2;0;2;1;1;1;1;1;6;0;1;1792;6;6;1;0;0;1;2;1792;0;4706;2;2;
/org.eclipse.swt/Eclipse SWT Custom Widgets/common_j2se/org/eclipse/swt/custom/LineStyleListener.java;1;0;1;1;0;0;0;1;0;0;1;1378;0;0;1;0;0;1;1;1378;0;1378;1;1;
/org.eclipse.jdt.ui/ui/org/eclipse/jdt/internal/ui/javaeditor/structureselection/StructureSelectHistoryAction.java;1;1;4;1;2;2;2;2;6;0;1;3567;12;12;2;1;0;2;4;3567;1;4630;3;1;
/org.eclipse.jdt.ui.tests.refactoring/resources/RenameTemp/canRename/A_test17_in.java;1;0;1;1;0;0;0;1;0;0;1;1625;0;0;1;0;0;1;1;1625;0;1625;1;1;
/org.eclipse.update.core/src/org/eclipse/update/core/IPluginContainer.java;3;0;16;1;0;0;0;16;54;2;14;1423;184;184;2;2;0;16;16;2661;2;2994;14;3;
/org.eclipse.update.examples/src/org/eclipse/update/examples/freeform/FreeFormSiteContentProvider.java;1;0;1;1;0;0;0;1;0;0;1;3028;0;0;1;0;0;1;1;3028;0;3028;1;1;
/org.eclipse.jdt.core/dom/org/eclipse/jdt/core/dom/ParenthesizedExpression.java;2;1;6;1;2;2;2;4;11;1;4;2669;35;35;1;0;0;4;6;2669;0;4453;6;2;
/org.eclipse.jdt.ui/core extension/org/eclipse/jdt/internal/corext/codemanipulation/ASTNodeCodeBlock.java;1;0;1;1;0;0;0;1;0;0;1;3870;0;0;1;0;0;1;1;3870;0;3870;1;1;
/org.eclipse.pde.ui/src/org/eclipse/pde/internal/ui/preferences/TracingPropertySource.java;1;0;2;1;0;0;0;2;0;1;2;3579;0;0;1;0;0;2;2;3579;0;3634;2;1;
/org.eclipse.team.cvs.ui/src/org/eclipse/team/internal/ccvs/ui/sync/CommitMergeAction.java;1;0;10;1;0;0;0;10;99;3;7;2231;210;210;3;3;0;10;10;2231;3;2828;7;1;
/org.eclipse.jdt.core/model/org/eclipse/jdt/core/util/IClassFileReader.java;2;1;8;1;5;5;5;3;49;2;2;3629;146;146;2;1;0;3;8;3629;1;4573;7;2;
/org.eclipse.ui/Eclipse JFace/org/eclipse/jface/viewers/ColumnWeightData.java;2;0;2;1;0;0;0;2;5;1;2;257;5;5;1;0;0;2;2;257;0;457;2;2;
/org.eclipse.jdt.ui.tests.refactoring/resources/PullUp/test5/out/A.java;1;0;1;1;0;0;0;1;0;0;1;2406;0;0;1;0;0;1;1;2406;0;2406;1;1;
/org.eclipse.jdt.ui.tests.refactoring/resources/ExtractMethodWorkSpace/ExtractMethodTests/locals_out/A_test527.java;1;2;4;1;3;2;3;1;58;0;1;2684;58;58;2;0;1;1;4;4419;1;4419;3;1;
/org.eclipse.jdt.ui/core refactoring/org/eclipse/jdt/internal/core/refactoring/changes/RenameResourceChange.java;2;0;3;1;0;0;0;3;4;1;3;1342;4;4;1;0;0;3;3;1342;0;1939;3;2;
/org.eclipse.jdt.ui/core extension/org/eclipse/jdt/internal/corext/codemanipulation/SimpleTextEdit.java;1;0;4;1;0;0;0;4;74;2;3;1937;82;82;2;1;0;4;4;2133;1;2133;3;1;
/org.eclipse.jdt.ui/ui/org/eclipse/jdt/internal/ui/reorg/DeleteResourcesAction.java;3;1;8;1;2;2;2;6;77;1;6;3222;164;164;1;0;0;6;8;3222;0;4426;8;3;
/org.eclipse.team.cvs.ui/src/org/eclipse/team/internal/ccvs/ui/actions/GenerateDiffFileAction.java;3;1;10;1;2;2;2;8;83;1;8;1992;145;145;1;0;0;8;10;1992;0;4021;10;3;
/org.eclipse.jdt.ui/ui refactoring/org/eclipse/jdt/internal/ui/nls/search/LibraryFilter.java;1;0;2;1;0;0;0;2;0;1;2;1913;0;0;1;0;0;2;2;1913;0;1922;2;1;
/org.eclipse.scripting/Eclipse Scripting/org/eclipse/scripting/internal/IXGRElementEventGeneratorOnClick.java;1;0;3;1;0;0;0;3;4;1;3;133;4;4;1;0;0;3;3;133;0;1424;3;1;
/org.eclipse.swt/Eclipse SWT Custom Widgets/common_j2se/org/eclipse/swt/custom/TreeEditor.java;1;0;1;1;0;0;0;1;0;0;1;1378;0;0;1;0;0;1;1;1378;0;1378;1;1;
/org.eclipse.ui/Eclipse UI/org/eclipse/ui/internal/ViewSite.java;5;0;7;1;0;0;0;7;12;1;7;257;41;41;1;0;0;7;7;257;0;2548;7;5;
/org.eclipse.pde.ui/src/org/eclipse/pde/internal/ui/editor/SystemFileDocumentProvider.java;1;1;3;1;2;2;2;1;94;0;1;3579;95;95;1;0;0;1;3;3579;0;4568;3;1;
/org.eclipse.scripting/Eclipse Scripting/org/eclipse/scripting/internal/views/ScriptDevelopmentPreferencePageWorkbenchEditor.java;2;0;5;1;0;0;0;5;31;1;5;133;40;40;1;0;0;5;5;133;0;1424;5;2;
/org.eclipse.jdt.ui.tests.refactoring/resources/RenamePrivateMethod/test12/in/A.java;1;0;1;1;0;0;0;1;0;0;1;49;0;0;1;0;0;1;1;49;0;49;1;1;
/org.eclipse.pde.ui/Eclipse PDE UI/org/eclipse/pde/internal/editor/text/TextUtil.java;2;0;5;2;0;0;0;5;12;3;3;267;12;12;3;2;0;5;5;324;2;1434;3;2;
/org.eclipse.pde.ui/src/org/eclipse/pde/internal/editor/schema/IRestrictionPage.java;2;0;2;1;0;0;0;2;0;1;2;1434;0;0;1;0;0;2;2;1434;0;3579;2;2;
/org.eclipse.team.cvs.core/src/org/eclipse/team/internal/ccvs/core/util/ProjectDescriptionWriter.java;3;0;5;1;0;0;0;5;203;1;5;1978;245;245;1;0;0;5;5;1978;0;3610;5;3;
/org.eclipse.scripting/src/org/eclipse/scripting/IDataElement.java;1;0;1;1;0;0;0;1;0;0;1;1424;0;0;1;0;0;1;1;1424;0;1424;1;1;
/org.eclipse.update.core/src/org/eclipse/update/core/model/InvalidSiteTypeException.java;1;0;3;1;0;0;0;3;38;1;3;2413;64;64;1;0;0;3;3;2413;0;3591;3;1;
/org.eclipse.search/search/org/eclipse/search/internal/ui/RemoveAllResultsAction.java;2;0;5;1;1;1;1;4;9;1;4;15;19;19;1;0;0;4;5;15;0;4619;5;2;
/org.eclipse.jdt.ui.tests.refactoring/resources/RenameType/test42/out/B.java;1;0;1;1;0;0;0;1;0;0;1;522;0;0;1;0;0;1;1;522;0;522;1;1;
/org.eclipse.vcm.core.cvs/src/org/eclipse/vcm/internal/core/ccvs/client/Request.java;2;0;2;1;0;0;0;2;6;1;2;0;6;6;1;0;0;2;2;0;0;298;2;2;
/org.eclipse.ui/Eclipse UI/org/eclipse/ui/internal/SwitchToWindowMenu.java;4;0;6;1;1;1;1;5;145;1;5;257;190;190;1;0;0;5;6;257;0;3894;6;4;
/org.eclipse.core.runtime/src/org/eclipse/core/runtime/IExecutableExtension.java;3;0;4;1;1;1;1;3;226;1;3;12;246;246;1;0;0;3;4;12;0;4214;4;3;
/org.eclipse.jdt.ui.tests.refactoring/resources/RenameType/test9/out/A.java;1;0;2;1;0;0;0;2;0;1;2;49;0;0;1;0;0;2;2;49;0;522;2;1;
/org.eclipse.pde.ui/src/org/eclipse/pde/core/IIdentifiable.java;1;0;2;1;0;0;0;2;0;1;2;3579;0;0;1;0;0;2;2;3579;0;3607;2;1;
/org.eclipse.scripting/src/org/eclipse/scripting/internal/uirenderer/XGRElementUISwtTableData.java;1;0;1;1;0;0;0;1;0;0;1;1424;0;0;1;0;0;1;1;1424;0;1424;1;1;
/org.eclipse.scripting/src/org/eclipse/scripting/internal/IXGRElementEventGeneratorOnKeyPress.java;1;0;1;1;0;0;0;1;0;0;1;1424;0;0;1;0;0;1;1;1424;0;1424;1;1;
/org.eclipse.jdt.ui.tests.refactoring/resources/ReorderParameters/canReorder/A_test0_in.java;1;0;3;1;0;0;0;3;0;1;3;724;0;0;1;0;0;3;3;724;0;2270;3;1;
/org.eclipse.swt/Eclipse SWT/common/org/eclipse/swt/widgets/Layout.java;3;1;4;1;2;2;2;2;6;1;2;106;16;16;1;0;0;2;4;106;0;4701;4;3;
/org.eclipse.swt/Eclipse SWT/motif/org/eclipse/swt/graphics/Color.java;3;1;5;1;3;3;3;2;163;1;2;106;229;229;1;0;0;2;5;106;0;4701;5;3;
/org.eclipse.jdt.debug.ui/ui/org/eclipse/jdt/internal/debug/ui/SWTUtil.java;2;1;3;1;2;2;2;1;3;0;1;3816;4;4;1;0;0;1;3;3816;0;4426;3;2;
/org.eclipse.ant.core/src/org/eclipse/ant/core/AntRunner.java;5;2;24;2;5;4;5;19;1440;2;15;14;4346;4346;2;4;1;19;24;357;5;4572;19;5;
/org.eclipse.jdt.debug/jdi/org/eclipse/jdi/internal/jdwp/JDWPMessages.java;1;0;1;1;0;0;0;1;0;0;1;3677;0;0;1;0;0;1;1;3677;0;3677;1;1;
/org.eclipse.scripting/Eclipse Scripting/org/eclipse/scripting/internal/uirenderer/XGRElementUISwtLabel.java;2;0;6;1;0;0;0;6;41;1;6;133;56;56;1;0;0;6;6;133;0;1424;6;2;
/org.eclipse.ui/Eclipse UI/org/eclipse/ui/actions/SelectionListenerAction.java;3;0;4;1;0;0;0;4;18;1;4;257;27;27;1;0;0;4;4;257;0;2864;4;3;
/org.eclipse.team.tests.cvs.core/src/org/eclipse/team/tests/ccvs/ui/LoggingTestCase.java;1;0;3;1;0;0;0;3;11;1;3;3068;16;16;1;0;0;3;3;3068;0;3452;3;1;
/org.eclipse.jdt.ui/ui refactoring/org/eclipse/jdt/internal/ui/refactoring/actions/PullUpAction.java;2;0;5;2;1;1;1;4;18;3;2;3793;18;18;3;2;0;4;5;3826;2;3970;3;2;
/org.eclipse.pde.ui/src/org/eclipse/pde/internal/editor/manifest/PluginListSection.java;2;0;4;1;0;0;0;4;21;1;4;1434;23;23;1;0;0;4;4;1434;0;2650;4;2;
/org.eclipse.debug.ui/ui/org/eclipse/debug/internal/ui/StepOverActionDelegate.java;3;0;7;1;0;0;0;7;43;1;7;187;71;71;1;0;0;7;7;187;0;2382;7;3;
/org.eclipse.jdt.ui/ui/org/eclipse/jdt/internal/ui/text/template/TemplateVariableProcessor.java;1;0;4;1;0;0;0;4;64;1;4;1929;113;113;1;0;0;4;4;1929;0;3589;4;1;
/org.eclipse.jdt.ui.tests.refactoring/resources/RenameType/test38/in/A.java;1;0;1;1;0;0;0;1;0;0;1;49;0;0;1;0;0;1;1;49;0;49;1;1;
/org.eclipse.update.ui.win32/src/org/eclipse/update/internal/ui/win32/views/WebBrowserView.java;2;1;2;1;2;2;2;0;2;0;0;4127;2;2;1;0;0;0;2;4127;0;4610;2;2;
/org.eclipse.swt/Eclipse SWT/common/org/eclipse/swt/internal/image/JPEGFrameHeader.java;3;0;4;1;1;1;1;3;15;1;3;106;25;25;1;0;0;3;4;106;0;4701;4;3;
/org.eclipse.ui/Eclipse UI Standard Components/org/eclipse/ui/views/navigator/ActionBarMenuContributionFactory.java;1;0;2;1;0;0;0;2;0;1;2;1727;0;0;1;0;0;2;2;1727;0;1757;2;1;
/org.eclipse.jdt.ui.tests.refactoring/resources/RenameTemp/canRename/A_test6_out.java;1;0;2;1;0;0;0;2;2;1;2;1625;2;2;1;0;0;2;2;1625;0;1652;2;1;
/org.eclipse.jdt.debug/jdi/org/eclipse/jdi/internal/event/ClassUnloadEventImpl.java;2;0;4;1;0;0;0;4;17;1;4;187;33;33;1;0;0;4;4;187;0;3670;4;2;
/org.eclipse.pde.build/src_ant/org/eclipse/pde/internal/build/types/StripMapper.java;1;0;4;1;1;1;1;3;2;2;2;3509;2;2;2;1;0;3;4;3571;1;4026;3;1;
/org.eclipse.update.core/src/org/eclipse/update/internal/core/ConfigurationSite.java;2;0;33;1;0;0;0;33;211;3;24;2032;1240;1240;3;9;0;33;33;2661;9;2994;24;2;
/org.eclipse.jdt.junit/Eclipse JUnit/org/eclipse/jdt/internal/junit/ui/ITestRunView.java;2;0;4;1;0;0;0;4;18;1;4;2007;23;23;1;0;0;4;4;2007;0;3313;4;2;
/org.eclipse.pde.ui/src/org/eclipse/pde/internal/util/SWTUtil.java;1;0;2;1;0;0;0;2;0;1;2;2998;0;0;1;0;0;2;2;2998;0;3579;2;1;
/org.eclipse.jdt.ui.tests.refactoring/resources/RenameVirtualMethodInClass/testAnon0/in/A.java;1;0;1;1;0;0;0;1;0;0;1;49;0;0;1;0;0;1;1;49;0;49;1;1;
/org.eclipse.jdt.debug.ui/ui/org/eclipse/jdt/debug/ui/launchConfigurations/JavaJRETab.java;3;6;12;2;12;7;12;0;153;0;0;4098;240;240;6;0;5;0;12;4214;5;4409;7;3;
/org.eclipse.jdt.ui.tests.refactoring/resources/StructureSelectionAction/OffsetTest.java;1;0;1;1;0;0;0;1;0;0;1;2139;0;0;1;0;0;1;1;2139;0;2139;1;1;
/org.eclipse.swt/Eclipse SWT Drag and Drop/photon/org/eclipse/swt/dnd/Clipboard.java;5;2;14;1;7;6;7;7;149;2;6;106;421;421;2;1;1;7;14;699;2;4824;12;5;
/org.eclipse.pde.ui/src/org/eclipse/pde/internal/ui/editor/feature/FeatureSpecSection.java;1;1;7;1;3;3;3;4;590;2;3;3579;644;644;2;1;0;4;7;3579;1;4318;6;1;
/org.eclipse.jdt.ui/core refactoring/org/eclipse/jdt/internal/corext/refactoring/reorg/MoveRefactoring.java;3;1;13;2;3;3;3;10;92;2;9;1939;242;242;2;1;0;10;13;2212;1;4427;12;3;
/org.eclipse.core.tests.runtime/src/org/eclipse/core/tests/internal/plugins/ConflictResolveTest_4.java;3;0;3;1;0;0;0;3;134;1;3;1794;144;144;1;0;0;3;3;1794;0;3476;3;3;
/org.eclipse.swt/Eclipse SWT/win32/org/eclipse/swt/widgets/ImageList.java;5;0;10;1;1;1;1;9;98;1;9;106;252;252;1;0;0;9;10;106;0;4701;10;5;
/org.eclipse.jdt.ui/core extension/org/eclipse/jdt/internal/corext/util/Bindings.java;2;0;3;1;0;0;0;3;11;1;3;1930;11;11;1;0;0;3;3;1930;0;3412;3;2;
/org.eclipse.update/Eclipse Update/org/eclipse/update/internal/ui/UMWizardPageURLInstallable.java;2;0;4;1;0;0;0;4;677;1;4;108;681;681;1;0;0;4;4;108;0;1424;4;2;
/org.eclipse.swt.tests/JUnit Tests/org/eclipse/swt/tests/junit/Test_org_eclipse_swt_custom_CTabFolder.java;2;0;2;1;1;1;1;1;6;0;1;1792;6;6;1;0;0;1;2;1792;0;4706;2;2;
/org.eclipse.jdt.ui.tests.refactoring/resources/SelectionAnalyzerWorkSpace/SelectionAnalyzerTests/invalidSelection/A_test161.java;1;0;1;1;0;0;0;1;0;0;1;1368;0;0;1;0;0;1;1;1368;0;1368;1;1;
/org.eclipse.team.cvs.ui/src/org/eclipse/team/internal/ccvs/ui/model/BranchCategory.java;2;0;5;1;0;0;0;5;14;1;5;2055;23;23;1;0;0;5;5;2055;0;3644;5;2;
/org.eclipse.debug.ui/ui/org/eclipse/debug/internal/ui/ConsoleViewer.java;3;0;8;1;0;0;0;8;42;1;8;187;65;65;1;0;0;8;8;187;0;2338;8;3;
/org.eclipse.pde.ui/src/org/eclipse/pde/internal/editor/StructuredViewerSection.java;1;0;7;1;0;0;0;7;37;2;6;2998;51;51;2;1;0;7;7;3136;1;3579;6;1;
/org.eclipse.help/src/org/eclipse/help/internal/server/OutputProcessor.java;1;0;2;1;0;0;0;2;0;1;2;1420;0;0;1;0;0;2;2;1420;0;3095;2;1;
/org.eclipse.jdt.ui.tests.refactoring/resources/RenameType/test22/out/B.java;1;0;1;1;0;0;0;1;0;0;1;522;0;0;1;0;0;1;1;522;0;522;1;1;
/org.eclipse.jdt.junit/src/org/eclipse/jdt/internal/junit/oldlauncher/JUnitLauncher.java;2;0;3;1;0;0;0;3;5;1;3;3171;5;5;1;0;0;3;3;3171;0;3638;3;2;
/org.eclipse.core.tests.runtime/src/org/eclipse/core/tests/internal/runtimetests/SampleGPR.java;1;0;2;1;0;0;0;2;10;1;2;3611;10;10;1;0;0;2;2;3611;0;3678;2;1;
/org.eclipse.ui/Eclipse JFace/org/eclipse/jface/viewers/ViewerDropAdapter.java;3;0;4;1;1;1;1;3;47;1;3;257;90;90;1;0;0;3;4;257;0;4081;4;3;
/org.eclipse.pde.build/src/antlib/org/eclipse/pde/internal/core/tasks/InitTemplate.java;1;0;1;1;0;0;0;1;0;0;1;3475;0;0;1;0;0;1;1;3475;0;3475;1;1;
/org.eclipse.jdt.ui.tests.refactoring/resources/RenameType/testFail01/in/A.java;1;0;1;1;0;0;0;1;0;0;1;49;0;0;1;0;0;1;1;49;0;49;1;1;
/org.eclipse.vcm.core/src/org/eclipse/vcm/internal/core/base/IFolderEdition.java;2;0;2;1;0;0;0;2;5;1;2;0;5;5;1;0;0;2;2;0;0;297;2;2;
/org.eclipse.pde.ui/src/org/eclipse/pde/internal/ui/editor/schema/SchemaAdapterFactory.java;1;0;3;1;0;0;0;3;86;2;2;3579;88;88;2;1;0;3;3;3579;1;3591;2;1;
/org.eclipse.pde.ui/src/org/eclipse/pde/internal/editor/feature/FeatureSourcePage.java;1;0;2;1;0;0;0;2;0;1;2;2951;0;0;1;0;0;2;2;2951;0;3579;2;1;
/org.eclipse.jdt.ui.tests.refactoring/resources/PasteSourceReference/test0/out/B.java;1;0;1;1;0;0;0;1;0;0;1;2003;0;0;1;0;0;1;1;2003;0;2003;1;1;
/org.eclipse.jdt.ui.tests.refactoring/resources/ExtractMethodWorkSpace/ExtractMethodTests/A.java;1;1;17;1;2;2;2;15;40;2;12;923;225;225;2;3;0;15;17;2580;3;4419;14;1;
/org.eclipse.jdt.ui/nls/org/eclipse/jdt/internal/ui/nls/ExternalizeWizardPage.java;1;0;4;1;0;0;0;4;5;2;3;1880;7;7;2;1;0;4;4;1880;1;1913;3;1;
/org.eclipse.scripting/src/org/eclipse/scripting/internal/uirenderer/IScriptPreferenceNode.java;1;0;1;1;0;0;0;1;0;0;1;1424;0;0;1;0;0;1;1;1424;0;1424;1;1;
/org.eclipse.jdt.ui/ui/org/eclipse/jdt/internal/ui/text/java/JavaDoubleClickSelector.java;2;0;3;1;0;0;0;3;200;1;3;15;205;205;1;0;0;3;3;15;0;1670;3;2;
/org.eclipse.compare/compare/org/eclipse/compare/internal/SimpleTextViewer.java;1;0;1;1;0;0;0;1;0;0;1;3183;0;0;1;0;0;1;1;3183;0;3183;1;1;
/org.eclipse.ui.tests/Eclipse UI Tests/org/eclipse/ui/tests/internal/ExtendedTextSelectionActionFilter.java;1;0;1;1;0;0;0;1;0;0;1;2236;0;0;1;0;0;1;1;2236;0;2236;1;1;
/org.eclipse.jdt.ui/core refactoring/org/eclipse/jdt/internal/corext/refactoring/surround/ISurroundWithTryCatchQuery.java;1;0;1;1;1;1;1;0;0;0;0;4000;0;0;1;0;0;0;1;4000;0;4000;1;1;
/org.eclipse.jdt.ui/core refactoring/org/eclipse/jdt/internal/corext/refactoring/code/AstMatchingNodeFinder.java;1;0;4;1;1;1;1;3;503;1;3;2480;519;519;1;0;0;3;4;2480;0;4363;4;1;
/org.eclipse.core.tests.runtime/src/org/eclipse/core/tests/runtime/RuntimeTest.java;4;0;5;1;0;0;0;5;48;1;5;1794;78;78;1;0;0;5;5;1794;0;3476;5;4;
/org.eclipse.jdt.launching/launching/org/eclipse/jdt/launching/sourcelookup/ArchiveSourceLocation.java;1;2;10;1;6;5;6;4;117;3;2;2372;350;350;3;2;1;4;10;2372;3;4456;7;1;
/org.eclipse.jdt.debug/eval/org/eclipse/jdt/internal/debug/eval/ast/engine/TwiddleOperator.java;1;0;3;1;0;0;0;3;3;1;3;3329;3;3;1;0;0;3;3;3329;0;3421;3;1;
/org.eclipse.swt/Eclipse SWT PI/photon/org/eclipse/swt/internal/photon/PhTile_t.java;2;0;2;1;1;1;1;1;6;0;1;2069;6;6;1;0;0;1;2;2069;0;4701;2;2;
/org.eclipse.jdt.ui.tests.refactoring/resources/MoveMembers/test2/in/A.java;1;0;1;1;0;0;0;1;0;0;1;2738;0;0;1;0;0;1;1;2738;0;2738;1;1;
/org.eclipse.update.ui/src/org/eclipse/update/internal/ui/model/MonitorAdapter.java;1;0;1;1;0;0;0;1;0;0;1;2797;0;0;1;0;0;1;1;2797;0;2797;1;1;
/org.eclipse.pde.ui/Eclipse PDE UI/org/eclipse/pde/internal/model/build/ExternalBuildModel.java;2;0;6;2;0;0;0;6;12;3;4;267;17;17;3;2;0;6;6;324;2;1434;4;2;
/org.eclipse.swt.tests/JUnit Tests/org/eclipse/swt/tests/junit/Test_org_eclipse_swt_events_ShellEvent.java;2;0;2;1;1;1;1;1;6;0;1;1792;6;6;1;0;0;1;2;1792;0;4706;2;2;
/org.eclipse.team.cvs.core/src/org/eclipse/team/internal/ccvs/core/util/Util.java;3;0;13;1;0;0;0;13;634;1;13;1978;1023;1023;1;0;0;13;13;1978;0;3873;13;3;
/org.eclipse.jdt.ui/ui/org/eclipse/jdt/internal/ui/javaeditor/GotoErrorAction.java;3;0;5;1;2;1;2;3;17;1;3;25;27;27;2;0;1;3;5;4395;1;4395;4;3;
/org.eclipse.jdt.ui.tests.refactoring/resources/ReorderParameters/canReorder/A_test3_in.java;1;0;3;1;0;0;0;3;0;1;3;724;0;0;1;0;0;3;3;724;0;2270;3;1;
/org.eclipse.jdt.ui/ui/org/eclipse/jdt/internal/ui/util/OpenTypeHierarchyUtil.java;5;2;20;1;8;7;8;12;117;1;12;1310;612;612;2;0;1;12;20;4450;1;4621;19;5;
/org.eclipse.vcm.ui/src/org/eclipse/vcm/internal/ui/NavigatorLabelDecorator.java;1;0;7;1;0;0;0;7;126;3;4;273;177;177;3;3;0;7;7;273;3;395;4;1;
/org.eclipse.ui.examples.readmetool/Eclipse UI Examples Readme Tool/org/eclipse/ui/examples/readmetool/ReadmeMarkerResolutionGenerator.java;1;0;1;1;0;0;0;1;0;0;1;2894;0;0;1;0;0;1;1;2894;0;2894;1;1;
/org.eclipse.pde.ui/src/org/eclipse/pde/internal/ui/IEnvironmentVariables.java;1;0;1;1;0;0;0;1;0;0;1;3579;0;0;1;0;0;1;1;3579;0;3579;1;1;
/org.eclipse.jdt.ui/core refactoring/org/eclipse/jdt/internal/core/refactoring/code/flow/ReturnFlowInfo.java;1;0;2;1;0;0;0;2;0;1;2;1236;0;0;1;0;0;2;2;1236;0;1939;2;1;
/org.eclipse.core.runtime/src/org/eclipse/core/internal/runtime/PluginStats.java;3;0;3;1;0;0;0;3;6;1;3;12;6;6;1;0;0;3;3;12;0;1392;3;3;
/org.eclipse.jdt.ui/core extension/org/eclipse/jdt/internal/corext/textmanipulation/TextRegion.java;1;0;1;1;0;0;0;1;0;0;1;2137;0;0;1;0;0;1;1;2137;0;2137;1;1;
/org.eclipse.ui/Eclipse JFace Text/org/eclipse/jface/text/Document.java;5;2;8;2;5;4;5;3;21;1;3;257;62;62;2;0;1;3;8;4449;1;4838;7;5;
/org.eclipse.swt/Eclipse SWT/common/org/eclipse/swt/internal/image/PngChunk.java;4;0;5;1;1;1;1;4;32;1;4;106;53;53;1;0;0;4;5;106;0;4701;5;4;
/org.eclipse.jdt.core/model/org/eclipse/jdt/internal/core/PackageFragmentRoot.java;4;0;30;2;1;1;1;29;588;4;22;455;959;959;4;7;0;29;30;1039;7;4063;23;4;
/org.eclipse.help.webapp/src/org/eclipse/help/servlet/SetUtf8Filter.java;1;0;2;1;0;0;0;2;0;1;2;3499;0;0;1;0;0;2;2;3499;0;3507;2;1;
/org.eclipse.jdt.debug/jdi/org/eclipse/jdi/internal/jdwp/JdwpStringID.java;2;0;3;1;0;0;0;3;5;1;3;187;8;8;1;0;0;3;3;187;0;3040;3;2;
/org.eclipse.scripting/Eclipse Scripting/org/eclipse/scripting/internal/uirenderer/XGRElementUISwtTextFieldHidden.java;2;0;5;1;0;0;0;5;5;1;5;133;13;13;1;0;0;5;5;133;0;1424;5;2;
/org.eclipse.swt.tests/JUnit Tests/org/eclipse/swt/tests/junit/Test_org_eclipse_swt_events_ModifyEvent.java;2;0;2;1;1;1;1;1;6;0;1;1792;6;6;1;0;0;1;2;1792;0;4706;2;2;
/org.eclipse.ui/Eclipse JFace Text/org/eclipse/jface/text/internal/html/HoverBrowserControl.java;2;0;5;1;1;1;1;4;18;1;4;1435;29;29;1;0;0;4;5;1435;0;3915;5;2;
/org.eclipse.jdt.ui.tests.refactoring/resources/ExtractMethodWorkSpace/ExtractMethodTests/invalidSelection/A_test173.java;2;1;3;1;2;2;2;1;0;0;1;511;0;0;1;0;0;1;3;511;0;4419;3;2;
/org.eclipse.jdt.ui.tests.refactoring/resources/RenameMethodInInterface/testFail40/in/A.java;1;0;1;1;0;0;0;1;0;0;1;49;0;0;1;0;0;1;1;49;0;49;1;1;
/org.eclipse.jdt.ui/core refactoring/org/eclipse/jdt/core/refactoring/text/SimpleTextChange.java;1;0;4;1;0;0;0;4;18;1;4;15;23;23;1;0;0;4;4;15;0;408;4;1;
/org.eclipse.jdt.ui.tests.refactoring/resources/ExtractTemp/canExtract/A_test31_in.java;1;0;1;1;0;0;0;1;0;0;1;3210;0;0;1;0;0;1;1;3210;0;3210;1;1;
/org.eclipse.ui.tests/UI Test Utils/org/eclipse/ui/tests/util/ActionUtil.java;1;0;1;1;0;0;0;1;0;0;1;2785;0;0;1;0;0;1;1;2785;0;2785;1;1;
/org.eclipse.jdt.ui/ui refactoring/org/eclipse/jdt/internal/ui/refactoring/nls/NLSUIMessages.java;1;0;2;1;1;1;1;1;10;0;1;1923;10;10;1;0;0;1;2;1923;0;4043;2;1;
/org.eclipse.jdt.core/compiler/org/eclipse/jdt/internal/compiler/lookup/MethodBinding.java;2;0;13;1;1;1;1;12;809;4;8;455;1140;1140;4;4;0;12;13;1039;4;4062;9;2;
/org.eclipse.pde.ui/src/org/eclipse/pde/internal/base/model/IModelProvider.java;2;0;3;1;0;0;0;3;2;1;3;1434;2;2;1;0;0;3;3;1434;0;3136;3;2;
/org.eclipse.swt.examples.controls/src/org/eclipse/swt/examples/controls/SliderTab.java;2;0;2;1;0;0;0;2;0;1;2;391;0;0;1;0;0;2;2;391;0;611;2;2;
/org.eclipse.update.ui.forms/src/org/eclipse/update/ui/forms/WrapGridData.java;1;0;2;1;0;0;0;2;0;0;1;1537;0;0;2;1;0;2;2;1537;1;1537;1;1;
/org.eclipse.jdt.ui.tests.refactoring/resources/InlineTemp/canInline/A_test8_out.java;1;0;1;1;0;0;0;1;0;0;1;2051;0;0;1;0;0;1;1;2051;0;2051;1;1;
/org.eclipse.pde.ui/src/org/eclipse/pde/internal/builders/ManifestConsistencyChecker.java;2;0;9;1;0;0;0;9;233;1;9;1434;253;253;1;0;0;9;9;1434;0;3579;9;2;
/org.eclipse.jdt.core/search/org/eclipse/jdt/internal/core/index/DocumentFactory.java;2;0;3;1;1;1;1;2;22;1;2;455;24;24;1;0;0;2;3;455;0;4063;3;2;
/org.eclipse.debug.ui/ui/org/eclipse/debug/internal/ui/launchConfigurations/LaunchConfigurationTabGroup.java;1;0;2;1;0;0;0;2;0;1;2;3313;0;0;1;0;0;2;2;3313;0;3634;2;1;
/org.eclipse.pde.ui/src/org/eclipse/pde/internal/ui/editor/schema/SchemaPropertySheet.java;1;0;1;1;0;0;0;1;0;0;1;3579;0;0;1;0;0;1;1;3579;0;3579;1;1;
/org.eclipse.help/src/org/eclipse/help/internal/util/SequenceGenerator.java;2;0;2;1;0;0;0;2;0;1;2;1420;0;0;1;0;0;2;2;1420;0;2217;2;2;
/org.eclipse.jdt.ui/ui refactoring/org/eclipse/jdt/internal/ui/refactoring/actions/JavaElementFinder.java;4;0;5;2;0;0;0;5;2;2;4;1258;6;6;2;1;0;5;5;1258;1;1345;4;4;
/org.eclipse.ui/Eclipse UI/org/eclipse/ui/internal/OpenNewAction.java;5;0;6;1;0;0;0;6;15;1;6;257;28;28;1;0;0;6;6;257;0;3050;6;5;
/org.eclipse.jdt.ui.tests.refactoring/resources/RenameMethodInInterface/test12/in/A.java;1;0;1;1;0;0;0;1;0;0;1;49;0;0;1;0;0;1;1;49;0;49;1;1;
/org.eclipse.jdt.debug/eval/org/eclipse/jdt/internal/debug/eval/ast/engine/Pop.java;1;0;3;1;0;0;0;3;58;1;3;3329;58;58;1;0;0;3;3;3329;0;3421;3;1;
/org.eclipse.jdt.ui.tests.refactoring/resources/ExtractMethodWorkSpace/ExtractMethodTests/try_in/A_test452.java;2;1;3;1;2;2;2;1;20;0;1;65;20;20;1;0;0;1;3;65;0;4419;3;2;
/org.eclipse.swt/Eclipse SWT/common/org/eclipse/swt/events/HelpListener.java;4;0;5;1;1;1;1;4;6;1;4;106;18;18;1;0;0;4;5;106;0;4701;5;4;
/org.eclipse.jdt.launching/launching/org/eclipse/jdt/internal/launching/JavaRemoteApplicationLaunchConfigurationDelegate.java;3;3;22;2;9;6;9;13;80;1;13;3055;323;323;3;0;3;13;22;4567;3;4567;19;3;
/org.eclipse.search/search/org/eclipse/search/internal/ui/Search.java;2;1;12;1;3;3;3;9;62;1;9;15;246;246;1;0;0;9;12;15;0;4275;12;2;
/org.eclipse.jdt.core/compiler/org/eclipse/jdt/internal/compiler/lookup/CompilationUnitScope.java;3;1;41;2;3;3;3;38;813;4;26;455;1499;1499;4;12;0;38;41;1039;12;4619;29;3;
/org.eclipse.jdt.ui.tests.refactoring/resources/ExtractMethodWorkSpace/ExtractMethodTests/invalidSelection/A_test100.java;2;1;3;1;2;2;2;1;0;0;1;49;0;0;1;0;0;1;3;49;0;4419;3;2;
/org.eclipse.compare/compare/org/eclipse/compare/internal/ImageMergeViewer.java;2;0;7;1;0;0;0;7;12;1;7;14;38;38;1;0;0;7;7;14;0;761;7;2;
/org.eclipse.jdt.debug.ui/ui/org/eclipse/jdt/internal/debug/ui/launcher/JavaLaunchConfigurationTab.java;2;1;8;1;3;3;3;5;119;2;4;3036;162;162;2;1;0;5;8;3049;1;4423;7;2;
/org.eclipse.jdt.debug/eval/org/eclipse/jdt/debug/eval/model/IInterfaceType.java;2;0;2;1;0;0;0;2;0;1;2;3421;0;0;1;0;0;2;2;3421;0;3555;2;2;
/org.eclipse.jdt.ui/core refactoring/org/eclipse/jdt/internal/corext/refactoring/rename/RenamePackageRefactoring.java;2;2;15;2;3;2;3;12;47;2;11;1939;226;226;2;1;1;12;15;2137;2;4396;13;2;
/org.eclipse.ui.tests/Eclipse UI Tests/org/eclipse/ui/tests/api/AbstractTestCase.java;2;0;4;1;0;0;0;4;54;1;4;983;80;80;1;0;0;4;4;983;0;1407;4;2;
/org.eclipse.jdt.ui/core refactoring/org/eclipse/jdt/internal/corext/refactoring/rename/TempOccurrenceFinder2.java;1;0;3;1;0;0;0;3;6;1;3;3048;6;6;1;0;0;3;3;3048;0;3087;3;1;
/org.eclipse.swt/Eclipse SWT/motif/org/eclipse/swt/internal/motif/XmDropFinishCallback.java;2;0;3;1;0;0;0;3;4;1;3;106;4;4;1;0;0;3;3;106;0;2069;3;2;
/org.eclipse.jdt.junit/src/org/eclipse/jdt/internal/junit/launcher/JUnitLaunchConfigurationTab.java;1;0;3;1;0;0;0;3;115;1;3;3171;127;127;1;0;0;3;3;3171;0;3562;3;1;
/org.eclipse.jdt.ui/ui/org/eclipse/jdt/internal/ui/text/correction/UnknownMethodEvaluator.java;2;0;10;1;0;0;0;10;29;2;7;3306;80;80;2;3;0;10;10;3306;3;3528;7;2;
/org.eclipse.jdt.ui/core refactoring/org/eclipse/jdt/internal/corext/refactoring/code/CommentAnalyzer.java;1;0;3;1;0;0;0;3;19;1;3;1939;19;19;1;0;0;3;3;1939;0;3106;3;1;
/org.eclipse.ui/Eclipse UI/org/eclipse/ui/actions/RetargetAction.java;3;1;7;1;2;2;2;5;44;2;4;3176;91;91;2;1;0;5;7;3212;1;4630;6;3;
/org.eclipse.swt/Eclipse SWT PI/gtk/org/eclipse/swt/internal/gtk/OS.java;5;4;102;3;38;24;38;64;1342;5;39;2107;2324;2324;5;25;14;64;102;3869;39;4701;63;5;
/org.eclipse.help/src/org/eclipse/help/internal/toc/TocFile.java;2;0;5;1;0;0;0;5;25;1;5;1857;38;38;1;0;0;5;5;1857;0;3766;5;2;
/org.eclipse.ui/Eclipse UI/org/eclipse/ui/IWorkingSetRegistry.java;1;0;1;1;0;0;0;1;0;0;1;3332;0;0;1;0;0;1;1;3332;0;3332;1;1;
/org.eclipse.ui/Eclipse UI Standard Components/org/eclipse/ui/views/internal/framelist/Frame.java;3;0;4;1;0;0;0;4;6;1;4;257;10;10;1;0;0;4;4;257;0;3816;4;3;
/org.eclipse.pde.ui/src/org/eclipse/pde/internal/forms/CustomWorkbook.java;2;0;2;1;0;0;0;2;0;1;2;1434;0;0;1;0;0;2;2;1434;0;2470;2;2;
/org.eclipse.update.ui/src/org/eclipse/update/internal/ui/preferences/UpdateColors.java;1;0;1;1;1;1;1;0;0;0;0;4353;0;0;1;0;0;0;1;4353;0;4353;1;1;
/org.eclipse.jdt.core/model/org/eclipse/jdt/internal/core/builder/impl/SourceFragmentImpl.java;1;0;10;1;0;0;0;10;51;4;6;455;87;87;4;4;0;10;10;1039;4;2808;6;1;
/org.eclipse.jdt.ui.tests/JUnit/junit/ui/LoadingTestRunner.java;2;0;2;1;0;0;0;2;0;1;2;49;0;0;1;0;0;2;2;49;0;1186;2;2;
/org.eclipse.jdt.ui.tests.refactoring/resources/RenameNonPrivateField/test11/out/A.java;1;0;1;1;0;0;0;1;0;0;1;49;0;0;1;0;0;1;1;49;0;49;1;1;
/org.eclipse.pde.ui/Eclipse PDE UI/org/eclipse/pde/internal/preferences/ExternalPluginsWizardPage.java;2;0;5;2;0;0;0;5;12;3;3;267;12;12;3;2;0;5;5;324;2;1434;3;2;
/org.eclipse.swt/Eclipse SWT Drag and Drop/win32/org/eclipse/swt/dnd/TreeDragUnderEffect.java;2;0;5;1;1;1;1;4;183;1;4;106;274;274;1;0;0;4;5;106;0;4701;5;2;
/org.eclipse.ui/Eclipse JFace Text/org/eclipse/jface/text/information/InformationPresenter.java;2;1;6;1;2;2;2;4;52;1;4;1435;126;126;1;0;0;4;6;1435;0;4838;6;2;
/org.eclipse.core.tests.resources/src/org/eclipse/core/tests/resources/session/TestMissingBuilder.java;2;0;2;1;0;0;0;2;2;1;2;3405;2;2;1;0;0;2;2;3405;0;3415;2;2;
/org.eclipse.jdt.core/model/org/eclipse/jdt/core/ISourceReference.java;3;2;8;2;4;3;4;4;58;1;4;455;114;114;2;0;1;4;8;4421;1;4493;7;3;
/org.eclipse.jdt.ui.tests.refactoring/resources/RenameTemp/cannotRename/A_testFail26.java;1;0;1;1;0;0;0;1;0;0;1;3309;0;0;1;0;0;1;1;3309;0;3309;1;1;
/org.eclipse.pde.ui/src/org/eclipse/pde/internal/editor/schema/NewReferenceAction.java;2;0;2;1;0;0;0;2;0;1;2;1434;0;0;1;0;0;2;2;1434;0;3579;2;2;
/org.eclipse.jdt.debug.ui/ui/org/eclipse/jdt/internal/debug/ui/actions/WatchpointAction.java;2;0;6;1;0;0;0;6;47;2;5;1915;60;60;2;1;0;6;6;2312;1;2646;5;2;
/org.eclipse.swt.tests/JUnit Tests/org/eclipse/swt/tests/junit/Test_org_eclipse_swt_custom_CTabFolderAdapter.java;2;0;2;1;1;1;1;1;6;0;1;1792;6;6;1;0;0;1;2;1792;0;4706;2;2;
/org.eclipse.jdt.ui.tests.refactoring/resources/RenameTemp/canRename/A_test3_out.java;1;0;2;1;0;0;0;2;8;1;2;1625;8;8;1;0;0;2;2;1625;0;1652;2;1;
/org.eclipse.swt/Eclipse SWT Drag and Drop/common/org/eclipse/swt/dnd/DNDListener.java;4;0;5;1;1;1;1;4;6;1;4;106;23;23;1;0;0;4;5;106;0;4701;5;4;
/org.eclipse.ui/Eclipse UI/org/eclipse/ui/internal/registry/AcceleratorRegistryReader.java;3;0;5;1;0;0;0;5;121;1;5;3055;206;206;1;0;0;5;5;3055;0;3607;5;3;
/org.eclipse.jdt.ui.tests.refactoring/resources/PullUp/testFail5/in/A.java;1;0;1;1;0;0;0;1;0;0;1;2406;0;0;1;0;0;1;1;2406;0;2406;1;1;
/org.eclipse.ui/Eclipse UI/org/eclipse/ui/internal/registry/ActionSetRegistryReader.java;3;0;3;1;0;0;0;3;9;1;3;257;10;10;1;0;0;3;3;257;0;620;3;3;
/org.eclipse.pde.core/src/org/eclipse/pde/internal/core/schema/RepeatableSchemaObject.java;1;0;2;1;0;0;0;2;2;1;2;3591;2;2;1;0;0;2;2;3591;0;3607;2;1;
/org.eclipse.jdt.core/compiler/org/eclipse/jdt/internal/compiler/lookup/LookupEnvironment.java;3;0;15;1;1;1;1;14;1077;4;10;455;1189;1189;4;4;0;14;15;1039;4;4062;11;3;
/org.eclipse.core.tests.runtime/src/org/eclipse/core/tests/internal/runtimetests/SampleIFR.java;1;0;2;1;0;0;0;2;10;1;2;3611;10;10;1;0;0;2;2;3611;0;3678;2;1;
/org.eclipse.team.webdav/src/org/eclipse/team/internal/webdav/core/DavState.java;5;2;23;2;23;20;23;0;217;0;0;4073;576;576;2;0;3;0;23;4128;3;4636;20;5;
/org.eclipse.scripting/Eclipse Scripting/org/eclipse/scripting/internal/views/ScriptConsoleViewer.java;2;0;5;1;0;0;0;5;17;1;5;133;37;37;1;0;0;5;5;133;0;1424;5;2;
/org.eclipse.jdt.debug/jdi/org/eclipse/jdi/internal/spy/BufWriter.java;2;0;3;1;0;0;0;3;12;1;3;187;16;16;1;0;0;3;3;187;0;3040;3;2;
/org.eclipse.jdt.junit/src/org/eclipse/jdt/internal/junit/launcher/JUnitBaseLaunchConfiguration.java;2;1;7;1;2;2;2;5;116;1;5;3171;164;164;1;0;0;5;7;3171;0;4453;7;2;
/org.eclipse.pde.ui/src/org/eclipse/pde/internal/editor/component/ComponentOutlinePage.java;2;0;2;1;0;0;0;2;0;1;2;1434;0;0;1;0;0;2;2;1434;0;2951;2;2;
/org.eclipse.jdt.ui.tests.refactoring/resources/ExtractMethodWorkSpace/ExtractMethodTests/validSelection/A_test255.java;2;1;3;1;2;2;2;1;6;0;1;195;6;6;1;0;0;1;3;195;0;4419;3;2;
/org.eclipse.pde.ui/src/org/eclipse/pde/internal/base/model/plugin/IPluginModel.java;2;0;2;1;0;0;0;2;0;1;2;1434;0;0;1;0;0;2;2;1434;0;3039;2;2;
/org.eclipse.pde.core/src/org/eclipse/pde/internal/core/plugin/PluginObject.java;1;0;2;1;0;0;0;2;4;1;2;3591;4;4;1;0;0;2;2;3591;0;3607;2;1;
/org.eclipse.swt/Eclipse SWT/photon/org/eclipse/swt/graphics/FontMetrics.java;4;1;8;1;4;4;4;4;81;1;4;106;109;109;1;0;0;4;8;106;0;4701;8;4;
/org.eclipse.jdt.ui.tests.refactoring/resources/SelectionAnalyzerWorkSpace/SelectionAnalyzerTests/validSelection/A_test190_.java;1;0;1;1;0;0;0;1;0;0;1;2139;0;0;1;0;0;1;1;2139;0;2139;1;1;
/org.eclipse.update/Eclipse Update/org/eclipse/update/internal/core/ISessionDefiner.java;1;0;3;1;0;0;0;3;4;1;3;108;4;4;1;0;0;3;3;108;0;1424;3;1;
/org.eclipse.jdt.ui.tests.refactoring/resources/RenamePrivateField/test2/out/A.java;1;0;1;1;0;0;0;1;0;0;1;1274;0;0;1;0;0;1;1;1274;0;1274;1;1;
/org.eclipse.help/Eclipse Help/org/eclipse/help/internal/contributions/xml/HelpContribution.java;4;0;7;1;0;0;0;7;38;2;6;135;65;65;2;1;0;7;7;489;1;1420;6;4;
/org.eclipse.jdt.ui.tests.refactoring/resources/PullUp/test0/in/A.java;1;0;1;1;0;0;0;1;0;0;1;2406;0;0;1;0;0;1;1;2406;0;2406;1;1;
/org.eclipse.swt/Eclipse SWT/carbon/org/eclipse/swt/widgets/Menu.java;5;1;5;2;5;5;5;0;110;0;0;4147;142;142;1;0;0;0;5;4147;0;4701;5;5;
/org.eclipse.pde.ui/Eclipse PDE UI/org/eclipse/pde/internal/model/jars/Jars.java;2;0;5;2;0;0;0;5;12;3;3;267;12;12;3;2;0;5;5;324;2;1434;3;2;
/org.eclipse.pde.ui/Eclipse PDE UI/org/eclipse/pde/internal/base/model/plugin/IPlugin.java;2;0;5;2;0;0;0;5;12;3;3;267;12;12;3;2;0;5;5;324;2;1434;3;2;
/org.eclipse.scripting/src/org/eclipse/scripting/internal/uirenderer/ScriptContributionNodeManager.java;1;0;1;1;0;0;0;1;0;0;1;1424;0;0;1;0;0;1;1;1424;0;1424;1;1;
/org.eclipse.pde.ui/src/org/eclipse/pde/internal/editor/build/BuildPropertiesEditor.java;2;0;8;1;0;0;0;8;16;1;8;1434;28;28;1;0;0;8;8;1434;0;3579;8;2;
/org.eclipse.jdt.ui.tests/ui/org/eclipse/jdt/ui/tests/AutomatedSuite.java;2;1;11;1;4;4;4;7;14;2;6;2182;59;59;2;1;0;7;11;2182;1;4643;10;2;
/org.eclipse.jdt.core/dom/org/eclipse/jdt/core/dom/PrefixExpression.java;2;2;8;1;4;3;4;4;21;1;4;2669;51;51;2;0;1;4;8;4452;1;4452;7;2;
/org.eclipse.jdt.ui/core refactoring/org/eclipse/jdt/core/refactoring/fields/RenameNonPrivateFieldRefactoring.java;1;0;2;1;0;0;0;2;0;1;2;28;0;0;1;0;0;2;2;28;0;237;2;1;
/org.eclipse.team.cvs.core/src/org/eclipse/team/internal/ccvs/core/resources/ICVSResourceVisitor.java;1;0;2;1;0;0;0;2;0;1;2;2156;0;0;1;0;0;2;2;2156;0;3089;2;1;
/org.eclipse.pde.ui/src/org/eclipse/pde/internal/wizards/project/NewFragmentProjectWizard.java;2;0;3;1;0;0;0;3;2;1;3;1434;2;2;1;0;0;3;3;1434;0;3579;3;2;
/org.eclipse.team.tests.cvs.core/src/org/eclipse/team/tests/ccvs/ui/SequenceGenerator.java;1;0;1;1;0;0;0;1;0;0;1;2977;0;0;1;0;0;1;1;2977;0;2977;1;1;
/org.eclipse.pde.ui/src/org/eclipse/pde/internal/parts/TreePart.java;1;0;2;1;0;0;0;2;0;1;2;3023;0;0;1;0;0;2;2;3023;0;3579;2;1;
/org.eclipse.help/src/org/eclipse/help/internal/contributions/xml1_0/HelpInsert.java;1;0;2;1;0;0;0;2;0;1;2;1675;0;0;1;0;0;2;2;1675;0;2217;2;1;
/org.eclipse.jdt.ui/core extension/org/eclipse/jdt/internal/corext/SourceRange.java;2;0;3;1;1;1;1;2;20;1;2;3188;22;22;1;0;0;2;3;3188;0;4424;3;2;
/org.eclipse.team.core/src/org/eclipse/team/core/TeamException.java;4;2;7;2;4;3;4;3;130;1;3;1978;172;172;2;0;1;3;7;4128;1;4674;6;4;
/org.eclipse.jdt.debug.ui/ui/org/eclipse/jdt/internal/debug/ui/actions/AddVariableAction.java;1;1;2;1;2;2;2;0;59;0;0;3912;59;59;1;0;0;0;2;3912;0;4403;2;1;
/org.eclipse.help/src/org/eclipse/help/internal/contributions/xml1_0/HelpInfoSet.java;2;0;5;1;0;0;0;5;20;1;5;1675;37;37;1;0;0;5;5;1675;0;2217;5;2;
/org.eclipse.jdt.debug/model/org/eclipse/jdt/internal/debug/core/JDIType.java;2;0;6;1;0;0;0;6;103;1;6;1623;130;130;1;0;0;6;6;1623;0;2517;6;2;
/org.eclipse.jdt.ui.tests.refactoring/resources/ExtractMethodWorkSpace/ExtractMethodTests/return_in/A_test707.java;1;1;3;1;2;2;2;1;24;0;1;887;24;24;1;0;0;1;3;887;0;4419;3;1;
/org.eclipse.jdt.debug.tests/tests/org/eclipse/jdt/debug/tests/core/TargetPatternBreakpointTests.java;3;1;4;1;3;3;3;1;38;0;1;3701;61;61;1;0;0;1;4;3701;0;4571;4;3;
/org.eclipse.vcm.core.cvs/src/org/eclipse/vcm/internal/core/ccvs/requests/UpdateMessageHandler.java;2;0;2;1;0;0;0;2;11;1;2;0;11;11;1;0;0;2;2;0;0;298;2;2;
/org.eclipse.jdt.core/codeassist/org/eclipse/jdt/internal/codeassist/complete/CompletionOnArgumentName.java;3;0;5;1;1;1;1;4;10;1;4;1580;22;22;1;0;0;4;5;1580;0;4062;5;3;
/org.eclipse.jdt.ui.tests/refactoring/org/eclipse/jdt/refactoring/tests/AbstractFieldTests.java;2;0;2;1;0;0;0;2;0;1;2;751;0;0;1;0;0;2;2;751;0;1186;2;2;
/org.eclipse.jdt.ui.tests.refactoring/resources/RenameMethodInInterface/test37/out/A.java;1;0;1;1;0;0;0;1;0;0;1;49;0;0;1;0;0;1;1;49;0;49;1;1;
/org.eclipse.core.resources/src/org/eclipse/core/internal/utils/Semaphore.java;2;0;5;1;1;1;1;4;78;1;4;12;106;106;1;0;0;4;5;12;0;4214;5;2;
/org.eclipse.team.cvs.core/src/org/eclipse/team/internal/ccvs/core/syncinfo/FileSystemSynchronizer.java;2;0;8;1;0;0;0;8;246;3;6;2690;305;305;3;2;0;8;8;2864;2;3089;6;2;
/org.eclipse.jdt.ui.tests.refactoring/resources/ExtractMethodWorkSpace/ExtractMethodTests/semicolon_out/A_test401.java;2;1;3;1;2;2;2;1;0;0;1;49;0;0;1;0;0;1;3;49;0;4419;3;2;
/org.eclipse.pde.runtime/src/org/eclipse/pde/internal/runtime/registry/ExtensionAdapter.java;1;0;1;1;0;0;0;1;0;0;1;1434;0;0;1;0;0;1;1;1434;0;1434;1;1;
/org.eclipse.update/src/org/eclipse/update/internal/ui/UMWizardPersistentProperties.java;1;0;1;1;0;0;0;1;0;0;1;1424;0;0;1;0;0;1;1;1424;0;1424;1;1;
/org.eclipse.swt/Eclipse SWT PI/gtk/org/eclipse/swt/internal/gtk/GdkEventMotion.java;1;0;2;1;0;0;0;2;0;1;2;2107;0;0;1;0;0;2;2;2107;0;3209;2;1;
/org.eclipse.core.resources/src/org/eclipse/core/internal/localstore/HistoryStore.java;3;1;12;1;2;2;2;10;708;1;10;12;1083;1083;1;0;0;10;12;12;0;4268;12;3;
/org.eclipse.ui/Eclipse UI/org/eclipse/ui/internal/dialogs/ReadOnlyStateChecker.java;2;0;2;1;0;0;0;2;0;1;2;2571;0;0;1;0;0;2;2;2571;0;3511;2;2;
/org.eclipse.pde.ui/src/org/eclipse/pde/internal/core/WorkspaceResourceHelper.java;1;0;4;1;0;0;0;4;23;3;2;3579;23;23;3;2;0;4;4;3579;2;3607;2;1;
/org.eclipse.jdt.debug/model/org/eclipse/jdt/internal/debug/core/JDIThread.java;4;0;68;3;0;0;0;68;1016;3;52;187;3400;3400;3;16;0;68;68;1530;16;2517;52;4;
/org.eclipse.jdt.ui/core extension/org/eclipse/jdt/internal/corext/textmanipulation/TextManipulationMessages.java;1;0;1;1;0;0;0;1;0;0;1;3565;0;0;1;0;0;1;1;3565;0;3565;1;1;
/org.eclipse.debug.core/core/org/eclipse/debug/core/ILaunch.java;3;0;15;1;1;1;1;14;42;2;13;187;196;196;2;1;0;14;15;1726;1;4649;14;3;
/org.eclipse.ui/Eclipse UI/org/eclipse/ui/dialogs/WizardNewProjectReferencePage.java;6;0;8;1;0;0;0;8;10;1;8;257;42;42;1;0;0;8;8;257;0;3573;8;6;
/org.eclipse.jdt.ui/ui/org/eclipse/jdt/internal/ui/actions/OpenHierarchyPerspectiveItem.java;4;0;11;1;0;0;0;11;10;4;8;344;47;47;4;3;0;11;11;344;3;2546;8;4;
/org.eclipse.tomcat/src_jdt/org/eclipse/tomcat/jasper/internal/JdtJasperCompiler.java;1;0;2;1;0;0;0;2;79;1;2;3285;79;79;1;0;0;2;2;3285;0;3356;2;1;
/org.eclipse.jdt.ui.tests.refactoring/resources/RenameVirtualMethodInClass/testFail23/in/A.java;1;0;1;1;0;0;0;1;0;0;1;49;0;0;1;0;0;1;1;49;0;49;1;1;
/org.eclipse.jdt.debug/eval/org/eclipse/jdt/debug/eval/model/IArray.java;2;0;2;1;0;0;0;2;0;1;2;3421;0;0;1;0;0;2;2;3421;0;3555;2;2;
/org.eclipse.jdt.ui/ui/org/eclipse/jdt/internal/ui/reorg/DeleteAction.java;5;0;21;1;0;0;0;21;185;2;19;15;733;733;2;2;0;21;21;437;2;3222;19;5;
/org.eclipse.swt/Eclipse SWT Custom Widgets/common_j2se/org/eclipse/swt/custom/TableTreeItem.java;1;0;1;1;0;0;0;1;0;0;1;1378;0;0;1;0;0;1;1;1378;0;1378;1;1;
/org.eclipse.jdt.debug/model/org/eclipse/jdt/internal/debug/core/JavaWatchpoint.java;3;0;23;1;0;0;0;23;245;3;20;1035;854;854;3;3;0;23;23;1480;3;2517;20;3;
/org.eclipse.jdt.ui.tests.refactoring/resources/SurroundWithWorkSpace/SurroundWithTests/trycatch_in/TestStaticField.java;1;0;1;1;1;1;1;0;0;0;0;4000;0;0;1;0;0;0;1;4000;0;4000;1;1;
/org.eclipse.jdt.ui.tests/test plugin/org/eclipse/jdt/testplugin/core/JavaTestCoreApplication.java;2;0;3;1;0;0;0;3;4;1;3;49;4;4;1;0;0;3;3;49;0;1186;3;2;
/org.eclipse.jdt.ui.tests.refactoring/resources/RenameTemp/cannotRename/A_testFail4.java;1;0;2;1;0;0;0;2;2;1;2;1625;2;2;1;0;0;2;2;1625;0;1652;2;1;
/org.eclipse.jdt.ui.tests.refactoring/resources/MoveCU/testFail9/in/p/B.java;2;0;2;1;0;0;0;2;0;1;2;49;0;0;1;0;0;2;2;49;0;2769;2;2;
/org.eclipse.pde.ui/src/org/eclipse/pde/internal/ui/editor/StructuredViewerSection.java;1;0;2;1;0;0;0;2;1;0;1;3579;1;1;2;1;0;2;2;3579;1;3579;1;1;
/org.eclipse.vcm.core.cvs/src/org/eclipse/vcm/internal/core/ccvs/requests/CheckedInHandler.java;3;0;3;1;0;0;0;3;14;1;3;0;20;20;1;0;0;3;3;0;0;298;3;3;
/org.eclipse.jdt.core/compiler/org/eclipse/jdt/internal/compiler/lookup/BlockScope.java;4;1;40;1;3;3;3;37;2406;4;30;455;5618;5618;4;7;0;37;40;1039;7;4421;33;4;
/org.eclipse.ui/Eclipse UI/org/eclipse/ui/dialogs/PropertyPage.java;2;0;2;1;0;0;0;2;5;1;2;257;5;5;1;0;0;2;2;257;0;457;2;2;
/org.eclipse.team.core/src/org/eclipse/team/core/IFileTypeRegistry.java;2;0;5;1;0;0;0;5;120;1;5;1978;191;191;1;0;0;5;5;1978;0;3458;5;2;
/org.eclipse.webdav/src/kernel/org/eclipse/webdav/internal/kernel/Response.java;2;0;4;1;1;1;1;3;230;1;3;1635;381;381;1;0;0;3;4;1635;0;4211;4;2;
/org.eclipse.core.tests.resources/src/org/eclipse/core/tests/internal/watson/PluggableDeltaLogicTest.java;3;0;4;1;1;1;1;3;408;1;3;1794;434;434;1;0;0;3;4;1794;0;4516;4;3;
/org.eclipse.pde.runtime/src/org/eclipse/pde/internal/runtime/registry/RegistryPropertySource.java;1;0;1;1;0;0;0;1;0;0;1;1434;0;0;1;0;0;1;1;1434;0;1434;1;1;
/org.eclipse.jdt.ui.tests.refactoring/resources/RenameParameters/canRename/A_test25_out.java;1;0;1;1;0;0;0;1;0;0;1;233;0;0;1;0;0;1;1;233;0;233;1;1;
/org.eclipse.ui/Eclipse JFace/org/eclipse/jface/viewers/ISelectionChangedListener.java;2;0;2;1;0;0;0;2;5;1;2;257;5;5;1;0;0;2;2;257;0;457;2;2;
/org.eclipse.jdt.ui.tests.refactoring/resources/RenameMethodInInterface/test22/in/A.java;1;0;1;1;0;0;0;1;0;0;1;49;0;0;1;0;0;1;1;49;0;49;1;1;
/org.eclipse.jdt.ui/core refactoring/org/eclipse/jdt/internal/corext/refactoring/util/ASTUtil.java;2;0;6;1;0;0;0;6;14;1;6;1939;46;46;1;0;0;6;6;1939;0;3413;6;2;
/org.eclipse.jdt.ui.tests.refactoring/resources/RenameTemp/canRename/A_test17_out.java;1;0;1;1;0;0;0;1;0;0;1;1625;0;0;1;0;0;1;1;1625;0;1625;1;1;
/org.eclipse.swt/Eclipse SWT Custom Widgets/common/org/eclipse/swt/custom/TextChangedEvent.java;3;1;4;1;2;2;2;2;24;1;2;106;33;33;1;0;0;2;4;106;0;4701;4;3;
/org.eclipse.scripting/src/org/eclipse/scripting/internal/uirenderer/XGRElementUISwtTableHeading.java;1;0;1;1;0;0;0;1;0;0;1;1424;0;0;1;0;0;1;1;1424;0;1424;1;1;
/org.eclipse.jdt.ui.tests.refactoring/resources/RenameType/testFail31/in/C.java;1;0;1;1;0;0;0;1;0;0;1;49;0;0;1;0;0;1;1;49;0;49;1;1;
/org.eclipse.jdt.ui.tests.refactoring/resources/RenameType/testFail5/in/B.java;1;0;1;1;0;0;0;1;0;0;1;49;0;0;1;0;0;1;1;49;0;49;1;1;
/org.eclipse.debug.ui/ui/org/eclipse/debug/internal/ui/InspectorAction.java;2;0;5;1;0;0;0;5;5;1;5;187;12;12;1;0;0;5;5;187;0;2348;5;2;
/org.eclipse.jdt.ui.tests.refactoring/resources/RenameMethodInInterface/testFail12/in/A.java;1;0;1;1;0;0;0;1;0;0;1;49;0;0;1;0;0;1;1;49;0;49;1;1;
/org.eclipse.jdt.ui.tests.refactoring/resources/RenameTemp/canRename/A_test3_in.java;1;0;2;1;0;0;0;2;4;1;2;1625;4;4;1;0;0;2;2;1625;0;1652;2;1;
/org.eclipse.scripting/src/org/eclipse/scripting/internal/views/ScriptDevelopmentPreferencePageWorkbenchImport.java;1;0;1;1;0;0;0;1;0;0;1;1424;0;0;1;0;0;1;1;1424;0;1424;1;1;
/org.eclipse.swt/Eclipse SWT PI/motif/org/eclipse/swt/internal/motif/XAnyEvent.java;2;0;2;1;1;1;1;1;6;0;1;2069;6;6;1;0;0;1;2;2069;0;4701;2;2;
/org.eclipse.swt/Eclipse SWT PI/win32/org/eclipse/swt/internal/ole/win32/VARDESC1.java;2;0;2;1;1;1;1;1;6;0;1;2069;6;6;1;0;0;1;2;2069;0;4701;2;2;
/org.eclipse.jdt.core/search/org/eclipse/jdt/internal/core/index/impl/IndexInput.java;2;1;5;1;2;2;2;3;38;1;3;455;76;76;1;0;0;3;5;455;0;4063;5;2;
/org.eclipse.jdt.ui.tests.refactoring/resources/SelectionAnalyzerWorkSpace/SelectionAnalyzerTests/invalidSelection/A_test044.java;1;0;1;1;0;0;0;1;0;0;1;1368;0;0;1;0;0;1;1;1368;0;1368;1;1;
/org.eclipse.jdt.ui.tests.refactoring/resources/ExtractMethodWorkSpace/ExtractMethodTests/expression_in/A_test609.java;1;1;3;1;2;2;2;1;0;0;1;1236;0;0;1;0;0;1;3;1236;0;4419;3;1;
/org.eclipse.jdt.core/compiler/org/eclipse/jdt/internal/compiler/ast/ArrayTypeReference.java;2;1;11;1;2;2;2;9;76;4;6;455;131;131;4;3;0;9;11;1039;3;4418;8;2;
/org.eclipse.team.tests.cvs.core/src/org/eclipse/team/tests/ccvs/ui/benchmark/AllTests.java;1;0;2;1;0;0;0;2;1;1;2;2977;1;1;1;0;0;2;2;2977;0;3452;2;1;
/org.eclipse.scripting/Eclipse Scripting/org/eclipse/scripting/internal/IXGRElementEventGeneratorOnFocus.java;1;0;3;1;0;0;0;3;4;1;3;133;4;4;1;0;0;3;3;133;0;1424;3;1;
/org.eclipse.pde.ui/src/org/eclipse/pde/internal/launcher/WorkbenchLaunchConfigurationDelegate.java;1;0;18;1;0;0;0;18;568;3;14;2868;797;797;3;4;0;18;18;3343;4;3579;14;1;
/org.eclipse.help.ui/Eclipse Help UI/org/eclipse/help/internal/ui/util/Util.java;2;0;3;1;0;0;0;3;7;1;3;136;7;7;1;0;0;3;3;136;0;1420;3;2;
/org.eclipse.pde.ui/src/org/eclipse/pde/internal/wizards/templates/StringOption.java;1;0;4;1;0;0;0;4;26;1;4;3278;41;41;1;0;0;4;4;3278;0;3579;4;1;
/org.eclipse.team.ui/src/org/eclipse/team/internal/ui/sync/TeamFile.java;1;1;5;1;2;2;2;3;304;2;2;2054;332;332;2;1;0;3;5;2231;1;4123;4;1;
/org.eclipse.swt/Eclipse SWT Accessibility/common/org/eclipse/swt/accessibility/AccessibleEvent.java;2;0;5;1;1;1;1;4;34;2;3;2781;58;58;2;1;0;4;5;3007;1;4701;4;2;
/org.eclipse.team.cvs.core/src/org/eclipse/team/internal/ccvs/core/client/listeners/UpdateListener.java;2;0;13;2;1;1;1;12;155;3;9;2572;331;331;3;3;0;12;13;3812;3;4368;10;2;
/org.eclipse.jdt.ui.tests.refactoring/resources/RenameTemp/canRename/A_test20_in.java;1;0;2;1;0;0;0;2;2;1;2;1625;2;2;1;0;0;2;2;1625;0;1652;2;1;
/org.eclipse.vcm.ui/src/org/eclipse/vcm/internal/ui/VCMCompareEditorInput.java;4;0;13;2;0;0;0;13;151;3;9;1;303;303;3;4;0;13;13;295;4;1566;9;4;
/org.eclipse.jdt.ui/ui debug/org/eclipse/jdt/internal/debug/ui/ExceptionCaughtToggleAction.java;2;0;8;1;0;0;0;8;15;1;8;15;37;37;1;0;0;8;8;15;0;1916;8;2;
/org.eclipse.help/Eclipse Help/org/eclipse/help/internal/contributors/ViewContributor.java;2;0;3;1;0;0;0;3;7;1;3;135;7;7;1;0;0;3;3;135;0;1420;3;2;
/org.eclipse.team.ftp/src/org/eclipse/team/internal/ftp/client/DataConnection.java;1;1;3;1;3;3;3;0;161;0;0;4535;163;163;1;0;0;0;3;4535;0;4625;3;1;
/org.eclipse.swt/Eclipse SWT/gtk1x/org/eclipse/swt/widgets/Trim.java;2;0;2;1;1;1;1;1;6;0;1;2107;6;6;1;0;0;1;2;2107;0;4701;2;2;
/org.eclipse.jdt.ui.tests.refactoring/resources/MultiMove/test2/in/p1/B.java;1;0;1;1;0;0;0;1;0;0;1;1157;0;0;1;0;0;1;1;1157;0;1157;1;1;
/org.eclipse.jdt.core/model/org/eclipse/jdt/internal/core/ProblemFactory.java;1;0;2;1;0;0;0;2;0;1;2;455;0;0;1;0;0;2;2;455;0;632;2;1;
/org.eclipse.update.examples/src/org/eclipse/update/examples/buildzip/BuildZipSiteFactory.java;2;0;7;1;0;0;0;7;89;2;6;2762;119;119;2;1;0;7;7;3570;1;3570;6;2;
/org.eclipse.jdt.ui/core extension/org/eclipse/jdt/internal/corext/textmanipulation/UndoMemento.java;1;0;2;1;0;0;0;2;2;1;2;2137;2;2;1;0;0;2;2;2137;0;2512;2;1;
/org.eclipse.jdt.ui.tests.refactoring/resources/RenameVirtualMethodInClass/test12/out/A.java;1;0;1;1;0;0;0;1;0;0;1;49;0;0;1;0;0;1;1;49;0;49;1;1;
/org.eclipse.jdt.ui/ui/org/eclipse/jdt/ui/actions/FindReadReferencesInHierarchyAction.java;3;1;3;1;3;3;3;0;9;0;0;4141;13;13;1;0;0;0;3;4141;0;4770;3;3;
/org.eclipse.jdt.ui/ui/org/eclipse/jdt/internal/ui/viewsupport/LabelProviderDisposer.java;2;0;3;1;1;1;1;2;8;1;2;15;11;11;1;0;0;2;3;15;0;4401;3;2;
/org.eclipse.compare/compare/org/eclipse/compare/internal/CompareWithEditionDialog.java;2;0;6;1;0;0;0;6;6;1;6;176;12;12;1;0;0;6;6;176;0;2052;6;2;
/org.eclipse.jdt.ui.tests.refactoring/resources/RenameType/test26/out/A.java;1;0;2;1;0;0;0;2;0;1;2;49;0;0;1;0;0;2;2;49;0;522;2;1;
/org.eclipse.jdt.debug.ui/ui/org/eclipse/jdt/debug/ui/launchConfigurations/JavaConnectTab.java;3;3;10;2;10;6;10;0;28;0;0;4098;59;59;3;0;4;0;10;4127;4;4527;6;3;
/org.eclipse.pde.ui/src/org/eclipse/pde/internal/editor/manifest/ExtensionPointSection.java;2;0;5;1;0;0;0;5;264;1;5;1434;272;272;1;0;0;5;5;1434;0;3579;5;2;
/org.eclipse.jdt.ui.tests.refactoring/resources/SelectionAnalyzerWorkSpace/SelectionAnalyzerTests/validSelection/A_test144_.java;1;0;1;1;0;0;0;1;0;0;1;2139;0;0;1;0;0;1;1;2139;0;2139;1;1;
/org.eclipse.swt/Eclipse SWT PI/win32/org/eclipse/swt/internal/ole/win32/IOleObject.java;2;0;2;1;1;1;1;1;6;0;1;2069;6;6;1;0;0;1;2;2069;0;4701;2;2;
/org.eclipse.jdt.ui.tests.refactoring/resources/RenameMethodInInterface/testFail38/in/A.java;1;0;1;1;0;0;0;1;0;0;1;49;0;0;1;0;0;1;1;49;0;49;1;1;
/org.eclipse.jdt.ui.tests/examples/org/eclipse/jdt/ui/examples/CheckBoxExample.java;2;0;3;1;1;1;1;2;18;1;2;1186;35;35;1;0;0;2;3;1186;0;4682;3;2;
/org.eclipse.help/src/org/eclipse/help/internal/search/ISearchEngine.java;2;0;2;1;0;0;0;2;0;1;2;2318;0;0;1;0;0;2;2;2318;0;2325;2;2;
/org.eclipse.jdt.ui/ui debug/org/eclipse/jdt/internal/debug/ui/JDIAttachLauncher.java;2;0;9;1;0;0;0;9;43;2;7;15;96;96;2;2;0;9;9;472;2;1916;7;2;
/org.eclipse.jdt.ui/ui/org/eclipse/jdt/internal/ui/wizards/NewPackageRootCreationWizard.java;3;0;8;1;0;0;0;8;18;2;7;15;42;42;2;1;0;8;8;144;1;1342;7;3;
/org.eclipse.pde.ui/src/org/eclipse/pde/internal/core/ischema/IDocumentSection.java;1;0;2;1;0;0;0;2;0;1;2;3591;0;0;1;0;0;2;2;3591;0;3607;2;1;
/org.eclipse.pde.ui/src/org/eclipse/pde/internal/base/model/plugin/IJarsModelFactory.java;2;0;2;1;0;0;0;2;0;1;2;1434;0;0;1;0;0;2;2;1434;0;2691;2;2;
/org.eclipse.jdt.ui.tests/refactoring/experiments/ReorderParameterASTAnalyzer.java;1;0;4;1;0;0;0;4;9;1;4;729;12;12;1;0;0;4;4;729;0;1895;4;1;
/org.eclipse.jdt.ui.tests.refactoring/resources/InlineTemp/canInline/A_test6_out.java;1;0;1;1;0;0;0;1;0;0;1;2051;0;0;1;0;0;1;1;2051;0;2051;1;1;
/org.eclipse.update/src/org/eclipse/update/internal/ui/JarVerificationDialog.java;1;0;1;1;0;0;0;1;0;0;1;1424;0;0;1;0;0;1;1;1424;0;1424;1;1;
/org.eclipse.swt/Eclipse SWT/common/org/eclipse/swt/internal/image/JPEGEndOfImage.java;2;0;3;1;1;1;1;2;6;1;2;106;10;10;1;0;0;2;3;106;0;4701;3;2;
/org.eclipse.pde.ui/Eclipse PDE UI/org/eclipse/pde/internal/base/schema/IMetaAttribute.java;2;0;5;2;0;0;0;5;12;3;3;267;12;12;3;2;0;5;5;324;2;1434;3;2;
/org.eclipse.swt/Eclipse SWT PI/carbon/org/eclipse/swt/internal/carbon/MacFont.java;3;1;3;1;3;3;3;0;6;0;0;4147;11;11;1;0;0;0;3;4147;0;4701;3;3;
/org.eclipse.jdt.debug/eval/org/eclipse/jdt/internal/debug/eval/ast/instructions/MultiplyAssignmentOperator.java;2;0;5;1;1;1;1;4;4;1;4;3421;10;10;1;0;0;4;5;3421;0;3955;5;2;
/org.eclipse.team.cvs.ui/src/org/eclipse/team/internal/ccvs/ui/wizards/KSubstWizard.java;2;0;8;1;1;1;1;7;219;1;7;3251;264;264;1;0;0;7;8;3251;0;4248;8;2;
/org.eclipse.pde.ui/src/org/eclipse/pde/internal/ui/editor/TableSection.java;1;0;1;1;0;0;0;1;0;0;1;3579;0;0;1;0;0;1;1;3579;0;3579;1;1;
/org.eclipse.jdt.ui/core refactoring/org/eclipse/jdt/internal/core/refactoring/CompilationUnitChange.java;2;0;5;1;0;0;0;5;12;1;5;15;19;19;1;0;0;5;5;15;0;1257;5;2;
/org.eclipse.jdt.debug/eval/org/eclipse/jdt/internal/debug/eval/ast/instructions/PushDouble.java;2;0;3;1;0;0;0;3;2;1;3;3421;4;4;1;0;0;3;3;3421;0;3677;3;2;
/org.eclipse.jdt.ui.tests.refactoring/resources/RenameType/testFail60/in/A.java;1;0;1;1;0;0;0;1;0;0;1;49;0;0;1;0;0;1;1;49;0;49;1;1;
/org.eclipse.jdt.ui/ui/org/eclipse/jdt/internal/ui/codemanipulation/AddUnimplementedMethodsOperation.java;2;0;14;1;0;0;0;14;18;2;13;15;99;99;2;1;0;14;14;238;1;2016;13;2;
/org.eclipse.jdt.ui/ui/org/eclipse/jdt/internal/ui/text/JavaCodeReader.java;2;0;4;1;0;0;0;4;10;1;4;1670;16;16;1;0;0;4;4;1670;0;2825;4;2;
/org.eclipse.help/src/org/eclipse/help/internal/protocols/help/HelpURLConnection.java;2;0;3;1;0;0;0;3;17;1;3;1420;17;17;1;0;0;3;3;1420;0;2694;3;2;
/org.eclipse.jdt.ui.tests.refactoring/resources/RenameVariables/canRename/A_test12_in.java;1;0;2;1;0;0;0;2;0;1;2;724;0;0;1;0;0;2;2;724;0;1665;2;1;
/org.eclipse.jdt.ui.tests.refactoring/resources/RenameType/testFail11/in/A.java;1;0;1;1;0;0;0;1;0;0;1;49;0;0;1;0;0;1;1;49;0;49;1;1;
/org.eclipse.ui/Eclipse UI/org/eclipse/ui/actions/SelectionProviderAction.java;3;0;3;1;1;1;1;2;10;1;2;257;15;15;1;0;0;2;3;257;0;4261;3;3;
/org.eclipse.core.tests.resources/src/org/eclipse/core/tests/resources/regression/LocalStoreRegressionTests.java;3;0;3;1;1;1;1;2;190;1;2;1794;200;200;1;0;0;2;3;1794;0;4516;3;3;
/org.eclipse.team.cvs.core/src/org/eclipse/team/internal/ccvs/core/ICVSProvider.java;3;0;17;1;0;0;0;17;300;2;16;2042;809;809;2;1;0;17;17;2049;1;3610;16;3;
/org.eclipse.jdt.debug.ui/ui/org/eclipse/jdt/internal/debug/ui/launcher/JavaApplicationLauncherDelegate.java;2;0;13;1;0;0;0;13;13;1;13;1915;56;56;1;0;0;13;13;1915;0;3634;13;2;
/org.eclipse.update.ui/src/org/eclipse/update/internal/ui/forms/UpdateSection.java;1;0;2;1;1;1;1;1;16;0;1;3662;16;16;1;0;0;1;2;3662;0;4361;2;1;
/org.eclipse.core.resources/src/org/eclipse/core/internal/dtree/ObjectNotFoundException.java;1;0;4;1;1;1;1;3;52;1;3;12;77;77;1;0;0;3;4;12;0;4214;4;1;
/org.eclipse.jdt.core/model/org/eclipse/jdt/internal/core/util/ConstantPoolEntry.java;2;1;3;1;2;2;2;1;18;0;1;3629;32;32;1;0;0;1;3;3629;0;4422;3;2;
/org.eclipse.update.ui.forms/src/org/eclipse/update/ui/forms/CustomWorkbook.java;1;0;2;1;0;0;0;2;0;1;2;1423;0;0;1;0;0;2;2;1423;0;2474;2;1;
/org.eclipse.ui/Eclipse JFace/org/eclipse/jface/preference/IPreferencePage.java;2;0;2;1;0;0;0;2;5;1;2;257;5;5;1;0;0;2;2;257;0;457;2;2;
/org.eclipse.update/Eclipse Update/org/eclipse/update/internal/core/UpdateManagerException.java;1;0;3;1;0;0;0;3;4;1;3;108;4;4;1;0;0;3;3;108;0;1424;3;1;
/org.eclipse.jdt.ui.tests.refactoring/resources/RenameType/test10/out/B.java;1;0;1;1;0;0;0;1;0;0;1;522;0;0;1;0;0;1;1;522;0;522;1;1;
/org.eclipse.jdt.ui.tests.refactoring/resources/RenamePrivateMethod/test16/in/A.java;1;0;1;1;0;0;0;1;0;0;1;49;0;0;1;0;0;1;1;49;0;49;1;1;
/org.eclipse.jdt.ui.tests.refactoring/resources/RenameNonPrivateField/testFail11/in/A.java;1;0;1;1;0;0;0;1;0;0;1;49;0;0;1;0;0;1;1;49;0;49;1;1;
/org.eclipse.jdt.ui.tests.refactoring/resources/RenamePrivateMethod/test23/in/A.java;1;0;2;1;0;0;0;2;2;1;2;49;2;2;1;0;0;2;2;49;0;512;2;1;
/org.eclipse.swt/Eclipse SWT/win32/org/eclipse/swt/widgets/CoolBar.java;7;2;33;2;10;7;10;23;345;2;21;106;1271;1271;2;2;3;23;33;1759;5;4701;28;7;
/org.eclipse.scripting/Eclipse Scripting/org/eclipse/scripting/internal/views/ScriptUIEditorSourceViewerConfiguration.java;1;0;3;1;0;0;0;3;7;1;3;133;7;7;1;0;0;3;3;133;0;1424;3;1;
/org.eclipse.update/Eclipse Update/org/eclipse/update/internal/ui/UMApplicationWindow.java;2;0;4;1;0;0;0;4;624;1;4;108;628;628;1;0;0;4;4;108;0;1424;4;2;
/org.eclipse.ui/Eclipse UI/org/eclipse/ui/internal/LayoutTree.java;3;0;6;1;1;1;1;5;26;1;5;257;53;53;1;0;0;5;6;257;0;4431;6;3;
/org.eclipse.jdt.ui/ui/org/eclipse/jdt/internal/ui/text/correction/LocalCorrectionsSubProcessor.java;2;2;12;1;9;8;9;3;125;1;3;3763;341;341;2;0;1;3;12;4187;1;4621;11;2;
/org.eclipse.jdt.core/codeassist/org/eclipse/jdt/internal/codeassist/impl/CompletionOptions.java;1;0;8;1;0;0;0;8;4;4;5;938;4;4;4;3;0;8;8;1039;3;1168;5;1;
/org.eclipse.swt/Eclipse SWT/motif/org/eclipse/swt/internal/motif/XButtonEvent.java;2;0;3;1;0;0;0;3;4;1;3;106;4;4;1;0;0;3;3;106;0;2069;3;2;
/org.eclipse.jdt.core/compiler/org/eclipse/jdt/internal/compiler/lookup/LocalVariableBinding.java;2;0;11;1;1;1;1;10;151;4;7;455;320;320;4;3;0;10;11;1039;3;4062;8;2;
/org.eclipse.team.cvs.core/src/org/eclipse/team/internal/ccvs/core/client/listeners/LogEntry.java;3;0;6;1;0;0;0;6;84;1;6;2572;107;107;1;0;0;6;6;2572;0;3610;6;3;
/org.eclipse.swt/Eclipse SWT/common/org/eclipse/swt/events/FocusAdapter.java;2;0;3;1;1;1;1;2;6;1;2;106;10;10;1;0;0;2;3;106;0;4701;3;2;
/org.eclipse.jdt.ui/ui/org/eclipse/jdt/internal/ui/text/java/ReconcilingProblemRequestor.java;2;0;3;1;0;0;0;3;6;1;3;3324;6;6;1;0;0;3;3;3324;0;3418;3;2;
/org.eclipse.ui/Eclipse UI Standard Components/org/eclipse/ui/wizards/newresource/BasicNewFileResourceWizard.java;2;0;3;1;0;0;0;3;21;1;3;257;28;28;1;0;0;3;3;257;0;2568;3;2;
/org.eclipse.jdt.ui.tests/refactoring/org/eclipse/jdt/refactoring/tests/SelectionAnalyzerTests.java;1;0;2;1;0;0;0;2;0;1;2;1368;0;0;1;0;0;2;2;1368;0;1896;2;1;
/org.eclipse.jdt.debug/jdi interfaces/com/sun/jdi/event/ExceptionEvent.java;2;0;2;1;0;0;0;2;14;1;2;2704;14;14;1;0;0;2;2;2704;0;3040;2;2;
/org.eclipse.jdt.ui/ui/org/eclipse/jdt/internal/ui/viewsupport/OverlayIcon.java;2;0;3;1;0;0;0;3;8;1;3;15;8;8;1;0;0;3;3;15;0;1310;3;2;
/org.eclipse.core.boot/src/org/eclipse/core/internal/boot/PlatformURLComponentConnection.java;3;0;3;1;0;0;0;3;16;1;3;23;16;16;1;0;0;3;3;23;0;2726;3;3;
/org.eclipse.jdt.ui/ui/org/eclipse/jdt/internal/ui/jarpackager/JarPackagerUtil.java;1;0;7;1;0;0;0;7;61;2;5;3529;110;110;2;2;0;7;7;3739;2;3849;5;1;
/org.eclipse.swt.examples/src/org/eclipse/swt/examples/helloworld/HelloWorld2.java;4;0;5;1;1;1;1;4;33;1;4;513;82;82;1;0;0;4;5;513;0;4705;5;4;
/org.eclipse.ui/Eclipse UI/org/eclipse/ui/internal/RetargetAction.java;4;0;6;1;0;0;0;6;11;2;5;257;23;23;2;1;0;6;6;1436;1;3176;5;4;
/org.eclipse.jdt.debug/eval/org/eclipse/jdt/internal/debug/eval/ast/engine/EvaluationEngineMessages.java;1;0;1;1;0;0;0;1;0;0;1;3764;0;0;1;0;0;1;1;3764;0;3764;1;1;
/org.eclipse.jdt.ui/ui/org/eclipse/jdt/internal/ui/search/WorkingSetFindAction.java;1;0;2;1;2;1;2;0;0;0;0;4140;0;0;2;0;1;0;2;4140;1;4140;1;1;
/org.eclipse.jdt.debug.tests/tests/org/eclipse/jdt/debug/tests/eval/NestedTypeFieldValue_168.java;2;1;3;1;3;3;3;0;12;0;0;4447;14;14;1;0;0;0;3;4447;0;4571;3;2;
/org.eclipse.jdt.debug/jdi/org/eclipse/jdi/internal/connect/PacketSendManager.java;2;0;4;1;0;0;0;4;13;1;4;187;27;27;1;0;0;4;4;187;0;3677;4;2;
/org.eclipse.vcm.ui/src/org/eclipse/vcm/internal/ui/syncdialog/ReleaseAction.java;2;0;2;1;0;0;0;2;0;1;2;1;0;0;1;0;0;2;2;1;0;68;2;2;
/org.eclipse.debug.ui/ui/org/eclipse/debug/internal/ui/actions/DebugWithAction.java;2;0;2;1;0;0;0;2;0;1;2;2382;0;0;1;0;0;2;2;2382;0;3634;2;2;
/org.eclipse.jdt.ui.tests.refactoring/resources/SurroundWithWorkSpace/SurroundWithTests/trycatch_out/TestWrappedLocal2.java;1;0;2;1;0;0;0;2;7;1;2;2327;7;7;1;0;0;2;2;2327;0;3870;2;1;
/org.eclipse.search/search/org/eclipse/search/ui/SearchUI.java;2;1;19;1;4;4;4;15;67;1;15;15;252;252;1;0;0;15;19;15;0;4700;19;2;
/org.eclipse.jdt.debug/jdi/org/eclipse/jdi/internal/ThreadReferenceImpl.java;3;1;13;1;2;2;2;11;43;2;10;187;178;178;2;1;0;11;13;2139;1;4207;12;3;
/org.eclipse.jdt.ui/ui/org/eclipse/jdt/ui/actions/FindAction.java;2;1;6;1;6;6;6;0;21;0;0;4141;44;44;1;0;0;0;6;4141;0;4725;6;2;
/org.eclipse.core.tests.resources/src/org/eclipse/core/tests/internal/watson/ElementDeltaTest.java;3;0;3;1;1;1;1;2;1134;1;2;1794;1151;1151;1;0;0;2;3;1794;0;4516;3;3;
/org.eclipse.update.ui.forms/src/org/eclipse/update/ui/forms/IFormTextListener.java;1;0;3;1;0;0;0;3;4;1;3;1423;4;4;1;0;0;3;3;1423;0;2474;3;1;
/org.eclipse.update.ui.forms/src/org/eclipse/update/ui/forms/internal/CustomWorkbook.java;1;0;1;1;0;0;0;1;0;0;1;2470;0;0;1;0;0;1;1;2470;0;2470;1;1;
/org.eclipse.swt.tests/JUnit Tests/org/eclipse/swt/tests/junit/Test_org_eclipse_swt_custom_BusyIndicator.java;2;0;2;1;1;1;1;1;6;0;1;1792;6;6;1;0;0;1;2;1792;0;4706;2;2;
/org.eclipse.swt/Eclipse SWT/common/org/eclipse/swt/graphics/ImageLoaderListener.java;4;0;5;1;1;1;1;4;6;1;4;106;20;20;1;0;0;4;5;106;0;4701;5;4;
/org.eclipse.jdt.core/compiler/org/eclipse/jdt/internal/compiler/ast/Literal.java;2;1;4;1;2;2;2;2;35;1;2;455;50;50;1;0;0;2;4;455;0;4421;4;2;
/org.eclipse.update.ui.forms/src/org/eclipse/update/ui/forms/internal/engine/TextSegment.java;1;1;8;1;2;2;2;6;304;3;4;2745;422;422;3;2;0;6;8;2745;2;4628;6;1;
/org.eclipse.jdt.core/compiler/org/eclipse/jdt/internal/compiler/lookup/InvocationSite.java;2;0;4;1;1;1;1;3;15;1;3;455;26;26;1;0;0;3;4;455;0;4062;4;2;
/org.eclipse.jdt.ui.tests.refactoring/resources/ExtractMethodWorkSpace/ExtractMethodTests/L.java;1;1;3;1;2;2;2;1;40;0;1;1236;40;40;1;0;0;1;3;1236;0;4419;3;1;
/org.eclipse.ui/Eclipse JFace/org/eclipse/jface/preference/FontFieldEditor.java;3;0;6;1;0;0;0;6;33;1;6;257;60;60;1;0;0;6;6;257;0;3310;6;3;
/org.eclipse.jdt.junit/src/org/eclipse/jdt/internal/junit/util/JUnitStatus.java;1;0;1;1;0;0;0;1;0;0;1;3247;0;0;1;0;0;1;1;3247;0;3247;1;1;
/org.eclipse.jdt.ui.tests.refactoring/resources/SelectionAnalyzerWorkSpace/SelectionAnalyzerTests/invalidSelection/A_test045.java;1;0;1;1;0;0;0;1;0;0;1;1368;0;0;1;0;0;1;1;1368;0;1368;1;1;
/org.eclipse.help/webapps/examples/WEB-INF/classes/error/Smart.java;1;0;2;1;0;0;0;2;0;1;2;1882;0;0;1;0;0;2;2;1882;0;1930;2;1;
/org.eclipse.swt/Eclipse SWT/motif/org/eclipse/swt/widgets/Control.java;9;2;52;2;14;13;14;38;2483;2;36;106;5863;5863;2;2;1;38;52;1241;3;4773;49;9;
/org.eclipse.ui/Eclipse UI/org/eclipse/ui/IWorkbenchWizard.java;2;0;2;1;0;0;0;2;5;1;2;257;5;5;1;0;0;2;2;257;0;457;2;2;
/org.eclipse.team.tests.cvs.core/src/org/eclipse/team/tests/ccvs/ui/logformatter/DelimitedValuesWriter.java;1;0;1;1;0;0;0;1;0;0;1;3452;0;0;1;0;0;1;1;3452;0;3452;1;1;
/org.eclipse.swt/Eclipse SWT OLE Win32/win32/org/eclipse/swt/ole/win32/OleFunctionDescription.java;2;0;3;1;1;1;1;2;10;1;2;106;16;16;1;0;0;2;3;106;0;4701;3;2;
/org.eclipse.pde.core/src/org/eclipse/pde/core/plugin/IPluginLibrary.java;1;0;3;1;2;1;2;1;98;0;1;3591;98;98;2;0;1;1;3;4751;1;4751;2;1;
/org.eclipse.swt/Eclipse SWT PI/carbon/org/eclipse/swt/internal/carbon/MacRect.java;2;1;2;1;2;2;2;0;6;0;0;4147;6;6;1;0;0;0;2;4147;0;4701;2;2;
/org.eclipse.jdt.ui/ui/org/eclipse/jdt/internal/ui/wizards/NewPackageCreationWizardPage.java;2;0;17;1;0;0;0;17;135;3;14;15;358;358;3;3;0;17;17;3084;3;3084;14;2;
/org.eclipse.scripting/Eclipse Scripting/org/eclipse/scripting/ScriptAdapterWorkbenchResourceImportWizard.java;1;0;3;1;0;0;0;3;7;1;3;133;7;7;1;0;0;3;3;133;0;1424;3;1;
/org.eclipse.jdt.ui/ui debug/org/eclipse/jdt/internal/debug/ui/JDIModelPresentation.java;6;0;33;2;0;0;0;33;265;3;29;15;1714;1714;3;4;0;33;33;965;4;1916;29;6;
/org.eclipse.jdt.ui/core extension/org/eclipse/jdt/internal/corext/dom/Selection.java;1;0;3;1;0;0;0;3;12;1;3;2876;14;14;1;0;0;3;3;2876;0;3585;3;1;
/org.eclipse.update/src/org/eclipse/update/internal/core/URLHandler.java;1;0;1;1;0;0;0;1;0;0;1;1424;0;0;1;0;0;1;1;1424;0;1424;1;1;
/org.eclipse.search/search/org/eclipse/search/internal/ui/text/TextSearchResultCollector.java;2;1;15;1;5;5;5;10;55;1;10;15;233;233;1;0;0;10;15;15;0;4619;15;2;
/org.eclipse.jdt.ui.tests.refactoring/resources/RenameTemp/cannotRename/A_testFail22.java;1;0;2;1;0;0;0;2;2;1;2;1625;2;2;1;0;0;2;2;1625;0;1652;2;1;
/org.eclipse.ui/Eclipse UI Standard Components/org/eclipse/ui/views/properties/PropertySheetPage.java;4;0;11;1;2;1;2;9;436;1;9;257;655;655;2;0;1;9;11;4382;1;4382;10;4;
/org.eclipse.jdt.ui.tests.refactoring/resources/RenameMethodInInterface/testFail6/in/A.java;1;0;1;1;0;0;0;1;0;0;1;49;0;0;1;0;0;1;1;49;0;49;1;1;
/org.eclipse.core.target/src/org/eclipse/core/internal/target/webdav/PushTargetVisitor.java;1;0;3;1;0;0;0;3;6;1;3;12;6;6;1;0;0;3;3;12;0;744;3;1;
/org.eclipse.jdt.ui.tests.refactoring/resources/RenameParameters/canRename/A_test7_in.java;1;0;1;1;0;0;0;1;0;0;1;233;0;0;1;0;0;1;1;233;0;233;1;1;
/org.eclipse.ui/Eclipse UI/org/eclipse/ui/internal/dialogs/TypeFilteringDialog.java;5;0;6;1;0;0;0;6;48;1;6;457;55;55;1;0;0;6;6;457;0;3029;6;5;
/org.eclipse.jdt.ui/core refactoring/org/eclipse/jdt/internal/corext/refactoring/base/RefactoringStatus.java;2;1;6;1;3;3;3;3;27;1;3;1939;85;85;1;0;0;3;6;1939;0;4189;6;2;
/org.eclipse.jdt.ui/ui/org/eclipse/jdt/internal/ui/javadocexport/JavadocSpecificsWizardPage.java;5;1;17;2;2;2;2;15;352;2;12;2878;1372;1372;2;3;0;15;17;3568;3;4630;14;5;
/org.eclipse.jdt.ui.tests.refactoring/resources/StructureSelectionAction/A_testWholeCu.java;1;0;1;1;0;0;0;1;0;0;1;2139;0;0;1;0;0;1;1;2139;0;2139;1;1;
/org.eclipse.pde.ui/src/org/eclipse/pde/internal/editor/feature/NewFeaturePluginWizardPage.java;1;0;5;1;0;0;0;5;126;1;5;2953;134;134;1;0;0;5;5;2953;0;3579;5;1;
/org.eclipse.ui/Eclipse UI Standard Components/org/eclipse/ui/views/tasklist/TaskListContentProvider.java;5;2;15;1;3;2;3;12;875;1;12;257;1654;1654;2;0;1;12;15;4268;1;4385;14;5;
/org.eclipse.jdt.debug/model/org/eclipse/jdt/internal/debug/core/model/JDIArrayValue.java;2;0;3;2;0;0;0;3;8;0;1;2517;8;8;3;2;0;3;3;2517;2;2517;1;2;
/org.eclipse.jdt.core/model/org/eclipse/jdt/internal/core/Region.java;2;0;10;1;1;1;1;9;230;4;6;455;303;303;4;3;0;9;10;1039;3;4063;7;2;
/org.eclipse.ant.core/src/org/eclipse/ant/core/ProxyBuildListener.java;1;0;1;1;0;0;0;1;0;0;1;3270;0;0;1;0;0;1;1;3270;0;3270;1;1;
/org.eclipse.jdt.ui/core refactoring/org/eclipse/jdt/internal/core/nls/model/Messages.java;1;0;2;1;0;0;0;2;0;1;2;1913;0;0;1;0;0;2;2;1913;0;1922;2;1;
/org.eclipse.jdt.ui.tests.refactoring/resources/ExtractMethodWorkSpace/ExtractMethodTests/validSelection/A_test275.java;2;1;3;1;2;2;2;1;6;0;1;195;6;6;1;0;0;1;3;195;0;4419;3;2;
/org.eclipse.jdt.ui/core refactoring/org/eclipse/jdt/internal/core/refactoring/tagging/IRenameRefactoring.java;3;0;5;1;0;0;0;5;29;1;5;408;56;56;1;0;0;5;5;408;0;1939;5;3;
/org.eclipse.jdt.core/compiler/org/eclipse/jdt/internal/compiler/parser/TerminalSymbols.java;2;0;12;1;0;0;0;12;1266;4;9;455;2233;2233;4;3;0;12;12;1039;3;3525;9;2;
/org.eclipse.jdt.ui.tests.refactoring/resources/RenameType/testFail59/in/A.java;1;0;1;1;0;0;0;1;0;0;1;49;0;0;1;0;0;1;1;49;0;49;1;1;
/org.eclipse.swt.examples.paint/org/eclipse/swt/examples/paint/RectangleFigure.java;4;0;5;2;1;1;1;4;64;2;3;566;75;75;2;1;0;4;5;609;1;4024;4;4;
/org.eclipse.core.target/src/org/eclipse/core/internal/target/webdav/DavTarget.java;2;0;11;1;1;1;1;10;518;4;7;12;729;729;4;3;0;10;11;663;3;4196;8;2;
/org.eclipse.jdt.ui.tests.refactoring/resources/RenameVirtualMethodInClass/test19/in/A.java;1;0;1;1;0;0;0;1;0;0;1;49;0;0;1;0;0;1;1;49;0;49;1;1;
/org.eclipse.swt/Eclipse SWT/motif/org/eclipse/swt/internal/motif/XmTextBlockRec.java;2;0;3;1;0;0;0;3;4;1;3;106;4;4;1;0;0;3;3;106;0;2069;3;2;
/org.eclipse.pde.ui/src/org/eclipse/pde/internal/core/feature/AbstractFeatureModel.java;1;0;4;1;0;0;0;4;17;2;3;3579;19;19;2;1;0;4;4;3579;1;3607;3;1;
/org.eclipse.ui/Eclipse UI Standard Components/org/eclipse/ui/views/tasklist/RemoveTaskAction.java;5;0;5;1;1;1;1;4;13;1;4;257;24;24;1;0;0;4;5;257;0;4269;5;5;
/org.eclipse.swt/Eclipse SWT/photon/org/eclipse/swt/graphics/Device.java;6;1;10;1;3;3;3;7;193;1;7;106;302;302;1;0;0;7;10;106;0;4701;10;6;
/org.eclipse.jdt.ui.tests.refactoring/resources/ReorderParameters/canReorder/A_test17_out.java;1;0;1;1;0;0;0;1;0;0;1;2296;0;0;1;0;0;1;1;2296;0;2296;1;1;
/org.eclipse.jdt.ui.tests/JUnit/junit/framework/TestFailure.java;2;0;2;1;0;0;0;2;0;1;2;49;0;0;1;0;0;2;2;49;0;1186;2;2;
/org.eclipse.jdt.ui/ui/org/eclipse/jdt/internal/ui/search/ByElementNameSorter.java;1;0;3;1;0;0;0;3;28;2;2;1119;28;28;2;1;0;3;3;1267;1;1267;2;1;
/org.eclipse.help.ui/src/org/eclipse/help/internal/ui/WorkbenchHelpPlugin.java;2;0;10;1;1;1;1;9;68;1;9;1420;176;176;1;0;0;9;10;1420;0;4439;10;2;
/org.eclipse.jdt.ui.tests.refactoring/resources/RenameType/test23/out/A.java;1;0;2;1;0;0;0;2;0;1;2;49;0;0;1;0;0;2;2;49;0;522;2;1;
/org.eclipse.jdt.core/model/org/eclipse/jdt/internal/core/TypeConverter.java;2;1;5;1;2;2;2;3;46;1;3;3265;105;105;1;0;0;3;5;3265;0;4063;5;2;
/org.eclipse.jdt.ui/core refactoring/org/eclipse/jdt/internal/corext/refactoring/structure/FieldReferenceFinder.java;2;0;6;1;0;0;0;6;243;1;6;2737;263;263;1;0;0;6;6;2737;0;3188;6;2;
/org.eclipse.jdt.ui.tests.refactoring/resources/MoveMembers/test13/in/B.java;1;0;1;1;0;0;0;1;0;0;1;2738;0;0;1;0;0;1;1;2738;0;2738;1;1;
/org.eclipse.core.target/src/org/eclipse/core/target/Target.java;1;0;11;1;1;1;1;10;550;6;5;12;738;738;6;5;0;10;11;666;5;4196;6;1;
/org.eclipse.jdt.ui.tests.refactoring/resources/ExtractTemp/canExtract/A_test1_out.java;1;0;1;1;0;0;0;1;0;0;1;2481;0;0;1;0;0;1;1;2481;0;2481;1;1;
/org.eclipse.jdt.junit/src/org/eclipse/jdt/internal/junit/wizards/NewTestSuiteCreationWizard.java;2;1;4;1;2;2;2;2;13;1;2;3527;25;25;1;0;0;2;4;3527;0;4254;4;2;
/org.eclipse.pde.ui/src/org/eclipse/pde/internal/editor/feature/EditorBuildFeatureAction.java;1;0;2;1;0;0;0;2;0;1;2;3113;0;0;1;0;0;2;2;3113;0;3579;2;1;
/org.eclipse.jdt.ui/core refactoring/org/eclipse/jdt/internal/corext/refactoring/reorg/DeleteRefactoring.java;2;0;6;1;1;1;1;5;25;1;5;1939;73;73;1;0;0;5;6;1939;0;4400;6;2;
/org.eclipse.jdt.ui.tests.refactoring/resources/RenameType/testFail30/in/A.java;1;0;1;1;0;0;0;1;0;0;1;49;0;0;1;0;0;1;1;49;0;49;1;1;
/org.eclipse.jdt.ui.tests.refactoring/resources/ExtractTemp/canExtract/A_test38_out.java;1;0;1;1;1;1;1;0;0;0;0;4363;0;0;1;0;0;0;1;4363;0;4363;1;1;
/org.eclipse.pde.ui/src/org/eclipse/pde/internal/ui/util/PDEProblemFinder.java;1;0;1;1;0;0;0;1;0;0;1;3579;0;0;1;0;0;1;1;3579;0;3579;1;1;
/org.eclipse.pde.ui/src/org/eclipse/pde/internal/editor/text/PDECommentScanner.java;2;0;2;1;0;0;0;2;0;1;2;1434;0;0;1;0;0;2;2;1434;0;3579;2;2;
/org.eclipse.jdt.ui/ui/org/eclipse/jdt/internal/ui/text/javadoc/JavaDocCommentReader.java;3;0;4;1;0;0;0;4;5;1;4;15;7;7;1;0;0;4;4;15;0;2495;4;3;
/org.eclipse.jdt.ui.tests.refactoring/resources/SelectionAnalyzerWorkSpace/SelectionAnalyzerTests/invalidSelection/A_test150.java;1;0;1;1;0;0;0;1;0;0;1;1368;0;0;1;0;0;1;1;1368;0;1368;1;1;
/org.eclipse.jdt.ui/ui/org/eclipse/jdt/internal/ui/util/JavaElementDeltaSpy.java;3;0;4;1;0;0;0;4;5;1;4;15;9;9;1;0;0;4;4;15;0;1199;4;3;
/org.eclipse.pde.build/src/plugin/org/eclipse/pde/internal/core/FetchScriptGeneratorApplication.java;1;0;1;1;0;0;0;1;0;0;1;3475;0;0;1;0;0;1;1;3475;0;3475;1;1;
/org.eclipse.jdt.ui.tests.refactoring/resources/RenameVariables/canRename/A_test17_out.java;1;0;2;1;0;0;0;2;0;1;2;724;0;0;1;0;0;2;2;724;0;1665;2;1;
/org.eclipse.swt/Eclipse SWT PI/gtk/org/eclipse/swt/internal/gtk/GtkContainer.java;1;0;2;1;0;0;0;2;0;1;2;2107;0;0;1;0;0;2;2;2107;0;3209;2;1;
/org.eclipse.jdt.ui.tests.refactoring/resources/RenameMethodInInterface/testFail35/in/A.java;1;0;1;1;0;0;0;1;0;0;1;49;0;0;1;0;0;1;1;49;0;49;1;1;
/org.eclipse.jdt.ui.tests/refactoring/org/eclipse/jdt/refactoring/tests/SafeDeleteTypeTests.java;1;0;2;1;0;0;0;2;0;1;2;49;0;0;1;0;0;2;2;49;0;81;2;1;
/org.eclipse.pde.ui/src/org/eclipse/pde/internal/editor/build/BuildSourceOutlinePage.java;2;0;2;1;0;0;0;2;0;1;2;1434;0;0;1;0;0;2;2;1434;0;3579;2;2;
/org.eclipse.compare/compare/org/eclipse/compare/internal/patch/PatchedResource.java;1;0;2;1;1;1;1;1;16;0;1;2876;16;16;1;0;0;1;2;2876;0;4541;2;1;
/org.eclipse.jdt.ui.tests.refactoring/test cases/org/eclipse/jdt/ui/tests/refactoring/RenameJavaProjectTests.java;1;0;4;1;0;0;0;4;11;1;4;2062;16;16;1;0;0;4;4;2062;0;3326;4;1;
/org.eclipse.help.ui/src/org/eclipse/help/ui/internal/IHyperlinkListener.java;1;0;1;1;1;1;1;0;0;0;0;4439;0;0;1;0;0;0;1;4439;0;4439;1;1;
/org.eclipse.pde.ui/src/org/eclipse/pde/internal/ui/wizards/templates/GenericTemplateSection.java;1;0;3;1;0;0;0;3;94;1;3;3579;94;94;1;0;0;3;3;3579;0;3819;3;1;
/org.eclipse.jdt.core/model/org/eclipse/jdt/internal/core/builder/impl/NamespaceNode.java;1;0;10;1;0;0;0;10;17;4;6;455;35;35;4;4;0;10;10;1039;4;2808;6;1;
/org.eclipse.swt/Eclipse SWT PI/photon/org/eclipse/swt/internal/photon/OS.java;2;1;11;1;4;4;4;7;19;1;7;2069;56;56;1;0;0;7;11;2069;0;4726;11;2;
/org.eclipse.scripting/src/org/eclipse/scripting/internal/IXGRElementEventGeneratorOnClick.java;1;0;1;1;0;0;0;1;0;0;1;1424;0;0;1;0;0;1;1;1424;0;1424;1;1;
/org.eclipse.team.tests.cvs.core/src/org/eclipse/team/tests/ccvs/core/provider/AllTestsProvider.java;2;0;2;1;0;0;0;2;1;1;2;3250;1;1;1;0;0;2;2;3250;0;3402;2;2;
/org.eclipse.jdt.ui/ui/org/eclipse/jdt/internal/ui/jarexporter/JarFileExportWizard.java;1;0;2;1;0;0;0;2;0;1;2;15;0;0;1;0;0;2;2;15;0;239;2;1;
/org.eclipse.vcm.ui/src/org/eclipse/vcm/internal/ui/syncdialog/IVCMNode.java;2;0;2;1;0;0;0;2;0;1;2;1;0;0;1;0;0;2;2;1;0;68;2;2;
/org.eclipse.pde.ui/Eclipse PDE UI/org/eclipse/pde/internal/editor/schema/ElementPropertySource.java;2;0;5;2;0;0;0;5;12;3;3;267;12;12;3;2;0;5;5;324;2;1434;3;2;
/org.eclipse.ant.core/src/org/eclipse/ant/internal/core/old/CommandDataType.java;1;0;1;1;0;0;0;1;0;0;1;3270;0;0;1;0;0;1;1;3270;0;3270;1;1;
/org.eclipse.jdt.ui/ui/org/eclipse/jdt/internal/ui/util/TypeInfoLabelProvider.java;3;0;5;1;0;0;0;5;33;1;5;1258;64;64;1;0;0;5;5;1258;0;2820;5;3;
/org.eclipse.swt/Eclipse SWT/motif/org/eclipse/swt/widgets/Button.java;9;1;18;1;4;4;4;14;397;1;14;106;1078;1078;1;0;0;14;18;106;0;4701;18;9;
/org.eclipse.pde.ui/src/org/eclipse/pde/internal/core/ischema/ISchema.java;1;0;2;1;0;0;0;2;0;1;2;3591;0;0;1;0;0;2;2;3591;0;3607;2;1;
/org.eclipse.jdt.ui.tests.refactoring/test cases/org/eclipse/jdt/ui/tests/refactoring/RenameTempTests.java;2;1;23;1;3;3;3;20;60;3;15;1896;219;219;3;5;0;20;23;3353;5;4620;18;2;
/org.eclipse.jdt.debug/eval/org/eclipse/jdt/debug/eval/ast/model/ICompiledExpression.java;1;0;2;1;0;0;0;2;0;1;2;3329;0;0;1;0;0;2;2;3329;0;3421;2;1;
/org.eclipse.team.ui/src/org/eclipse/team/ui/actions/MoveAction.java;1;0;3;1;0;0;0;3;80;1;3;1978;80;80;1;0;0;3;3;1978;0;2517;3;1;
/org.eclipse.pde.ui/src/org/eclipse/pde/internal/ui/wizards/extension/NewExtensionRegistryReader.java;1;0;1;1;0;0;0;1;0;0;1;3579;0;0;1;0;0;1;1;3579;0;3579;1;1;
/org.eclipse.team.core/src/org/eclipse/team/core/sync/ISyncProvider.java;1;0;3;1;0;0;0;3;2;1;3;2019;2;2;1;0;0;3;3;2019;0;3185;3;1;
/org.eclipse.pde.ui/Eclipse PDE UI/org/eclipse/pde/internal/forms/IHyperlinkListener.java;2;0;5;2;0;0;0;5;12;3;3;267;12;12;3;2;0;5;5;324;2;1434;3;2;
/org.eclipse.team.cvs.core/src/org/eclipse/team/internal/ccvs/core/util/StringMatcher.java;3;0;6;1;1;1;1;5;776;1;5;1978;1560;1560;1;0;0;5;6;1978;0;4571;6;3;
/org.eclipse.pde.ui/Eclipse PDE UI/org/eclipse/pde/internal/base/model/plugin/IJarsModel.java;2;0;5;2;0;0;0;5;18;3;3;267;18;18;3;2;0;5;5;324;2;1434;3;2;
/org.eclipse.jdt.ui/ui/org/eclipse/jdt/internal/ui/workingsets/JavaWorkingSetPage.java;5;2;13;2;10;8;10;3;23;2;2;3834;82;82;2;1;2;3;13;3834;3;4627;10;5;
/org.eclipse.jdt.ui.vcm/vcm/org/eclipse/vcm/internal/ui/VCMLabelDecorator.java;1;0;2;1;0;0;0;2;0;1;2;419;0;0;1;0;0;2;2;419;0;434;2;1;
/org.eclipse.core.runtime/src/org/eclipse/core/internal/plugins/IPluginVisitor.java;3;0;4;1;1;1;1;3;24;1;3;12;46;46;1;0;0;3;4;12;0;4213;4;3;
/org.eclipse.swt/Eclipse SWT/gtk1x/org/eclipse/swt/widgets/GtkFileDialog.java;2;1;4;1;2;2;2;2;22;1;2;2726;38;38;1;0;0;2;4;2726;0;4701;4;2;
/org.eclipse.team.cvs.core/src/org/eclipse/team/internal/ccvs/core/response/UpdateExisting.java;2;0;2;1;0;0;0;2;0;1;2;1978;0;0;1;0;0;2;2;1978;0;2607;2;2;
/org.eclipse.jdt.ui/ui/org/eclipse/jdt/internal/ui/launcher/OpenTypeAction.java;3;0;5;1;0;0;0;5;52;1;5;15;74;74;1;0;0;5;5;15;0;1916;5;3;
/org.eclipse.swt.tests/JUnit Tests/org/eclipse/swt/tests/junit/Test_org_eclipse_swt_widgets_TabItem.java;2;0;2;1;1;1;1;1;6;0;1;1792;6;6;1;0;0;1;2;1792;0;4706;2;2;
/org.eclipse.compare/compare/org/eclipse/compare/patch/PatchParser.java;1;0;4;1;0;0;0;4;52;1;4;1516;83;83;1;0;0;4;4;1516;0;1802;4;1;
/org.eclipse.pde.ui/src/org/eclipse/pde/internal/editor/build/BuildSourcePage.java;2;0;2;1;0;0;0;2;0;1;2;1434;0;0;1;0;0;2;2;1434;0;3579;2;2;
/org.eclipse.jdt.ui/ui/org/eclipse/jdt/internal/ui/jarpackager/JavaElementModalListContentProvider.java;2;0;2;1;0;0;0;2;0;1;2;902;0;0;1;0;0;2;2;902;0;1322;2;2;
/org.eclipse.jdt.ui.tests.refactoring/resources/RenameVirtualMethodInClass/test2/in/A.java;1;0;1;1;0;0;0;1;0;0;1;49;0;0;1;0;0;1;1;49;0;49;1;1;
/org.eclipse.jdt.ui.tests.refactoring/resources/MoveCU/test1/out/p1/C.java;2;0;2;1;0;0;0;2;0;1;2;49;0;0;1;0;0;2;2;49;0;2769;2;2;
/org.eclipse.jdt.debug/eval/org/eclipse/jdt/internal/debug/eval/ast/engine/PushType.java;1;0;3;1;0;0;0;3;96;1;3;3329;96;96;1;0;0;3;3;3329;0;3421;3;1;
/org.eclipse.pde.ui/src/org/eclipse/pde/internal/core/ischema/ISchemaRestriction.java;1;0;2;1;0;0;0;2;0;1;2;3591;0;0;1;0;0;2;2;3591;0;3607;2;1;
/org.eclipse.ui.tests/Eclipse UI Tests/org/eclipse/ui/tests/api/IFileMock.java;1;0;2;1;0;0;0;2;0;1;2;983;0;0;1;0;0;2;2;983;0;1038;2;1;
/org.eclipse.jdt.ui.tests.refactoring/resources/RenameTemp/canRename/A_test45_out.java;1;0;1;1;0;0;0;1;0;0;1;3356;0;0;1;0;0;1;1;3356;0;3356;1;1;
/org.eclipse.compare/compare/org/eclipse/compare/contentmergeviewer/TextMergeViewer.java;2;3;61;1;14;10;14;47;582;2;43;14;4026;4026;3;4;4;47;61;4464;8;4820;53;2;
/org.eclipse.core.tests.runtime/src/org/eclipse/core/tests/internal/plugins/NumberOfElementsTest.java;3;0;3;1;0;0;0;3;144;1;3;1794;154;154;1;0;0;3;3;1794;0;3476;3;3;
/org.eclipse.ui/Eclipse UI/org/eclipse/ui/internal/registry/AcceleratorScope.java;3;2;20;1;4;3;4;16;247;5;11;3055;582;582;5;5;1;16;20;3267;6;4625;14;3;
/org.eclipse.team.cvs.core/src/org/eclipse/team/internal/ccvs/core/response/ResponseHandler.java;3;0;8;1;0;0;0;8;212;1;8;1978;610;610;1;0;0;8;8;1978;0;2607;8;3;
/org.eclipse.jdt.ui.tests.refactoring/resources/RenameParameters/canRename/A_test13_out.java;1;0;1;1;0;0;0;1;0;0;1;233;0;0;1;0;0;1;1;233;0;233;1;1;
/org.eclipse.ui.examples.readmetool/Eclipse UI Examples Readme Tool/org/eclipse/ui/examples/readmetool/AddReadmeMarkerAction.java;1;0;1;1;0;0;0;1;0;0;1;2497;0;0;1;0;0;1;1;2497;0;2497;1;1;
/org.eclipse.jdt.core/model/org/eclipse/jdt/core/IParent.java;2;0;4;1;1;1;1;3;36;1;3;455;72;72;1;0;0;3;4;455;0;4061;4;2;
/org.eclipse.debug.ui/ui/org/eclipse/debug/internal/ui/RemoveAllBreakpointsAction.java;3;0;12;1;0;0;0;12;25;1;12;187;118;118;1;0;0;12;12;187;0;2382;12;3;
/org.eclipse.scripting/Eclipse Scripting/org/eclipse/scripting/internal/uirenderer/XGRUILinkManager.java;2;0;4;1;0;0;0;4;10;1;4;133;17;17;1;0;0;4;4;133;0;1424;4;2;
/org.eclipse.update.ui/src/org/eclipse/update/internal/ui/IURLAction.java;1;0;2;1;0;0;0;2;0;1;2;1526;0;0;1;0;0;2;2;1526;0;1570;2;1;
/org.eclipse.jdt.debug/model/org/eclipse/jdt/debug/core/IJavaPatternBreakpoint.java;3;0;6;1;0;0;0;6;23;1;6;1280;68;68;1;0;0;6;6;1280;0;3572;6;3;
/org.eclipse.jdt.ui.tests.refactoring/resources/RenameVirtualMethodInClass/test14/out/A.java;1;0;1;1;0;0;0;1;0;0;1;49;0;0;1;0;0;1;1;49;0;49;1;1;
/org.eclipse.swt.examples.paint/src/org/eclipse/swt/examples/paint/TextTool.java;3;0;4;2;1;1;1;3;140;2;2;587;146;146;2;1;0;3;4;609;1;4705;3;3;
/org.eclipse.swt.examples.launcher/org/eclipse/swt/examples/launcher/LauncherPlugin.java;4;0;5;1;1;1;1;4;413;1;4;513;469;469;1;0;0;4;5;513;0;4024;5;4;
/org.eclipse.vcm.core.cvs/src/org/eclipse/vcm/internal/core/ccvs/client/RemoteServerConnection.java;1;0;1;1;0;0;0;1;0;0;1;126;0;0;1;0;0;1;1;126;0;126;1;1;
/org.eclipse.jdt.ui.tests.refactoring/resources/SurroundWithWorkSpace/SurroundWithTests/trycatch_out/TestExceptionOrder.java;1;0;2;1;0;0;0;2;4;1;2;2327;4;4;1;0;0;2;2;2327;0;3870;2;1;
/org.eclipse.pde.build/src/org/eclipse/pde/internal/build/InitTemplate.java;4;0;4;1;0;0;0;4;27;1;4;245;29;29;1;0;0;4;4;245;0;3089;4;4;
/org.eclipse.pde.ui/src/org/eclipse/pde/internal/model/feature/WorkspaceFeatureModel.java;1;0;5;1;0;0;0;5;20;1;5;2951;23;23;1;0;0;5;5;2951;0;3579;5;1;
/org.eclipse.swt/Eclipse SWT/win32/org/eclipse/swt/internal/win32/COMPOSITIONFORM.java;2;0;3;1;0;0;0;3;5;1;3;106;5;5;1;0;0;3;3;106;0;2069;3;2;
/org.eclipse.pde.ui/src/org/eclipse/pde/internal/model/plugin/AttributeChangedEvent.java;1;0;2;1;0;0;0;2;0;1;2;3136;0;0;1;0;0;2;2;3136;0;3579;2;1;
/org.eclipse.team.cvs.ui/src/org/eclipse/team/internal/ccvs/ui/TextViewerAction.java;1;0;1;1;0;0;0;1;0;0;1;2619;0;0;1;0;0;1;1;2619;0;2619;1;1;
/org.eclipse.pde.ui/src/org/eclipse/pde/IPluginStructureData.java;1;0;2;1;0;0;0;2;0;1;2;3039;0;0;1;0;0;2;2;3039;0;3579;2;1;
/org.eclipse.help/src/org/eclipse/help/internal/util/RuntimeHelpStatus.java;2;0;2;1;0;0;0;2;2;1;2;1420;2;2;1;0;0;2;2;1420;0;3609;2;2;
/org.eclipse.core.tests.resources/src/org/eclipse/core/tests/resources/regression/IResourceTest.java;3;0;7;1;1;1;1;6;962;1;6;1794;1028;1028;1;0;0;6;7;1794;0;4516;7;3;
/org.eclipse.core.resources/src/org/eclipse/core/internal/resources/SafeFileTable.java;2;0;4;1;1;1;1;3;162;1;3;12;194;194;1;0;0;3;4;12;0;4213;4;2;
/org.eclipse.pde.ui/Eclipse PDE UI/org/eclipse/pde/internal/editor/component/URLSection.java;2;0;6;2;0;0;0;6;12;3;4;267;13;13;3;2;0;6;6;324;2;1434;4;2;
/org.eclipse.jdt.core/search/org/eclipse/jdt/internal/core/search/matching/MethodPattern.java;2;0;10;1;1;1;1;9;236;4;5;455;486;486;4;4;0;9;10;1039;4;4063;6;2;
/org.eclipse.jdt.core/model/org/eclipse/jdt/internal/core/builder/impl/MethodCollaboratorIndictment.java;1;0;10;1;0;0;0;10;39;4;6;455;57;57;4;4;0;10;10;1039;4;2808;6;1;
/org.eclipse.core.tests.runtime/src/org/eclipse/core/tests/internal/plugins/RegressionResolveTest_9.java;3;0;3;1;0;0;0;3;132;1;3;1794;142;142;1;0;0;3;3;1794;0;3476;3;3;
/org.eclipse.jdt.core/model/org/eclipse/jdt/internal/core/builder/impl/StateTables.java;1;0;2;1;0;0;0;2;0;1;2;455;0;0;1;0;0;2;2;455;0;2808;2;1;
/org.eclipse.update.ui/src/org/eclipse/update/ui/internal/manager/UpdateManagerInput.java;1;0;2;1;0;0;0;2;0;0;1;1426;0;0;2;1;0;2;2;1426;1;1426;1;1;
/org.eclipse.ui/Eclipse UI/org/eclipse/ui/IPrinting.java;1;0;1;1;0;0;0;1;0;0;1;969;0;0;1;0;0;1;1;969;0;969;1;1;
/org.eclipse.pde.ui/src/org/eclipse/pde/internal/wizards/imports/PluginImportWizardFirstPage.java;1;0;15;1;0;0;0;15;103;2;14;2522;268;268;2;1;0;15;15;2555;1;3579;14;1;
/org.eclipse.debug.core/core/org/eclipse/debug/internal/core/LaunchConfigurationComparator.java;1;0;1;1;1;1;1;0;0;0;0;4215;0;0;1;0;0;0;1;4215;0;4215;1;1;
/org.eclipse.update.tests.core/src/org/eclipse/update/tests/regularInstall/TestSpaceInInstall.java;1;0;9;1;1;1;1;8;12;1;8;2726;43;43;1;0;0;8;9;2726;0;4329;9;1;
/org.eclipse.jdt.ui.tests.refactoring/resources/ExtractMethodWorkSpace/ExtractMethodTests/try_out/A_test451.java;2;1;4;1;2;2;2;2;28;1;2;65;29;29;1;0;0;2;4;65;0;4419;4;2;
/org.eclipse.jdt.ui/core refactoring/org/eclipse/jdt/internal/core/refactoring/Checks.java;4;0;30;1;0;0;0;30;111;3;26;15;656;656;3;4;0;30;30;942;4;1939;26;4;
/org.eclipse.jdt.ui.tests.refactoring/resources/MultiMove/test0/out/p2/C.java;1;0;2;1;0;0;0;2;2;1;2;1157;2;2;1;0;0;2;2;1157;0;2584;2;1;
/org.eclipse.ui/Eclipse UI/org/eclipse/ui/internal/registry/WorkingSetRegistry.java;2;0;4;1;1;1;1;3;65;1;3;3494;76;76;1;0;0;3;4;3494;0;4123;4;2;
/org.eclipse.ui/Eclipse JFace/org/eclipse/jface/viewers/OpenEvent.java;1;0;1;1;0;0;0;1;0;0;1;3576;0;0;1;0;0;1;1;3576;0;3576;1;1;
/org.eclipse.team.cvs.core/src/org/eclipse/team/ccvs/core/IRemoteRoot.java;2;0;2;1;0;0;0;2;0;1;2;1978;0;0;1;0;0;2;2;1978;0;2049;2;2;
/org.eclipse.jdt.ui/ui refactoring/org/eclipse/jdt/internal/ui/refactoring/PullUpMethodsInputPage.java;1;0;2;1;0;0;0;2;0;1;2;2270;0;0;1;0;0;2;2;2270;0;2406;2;1;
/org.eclipse.jdt.ui/core codemanipulation/org/eclipse/jdt/internal/core/codemanipulation/SimpleTextEdit.java;1;0;2;1;0;0;0;2;0;1;2;1800;0;0;1;0;0;2;2;1800;0;1937;2;1;
/org.eclipse.ui/Eclipse JFace Text/org/eclipse/jface/text/contentassist/IContextInformationPresenter.java;2;0;3;1;1;1;1;2;40;1;2;1226;58;58;1;0;0;2;3;1226;0;4838;3;2;
/org.eclipse.swt.tests/JUnit Tests/org/eclipse/swt/tests/junit/Test_org_eclipse_swt_events_KeyAdapter.java;2;0;2;1;1;1;1;1;6;0;1;1792;6;6;1;0;0;1;2;1792;0;4706;2;2;
/org.eclipse.ui/Eclipse UI/org/eclipse/ui/internal/ObjectActionContributor.java;5;0;10;1;1;1;1;9;86;2;8;257;183;183;2;1;0;9;10;2033;1;4555;9;5;
/org.eclipse.jdt.ui.tests.refactoring/resources/RenamePrivateField/test1/out/A.java;1;0;1;1;0;0;0;1;0;0;1;49;0;0;1;0;0;1;1;49;0;49;1;1;
/org.eclipse.ui/Eclipse UI/org/eclipse/ui/internal/dialogs/WizardCollectionElement.java;2;0;3;1;0;0;0;3;19;1;3;257;32;32;1;0;0;3;3;257;0;3720;3;2;
/org.eclipse.jdt.ui/ui/org/eclipse/jdt/internal/ui/viewsupport/ProblemItemMapper.java;2;0;12;1;1;1;1;11;122;1;11;1035;266;266;1;0;0;11;12;1035;0;3999;12;2;
/org.eclipse.pde.ui/src/org/eclipse/pde/core/plugin/IPluginReference.java;1;0;2;1;0;0;0;2;0;1;2;3579;0;0;1;0;0;2;2;3579;0;3607;2;1;
/org.eclipse.jdt.ui/ui/org/eclipse/jdt/internal/ui/reorg/PasteInCompilationUnitEdit.java;2;0;4;1;0;0;0;4;16;2;3;2003;19;19;2;1;0;4;4;2133;1;2619;3;2;
/org.eclipse.debug.ui/ui/org/eclipse/debug/ui/AbstractDebugView.java;3;2;38;2;5;4;5;33;223;6;20;2313;840;840;6;13;1;33;38;2328;14;4726;24;3;
/org.eclipse.pde.ui/src/org/eclipse/pde/internal/ui/preferences/EditorPreferencePage.java;1;0;1;1;1;1;1;0;0;0;0;4588;0;0;1;0;0;0;1;4588;0;4588;1;1;
/org.eclipse.core.tests.runtime/src/org/eclipse/core/tests/internal/plugins/ActivationTest_DirectOtherRef.java;4;0;4;1;0;0;0;4;164;1;4;1794;194;194;1;0;0;4;4;1794;0;3476;4;4;
/org.eclipse.jdt.junit/Eclipse JUnit/org/eclipse/jdt/internal/junit/ui/JUnitPlugin.java;3;0;10;2;0;0;0;10;97;2;9;2007;306;306;2;1;0;10;10;3068;1;3313;9;3;
/org.eclipse.update.core/src/org/eclipse/update/core/IImport.java;2;0;9;1;1;1;1;8;71;2;7;1710;114;114;2;1;0;8;9;3571;1;4554;8;2;
/org.eclipse.pde.ui/src/org/eclipse/pde/internal/base/model/plugin/IPluginModelFactory.java;2;0;3;1;0;0;0;3;2;1;3;1434;2;2;1;0;0;3;3;1434;0;3039;3;2;
/org.eclipse.team.cvs.core/src/org/eclipse/team/internal/ccvs/core/util/SyncFileUtil.java;2;0;22;2;0;0;0;22;199;3;17;2156;593;593;3;5;0;22;22;2864;5;3089;17;2;
/org.eclipse.core.boot/src/org/eclipse/core/internal/boot/update/IUMFactory.java;2;0;3;1;0;0;0;3;7;1;3;12;7;7;1;0;0;3;3;12;0;2726;3;2;
/org.eclipse.jdt.core/codeassist/org/eclipse/jdt/internal/codeassist/complete/CompletionOnQualifiedInterfaceReference.java;2;2;3;1;3;2;3;0;17;0;0;3890;20;20;2;0;1;0;3;3890;1;4062;2;2;
/org.eclipse.core.tests.runtime/src/org/eclipse/core/tests/internal/plugins/PlatformURLTest.java;4;0;6;1;1;1;1;5;962;1;5;1794;1181;1181;1;0;0;5;6;1794;0;4191;6;4;
/org.eclipse.jdt.ui.tests.refactoring/resources/MoveCU/testFail0/in/p/A.java;2;0;2;1;0;0;0;2;0;1;2;49;0;0;1;0;0;2;2;49;0;2769;2;2;
/org.eclipse.jdt.ui/core refactoring/org/eclipse/jdt/internal/core/refactoring/util/ResourceManager.java;1;0;2;1;0;0;0;2;0;1;2;1800;0;0;1;0;0;2;2;1800;0;1939;2;1;
/org.eclipse.jdt.core/model/org/eclipse/jdt/internal/core/builder/IMember.java;1;0;4;1;0;0;0;4;22;1;4;455;23;23;1;0;0;4;4;455;0;2808;4;1;
/org.eclipse.swt.examples/src/org/eclipse/swt/examples/controlexample/RangeTab.java;5;1;7;1;3;3;3;4;278;1;4;513;465;465;1;0;0;4;7;513;0;4705;7;5;
/org.eclipse.update/Eclipse Update/org/eclipse/update/internal/core/UpdateManagerURLComparator.java;1;0;3;1;0;0;0;3;4;1;3;108;4;4;1;0;0;3;3;108;0;1424;3;1;
/org.eclipse.swt/Eclipse SWT Custom Widgets/common/org/eclipse/swt/custom/StyledTextContent.java;4;1;5;1;2;2;2;3;68;1;3;106;137;137;1;0;0;3;5;106;0;4701;5;4;
/org.eclipse.vcm.core.cvs/src/org/eclipse/vcm/internal/core/ccvs/VersionHistory.java;2;0;2;1;0;0;0;2;5;1;2;0;5;5;1;0;0;2;2;0;0;298;2;2;
/org.eclipse.swt/Eclipse SWT/common_j2se/org/eclipse/swt/internal/CloneableCompatibility.java;2;0;2;1;1;1;1;1;6;0;1;1434;6;6;1;0;0;1;2;1434;0;4701;2;2;
/org.eclipse.pde.ui/src/org/eclipse/pde/internal/editor/TableSection.java;1;0;6;1;0;0;0;6;14;1;6;2998;29;29;1;0;0;6;6;2998;0;3579;6;1;
/org.eclipse.help.ui/src/org/eclipse/help/internal/ui/ContextHelpDialog.java;2;2;16;2;4;3;4;12;304;1;12;1420;709;709;2;0;1;12;16;4144;1;4439;15;2;
/org.eclipse.ui/Eclipse JFace/org/eclipse/jface/viewers/TextCellEditor.java;5;0;6;1;1;1;1;5;151;1;5;257;176;176;1;0;0;5;6;257;0;4211;6;5;
/org.eclipse.ant.ui/src/org/eclipse/ant/ui/internal/toolscripts/AbstractToolScriptWizard.java;1;0;2;1;0;0;0;2;0;1;2;2919;0;0;1;0;0;2;2;2919;0;2933;2;1;
/org.eclipse.ui/Eclipse UI Standard Components/org/eclipse/ui/views/navigator/NavigatorDragAdapter.java;6;1;9;1;2;2;2;7;224;2;6;257;345;345;2;1;0;7;9;3509;1;4426;8;6;
/org.eclipse.team.core/src/org/eclipse/team/internal/core/target/ISiteListener.java;1;0;1;1;1;1;1;0;0;0;0;4636;0;0;1;0;0;0;1;4636;0;4636;1;1;
/org.eclipse.core.tests.runtime/src/org/eclipse/core/tests/internal/plugin/c/api/ApiClass.java;3;0;3;1;0;0;0;3;10;1;3;1794;20;20;1;0;0;3;3;1794;0;3476;3;3;
/org.eclipse.pde.ui/src/org/eclipse/pde/internal/ui/preferences/MainPreferencePage.java;1;1;5;1;2;2;2;3;176;1;3;3579;186;186;1;0;0;3;5;3579;0;4588;5;1;
/org.eclipse.team.core/src/org/eclipse/team/internal/core/target/ISiteFactory.java;1;0;1;1;1;1;1;0;0;0;0;4636;0;0;1;0;0;0;1;4636;0;4636;1;1;
/org.eclipse.pde.ui/Eclipse PDE UI/org/eclipse/pde/internal/editor/manifest/ReqGraphSection.java;2;0;6;2;0;0;0;6;12;3;4;267;13;13;3;2;0;6;6;324;2;1434;4;2;
/org.eclipse.jdt.ui.tests.refactoring/resources/RenameTemp/cannotRename/A_testFail8.java;1;0;2;1;0;0;0;2;2;1;2;1625;2;2;1;0;0;2;2;1625;0;1652;2;1;
/org.eclipse.jdt.ui/core refactoring/org/eclipse/jdt/core/refactoring/fields/RenamePrivateFieldRefactoring.java;1;0;5;1;0;0;0;5;199;3;3;15;199;199;3;2;0;5;5;25;2;237;3;1;
/org.eclipse.jdt.ui/ui/org/eclipse/jdt/ui/actions/ReadReferencesSearchGroup.java;2;2;4;2;4;3;4;0;24;0;0;4146;32;32;2;0;1;0;4;4146;1;4770;3;2;
/org.eclipse.jdt.core/dom/org/eclipse/jdt/core/dom/AssertStatement.java;2;1;6;1;2;2;2;4;18;1;4;2669;50;50;1;0;0;4;6;2669;0;4453;6;2;
/org.eclipse.team.cvs.ui/src/org/eclipse/team/internal/ccvs/ui/actions/SyncOutgoingAction.java;1;1;2;1;2;2;2;0;42;0;0;4023;42;42;1;0;0;0;2;4023;0;4143;2;1;
/org.eclipse.pde.ui/src/org/eclipse/pde/internal/preferences/TextOption.java;2;0;2;1;0;0;0;2;0;1;2;1434;0;0;1;0;0;2;2;1434;0;3579;2;2;
/org.eclipse.jdt.ui/core refactoring/org/eclipse/jdt/internal/corext/refactoring/rename/RenameTempASTAnalyzer.java;3;0;4;1;0;0;0;4;32;1;4;1939;46;46;1;0;0;4;4;1939;0;3309;4;3;
/org.eclipse.pde.ui/src/org/eclipse/pde/IPluginContentWizard.java;1;0;2;1;0;0;0;2;0;1;2;3039;0;0;1;0;0;2;2;3039;0;3579;2;1;
/org.eclipse.jdt.ui.tests.refactoring/test cases/org/eclipse/jdt/ui/tests/refactoring/TestUtil.java;1;0;1;1;0;0;0;1;0;0;1;2735;0;0;1;0;0;1;1;2735;0;2735;1;1;
/org.eclipse.jdt.debug/eval/org/eclipse/jdt/internal/debug/eval/ast/instructions/PushLocalVariable.java;2;0;4;1;0;0;0;4;7;1;4;3645;12;12;1;0;0;4;4;3645;0;3833;4;2;
/org.eclipse.jdt.core/compiler/org/eclipse/jdt/internal/compiler/lookup/CompilerModifiers.java;2;0;3;1;1;1;1;2;16;1;2;455;27;27;1;0;0;2;3;455;0;4062;3;2;
/org.eclipse.vcm.ui/src/org/eclipse/vcm/internal/ui/syncdialog/CommitChangesAction.java;2;0;2;1;0;0;0;2;0;1;2;1;0;0;1;0;0;2;2;1;0;68;2;2;
/org.eclipse.tomcat/src/org/eclipse/tomcat/TomcatPlugin.java;2;0;3;1;0;0;0;3;2;1;3;2409;2;2;1;0;0;3;3;2409;0;3285;3;2;
/org.eclipse.jdt.ui.tests.refactoring/resources/RenameMethodInInterface/testFail26/in/A.java;1;0;1;1;0;0;0;1;0;0;1;49;0;0;1;0;0;1;1;49;0;49;1;1;
/org.eclipse.jdt.ui.tests.refactoring/resources/InlineTemp/canInline/A_test3_out.java;1;0;1;1;0;0;0;1;0;0;1;2015;0;0;1;0;0;1;1;2015;0;2015;1;1;
/org.eclipse.pde.ui/Eclipse PDE UI/org/eclipse/pde/internal/model/component/ComponentReference.java;2;0;5;2;0;0;0;5;12;3;3;267;12;12;3;2;0;5;5;324;2;1434;3;2;
/org.eclipse.jdt.debug/eval/org/eclipse/jdt/debug/eval/model/IClassType.java;2;0;2;1;0;0;0;2;0;1;2;3421;0;0;1;0;0;2;2;3421;0;3555;2;2;
/org.eclipse.pde.ui/src/org/eclipse/pde/internal/preferences/ExternalPluginsWizard.java;2;0;2;1;0;0;0;2;0;1;2;1434;0;0;1;0;0;2;2;1434;0;2750;2;2;
/org.eclipse.jdt.ui.tests.refactoring/resources/MultiMove/test1/in/p3/B.java;1;0;1;1;0;0;0;1;0;0;1;1157;0;0;1;0;0;1;1;1157;0;1157;1;1;
/org.eclipse.update.ui/src/org/eclipse/update/internal/ui/forms/InstallableSiteForm.java;2;0;4;2;2;1;2;2;3;1;2;3662;6;6;2;0;1;2;4;4606;1;4606;3;2;
/org.eclipse.jdt.ui.tests.refactoring/resources/ExtractMethodWorkSpace/ExtractMethodTests/validSelection/A_test310.java;2;1;3;1;2;2;2;1;2;0;1;195;2;2;1;0;0;1;3;195;0;4419;3;2;
/org.eclipse.jdt.ui/ui/org/eclipse/jdt/internal/ui/wizards/NewSourceFolderWizardPage.java;3;1;10;1;8;8;8;2;213;1;2;3089;288;288;1;0;0;2;10;3089;0;4621;10;3;
/org.eclipse.update.ui/src/org/eclipse/update/internal/ui/manager/DetailsSection.java;1;0;6;1;0;0;0;6;144;2;5;1457;151;151;2;1;0;6;6;1457;1;1581;5;1;
/org.eclipse.jdt.core/compiler/org/eclipse/jdt/internal/compiler/env/IBinaryMethod.java;2;0;5;1;1;1;1;4;42;1;4;455;74;74;1;0;0;4;5;455;0;4062;5;2;
/org.eclipse.swt/Eclipse SWT OLE Win32/win32/org/eclipse/swt/internal/ole/win32/FORMATETC.java;2;0;3;1;0;0;0;3;5;1;3;106;5;5;1;0;0;3;3;106;0;2069;3;2;
/org.eclipse.ui/Eclipse UI/org/eclipse/ui/dialogs/IOverwriteQuery.java;4;0;4;1;0;0;0;4;8;1;4;257;19;19;1;0;0;4;4;257;0;3837;4;4;
/org.eclipse.jdt.ui/ui/org/eclipse/jdt/internal/ui/actions/RetargetActionDelegator.java;1;0;4;1;1;1;1;3;6;1;3;3533;8;8;1;0;0;3;4;3533;0;3914;4;1;
/org.eclipse.pde.ui/src/org/eclipse/pde/internal/ui/editor/feature/EditorBuildFeatureAction.java;1;0;3;1;0;0;0;3;2;1;3;3579;3;3;1;0;0;3;3;3579;0;3793;3;1;
/org.eclipse.jdt.ui.tests.refactoring/resources/PullUp/testFail8/in/A.java;1;0;1;1;0;0;0;1;0;0;1;2406;0;0;1;0;0;1;1;2406;0;2406;1;1;
/org.eclipse.update.ui/src/org/eclipse/update/internal/ui/forms/SearchResultSection.java;1;1;5;1;2;2;2;3;43;0;1;3662;82;82;3;2;0;3;5;3662;2;4460;3;1;
/org.eclipse.jdt.core/compiler/org/eclipse/jdt/internal/compiler/ast/LabeledStatement.java;2;1;15;1;2;2;2;13;171;4;10;455;374;374;4;3;0;13;15;1039;3;4421;12;2;
/org.eclipse.compare/compare/org/eclipse/compare/internal/ResizableDialog.java;1;1;2;1;2;2;2;0;15;0;0;4188;15;15;1;0;0;0;2;4188;0;4564;2;1;
/org.eclipse.jdt.ui.tests.refactoring/resources/RenameType/testFail02/in/A.java;1;0;1;1;0;0;0;1;0;0;1;49;0;0;1;0;0;1;1;49;0;49;1;1;
/org.eclipse.swt/Eclipse SWT/common/org/eclipse/swt/internal/Callback.java;6;0;25;1;1;1;1;24;102;2;23;106;195;195;2;1;0;24;25;2016;1;4701;24;6;
/org.eclipse.pde.build/src/org/eclipse/pde/internal/build/tasks/PluginLocationTask.java;1;0;5;1;0;0;0;5;40;4;2;3190;40;40;4;3;0;5;5;3190;3;3509;2;1;
/org.eclipse.vcm.ui/src/org/eclipse/vcm/internal/ui/sync/CatchupAction.java;1;0;4;1;0;0;0;4;8;1;4;48;8;8;1;0;0;4;4;48;0;349;4;1;
/org.eclipse.jdt.debug/jdi interfaces/com/sun/jdi/event/VMDisconnectEvent.java;2;0;2;1;0;0;0;2;6;1;2;2704;6;6;1;0;0;2;2;2704;0;3040;2;2;
/org.eclipse.jdt.ui.tests.refactoring/resources/ExtractMethodWorkSpace/ExtractMethodTests/validSelection/A_test285.java;2;1;3;1;2;2;2;1;8;0;1;158;8;8;1;0;0;1;3;158;0;4419;3;2;
/org.eclipse.help.ui/Eclipse Help UI/org/eclipse/help/internal/ui/HTMLHelpViewer.java;3;0;14;1;0;0;0;14;25;2;13;136;70;70;2;1;0;14;14;688;1;1420;13;3;
/org.eclipse.swt/Eclipse SWT/common_j2me/org/eclipse/swt/internal/SerializableCompatibility.java;2;0;2;1;1;1;1;1;6;0;1;1434;6;6;1;0;0;1;2;1434;0;4701;2;2;
/org.eclipse.jdt.debug/eval/org/eclipse/jdt/debug/eval/model/IVirtualMachine.java;2;0;2;1;0;0;0;2;0;1;2;3421;0;0;1;0;0;2;2;3421;0;3555;2;2;
/org.eclipse.jdt.ui.tests.refactoring/test cases/org/eclipse/jdt/ui/tests/refactoring/RenamePrivateMethodTests.java;2;0;3;1;0;0;0;3;8;1;3;1896;16;16;1;0;0;3;3;1896;0;1939;3;2;
/org.eclipse.pde.build/src/org/eclipse/pde/internal/build/ant/JavacTask.java;1;1;8;1;2;2;2;6;78;2;4;3672;127;127;2;2;0;6;8;3698;2;4273;6;1;
/org.eclipse.jdt.ui.tests.refactoring/resources/RenameTemp/canRename/A_test5_out.java;1;0;2;1;0;0;0;2;2;1;2;1625;2;2;1;0;0;2;2;1625;0;1652;2;1;
/org.eclipse.jdt.core/codeassist/org/eclipse/jdt/internal/codeassist/complete/CompletionOnInterfaceReference.java;2;2;3;1;3;2;3;0;17;0;0;3890;20;20;2;0;1;0;3;3890;1;4062;2;2;
/org.eclipse.jdt.core/model/org/eclipse/jdt/core/ICodeAssist.java;4;2;11;2;5;4;5;6;83;1;6;455;230;230;2;0;1;6;11;4421;1;4805;10;4;
/org.eclipse.jdt.ui/ui/org/eclipse/jdt/internal/ui/jarpackager/SealPackagesFilter.java;1;0;2;1;1;1;1;1;15;0;1;914;19;19;1;0;0;1;2;914;0;4211;2;1;
/org.eclipse.ui/Eclipse UI Standard Components/org/eclipse/ui/views/navigator/StringMatcher.java;3;0;4;1;0;0;0;4;36;1;4;257;52;52;1;0;0;4;4;257;0;1815;4;3;
/org.eclipse.pde.ui/Eclipse PDE UI/org/eclipse/pde/internal/wizards/WizardCollectionElement.java;2;0;5;2;0;0;0;5;12;3;3;267;12;12;3;2;0;5;5;324;2;1434;3;2;
/org.eclipse.vcm.ui.cvs/src/org/eclipse/vcm/internal/ui/ccvs/FilterRepositoryWizard.java;1;0;3;1;0;0;0;3;87;1;3;1424;93;93;1;0;0;3;3;1424;0;1578;3;1;
/org.eclipse.jdt.core/compiler/org/eclipse/jdt/internal/compiler/ast/Assignment.java;2;1;15;1;2;2;2;13;218;4;10;455;545;545;4;3;0;13;15;1039;3;4418;12;2;
/org.eclipse.vcm.core.cvs/src/org/eclipse/vcm/internal/core/ccvs/requests/IUpdatedListener.java;3;0;4;1;0;0;0;4;22;1;4;0;33;33;1;0;0;4;4;0;0;1499;4;3;
/org.eclipse.jdt.ui.tests.refactoring/resources/DeleteSourceReferenceEdit/A_testField1_out.java;1;0;1;1;0;0;0;1;0;0;1;2857;0;0;1;0;0;1;1;2857;0;2857;1;1;
/org.eclipse.vcm.ui/src/org/eclipse/vcm/internal/ui/merge/BeforeStatePage.java;4;0;8;2;0;0;0;8;27;2;7;1;53;53;2;1;0;8;8;297;1;1548;7;4;
/org.eclipse.jdt.ui/core refactoring/org/eclipse/jdt/internal/corext/refactoring/rename/UpdateTypeReferenceEdit.java;1;0;1;1;0;0;0;1;0;0;1;3872;0;0;1;0;0;1;1;3872;0;3872;1;1;
/org.eclipse.core.resources/src/org/eclipse/core/internal/resources/FileState.java;2;0;4;1;1;1;1;3;146;1;3;12;171;171;1;0;0;3;4;12;0;4213;4;2;
/org.eclipse.jdt.ui.tests.refactoring/resources/RenameNonPrivateField/test14/out/A.java;1;0;1;1;0;0;0;1;0;0;1;1274;0;0;1;0;0;1;1;1274;0;1274;1;1;
/org.eclipse.swt/Eclipse SWT Custom Widgets/common_j2se/org/eclipse/swt/custom/AnimatedProgress.java;1;0;1;1;0;0;0;1;0;0;1;1378;0;0;1;0;0;1;1;1378;0;1378;1;1;
/org.eclipse.pde.ui/src/org/eclipse/pde/internal/forms/renamed/IFormPage.java;1;0;2;1;0;0;0;2;0;1;2;2470;0;0;1;0;0;2;2;2470;0;2691;2;1;
/org.eclipse.core.tests.resources/src/org/eclipse/core/tests/internal/indexing/TestEnvironment.java;3;0;4;1;1;1;1;3;72;1;3;1794;93;93;1;0;0;3;4;1794;0;4516;4;3;
/org.eclipse.ui.tests/Eclipse UI Tests/org/eclipse/ui/tests/api/IWorkbenchWindowTest.java;4;0;9;1;0;0;0;9;206;1;9;881;340;340;1;0;0;9;9;881;0;3068;9;4;
/org.eclipse.swt/Eclipse SWT/gtk/org/eclipse/swt/widgets/GtkFileDialog.java;3;1;7;2;2;2;2;5;146;2;4;2726;199;199;2;1;0;5;7;3511;1;4701;6;3;
/org.eclipse.jdt.ui.tests.refactoring/test cases/org/eclipse/jdt/ui/tests/refactoring/infra/TextBufferChangeCreator.java;1;0;3;1;0;0;0;3;4;1;3;1896;4;4;1;0;0;3;3;1896;0;2216;3;1;
/org.eclipse.ui/Eclipse JFace/org/eclipse/jface/preference/PreferenceNode.java;2;0;2;1;0;0;0;2;5;1;2;257;5;5;1;0;0;2;2;257;0;457;2;2;
/org.eclipse.pde/src/org/eclipse/pde/internal/builders/DependencyLoopFinder.java;1;0;3;1;1;1;1;2;15;1;2;3631;23;23;1;0;0;2;3;3631;0;4733;3;1;
/org.eclipse.compare/compare/org/eclipse/compare/patch/PatchCompareInput.java;1;0;6;1;0;0;0;6;63;1;6;1516;148;148;1;0;0;6;6;1516;0;2876;6;1;
/org.eclipse.ui.examples.readmetool/Eclipse UI Examples Readme Tool/org/eclipse/ui/examples/readmetool/ReadmeModelFactory.java;2;0;2;1;0;0;0;2;2;1;2;932;2;2;1;0;0;2;2;932;0;945;2;2;
/org.eclipse.core.tests.runtime/src/org/eclipse/core/tests/internal/runtimetests/SampleIPB.java;1;0;2;1;0;0;0;2;10;1;2;3611;10;10;1;0;0;2;2;3611;0;3678;2;1;
/org.eclipse.jdt.ui.tests.refactoring/resources/RenamePrivateMethod/test16/out/A.java;1;0;1;1;0;0;0;1;0;0;1;49;0;0;1;0;0;1;1;49;0;49;1;1;
/org.eclipse.jdt.ui.tests.refactoring/resources/ExtractMethodWorkSpace/ExtractMethodTests/try_in/A_test458.java;1;1;3;1;2;2;2;1;0;0;1;922;0;0;1;0;0;1;3;922;0;4419;3;1;
/org.eclipse.jdt.ui.tests.refactoring/resources/RenameVariables/cannotRename/A_testFail12.java;1;0;2;1;0;0;0;2;0;1;2;724;0;0;1;0;0;2;2;724;0;1665;2;1;
/org.eclipse.update/Eclipse Update/org/eclipse/update/internal/ui/UMWizard.java;2;0;4;1;0;0;0;4;221;1;4;108;229;229;1;0;0;4;4;108;0;1424;4;2;
/org.eclipse.swt/Eclipse SWT OLE Win32/win32/org/eclipse/swt/internal/ole/win32/FUNCDESC1.java;2;0;3;1;0;0;0;3;6;1;3;106;6;6;1;0;0;3;3;106;0;2069;3;2;
/org.eclipse.swt.examples/src/org/eclipse/swt/examples/explorer/IconCache.java;1;0;1;1;0;0;0;1;0;0;1;553;0;0;1;0;0;1;1;553;0;553;1;1;
/org.eclipse.pde.ui/src/org/eclipse/pde/internal/editor/manifest/ResourceAttributeCellEditor.java;2;0;2;1;0;0;0;2;0;1;2;1434;0;0;1;0;0;2;2;1434;0;3579;2;2;
/org.eclipse.jdt.ui.tests.refactoring/resources/RenameMethodInInterface/test16/in/A.java;2;0;2;1;0;0;0;2;2;1;2;49;2;2;1;0;0;2;2;49;0;1297;2;2;
/org.eclipse.core.tests.runtime/src/org/eclipse/core/tests/internal/plugins/ConflictResolveTest_6.java;3;0;3;1;0;0;0;3;134;1;3;1794;144;144;1;0;0;3;3;1794;0;3476;3;3;
/org.eclipse.pde.build/src/org/eclipse/pde/internal/build/FeatureBuildScriptGenerator.java;2;2;39;1;19;14;19;20;1110;3;14;2859;2771;2771;3;6;5;20;39;3190;11;4364;28;2;
/org.eclipse.scripting/Eclipse Scripting/org/eclipse/scripting/internal/views/ScriptUIEditorDocScanner.java;1;0;3;1;0;0;0;3;7;1;3;133;7;7;1;0;0;3;3;133;0;1424;3;1;
/org.eclipse.update.ui.forms/src/org/eclipse/update/ui/forms/internal/HyperlinkSettings.java;1;0;2;1;0;0;0;2;12;1;2;2745;12;12;1;0;0;2;2;2745;0;3727;2;1;
/org.eclipse.core.resources/src/org/eclipse/core/resources/ISynchronizer.java;1;1;5;1;2;2;2;3;242;1;3;12;264;264;1;0;0;3;5;12;0;4214;5;1;
/org.eclipse.debug.ui/ui/org/eclipse/debug/internal/ui/LaunchesViewer.java;3;0;5;1;0;0;0;5;55;1;5;187;64;64;1;0;0;5;5;187;0;2312;5;3;
/org.eclipse.ui.examples.propertysheet/Eclipse UI Examples PropertySheet/org/eclipse/ui/examples/propertysheet/UserElement.java;3;0;3;1;0;0;0;3;72;1;3;931;88;88;1;0;0;3;3;931;0;3029;3;3;
/org.eclipse.update.tests.core/src/org/eclipse/update/tests/model/SiteMain.java;2;0;6;1;0;0;0;6;148;2;5;2420;203;203;2;1;0;6;6;2858;1;3107;5;2;
/org.eclipse.scripting/src/org/eclipse/scripting/internal/uirenderer/XGRElementUISwtText.java;1;0;1;1;0;0;0;1;0;0;1;1424;0;0;1;0;0;1;1;1424;0;1424;1;1;
/org.eclipse.swt/Eclipse SWT Drag and Drop/win32/org/eclipse/swt/dnd/OleEnumFORMATETC.java;2;0;3;1;1;1;1;2;6;1;2;106;11;11;1;0;0;2;3;106;0;4701;3;2;
/org.eclipse.jdt.debug/model/org/eclipse/jdt/internal/debug/core/model/JDIInterfaceType.java;1;0;3;1;1;1;1;2;3;1;2;3161;4;4;1;0;0;2;3;3161;0;4423;3;1;
/org.eclipse.team.cvs.ui/src/org/eclipse/team/internal/ccvs/ui/model/RemoteFolderElement.java;3;0;9;1;0;0;0;9;70;1;9;1978;154;154;1;0;0;9;9;1978;0;3791;9;3;
/org.eclipse.ant.core/src/org/eclipse/ant/core/AntCorePlugin.java;1;1;8;1;4;4;4;4;120;2;3;3387;231;231;2;1;0;4;8;3575;1;4572;7;1;
/org.eclipse.ui/Eclipse UI/org/eclipse/ui/dialogs/ISelectionStatusValidator.java;1;0;1;1;0;0;0;1;0;0;1;3733;0;0;1;0;0;1;1;3733;0;3733;1;1;
/org.eclipse.update.ui/src/org/eclipse/update/internal/ui/manager/NewSiteDialog.java;2;0;7;1;0;0;0;7;46;1;7;1460;59;59;1;0;0;7;7;1460;0;3658;7;2;
/org.eclipse.debug.ui/ui/org/eclipse/debug/internal/ui/actions/DebugHistoryMenuAction.java;2;1;5;1;2;2;2;3;39;1;3;2382;69;69;1;0;0;3;5;2382;0;4452;5;2;
/org.eclipse.jdt.debug.ui/ui/org/eclipse/jdt/internal/debug/ui/ConditionalBreakpointErrorDialog.java;3;1;7;1;3;3;3;4;13;1;4;3329;32;32;1;0;0;4;7;3329;0;4567;7;3;
/org.eclipse.jdt.core/batch/org/eclipse/jdt/internal/compiler/batch/ClasspathDirectory.java;3;0;17;2;1;1;1;16;360;4;11;455;576;576;4;5;0;16;17;1039;5;4061;12;3;
/org.eclipse.jdt.ui/ui debug/org/eclipse/jdt/internal/debug/ui/JavaExceptionBreakpointPropertySource.java;2;0;2;1;0;0;0;2;0;1;2;1330;0;0;1;0;0;2;2;1330;0;1916;2;2;
/org.eclipse.swt/Eclipse SWT/common/org/eclipse/swt/internal/image/JPEGSegment.java;2;0;3;1;1;1;1;2;6;1;2;106;10;10;1;0;0;2;3;106;0;4701;3;2;
/org.eclipse.team.cvs.ui/src/org/eclipse/team/internal/ccvs/ui/actions/ReplaceWithRemoteAction.java;3;1;15;1;5;5;5;10;28;1;10;2806;125;125;1;0;0;10;15;2806;0;4428;15;3;
/org.eclipse.swt.examples.paint/org/eclipse/swt/examples/paint/MetaStatelessXORHelper.java;1;0;1;1;0;0;0;1;0;0;1;513;0;0;1;0;0;1;1;513;0;513;1;1;
/org.eclipse.swt.examples.controls/src/org/eclipse/swt/examples/controls/TextTab.java;2;0;2;1;0;0;0;2;0;1;2;391;0;0;1;0;0;2;2;391;0;611;2;2;
/org.eclipse.ui/Eclipse UI/org/eclipse/ui/IContributorResourceAdapter.java;1;0;4;1;0;0;0;4;18;2;3;2139;24;24;2;1;0;4;4;2198;1;2198;3;1;
/org.eclipse.swt/Eclipse SWT PI/win32/org/eclipse/swt/internal/ole/win32/OLEINPLACEFRAMEINFO.java;2;0;2;1;1;1;1;1;6;0;1;2069;6;6;1;0;0;1;2;2069;0;4701;2;2;
/org.eclipse.swt/Eclipse SWT Custom Widgets/common_j2se/org/eclipse/swt/custom/TableEditor.java;1;0;1;1;0;0;0;1;0;0;1;1378;0;0;1;0;0;1;1;1378;0;1378;1;1;
/org.eclipse.pde.ui/src/org/eclipse/pde/internal/editor/feature/PortabilityChoicesDialog.java;1;0;5;1;0;0;0;5;60;1;5;2953;77;77;1;0;0;5;5;2953;0;3579;5;1;
/org.eclipse.jdt.core/dom/org/eclipse/jdt/core/dom/InstanceofExpression.java;3;1;5;1;4;4;4;1;18;0;1;3816;36;36;1;0;0;1;5;3816;0;4453;5;3;
/org.eclipse.pde.ui/Eclipse PDE UI/org/eclipse/pde/internal/base/schema/ISchemaAttributeProvider.java;2;0;5;2;0;0;0;5;12;3;3;267;12;12;3;2;0;5;5;324;2;1434;3;2;
/org.eclipse.swt/Eclipse SWT Accessibility/emulated/org/eclipse/swt/accessibility/Accessible.java;2;1;7;1;4;4;4;3;121;2;2;3008;212;212;2;1;0;3;7;3008;1;4701;6;2;
/org.eclipse.core.boot/src/org/eclipse/core/internal/boot/update/BootUpdateManagerStrings.java;2;0;2;2;0;0;0;2;96;0;1;323;96;96;2;1;0;2;2;323;1;323;1;2;
/org.eclipse.scripting/src/org/eclipse/scripting/IDefault.java;1;0;1;1;0;0;0;1;0;0;1;1424;0;0;1;0;0;1;1;1424;0;1424;1;1;
/org.eclipse.swt.examples.controls/src/org/eclipse/swt/examples/controls/AlignableTab.java;2;0;2;1;0;0;0;2;0;1;2;391;0;0;1;0;0;2;2;391;0;611;2;2;
/org.eclipse.update.ui/src/org/eclipse/update/internal/ui/manager/HistoryView.java;3;0;22;2;0;0;0;22;590;3;19;1460;1191;1191;3;3;0;22;22;2172;3;3537;19;3;
/org.eclipse.jdt.ui.tests.refactoring/resources/ExtractMethodWorkSpace/ExtractMethodTests/invalidSelection/A_test081.java;2;1;3;1;2;2;2;1;0;0;1;49;0;0;1;0;0;1;3;49;0;4419;3;2;
/org.eclipse.search/search/org/eclipse/search/internal/ui/util/SWTUtil.java;1;0;1;1;0;0;0;1;0;0;1;1434;0;0;1;0;0;1;1;1434;0;1434;1;1;
/org.eclipse.jdt.ui.tests.refactoring/resources/RenamePrivateField/test1/in/A.java;1;0;1;1;0;0;0;1;0;0;1;49;0;0;1;0;0;1;1;49;0;49;1;1;
/org.eclipse.jdt.debug.tests/tests/org/eclipse/jdt/debug/tests/eval/NestedTypeFieldValue_134.java;2;1;3;1;3;3;3;0;12;0;0;4447;14;14;1;0;0;0;3;4447;0;4571;3;2;
/org.eclipse.jdt.ui/ui/org/eclipse/jdt/internal/ui/preferences/JavadocConfigurationPropertyPage.java;4;1;12;1;5;5;5;7;233;2;5;3247;437;437;2;2;0;7;12;3247;2;4631;10;4;
/org.eclipse.pde.ui/src/org/eclipse/pde/internal/core/ischema/IMetaElement.java;1;0;2;1;0;0;0;2;0;1;2;3591;0;0;1;0;0;2;2;3591;0;3607;2;1;
/org.eclipse.jdt.core/model/org/eclipse/jdt/internal/core/eval/RequestorWrapper.java;2;0;6;1;1;1;1;5;93;2;4;455;125;125;2;1;0;5;6;3084;1;4063;5;2;
/org.eclipse.debug.ui/ui/org/eclipse/debug/internal/ui/launchConfigurations/LaunchShortcutExtension.java;2;1;3;1;3;3;3;0;6;0;0;4367;7;7;1;0;0;0;3;4367;0;4423;3;2;
/org.eclipse.team.webdav/src/org/eclipse/team/internal/webdav/core/Authenticator.java;2;1;2;1;2;2;2;0;10;0;0;4073;10;10;1;0;0;0;2;4073;0;4245;2;2;
/org.eclipse.swt/Eclipse SWT/motif/org/eclipse/swt/graphics/Cursor.java;4;1;6;1;3;3;3;3;136;1;3;106;192;192;1;0;0;3;6;106;0;4701;6;4;
/org.eclipse.jdt.ui.tests.refactoring/resources/RenameParameters/canRename/A_test24_out.java;1;0;1;1;0;0;0;1;0;0;1;233;0;0;1;0;0;1;1;233;0;233;1;1;
/org.eclipse.jdt.ui.tests.refactoring/resources/ReorderParameters/canReorder/A_test9_in.java;1;0;3;1;0;0;0;3;0;1;3;724;0;0;1;0;0;3;3;724;0;2270;3;1;
/org.eclipse.core.runtime/src/org/eclipse/core/runtime/IPath.java;3;0;8;1;1;1;1;7;896;1;7;12;964;964;1;0;0;7;8;12;0;4214;8;3;
/org.eclipse.jdt.core/compiler/org/eclipse/jdt/internal/compiler/ast/Clinit.java;2;1;17;1;2;2;2;15;1842;4;12;455;3333;3333;4;3;0;15;17;1039;3;4421;14;2;
/org.eclipse.update/Eclipse Update/org/eclipse/update/internal/ui/UMWizardTreeItem.java;2;0;4;1;0;0;0;4;179;1;4;108;185;185;1;0;0;4;4;108;0;1424;4;2;
/org.eclipse.jdt.debug/jdi/org/eclipse/jdi/internal/request/MethodExitRequestImpl.java;2;0;4;1;0;0;0;4;12;1;4;187;25;25;1;0;0;4;4;187;0;3670;4;2;
/org.eclipse.jdt.ui/core refactoring/org/eclipse/jdt/internal/core/refactoring/reorg/TextBufferChangeManager.java;2;0;4;1;0;0;0;4;29;1;4;1258;33;33;1;0;0;4;4;1258;0;1877;4;2;
/org.eclipse.jdt.ui/ui/org/eclipse/jdt/internal/ui/javaeditor/AddBreakpointAction.java;5;0;13;1;0;0;0;13;39;1;13;15;116;116;1;0;0;13;13;15;0;2024;13;5;
/org.eclipse.ui/Eclipse JFace/org/eclipse/jface/wizard/IWizardContainer.java;2;0;2;1;0;0;0;2;5;1;2;257;5;5;1;0;0;2;2;257;0;457;2;2;
/org.eclipse.swt.examples/org/eclipse/swt/examples/fileviewer/TreeDropFeedbackListener.java;2;0;7;1;0;0;0;7;8;4;4;613;10;10;4;3;0;7;7;641;3;1625;4;2;
/org.eclipse.pde.ui/src/org/eclipse/pde/internal/model/WorkspacePluginModelBase.java;2;0;8;1;0;0;0;8;33;1;8;1434;44;44;1;0;0;8;8;1434;0;3136;8;2;
/org.eclipse.core.resources/src/org/eclipse/core/resources/IResourceVisitor.java;1;0;4;1;1;1;1;3;82;1;3;12;103;103;1;0;0;3;4;12;0;4214;4;1;
/org.eclipse.jdt.core/compiler/org/eclipse/jdt/internal/compiler/env/INameEnvironment.java;2;0;6;1;1;1;1;5;76;1;5;455;124;124;1;0;0;5;6;455;0;4062;6;2;
/org.eclipse.jdt.core/dom/org/eclipse/jdt/core/dom/StringLiteral.java;3;1;15;1;2;2;2;13;130;2;11;2669;267;267;2;2;0;13;15;2773;2;4421;13;3;
/org.eclipse.core.resources/src/org/eclipse/core/internal/dtree/DataTree.java;2;0;5;1;1;1;1;4;596;1;4;12;1117;1117;1;0;0;4;5;12;0;4214;5;2;
/org.eclipse.pde.ui/src/org/eclipse/pde/model/plugin/IPluginImport.java;1;0;2;1;0;0;0;2;0;1;2;3039;0;0;1;0;0;2;2;3039;0;3579;2;1;
/org.eclipse.update.ui/src/org/eclipse/update/internal/ui/pages/ExtensionRootPage.java;1;0;1;1;1;1;1;0;0;0;0;4244;0;0;1;0;0;0;1;4244;0;4244;1;1;
/org.eclipse.swt/Eclipse SWT/gtk1x/org/eclipse/swt/graphics/Cursor.java;4;0;4;1;1;1;1;3;11;1;3;2107;20;20;1;0;0;3;4;2107;0;4701;4;4;
/org.eclipse.ui/Eclipse UI Standard Components/org/eclipse/ui/wizards/datatransfer/WizardZipFileResourceImportPage1.java;4;0;7;1;0;0;0;7;102;1;7;257;145;145;1;0;0;7;7;257;0;3029;7;4;
/org.eclipse.swt/Eclipse SWT OLE Win32/win32/org/eclipse/swt/internal/ole/win32/IProvideClassInfo.java;2;0;3;1;0;0;0;3;5;1;3;106;5;5;1;0;0;3;3;106;0;2069;3;2;
/org.eclipse.webdav/src/client/org/eclipse/webdav/http/client/IAuthenticator.java;3;0;5;1;1;1;1;4;244;1;4;12;461;461;1;0;0;4;5;12;0;4211;5;3;
/org.eclipse.ui/Eclipse UI/org/eclipse/ui/internal/dialogs/ViewsPreferencePage.java;7;1;19;1;2;2;2;17;76;1;17;257;534;534;1;0;0;17;19;257;0;4144;19;7;
/org.eclipse.swt/Eclipse SWT PI/win32/org/eclipse/swt/internal/win32/WINDOWPOS.java;2;0;2;1;1;1;1;1;6;0;1;2069;6;6;1;0;0;1;2;2069;0;4701;2;2;
/org.eclipse.jdt.debug/eval/org/eclipse/jdt/internal/debug/eval/ast/engine/OrOperator.java;1;0;2;1;0;0;0;2;0;1;2;3329;0;0;1;0;0;2;2;3329;0;3421;2;1;
/org.eclipse.ui/Eclipse UI Text Editor/org/eclipse/ui/editors/text/IEncodingSupport.java;1;1;2;1;2;2;2;0;30;0;0;4138;30;30;1;0;0;0;2;4138;0;4838;2;1;
/org.eclipse.jdt.core/compiler/org/eclipse/jdt/internal/compiler/env/IBinaryType.java;2;1;11;1;2;2;2;9;118;4;6;455;223;223;4;3;0;9;11;1039;3;4404;8;2;
/org.eclipse.jdt.ui.tests.refactoring/resources/AbstractField/can/A_test1_in.java;1;0;1;1;0;0;0;1;0;0;1;751;0;0;1;0;0;1;1;751;0;751;1;1;
/org.eclipse.update.core/src/org/eclipse/update/core/FeatureContentConsumer.java;2;0;3;1;0;0;0;3;21;1;3;2465;21;21;1;0;0;3;3;2465;0;2994;3;2;
/org.eclipse.scripting/src/org/eclipse/scripting/internal/uirenderer/ScriptPreferenceManager.java;1;0;1;1;0;0;0;1;0;0;1;1424;0;0;1;0;0;1;1;1424;0;1424;1;1;
/org.eclipse.jdt.ui/core refactoring/org/eclipse/jdt/core/refactoring/types/RenameTypeRefactoring.java;1;0;15;1;0;0;0;15;34;2;13;15;187;187;2;2;0;15;15;106;2;408;13;1;
/org.eclipse.jdt.debug.ui/ui/org/eclipse/jdt/internal/debug/ui/MethodAdapterFactory.java;1;0;1;1;1;1;1;0;0;0;0;4457;0;0;1;0;0;0;1;4457;0;4457;1;1;
/org.eclipse.core.tests.resources/src/org/eclipse/core/tests/resources/WorkspaceTest.java;3;0;4;1;1;1;1;3;680;1;3;1794;710;710;1;0;0;3;4;1794;0;4516;4;3;
/org.eclipse.scripting/Eclipse Scripting/org/eclipse/scripting/internal/uirenderer/XGRElementScript.java;2;0;4;1;0;0;0;4;4;1;4;133;7;7;1;0;0;4;4;133;0;1424;4;2;
/org.eclipse.ui.tests/Eclipse JFace Tests/org/eclipse/jface/tests/viewers/interactive/Filter.java;1;0;1;1;0;0;0;1;0;0;1;1488;0;0;1;0;0;1;1;1488;0;1488;1;1;
/org.eclipse.jdt.ui.tests.refactoring/resources/PullUpMethods/test13/in/A.java;1;0;3;1;0;0;0;3;2;1;3;2215;2;2;1;0;0;3;3;2215;0;2406;3;1;
/org.eclipse.swt/Eclipse SWT/photon/org/eclipse/swt/widgets/WidgetTable.java;4;1;6;1;2;2;2;4;6;1;4;106;20;20;1;0;0;4;6;106;0;4701;6;4;
/org.eclipse.jdt.debug/jdi interfaces/com/sun/jdi/InterfaceType.java;2;0;2;1;0;0;0;2;12;1;2;2704;12;12;1;0;0;2;2;2704;0;3033;2;2;
/org.eclipse.jdt.ui/core refactoring/org/eclipse/jdt/internal/core/refactoring/code/StatementAnalyzer.java;4;0;23;1;0;0;0;23;1062;5;16;408;1720;1720;5;7;0;23;23;408;7;1939;16;4;
/org.eclipse.debug.ui/ui/org/eclipse/debug/internal/ui/actions/DebugWithConfigurationAction.java;2;1;3;1;2;2;2;1;11;0;1;3648;17;17;1;0;0;1;3;3648;0;4401;3;2;
/org.eclipse.help/src/org/eclipse/help/topics/ITopicNode.java;1;0;2;1;0;0;0;2;0;1;2;1675;0;0;1;0;0;2;2;1675;0;1694;2;1;
/org.eclipse.jdt.debug.tests/testprograms/org/eclipse/debug/tests/targets/HelloLauncher.java;2;0;2;1;1;1;1;1;11;0;1;3719;11;11;1;0;0;1;2;3719;0;4571;2;2;
/org.eclipse.pde.ui/Eclipse PDE UI/org/eclipse/pde/internal/wizards/project/NewFragmentProjectWizard.java;2;0;5;2;0;0;0;5;12;3;3;267;12;12;3;2;0;5;5;324;2;1434;3;2;
/org.eclipse.ui/Eclipse UI/org/eclipse/ui/internal/LabelRetargetAction.java;3;0;3;1;0;0;0;3;5;1;3;257;5;5;1;0;0;3;3;257;0;3176;3;3;
/org.eclipse.pde.ui/src/org/eclipse/pde/internal/ui/editor/feature/FeatureUndoManager.java;1;0;1;1;1;1;1;0;0;0;0;3994;0;0;1;0;0;0;1;3994;0;3994;1;1;
/org.eclipse.pde.ui/Eclipse PDE UI/org/eclipse/pde/internal/editor/PDEMultiPageXMLEditor.java;2;0;7;2;0;0;0;7;110;3;4;267;122;122;3;3;0;7;7;324;3;1434;4;2;
/org.eclipse.ui/Eclipse UI/org/eclipse/ui/internal/ViewActionBuilder.java;2;0;2;1;0;0;0;2;7;1;2;257;7;7;1;0;0;2;2;257;0;457;2;2;
/org.eclipse.pde.ui/src/org/eclipse/pde/internal/editor/manifest/ManifestExtensionsPage.java;2;0;5;1;0;0;0;5;4;1;5;1434;9;9;1;0;0;5;5;1434;0;3579;5;2;
/org.eclipse.swt.examples/Eclipse SWT Examples/common/org/eclipse/swt/examples/javaviewer/JavaLineStyler.java;1;0;2;1;0;0;0;2;0;1;2;107;0;0;1;0;0;2;2;107;0;611;2;1;
/org.eclipse.pde.ui/Eclipse PDE UI/org/eclipse/pde/internal/forms/IFormPage.java;2;0;5;2;0;0;0;5;12;3;3;267;12;12;3;2;0;5;5;324;2;1434;3;2;
/org.eclipse.jdt.ui/ui/org/eclipse/jdt/internal/ui/text/template/TemplateSet.java;4;0;13;1;0;0;0;13;191;2;12;1469;271;271;2;1;0;13;13;1601;1;2784;12;4;
/org.eclipse.jdt.core/model/org/eclipse/jdt/internal/core/OverflowingLRUCache.java;3;1;18;2;3;3;3;15;448;4;10;455;698;698;4;5;0;15;18;1039;5;4187;13;3;
/org.eclipse.pde.ui/Eclipse PDE UI/org/eclipse/pde/internal/editor/manifest/IDependencyGraphNode.java;2;0;5;2;0;0;0;5;12;3;3;267;12;12;3;2;0;5;5;324;2;1434;3;2;
/org.eclipse.core.resources/src/org/eclipse/core/internal/localstore/CoreFileSystemLibraryWindows.java;2;0;2;1;0;0;0;2;0;1;2;12;0;0;1;0;0;2;2;12;0;49;2;2;
/org.eclipse.pde.ui/src/org/eclipse/pde/internal/core/feature/FeatureFactory.java;1;0;3;1;0;0;0;3;2;1;3;3579;2;2;1;0;0;3;3;3579;0;3607;3;1;
/org.eclipse.core.runtime/src/org/eclipse/core/internal/plugins/PluginRegistry.java;4;2;16;1;3;2;3;13;574;2;12;12;764;764;2;1;1;13;16;2702;2;4689;14;4;
/org.eclipse.jdt.ui/ui/org/eclipse/jdt/internal/ui/dialogs/MessageLine.java;3;0;4;1;0;0;0;4;150;1;4;1339;155;155;1;0;0;4;4;1339;0;3683;4;3;
/org.eclipse.ui.examples.javaeditor/Eclipse Java Editor Example/org/eclipse/ui/examples/javaeditor/java/JavaWordDetector.java;1;0;1;1;0;0;0;1;0;0;1;1067;0;0;1;0;0;1;1;1067;0;1067;1;1;
/org.eclipse.jdt.ui/ui/org/eclipse/jdt/internal/ui/jarexporter/ZipFileExporter.java;1;0;2;1;0;0;0;2;0;1;2;15;0;0;1;0;0;2;2;15;0;239;2;1;
/org.eclipse.compare/compare/org/eclipse/compare/internal/EditionAction.java;2;1;9;1;2;2;2;7;163;2;6;918;299;299;2;1;0;7;9;2201;1;4403;8;2;
/org.eclipse.jdt.ui/core refactoring/org/eclipse/jdt/internal/core/refactoring/changes/AddToClasspathChange.java;2;0;6;1;0;0;0;6;23;1;6;1108;62;62;1;0;0;6;6;1108;0;1939;6;2;
/org.eclipse.pde.ui/Eclipse PDE UI/org/eclipse/pde/internal/schema/FileSchemaDescriptor.java;2;0;5;2;0;0;0;5;12;3;3;267;12;12;3;2;0;5;5;324;2;1434;3;2;
/org.eclipse.swt/Eclipse SWT/gtk1x/org/eclipse/swt/widgets/TableColumn.java;3;0;3;1;1;1;1;2;6;1;2;2107;10;10;1;0;0;2;3;2107;0;4701;3;3;
/org.eclipse.scripting/src/org/eclipse/scripting/internal/views/ScriptUIEditorTreeViewerDragAdapter.java;1;0;1;1;0;0;0;1;0;0;1;1424;0;0;1;0;0;1;1;1424;0;1424;1;1;
/org.eclipse.jdt.ui.tests.refactoring/resources/ExtractMethodWorkSpace/ExtractMethodTests/invalidSelection/A_test092.java;2;1;3;1;2;2;2;1;0;0;1;49;0;0;1;0;0;1;3;49;0;4419;3;2;
/org.eclipse.team.ftp/src/org/eclipse/team/internal/ftp/client/FTPDirectoryEntry.java;1;0;1;1;1;1;1;0;0;0;0;4169;0;0;1;0;0;0;1;4169;0;4169;1;1;
/org.eclipse.jdt.ui/core refactoring/org/eclipse/jdt/internal/corext/refactoring/code/flow/ConditionalFlowInfo.java;1;0;1;1;0;0;0;1;0;0;1;1939;0;0;1;0;0;1;1;1939;0;1939;1;1;
/org.eclipse.scripting/src/org/eclipse/scripting/internal/IXGRElementEventGeneratorOnUnload.java;1;0;1;1;0;0;0;1;0;0;1;1424;0;0;1;0;0;1;1;1424;0;1424;1;1;
/org.eclipse.swt.examples/Eclipse SWT Examples/common/org/eclipse/swt/examples/controlexample/ControlExample.java;1;0;2;1;0;0;0;2;0;1;2;107;0;0;1;0;0;2;2;107;0;611;2;1;
/org.eclipse.jdt.ui/ui refactoring/org/eclipse/jdt/internal/ui/refactoring/actions/SurroundWithTryCatchAction.java;2;0;12;1;1;1;1;11;54;2;9;2327;98;98;2;2;0;11;12;2510;2;3970;10;2;
/org.eclipse.jdt.ui/core refactoring/org/eclipse/jdt/core/refactoring/code/Selection.java;1;0;7;1;0;0;0;7;34;2;5;15;63;63;2;2;0;7;7;25;2;408;5;1;
/org.eclipse.ui/Eclipse JFace/org/eclipse/jface/wizard/WizardPage.java;3;1;7;1;2;2;2;5;48;1;5;257;106;106;1;0;0;5;7;257;0;4119;7;3;
/org.eclipse.jdt.debug/eval/org/eclipse/jdt/internal/debug/eval/ast/instructions/RightShiftAssignmentOperator.java;2;0;5;1;1;1;1;4;4;1;4;3421;10;10;1;0;0;4;5;3421;0;3955;5;2;
/org.eclipse.jdt.debug/eval/org/eclipse/jdt/internal/debug/eval/ast/engine/LessEqualOperator.java;1;0;2;1;0;0;0;2;0;1;2;3329;0;0;1;0;0;2;2;3329;0;3421;2;1;
/org.eclipse.jdt.ui.tests.refactoring/resources/PullUp/test12/in/B.java;1;0;1;1;0;0;0;1;0;0;1;2406;0;0;1;0;0;1;1;2406;0;2406;1;1;
/org.eclipse.jdt.ui.tests.refactoring/resources/PullUpMethods/testFail7/in/A.java;1;0;2;1;0;0;0;2;0;1;2;2156;0;0;1;0;0;2;2;2156;0;2406;2;1;
/org.eclipse.help/src/org/eclipse/help/internal/context/RelatedTopic.java;1;0;3;1;0;0;0;3;32;1;3;2791;51;51;1;0;0;3;3;2791;0;3075;3;1;
/org.eclipse.jdt.ui.tests.refactoring/resources/RenameTemp/canRename/A_test32_out.java;1;0;2;1;0;0;0;2;2;1;2;1625;2;2;1;0;0;2;2;1625;0;1652;2;1;
/org.eclipse.jdt.core/search/org/eclipse/jdt/internal/core/search/matching/MatchLocator.java;3;3;74;2;13;9;13;61;8046;4;50;455;16020;16020;4;11;4;61;74;1039;15;4764;59;3;
/org.eclipse.ui/Eclipse JFace Text/org/eclipse/jface/text/reconciler/IReconcilingStrategyExtension.java;1;1;2;1;2;2;2;0;27;0;0;4038;27;27;1;0;0;0;2;4038;0;4838;2;1;
/org.eclipse.swt/Eclipse SWT/motif/org/eclipse/swt/widgets/Group.java;9;1;15;1;3;3;3;12;99;1;12;106;352;352;1;0;0;12;15;106;0;4701;15;9;
/org.eclipse.jdt.core/model/org/eclipse/jdt/internal/core/CopyResourceElementsOperation.java;3;3;29;1;7;5;7;22;879;4;17;455;1219;1219;4;5;2;22;29;1039;7;4568;22;3;
/org.eclipse.pde.ui/src/org/eclipse/pde/internal/view/PluginsContentProvider.java;1;0;3;1;0;0;0;3;17;2;2;3445;17;17;2;1;0;3;3;3445;1;3579;2;1;
/org.eclipse.debug.ui/ui/org/eclipse/debug/internal/ui/actions/ShowDetailPaneAction.java;2;1;5;1;3;3;3;2;3;1;2;3536;8;8;1;0;0;2;5;3536;0;4002;5;2;
/org.eclipse.swt/Eclipse SWT/gtk1x/org/eclipse/swt/graphics/Color.java;2;0;3;1;1;1;1;2;8;1;2;2107;14;14;1;0;0;2;3;2107;0;4701;3;2;
/org.eclipse.debug.ui/ui/org/eclipse/debug/internal/ui/RunDropDownAction.java;3;0;7;1;0;0;0;7;5;1;7;187;17;17;1;0;0;7;7;187;0;2382;7;3;
/org.eclipse.webdav/src/client/org/eclipse/webdav/http/client/IStatusCodes.java;2;0;4;1;1;1;1;3;118;1;3;12;145;145;1;0;0;3;4;12;0;4211;4;2;
/org.eclipse.compare/compare/org/eclipse/compare/internal/Utilities.java;3;1;18;1;3;3;3;15;44;2;14;14;279;279;2;1;0;15;18;77;1;4541;17;3;
/org.eclipse.jdt.core/model/org/eclipse/jdt/core/util/IAttributeNamesConstants.java;2;2;5;1;4;3;4;1;20;0;1;3629;38;38;2;0;1;1;5;4058;1;4573;4;2;
/org.eclipse.jdt.core/search/org/eclipse/jdt/internal/core/index/impl/ICacheEnumeration.java;2;0;2;1;1;1;1;1;14;0;1;455;14;14;1;0;0;1;2;455;0;4063;2;2;
/org.eclipse.jdt.ui/core extension/org/eclipse/jdt/internal/corext/codemanipulation/TextBufferFactory.java;1;0;2;1;0;0;0;2;0;1;2;1937;0;0;1;0;0;2;2;1937;0;2137;2;1;
/org.eclipse.core.tests.resources/src/org/eclipse/core/tests/internal/watson/WatsonTest.java;3;0;5;1;1;1;1;4;66;1;4;1794;93;93;1;0;0;4;5;1794;0;4516;5;3;
/org.eclipse.jdt.ui.tests.refactoring/resources/RenameMethodInInterface/test2/in/A.java;1;0;1;1;0;0;0;1;0;0;1;49;0;0;1;0;0;1;1;49;0;49;1;1;
/org.eclipse.swt.tests/JUnit Tests/org/eclipse/swt/tests/junit/StyledTextContentSpec.java;2;0;2;1;1;1;1;1;6;0;1;1792;6;6;1;0;0;1;2;1792;0;4706;2;2;
/org.eclipse.pde.ui/src/org/eclipse/pde/internal/schema/ExternalSchemaDescriptor.java;1;0;5;1;0;0;0;5;3;1;5;2696;7;7;1;0;0;5;5;2696;0;3579;5;1;
/org.eclipse.jdt.core/model/org/eclipse/jdt/core/util/IFieldInfo.java;2;2;7;1;5;4;5;2;27;0;1;3629;73;73;2;1;1;2;7;3629;2;4573;5;2;
/org.eclipse.debug.ui/ui/org/eclipse/debug/internal/ui/OpenBreakpointMarkerAction.java;3;0;8;1;0;0;0;8;15;1;8;187;51;51;1;0;0;8;8;187;0;2382;8;3;
/org.eclipse.jdt.ui/core extension/org/eclipse/jdt/internal/corext/dom/JavaElementMapper.java;1;0;1;1;0;0;0;1;0;0;1;2876;0;0;1;0;0;1;1;2876;0;2876;1;1;
/org.eclipse.jdt.ui.tests.refactoring/resources/RenameVariables/canRename/A_test3_in.java;1;0;2;1;0;0;0;2;0;1;2;724;0;0;1;0;0;2;2;724;0;1665;2;1;
/org.eclipse.jdt.ui/ui/org/eclipse/jdt/internal/ui/JavaContributorResourceAdapter.java;1;0;2;1;1;1;1;1;16;0;1;2199;16;16;1;0;0;1;2;2199;0;4009;2;1;
/org.eclipse.compare/compare/org/eclipse/compare/internal/NullViewer.java;1;0;1;1;0;0;0;1;0;0;1;1802;0;0;1;0;0;1;1;1802;0;1802;1;1;
/org.eclipse.swt/Eclipse SWT Custom Widgets/common/org/eclipse/swt/custom/DefaultLineStyler.java;6;1;9;1;3;3;3;6;94;1;6;106;205;205;1;0;0;6;9;106;0;4701;9;6;
/org.eclipse.jdt.ui/ui/org/eclipse/jdt/internal/ui/IUIConstants.java;4;0;7;1;0;0;0;7;14;1;7;15;46;46;1;0;0;7;7;15;0;2581;7;4;
/org.eclipse.pde.ui/src/org/eclipse/pde/internal/ui/editor/feature/SynchronizeVersionsWizard.java;1;0;1;1;0;0;0;1;0;0;1;3579;0;0;1;0;0;1;1;3579;0;3579;1;1;
/org.eclipse.jdt.core/dom/org/eclipse/jdt/core/dom/BreakStatement.java;2;1;6;1;2;2;2;4;9;1;4;2669;29;29;1;0;0;4;6;2669;0;4453;6;2;
/org.eclipse.jdt.ui.tests.refactoring/resources/ExtractTemp/cannotExtract/A_testFail13.java;1;0;1;1;0;0;0;1;0;0;1;2873;0;0;1;0;0;1;1;2873;0;2873;1;1;
/org.eclipse.jdt.debug/jdi/org/eclipse/jdi/internal/connect/ConnectorImpl.java;3;0;7;1;1;1;1;6;20;1;6;187;45;45;1;0;0;6;7;187;0;4065;7;3;
/org.eclipse.pde.ui/src/org/eclipse/pde/internal/editor/feature/DescriptionSection.java;1;0;3;1;0;0;0;3;3;1;3;2951;3;3;1;0;0;3;3;2951;0;3093;3;1;
/org.eclipse.team.cvs.core/src/org/eclipse/team/internal/ccvs/core/resources/EclipseFile.java;3;1;22;2;2;2;2;20;221;2;15;3004;559;559;2;5;0;20;22;3167;5;4569;17;3;
/org.eclipse.help/src/org/eclipse/help/internal/HelpApplication.java;1;0;5;1;0;0;0;5;35;2;4;3015;68;68;2;1;0;5;5;3048;1;3609;4;1;
/org.eclipse.ui.tests/Eclipse UI Tests/org/eclipse/ui/tests/api/IConstants.java;1;0;1;1;0;0;0;1;0;0;1;1073;0;0;1;0;0;1;1;1073;0;1073;1;1;
/org.eclipse.core.resources/src/org/eclipse/core/internal/indexing/BinarySmallObject.java;2;0;3;1;1;1;1;2;200;1;2;448;225;225;1;0;0;2;3;448;0;4214;3;2;
/org.eclipse.pde.ui/src/org/eclipse/pde/internal/feature/NewFeatureProjectWizard.java;1;0;8;1;0;0;0;8;6;3;5;2951;18;18;3;3;0;8;8;2951;3;3579;5;1;
/org.eclipse.jdt.core/compiler/org/eclipse/jdt/internal/compiler/ast/SuperReference.java;2;0;10;1;1;1;1;9;96;4;6;455;135;135;4;3;0;9;10;1039;3;4062;7;2;
/org.eclipse.swt/Eclipse SWT/common/org/eclipse/swt/events/ArmEvent.java;2;0;3;1;1;1;1;2;6;1;2;106;10;10;1;0;0;2;3;106;0;4701;3;2;
/org.eclipse.webdav/src/client/org/eclipse/webdav/client/RemoteDAVClient.java;3;0;5;1;1;1;1;4;1158;1;4;12;2135;2135;1;0;0;4;5;12;0;4211;5;3;
/org.eclipse.team.ui/src/org/eclipse/team/internal/ui/target/GetSyncAction.java;4;3;9;1;9;6;9;0;28;0;0;4227;71;71;3;0;3;0;9;4244;3;4636;6;4;
/org.eclipse.ui/Eclipse UI Text Editor/org/eclipse/ui/editors/text/DefaultEncodingSupport.java;1;1;3;1;3;3;3;0;37;0;0;4138;41;41;1;0;0;0;3;4138;0;4838;3;1;
/org.eclipse.help/src/org/eclipse/help/internal/protocols/SearchQuery.java;1;0;2;1;2;1;2;0;0;0;0;4000;0;0;2;0;1;0;2;4000;1;4000;1;1;
/org.eclipse.jdt.ui/ui/org/eclipse/jdt/internal/ui/packageview/FiltersContentProvider.java;3;0;7;1;1;1;1;6;69;1;6;37;118;118;1;0;0;6;7;37;0;4211;7;3;
/org.eclipse.jdt.ui.tests.refactoring/resources/SelectionAnalyzerWorkSpace/SelectionAnalyzerTests/validSelection/A_test308.java;1;0;1;1;0;0;0;1;0;0;1;1368;0;0;1;0;0;1;1;1368;0;1368;1;1;
/org.eclipse.jdt.ui/ui/org/eclipse/jdt/internal/ui/browsing/JavaBrowsingPreferencePage.java;5;2;7;2;3;2;3;4;72;1;4;2878;130;130;2;0;1;4;7;4181;1;4181;6;5;
/org.eclipse.jdt.ui.tests.refactoring/resources/SurroundWithWorkSpace/SurroundWithTests/trycatch_in/TestInitializerThrowsException.java;1;0;1;1;0;0;0;1;0;0;1;3870;0;0;1;0;0;1;1;3870;0;3870;1;1;
/org.eclipse.jdt.ui.tests.refactoring/resources/MoveMembers/test12/in/A.java;1;0;1;1;0;0;0;1;0;0;1;2738;0;0;1;0;0;1;1;2738;0;2738;1;1;
/org.eclipse.jdt.debug/eval/org/eclipse/jdt/internal/debug/eval/ast/instructions/GreaterOperator.java;3;0;6;1;0;0;0;6;36;1;6;3421;48;48;1;0;0;6;6;3421;0;3677;6;3;
/org.eclipse.ui/Eclipse UI/org/eclipse/ui/internal/dialogs/IPropertyPageContributor.java;2;0;2;1;0;0;0;2;5;1;2;257;5;5;1;0;0;2;2;257;0;457;2;2;
/org.eclipse.jdt.debug.ui/ui/org/eclipse/jdt/internal/debug/ui/actions/InspectAction.java;2;0;10;1;1;1;1;9;35;1;9;2813;66;66;1;0;0;9;10;2813;0;3901;10;2;
/org.eclipse.pde.ui/src/org/eclipse/pde/internal/ui/editor/schema/SchemaSourcePage.java;1;0;1;1;0;0;0;1;0;0;1;3579;0;0;1;0;0;1;1;3579;0;3579;1;1;
/org.eclipse.debug.ui/ui/org/eclipse/debug/internal/ui/BreakpointsContentProvider.java;3;0;8;1;0;0;0;8;14;1;8;187;53;53;1;0;0;8;8;187;0;2312;8;3;
/org.eclipse.pde.ui/Eclipse PDE UI/org/eclipse/pde/internal/schema/EditableSchema.java;2;0;5;2;0;0;0;5;12;3;3;267;12;12;3;2;0;5;5;324;2;1434;3;2;
/org.eclipse.core.resources/src/org/eclipse/core/internal/dtree/A.java;1;0;1;1;1;1;1;0;0;0;0;4547;0;0;1;0;0;0;1;4547;0;4547;1;1;
/org.eclipse.jdt.ui.tests.refactoring/resources/RenameMethodInInterface/test47/out/A.java;1;0;1;1;0;0;0;1;0;0;1;1297;0;0;1;0;0;1;1;1297;0;1297;1;1;
/org.eclipse.jdt.core/model/org/eclipse/jdt/internal/core/builder/impl/PackageMapEntry.java;1;0;10;1;0;0;0;10;55;4;6;455;91;91;4;4;0;10;10;1039;4;2808;6;1;
/org.eclipse.pde.ui/src/org/eclipse/pde/internal/ui/editor/feature/URLElementPropertySource.java;1;0;2;1;0;0;0;2;4;1;2;3579;4;4;1;0;0;2;2;3579;0;3591;2;1;
/org.eclipse.jdt.junit/Eclipse JUnit/org/eclipse/jdt/internal/junit/ui/BaseLauncher.java;1;0;3;1;0;0;0;3;1;1;3;2007;1;1;1;0;0;3;3;2007;0;2143;3;1;
/org.eclipse.jdt.ui.tests.refactoring/resources/RenameType/test56/in/default/A.java;1;0;1;1;0;0;0;1;0;0;1;1547;0;0;1;0;0;1;1;1547;0;1547;1;1;
/org.eclipse.vcm.core.cvs.ext/src/org/eclipse/vcm/internal/core/ccvs/ext/EXTMethod.java;1;0;2;1;0;0;0;2;6;1;2;1205;6;6;1;0;0;2;2;1205;0;1212;2;1;
/org.eclipse.update.ui/src/org/eclipse/update/internal/ui/manager/DetailsPage.java;1;0;5;1;0;0;0;5;5;1;5;1460;9;9;1;0;0;5;5;1460;0;3537;5;1;
/org.eclipse.jdt.ui.tests.refactoring/resources/RenameVariables/cannotRename/A_testFail13.java;1;0;2;1;0;0;0;2;0;1;2;724;0;0;1;0;0;2;2;724;0;1665;2;1;
/org.eclipse.ui/Eclipse UI/org/eclipse/ui/internal/dialogs/FakeActionSetDescriptor.java;2;0;2;1;0;0;0;2;4;1;2;257;4;4;1;0;0;2;2;257;0;457;2;2;
/org.eclipse.pde.ui/src/org/eclipse/pde/internal/builders/PluginBaseParser.java;1;0;3;1;0;0;0;3;57;1;3;2702;57;57;1;0;0;3;3;2702;0;2730;3;1;
/org.eclipse.jdt.ui/ui/org/eclipse/jdt/internal/ui/text/java/JavaTypeCompletionProposal.java;2;1;3;1;3;3;3;0;2;0;0;3914;4;4;1;0;0;0;3;3914;0;4621;3;2;
/org.eclipse.jdt.ui.tests.refactoring/test cases/org/eclipse/jdt/ui/tests/refactoring/MoveMembersTests.java;1;0;4;1;0;0;0;4;50;1;4;2738;57;57;1;0;0;4;4;2738;0;3357;4;1;
/org.eclipse.webdav/src/interface/org/eclipse/webdav/IContext.java;2;0;4;1;1;1;1;3;1770;1;3;1635;2684;2684;1;0;0;3;4;1635;0;4211;4;2;
/org.eclipse.jdt.ui/core extension/org/eclipse/jdt/internal/corext/util/Strings.java;1;0;10;1;1;1;1;9;178;2;7;1930;298;298;2;2;0;9;10;3827;2;4400;8;1;
/org.eclipse.swt/Eclipse SWT/photon/org/eclipse/swt/internal/BidiText.java;1;0;1;1;0;0;0;1;0;0;1;1029;0;0;1;0;0;1;1;1029;0;1029;1;1;
/org.eclipse.pde.ui/src/org/eclipse/pde/internal/editor/feature/FeatureReferencePage.java;1;0;2;1;0;0;0;2;0;1;2;2951;0;0;1;0;0;2;2;2951;0;3579;2;1;
/org.eclipse.pde.ui/src/org/eclipse/pde/internal/base/model/component/IComponentURLElement.java;2;0;2;1;0;0;0;2;0;1;2;1434;0;0;1;0;0;2;2;1434;0;2951;2;2;
/org.eclipse.swt.examples/org/eclipse/swt/examples/explorer/UpdateWorker.java;1;0;1;1;0;0;0;1;0;0;1;513;0;0;1;0;0;1;1;513;0;513;1;1;
/org.eclipse.webdav/src/client/org/eclipse/webdav/internal/authentication/AuthorizationAuthority.java;3;1;6;1;2;2;2;4;790;1;4;12;1444;1444;1;0;0;4;6;12;0;4266;6;3;
/org.eclipse.jdt.ui.tests.refactoring/resources/RenameStaticMethod/test8/in/A.java;1;0;1;1;0;0;0;1;0;0;1;49;0;0;1;0;0;1;1;49;0;49;1;1;
/org.eclipse.ant.ui/src/org/eclipse/ant/internal/ui/AntConsolePreferencePage.java;3;0;3;1;0;0;0;3;166;1;3;677;188;188;1;0;0;3;3;677;0;3606;3;3;
/org.eclipse.update.ui.forms/src/org/eclipse/update/ui/forms/HTMLTableLayout.java;1;0;8;1;0;0;0;8;53;2;7;1541;106;106;2;1;0;8;8;1541;1;2474;7;1;
/org.eclipse.pde.core/src/org/eclipse/pde/internal/core/builders/ManifestConsistencyChecker.java;1;0;4;1;0;0;0;4;31;2;3;3591;48;48;2;1;0;4;4;3629;1;3629;3;1;
/org.eclipse.jdt.debug/model/org/eclipse/jdt/internal/debug/core/model/JDILocalVariable.java;2;0;3;2;0;0;0;3;5;0;1;2517;5;5;3;2;0;3;3;2517;2;2517;1;2;
/org.eclipse.jdt.ui.tests.refactoring/resources/RenamePackage/testFail2/in/r/p1/A.java;1;0;1;1;0;0;0;1;0;0;1;1258;0;0;1;0;0;1;1;1258;0;1258;1;1;
/org.eclipse.swt/Eclipse SWT/gtk/org/eclipse/swt/widgets/WidgetTable.java;3;1;4;1;3;3;3;1;12;0;1;2107;20;20;1;0;0;1;4;2107;0;4701;4;3;
/org.eclipse.jdt.ui/ui/org/eclipse/jdt/internal/ui/typehierarchy/SelectionProviderMediator.java;2;0;4;1;1;1;1;3;8;1;3;1256;13;13;1;0;0;3;4;1256;0;4180;4;2;
/org.eclipse.team.cvs.ui/src/org/eclipse/team/internal/ccvs/ui/CVSPropertiesPage.java;3;0;18;3;0;0;0;18;391;3;15;1978;757;757;3;3;0;18;18;3204;3;3763;15;3;
/org.eclipse.jdt.debug/jdi interfaces/com/sun/jdi/ClassObjectReference.java;2;0;2;1;0;0;0;2;10;1;2;2704;10;10;1;0;0;2;2;2704;0;3033;2;2;
/org.eclipse.pde.ui/src/org/eclipse/pde/internal/ui/editor/feature/InfoSection.java;1;2;10;1;6;5;6;4;68;2;3;3579;204;204;2;1;1;4;10;3579;2;4691;8;1;
/org.eclipse.vcm.ui.cvs/src/org/eclipse/vcm/internal/ui/ccvs/CVSOperationCancelledException.java;1;0;2;1;0;0;0;2;31;1;2;1237;31;31;1;0;0;2;2;1237;0;1262;2;1;
/org.eclipse.swt.examples.launcher/src/org/eclipse/swt/examples/launcher/ItemDescriptor.java;4;0;4;1;1;1;1;3;85;1;3;513;130;130;1;0;0;3;4;513;0;4705;4;4;
/org.eclipse.jdt.ui.tests.refactoring/resources/RenameType/testFail8/in/A.java;1;0;1;1;0;0;0;1;0;0;1;49;0;0;1;0;0;1;1;49;0;49;1;1;
/org.eclipse.jdt.ui/ui/org/eclipse/jdt/internal/ui/packageview/EmptyInnerPackageFilter.java;3;0;5;1;1;1;1;4;10;1;4;15;24;24;1;0;0;4;5;15;0;4211;5;3;
/org.eclipse.pde.ui/src/org/eclipse/pde/internal/launcher/PluginPathDialog.java;1;0;2;1;0;0;0;2;0;1;2;3406;0;0;1;0;0;2;2;3406;0;3579;2;1;
/org.eclipse.ui/Eclipse JFace/org/eclipse/jface/viewers/DialogCellEditor.java;4;0;6;1;0;0;0;6;19;2;5;257;34;34;2;1;0;6;6;3791;1;3791;5;4;
/org.eclipse.pde.ui/Eclipse PDE UI/org/eclipse/pde/internal/base/model/ModelChangedEvent.java;2;0;5;2;0;0;0;5;12;3;3;267;12;12;3;2;0;5;5;324;2;1434;3;2;
/org.eclipse.swt/Eclipse SWT/photon/org/eclipse/swt/internal/photon/FontDetails.java;2;0;3;1;0;0;0;3;4;1;3;106;4;4;1;0;0;3;3;106;0;2069;3;2;
/org.eclipse.swt/Eclipse SWT/common/org/eclipse/swt/events/TypedEvent.java;5;1;6;1;2;2;2;4;10;1;4;106;28;28;1;0;0;4;6;106;0;4701;6;5;
/org.eclipse.ant.core/src/org/eclipse/ant/core/DeleteProject.java;3;0;3;1;0;0;0;3;256;1;3;896;256;256;1;0;0;3;3;896;0;3489;3;3;
/org.eclipse.jdt.ui/ui/org/eclipse/jdt/internal/ui/typehierarchy/HistoryDropDownAction.java;1;0;6;1;0;0;0;6;26;2;5;1589;85;85;2;1;0;6;6;1589;1;3050;5;1;
/org.eclipse.jdt.debug.ui/ui/org/eclipse/jdt/internal/debug/ui/FilterViewerSorter.java;1;0;2;1;0;0;0;2;16;0;1;3149;16;16;2;1;0;2;2;3149;1;3149;1;1;
/org.eclipse.ui.externaltools/External Tools/org/eclipse/ui/externaltools/internal/ui/OutputStructureElement.java;1;0;1;1;1;1;1;0;0;0;0;4090;0;0;1;0;0;0;1;4090;0;4090;1;1;
/org.eclipse.jdt.debug/eval/org/eclipse/jdt/internal/debug/eval/ast/instructions/PushVariable.java;2;0;3;1;0;0;0;3;8;1;3;3421;8;8;1;0;0;3;3;3421;0;3645;3;2;
/org.eclipse.team.webdav/src/org/eclipse/team/internal/webdav/core/WebDavFactory.java;3;2;4;2;4;2;4;0;5;0;0;4113;7;7;2;0;2;0;4;4113;2;4123;2;3;
/org.eclipse.update/src/org/eclipse/update/internal/core/UMSessionManagerParcel.java;1;0;1;1;0;0;0;1;0;0;1;1424;0;0;1;0;0;1;1;1424;0;1424;1;1;
/org.eclipse.core.target/src/org/eclipse/core/target/TargetManagementPlugin.java;2;0;9;1;1;1;1;8;254;3;6;12;393;393;3;2;0;8;9;677;2;4196;7;2;
/org.eclipse.jdt.ui.tests.refactoring/resources/ExtractMethodWorkSpace/ExtractMethodTests/invalidSelection/A_test030.java;2;1;3;1;2;2;2;1;0;0;1;49;0;0;1;0;0;1;3;49;0;4419;3;2;
/org.eclipse.ui/Eclipse JFace/org/eclipse/jface/dialogs/ErrorDialog.java;5;0;7;1;1;1;1;6;21;1;6;257;46;46;1;0;0;6;7;257;0;4601;7;5;
/org.eclipse.team.tests.cvs.core/src/org/eclipse/team/tests/ccvs/core/provider/RemoteResourceTest.java;2;0;17;2;2;1;2;15;52;2;14;2536;188;188;2;1;1;15;17;3089;2;4042;15;2;
/org.eclipse.pde.ui/src/org/eclipse/pde/internal/core/EntryFileAdapter.java;1;0;5;1;0;0;0;5;5;2;3;3445;9;9;2;2;0;5;5;3445;2;3607;3;1;
/org.eclipse.jdt.ui.tests.refactoring/resources/ExtractMethodWorkSpace/ExtractMethodTests/validSelection_in/A_test362.java;1;1;3;1;2;2;2;1;28;0;1;2621;28;28;1;0;0;1;3;2621;0;4419;3;1;
/org.eclipse.ui/Eclipse UI/org/eclipse/ui/part/PluginDropAdapter.java;2;0;2;1;0;0;0;2;11;1;2;257;11;11;1;0;0;2;2;257;0;457;2;2;
/org.eclipse.swt.examples/org/eclipse/swt/examples/addressbook/SearchDialog.java;4;0;4;1;1;1;1;3;196;1;3;513;197;197;1;0;0;3;4;513;0;4024;4;4;
/org.eclipse.update.ui/src/org/eclipse/update/internal/ui/model/IConfigurationSiteContext.java;2;0;2;1;0;0;0;2;0;1;2;2834;0;0;1;0;0;2;2;2834;0;2994;2;2;
/org.eclipse.core.resources/src/org/eclipse/core/internal/resources/ModelObject.java;2;0;4;1;1;1;1;3;56;1;3;12;77;77;1;0;0;3;4;12;0;4213;4;2;
/org.eclipse.ui/Eclipse UI/org/eclipse/ui/actions/ActionGroup.java;1;0;1;1;0;0;0;1;0;0;1;3451;0;0;1;0;0;1;1;3451;0;3451;1;1;
/org.eclipse.ui/Eclipse UI/org/eclipse/ui/internal/dialogs/FileStatesPage.java;6;1;9;1;3;3;3;6;94;1;6;257;231;231;1;0;0;6;9;257;0;4429;9;6;
/org.eclipse.jdt.ui.tests.refactoring/resources/ExtractMethodWorkSpace/ExtractMethodTests/return_in/A_test720.java;1;1;3;1;2;2;2;1;32;0;1;1368;32;32;1;0;0;1;3;1368;0;4419;3;1;
/org.eclipse.help/src/org/eclipse/help/internal/context/Context.java;1;0;1;1;0;0;0;1;0;0;1;2829;0;0;1;0;0;1;1;2829;0;2829;1;1;
/org.eclipse.jdt.debug.ui/ui/org/eclipse/jdt/internal/debug/ui/ErrorDialogWithToggle.java;1;0;1;1;0;0;0;1;0;0;1;3329;0;0;1;0;0;1;1;3329;0;3329;1;1;
/org.eclipse.jdt.ui/ui/org/eclipse/jdt/internal/ui/search/LRUWorkingSetsList.java;1;0;1;1;0;0;0;1;0;0;1;3760;0;0;1;0;0;1;1;3760;0;3760;1;1;
/org.eclipse.swt/Eclipse SWT OLE Win32/win32/org/eclipse/swt/internal/ole/win32/TYPEATTR.java;2;0;3;1;0;0;0;3;5;1;3;106;5;5;1;0;0;3;3;106;0;2069;3;2;
/org.eclipse.help/src/org/eclipse/help/internal/server/HelpContentManager.java;2;0;3;1;0;0;0;3;3;1;3;1420;3;3;1;0;0;3;3;1420;0;3095;3;2;
/org.eclipse.swt.examples/src/org/eclipse/swt/examples/hoverhelp/HoverHelp.java;5;1;6;1;2;2;2;4;336;1;4;513;414;414;1;0;0;4;6;513;0;4705;6;5;
/org.eclipse.jdt.ui.tests.refactoring/resources/StructureSelectionAction/A_test8.java;1;0;2;1;0;0;0;2;2;1;2;2139;2;2;1;0;0;2;2;2139;0;2412;2;1;
/org.eclipse.vcm.core.cvs/src/org/eclipse/vcm/internal/core/ccvs/StringMatcher.java;1;0;3;1;0;0;0;3;5;1;3;373;7;7;1;0;0;3;3;373;0;2216;3;1;
/org.eclipse.jdt.ui.tests.refactoring/resources/RenameType/testFail64/in/A.java;1;0;1;1;0;0;0;1;0;0;1;49;0;0;1;0;0;1;1;49;0;49;1;1;
/org.eclipse.jdt.ui.tests.refactoring/resources/InlineTemp/cannotInline/A_testFail4.java;1;0;1;1;0;0;0;1;0;0;1;2015;0;0;1;0;0;1;1;2015;0;2015;1;1;
/org.eclipse.pde.ui/Eclipse PDE UI/org/eclipse/pde/internal/editor/jars/JarsSourceOutlinePage.java;2;0;5;2;0;0;0;5;12;3;3;267;12;12;3;2;0;5;5;324;2;1434;3;2;
/org.eclipse.swt.examples/org/eclipse/swt/examples/imageexample/ImageAnalyzer.java;1;0;1;1;0;0;0;1;0;0;1;513;0;0;1;0;0;1;1;513;0;513;1;1;
/org.eclipse.ui/Eclipse JFace Text/org/eclipse/jface/text/rules/RuleBasedPartitioner.java;4;0;11;1;1;1;1;10;970;2;9;257;1317;1317;2;1;0;10;11;3812;1;4838;10;4;
/org.eclipse.team.cvs.ui/src/org/eclipse/team/internal/ccvs/ui/actions/ReplaceWithVersionAction.java;1;0;2;1;0;0;0;2;4;1;2;2377;4;4;1;0;0;2;2;2377;0;2388;2;1;
/org.eclipse.jdt.ui.examples.projects/examples/org/eclipse/jdt/internal/ui/exampleprojects/ExampleProjectCreationOperation.java;3;0;5;1;1;1;1;4;2;2;3;534;8;8;2;1;0;4;5;534;1;4440;4;3;
/org.eclipse.jdt.core/compiler/org/eclipse/jdt/internal/compiler/impl/ReferenceContext.java;2;1;4;1;2;2;2;2;15;1;2;455;28;28;1;0;0;2;4;455;0;4062;4;2;
/org.eclipse.pde.ui/src/org/eclipse/pde/internal/elements/DefaultTableProvider.java;1;0;2;1;0;0;0;2;0;1;2;2981;0;0;1;0;0;2;2;2981;0;3579;2;1;
/org.eclipse.ui/Eclipse UI Text Editor/org/eclipse/ui/texteditor/GotoLineAction.java;5;1;10;1;3;3;3;7;39;1;7;257;139;139;1;0;0;7;10;257;0;4853;10;5;
/org.eclipse.jdt.ui/ui refactoring/org/eclipse/jdt/internal/ui/refactoring/TextInputWizardPage2.java;1;0;2;1;0;0;0;2;0;0;1;192;0;0;2;1;0;2;2;192;1;192;1;1;
/org.eclipse.search/search/org/eclipse/search/internal/ui/util/RowLayouter.java;1;0;2;1;0;0;0;2;9;1;2;15;9;9;1;0;0;2;2;15;0;343;2;1;
/org.eclipse.team.cvs.ui/src/org/eclipse/team/internal/ccvs/ui/model/ProjectVersion.java;2;0;3;1;0;0;0;3;2;1;3;2055;2;2;1;0;0;3;3;2055;0;2126;3;2;
/org.eclipse.core.resources/src/org/eclipse/core/internal/resources/Workspace.java;5;2;54;2;7;6;7;47;3433;2;42;12;4975;4975;2;5;1;47;54;496;6;4388;48;5;
/org.eclipse.jdt.debug.ui/ui/org/eclipse/jdt/internal/debug/ui/actions/JavaBreakpointPropertiesAction.java;1;0;2;1;0;0;0;2;3;1;2;2700;3;3;1;0;0;2;2;2700;0;2846;2;1;
/org.eclipse.swt/Eclipse SWT/photon/org/eclipse/swt/widgets/List.java;6;1;15;1;4;4;4;11;644;2;9;106;901;901;2;2;0;11;15;2064;2;4701;13;6;
/org.eclipse.help/src/org/eclipse/help/internal/contributors/xml1_0/XMLViewContributorCreator.java;1;0;2;1;0;0;0;2;0;1;2;1675;0;0;1;0;0;2;2;1675;0;2217;2;1;
/org.eclipse.jdt.core/compiler/org/eclipse/jdt/internal/compiler/ast/AND_AND_Expression.java;2;0;8;1;1;1;1;7;540;2;6;455;1140;1140;2;1;0;7;8;1284;1;4062;7;2;
/org.eclipse.pde.runtime/Eclipse PDE Runtime/org/eclipse/pde/internal/runtime/registry/PrerequisitePropertySource.java;2;0;3;1;0;0;0;3;4;1;3;267;4;4;1;0;0;3;3;267;0;1434;3;2;
/org.eclipse.team.examples.filesystem/src/org/eclipse/team/examples/filesystem/FileSystemRemoteResource.java;1;1;2;1;2;2;2;0;62;0;0;4674;62;62;1;0;0;0;2;4674;0;4727;2;1;
/org.eclipse.help/src/org/eclipse/help/internal/contributors/xml/HelpContributionManager.java;2;0;2;1;0;0;0;2;0;1;2;1420;0;0;1;0;0;2;2;1420;0;1675;2;2;
/org.eclipse.team.tests.cvs.core/src/org/eclipse/team/tests/ccvs/core/EclipseTest.java;2;0;22;2;0;0;0;22;84;2;19;2536;365;365;2;3;0;22;22;3089;3;3838;19;2;
/org.eclipse.ui/Eclipse UI/org/eclipse/ui/actions/OpenPerspectiveMenu.java;6;0;12;1;1;1;1;11;132;1;11;257;284;284;1;0;0;11;12;257;0;4167;12;6;
/org.eclipse.team.cvs.ui/src/org/eclipse/team/internal/ccvs/ui/actions/DefineTagAction.java;2;0;5;2;0;0;0;5;25;2;4;1997;44;44;2;1;0;5;5;2049;1;2126;4;2;
/org.eclipse.help/src/org/eclipse/help/internal/protocols/LiveHelpURLConnection.java;1;0;2;1;0;0;0;2;2;0;1;2694;2;2;2;1;0;2;2;2694;1;2694;1;1;
/org.eclipse.core.resources/src/org/eclipse/core/internal/localstore/ProjectUnifiedTree.java;2;0;4;1;0;0;0;4;5;1;4;12;7;7;1;0;0;4;4;12;0;429;4;2;
/org.eclipse.jdt.ui.tests.refactoring/resources/ExtractMethodWorkSpace/ExtractMethodTests/invalidSelection/A_test073.java;2;1;3;1;2;2;2;1;0;0;1;49;0;0;1;0;0;1;3;49;0;4419;3;2;
/org.eclipse.ui.examples.javaeditor/Eclipse Java Editor Example/org/eclipse/ui/examples/javaeditor/util/JavaColorProvider.java;1;0;1;1;0;0;0;1;0;0;1;1067;0;0;1;0;0;1;1;1067;0;1067;1;1;
/org.eclipse.help/src/org/eclipse/help/internal/util/XMLGenerator.java;2;0;3;1;0;0;0;3;55;1;3;1675;57;57;1;0;0;3;3;1675;0;3609;3;2;
/org.eclipse.jdt.core/model/org/eclipse/jdt/core/util/ILineNumberAttribute.java;2;1;6;1;4;4;4;2;18;0;1;3629;42;42;2;1;0;2;6;3629;1;4573;5;2;
/org.eclipse.pde.junit/src/org/eclipse/pde/internal/junit/launcher/JUnitPdeTabGroup.java;1;1;5;1;4;4;4;1;19;0;1;3466;28;28;1;0;0;1;5;3466;0;4618;5;1;
/org.eclipse.jdt.debug.ui/ui/org/eclipse/jdt/internal/debug/ui/launcher/VMLibraryBlock.java;2;1;5;1;5;5;5;0;50;0;0;4033;72;72;1;0;0;0;5;4033;0;4350;5;2;
/org.eclipse.jdt.ui.tests.refactoring/resources/InlineTemp/canInline/A_test16_out.java;1;0;1;1;0;0;0;1;0;0;1;3067;0;0;1;0;0;1;1;3067;0;3067;1;1;
/org.eclipse.team.cvs.core/src/org/eclipse/team/internal/ccvs/core/ICVSRunnable.java;1;0;3;1;0;0;0;3;37;1;3;3042;40;40;1;0;0;3;3;3042;0;3610;3;1;
/org.eclipse.update.core/src/org/eclipse/update/core/ContentReference.java;2;1;13;1;5;5;5;8;169;2;7;2443;487;487;2;1;0;8;13;2976;1;4453;12;2;
/org.eclipse.swt/Eclipse SWT/motif/org/eclipse/swt/widgets/TableItem.java;2;0;5;1;0;0;0;5;288;1;5;106;449;449;1;0;0;5;5;106;0;1028;5;2;
/org.eclipse.vcm.core/src/org/eclipse/vcm/internal/core/base/IResourceEditionTree.java;2;0;3;1;0;0;0;3;28;2;2;56;33;33;2;1;0;3;3;56;1;297;2;2;
/org.eclipse.pde.ui/src/org/eclipse/pde/internal/ui/wizards/templates/DefaultPluginTemplateWizard.java;1;0;2;1;0;0;0;2;2;1;2;3579;2;2;1;0;0;2;2;3579;0;3819;2;1;
/org.eclipse.pde.junit/src/org/eclipse/pde/internal/junit/ui/JUnitPdePlugin.java;1;0;2;1;1;1;1;1;22;0;1;3171;22;22;1;0;0;1;2;3171;0;4498;2;1;
/org.eclipse.jdt.debug/eval/org/eclipse/jdt/internal/debug/eval/ast/instructions/BinaryOperator.java;2;0;4;1;0;0;0;4;45;1;4;3421;55;55;1;0;0;4;4;3421;0;3645;4;2;
/org.eclipse.pde.ui/src/org/eclipse/pde/internal/editor/feature/FeatureAdapterFactory.java;1;0;3;1;0;0;0;3;2;1;3;2951;2;2;1;0;0;3;3;2951;0;3579;3;1;
/org.eclipse.jdt.ui/ui/org/eclipse/jdt/internal/ui/snippeteditor/RunAction.java;3;0;5;1;0;0;0;5;24;1;5;15;38;38;1;0;0;5;5;15;0;1916;5;3;
/org.eclipse.jdt.ui.tests.refactoring/resources/MoveMembers/test17/out/A.java;1;0;1;1;0;0;0;1;0;0;1;2738;0;0;1;0;0;1;1;2738;0;2738;1;1;
/org.eclipse.ui.externaltools/External Tools/org/eclipse/ui/externaltools/internal/core/ExternalTool.java;1;1;3;1;3;3;3;0;20;0;0;4090;21;21;1;0;0;0;3;4090;0;4729;3;1;
/org.eclipse.help/src/org/eclipse/help/internal/protocols/PreferencesURL.java;1;0;2;1;0;0;0;2;9;0;1;3776;9;9;2;1;0;2;2;3776;1;3776;1;1;
/org.eclipse.ui.examples.propertysheet/Eclipse UI Examples PropertySheet/org/eclipse/ui/examples/propertysheet/UserFileParser.java;2;0;2;1;0;0;0;2;94;1;2;931;94;94;1;0;0;2;2;931;0;946;2;2;
/org.eclipse.ui/Eclipse UI/org/eclipse/ui/internal/IPartDropListener.java;2;0;2;1;0;0;0;2;5;1;2;257;5;5;1;0;0;2;2;257;0;457;2;2;
/org.eclipse.jdt.ui.tests.refactoring/resources/PullUpMethods/test13/out/A.java;1;0;3;1;0;0;0;3;2;1;3;2215;2;2;1;0;0;3;3;2215;0;2406;3;1;
/org.eclipse.update/src/org/eclipse/update/internal/ui/UMWizardProductComponentUpdate.java;1;0;1;1;0;0;0;1;0;0;1;1424;0;0;1;0;0;1;1;1424;0;1424;1;1;
/org.eclipse.jdt.ui.tests.refactoring/resources/MoveMembers/test0/out/B.java;1;0;1;1;0;0;0;1;0;0;1;2738;0;0;1;0;0;1;1;2738;0;2738;1;1;
/org.eclipse.swt/Eclipse SWT Printing/win32/org/eclipse/swt/printing/Printer.java;7;0;9;1;1;1;1;8;91;2;7;106;159;159;2;1;0;8;9;1190;1;4701;8;7;
/org.eclipse.jdt.debug.tests/testprograms/org/eclipse/debug/tests/targets/HelloLauncherWithArgs.java;2;0;2;1;1;1;1;1;11;0;1;3719;11;11;1;0;0;1;2;3719;0;4571;2;2;
/org.eclipse.pde.ui/Eclipse PDE UI/org/eclipse/pde/internal/editor/manifest/ExtensionsForm.java;3;0;7;2;0;0;0;7;12;3;5;267;18;18;3;2;0;7;7;324;2;1434;5;3;
/org.eclipse.jdt.ui/core refactoring/org/eclipse/jdt/internal/corext/refactoring/rename/TempOccurrenceFinder.java;1;0;5;1;0;0;0;5;324;1;5;2015;360;360;1;0;0;5;5;2015;0;3307;5;1;
/org.eclipse.swt/Eclipse SWT/gtk/org/eclipse/swt/graphics/GCData.java;4;1;7;1;3;3;3;4;25;1;4;2107;46;46;1;0;0;4;7;2107;0;4701;7;4;
/org.eclipse.jdt.ui.tests.refactoring/resources/ExtractMethodWorkSpace/ExtractMethodTests/wiki_in/A_test2001.java;1;1;3;1;2;2;2;1;26;0;1;1236;26;26;1;0;0;1;3;1236;0;4419;3;1;
/org.eclipse.jdt.ui.tests.refactoring/resources/RenamePackage/test3/in/r/r/B.java;1;0;1;1;0;0;0;1;0;0;1;1258;0;0;1;0;0;1;1;1258;0;1258;1;1;
/org.eclipse.ui/Eclipse UI/org/eclipse/ui/internal/UIWorkspaceLock.java;5;0;7;1;0;0;0;7;23;1;7;257;55;55;1;0;0;7;7;257;0;3607;7;5;
/org.eclipse.jdt.ui.tests.refactoring/resources/ExtractMethodWorkSpace/ExtractMethodTests/branch_out/A_test755.java;1;1;4;1;2;2;2;2;34;1;2;1851;35;35;1;0;0;2;4;1851;0;4419;4;1;
/org.eclipse.vcm.ui/src/org/eclipse/vcm/internal/ui/actions/ReplaceWithBaseVersionAction.java;3;0;7;2;0;0;0;7;8;2;6;1;25;25;2;1;0;7;7;297;1;1232;6;3;
/org.eclipse.jdt.ui.tests.refactoring/resources/RenamePrivateField/test0/out/A.java;1;0;1;1;0;0;0;1;0;0;1;49;0;0;1;0;0;1;1;49;0;49;1;1;
/org.eclipse.core.tests.resources/src/org/eclipse/core/tests/resources/usecase/IResourceTest.java;3;0;3;1;0;0;0;3;96;1;3;1794;108;108;1;0;0;3;3;1794;0;3420;3;3;
/org.eclipse.swt.examples/Eclipse SWT Examples/common/org/eclipse/swt/examples/texteditor/ColorTextEditor.java;1;0;2;1;0;0;0;2;0;1;2;107;0;0;1;0;0;2;2;107;0;611;2;1;
/org.eclipse.vcm.ui/src/org/eclipse/vcm/internal/ui/CompareResourceEditorInput.java;1;0;2;1;0;0;0;2;16;1;2;1288;30;30;1;0;0;2;2;1288;0;1394;2;1;
/org.eclipse.jdt.core/model/org/eclipse/jdt/core/ICodeFormatter.java;2;2;7;1;4;3;4;3;40;1;3;3349;89;89;2;0;1;3;7;4058;1;4058;6;2;
/org.eclipse.ui/Eclipse JFace/org/eclipse/jface/resource/StringConverter.java;4;0;5;1;0;0;0;5;32;1;5;257;62;62;1;0;0;5;5;257;0;3607;5;4;
/org.eclipse.pde.runtime/src/org/eclipse/pde/internal/runtime/logview/LogViewLabelProvider.java;2;0;3;1;1;1;1;2;80;1;2;1434;82;82;1;0;0;2;3;1434;0;4070;3;2;
/org.eclipse.swt/Eclipse SWT/common_j2me/org/eclipse/swt/internal/EventListenerCompatability.java;1;0;1;1;0;0;0;1;0;0;1;1397;0;0;1;0;0;1;1;1397;0;1397;1;1;
/org.eclipse.swt.examples/src/org/eclipse/swt/examples/fileviewer/TreeScrollDropListener.java;2;0;3;2;0;0;0;3;1;2;2;554;1;1;2;1;0;3;3;609;1;609;2;2;
/org.eclipse.help/src/org/eclipse/help/internal/contributors1_0/ContributorCreator.java;1;0;2;1;0;0;0;2;0;1;2;1675;0;0;1;0;0;2;2;1675;0;2217;2;1;
/org.eclipse.jdt.ui.tests.refactoring/resources/ExtractMethodWorkSpace/ExtractMethodTests/invalidSelection/A_test144.java;1;1;3;1;2;2;2;1;20;0;1;887;20;20;1;0;0;1;3;887;0;4419;3;1;
/org.eclipse.jdt.ui/ui/org/eclipse/jdt/internal/ui/compare/TextMergeViewerCreator.java;1;0;2;1;0;0;0;2;5;1;2;15;5;5;1;0;0;2;2;15;0;329;2;1;
/org.eclipse.jdt.ui.tests.refactoring/resources/SurroundWithWorkSpace/SurroundWithTests/trycatch_out/TestSimple.java;1;0;2;1;0;0;0;2;2;1;2;2327;2;2;1;0;0;2;2;2327;0;3870;2;1;
/org.eclipse.swt/Eclipse SWT/common/org/eclipse/swt/internal/image/PngFileReadState.java;2;0;3;1;1;1;1;2;6;1;2;106;12;12;1;0;0;2;3;106;0;4701;3;2;
/org.eclipse.ui/Eclipse JFace Text/org/eclipse/jface/text/ITextInputListener.java;3;0;3;1;0;0;0;3;5;1;3;257;8;8;1;0;0;3;3;257;0;1066;3;3;
/org.eclipse.jdt.ui/ui/org/eclipse/jdt/internal/ui/javaeditor/CodeAssistAction.java;1;0;1;1;0;0;0;1;0;0;1;2824;0;0;1;0;0;1;1;2824;0;2824;1;1;
/org.eclipse.jdt.ui/ui/org/eclipse/jdt/internal/ui/search/JavaSearchMarkerUpdater.java;2;0;4;1;1;1;1;3;9;1;3;15;20;20;1;0;0;3;4;15;0;4627;4;2;
/org.eclipse.jdt.ui/ui/org/eclipse/jdt/internal/ui/reorg/DualReorgAction.java;2;1;6;1;2;2;2;4;79;1;4;3222;105;105;1;0;0;4;6;3222;0;4630;6;2;
/org.eclipse.ui/Eclipse UI/org/eclipse/ui/internal/dialogs/ProjectCapabilityPage.java;1;0;2;1;0;0;0;2;0;1;2;3167;0;0;1;0;0;2;2;3167;0;3238;2;1;
/org.eclipse.jdt.debug/model/org/eclipse/jdt/debug/core/IJavaEvaluate.java;2;0;5;1;0;0;0;5;33;1;5;187;42;42;1;0;0;5;5;187;0;2381;5;2;
/org.eclipse.pde.core/src/org/eclipse/pde/internal/core/ifeature/IFeatureEntry.java;1;0;2;1;1;1;1;1;8;0;1;3591;8;8;1;0;0;1;2;3591;0;4430;2;1;
/org.eclipse.search/search/org/eclipse/search/internal/core/SearchScope.java;2;0;4;1;1;1;1;3;47;1;3;15;58;58;1;0;0;3;4;15;0;4619;4;2;
/org.eclipse.webdav/src/interface/org/eclipse/webdav/dom/LockEntry.java;3;0;5;1;1;1;1;4;170;1;4;12;228;228;1;0;0;4;5;12;0;4211;5;3;
/org.eclipse.jdt.debug.ui/ui/org/eclipse/jdt/internal/debug/ui/actions/ExceptionCaughtToggleAction.java;2;0;3;1;0;0;0;3;19;1;3;1915;24;24;1;0;0;3;3;1915;0;2844;3;2;
/org.eclipse.update.ui/src/org/eclipse/update/internal/ui/parts/BrowserPage.java;1;0;13;1;0;0;0;13;16;3;11;1596;52;52;3;2;0;13;13;1824;2;3662;11;1;
/org.eclipse.team.cvs.ui/src/org/eclipse/team/internal/ccvs/ui/wizards/CheckoutWizard.java;2;0;7;2;0;0;0;7;173;2;6;1978;197;197;2;1;0;7;7;2433;1;2433;6;2;
/org.eclipse.scripting/src/org/eclipse/scripting/internal/IXGRElementUITableDataElement.java;1;0;1;1;0;0;0;1;0;0;1;1424;0;0;1;0;0;1;1;1424;0;1424;1;1;
/org.eclipse.debug.core/core/org/eclipse/debug/core/model/IValue.java;3;0;7;1;1;1;1;6;46;1;6;187;110;110;1;0;0;6;7;187;0;4652;7;3;
/org.eclipse.ui.examples.javaeditor/Java Editor Example/org/eclipse/ui/examples/javaeditor/JavaEditor.java;1;0;2;1;0;0;0;2;0;0;1;1066;0;0;2;1;0;2;2;1066;1;1066;1;1;
/org.eclipse.swt/Eclipse SWT/gtk/org/eclipse/swt/widgets/Label.java;6;3;20;2;9;6;9;11;256;2;10;2107;948;948;3;1;3;11;20;4361;4;4701;16;6;
/org.eclipse.jdt.ui.tests.refactoring/resources/PullUpMethods/test7/out/A.java;1;0;4;1;0;0;0;4;3;1;4;2156;5;5;1;0;0;4;4;2156;0;2406;4;1;
/org.eclipse.swt/Eclipse SWT/win32/org/eclipse/swt/widgets/ScrollBar.java;9;2;19;1;7;6;7;12;148;2;11;106;595;595;2;1;1;12;19;2313;2;4701;17;9;
/org.eclipse.core.tests.runtime/src/org/eclipse/core/tests/internal/plugin/a/api/ApiClass.java;3;0;3;1;0;0;0;3;10;1;3;1794;20;20;1;0;0;3;3;1794;0;3476;3;3;
/org.eclipse.update.ui/src/org/eclipse/update/internal/ui/pages/InstallConfigurationPage.java;1;0;2;1;0;0;0;2;3;1;2;3537;3;3;1;0;0;2;2;3537;0;3662;2;1;
/org.eclipse.jdt.core/formatter/org/eclipse/jdt/internal/formatter/impl/SplitLine.java;2;0;10;1;1;1;1;9;504;4;6;455;1159;1159;4;3;0;9;10;1039;3;4062;7;2;
/org.eclipse.scripting.examples/src/org/eclipse/scripting/examples/ExcaliburStringScriptEventHandler.java;1;0;1;1;0;0;0;1;0;0;1;1424;0;0;1;0;0;1;1;1424;0;1424;1;1;
/org.eclipse.team.ui/src/org/eclipse/team/internal/ui/target/PutAction.java;3;2;6;1;6;5;6;0;7;0;0;4155;22;22;2;0;1;0;6;4401;1;4636;5;3;
/org.eclipse.update.ui/src/org/eclipse/update/internal/ui/forms/ActivityConstraints.java;2;1;9;1;9;9;9;0;732;0;0;4048;1148;1148;1;0;0;0;9;4048;0;4595;9;2;
/org.eclipse.jdt.ui/ui/org/eclipse/jdt/internal/ui/text/JavaPairMatcher.java;1;0;3;1;0;0;0;3;122;1;3;1515;163;163;1;0;0;3;3;1515;0;1787;3;1;
/org.eclipse.team.ui/src/org/eclipse/team/internal/ui/OverlayIcon.java;2;0;3;1;0;0;0;3;288;1;3;1978;288;288;1;0;0;3;3;1978;0;2513;3;2;
/org.eclipse.jdt.ui.tests.refactoring/resources/DeleteSourceReference/test0/in/A.java;1;0;1;1;0;0;0;1;0;0;1;2857;0;0;1;0;0;1;1;2857;0;2857;1;1;
/org.eclipse.scripting/src/org/eclipse/scripting/internal/IXGRElementNamed.java;1;0;1;1;0;0;0;1;0;0;1;1424;0;0;1;0;0;1;1;1424;0;1424;1;1;
/org.eclipse.jdt.ui/ui/org/eclipse/jdt/internal/ui/JDK122Settings.java;1;0;6;1;0;0;0;6;15;1;6;15;32;32;1;0;0;6;6;15;0;416;6;1;
/org.eclipse.update.core/src/org/eclipse/update/internal/core/SiteLocal.java;2;6;107;2;28;16;28;79;929;3;58;1791;7373;7373;6;21;12;79;107;4256;33;4340;74;2;
/org.eclipse.team.tests.cvs.core/src/org/eclipse/team/tests/ccvs/ui/Util.java;3;0;7;1;1;1;1;6;162;1;6;2977;364;364;1;0;0;6;7;2977;0;4571;7;3;
/org.eclipse.compare/compare/org/eclipse/compare/structuremergeviewer/ICompareInput.java;1;0;2;1;0;0;0;2;5;1;2;14;5;5;1;0;0;2;2;14;0;329;2;1;
/org.eclipse.pde.ui/src/org/eclipse/pde/internal/pluginsview/PluginsViewLabelProvider.java;1;0;2;1;0;0;0;2;0;1;2;2650;0;0;1;0;0;2;2;2650;0;2978;2;1;
/org.eclipse.swt/Eclipse SWT/win32/org/eclipse/swt/widgets/Combo.java;9;2;22;2;7;5;7;15;56;2;12;106;253;253;2;3;2;15;22;1989;5;4701;17;9;
/org.eclipse.swt/Eclipse SWT PI/win32/org/eclipse/swt/internal/ole/win32/IPersistStorage.java;2;0;2;1;1;1;1;1;6;0;1;2069;6;6;1;0;0;1;2;2069;0;4701;2;2;
/org.eclipse.jdt.debug.ui/ui/org/eclipse/jdt/internal/debug/ui/display/DisplayCompletionProcessor.java;3;0;18;1;1;1;1;17;212;2;16;1915;590;590;2;1;0;17;18;3322;1;4007;17;3;
/org.eclipse.jdt.ui.tests.refactoring/resources/ExtractMethodWorkSpace/ExtractMethodTests/error_out/A_test801.java;1;1;3;1;2;2;2;1;0;0;1;3150;0;0;1;0;0;1;3;3150;0;4419;3;1;
/org.eclipse.webdav/src/client/org/eclipse/webdav/internal/authentication/AuthenticateChallenge.java;3;0;5;1;1;1;1;4;218;1;4;12;248;248;1;0;0;4;5;12;0;4211;5;3;
/org.eclipse.swt/Eclipse SWT/common/org/eclipse/swt/SWT.java;10;2;28;3;6;5;6;22;404;4;16;106;1368;1368;4;6;1;22;28;1710;7;4701;21;10;
/org.eclipse.jdt.ui.tests.refactoring/resources/MoveMembers/test2/out/A.java;1;0;1;1;0;0;0;1;0;0;1;2738;0;0;1;0;0;1;1;2738;0;2738;1;1;
/org.eclipse.jdt.launching/launching/org/eclipse/jdt/launching/AbstractVMRunner.java;2;1;10;1;5;5;5;5;343;1;5;3122;459;459;1;0;0;5;10;3122;0;4423;10;2;
/org.eclipse.ui/Eclipse UI Standard Components/org/eclipse/ui/views/tasklist/NewTaskAction.java;5;0;9;1;1;1;1;8;83;1;8;257;123;123;1;0;0;8;9;257;0;4269;9;5;
/org.eclipse.jdt.ui.tests.refactoring/resources/RenameType/test8/out/B.java;1;0;1;1;0;0;0;1;0;0;1;522;0;0;1;0;0;1;1;522;0;522;1;1;
/org.eclipse.jdt.junit/Eclipse JUnit/org/eclipse/jdt/junit/internal/SocketUtil.java;2;0;2;1;0;0;0;2;0;1;2;1531;0;0;1;0;0;2;2;1531;0;2007;2;2;
/org.eclipse.team.cvs.ui/src/org/eclipse/team/internal/ccvs/ui/wizards/UpdateWizardPage.java;3;1;6;1;2;2;2;4;18;1;4;3204;38;38;1;0;0;4;6;3204;0;4196;6;3;
/org.eclipse.swt.examples/Eclipse SWT Examples/common/org/eclipse/swt/examples/controlexample/RangeTab.java;1;0;2;1;0;0;0;2;0;1;2;107;0;0;1;0;0;2;2;107;0;611;2;1;
/org.eclipse.swt.tests/JUnit Tests/org/eclipse/swt/tests/junit/Test_org_eclipse_swt_dnd_ByteArrayTransfer.java;2;0;2;1;1;1;1;1;6;0;1;1792;6;6;1;0;0;1;2;1792;0;4706;2;2;
/org.eclipse.jdt.ui/ui/org/eclipse/jdt/internal/ui/wizards/NewPackageCreationWizard.java;2;0;9;1;0;0;0;9;18;2;7;15;53;53;2;2;0;9;9;144;2;3088;7;2;
/org.eclipse.jdt.ui.tests.refactoring/resources/RenameMethodInInterface/test44/out/A.java;1;0;1;1;0;0;0;1;0;0;1;49;0;0;1;0;0;1;1;49;0;49;1;1;
/org.eclipse.swt/Eclipse SWT/gtk/org/eclipse/swt/widgets/DirectoryDialog.java;4;1;7;1;3;3;3;4;182;1;4;2107;238;238;1;0;0;4;7;2107;0;4701;7;4;
/org.eclipse.ui/Eclipse UI Standard Components/org/eclipse/ui/wizards/datatransfer/PopulateRootOperation.java;2;0;2;1;0;0;0;2;5;1;2;257;5;5;1;0;0;2;2;257;0;457;2;2;
/org.eclipse.vcm.core/src/org/eclipse/vcm/internal/core/adapter/IServerResourceTree.java;2;0;2;1;0;0;0;2;4;1;2;0;4;4;1;0;0;2;2;0;0;297;2;2;
/org.eclipse.update.ui/src/org/eclipse/update/ui/model/UpdateModel.java;1;0;3;1;0;0;0;3;12;1;3;1460;12;12;1;0;0;3;3;1460;0;1526;3;1;
/org.eclipse.update.tests.core/src/org/eclipse/update/tests/regularInstall/AllRegularInstallTests.java;2;0;12;1;0;0;0;12;6;1;12;1531;24;24;1;0;0;12;12;1531;0;3027;12;2;
/org.eclipse.vcm.core.cvs/src/org/eclipse/vcm/internal/core/ccvs/client/SocketConnection.java;2;0;2;1;0;0;0;2;0;1;2;0;0;0;1;0;0;2;2;0;0;197;2;2;
/org.eclipse.swt/Eclipse SWT PI/gtk/org/eclipse/swt/internal/gtk/GtkColorSelectionDialog.java;2;0;5;1;2;1;2;3;45;1;3;2107;52;52;2;0;1;3;5;4701;1;4701;4;2;
/org.eclipse.pde.ui/src/org/eclipse/pde/internal/parts/ModifiedTextCellEditor.java;1;0;2;1;0;0;0;2;0;1;2;2998;0;0;1;0;0;2;2;2998;0;3579;2;1;
/org.eclipse.jdt.ui.tests.refactoring/resources/RenameStaticMethod/testFail3/in/A.java;2;0;2;1;0;0;0;2;0;1;2;49;0;0;1;0;0;2;2;49;0;1258;2;2;
/org.eclipse.pde.ui/src/org/eclipse/pde/internal/model/plugin/ImportObject.java;1;0;2;1;0;0;0;2;0;1;2;3136;0;0;1;0;0;2;2;3136;0;3579;2;1;
/org.eclipse.jdt.ui.tests.refactoring/resources/RenamePrivateMethod/test10/out/A.java;1;0;1;1;0;0;0;1;0;0;1;49;0;0;1;0;0;1;1;49;0;49;1;1;
/org.eclipse.update/src/org/eclipse/update/internal/core/UMLock.java;1;0;1;1;0;0;0;1;0;0;1;1424;0;0;1;0;0;1;1;1424;0;1424;1;1;
/org.eclipse.jdt.ui.tests.refactoring/resources/SurroundWithWorkSpace/SurroundWithTests/trycatch_in/TestInitializer.java;1;0;1;1;1;1;1;0;0;0;0;4000;0;0;1;0;0;0;1;4000;0;4000;1;1;
/org.eclipse.jdt.ui.tests.refactoring/resources/ExtractMethodWorkSpace/ExtractMethodTests/try_out/A_test453.java;2;1;4;1;2;2;2;2;30;1;2;65;31;31;1;0;0;2;4;65;0;4419;4;2;
/org.eclipse.ui/Eclipse JFace/org/eclipse/jface/action/StatusLine.java;5;1;8;1;2;2;2;6;59;1;6;257;124;124;1;0;0;6;8;257;0;4606;8;5;
/org.eclipse.pde.ui/src/org/eclipse/pde/internal/core/schema/MappedSchemaDescriptor.java;1;0;2;1;0;0;0;2;0;1;2;3579;0;0;1;0;0;2;2;3579;0;3607;2;1;
/org.eclipse.scripting/src/org/eclipse/scripting/internal/uirenderer/XGRElementScript.java;1;0;1;1;0;0;0;1;0;0;1;1424;0;0;1;0;0;1;1;1424;0;1424;1;1;
/org.eclipse.jdt.core/dom/org/eclipse/jdt/core/dom/Message.java;2;0;3;1;1;1;1;2;76;1;2;2776;124;124;1;0;0;2;3;2776;0;4020;3;2;
/org.eclipse.jdt.debug.ui/ui/org/eclipse/jdt/internal/debug/ui/actions/AddAdvancedAction.java;1;2;3;1;3;2;3;0;6;0;0;4188;8;8;2;0;1;0;3;4188;1;4423;2;1;
/org.eclipse.swt/Eclipse SWT/gtk/org/eclipse/swt/widgets/Group.java;6;1;17;1;7;7;7;10;149;1;10;2107;699;699;1;0;0;10;17;2107;0;4701;17;6;
/org.eclipse.swt/Eclipse SWT/carbon/org/eclipse/swt/internal/Converter.java;2;1;2;1;2;2;2;0;6;0;0;4147;6;6;1;0;0;0;2;4147;0;4701;2;2;
/org.eclipse.pde.ui/src/org/eclipse/pde/internal/ui/parts/EditableTablePart.java;1;0;2;1;0;0;0;2;17;1;2;3579;17;17;1;0;0;2;2;3579;0;3768;2;1;
/org.eclipse.ant.core/src/org/eclipse/ant/core/Policy.java;4;0;8;1;0;0;0;8;194;1;8;332;233;233;1;0;0;8;8;332;0;3489;8;4;
/org.eclipse.update.ui/src/org/eclipse/update/internal/ui/search/BackgroundProgressMonitor.java;1;1;3;1;2;2;2;1;27;0;1;3537;34;34;1;0;0;1;3;3537;0;4460;3;1;
/org.eclipse.pde.ui/Eclipse PDE UI/org/eclipse/pde/internal/base/schema/ISchemaRestriction.java;2;0;5;2;0;0;0;5;12;3;3;267;12;12;3;2;0;5;5;324;2;1434;3;2;
/org.eclipse.jdt.ui/core refactoring/org/eclipse/jdt/internal/corext/refactoring/changes/CreateCompilationUnitChange.java;1;1;4;1;2;2;2;2;80;1;2;3701;98;98;1;0;0;2;4;3701;0;4179;4;1;
/org.eclipse.compare/compare/org/eclipse/compare/internal/ViewerDescriptor.java;2;0;4;1;0;0;0;4;13;1;4;14;22;22;1;0;0;4;4;14;0;3170;4;2;
/org.eclipse.core.tests.resources.saveparticipant3/src/org/eclipse/core/tests/resources/saveparticipant3/SaveParticipantPlugin.java;3;0;3;1;0;0;0;3;328;1;3;1794;338;338;1;0;0;3;3;1794;0;3475;3;3;
/org.eclipse.jdt.ui.tests.refactoring/resources/ExtractMethodWorkSpace/ExtractMethodTests/locals_in/A_test500.java;2;1;4;1;2;2;2;2;13;1;2;80;15;15;1;0;0;2;4;80;0;4419;4;2;
/org.eclipse.vcm.core.cvs/src/org/eclipse/vcm/internal/core/ccvs/requests/UpdateErrorHandler.java;3;0;6;1;0;0;0;6;22;1;6;0;50;50;1;0;0;6;6;0;0;398;6;3;
/org.eclipse.pde.ui/src/org/eclipse/pde/internal/editor/schema/SchemaPropertySheet.java;2;0;2;1;0;0;0;2;0;1;2;1434;0;0;1;0;0;2;2;1434;0;3579;2;2;
/org.eclipse.jdt.core/model/org/eclipse/jdt/core/Signature.java;3;0;19;2;1;1;1;18;1310;4;13;455;3214;3214;4;5;0;18;19;1039;5;4061;14;3;
/org.eclipse.swt.tests/JUnit Tests/org/eclipse/swt/tests/junit/Test_org_eclipse_swt_widgets_Label.java;2;0;2;1;1;1;1;1;6;0;1;1792;6;6;1;0;0;1;2;1792;0;4706;2;2;
/org.eclipse.help.webapp/src/org/eclipse/help/servlet/UrlUtil.java;2;1;5;1;2;2;2;3;58;1;3;3491;156;156;1;0;0;3;5;3491;0;4630;5;2;
/org.eclipse.ui/Eclipse JFace Text/org/eclipse/jface/text/IDocumentListener.java;3;0;3;1;0;0;0;3;5;1;3;257;6;6;1;0;0;3;3;257;0;1066;3;3;
/org.eclipse.swt/Eclipse SWT/photon/org/eclipse/swt/widgets/ToolBar.java;7;1;21;1;8;8;8;13;139;2;11;106;411;411;2;2;0;13;21;2064;2;4701;19;7;
/org.eclipse.jdt.core/model/org/eclipse/jdt/internal/core/JavaModelInfo.java;3;1;9;1;2;2;2;7;61;2;6;455;163;163;2;1;0;7;9;2030;1;4321;8;3;
/org.eclipse.jdt.ui/core extension/org/eclipse/jdt/internal/corext/codemanipulation/MethodBlock.java;1;1;3;1;2;2;2;1;29;0;1;3872;31;31;1;0;0;1;3;3872;0;4543;3;1;
/org.eclipse.pde.core/src/org/eclipse/pde/core/plugin/IPluginExtension.java;1;0;3;1;2;1;2;1;30;0;1;3591;30;30;2;0;1;1;3;4751;1;4751;2;1;
/org.eclipse.jdt.ui.tests.refactoring/resources/ExtractMethodWorkSpace/ExtractMethodTests/return_in/A_test718.java;1;1;3;1;2;2;2;1;24;0;1;1236;24;24;1;0;0;1;3;1236;0;4419;3;1;
/org.eclipse.jdt.core/search/org/eclipse/jdt/internal/core/search/matching/FileNameEnvironment.java;3;0;6;2;1;1;1;5;43;4;2;3101;67;67;4;3;0;5;6;3101;3;4063;3;3;
/org.eclipse.update/src/org/eclipse/update/internal/core/UMSessionManagerSession.java;1;0;1;1;0;0;0;1;0;0;1;1424;0;0;1;0;0;1;1;1424;0;1424;1;1;
/org.eclipse.swt/Eclipse SWT Drag and Drop/carbon/org/eclipse/swt/dnd/TextTransfer.java;4;1;6;1;6;6;6;0;43;0;0;4147;71;71;1;0;0;0;6;4147;0;4824;6;4;
/org.eclipse.jdt.ui.tests.refactoring/resources/RenameType/test54/out/A.java;1;0;1;1;0;0;0;1;0;0;1;1284;0;0;1;0;0;1;1;1284;0;1284;1;1;
/org.eclipse.swt/Eclipse SWT/common/org/eclipse/swt/events/TraverseEvent.java;3;1;4;1;2;2;2;2;15;1;2;106;27;27;1;0;0;2;4;106;0;4701;4;3;
/org.eclipse.swt/Eclipse SWT/common/org/eclipse/swt/internal/image/PngIendChunk.java;2;0;3;1;1;1;1;2;10;1;2;106;16;16;1;0;0;2;3;106;0;4701;3;2;
/org.eclipse.jdt.core/model/org/eclipse/jdt/internal/core/builder/impl/ImageBuilderInternalException.java;1;0;11;1;0;0;0;11;53;4;7;455;80;80;4;4;0;11;11;1039;4;2808;7;1;
/org.eclipse.team.cvs.ui/src/org/eclipse/team/internal/ccvs/ui/CVSDecoratorConfiguration.java;3;0;9;2;0;0;0;9;56;2;8;2484;83;83;2;1;0;9;9;2917;1;3610;8;3;
/org.eclipse.pde.ui/src/org/eclipse/pde/internal/ui/wizards/BaseWizardSelectionPage.java;1;0;1;1;0;0;0;1;0;0;1;3579;0;0;1;0;0;1;1;3579;0;3579;1;1;
/org.eclipse.update.core/src/org/eclipse/update/core/IDataEntry.java;2;0;4;1;0;0;0;4;6;2;3;2004;8;8;2;1;0;4;4;2004;1;2583;3;2;
/org.eclipse.ui/Eclipse JFace/org/eclipse/jface/viewers/LabelProviderChangedEvent.java;4;0;7;1;1;1;1;6;120;2;5;257;249;249;2;1;0;6;7;3413;1;4019;6;4;
/org.eclipse.jdt.ui.tests.refactoring/resources/PullUpMethods/testFail2/in/A.java;1;0;2;1;0;0;0;2;0;1;2;2156;0;0;1;0;0;2;2;2156;0;2406;2;1;
/org.eclipse.jdt.debug.ui/ui/org/eclipse/jdt/debug/ui/launchConfigurations/JavaClasspathTab.java;3;2;13;1;13;9;13;0;48;0;0;4098;187;187;2;0;4;0;13;4098;4;4452;9;3;
/org.eclipse.pde.ui/Eclipse PDE UI/org/eclipse/pde/internal/model/component/Component.java;2;0;7;2;0;0;0;7;12;3;5;267;19;19;3;2;0;7;7;324;2;1434;5;2;
/org.eclipse.swt/Eclipse SWT/emulated/treetable/org/eclipse/swt/widgets/TableItem.java;7;2;16;2;10;8;10;6;152;1;6;1028;501;501;2;0;2;6;16;3939;2;4701;14;7;
/org.eclipse.pde.ui/src/org/eclipse/pde/internal/ui/editor/XMLConfiguration.java;1;1;5;1;2;2;2;3;101;1;3;3579;117;117;1;0;0;3;5;3579;0;4588;5;1;
/org.eclipse.swt/Eclipse SWT PI/win32/org/eclipse/swt/internal/ole/win32/IDataObject.java;2;0;2;1;1;1;1;1;6;0;1;2069;6;6;1;0;0;1;2;2069;0;4701;2;2;
/org.eclipse.swt/Eclipse SWT/common/org/eclipse/swt/events/MenuEvent.java;2;0;3;1;1;1;1;2;6;1;2;106;10;10;1;0;0;2;3;106;0;4701;3;2;
/org.eclipse.swt.examples/Eclipse SWT Examples/common/org/eclipse/swt/examples/addressbook/SearchDialog.java;1;0;2;1;0;0;0;2;0;1;2;107;0;0;1;0;0;2;2;107;0;611;2;1;
/org.eclipse.jdt.ui/core refactoring/org/eclipse/jdt/internal/corext/refactoring/rename/RenameMethodASTAnalyzer.java;2;0;5;1;0;0;0;5;23;2;4;1939;25;25;2;1;0;5;5;3412;1;3825;4;2;
/org.eclipse.jdt.ui/core refactoring/org/eclipse/jdt/internal/core/refactoring/code/flow/FlowContext.java;1;0;3;1;0;0;0;3;19;1;3;1236;19;19;1;0;0;3;3;1236;0;1939;3;1;
/org.eclipse.jdt.ui.tests.refactoring/resources/ExtractTemp/cannotExtract/A_testFail12.java;1;0;1;1;0;0;0;1;0;0;1;2873;0;0;1;0;0;1;1;2873;0;2873;1;1;
/org.eclipse.scripting/Eclipse Scripting/org/eclipse/scripting/internal/views/ScriptUIEditor.java;2;0;7;1;0;0;0;7;97;1;7;133;159;159;1;0;0;7;7;133;0;1424;7;2;
/org.eclipse.jdt.ui/core refactoring/org/eclipse/jdt/internal/core/refactoring/rename/RefactoringScope.java;1;0;4;1;0;0;0;4;12;1;4;1483;20;20;1;0;0;4;4;1483;0;1922;4;1;
/org.eclipse.help/src/org/eclipse/help/internal/navigation/NavigationModel.java;2;0;2;1;0;0;0;2;0;1;2;1420;0;0;1;0;0;2;2;1420;0;1675;2;2;
/org.eclipse.jdt.ui.tests.refactoring/resources/PullUpMethods/testFail8/in/B.java;1;0;2;1;0;0;0;2;0;1;2;2156;0;0;1;0;0;2;2;2156;0;2406;2;1;
/org.eclipse.team.cvs.core/src/org/eclipse/team/internal/ccvs/core/streams/TimeoutOutputStream.java;2;1;5;1;2;2;2;3;289;1;3;3574;564;564;1;0;0;3;5;3574;0;4169;5;2;
/org.eclipse.scripting/src/org/eclipse/scripting/internal/uirenderer/ScriptWizardPage.java;1;0;1;1;0;0;0;1;0;0;1;1424;0;0;1;0;0;1;1;1424;0;1424;1;1;
/org.eclipse.pde.ui/src/org/eclipse/pde/internal/model/feature/FeatureData.java;1;0;3;1;0;0;0;3;9;1;3;3468;9;9;1;0;0;3;3;3468;0;3579;3;1;
/org.eclipse.team.cvs.core/src/org/eclipse/team/internal/ccvs/core/CVSProvider.java;3;1;55;3;6;6;6;49;902;4;38;2042;3529;3529;4;11;0;49;55;3526;11;4632;44;3;
/org.eclipse.help.ui/src/org/eclipse/help/ui/browser/IBrowserFactory.java;2;0;3;1;0;0;0;3;5;1;3;2429;7;7;1;0;0;3;3;2429;0;3609;3;2;
/org.eclipse.vcm.ui/src/org/eclipse/vcm/internal/ui/actions/ReplaceWithVersionAction.java;3;0;7;1;0;0;0;7;56;1;7;1;108;108;1;0;0;7;7;1;0;1288;7;3;
/org.eclipse.ui.tests/Eclipse UI Tests/org/eclipse/ui/tests/internal/ActionExpressionTest.java;2;0;4;1;0;0;0;4;39;2;3;2033;43;43;2;1;0;4;4;2033;1;2785;3;2;
/org.eclipse.jdt.junit/src/org/eclipse/jdt/internal/junit/util/ISelectionValidator.java;1;1;2;1;2;2;2;0;0;0;0;4020;0;0;1;0;0;0;2;4020;0;4036;2;1;
/org.eclipse.jdt.ui/ui refactoring/org/eclipse/jdt/internal/ui/nls/search/INLSSearchUIConstants.java;1;0;2;1;0;0;0;2;0;1;2;1913;0;0;1;0;0;2;2;1913;0;1922;2;1;
/org.eclipse.team.ui/src/org/eclipse/team/internal/ui/IPromptCondition.java;1;0;1;1;1;1;1;0;0;0;0;4256;0;0;1;0;0;0;1;4256;0;4256;1;1;
/org.eclipse.jdt.ui/ui refactoring/org/eclipse/jdt/internal/ui/nls/search/NLSSearchPage.java;1;0;2;1;0;0;0;2;0;1;2;1913;0;0;1;0;0;2;2;1913;0;1922;2;1;
/org.eclipse.help/src/org/eclipse/help/internal/contributors1_0/ViewContributor.java;1;0;2;1;0;0;0;2;0;1;2;1675;0;0;1;0;0;2;2;1675;0;2217;2;1;
/org.eclipse.team.ftp/src/org/eclipse/team/internal/ftp/client/InputStreamProvider.java;1;2;3;1;3;2;3;0;3;0;0;4287;3;3;2;0;1;0;3;4287;1;4573;2;1;
/org.eclipse.jdt.core/search/org/eclipse/jdt/internal/core/index/IQueryResult.java;2;0;3;1;1;1;1;2;15;1;2;455;20;20;1;0;0;2;3;455;0;4063;3;2;
/org.eclipse.pde/src/org/eclipse/pde/internal/PDE.java;1;0;3;1;1;1;1;2;10;1;2;3631;18;18;1;0;0;2;3;3631;0;4424;3;1;
/org.eclipse.jdt.core/model/org/eclipse/jdt/internal/core/ImportDeclaration.java;3;0;10;1;1;1;1;9;91;4;6;455;166;166;4;3;0;9;10;1039;3;4063;7;3;
/org.eclipse.jdt.ui.tests.refactoring/resources/AbstractField/can/A_test5_in.java;1;0;1;1;0;0;0;1;0;0;1;751;0;0;1;0;0;1;1;751;0;751;1;1;
/org.eclipse.help.webapp/src/org/eclipse/help/servlet/TopicsStack.java;1;0;1;1;0;0;0;1;0;0;1;3449;0;0;1;0;0;1;1;3449;0;3449;1;1;
/org.eclipse.jdt.ui.tests.refactoring/test cases/org/eclipse/jdt/ui/tests/refactoring/SelectionAnalyzerTests.java;2;0;7;1;0;0;0;7;120;1;7;1896;152;152;1;0;0;7;7;1896;0;3084;7;2;
/org.eclipse.jdt.ui/core extension/org/eclipse/jdt/internal/corext/codemanipulation/MoveTextEdit.java;1;0;3;1;0;0;0;3;132;2;2;1983;132;132;2;1;0;3;3;2133;1;2133;2;1;
/org.eclipse.jdt.ui.tests.refactoring/resources/MoveMembers/test24/out/B.java;1;0;1;1;0;0;0;1;0;0;1;2928;0;0;1;0;0;1;1;2928;0;2928;1;1;
/org.eclipse.jdt.ui.tests.refactoring/resources/RenameParameters/canRename/A_test22_out.java;1;0;1;1;0;0;0;1;0;0;1;233;0;0;1;0;0;1;1;233;0;233;1;1;
/org.eclipse.jdt.ui/ui/org/eclipse/jdt/internal/ui/dialogs/ISelectionValidator.java;4;0;5;2;1;1;1;4;17;2;3;15;25;25;2;1;0;4;5;1254;1;4018;4;4;
/org.eclipse.pde.ui/Eclipse PDE UI/org/eclipse/pde/internal/editor/manifest/ManifestPropertySource.java;2;0;5;2;0;0;0;5;12;3;3;267;12;12;3;2;0;5;5;324;2;1434;3;2;
/org.eclipse.update.ui/src/org/eclipse/update/ui/internal/model/PreservedConfiguration.java;1;0;3;1;0;0;0;3;2;1;3;2319;2;2;1;0;0;3;3;2319;0;2797;3;1;
/org.eclipse.jdt.ui/core refactoring/org/eclipse/jdt/internal/core/refactoring/CustomSearchEngine.java;4;0;7;1;0;0;0;7;70;1;7;15;83;83;1;0;0;7;7;15;0;1939;7;4;
/org.eclipse.core.boot/src/org/eclipse/core/internal/boot/update/NLResourceHelper.java;3;0;7;2;0;0;0;7;17;3;5;12;25;25;3;2;0;7;7;323;2;2726;5;3;
/org.eclipse.team.cvs.ui/src/org/eclipse/team/internal/ccvs/ui/merge/UpdateMergeAction.java;3;2;13;2;5;4;5;8;115;2;7;2828;242;242;2;1;1;8;13;2864;2;4455;11;3;
/org.eclipse.jdt.ui.tests.refactoring/resources/ExtractMethodWorkSpace/ExtractMethodTests/nested_out/A_test652.java;2;1;3;1;2;2;2;1;26;0;1;354;26;26;1;0;0;1;3;354;0;4419;3;2;
/org.eclipse.jdt.junit/src/org/eclipse/jdt/internal/junit/ui/OpenEditorAction.java;2;0;2;1;0;0;0;2;8;1;2;3171;8;8;1;0;0;2;2;3171;0;3659;2;2;
/org.eclipse.jdt.ui.tests.refactoring/resources/SelectionAnalyzerWorkSpace/SelectionAnalyzerTests/invalidSelection/A_test152.java;1;0;1;1;0;0;0;1;0;0;1;1368;0;0;1;0;0;1;1;1368;0;1368;1;1;
/org.eclipse.jdt.ui.tests.refactoring/test cases/org/eclipse/jdt/ui/tests/refactoring/CopyPackageChangeTest.java;2;0;4;1;1;1;1;3;8;1;3;1896;12;12;1;0;0;3;4;1896;0;4212;4;2;
/org.eclipse.swt.examples.launcher/src/org/eclipse/swt/examples/launcher/ImportProjectTask.java;1;0;1;1;0;0;0;1;0;0;1;480;0;0;1;0;0;1;1;480;0;480;1;1;
/org.eclipse.help/src/org/eclipse/help/internal/contributions/TopicRef.java;2;0;2;1;0;0;0;2;0;1;2;1420;0;0;1;0;0;2;2;1420;0;1675;2;2;
/org.eclipse.jdt.debug.ui/ui/org/eclipse/jdt/internal/debug/ui/display/DisplayMessages.java;1;0;1;1;0;0;0;1;0;0;1;1915;0;0;1;0;0;1;1;1915;0;1915;1;1;
/org.eclipse.swt/Eclipse SWT/gtk1x/org/eclipse/swt/widgets/ColorDialog.java;4;0;4;1;1;1;1;3;6;1;3;2107;12;12;1;0;0;3;4;2107;0;4701;4;4;
/org.eclipse.jdt.ui.tests.refactoring/resources/RenameTemp/canRename/A_test2_out.java;1;0;1;1;0;0;0;1;0;0;1;1625;0;0;1;0;0;1;1;1625;0;1625;1;1;
/org.eclipse.jdt.ui.tests.refactoring/resources/MultiMove/test1/in/p2/C.java;1;0;1;1;0;0;0;1;0;0;1;1157;0;0;1;0;0;1;1;1157;0;1157;1;1;
/org.eclipse.vcm.core.cvs.ssh/src/org/eclipse/vcm/internal/core/ccvs/ssh/SSHServerConnection.java;4;0;9;1;0;0;0;9;64;1;9;197;162;162;1;0;0;9;9;197;0;1591;9;4;
/org.eclipse.jdt.debug/eval/org/eclipse/jdt/debug/eval/ast/model/IValue.java;1;0;2;1;0;0;0;2;0;1;2;3329;0;0;1;0;0;2;2;3329;0;3421;2;1;
/org.eclipse.jdt.ui/ui/org/eclipse/jdt/internal/ui/viewsupport/JavaImageLabelProvider.java;5;0;10;1;0;0;0;10;234;2;9;15;421;421;2;1;0;10;10;1705;1;1705;9;5;
/org.eclipse.jdt.ui.tests.refactoring/resources/RenameType/testFail81/in/A.java;1;0;1;1;0;0;0;1;0;0;1;49;0;0;1;0;0;1;1;49;0;49;1;1;
/org.eclipse.team.cvs.ui/src/org/eclipse/team/internal/ccvs/ui/CVSDecoratorPreferencesPage.java;3;1;16;1;4;4;4;12;89;2;10;2484;156;156;2;2;0;12;16;2484;2;4829;14;3;
/org.eclipse.core.resources/src/org/eclipse/core/internal/dtree/DataTreeReader.java;2;0;6;1;1;1;1;5;248;1;5;12;294;294;1;0;0;5;6;12;0;4214;6;2;
/org.eclipse.core.resources/src/org/eclipse/core/internal/resources/MarkerManager.java;4;0;18;1;1;1;1;17;962;2;16;12;1494;1494;2;1;0;17;18;1360;1;4213;17;4;
/org.eclipse.jdt.ui/ui/org/eclipse/jdt/internal/ui/javaeditor/EditorDisplayAction.java;5;0;10;1;0;0;0;10;44;2;9;345;97;97;2;1;0;10;10;759;1;1916;9;5;
/org.eclipse.jdt.ui/ui/org/eclipse/jdt/internal/ui/util/ArrayUtility.java;2;0;5;1;0;0;0;5;12;1;5;15;20;20;1;0;0;5;5;15;0;1199;5;2;
/org.eclipse.ui/Eclipse UI Standard Components/org/eclipse/ui/views/navigator/LabelDecoratorAction.java;2;0;2;1;0;0;0;2;0;1;2;2011;0;0;1;0;0;2;2;2011;0;2549;2;2;
/org.eclipse.ui/Eclipse UI/org/eclipse/ui/internal/ReuseEditorAction.java;1;0;3;1;0;0;0;3;70;1;3;892;70;70;1;0;0;3;3;892;0;3052;3;1;
/org.eclipse.jdt.core/model/org/eclipse/jdt/internal/core/InitializerElementInfo.java;2;0;3;1;1;1;1;2;16;1;2;455;19;19;1;0;0;2;3;455;0;4063;3;2;
/org.eclipse.update.core/src/org/eclipse/update/internal/core/AbstractFeature.java;1;0;12;1;0;0;0;12;468;3;8;1643;937;937;3;4;0;12;12;1653;4;1791;8;1;
/org.eclipse.pde.ui/Eclipse PDE UI/org/eclipse/pde/internal/editor/schema/SchemaFormOutlinePage.java;2;0;7;2;0;0;0;7;12;3;5;267;18;18;3;2;0;7;7;324;2;1434;5;2;
/org.eclipse.swt/Eclipse SWT Custom Widgets/common_j2se/org/eclipse/swt/custom/DefaultContent.java;1;0;1;1;0;0;0;1;0;0;1;1378;0;0;1;0;0;1;1;1378;0;1378;1;1;
/org.eclipse.jdt.ui.tests.refactoring/resources/RenameType/test3/in/A.java;1;0;1;1;0;0;0;1;0;0;1;49;0;0;1;0;0;1;1;49;0;49;1;1;
/org.eclipse.jdt.debug.ui/ui/org/eclipse/jdt/internal/debug/ui/snippeteditor/SnippetAction.java;2;0;3;1;1;1;1;2;34;1;2;1915;52;52;1;0;0;2;3;1915;0;3901;3;2;
/org.eclipse.ui/Eclipse UI/org/eclipse/ui/actions/ActionDelegate.java;2;0;2;1;0;0;0;2;5;1;2;257;5;5;1;0;0;2;2;257;0;457;2;2;
/org.eclipse.jdt.ui/ui refactoring/org/eclipse/jdt/internal/ui/refactoring/ModifyParametersWizard.java;1;0;2;1;0;0;0;2;4;1;2;2820;4;4;1;0;0;2;2;2820;0;2933;2;1;
/org.eclipse.ui.examples.javaeditor/Eclipse Java Editor Example/org/eclipse/ui/examples/javaeditor/util/JavaWordDetector.java;1;0;1;1;0;0;0;1;0;0;1;1067;0;0;1;0;0;1;1;1067;0;1067;1;1;
/org.eclipse.swt/Eclipse SWT PI/win32/org/eclipse/swt/internal/ole/win32/TYPEATTR.java;2;0;2;1;1;1;1;1;6;0;1;2069;6;6;1;0;0;1;2;2069;0;4701;2;2;
/org.eclipse.jdt.ui.tests.refactoring/resources/RenameMethodInInterface/test25/out/A.java;1;0;1;1;0;0;0;1;0;0;1;49;0;0;1;0;0;1;1;49;0;49;1;1;
/org.eclipse.swt.tests/JUnit Tests/org/eclipse/swt/tests/junit/Test_org_eclipse_swt_events_MouseTrackAdapter.java;2;0;2;1;1;1;1;1;6;0;1;1792;6;6;1;0;0;1;2;1792;0;4706;2;2;
/org.eclipse.jdt.debug.ui/ui/org/eclipse/jdt/internal/debug/ui/JDIDebugUIPlugin.java;4;1;50;2;7;7;7;43;214;2;38;1915;950;950;2;5;0;43;50;2231;5;4552;45;4;
/org.eclipse.help/src/org/eclipse/help/internal/contributions/xml/HelpTopicRef.java;2;0;3;1;0;0;0;3;25;1;3;1420;25;25;1;0;0;3;3;1420;0;1675;3;2;
/org.eclipse.help.ui/src/org/eclipse/help/internal/ui/win32/TableOfContentsGenerator.java;2;0;2;2;0;0;0;2;0;0;1;1675;0;0;2;1;0;2;2;1675;1;1675;1;2;
/org.eclipse.swt/Eclipse SWT Custom Widgets/common/org/eclipse/swt/custom/TableCell.java;1;0;1;1;0;0;0;1;0;0;1;1777;0;0;1;0;0;1;1;1777;0;1777;1;1;
/org.eclipse.jdt.junit/Eclipse JUnit/org/eclipse/jdt/internal/junit/ui/TestInfo.java;1;0;2;1;0;0;0;2;0;1;2;2007;0;0;1;0;0;2;2;2007;0;2399;2;1;
/org.eclipse.pde.ui/Eclipse PDE UI/org/eclipse/pde/internal/editor/schema/SchemaSourceOutlinePage.java;2;0;5;2;0;0;0;5;12;3;3;267;12;12;3;2;0;5;5;324;2;1434;3;2;
/org.eclipse.jdt.ui.tests.refactoring/resources/InlineTemp/canInline/A_test10_out.java;1;0;2;1;0;0;0;2;2;0;1;2751;2;2;2;1;0;2;2;2751;1;2751;1;1;
/org.eclipse.jdt.debug/jdi interfaces/com/sun/jdi/LongType.java;2;0;2;1;0;0;0;2;6;1;2;2704;6;6;1;0;0;2;2;2704;0;3033;2;2;
/org.eclipse.jdt.ui.tests.refactoring/resources/RenameMethodInInterface/test43/out/A.java;1;0;1;1;0;0;0;1;0;0;1;49;0;0;1;0;0;1;1;49;0;49;1;1;
/org.eclipse.core.tests.runtime/src/org/eclipse/core/tests/internal/plugins/RegressionResolveTest_2.java;3;0;3;1;0;0;0;3;132;1;3;1794;142;142;1;0;0;3;3;1794;0;3476;3;3;
/org.eclipse.ui/Eclipse JFace/org/eclipse/jface/dialogs/ControlEnableState.java;2;0;2;1;0;0;0;2;5;1;2;257;5;5;1;0;0;2;2;257;0;457;2;2;
/org.eclipse.swt/Eclipse SWT PI/gtk1x/org/eclipse/swt/internal/gtk/GtkFrame.java;2;0;2;1;1;1;1;1;3;0;1;2107;3;3;1;0;0;1;2;2107;0;4701;2;2;
/org.eclipse.ui.examples.readmetool/Eclipse UI Examples Readme Tool/org/eclipse/ui/examples/readmetool/AddSentenceResolution.java;2;0;3;1;1;1;1;2;25;1;2;2497;40;40;1;0;0;2;3;2497;0;4455;3;2;
/org.eclipse.ui/Eclipse JFace/org/eclipse/jface/wizard/IWizardNode.java;2;0;2;1;0;0;0;2;5;1;2;257;5;5;1;0;0;2;2;257;0;457;2;2;
/org.eclipse.jdt.ui.tests.refactoring/resources/RenameVariables/cannotRename/A_testFail19.java;1;0;2;1;0;0;0;2;0;1;2;724;0;0;1;0;0;2;2;724;0;1665;2;1;
/org.eclipse.jdt.ui.tests.refactoring/resources/StructureSelectionAction/A_test22.java;1;0;1;1;0;0;0;1;0;0;1;3003;0;0;1;0;0;1;1;3003;0;3003;1;1;
/org.eclipse.pde.runtime/src/org/eclipse/pde/internal/runtime/logview/StatusAdapter.java;2;0;2;1;0;0;0;2;0;1;2;1434;0;0;1;0;0;2;2;1434;0;3877;2;2;
/org.eclipse.pde.ui/Eclipse PDE UI/org/eclipse/pde/internal/editor/text/PDETagScanner.java;2;0;5;2;0;0;0;5;12;3;3;267;12;12;3;2;0;5;5;324;2;1434;3;2;
/org.eclipse.pde.ui/Eclipse PDE UI/org/eclipse/pde/internal/forms/HyperlinkAdapter.java;2;0;5;2;0;0;0;5;12;3;3;267;12;12;3;2;0;5;5;324;2;1434;3;2;
/org.eclipse.swt/Eclipse SWT/motif/org/eclipse/swt/internal/motif/XKeyEvent.java;2;0;3;1;0;0;0;3;4;1;3;106;4;4;1;0;0;3;3;106;0;2069;3;2;
/org.eclipse.team.webdav/src/org/eclipse/team/internal/webdav/core/WebDavPlugin.java;2;1;7;1;7;7;7;0;27;0;0;4073;87;87;1;0;0;0;7;4073;0;4315;7;2;
/org.eclipse.jdt.ui.tests.refactoring/resources/PullUpMethods/test15/out/A.java;1;0;2;1;0;0;0;2;0;1;2;2286;0;0;1;0;0;2;2;2286;0;2406;2;1;
/org.eclipse.jdt.core/search/org/eclipse/jdt/internal/core/search/matching/MethodDeclarationPattern.java;2;0;13;1;1;1;1;12;1170;4;8;455;2315;2315;4;4;0;12;13;1039;4;4063;9;2;
/org.eclipse.ui/Eclipse UI/org/eclipse/ui/internal/dialogs/WelcomeEditor.java;3;1;20;2;5;5;5;15;213;3;10;457;491;491;3;5;0;15;20;3700;5;4687;15;3;
/org.eclipse.update.ui/src/org/eclipse/update/internal/ui/manager/UpdateSearchProgressMonitor.java;1;0;4;1;0;0;0;4;13;2;3;1942;15;15;2;1;0;4;4;1942;1;3662;3;1;
/org.eclipse.team.cvs.core/src/org/eclipse/team/internal/ccvs/core/client/RemoteCommand.java;1;0;1;1;0;0;0;1;0;0;1;3873;0;0;1;0;0;1;1;3873;0;3873;1;1;
/org.eclipse.team.examples.filesystem/src/org/eclipse/team/examples/filesystem/StreamUtil.java;1;0;1;1;1;1;1;0;0;0;0;4674;0;0;1;0;0;0;1;4674;0;4674;1;1;
/org.eclipse.jdt.debug/eval/org/eclipse/jdt/debug/eval/model/IArrayType.java;2;0;2;1;0;0;0;2;0;1;2;3421;0;0;1;0;0;2;2;3421;0;3555;2;2;
/org.eclipse.pde.core/src/org/eclipse/pde/core/plugin/IPlugin.java;1;0;3;1;2;1;2;1;30;0;1;3591;30;30;2;0;1;1;3;4751;1;4751;2;1;
/org.eclipse.ui/Eclipse UI Text Editor/org/eclipse/ui/texteditor/BookmarkRulerAction.java;1;1;4;1;3;3;3;1;6;0;1;3592;11;11;1;0;0;1;4;3592;0;4838;4;1;
/org.eclipse.swt.tests/JUnit Tests/org/eclipse/swt/tests/junit/Test_org_eclipse_swt_widgets_Canvas.java;2;0;2;1;1;1;1;1;6;0;1;1792;6;6;1;0;0;1;2;1792;0;4706;2;2;
/org.eclipse.ui/Eclipse UI Text Editor/org/eclipse/ui/texteditor/IAbstractTextEditorHelpContextIds.java;3;1;9;1;6;6;6;3;190;1;3;620;215;215;1;0;0;3;9;620;0;4853;9;3;
/org.eclipse.pde.ui/Eclipse PDE UI/org/eclipse/pde/internal/editor/manifest/ExtensionSection.java;2;0;6;2;0;0;0;6;12;3;4;267;13;13;3;2;0;6;6;324;2;1434;4;2;
/org.eclipse.jdt.debug/model/org/eclipse/jdt/internal/debug/core/JDIPrimitiveValue.java;3;0;3;1;0;0;0;3;2;1;3;2010;2;2;1;0;0;3;3;2010;0;2517;3;3;
/org.eclipse.jdt.ui/ui/org/eclipse/jdt/internal/ui/text/correction/CorrectionMarkerResolutionGenerator.java;2;2;4;1;4;3;4;0;111;0;0;4161;115;115;2;0;1;0;4;4161;1;4621;3;2;
/org.eclipse.jdt.ui.tests.refactoring/resources/MoveCU/testFail7/in/p1/C.java;2;0;2;1;0;0;0;2;0;1;2;49;0;0;1;0;0;2;2;49;0;2769;2;2;
/org.eclipse.help/Eclipse Help/org/eclipse/help/IHelp.java;3;0;5;1;0;0;0;5;21;1;5;135;34;34;1;0;0;5;5;135;0;1420;5;3;
/org.eclipse.swt.tests/JUnit Tests/org/eclipse/swt/tests/junit/Test_org_eclipse_swt_events_SelectionEvent.java;2;0;2;1;1;1;1;1;6;0;1;1792;6;6;1;0;0;1;2;1792;0;4706;2;2;
/org.eclipse.scripting/src/org/eclipse/scripting/internal/views/ScriptUIEditorDocumentProvider.java;1;0;1;1;0;0;0;1;0;0;1;1424;0;0;1;0;0;1;1;1424;0;1424;1;1;
/org.eclipse.update.ui/src/org/eclipse/update/internal/ui/manager/ChecklistView.java;1;0;10;1;0;0;0;10;28;2;8;1460;73;73;2;2;0;10;10;1526;2;2174;8;1;
/org.eclipse.help/src/org/eclipse/help/internal/contributors/xml1_0/InfosetsContributionFactory.java;1;0;2;1;0;0;0;2;0;1;2;1675;0;0;1;0;0;2;2;1675;0;2217;2;1;
/org.eclipse.pde.ui/src/org/eclipse/pde/internal/ui/editor/feature/PluginReference.java;1;0;2;1;0;0;0;2;2;1;2;3579;2;2;1;0;0;2;2;3579;0;3591;2;1;
/org.eclipse.jdt.core/model/org/eclipse/jdt/core/jdom/IDOMType.java;2;0;5;1;2;1;2;3;201;1;3;455;236;236;2;0;1;3;5;4058;1;4058;4;2;
/org.eclipse.pde.ui/src/org/eclipse/pde/ui/templates/IVariableProvider.java;1;0;2;1;1;1;1;1;22;0;1;3819;22;22;1;0;0;1;2;3819;0;4752;2;1;
/org.eclipse.vcm.ui/src/org/eclipse/vcm/internal/ui/sync/ForcedAction.java;1;0;2;1;0;0;0;2;164;1;2;1505;164;164;1;0;0;2;2;1505;0;1515;2;1;
/org.eclipse.update.core/src/org/eclipse/update/internal/core/DefaultFeatureParser.java;1;0;14;1;0;0;0;14;136;3;11;1577;468;468;3;3;0;14;14;1577;3;1791;11;1;
/org.eclipse.core.resources/src/org/eclipse/core/internal/localstore/CoreFileSystemLibraryPureJava.java;2;0;2;1;0;0;0;2;0;1;2;12;0;0;1;0;0;2;2;12;0;49;2;2;
/org.eclipse.jdt.core/model/org/eclipse/jdt/internal/core/builder/impl/MarkerProblemReporter.java;1;0;11;1;0;0;0;11;476;4;7;455;901;901;4;4;0;11;11;1039;4;2808;7;1;
/org.eclipse.jdt.ui.tests.refactoring/resources/RenameStaticMethod/test3/out/A.java;1;0;1;1;0;0;0;1;0;0;1;49;0;0;1;0;0;1;1;49;0;49;1;1;
/org.eclipse.swt.examples/Eclipse SWT Examples/common/org/eclipse/swt/examples/controlexample/AlignableTab.java;1;0;2;1;0;0;0;2;0;1;2;107;0;0;1;0;0;2;2;107;0;611;2;1;
/org.eclipse.jdt.ui/ui/org/eclipse/jdt/internal/ui/text/correction/NewVariableCompletionProposal.java;4;2;14;1;3;2;3;11;278;2;9;3469;515;515;2;2;1;11;14;3570;3;4642;11;4;
/org.eclipse.team.cvs.core/src/org/eclipse/team/internal/ccvs/core/client/DiffStructureVisitor.java;3;0;14;2;0;0;0;14;49;2;11;2572;126;126;2;3;0;14;14;3089;3;3610;11;3;
/org.eclipse.team.cvs.ui/src/org/eclipse/team/internal/ccvs/ui/sync/ForceUpdateSyncAction.java;3;2;14;2;6;5;6;8;388;2;7;3157;511;511;2;1;1;8;14;3831;2;4455;12;3;
/org.eclipse.jdt.core/model/org/eclipse/jdt/internal/core/SetOutputLocationOperation.java;1;0;12;1;0;0;0;12;354;4;9;455;820;820;4;3;0;12;12;1039;3;1976;9;1;
/org.eclipse.pde.ui/Eclipse PDE UI/org/eclipse/pde/internal/model/Plugin.java;2;0;7;2;0;0;0;7;23;3;5;267;37;37;3;2;0;7;7;324;2;1434;5;2;
/org.eclipse.ui/Eclipse UI Standard Components/org/eclipse/ui/views/navigator/RefactorActionGroup.java;2;0;4;1;1;1;1;3;64;1;3;3451;98;98;1;0;0;3;4;3451;0;4067;4;2;
/org.eclipse.jdt.ui/ui/org/eclipse/jdt/ui/text/IColorManager.java;2;0;3;1;1;1;1;2;15;1;2;15;25;25;1;0;0;2;3;15;0;4810;3;2;
/org.eclipse.jdt.ui.tests.refactoring/resources/SelectionAnalyzerWorkSpace/SelectionAnalyzerTests/validSelection/A_test283.java;1;0;1;1;0;0;0;1;0;0;1;1368;0;0;1;0;0;1;1;1368;0;1368;1;1;
/org.eclipse.jdt.core/model/org/eclipse/jdt/internal/core/IBufferManager.java;1;0;3;1;0;0;0;3;34;1;3;455;34;34;1;0;0;3;3;455;0;1755;3;1;
/org.eclipse.pde.ui/src/org/eclipse/pde/internal/parts/WizardCheckboxTablePart.java;1;0;3;1;0;0;0;3;110;1;3;2981;110;110;1;0;0;3;3;2981;0;3579;3;1;
/org.eclipse.pde.ui/src/org/eclipse/pde/internal/editor/schema/SchemaEditor.java;2;0;3;1;0;0;0;3;1;1;3;1434;1;1;1;0;0;3;3;1434;0;3579;3;2;
/org.eclipse.jdt.ui.tests.refactoring/resources/RenameVirtualMethodInClass/test20/out/A.java;1;0;1;1;0;0;0;1;0;0;1;49;0;0;1;0;0;1;1;49;0;49;1;1;
/org.eclipse.update/src/org/eclipse/update/internal/ui/Main.java;1;0;1;1;0;0;0;1;0;0;1;1424;0;0;1;0;0;1;1;1424;0;1424;1;1;
/org.eclipse.jdt.ui.tests.refactoring/resources/RenameTemp/cannotRename/A_testFail6.java;1;0;2;1;0;0;0;2;2;1;2;1625;2;2;1;0;0;2;2;1625;0;1652;2;1;
/org.eclipse.core.tests.runtime/src/org/eclipse/core/tests/runtime/PreferenceExportTest.java;1;0;1;1;1;1;1;0;0;0;0;4772;0;0;1;0;0;0;1;4772;0;4772;1;1;
/org.eclipse.pde.ui/Eclipse PDE UI/org/eclipse/pde/internal/base/model/plugin/IFragment.java;2;0;5;2;0;0;0;5;12;3;3;267;12;12;3;2;0;5;5;324;2;1434;3;2;
/org.eclipse.jdt.ui.tests/ui/org/eclipse/jdt/ui/tests/AddUnimplementedMethodsTest.java;2;0;3;1;0;0;0;3;6;2;2;522;6;6;2;1;0;3;3;1186;1;1186;2;2;
/org.eclipse.update.ui.forms/src/org/eclipse/update/ui/forms/HyperlinkHandler.java;1;0;3;1;0;0;0;3;150;1;3;1423;150;150;1;0;0;3;3;1423;0;2474;3;1;
/org.eclipse.team.cvs.core/src/org/eclipse/team/internal/ccvs/core/commands/Diff.java;3;0;5;1;0;0;0;5;155;1;5;1978;301;301;1;0;0;5;5;1978;0;2607;5;3;
/org.eclipse.jdt.core/dom/org/eclipse/jdt/core/dom/AST.java;3;2;21;2;8;7;8;13;314;4;9;2669;641;641;4;4;1;13;21;3188;5;4567;16;3;
/org.eclipse.jdt.core/formatter/org/eclipse/jdt/internal/formatter/impl/FormatterOptions.java;2;0;15;1;1;1;1;14;588;4;9;455;1572;1572;4;5;0;14;15;1039;5;4062;10;2;
/org.eclipse.ui/Eclipse JFace/org/eclipse/jface/preference/ListEditor.java;4;0;4;1;0;0;0;4;8;1;4;257;20;20;1;0;0;4;4;257;0;793;4;4;
/org.eclipse.swt/Eclipse SWT/gtk1x/org/eclipse/swt/widgets/Display.java;5;0;10;2;1;1;1;9;85;2;7;2107;143;143;2;2;0;9;10;2417;2;4701;8;5;
/org.eclipse.scripting/Eclipse Scripting/org/eclipse/scripting/internal/uirenderer/XGRElementUISwtWizardPageBuildTime.java;2;0;4;1;0;0;0;4;31;1;4;133;50;50;1;0;0;4;4;133;0;1424;4;2;
/org.eclipse.pde.ui/src/org/eclipse/pde/internal/ui/ischema/ISchemaComplexType.java;1;0;3;1;0;0;0;3;4;2;2;3579;4;4;2;1;0;3;3;3579;1;3591;2;1;
/org.eclipse.core.tests.runtime/src/org/eclipse/core/tests/internal/runtime/AllTests.java;3;0;4;1;0;0;0;4;56;1;4;1794;67;67;1;0;0;4;4;1794;0;3476;4;3;
/org.eclipse.team.cvs.core/src/org/eclipse/team/internal/ccvs/core/commands/FileStructureVisitor.java;3;0;7;1;0;0;0;7;294;1;7;1978;835;835;1;0;0;7;7;1978;0;2607;7;3;
/org.eclipse.scripting/src/org/eclipse/scripting/internal/datamodels/XGRDataModelFactory.java;1;0;1;1;0;0;0;1;0;0;1;1424;0;0;1;0;0;1;1;1424;0;1424;1;1;
/org.eclipse.jdt.debug.ui/ui/org/eclipse/jdt/internal/debug/ui/actions/AttachSourceAction.java;1;0;1;1;1;1;1;0;0;0;0;4101;0;0;1;0;0;0;1;4101;0;4101;1;1;
/org.eclipse.pde.ui/src/org/eclipse/pde/internal/ui/editor/manifest/ManifestFormOutlinePage.java;1;0;4;1;0;0;0;4;6;2;3;3579;10;10;2;1;0;4;4;3579;1;3607;3;1;
/org.eclipse.jdt.ui.tests.refactoring/resources/InlineTemp/canInline/A_test15_in.java;1;0;1;1;0;0;0;1;0;0;1;3048;0;0;1;0;0;1;1;3048;0;3048;1;1;
/org.eclipse.jdt.core/compiler/org/eclipse/jdt/internal/compiler/problem/DefaultProblem.java;2;1;19;2;2;2;2;17;440;4;11;455;1009;1009;4;6;0;17;19;1039;6;4062;13;2;
/org.eclipse.ui/Eclipse UI Standard Components/org/eclipse/ui/wizards/datatransfer/ZipFileStructureProvider.java;3;0;3;1;0;0;0;3;9;1;3;257;16;16;1;0;0;3;3;257;0;620;3;3;
/org.eclipse.pde.ui/src/org/eclipse/pde/internal/codegen/JavaCodeGenerator.java;2;0;5;1;0;0;0;5;190;1;5;1434;195;195;1;0;0;5;5;1434;0;3579;5;2;
/org.eclipse.jdt.ui.tests.refactoring/resources/ExtractMethodWorkSpace/ExtractMethodTests/invalidSelection/A_test112.java;2;1;3;1;2;2;2;1;0;0;1;49;0;0;1;0;0;1;3;49;0;4419;3;2;
/org.eclipse.swt.examples.paint/src/org/eclipse/swt/examples/paint/LineFigure.java;4;0;5;2;1;1;1;4;63;2;3;566;80;80;2;1;0;4;5;609;1;4705;4;4;
/org.eclipse.help.webapp/src/org/eclipse/help/internal/proxy/protocol/platform/Handler.java;1;0;1;1;0;0;0;1;0;0;1;3454;0;0;1;0;0;1;1;3454;0;3454;1;1;
/org.eclipse.jdt.ui.tests.refactoring/test cases/org/eclipse/jdt/ui/tests/refactoring/PathTransformationTests.java;2;0;3;1;0;0;0;3;8;1;3;1896;10;10;1;0;0;3;3;1896;0;1939;3;2;
/org.eclipse.jdt.core/model/org/eclipse/jdt/core/JavaCore.java;5;5;139;3;37;21;39;100;12576;6;67;455;29486;29486;6;33;18;102;139;3872;51;4665;88;5;
/org.eclipse.jdt.ui.tests.refactoring/resources/RenameType/testFail1/in/A.java;1;0;1;1;0;0;0;1;0;0;1;49;0;0;1;0;0;1;1;49;0;49;1;1;
/org.eclipse.swt/Eclipse SWT Printing/motif/org/eclipse/swt/printing/Printer.java;9;1;13;1;2;2;2;11;233;2;9;106;391;391;2;2;0;11;13;1191;2;4701;11;9;
/org.eclipse.jdt.ui.tests.refactoring/resources/RenameVariables/canRename/A_test7_out.java;1;0;2;1;0;0;0;2;0;1;2;724;0;0;1;0;0;2;2;724;0;1665;2;1;
/org.eclipse.swt/Eclipse SWT/emulated/tabfolder/org/eclipse/swt/widgets/TabFolder.java;4;2;11;1;5;4;5;6;135;1;6;1029;318;318;2;0;1;6;11;4557;1;4701;10;4;
/org.eclipse.swt/Eclipse SWT/gtk/org/eclipse/swt/graphics/Region.java;4;1;6;1;3;3;3;3;311;1;3;2107;414;414;1;0;0;3;6;2107;0;4701;6;4;
/org.eclipse.ui.tests/Eclipse UI Tests/org/eclipse/ui/tests/zoom/HideViewTest.java;1;0;1;1;0;0;0;1;0;0;1;3633;0;0;1;0;0;1;1;3633;0;3633;1;1;
/org.eclipse.jdt.ui/core refactoring/org/eclipse/jdt/internal/core/refactoring/tagging/IMultiRenameRefactoring.java;2;0;2;1;0;0;0;2;0;1;2;1665;0;0;1;0;0;2;2;1665;0;1939;2;2;
/org.eclipse.team.tests.cvs.core/src/org/eclipse/team/tests/ccvs/core/NullOutputStream.java;2;0;2;1;0;0;0;2;0;1;2;2536;0;0;1;0;0;2;2;2536;0;3089;2;2;
/org.eclipse.core.resources/src/org/eclipse/core/resources/IResourceChangeListener.java;1;0;4;1;1;1;1;3;84;1;3;12;105;105;1;0;0;3;4;12;0;4214;4;1;
/org.eclipse.vcm.ui/src/org/eclipse/vcm/internal/ui/HistoryDropAdapter.java;1;0;2;1;0;0;0;2;2;1;2;1159;2;2;1;0;0;2;2;1159;0;1293;2;1;
/org.eclipse.jdt.ui.tests.refactoring/resources/RenameMethodInInterface/test2/out/A.java;1;0;1;1;0;0;0;1;0;0;1;49;0;0;1;0;0;1;1;49;0;49;1;1;
/org.eclipse.jdt.ui/core refactoring/org/eclipse/jdt/internal/corext/refactoring/code/flow/TryFlowInfo.java;1;0;2;1;0;0;0;2;2;1;2;1939;2;2;1;0;0;2;2;1939;0;2684;2;1;
/org.eclipse.swt/Eclipse SWT PI/win32/org/eclipse/swt/internal/win32/ICONINFO.java;2;0;2;1;1;1;1;1;6;0;1;2069;6;6;1;0;0;1;2;2069;0;4701;2;2;
/org.eclipse.jdt.ui/ui/org/eclipse/jdt/internal/ui/packageview/PackageExplorerActions.java;1;0;1;1;0;0;0;1;0;0;1;3716;0;0;1;0;0;1;1;3716;0;3716;1;1;
/org.eclipse.scripting/src/org/eclipse/scripting/internal/uirenderer/XGREventAction.java;1;0;1;1;0;0;0;1;0;0;1;1424;0;0;1;0;0;1;1;1424;0;1424;1;1;
/org.eclipse.jdt.ui.tests.refactoring/resources/RenamePackage/testFail2/in/p/p1/A.java;2;0;2;1;0;0;0;2;0;1;2;49;0;0;1;0;0;2;2;49;0;1258;2;2;
/org.eclipse.jdt.ui.tests.refactoring/resources/ExtractMethodWorkSpace/ExtractMethodTests/semicolon_in/A_test405.java;2;0;2;1;0;0;0;2;0;1;2;80;0;0;1;0;0;2;2;80;0;3106;2;2;
/org.eclipse.scripting/src/org/eclipse/scripting/internal/views/ScriptUIEditorPropertySheetPage.java;1;0;1;1;0;0;0;1;0;0;1;1424;0;0;1;0;0;1;1;1424;0;1424;1;1;
/org.eclipse.team.ui/src/org/eclipse/team/ui/actions/DeconfigureProjectAction.java;2;0;6;1;1;1;1;5;90;1;5;1978;104;104;1;0;0;5;6;1978;0;4020;6;2;
/org.eclipse.jdt.ui.tests.refactoring/resources/RenameTemp/canRename/A_test24_out.java;1;0;2;1;0;0;0;2;2;1;2;1625;2;2;1;0;0;2;2;1625;0;1652;2;1;
/org.eclipse.swt.examples/org/eclipse/swt/examples/addressbook/FindListener.java;3;0;3;1;1;1;1;2;12;1;2;513;12;12;1;0;0;2;3;513;0;4024;3;3;
/org.eclipse.pde.ui/src/org/eclipse/pde/internal/ui/editor/manifest/ExtensionSection.java;1;0;5;1;0;0;0;5;63;2;4;3579;82;82;2;1;0;5;5;3579;1;3687;4;1;
/org.eclipse.ui/Eclipse UI/org/eclipse/ui/internal/PluginActionSetBuilder.java;4;1;6;1;4;4;4;2;108;1;2;257;227;227;1;0;0;2;6;257;0;4571;6;4;
/org.eclipse.jdt.debug/jdi interfaces/com/sun/jdi/LongValue.java;2;0;2;1;0;0;0;2;6;1;2;2704;6;6;1;0;0;2;2;2704;0;3033;2;2;
/org.eclipse.jdt.core/dom/org/eclipse/jdt/core/dom/ASTSyntaxErrorPropagator.java;3;0;8;2;1;1;1;7;15;3;5;2776;41;41;3;2;0;7;8;3084;2;4421;6;3;
/org.eclipse.team.cvs.ui/src/org/eclipse/team/internal/ccvs/ui/wizards/SharingWizard.java;3;1;31;2;11;11;11;20;82;2;18;2577;583;583;2;2;0;20;31;2684;2;4571;29;3;
/org.eclipse.pde.ui/src/org/eclipse/pde/internal/base/model/component/IComponentModel.java;2;0;2;1;0;0;0;2;0;1;2;1434;0;0;1;0;0;2;2;1434;0;2951;2;2;
/org.eclipse.jdt.core/compiler/org/eclipse/jdt/internal/compiler/util/ObjectSet.java;1;0;9;1;0;0;0;9;41;2;8;1710;113;113;2;1;0;9;9;1974;1;2026;8;1;
/org.eclipse.jdt.ui.tests.refactoring/resources/ExtractMethodWorkSpace/ExtractMethodTests/locals_out/A_test513.java;2;1;5;1;2;2;2;3;13;1;3;369;21;21;1;0;0;3;5;369;0;4419;5;2;
/org.eclipse.debug.ui/ui/org/eclipse/debug/internal/ui/InspectorList.java;2;0;3;1;0;0;0;3;5;1;3;187;5;5;1;0;0;3;3;187;0;2348;3;2;
/org.eclipse.swt/Eclipse SWT/win32/org/eclipse/swt/internal/win32/GRADIENT_RECT.java;2;0;2;1;0;0;0;2;0;1;2;1088;0;0;1;0;0;2;2;1088;0;2069;2;2;
/org.eclipse.jdt.ui.tests.refactoring/resources/RenameStaticMethod/test9/in/A.java;1;0;1;1;0;0;0;1;0;0;1;1274;0;0;1;0;0;1;1;1274;0;1274;1;1;
/org.eclipse.pde.ui/src/org/eclipse/pde/internal/editor/manifest/JavaAttributeWizard.java;2;0;4;1;0;0;0;4;2;1;4;1434;4;4;1;0;0;4;4;1434;0;3579;4;2;
/org.eclipse.jdt.debug/jdi/org/eclipse/jdi/internal/VirtualMachineManagerImpl.java;3;0;6;1;1;1;1;5;29;1;5;187;66;66;1;0;0;5;6;187;0;4430;6;3;
/org.eclipse.jdt.ui.tests.refactoring/resources/RenameNonPrivateField/test15/in/A.java;1;0;1;1;0;0;0;1;0;0;1;1274;0;0;1;0;0;1;1;1274;0;1274;1;1;
/org.eclipse.jdt.ui/core refactoring/org/eclipse/jdt/internal/corext/refactoring/base/ChangeAbortException.java;1;0;1;1;0;0;0;1;0;0;1;1939;0;0;1;0;0;1;1;1939;0;1939;1;1;
/org.eclipse.pde.ui/Eclipse PDE UI/org/eclipse/pde/internal/editor/manifest/NullMenuManager.java;2;0;5;2;0;0;0;5;12;3;3;267;12;12;3;2;0;5;5;324;2;1434;3;2;
/org.eclipse.jdt.ui.tests.refactoring/resources/PullUp/test3/in/A.java;1;0;1;1;0;0;0;1;0;0;1;2406;0;0;1;0;0;1;1;2406;0;2406;1;1;
/org.eclipse.team.ftp/src/org/eclipse/team/internal/ftp/client/FTPServiceNotAvailableException.java;1;1;2;1;2;2;2;0;0;0;0;4169;0;0;1;0;0;0;2;4169;0;4327;2;1;
/org.eclipse.vcm.ui/src/org/eclipse/vcm/internal/ui/model/VCMAdapterFactory.java;3;0;3;2;0;0;0;3;16;2;2;1;16;16;2;1;0;3;3;297;1;297;2;3;
/org.eclipse.jdt.ui/ui refactoring/org/eclipse/jdt/internal/ui/nls/search/GotoMarkerAction.java;1;0;2;1;0;0;0;2;0;1;2;1913;0;0;1;0;0;2;2;1913;0;1922;2;1;
/org.eclipse.team.cvs.ui/src/org/eclipse/team/internal/ccvs/ui/actions/ReplaceWithTagAction.java;3;1;25;2;8;8;8;17;66;2;15;2388;430;430;2;2;0;17;25;2388;2;4455;23;3;
/org.eclipse.jdt.junit/src/org/eclipse/jdt/junit/wizards/MethodStubsSelectionButtonGroup.java;2;0;4;1;0;0;0;4;7;3;2;3394;7;7;3;2;0;4;4;3394;2;3527;2;2;
/org.eclipse.swt.examples/src/org/eclipse/swt/examples/helloworld/HelloWorld3.java;4;0;5;1;1;1;1;4;40;1;4;513;81;81;1;0;0;4;5;513;0;4705;5;4;
/org.eclipse.jdt.debug/jdi interfaces/com/sun/jdi/event/VMStartEvent.java;2;0;2;1;0;0;0;2;8;1;2;2704;8;8;1;0;0;2;2;2704;0;3040;2;2;
/org.eclipse.jdt.ui.tests.refactoring/resources/RenameNonPrivateField/testFail6/in/A.java;1;0;1;1;0;0;0;1;0;0;1;49;0;0;1;0;0;1;1;49;0;49;1;1;
/org.eclipse.jdt.ui.tests.refactoring/resources/SelectionAnalyzerWorkSpace/SelectionAnalyzerTests/validSelection/A_test287.java;1;0;1;1;0;0;0;1;0;0;1;1368;0;0;1;0;0;1;1;1368;0;1368;1;1;
/org.eclipse.jdt.ui.tests.refactoring/resources/RenameVariables/canRename/A_test32_in.java;1;0;2;1;0;0;0;2;0;1;2;724;0;0;1;0;0;2;2;724;0;1665;2;1;
/org.eclipse.swt/Eclipse SWT/common/org/eclipse/swt/internal/image/JPEGRestartInterval.java;2;0;3;1;1;1;1;2;6;1;2;106;10;10;1;0;0;2;3;106;0;4701;3;2;
/org.eclipse.core.resources/src/org/eclipse/core/internal/resources/MarkerReader_1.java;2;0;9;1;1;1;1;8;276;1;8;12;452;452;1;0;0;8;9;12;0;4213;9;2;
/org.eclipse.jdt.ui/core refactoring/org/eclipse/jdt/internal/core/refactoring/base/ChangeContext.java;2;0;4;1;0;0;0;4;48;1;4;408;50;50;1;0;0;4;4;408;0;1939;4;2;
/org.eclipse.jdt.ui/nls/org/eclipse/jdt/internal/ui/nls/ListDialog.java;1;0;3;1;0;0;0;3;51;2;2;1880;51;51;2;1;0;3;3;1910;1;1910;2;1;
/org.eclipse.pde.ui/src/org/eclipse/pde/internal/ui/wizards/templates/PDETemplateSection.java;1;0;3;1;0;0;0;3;69;1;3;3579;72;72;1;0;0;3;3;3579;0;3840;3;1;
/org.eclipse.core.tests.resources/src/org/eclipse/core/tests/internal/localstore/LocalStoreTest.java;3;0;5;1;1;1;1;4;340;1;4;1794;372;372;1;0;0;4;5;1794;0;4516;5;3;
/org.eclipse.jdt.ui.examples.projects/examples/org/eclipse/jdt/internal/ui/exampleprojects/ExampleProjectsPlugin.java;3;0;4;1;1;1;1;3;75;1;3;534;110;110;1;0;0;3;4;534;0;4440;4;3;
/org.eclipse.jdt.debug.ui/ui/org/eclipse/jdt/debug/ui/launchConfigurations/JavaArgumentsTab.java;3;2;7;2;7;6;7;0;10;0;0;4098;34;34;2;0;1;0;7;4382;1;4659;6;3;
/org.eclipse.swt.tests/JUnit Tests/org/eclipse/swt/tests/junit/Test_org_eclipse_swt_graphics_ImageLoaderListener.java;2;0;2;1;1;1;1;1;6;0;1;1792;6;6;1;0;0;1;2;1792;0;4706;2;2;
/org.eclipse.jdt.ui/core extension/org/eclipse/jdt/internal/corext/textmanipulation/MoveTextEdit.java;2;0;4;1;0;0;0;4;4;1;4;2137;9;9;1;0;0;4;4;2137;0;3825;4;2;
/org.eclipse.ui/Eclipse JFace Text/org/eclipse/jface/text/BadLocationException.java;3;0;3;1;0;0;0;3;5;1;3;257;6;6;1;0;0;3;3;257;0;1066;3;3;
/org.eclipse.ui/Eclipse JFace/org/eclipse/jface/action/Action.java;4;2;16;1;3;2;3;13;219;2;11;257;551;551;2;2;1;13;16;1436;3;4383;13;4;
/org.eclipse.help/Eclipse Help/org/eclipse/help/internal/contributors/xml/InfosetsContributionFactory.java;1;0;2;1;0;0;0;2;0;1;2;992;0;0;1;0;0;2;2;992;0;1420;2;1;
/org.eclipse.swt/Eclipse SWT PI/win32/org/eclipse/swt/internal/ole/win32/IDispatch.java;2;0;2;1;1;1;1;1;6;0;1;2069;6;6;1;0;0;1;2;2069;0;4701;2;2;
/org.eclipse.jdt.debug.ui/ui/org/eclipse/jdt/internal/debug/ui/launcher/JavaApplicationAction.java;3;3;10;2;10;7;10;0;90;0;0;3952;124;124;3;0;3;0;10;4214;3;4367;7;3;
/org.eclipse.ui/Eclipse JFace Text/org/eclipse/jface/text/TextEvent.java;4;1;5;1;2;2;2;3;31;1;3;257;82;82;1;0;0;3;5;257;0;4838;5;4;
/org.eclipse.jdt.ui.tests.refactoring/resources/RenameParameters/canRename/A_test4_in.java;1;0;1;1;0;0;0;1;0;0;1;233;0;0;1;0;0;1;1;233;0;233;1;1;
/org.eclipse.pde.ui/src/org/eclipse/pde/internal/ui/editor/manifest/JavaAttributeValue.java;1;0;2;1;0;0;0;2;2;1;2;3579;2;2;1;0;0;2;2;3579;0;3591;2;1;
/org.eclipse.pde.ui/Eclipse PDE UI/org/eclipse/pde/internal/editor/manifest/PluginListSection.java;2;0;8;2;0;0;0;8;81;2;7;267;122;122;2;1;0;8;8;324;1;1434;7;2;
/org.eclipse.jdt.ui.tests.refactoring/resources/RenameType/test14/out/A.java;1;0;2;1;0;0;0;2;0;1;2;49;0;0;1;0;0;2;2;49;0;522;2;1;
/org.eclipse.pde.ui/src/org/eclipse/pde/internal/core/plugin/ExternalPluginModelBase.java;1;0;3;1;0;0;0;3;15;1;3;3579;15;15;1;0;0;3;3;3579;0;3607;3;1;
/org.eclipse.jdt.ui/nls/org/eclipse/jdt/internal/ui/nls/model/NLSElement.java;1;0;3;1;0;0;0;3;19;1;3;1880;19;19;1;0;0;3;3;1880;0;1913;3;1;
/org.eclipse.jdt.ui/ui/org/eclipse/jdt/internal/ui/text/template/TemplateContext.java;1;0;10;1;0;0;0;10;100;2;8;1587;294;294;2;2;0;10;10;1587;2;2784;8;1;
/org.eclipse.jdt.ui/core refactoring/org/eclipse/jdt/internal/core/refactoring/rename/RenameTypeRefactoring.java;2;0;15;1;0;0;0;15;207;2;12;1342;479;479;2;3;0;15;15;1342;3;1937;12;2;
/org.eclipse.ui/Eclipse JFace Text/org/eclipse/jface/text/contentassist/Helper.java;3;0;3;1;0;0;0;3;5;1;3;257;7;7;1;0;0;3;3;257;0;1066;3;3;
/org.eclipse.team.cvs.ui/src/org/eclipse/team/internal/ccvs/ui/merge/UpdateWithForcedJoinAction.java;3;1;5;1;2;2;2;3;8;1;3;3156;21;21;1;0;0;3;5;3156;0;4455;5;3;
/org.eclipse.pde.ui/src/org/eclipse/pde/internal/editor/feature/ReferenceForm.java;1;0;8;1;0;0;0;8;35;2;7;2951;72;72;2;1;0;8;8;2951;1;3579;7;1;
/org.eclipse.ui/Eclipse UI/org/eclipse/ui/internal/misc/TestPartListener.java;2;0;2;1;0;0;0;2;14;1;2;257;14;14;1;0;0;2;2;257;0;457;2;2;
/org.eclipse.debug.ui/ui/org/eclipse/debug/internal/ui/DebugAction.java;2;0;5;1;0;0;0;5;13;1;5;187;24;24;1;0;0;5;5;187;0;2205;5;2;
/org.eclipse.jdt.debug.tests/test plugin/org/eclipse/jdt/debug/testplugin/NewMain.java;2;0;2;1;1;1;1;1;16;0;1;3701;16;16;1;0;0;1;2;3701;0;4328;2;2;
/org.eclipse.jdt.ui.tests.refactoring/resources/InlineTemp/canInline/A_test22_out.java;1;0;1;1;1;1;1;0;0;0;0;4419;0;0;1;0;0;0;1;4419;0;4419;1;1;
/org.eclipse.pde.ui/src/org/eclipse/pde/internal/core/feature/FeatureURLElement.java;1;0;3;1;0;0;0;3;2;1;3;3579;2;2;1;0;0;3;3;3579;0;3607;3;1;
/org.eclipse.jdt.ui.tests.refactoring/resources/RenameTemp/cannotRename/A_testFail30.java;1;0;1;1;1;1;1;0;0;0;0;4620;0;0;1;0;0;0;1;4620;0;4620;1;1;
/org.eclipse.team.ui/src/org/eclipse/team/internal/ui/target/RemoteTargetSyncElement.java;4;1;9;1;9;9;9;0;70;0;0;4215;133;133;1;0;0;0;9;4215;0;4573;9;4;
/org.eclipse.ui/Eclipse UI/org/eclipse/ui/actions/OpenSystemEditorAction.java;3;0;3;1;0;0;0;3;18;1;3;257;20;20;1;0;0;3;3;257;0;3029;3;3;
/org.eclipse.jdt.ui.tests.refactoring/resources/ExtractMethodWorkSpace/ExtractMethodTests/try_out/A_test460.java;1;1;4;1;2;2;2;2;60;1;2;1851;67;67;1;0;0;2;4;1851;0;4419;4;1;
/org.eclipse.jdt.ui.tests.refactoring/resources/PullUp/test4/out/B.java;1;0;1;1;0;0;0;1;0;0;1;2406;0;0;1;0;0;1;1;2406;0;2406;1;1;
/org.eclipse.jdt.ui.tests/ui/org/eclipse/jdt/ui/tests/JavaDocTestCase.java;2;0;4;1;0;0;0;4;6;2;3;522;9;9;2;1;0;4;4;1186;1;1186;3;2;
/org.eclipse.jdt.ui.tests.refactoring/resources/StructureSelectionAction/A_test0.java;1;0;2;1;0;0;0;2;2;1;2;2139;2;2;1;0;0;2;2;2139;0;3020;2;1;
/org.eclipse.jdt.debug.tests/tests/org/eclipse/jdt/debug/tests/core/BootpathTests.java;1;0;1;1;1;1;1;0;0;0;0;4449;0;0;1;0;0;0;1;4449;0;4449;1;1;
/org.eclipse.jdt.ui/ui/org/eclipse/jdt/internal/ui/util/JavaUIHelp.java;4;1;8;1;4;4;4;4;156;1;4;3286;175;175;1;0;0;4;8;3286;0;4621;8;4;
/org.eclipse.pde.ui/Eclipse PDE UI/org/eclipse/pde/internal/model/PluginLibrary.java;2;0;6;2;0;0;0;6;12;3;4;267;14;14;3;2;0;6;6;324;2;1434;4;2;
/org.eclipse.update.core/src/org/eclipse/update/internal/core/NonPluginEntryContentConsumer.java;2;1;4;1;2;2;2;2;54;1;2;2487;93;93;1;0;0;2;4;2487;0;4207;4;2;
/org.eclipse.pde.ui/src/org/eclipse/pde/internal/wizards/extension/NewExtensionPointMainPage.java;2;0;5;1;0;0;0;5;2;1;5;1434;4;4;1;0;0;5;5;1434;0;3579;5;2;
/org.eclipse.jdt.debug/eval/org/eclipse/jdt/internal/debug/eval/ast/instructions/DivideOperator.java;3;0;8;1;1;1;1;7;45;1;7;3421;71;71;1;0;0;7;8;3421;0;4423;8;3;
/org.eclipse.jdt.debug.ui/ui/org/eclipse/jdt/internal/debug/ui/actions/BreakpointToggleAction.java;3;0;9;1;0;0;0;9;171;2;7;2646;195;195;2;2;0;9;9;2844;2;3676;7;3;
/org.eclipse.vcm.core/src/org/eclipse/vcm/internal/core/Handle.java;6;0;11;1;0;0;0;11;30;2;10;0;99;99;2;1;0;11;11;531;1;531;10;6;
/org.eclipse.help.webapp/src/org/eclipse/help/internal/proxy/protocol/help/Handler.java;1;0;1;1;0;0;0;1;0;0;1;3454;0;0;1;0;0;1;1;3454;0;3454;1;1;
/org.eclipse.ui/Eclipse UI Text Editor/org/eclipse/ui/texteditor/IElementStateListenerExtension.java;1;1;3;1;2;2;2;1;32;0;1;3592;43;43;1;0;0;1;3;3592;0;4838;3;1;
/org.eclipse.core.resources/src/org/eclipse/core/resources/IWorkspaceDescription.java;2;2;6;2;3;2;3;3;278;1;3;12;320;320;2;0;1;3;6;4209;1;4426;5;2;
/org.eclipse.ui/Eclipse JFace/org/eclipse/jface/preference/PreferenceConverter.java;4;0;10;1;1;1;1;9;191;1;9;257;249;249;1;0;0;9;10;257;0;4023;10;4;
/org.eclipse.jdt.debug/eval/org/eclipse/jdt/internal/debug/eval/ast/instructions/PushArrayType.java;1;0;2;1;0;0;0;2;4;1;2;3421;4;4;1;0;0;2;2;3421;0;3505;2;1;
/org.eclipse.ui/Eclipse UI Standard Components/org/eclipse/ui/views/framelist/IFrameSource.java;1;0;1;1;0;0;0;1;0;0;1;3498;0;0;1;0;0;1;1;3498;0;3498;1;1;
/org.eclipse.help.ui/Eclipse Help UI/org/eclipse/help/internal/ui/HelpPerspective.java;2;0;5;1;0;0;0;5;12;2;4;136;20;20;2;1;0;5;5;1419;1;1419;4;2;
/org.eclipse.jdt.ui/ui refactoring/org/eclipse/jdt/internal/ui/nls/search/Properties.java;1;0;2;1;0;0;0;2;0;1;2;1913;0;0;1;0;0;2;2;1913;0;1922;2;1;
/org.eclipse.pde.ui/src/org/eclipse/pde/internal/wizards/templates/HelloWorldNewWizard.java;1;0;4;1;0;0;0;4;12;1;4;3240;14;14;1;0;0;4;4;3240;0;3579;4;1;
/org.eclipse.core.resources/src/org/eclipse/core/internal/indexing/Buffer.java;3;0;6;1;1;1;1;5;452;1;5;12;1007;1007;1;0;0;5;6;12;0;4214;6;3;
/org.eclipse.jdt.ui.tests.refactoring/resources/MoveCU/test1/in/p/B.java;2;0;2;1;0;0;0;2;0;1;2;49;0;0;1;0;0;2;2;49;0;2769;2;2;
/org.eclipse.jdt.ui/ui/org/eclipse/jdt/internal/ui/wizards/buildpaths/NewVariableEntryDialog.java;2;1;7;1;4;4;4;3;65;1;3;3680;148;148;1;0;0;3;7;3680;0;4630;7;2;
/org.eclipse.ui.tests/Eclipse JFace Tests/org/eclipse/jface/tests/viewers/interactive/ChangeInputLabelAction.java;1;0;1;1;0;0;0;1;0;0;1;1488;0;0;1;0;0;1;1;1488;0;1488;1;1;
/org.eclipse.jdt.core/model/org/eclipse/jdt/internal/core/jdom/DOMInitializer.java;2;0;11;1;1;1;1;10;410;4;7;455;501;501;4;3;0;10;11;1039;3;4063;8;2;
/org.eclipse.ui/Eclipse UI/org/eclipse/ui/actions/OpenNewPageMenu.java;3;0;4;1;0;0;0;4;13;1;4;257;17;17;1;0;0;4;4;257;0;3067;4;3;
/org.eclipse.pde.ui/src/org/eclipse/pde/internal/model/PluginBase.java;2;0;7;1;0;0;0;7;449;2;6;1434;522;522;2;1;0;7;7;3134;1;3134;6;2;
/org.eclipse.pde.ui/Eclipse PDE UI/org/eclipse/pde/internal/model/build/BuildObject.java;2;0;5;2;0;0;0;5;12;3;3;267;12;12;3;2;0;5;5;324;2;1434;3;2;
/org.eclipse.swt/Eclipse SWT/gtk/org/eclipse/swt/widgets/Decorations.java;5;1;20;1;8;8;8;12;580;2;10;2107;785;785;2;2;0;12;20;3451;2;4701;18;5;
/org.eclipse.jdt.ui/core refactoring/org/eclipse/jdt/internal/core/refactoring/util/SelectionAnalyzer.java;1;0;4;1;0;0;0;4;27;1;4;1345;29;29;1;0;0;4;4;1345;0;1939;4;1;
/org.eclipse.pde.ui/src/org/eclipse/pde/internal/core/ifeature/IFeatureInstallHandler.java;1;0;2;1;0;0;0;2;0;1;2;3591;0;0;1;0;0;2;2;3591;0;3607;2;1;
/org.eclipse.pde.ui/src/org/eclipse/pde/internal/ui/editor/feature/PortabilityChoiceDescriptor.java;1;0;1;1;0;0;0;1;0;0;1;3579;0;0;1;0;0;1;1;3579;0;3579;1;1;
/org.eclipse.team.cvs.ui/src/org/eclipse/team/internal/ccvs/ui/model/CVSFileElement.java;1;0;3;1;0;0;0;3;67;1;3;3545;71;71;1;0;0;3;3;3545;0;3610;3;1;
/org.eclipse.pde.ui/src/org/eclipse/pde/internal/util/ChoiceCellEditor.java;1;0;2;1;0;0;0;2;0;1;2;3113;0;0;1;0;0;2;2;3113;0;3579;2;1;
/org.eclipse.jdt.ui.tests.refactoring/resources/RenameTemp/cannotRename/A_testFail0.java;1;0;2;1;0;0;0;2;2;1;2;1625;2;2;1;0;0;2;2;1625;0;1652;2;1;
/org.eclipse.scripting.examples/src/org/eclipse/scripting/examples/ExcaliburWorkbenchNewWizardAdapter.java;1;0;1;1;0;0;0;1;0;0;1;1424;0;0;1;0;0;1;1;1424;0;1424;1;1;
/org.eclipse.jdt.debug/model/org/eclipse/jdt/internal/debug/core/EvaluationVisitor.java;1;0;4;1;0;0;0;4;200;1;4;1610;206;206;1;0;0;4;4;1610;0;1758;4;1;
/org.eclipse.jdt.ui/ui/org/eclipse/jdt/internal/ui/packageview/PackageExplorerContentProvider.java;3;2;6;2;6;3;6;0;43;0;0;4466;85;85;2;0;3;0;6;4466;3;4621;3;3;
/org.eclipse.ui.examples.readmetool/Eclipse UI Examples Readme Tool/org/eclipse/ui/examples/readmetool/ReadmeCreationPage.java;3;0;3;1;0;0;0;3;42;1;3;932;44;44;1;0;0;3;3;932;0;3029;3;3;
/org.eclipse.swt.examples.paint/src/org/eclipse/swt/examples/paint/PaintView.java;3;0;5;2;1;1;1;4;548;3;2;513;554;554;3;2;0;4;5;609;2;4705;3;3;
/org.eclipse.jdt.ui/ui/org/eclipse/jdt/internal/ui/reorg/NameClashDialog.java;5;0;10;1;0;0;0;10;14;1;10;15;49;49;1;0;0;10;10;15;0;1667;10;5;
/org.eclipse.team.cvs.core/src/org/eclipse/team/internal/ccvs/core/resources/api/ICVSFile.java;2;0;2;1;0;0;0;2;0;1;2;1978;0;0;1;0;0;2;2;1978;0;2156;2;2;
/org.eclipse.ui/Eclipse UI/org/eclipse/ui/internal/PageEventAction.java;3;0;3;1;0;0;0;3;5;1;3;257;7;7;1;0;0;3;3;257;0;1737;3;3;
/org.eclipse.jdt.debug.ui/ui/org/eclipse/jdt/internal/debug/ui/actions/ManageMethodBreakpointAction.java;2;1;9;1;2;2;2;7;162;2;6;2761;240;240;2;1;0;7;9;3362;1;4025;8;2;
/org.eclipse.jdt.ui.tests.refactoring/resources/SelectionAnalyzerWorkSpace/SelectionAnalyzerTests/validSelection/A_test103_.java;2;0;2;1;0;0;0;2;0;1;2;2139;0;0;1;0;0;2;2;2139;0;2327;2;2;
/org.eclipse.debug.ui/ui/org/eclipse/debug/internal/ui/LaunchWithAction.java;3;0;8;1;0;0;0;8;51;1;8;187;142;142;1;0;0;8;8;187;0;2382;8;3;
/org.eclipse.update/src/org/eclipse/update/internal/ui/UMWizardPageLaunchHistory.java;1;0;1;1;0;0;0;1;0;0;1;1424;0;0;1;0;0;1;1;1424;0;1424;1;1;
/org.eclipse.jdt.ui.tests.refactoring/resources/ExtractMethodWorkSpace/ExtractMethodTests/locals_out/A_test516.java;2;1;5;1;2;2;2;3;21;1;3;369;23;23;1;0;0;3;5;369;0;4419;5;2;
/org.eclipse.pde.build/src/plugin/org/eclipse/pde/internal/core/AbstractBuildScriptGenerator.java;1;0;1;1;0;0;0;1;0;0;1;3475;0;0;1;0;0;1;1;3475;0;3475;1;1;
/org.eclipse.ui/Eclipse UI Standard Components/org/eclipse/ui/views/tasklist/GotoTaskAction.java;5;0;8;1;1;1;1;7;27;1;7;257;49;49;1;0;0;7;8;257;0;4269;8;5;
/org.eclipse.swt/Eclipse SWT PI/win32/org/eclipse/swt/internal/win32/RECT.java;2;0;2;1;1;1;1;1;6;0;1;2069;6;6;1;0;0;1;2;2069;0;4701;2;2;
/org.eclipse.jdt.core/compiler/org/eclipse/jdt/internal/compiler/impl/CompilerOptions.java;2;2;26;2;4;3;4;22;4380;4;17;455;9546;9546;4;5;1;22;26;1039;6;4419;20;2;
/org.eclipse.update/Eclipse Update/org/eclipse/update/internal/core/UMSessionManagerParcel.java;1;0;3;1;0;0;0;3;12;1;3;108;12;12;1;0;0;3;3;108;0;1424;3;1;
/org.eclipse.jdt.debug.ui/ui/org/eclipse/jdt/internal/debug/ui/snippeteditor/JavaSnippetEditor.java;4;2;55;3;10;9;10;45;122;3;37;1915;1017;1017;3;8;1;45;55;2343;9;4550;46;4;
/org.eclipse.pde.ui/src/org/eclipse/pde/internal/wizards/templates/PluginCodeGeneratorWizard.java;1;0;2;1;0;0;0;2;0;1;2;3240;0;0;1;0;0;2;2;3240;0;3579;2;1;
/org.eclipse.jdt.ui.tests.refactoring/resources/InlineTemp/cannotInline/A_testFail2.java;1;0;1;1;0;0;0;1;0;0;1;2015;0;0;1;0;0;1;1;2015;0;2015;1;1;
/org.eclipse.jdt.ui/ui/org/eclipse/jdt/ui/actions/ModifyParametersAction.java;3;2;10;2;10;8;10;0;128;0;0;3970;189;189;2;0;2;0;10;4382;2;4852;8;3;
/org.eclipse.scripting/src/org/eclipse/scripting/internal/IXGRDataChangedListener.java;1;0;1;1;0;0;0;1;0;0;1;1424;0;0;1;0;0;1;1;1424;0;1424;1;1;
/org.eclipse.jdt.junit/Eclipse JUnit/org/eclipse/jdt/internal/junit/ui/FilterPatternsDialog.java;2;0;3;1;0;0;0;3;10;1;3;2007;10;10;1;0;0;3;3;2007;0;3313;3;2;
/org.eclipse.jdt.ui.tests.refactoring/resources/RenameMethodInInterface/test15/in/A.java;1;0;1;1;0;0;0;1;0;0;1;49;0;0;1;0;0;1;1;49;0;49;1;1;
/org.eclipse.debug.ui/ui/org/eclipse/debug/internal/ui/InspectItem.java;3;0;3;1;0;0;0;3;5;1;3;187;5;5;1;0;0;3;3;187;0;2350;3;3;
/org.eclipse.swt.tests/JUnit Tests/org/eclipse/swt/tests/junit/Test_org_eclipse_swt_custom_TextChangeListener.java;3;0;3;1;1;1;1;2;75;1;2;1792;81;81;1;0;0;2;3;1792;0;4706;3;3;
/org.eclipse.pde.core/src/org/eclipse/pde/internal/core/ischema/ISchemaType.java;1;0;1;1;0;0;0;1;0;0;1;3591;0;0;1;0;0;1;1;3591;0;3591;1;1;
/org.eclipse.jdt.core/batch/org/eclipse/jdt/internal/compiler/batch/Main.java;2;1;52;2;3;3;3;49;2598;4;39;455;8363;8363;4;10;0;49;52;1039;10;4655;42;2;
/org.eclipse.ui/Eclipse UI Standard Components/org/eclipse/ui/wizards/datatransfer/Base64Encoder.java;2;0;2;1;0;0;0;2;11;1;2;257;11;11;1;0;0;2;2;257;0;457;2;2;
/org.eclipse.jdt.ui.tests.refactoring/resources/SelectionAnalyzerWorkSpace/SelectionAnalyzerTests/invalidSelection/A_test031.java;1;0;1;1;0;0;0;1;0;0;1;1368;0;0;1;0;0;1;1;1368;0;1368;1;1;
/org.eclipse.jdt.debug/jdi/org/eclipse/jdi/internal/ValueCache.java;2;0;3;1;0;0;0;3;47;1;3;187;59;59;1;0;0;3;3;187;0;2432;3;2;
/org.eclipse.jdt.core/model/org/eclipse/jdt/core/util/ILocalVariableTableEntry.java;2;1;5;1;4;4;4;1;21;0;1;3629;56;56;1;0;0;1;5;3629;0;4573;5;2;
/org.eclipse.jdt.ui.tests.refactoring/resources/PullUp/testFail6/in/B.java;1;0;1;1;0;0;0;1;0;0;1;2406;0;0;1;0;0;1;1;2406;0;2406;1;1;
/org.eclipse.jdt.core/search/org/eclipse/jdt/internal/core/index/impl/WordEntry.java;3;0;5;1;1;1;1;4;93;1;4;455;145;145;1;0;0;4;5;455;0;4063;5;3;
/org.eclipse.jdt.ui/core extension/org/eclipse/jdt/internal/corext/codemanipulation/ChangeVisibilityEdit.java;2;0;8;1;0;0;0;8;16;2;7;1937;43;43;2;1;0;8;8;2133;1;3700;7;2;
/org.eclipse.team.ui/src/org/eclipse/team/internal/ui/target/SiteLazyContentProvider.java;3;3;4;2;4;2;4;0;10;0;0;4164;18;18;3;0;2;0;4;4164;2;4245;2;3;
/org.eclipse.ui.tests/Eclipse UI Tests/org/eclipse/ui/tests/zoom/ZoomTestSuite.java;1;0;1;1;0;0;0;1;0;0;1;3633;0;0;1;0;0;1;1;3633;0;3633;1;1;
/org.eclipse.pde.ui/src/org/eclipse/pde/internal/schema/MappedSchemaDescriptor.java;2;0;3;1;0;0;0;3;4;1;3;1434;4;4;1;0;0;3;3;1434;0;3579;3;2;
/org.eclipse.update.ui/src/org/eclipse/update/internal/ui/parts/UpdateSection.java;1;0;4;1;0;0;0;4;5;1;4;1428;7;7;1;0;0;4;4;1428;0;3662;4;1;
/org.eclipse.ui.examples.propertysheet/Eclipse UI Examples PropertySheet/org/eclipse/ui/examples/propertysheet/PropertySheetContentOutlinePage.java;2;0;4;1;1;1;1;3;24;1;3;931;48;48;1;0;0;3;4;931;0;4324;4;2;
/org.eclipse.jdt.ui.tests.refactoring/resources/ExtractMethodWorkSpace/ExtractMethodTests/locals_out/A_test502.java;2;1;4;1;2;2;2;2;28;1;2;80;30;30;1;0;0;2;4;80;0;4419;4;2;
/org.eclipse.pde.ui/src/org/eclipse/pde/internal/preferences/ExternalPluginsEditor.java;2;0;9;1;0;0;0;9;108;2;8;1434;128;128;2;1;0;9;9;3213;1;3579;8;2;
/org.eclipse.help.ui/src/org/eclipse/help/ui/internal/util/BrowserLog.java;1;0;1;1;1;1;1;0;0;0;0;4673;0;0;1;0;0;0;1;4673;0;4673;1;1;
/org.eclipse.webdav/src/interface/org/eclipse/webdav/dom/Property.java;2;0;4;1;1;1;1;3;84;1;3;12;111;111;1;0;0;3;4;12;0;4211;4;2;
/org.eclipse.help/src/org/eclipse/help/internal/protocols/search/SearchURL.java;3;0;4;1;0;0;0;4;160;1;4;2318;160;160;1;0;0;4;4;2318;0;2694;4;3;
/org.eclipse.pde.ui/src/org/eclipse/pde/internal/wizards/imports/PluginImportOperation.java;1;0;11;1;0;0;0;11;394;1;11;2522;621;621;1;0;0;11;11;2522;0;3579;11;1;
/org.eclipse.ui/Eclipse UI/org/eclipse/ui/internal/registry/PerspectiveExtensionReader.java;3;0;4;1;0;0;0;4;62;1;4;257;126;126;1;0;0;4;4;257;0;3795;4;3;
/org.eclipse.swt/Eclipse SWT/common/org/eclipse/swt/events/ShellListener.java;4;0;5;1;1;1;1;4;6;1;4;106;18;18;1;0;0;4;5;106;0;4701;5;4;
/org.eclipse.ui/Eclipse UI/org/eclipse/ui/internal/dialogs/NewWizard.java;2;0;2;1;0;0;0;2;20;1;2;257;20;20;1;0;0;2;2;257;0;457;2;2;
/org.eclipse.scripting/Eclipse Scripting/org/eclipse/scripting/internal/views/ScriptUIEditorLayout.java;2;0;4;1;0;0;0;4;7;1;4;133;11;11;1;0;0;4;4;133;0;1424;4;2;
/org.eclipse.jdt.ui.tests.refactoring/resources/RenamePrivateField/testFail7/in/A.java;1;0;1;1;0;0;0;1;0;0;1;1547;0;0;1;0;0;1;1;1547;0;1547;1;1;
/org.eclipse.jdt.ui.tests.refactoring/resources/ExtractMethodWorkSpace/ExtractMethodTests/invalidSelection/A_test116.java;1;1;3;1;2;2;2;1;0;0;1;3106;0;0;1;0;0;1;3;3106;0;4419;3;1;
/org.eclipse.jdt.debug/eval/org/eclipse/jdt/debug/eval/model/IThread.java;2;0;2;1;0;0;0;2;0;1;2;3421;0;0;1;0;0;2;2;3421;0;3555;2;2;
/org.eclipse.jdt.debug/eval/org/eclipse/jdt/internal/debug/eval/ast/JDIStackFrameToMagicSourceMapper.java;1;0;2;1;0;0;0;2;0;1;2;3329;0;0;1;0;0;2;2;3329;0;3344;2;1;
/org.eclipse.core.tests.runtime/src/org/eclipse/core/tests/plugintests/PluginFindTests.java;2;1;3;1;3;3;3;0;729;0;0;3898;879;879;1;0;0;0;3;3898;0;4552;3;2;
/org.eclipse.pde.ui/src/org/eclipse/pde/internal/base/model/build/IBuildModel.java;2;0;2;1;0;0;0;2;0;1;2;1434;0;0;1;0;0;2;2;1434;0;3039;2;2;
/org.eclipse.jdt.core/eval/org/eclipse/jdt/internal/eval/GlobalVariable.java;2;0;11;1;1;1;1;10;104;4;6;455;182;182;4;4;0;10;11;1039;4;4062;7;2;
/org.eclipse.jdt.ui/ui/org/eclipse/jdt/internal/ui/text/correction/ReorgEvaluator.java;2;0;7;1;0;0;0;7;36;2;6;3308;87;87;2;1;0;7;7;3528;1;3528;6;2;
/org.eclipse.help/src/org/eclipse/help/internal/util/HelpLogListener.java;2;0;5;1;0;0;0;5;112;1;5;1420;133;133;1;0;0;5;5;1420;0;3609;5;2;
/org.eclipse.swt/Eclipse SWT Printing/photon/org/eclipse/swt/printing/Printer.java;5;1;6;1;2;2;2;4;216;1;4;135;318;318;1;0;0;4;6;135;0;4701;6;5;
/org.eclipse.team.cvs.ui/src/org/eclipse/team/internal/ccvs/ui/wizards/ConfigurationWizard.java;2;0;10;2;0;0;0;10;202;2;9;1978;423;423;2;1;0;10;10;2433;1;2577;9;2;
/org.eclipse.ui/Eclipse UI/org/eclipse/ui/internal/WorkingSet.java;1;1;10;1;4;4;4;6;193;2;5;3287;342;342;2;1;0;6;10;3576;1;4675;9;1;
/org.eclipse.team.cvs.core/src/org/eclipse/team/internal/ccvs/core/resources/RemoteManagedFolder.java;2;0;3;1;0;0;0;3;39;2;2;1978;39;39;2;1;0;3;3;2032;1;2032;2;2;
/org.eclipse.jdt.ui/core refactoring/org/eclipse/jdt/internal/core/refactoring/nls/NLSSubstitution.java;2;0;2;1;0;0;0;2;0;1;2;1922;0;0;1;0;0;2;2;1922;0;1939;2;2;
/org.eclipse.pde.ui/src/org/eclipse/pde/internal/ui/view/PluginsContentProvider.java;1;0;4;1;2;1;2;2;23;1;2;3579;24;24;2;0;1;2;4;4751;1;4751;3;1;
/org.eclipse.jdt.debug/eval/org/eclipse/jdt/internal/debug/eval/ast/engine/PushThis.java;1;0;3;1;0;0;0;3;64;1;3;3329;64;64;1;0;0;3;3;3329;0;3421;3;1;
/org.eclipse.jdt.junit/src/org/eclipse/jdt/internal/junit/runner/MessageIds.java;2;0;3;1;1;1;1;2;30;1;2;3171;32;32;1;0;0;2;3;3171;0;4341;3;2;
/org.eclipse.jdt.ui.tests.refactoring/resources/RenameType/test30/in/A.java;1;0;1;1;0;0;0;1;0;0;1;49;0;0;1;0;0;1;1;49;0;49;1;1;
/org.eclipse.jdt.ui.tests.refactoring/resources/ExtractMethodWorkSpace/ExtractMethodTests/locals_in/A_test564.java;1;1;3;1;2;2;2;1;26;0;1;2580;26;26;1;0;0;1;3;2580;0;4419;3;1;
/org.eclipse.update/Eclipse Update/org/eclipse/update/internal/core/UMSessionDefinerReferenceUpdate.java;2;0;6;2;0;0;0;6;25;2;5;108;33;33;2;1;0;6;6;324;1;1424;5;2;
/org.eclipse.team.cvs.core/src/org/eclipse/team/internal/ccvs/core/connection/Connection.java;3;0;14;1;1;1;1;13;724;1;13;1978;2425;2425;1;0;0;13;14;1978;0;3897;14;3;
/org.eclipse.pde.ui/src/org/eclipse/pde/internal/core/ischema/ISchemaComplexType.java;1;0;2;1;0;0;0;2;0;1;2;3591;0;0;1;0;0;2;2;3591;0;3607;2;1;
/org.eclipse.swt.examples/Eclipse SWT Examples/common/org/eclipse/swt/examples/controlexample/ScrollableTab.java;1;0;2;1;0;0;0;2;0;1;2;107;0;0;1;0;0;2;2;107;0;611;2;1;
/org.eclipse.jdt.debug/eval/org/eclipse/jdt/internal/debug/eval/model/IObject.java;2;0;2;1;0;0;0;2;0;1;2;3555;0;0;1;0;0;2;2;3555;0;3645;2;2;
/org.eclipse.ui/Eclipse UI/org/eclipse/ui/internal/WorkbenchHistory.java;1;0;1;1;0;0;0;1;0;0;1;941;0;0;1;0;0;1;1;941;0;941;1;1;
/org.eclipse.ui/Eclipse UI Standard Components/org/eclipse/ui/views/navigator/ActionContributionFactory.java;1;0;2;1;0;0;0;2;0;1;2;1726;0;0;1;0;0;2;2;1726;0;1757;2;1;
/org.eclipse.debug.ui/ui/org/eclipse/debug/internal/ui/LaunchWizardDialog.java;2;0;4;1;0;0;0;4;19;1;4;187;24;24;1;0;0;4;4;187;0;3634;4;2;
/org.eclipse.jdt.ui.tests.refactoring/resources/RenameNonPrivateField/testFail2/in/A.java;1;0;1;1;0;0;0;1;0;0;1;49;0;0;1;0;0;1;1;49;0;49;1;1;
/org.eclipse.webdav/src/client/org/eclipse/webdav/client/Policy.java;3;1;8;1;2;2;2;6;168;1;6;400;248;248;1;0;0;6;8;400;0;4228;8;3;
/org.eclipse.search/search/org/eclipse/search/internal/ui/CopyToClipboardActionDelegate.java;1;0;4;1;0;0;0;4;4;1;4;1117;6;6;1;0;0;4;4;1117;0;1670;4;1;
/org.eclipse.jdt.ui/ui/org/eclipse/jdt/internal/ui/text/template/ModelEvaluator.java;1;0;3;1;0;0;0;3;7;1;3;1587;7;7;1;0;0;3;3;1587;0;1720;3;1;
/org.eclipse.help.tests/src/org/eclipse/help/tests/launching/DisplayHelpResource_IContext_x_y.java;1;0;1;1;1;1;1;0;0;0;0;4045;0;0;1;0;0;0;1;4045;0;4045;1;1;
/org.eclipse.pde.ui/src/org/eclipse/pde/internal/ui/editor/StreamDocumentProvider.java;1;0;1;1;1;1;1;0;0;0;0;4067;0;0;1;0;0;0;1;4067;0;4067;1;1;
/org.eclipse.pde.core/src/org/eclipse/pde/internal/core/ifeature/IVersonable.java;1;0;1;1;0;0;0;1;0;0;1;3591;0;0;1;0;0;1;1;3591;0;3591;1;1;
/org.eclipse.jdt.debug.ui/ui/org/eclipse/jdt/internal/debug/ui/JDIImageDescriptor.java;2;2;7;1;3;2;3;4;136;1;4;2789;211;211;2;0;1;4;7;4193;1;4193;6;2;
/org.eclipse.ui/Eclipse UI/org/eclipse/ui/internal/ClosePageAction.java;4;0;4;1;0;0;0;4;10;1;4;257;12;12;1;0;0;4;4;257;0;3103;4;4;
/org.eclipse.team.ui/src/org/eclipse/team/internal/ui/sync/MergeResource.java;1;1;5;1;2;2;2;3;35;2;2;2054;58;58;2;1;0;3;5;2231;1;4125;4;1;
/org.eclipse.jdt.ui/ui/org/eclipse/jdt/internal/ui/javaeditor/ClassFileEditor.java;8;4;38;3;15;11;15;23;463;2;20;15;1569;1569;4;3;4;23;38;4036;7;4764;31;8;
/org.eclipse.jdt.ui.tests.refactoring/resources/ExtractMethodWorkSpace/ExtractMethodTests/invalidSelection/A_test146.java;1;1;3;1;2;2;2;1;32;0;1;887;32;32;1;0;0;1;3;887;0;4419;3;1;
/org.eclipse.jdt.ui.tests/JUnit/junit/extensions/TestSetup.java;2;0;2;1;0;0;0;2;0;1;2;49;0;0;1;0;0;2;2;49;0;1186;2;2;
/org.eclipse.team.cvs.ui/src/org/eclipse/team/internal/ccvs/ui/HistoryFilter.java;3;0;4;1;1;1;1;3;126;1;3;3380;140;140;1;0;0;3;4;3380;0;4545;4;3;
/org.eclipse.core.resources/src/org/eclipse/core/internal/indexing/IndexedStoreObject.java;3;1;6;1;2;2;2;4;164;1;4;12;326;326;1;0;0;4;6;12;0;4632;6;3;
/org.eclipse.swt/Eclipse SWT/emulated/coolbar/org/eclipse/swt/widgets/CoolBar.java;4;2;23;2;11;10;11;12;686;3;9;1947;1834;1834;3;3;1;12;23;1989;4;4701;19;4;
/org.eclipse.swt/Eclipse SWT/win32/org/eclipse/swt/internal/win32/TRIVERTEX.java;2;0;2;1;0;0;0;2;0;1;2;1088;0;0;1;0;0;2;2;1088;0;2069;2;2;
/org.eclipse.ui/Eclipse UI/org/eclipse/ui/actions/NewWizardMenu.java;2;0;6;1;0;0;0;6;7;1;6;457;24;24;1;0;0;6;6;457;0;3724;6;2;
/org.eclipse.vcm.core.cvs/src/org/eclipse/vcm/internal/core/ccvs/client/CVSException.java;2;0;2;1;0;0;0;2;14;1;2;0;14;14;1;0;0;2;2;0;0;298;2;2;
/org.eclipse.webdav/src/kernel/org/eclipse/webdav/internal/kernel/Locator.java;2;1;5;1;2;2;2;3;192;1;3;1635;316;316;1;0;0;3;5;1635;0;4448;5;2;
/org.eclipse.search/search/org/eclipse/search/internal/workingsets/WorkingSetReader.java;1;0;4;1;0;0;0;4;61;1;4;1725;63;63;1;0;0;4;4;1725;0;3849;4;1;
/org.eclipse.swt/Eclipse SWT/photon/org/eclipse/swt/internal/photon/PtColorSelectInfo_t.java;2;0;3;1;0;0;0;3;6;1;3;106;6;6;1;0;0;3;3;106;0;2069;3;2;
/org.eclipse.ui/Eclipse UI Tool Script/org/eclipse/toolscript/core/internal/ToolScriptBuilder.java;1;1;5;1;5;5;5;0;17;0;0;3920;28;28;1;0;0;0;5;3920;0;4087;5;1;
/org.eclipse.jdt.debug/model/org/eclipse/jdt/internal/debug/pattern/PatternDebugModel.java;1;0;1;1;0;0;0;1;0;0;1;971;0;0;1;0;0;1;1;971;0;971;1;1;
/org.eclipse.pde.ui/src/org/eclipse/pde/internal/ui/model/ifeature/IFeatureURLElement.java;1;0;2;1;0;0;0;2;0;1;2;3579;0;0;1;0;0;2;2;3579;0;3591;2;1;
/org.eclipse.jdt.ui.tests.refactoring/resources/PullUpMethods/test4/in/B.java;1;0;2;1;0;0;0;2;0;1;2;2156;0;0;1;0;0;2;2;2156;0;2406;2;1;
/org.eclipse.jdt.ui.tests.refactoring/resources/RenameParameters/cannotRename/A_testFail9.java;1;0;1;1;0;0;0;1;0;0;1;233;0;0;1;0;0;1;1;233;0;233;1;1;
/org.eclipse.pde.ui/src/org/eclipse/pde/internal/ui/editor/feature/FeaturePropertySource.java;1;0;3;1;1;1;1;2;52;1;2;3579;54;54;1;0;0;2;3;3579;0;4067;3;1;
/org.eclipse.jdt.core/model/org/eclipse/jdt/internal/core/FailedReconciliationException.java;2;0;4;1;1;1;1;3;28;1;3;455;48;48;1;0;0;3;4;455;0;4063;4;2;
/org.eclipse.jdt.junit/Eclipse JUnit/org/eclipse/jdt/internal/junit/ui/TestRunnerViewPart.java;2;0;11;1;0;0;0;11;730;2;9;2007;921;921;2;2;0;11;11;2025;2;3313;9;2;
/org.eclipse.ui/Eclipse JFace/org/eclipse/jface/action/Separator.java;2;0;2;1;0;0;0;2;5;1;2;257;5;5;1;0;0;2;2;257;0;457;2;2;
/org.eclipse.ui/Eclipse UI/org/eclipse/ui/IPlaceholderFolderLayout.java;1;0;1;1;0;0;0;1;0;0;1;3528;0;0;1;0;0;1;1;3528;0;3528;1;1;
/org.eclipse.jdt.ui.tests.refactoring/resources/RenameMethodInInterface/test37/in/A.java;1;0;1;1;0;0;0;1;0;0;1;49;0;0;1;0;0;1;1;49;0;49;1;1;
/org.eclipse.jdt.ui/ui/org/eclipse/jdt/ui/actions/OpenSuperImplementationAction.java;3;2;15;2;8;7;8;7;56;2;6;3533;168;168;2;1;1;7;15;3641;2;4770;13;3;
/org.eclipse.jdt.core/dom/org/eclipse/jdt/core/dom/ASTConverter.java;3;1;57;2;8;8;8;49;313;7;30;2669;1737;1737;7;19;0;49;57;3083;19;4764;38;3;
/org.eclipse.jdt.ui.tests.refactoring/resources/ExtractMethodWorkSpace/ExtractMethodTests/try_in/A_test455.java;2;1;3;1;2;2;2;1;10;0;1;511;10;10;1;0;0;1;3;511;0;4419;3;2;
/org.eclipse.pde.ui/src/org/eclipse/pde/internal/view/PluginsViewAdapterFactory.java;1;0;2;1;0;0;0;2;0;1;2;3446;0;0;1;0;0;2;2;3446;0;3579;2;1;
/org.eclipse.swt/Eclipse SWT PI/win32/org/eclipse/swt/internal/ole/win32/IFont.java;2;0;2;1;1;1;1;1;6;0;1;2069;6;6;1;0;0;1;2;2069;0;4701;2;2;
/org.eclipse.debug.ui/ui/org/eclipse/debug/internal/ui/launchConfigurations/LaunchHistoryPreferenceTab.java;3;1;11;1;2;2;2;9;78;2;8;3132;198;198;2;1;0;9;11;3132;1;3975;10;3;
/org.eclipse.jdt.ui/ui/org/eclipse/jdt/ui/actions/AddJavaDocStubAction.java;4;1;13;2;7;7;7;6;78;2;5;3533;169;169;2;1;0;6;13;3571;1;4770;12;4;
/org.eclipse.update/Eclipse Update/org/eclipse/update/internal/core/IUMLock.java;1;0;3;1;0;0;0;3;13;1;3;108;13;13;1;0;0;3;3;108;0;1424;3;1;
/org.eclipse.update.ui/src/org/eclipse/update/internal/ui/forms/InstallConfigurationForm.java;3;2;6;2;3;2;3;3;226;1;3;3662;238;238;2;0;1;3;6;4606;1;4606;5;3;
/org.eclipse.ui.externaltools/External Tools/org/eclipse/ui/externaltools/internal/ui/AntTasksPage.java;1;0;1;1;1;1;1;0;0;0;0;4123;0;0;1;0;0;0;1;4123;0;4123;1;1;
/org.eclipse.core.tests.runtime/src/org/eclipse/core/tests/internal/runtime/CipherStreamsTest.java;3;0;3;1;0;0;0;3;118;1;3;1794;128;128;1;0;0;3;3;1794;0;3476;3;3;
/org.eclipse.swt/Eclipse SWT Drag and Drop/gtk/org/eclipse/swt/dnd/FileTransfer.java;3;2;8;1;6;5;6;2;99;1;2;2107;168;168;2;0;1;2;8;4016;1;4824;7;3;
/org.eclipse.pde.ui/src/org/eclipse/pde/internal/ui/editor/schema/NewCompositorAction.java;1;0;3;1;1;1;1;2;2;1;2;3579;4;4;1;0;0;2;3;3579;0;4695;3;1;
/org.eclipse.swt/Eclipse SWT OLE Win32/win32/org/eclipse/swt/ole/win32/OLE.java;4;0;7;1;1;1;1;6;29;1;6;106;53;53;1;0;0;6;7;106;0;4701;7;4;
/org.eclipse.scripting/src/org/eclipse/scripting/internal/views/ScriptUIEditorJavaDocCompletionProcessor.java;1;0;1;1;0;0;0;1;0;0;1;1424;0;0;1;0;0;1;1;1424;0;1424;1;1;
/org.eclipse.tomcat/src/org/eclipse/tomcat/internal/TomcatAppServer.java;2;0;7;1;0;0;0;7;112;1;7;3285;160;160;1;0;0;7;7;3285;0;3777;7;2;
/org.eclipse.pde.ui/Eclipse PDE UI/org/eclipse/pde/internal/editor/component/SynchronizeVersionsWizardPage.java;2;0;7;2;0;0;0;7;12;3;5;267;25;25;3;2;0;7;7;324;2;1434;5;2;
/org.eclipse.jdt.debug/eval/org/eclipse/jdt/internal/debug/eval/ast/instructions/DivideAssignmentOperator.java;2;0;5;1;1;1;1;4;4;1;4;3421;10;10;1;0;0;4;5;3421;0;3955;5;2;
/org.eclipse.ui/Eclipse JFace/org/eclipse/jface/preference/IPreferenceNode.java;2;0;2;1;0;0;0;2;5;1;2;257;5;5;1;0;0;2;2;257;0;457;2;2;
/org.eclipse.help/Eclipse Help/org/eclipse/help/internal/contributions/Action.java;2;0;3;1;0;0;0;3;7;1;3;135;7;7;1;0;0;3;3;135;0;1420;3;2;
/org.eclipse.pde.ui/Eclipse PDE UI/org/eclipse/pde/internal/editor/manifest/NewElementAction.java;2;0;5;2;0;0;0;5;12;3;3;267;12;12;3;2;0;5;5;324;2;1434;3;2;
/org.eclipse.jdt.ui/core refactoring/org/eclipse/jdt/internal/corext/refactoring/rename/RefactoringAnalyzeUtil.java;1;2;8;1;4;3;4;4;21;1;4;3393;68;68;2;0;1;4;8;4014;1;4040;7;1;
/org.eclipse.jdt.ui/core refactoring/org/eclipse/jdt/internal/corext/refactoring/structure/TypeReferenceFinder.java;2;0;7;2;0;0;0;7;227;3;5;2737;238;238;3;2;0;7;7;3166;2;3188;5;2;
/org.eclipse.ui/Eclipse JFace/org/eclipse/jface/util/ListenerList.java;3;0;3;1;0;0;0;3;196;1;3;257;201;201;1;0;0;3;3;257;0;3642;3;3;
/org.eclipse.core.boot/src/org/eclipse/core/internal/boot/update/IURLNamePair.java;2;0;3;1;0;0;0;3;7;1;3;12;7;7;1;0;0;3;3;12;0;2726;3;2;
/org.eclipse.jdt.launching/launching/org/eclipse/jdt/internal/launching/RuntimeClasspathEntry.java;2;3;23;2;22;17;22;1;234;0;1;3856;859;859;3;0;5;1;23;3953;5;4625;18;2;
/org.eclipse.jdt.ui.tests.refactoring/resources/ExtractMethodWorkSpace/ExtractMethodTests/locals_in/A_test506.java;2;1;4;1;2;2;2;2;22;1;2;80;37;37;1;0;0;2;4;80;0;4419;4;2;
/org.eclipse.swt/Eclipse SWT PI/win32/org/eclipse/swt/internal/ole/win32/FUNCDESC2.java;2;0;2;1;1;1;1;1;6;0;1;2069;6;6;1;0;0;1;2;2069;0;4701;2;2;
/org.eclipse.jdt.core/model/org/eclipse/jdt/core/IMember.java;2;1;6;1;3;3;3;3;95;1;3;455;166;166;1;0;0;3;6;455;0;4421;6;2;
/org.eclipse.ui/Eclipse UI/org/eclipse/ui/internal/registry/ViewRegistryReader.java;3;0;3;1;0;0;0;3;13;1;3;257;16;16;1;0;0;3;3;257;0;620;3;3;
/org.eclipse.vcm.tests.core/src/org/eclipse/vcm/tests/core/ISyncComparator.java;1;0;1;1;0;0;0;1;0;0;1;1688;0;0;1;0;0;1;1;1688;0;1688;1;1;
/org.eclipse.swt/Eclipse SWT/photon/org/eclipse/swt/widgets/Group.java;6;1;12;1;4;4;4;8;75;2;7;106;133;133;2;1;0;8;12;2064;1;4701;11;6;
/org.eclipse.debug.ui/ui/org/eclipse/debug/internal/ui/preferences/RunHistoryPreferenceTab.java;1;0;2;1;2;1;2;0;1;0;0;4207;1;1;2;0;1;0;2;4207;1;4207;1;1;
/org.eclipse.swt/Eclipse SWT/gtk/org/eclipse/swt/widgets/TableColumn.java;5;1;9;1;5;5;5;4;36;1;4;2107;136;136;1;0;0;4;9;2107;0;4701;9;5;
/org.eclipse.help.ui/src/org/eclipse/help/ui/internal/search/HelpSearchPage.java;2;2;13;1;4;3;4;9;131;2;7;2429;535;535;2;2;1;9;13;2586;3;4439;10;2;
/org.eclipse.help/src/org/eclipse/help/IContext.java;2;0;5;1;1;1;1;4;8;1;4;1420;19;19;1;0;0;4;5;1420;0;3938;5;2;
/org.eclipse.vcm.core.cvs/src/org/eclipse/vcm/internal/core/ccvs/client/LocalServerConnection.java;2;0;2;1;0;0;0;2;0;1;2;0;0;0;1;0;0;2;2;0;0;136;2;2;
/org.eclipse.pde.ui/src/org/eclipse/pde/internal/model/component/ComponentFactory.java;2;0;2;1;0;0;0;2;0;1;2;1434;0;0;1;0;0;2;2;1434;0;2951;2;2;
/org.eclipse.jdt.ui.tests.refactoring/resources/MoveMembers/test0/in/A.java;1;0;1;1;0;0;0;1;0;0;1;2738;0;0;1;0;0;1;1;2738;0;2738;1;1;
/org.eclipse.swt/Eclipse SWT/gtk1x/org/eclipse/swt/widgets/Composite.java;4;0;5;1;1;1;1;4;14;1;4;2107;33;33;1;0;0;4;5;2107;0;4701;5;4;
/org.eclipse.swt/Eclipse SWT PI/gtk/org/eclipse/swt/internal/gtk/GdkEventFocus.java;2;0;3;1;2;1;2;1;7;0;1;3869;7;7;2;0;1;1;3;4701;1;4701;2;2;
/org.eclipse.pde.ui/src/org/eclipse/pde/internal/ui/parts/FormBrowser.java;1;0;1;1;0;0;0;1;0;0;1;3579;0;0;1;0;0;1;1;3579;0;3579;1;1;
/org.eclipse.swt/Eclipse SWT OLE Win32/win32/org/eclipse/swt/internal/ole/win32/COSERVERINFO.java;2;0;3;1;0;0;0;3;5;1;3;106;5;5;1;0;0;3;3;106;0;2069;3;2;
/org.eclipse.swt.examples/org/eclipse/swt/examples/controlexample/Images.java;2;0;3;1;0;0;0;3;50;1;3;513;50;50;1;0;0;3;3;513;0;970;3;2;
/org.eclipse.vcm.ui/src/org/eclipse/vcm/internal/ui/RepositoryView.java;6;0;23;2;0;0;0;23;90;2;19;1;410;410;2;4;0;23;23;31;4;1548;19;6;
/org.eclipse.swt/Eclipse SWT PI/photon/org/eclipse/swt/internal/photon/PtTreeItem_t.java;2;0;2;1;1;1;1;1;6;0;1;2069;6;6;1;0;0;1;2;2069;0;4701;2;2;
/org.eclipse.update.core/src/org/eclipse/update/core/ArchiveReference.java;2;0;5;1;0;0;0;5;36;1;5;2476;88;88;1;0;0;5;5;2476;0;3512;5;2;
/org.eclipse.jdt.ui.tests.refactoring/resources/MoveCU/test1/in/p/A.java;2;0;2;1;0;0;0;2;0;1;2;49;0;0;1;0;0;2;2;49;0;2769;2;2;
/org.eclipse.pde.ui/src/org/eclipse/pde/internal/schema/RepeatableSchemaObject.java;2;0;3;1;0;0;0;3;6;1;3;1434;6;6;1;0;0;3;3;1434;0;3579;3;2;
/org.eclipse.ui/Eclipse UI Standard Components/org/eclipse/ui/views/properties/ColorPropertyDescriptor.java;2;0;2;1;0;0;0;2;5;1;2;257;5;5;1;0;0;2;2;257;0;457;2;2;
/org.eclipse.webdav/src/interface/org/eclipse/webdav/Response.java;3;0;3;1;0;0;0;3;13;1;3;12;13;13;1;0;0;3;3;12;0;1874;3;3;
/org.eclipse.swt/Eclipse SWT Drag and Drop/win32/org/eclipse/swt/dnd/FileTransfer.java;2;1;6;1;3;3;3;3;66;1;3;106;172;172;1;0;0;3;6;106;0;4824;6;2;
/org.eclipse.pde.ui/src/org/eclipse/pde/internal/editor/schema/SchemaSourcePage.java;2;0;2;1;0;0;0;2;0;1;2;1434;0;0;1;0;0;2;2;1434;0;3579;2;2;
/org.eclipse.jdt.ui.tests.refactoring/resources/ExtractTemp/canExtract/A_test7_in.java;1;0;1;1;0;0;0;1;0;0;1;2481;0;0;1;0;0;1;1;2481;0;2481;1;1;
/org.eclipse.swt/Eclipse SWT/common/org/eclipse/swt/events/TreeListener.java;4;0;5;1;1;1;1;4;6;1;4;106;18;18;1;0;0;4;5;106;0;4701;5;4;
/org.eclipse.pde.ui/src/org/eclipse/pde/internal/ui/editor/manifest/ImportStatusSection.java;1;0;5;1;1;1;1;4;37;2;3;3579;46;46;2;1;0;4;5;3579;1;4428;4;1;
/org.eclipse.jdt.ui/ui/org/eclipse/jdt/internal/ui/launcher/ExecutionArgsPropertyPage.java;4;0;10;1;0;0;0;10;23;1;10;15;56;56;1;0;0;10;10;15;0;1916;10;4;
/org.eclipse.swt/Eclipse SWT/motif/org/eclipse/swt/widgets/ScrollBar.java;8;2;14;2;7;6;7;7;741;1;7;106;1654;1654;2;0;1;7;14;4669;1;4701;13;8;
/org.eclipse.jdt.ui.tests.refactoring/resources/RenameType/test56/in/B.java;1;0;1;1;0;0;0;1;0;0;1;1547;0;0;1;0;0;1;1;1547;0;1547;1;1;
/org.eclipse.pde.core/src/org/eclipse/pde/core/plugin/IPluginAttribute.java;1;0;3;1;2;1;2;1;30;0;1;3591;30;30;2;0;1;1;3;4751;1;4751;2;1;
/org.eclipse.jdt.ui/nls/org/eclipse/jdt/internal/ui/nls/model/NLSRefactoring.java;1;0;6;1;0;0;0;6;182;3;3;1880;227;227;3;3;0;6;6;1908;3;1908;3;1;
/org.eclipse.ui/Eclipse UI/org/eclipse/ui/internal/dialogs/ProductInfoDialog.java;1;1;2;1;2;2;2;0;23;0;0;4284;23;23;1;0;0;0;2;4284;0;4360;2;1;
/org.eclipse.team.tests.core/src/org/eclipse/team/tests/ftp/TestApplication.java;1;1;2;1;2;2;2;0;0;0;0;4169;0;0;1;0;0;0;2;4169;0;4186;2;1;
/org.eclipse.swt.tests/JUnit Tests/org/eclipse/swt/tests/junit/Test_org_eclipse_swt_widgets_Decorations.java;2;0;2;1;1;1;1;1;6;0;1;1792;6;6;1;0;0;1;2;1792;0;4706;2;2;
/org.eclipse.jdt.core/model/org/eclipse/jdt/internal/core/builder/impl/PathMap.java;1;0;10;1;0;0;0;10;117;4;6;455;243;243;4;4;0;10;10;1039;4;2808;6;1;
/org.eclipse.jdt.ui/core refactoring/org/eclipse/jdt/internal/core/refactoring/text/ITextBuffer.java;2;0;4;1;0;0;0;4;15;1;4;408;17;17;1;0;0;4;4;408;0;1939;4;2;
/org.eclipse.core.tests.resources/src/org/eclipse/core/tests/internal/indexing/BasicFieldTest.java;3;0;3;1;1;1;1;2;284;1;2;1794;294;294;1;0;0;2;3;1794;0;4516;3;3;
/org.eclipse.swt/Eclipse SWT Custom Widgets/common/org/eclipse/swt/custom/CTabFolderListener.java;3;0;4;1;1;1;1;3;6;1;3;106;14;14;1;0;0;3;4;106;0;4701;4;3;
/org.eclipse.update.ui.forms/src/org/eclipse/update/ui/forms/internal/engine/ITextSegment.java;1;0;6;1;1;1;1;5;4;2;4;2745;8;8;2;1;0;5;6;2745;1;4628;5;1;
/org.eclipse.swt.examples/Eclipse SWT Examples/common/org/eclipse/swt/examples/addressbook/DataEntryDialog.java;1;0;2;1;0;0;0;2;0;1;2;107;0;0;1;0;0;2;2;107;0;611;2;1;
/org.eclipse.pde.ui/src/org/eclipse/pde/internal/core/ischema/ISchemaEnumeration.java;1;0;2;1;0;0;0;2;0;1;2;3591;0;0;1;0;0;2;2;3591;0;3607;2;1;
/org.eclipse.jdt.debug/jdi interfaces/com/sun/jdi/PathSearchingVirtualMachine.java;2;0;2;1;0;0;0;2;6;1;2;2704;6;6;1;0;0;2;2;2704;0;3033;2;2;
/org.eclipse.swt/Eclipse SWT Custom Widgets/common/org/eclipse/swt/custom/ST.java;3;0;4;1;1;1;1;3;6;1;3;106;15;15;1;0;0;3;4;106;0;4701;4;3;
/org.eclipse.jdt.ui.tests.refactoring/resources/ExtractMethodWorkSpace/ExtractMethodTests/expression_in/A_test613.java;1;1;3;1;2;2;2;1;0;0;1;1236;0;0;1;0;0;1;3;1236;0;4419;3;1;
/org.eclipse.jdt.ui.tests.refactoring/resources/RenameType/test1/in/A.java;1;0;1;1;0;0;0;1;0;0;1;49;0;0;1;0;0;1;1;49;0;49;1;1;
/org.eclipse.jdt.ui/ui/org/eclipse/jdt/internal/ui/viewsupport/IReconciled.java;2;1;2;1;2;2;2;0;0;0;0;4138;0;0;1;0;0;0;2;4138;0;4212;2;2;
/org.eclipse.core.resources/src/org/eclipse/core/internal/localstore/FileStore.java;1;0;1;1;0;0;0;1;0;0;1;653;0;0;1;0;0;1;1;653;0;653;1;1;
/org.eclipse.update.core/src/org/eclipse/update/internal/model/SiteLocalParser.java;2;1;5;1;3;3;3;2;61;0;1;3027;107;107;2;1;0;2;5;3027;1;4342;4;2;
/org.eclipse.ui/Eclipse UI/org/eclipse/ui/internal/registry/CapabilityRegistry.java;1;0;15;1;0;0;0;15;107;2;13;3074;492;492;2;2;0;15;15;3269;2;3529;13;1;
/org.eclipse.pde.build/src/org/eclipse/pde/internal/build/types/StripMapper.java;1;0;3;1;0;0;0;3;70;1;3;2946;70;70;1;0;0;3;3;2946;0;3509;3;1;
/org.eclipse.ui/Eclipse UI/org/eclipse/ui/internal/EditorActionBars.java;5;1;14;1;7;7;7;7;43;1;7;257;173;173;1;0;0;7;14;257;0;4569;14;5;
/org.eclipse.update.core/src/org/eclipse/update/core/ISiteLocal.java;1;0;2;1;0;0;0;2;0;1;2;2010;0;0;1;0;0;2;2;2010;0;2017;2;1;
/org.eclipse.jdt.ui/ui/org/eclipse/jdt/internal/ui/reorg/INamingPolicy.java;2;0;3;1;0;0;0;3;7;1;3;15;7;7;1;0;0;3;3;15;0;1258;3;2;
/org.eclipse.ui/Eclipse UI/org/eclipse/ui/ResourceWorkingSetFilter.java;1;0;2;1;0;0;0;2;2;1;2;3494;2;2;1;0;0;2;2;3494;0;3831;2;1;
/org.eclipse.help/src/org/eclipse/help/internal/search/QueryBuilder.java;2;0;6;1;0;0;0;6;249;2;4;3186;439;439;2;2;0;6;6;3186;2;3342;4;2;
/org.eclipse.pde.ui/Eclipse PDE UI/org/eclipse/pde/internal/model/component/ComponentFactory.java;2;0;5;2;0;0;0;5;12;3;3;267;12;12;3;2;0;5;5;324;2;1434;3;2;
/org.eclipse.jdt.ui/ui/org/eclipse/jdt/internal/ui/dnd/JdtViewerDropAdapter.java;2;0;5;1;1;1;1;4;56;1;4;15;115;115;1;0;0;4;5;15;0;4400;5;2;
/org.eclipse.update.ui/src/org/eclipse/update/ui/internal/model/ChecklistJob.java;1;0;3;1;0;0;0;3;5;1;3;1526;5;5;1;0;0;3;3;1526;0;2781;3;1;
/org.eclipse.ui/Eclipse JFace/org/eclipse/jface/preference/PreferenceStore.java;4;0;5;1;0;0;0;5;8;2;4;257;17;17;2;1;0;5;5;3167;1;3167;4;4;
/org.eclipse.webdav/src/kernel/org/eclipse/webdav/internal/kernel/utils/EmptyEnumeration.java;1;0;4;1;1;1;1;3;44;1;3;12;64;64;1;0;0;3;4;12;0;4211;4;1;
/org.eclipse.swt.examples.controls/org/eclipse/swt/examples/controls/Tab.java;2;0;3;1;0;0;0;3;364;1;3;513;364;364;1;0;0;3;3;513;0;970;3;2;
/org.eclipse.update.ui/src/org/eclipse/update/ui/internal/manager/UpdateManager.java;1;0;2;1;0;0;0;2;0;0;1;1426;0;0;2;1;0;2;2;1426;1;1426;1;1;
/org.eclipse.jdt.ui.tests.refactoring/resources/ExtractMethodWorkSpace/ExtractMethodTests/validSelection/A_test309.java;2;1;3;1;2;2;2;1;0;0;1;49;0;0;1;0;0;1;3;49;0;4419;3;2;
/org.eclipse.jdt.core/compiler/org/eclipse/jdt/internal/compiler/CompilationResult.java;2;1;16;1;8;8;8;8;325;2;7;455;525;525;2;1;0;8;16;3084;1;4421;15;2;
/org.eclipse.jdt.ui.tests.refactoring/resources/ExtractMethodWorkSpace/ExtractMethodTests/return_in/A_test702.java;1;1;3;1;2;2;2;1;14;0;1;887;14;14;1;0;0;1;3;887;0;4419;3;1;
/org.eclipse.team.cvs.ui/src/org/eclipse/team/internal/ccvs/ui/PromptingDialog.java;2;1;3;1;2;2;2;1;2;0;1;3760;2;2;1;0;0;1;3;3760;0;4256;3;2;
/org.eclipse.update.ui/src/org/eclipse/update/internal/ui/forms/DetailsHistory.java;1;0;1;1;0;0;0;1;0;0;1;3662;0;0;1;0;0;1;1;3662;0;3662;1;1;
/org.eclipse.vcm.core.cvs/src/org/eclipse/vcm/internal/core/ccvs/base/IServerConnection.java;3;0;3;1;0;0;0;3;16;1;3;168;18;18;1;0;0;3;3;168;0;1568;3;3;
/org.eclipse.jdt.ui/ui/org/eclipse/jdt/internal/ui/packageview/PackageFilter.java;3;0;4;1;1;1;1;3;7;1;3;15;14;14;1;0;0;3;4;15;0;4211;4;3;
/org.eclipse.ui/Eclipse UI/org/eclipse/ui/internal/WindowSelectionService.java;1;0;1;1;0;0;0;1;0;0;1;2999;0;0;1;0;0;1;1;2999;0;2999;1;1;
/org.eclipse.jdt.ui.tests/ui/org/eclipse/jdt/ui/tests/text/Test.java;1;0;1;1;1;1;1;0;0;0;0;4002;0;0;1;0;0;0;1;4002;0;4002;1;1;
/org.eclipse.jdt.ui/ui/org/eclipse/jdt/internal/ui/text/JavaPartitionScanner.java;3;0;9;1;1;1;1;8;53;1;8;15;111;111;1;0;0;8;9;15;0;4057;9;3;
/org.eclipse.core.resources/src/org/eclipse/core/resources/IResourceDelta.java;2;0;9;1;1;1;1;8;998;1;8;12;1168;1168;1;0;0;8;9;12;0;4214;9;2;
/org.eclipse.update.ui/src/org/eclipse/update/internal/ui/manager/UnknownObjectPage.java;1;0;2;1;0;0;0;2;0;1;2;2827;0;0;1;0;0;2;2;2827;0;3537;2;1;
/org.eclipse.jdt.ui.tests.refactoring/resources/RenamePackage/testFail11/in/p/p1/A.java;2;0;2;1;0;0;0;2;0;1;2;91;0;0;1;0;0;2;2;91;0;1258;2;2;
/org.eclipse.pde.ui/Eclipse PDE UI/org/eclipse/pde/internal/model/component/ComponentPlugin.java;2;0;6;2;0;0;0;6;12;3;4;267;14;14;3;2;0;6;6;324;2;1434;4;2;
/org.eclipse.jdt.ui.tests.refactoring/resources/ExtractMethodWorkSpace/ExtractMethodTests/locals_out/A_test508.java;2;1;5;1;2;2;2;3;36;1;3;95;69;69;1;0;0;3;5;95;0;4419;5;2;
/org.eclipse.ui.examples.propertysheet/Eclipse UI Examples PropertySheet/org/eclipse/ui/examples/propertysheet/OrganizationElement.java;2;0;2;1;0;0;0;2;2;1;2;931;2;2;1;0;0;2;2;931;0;946;2;2;
/org.eclipse.ui/Eclipse UI/org/eclipse/ui/internal/WorkbenchColors.java;4;0;5;1;0;0;0;5;81;1;5;257;134;134;1;0;0;5;5;257;0;2809;5;4;
/org.eclipse.jdt.ui/ui/org/eclipse/jdt/internal/ui/text/correction/CorrectPackageDeclarationProposal.java;4;1;11;1;3;3;3;8;18;1;8;3325;69;69;1;0;0;8;11;3325;0;4621;11;4;
/org.eclipse.jdt.ui.tests.refactoring/resources/RenameNonPrivateField/test1/in/A.java;1;0;1;1;0;0;0;1;0;0;1;49;0;0;1;0;0;1;1;49;0;49;1;1;
/org.eclipse.core.runtime/src/org/eclipse/core/runtime/NullProgressMonitor.java;3;0;4;1;1;1;1;3;206;1;3;12;226;226;1;0;0;3;4;12;0;4214;4;3;
/org.eclipse.ui.tests/Eclipse JFace Tests/org/eclipse/jface/tests/preferences/FontPreferenceTestCase.java;2;0;2;1;0;0;0;2;2;1;2;1755;2;2;1;0;0;2;2;1755;0;2785;2;2;
/org.eclipse.jdt.ui.tests.refactoring/resources/RenameVirtualMethodInClass/testFail38/in/A.java;1;0;1;1;0;0;0;1;0;0;1;49;0;0;1;0;0;1;1;49;0;49;1;1;
/org.eclipse.swt/Eclipse SWT/common_j2me/org/eclipse/swt/internal/EventListenerCompatibility.java;2;0;2;1;0;0;0;2;0;1;2;1434;0;0;1;0;0;2;2;1434;0;1561;2;2;
/org.eclipse.pde.ui/src/org/eclipse/pde/internal/builders/ExtensionPointSchemaBuilder.java;2;0;4;1;0;0;0;4;23;1;4;1434;24;24;1;0;0;4;4;1434;0;3579;4;2;
/org.eclipse.jdt.ui.tests/test plugin/org/eclipse/jdt/testplugin/util/AccessibilityTestPass.java;2;0;2;1;1;1;1;1;6;0;1;2180;6;6;1;0;0;1;2;2180;0;4682;2;2;
/org.eclipse.pde.ui/Eclipse PDE UI/org/eclipse/pde/internal/component/ComponentSpecPage.java;2;0;7;2;0;0;0;7;53;3;5;267;95;95;3;2;0;7;7;324;2;1434;5;2;
/org.eclipse.jdt.ui/ui/org/eclipse/jdt/internal/ui/actions/ImplementMethodQuery.java;1;0;2;1;0;0;0;2;0;1;2;2232;0;0;1;0;0;2;2;2232;0;2246;2;1;
/org.eclipse.jdt.debug/eval/org/eclipse/jdt/internal/debug/eval/ast/engine/PushBoolean.java;1;0;3;1;0;0;0;3;52;1;3;3329;52;52;1;0;0;3;3;3329;0;3421;3;1;
/org.eclipse.core.tests.resources/src/org/eclipse/core/tests/resources/usecase/ConcurrentOperation01.java;3;0;3;1;0;0;0;3;60;1;3;1794;70;70;1;0;0;3;3;1794;0;3475;3;3;
/org.eclipse.team.cvs.core/src/org/eclipse/team/internal/ccvs/core/client/FileInputStreamProvider.java;1;0;1;1;0;0;0;1;0;0;1;3226;0;0;1;0;0;1;1;3226;0;3226;1;1;
/org.eclipse.pde.ui/src/org/eclipse/pde/internal/ui/feature/BuildConsoleViewer.java;1;0;1;1;0;0;0;1;0;0;1;3579;0;0;1;0;0;1;1;3579;0;3579;1;1;
/org.eclipse.jdt.ui/ui/org/eclipse/jdt/internal/ui/reorg/MockUnifiedSite.java;2;0;4;2;0;0;0;4;15;2;3;3739;29;29;2;1;0;4;4;3826;1;3826;3;2;
/org.eclipse.pde.ui/Eclipse PDE UI/org/eclipse/pde/internal/forms/CustomWorkbook.java;2;0;8;2;0;0;0;8;12;3;6;267;18;18;3;2;0;8;8;324;2;1434;6;2;
/org.eclipse.swt.tests/JUnit Tests/org/eclipse/swt/tests/junit/Test_org_eclipse_swt_graphics_PaletteData.java;2;0;2;1;1;1;1;1;6;0;1;1792;6;6;1;0;0;1;2;1792;0;4706;2;2;
/org.eclipse.jdt.ui.tests.refactoring/resources/PullUpMethods/test1/out/A.java;1;0;3;1;0;0;0;3;3;1;3;2156;3;3;1;0;0;3;3;2156;0;2406;3;1;
/org.eclipse.swt/Eclipse SWT Custom Widgets/common_j2se/org/eclipse/swt/custom/BusyIndicator.java;1;0;1;1;0;0;0;1;0;0;1;1378;0;0;1;0;0;1;1;1378;0;1378;1;1;
/org.eclipse.pde.ui/src/org/eclipse/pde/internal/component/PluginListPage.java;2;0;3;1;0;0;0;3;2;1;3;1434;2;2;1;0;0;3;3;1434;0;2951;3;2;
/org.eclipse.ui/Eclipse UI/org/eclipse/ui/internal/dialogs/CheckboxSingleListGroup.java;4;0;5;1;0;0;0;5;5;1;5;257;13;13;1;0;0;5;5;257;0;2681;5;4;
/org.eclipse.core.tests.resources/src/org/eclipse/core/tests/resources/session/TestBug6995.java;2;0;3;1;0;0;0;3;204;1;3;2390;214;214;1;0;0;3;3;2390;0;3475;3;2;
/org.eclipse.pde.ui/src/org/eclipse/pde/internal/editor/feature/SynchronizeVersionsWizard.java;1;0;5;1;0;0;0;5;8;1;5;2951;12;12;1;0;0;5;5;2951;0;3579;5;1;
/org.eclipse.jdt.ui.tests.refactoring/resources/PullUp/testFail0/in/A.java;1;0;1;1;0;0;0;1;0;0;1;2406;0;0;1;0;0;1;1;2406;0;2406;1;1;
/org.eclipse.jdt.ui.tests.refactoring/resources/RenamePackage/testFail8/in/r/A.java;1;0;1;1;0;0;0;1;0;0;1;1258;0;0;1;0;0;1;1;1258;0;1258;1;1;
/org.eclipse.help/src/org/eclipse/help/internal/contributors/xml/XMLContextContributorCreator.java;2;0;2;1;0;0;0;2;0;1;2;1420;0;0;1;0;0;2;2;1420;0;1675;2;2;
/org.eclipse.pde.ui/src/org/eclipse/pde/internal/model/component/ComponentURLElement.java;2;0;2;1;0;0;0;2;0;1;2;1434;0;0;1;0;0;2;2;1434;0;2951;2;2;
/org.eclipse.swt.tests/JUnit Tests/org/eclipse/swt/tests/junit/Test_org_eclipse_swt_events_FocusEvent.java;2;0;2;1;1;1;1;1;6;0;1;1792;6;6;1;0;0;1;2;1792;0;4706;2;2;
/org.eclipse.jdt.ui/ui/org/eclipse/jdt/internal/ui/javaeditor/InspectAction.java;2;0;5;1;0;0;0;5;28;2;4;15;33;33;2;1;0;5;5;759;1;759;4;2;
/org.eclipse.jdt.ui/core codemanipulation/org/eclipse/jdt/internal/core/codemanipulation/IUndoTextEdits.java;1;0;2;1;0;0;0;2;0;1;2;1800;0;0;1;0;0;2;2;1800;0;1937;2;1;
/org.eclipse.jdt.ui.tests.refactoring/resources/PasteSourceReference/test3/out/B.java;1;0;1;1;1;1;1;0;2;0;0;4544;2;2;1;0;0;0;1;4544;0;4544;1;1;
/org.eclipse.vcm.core/src/org/eclipse/vcm/internal/core/base/IResourceEdition.java;4;0;5;1;0;0;0;5;42;1;5;0;71;71;1;0;0;5;5;0;0;297;5;4;
/org.eclipse.core.tests.runtime/src/org/eclipse/core/tests/internal/plugins/ParseHelper.java;3;0;3;1;0;0;0;3;76;1;3;1794;86;86;1;0;0;3;3;1794;0;3476;3;3;
/org.eclipse.update.tests.core/src/org/eclipse/update/tests/sitevalidation/AllSiteValidationTests.java;1;0;1;1;1;1;1;0;0;0;0;4191;0;0;1;0;0;0;1;4191;0;4191;1;1;
/org.eclipse.jdt.ui/ui/org/eclipse/jdt/ui/jarpackager/JarPackageData.java;3;1;13;1;4;4;4;9;869;2;6;3529;1186;1186;2;3;0;9;13;3529;3;4852;10;3;
/org.eclipse.ui/Eclipse UI Standard Components/org/eclipse/ui/views/navigator/NavigatorDropAdapter.java;6;1;12;1;5;5;5;7;762;2;6;257;1184;1184;2;1;0;7;12;1498;1;4630;11;6;
/org.eclipse.jdt.ui.tests.refactoring/resources/DeleteSourceReference/A_testField2_out.java;1;0;2;1;0;0;0;2;0;1;2;2003;0;0;1;0;0;2;2;2003;0;2857;2;1;
/org.eclipse.swt/Eclipse SWT PI/win32/org/eclipse/swt/internal/win32/SIZE.java;2;0;2;1;1;1;1;1;6;0;1;2069;6;6;1;0;0;1;2;2069;0;4701;2;2;
/org.eclipse.team.cvs.core/src/org/eclipse/team/internal/ccvs/core/client/MTHandler.java;1;0;2;1;0;0;0;2;4;1;2;3541;4;4;1;0;0;2;2;3541;0;3569;2;1;
/org.eclipse.jdt.debug/jdi interfaces/com/sun/jdi/event/ModificationWatchpointEvent.java;2;0;2;1;0;0;0;2;8;1;2;2704;8;8;1;0;0;2;2;2704;0;3040;2;2;
/org.eclipse.jdt.core/model/org/eclipse/jdt/internal/core/builder/IPackage.java;1;0;4;1;0;0;0;4;14;1;4;455;20;20;1;0;0;4;4;455;0;2808;4;1;
/org.eclipse.jdt.ui/core extension/org/eclipse/jdt/internal/corext/util/CodeFormatterUtil.java;3;0;7;2;1;1;1;6;264;4;3;3811;268;268;4;3;0;6;7;3825;3;4103;4;3;
/org.eclipse.pde.ui/src/org/eclipse/pde/internal/builders/SourceDOMParser.java;1;0;2;1;0;0;0;2;0;1;2;2730;0;0;1;0;0;2;2;2730;0;3579;2;1;
/org.eclipse.ui.tests/Eclipse UI Tests/org/eclipse/ui/tests/api/IViewSiteTest.java;1;0;1;1;0;0;0;1;0;0;1;1097;0;0;1;0;0;1;1;1097;0;1097;1;1;
/org.eclipse.pde.ui/src/org/eclipse/pde/internal/ui/preferences/RuntimeOption.java;1;0;2;1;0;0;0;2;0;1;2;3579;0;0;1;0;0;2;2;3579;0;3634;2;1;
/org.eclipse.pde.ui/src/org/eclipse/pde/internal/editor/feature/PluginReference.java;1;0;3;1;0;0;0;3;2;1;3;2951;2;2;1;0;0;3;3;2951;0;3579;3;1;
/org.eclipse.pde.core/src/org/eclipse/pde/internal/core/CoreSorter.java;1;0;1;1;0;0;0;1;0;0;1;3607;0;0;1;0;0;1;1;3607;0;3607;1;1;
/org.eclipse.scripting/Eclipse Scripting/org/eclipse/scripting/internal/views/ScriptDevelopmentPreferencePageWorkbenchAbstractWizard.java;2;0;5;1;0;0;0;5;29;1;5;133;39;39;1;0;0;5;5;133;0;1424;5;2;
/org.eclipse.jdt.ui.tests.refactoring/resources/PullUpMethods/testTemplate/out/A.java;1;0;2;1;0;0;0;2;0;1;2;2156;0;0;1;0;0;2;2;2156;0;2406;2;1;
/org.eclipse.jdt.ui/ui debug/org/eclipse/jdt/internal/debug/ui/display/DisplayResultCollector.java;2;0;4;1;0;0;0;4;12;1;4;1388;16;16;1;0;0;4;4;1388;0;1619;4;2;
/org.eclipse.pde.ui/src/org/eclipse/pde/internal/launcher/LauncherData.java;1;0;3;1;0;0;0;3;2;1;3;2593;2;2;1;0;0;3;3;2593;0;3579;3;1;
/org.eclipse.core.tests.resources/src/org/eclipse/core/tests/internal/resources/SimpleNature.java;1;0;1;1;0;0;0;1;0;0;1;3075;0;0;1;0;0;1;1;3075;0;3075;1;1;
/org.eclipse.jdt.debug.ui/ui/org/eclipse/jdt/internal/debug/ui/actions/DropToFrameAction.java;3;0;7;1;1;1;1;6;62;1;6;1915;110;110;1;0;0;6;7;1915;0;4552;7;3;
/org.eclipse.swt/Eclipse SWT/win32/org/eclipse/swt/widgets/CoolItem.java;7;2;27;1;11;9;11;16;143;3;13;106;655;655;3;3;2;16;27;3455;5;4701;22;7;
/org.eclipse.core.tests.runtime/src/org/eclipse/core/tests/internal/plugins/SoftPrereqTest_5.java;3;0;3;1;0;0;0;3;116;1;3;1794;126;126;1;0;0;3;3;1794;0;3476;3;3;
/org.eclipse.team.tests.core/src/org/eclipse/team/tests/core/TeamTest.java;2;2;10;1;8;6;8;2;158;0;1;3275;349;349;2;1;2;2;10;3275;3;4636;7;2;
/org.eclipse.jdt.ui.tests.refactoring/resources/PasteSourceReference/test3/in/A.java;1;0;1;1;1;1;1;0;0;0;0;4544;0;0;1;0;0;0;1;4544;0;4544;1;1;
/org.eclipse.pde.ui/src/org/eclipse/pde/ui/templates/ChoiceOption.java;1;0;2;1;1;1;1;1;36;0;1;3840;36;36;1;0;0;1;2;3840;0;4752;2;1;
/org.eclipse.compare/compare/org/eclipse/compare/internal/DocumentManager.java;1;0;1;1;0;0;0;1;0;0;1;3170;0;0;1;0;0;1;1;3170;0;3170;1;1;
/org.eclipse.jdt.ui.tests/JUnit/junit/framework/Protectable.java;2;0;2;1;0;0;0;2;0;1;2;49;0;0;1;0;0;2;2;49;0;1186;2;2;
/org.eclipse.jdt.ui.tests.refactoring/resources/ExtractMethodWorkSpace/ExtractMethodTests/expression_out/A_test618.java;1;1;3;1;2;2;2;1;22;0;1;1368;22;22;1;0;0;1;3;1368;0;4419;3;1;
/org.eclipse.update.ui.forms/src/org/eclipse/update/ui/forms/IFormWorkbook.java;1;0;2;1;0;0;0;2;0;1;2;1423;0;0;1;0;0;2;2;1423;0;2474;2;1;
/org.eclipse.ant.core/src/org/eclipse/ant/core/EclipseCompilerAdapterFactory.java;4;0;8;1;0;0;0;8;136;1;8;14;164;164;1;0;0;8;8;14;0;3489;8;4;
/org.eclipse.jdt.ui.tests.refactoring/resources/MultiMove/test0/out/p2/A.java;1;0;3;1;0;0;0;3;3;1;3;1157;5;5;1;0;0;3;3;1157;0;2682;3;1;
/org.eclipse.jdt.ui/ui refactoring/org/eclipse/jdt/internal/ui/refactoring/actions/StructuredSelectionProvider.java;2;0;2;1;0;0;0;2;0;1;2;1345;0;0;1;0;0;2;2;1345;0;1639;2;2;
/org.eclipse.jdt.ui/ui/org/eclipse/jdt/internal/ui/viewsupport/ContainerCheckedTreeViewer.java;4;1;4;1;2;2;2;2;388;1;2;2232;390;390;1;0;0;2;4;2232;0;4466;4;4;
/org.eclipse.swt.tests/JUnit Tests/org/eclipse/swt/tests/junit/Test_org_eclipse_swt_events_PaintListener.java;2;0;2;1;1;1;1;1;6;0;1;1792;6;6;1;0;0;1;2;1792;0;4706;2;2;
/org.eclipse.jdt.ui/core refactoring/org/eclipse/jdt/internal/core/refactoring/NullChange.java;3;0;7;1;0;0;0;7;8;1;7;15;19;19;1;0;0;7;7;15;0;1939;7;3;
/org.eclipse.help/src/org/eclipse/help/internal/toc/TocWriter.java;2;0;6;1;0;0;0;6;33;1;6;1857;87;87;1;0;0;6;6;1857;0;3697;6;2;
/org.eclipse.ui/Eclipse UI/org/eclipse/ui/internal/PagePartSelectionTracker.java;2;1;3;1;2;2;2;1;27;0;1;2999;37;37;1;0;0;1;3;2999;0;4747;3;2;
/org.eclipse.jdt.debug/eval/org/eclipse/jdt/internal/debug/eval/ast/instructions/ConditionalJump.java;3;0;6;1;0;0;0;6;4;1;6;3421;14;14;1;0;0;6;6;3421;0;3677;6;3;
/org.eclipse.debug.ui/ui/org/eclipse/debug/internal/ui/preferences/BooleanFieldEditor2.java;1;0;1;1;1;1;1;0;0;0;0;4594;0;0;1;0;0;0;1;4594;0;4594;1;1;
/org.eclipse.ui.examples.readmetool/Eclipse UI Examples Readme Tool/org/eclipse/ui/examples/readmetool/ReadmeFilePropertyPage2.java;3;0;4;1;0;0;0;4;18;2;3;932;20;20;2;1;0;4;4;945;1;3029;3;3;
/org.eclipse.scripting/src/org/eclipse/scripting/internal/uirenderer/ScriptViewport.java;1;0;1;1;0;0;0;1;0;0;1;1424;0;0;1;0;0;1;1;1424;0;1424;1;1;
/org.eclipse.scripting/src/org/eclipse/scripting/internal/ScriptReaderLineInputStream.java;1;0;1;1;0;0;0;1;0;0;1;1424;0;0;1;0;0;1;1;1424;0;1424;1;1;
/org.eclipse.help/src/org/eclipse/help/internal/topics/Topics.java;2;0;5;1;0;0;0;5;58;1;5;1675;117;117;1;0;0;5;5;1675;0;1857;5;2;
/org.eclipse.ui/Eclipse UI Standard Components/org/eclipse/ui/views/navigator/ShowInNavigatorAction.java;4;0;5;1;1;1;1;4;11;1;4;257;21;21;1;0;0;4;5;257;0;4429;5;4;
/org.eclipse.scripting/src/org/eclipse/scripting/internal/uirenderer/ScriptPreferenceViewer.java;1;0;1;1;0;0;0;1;0;0;1;1424;0;0;1;0;0;1;1;1424;0;1424;1;1;
/org.eclipse.core.tests.runtime/src/org/eclipse/core/tests/internal/runtimetests/SampleCPR.java;1;0;3;1;0;0;0;3;10;2;2;3605;13;13;2;1;0;3;3;3605;1;3678;2;1;
/org.eclipse.ui/Eclipse UI/org/eclipse/ui/internal/DefaultContributorResourceAdapter.java;1;0;1;1;0;0;0;1;0;0;1;2205;0;0;1;0;0;1;1;2205;0;2205;1;1;
/org.eclipse.jdt.debug/jdi interfaces/com/sun/jdi/request/ThreadStartRequest.java;2;0;2;1;0;0;0;2;8;1;2;2704;8;8;1;0;0;2;2;2704;0;3040;2;2;
/org.eclipse.jdt.ui.tests.refactoring/resources/ExtractTemp/canExtract/A_test32_out.java;1;0;1;1;0;0;0;1;0;0;1;3210;0;0;1;0;0;1;1;3210;0;3210;1;1;
/org.eclipse.jdt.ui/ui/org/eclipse/jdt/internal/ui/launcher/VMPropertyPage.java;4;0;15;1;0;0;0;15;97;2;12;15;308;308;2;3;0;15;15;218;3;1916;12;4;
/org.eclipse.compare/compare/org/eclipse/compare/internal/ResourceCompareInput.java;3;1;15;1;2;2;2;13;182;1;13;14;456;456;1;0;0;13;15;14;0;4741;15;3;
/org.eclipse.ui/Eclipse UI Standard Components/org/eclipse/ui/views/contentoutline/ContentOutlinePage.java;4;0;5;1;0;0;0;5;18;1;5;257;30;30;1;0;0;5;5;257;0;2641;5;4;
/org.eclipse.jdt.debug/jdi/org/eclipse/jdi/hcr/ReenterStepRequest.java;1;0;3;1;1;1;1;2;12;1;2;187;15;15;1;0;0;2;3;187;0;4423;3;1;
/org.eclipse.vcm.core/src/org/eclipse/vcm/internal/core/base/IStateId.java;2;0;2;1;0;0;0;2;5;1;2;0;5;5;1;0;0;2;2;0;0;297;2;2;
/org.eclipse.pde.ui/Eclipse PDE UI/org/eclipse/pde/internal/editor/manifest/ExportSection.java;2;0;6;2;0;0;0;6;12;3;4;267;13;13;3;2;0;6;6;324;2;1434;4;2;
/org.eclipse.jdt.ui.tests.refactoring/resources/MoveCU/test2/in/p/B.java;2;0;2;1;0;0;0;2;0;1;2;49;0;0;1;0;0;2;2;49;0;2769;2;2;
/org.eclipse.jdt.debug/eval/org/eclipse/jdt/internal/debug/eval/ast/instructions/MinusOperator.java;3;0;6;1;0;0;0;6;36;1;6;3421;48;48;1;0;0;6;6;3421;0;3677;6;3;
/org.eclipse.jdt.ui/ui debug/org/eclipse/jdt/internal/debug/ui/WatchpointAction.java;2;0;4;1;0;0;0;4;152;1;4;965;174;174;1;0;0;4;4;965;0;1916;4;2;
/org.eclipse.jdt.debug/jdi/org/eclipse/jdi/internal/request/EventRequestImpl.java;4;0;8;1;1;1;1;7;296;1;7;187;426;426;1;0;0;7;8;187;0;4426;8;4;
/org.eclipse.pde.core/src/org/eclipse/pde/internal/core/SourceLocation.java;1;0;2;1;2;1;2;0;2;0;0;4409;2;2;2;0;1;0;2;4409;1;4409;1;1;
/org.eclipse.swt.examples/Eclipse SWT Examples/common/org/eclipse/swt/examples/explorer/FileViewer.java;1;0;1;1;0;0;0;1;0;0;1;480;0;0;1;0;0;1;1;480;0;480;1;1;
/org.eclipse.swt/Eclipse SWT PI/win32/org/eclipse/swt/internal/win32/COMPOSITIONFORM.java;2;0;2;1;1;1;1;1;6;0;1;2069;6;6;1;0;0;1;2;2069;0;4701;2;2;
/org.eclipse.pde.ui/Eclipse PDE UI/org/eclipse/pde/internal/editor/manifest/JavaAttributeWizard.java;2;0;6;2;0;0;0;6;12;3;4;267;22;22;3;2;0;6;6;324;2;1434;4;2;
/org.eclipse.jdt.debug/eval/org/eclipse/jdt/internal/debug/eval/ast/engine/AndAssignmentOperator.java;1;0;2;1;0;0;0;2;0;1;2;3329;0;0;1;0;0;2;2;3329;0;3421;2;1;
/org.eclipse.jdt.ui/ui/org/eclipse/jdt/internal/ui/wizards/buildpaths/ClasspathContainerSelectionPage.java;1;1;2;1;2;2;2;0;0;0;0;4117;0;0;1;0;0;0;2;4117;0;4165;2;1;
/org.eclipse.jdt.ui/ui/org/eclipse/jdt/internal/ui/text/link/LinkedPositionMessages.java;1;0;1;1;0;0;0;1;0;0;1;1720;0;0;1;0;0;1;1;1720;0;1720;1;1;
/org.eclipse.jdt.core/compiler/org/eclipse/jdt/internal/compiler/impl/StringConstant.java;2;0;12;1;1;1;1;11;67;4;7;455;118;118;4;4;0;11;12;1039;4;4062;8;2;
/org.eclipse.jdt.ui.tests.refactoring/resources/SurroundWithWorkSpace/SurroundWithTests/trycatch_in/TestThrowInCatch.java;1;0;1;1;0;0;0;1;0;0;1;2684;0;0;1;0;0;1;1;2684;0;2684;1;1;
/org.eclipse.jdt.ui/ui refactoring/org/eclipse/jdt/internal/ui/refactoring/TextEditChangeElement.java;1;0;4;1;0;0;0;4;8;1;4;1800;14;14;1;0;0;4;4;1800;0;2512;4;1;
/org.eclipse.jdt.ui.tests.refactoring/resources/SurroundWithWorkSpace/SurroundWithTests/trycatch_in/TestInvalidParent2.java;1;0;1;1;0;0;0;1;0;0;1;2327;0;0;1;0;0;1;1;2327;0;2327;1;1;
/org.eclipse.jdt.ui.tests.refactoring/resources/ExtractMethodWorkSpace/ExtractMethodTests/validSelection_out/A_test360.java;1;1;3;1;2;2;2;1;22;0;1;2621;22;22;1;0;0;1;3;2621;0;4419;3;1;
/org.eclipse.jdt.ui.tests.refactoring/resources/RenameVariables/canRename/A_test28_in.java;1;0;2;1;0;0;0;2;0;1;2;724;0;0;1;0;0;2;2;724;0;1665;2;1;
/org.eclipse.jdt.ui.tests.refactoring/resources/SelectionAnalyzerWorkSpace/SelectionAnalyzerTests/invalidSelection/A_test121.java;2;0;2;1;0;0;0;2;0;1;2;1368;0;0;1;0;0;2;2;1368;0;2139;2;2;
/org.eclipse.help.ui/src/org/eclipse/help/ui/internal/search/SearchOperation.java;2;2;17;2;6;4;6;11;76;2;9;2429;244;244;2;2;2;11;17;3027;4;4439;13;2;
/org.eclipse.update.tests.core/src/org/eclipse/update/tests/UpdateTestsPlugin.java;1;0;9;1;0;0;0;9;62;3;6;2689;107;107;3;3;0;9;9;2868;3;3066;6;1;
/org.eclipse.swt/Eclipse SWT PI/win32/org/eclipse/swt/internal/win32/LVCOLUMN.java;2;0;2;1;1;1;1;1;6;0;1;2069;6;6;1;0;0;1;2;2069;0;4701;2;2;
/org.eclipse.jdt.ui/core refactoring/org/eclipse/jdt/internal/corext/refactoring/code/CodeRefactoringUtil.java;2;0;3;2;3;1;3;0;29;0;0;4420;29;29;3;0;2;0;3;4420;2;4420;1;2;
/org.eclipse.core.tests.resources/src/org/eclipse/core/tests/resources/session/TestSave.java;2;0;5;1;0;0;0;5;100;2;4;2289;117;117;2;1;0;5;5;2289;1;3475;4;2;
/org.eclipse.jdt.debug.ui/ui/org/eclipse/jdt/internal/debug/ui/actions/RunToLineAction.java;2;1;20;1;3;3;3;17;85;2;14;2056;371;371;2;3;0;17;20;2215;3;3935;17;2;
/org.eclipse.jdt.ui.tests.refactoring/resources/MoveMembers/testFail3/in/A.java;1;0;1;1;0;0;0;1;0;0;1;2738;0;0;1;0;0;1;1;2738;0;2738;1;1;
/org.eclipse.jdt.ui/ui refactoring/org/eclipse/jdt/internal/ui/nls/NLSSubstitutionContentProvider.java;1;0;2;1;0;0;0;2;0;1;2;1913;0;0;1;0;0;2;2;1913;0;1922;2;1;
/org.eclipse.ui/Eclipse UI/org/eclipse/ui/internal/PartPane.java;6;2;36;2;12;10;12;24;155;2;23;257;650;650;2;1;2;24;36;1828;3;4431;33;6;
/org.eclipse.jdt.ui.tests.refactoring/resources/ExtractMethodWorkSpace/ExtractMethodTests/return_out/A_test713.java;1;1;3;1;2;2;2;1;18;0;1;887;18;18;1;0;0;1;3;887;0;4419;3;1;
/org.eclipse.update.tests.core/src/org/eclipse/update/tests/regularInstall/TestDataEntryInstall.java;2;0;14;1;0;0;0;14;40;2;13;2008;82;82;2;1;0;14;14;2434;1;3433;13;2;
/org.eclipse.ui/Eclipse UI/org/eclipse/ui/internal/dialogs/ResourceTreeAndListGroup.java;3;0;17;2;0;0;0;17;119;2;13;457;333;333;2;4;0;17;17;1418;4;3678;13;3;
/org.eclipse.jdt.ui.tests.refactoring/resources/ExtractMethodWorkSpace/ExtractMethodTests/locals_in/A_test510.java;2;1;4;1;2;2;2;2;8;1;2;216;12;12;1;0;0;2;4;216;0;4419;4;2;
/org.eclipse.ui/Eclipse UI/org/eclipse/ui/actions/CopyResourceAction.java;7;0;10;1;2;1;2;8;1163;1;8;257;1283;1283;2;0;1;8;10;4264;1;4264;9;7;
/org.eclipse.pde.ui/src/org/eclipse/pde/internal/base/model/plugin/IPluginObject.java;2;0;5;1;0;0;0;5;8;1;5;1434;18;18;1;0;0;5;5;1434;0;3039;5;2;
/org.eclipse.pde.build/src/org/eclipse/pde/internal/build/BuildManifestToFetchConverter.java;1;0;2;1;1;1;1;1;0;0;1;3830;0;0;1;0;0;1;2;3830;0;4082;2;1;
/org.eclipse.help/Eclipse Help/org/eclipse/help/internal/contributors/InfosetsContributor.java;1;0;2;1;0;0;0;2;0;1;2;992;0;0;1;0;0;2;2;992;0;1420;2;1;
/org.eclipse.jdt.ui/ui/org/eclipse/jdt/internal/ui/SharedImages.java;2;0;3;1;0;0;0;3;35;1;3;15;43;43;1;0;0;3;3;15;0;1312;3;2;
/org.eclipse.swt.tests/JUnit Tests/org/eclipse/swt/tests/junit/Test_org_eclipse_swt_custom_TextChangingEvent.java;2;0;2;1;1;1;1;1;6;0;1;1792;6;6;1;0;0;1;2;1792;0;4706;2;2;
/org.eclipse.vcm.core/src/org/eclipse/vcm/internal/core/FileVersionHandle.java;4;0;8;1;0;0;0;8;35;3;6;0;79;79;3;2;0;8;8;199;2;297;6;4;
/org.eclipse.scripting/Eclipse Scripting/org/eclipse/scripting/internal/uirenderer/ScriptContributionNodeManager.java;2;0;4;1;0;0;0;4;12;1;4;133;14;14;1;0;0;4;4;133;0;1424;4;2;
/org.eclipse.ui/Eclipse UI/org/eclipse/ui/internal/PerspectiveHistory.java;4;0;7;1;0;0;0;7;96;3;5;1730;160;160;3;2;0;7;7;2271;2;3607;5;4;
/org.eclipse.pde.ui/src/org/eclipse/pde/internal/ui/editor/feature/FeatureEditorContributor.java;1;1;3;1;2;2;2;1;5;0;1;3579;10;10;1;0;0;1;3;3579;0;4269;3;1;
/org.eclipse.jdt.core/model/org/eclipse/jdt/internal/core/builder/impl/ArrayTypeHandleImpl.java;1;0;10;1;0;0;0;10;215;4;6;455;251;251;4;4;0;10;10;1039;4;2808;6;1;
/org.eclipse.ui/Eclipse JFace/org/eclipse/jface/action/SubContributionItem.java;3;0;4;1;0;0;0;4;21;1;4;257;38;38;1;0;0;4;4;257;0;3447;4;3;
/org.eclipse.jdt.ui/core extension/org/eclipse/jdt/internal/corext/codemanipulation/CodeGenerationSettings.java;2;0;4;1;1;1;1;3;12;1;3;2137;18;18;1;0;0;3;4;2137;0;4120;4;2;
/org.eclipse.pde.runtime/Eclipse PDE Runtime/org/eclipse/pde/internal/runtime/logview/StatusPropertyPage.java;2;0;4;1;0;0;0;4;12;1;4;267;16;16;1;0;0;4;4;267;0;1434;4;2;
/org.eclipse.ui/Eclipse JFace/org/eclipse/jface/wizard/IWizard.java;2;0;2;1;0;0;0;2;5;1;2;257;5;5;1;0;0;2;2;257;0;457;2;2;
/org.eclipse.pde.build/src/org/eclipse/pde/internal/build/ant/ITask.java;1;0;1;1;0;0;0;1;0;0;1;3672;0;0;1;0;0;1;1;3672;0;3672;1;1;
/org.eclipse.ui/Eclipse UI/org/eclipse/ui/internal/ShowViewMenu.java;6;2;11;2;3;2;3;8;360;1;8;257;555;555;2;0;1;8;11;4134;1;4429;10;6;
/org.eclipse.core.tests.resources.saveparticipant1/src/org/eclipse/core/tests/resources/saveparticipant1/SaveParticipant1Plugin.java;3;0;3;1;0;0;0;3;334;1;3;1794;344;344;1;0;0;3;3;1794;0;3475;3;3;
/org.eclipse.debug.ui/ui/org/eclipse/debug/internal/ui/ExecutionAction.java;4;0;18;1;0;0;0;18;126;2;16;187;368;368;2;2;0;18;18;1885;2;2382;16;4;
/org.eclipse.ui/Eclipse UI Standard Components/org/eclipse/ui/views/framelist/FrameList.java;1;0;1;1;0;0;0;1;0;0;1;3498;0;0;1;0;0;1;1;3498;0;3498;1;1;
/org.eclipse.jdt.debug/jdi/org/eclipse/jdi/internal/IntegerValueImpl.java;2;0;4;1;0;0;0;4;19;1;4;187;37;37;1;0;0;4;4;187;0;3670;4;2;
/org.eclipse.pde.ui/src/org/eclipse/pde/internal/model/RuntimeLibrary.java;2;0;2;1;0;0;0;2;0;1;2;1434;0;0;1;0;0;2;2;1434;0;2730;2;2;
/org.eclipse.vcm.core/src/org/eclipse/vcm/internal/core/TeamStreamHandle.java;5;0;10;1;0;0;0;10;35;2;9;0;90;90;2;1;0;10;10;199;1;983;9;5;
/org.eclipse.jdt.ui.tests/refactoring/experiments/AbstractFieldRefactoring.java;1;0;5;1;0;0;0;5;18;1;5;751;46;46;1;0;0;5;5;751;0;1665;5;1;
/org.eclipse.jdt.ui.tests.refactoring/resources/RenameMethodInInterface/test29/out/A.java;1;0;1;1;0;0;0;1;0;0;1;49;0;0;1;0;0;1;1;49;0;49;1;1;
/org.eclipse.core.tests.resources/src/org/eclipse/core/tests/internal/builders/AllTests.java;3;0;4;1;0;0;0;4;52;1;4;1794;59;59;1;0;0;4;4;1794;0;3420;4;3;
/org.eclipse.ui/Eclipse JFace Text/org/eclipse/jface/text/formatter/IContentFormatter.java;3;0;3;1;0;0;0;3;5;1;3;257;6;6;1;0;0;3;3;257;0;1066;3;3;
/org.eclipse.jdt.ui.tests.refactoring/resources/RenameType/test44/in/A.java;1;0;1;1;0;0;0;1;0;0;1;49;0;0;1;0;0;1;1;49;0;49;1;1;
/org.eclipse.jdt.ui/ui/org/eclipse/jdt/internal/ui/dialogs/AbstractElementListSelectionDialog.java;6;0;28;2;1;1;1;27;207;3;18;15;840;840;3;9;0;27;28;1254;9;4015;19;6;
/org.eclipse.debug.ui/ui/org/eclipse/debug/internal/ui/DebugActionGroupsContentProvider.java;2;0;2;1;1;1;1;1;0;0;1;3257;0;0;1;0;0;1;2;3257;0;3975;2;2;
/org.eclipse.swt/Eclipse SWT Drag and Drop/common/org/eclipse/swt/dnd/NoDragUnderEffect.java;2;0;3;1;1;1;1;2;10;1;2;106;16;16;1;0;0;2;3;106;0;4701;3;2;
/org.eclipse.compare/compare/org/eclipse/compare/patch/InputPatchPage.java;1;0;8;1;0;0;0;8;290;1;8;1516;560;560;1;0;0;8;8;1516;0;2876;8;1;
/org.eclipse.jdt.ui/ui/org/eclipse/jdt/internal/ui/jarexporter/WizardZipFileExportPage1.java;1;0;2;1;0;0;0;2;0;1;2;15;0;0;1;0;0;2;2;15;0;239;2;1;
/org.eclipse.jdt.ui/core refactoring/org/eclipse/jdt/internal/core/refactoring/rename/RefactoringScanner.java;2;0;3;1;0;0;0;3;1;1;3;1547;1;1;1;0;0;3;3;1547;0;1939;3;2;
/org.eclipse.ui/Eclipse JFace/org/eclipse/jface/action/IMenuListener.java;2;0;2;1;0;0;0;2;5;1;2;257;5;5;1;0;0;2;2;257;0;457;2;2;
/org.eclipse.team.cvs.core/src/org/eclipse/team/internal/ccvs/core/response/NullCopyHandler.java;1;0;2;1;0;0;0;2;0;1;2;2253;0;0;1;0;0;2;2;2253;0;2607;2;1;
/org.eclipse.pde.junit/Pde JUnit/org/eclipse/pde/internal/junit/launcher/JUnitPdeLaunchConfiguration.java;2;0;2;1;0;0;0;2;0;1;2;2861;0;0;1;0;0;2;2;2861;0;3205;2;2;
/org.eclipse.jdt.ui/core codemanipulation/org/eclipse/jdt/internal/core/codemanipulation/AddMemberEdit.java;1;0;2;1;0;0;0;2;0;1;2;1800;0;0;1;0;0;2;2;1800;0;1937;2;1;
/org.eclipse.pde.core/src/org/eclipse/pde/internal/core/plugin/PluginBase.java;1;0;2;1;1;1;1;1;11;0;1;3591;11;11;1;0;0;1;2;3591;0;4238;2;1;
/org.eclipse.swt/Eclipse SWT Printing/gtk1x/org/eclipse/swt/printing/Printer.java;2;0;2;1;1;1;1;1;6;0;1;2107;6;6;1;0;0;1;2;2107;0;4701;2;2;
/org.eclipse.ui.tests/Eclipse JFace Tests/org/eclipse/jface/tests/viewers/interactive/AddSiblingAction.java;1;0;1;1;0;0;0;1;0;0;1;1488;0;0;1;0;0;1;1;1488;0;1488;1;1;
/org.eclipse.jdt.ui.tests.refactoring/resources/SelectionAnalyzerWorkSpace/SelectionAnalyzerTests/invalidSelection/A_test147.java;2;0;2;1;0;0;0;2;0;1;2;1368;0;0;1;0;0;2;2;1368;0;2139;2;2;
/org.eclipse.debug.core/core/org/eclipse/debug/core/model/IBreakpointSupport.java;2;0;3;1;0;0;0;3;7;1;3;187;7;7;1;0;0;3;3;187;0;1035;3;2;
/org.eclipse.jdt.ui.tests.refactoring/resources/RenameType/test11/out/AA.java;1;0;1;1;0;0;0;1;0;0;1;49;0;0;1;0;0;1;1;49;0;49;1;1;
/org.eclipse.pde.ui/src/org/eclipse/pde/internal/editor/feature/ReferencePropertySource.java;1;0;6;1;0;0;0;6;226;2;5;2951;303;303;2;1;0;6;6;2951;1;3579;5;1;
/org.eclipse.help/Eclipse Help/org/eclipse/help/internal/contributors/xml/XMLActionContributorCreator.java;2;0;3;1;0;0;0;3;7;1;3;135;7;7;1;0;0;3;3;135;0;1420;3;2;
/org.eclipse.jdt.ui.tests.refactoring/resources/RenameMethodInInterface/test7/in/A.java;1;0;1;1;0;0;0;1;0;0;1;49;0;0;1;0;0;1;1;49;0;49;1;1;
/org.eclipse.update.examples/src/org/eclipse/update/examples/buildzip/Test.java;2;0;4;1;0;0;0;4;59;1;4;2553;71;71;1;0;0;4;4;2553;0;2976;4;2;
/org.eclipse.scripting/Eclipse Scripting/org/eclipse/scripting/internal/ScriptStrings.java;2;0;5;1;0;0;0;5;4;1;5;133;10;10;1;0;0;5;5;133;0;1424;5;2;
/org.eclipse.ui/Eclipse UI/org/eclipse/ui/dialogs/FileSystemElement.java;3;0;3;1;0;0;0;3;32;1;3;257;49;49;1;0;0;3;3;257;0;2618;3;3;
/org.eclipse.ui.tests/Eclipse UI Tests/org/eclipse/ui/tests/datatransfer/ImportOperationTestCase.java;3;0;5;1;0;0;0;5;29;1;5;1455;52;52;1;0;0;5;5;1455;0;2785;5;3;
/org.eclipse.jdt.ui.tests.refactoring/resources/MoveMembers/test20/out/B.java;1;0;3;1;0;0;0;3;3;1;3;2738;5;5;1;0;0;3;3;2738;0;3188;3;1;
/org.eclipse.core.resources/src/org/eclipse/core/internal/resources/ICoreConstants.java;4;0;11;1;1;1;1;10;130;1;10;12;208;208;1;0;0;10;11;12;0;4213;11;4;
/org.eclipse.jdt.ui.tests.refactoring/resources/SelectionAnalyzerWorkSpace/SelectionAnalyzerTests/validSelection/A_test274.java;1;0;1;1;0;0;0;1;0;0;1;1368;0;0;1;0;0;1;1;1368;0;1368;1;1;
/org.eclipse.debug.ui/ui/org/eclipse/debug/internal/ui/ConsoleViewerAction.java;2;0;5;1;0;0;0;5;21;1;5;187;29;29;1;0;0;5;5;187;0;1714;5;2;
/org.eclipse.update/src/org/eclipse/update/internal/core/UMSessionManager.java;1;0;1;1;0;0;0;1;0;0;1;1424;0;0;1;0;0;1;1;1424;0;1424;1;1;
/org.eclipse.ui/Eclipse UI/org/eclipse/ui/actions/SimpleWildcardTester.java;3;0;3;1;0;0;0;3;13;1;3;257;17;17;1;0;0;3;3;257;0;3510;3;3;
/org.eclipse.ui.tests/UI Test Utils/org/eclipse/ui/tests/internal/util/IDialogTestPass.java;1;0;1;1;0;0;0;1;0;0;1;2785;0;0;1;0;0;1;1;2785;0;2785;1;1;
/org.eclipse.core.tests.runtime/src/org/eclipse/core/tests/internal/plugins/FragmentResolveTest_4.java;3;0;4;1;0;0;0;4;308;1;4;1819;320;320;1;0;0;4;4;1819;0;3476;4;3;
/org.eclipse.core.tests.runtime/src/org/eclipse/core/tests/internal/plugins/FragmentResolveTest_12.java;2;0;2;1;0;0;0;2;10;1;2;3168;10;10;1;0;0;2;2;3168;0;3476;2;2;
/org.eclipse.jdt.ui.tests.refactoring/resources/RenameParameters/canRename/A_test14_in.java;1;0;1;1;0;0;0;1;0;0;1;233;0;0;1;0;0;1;1;233;0;233;1;1;
/org.eclipse.help/Eclipse Help/org/eclipse/help/internal/navigation/XMLNavGenerator.java;4;0;13;2;0;0;0;13;174;2;12;135;396;396;2;1;0;13;13;830;1;1420;12;4;
/org.eclipse.jdt.ui/ui/org/eclipse/jdt/internal/ui/actions/AddMethodEntryBreakpointAction.java;7;0;10;2;0;0;0;10;97;2;9;15;226;226;2;1;0;10;10;740;1;2217;9;7;
/org.eclipse.swt.examples.controls/src/org/eclipse/swt/examples/controls/ShellTab.java;2;0;2;1;0;0;0;2;0;1;2;391;0;0;1;0;0;2;2;391;0;611;2;2;
/org.eclipse.team.core/src/org/eclipse/team/core/TargetProvider.java;1;1;3;1;3;3;3;0;75;0;0;4010;75;75;1;0;0;0;3;4010;0;4113;3;1;
/org.eclipse.vcm.tests.core/src/org/eclipse/vcm/tests/core/base/ISharingManagerTest.java;1;0;1;1;0;0;0;1;0;0;1;1688;0;0;1;0;0;1;1;1688;0;1688;1;1;
/org.eclipse.jdt.ui.tests.refactoring/resources/MoveMembers/test3/out/B.java;1;0;1;1;0;0;0;1;0;0;1;2738;0;0;1;0;0;1;1;2738;0;2738;1;1;
/org.eclipse.swt/Eclipse SWT/common/org/eclipse/swt/events/MouseTrackAdapter.java;2;0;3;1;1;1;1;2;6;1;2;106;10;10;1;0;0;2;3;106;0;4701;3;2;
/org.eclipse.vcm.ui/src/org/eclipse/vcm/internal/ui/sync/ReleaseAction.java;1;0;4;1;0;0;0;4;8;1;4;48;8;8;1;0;0;4;4;48;0;349;4;1;
/org.eclipse.swt/Eclipse SWT/gtk/org/eclipse/swt/graphics/Cursor.java;6;1;8;1;3;3;3;5;245;1;5;2107;338;338;1;0;0;5;8;2107;0;4701;8;6;
/org.eclipse.pde.ui/src/org/eclipse/pde/internal/core/plugin/PluginExtension.java;1;0;4;1;0;0;0;4;19;2;3;3579;21;21;2;1;0;4;4;3579;1;3607;3;1;
/org.eclipse.swt.examples/src/org/eclipse/swt/examples/layoutexample/NameDialog.java;1;0;2;1;0;0;0;2;55;1;2;3420;55;55;1;0;0;2;2;3420;0;3583;2;1;
/org.eclipse.jdt.ui/core refactoring/org/eclipse/jdt/core/refactoring/IUndoManagerListener.java;1;0;3;1;0;0;0;3;5;1;3;15;5;5;1;0;0;3;3;15;0;408;3;1;
/org.eclipse.scripting/Eclipse Scripting/org/eclipse/scripting/internal/IXGRElementScriptElement.java;1;0;3;1;0;0;0;3;4;1;3;133;4;4;1;0;0;3;3;133;0;1424;3;1;
/org.eclipse.pde.ui/src/org/eclipse/pde/internal/ui/editor/feature/NewFeaturePluginWizardPage.java;1;2;6;1;3;2;3;3;109;1;3;3579;230;230;2;0;1;3;6;3958;1;4262;5;1;
/org.eclipse.jdt.ui.tests.refactoring/resources/ExtractMethodWorkSpace/ExtractMethodTests/validSelection/A_test243.java;2;0;2;1;0;0;0;2;0;1;2;49;0;0;1;0;0;2;2;49;0;3106;2;2;
/org.eclipse.jdt.debug/eval/org/eclipse/jdt/internal/debug/eval/ast/engine/DivideAssignmentOperator.java;1;0;2;1;0;0;0;2;0;1;2;3329;0;0;1;0;0;2;2;3329;0;3421;2;1;
/org.eclipse.jdt.debug/eval/org/eclipse/jdt/debug/eval/ast/model/IInterfaceType.java;1;0;2;1;0;0;0;2;0;1;2;3329;0;0;1;0;0;2;2;3329;0;3421;2;1;
/org.eclipse.jdt.ui.tests.refactoring/resources/RenamePrivateMethod/testFail1/in/A.java;1;0;1;1;0;0;0;1;0;0;1;49;0;0;1;0;0;1;1;49;0;49;1;1;
/org.eclipse.pde.ui/src/org/eclipse/pde/internal/model/PluginExtensionPoint.java;2;0;5;1;0;0;0;5;12;1;5;1434;18;18;1;0;0;5;5;1434;0;3136;5;2;
/org.eclipse.pde.ui/src/org/eclipse/pde/internal/model/feature/FeatureInstallHandler.java;1;0;4;1;0;0;0;4;20;1;4;2953;21;21;1;0;0;4;4;2953;0;3579;4;1;
/org.eclipse.jdt.ui/core refactoring/org/eclipse/jdt/internal/core/refactoring/RefactoringMatchLocator.java;2;0;5;1;0;0;0;5;81;1;5;15;89;89;1;0;0;5;5;15;0;1939;5;2;
/org.eclipse.ui/Eclipse JFace Text/org/eclipse/jface/text/IDocumentPartitioner.java;3;0;3;1;0;0;0;3;37;1;3;257;42;42;1;0;0;3;3;257;0;1066;3;3;
/org.eclipse.team.cvs.core/src/org/eclipse/team/internal/ccvs/core/response/MessageOutputHandler.java;3;0;3;1;0;0;0;3;4;1;3;1978;4;4;1;0;0;3;3;1978;0;2607;3;3;
/org.eclipse.debug.core/core/org/eclipse/debug/core/ILauncher.java;2;0;7;1;0;0;0;7;25;2;6;187;46;46;2;1;0;7;7;1724;1;3634;6;2;
/org.eclipse.scripting/src/org/eclipse/scripting/internal/IXGRElement.java;1;0;1;1;0;0;0;1;0;0;1;1424;0;0;1;0;0;1;1;1424;0;1424;1;1;
/org.eclipse.pde.ui/src/org/eclipse/pde/internal/editor/component/ComponentSpecSection.java;2;0;3;1;0;0;0;3;40;1;3;1434;40;40;1;0;0;3;3;1434;0;2951;3;2;
/org.eclipse.jdt.ui/ui refactoring/org/eclipse/jdt/internal/ui/refactoring/actions/structureselection/StructureSelectNextAction.java;2;0;7;1;0;0;0;7;34;1;7;2273;44;44;1;0;0;7;7;2273;0;3188;7;2;
/org.eclipse.jdt.core/compiler/org/eclipse/jdt/internal/compiler/ast/IfStatement.java;2;0;15;1;1;1;1;14;394;4;11;455;863;863;4;3;0;14;15;1039;3;4062;12;2;
/org.eclipse.jdt.ui/ui/org/eclipse/jdt/internal/ui/actions/CopyNamesToClipboardAction.java;2;0;3;1;0;0;0;3;2;1;3;903;2;2;1;0;0;3;3;903;0;3189;3;2;
/org.eclipse.update.ui/src/org/eclipse/update/internal/ui/model/PreservedConfiguration.java;2;0;3;1;0;0;0;3;2;1;3;2797;3;3;1;0;0;3;3;2797;0;3740;3;2;
/org.eclipse.team.core/src/org/eclipse/team/internal/core/TeamPlugin.java;3;1;4;1;4;4;4;0;14;0;0;4123;18;18;1;0;0;0;4;4123;0;4636;4;3;
/org.eclipse.vcm.ui.cvs/src/org/eclipse/vcm/internal/ui/ccvs/NewRepositoryWizard.java;5;0;11;1;0;0;0;11;35;2;10;31;119;119;2;1;0;11;11;31;1;1597;10;5;
/org.eclipse.jdt.ui.tests.refactoring/resources/RenameParameters/canRename/A_test28_in.java;1;0;1;1;0;0;0;1;0;0;1;233;0;0;1;0;0;1;1;233;0;233;1;1;
/org.eclipse.compare/compare/org/eclipse/compare/internal/BufferedResourceNode.java;1;0;4;1;0;0;0;4;22;1;4;761;28;28;1;0;0;4;4;761;0;3053;4;1;
/org.eclipse.jdt.ui/ui/org/eclipse/jdt/internal/ui/dialogs/TypeSelectionDialog.java;7;1;33;2;3;3;3;30;114;3;27;15;663;663;3;3;0;30;33;1257;3;4450;30;7;
/org.eclipse.search/search/org/eclipse/search/internal/ui/text/GotoMarkerAction.java;3;0;8;1;1;1;1;7;56;1;7;15;152;152;1;0;0;7;8;15;0;4139;8;3;
/org.eclipse.update.ui/src/org/eclipse/update/internal/ui/model/BackgroundProgressMonitor.java;1;0;2;1;0;0;0;2;0;1;2;2797;0;0;1;0;0;2;2;2797;0;3537;2;1;
/org.eclipse.jdt.ui.tests/JUnit/junit/framework/Test.java;2;0;2;1;0;0;0;2;0;1;2;49;0;0;1;0;0;2;2;49;0;1186;2;2;
/org.eclipse.jdt.debug/jdi interfaces/com/sun/jdi/Field.java;2;0;2;1;0;0;0;2;10;1;2;2704;10;10;1;0;0;2;2;2704;0;3033;2;2;
/org.eclipse.jdt.core/compiler/org/eclipse/jdt/internal/compiler/problem/ProblemHandler.java;2;1;8;1;2;2;2;6;274;2;5;455;331;331;2;1;0;6;8;3084;1;4062;7;2;
/org.eclipse.jdt.ui/ui/org/eclipse/jdt/internal/ui/preferences/CPVariableElementLabelProvider.java;1;0;2;1;0;0;0;2;0;1;2;133;0;0;1;0;0;2;2;133;0;159;2;1;
/org.eclipse.update.ui/src/org/eclipse/update/internal/ui/properties/SiteBookmarkPropertySource.java;1;0;1;1;0;0;0;1;0;0;1;3537;0;0;1;0;0;1;1;3537;0;3537;1;1;
/org.eclipse.jdt.core/compiler/org/eclipse/jdt/internal/compiler/codegen/ConstantPool.java;2;1;17;1;3;3;3;14;4817;4;11;455;8985;8985;4;3;0;14;17;1039;3;4421;14;2;
/org.eclipse.team.cvs.ui/src/org/eclipse/team/internal/ccvs/ui/HistoryDropAdapter.java;2;0;5;1;0;0;0;5;50;2;4;1991;86;86;2;1;0;5;5;1991;1;3213;4;2;
/org.eclipse.swt/Eclipse SWT/common/org/eclipse/swt/internal/image/FileFormat.java;2;0;3;1;1;1;1;2;7;1;2;106;13;13;1;0;0;2;3;106;0;4701;3;2;
/org.eclipse.swt/Eclipse SWT PI/gtk/org/eclipse/swt/internal/gtk/GtkText.java;2;0;3;1;0;0;0;3;8;1;3;2107;8;8;1;0;0;3;3;2107;0;3378;3;2;
/org.eclipse.help.ui/Eclipse Help UI Motif/org/eclipse/help/internal/ui/motif/WebBrowser.java;3;0;6;1;0;0;0;6;129;1;6;136;146;146;1;0;0;6;6;136;0;1420;6;3;
/org.eclipse.jdt.core/search/org/eclipse/jdt/internal/core/search/matching/DeclarationOfReferencedTypesPattern.java;3;1;10;1;5;5;5;5;17;2;4;1942;89;89;2;1;0;5;10;1942;1;4444;9;3;
/org.eclipse.compare/compare/org/eclipse/compare/internal/TextViewer.java;2;0;5;1;0;0;0;5;7;1;5;14;14;14;1;0;0;5;5;14;0;3183;5;2;
/org.eclipse.webdav/src/client/org/eclipse/webdav/http/client/Response.java;3;0;5;1;1;1;1;4;368;1;4;12;678;678;1;0;0;4;5;12;0;4211;5;3;
/org.eclipse.jdt.ui.tests/test plugin/org/eclipse/jdt/testplugin/test/JavaTestCase.java;2;0;4;1;0;0;0;4;43;1;4;49;69;69;1;0;0;4;4;49;0;1228;4;2;
/org.eclipse.debug.ui/ui/org/eclipse/debug/internal/ui/AbstractDebugView.java;3;0;15;1;0;0;0;15;285;3;13;187;518;518;3;2;0;15;15;2307;2;2307;13;3;
/org.eclipse.ui/Eclipse UI/org/eclipse/ui/internal/AboutItem.java;1;1;2;1;2;2;2;0;9;0;0;4030;9;9;1;0;0;0;2;4030;0;4150;2;1;
/org.eclipse.update.ui/src/org/eclipse/update/internal/ui/search/ExpressionQuery.java;1;0;2;1;0;0;0;2;0;1;2;3537;0;0;1;0;0;2;2;3537;0;3553;2;1;
/org.eclipse.pde.core/src/org/eclipse/pde/internal/core/builders/ManifestParser.java;1;0;3;1;0;0;0;3;14;1;3;3591;14;14;1;0;0;3;3;3591;0;3631;3;1;
/org.eclipse.jdt.ui/core refactoring/org/eclipse/jdt/internal/corext/refactoring/reorg/SourceReferenceUtil.java;1;0;2;1;0;0;0;2;19;1;2;2212;19;19;1;0;0;2;2;2212;0;2735;2;1;
/org.eclipse.pde.build/src/plugin/org/eclipse/pde/internal/core/FragmentBuildScriptGenerator.java;1;0;1;1;0;0;0;1;0;0;1;3475;0;0;1;0;0;1;1;3475;0;3475;1;1;
/org.eclipse.jdt.ui.tests.refactoring/resources/MoveMembers/test0/in/B.java;1;0;1;1;0;0;0;1;0;0;1;2738;0;0;1;0;0;1;1;2738;0;2738;1;1;
/org.eclipse.ui/Eclipse UI Text Editor/org/eclipse/ui/editors/text/TextEditor.java;5;1;14;1;8;8;8;6;132;1;6;257;494;494;1;0;0;6;14;257;0;4838;14;5;
/org.eclipse.jdt.ui.tests.refactoring/resources/ExtractMethodWorkSpace/ExtractMethodTests/validSelection/A_test241.java;2;1;3;1;2;2;2;1;0;0;1;49;0;0;1;0;0;1;3;49;0;4419;3;2;
/org.eclipse.ui/Eclipse UI Text Editor/org/eclipse/ui/texteditor/AbstractMarkerAnnotationModel.java;4;1;10;1;3;3;3;7;396;1;7;257;666;666;1;0;0;7;10;257;0;4838;10;4;
/org.eclipse.update.core/src/org/eclipse/update/core/Category.java;2;0;5;1;0;0;0;5;48;1;5;2476;93;93;1;0;0;5;5;2476;0;3512;5;2;
/org.eclipse.pde.ui/src/org/eclipse/pde/internal/ui/editor/feature/FeatureSourceOutlinePage.java;1;0;1;1;0;0;0;1;0;0;1;3579;0;0;1;0;0;1;1;3579;0;3579;1;1;
/org.eclipse.team.core/src/org/eclipse/team/internal/core/target/BaseIdentifierNotInitializedException.java;2;1;3;1;3;3;3;0;21;0;0;4010;31;31;1;0;0;0;3;4010;0;4245;3;2;
/org.eclipse.update.ui.forms/src/org/eclipse/update/ui/forms/TableLayoutTest.java;1;0;12;1;0;0;0;12;34;2;10;1541;118;118;2;2;0;12;12;1541;2;2474;10;1;
/org.eclipse.swt/Eclipse SWT PI/gtk1x/org/eclipse/swt/internal/gtk/GdkFont.java;2;0;2;1;1;1;1;1;3;0;1;2107;3;3;1;0;0;1;2;2107;0;4701;2;2;
/org.eclipse.help/src/org/eclipse/help/internal/server/HelpURL.java;2;0;4;2;0;0;0;4;5;2;3;1420;6;6;2;1;0;4;4;3093;1;3093;3;2;
/org.eclipse.pde.ui/src/org/eclipse/pde/internal/editor/PDESourcePage.java;2;0;6;1;0;0;0;6;5;1;6;1434;10;10;1;0;0;6;6;1434;0;3579;6;2;
/org.eclipse.pde.ui/src/org/eclipse/pde/internal/ui/wizards/imports/UpdateClasspathOperation.java;2;2;7;1;5;4;5;2;53;1;2;3579;118;118;2;0;1;2;7;4234;1;4234;6;2;
/org.eclipse.swt/Eclipse SWT Drag and Drop/photon/org/eclipse/swt/dnd/FileTransfer.java;4;1;10;1;6;6;6;4;130;1;4;106;325;325;1;0;0;4;10;106;0;4824;10;4;
/org.eclipse.team.cvs.ui/src/org/eclipse/team/internal/ccvs/ui/wizards/NewLocationWizard.java;3;1;14;1;3;3;3;11;63;2;10;2577;172;172;2;1;0;11;14;2722;1;4248;13;3;
/org.eclipse.jdt.ui/ui refactoring/org/eclipse/jdt/internal/ui/refactoring/nls/search/PrettySignature.java;2;0;2;1;0;0;0;2;0;1;2;1922;0;0;1;0;0;2;2;1922;0;2155;2;2;
/org.eclipse.jdt.debug/eval/org/eclipse/jdt/internal/debug/eval/ast/engine/AssignmentOperator.java;1;0;3;1;0;0;0;3;3;1;3;3329;3;3;1;0;0;3;3;3329;0;3421;3;1;
/org.eclipse.ui/Eclipse UI/org/eclipse/ui/internal/EditorMenuManager.java;3;0;14;2;1;1;1;13;108;3;9;457;295;295;3;4;0;13;14;3447;4;4367;10;3;
/org.eclipse.update/Eclipse Update/org/eclipse/update/internal/ui/UMWizardPageInstalling.java;2;0;4;1;0;0;0;4;401;1;4;108;405;405;1;0;0;4;4;108;0;1424;4;2;
/org.eclipse.swt/Eclipse SWT OLE Win32/win32/org/eclipse/swt/internal/ole/win32/ITypeInfo.java;2;0;3;1;0;0;0;3;5;1;3;106;5;5;1;0;0;3;3;106;0;2069;3;2;
/org.eclipse.jdt.ui.tests.refactoring/resources/ExtractTemp/canExtract/A_test3_in.java;1;0;1;1;0;0;0;1;0;0;1;2481;0;0;1;0;0;1;1;2481;0;2481;1;1;
/org.eclipse.jdt.ui/ui/org/eclipse/jdt/internal/ui/filters/NamePatternFilter.java;1;0;1;1;1;1;1;0;0;0;0;4211;0;0;1;0;0;0;1;4211;0;4211;1;1;
/org.eclipse.jdt.ui.tests.refactoring/resources/RenameTemp/cannotRename/A_testFail28.java;1;0;1;1;0;0;0;1;0;0;1;3322;0;0;1;0;0;1;1;3322;0;3322;1;1;
/org.eclipse.pde.ui/src/org/eclipse/pde/internal/ui/feature/FeatureData.java;1;0;1;1;0;0;0;1;0;0;1;3579;0;0;1;0;0;1;1;3579;0;3579;1;1;
/org.eclipse.update.ui/src/org/eclipse/update/ui/internal/model/IUpdateModelChangedListener.java;1;0;3;1;0;0;0;3;5;1;3;1526;5;5;1;0;0;3;3;1526;0;2797;3;1;
/org.eclipse.pde.ui/src/org/eclipse/pde/internal/model/plugin/PluginLibrary.java;1;0;2;1;0;0;0;2;0;1;2;3136;0;0;1;0;0;2;2;3136;0;3579;2;1;
/org.eclipse.jdt.ui/core refactoring/org/eclipse/jdt/internal/corext/refactoring/text/AbstractTextBufferChange.java;1;0;2;1;0;0;0;2;0;1;2;1939;0;0;1;0;0;2;2;1939;0;2216;2;1;
/org.eclipse.jdt.ui.tests.refactoring/resources/ExtractMethodWorkSpace/ExtractMethodTests/try_out/A_test454.java;2;1;4;1;2;2;2;2;10;1;2;511;12;12;1;0;0;2;4;511;0;4419;4;2;
/org.eclipse.jdt.ui.tests.refactoring/resources/RenameParameters/canRename/A_out.java;1;0;1;1;0;0;0;1;0;0;1;233;0;0;1;0;0;1;1;233;0;233;1;1;
/org.eclipse.team.cvs.ui/src/org/eclipse/team/internal/ccvs/ui/actions/ContentAction.java;3;2;5;1;5;4;5;0;17;0;0;3937;34;34;2;0;1;0;5;3937;1;4628;4;3;
/org.eclipse.ui/Eclipse UI/org/eclipse/ui/internal/QuitAction.java;5;0;5;1;0;0;0;5;11;1;5;257;16;16;1;0;0;5;5;257;0;3029;5;5;
/org.eclipse.jdt.ui.tests.refactoring/resources/PullUpMethods/test4/out/B.java;1;0;3;1;0;0;0;3;2;1;3;2156;2;2;1;0;0;3;3;2156;0;2406;3;1;
/org.eclipse.update.ui/src/org/eclipse/update/internal/ui/manager/CDROMPage.java;1;0;3;1;0;0;0;3;2;1;3;1905;2;2;1;0;0;3;3;1905;0;2651;3;1;
/org.eclipse.jdt.debug.tests/tests/org/eclipse/jdt/debug/tests/eval/NestedTypeFieldValue_54.java;2;1;3;1;3;3;3;0;12;0;0;4447;14;14;1;0;0;0;3;4447;0;4571;3;2;
/org.eclipse.jdt.core/model/org/eclipse/jdt/internal/core/jdom/DOMField.java;2;0;12;1;1;1;1;11;1173;4;8;455;1323;1323;4;3;0;11;12;1039;3;4063;9;2;
/org.eclipse.jdt.ui/core refactoring/org/eclipse/jdt/internal/core/refactoring/projects/RenameResourceRefactoring.java;1;0;1;1;0;0;0;1;0;0;1;990;0;0;1;0;0;1;1;990;0;990;1;1;
/org.eclipse.jdt.ui.tests.refactoring/resources/RenameType/test22/out/A.java;1;0;2;1;0;0;0;2;0;1;2;49;0;0;1;0;0;2;2;49;0;522;2;1;
/org.eclipse.jdt.ui.tests.refactoring/resources/RenameVariables/canRename/A_test10_out.java;1;0;2;1;0;0;0;2;0;1;2;724;0;0;1;0;0;2;2;724;0;1665;2;1;
/org.eclipse.ui/Eclipse JFace/org/eclipse/jface/viewers/IStructuredSelection.java;2;0;2;1;0;0;0;2;5;1;2;257;5;5;1;0;0;2;2;257;0;457;2;2;
/org.eclipse.swt/Eclipse SWT/common/org/eclipse/swt/events/TreeAdapter.java;2;0;3;1;1;1;1;2;6;1;2;106;10;10;1;0;0;2;3;106;0;4701;3;2;
/org.eclipse.jdt.ui/core refactoring/org/eclipse/jdt/internal/corext/refactoring/rename/RippleMethodFinder.java;2;0;5;1;1;1;1;4;32;1;4;1939;60;60;1;0;0;4;5;1939;0;4165;5;2;
/org.eclipse.jdt.ui.tests/refactoring/experiments/AbstractFieldTests.java;2;0;3;1;0;0;0;3;5;1;3;1186;5;5;1;0;0;3;3;1186;0;1665;3;2;
/org.eclipse.jdt.ui/core extension/org/eclipse/jdt/internal/corext/codemanipulation/IImplementMethodQuery.java;1;0;2;1;0;0;0;2;0;1;2;2232;0;0;1;0;0;2;2;2232;0;2246;2;1;
/org.eclipse.jdt.ui.tests.refactoring/resources/PullUp/testField0/out/A.java;1;0;1;1;0;0;0;1;0;0;1;2406;0;0;1;0;0;1;1;2406;0;2406;1;1;
/org.eclipse.jdt.ui.tests.refactoring/resources/RenamePrivateField/testFail10/in/A.java;1;0;1;1;0;0;0;1;0;0;1;2875;0;0;1;0;0;1;1;2875;0;2875;1;1;
/org.eclipse.jdt.ui.tests.refactoring/resources/MoveMembers/test9/out/A.java;1;0;1;1;0;0;0;1;0;0;1;2738;0;0;1;0;0;1;1;2738;0;2738;1;1;
/org.eclipse.jdt.core/batch/org/eclipse/jdt/internal/compiler/batch/FileSystem.java;3;0;17;2;1;1;1;16;344;4;10;455;730;730;4;6;0;16;17;1039;6;4061;11;3;
/org.eclipse.update.ui/src/org/eclipse/update/internal/ui/manager/LocalSiteView.java;3;0;30;1;0;0;0;30;608;2;28;1460;1760;1760;2;2;0;30;30;2172;2;3537;28;3;
/org.eclipse.pde.ui/src/org/eclipse/pde/internal/ui/editor/SystemFileEditorInputFactory.java;1;0;1;1;0;0;0;1;0;0;1;3579;0;0;1;0;0;1;1;3579;0;3579;1;1;
/org.eclipse.scripting/src/org/eclipse/scripting/ScriptAdapterDelegatingWizard.java;1;0;1;1;0;0;0;1;0;0;1;1424;0;0;1;0;0;1;1;1424;0;1424;1;1;
/org.eclipse.pde.ui/src/org/eclipse/pde/internal/core/schema/SchemaElementReference.java;1;0;3;1;0;0;0;3;6;1;3;3579;6;6;1;0;0;3;3;3579;0;3607;3;1;
/org.eclipse.update.ui/src/org/eclipse/update/internal/ui/forms/InfoLink.java;1;0;2;1;1;1;1;1;1;0;1;3662;1;1;1;0;0;1;2;3662;0;4714;2;1;
/org.eclipse.vcm.ui/src/org/eclipse/vcm/internal/ui/model/ResourceEditionPropertySource.java;4;0;8;2;0;0;0;8;65;2;6;1;102;102;2;2;0;8;8;163;2;1158;6;4;
/org.eclipse.jdt.ui.tests.refactoring/resources/SelectionAnalyzerWorkSpace/SelectionAnalyzerTests/invalidSelection/A_test072.java;1;0;1;1;0;0;0;1;0;0;1;1368;0;0;1;0;0;1;1;1368;0;1368;1;1;
/org.eclipse.jdt.ui/core refactoring/org/eclipse/jdt/internal/core/refactoring/base/ICompositeChange.java;2;0;2;1;0;0;0;2;0;1;2;408;0;0;1;0;0;2;2;408;0;1939;2;2;
/org.eclipse.ui/Eclipse UI/org/eclipse/ui/internal/dialogs/FontPreferencePage.java;5;0;16;2;2;1;2;14;335;1;14;968;672;672;2;0;1;14;16;4142;1;4142;15;5;
/org.eclipse.scripting/Eclipse Scripting/org/eclipse/scripting/internal/IXGRElementEventGenerator.java;1;0;3;1;0;0;0;3;4;1;3;133;4;4;1;0;0;3;3;133;0;1424;3;1;
/org.eclipse.jdt.ui.tests.refactoring/resources/SelectionAnalyzerWorkSpace/SelectionAnalyzerTests/invalidSelection/A_test111.java;1;0;1;1;0;0;0;1;0;0;1;1368;0;0;1;0;0;1;1;1368;0;1368;1;1;
/org.eclipse.core.tests.resources/src/org/eclipse/core/tests/resources/ResourceURLTest.java;3;0;4;1;1;1;1;3;222;1;3;1794;256;256;1;0;0;3;4;1794;0;4516;4;3;
/org.eclipse.jdt.debug/model/org/eclipse/jdt/internal/debug/core/model/JDIClassType.java;3;0;11;3;1;1;1;10;35;3;5;2517;74;74;3;5;0;10;11;2517;5;4423;6;3;
/org.eclipse.jdt.ui.tests/JUnit/junit/extensions/TestDecorator.java;2;0;2;1;0;0;0;2;0;1;2;49;0;0;1;0;0;2;2;49;0;1186;2;2;
/org.eclipse.swt.examples.controls/org/eclipse/swt/examples/controls/ToolBarTab.java;2;0;5;2;0;0;0;5;451;3;3;513;451;451;3;2;0;5;5;609;2;970;3;2;
/org.eclipse.jdt.ui/ui/org/eclipse/jdt/internal/ui/javaeditor/RunToLineAction.java;5;0;11;1;0;0;0;11;140;1;11;15;402;402;1;0;0;11;11;15;0;2057;11;5;
/org.eclipse.jdt.junit/Eclipse JUnit/org/eclipse/jdt/junit/util/ActionUtil.java;2;0;2;1;0;0;0;2;0;1;2;1511;0;0;1;0;0;2;2;1511;0;1996;2;2;
/org.eclipse.jdt.core/compiler/org/eclipse/jdt/internal/compiler/ast/ArrayAllocationExpression.java;2;0;12;1;1;1;1;11;272;4;8;455;613;613;4;3;0;11;12;1039;3;4062;9;2;
/org.eclipse.jdt.ui.tests.refactoring/resources/RenameType/test58/out/B.java;1;1;2;1;2;2;2;0;2;0;0;4291;2;2;1;0;0;0;2;4291;0;4423;2;1;
/org.eclipse.pde.ui/src/org/eclipse/pde/internal/editor/manifest/NewDependencyWizardPage.java;1;0;8;1;0;0;0;8;26;2;7;2491;59;59;2;1;0;8;8;3035;1;3579;7;1;
/org.eclipse.jdt.debug.tests/testprograms/WorkingDirectoryTest.java;2;0;2;1;1;1;1;1;11;0;1;3719;11;11;1;0;0;1;2;3719;0;4571;2;2;
/org.eclipse.ui/Eclipse JFace/org/eclipse/jface/resource/ImageDescriptor.java;3;0;3;1;0;0;0;3;29;1;3;257;34;34;1;0;0;3;3;257;0;3574;3;3;
/org.eclipse.ui/Eclipse JFace Text/org/eclipse/jface/text/internal/html/WebBrowser.java;2;0;3;1;1;1;1;2;4;1;2;1435;4;4;1;0;0;2;3;1435;0;3915;3;2;
/org.eclipse.jdt.debug/model/org/eclipse/jdt/internal/debug/core/JavaExceptionBreakpoint.java;4;0;23;3;0;0;0;23;221;2;19;1035;775;775;2;4;0;23;23;1035;4;2517;19;4;
/org.eclipse.scripting/src/org/eclipse/scripting/internal/views/ScriptUIEditorActionManager.java;1;0;1;1;0;0;0;1;0;0;1;1424;0;0;1;0;0;1;1;1424;0;1424;1;1;
/org.eclipse.pde.core/src/org/eclipse/pde/internal/core/FeatureProject.java;1;0;2;1;0;0;0;2;0;1;2;3591;0;0;1;0;0;2;2;3591;0;3631;2;1;
/org.eclipse.team.cvs.core/src/org/eclipse/team/internal/ccvs/core/client/FileStructureVisitor.java;2;0;8;2;1;1;1;7;138;2;6;2572;248;248;2;1;0;7;8;3089;1;4007;7;2;
/org.eclipse.jdt.ui.tests/test plugin/org/eclipse/jdt/testplugin/TestPluginLauncher.java;2;0;5;1;0;0;0;5;31;1;5;49;47;47;1;0;0;5;5;49;0;1238;5;2;
/org.eclipse.jdt.core/compiler/org/eclipse/jdt/internal/compiler/codegen/ExceptionLabel.java;2;0;4;1;1;1;1;3;38;1;3;455;58;58;1;0;0;3;4;455;0;4062;4;2;
/org.eclipse.jdt.junit/Eclipse JUnit/org/eclipse/jdt/junit/internal/ITestRunView.java;2;0;2;1;0;0;0;2;0;1;2;1531;0;0;1;0;0;2;2;1531;0;2007;2;2;
/org.eclipse.ui/Eclipse UI/org/eclipse/ui/internal/model/WorkbenchWorkingSet.java;1;0;1;1;0;0;0;1;0;0;1;3287;0;0;1;0;0;1;1;3287;0;3287;1;1;
/org.eclipse.ui/Eclipse UI Standard Components/org/eclipse/ui/views/framelist/FrameListMessages.java;1;0;1;1;0;0;0;1;0;0;1;3498;0;0;1;0;0;1;1;3498;0;3498;1;1;
/org.eclipse.jdt.ui.tests.refactoring/resources/ExtractTemp/canExtract/A_test3_out.java;1;0;1;1;0;0;0;1;0;0;1;2481;0;0;1;0;0;1;1;2481;0;2481;1;1;
/org.eclipse.ui/Eclipse UI/org/eclipse/ui/actions/OpenInNewWindowAction.java;3;1;4;1;3;3;3;1;39;0;1;3582;84;84;1;0;0;1;4;3582;0;4429;4;3;
/org.eclipse.debug.ui/ui/org/eclipse/debug/internal/ui/actions/SelectAllBreakpointsAction.java;2;0;5;2;0;0;0;5;50;2;4;3178;106;106;2;1;0;5;5;3251;1;3730;4;2;
/org.eclipse.jdt.core/eval/org/eclipse/jdt/internal/eval/CodeSnippetCodeStream.java;2;0;6;1;1;1;1;5;751;1;5;455;849;849;1;0;0;5;6;455;0;4062;6;2;
/org.eclipse.ant.core/src/org/eclipse/ant/internal/core/AntCorePreferences.java;1;1;11;1;4;4;4;7;283;3;4;3387;579;579;3;3;0;7;11;3489;3;4404;8;1;
/org.eclipse.update.ui/src/org/eclipse/update/internal/ui/model/FeatureReferenceAdapter.java;1;1;3;1;2;2;2;1;22;0;1;2834;32;32;1;0;0;1;3;2834;0;4384;3;1;
/org.eclipse.update.ui/src/org/eclipse/update/internal/ui/model/FeatureAdapter.java;2;0;4;1;1;1;1;3;22;1;3;2834;25;25;1;0;0;3;4;2834;0;4010;4;2;
/org.eclipse.jdt.junit/src/org/eclipse/jdt/internal/junit/oldlauncher/JUnitBaseLauncherDelegate.java;2;0;3;1;0;0;0;3;15;1;3;3171;15;15;1;0;0;3;3;3171;0;3638;3;2;
/org.eclipse.jdt.ui.tests.refactoring/resources/ExtractMethodWorkSpace/ExtractMethodTests/invalidSelection/A_test012.java;2;1;3;1;2;2;2;1;0;0;1;49;0;0;1;0;0;1;3;49;0;4419;3;2;
/org.eclipse.team.cvs.ui/src/org/eclipse/team/internal/ccvs/ui/actions/ShowCVSPerspectiveAction.java;1;0;2;1;0;0;0;2;2;1;2;3555;2;2;1;0;0;2;2;3555;0;3577;2;1;
/org.eclipse.update.ui/src/org/eclipse/update/internal/ui/properties/ConfigurationPropertyPage.java;1;0;1;1;0;0;0;1;0;0;1;3537;0;0;1;0;0;1;1;3537;0;3537;1;1;
/org.eclipse.ui/Eclipse UI/org/eclipse/ui/internal/CloseAllSavedAction.java;2;1;4;1;2;2;2;2;44;1;2;3799;61;61;1;0;0;2;4;3799;0;4608;4;2;
/org.eclipse.pde.ui/src/org/eclipse/pde/internal/model/plugin/PluginModelFactory.java;1;0;2;1;0;0;0;2;0;1;2;3136;0;0;1;0;0;2;2;3136;0;3579;2;1;
/org.eclipse.vcm.core.cvs/src/org/eclipse/vcm/internal/core/ccvs/CVSResourceTreeBuilder.java;3;0;4;1;0;0;0;4;20;1;4;0;40;40;1;0;0;4;4;0;0;1584;4;3;
/org.eclipse.update.tests.core/src/org/eclipse/update/tests/reconciliation/TestSiteReconciliation.java;1;1;9;1;4;4;4;5;37;2;4;2937;150;150;2;1;0;5;9;2994;1;4351;8;1;
/org.eclipse.jdt.core/model/org/eclipse/jdt/internal/core/builder/IBinaryBroker.java;1;0;2;1;0;0;0;2;0;1;2;455;0;0;1;0;0;2;2;455;0;2808;2;1;
/org.eclipse.ui.examples.readmetool/Eclipse UI Examples Readme Tool/org/eclipse/ui/examples/readmetool/ViewActionDelegate.java;2;0;2;1;0;0;0;2;4;1;2;932;4;4;1;0;0;2;2;932;0;945;2;2;
/org.eclipse.pde.ui/src/org/eclipse/pde/internal/editor/manifest/ReqGraphSection.java;2;0;4;1;0;0;0;4;6;2;3;1434;6;6;2;1;0;4;4;2470;1;2650;3;2;
/org.eclipse.pde.ui/src/org/eclipse/pde/internal/ui/model/ifeature/IFeatureImport.java;1;0;2;1;0;0;0;2;0;1;2;3579;0;0;1;0;0;2;2;3579;0;3591;2;1;
/org.eclipse.jdt.core/dom/org/eclipse/jdt/core/dom/PackageDeclaration.java;2;1;7;1;2;2;2;5;15;1;5;2669;44;44;1;0;0;5;7;2669;0;4453;7;2;
/org.eclipse.jdt.ui.tests.refactoring/resources/RenamePackage/testFail7/in/p/A.java;2;0;2;1;0;0;0;2;0;1;2;49;0;0;1;0;0;2;2;49;0;1258;2;2;
/org.eclipse.ui/Eclipse UI/org/eclipse/ui/internal/registry/MarkerImageProviderRegistry.java;2;0;2;1;0;0;0;2;20;1;2;257;20;20;1;0;0;2;2;257;0;457;2;2;
/org.eclipse.search/search/org/eclipse/search/internal/ui/OpenSearchDialogAction.java;2;0;4;1;1;1;1;3;13;1;3;15;35;35;1;0;0;3;4;15;0;4001;4;2;
/org.eclipse.jdt.ui.tests.refactoring/resources/ExtractMethodWorkSpace/ExtractMethodTests/try_out/A_test452.java;2;1;4;1;2;2;2;2;28;1;2;65;29;29;1;0;0;2;4;65;0;4419;4;2;
/org.eclipse.swt/Eclipse SWT/win32/org/eclipse/swt/internal/win32/WINDOWPLACEMENT.java;2;0;3;1;0;0;0;3;5;1;3;106;5;5;1;0;0;3;3;106;0;2069;3;2;
/org.eclipse.help.ui/src/org/eclipse/help/ui/internal/HelpContentsAction.java;1;0;1;1;1;1;1;0;0;0;0;4439;0;0;1;0;0;0;1;4439;0;4439;1;1;
/org.eclipse.update.ui/src/org/eclipse/update/internal/ui/model/ExtensionRoot.java;1;1;2;1;2;2;2;0;4;0;0;4197;4;4;1;0;0;0;2;4197;0;4217;2;1;
/org.eclipse.jdt.ui.tests.refactoring/resources/SafeDeleteType/testFail20/in/A.java;1;0;1;1;0;0;0;1;0;0;1;49;0;0;1;0;0;1;1;49;0;49;1;1;
/org.eclipse.vcm.ui/src/org/eclipse/vcm/internal/ui/ManagingPerspective.java;1;0;3;1;0;0;0;3;6;1;3;124;12;12;1;0;0;3;3;124;0;312;3;1;
/org.eclipse.jdt.debug.ui/ui/org/eclipse/jdt/debug/ui/JavaUISourceLocator.java;3;1;16;1;5;5;5;11;93;3;9;2779;207;207;3;2;0;11;16;3185;2;4536;14;3;
/org.eclipse.core.resources/src/org/eclipse/core/internal/events/BuildManager.java;4;1;27;2;4;4;4;23;1230;3;18;12;2650;2650;3;5;0;23;27;43;5;4692;22;4;
/org.eclipse.vcm.ui.cvs/src/org/eclipse/vcm/internal/ui/ccvs/IWorkbenchCVSConstants.java;3;0;6;1;0;0;0;6;5;1;6;1;12;12;1;0;0;6;6;1;0;1578;6;3;
/org.eclipse.jdt.ui/ui/org/eclipse/jdt/internal/ui/wizards/dialogfields/StringDialogField.java;2;0;7;1;0;0;0;7;32;1;7;15;59;59;1;0;0;7;7;15;0;3084;7;2;
/org.eclipse.search/search/org/eclipse/search/internal/ui/util/FileTypeEditor.java;2;0;9;1;0;0;0;9;77;2;8;15;163;163;2;1;0;9;9;863;1;2962;8;2;
/org.eclipse.jdt.ui.tests/refactoring/org/eclipse/jdt/refactoring/tests/RenameMethodTests.java;4;0;6;1;0;0;0;6;9;1;6;49;24;24;1;0;0;6;6;49;0;1896;6;4;
/org.eclipse.swt.examples.paint/org/eclipse/swt/examples/paint/PointFigure.java;2;0;2;1;1;1;1;1;0;0;1;615;0;0;1;0;0;1;2;615;0;4024;2;2;
/org.eclipse.jdt.ui.tests.refactoring/resources/RenameTemp/canRename/A_test12_in.java;1;0;2;1;0;0;0;2;2;1;2;1625;2;2;1;0;0;2;2;1625;0;1652;2;1;
/org.eclipse.ant.core/src/org/eclipse/ant/core/EclipseCopy.java;2;0;3;1;0;0;0;3;826;1;3;1986;826;826;1;0;0;3;3;1986;0;3489;3;2;
/org.eclipse.ui.examples.propertysheet/Eclipse UI Examples PropertySheet/org/eclipse/ui/examples/propertysheet/UserEditor.java;2;0;2;1;0;0;0;2;2;1;2;931;2;2;1;0;0;2;2;931;0;946;2;2;
/org.eclipse.jdt.ui.tests.refactoring/resources/ExtractMethodWorkSpace/ExtractMethodTests/locals_in/A_test557.java;1;1;3;1;2;2;2;1;24;0;1;1236;24;24;1;0;0;1;3;1236;0;4419;3;1;
/org.eclipse.ui.tests/Eclipse JFace Tests/org/eclipse/jface/tests/viewers/interactive/FlushInputAction.java;1;0;1;1;0;0;0;1;0;0;1;1488;0;0;1;0;0;1;1;1488;0;1488;1;1;
/org.eclipse.swt/Eclipse SWT Custom Widgets/common_j2se/org/eclipse/swt/custom/TextChangedEvent.java;1;0;1;1;0;0;0;1;0;0;1;1378;0;0;1;0;0;1;1;1378;0;1378;1;1;
/org.eclipse.update.core/src/org/eclipse/update/configuration/LocalSystemInfo.java;2;2;17;2;9;8;9;8;138;1;8;3067;442;442;2;0;1;8;17;4102;1;4687;16;2;
/org.eclipse.swt/Eclipse SWT/common/org/eclipse/swt/events/VerifyEvent.java;2;0;3;1;1;1;1;2;6;1;2;106;10;10;1;0;0;2;3;106;0;4701;3;2;
/org.eclipse.compare/compare/org/eclipse/compare/internal/IgnoreWhiteSpaceAction.java;2;0;3;1;0;0;0;3;5;1;3;14;7;7;1;0;0;3;3;14;0;761;3;2;
/org.eclipse.ui/Eclipse UI Standard Components/org/eclipse/ui/wizards/datatransfer/ZipFileImportWizard.java;2;0;3;1;0;0;0;3;17;1;3;257;24;24;1;0;0;3;3;257;0;2568;3;2;
/org.eclipse.jdt.ui/ui/org/eclipse/jdt/internal/ui/preferences/RefactoringPreferencePage.java;4;2;6;2;3;2;3;3;24;1;3;2007;34;34;2;0;1;3;6;4181;1;4400;5;4;
/org.eclipse.jdt.ui/ui/org/eclipse/jdt/ui/actions/ExtractTempAction.java;2;1;7;1;7;7;7;0;31;0;0;3970;59;59;1;0;0;0;7;3970;0;4770;7;2;
/org.eclipse.jdt.ui.tests.refactoring/test cases/org/eclipse/jdt/ui/tests/refactoring/SefTests.java;1;0;5;1;1;1;1;4;100;1;4;2155;110;110;1;0;0;4;5;2155;0;4403;5;1;
/org.eclipse.team.cvs.ui/src/org/eclipse/team/internal/ccvs/ui/sync/GetMergeAction.java;1;0;8;1;0;0;0;8;78;2;6;2231;181;181;2;2;0;8;8;2231;2;2672;6;1;
/org.eclipse.jdt.ui.tests.refactoring/resources/SafeDeleteType/testFail19/in/A.java;1;0;1;1;0;0;0;1;0;0;1;49;0;0;1;0;0;1;1;49;0;49;1;1;
/org.eclipse.pde.ui/src/org/eclipse/pde/internal/ui/editor/feature/HandlerSection.java;1;1;5;1;2;2;2;3;25;2;2;3579;39;39;2;1;0;3;5;3579;1;4067;4;1;
/org.eclipse.jdt.ui/core refactoring/org/eclipse/jdt/core/refactoring/code/LocalVariableAnalyzer.java;1;0;13;1;0;0;0;13;80;2;11;15;356;356;2;2;0;13;13;25;2;408;11;1;
/org.eclipse.swt/Eclipse SWT PI/photon/org/eclipse/swt/internal/photon/PtScrollbarCallback_t.java;2;0;2;1;1;1;1;1;6;0;1;2069;6;6;1;0;0;1;2;2069;0;4701;2;2;
/org.eclipse.jdt.ui/ui refactoring/org/eclipse/jdt/internal/ui/refactoring/RenameFieldInputWizardPage.java;3;1;6;1;2;2;2;4;8;1;4;2804;38;38;1;0;0;4;6;2804;0;4621;6;3;
/org.eclipse.jdt.ui.tests.refactoring/resources/SurroundWithWorkSpace/SurroundWithTests/trycatch_out/TestWrappedLocal3.java;1;0;2;1;0;0;0;2;2;1;2;2327;2;2;1;0;0;2;2;2327;0;3870;2;1;
/org.eclipse.swt/Eclipse SWT Custom Widgets/common_j2se/org/eclipse/swt/custom/ControlEditor.java;1;0;1;1;0;0;0;1;0;0;1;1378;0;0;1;0;0;1;1;1378;0;1378;1;1;
/org.eclipse.jdt.debug.ui/ui/org/eclipse/jdt/internal/debug/ui/display/EditorDisplayAction.java;2;0;5;1;0;0;0;5;7;1;5;1915;10;10;1;0;0;5;5;1915;0;2273;5;2;
/org.eclipse.team.core/src/org/eclipse/team/core/target/ISiteFactory.java;2;1;3;1;3;3;3;0;28;0;0;4132;28;28;1;0;0;0;3;4132;0;4636;3;2;
/org.eclipse.core.tests.runtime/src/org/eclipse/core/tests/internal/plugins/PluginResolveTest_11.java;3;0;3;1;0;0;0;3;142;1;3;1794;152;152;1;0;0;3;3;1794;0;3476;3;3;
/org.eclipse.help/src/org/eclipse/help/LiveHelpExtension.java;2;0;2;1;0;0;0;2;0;1;2;2683;0;0;1;0;0;2;2;2683;0;3048;2;2;
/org.eclipse.pde.build/src/org/eclipse/pde/internal/build/BuildScriptGeneratorApplication.java;1;0;8;1;1;1;1;7;75;2;6;2977;115;115;2;1;0;7;8;3571;1;3974;7;1;
/org.eclipse.vcm.tests.core/src/org/eclipse/vcm/tests/core/base/ISubscriberTest.java;1;0;1;1;0;0;0;1;0;0;1;1688;0;0;1;0;0;1;1;1688;0;1688;1;1;
/org.eclipse.jdt.debug.ui/ui/org/eclipse/jdt/internal/debug/ui/launcher/AbstractJavaCommandTab.java;3;2;4;2;4;3;4;0;18;0;0;4214;23;23;2;0;1;0;4;4214;1;4567;3;3;
/org.eclipse.pde.ui/src/org/eclipse/pde/internal/base/model/IModelUndoManager.java;1;0;3;1;0;0;0;3;23;2;2;2851;23;23;2;1;0;3;3;3035;1;3035;2;1;
/org.eclipse.jdt.ui.tests.refactoring/resources/ExtractMethodWorkSpace/ExtractMethodTests/locals_out/A_test506.java;2;1;4;1;2;2;2;2;30;1;2;80;50;50;1;0;0;2;4;80;0;4419;4;2;
/org.eclipse.jdt.core/dom/org/eclipse/jdt/core/dom/PackageBinding.java;4;0;9;1;1;1;1;8;13;2;6;2669;26;26;2;2;0;8;9;2701;2;4421;7;4;
/org.eclipse.ui.tests/Eclipse UI Tests/org/eclipse/ui/tests/TestPlugin.java;1;0;2;1;0;0;0;2;26;1;2;803;26;26;1;0;0;2;2;803;0;1500;2;1;
/org.eclipse.swt/Eclipse SWT/gtk1x/org/eclipse/swt/graphics/Font.java;3;0;3;1;1;1;1;2;12;1;2;2107;18;18;1;0;0;2;3;2107;0;4701;3;3;
/org.eclipse.swt/Eclipse SWT/gtk/org/eclipse/swt/widgets/TabFolder.java;4;2;16;1;7;6;7;9;288;2;8;2107;902;902;2;1;1;9;16;3629;2;4701;14;4;
/org.eclipse.team.core/src/org/eclipse/team/internal/core/target/ITargetRunnable.java;1;0;1;1;1;1;1;0;0;0;0;4636;0;0;1;0;0;0;1;4636;0;4636;1;1;
/org.eclipse.team.cvs.core/src/org/eclipse/team/internal/ccvs/core/resources/CVSLocalSyncElement.java;3;0;12;1;1;1;1;11;266;1;11;2156;415;415;1;0;0;11;12;2156;0;3921;12;3;
/org.eclipse.pde.core/src/org/eclipse/pde/internal/core/ifeature/IFeatureData.java;1;0;1;1;0;0;0;1;0;0;1;3591;0;0;1;0;0;1;1;3591;0;3591;1;1;
/org.eclipse.help.tests/src/org/eclipse/help/tests/base/TestHelpSystem.java;1;0;5;1;0;0;0;5;22;1;5;1642;53;53;1;0;0;5;5;1642;0;3767;5;1;
/org.eclipse.team.cvs.core/src/org/eclipse/team/internal/ccvs/core/util/EmptyTokenizer.java;2;0;2;1;0;0;0;2;264;1;2;1978;264;264;1;0;0;2;2;1978;0;2791;2;2;
/org.eclipse.help.ui/src/org/eclipse/help/ui/browser/LaunchURL.java;1;0;1;1;1;1;1;0;0;0;0;3906;0;0;1;0;0;0;1;3906;0;3906;1;1;
/org.eclipse.swt.examples/org/eclipse/swt/examples/fileviewer/TreeView.java;2;0;3;2;0;0;0;3;1;2;2;554;1;1;2;1;0;3;3;609;1;609;2;2;
/org.eclipse.ui.examples.javaeditor/Java Editor Example/org/eclipse/ui/examples/javaeditor/java/JavaCodeScanner.java;1;0;2;1;0;0;0;2;0;0;1;1066;0;0;2;1;0;2;2;1066;1;1066;1;1;
/org.eclipse.ui/Eclipse UI/org/eclipse/ui/IPartListener.java;2;0;2;1;0;0;0;2;5;1;2;257;5;5;1;0;0;2;2;257;0;457;2;2;
/org.eclipse.jdt.debug.tests/testprograms/NativeDropTests.java;2;0;2;1;1;1;1;1;11;0;1;3719;11;11;1;0;0;1;2;3719;0;4571;2;2;
/org.eclipse.ui/Eclipse UI/org/eclipse/ui/internal/dialogs/SavePerspectiveDialog.java;5;0;7;1;0;0;0;7;21;1;7;257;66;66;1;0;0;7;7;257;0;3752;7;5;
/org.eclipse.jdt.ui/ui/org/eclipse/jdt/internal/ui/launcher/JDIPreferencePage.java;1;0;2;1;0;0;0;2;0;1;2;218;0;0;1;0;0;2;2;218;0;323;2;1;
/org.eclipse.team.cvs.ui/src/org/eclipse/team/internal/ccvs/ui/model/AllRootsElement.java;1;0;3;1;0;0;0;3;9;2;2;1997;9;9;2;1;0;3;3;2049;1;2049;2;1;
/org.eclipse.jdt.ui.tests.refactoring/resources/SelectionAnalyzerWorkSpace/SelectionAnalyzerTests/invalidSelection/A_test042.java;1;0;1;1;0;0;0;1;0;0;1;1368;0;0;1;0;0;1;1;1368;0;1368;1;1;
/org.eclipse.jdt.ui.tests.refactoring/resources/RenameMethodInInterface/test40/out/A.java;1;0;1;1;0;0;0;1;0;0;1;49;0;0;1;0;0;1;1;49;0;49;1;1;
/org.eclipse.swt/Eclipse SWT PI/motif/org/eclipse/swt/internal/motif/XColor.java;2;0;2;1;1;1;1;1;6;0;1;2069;6;6;1;0;0;1;2;2069;0;4701;2;2;
/org.eclipse.jdt.core/model/org/eclipse/jdt/core/ICompilationUnit.java;3;2;11;1;3;2;3;8;376;2;7;455;462;462;2;1;1;8;11;1755;2;4058;9;3;
/org.eclipse.pde.ui/Eclipse PDE UI/org/eclipse/pde/internal/editor/component/ReferenceForm.java;3;0;8;2;0;0;0;8;12;3;6;267;20;20;3;2;0;8;8;324;2;1434;6;3;
/org.eclipse.pde.ui/Eclipse PDE UI/org/eclipse/pde/internal/editor/schema/DocForm.java;3;0;7;2;0;0;0;7;12;3;5;267;18;18;3;2;0;7;7;324;2;1434;5;3;
/org.eclipse.jdt.debug.tests/testprograms/HitCountException.java;1;0;1;1;1;1;1;0;0;0;0;4571;0;0;1;0;0;0;1;4571;0;4571;1;1;
/org.eclipse.scripting/Eclipse Scripting/org/eclipse/scripting/internal/views/ScriptUIEditorTextHover.java;1;0;3;1;0;0;0;3;7;1;3;133;7;7;1;0;0;3;3;133;0;1424;3;1;
/org.eclipse.vcm.core.cvs/src/org/eclipse/vcm/internal/core/ccvs/requests/CreatedHandler.java;2;0;2;1;0;0;0;2;17;1;2;0;17;17;1;0;0;2;2;0;0;298;2;2;
/org.eclipse.jdt.ui.tests.refactoring/resources/PullUp/test15/out/A.java;1;0;1;1;0;0;0;1;0;0;1;2406;0;0;1;0;0;1;1;2406;0;2406;1;1;
/org.eclipse.jdt.debug.tests/tests/org/eclipse/jdt/debug/tests/eval/TypeHierarchy_108_1.java;2;1;3;1;3;3;3;0;13;0;0;4447;15;15;1;0;0;0;3;4447;0;4571;3;2;
/org.eclipse.core.runtime/src/org/eclipse/core/internal/runtime/AssertionFailedException.java;3;0;4;1;1;1;1;3;56;1;3;12;78;78;1;0;0;3;4;12;0;4213;4;3;
/org.eclipse.core.tests.runtime/src/org/eclipse/core/tests/internal/plugin/a/BaseExtension.java;3;0;3;1;0;0;0;3;28;1;3;1794;38;38;1;0;0;3;3;1794;0;3476;3;3;
/org.eclipse.swt.tests/JUnit Tests/org/eclipse/swt/tests/junit/Test_org_eclipse_swt_widgets_CoolBar.java;2;0;2;1;1;1;1;1;6;0;1;1792;6;6;1;0;0;1;2;1792;0;4706;2;2;
/org.eclipse.update.ui/src/org/eclipse/update/internal/ui/wizards/NewSearchWizardPage.java;2;1;5;1;3;3;3;2;14;0;1;3653;27;27;2;1;0;2;5;3653;1;4610;4;2;
/org.eclipse.webdav/src/kernel/org/eclipse/webdav/internal/kernel/LocatorFactoryImpl.java;2;0;3;1;0;0;0;3;5;1;3;12;5;5;1;0;0;3;3;12;0;1874;3;2;
/org.eclipse.core.tests.resources/src/org/eclipse/core/tests/internal/localstore/RefreshLocalPerformanceTest.java;3;0;4;1;1;1;1;3;232;1;3;1794;263;263;1;0;0;3;4;1794;0;4516;4;3;
/org.eclipse.ui/Eclipse JFace Text/org/eclipse/jface/text/IDocumentPartitioningListenerExtension.java;1;0;2;1;1;1;1;1;32;0;1;3068;32;32;1;0;0;1;2;3068;0;4838;2;1;
/org.eclipse.jdt.ui.tests.refactoring/resources/DeleteSourceReference/test12/in/A.java;1;0;1;1;0;0;0;1;0;0;1;2857;0;0;1;0;0;1;1;2857;0;2857;1;1;
/org.eclipse.jdt.ui.tests.refactoring/resources/SafeDeleteType/testFail1/in/A.java;1;0;1;1;0;0;0;1;0;0;1;49;0;0;1;0;0;1;1;49;0;49;1;1;
/org.eclipse.jdt.ui.tests.refactoring/resources/PullUp/testFieldMethod0/in/A.java;1;0;1;1;0;0;0;1;0;0;1;2406;0;0;1;0;0;1;1;2406;0;2406;1;1;
/org.eclipse.jdt.debug.ui/ui/org/eclipse/jdt/internal/debug/ui/launcher/SourceAttachmentBlock.java;2;1;4;1;4;4;4;0;23;0;0;4101;49;49;1;0;0;0;4;4101;0;4401;4;2;
/org.eclipse.pde.ui/Eclipse PDE UI/org/eclipse/pde/internal/editor/manifest/IRootNodeListener.java;2;0;5;2;0;0;0;5;12;3;3;267;12;12;3;2;0;5;5;324;2;1434;3;2;
/org.eclipse.pde.ui/src/org/eclipse/pde/internal/editor/SelectionProvider.java;2;0;3;1;0;0;0;3;3;1;3;1434;3;3;1;0;0;3;3;1434;0;3579;3;2;
/org.eclipse.help/Eclipse Help/org/eclipse/help/internal/contributions/xml/HelpTopicFactory.java;2;0;3;1;0;0;0;3;7;1;3;135;7;7;1;0;0;3;3;135;0;513;3;2;
/org.eclipse.jdt.core/search/org/eclipse/jdt/internal/core/search/indexing/IndexAllProject.java;3;2;25;1;6;5;6;19;192;4;15;455;646;646;4;4;1;19;25;1039;5;4525;20;3;
/org.eclipse.core.tests.runtime/src/org/eclipse/core/tests/plugintests/CmdLineAndStateAndPluginLocalTest.java;1;0;1;1;1;1;1;0;0;0;0;4006;0;0;1;0;0;0;1;4006;0;4006;1;1;
/org.eclipse.pde.ui/src/org/eclipse/pde/internal/core/schema/ChoiceRestriction.java;1;0;3;1;0;0;0;3;2;1;3;3579;2;2;1;0;0;3;3;3579;0;3607;3;1;
/org.eclipse.core.tests.resources/src/org/eclipse/core/tests/resources/regression/PR_1GH2B0N_Test.java;3;0;5;1;1;1;1;4;110;1;4;1794;166;166;1;0;0;4;5;1794;0;4516;5;3;
/org.eclipse.scripting/Eclipse Scripting/org/eclipse/scripting/IToolkitUI.java;2;0;4;1;0;0;0;4;7;1;4;133;10;10;1;0;0;4;4;133;0;1424;4;2;
/org.eclipse.team.ui/src/org/eclipse/team/internal/ui/target/DiscardSiteAction.java;3;1;5;1;5;5;5;0;37;0;0;4284;81;81;1;0;0;0;5;4284;0;4707;5;3;
/org.eclipse.pde.ui/Eclipse PDE UI/org/eclipse/pde/internal/preferences/BuildpathPreferencePage.java;2;0;2;1;0;0;0;2;0;1;2;337;0;0;1;0;0;2;2;337;0;1434;2;2;
/org.eclipse.ui/Eclipse UI Standard Components/org/eclipse/ui/views/navigator/ResourcePatternFilter.java;3;0;3;1;1;1;1;2;25;1;2;257;33;33;1;0;0;2;3;257;0;4067;3;3;
/org.eclipse.jdt.ui.tests.refactoring/resources/RenamePrivateMethod/test23/out/A.java;1;0;2;1;0;0;0;2;2;1;2;49;2;2;1;0;0;2;2;49;0;512;2;1;
/org.eclipse.jdt.ui/ui/org/eclipse/jdt/ui/actions/OpenViewActionGroup.java;2;2;11;1;9;7;9;2;54;1;2;3716;122;122;2;0;2;2;11;3894;2;4770;9;2;
/org.eclipse.jdt.ui.tests.refactoring/resources/ExtractMethodWorkSpace/ExtractMethodTests/invalidSelection/A_test044.java;2;1;3;1;2;2;2;1;0;0;1;49;0;0;1;0;0;1;3;49;0;4419;3;2;
/org.eclipse.ui.tests/UI Test Utils/org/eclipse/ui/tests/util/EmptyPerspective.java;1;0;1;1;0;0;0;1;0;0;1;2785;0;0;1;0;0;1;1;2785;0;2785;1;1;
/org.eclipse.jdt.ui/ui refactoring/org/eclipse/jdt/internal/ui/refactoring/ReorgInputPage.java;1;0;1;1;0;0;0;1;0;0;1;1108;0;0;1;0;0;1;1;1108;0;1108;1;1;
/org.eclipse.pde.build/src/org/eclipse/pde/internal/build/ComponentBuildScriptGenerator.java;7;0;25;1;0;0;0;25;1008;5;18;245;1411;1411;5;7;0;25;25;256;7;3089;18;7;
/org.eclipse.jdt.core/compiler/org/eclipse/jdt/internal/compiler/env/IBinaryNestedType.java;2;0;4;1;1;1;1;3;40;1;3;455;60;60;1;0;0;3;4;455;0;4062;4;2;
/org.eclipse.swt/Eclipse SWT/common/org/eclipse/swt/events/MouseEvent.java;2;0;3;1;1;1;1;2;6;1;2;106;10;10;1;0;0;2;3;106;0;4701;3;2;
/org.eclipse.team.ui/src/org/eclipse/team/internal/ui/target/ConfigureTargetWizard.java;3;2;18;1;18;12;18;0;338;0;0;4149;665;665;2;0;6;0;18;4164;6;4636;12;3;
/org.eclipse.jdt.core/compiler/org/eclipse/jdt/internal/compiler/ast/LongLiteral.java;2;0;5;1;1;1;1;4;277;1;4;455;295;295;1;0;0;4;5;455;0;4062;5;2;
/org.eclipse.swt.examples/org/eclipse/swt/examples/layoutexample/Tab.java;2;0;4;1;1;1;1;3;300;1;3;3420;306;306;1;0;0;3;4;3420;0;4024;4;2;
/org.eclipse.pde.ui/src/org/eclipse/pde/internal/forms/FormButton.java;2;0;2;1;0;0;0;2;0;1;2;1434;0;0;1;0;0;2;2;1434;0;2470;2;2;
/org.eclipse.ui/Eclipse UI/org/eclipse/ui/internal/CoolBarLayout.java;2;0;8;1;1;1;1;7;61;2;6;3484;123;123;2;1;0;7;8;3484;1;4009;7;2;
/org.eclipse.team.ui/src/org/eclipse/team/ui/sync/ITeamNode.java;2;0;4;1;1;1;1;3;8;1;3;2233;14;14;1;0;0;3;4;2233;0;4005;4;2;
/org.eclipse.pde.ui/src/org/eclipse/pde/internal/ui/editor/ModelUndoManager.java;1;0;3;1;0;0;0;3;9;0;1;3579;9;9;3;2;0;3;3;3579;2;3579;1;1;
/org.eclipse.jdt.ui/ui/org/eclipse/jdt/internal/ui/preferences/CPVariableElement.java;1;0;2;1;0;0;0;2;0;1;2;133;0;0;1;0;0;2;2;133;0;159;2;1;
/org.eclipse.ui/Eclipse UI/org/eclipse/ui/internal/dialogs/ProjectCapabilitySimpleAddWizard.java;1;0;1;1;0;0;0;1;0;0;1;3609;0;0;1;0;0;1;1;3609;0;3609;1;1;
/org.eclipse.vcm.tests.core/src/org/eclipse/vcm/tests/core/regression/AllTests.java;1;0;1;1;0;0;0;1;0;0;1;1688;0;0;1;0;0;1;1;1688;0;1688;1;1;
/org.eclipse.ui.tests/Eclipse JFace Tests/org/eclipse/jface/tests/viewers/TestModelContentProvider.java;1;0;1;1;0;0;0;1;0;0;1;1488;0;0;1;0;0;1;1;1488;0;1488;1;1;
/org.eclipse.pde.ui/Eclipse PDE UI/org/eclipse/pde/internal/base/model/plugin/IPluginModelFactory.java;2;0;5;2;0;0;0;5;12;3;3;267;12;12;3;2;0;5;5;324;2;1434;3;2;
/org.eclipse.jdt.debug/model/org/eclipse/jdt/debug/core/IJavaEvaluationResult.java;3;0;7;1;0;0;0;7;46;1;7;187;69;69;1;0;0;7;7;187;0;2381;7;3;
/org.eclipse.jdt.ui.tests.refactoring/resources/ExtractTemp/canExtract/A_test21_out.java;1;0;1;1;0;0;0;1;0;0;1;2498;0;0;1;0;0;1;1;2498;0;2498;1;1;
/org.eclipse.vcm.ui/src/org/eclipse/vcm/internal/ui/actions/ReplaceWithAction.java;3;0;11;2;0;0;0;11;41;2;9;1;126;126;2;2;0;11;11;297;2;1288;9;3;
/org.eclipse.scripting/Eclipse Scripting/org/eclipse/scripting/internal/views/ScriptUIEditorXmlParserException.java;2;0;4;1;0;0;0;4;10;1;4;133;17;17;1;0;0;4;4;133;0;1424;4;2;
/org.eclipse.swt/Eclipse SWT/gtk1x/org/eclipse/swt/widgets/Tree.java;5;0;11;2;1;1;1;10;1047;3;7;2107;1264;1264;3;3;0;10;11;2274;3;4701;8;5;
/org.eclipse.scripting/src/org/eclipse/scripting/internal/IXGRDataNodeXml.java;1;0;1;1;0;0;0;1;0;0;1;1424;0;0;1;0;0;1;1;1424;0;1424;1;1;
/org.eclipse.jdt.core/model/org/eclipse/jdt/internal/core/PackageFragment.java;3;2;21;1;3;2;3;18;616;4;13;455;924;924;4;5;1;18;21;1039;6;4063;15;3;
/org.eclipse.core.resources/src/org/eclipse/core/internal/indexing/IPageFactory.java;2;0;3;1;0;0;0;3;5;1;3;12;5;5;1;0;0;3;3;12;0;370;3;2;
/org.eclipse.jdt.ui/core refactoring/org/eclipse/jdt/internal/core/refactoring/rename/RenameVirtualMethodRefactoring.java;2;0;4;2;0;0;0;4;21;2;3;1342;40;40;2;1;0;4;4;1938;1;1938;3;2;
/org.eclipse.team.cvs.core/src/org/eclipse/team/internal/ccvs/core/resources/RemoteRoot.java;2;0;2;1;0;0;0;2;0;1;2;1978;0;0;1;0;0;2;2;1978;0;2036;2;2;
/org.eclipse.ui.examples.javaeditor/Eclipse Java Editor Example/org/eclipse/ui/examples/javaeditor/JavaSourceViewerConfiguration.java;1;0;1;1;0;0;0;1;0;0;1;1067;0;0;1;0;0;1;1;1067;0;1067;1;1;
/org.eclipse.pde.ui/src/org/eclipse/pde/internal/editor/feature/FeatureOutlinePage.java;1;0;6;1;0;0;0;6;297;2;4;2951;398;398;2;2;0;6;6;2951;2;3579;4;1;
/org.eclipse.jdt.ui/ui/org/eclipse/jdt/internal/ui/wizards/NewProjectCreationWizardPage.java;2;2;6;1;6;5;6;0;12;0;0;4076;35;35;2;0;1;0;6;4076;1;4621;5;2;
/org.eclipse.jdt.ui/ui/org/eclipse/jdt/internal/ui/text/FastJavaPartitionScanner.java;2;1;5;1;4;4;4;1;1057;0;1;3873;1152;1152;1;0;0;1;5;3873;0;4400;5;2;
/org.eclipse.ui/Eclipse UI/org/eclipse/ui/internal/registry/EditorRegistryReader.java;4;0;4;1;0;0;0;4;37;1;4;257;40;40;1;0;0;4;4;257;0;2286;4;4;
/org.eclipse.swt/Eclipse SWT/gtk/org/eclipse/swt/widgets/ProgressBar.java;5;1;8;1;5;5;5;3;49;1;3;2107;91;91;1;0;0;3;8;2107;0;4701;8;5;
/org.eclipse.jdt.ui.tests.refactoring/resources/RenameType/testFail4/in/B.java;1;0;1;1;0;0;0;1;0;0;1;49;0;0;1;0;0;1;1;49;0;49;1;1;
/org.eclipse.jdt.ui/ui refactoring/org/eclipse/jdt/internal/ui/refactoring/actions/MoveAction.java;2;0;5;2;1;1;1;4;61;2;3;3791;65;65;2;1;0;4;5;3826;1;3970;4;2;
/org.eclipse.ui/Eclipse UI/org/eclipse/ui/internal/dialogs/FilterDialog.java;2;1;4;1;3;3;3;1;91;0;1;3870;170;170;1;0;0;1;4;3870;0;4609;4;2;
/org.eclipse.pde.ui/src/org/eclipse/pde/internal/base/IBasePluginWizard.java;2;0;2;1;0;0;0;2;0;1;2;1434;0;0;1;0;0;2;2;1434;0;3039;2;2;
/org.eclipse.jdt.ui.tests.refactoring/resources/RenameTemp/canRename/A_test28_in.java;1;0;2;1;0;0;0;2;2;1;2;1625;2;2;1;0;0;2;2;1625;0;1652;2;1;
/org.eclipse.jdt.ui/core refactoring/org/eclipse/jdt/internal/corext/refactoring/DebugUtils.java;2;0;5;1;0;0;0;5;6;1;5;1939;16;16;1;0;0;5;5;1939;0;3357;5;2;
/org.eclipse.jdt.ui.tests.refactoring/resources/RenameType/testFail82/in/A.java;1;0;1;1;0;0;0;1;0;0;1;49;0;0;1;0;0;1;1;49;0;49;1;1;
/org.eclipse.swt/Eclipse SWT Drag and Drop/photon/org/eclipse/swt/dnd/DropTarget.java;3;1;7;1;4;4;4;3;89;1;3;106;253;253;1;0;0;3;7;106;0;4824;7;3;
/org.eclipse.jdt.ui/core refactoring/org/eclipse/jdt/internal/corext/refactoring/code/flow/BranchFlowInfo.java;1;0;3;1;0;0;0;3;6;1;3;1939;10;10;1;0;0;3;3;1939;0;3106;3;1;
/org.eclipse.swt/Eclipse SWT PI/carbon/org/eclipse/swt/internal/carbon/MacPoint.java;2;1;2;1;2;2;2;0;6;0;0;4147;6;6;1;0;0;0;2;4147;0;4701;2;2;
/org.eclipse.jdt.ui/ui refactoring/org/eclipse/jdt/internal/ui/refactoring/ChangeElementContentProvider.java;1;0;8;1;0;0;0;8;40;2;6;1800;98;98;2;2;0;8;8;1937;2;2619;6;1;
/org.eclipse.core.resources/src/org/eclipse/core/internal/resources/MoveDeleteHook.java;1;0;1;1;0;0;0;1;0;0;1;3251;0;0;1;0;0;1;1;3251;0;3251;1;1;
/org.eclipse.jdt.core/model/org/eclipse/jdt/core/CompletionRequestorAdapter.java;4;1;5;1;3;3;3;2;39;1;2;3282;58;58;1;0;0;2;5;3282;0;4836;5;4;
/org.eclipse.ui/Eclipse JFace Text/org/eclipse/jface/text/IDocumentPartitionerExtension.java;1;0;2;1;1;1;1;1;29;0;1;3068;29;29;1;0;0;1;2;3068;0;4838;2;1;
/org.eclipse.update.core/src/org/eclipse/update/core/ISiteContentProvider.java;2;0;4;1;0;0;0;4;61;1;4;2438;108;108;1;0;0;4;4;2438;0;3574;4;2;
/org.eclipse.update.tests.core/src/org/eclipse/update/tests/api/TestDefaultPackageFeatureAPI.java;2;0;17;2;0;0;0;17;79;3;13;1531;338;338;3;4;0;17;17;2583;4;2994;13;2;
/org.eclipse.compare/compare/org/eclipse/compare/structuremergeviewer/DiffNode.java;2;0;9;1;0;0;0;9;47;2;8;14;126;126;2;1;0;9;9;2459;1;3053;8;2;
/org.eclipse.pde.ui/src/org/eclipse/pde/internal/ui/editor/manifest/ManifestFormPage.java;1;0;1;1;0;0;0;1;0;0;1;3579;0;0;1;0;0;1;1;3579;0;3579;1;1;
/org.eclipse.pde.ui/templates/editor/java/$editorClass$.java;1;0;3;1;2;1;2;1;16;0;1;3812;16;16;2;0;1;1;3;4316;1;4316;2;1;
/org.eclipse.jdt.ui.tests.refactoring/resources/DeleteSourceReference/test6/out/A.java;1;0;1;1;0;0;0;1;0;0;1;2857;0;0;1;0;0;1;1;2857;0;2857;1;1;
/org.eclipse.jdt.debug.tests/tests/org/eclipse/jdt/debug/tests/eval/NestedTypeFieldValue_395.java;2;1;3;1;3;3;3;0;12;0;0;4447;14;14;1;0;0;0;3;4447;0;4571;3;2;
/org.eclipse.jdt.ui.tests.refactoring/resources/RenameParameters/canRename/A_test35_in.java;1;0;1;1;0;0;0;1;0;0;1;2757;0;0;1;0;0;1;1;2757;0;2757;1;1;
/org.eclipse.jdt.ui/ui refactoring/org/eclipse/jdt/internal/ui/refactoring/RefactoringPreferencePage.java;3;0;8;1;0;0;0;8;39;1;8;15;118;118;1;0;0;8;8;15;0;2007;8;3;
/org.eclipse.core.tests.resources.saveparticipant3/src/org/eclipse/core/tests/resources/saveparticipant3/SaveParticipant3Plugin.java;3;0;3;1;0;0;0;3;94;1;3;1794;104;104;1;0;0;3;3;1794;0;3475;3;3;
/org.eclipse.core.tests.runtime/src/org/eclipse/core/tests/plugintests/CmdLineAndStateAndPluginLocalAndPrimaryFeatureTest.java;1;0;1;1;1;1;1;0;0;0;0;4006;0;0;1;0;0;0;1;4006;0;4006;1;1;
/org.eclipse.swt/Eclipse SWT/photon/org/eclipse/swt/graphics/Image.java;7;1;15;1;4;4;4;11;311;1;11;106;595;595;1;0;0;11;15;106;0;4701;15;7;
/org.eclipse.core.tests.resources/src/org/eclipse/core/tests/resources/regression/PR_1G1N9GZ_2Test.java;3;0;4;1;0;0;0;4;12;1;4;1794;22;22;1;0;0;4;4;1794;0;3287;4;3;
/org.eclipse.jdt.debug.tests/tests/org/eclipse/jdt/debug/tests/eval/BooleanOperatorsTests.java;2;2;3;2;3;2;3;0;18;0;0;4447;20;20;2;0;1;0;3;4447;1;4571;2;2;
/org.eclipse.pde.ui/src/org/eclipse/pde/internal/ui/wizards/project/NewFragmentProjectWizard.java;1;0;1;1;0;0;0;1;0;0;1;3579;0;0;1;0;0;1;1;3579;0;3579;1;1;
/org.eclipse.jdt.ui/ui/org/eclipse/jdt/internal/ui/text/JavaAnnotationHover.java;4;0;13;1;1;1;1;12;85;2;11;15;238;238;2;1;0;12;13;326;1;4401;12;4;
/org.eclipse.core.resources/src/org/eclipse/core/internal/indexing/UserDefinedObject.java;3;0;4;1;0;0;0;4;5;1;4;12;7;7;1;0;0;4;4;12;0;448;4;3;
/org.eclipse.team.ftp/src/org/eclipse/team/internal/ftp/target/FTPSite.java;4;2;9;2;9;8;9;0;52;0;0;4241;151;151;2;0;1;0;9;4249;1;4636;8;4;
/org.eclipse.jdt.core/compiler/org/eclipse/jdt/internal/compiler/ast/EqualExpression.java;2;1;13;1;4;4;4;9;997;2;8;455;1141;1141;2;1;0;9;13;2664;1;4421;12;2;
/org.eclipse.help/src/org/eclipse/help/internal/context/IContextContribution.java;1;0;2;1;0;0;0;2;0;1;2;1675;0;0;1;0;0;2;2;1675;0;2217;2;1;
/org.eclipse.help/Eclipse Help/org/eclipse/help/internal/contributions/TopicRef.java;2;0;3;1;0;0;0;3;7;1;3;135;7;7;1;0;0;3;3;135;0;1420;3;2;
/org.eclipse.team.cvs.ui/src/org/eclipse/team/internal/ccvs/ui/ConsoleOutputStream.java;3;0;3;1;0;0;0;3;78;1;3;1978;78;78;1;0;0;3;3;1978;0;3452;3;3;
/org.eclipse.jdt.ui.tests.refactoring/resources/RenameVariables/canRename/A_test28_out.java;1;0;2;1;0;0;0;2;0;1;2;724;0;0;1;0;0;2;2;724;0;1665;2;1;
/org.eclipse.jdt.ui.tests.refactoring/resources/RenameType/test50/in/A.java;1;0;1;1;0;0;0;1;0;0;1;49;0;0;1;0;0;1;1;49;0;49;1;1;
/org.eclipse.jdt.ui.tests.refactoring/resources/ExtractMethodWorkSpace/ExtractMethodTests/locals_in/A_test532.java;1;1;3;1;2;2;2;1;18;0;1;922;18;18;1;0;0;1;3;922;0;4419;3;1;
/org.eclipse.jdt.ui.tests.refactoring/resources/RenameTemp/canRename/A_test12_out.java;1;0;2;1;0;0;0;2;2;1;2;1625;2;2;1;0;0;2;2;1625;0;1652;2;1;
/org.eclipse.vcm.core/src/org/eclipse/vcm/internal/core/base/IProjectEdition.java;2;0;2;1;0;0;0;2;5;1;2;0;5;5;1;0;0;2;2;0;0;297;2;2;
/org.eclipse.pde.ui/src/org/eclipse/pde/internal/editor/manifest/ExtensionPointForm.java;2;0;5;1;0;0;0;5;16;1;5;1434;31;31;1;0;0;5;5;1434;0;3579;5;2;
/org.eclipse.jdt.debug.tests/tests/org/eclipse/jdt/debug/tests/eval/TestsTypeHierarchy2.java;2;2;4;2;4;3;4;0;13;0;0;4447;21;21;2;0;1;0;4;4568;1;4568;3;2;
/org.eclipse.jdt.core/model/org/eclipse/jdt/internal/core/util/Util.java;2;1;5;1;3;3;3;2;101;0;1;3629;195;195;2;1;0;2;5;3629;1;4422;4;2;
/org.eclipse.help.webapp/src/org/eclipse/help/servlet/EclipseConnector.java;3;1;9;2;2;2;2;7;121;2;6;2409;352;352;2;1;0;7;9;2409;1;4630;8;3;
/org.eclipse.jdt.ui.tests.refactoring/resources/RenameType/test31/out/AA.java;1;0;1;1;0;0;0;1;0;0;1;49;0;0;1;0;0;1;1;49;0;49;1;1;
/org.eclipse.jdt.core/dom/org/eclipse/jdt/core/dom/ArrayCreation.java;3;1;8;1;4;4;4;4;16;1;4;2669;56;56;1;0;0;4;8;2669;0;4453;8;3;
/org.eclipse.jdt.ui.tests/ui/com/ibm/jdt/ui/tests/JavaDocTestCase.java;1;0;3;1;0;0;0;3;16;1;3;255;21;21;1;0;0;3;3;255;0;522;3;1;
/org.eclipse.jdt.ui/ui/org/eclipse/jdt/internal/ui/util/IDocumentManager.java;2;0;4;1;0;0;0;4;20;1;4;15;25;25;1;0;0;4;4;15;0;2218;4;2;
/org.eclipse.swt/Eclipse SWT PI/gtk/org/eclipse/swt/internal/gtk/GtkFixed.java;2;2;3;1;3;2;3;0;7;0;0;4404;7;7;2;0;1;0;3;4701;1;4701;2;2;
/org.eclipse.pde.ui/src/org/eclipse/pde/internal/model/PluginObject.java;2;0;7;1;0;0;0;7;308;1;7;1434;363;363;1;0;0;7;7;1434;0;3136;7;2;
/org.eclipse.jdt.core/model/org/eclipse/jdt/internal/core/BinaryField.java;3;0;6;1;1;1;1;5;74;1;5;455;115;115;1;0;0;5;6;455;0;4063;6;3;
/org.eclipse.pde.ui/src/org/eclipse/pde/internal/editor/manifest/ExtensionSection.java;2;0;6;1;0;0;0;6;272;1;6;1434;289;289;1;0;0;6;6;1434;0;3579;6;2;
/org.eclipse.core.tests.runtime/src/org/eclipse/core/tests/internal/plugins/SoftPrereqTest_17.java;3;0;3;1;0;0;0;3;180;1;3;1794;190;190;1;0;0;3;3;1794;0;3476;3;3;
/org.eclipse.jdt.debug/model/org/eclipse/jdt/internal/debug/core/JDIDebugUtils.java;2;0;4;1;0;0;0;4;6;1;4;1962;8;8;1;0;0;4;4;1962;0;2635;4;2;
/org.eclipse.jdt.ui/core extension/org/eclipse/jdt/internal/corext/dom/Binding2JavaModel.java;2;0;3;1;0;0;0;3;25;1;3;3049;29;29;1;0;0;3;3;3049;0;3585;3;2;
/org.eclipse.jdt.debug/jdi/org/eclipse/jdi/internal/request/ThreadDeathRequestImpl.java;2;0;4;1;0;0;0;4;12;1;4;187;25;25;1;0;0;4;4;187;0;3670;4;2;
/org.eclipse.jdt.ui/ui refactoring/org/eclipse/jdt/internal/ui/refactoring/actions/SelfEncapsulateFieldAction.java;3;0;13;2;0;0;0;13;19;2;11;1462;74;74;2;2;0;13;13;1939;2;3792;11;3;
/org.eclipse.ui/Eclipse UI/org/eclipse/ui/internal/dialogs/FakeActionSetCategory.java;2;0;2;1;0;0;0;2;9;1;2;257;9;9;1;0;0;2;2;257;0;457;2;2;
/org.eclipse.jdt.core/compiler/org/eclipse/jdt/core/compiler/IScanner.java;2;1;9;1;3;3;3;6;31;2;5;3349;78;78;2;1;0;6;9;3373;1;4061;8;2;
/org.eclipse.update.ui/src/org/eclipse/update/internal/ui/manager/FeatureSelectionBlock.java;1;0;2;1;0;0;0;2;0;0;1;1457;0;0;2;1;0;2;2;1457;1;1457;1;1;
/org.eclipse.swt/Eclipse SWT/gtk/org/eclipse/swt/graphics/Color.java;3;1;7;1;3;3;3;4;281;1;4;2107;491;491;1;0;0;4;7;2107;0;4701;7;3;
/org.eclipse.scripting/src/org/eclipse/scripting/IToolkitUI.java;1;0;1;1;0;0;0;1;0;0;1;1424;0;0;1;0;0;1;1;1424;0;1424;1;1;
/org.eclipse.jdt.ui.tests.refactoring/resources/RenameType/test51/in/C.java;1;0;1;1;0;0;0;1;0;0;1;49;0;0;1;0;0;1;1;49;0;49;1;1;
/org.eclipse.jdt.ui.tests.refactoring/resources/RenameParameters/cannotRename/A_testFail11.java;1;0;1;1;0;0;0;1;0;0;1;233;0;0;1;0;0;1;1;233;0;233;1;1;
/org.eclipse.webdav/src/kernel/org/eclipse/webdav/internal/kernel/ContextImpl.java;2;0;3;1;0;0;0;3;5;1;3;12;5;5;1;0;0;3;3;12;0;1874;3;2;
/org.eclipse.core.tests.resources/src/org/eclipse/core/tests/internal/watson/PhantomElementData.java;3;0;4;1;1;1;1;3;62;1;3;1794;82;82;1;0;0;3;4;1794;0;4516;4;3;
/org.eclipse.jdt.core/compiler/org/eclipse/jdt/internal/compiler/lookup/LocalTypeBinding.java;2;0;10;1;1;1;1;9;199;4;6;455;318;318;4;3;0;9;10;1039;3;4062;7;2;
/org.eclipse.jdt.junit/Eclipse JUnit/org/eclipse/jdt/junit/internal/TextTestListener.java;2;0;2;1;0;0;0;2;0;1;2;1531;0;0;1;0;0;2;2;1531;0;2007;2;2;
/org.eclipse.swt.examples/src/org/eclipse/swt/examples/fileviewer/ComboView.java;2;0;3;2;0;0;0;3;88;2;2;554;88;88;2;1;0;3;3;609;1;609;2;2;
/org.eclipse.jdt.core/model/org/eclipse/jdt/internal/core/BinaryType.java;4;2;36;1;10;9;10;26;670;4;22;455;1143;1143;4;4;1;26;36;1039;5;4404;31;4;
/org.eclipse.jdt.ui/ui/org/eclipse/jdt/internal/ui/packageview/SelectionTransferDragAdapter.java;3;0;6;1;0;0;0;6;65;1;6;15;84;84;1;0;0;6;6;15;0;3794;6;3;
/org.eclipse.pde.ui/Eclipse PDE UI/org/eclipse/pde/internal/model/component/ComponentURL.java;2;0;5;2;0;0;0;5;12;3;3;267;12;12;3;2;0;5;5;324;2;1434;3;2;
/org.eclipse.ui.tests/Eclipse UI Tests/org/eclipse/ui/tests/api/IEditorDescriptorTest.java;3;0;5;1;0;0;0;5;4;1;5;983;11;11;1;0;0;5;5;983;0;2785;5;3;
/org.eclipse.pde.ui/src/org/eclipse/pde/internal/model/component/AbstractComponentModel.java;2;0;3;1;0;0;0;3;8;1;3;1434;8;8;1;0;0;3;3;1434;0;2951;3;2;
/org.eclipse.jdt.ui/core refactoring/org/eclipse/jdt/internal/corext/refactoring/text/ITextBuffer.java;1;0;2;1;0;0;0;2;0;1;2;1939;0;0;1;0;0;2;2;1939;0;2216;2;1;
/org.eclipse.team.cvs.core/src/org/eclipse/team/internal/ccvs/core/util/FileDateFormat.java;3;0;4;1;0;0;0;4;86;1;4;1978;89;89;1;0;0;4;4;1978;0;2570;4;3;
/org.eclipse.swt.examples/Eclipse SWT Examples/common/org/eclipse/swt/examples/addressbook/FindListener.java;1;0;2;1;0;0;0;2;0;1;2;107;0;0;1;0;0;2;2;107;0;611;2;1;
/org.eclipse.jdt.ui.tests.refactoring/resources/PullUp/testField0/in/A.java;1;0;1;1;0;0;0;1;0;0;1;2406;0;0;1;0;0;1;1;2406;0;2406;1;1;
/org.eclipse.jdt.debug.tests/tests/org/eclipse/jdt/debug/tests/eval/TypeHierarchy_57_3.java;2;1;3;1;3;3;3;0;13;0;0;4447;15;15;1;0;0;0;3;4447;0;4571;3;2;
/org.eclipse.webdav/src/interface/org/eclipse/webdav/dom/Status.java;3;0;6;1;1;1;1;5;170;1;5;12;209;209;1;0;0;5;6;12;0;4211;6;3;
/org.eclipse.jdt.ui.tests.refactoring/resources/RenameMethodInInterface/test20/out/A.java;1;0;1;1;0;0;0;1;0;0;1;49;0;0;1;0;0;1;1;49;0;49;1;1;
/org.eclipse.core.tests.runtime/src/org/eclipse/core/tests/runtime/model/ConfigurationElementModelTest.java;3;0;4;1;0;0;0;4;16;1;4;1794;34;34;1;0;0;4;4;1794;0;3476;4;3;
/org.eclipse.webdav/src/interface/org/eclipse/webdav/ILocatorFactory.java;2;0;4;1;1;1;1;3;142;1;3;1635;228;228;1;0;0;3;4;1635;0;4211;4;2;
/org.eclipse.jdt.ui.tests.refactoring/resources/PullUpMethods/testFail0/in/A.java;1;0;2;1;0;0;0;2;0;1;2;2156;0;0;1;0;0;2;2;2156;0;2406;2;1;
/org.eclipse.team.tests.cvs.core/src/org/eclipse/team/tests/ccvs/ui/logformatter/CaseEntry.java;1;0;1;1;0;0;0;1;0;0;1;2977;0;0;1;0;0;1;1;2977;0;2977;1;1;
/org.eclipse.help/src/org/eclipse/help/internal/Help.java;2;0;4;1;0;0;0;4;20;1;4;1420;28;28;1;0;0;4;4;1420;0;2586;4;2;
/org.eclipse.jdt.ui.tests.refactoring/resources/RenameType/test41/out/B.java;1;0;1;1;0;0;0;1;0;0;1;49;0;0;1;0;0;1;1;49;0;49;1;1;
/org.eclipse.pde.core/src/org/eclipse/pde/internal/core/builders/SchemaTransformer.java;1;0;3;1;0;0;0;3;29;1;3;3591;29;29;1;0;0;3;3;3591;0;3631;3;1;
/org.eclipse.swt/Eclipse SWT Custom Widgets/common/org/eclipse/swt/custom/DefaultContent.java;6;0;11;1;1;1;1;10;77;1;10;106;150;150;1;0;0;10;11;106;0;4701;11;6;
/org.eclipse.pde.ui/src/org/eclipse/pde/internal/core/plugin/PluginBase.java;1;0;3;1;0;0;0;3;15;2;2;3579;15;15;2;1;0;3;3;3579;1;3607;2;1;
/org.eclipse.jdt.ui/core refactoring/org/eclipse/jdt/core/refactoring/methods/MethodRefactoring.java;1;0;4;1;0;0;0;4;11;1;4;15;16;16;1;0;0;4;4;15;0;408;4;1;
/org.eclipse.jdt.ui.tests.refactoring/test cases/org/eclipse/jdt/ui/tests/refactoring/DeleteSourceReferenceTests.java;2;0;5;1;0;0;0;5;8;2;4;2003;10;10;2;1;0;5;5;2133;1;2857;4;2;
/org.eclipse.jdt.ui/ui/org/eclipse/jdt/internal/ui/actions/AddUnimplementedMethodsAction.java;5;0;20;2;1;1;1;19;57;2;18;15;189;189;2;1;0;19;20;740;1;3968;19;5;
/org.eclipse.help.ui/src/org/eclipse/help/ui/internal/StyledLineWrapper.java;2;1;2;1;2;2;2;0;6;0;0;4439;6;6;1;0;0;0;2;4439;0;4668;2;2;
/org.eclipse.webdav/src/interface/org/eclipse/webdav/Context.java;3;0;3;1;0;0;0;3;12;1;3;12;12;12;1;0;0;3;3;12;0;1874;3;3;
/org.eclipse.swt.tests/JUnit Tests/org/eclipse/swt/tests/junit/Test_org_eclipse_swt_widgets_Text.java;2;0;2;1;1;1;1;1;6;0;1;1792;6;6;1;0;0;1;2;1792;0;4706;2;2;
/org.eclipse.debug.ui/ui/org/eclipse/debug/internal/ui/VariableViewsPreferencePage.java;2;0;3;1;1;1;1;2;12;1;2;3835;12;12;1;0;0;2;3;3835;0;3975;3;2;
/org.eclipse.swt/Eclipse SWT/win32/org/eclipse/swt/internal/BidiText.java;1;0;1;1;0;0;0;1;0;0;1;1029;0;0;1;0;0;1;1;1029;0;1029;1;1;
/org.eclipse.jdt.ui.tests.refactoring/resources/SelectionAnalyzerWorkSpace/SelectionAnalyzerTests/invalidSelection/A_test180.java;2;0;2;1;0;0;0;2;0;1;2;1368;0;0;1;0;0;2;2;1368;0;2139;2;2;
/org.eclipse.core.tests.resources/src/org/eclipse/core/tests/resources/IWorkspaceRootTest.java;3;0;6;1;0;0;0;6;126;1;6;1794;229;229;1;0;0;6;6;1794;0;3859;6;3;
/org.eclipse.update.ui/src/org/eclipse/update/internal/ui/model/BookmarkUtil.java;1;0;5;1;1;1;1;4;78;1;4;3517;145;145;1;0;0;4;5;3517;0;4436;5;1;
/org.eclipse.pde.build/src_ant/org/eclipse/pde/internal/build/tasks/FetchTask.java;1;0;5;1;0;0;0;5;7;2;4;3509;13;13;2;1;0;5;5;3571;1;3672;4;1;
/org.eclipse.core.tests.harness/src/org/eclipse/core/tests/harness/PerformanceTestResult.java;3;0;4;1;1;1;1;3;276;1;3;1794;297;297;1;0;0;3;4;1794;0;4516;4;3;
/org.eclipse.ui/Eclipse UI Text Editor/org/eclipse/ui/texteditor/AbstractDocumentProvider.java;4;1;14;1;6;6;6;8;430;1;8;257;899;899;1;0;0;8;14;257;0;4853;14;4;
/org.eclipse.jdt.ui.tests.refactoring/resources/RenameType/testFail46/in/A.java;1;0;1;1;0;0;0;1;0;0;1;49;0;0;1;0;0;1;1;49;0;49;1;1;
/org.eclipse.ui/Eclipse JFace/org/eclipse/jface/viewers/ILabelDecorator.java;2;0;2;1;0;0;0;2;4;1;2;257;4;4;1;0;0;2;2;257;0;457;2;2;
/org.eclipse.jdt.ui.tests/nls/org/eclipse/jdt/ui/nls/tests/NLSScannerTester.java;1;0;4;1;0;0;0;4;31;1;4;1754;43;43;1;0;0;4;4;1754;0;1939;4;1;
/org.eclipse.help.ui/src/org/eclipse/help/internal/ui/HyperlinkHandler.java;2;1;5;1;2;2;2;3;47;1;3;1420;62;62;1;0;0;3;5;1420;0;4439;5;2;
/org.eclipse.jdt.ui/ui/org/eclipse/jdt/internal/ui/J9Settings.java;1;0;5;1;0;0;0;5;17;1;5;15;29;29;1;0;0;5;5;15;0;416;5;1;
/org.eclipse.webdav/src/client/org/eclipse/webdav/internal/authentication/Parser.java;3;0;5;1;1;1;1;4;264;1;4;12;468;468;1;0;0;4;5;12;0;4211;5;3;
/org.eclipse.help.webapp/src/org/eclipse/help/servlet/ContentServlet.java;3;0;4;1;1;1;1;3;3;1;3;2409;6;6;1;0;0;3;4;2409;0;3928;4;3;
/org.eclipse.ui/Eclipse UI/org/eclipse/ui/IEditorActionDelegate.java;2;0;2;1;0;0;0;2;5;1;2;257;5;5;1;0;0;2;2;257;0;457;2;2;
/org.eclipse.jdt.ui.tests.refactoring/resources/ReorderParameters/canReorder/A_test7_in.java;1;0;3;1;0;0;0;3;0;1;3;724;0;0;1;0;0;3;3;724;0;2270;3;1;
/org.eclipse.pde.ui/src/org/eclipse/pde/core/IModelChangedListener.java;1;0;2;1;0;0;0;2;0;1;2;3579;0;0;1;0;0;2;2;3579;0;3607;2;1;
/org.eclipse.jdt.ui.tests.refactoring/resources/MoveMembers/test4/out/B.java;1;0;1;1;0;0;0;1;0;0;1;2738;0;0;1;0;0;1;1;2738;0;2738;1;1;
/org.eclipse.team.cvs.core/src/org/eclipse/team/internal/ccvs/core/resources/EclipseResource.java;3;2;19;2;6;5;6;13;243;3;11;3004;324;324;3;2;1;13;19;3105;3;4569;16;3;
/org.eclipse.jdt.core/model/org/eclipse/jdt/internal/core/CompilationUnitStructureRequestor.java;3;0;19;1;1;1;1;18;1062;4;14;455;1485;1485;4;4;0;18;19;1039;4;4063;15;3;
/org.eclipse.pde.ui/src/org/eclipse/pde/internal/model/jars/WorkspaceJarsModel.java;2;0;2;1;0;0;0;2;0;1;2;1434;0;0;1;0;0;2;2;1434;0;2650;2;2;
/org.eclipse.update.core/src/org/eclipse/update/core/IActivity.java;1;0;9;1;0;0;0;9;20;2;8;2004;56;56;2;1;0;9;9;2180;1;2994;8;1;
/org.eclipse.jdt.ui/ui/org/eclipse/jdt/internal/ui/dialogs/ElementListSelectionDialog.java;4;0;15;1;1;1;1;14;65;3;11;15;222;222;3;3;0;14;15;1298;3;4015;12;4;
/org.eclipse.team.core/src/org/eclipse/team/internal/core/StringMatcher.java;1;0;2;1;1;1;1;1;2;0;1;3762;2;2;1;0;0;1;2;3762;0;4571;2;1;
/org.eclipse.help/src/org/eclipse/help/internal/server/HelpHttpConnection.java;1;0;2;1;0;0;0;2;0;1;2;1420;0;0;1;0;0;2;2;1420;0;3095;2;1;
/org.eclipse.debug.ui/ui/org/eclipse/debug/internal/ui/ControlActionDelegate.java;3;0;20;2;0;0;0;20;125;3;17;187;371;371;3;3;0;20;20;2327;3;2382;17;3;
/org.eclipse.jdt.ui/core extension/org/eclipse/jdt/internal/corext/dom/BindingIdentifier.java;1;0;1;1;0;0;0;1;0;0;1;2876;0;0;1;0;0;1;1;2876;0;2876;1;1;
/org.eclipse.jdt.core/search/org/eclipse/jdt/internal/core/search/indexing/AddClassFileToIndex.java;3;1;20;1;4;4;4;16;104;4;13;455;307;307;4;3;0;16;20;1039;3;4525;17;3;
/org.eclipse.jdt.ui.tests.refactoring/resources/ExtractMethodWorkSpace/ExtractMethodTests/return_out/A_test706.java;1;1;3;1;2;2;2;1;24;0;1;887;24;24;1;0;0;1;3;887;0;4419;3;1;
/org.eclipse.swt/Eclipse SWT/photon/org/eclipse/swt/widgets/Text.java;7;1;21;2;5;5;5;16;672;2;15;106;1089;1089;2;1;0;16;21;860;1;4701;20;7;
/org.eclipse.swt/Eclipse SWT/common/org/eclipse/swt/events/PaintEvent.java;2;0;3;1;1;1;1;2;6;1;2;106;10;10;1;0;0;2;3;106;0;4701;3;2;
/org.eclipse.jdt.ui.tests.refactoring/resources/ExtractMethodWorkSpace/ExtractMethodTests/B.java;1;0;2;1;0;0;0;2;0;1;2;1236;0;0;1;0;0;2;2;1236;0;2915;2;1;
/org.eclipse.jdt.junit/src/org/eclipse/jdt/internal/junit/launcher/LaunchTestAction.java;1;1;2;1;2;2;2;0;0;0;0;4254;0;0;1;0;0;0;2;4254;0;4370;2;1;
/org.eclipse.core.tests.resources/src/org/eclipse/core/tests/resources/session/TestBuilderDeltaSerialization.java;2;0;3;1;0;0;0;3;228;1;3;2584;238;238;1;0;0;3;3;2584;0;3475;3;2;
/org.eclipse.jdt.ui/ui/org/eclipse/jdt/internal/ui/preferences/JavaPreferencesSettings.java;3;0;4;1;0;0;0;4;3;1;4;2016;6;6;1;0;0;4;4;2016;0;3701;4;3;
/org.eclipse.jdt.ui.tests.refactoring/resources/PullUpMethods/test14/in/A.java;1;0;3;1;0;0;0;3;2;1;3;2286;2;2;1;0;0;3;3;2286;0;2406;3;1;
/org.eclipse.jdt.ui/ui/org/eclipse/jdt/internal/ui/viewsupport/JavaUILabelProvider.java;2;1;10;1;4;4;4;6;142;3;4;2581;292;292;3;2;0;6;10;2581;2;4361;8;2;
/org.eclipse.jdt.core/model/org/eclipse/jdt/internal/core/builder/impl/SourceElementTable.java;1;0;10;1;0;0;0;10;97;4;6;455;115;115;4;4;0;10;10;1039;4;2808;6;1;
/org.eclipse.help/src/RequestInfoExample.java;1;0;2;1;0;0;0;2;0;1;2;1882;0;0;1;0;0;2;2;1882;0;1930;2;1;
/org.eclipse.update.tests.core/src/org/eclipse/update/tests/nativeTests/TestLocalSystemInfo.java;2;2;5;2;3;2;3;2;32;1;2;3721;42;42;2;0;1;2;5;3901;1;4119;4;2;
/org.eclipse.jdt.ui.tests.refactoring/resources/RenameType/testFail6/in/A.java;1;0;1;1;0;0;0;1;0;0;1;49;0;0;1;0;0;1;1;49;0;49;1;1;
/org.eclipse.jdt.ui/core refactoring/org/eclipse/jdt/internal/core/refactoring/util/ASTs.java;2;0;3;1;0;0;0;3;6;1;3;1236;6;6;1;0;0;3;3;1236;0;1462;3;2;
/org.eclipse.webdav/src/interface/org/eclipse/webdav/internal/utils/URLDecoder.java;4;1;7;1;3;3;3;4;280;1;4;12;635;635;1;0;0;4;7;12;0;4651;7;4;
/org.eclipse.ui.examples.javaeditor/Eclipse Java Editor Example/org/eclipse/ui/examples/javaeditor/java/JavaEditorMessages.java;1;0;1;1;0;0;0;1;0;0;1;1067;0;0;1;0;0;1;1;1067;0;1067;1;1;
/org.eclipse.team.examples.filesystem/src/org/eclipse/team/examples/filesystem/FileSystemPlugin.java;1;0;1;1;1;1;1;0;0;0;0;4674;0;0;1;0;0;0;1;4674;0;4674;1;1;
/org.eclipse.jdt.ui/ui/org/eclipse/jdt/internal/ui/text/template/LocalVariableEvaluator.java;1;0;3;1;0;0;0;3;52;1;3;1469;52;52;1;0;0;3;3;1469;0;1720;3;1;
/org.eclipse.jdt.ui.tests.refactoring/resources/ReorderParameters/canReorder/A_test13_out.java;1;0;3;1;0;0;0;3;0;1;3;724;0;0;1;0;0;3;3;724;0;2270;3;1;
/org.eclipse.jdt.ui.tests.refactoring/resources/MoveCU/testFail3/in/p1/C.java;2;0;2;1;0;0;0;2;0;1;2;49;0;0;1;0;0;2;2;49;0;2769;2;2;
/org.eclipse.jdt.ui.tests.refactoring/resources/ExtractMethodWorkSpace/ExtractMethodTests/semicolon_in/A_test401.java;2;1;3;1;2;2;2;1;0;0;1;49;0;0;1;0;0;1;3;49;0;4419;3;2;
/org.eclipse.jdt.ui/ui refactoring/org/eclipse/jdt/internal/ui/refactoring/PseudoJavaChangeElement.java;1;0;3;1;0;0;0;3;2;1;3;1800;4;4;1;0;0;3;3;1800;0;2512;3;1;
/org.eclipse.update.core/src/org/eclipse/update/internal/core/FeaturePackaged.java;2;0;11;1;0;0;0;11;30;1;11;1791;64;64;1;0;0;11;11;1791;0;2583;11;2;
/org.eclipse.core.tests.resources/src/org/eclipse/core/tests/internal/watson/DeltaChainFlatteningTest.java;3;0;3;1;1;1;1;2;126;1;2;1794;145;145;1;0;0;2;3;1794;0;4516;3;3;
/org.eclipse.swt/Eclipse SWT/common_j2se/org/eclipse/swt/internal/EventObjectCompatability.java;1;0;1;1;0;0;0;1;0;0;1;1378;0;0;1;0;0;1;1;1378;0;1378;1;1;
/org.eclipse.debug.ui/ui/org/eclipse/debug/internal/ui/preferences/ConsolePreferencePage.java;3;2;8;2;8;7;8;0;188;0;0;3975;296;296;2;0;1;0;8;4207;1;4688;7;3;
/org.eclipse.jdt.ui/ui/org/eclipse/jdt/internal/ui/compare/JavaAddElementFromHistory.java;3;1;26;1;2;2;2;24;207;2;20;15;924;924;2;4;0;24;26;77;4;4450;22;3;
/org.eclipse.pde.ui/src/org/eclipse/pde/internal/model/IdentifiablePluginObject.java;2;0;4;1;0;0;0;4;12;1;4;1434;13;13;1;0;0;4;4;1434;0;3136;4;2;
/org.eclipse.debug.ui/ui/org/eclipse/debug/internal/ui/actions/RemoveAllExpressionsAction.java;2;0;4;1;0;0;0;4;23;1;4;2382;31;31;1;0;0;4;4;2382;0;3257;4;2;
/org.eclipse.pde.ui/Eclipse PDE UI/org/eclipse/pde/internal/model/component/AbstractComponentModel.java;2;0;5;2;0;0;0;5;12;3;3;267;12;12;3;2;0;5;5;324;2;1434;3;2;
/org.eclipse.jdt.ui/nls/org/eclipse/jdt/internal/ui/nls/NLSSubstitutionContentProvider.java;1;0;2;1;0;0;0;2;0;1;2;1880;0;0;1;0;0;2;2;1880;0;1913;2;1;
/org.eclipse.jdt.debug.tests/tests/org/eclipse/jdt/debug/tests/core/RuntimeClasspathEntryTests.java;2;2;10;1;10;8;10;0;59;0;0;3939;114;114;2;0;2;0;10;3954;2;4571;8;2;
/org.eclipse.pde.ui/Eclipse PDE UI/org/eclipse/pde/internal/editor/schema/SchemaFormPage.java;2;0;5;2;0;0;0;5;12;3;3;267;12;12;3;2;0;5;5;324;2;1434;3;2;
/org.eclipse.jdt.junit/Eclipse JUnit/org/eclipse/jdt/internal/junit/launcher/JUnitArgumentsTab.java;2;0;3;2;0;0;0;3;226;2;2;2861;226;226;2;1;0;3;3;3068;1;3068;2;2;
/org.eclipse.pde.ui/Eclipse PDE UI/org/eclipse/pde/internal/base/schema/ISchemaSimpleType.java;2;0;5;2;0;0;0;5;12;3;3;267;12;12;3;2;0;5;5;324;2;1434;3;2;
/org.eclipse.jdt.ui/ui/org/eclipse/jdt/internal/ui/wizards/buildpaths/ClasspathContainerDefaultPage.java;2;1;2;1;2;2;2;0;4;0;0;4117;4;4;1;0;0;0;2;4117;0;4630;2;2;
/org.eclipse.jdt.core/model/org/eclipse/jdt/core/util/IClassFileDisassembler.java;3;2;11;2;8;7;8;3;69;2;2;3629;164;164;2;1;1;3;11;3644;2;4520;9;3;
/org.eclipse.update.ui/src/org/eclipse/update/internal/ui/model/IConfigurationSiteAdapter.java;2;0;2;1;0;0;0;2;0;1;2;2834;0;0;1;0;0;2;2;2834;0;2994;2;2;
/org.eclipse.swt.tests/JUnit Tests/org/eclipse/swt/tests/junit/Test_org_eclipse_swt_custom_AnimatedProgress.java;2;0;2;1;1;1;1;1;6;0;1;1792;6;6;1;0;0;1;2;1792;0;4706;2;2;
/org.eclipse.jdt.ui.tests.refactoring/resources/MoveMembers/test15/out/B.java;1;0;1;1;0;0;0;1;0;0;1;2738;0;0;1;0;0;1;1;2738;0;2738;1;1;
/org.eclipse.jdt.debug/jdi/org/eclipse/jdi/internal/event/ThreadDeathEventImpl.java;2;0;4;1;0;0;0;4;17;1;4;187;31;31;1;0;0;4;4;187;0;3670;4;2;
/org.eclipse.jdt.ui.tests.refactoring/resources/ExtractTemp/canExtract/A_test35_in.java;1;0;1;1;0;0;0;1;0;0;1;3264;0;0;1;0;0;1;1;3264;0;3264;1;1;
/org.eclipse.debug.ui/ui/org/eclipse/debug/ui/IDebugUIConstants.java;4;3;63;3;11;8;11;52;138;4;42;187;891;891;4;10;3;52;63;2340;13;4652;50;4;
/org.eclipse.swt.examples.paint/src/org/eclipse/swt/examples/paint/RoundedRectangleTool.java;4;0;5;2;1;1;1;4;82;2;3;586;90;90;2;1;0;4;5;609;1;4705;4;4;
/org.eclipse.jdt.ui/ui/org/eclipse/jdt/ui/actions/RefreshAction.java;2;1;4;1;4;4;4;0;19;0;0;4419;32;32;1;0;0;0;4;4419;0;4770;4;2;
/org.eclipse.scripting/src/org/eclipse/scripting/internal/uirenderer/XGRElementUISwtBreak.java;1;0;1;1;0;0;0;1;0;0;1;1424;0;0;1;0;0;1;1;1424;0;1424;1;1;
/org.eclipse.help.tests/src/org/eclipse/help/tests/appserver/TestTwoWebApps.java;1;0;1;1;0;0;0;1;0;0;1;2881;0;0;1;0;0;1;1;2881;0;2881;1;1;
/org.eclipse.ui.examples.javaeditor/Java Editor Example/org/eclipse/ui/examples/javaeditor/JavaContentOutlinePage.java;1;0;2;1;0;0;0;2;0;0;1;1066;0;0;2;1;0;2;2;1066;1;1066;1;1;
/org.eclipse.swt/Eclipse SWT/win32/org/eclipse/swt/widgets/Widget.java;9;3;16;1;6;4;6;10;94;2;9;106;288;288;3;1;2;10;16;4554;3;4701;13;9;
/org.eclipse.swt/Eclipse SWT/photon/org/eclipse/swt/widgets/Canvas.java;5;1;11;1;4;4;4;7;107;1;7;106;234;234;1;0;0;7;11;106;0;4701;11;5;
/org.eclipse.ui/Eclipse UI/org/eclipse/ui/IWindowListener.java;1;0;1;1;0;0;0;1;0;0;1;3589;0;0;1;0;0;1;1;3589;0;3589;1;1;
/org.eclipse.jdt.ui/ui refactoring/org/eclipse/jdt/internal/ui/refactoring/RenameRefactoringWizard.java;4;0;23;2;1;1;1;22;25;2;21;15;184;184;2;1;0;22;23;415;1;4141;22;4;
/org.eclipse.core.runtime/src/org/eclipse/core/runtime/model/PluginRegistryModel.java;4;0;7;1;1;1;1;6;760;1;6;12;947;947;1;0;0;6;7;12;0;4214;7;4;
/org.eclipse.jdt.ui/ui refactoring/org/eclipse/jdt/internal/ui/refactoring/nls/NLSSubstitutionContentProvider.java;2;0;2;1;0;0;0;2;4;1;2;1922;8;8;1;0;0;2;2;1922;0;1939;2;2;
/org.eclipse.jdt.ui.tests/JUnit/junit/swingui/TraceFrame.java;2;0;2;1;0;0;0;2;0;1;2;49;0;0;1;0;0;2;2;49;0;1186;2;2;
/org.eclipse.ui/Eclipse JFace/org/eclipse/jface/viewers/ColumnLayoutData.java;2;0;2;1;0;0;0;2;5;1;2;257;5;5;1;0;0;2;2;257;0;457;2;2;
/org.eclipse.jdt.ui/core refactoring/org/eclipse/jdt/core/refactoring/RefactoringStatusEntry.java;1;0;4;1;0;0;0;4;8;1;4;15;13;13;1;0;0;4;4;15;0;408;4;1;
/org.eclipse.core.resources/src/org/eclipse/core/internal/resources/WorkspaceTreeReader_2.java;3;0;4;1;1;1;1;3;130;1;3;182;171;171;1;0;0;3;4;182;0;4213;4;3;
/org.eclipse.jdt.ui.tests.refactoring/resources/SafeDeleteType/testFail3/in/A.java;1;0;1;1;0;0;0;1;0;0;1;49;0;0;1;0;0;1;1;49;0;49;1;1;
/org.eclipse.jdt.ui/core refactoring/org/eclipse/jdt/core/refactoring/text/ITextRegion.java;1;0;3;1;0;0;0;3;5;1;3;15;5;5;1;0;0;3;3;15;0;408;3;1;
/org.eclipse.jdt.ui.tests.refactoring/resources/RenamePrivateMethod/test27/in/A.java;1;0;1;1;0;0;0;1;0;0;1;1274;0;0;1;0;0;1;1;1274;0;1274;1;1;
/org.eclipse.debug.ui/ui/org/eclipse/debug/internal/ui/views/BreakpointsView.java;3;1;26;2;2;2;2;24;162;3;16;2312;454;454;3;8;0;24;26;2312;8;3975;18;3;
/org.eclipse.pde.ui/src/org/eclipse/pde/internal/wizards/imports/UpdateClasspathOperation.java;1;0;13;1;0;0;0;13;314;2;12;2522;522;522;2;1;0;13;13;3231;1;3579;12;1;
/org.eclipse.jdt.debug.tests/testprograms/EvalTypeHierarchyTests.java;2;1;2;1;2;2;2;0;11;0;0;4447;11;11;1;0;0;0;2;4447;0;4571;2;2;
/org.eclipse.team.cvs.ui/src/org/eclipse/team/internal/ccvs/ui/CVSDecorationRunnable.java;4;2;34;2;9;8;9;25;171;3;22;2484;752;752;3;3;1;25;34;3206;4;4707;30;4;
/org.eclipse.update.ui/src/org/eclipse/update/internal/ui/views/DetailsView.java;2;2;16;1;8;7;8;8;502;2;7;3537;677;677;2;1;1;8;16;3657;2;4771;14;2;
/org.eclipse.pde.ui/Eclipse PDE UI/org/eclipse/pde/internal/base/schema/ISchemaRepeatable.java;2;0;5;2;0;0;0;5;12;3;3;267;12;12;3;2;0;5;5;324;2;1434;3;2;
/org.eclipse.compare/compare/org/eclipse/compare/internal/patch/Patcher.java;1;2;11;1;5;4;5;6;122;2;5;2876;272;272;2;1;1;6;11;2876;2;4570;9;1;
/org.eclipse.update/src/org/eclipse/update/internal/core/UpdateManagerPlugin.java;1;0;1;1;0;0;0;1;0;0;1;1424;0;0;1;0;0;1;1;1424;0;1424;1;1;
/org.eclipse.ui/Eclipse JFace/org/eclipse/jface/action/ControlContribution.java;2;0;2;1;0;0;0;2;5;1;2;257;5;5;1;0;0;2;2;257;0;457;2;2;
/org.eclipse.swt/Eclipse SWT/gtk/org/eclipse/swt/widgets/Tracker.java;6;2;13;2;5;4;5;8;181;1;8;2107;396;396;2;0;1;8;13;4701;1;4701;12;6;
/org.eclipse.swt/Eclipse SWT/motif/org/eclipse/swt/graphics/Font.java;7;1;9;1;4;4;4;5;212;1;5;106;472;472;1;0;0;5;9;106;0;4701;9;7;
/org.eclipse.jdt.core/dom/org/eclipse/jdt/core/dom/VariableDeclarationExpression.java;2;1;6;1;2;2;2;4;14;1;4;2669;36;36;1;0;0;4;6;2669;0;4453;6;2;
/org.eclipse.team.cvs.ui/src/org/eclipse/team/internal/ccvs/ui/actions/CompareWithRevisionAction.java;3;1;11;1;2;2;2;9;38;1;9;2377;116;116;1;0;0;9;11;2377;0;4021;11;3;
/org.eclipse.ui/Eclipse UI Text Editor/org/eclipse/ui/editors/text/EncodingActionGroup.java;1;1;4;1;4;4;4;0;64;0;0;4138;88;88;1;0;0;0;4;4138;0;4838;4;1;
/org.eclipse.jdt.junit/src/org/eclipse/jdt/internal/junit/launcher/JUnitArgumentsTab.java;2;0;3;1;0;0;0;3;13;1;3;3171;13;13;1;0;0;3;3;3171;0;3624;3;2;
/org.eclipse.swt/Eclipse SWT Custom Widgets/common/org/eclipse/swt/custom/StyledText.java;11;2;75;2;13;10;13;62;2401;3;44;106;10182;10182;3;18;3;62;75;1406;21;4701;54;11;
/org.eclipse.pde.ui/src/org/eclipse/pde/internal/model/plugin/WorkspacePluginModel.java;1;0;2;1;0;0;0;2;0;1;2;3136;0;0;1;0;0;2;2;3136;0;3579;2;1;
/org.eclipse.jdt.debug/model/org/eclipse/jdt/debug/core/IJavaClassObject.java;1;0;2;1;0;0;0;2;9;1;2;1675;9;9;1;0;0;2;2;1675;0;3559;2;1;
/org.eclipse.swt/Eclipse SWT/carbon/org/eclipse/swt/graphics/Image.java;4;1;6;1;6;6;6;0;80;0;0;4147;113;113;1;0;0;0;6;4147;0;4701;6;4;
/org.eclipse.swt/Eclipse SWT/common/org/eclipse/swt/events/ModifyEvent.java;2;0;3;1;1;1;1;2;6;1;2;106;10;10;1;0;0;2;3;106;0;4701;3;2;
/org.eclipse.jdt.ui.tests.refactoring/resources/MultiMove/test2/in/p1/A.java;1;0;1;1;0;0;0;1;0;0;1;1157;0;0;1;0;0;1;1;1157;0;1157;1;1;
/org.eclipse.ui.tests/Eclipse UI Tests/org/eclipse/ui/tests/dialogs/UIMessageDialogs.java;3;0;6;1;1;1;1;5;66;1;5;1113;80;80;1;0;0;5;6;1113;0;4261;6;3;
/org.eclipse.help/src/org/eclipse/help/internal/contributions/InfoSet.java;2;0;2;1;0;0;0;2;0;1;2;1420;0;0;1;0;0;2;2;1420;0;1675;2;2;
/org.eclipse.jdt.core/compiler/org/eclipse/jdt/internal/compiler/lookup/PackageBinding.java;3;0;12;1;1;1;1;11;356;4;7;455;426;426;4;4;0;11;12;1039;4;4062;8;3;
/org.eclipse.jdt.ui.tests/refactoring/experiments/MyAction.java;1;0;2;1;0;0;0;2;0;1;2;729;0;0;1;0;0;2;2;729;0;1895;2;1;
/org.eclipse.jdt.ui/core refactoring/org/eclipse/jdt/internal/corext/refactoring/rename/RenameParameterASTAnalyzer.java;2;0;3;1;0;0;0;3;4;1;3;1939;4;4;1;0;0;3;3;1939;0;2630;3;2;
/org.eclipse.jdt.debug/jdi interfaces/com/sun/jdi/event/MethodEntryEvent.java;2;0;2;1;0;0;0;2;11;1;2;2704;11;11;1;0;0;2;2;2704;0;3040;2;2;
/org.eclipse.jdt.ui.tests.refactoring/resources/MultiMove/test2/out/p2/A.java;1;0;3;1;0;0;0;3;3;1;3;1157;5;5;1;0;0;3;3;1157;0;2682;3;1;
/org.eclipse.team.cvs.ui/src/org/eclipse/team/internal/ccvs/ui/BranchPromptDialog.java;2;2;7;1;7;6;7;0;17;0;0;3957;42;42;2;0;1;0;7;3957;1;4284;6;2;
/org.eclipse.jdt.debug/eval/org/eclipse/jdt/internal/debug/eval/model/EvaluationElement.java;1;0;2;1;0;0;0;2;0;1;2;3421;0;0;1;0;0;2;2;3421;0;3645;2;1;
/org.eclipse.pde.ui/src/org/eclipse/pde/internal/editor/schema/TypeRestrictionDescriptor.java;2;0;2;1;0;0;0;2;0;1;2;1434;0;0;1;0;0;2;2;1434;0;3579;2;2;
/org.eclipse.swt/Eclipse SWT Drag and Drop/emulated/org/eclipse/swt/dnd/Clipboard.java;2;2;7;1;6;5;6;1;85;0;1;3126;189;189;2;0;1;1;7;4824;1;4824;6;2;
/org.eclipse.pde.ui/src/org/eclipse/pde/internal/model/component/ComponentReference.java;2;0;2;1;0;0;0;2;0;1;2;1434;0;0;1;0;0;2;2;1434;0;2951;2;2;
/org.eclipse.jdt.debug.tests/test plugin/org/eclipse/jdt/debug/testplugin/SpecificDebugElementEventWaiter.java;2;0;2;1;1;1;1;1;11;0;1;3701;11;11;1;0;0;1;2;3701;0;4328;2;2;
/org.eclipse.ui.examples.readmetool/Eclipse UI Examples Readme Tool/org/eclipse/ui/examples/readmetool/ReadmeFilePropertyPage.java;3;0;3;1;0;0;0;3;16;1;3;932;18;18;1;0;0;3;3;932;0;3029;3;3;
/org.eclipse.jdt.ui.tests.refactoring/resources/RenameType/test13/out/A.java;1;0;2;1;0;0;0;2;0;1;2;49;0;0;1;0;0;2;2;49;0;522;2;1;
/org.eclipse.jdt.ui/ui/org/eclipse/jdt/internal/ui/jarpackager/JarWriter.java;2;0;12;1;0;0;0;12;28;2;11;239;119;119;2;1;0;12;12;872;1;3529;11;2;
/org.eclipse.vcm.ui/src/org/eclipse/vcm/internal/ui/sync/CommitChangesAction.java;1;0;2;1;0;0;0;2;0;1;2;48;0;0;1;0;0;2;2;48;0;62;2;1;
/org.eclipse.help/src/org/eclipse/help/internal/contributors/xml/ContributionParser.java;2;0;2;1;0;0;0;2;0;1;2;1420;0;0;1;0;0;2;2;1420;0;1675;2;2;
/org.eclipse.core.resources/src/org/eclipse/core/internal/indexing/IndexNode.java;4;0;7;1;1;1;1;6;1852;1;6;12;3592;3592;1;0;0;6;7;12;0;4214;7;4;
/org.eclipse.pde.ui/src/org/eclipse/pde/internal/ui/util/SharedLabelProvider.java;1;0;1;1;0;0;0;1;0;0;1;3579;0;0;1;0;0;1;1;3579;0;3579;1;1;
/org.eclipse.jdt.ui.tests.refactoring/resources/MoveMembers/test24/in/A.java;1;0;1;1;0;0;0;1;0;0;1;2928;0;0;1;0;0;1;1;2928;0;2928;1;1;
/org.eclipse.ui/Eclipse UI/org/eclipse/ui/internal/EditorArea.java;5;0;8;1;1;1;1;7;21;1;7;257;55;55;1;0;0;7;8;257;0;4082;8;5;
/org.eclipse.help/src/org/eclipse/help/internal/search/ISearchHitCollector.java;1;0;1;1;1;1;1;0;0;0;0;4002;0;0;1;0;0;0;1;4002;0;4002;1;1;
/org.eclipse.jdt.ui.tests/JUnit/junit/ui/AboutDialog.java;2;0;2;1;0;0;0;2;0;1;2;49;0;0;1;0;0;2;2;49;0;1186;2;2;
/org.eclipse.pde.ui/Eclipse PDE UI/org/eclipse/pde/internal/wizards/extension/NewExtensionRegistryReader.java;2;0;5;2;0;0;0;5;12;3;3;267;12;12;3;2;0;5;5;324;2;1434;3;2;
/org.eclipse.jdt.ui/core refactoring/org/eclipse/jdt/internal/corext/refactoring/Assert.java;1;0;2;1;1;1;1;1;6;0;1;1939;6;6;1;0;0;1;2;1939;0;4400;2;1;
/org.eclipse.ui/Eclipse UI/org/eclipse/ui/IMarkerResolutionGenerator.java;1;0;1;1;0;0;0;1;0;0;1;2895;0;0;1;0;0;1;1;2895;0;2895;1;1;
/org.eclipse.core.tests.runtime/src/org/eclipse/core/tests/runtime/ProgressMonitorWrapperTest.java;3;0;3;1;0;0;0;3;82;1;3;1794;92;92;1;0;0;3;3;1794;0;3476;3;3;
/org.eclipse.webdav/src/kernel/org/eclipse/webdav/internal/kernel/InvalidPropertyNameException.java;1;1;5;1;2;2;2;3;56;1;3;12;80;80;1;0;0;3;5;12;0;4228;5;1;
/org.eclipse.jdt.ui.tests.refactoring/resources/RenameNonPrivateField/test12/out/A.java;1;0;1;1;0;0;0;1;0;0;1;951;0;0;1;0;0;1;1;951;0;951;1;1;
/org.eclipse.ui.examples.readmetool/Eclipse UI Examples Readme Tool/org/eclipse/ui/examples/readmetool/ReadmeImages.java;2;0;3;1;1;1;1;2;28;1;2;932;34;34;1;0;0;2;3;932;0;4639;3;2;
/org.eclipse.update.ui/src/org/eclipse/update/internal/transform/FeatureTransform.java;1;0;5;1;0;0;0;5;42;2;4;1526;84;84;2;1;0;5;5;1526;1;1596;4;1;
/org.eclipse.jdt.ui/ui/org/eclipse/jdt/internal/ui/actions/ShowTypeHierarchyOnTypeAction.java;1;0;2;1;0;0;0;2;0;1;2;15;0;0;1;0;0;2;2;15;0;349;2;1;
/org.eclipse.ui/Eclipse UI Text Editor/org/eclipse/ui/texteditor/InfoForm.java;1;1;3;1;3;3;3;0;49;0;0;4138;59;59;1;0;0;0;3;4138;0;4853;3;1;
/org.eclipse.jdt.ui.tests.refactoring/resources/MoveCU/testFail5/in/p1/C.java;2;0;2;1;0;0;0;2;0;1;2;49;0;0;1;0;0;2;2;49;0;2769;2;2;
/org.eclipse.jdt.ui/ui refactoring/org/eclipse/jdt/internal/ui/refactoring/RenameRefactoringWizard2.java;2;0;2;2;0;0;0;2;2;1;2;1877;2;2;1;0;0;2;2;1877;0;1939;2;2;
/org.eclipse.swt/Eclipse SWT/common/org/eclipse/swt/events/ControlEvent.java;2;0;3;1;1;1;1;2;6;1;2;106;10;10;1;0;0;2;3;106;0;4701;3;2;
/org.eclipse.jdt.debug.ui/ui/org/eclipse/jdt/internal/debug/ui/actions/StackFrameAction.java;1;0;2;1;1;1;1;1;2;0;1;2384;2;2;1;0;0;1;2;2384;0;4552;2;1;
/org.eclipse.jdt.ui/ui/org/eclipse/jdt/internal/ui/filters/JavaFileFilter.java;1;0;1;1;1;1;1;0;0;0;0;4212;0;0;1;0;0;0;1;4212;0;4212;1;1;
/org.eclipse.jdt.ui/ui/org/eclipse/jdt/internal/ui/reorg/MockWorkbenchSite.java;1;0;1;1;0;0;0;1;0;0;1;3827;0;0;1;0;0;1;1;3827;0;3827;1;1;
/org.eclipse.help/src/org/eclipse/help/internal/contributions1_0/TopicRef.java;1;0;2;1;0;0;0;2;0;1;2;1675;0;0;1;0;0;2;2;1675;0;2217;2;1;
/org.eclipse.jdt.junit/src/org/eclipse/jdt/internal/junit/ui/OpenEditorAtLineAction.java;1;1;3;1;2;2;2;1;2;0;1;3171;4;4;1;0;0;1;3;3171;0;4634;3;1;
/org.eclipse.jdt.core/model/org/eclipse/jdt/internal/core/builder/SearchResultEvent.java;1;0;4;1;0;0;0;4;69;1;4;455;81;81;1;0;0;4;4;455;0;2808;4;1;
/org.eclipse.scripting/Eclipse Scripting/org/eclipse/scripting/internal/uirenderer/XGRElementUISwtCheckBox.java;2;0;6;1;0;0;0;6;41;1;6;133;56;56;1;0;0;6;6;133;0;1424;6;2;
/org.eclipse.pde.ui/src/org/eclipse/pde/internal/editor/schema/SchemaSourceOutlinePage.java;2;0;2;1;0;0;0;2;0;1;2;1434;0;0;1;0;0;2;2;1434;0;3579;2;2;
/org.eclipse.jdt.ui.tests.refactoring/resources/RenameType/testFail63/in/A.java;1;0;1;1;0;0;0;1;0;0;1;49;0;0;1;0;0;1;1;49;0;49;1;1;
/org.eclipse.jdt.ui.tests.refactoring/test cases/org/eclipse/jdt/ui/tests/nls/AllTests.java;1;0;2;1;0;0;0;2;3;1;2;2015;3;3;1;0;0;2;2;2015;0;3246;2;1;
/org.eclipse.jdt.core/codeassist/org/eclipse/jdt/internal/codeassist/complete/CompletionOnQualifiedNameReference.java;2;0;9;1;1;1;1;8;85;4;5;455;153;153;4;3;0;8;9;1039;3;4062;6;2;
/org.eclipse.update.ui/src/org/eclipse/update/internal/ui/manager/InstallConfigurationForm.java;2;0;6;1;0;0;0;6;4;1;6;2827;10;10;1;0;0;6;6;2827;0;3662;6;2;
/org.eclipse.ui/Eclipse UI/org/eclipse/ui/actions/CloseResourceAction.java;6;0;9;1;1;1;1;8;248;1;8;257;306;306;1;0;0;8;9;257;0;4082;9;6;
/org.eclipse.pde.ui/src/org/eclipse/pde/internal/elements/NamedElement.java;2;0;2;1;0;0;0;2;0;1;2;1434;0;0;1;0;0;2;2;1434;0;3579;2;2;
/org.eclipse.jdt.ui.tests.refactoring/resources/DeleteSourceReference/test6/in/A.java;1;0;1;1;0;0;0;1;0;0;1;2857;0;0;1;0;0;1;1;2857;0;2857;1;1;
/org.eclipse.jdt.core/model/org/eclipse/jdt/core/jdom/IDOMMember.java;2;0;5;1;2;1;2;3;70;1;3;455;104;104;2;0;1;3;5;4058;1;4058;4;2;
/org.eclipse.core.resources/src/org/eclipse/core/internal/resources/MarkerReader.java;2;0;6;1;1;1;1;5;86;1;5;12;136;136;1;0;0;5;6;12;0;4213;6;2;
/org.eclipse.jdt.ui/ui/org/eclipse/jdt/internal/ui/filters/CuAndClassFileFilter.java;1;0;2;1;2;1;2;0;0;0;0;4211;0;0;2;0;1;0;2;4211;1;4211;1;1;
/org.eclipse.core.resources/src/org/eclipse/core/internal/utils/AssertionFailedException.java;1;0;4;1;1;1;1;3;54;1;3;12;75;75;1;0;0;3;4;12;0;4214;4;1;
/org.eclipse.jdt.ui/core refactoring/org/eclipse/jdt/internal/corext/refactoring/changes/DeleteFileChange.java;2;0;3;1;1;1;1;2;37;1;2;1939;42;42;1;0;0;2;3;1939;0;3947;3;2;
/org.eclipse.jdt.core/compiler/org/eclipse/jdt/internal/compiler/ast/NameReference.java;2;1;7;1;2;2;2;5;73;1;5;455;103;103;1;0;0;5;7;455;0;4421;7;2;
/org.eclipse.jdt.ui.tests.refactoring/resources/RenameTemp/canRename/A_test26_out.java;1;0;2;1;0;0;0;2;2;1;2;1625;2;2;1;0;0;2;2;1625;0;1652;2;1;
/org.eclipse.debug.ui/ui/org/eclipse/debug/ui/DebugUITools.java;4;2;26;2;4;3;4;22;107;2;18;187;496;496;2;4;1;22;26;2331;5;4454;21;4;
/org.eclipse.ui/Eclipse UI/org/eclipse/ui/internal/dialogs/ProjectCapabilitySimpleSelectionPage.java;1;0;1;1;0;0;0;1;0;0;1;3609;0;0;1;0;0;1;1;3609;0;3609;1;1;
/org.eclipse.scripting/Eclipse Scripting/org/eclipse/scripting/internal/datamodels/XGRXmlElementsAndAttributesDataModel.java;2;0;4;1;0;0;0;4;18;1;4;133;22;22;1;0;0;4;4;133;0;1424;4;2;
/org.eclipse.debug.core/core/org/eclipse/debug/core/model/ITerminate.java;3;0;4;1;0;0;0;4;6;1;4;187;17;17;1;0;0;4;4;187;0;3474;4;3;
/org.eclipse.jdt.ui.tests.refactoring/resources/RenameParameters/canRename/A_test31_in.java;1;0;1;1;0;0;0;1;0;0;1;233;0;0;1;0;0;1;1;233;0;233;1;1;
/org.eclipse.jdt.core/model/org/eclipse/jdt/internal/core/ElementCache.java;2;1;4;1;2;2;2;2;67;1;2;455;111;111;1;0;0;2;4;455;0;4522;4;2;
/org.eclipse.compare/compare/org/eclipse/compare/internal/BinaryCompareViewer.java;2;0;7;1;1;1;1;6;46;1;6;14;94;94;1;0;0;6;7;14;0;4446;7;2;
/org.eclipse.help.tests/src/org/eclipse/help/tests/base/TestContexts.java;1;0;3;1;0;0;0;3;30;1;3;1882;60;60;1;0;0;3;3;1882;0;3400;3;1;
/org.eclipse.update.tests.core/src/org/eclipse/update/tests/regularInstall/TestExecutableInstall.java;2;1;14;1;2;2;2;12;13;1;12;1686;54;54;1;0;0;12;14;1686;0;4329;14;2;
/org.eclipse.update.core/src/org/eclipse/update/core/model/InstallConfigurationParser.java;1;0;8;1;0;0;0;8;13;1;8;2764;39;39;1;0;0;8;8;2764;0;3027;8;1;
/org.eclipse.help/src/org/eclipse/help/internal/protocols/SearchURLHandler.java;1;0;2;1;0;0;0;2;0;1;2;2694;0;0;1;0;0;2;2;2694;0;2773;2;1;
/org.eclipse.jdt.ui/ui/org/eclipse/jdt/internal/ui/JavaStatusConstants.java;2;0;2;1;0;0;0;2;6;1;2;1312;6;6;1;0;0;2;2;1312;0;1786;2;2;
/org.eclipse.pde.ui/src/org/eclipse/pde/internal/schema/SchemaElementReference.java;2;0;7;1;0;0;0;7;22;1;7;1434;49;49;1;0;0;7;7;1434;0;3579;7;2;
/org.eclipse.core.tests.resources/src/org/eclipse/core/tests/internal/indexing/StandAlonePageStoreTest.java;3;0;4;1;1;1;1;3;32;1;3;1794;54;54;1;0;0;3;4;1794;0;4516;4;3;
/org.eclipse.team.core/src/org/eclipse/team/core/IProjectSetSerializer.java;2;1;5;1;2;2;2;3;65;2;2;3728;77;77;2;1;0;3;5;3812;1;4707;4;2;
/org.eclipse.vcm.core.cvs/src/org/eclipse/vcm/internal/core/ccvs/ModuleExpansion.java;2;0;2;1;0;0;0;2;111;1;2;1011;111;111;1;0;0;2;2;1011;0;1277;2;2;
/org.eclipse.team.cvs.ui/src/org/eclipse/team/internal/ccvs/ui/wizards/AddWizard.java;2;0;4;1;0;0;0;4;82;1;4;1978;86;86;1;0;0;4;4;1978;0;2577;4;2;
/org.eclipse.jdt.ui.tests.refactoring/resources/AbstractField/can/A_test0_out.java;1;0;1;1;0;0;0;1;0;0;1;751;0;0;1;0;0;1;1;751;0;751;1;1;
/org.eclipse.swt/Eclipse SWT Custom Widgets/common/org/eclipse/swt/custom/CCombo.java;3;2;17;1;6;5;6;11;190;1;11;106;493;493;2;0;1;11;17;4557;1;4701;16;3;
/org.eclipse.swt/Eclipse SWT/photon/org/eclipse/swt/widgets/Scale.java;7;1;14;1;4;4;4;10;197;2;9;106;303;303;2;1;0;10;14;2064;1;4701;13;7;
/org.eclipse.core.tests.resources/src/org/eclipse/core/tests/internal/localstore/CaseSensitivityTest.java;3;0;4;1;1;1;1;3;650;1;3;1794;654;654;1;0;0;3;4;1794;0;4516;4;3;
/org.eclipse.jdt.ui.tests.refactoring/test cases/org/eclipse/jdt/ui/nls/tests/CellEditorTester.java;1;0;2;1;0;0;0;2;2;1;2;1939;2;2;1;0;0;2;2;1939;0;2015;2;1;
/org.eclipse.ui/Eclipse UI/org/eclipse/ui/internal/dialogs/ActionSetContentProvider.java;2;0;2;1;0;0;0;2;4;1;2;257;4;4;1;0;0;2;2;257;0;457;2;2;
/org.eclipse.jdt.ui/core refactoring/org/eclipse/jdt/internal/core/refactoring/base/UndoManagerAdapter.java;1;0;2;1;0;0;0;2;0;1;2;1345;0;0;1;0;0;2;2;1345;0;1939;2;1;
/org.eclipse.update.core/src/org/eclipse/update/core/ContentRef.java;1;0;1;1;0;0;0;1;0;0;1;2442;0;0;1;0;0;1;1;2442;0;2442;1;1;
/org.eclipse.vcm.core.cvs/src/org/eclipse/vcm/internal/core/ccvs/requests/IEntryIterator.java;2;0;3;1;0;0;0;3;9;1;3;0;14;14;1;0;0;3;3;0;0;327;3;2;
/org.eclipse.core.tests.resources/src/org/eclipse/core/tests/resources/session/TestInterestingProjectPersistence.java;2;0;3;1;0;0;0;3;314;1;3;2394;324;324;1;0;0;3;3;2394;0;3475;3;2;
/org.eclipse.ui.examples.readmetool/Eclipse UI Examples Readme Tool/org/eclipse/ui/examples/readmetool/WindowActionDelegate.java;1;0;1;1;0;0;0;1;0;0;1;932;0;0;1;0;0;1;1;932;0;932;1;1;
/org.eclipse.jdt.ui/core refactoring/org/eclipse/jdt/core/refactoring/text/ITextBufferChange.java;1;0;3;1;0;0;0;3;5;1;3;15;5;5;1;0;0;3;3;15;0;408;3;1;
/org.eclipse.jdt.ui/core extension/org/eclipse/jdt/internal/corext/Assert.java;1;0;2;1;1;1;1;1;4;0;1;2327;4;4;1;0;0;1;2;2327;0;4400;2;1;
/org.eclipse.jdt.core/model/org/eclipse/jdt/internal/core/builder/impl/CompilerCompilationUnit.java;1;0;10;1;0;0;0;10;88;4;7;455;112;112;4;3;0;10;10;1039;3;2808;7;1;
/org.eclipse.jdt.ui.tests.refactoring/resources/ExtractMethodWorkSpace/ExtractMethodTests/locals_in/A_test505.java;2;1;4;1;2;2;2;2;8;1;2;80;8;8;1;0;0;2;4;80;0;4419;4;2;
/org.eclipse.swt/Eclipse SWT Drag and Drop/motif/org/eclipse/swt/dnd/ByteArrayTransfer.java;3;2;9;1;6;5;6;3;115;1;3;106;196;196;2;0;1;3;9;4824;1;4824;8;3;
/org.eclipse.ui.examples.javaeditor/Java Editor Example/org/eclipse/ui/examples/javaeditor/java/JavaDoubleClickSelector.java;1;0;2;1;0;0;0;2;0;0;1;1066;0;0;2;1;0;2;2;1066;1;1066;1;1;
/org.eclipse.ui/Eclipse UI/org/eclipse/ui/internal/misc/TestPageListener.java;2;0;2;1;0;0;0;2;10;1;2;257;10;10;1;0;0;2;2;257;0;457;2;2;
/org.eclipse.webdav/src/client/org/eclipse/webdav/client/WebDAVFactory.java;3;0;5;1;1;1;1;4;150;1;4;12;291;291;1;0;0;4;5;12;0;4211;5;3;
/org.eclipse.pde.ui/src/org/eclipse/pde/internal/ui/editor/PDEMultiPageContentOutline.java;1;0;1;1;0;0;0;1;0;0;1;3579;0;0;1;0;0;1;1;3579;0;3579;1;1;
/org.eclipse.jdt.debug.ui/ui/org/eclipse/jdt/internal/debug/ui/launcher/AddVMDialog.java;4;2;20;1;7;6;7;13;283;1;13;1915;726;726;2;0;1;13;20;4347;1;4347;19;4;
/org.eclipse.core.resources/src/org/eclipse/core/internal/events/ResourceDeltaFactory.java;3;1;11;2;2;2;2;9;354;1;9;12;553;553;1;0;0;9;11;12;0;4214;11;3;
/org.eclipse.pde.ui/src/org/eclipse/pde/ui/IExtensionWizard.java;1;0;2;1;1;1;1;1;12;0;1;3579;12;12;1;0;0;1;2;3579;0;4752;2;1;
/org.eclipse.help.ui/src/org/eclipse/help/ui/internal/browser/BrowserManager.java;2;1;6;1;2;2;2;4;33;1;4;2429;54;54;1;0;0;4;6;2429;0;4439;6;2;
/org.eclipse.vcm.ui/src/org/eclipse/vcm/internal/ui/FileEditionStorage.java;2;0;2;2;0;0;0;2;0;0;1;1;0;0;2;1;0;2;2;1;1;1;1;2;
/org.eclipse.update.core/src/org/eclipse/update/internal/model/InstallConfigurationModel.java;1;1;9;1;2;2;2;7;21;2;6;3027;51;51;2;1;0;7;9;3027;1;4342;8;1;
/org.eclipse.jdt.ui.tests/refactoring/org/eclipse/jdt/refactoring/tests/RefactoringTest.java;4;0;19;1;0;0;0;19;46;2;18;49;250;250;2;1;0;19;19;437;1;1896;18;4;
/org.eclipse.jdt.ui/ui/org/eclipse/jdt/internal/ui/launcher/JDKRootFieldEditor.java;1;0;2;1;0;0;0;2;0;1;2;15;0;0;1;0;0;2;2;15;0;218;2;1;
/org.eclipse.scripting/src/org/eclipse/scripting/internal/views/ScriptDevelopmentPreferencePageWorkbenchAbstractWizard.java;1;0;1;1;0;0;0;1;0;0;1;1424;0;0;1;0;0;1;1;1424;0;1424;1;1;
/org.eclipse.update.ui/src/org/eclipse/update/internal/ui/manager/LocalSitePage.java;1;0;3;1;0;0;0;3;2;1;3;1889;2;2;1;0;0;3;3;1889;0;3537;3;1;
/org.eclipse.ui/Eclipse UI/org/eclipse/ui/internal/registry/CapabilityCategory.java;1;0;2;1;0;0;0;2;0;1;2;3074;0;0;1;0;0;2;2;3074;0;3119;2;1;
/org.eclipse.ui/Eclipse UI/org/eclipse/ui/dialogs/FileSelectionDialog.java;4;0;5;1;0;0;0;5;12;1;5;257;30;30;1;0;0;5;5;257;0;3029;5;4;
/org.eclipse.jdt.debug.ui/ui/org/eclipse/jdt/internal/debug/ui/launcher/WorkingDirectoryStatusHandler.java;2;0;2;1;0;0;0;2;2;1;2;3122;2;2;1;0;0;2;2;3122;0;3676;2;2;
/org.eclipse.jdt.ui/core refactoring/org/eclipse/jdt/internal/core/refactoring/RefactoringCoreMessages.java;2;0;2;1;0;0;0;2;0;1;2;716;0;0;1;0;0;2;2;716;0;1939;2;2;
/org.eclipse.jdt.ui/core refactoring/org/eclipse/jdt/internal/corext/refactoring/rename/InlineTempRefactoring.java;1;0;2;1;0;0;0;2;0;1;2;2015;0;0;1;0;0;2;2;2015;0;2062;2;1;
/org.eclipse.team.cvs.core/src/org/eclipse/team/internal/ccvs/core/util/DirtyDeltaVisitor.java;2;0;5;1;0;0;0;5;107;2;4;2049;117;117;2;1;0;5;5;2049;1;2253;4;2;
/org.eclipse.jdt.ui/ui refactoring/org/eclipse/jdt/internal/ui/refactoring/actions/RefactoringErrorDialogUtil.java;3;1;5;1;2;2;2;3;27;1;3;3502;36;36;1;0;0;3;5;3502;0;4427;5;3;
/org.eclipse.swt.examples/org/eclipse/swt/examples/texteditor/Images.java;4;0;4;1;1;1;1;3;52;1;3;513;74;74;1;0;0;3;4;513;0;4024;4;4;
/org.eclipse.ui/Eclipse UI/org/eclipse/ui/internal/dialogs/ViewContentProvider.java;3;0;3;1;0;0;0;3;4;1;3;257;7;7;1;0;0;3;3;257;0;3092;3;3;
/org.eclipse.vcm.tests.core/src/org/eclipse/vcm/tests/core/VCMBlackBoxTest.java;1;0;1;1;0;0;0;1;0;0;1;1688;0;0;1;0;0;1;1;1688;0;1688;1;1;
/org.eclipse.help/webapps/examples/WEB-INF/classes/listeners/ContextListener.java;1;0;2;1;0;0;0;2;0;1;2;1882;0;0;1;0;0;2;2;1882;0;1930;2;1;
/org.eclipse.jdt.debug/jdi interfaces/com/sun/jdi/Locatable.java;2;0;2;1;0;0;0;2;6;1;2;2704;6;6;1;0;0;2;2;2704;0;3033;2;2;
/org.eclipse.swt.tests/JUnit Tests/org/eclipse/swt/tests/junit/Test_org_eclipse_swt_events_ShellAdapter.java;2;0;2;1;1;1;1;1;6;0;1;1792;6;6;1;0;0;1;2;1792;0;4706;2;2;
/org.eclipse.jdt.core/compiler/org/eclipse/jdt/internal/compiler/lookup/ProblemPackageBinding.java;2;0;4;1;1;1;1;3;33;1;3;455;53;53;1;0;0;3;4;455;0;4062;4;2;
/org.eclipse.pde.ui/src/org/eclipse/pde/internal/base/model/ModelChangedEvent.java;2;0;3;1;0;0;0;3;22;1;3;1434;22;22;1;0;0;3;3;1434;0;3039;3;2;
/org.eclipse.pde.ui/src/org/eclipse/pde/internal/schema/SchemaRegistry.java;2;0;10;1;0;0;0;10;72;2;9;1434;125;125;2;1;0;10;10;2691;1;3579;9;2;
/org.eclipse.team.core/src/org/eclipse/team/core/internal/MoveDeleteManager.java;3;0;5;1;0;0;0;5;16;1;5;3211;23;23;1;0;0;5;5;3211;0;3762;5;3;
/org.eclipse.swt.tests/JUnit Tests/org/eclipse/swt/tests/junit/Test_org_eclipse_swt_events_MenuListener.java;2;0;2;1;1;1;1;1;6;0;1;1792;6;6;1;0;0;1;2;1792;0;4706;2;2;
/org.eclipse.scripting/Eclipse Scripting/org/eclipse/scripting/internal/views/ScriptDevelopmentWizardPageConfirmation.java;2;0;4;1;0;0;0;4;17;1;4;133;33;33;1;0;0;4;4;133;0;1424;4;2;
/org.eclipse.swt/Eclipse SWT PI/win32/org/eclipse/swt/internal/win32/WNDCLASS.java;2;0;2;1;1;1;1;1;6;0;1;2069;6;6;1;0;0;1;2;2069;0;4701;2;2;
/org.eclipse.jdt.ui/ui/org/eclipse/jdt/internal/ui/typehierarchy/FocusOnTypeAction.java;3;0;7;1;0;0;0;7;35;1;7;436;55;55;1;0;0;7;7;436;0;3050;7;3;
/org.eclipse.ui/Eclipse UI Text Editor/org/eclipse/ui/texteditor/ResourceMarkerAnnotationModel.java;4;1;6;1;2;2;2;4;61;1;4;257;98;98;1;0;0;4;6;257;0;4838;6;4;
/org.eclipse.jdt.core/codeassist/org/eclipse/jdt/internal/codeassist/ISearchRequestor.java;2;0;10;1;1;1;1;9;456;4;6;455;781;781;4;3;0;9;10;1039;3;4062;7;2;
/org.eclipse.update.core/src/org/eclipse/update/core/IInstallHandlerEntry.java;2;0;5;1;0;0;0;5;90;3;3;2981;108;108;3;2;0;5;5;3568;2;3568;3;2;
/org.eclipse.pde.ui/src/org/eclipse/pde/model/plugin/IPluginParent.java;1;0;3;1;0;0;0;3;20;1;3;3039;20;20;1;0;0;3;3;3039;0;3579;3;1;
/org.eclipse.help/src/org/eclipse/help/internal/contributions/xml1_0/HelpInfoView.java;2;0;5;1;0;0;0;5;21;1;5;1675;57;57;1;0;0;5;5;1675;0;2217;5;2;
/org.eclipse.pde.core/src/org/eclipse/pde/internal/core/WorkspaceResourceHelper.java;1;0;1;1;0;0;0;1;0;0;1;3591;0;0;1;0;0;1;1;3591;0;3591;1;1;
/org.eclipse.jdt.debug/eval/org/eclipse/jdt/internal/debug/eval/ast/instructions/SendMessage.java;3;0;7;1;1;1;1;6;29;1;6;3421;51;51;1;0;0;6;7;3421;0;3915;7;3;
/org.eclipse.ui/Eclipse JFace Text/org/eclipse/jface/text/ITextStore.java;3;0;3;1;0;0;0;3;6;1;3;257;10;10;1;0;0;3;3;257;0;1066;3;3;
/org.eclipse.ui/Eclipse UI Standard Components/org/eclipse/ui/views/navigator/ResourceNavigatorActionFactory.java;4;0;12;2;1;1;1;11;13;2;9;1830;40;40;2;2;0;11;12;1830;2;4067;10;4;
/org.eclipse.jdt.ui.tests.refactoring/resources/InlineTemp/canInline/A_test13_out.java;1;0;1;1;0;0;0;1;0;0;1;2758;0;0;1;0;0;1;1;2758;0;2758;1;1;
/org.eclipse.jdt.core/compiler/org/eclipse/jdt/internal/compiler/AbstractSyntaxTreeVisitorAdapter.java;2;0;14;1;1;1;1;13;157;4;9;455;252;252;4;4;0;13;14;1039;4;4062;10;2;
/org.eclipse.jdt.core/search/org/eclipse/jdt/internal/core/search/matching/MethodReferencePattern.java;3;0;19;1;1;1;1;18;720;4;14;455;1543;1543;4;4;0;18;19;1039;4;4063;15;3;
/org.eclipse.jdt.launching/launching/org/eclipse/jdt/internal/launching/Standard11xVMRunner.java;1;0;1;1;1;1;1;0;0;0;0;4572;0;0;1;0;0;0;1;4572;0;4572;1;1;
/org.eclipse.webdav/src/kernel/org/eclipse/webdav/internal/kernel/ElementHelper.java;3;0;6;1;1;1;1;5;210;1;5;12;416;416;1;0;0;5;6;12;0;4211;6;3;
/org.eclipse.jdt.ui.tests.refactoring/resources/InlineTemp/canInline/A_test5_out.java;1;0;2;1;1;1;1;1;12;0;1;2015;12;12;1;0;0;1;2;2015;0;4419;2;1;
/org.eclipse.jdt.debug.tests/tests/org/eclipse/jdt/debug/tests/AbstractDebugTest.java;3;4;13;1;11;6;11;2;175;1;2;3701;351;351;4;0;5;2;13;4286;5;4510;8;3;
/org.eclipse.core.runtime/src/org/eclipse/core/internal/plugins/RegistryResolver.java;4;0;22;2;2;1;2;20;2626;2;18;12;4083;4083;2;2;1;20;22;489;3;4212;19;4;
/org.eclipse.team.cvs.core/src/org/eclipse/team/internal/ccvs/core/commands/AbstractMessageCommand.java;3;0;5;1;0;0;0;5;106;1;5;1978;110;110;1;0;0;5;5;1978;0;2607;5;3;
/org.eclipse.team.cvs.ui/src/org/eclipse/team/internal/ccvs/ui/merge/MergeWizardEndPage.java;3;1;17;1;3;3;3;14;47;3;11;2641;139;139;3;3;0;14;17;3577;3;4829;14;3;
/org.eclipse.jdt.debug/eval/org/eclipse/jdt/debug/eval/model/IType.java;2;0;2;1;0;0;0;2;0;1;2;3421;0;0;1;0;0;2;2;3421;0;3555;2;2;
/org.eclipse.jdt.ui.tests.refactoring/resources/RenameVirtualMethodInClass/test32/out/A.java;1;0;1;1;0;0;0;1;0;0;1;1274;0;0;1;0;0;1;1;1274;0;1274;1;1;
/org.eclipse.scripting/src/org/eclipse/scripting/internal/ScriptDescriptor.java;1;0;1;1;0;0;0;1;0;0;1;1424;0;0;1;0;0;1;1;1424;0;1424;1;1;
/org.eclipse.team.cvs.ui/src/org/eclipse/team/internal/ccvs/ui/actions/CompareWithTagAction.java;3;1;18;1;7;7;7;11;98;2;10;2388;374;374;2;1;0;11;18;2388;1;4455;17;3;
/org.eclipse.jdt.debug.ui/ui/org/eclipse/jdt/internal/debug/ui/launcher/LocalJavaApplicationTabGroup.java;2;1;7;2;5;5;5;2;15;1;2;3313;38;38;1;0;0;2;7;3313;0;4166;7;2;
/org.eclipse.ui.externaltools/External Tools/org/eclipse/ui/externaltools/internal/ui/IHelpContextIds.java;1;1;2;1;2;2;2;0;23;0;0;4090;23;23;1;0;0;0;2;4090;0;4426;2;1;
/org.eclipse.jdt.ui/ui refactoring/org/eclipse/jdt/internal/ui/refactoring/sef/SelfEncapsulateFieldAction.java;1;0;2;1;0;0;0;2;0;1;2;1453;0;0;1;0;0;2;2;1453;0;1462;2;1;
/org.eclipse.debug.core/core/org/eclipse/debug/core/model/IBreakpointFactoryDelegate.java;2;0;3;1;0;0;0;3;29;1;3;831;29;29;1;0;0;3;3;831;0;1122;3;2;
/org.eclipse.pde.ui/src/org/eclipse/pde/internal/core/PluginModelManager.java;1;0;6;1;0;0;0;6;20;2;4;3445;30;30;2;2;0;6;6;3445;2;3607;4;1;
/org.eclipse.jdt.ui.tests.refactoring/resources/ExtractMethodWorkSpace/ExtractMethodTests/locals_in/A_test503.java;2;1;4;1;2;2;2;2;16;1;2;80;18;18;1;0;0;2;4;80;0;4419;4;2;
/org.eclipse.pde.build/src/plugin/org/eclipse/pde/internal/core/ant/AntScript.java;1;0;1;1;0;0;0;1;0;0;1;3475;0;0;1;0;0;1;1;3475;0;3475;1;1;
/org.eclipse.jdt.core/compiler/org/eclipse/jdt/internal/compiler/impl/LongConstant.java;2;0;11;1;1;1;1;10;90;4;6;455;150;150;4;4;0;10;11;1039;4;4062;7;2;
/org.eclipse.swt/Eclipse SWT PI/gtk/org/eclipse/swt/internal/gtk/GtkAdjustment.java;2;0;5;1;2;1;2;3;20;1;3;2107;32;32;2;0;1;3;5;4701;1;4701;4;2;
/org.eclipse.debug.ui/ui/org/eclipse/debug/ui/ILaunchConfigurationTabGroup.java;2;0;5;1;1;1;1;4;12;2;3;3277;26;26;2;1;0;4;5;3490;1;4653;4;2;
/org.eclipse.jdt.debug/jdi/org/eclipse/jdi/internal/ClassObjectReferenceImpl.java;2;0;4;1;0;0;0;4;21;1;4;187;37;37;1;0;0;4;4;187;0;3670;4;2;
/org.eclipse.jdt.ui.tests.refactoring/resources/RenameType/test40/in/A.java;1;0;1;1;0;0;0;1;0;0;1;49;0;0;1;0;0;1;1;49;0;49;1;1;
/org.eclipse.core.target/src/org/eclipse/core/internal/target/RemoteFolder.java;1;0;3;1;0;0;0;3;12;2;2;668;12;12;2;1;0;3;3;668;1;713;2;1;
/org.eclipse.pde.ui/src/org/eclipse/pde/internal/ui/wizards/extension/NewExtensionPointMainPage.java;1;0;2;1;0;0;0;2;2;1;2;3579;2;2;1;0;0;2;2;3579;0;3591;2;1;
/org.eclipse.team.cvs.core/src/org/eclipse/team/internal/ccvs/core/response/custom/IStatusListener.java;2;0;2;1;0;0;0;2;0;1;2;1978;0;0;1;0;0;2;2;1978;0;2607;2;2;
/org.eclipse.ui/Eclipse UI/org/eclipse/ui/internal/registry/MarkerQueryResult.java;1;0;1;1;0;0;0;1;0;0;1;2497;0;0;1;0;0;1;1;2497;0;2497;1;1;
/org.eclipse.ui/Eclipse JFace Text/org/eclipse/jface/text/contentassist/ContextInformation.java;3;0;3;1;0;0;0;3;17;1;3;257;22;22;1;0;0;3;3;257;0;1066;3;3;
/org.eclipse.jdt.ui.tests.refactoring/resources/RenamePrivateMethod/test18/out/C.java;1;0;1;1;0;0;0;1;0;0;1;49;0;0;1;0;0;1;1;49;0;49;1;1;
/org.eclipse.swt/Eclipse SWT PI/carbon/org/eclipse/swt/internal/carbon/OS.java;3;1;4;1;4;4;4;0;69;0;0;4147;77;77;1;0;0;0;4;4147;0;4701;4;3;
/org.eclipse.ui/Eclipse UI/org/eclipse/ui/IEditorPart.java;2;0;2;1;0;0;0;2;5;1;2;257;5;5;1;0;0;2;2;257;0;457;2;2;
/org.eclipse.core.resources/src/org/eclipse/core/internal/properties/IVisitor.java;2;0;4;1;1;1;1;3;84;1;3;12;103;103;1;0;0;3;4;12;0;4214;4;2;
/org.eclipse.jdt.core/search/org/eclipse/jdt/internal/core/search/indexing/IndexManager.java;3;2;51;2;13;11;13;38;650;4;29;455;1716;1716;4;9;2;38;51;1039;11;4525;40;3;
/org.eclipse.jdt.ui/core refactoring/org/eclipse/jdt/internal/corext/refactoring/CustomSearchEngine.java;2;0;2;1;0;0;0;2;0;1;2;1939;0;0;1;0;0;2;2;1939;0;2212;2;2;
/org.eclipse.swt/Eclipse SWT PI/gtk1x/org/eclipse/swt/internal/gtk/GtkStyle.java;2;0;2;1;1;1;1;1;3;0;1;2107;3;3;1;0;0;1;2;2107;0;4701;2;2;
/org.eclipse.jdt.debug/jdi/org/eclipse/jdi/internal/FloatTypeImpl.java;2;0;4;1;0;0;0;4;13;1;4;187;27;27;1;0;0;4;4;187;0;3670;4;2;
/org.eclipse.jdt.ui/nls/org/eclipse/jdt/internal/ui/nls/NLSImages.java;1;0;2;1;0;0;0;2;0;1;2;1880;0;0;1;0;0;2;2;1880;0;1913;2;1;
/org.eclipse.update.core/src/org/eclipse/update/core/model/InstallConfigurationModel.java;1;0;9;1;0;0;0;9;35;1;9;2764;63;63;1;0;0;9;9;2764;0;3027;9;1;
/org.eclipse.pde.core/src/org/eclipse/pde/internal/core/schema/EditableSchema.java;1;0;2;1;0;0;0;2;2;1;2;3591;2;2;1;0;0;2;2;3591;0;3607;2;1;
/org.eclipse.update.ui.forms/src/org/eclipse/update/ui/forms/internal/engine/BulletParagraph.java;1;0;2;1;0;0;0;2;55;1;2;3245;55;55;1;0;0;2;2;3245;0;3259;2;1;
/org.eclipse.team.tests.cvs.core/src/org/eclipse/team/tests/ccvs/core/compatible/SameResultEnv.java;2;0;20;2;0;0;0;20;481;2;17;2536;802;802;2;3;0;20;20;2989;3;3873;17;2;
/org.eclipse.jdt.ui/core refactoring/org/eclipse/jdt/core/refactoring/ChangeAbortException.java;1;0;3;1;0;0;0;3;5;1;3;157;5;5;1;0;0;3;3;157;0;408;3;1;
/org.eclipse.jdt.ui.tests.refactoring/resources/templates/test/in/A.java;1;0;1;1;0;0;0;1;0;0;1;49;0;0;1;0;0;1;1;49;0;49;1;1;
/org.eclipse.update.ui/src/org/eclipse/update/internal/ui/UpdateUIPlugin.java;3;1;31;1;10;10;10;21;163;2;20;1428;493;493;2;1;0;21;31;2172;1;4772;30;3;
/org.eclipse.update.ui/src/org/eclipse/update/internal/ui/manager/UpdateManager.java;1;0;3;1;0;0;0;3;4;2;2;1428;4;4;2;1;0;3;3;1457;1;1457;2;1;
/org.eclipse.help/webapps/examples/WEB-INF/classes/filters/ExampleFilter.java;1;0;2;1;0;0;0;2;0;1;2;1882;0;0;1;0;0;2;2;1882;0;1930;2;1;
/org.eclipse.team.core/src/org/eclipse/team/core/target/ISiteListener.java;3;1;3;1;3;3;3;0;10;0;0;4164;10;10;1;0;0;0;3;4164;0;4636;3;3;
/org.eclipse.core.resources/src/org/eclipse/core/internal/resources/ProjectInfo.java;2;0;5;1;1;1;1;4;176;1;4;12;199;199;1;0;0;4;5;12;0;4213;5;2;
/org.eclipse.swt.examples.paint/src/org/eclipse/swt/examples/paint/MetaSolidRectangle.java;1;0;1;1;0;0;0;1;0;0;1;512;0;0;1;0;0;1;1;512;0;512;1;1;
/org.eclipse.pde.ui/src/org/eclipse/pde/internal/model/feature/FeatureFactory.java;1;0;5;1;0;0;0;5;17;3;3;2951;25;25;3;2;0;5;5;2951;2;3579;3;1;
/org.eclipse.swt/Eclipse SWT/photon/org/eclipse/swt/internal/photon/PhWindowEvent_t.java;2;0;3;1;0;0;0;3;6;1;3;106;6;6;1;0;0;3;3;106;0;2069;3;2;
/org.eclipse.swt/Eclipse SWT PI/photon/org/eclipse/swt/internal/photon/FontQueryInfo.java;2;0;2;1;1;1;1;1;6;0;1;2069;6;6;1;0;0;1;2;2069;0;4701;2;2;
/org.eclipse.ui/Eclipse UI/org/eclipse/ui/internal/registry/AcceleratorConfiguration.java;2;0;4;1;0;0;0;4;24;1;4;3055;39;39;1;0;0;4;4;3055;0;3270;4;2;
/org.eclipse.jdt.ui/ui/org/eclipse/jdt/internal/ui/text/AbstractJavaScanner.java;2;0;2;1;0;0;0;2;2;1;2;1864;2;2;1;0;0;2;2;1864;0;3697;2;2;
/org.eclipse.help/Eclipse Help/org/eclipse/help/internal/server/HelpURL.java;3;0;6;1;0;0;0;6;22;1;6;135;36;36;1;0;0;6;6;135;0;1420;6;3;
/org.eclipse.core.runtime/src/org/eclipse/core/internal/runtime/PlatformLogListener.java;3;0;7;1;0;0;0;7;206;1;7;12;278;278;1;0;0;7;7;12;0;3590;7;3;
/org.eclipse.swt/Eclipse SWT PI/motif/org/eclipse/swt/internal/motif/XmAnyCallbackStruct.java;2;0;2;1;1;1;1;1;6;0;1;2069;6;6;1;0;0;1;2;2069;0;4701;2;2;
/org.eclipse.webdav/src/interface/org/eclipse/webdav/dom/LockInfo.java;3;0;5;1;1;1;1;4;292;1;4;12;368;368;1;0;0;4;5;12;0;4211;5;3;
/org.eclipse.jdt.ui.tests.refactoring/resources/ExtractMethodWorkSpace/ExtractMethodTests/validSelection/A_test232.java;2;1;3;1;2;2;2;1;0;0;1;49;0;0;1;0;0;1;3;49;0;4419;3;2;
/org.eclipse.search/search/org/eclipse/search/ui/IContextMenuConstants.java;1;0;2;1;0;0;0;2;2;1;2;1117;2;2;1;0;0;2;2;1117;0;2227;2;1;
/org.eclipse.jdt.ui/core refactoring/org/eclipse/jdt/internal/core/refactoring/types/TypeRefactoring.java;2;0;6;1;0;0;0;6;11;1;6;408;26;26;1;0;0;6;6;408;0;1258;6;2;
/org.eclipse.ui/Eclipse UI Text Editor/org/eclipse/ui/texteditor/IElementStateListener.java;3;0;3;1;0;0;0;3;20;1;3;257;25;25;1;0;0;3;3;257;0;1066;3;3;
/org.eclipse.jdt.debug.ui/ui/org/eclipse/jdt/internal/debug/ui/launcher/VMPreferencePage.java;3;2;27;2;11;8;11;16;4;2;15;1915;52;52;2;1;3;16;27;3816;4;4686;23;3;
/org.eclipse.jdt.debug.tests/tests/org/eclipse/jdt/debug/tests/eval/NestedTypeFieldValue_605.java;2;1;3;1;3;3;3;0;12;0;0;4447;14;14;1;0;0;0;3;4447;0;4571;3;2;
/org.eclipse.jdt.ui.tests.refactoring/resources/MoveMembers/test19/out/B.java;1;0;2;1;0;0;0;2;3;1;2;2738;3;3;1;0;0;2;2;2738;0;3188;2;1;
/org.eclipse.swt/Eclipse SWT/photon/org/eclipse/swt/widgets/Scrollable.java;5;1;11;1;4;4;4;7;101;1;7;106;157;157;1;0;0;7;11;106;0;4701;11;5;
/org.eclipse.webdav/src/interface/org/eclipse/webdav/dom/BaselineControl.java;3;0;5;1;1;1;1;4;120;1;4;12;162;162;1;0;0;4;5;12;0;4211;5;3;
/org.eclipse.jdt.core/dom/org/eclipse/jdt/core/dom/VariableDeclarationFragment.java;2;0;6;1;1;1;1;5;34;1;5;2669;59;59;1;0;0;5;6;2669;0;3942;6;2;
/org.eclipse.ui/Eclipse UI/org/eclipse/ui/dialogs/SaveAsDialog.java;4;0;10;1;0;0;0;10;55;2;9;257;101;101;2;1;0;10;10;2531;1;3029;9;4;
/org.eclipse.webdav/src/client/org/eclipse/webdav/internal/authentication/HexConverter.java;3;0;5;1;1;1;1;4;94;1;4;12;183;183;1;0;0;4;5;12;0;4211;5;3;
/org.eclipse.jdt.ui.tests.refactoring/resources/RenameType/test1/out/A.java;1;0;2;1;0;0;0;2;0;1;2;49;0;0;1;0;0;2;2;49;0;522;2;1;
/org.eclipse.pde.ui/src/org/eclipse/pde/internal/editor/schema/ICloneablePropertySource.java;2;0;2;1;0;0;0;2;0;1;2;1434;0;0;1;0;0;2;2;1434;0;3579;2;2;
/org.eclipse.jdt.ui/core refactoring/org/eclipse/jdt/internal/core/refactoring/code/flow/BlockFlowInfo.java;1;0;2;1;0;0;0;2;0;1;2;1236;0;0;1;0;0;2;2;1236;0;1939;2;1;
/org.eclipse.jdt.ui/ui/org/eclipse/jdt/internal/ui/text/template/CursorSelectionEvaluator.java;1;0;3;1;0;0;0;3;33;1;3;1469;33;33;1;0;0;3;3;1469;0;1720;3;1;
/org.eclipse.jdt.ui.tests.refactoring/resources/SelectionAnalyzerWorkSpace/SelectionAnalyzerTests/validSelection/A_test253.java;1;0;1;1;0;0;0;1;0;0;1;1368;0;0;1;0;0;1;1;1368;0;1368;1;1;
/org.eclipse.swt/Eclipse SWT/motif/org/eclipse/swt/internal/BidiText.java;1;0;1;1;0;0;0;1;0;0;1;1029;0;0;1;0;0;1;1;1029;0;1029;1;1;
/org.eclipse.team.cvs.ui/src/org/eclipse/team/internal/ccvs/ui/wizards/CVSWizard.java;1;0;4;1;0;0;0;4;103;1;4;1978;125;125;1;0;0;4;4;1978;0;2577;4;1;
/org.eclipse.jdt.ui.tests.refactoring/resources/RenameParameters/canRename/A_test6_in.java;1;0;1;1;0;0;0;1;0;0;1;233;0;0;1;0;0;1;1;233;0;233;1;1;
/org.eclipse.jdt.debug/jdi/org/eclipse/jdi/internal/event/MethodExitEventImpl.java;2;0;4;1;0;0;0;4;17;1;4;187;31;31;1;0;0;4;4;187;0;3670;4;2;
/org.eclipse.scripting/src/org/eclipse/scripting/internal/views/ScriptDevelopmentWizardPageActionType.java;1;0;1;1;0;0;0;1;0;0;1;1424;0;0;1;0;0;1;1;1424;0;1424;1;1;
/org.eclipse.jdt.ui.tests.refactoring/resources/DeleteSourceReference/test0/out/A.java;1;0;1;1;0;0;0;1;0;0;1;2857;0;0;1;0;0;1;1;2857;0;2857;1;1;
/org.eclipse.jdt.core/model/org/eclipse/jdt/internal/core/builder/impl/BinaryStructure.java;1;0;3;1;0;0;0;3;679;1;3;455;679;679;1;0;0;3;3;455;0;2808;3;1;
/org.eclipse.ui/Eclipse UI/org/eclipse/ui/internal/registry/CapabilityRegistryReader.java;2;0;6;1;0;0;0;6;59;2;5;3074;130;130;2;1;0;6;6;3487;1;3607;5;2;
/org.eclipse.jdt.ui/ui/org/eclipse/jdt/internal/ui/actions/ActionChecker.java;1;0;2;1;1;1;1;1;0;0;1;3533;0;0;1;0;0;1;2;3533;0;3914;2;1;
/org.eclipse.jdt.junit/src/org/eclipse/jdt/internal/junit/ui/TestRunnerViewPart.java;3;1;17;1;10;10;10;7;150;1;7;3171;572;572;1;0;0;7;17;3171;0;4720;17;3;
/org.eclipse.jdt.ui.tests.refactoring/resources/ExtractMethodWorkSpace/ExtractMethodTests/locals_in/A_test559.java;1;1;3;1;2;2;2;1;24;0;1;1236;24;24;1;0;0;1;3;1236;0;4419;3;1;
/org.eclipse.scripting/Eclipse Scripting/org/eclipse/scripting/internal/datamodels/XGRBaseDataNode.java;2;0;4;1;0;0;0;4;32;1;4;133;36;36;1;0;0;4;4;133;0;1424;4;2;
/org.eclipse.jdt.ui.tests.refactoring/resources/RenameType/testFail0/in/A.java;1;0;1;1;0;0;0;1;0;0;1;49;0;0;1;0;0;1;1;49;0;49;1;1;
/org.eclipse.debug.ui/ui/org/eclipse/debug/internal/ui/actions/TextViewerGotoLineAction.java;2;1;7;1;2;2;2;5;14;1;5;2382;42;42;1;0;0;5;7;2382;0;4263;7;2;
/org.eclipse.core.tests.runtime/src/org/eclipse/core/tests/internal/plugins/ExtensiveLibraryTest.java;3;0;3;1;0;0;0;3;496;1;3;1794;506;506;1;0;0;3;3;1794;0;3476;3;3;
/org.eclipse.team.cvs.core/src/org/eclipse/team/internal/ccvs/core/client/Status.java;2;0;4;1;0;0;0;4;15;1;4;2572;19;19;1;0;0;4;4;2572;0;3452;4;2;
/org.eclipse.jdt.ui/ui/org/eclipse/jdt/internal/ui/launcher/LauncherException.java;3;0;4;1;0;0;0;4;5;1;4;15;7;7;1;0;0;4;4;15;0;1607;4;3;
/org.eclipse.ui/Eclipse UI/org/eclipse/ui/IPerspectiveRegistry.java;2;0;2;1;0;0;0;2;5;1;2;257;5;5;1;0;0;2;2;257;0;457;2;2;
/org.eclipse.jdt.ui.tests.refactoring/resources/RenameMethodInInterface/testFail14/in/A.java;1;0;1;1;0;0;0;1;0;0;1;49;0;0;1;0;0;1;1;49;0;49;1;1;
/org.eclipse.webdav/src/client/org/eclipse/webdav/http/client/ISocketFactory.java;2;0;4;1;1;1;1;3;40;1;3;12;67;67;1;0;0;3;4;12;0;4211;4;2;
/org.eclipse.jdt.debug/eval/org/eclipse/jdt/internal/debug/eval/model/IArrayType.java;2;0;2;1;0;0;0;2;0;1;2;3555;0;0;1;0;0;2;2;3555;0;3645;2;2;
/org.eclipse.scripting.adapters.javascript/src/org/eclipse/scripting/adapters/javascript/ScriptEngineJavaScript.java;1;0;1;1;0;0;0;1;0;0;1;1424;0;0;1;0;0;1;1;1424;0;1424;1;1;
/org.eclipse.jdt.ui/ui/org/eclipse/jdt/internal/ui/search/ReadReferencesSearchGroup.java;1;3;9;1;5;3;5;4;35;1;4;1707;114;114;3;0;2;4;9;4140;2;4140;7;1;
/org.eclipse.jdt.ui.tests.refactoring/resources/MoveMembers/test11/in/A.java;1;0;1;1;0;0;0;1;0;0;1;2738;0;0;1;0;0;1;1;2738;0;2738;1;1;
/org.eclipse.help/src/org/eclipse/help/internal/contributors/xml/XMLViewContributor.java;2;0;2;1;0;0;0;2;0;1;2;1420;0;0;1;0;0;2;2;1420;0;1675;2;2;
/org.eclipse.help/src/org/eclipse/help/internal/contributors1_0/InfosetsContributor.java;1;0;2;1;0;0;0;2;0;1;2;1675;0;0;1;0;0;2;2;1675;0;2217;2;1;
/org.eclipse.jdt.ui.tests.refactoring/resources/RenameType/test46/in/C.java;1;0;1;1;0;0;0;1;0;0;1;49;0;0;1;0;0;1;1;49;0;49;1;1;
/org.eclipse.swt.tests/JUnit Tests/org/eclipse/swt/tests/junit/Test_org_eclipse_swt_events_VerifyListener.java;2;0;2;1;1;1;1;1;6;0;1;1792;6;6;1;0;0;1;2;1792;0;4706;2;2;
/org.eclipse.jdt.debug/eval/org/eclipse/jdt/internal/debug/eval/ast/instructions/Jump.java;3;0;6;1;0;0;0;6;4;1;6;3421;11;11;1;0;0;6;6;3421;0;3677;6;3;
/org.eclipse.team.cvs.core/src/org/eclipse/team/ccvs/core/IRemoteFile.java;2;0;3;1;0;0;0;3;2;1;3;1978;2;2;1;0;0;3;3;1978;0;2049;3;2;
/org.eclipse.team.cvs.core/src/org/eclipse/team/internal/ccvs/core/client/ValidRequests.java;2;0;6;1;0;0;0;6;45;1;6;2572;88;88;1;0;0;6;6;2572;0;3452;6;2;
/org.eclipse.pde.ui/src/org/eclipse/pde/internal/ui/wizards/templates/BooleanOption.java;1;0;3;1;0;0;0;3;3;1;3;3579;3;3;1;0;0;3;3;3579;0;3840;3;1;
/org.eclipse.vcm.ui/src/org/eclipse/vcm/internal/ui/actions/ReplaceWithTeamStreamAction.java;3;0;11;2;0;0;0;11;104;2;10;1;203;203;2;1;0;11;11;297;1;1866;10;3;
/org.eclipse.core.tests.runtime/src/org/eclipse/core/tests/internal/plugins/BasicXMLTest.java;4;0;5;1;0;0;0;5;4192;1;5;1794;4336;4336;1;0;0;5;5;1794;0;3476;5;4;
/org.eclipse.update.ui/src/org/eclipse/update/internal/ui/forms/SiteForm.java;2;0;4;1;1;1;1;3;3;1;3;3662;7;7;1;0;0;3;4;3662;0;4610;4;2;
/org.eclipse.swt/Eclipse SWT Custom Widgets/common/org/eclipse/swt/custom/CTabItem.java;5;2;24;2;6;5;6;18;296;4;14;106;842;842;4;4;1;18;24;2876;5;4841;19;5;
/org.eclipse.update.core/src/org/eclipse/update/core/Version.java;3;0;9;1;1;1;1;8;435;1;8;1423;659;659;1;0;0;8;9;1423;0;3900;9;3;
/org.eclipse.jdt.junit/Eclipse JUnit/org/eclipse/jdt/internal/junit/oldlauncher/JUnitBaseLauncherDelegate.java;2;0;3;1;0;0;0;3;2;1;3;2861;2;2;1;0;0;3;3;2861;0;3205;3;2;
/org.eclipse.team.cvs.core/src/org/eclipse/team/internal/ccvs/core/commands/Commit.java;3;0;6;2;0;0;0;6;319;2;5;1978;511;511;2;1;0;6;6;2375;1;2607;5;3;
/org.eclipse.jdt.ui.tests.refactoring/resources/RenameType/testFail6/in/C.java;1;0;1;1;0;0;0;1;0;0;1;49;0;0;1;0;0;1;1;49;0;49;1;1;
/org.eclipse.ui/Eclipse JFace Text/org/eclipse/jface/text/IRewriteTarget.java;1;1;2;1;2;2;2;0;44;0;0;4430;44;44;1;0;0;0;2;4430;0;4838;2;1;
/org.eclipse.jdt.ui/ui/org/eclipse/jdt/internal/ui/util/MigrationCompletionRequestorAdapter.java;2;0;2;1;0;0;0;2;0;1;2;3528;0;0;1;0;0;2;2;3528;0;3643;2;2;
/org.eclipse.swt.examples.paint/src/org/eclipse/swt/examples/paint/ContinuousPaintSession.java;3;0;5;2;1;1;1;4;243;2;3;513;288;288;2;1;0;4;5;609;1;4705;4;3;
/org.eclipse.ui/Eclipse UI Text Editor/org/eclipse/ui/texteditor/IStatusField.java;1;0;2;1;1;1;1;1;28;0;1;2017;28;28;1;0;0;1;2;2017;0;4838;2;1;
/org.eclipse.jdt.debug.ui/ui/org/eclipse/jdt/internal/debug/ui/launcher/J9VMCommandTab.java;2;0;2;2;2;1;2;0;0;0;0;4214;0;0;2;0;1;0;2;4214;1;4214;1;2;
/org.eclipse.pde.ui/src/org/eclipse/pde/internal/model/PluginElement.java;2;0;6;1;0;0;0;6;34;1;6;1434;49;49;1;0;0;6;6;1434;0;3136;6;2;
/org.eclipse.team.cvs.ui/src/org/eclipse/team/internal/ccvs/ui/HistoryFilterDialog.java;1;1;4;1;2;2;2;2;496;1;2;3380;556;556;1;0;0;2;4;3380;0;4607;4;1;
/org.eclipse.jdt.ui/ui/org/eclipse/jdt/internal/ui/text/correction/ReplaceCorrectionProposal.java;4;0;8;1;1;1;1;7;18;1;7;3306;56;56;1;0;0;7;8;3306;0;4454;8;4;
/org.eclipse.swt/Eclipse SWT Drag and Drop/motif/org/eclipse/swt/dnd/TreeDragUnderEffect.java;3;1;6;1;2;2;2;4;171;1;4;106;266;266;1;0;0;4;6;106;0;4701;6;3;
/org.eclipse.pde.build/src/org/eclipse/pde/internal/build/ant/Condition.java;1;0;4;1;1;1;1;3;12;2;2;3194;14;14;2;1;0;3;4;3571;1;4273;3;1;
/org.eclipse.ant.core/src/org/eclipse/ant/internal/core/InternalAntRunner.java;1;0;1;1;0;0;0;1;0;0;1;3365;0;0;1;0;0;1;1;3365;0;3365;1;1;
/org.eclipse.jdt.ui.tests.refactoring/resources/ExtractTemp/canExtract/A_test9_out.java;1;0;1;1;0;0;0;1;0;0;1;2481;0;0;1;0;0;1;1;2481;0;2481;1;1;
/org.eclipse.core.target/src/org/eclipse/core/internal/target/Policy.java;2;0;7;1;0;0;0;7;282;1;7;12;371;371;1;0;0;7;7;12;0;3723;7;2;
/org.eclipse.ui/Eclipse JFace/org/eclipse/jface/dialogs/Dialog.java;6;2;20;2;4;3;4;16;182;2;14;257;451;451;2;2;1;16;20;2229;3;4547;17;6;
/org.eclipse.pde.ui/Eclipse PDE UI/org/eclipse/pde/internal/editor/manifest/ManifestForm.java;2;0;6;2;0;0;0;6;12;3;4;267;18;18;3;2;0;6;6;324;2;1434;4;2;
/org.eclipse.ui/Eclipse UI Standard Components/org/eclipse/ui/wizards/datatransfer/WizardZipFileExportPage1.java;3;0;3;1;0;0;0;3;43;1;3;257;45;45;1;0;0;3;3;257;0;2738;3;3;
/org.eclipse.jdt.ui.tests.refactoring/resources/ExtractMethodWorkSpace/ExtractMethodTests/locals_out/A_test552.java;1;1;4;1;2;2;2;2;34;1;2;1236;37;37;1;0;0;2;4;1236;0;4419;4;1;
/org.eclipse.jdt.ui.tests.refactoring/resources/SelectionAnalyzerWorkSpace/SelectionAnalyzerTests/invalidSelection/A_test046.java;1;0;1;1;0;0;0;1;0;0;1;1368;0;0;1;0;0;1;1;1368;0;1368;1;1;
/org.eclipse.update.core/src/org/eclipse/update/core/model/ConfiguredSiteModel.java;1;0;2;1;0;0;0;2;0;1;2;3018;0;0;1;0;0;2;2;3018;0;3027;2;1;
/org.eclipse.update.ui.forms/src/org/eclipse/update/ui/forms/IHyperlinkListener.java;1;0;2;1;0;0;0;2;0;1;2;1423;0;0;1;0;0;2;2;1423;0;2474;2;1;
/org.eclipse.jdt.ui/ui/org/eclipse/jdt/internal/ui/launcher/JavaLaunchUtils.java;4;0;6;2;0;0;0;6;34;2;5;15;39;39;2;1;0;6;6;1607;1;1619;5;4;
/org.eclipse.swt.examples/src/org/eclipse/swt/examples/controlexample/SashTab.java;4;1;5;1;2;2;2;3;260;1;3;513;423;423;1;0;0;3;5;513;0;4705;5;4;
/org.eclipse.help/webapps/examples/WEB-INF/classes/cal/Entries.java;1;0;2;1;0;0;0;2;0;1;2;1882;0;0;1;0;0;2;2;1882;0;1930;2;1;
/org.eclipse.ui/Eclipse UI Standard Components/org/eclipse/ui/wizards/datatransfer/DataTransferMessages.java;1;0;1;1;0;0;0;1;0;0;1;457;0;0;1;0;0;1;1;457;0;457;1;1;
/org.eclipse.update.ui/src/org/eclipse/update/internal/ui/parts/EmbeddedBrowser.java;1;0;8;1;0;0;0;8;144;2;7;1477;326;326;2;1;0;8;8;1526;1;1596;7;1;
/org.eclipse.jdt.ui/core extension/org/eclipse/jdt/internal/corext/codemanipulation/MultiTextEdit.java;1;0;2;1;0;0;0;2;0;0;1;2133;0;0;2;1;0;2;2;2133;1;2133;1;1;
/org.eclipse.ui/Eclipse UI/org/eclipse/ui/internal/model/WorkbenchFile.java;2;0;2;1;0;0;0;2;5;1;2;257;5;5;1;0;0;2;2;257;0;457;2;2;
/org.eclipse.ui.examples.readmetool/Eclipse UI Examples Readme Tool/org/eclipse/ui/examples/readmetool/DefaultSectionsParser.java;2;0;2;1;0;0;0;2;2;1;2;932;2;2;1;0;0;2;2;932;0;945;2;2;
/org.eclipse.update.core/src/org/eclipse/update/core/IConfigurationPolicy.java;1;0;8;1;0;0;0;8;20;2;7;2032;73;73;2;1;0;8;8;2032;1;2994;7;1;
/org.eclipse.debug.ui/ui/org/eclipse/debug/internal/ui/LaunchWizardSelectionPage.java;3;0;18;2;0;0;0;18;57;3;13;187;200;200;3;5;0;18;18;900;5;3634;13;3;
/org.eclipse.jdt.ui.tests.refactoring/resources/RenameNonPrivateField/test5/in/A.java;1;0;1;1;0;0;0;1;0;0;1;49;0;0;1;0;0;1;1;49;0;49;1;1;
/org.eclipse.swt/Eclipse SWT/carbon/org/eclipse/swt/graphics/GCData.java;3;1;3;1;3;3;3;0;6;0;0;4147;8;8;1;0;0;0;3;4147;0;4701;3;3;
/org.eclipse.ui.examples.readmetool/Eclipse UI Examples Readme Tool/org/eclipse/ui/examples/readmetool/EditorActionDelegate.java;2;0;2;1;0;0;0;2;4;1;2;932;4;4;1;0;0;2;2;932;0;945;2;2;
/org.eclipse.core.tests.runtime/src/org/eclipse/core/tests/internal/plugins/JarPluginPathTest.java;3;0;3;1;0;0;0;3;104;1;3;2448;114;114;1;0;0;3;3;2448;0;3476;3;3;
/org.eclipse.ui/Eclipse UI/org/eclipse/ui/part/IPage.java;3;0;7;1;0;0;0;7;25;2;6;257;80;80;2;1;0;7;7;1816;1;3642;6;3;
/org.eclipse.scripting/src/org/eclipse/scripting/internal/uirenderer/XGRElementUISwtImage.java;1;0;1;1;0;0;0;1;0;0;1;1424;0;0;1;0;0;1;1;1424;0;1424;1;1;
/org.eclipse.ui/src-workbench/org/eclipse/ui/internal/SystemSummaryEditorInputFactory.java;1;0;2;1;2;1;2;0;0;0;0;4386;0;0;2;0;1;0;2;4386;1;4386;1;1;
/org.eclipse.team.cvs.ui/src/org/eclipse/team/internal/ccvs/ui/ResizableWizardDialog.java;1;0;1;1;0;0;0;1;0;0;1;3313;0;0;1;0;0;1;1;3313;0;3313;1;1;
/org.eclipse.pde.core/src/org/eclipse/pde/internal/core/plugin/Plugin.java;1;0;1;1;0;0;0;1;0;0;1;3591;0;0;1;0;0;1;1;3591;0;3591;1;1;
/org.eclipse.ui/Eclipse UI Standard Components/org/eclipse/ui/views/navigator/SortAndFilterActionGroup.java;1;0;2;1;1;1;1;1;24;0;1;3451;24;24;1;0;0;1;2;3451;0;4067;2;1;
/org.eclipse.jdt.ui.tests.refactoring/resources/MoveCU/testFail9/in/p/A.java;2;0;2;1;0;0;0;2;0;1;2;49;0;0;1;0;0;2;2;49;0;2769;2;2;
/org.eclipse.compare/compare/org/eclipse/compare/rangedifferencer/LinkedRangeDifference.java;1;0;2;1;0;0;0;2;5;1;2;14;5;5;1;0;0;2;2;14;0;329;2;1;
/org.eclipse.swt/Eclipse SWT PI/win32/org/eclipse/swt/internal/win32/FILETIME.java;2;0;2;1;1;1;1;1;6;0;1;2069;6;6;1;0;0;1;2;2069;0;4701;2;2;
/org.eclipse.ui/Eclipse UI Standard Components/org/eclipse/ui/views/tasklist/PasteTaskAction.java;2;0;7;1;1;1;1;6;8;1;6;2932;28;28;1;0;0;6;7;2932;0;4269;7;2;
/org.eclipse.ui/Eclipse UI/org/eclipse/ui/dialogs/WizardNewFolderMainPage.java;6;1;9;1;2;2;2;7;111;1;7;257;221;221;1;0;0;7;9;257;0;4567;9;6;
/org.eclipse.pde.ui/src/org/eclipse/pde/ui/templates/IFieldData.java;1;0;2;1;1;1;1;1;30;0;1;3840;30;30;1;0;0;1;2;3840;0;4752;2;1;
/org.eclipse.jdt.core/compiler/org/eclipse/jdt/internal/compiler/ast/AstNode.java;2;1;15;1;2;2;2;13;240;4;10;455;823;823;4;3;0;13;15;1039;3;4421;12;2;
/org.eclipse.debug.core/core/org/eclipse/debug/core/model/ILineBreakpoint.java;3;0;3;1;0;0;0;3;9;1;3;1139;14;14;1;0;0;3;3;1139;0;1756;3;3;
/org.eclipse.jdt.ui.tests.refactoring/resources/ExtractMethodWorkSpace/ExtractMethodTests/expression_out/A_test619.java;1;1;3;1;2;2;2;1;20;0;1;2634;20;20;1;0;0;1;3;2634;0;4419;3;1;
/org.eclipse.ui/Eclipse UI/org/eclipse/ui/dialogs/WizardNewFileCreationPage.java;6;1;9;1;2;2;2;7;49;1;7;257;158;158;1;0;0;7;9;257;0;4567;9;6;
/org.eclipse.jdt.ui.tests/ui/org/eclipse/jdt/ui/tests/core/TypeInfoTest.java;1;0;10;1;0;0;0;10;47;1;10;1379;90;90;1;0;0;10;10;1379;0;2820;10;1;
/org.eclipse.jdt.ui.tests.refactoring/resources/SurroundWithWorkSpace/SurroundWithTests/trycatch_in/TestExpression.java;1;0;1;1;0;0;0;1;0;0;1;3870;0;0;1;0;0;1;1;3870;0;3870;1;1;
/org.eclipse.team.cvs.core/src/org/eclipse/team/internal/ccvs/core/commands/Remove.java;3;0;5;1;0;0;0;5;118;1;5;1978;122;122;1;0;0;5;5;1978;0;2607;5;3;
/org.eclipse.pde.ui/Eclipse PDE UI/org/eclipse/pde/internal/base/schema/ISchemaElement.java;2;0;5;2;0;0;0;5;12;3;3;267;12;12;3;2;0;5;5;324;2;1434;3;2;
/org.eclipse.pde.core/src/org/eclipse/pde/internal/core/plugin/PluginReference.java;1;0;3;1;1;1;1;2;6;1;2;3591;12;12;1;0;0;2;3;3591;0;4552;3;1;
/org.eclipse.pde.ui/src/org/eclipse/pde/internal/ui/ischema/ISchemaRepeatable.java;1;0;2;1;0;0;0;2;0;1;2;3579;0;0;1;0;0;2;2;3579;0;3591;2;1;
/org.eclipse.vcm.ui/src/org/eclipse/vcm/internal/ui/model/RepositoryElement.java;4;0;5;2;0;0;0;5;7;2;4;1;16;16;2;1;0;5;5;297;1;1273;4;4;
/org.eclipse.jdt.ui.tests.refactoring/resources/RenameNonPrivateField/test4/in/A.java;1;0;1;1;0;0;0;1;0;0;1;49;0;0;1;0;0;1;1;49;0;49;1;1;
/org.eclipse.jdt.ui/core refactoring/org/eclipse/jdt/internal/corext/refactoring/changes/DeleteFolderChange.java;2;0;3;1;1;1;1;2;3;1;2;1939;5;5;1;0;0;2;3;1939;0;3947;3;2;
/org.eclipse.jdt.debug.ui/ui/org/eclipse/jdt/internal/debug/ui/launcher/JDKDebugLauncher.java;3;0;7;2;0;0;0;7;156;2;6;2388;254;254;2;1;0;7;7;3089;1;3122;6;3;
/org.eclipse.swt.tests/JUnit Tests/org/eclipse/swt/tests/junit/Test_org_eclipse_swt_dnd_DND.java;2;0;2;1;1;1;1;1;6;0;1;1792;6;6;1;0;0;1;2;1792;0;4706;2;2;
/org.eclipse.ui/Eclipse UI/org/eclipse/ui/internal/WindowPerspectiveMenu.java;2;0;6;1;0;0;0;6;112;2;5;1673;167;167;2;1;0;6;6;1727;1;3050;5;2;
/org.eclipse.pde.ui/src/org/eclipse/pde/internal/wizards/templates/PreprocessorParser.java;1;0;4;1;0;0;0;4;41;1;4;3388;44;44;1;0;0;4;4;3388;0;3579;4;1;
/org.eclipse.help/webapps/examples/WEB-INF/classes/filters/SetCharacterEncodingFilter.java;1;0;2;1;0;0;0;2;0;1;2;1882;0;0;1;0;0;2;2;1882;0;1930;2;1;
/org.eclipse.core.target/src/org/eclipse/core/internal/target/webdav/PushTarget.java;2;0;7;1;1;1;1;6;418;1;6;12;596;596;1;0;0;6;7;12;0;4196;7;2;
/org.eclipse.help.ui/src/org/eclipse/help/ui/internal/util/TString.java;1;0;1;1;1;1;1;0;0;0;0;4439;0;0;1;0;0;0;1;4439;0;4439;1;1;
/org.eclipse.scripting/src/org/eclipse/scripting/internal/uirenderer/XGRElementUISwtTextField.java;1;0;1;1;0;0;0;1;0;0;1;1424;0;0;1;0;0;1;1;1424;0;1424;1;1;
/org.eclipse.jdt.launching/launching/org/eclipse/jdt/launching/IJavaLaunchConfigurationConstants.java;3;2;19;1;13;12;13;6;151;1;6;3055;410;410;2;0;1;6;19;4059;1;4650;18;3;
/org.eclipse.help.tests/src/org/eclipse/help/tests/launching/DisplayHelpResource_contextID_x_y.java;1;0;1;1;1;1;1;0;0;0;0;4042;0;0;1;0;0;0;1;4042;0;4042;1;1;
/org.eclipse.jdt.debug.ui/ui/org/eclipse/jdt/internal/debug/ui/ZipEntryStorageEditorInput.java;1;0;1;1;0;0;0;1;0;0;1;2372;0;0;1;0;0;1;1;2372;0;2372;1;1;
/org.eclipse.help.webapp/src/org/eclipse/help/servlet/CSSFilter.java;2;2;6;1;3;2;3;3;6;1;3;3472;14;14;2;0;1;3;6;4527;1;4527;5;2;
/org.eclipse.jdt.debug/eval/org/eclipse/jdt/internal/debug/eval/ast/instructions/PlusAssignmentOperator.java;2;0;5;1;1;1;1;4;4;1;4;3421;10;10;1;0;0;4;5;3421;0;3955;5;2;
/org.eclipse.core.tests.runtime/src/org/eclipse/core/tests/runtime/PluginVersionIdentifierTest.java;3;0;4;1;1;1;1;3;22;1;3;1794;42;42;1;0;0;3;4;1794;0;4455;4;3;
/org.eclipse.swt.examples/org/eclipse/swt/examples/controlexample/RangeTab.java;4;1;6;1;2;2;2;4;278;1;4;513;443;443;1;0;0;4;6;513;0;4024;6;4;
/org.eclipse.jdt.ui.tests.refactoring/resources/SelectionAnalyzerWorkSpace/SelectionAnalyzerTests/invalidSelection/A_test145.java;2;0;2;1;0;0;0;2;0;1;2;1368;0;0;1;0;0;2;2;1368;0;2139;2;2;
/org.eclipse.jdt.ui/core refactoring/org/eclipse/jdt/internal/core/refactoring/DeleteCompilationUnitChange.java;3;0;7;1;0;0;0;7;36;1;7;15;52;52;1;0;0;7;7;15;0;1257;7;3;
/org.eclipse.swt/Eclipse SWT/gtk/org/eclipse/swt/widgets/MessageBox.java;6;1;11;1;3;3;3;8;484;1;8;2107;688;688;1;0;0;8;11;2107;0;4701;11;6;
/org.eclipse.debug.ui/ui/org/eclipse/debug/internal/ui/views/ConsoleViewer.java;3;0;5;1;1;1;1;4;8;1;4;2338;15;15;1;0;0;4;5;2338;0;3975;5;3;
/org.eclipse.core.tests.resources/src/org/eclipse/core/tests/internal/indexing/IntegratedFieldTest.java;3;0;3;1;1;1;1;2;24;1;2;1794;34;34;1;0;0;2;3;1794;0;4516;3;3;
/org.eclipse.pde.ui/Eclipse PDE UI/org/eclipse/pde/internal/PDEHackFinder.java;2;0;5;2;0;0;0;5;18;3;3;267;18;18;3;2;0;5;5;324;2;518;3;2;
/org.eclipse.debug.ui/ui/org/eclipse/debug/internal/ui/DisconnectActionDelegate.java;3;0;8;1;0;0;0;8;42;1;8;187;76;76;1;0;0;8;8;187;0;2382;8;3;
/org.eclipse.webdav/src/kernel/org/eclipse/webdav/internal/kernel/utils/URLDecoder.java;1;1;5;1;2;2;2;3;80;1;3;12;100;100;1;0;0;3;5;12;0;4651;5;1;
/org.eclipse.jdt.ui.tests.refactoring/resources/DeleteSourceReference/test5/out/A.java;1;0;1;1;0;0;0;1;0;0;1;2857;0;0;1;0;0;1;1;2857;0;2857;1;1;
/org.eclipse.swt.tests/JUnit Tests/org/eclipse/swt/tests/junit/Test_org_eclipse_swt_graphics_DeviceData.java;2;0;2;1;1;1;1;1;6;0;1;1792;6;6;1;0;0;1;2;1792;0;4706;2;2;
/org.eclipse.jdt.ui.tests.refactoring/resources/SurroundWithWorkSpace/SurroundWithTests/trycatch_out/TestInitializerThrowsException.java;1;0;1;1;0;0;0;1;0;0;1;3870;0;0;1;0;0;1;1;3870;0;3870;1;1;
/org.eclipse.jdt.ui/ui/org/eclipse/jdt/internal/ui/browsing/NonJavaElementFilter.java;1;0;2;1;1;1;1;1;0;0;1;2878;0;0;1;0;0;1;2;2878;0;4211;2;1;
/org.eclipse.jdt.ui/ui/org/eclipse/jdt/internal/ui/wizards/NewClassCreationWizard.java;3;1;11;1;2;2;2;9;20;2;7;15;61;61;2;2;0;9;11;144;2;4621;9;3;
/org.eclipse.jdt.debug.tests/tests/org/eclipse/jdt/debug/tests/core/PatternBreakpointTests.java;3;1;4;1;3;3;3;1;38;0;1;3701;60;60;1;0;0;1;4;3701;0;4571;4;3;
/org.eclipse.jdt.ui.tests.refactoring/resources/RenameTemp/canRename/A_test44_in.java;1;0;1;1;0;0;0;1;0;0;1;3353;0;0;1;0;0;1;1;3353;0;3353;1;1;
/org.eclipse.ui/Eclipse JFace Text/org/eclipse/jface/text/presentation/IPresentationRepairer.java;3;0;3;1;0;0;0;3;13;1;3;257;18;18;1;0;0;3;3;257;0;1066;3;3;
/org.eclipse.jdt.ui.tests.refactoring/resources/MoveCU/test2/in/p1/C.java;2;0;2;1;0;0;0;2;0;1;2;49;0;0;1;0;0;2;2;49;0;2769;2;2;
/org.eclipse.team.tests.cvs.core/src/org/eclipse/team/tests/ccvs/core/provider/ResourceDeltaTest.java;2;0;3;1;0;0;0;3;8;1;3;3402;16;16;1;0;0;3;3;3402;0;3610;3;2;
/org.eclipse.update.core/src/org/eclipse/update/examples/buildzip/BuildZipFeatureFactory.java;1;0;1;1;0;0;0;1;0;0;1;2472;0;0;1;0;0;1;1;2472;0;2472;1;1;
/org.eclipse.compare/compare/org/eclipse/compare/patch/PatchWizard.java;1;0;8;1;0;0;0;8;54;2;7;1516;201;201;2;1;0;8;8;1704;1;2876;7;1;
/org.eclipse.core.resources/src/org/eclipse/core/internal/resources/MarkerDelta.java;2;0;6;1;1;1;1;5;404;1;5;12;504;504;1;0;0;5;6;12;0;4213;6;2;
/org.eclipse.update.ui/src/org/eclipse/update/internal/ui/manager/UpdateManagerInput.java;1;0;2;1;0;0;0;2;0;1;2;1428;0;0;1;0;0;2;2;1428;0;1596;2;1;
/org.eclipse.pde.ui/Eclipse PDE UI/org/eclipse/pde/internal/wizards/extension/NewExtensionPointMainPage.java;2;0;5;2;0;0;0;5;12;3;3;267;12;12;3;2;0;5;5;324;2;1434;3;2;
/org.eclipse.ui/Eclipse UI/org/eclipse/ui/internal/PartDragDrop.java;5;1;12;1;2;2;2;10;16;1;10;257;94;94;1;0;0;10;12;257;0;4382;12;5;
/org.eclipse.jdt.debug/model/org/eclipse/jdt/internal/debug/core/JDIValue.java;4;0;28;2;0;0;0;28;107;2;24;187;630;630;2;4;0;28;28;411;4;2517;24;4;
/org.eclipse.ui/Eclipse UI/org/eclipse/ui/internal/SystemSummaryDocumentProvider.java;2;1;6;1;6;6;6;0;77;0;0;4387;150;150;1;0;0;0;6;4387;0;4808;6;2;
/org.eclipse.ui/Eclipse UI/org/eclipse/ui/internal/Mode.java;1;0;2;1;0;0;0;2;0;1;2;3128;0;0;1;0;0;2;2;3128;0;3270;2;1;
/org.eclipse.swt/Eclipse SWT Custom Widgets/common_j2se/org/eclipse/swt/custom/ScrolledComposite.java;1;0;1;1;0;0;0;1;0;0;1;1378;0;0;1;0;0;1;1;1378;0;1378;1;1;
/org.eclipse.pde.ui/src/org/eclipse/pde/internal/forms/IFormPage.java;2;0;2;1;0;0;0;2;0;1;2;1434;0;0;1;0;0;2;2;1434;0;2470;2;2;
/org.eclipse.ui/Eclipse JFace/org/eclipse/jface/preference/IPreferencePageContainer.java;2;0;2;1;0;0;0;2;5;1;2;257;5;5;1;0;0;2;2;257;0;457;2;2;
/org.eclipse.jdt.ui.tests.refactoring/resources/ExtractMethodWorkSpace/ExtractMethodTests/locals_out/A_test526.java;1;1;4;1;2;2;2;2;68;1;2;2684;70;70;1;0;0;2;4;2684;0;4419;4;1;
/org.eclipse.jdt.ui.tests.refactoring/resources/MoveMembers/testFail12/in/B.java;1;0;1;1;0;0;0;1;0;0;1;2738;0;0;1;0;0;1;1;2738;0;2738;1;1;
/org.eclipse.ui/Eclipse UI/org/eclipse/ui/IWorkbenchPropertyPage.java;2;0;2;1;0;0;0;2;5;1;2;257;5;5;1;0;0;2;2;257;0;457;2;2;
/org.eclipse.update.ui/src/org/eclipse/update/internal/ui/pages/LocalSitePage.java;1;0;2;1;0;0;0;2;3;1;2;3537;3;3;1;0;0;2;2;3537;0;3662;2;1;
/org.eclipse.search/search/org/eclipse/search/internal/ui/GotoMarkerAction.java;2;0;4;1;0;0;0;4;9;1;4;15;16;16;1;0;0;4;4;15;0;687;4;2;
/org.eclipse.jdt.ui.tests.refactoring/resources/RenameParameters/canRename/A_test27_out.java;1;0;1;1;0;0;0;1;0;0;1;233;0;0;1;0;0;1;1;233;0;233;1;1;
/org.eclipse.jdt.ui/core refactoring/org/eclipse/jdt/core/refactoring/code/StatementAnalyzer.java;1;0;19;1;0;0;0;19;295;2;17;15;1210;1210;2;2;0;19;19;25;2;408;17;1;
/org.eclipse.pde.ui/src/org/eclipse/pde/internal/wizards/templates/TemplateControlStack.java;1;0;3;1;0;0;0;3;3;1;3;3388;3;3;1;0;0;3;3;3388;0;3442;3;1;
/org.eclipse.jdt.debug/eval/org/eclipse/jdt/internal/debug/eval/ast/instructions/UnaryPlusOperator.java;3;0;6;1;0;0;0;6;5;1;6;3421;17;17;1;0;0;6;6;3421;0;3677;6;3;
/org.eclipse.jdt.ui.tests.refactoring/resources/ExtractTemp/cannotExtract/A_testFail17.java;1;0;1;1;0;0;0;1;0;0;1;3374;0;0;1;0;0;1;1;3374;0;3374;1;1;
/org.eclipse.core.tests.runtime/src/org/eclipse/core/tests/internal/plugins/PluginResolveTest_28.java;3;0;3;1;0;0;0;3;86;1;3;1794;96;96;1;0;0;3;3;1794;0;3476;3;3;
/org.eclipse.jdt.ui.tests/refactoring/org/eclipse/jdt/refactoring/tests/RenameFieldTests.java;4;0;6;1;0;0;0;6;8;1;6;49;23;23;1;0;0;6;6;49;0;1896;6;4;
/org.eclipse.jdt.ui.tests.refactoring/resources/RenameType/test1/out/B.java;1;0;1;1;0;0;0;1;0;0;1;522;0;0;1;0;0;1;1;522;0;522;1;1;
/org.eclipse.help/src/org/eclipse/help/internal/util/HelpProperties.java;2;0;3;1;0;0;0;3;4;1;3;1420;6;6;1;0;0;3;3;1420;0;3609;3;2;
/org.eclipse.pde.ui/src/org/eclipse/pde/internal/ui/editor/feature/FeatureReferencePage.java;1;0;1;1;0;0;0;1;0;0;1;3579;0;0;1;0;0;1;1;3579;0;3579;1;1;
/org.eclipse.ui/Eclipse UI/org/eclipse/ui/internal/ViewActionBars.java;4;0;4;1;0;0;0;4;5;1;4;257;8;8;1;0;0;4;4;257;0;3232;4;4;
/org.eclipse.jdt.ui/core codemanipulation/org/eclipse/jdt/internal/core/codemanipulation/PositionUpdater.java;1;0;2;1;0;0;0;2;0;1;2;1800;0;0;1;0;0;2;2;1800;0;1937;2;1;
/org.eclipse.jdt.core/compiler/org/eclipse/jdt/internal/compiler/codegen/MethodNameAndTypeCache.java;2;1;11;1;2;2;2;9;299;4;6;455;402;402;4;3;0;9;11;1039;3;4062;8;2;
/org.eclipse.jdt.ui/core extension/org/eclipse/jdt/internal/corext/codemanipulation/IRequestQuery.java;1;0;1;1;0;0;0;1;0;0;1;2137;0;0;1;0;0;1;1;2137;0;2137;1;1;
/org.eclipse.pde.runtime/Eclipse PDE Runtime/org/eclipse/pde/internal/runtime/OverlayIcon.java;2;0;3;1;0;0;0;3;4;1;3;267;4;4;1;0;0;3;3;267;0;1434;3;2;
/org.eclipse.ui/Eclipse JFace/org/eclipse/jface/preference/RadioGroupFieldEditor.java;3;0;3;1;0;0;0;3;96;1;3;257;101;101;1;0;0;3;3;257;0;3459;3;3;
/org.eclipse.team.tests.cvs.core/src/org/eclipse/team/tests/ccvs/core/compatible/AllTestsCompatibility.java;1;0;1;1;0;0;0;1;0;0;1;3250;0;0;1;0;0;1;1;3250;0;3250;1;1;
/org.eclipse.debug.core/core/org/eclipse/debug/core/model/IVariable.java;3;0;8;1;1;1;1;7;37;1;7;187;97;97;1;0;0;7;8;187;0;4652;8;3;
/org.eclipse.swt/Eclipse SWT/motif/org/eclipse/swt/widgets/Table.java;2;0;5;1;0;0;0;5;1304;1;5;106;2204;2204;1;0;0;5;5;106;0;1028;5;2;
/org.eclipse.jdt.ui.tests.refactoring/resources/DeleteSourceReferenceEdit/A_testField3_in.java;1;0;1;1;0;0;0;1;0;0;1;2857;0;0;1;0;0;1;1;2857;0;2857;1;1;
/org.eclipse.jdt.core/model/org/eclipse/jdt/internal/core/util/FieldInfo.java;3;2;5;2;3;2;3;2;28;0;1;3629;66;66;2;1;1;2;5;3629;2;4421;3;3;
/org.eclipse.scripting/Eclipse Scripting/org/eclipse/scripting/internal/views/ScriptUIEditorAnnotationHover.java;2;0;4;1;0;0;0;4;13;1;4;133;20;20;1;0;0;4;4;133;0;1424;4;2;
/org.eclipse.jdt.core/search/org/eclipse/jdt/internal/core/search/indexing/SourceIndexerRequestor.java;2;0;9;1;1;1;1;8;492;2;7;455;577;577;2;1;0;8;9;3084;1;4063;8;2;
/org.eclipse.jdt.ui/ui refactoring/org/eclipse/jdt/internal/ui/refactoring/ComparePreviewer.java;3;0;8;2;1;1;1;7;37;2;6;1800;70;70;2;1;0;7;8;1800;1;4602;7;3;
/org.eclipse.webdav/src/kernel/org/eclipse/webdav/internal/kernel/WebDAVPreconditionFailures.java;2;0;5;1;1;1;1;4;278;1;4;12;399;399;1;0;0;4;5;12;0;4211;5;2;
/org.eclipse.swt/Eclipse SWT PI/gtk1x/org/eclipse/swt/internal/gtk/GtkCTreeRow.java;2;0;2;1;1;1;1;1;3;0;1;2107;3;3;1;0;0;1;2;2107;0;4701;2;2;
/org.eclipse.jdt.junit/Eclipse JUnit/org/eclipse/jdt/internal/junit/ui/JavaModelUtil.java;2;0;2;1;0;0;0;2;0;1;2;2399;0;0;1;0;0;2;2;2399;0;3313;2;2;
/org.eclipse.jdt.ui.tests.refactoring/resources/SurroundWithWorkSpace/SurroundWithTests/trycatch_in/TestWrappedLocal1.java;1;0;1;1;0;0;0;1;0;0;1;2327;0;0;1;0;0;1;1;2327;0;2327;1;1;
/org.eclipse.jdt.ui.tests.refactoring/resources/RenameType/testFail31/in/B.java;1;0;1;1;0;0;0;1;0;0;1;49;0;0;1;0;0;1;1;49;0;49;1;1;
/org.eclipse.jdt.debug.ui/ui/org/eclipse/jdt/internal/debug/ui/JDIDebugElementImageDescriptor.java;2;0;3;1;0;0;0;3;12;1;3;2021;12;12;1;0;0;3;3;2021;0;2789;3;2;
/org.eclipse.core.tests.runtime/src/org/eclipse/core/tests/internal/plugins/PluginResolveTest_21.java;3;0;3;1;0;0;0;3;110;1;3;1794;120;120;1;0;0;3;3;1794;0;3476;3;3;
/org.eclipse.team.cvs.core/src/org/eclipse/team/internal/ccvs/core/CVSDiffException.java;2;0;3;1;0;0;0;3;50;1;3;1978;50;50;1;0;0;3;3;1978;0;2791;3;2;
/org.eclipse.swt/Eclipse SWT/gtk/org/eclipse/swt/graphics/DeviceData.java;3;1;3;1;2;2;2;1;6;0;1;2107;8;8;1;0;0;1;3;2107;0;4701;3;3;
/org.eclipse.jdt.debug/eval/org/eclipse/jdt/internal/debug/eval/model/EvaluationClassType.java;2;0;3;1;0;0;0;3;5;1;3;3421;5;5;1;0;0;3;3;3421;0;3645;3;2;
/org.eclipse.compare/compare/org/eclipse/compare/internal/ImageCanvas.java;1;0;2;1;0;0;0;2;5;1;2;14;5;5;1;0;0;2;2;14;0;329;2;1;
/org.eclipse.update.ui/src/org/eclipse/update/internal/ui/forms/DiscoveryFolderForm.java;2;1;4;1;2;2;2;2;5;1;2;3662;10;10;1;0;0;2;4;3662;0;4610;4;2;
/org.eclipse.jdt.ui.tests.refactoring/resources/ReorgTests/p1/A.java;1;0;1;1;0;0;0;1;0;0;1;1301;0;0;1;0;0;1;1;1301;0;1301;1;1;
/org.eclipse.pde.runtime/src/org/eclipse/pde/internal/runtime/registry/ConfigurationElementPropertySource.java;1;0;1;1;0;0;0;1;0;0;1;1434;0;0;1;0;0;1;1;1434;0;1434;1;1;
/org.eclipse.update.core/src/org/eclipse/update/internal/core/ListenersList.java;1;0;1;1;0;0;0;1;0;0;1;1643;0;0;1;0;0;1;1;1643;0;1643;1;1;
/org.eclipse.jdt.ui/core extension/org/eclipse/jdt/internal/corext/template/ContextTypeRegistry.java;1;0;1;1;0;0;0;1;0;0;1;2784;0;0;1;0;0;1;1;2784;0;2784;1;1;
/org.eclipse.jdt.debug.tests/tests/org/eclipse/jdt/debug/tests/eval/NestedTypeFieldValue_343.java;2;1;3;1;3;3;3;0;12;0;0;4447;14;14;1;0;0;0;3;4447;0;4571;3;2;
/org.eclipse.swt/Eclipse SWT/common/org/eclipse/swt/events/MouseTrackListener.java;4;0;5;1;1;1;1;4;6;1;4;106;20;20;1;0;0;4;5;106;0;4701;5;4;
/org.eclipse.swt/Eclipse SWT/gtk/org/eclipse/swt/graphics/FontMetrics.java;3;1;5;1;2;2;2;3;20;1;3;2107;40;40;1;0;0;3;5;2107;0;4701;5;3;
/org.eclipse.webdav/src/client/org/eclipse/webdav/client/RequestBodyWriter.java;3;0;5;1;1;1;1;4;76;1;4;12;143;143;1;0;0;4;5;12;0;4211;5;3;
/org.eclipse.pde.ui/Eclipse PDE UI/org/eclipse/pde/internal/editor/build/BuildEditorContributor.java;2;0;5;2;0;0;0;5;12;3;3;267;12;12;3;2;0;5;5;324;2;1434;3;2;
/org.eclipse.jdt.ui/core extension/org/eclipse/jdt/internal/corext/codemanipulation/AbstractCodeBlock.java;1;0;1;1;0;0;0;1;0;0;1;3870;0;0;1;0;0;1;1;3870;0;3870;1;1;
/org.eclipse.jdt.ui/ui/org/eclipse/jdt/internal/ui/wizards/buildpaths/VariableCreationDialog.java;3;0;24;1;0;0;0;24;85;2;23;159;308;308;2;1;0;24;24;220;1;3737;23;3;
/org.eclipse.jdt.ui.tests.refactoring/resources/ExtractMethodWorkSpace/ExtractMethodTests/invalidSelection/A_testx.java;2;0;2;1;0;0;0;2;0;1;2;49;0;0;1;0;0;2;2;49;0;2155;2;2;
/org.eclipse.swt/Eclipse SWT/photon/org/eclipse/swt/widgets/FileDialog.java;5;1;11;1;4;4;4;7;141;2;6;106;193;193;2;1;0;7;11;2064;1;4701;10;5;
/org.eclipse.pde.ui/src/org/eclipse/pde/internal/editor/manifest/JarsSection.java;2;0;10;1;0;0;0;10;482;1;10;1434;523;523;1;0;0;10;10;1434;0;3579;10;2;
/org.eclipse.swt/Eclipse SWT/gtk1x/org/eclipse/swt/widgets/Shell.java;6;0;13;1;1;1;1;12;112;4;7;2107;256;256;4;5;0;12;13;2359;5;4701;8;6;
/org.eclipse.pde.core/src/org/eclipse/pde/internal/core/plugin/PluginExtensionPoint.java;1;0;1;1;0;0;0;1;0;0;1;3591;0;0;1;0;0;1;1;3591;0;3591;1;1;
/org.eclipse.team.cvs.core/src/org/eclipse/team/internal/ccvs/core/ICVSRemoteFolder.java;3;0;11;1;1;1;1;10;70;1;10;2049;199;199;1;0;0;10;11;2049;0;4081;11;3;
/org.eclipse.jdt.ui.tests.refactoring/resources/DeleteSourceReference/test15/out/A.java;1;0;2;1;0;0;0;2;2;1;2;3416;2;2;1;0;0;2;2;3416;0;3471;2;1;
/org.eclipse.team.cvs.ui/src/org/eclipse/team/internal/ccvs/ui/merge/MergeEditorInput.java;3;1;14;2;5;5;5;9;44;2;8;2641;184;184;2;1;0;9;14;2828;1;4005;13;3;
/org.eclipse.pde.ui/src/org/eclipse/pde/internal/ui/wizards/WizardCollectionElement.java;1;0;1;1;0;0;0;1;0;0;1;3579;0;0;1;0;0;1;1;3579;0;3579;1;1;
/org.eclipse.team.cvs.ui/src/org/eclipse/team/internal/ccvs/ui/model/CVSFolderElement.java;1;0;5;1;1;1;1;4;82;1;4;3545;137;137;1;0;0;4;5;3545;0;3976;5;1;
/org.eclipse.pde.ui/src/org/eclipse/pde/internal/model/build/Build.java;2;0;4;1;0;0;0;4;3;1;4;1434;5;5;1;0;0;4;4;1434;0;3579;4;2;
/org.eclipse.pde.ui/Eclipse PDE UI/org/eclipse/pde/internal/model/component/ComponentURLElement.java;2;0;6;2;0;0;0;6;12;3;4;267;16;16;3;2;0;6;6;324;2;1434;4;2;
/org.eclipse.vcm.core.cvs/src/org/eclipse/vcm/internal/core/ccvs/CVSAdapterFactory.java;6;0;9;2;0;0;0;9;74;2;7;0;146;146;2;2;0;9;9;195;2;1262;7;6;
/org.eclipse.jdt.core/model/org/eclipse/jdt/core/IField.java;2;1;6;1;3;3;3;3;48;1;3;455;103;103;1;0;0;3;6;455;0;4421;6;2;
/org.eclipse.core.tests.resources/src/org/eclipse/core/tests/internal/watson/IPathConstants.java;3;0;4;1;1;1;1;3;64;1;3;1794;84;84;1;0;0;3;4;1794;0;4516;4;3;
/org.eclipse.jdt.ui/ui/org/eclipse/jdt/internal/ui/filters/LibraryFilter.java;1;0;1;1;1;1;1;0;0;0;0;4211;0;0;1;0;0;0;1;4211;0;4211;1;1;
/org.eclipse.pde.core/src/org/eclipse/pde/core/IWritable.java;1;0;4;1;2;1;2;2;16;1;2;3591;18;18;2;0;1;2;4;4751;1;4751;3;1;
/org.eclipse.pde.junit/src/org/eclipse/pde/internal/junit/launcher/JUnitPdeMainTab.java;1;1;9;1;3;3;3;6;172;1;6;3171;410;410;1;0;0;6;9;3171;0;4498;9;1;
/org.eclipse.jdt.ui/ui/org/eclipse/jdt/internal/ui/preferences/NewVariableDialog.java;1;0;3;1;0;0;0;3;7;1;3;133;11;11;1;0;0;3;3;133;0;159;3;1;
/org.eclipse.ui/Eclipse JFace Text/org/eclipse/jface/text/presentation/IPresentationReconciler.java;3;0;3;1;0;0;0;3;31;1;3;257;36;36;1;0;0;3;3;257;0;1066;3;3;
/org.eclipse.jdt.ui/ui/org/eclipse/jdt/internal/ui/reorg/TypedSourceTransfer.java;1;0;2;1;0;0;0;2;4;1;2;2064;4;4;1;0;0;2;2;2064;0;3413;2;1;
/org.eclipse.tomcat/src/org/eclipse/tomcat/internal/ServerInfo.java;2;0;2;1;0;0;0;2;0;1;2;3285;0;0;1;0;0;2;2;3285;0;3297;2;2;
/org.eclipse.jdt.debug/eval/org/eclipse/jdt/internal/debug/eval/ast/instructions/RightShiftOperator.java;3;0;6;1;0;0;0;6;36;1;6;3421;48;48;1;0;0;6;6;3421;0;3677;6;3;
/org.eclipse.jdt.ui.tests.refactoring/resources/ExtractMethodWorkSpace/ExtractMethodTests/validSelection/A_test262.java;2;1;3;1;2;2;2;1;6;0;1;195;6;6;1;0;0;1;3;195;0;4419;3;2;
/org.eclipse.jdt.ui.tests.refactoring/resources/RenameType/test46/in/A.java;2;0;2;1;0;0;0;2;2;1;2;49;2;2;1;0;0;2;2;49;0;1297;2;2;
/org.eclipse.swt.examples/src/org/eclipse/swt/examples/explorer/FileViewer.java;1;0;1;1;0;0;0;1;0;0;1;513;0;0;1;0;0;1;1;513;0;513;1;1;
/org.eclipse.swt.examples.launcher/org/eclipse/swt/examples/launcher/OptimalSplitLayout.java;1;0;1;1;0;0;0;1;0;0;1;554;0;0;1;0;0;1;1;554;0;554;1;1;
/org.eclipse.ui/Eclipse UI/org/eclipse/ui/actions/NewProjectAction.java;3;0;5;1;1;1;1;4;31;1;4;2572;53;53;1;0;0;4;5;2572;0;4458;5;3;
/org.eclipse.search/search/org/eclipse/search/internal/ui/SearchMessages.java;1;0;5;1;0;0;0;5;17;1;5;687;35;35;1;0;0;5;5;687;0;1434;5;1;
/org.eclipse.webdav/src/interface/org/eclipse/webdav/Server.java;3;0;3;1;0;0;0;3;12;1;3;12;12;12;1;0;0;3;3;12;0;1874;3;3;
/org.eclipse.jdt.ui.tests.refactoring/resources/RenameVariables/canRename/A_test0_in.java;1;0;2;1;0;0;0;2;0;1;2;724;0;0;1;0;0;2;2;724;0;1665;2;1;
/org.eclipse.jdt.core/model/org/eclipse/jdt/core/ToolFactory.java;3;2;19;2;8;7;8;11;72;2;9;3349;225;225;2;2;1;11;19;3376;3;4836;16;3;
/org.eclipse.debug.core/core/org/eclipse/debug/core/model/ISuspendResume.java;3;0;4;1;0;0;0;4;12;1;4;187;23;23;1;0;0;4;4;187;0;3474;4;3;
/org.eclipse.jdt.ui.tests.refactoring/resources/RenameType/test33/in/A.java;1;0;1;1;0;0;0;1;0;0;1;49;0;0;1;0;0;1;1;49;0;49;1;1;
/org.eclipse.core.tests.runtime/src/org/eclipse/core/tests/internal/runtimetests/SampleD.java;1;0;3;1;0;0;0;3;10;2;2;3605;13;13;2;1;0;3;3;3605;1;3678;2;1;
/org.eclipse.core.tests.resources/src/org/eclipse/core/tests/resources/NatureTest.java;1;0;3;1;1;1;1;2;14;1;2;3075;17;17;1;0;0;2;3;3075;0;4516;3;1;
/org.eclipse.pde.ui/src/org/eclipse/pde/internal/editor/feature/RequiresSection.java;1;0;8;1;0;0;0;8;89;2;7;2952;148;148;2;1;0;8;8;3035;1;3579;7;1;
/org.eclipse.jdt.core/ant/org/eclipse/jdt/internal/core/ant/Util.java;1;0;11;1;0;0;0;11;8;4;8;677;17;17;4;3;0;11;11;1039;3;3526;8;1;
/org.eclipse.jdt.ui.tests.refactoring/resources/SelectionAnalyzerWorkSpace/SelectionAnalyzerTests/invalidSelection/A_test090.java;2;0;2;1;0;0;0;2;0;1;2;1368;0;0;1;0;0;2;2;1368;0;2139;2;2;
/org.eclipse.ui/Eclipse UI/org/eclipse/ui/internal/PartTabFolder.java;6;1;20;1;7;7;7;13;49;1;13;257;321;321;1;0;0;13;20;257;0;4604;20;6;
/org.eclipse.help/src/org/eclipse/help/internal/navigation1_0/InfosetBuilder.java;1;0;2;1;0;0;0;2;0;1;2;1675;0;0;1;0;0;2;2;1675;0;2217;2;1;
/org.eclipse.help.webapp/src/org/eclipse/help/servlet/LiveHelpServlet.java;1;0;1;1;1;1;1;0;0;0;0;3928;0;0;1;0;0;0;1;3928;0;3928;1;1;
/org.eclipse.jdt.core/search/org/eclipse/jdt/internal/core/search/matching/PackageDeclarationPattern.java;2;0;11;1;1;1;1;10;183;4;6;455;463;463;4;4;0;10;11;1039;4;4063;7;2;
/org.eclipse.jdt.ui.tests.refactoring/resources/RenameVirtualMethodInClass/test26/out/A.java;1;0;1;1;0;0;0;1;0;0;1;49;0;0;1;0;0;1;1;49;0;49;1;1;
/org.eclipse.jdt.debug/model/org/eclipse/jdt/debug/core/IJavaEvaluationListener.java;2;0;5;1;0;0;0;5;10;1;5;187;17;17;1;0;0;5;5;187;0;2381;5;2;
/org.eclipse.jdt.ui/core refactoring/org/eclipse/jdt/internal/corext/refactoring/code/flow/GenericConditionalFlowInfo.java;1;0;2;1;0;0;0;2;1;1;2;1939;1;1;1;0;0;2;2;1939;0;2684;2;1;
/org.eclipse.jdt.ui/ui/org/eclipse/jdt/internal/ui/reorg/DeleteSourceReferenceEdit.java;2;0;5;1;0;0;0;5;23;2;4;2003;26;26;2;1;0;5;5;2133;1;2310;4;2;
/org.eclipse.search/search/org/eclipse/search/internal/ui/RemoveAllSearchesAction.java;2;0;5;1;1;1;1;4;9;1;4;15;18;18;1;0;0;4;5;15;0;4619;5;2;
/org.eclipse.scripting/src/org/eclipse/scripting/internal/views/ScriptDevelopmentWizardPageFileName.java;1;0;1;1;0;0;0;1;0;0;1;1424;0;0;1;0;0;1;1;1424;0;1424;1;1;
/org.eclipse.core.tests.resources/src/org/eclipse/core/tests/resources/usecase/ConcurrencyPerformanceTest.java;3;0;3;1;0;0;0;3;62;1;3;1794;72;72;1;0;0;3;3;1794;0;3475;3;3;
/org.eclipse.jdt.ui/core extension/org/eclipse/jdt/internal/corext/codegeneration/StubUtility.java;2;0;2;1;0;0;0;2;2;1;2;2016;2;2;1;0;0;2;2;2016;0;2137;2;2;
/org.eclipse.swt/Eclipse SWT/emulated/tabfolder/org/eclipse/swt/widgets/TabItem.java;5;2;12;1;6;4;6;6;69;1;6;1029;114;114;2;0;2;6;12;4557;2;4701;10;5;
/org.eclipse.jdt.ui.tests.refactoring/resources/PullUp/testFail1/in/A.java;1;0;1;1;0;0;0;1;0;0;1;2406;0;0;1;0;0;1;1;2406;0;2406;1;1;
/org.eclipse.jdt.ui.tests.refactoring/resources/ExtractTemp/cannotExtract/A_testFail2.java;1;0;1;1;0;0;0;1;0;0;1;2481;0;0;1;0;0;1;1;2481;0;2481;1;1;
/org.eclipse.jdt.ui.tests.refactoring/resources/RenameMethodInInterface/test42/out/A.java;1;0;1;1;0;0;0;1;0;0;1;49;0;0;1;0;0;1;1;49;0;49;1;1;
/org.eclipse.pde.ui/src/org/eclipse/pde/internal/forms/renamed/ScrollableForm.java;1;0;2;1;0;0;0;2;0;1;2;2470;0;0;1;0;0;2;2;2470;0;2691;2;1;
/org.eclipse.swt/Eclipse SWT/common/org/eclipse/swt/events/DisposeEvent.java;2;0;3;1;1;1;1;2;6;1;2;106;10;10;1;0;0;2;3;106;0;4701;3;2;
/org.eclipse.help.ui/Eclipse Help UI/org/eclipse/help/internal/ui/HyperlinkAdapter.java;2;0;3;1;0;0;0;3;7;1;3;136;7;7;1;0;0;3;3;136;0;1420;3;2;
/org.eclipse.pde.ui/src/org/eclipse/pde/internal/ui/preferences/CheckOption.java;1;0;2;1;0;0;0;2;0;1;2;3579;0;0;1;0;0;2;2;3579;0;3634;2;1;
/org.eclipse.jdt.ui/ui/org/eclipse/jdt/internal/ui/text/correction/UnresolvedElementsEvaluations.java;2;0;3;2;0;0;0;3;2;2;2;3531;2;2;2;1;0;3;3;3569;1;3569;2;2;
/org.eclipse.jdt.ui.tests.refactoring/resources/InlineTemp/canInline/A_test16_in.java;1;0;1;1;0;0;0;1;0;0;1;3067;0;0;1;0;0;1;1;3067;0;3067;1;1;
/org.eclipse.jdt.core/model/org/eclipse/jdt/core/ISourceRange.java;2;0;4;1;1;1;1;3;21;1;3;455;53;53;1;0;0;3;4;455;0;4061;4;2;
/org.eclipse.pde.ui/src/org/eclipse/pde/internal/ui/editor/SelectionProvider.java;1;0;1;1;0;0;0;1;0;0;1;3579;0;0;1;0;0;1;1;3579;0;3579;1;1;
/org.eclipse.jdt.ui.tests.refactoring/resources/ExtractMethodWorkSpace/ExtractMethodTests/invalidSelection/A_test141.java;2;1;4;1;2;2;2;2;18;1;2;226;29;29;1;0;0;2;4;226;0;4419;4;2;
/org.eclipse.ant.ui/src/org/eclipse/ant/ui/internal/toolscripts/RunToolScriptDialog.java;1;0;3;1;0;0;0;3;2;2;2;2919;2;2;2;1;0;3;3;2919;1;2933;2;1;
/org.eclipse.swt.tests/JUnit Tests/org/eclipse/swt/tests/junit/Test_org_eclipse_swt_layout_RowData.java;2;0;2;1;1;1;1;1;6;0;1;1792;6;6;1;0;0;1;2;1792;0;4706;2;2;
/org.eclipse.swt/Eclipse SWT/common_j2me/org/eclipse/swt/internal/Compatability.java;1;0;1;1;0;0;0;1;0;0;1;1378;0;0;1;0;0;1;1;1378;0;1378;1;1;
/org.eclipse.jdt.ui/ui/org/eclipse/jdt/internal/ui/actions/AddJavaDocStubAction.java;3;0;10;1;1;1;1;9;14;1;9;1359;56;56;1;0;0;9;10;1359;0;3968;10;3;
/org.eclipse.swt/Eclipse SWT PI/gtk/org/eclipse/swt/internal/gtk/GtkBox.java;1;0;2;1;0;0;0;2;0;1;2;2107;0;0;1;0;0;2;2;2107;0;3209;2;1;
/org.eclipse.jdt.ui/ui/org/eclipse/jdt/ui/IWorkingCopyManager.java;2;0;4;1;1;1;1;3;14;1;3;15;25;25;1;0;0;3;4;15;0;4810;4;2;
/org.eclipse.jdt.core/eval/org/eclipse/jdt/internal/eval/EvaluationConstants.java;2;0;10;1;1;1;1;9;156;4;5;455;299;299;4;4;0;9;10;1039;4;4062;6;2;
/org.eclipse.update.ui.forms/src/org/eclipse/update/ui/forms/internal/engine/FormEngine.java;2;2;16;1;7;5;7;9;115;2;8;2746;546;546;2;1;2;9;16;2746;3;4628;13;2;
/org.eclipse.jdt.ui.tests.refactoring/resources/PasteSourceReference/Copy of test0/in/A.java;1;0;2;1;0;0;0;2;0;1;2;2003;0;0;1;0;0;2;2;2003;0;2156;2;1;
/org.eclipse.ui/Eclipse UI/org/eclipse/ui/internal/registry/AcceleratorRegistry.java;2;0;8;1;0;0;0;8;128;2;7;3055;369;369;2;1;0;8;8;3450;1;3450;7;2;
/org.eclipse.jdt.debug.tests/test plugin/org/eclipse/jdt/debug/testplugin/TestPluginLauncher.java;2;1;3;1;2;2;2;1;15;0;1;3701;19;19;1;0;0;1;3;3701;0;4328;3;2;
/org.eclipse.jdt.ui/nls/org/eclipse/jdt/internal/nls/changes/CreateTextFileChange.java;1;0;2;1;0;0;0;2;0;1;2;1880;0;0;1;0;0;2;2;1880;0;1913;2;1;
/org.eclipse.pde.ui/src/org/eclipse/pde/internal/util/JavaCodeGenerator.java;1;0;2;1;0;0;0;2;0;1;2;2978;0;0;1;0;0;2;2;2978;0;3240;2;1;
/org.eclipse.jdt.junit/Eclipse JUnit/org/eclipse/jdt/junit/internal/TestInfo.java;2;0;2;1;0;0;0;2;0;1;2;1531;0;0;1;0;0;2;2;1531;0;2007;2;2;
/org.eclipse.debug.ui/ui/org/eclipse/debug/internal/ui/LaunchesViewerFilter.java;2;0;3;1;0;0;0;3;5;1;3;187;5;5;1;0;0;3;3;187;0;2390;3;2;
/org.eclipse.jdt.ui.tests.refactoring/resources/RenamePrivateMethod/test20/out/A.java;1;0;1;1;0;0;0;1;0;0;1;49;0;0;1;0;0;1;1;49;0;49;1;1;
/org.eclipse.jdt.ui.tests.refactoring/resources/RenamePrivateMethod/testFail5/in/A.java;1;0;1;1;0;0;0;1;0;0;1;49;0;0;1;0;0;1;1;49;0;49;1;1;
/org.eclipse.help.ui/src/org/eclipse/help/ui/internal/browser/solaris/NetscapeBrowserAdapter.java;2;0;3;1;1;1;1;2;13;1;2;2429;15;15;1;0;0;2;3;2429;0;4439;3;2;
/org.eclipse.team.cvs.ssh/src/org/eclipse/team/internal/ccvs/ssh/SSHPlugin.java;2;0;3;1;0;0;0;3;2;1;3;1978;4;4;1;0;0;3;3;1978;0;3102;3;2;
/org.eclipse.jdt.ui/ui/org/eclipse/jdt/internal/ui/reorg/IRenameSupport.java;2;0;3;1;0;0;0;3;5;1;3;15;5;5;1;0;0;3;3;15;0;1258;3;2;
/org.eclipse.core.runtime/src/org/eclipse/core/internal/plugins/PluginPrerequisite.java;3;0;8;1;1;1;1;7;150;2;6;12;229;229;2;1;0;7;8;1657;1;4213;7;3;
/org.eclipse.vcm.tests.core.cvs.ssh/src/org/eclipse/vcm/tests/core/ccvs/ssh/BlowfishPerformanceTest.java;1;0;1;1;0;0;0;1;0;0;1;1688;0;0;1;0;0;1;1;1688;0;1688;1;1;
/org.eclipse.jdt.ui/ui/org/eclipse/jdt/internal/ui/actions/SelectionConverter.java;5;1;12;1;6;6;6;6;43;1;6;3533;142;142;1;0;0;6;12;3533;0;4426;12;5;
/org.eclipse.jdt.ui/core extension/org/eclipse/jdt/internal/corext/template/Template.java;1;0;2;1;0;0;0;2;7;1;2;2784;7;7;1;0;0;2;2;2784;0;3640;2;1;
/org.eclipse.jdt.ui/ui/org/eclipse/jdt/internal/ui/packageview/FrameBackAction.java;1;0;3;1;0;0;0;3;4;1;3;213;4;4;1;0;0;3;3;213;0;390;3;1;
/org.eclipse.jdt.ui.tests.refactoring/resources/PullUp/testTemplate/in/A.java;1;0;1;1;0;0;0;1;0;0;1;2406;0;0;1;0;0;1;1;2406;0;2406;1;1;
/org.eclipse.jdt.launching.j9/j9/org/eclipse/jdt/internal/launching/j9/J9VMInstall.java;1;0;1;1;0;0;0;1;0;0;1;3314;0;0;1;0;0;1;1;3314;0;3314;1;1;
/org.eclipse.jdt.ui.tests.refactoring/resources/RenameStaticMethod/test0/in/A.java;1;0;1;1;0;0;0;1;0;0;1;49;0;0;1;0;0;1;1;49;0;49;1;1;
/org.eclipse.team.cvs.core/src/org/eclipse/team/internal/ccvs/core/resources/Synchronizer.java;2;0;16;1;0;0;0;16;494;5;11;2156;1568;1568;5;5;0;16;16;2275;5;2690;11;2;
/org.eclipse.pde.runtime/Eclipse PDE Runtime/org/eclipse/pde/internal/runtime/registry/ExtensionPointPropertySource.java;2;0;3;1;0;0;0;3;4;1;3;267;4;4;1;0;0;3;3;267;0;1434;3;2;
/org.eclipse.pde.ui/src/org/eclipse/pde/internal/editor/component/ComponentFormPage.java;2;0;4;1;0;0;0;4;4;1;4;1434;6;6;1;0;0;4;4;1434;0;2951;4;2;
/org.eclipse.jdt.ui/core extension/org/eclipse/jdt/internal/corext/codemanipulation/AddMemberEdit2.java;2;0;3;1;0;0;0;3;2;2;2;1937;2;2;2;1;0;3;3;1937;1;1955;2;2;
/org.eclipse.update.core/src/org/eclipse/update/internal/core/ErrorRecoveryLog.java;2;3;10;1;10;8;10;0;340;0;0;4060;454;454;3;0;2;0;10;4260;2;4408;8;2;
/org.eclipse.jdt.junit/Eclipse JUnit/org/eclipse/jdt/internal/junit/ui/FailureDetailView.java;1;0;4;1;0;0;0;4;14;1;4;2007;15;15;1;0;0;4;4;2007;0;2399;4;1;
/org.eclipse.team.cvs.core/src/org/eclipse/team/internal/ccvs/core/client/listeners/ICommandOutputListener.java;2;0;6;1;0;0;0;6;51;1;6;2572;86;86;1;0;0;6;6;2572;0;3610;6;2;
/org.eclipse.jdt.core/model/org/eclipse/jdt/internal/core/builder/impl/AbstractMemberHandleSWH.java;1;0;3;1;0;0;0;3;21;1;3;455;21;21;1;0;0;3;3;455;0;2808;3;1;
/org.eclipse.update.tests.core/src/org/eclipse/update/tests/core/boot/AllPlatformConfigurationTests.java;2;0;7;2;0;0;0;7;5;3;5;2082;14;14;3;2;0;7;7;2583;2;2667;5;2;
/org.eclipse.jdt.ui/ui/org/eclipse/jdt/ui/IContextMenuConstants.java;4;0;7;1;1;1;1;6;28;1;6;15;121;121;1;0;0;6;7;15;0;4810;7;4;
/org.eclipse.team.ftp/src/org/eclipse/team/internal/ftp/ui/FTPConfigurationWizard.java;4;1;5;1;5;5;5;0;19;0;0;4250;34;34;1;0;0;0;5;4250;0;4636;5;4;
/org.eclipse.jdt.ui.tests.refactoring/resources/SelectionAnalyzerWorkSpace/SelectionAnalyzerTests/invalidSelection/A_test083.java;1;0;1;1;0;0;0;1;0;0;1;1368;0;0;1;0;0;1;1;1368;0;1368;1;1;
/org.eclipse.pde.ui/src/org/eclipse/pde/internal/ui/editor/feature/ReferenceWizardPage.java;1;1;2;1;2;2;2;0;1;0;0;4262;1;1;1;0;0;0;2;4262;0;4435;2;1;
/org.eclipse.ui/Eclipse UI Standard Components/org/eclipse/ui/wizards/datatransfer/WizardZipFileImportPage1.java;3;0;3;1;0;0;0;3;35;1;3;257;36;36;1;0;0;3;3;257;0;2738;3;3;
/org.eclipse.jdt.ui.tests.refactoring/resources/ExtractMethodWorkSpace/ExtractMethodTests/invalidSelection/A_test152.java;2;1;3;1;2;2;2;1;12;0;1;254;12;12;1;0;0;1;3;254;0;4419;3;2;
/org.eclipse.jdt.ui/core refactoring/org/eclipse/jdt/internal/core/refactoring/sef/EncapsulateWriteAccess.java;2;0;6;1;0;0;0;6;88;2;5;1453;151;151;2;1;0;6;6;1937;1;1937;5;2;
/org.eclipse.pde.ui/src/org/eclipse/pde/internal/wizards/templates/LabelField.java;1;0;2;1;0;0;0;2;0;1;2;3415;0;0;1;0;0;2;2;3415;0;3579;2;1;
/org.eclipse.jdt.ui.tests.refactoring/resources/ExtractMethodWorkSpace/ExtractMethodTests/expression_in/A_test605.java;2;1;3;1;2;2;2;1;16;0;1;239;16;16;1;0;0;1;3;239;0;4419;3;2;
/org.eclipse.swt.examples.launcher/org/eclipse/swt/examples/launcher/ItemDescriptor.java;4;0;4;1;1;1;1;3;85;1;3;513;123;123;1;0;0;3;4;513;0;4024;4;4;
/org.eclipse.jdt.debug.tests/tests/org/eclipse/jdt/debug/tests/eval/TestsNestedTypes1.java;2;2;4;2;4;3;4;0;12;0;0;4447;18;18;2;0;1;0;4;4568;1;4568;3;2;
/org.eclipse.jdt.ui/ui refactoring/org/eclipse/jdt/internal/ui/refactoring/actions/ModifyParametersActionDelegate.java;1;0;3;1;0;0;0;3;3;1;3;2820;3;3;1;0;0;3;3;2820;0;3754;3;1;
/org.eclipse.jdt.ui.tests.refactoring/test cases/org/eclipse/jdt/ui/tests/refactoring/AllChangeTests.java;2;0;2;1;0;0;0;2;10;1;2;1896;10;10;1;0;0;2;2;1896;0;1913;2;2;
/org.eclipse.jdt.ui/core refactoring/org/eclipse/jdt/internal/core/refactoring/packages/RenamePackageChange.java;3;0;8;1;0;0;0;8;88;1;8;408;147;147;1;0;0;8;8;408;0;1342;8;3;
/org.eclipse.ui/Eclipse UI Tool Script/org/eclipse/toolscript/ui/internal/LogConsoleView.java;1;1;2;1;2;2;2;0;2;0;0;4065;2;2;1;0;0;0;2;4065;0;4087;2;1;
/org.eclipse.jdt.ui/core refactoring/org/eclipse/jdt/internal/core/refactoring/packageroots/RenameSourceFolderChange.java;1;0;3;1;0;0;0;3;16;1;3;988;16;16;1;0;0;3;3;988;0;1342;3;1;
/org.eclipse.jdt.ui.tests.refactoring/resources/RenameNonPrivateField/test8/out/A.java;1;0;1;1;0;0;0;1;0;0;1;49;0;0;1;0;0;1;1;49;0;49;1;1;
/org.eclipse.jdt.ui.tests.refactoring/resources/RenameMethodInInterface/test14/out/A.java;1;0;1;1;0;0;0;1;0;0;1;49;0;0;1;0;0;1;1;49;0;49;1;1;
/org.eclipse.jdt.ui.tests.refactoring/resources/RenameVirtualMethodInClass/testFail26/in/A.java;1;0;1;1;0;0;0;1;0;0;1;49;0;0;1;0;0;1;1;49;0;49;1;1;
/org.eclipse.update.core/src/org/eclipse/update/internal/core/FeatureReference.java;2;0;20;1;0;0;0;20;140;2;19;1744;532;532;2;1;0;20;20;3027;1;3569;19;2;
/org.eclipse.swt.tests/JUnit Tests/org/eclipse/swt/tests/junit/Test_org_eclipse_swt_graphics_RGB.java;2;0;2;1;1;1;1;1;6;0;1;1792;6;6;1;0;0;1;2;1792;0;4706;2;2;
/org.eclipse.jdt.ui.tests.refactoring/resources/RenameVirtualMethodInClass/testFail24/in/A.java;1;0;1;1;0;0;0;1;0;0;1;49;0;0;1;0;0;1;1;49;0;49;1;1;
/org.eclipse.jdt.ui/ui/org/eclipse/jdt/internal/ui/filters/NonJavaElementFilter.java;1;0;1;1;1;1;1;0;0;0;0;4211;0;0;1;0;0;0;1;4211;0;4211;1;1;
/org.eclipse.core.tests.resources/src/org/eclipse/core/tests/resources/usecase/IFolderTest.java;3;0;4;1;0;0;0;4;548;1;4;1794;572;572;1;0;0;4;4;1794;0;3475;4;3;
/org.eclipse.ui/Eclipse UI Standard Components/org/eclipse/ui/views/navigator/OpenActionGroup.java;3;1;4;1;2;2;2;2;20;1;2;3451;27;27;1;0;0;2;4;3451;0;4381;4;3;
/org.eclipse.jdt.ui.tests.refactoring/resources/MoveMembers/test22/out/B.java;1;0;1;1;0;0;0;1;0;0;1;2738;0;0;1;0;0;1;1;2738;0;2738;1;1;
/org.eclipse.webdav/src/kernel/org/eclipse/webdav/internal/kernel/LockToken.java;1;0;4;1;1;1;1;3;46;1;3;12;66;66;1;0;0;3;4;12;0;4211;4;1;
/org.eclipse.team.ftp/src/org/eclipse/team/internal/ftp/client/FTPAuthenticationException.java;1;1;2;1;2;2;2;0;0;0;0;4169;0;0;1;0;0;0;2;4169;0;4327;2;1;
/org.eclipse.jdt.core/compiler/org/eclipse/jdt/internal/compiler/problem/AbortType.java;2;0;3;1;1;1;1;2;16;1;2;455;23;23;1;0;0;2;3;455;0;4062;3;2;
/org.eclipse.jdt.debug.ui/ui/org/eclipse/jdt/internal/debug/ui/launcher/VMContentProvider.java;1;0;1;1;0;0;0;1;0;0;1;1915;0;0;1;0;0;1;1;1915;0;1915;1;1;
/org.eclipse.jdt.debug.ui/ui/org/eclipse/jdt/internal/debug/ui/launcher/JavaProjectPropertyPage.java;2;0;3;1;0;0;0;3;2;1;3;1915;4;4;1;0;0;3;3;1915;0;3363;3;2;
/org.eclipse.ui/Eclipse UI/org/eclipse/ui/internal/ResetToolBarAction.java;1;0;1;1;1;1;1;0;0;0;0;4607;0;0;1;0;0;0;1;4607;0;4607;1;1;
/org.eclipse.search/search/org/eclipse/search/internal/ui/SearchManager.java;2;3;28;1;7;5;7;21;63;2;19;15;427;427;3;2;2;21;28;4161;4;4619;24;2;
/org.eclipse.core.resources/src/org/eclipse/core/internal/dtree/DataTreeNode.java;2;0;7;1;1;1;1;6;678;2;5;12;1234;1234;2;1;0;6;7;1241;1;4214;6;2;
/org.eclipse.update.core/src/org/eclipse/update/internal/core/SessionDelta.java;2;1;10;1;10;10;10;0;106;0;0;3901;223;223;1;0;0;0;10;3901;0;4331;10;2;
/org.eclipse.pde.ui/templates/editor/java/XMLConfiguration.java;1;0;4;1;2;1;2;2;33;1;2;3812;43;43;2;0;1;2;4;4316;1;4316;3;1;
/org.eclipse.core.runtime/src/org/eclipse/core/runtime/OperationCanceledException.java;3;0;4;1;1;1;1;3;50;1;3;12;71;71;1;0;0;3;4;12;0;4214;4;3;
/org.eclipse.pde.ui/src/org/eclipse/pde/internal/ui/editor/feature/ReferenceForm.java;1;0;4;1;1;1;1;3;9;2;2;3579;18;18;2;1;0;3;4;3579;1;3982;3;1;
/org.eclipse.team.cvs.ui/src/org/eclipse/team/internal/ccvs/ui/wizards/KSubstWizardDirtyFilesPage.java;3;1;6;1;3;3;3;3;23;1;3;3251;46;46;1;0;0;3;6;3251;0;4626;6;3;
/org.eclipse.jdt.ui.tests.refactoring/resources/MoveMembers/test18/in/B.java;1;0;1;1;0;0;0;1;0;0;1;2738;0;0;1;0;0;1;1;2738;0;2738;1;1;
/org.eclipse.jdt.launching/launching/org/eclipse/jdt/internal/launching/StandardVM.java;1;0;1;1;0;0;0;1;0;0;1;3122;0;0;1;0;0;1;1;3122;0;3122;1;1;
/org.eclipse.scripting/src/org/eclipse/scripting/internal/uirenderer/XGRElementUISwtShell.java;1;0;1;1;0;0;0;1;0;0;1;1424;0;0;1;0;0;1;1;1424;0;1424;1;1;
/org.eclipse.vcm.ui/src/org/eclipse/vcm/internal/ui/syncdialog/DiffCategory.java;2;0;2;1;0;0;0;2;0;1;2;1;0;0;1;0;0;2;2;1;0;68;2;2;
/org.eclipse.pde.build/src_ant/org/eclipse/pde/internal/build/tasks/InitTemplate.java;1;0;6;1;1;1;1;5;8;2;4;3509;14;14;2;1;0;5;6;3571;1;3973;5;1;
/org.eclipse.core.resources/src/org/eclipse/core/internal/indexing/ObjectStorePage.java;2;0;5;1;1;1;1;4;56;1;4;12;96;96;1;0;0;4;5;12;0;4214;5;2;
/org.eclipse.swt/Eclipse SWT/photon/org/eclipse/swt/widgets/Shell.java;8;1;26;1;6;6;6;20;307;3;17;106;1269;1269;3;3;0;20;26;616;3;4727;23;8;
/org.eclipse.jdt.ui.tests.refactoring/resources/ExtractTemp/cannotExtract/A_testFail6.java;1;0;1;1;0;0;0;1;0;0;1;2820;0;0;1;0;0;1;1;2820;0;2820;1;1;
/org.eclipse.jdt.ui.tests/ui/org/eclipse/jdt/ui/tests/wizardapi/NewJavaProjectWizardTest.java;2;0;4;1;1;1;1;3;22;1;3;1276;30;30;1;0;0;3;4;1276;0;4452;4;2;
/org.eclipse.debug.ui/ui/org/eclipse/debug/internal/ui/RelaunchActionDelegate.java;4;0;17;1;0;0;0;17;81;2;16;187;285;285;2;1;0;17;17;963;1;2382;16;4;
/org.eclipse.update/Eclipse Update/org/eclipse/update/internal/ui/UMWizardProductComponentRevert.java;2;0;5;1;0;0;0;5;75;1;5;108;81;81;1;0;0;5;5;108;0;1424;5;2;
/org.eclipse.jdt.core/jdom/org/eclipse/jdt/core/dom/Node.java;1;0;2;1;0;0;0;2;0;1;2;1241;0;0;1;0;0;2;2;1241;0;2675;2;1;
/org.eclipse.jdt.ui/core refactoring/org/eclipse/jdt/internal/corext/refactoring/Checks.java;4;1;19;2;2;2;2;17;42;2;16;1939;256;256;2;1;0;17;19;3185;1;4427;18;4;
/org.eclipse.swt.examples.controls/org/eclipse/swt/examples/controls/LabelTab.java;2;0;3;1;0;0;0;3;158;1;3;513;158;158;1;0;0;3;3;513;0;970;3;2;
/org.eclipse.jdt.debug.tests/test plugin/org/eclipse/jdt/debug/testplugin/DebugElementEventWaiter.java;2;0;2;1;1;1;1;1;11;0;1;3701;11;11;1;0;0;1;2;3701;0;4328;2;2;
/org.eclipse.jdt.ui/core refactoring/org/eclipse/jdt/internal/core/refactoring/types/RenameTypeRefactoring.java;4;0;18;1;0;0;0;18;522;4;14;408;821;821;4;4;0;18;18;408;4;1342;14;4;
/org.eclipse.pde.ui/templates/view/java/$className$.java;1;0;2;1;0;0;0;2;14;0;1;3425;14;14;2;1;0;2;2;3425;1;3425;1;1;
/org.eclipse.jdt.ui/ui/org/eclipse/jdt/internal/ui/launcher/AddExceptionAction.java;4;0;8;1;0;0;0;8;218;1;8;15;259;259;1;0;0;8;8;15;0;1916;8;4;
/org.eclipse.jdt.ui.tests.refactoring/resources/ExtractMethodWorkSpace/ExtractMethodTests/expression_out/A_test613.java;1;1;4;1;2;2;2;2;4;1;2;1236;4;4;1;0;0;2;4;1236;0;4419;4;1;
/org.eclipse.jdt.ui.tests.refactoring/resources/ExtractTemp/cannotExtract/A_testFail19.java;1;0;1;1;0;0;0;1;0;0;1;3414;0;0;1;0;0;1;1;3414;0;3414;1;1;
/org.eclipse.ui.externaltools/External Tools/org/eclipse/ui/externaltools/internal/ui/LogTreeContentProvider.java;1;0;1;1;1;1;1;0;0;0;0;4123;0;0;1;0;0;0;1;4123;0;4123;1;1;
/org.eclipse.scripting/Eclipse Scripting/org/eclipse/scripting/internal/uirenderer/XGREventAction.java;2;0;4;1;0;0;0;4;4;1;4;133;8;8;1;0;0;4;4;133;0;1424;4;2;
/org.eclipse.pde.core/src/org/eclipse/pde/internal/core/build/BuildModel.java;1;0;2;1;1;1;1;1;10;0;1;3591;10;10;1;0;0;1;2;3591;0;4568;2;1;
/org.eclipse.tomcat/src/org/eclipse/tomcat/internal/TomcatPlugin.java;1;0;4;1;0;0;0;4;39;1;4;3285;43;43;1;0;0;4;4;3285;0;3777;4;1;
/org.eclipse.jdt.debug.ui/ui/org/eclipse/jdt/internal/debug/ui/launcher/RuntimeClasspathEntryLabelProvider.java;1;1;9;1;8;8;8;1;31;0;1;3875;80;80;1;0;0;1;9;3875;0;4693;9;1;
/org.eclipse.pde.ui/src/org/eclipse/pde/internal/util/AbstractOverlayIcon.java;1;0;2;1;0;0;0;2;0;1;2;2847;0;0;1;0;0;2;2;2847;0;3579;2;1;
/org.eclipse.jdt.ui/ui/org/eclipse/jdt/internal/ui/preferences/SpacerFieldEditor.java;2;0;2;1;0;0;0;2;0;1;2;1861;0;0;1;0;0;2;2;1861;0;3084;2;2;
/org.eclipse.ui/Eclipse UI/org/eclipse/ui/internal/DynamicMenuManager.java;1;0;1;1;0;0;0;1;0;0;1;2918;0;0;1;0;0;1;1;2918;0;2918;1;1;
/org.eclipse.pde.ui/src/org/eclipse/pde/internal/core/feature/FeatureInstallHandler.java;1;0;3;1;0;0;0;3;2;1;3;3579;2;2;1;0;0;3;3;3579;0;3607;3;1;
/org.eclipse.swt/Eclipse SWT PI/photon/org/eclipse/swt/internal/photon/PgDisplaySettings_t.java;2;0;2;1;1;1;1;1;6;0;1;2069;6;6;1;0;0;1;2;2069;0;4701;2;2;
/org.eclipse.team.tests.cvs.core/src/org/eclipse/team/tests/ccvs/ui/PerformanceTimer.java;1;0;1;1;0;0;0;1;0;0;1;2977;0;0;1;0;0;1;1;2977;0;2977;1;1;
/org.eclipse.jdt.debug.ui/ui/org/eclipse/jdt/internal/debug/ui/launcher/JavaEnvironmentTab.java;3;1;40;2;5;5;5;35;692;3;24;2607;2555;2555;3;11;0;35;40;3206;11;3984;29;3;
/org.eclipse.team.core/src/org/eclipse/team/core/internal/Policy.java;3;0;5;1;0;0;0;5;164;1;5;1978;180;180;1;0;0;5;5;1978;0;3762;5;3;
/org.eclipse.jdt.ui.tests.refactoring/resources/PullUp/testFail11/in/B.java;1;0;1;1;0;0;0;1;0;0;1;2406;0;0;1;0;0;1;1;2406;0;2406;1;1;
/org.eclipse.team.core/src/org/eclipse/team/core/target/ILocationFactory.java;2;0;2;2;2;1;2;0;0;0;0;4128;0;0;2;0;1;0;2;4128;1;4128;1;2;
/org.eclipse.jdt.core/batch/org/eclipse/jdt/internal/compiler/batch/FileFinder.java;2;0;11;1;1;1;1;10;71;4;7;455;129;129;4;3;0;10;11;1039;3;4061;8;2;
/org.eclipse.swt/Eclipse SWT/common/org/eclipse/swt/widgets/Item.java;4;2;7;1;4;3;4;3;67;1;3;106;93;93;2;0;1;3;7;4557;1;4701;6;4;
/org.eclipse.jdt.ui.tests/JUnit/junit/extensions/ExceptionTestCase.java;2;0;2;1;0;0;0;2;0;1;2;49;0;0;1;0;0;2;2;49;0;1186;2;2;
/org.eclipse.team.examples.filesystem/src/org/eclipse/team/examples/filesystem/ui/ConfigurationWizard.java;1;0;1;1;1;1;1;0;0;0;0;4674;0;0;1;0;0;0;1;4674;0;4674;1;1;
/org.eclipse.ui/Eclipse UI/org/eclipse/ui/dialogs/WizardExportPage.java;4;0;5;1;1;1;1;4;74;1;4;257;91;91;1;0;0;4;5;257;0;4283;5;4;
/org.eclipse.swt/Eclipse SWT/carbon/org/eclipse/swt/graphics/FontMetrics.java;3;1;4;1;4;4;4;0;11;0;0;4147;22;22;1;0;0;0;4;4147;0;4701;4;3;
/org.eclipse.help.ui/src/org/eclipse/help/internal/ui/HyperlinkLabel.java;2;1;2;1;2;2;2;0;0;0;0;3897;0;0;1;0;0;0;2;3897;0;4439;2;2;
/org.eclipse.core.tests.runtime/src/org/eclipse/core/tests/internal/plugins/SoftPrereqTest_10.java;3;0;3;1;0;0;0;3;126;1;3;1794;136;136;1;0;0;3;3;1794;0;3476;3;3;
/org.eclipse.jdt.ui.tests.refactoring/resources/RenameType/test24/out/A.java;1;0;2;1;0;0;0;2;0;1;2;49;0;0;1;0;0;2;2;49;0;522;2;1;
/org.eclipse.jdt.ui/core refactoring/org/eclipse/jdt/internal/corext/refactoring/rename/ParameterOffsetFinder.java;2;0;2;1;0;0;0;2;0;1;2;1939;0;0;1;0;0;2;2;1939;0;2630;2;2;
/org.eclipse.vcm.core.cvs/src/org/eclipse/vcm/internal/core/ccvs/client/IRequestNames.java;2;0;3;1;0;0;0;3;6;1;3;0;7;7;1;0;0;3;3;0;0;1627;3;2;
/org.eclipse.jdt.ui/ui/org/eclipse/jdt/internal/ui/text/template/TemplateInterpolator.java;1;0;6;1;0;0;0;6;54;1;6;1469;106;106;1;0;0;6;6;1469;0;2784;6;1;
/org.eclipse.ui.tests/UI Test Utils/org/eclipse/ui/tests/internal/util/FailureDialog.java;1;0;1;1;0;0;0;1;0;0;1;2785;0;0;1;0;0;1;1;2785;0;2785;1;1;
/org.eclipse.scripting/src/org/eclipse/scripting/internal/Script.java;1;0;1;1;0;0;0;1;0;0;1;1424;0;0;1;0;0;1;1;1424;0;1424;1;1;
/org.eclipse.debug.ui/ui/org/eclipse/debug/internal/ui/TextViewerGotoLineAction.java;3;0;3;1;0;0;0;3;1;1;3;1714;1;1;1;0;0;3;3;1714;0;2382;3;3;
/org.eclipse.jdt.debug/model/org/eclipse/jdt/debug/core/IJavaDebugTarget.java;4;1;12;1;2;2;2;10;121;1;10;187;430;430;1;0;0;10;12;187;0;4423;12;4;
/org.eclipse.ui/Eclipse UI Tool Script/org/eclipse/toolscript/core/internal/IToolScript.java;1;1;2;1;2;2;2;0;16;0;0;3920;16;16;1;0;0;0;2;3920;0;3976;2;1;
/org.eclipse.jdt.ui.tests.refactoring/resources/RenameType/test53/out/B.java;1;0;1;1;0;0;0;1;0;0;1;1274;0;0;1;0;0;1;1;1274;0;1274;1;1;
/org.eclipse.core.boot/src/org/eclipse/core/internal/boot/update/FragmentEntryDescriptorModel.java;2;0;3;1;0;0;0;3;4;1;3;12;4;4;1;0;0;3;3;12;0;2726;3;2;
/org.eclipse.jdt.debug.ui/ui/org/eclipse/jdt/internal/debug/ui/JDISourceViewer.java;1;0;2;1;1;1;1;1;77;0;1;1933;77;77;1;0;0;1;2;1933;0;3939;2;1;
/org.eclipse.jdt.core/model/org/eclipse/jdt/core/IJavaProject.java;3;1;20;2;5;5;5;15;569;2;13;455;1565;1565;2;2;0;15;20;1976;2;4505;18;3;
/org.eclipse.jdt.core/dom/org/eclipse/jdt/core/dom/PrimitiveType.java;2;1;9;1;3;3;3;6;18;1;6;2669;62;62;1;0;0;6;9;2669;0;4452;9;2;
/org.eclipse.jdt.core/model/org/eclipse/jdt/internal/core/builder/InvalidKeyException.java;1;0;4;1;0;0;0;4;20;1;4;455;22;22;1;0;0;4;4;455;0;2808;4;1;
/org.eclipse.jdt.ui/core refactoring/org/eclipse/jdt/internal/core/refactoring/changes/MovePackageChange.java;2;0;3;1;0;0;0;3;23;1;3;1108;23;23;1;0;0;3;3;1108;0;1939;3;2;
/org.eclipse.jdt.ui.tests.refactoring/resources/RenameVirtualMethodInClass/test1/in/A.java;1;0;1;1;0;0;0;1;0;0;1;49;0;0;1;0;0;1;1;49;0;49;1;1;
/org.eclipse.core.target/src/org/eclipse/core/internal/target/filesystem/PushTarget.java;2;0;7;1;1;1;1;6;360;1;6;12;573;573;1;0;0;6;7;12;0;4196;7;2;
/org.eclipse.swt/Eclipse SWT/win32/org/eclipse/swt/internal/win32/GCP_RESULTS.java;2;0;2;1;0;0;0;2;0;1;2;1002;0;0;1;0;0;2;2;1002;0;2069;2;2;
/org.eclipse.jdt.debug/eval/org/eclipse/jdt/internal/debug/eval/ast/engine/EvaluationThread.java;3;1;6;1;5;5;5;1;11;0;1;3852;26;26;1;0;0;1;6;3852;0;4737;6;3;
/org.eclipse.ant.ui/src/org/eclipse/ant/internal/ui/toolscripts/AntBuilderPropertyPage.java;1;0;3;1;0;0;0;3;11;2;2;2933;11;11;2;1;0;3;3;2933;1;2979;2;1;
/org.eclipse.jdt.ui/ui/org/eclipse/jdt/internal/ui/viewsupport/SeverityItemMapper.java;1;0;2;1;0;0;0;2;0;1;2;1004;0;0;1;0;0;2;2;1004;0;1048;2;1;
/org.eclipse.pde.ui/src/org/eclipse/pde/internal/model/jars/JarEntry.java;2;0;2;1;0;0;0;2;0;1;2;1434;0;0;1;0;0;2;2;1434;0;2650;2;2;
/org.eclipse.jdt.ui/ui refactoring/org/eclipse/jdt/internal/ui/nls/FindStringsAction.java;1;0;2;1;0;0;0;2;0;1;2;1913;0;0;1;0;0;2;2;1913;0;1922;2;1;
/org.eclipse.help/src/org/eclipse/help/internal/navigation/InfosetsMap.java;2;0;2;1;0;0;0;2;0;1;2;1420;0;0;1;0;0;2;2;1420;0;1675;2;2;
/org.eclipse.update.core/src/org/eclipse/update/core/model/URLEntryModel.java;1;0;3;1;0;0;0;3;113;1;3;2409;161;161;1;0;0;3;3;2409;0;3575;3;1;
/org.eclipse.search/search/org/eclipse/search/internal/ui/text/ResourcenameSorter.java;1;0;4;1;0;0;0;4;20;1;4;1117;35;35;1;0;0;4;4;1117;0;1272;4;1;
/org.eclipse.jdt.ui/nls/org/eclipse/jdt/internal/ui/nls/search/GroupByKeyComputer.java;1;0;2;1;0;0;0;2;0;1;2;1880;0;0;1;0;0;2;2;1880;0;1913;2;1;
/org.eclipse.debug.ui/ui/org/eclipse/debug/internal/ui/launchConfigurations/LaunchConfigurationTypesPreferencePage.java;2;0;5;1;1;1;1;4;11;2;3;3741;17;17;2;1;0;4;5;3814;1;3915;4;2;
/org.eclipse.jdt.core/model/org/eclipse/jdt/internal/core/jdom/NullProblem.java;1;0;3;1;0;0;0;3;205;1;3;455;205;205;1;0;0;3;3;455;0;2849;3;1;
/org.eclipse.jdt.ui.tests.refactoring/resources/RenameStaticMethod/testFail2/in/A.java;1;0;1;1;0;0;0;1;0;0;1;49;0;0;1;0;0;1;1;49;0;49;1;1;
/org.eclipse.pde.ui/Eclipse PDE UI/org/eclipse/pde/internal/editor/component/ComponentEditor.java;2;0;8;2;0;0;0;8;40;3;6;267;75;75;3;2;0;8;8;324;2;1434;6;2;
/org.eclipse.jdt.ui.tests.refactoring/resources/RenameMethodInInterface/test10/in/A.java;1;0;1;1;0;0;0;1;0;0;1;49;0;0;1;0;0;1;1;49;0;49;1;1;
/org.eclipse.jdt.ui.tests.refactoring/resources/RenameTemp/canRename/A_test15_in.java;1;0;1;1;0;0;0;1;0;0;1;1625;0;0;1;0;0;1;1;1625;0;1625;1;1;
/org.eclipse.jdt.ui/core refactoring/org/eclipse/jdt/internal/corext/refactoring/changes/AbstractDeleteChange.java;2;0;3;1;1;1;1;2;10;1;2;1939;12;12;1;0;0;2;3;1939;0;3947;3;2;
/org.eclipse.help.ui.win32/src/org/eclipse/help/ui/internal/browser/win32/HelpControlSite.java;1;1;2;1;2;2;2;0;2;0;0;4427;2;2;1;0;0;0;2;4427;0;4439;2;1;
/org.eclipse.ui/Eclipse UI/org/eclipse/ui/internal/misc/ExternalProgramImageDescriptor.java;3;0;3;1;0;0;0;3;14;1;3;257;18;18;1;0;0;3;3;257;0;620;3;3;
/org.eclipse.update.core/src/org/eclipse/update/internal/core/NonPluginEntry.java;1;0;1;1;0;0;0;1;0;0;1;2419;0;0;1;0;0;1;1;2419;0;2419;1;1;
/org.eclipse.jdt.ui/core refactoring/org/eclipse/jdt/internal/corext/refactoring/rename/RenameTempRefactoring.java;2;1;23;2;2;2;2;21;276;2;19;1939;912;912;2;2;0;21;23;2137;2;4003;21;2;
/org.eclipse.jdt.core/model/org/eclipse/jdt/internal/core/builder/impl/ConsoleProgressMonitor.java;1;0;3;1;0;0;0;3;15;2;2;455;15;15;2;1;0;3;3;630;1;630;2;1;
/org.eclipse.help.webapp/src/org/eclipse/help/internal/proxy/protocol/livehelp/Handler.java;1;0;1;1;0;0;0;1;0;0;1;3454;0;0;1;0;0;1;1;3454;0;3454;1;1;
/org.eclipse.jdt.ui.tests.refactoring/resources/ExtractMethodWorkSpace/ExtractMethodTests/return_in/A_test719.java;1;1;3;1;2;2;2;1;24;0;1;1236;24;24;1;0;0;1;3;1236;0;4419;3;1;
/org.eclipse.jdt.ui/ui/org/eclipse/jdt/ui/actions/OpenActionGroup.java;1;0;3;1;0;0;0;3;2;1;3;3533;2;2;1;0;0;3;3;3533;0;3716;3;1;
/org.eclipse.swt.examples.paint/org/eclipse/swt/examples/paint/FilledRectangleTool.java;1;0;1;1;0;0;0;1;0;0;1;513;0;0;1;0;0;1;1;513;0;513;1;1;
/org.eclipse.jdt.junit/src/org/eclipse/jdt/internal/junit/ui/RerunAction.java;2;0;3;1;1;1;1;2;2;1;2;3171;4;4;1;0;0;2;3;3171;0;4634;3;2;
/org.eclipse.update/Eclipse Update/org/eclipse/update/internal/ui/UMDialogAction.java;2;0;4;1;0;0;0;4;28;1;4;108;35;35;1;0;0;4;4;108;0;1424;4;2;
/org.eclipse.jdt.ui/nls/org/eclipse/jdt/internal/ui/nls/search/NLSSearchMessages.java;1;0;2;1;0;0;0;2;0;1;2;1880;0;0;1;0;0;2;2;1880;0;1913;2;1;
/org.eclipse.search/search/org/eclipse/search/ui/ISearchResultViewEntry.java;2;0;3;1;0;0;0;3;9;1;3;15;14;14;1;0;0;3;3;15;0;1434;3;2;
/org.eclipse.ant.core/src/org/eclipse/ant/internal/core/old/MoveProject.java;1;0;1;1;0;0;0;1;0;0;1;3270;0;0;1;0;0;1;1;3270;0;3270;1;1;
/org.eclipse.pde.ui/src/org/eclipse/pde/internal/model/PluginExtension.java;2;0;5;1;0;0;0;5;13;1;5;1434;20;20;1;0;0;5;5;1434;0;3136;5;2;
/org.eclipse.jdt.debug.ui/ui/org/eclipse/jdt/internal/debug/ui/MethodActionFilter.java;1;0;1;1;1;1;1;0;0;0;0;4457;0;0;1;0;0;0;1;4457;0;4457;1;1;
/org.eclipse.pde.ui/Eclipse PDE UI/org/eclipse/pde/internal/editor/build/BuildForm.java;3;0;8;2;0;0;0;8;12;3;6;267;20;20;3;2;0;8;8;324;2;1434;6;3;
/org.eclipse.ui.tests/Eclipse JFace Tests/org/eclipse/jface/tests/viewers/ITestModelListener.java;1;0;1;1;0;0;0;1;0;0;1;1488;0;0;1;0;0;1;1;1488;0;1488;1;1;
/org.eclipse.ui/Eclipse JFace Text/org/eclipse/jface/text/source/IVerticalRulerInfo.java;1;1;4;1;3;3;3;1;22;0;1;3592;58;58;1;0;0;1;4;3592;0;4838;4;1;
/org.eclipse.jdt.debug/eval/org/eclipse/jdt/internal/debug/eval/model/IPrimitiveType.java;2;0;2;1;0;0;0;2;0;1;2;3555;0;0;1;0;0;2;2;3555;0;3645;2;2;
/org.eclipse.jdt.core/dom/org/eclipse/jdt/core/dom/TryStatement.java;2;1;6;1;2;2;2;4;18;1;4;2669;51;51;1;0;0;4;6;2669;0;4453;6;2;
/org.eclipse.jdt.ui.tests.refactoring/resources/RenameParameters/cannotRename/A_testFail2.java;1;0;1;1;0;0;0;1;0;0;1;233;0;0;1;0;0;1;1;233;0;233;1;1;
/org.eclipse.jdt.ui/ui/org/eclipse/jdt/internal/ui/JavaWorkbenchAdapter.java;4;1;9;1;3;3;3;6;41;1;6;15;67;67;1;0;0;6;9;15;0;4621;9;4;
/org.eclipse.swt/Eclipse SWT/photon/org/eclipse/swt/internal/photon/PhClipHeader.java;2;0;4;1;0;0;0;4;20;1;4;638;25;25;1;0;0;4;4;638;0;2069;4;2;
/org.eclipse.core.tests.runtime/src/org/eclipse/core/tests/internal/plugins/PluginResolveTest_12.java;3;0;3;1;0;0;0;3;128;1;3;1794;138;138;1;0;0;3;3;1794;0;3476;3;3;
/org.eclipse.pde.ui/Eclipse PDE UI/org/eclipse/pde/internal/model/component/ComponentFragment.java;2;0;6;2;0;0;0;6;12;3;4;267;14;14;3;2;0;6;6;324;2;1434;4;2;
/org.eclipse.jdt.ui.tests.refactoring/resources/RenameVirtualMethodInClass/test15/in/A.java;1;0;1;1;0;0;0;1;0;0;1;49;0;0;1;0;0;1;1;49;0;49;1;1;
/org.eclipse.swt.examples/src/org/eclipse/swt/examples/javaviewer/JavaViewer.java;4;0;5;1;1;1;1;4;180;1;4;513;256;256;1;0;0;4;5;513;0;4705;5;4;
/org.eclipse.team.tests.cvs.core/src/org/eclipse/team/tests/ccvs/ui/logformatter/ArgumentParser.java;1;0;1;1;0;0;0;1;0;0;1;3452;0;0;1;0;0;1;1;3452;0;3452;1;1;
/org.eclipse.jdt.ui.tests.refactoring/resources/MultiMove/test1/out/p2/C.java;1;0;2;1;0;0;0;2;2;1;2;1157;2;2;1;0;0;2;2;1157;0;2584;2;1;
/org.eclipse.webdav/src/kernel/org/eclipse/webdav/internal/kernel/ResponseImpl.java;3;0;4;1;0;0;0;4;12;1;4;12;17;17;1;0;0;4;4;12;0;1874;4;3;
/org.eclipse.jdt.ui.tests.refactoring/resources/ExtractMethodWorkSpace/ExtractMethodTests/locals_out/A_test534.java;1;1;4;1;2;2;2;2;28;1;2;922;31;31;1;0;0;2;4;922;0;4419;4;1;
/org.eclipse.jdt.ui/core refactoring/org/eclipse/jdt/internal/corext/refactoring/changes/RenameCompilationUnitChange.java;2;0;3;1;0;0;0;3;7;1;3;1939;10;10;1;0;0;3;3;1939;0;3699;3;2;
/org.eclipse.jdt.debug.ui/ui/org/eclipse/jdt/internal/debug/ui/JavaDebugHover.java;3;1;7;1;2;2;2;5;127;2;4;2009;161;161;2;1;0;5;7;3362;1;4550;6;3;
/org.eclipse.jdt.ui/ui refactoring/org/eclipse/jdt/internal/ui/refactoring/actions/DelegatingRenameAction.java;1;0;2;1;0;0;0;2;0;1;2;1345;0;0;1;0;0;2;2;1345;0;1360;2;1;
/org.eclipse.swt.examples.paint/src/org/eclipse/swt/examples/paint/ToolSettings.java;3;0;4;2;1;1;1;3;31;2;2;513;37;37;2;1;0;3;4;609;1;4705;3;3;
/org.eclipse.search/search/org/eclipse/search/internal/ui/SearchResultLabelProvider.java;2;0;11;1;0;0;0;11;57;1;11;15;186;186;1;0;0;11;11;15;0;3224;11;2;
/org.eclipse.debug.ui/ui/org/eclipse/debug/internal/ui/views/AbstractDebugSelectionProvider.java;2;0;3;1;0;0;0;3;2;1;3;2325;2;2;1;0;0;3;3;2325;0;3186;3;2;
/org.eclipse.jdt.ui/ui/org/eclipse/jdt/internal/ui/launcher/StandardVM.java;3;0;5;1;0;0;0;5;8;2;4;218;16;16;2;1;0;5;5;218;1;1916;4;3;
/org.eclipse.scripting/Eclipse Scripting/org/eclipse/scripting/internal/IXGRElementEventGeneratorOnReset.java;1;0;3;1;0;0;0;3;4;1;3;133;4;4;1;0;0;3;3;133;0;1424;3;1;
/org.eclipse.update.ui/src/org/eclipse/update/internal/ui/views/MultiPageView.java;1;0;5;1;1;1;1;4;23;1;4;3537;30;30;1;0;0;4;5;3537;0;4370;5;1;
/org.eclipse.jdt.ui.tests.refactoring/resources/RenameVirtualMethodInClass/test34/in/A.java;1;0;1;1;1;1;1;0;0;0;0;4465;0;0;1;0;0;0;1;4465;0;4465;1;1;
/org.eclipse.jdt.debug.ui/ui/org/eclipse/jdt/internal/debug/ui/JavaApplicationLaunchConfigurationDelegate.java;3;0;13;1;0;0;0;13;263;2;11;1915;535;535;2;2;0;13;13;2220;2;2556;11;3;
/org.eclipse.vcm.core.cvs/src/org/eclipse/vcm/internal/core/ccvs/utils/TimeUtil.java;2;0;2;1;0;0;0;2;0;1;2;0;0;0;1;0;0;2;2;0;0;101;2;2;
/org.eclipse.update.examples/src/org/eclipse/update/examples/buildzip/DefaultModelWriter.java;1;0;3;1;0;0;0;3;5;1;3;2976;7;7;1;0;0;3;3;2976;0;3361;3;1;
/org.eclipse.jdt.ui.tests.refactoring/resources/ExtractMethodWorkSpace/ExtractMethodTests/locals_out/A_test533.java;1;1;4;1;2;2;2;2;24;1;2;922;29;29;1;0;0;2;4;922;0;4419;4;1;
/org.eclipse.ui/Eclipse UI/org/eclipse/ui/actions/PartEventAction.java;2;0;2;1;0;0;0;2;5;1;2;257;5;5;1;0;0;2;2;257;0;457;2;2;
/org.eclipse.jdt.ui.tests.refactoring/resources/RenameType/testFail37/in/B.java;1;0;1;1;0;0;0;1;0;0;1;49;0;0;1;0;0;1;1;49;0;49;1;1;
/org.eclipse.swt/Eclipse SWT/carbon/org/eclipse/swt/graphics/Device.java;3;1;4;1;4;4;4;0;10;0;0;4147;20;20;1;0;0;0;4;4147;0;4701;4;3;
/org.eclipse.pde.ui/src/org/eclipse/pde/internal/schema/EditableSchema.java;2;0;4;1;0;0;0;4;4;1;4;1434;5;5;1;0;0;4;4;1434;0;3579;4;2;
/org.eclipse.core.tests.resources/src/org/eclipse/core/tests/resources/session/TestSnapSaveSnap.java;2;0;3;1;0;0;0;3;134;1;3;2390;144;144;1;0;0;3;3;2390;0;3475;3;2;
/org.eclipse.jdt.launching/launching/org/eclipse/jdt/internal/launching/LaunchingMessages.java;1;0;1;1;0;0;0;1;0;0;1;2022;0;0;1;0;0;1;1;2022;0;2022;1;1;
/org.eclipse.jdt.ui/ui/org/eclipse/jdt/internal/ui/viewsupport/BaseJavaElementContentProvider.java;4;1;13;1;6;6;6;7;74;1;7;1315;281;281;1;0;0;7;13;1315;0;4212;13;4;
/org.eclipse.jdt.ui/core refactoring/org/eclipse/jdt/core/refactoring/text/ITextBufferChangeCreator.java;1;0;3;1;0;0;0;3;5;1;3;15;5;5;1;0;0;3;3;15;0;408;3;1;
/org.eclipse.ui/Eclipse JFace Text/org/eclipse/jface/text/TextViewer.java;6;3;45;1;14;12;14;31;2267;2;28;257;4852;4852;3;3;2;31;45;4423;5;4853;40;6;
/org.eclipse.ui/Eclipse UI/org/eclipse/ui/internal/registry/ActionSetPartAssociationsReader.java;1;0;1;1;0;0;0;1;0;0;1;3233;0;0;1;0;0;1;1;3233;0;3233;1;1;
/org.eclipse.scripting/src/org/eclipse/scripting/internal/datamodels/XGRXmlDataNode.java;1;0;1;1;0;0;0;1;0;0;1;1424;0;0;1;0;0;1;1;1424;0;1424;1;1;
/org.eclipse.ui/Eclipse UI/org/eclipse/ui/internal/PopupMenuExtender.java;3;0;3;1;0;0;0;3;45;1;3;257;68;68;1;0;0;3;3;257;0;1528;3;3;
/org.eclipse.scripting/Eclipse Scripting/org/eclipse/scripting/internal/views/ScriptUIEditorModel.java;2;0;5;1;0;0;0;5;41;1;5;133;50;50;1;0;0;5;5;133;0;1424;5;2;
/org.eclipse.jdt.ui/core refactoring/org/eclipse/jdt/internal/corext/refactoring/structure/MemberCheckUtil.java;1;0;5;1;1;1;1;4;25;1;4;2737;57;57;1;0;0;4;5;2737;0;4014;5;1;
/org.eclipse.jdt.ui/ui/org/eclipse/jdt/internal/ui/packageview/FilterSelectionAction.java;4;0;9;1;1;1;1;8;8;1;8;37;29;29;1;0;0;8;9;37;0;4211;9;4;
/org.eclipse.ui.externaltools/External Tools/org/eclipse/ui/externaltools/internal/ui/AntLaunchWizard.java;1;2;7;1;7;5;7;0;21;0;0;4090;64;64;2;0;2;0;7;4188;2;4402;5;1;
/org.eclipse.swt/Eclipse SWT/win32/org/eclipse/swt/internal/win32/MSG.java;2;0;3;1;0;0;0;3;5;1;3;106;5;5;1;0;0;3;3;106;0;2069;3;2;
/org.eclipse.jdt.ui.tests.refactoring/resources/RenameTemp/cannotRename/A_testFail20.java;1;0;2;1;0;0;0;2;2;1;2;1625;2;2;1;0;0;2;2;1625;0;1652;2;1;
/org.eclipse.jdt.junit/src/org/eclipse/jdt/internal/junit/util/JUnitStubUtility.java;1;1;5;1;4;4;4;1;9;0;1;3247;19;19;1;0;0;1;5;3247;0;4634;5;1;
/org.eclipse.jdt.debug/eval/org/eclipse/jdt/internal/debug/eval/ast/instructions/RemainderAssignmentOperator.java;2;0;5;1;1;1;1;4;4;1;4;3421;10;10;1;0;0;4;5;3421;0;3955;5;2;
/org.eclipse.jdt.ui.tests.refactoring/resources/RenameType/test52/out/B.java;1;0;1;1;0;0;0;1;0;0;1;1258;0;0;1;0;0;1;1;1258;0;1258;1;1;
/org.eclipse.pde.runtime/Eclipse PDE Runtime/org/eclipse/pde/internal/runtime/logview/LogViewContentProvider.java;2;0;3;1;0;0;0;3;4;1;3;267;4;4;1;0;0;3;3;267;0;1434;3;2;
/org.eclipse.scripting/src/org/eclipse/scripting/internal/ScriptNLTranslationManager.java;1;0;1;1;0;0;0;1;0;0;1;1424;0;0;1;0;0;1;1;1424;0;1424;1;1;
/org.eclipse.ui/Eclipse UI/org/eclipse/ui/internal/dialogs/ViewLabelProvider.java;3;0;3;1;0;0;0;3;7;1;3;257;12;12;1;0;0;3;3;257;0;1382;3;3;
/org.eclipse.jdt.core/model/org/eclipse/jdt/internal/core/newbuilder/State.java;1;0;20;1;0;0;0;20;223;2;16;1764;748;748;2;4;0;20;20;1764;4;2979;16;1;
/org.eclipse.jdt.ui/ui/org/eclipse/jdt/internal/ui/util/PixelConverter.java;3;0;3;1;1;1;1;2;8;1;2;2483;14;14;1;0;0;2;3;2483;0;4401;3;3;
/org.eclipse.jdt.core/search/org/eclipse/jdt/internal/core/search/JavaWorkspaceScope.java;3;1;11;1;2;2;2;9;69;2;8;455;158;158;2;1;0;9;11;1586;1;4320;10;3;
/org.eclipse.pde.core/src/org/eclipse/pde/internal/core/builders/SourceDOMParser.java;1;0;2;1;0;0;0;2;0;1;2;3591;0;0;1;0;0;2;2;3591;0;3631;2;1;
/org.eclipse.jdt.core/model/org/eclipse/jdt/core/eval/IEvaluationContext.java;2;0;6;1;2;1;2;4;452;1;4;455;911;911;2;0;1;4;6;4058;1;4058;5;2;
/org.eclipse.scripting/src/org/eclipse/scripting/internal/IXGRElementUIRunnable.java;1;0;1;1;0;0;0;1;0;0;1;1424;0;0;1;0;0;1;1;1424;0;1424;1;1;
/org.eclipse.ui/Eclipse UI Standard Components/org/eclipse/ui/views/tasklist/TaskListMessages.java;2;0;2;1;1;1;1;1;3;0;1;457;3;3;1;0;0;1;2;457;0;4269;2;2;
/org.eclipse.scripting/Eclipse Scripting/org/eclipse/scripting/internal/views/ScriptUIEditorTreeViewerDropAdapter.java;2;0;4;1;0;0;0;4;16;1;4;133;29;29;1;0;0;4;4;133;0;1424;4;2;
/org.eclipse.jdt.ui/ui/org/eclipse/jdt/internal/ui/reorg/CutSourceReferencesToClipboardAction.java;2;1;15;2;4;4;4;11;40;2;8;2003;157;157;2;3;0;11;15;2003;3;4630;12;2;
/org.eclipse.ui/Eclipse UI/org/eclipse/ui/ResourceAdapterUtil.java;1;0;2;1;0;0;0;2;0;1;2;2139;0;0;1;0;0;2;2;2139;0;2205;2;1;
/org.eclipse.update.ui/src/org/eclipse/update/internal/ui/model/ConfigurationSiteAdapter.java;2;0;3;1;0;0;0;3;11;1;3;2834;13;13;1;0;0;3;3;2834;0;3740;3;2;
/org.eclipse.swt.examples/src/org/eclipse/swt/examples/controlexample/CoolBarTab.java;3;1;13;1;5;5;5;8;162;2;7;1759;345;345;2;1;0;8;13;3455;1;4705;12;3;
/org.eclipse.jdt.ui.tests.refactoring/resources/ExtractMethodWorkSpace/ExtractMethodTests/invalidSelection/A_test041.java;2;1;3;1;2;2;2;1;0;0;1;49;0;0;1;0;0;1;3;49;0;4419;3;2;
/org.eclipse.team.cvs.core/src/org/eclipse/team/internal/ccvs/core/util/FileNameMatcher.java;2;0;5;1;0;0;0;5;89;2;4;2572;117;117;2;1;0;5;5;2864;1;2864;4;2;
/org.eclipse.scripting/src/org/eclipse/scripting/internal/uirenderer/XGRElementUISwtComposite.java;1;0;1;1;0;0;0;1;0;0;1;1424;0;0;1;0;0;1;1;1424;0;1424;1;1;
/org.eclipse.ui/Eclipse UI/org/eclipse/ui/part/PageBookView.java;4;0;13;1;1;1;1;12;183;2;11;257;342;342;2;1;0;12;13;1816;1;4725;12;4;
/org.eclipse.tomcat/src/org/eclipse/tomcat/ServerInfo.java;2;0;3;1;0;0;0;3;2;1;3;2409;2;2;1;0;0;3;3;2409;0;3285;3;2;
/org.eclipse.ui/Eclipse JFace/org/eclipse/jface/action/IContributionManagerOverrides.java;3;0;5;2;0;0;0;5;22;4;2;3447;24;24;4;3;0;5;5;3447;3;3607;2;3;
/org.eclipse.jdt.ui/ui refactoring/org/eclipse/jdt/internal/ui/refactoring/actions/structureselection/StructureSelectPreviousAction.java;2;0;7;1;0;0;0;7;35;1;7;2273;46;46;1;0;0;7;7;2273;0;3188;7;2;
/org.eclipse.jdt.ui/ui/org/eclipse/jdt/internal/ui/compare/ResizableDialog.java;1;1;2;1;2;2;2;0;15;0;0;4189;15;15;1;0;0;0;2;4189;0;4564;2;1;
/org.eclipse.jdt.core/model/org/eclipse/jdt/internal/core/builder/ISearchFactory.java;1;0;4;1;0;0;0;4;392;1;4;455;579;579;1;0;0;4;4;455;0;2808;4;1;
/org.eclipse.pde.build/src/org/eclipse/pde/internal/build/StripMapper.java;2;0;5;1;0;0;0;5;39;2;4;1250;49;49;2;1;0;5;5;1250;1;3089;4;2;
/org.eclipse.swt.tests/JUnit Tests/org/eclipse/swt/tests/junit/Test_org_eclipse_swt_events_TraverseEvent.java;2;0;2;1;1;1;1;1;6;0;1;1792;6;6;1;0;0;1;2;1792;0;4706;2;2;
/org.eclipse.jdt.ui.tests.refactoring/resources/MoveMembers/test23/out/A.java;1;0;1;1;0;0;0;1;0;0;1;2928;0;0;1;0;0;1;1;2928;0;2928;1;1;
/org.eclipse.update.tests.core/src/org/eclipse/update/tests/uivalues/TestUILabel.java;2;0;18;2;2;1;2;16;23;2;13;1674;97;97;2;3;1;16;18;1815;4;3974;14;2;
/org.eclipse.jdt.debug.ui/ui/org/eclipse/jdt/internal/debug/ui/launcher/ArchiveFileFilter.java;1;0;1;1;1;1;1;0;0;0;0;4101;0;0;1;0;0;0;1;4101;0;4101;1;1;
/org.eclipse.team.ftp/src/org/eclipse/team/internal/ftp/client/DataTransferManager.java;1;3;6;1;6;4;6;0;37;0;0;4169;47;47;3;0;2;0;6;4285;2;4573;4;1;
/org.eclipse.platform/src/org/eclipse/core/launcher/Main.java;4;2;16;2;16;13;16;0;282;0;0;4064;741;741;2;0;3;0;16;4195;3;4731;13;4;
/org.eclipse.swt/Eclipse SWT Drag and Drop/win32/org/eclipse/swt/dnd/TransferData.java;2;1;4;1;2;2;2;2;42;1;2;106;71;71;1;0;0;2;4;106;0;4701;4;2;
/org.eclipse.pde.ui/Eclipse PDE UI/org/eclipse/pde/internal/editor/build/VariableSection.java;2;0;6;2;0;0;0;6;18;2;5;267;22;22;2;1;0;6;6;324;1;1434;5;2;
/org.eclipse.update.core/src/org/eclipse/update/internal/core/obsolete/SiteURL.java;1;0;1;1;0;0;0;1;0;0;1;2487;0;0;1;0;0;1;1;2487;0;2487;1;1;
/org.eclipse.scripting/Eclipse Scripting/org/eclipse/scripting/internal/views/ScriptUIEditorWhitespaceDetector.java;1;0;3;1;0;0;0;3;7;1;3;133;7;7;1;0;0;3;3;133;0;1424;3;1;
/org.eclipse.update.core/src/org/eclipse/update/configuration/IProblemHandler.java;2;0;4;1;1;1;1;3;37;1;3;3018;64;64;1;0;0;3;4;3018;0;4687;4;2;
/org.eclipse.swt/Eclipse SWT/common/org/eclipse/swt/events/MenuListener.java;4;0;5;1;1;1;1;4;6;1;4;106;18;18;1;0;0;4;5;106;0;4701;5;4;
/org.eclipse.scripting/Eclipse Scripting/org/eclipse/scripting/internal/uirenderer/XGRPresentationModelException.java;2;0;4;1;0;0;0;4;10;1;4;133;17;17;1;0;0;4;4;133;0;1424;4;2;
/org.eclipse.pde.ui/src/org/eclipse/pde/internal/wizards/project/ConvertedProjectsPage.java;2;0;11;1;0;0;0;11;553;2;9;1434;602;602;2;2;0;11;11;2691;2;3579;9;2;
/org.eclipse.team.webdav/src/org/eclipse/team/internal/webdav/WebdavPlugin.java;1;1;2;1;2;2;2;0;0;0;0;4023;0;0;1;0;0;0;2;4023;0;4073;2;1;
/org.eclipse.jdt.ui.tests.refactoring/resources/SafeDeleteType/testFail4/in/A.java;1;0;1;1;0;0;0;1;0;0;1;49;0;0;1;0;0;1;1;49;0;49;1;1;
/org.eclipse.swt/Eclipse SWT PI/win32/org/eclipse/swt/internal/ole/win32/IMoniker.java;2;0;2;1;1;1;1;1;6;0;1;2069;6;6;1;0;0;1;2;2069;0;4701;2;2;
/org.eclipse.jdt.ui.tests.refactoring/resources/SelectionAnalyzerWorkSpace/SelectionAnalyzerTests/validSelection/A_test246.java;1;0;1;1;0;0;0;1;0;0;1;1368;0;0;1;0;0;1;1;1368;0;1368;1;1;
/org.eclipse.update.ui/src/org/eclipse/update/internal/ui/security/JarVerificationPage.java;3;2;11;2;7;6;7;4;228;3;2;3853;413;413;3;2;1;4;11;3866;3;4708;8;3;
/org.eclipse.jdt.ui.tests.refactoring/resources/MoveMembers/test24/out/A.java;1;0;1;1;0;0;0;1;0;0;1;2928;0;0;1;0;0;1;1;2928;0;2928;1;1;
/org.eclipse.swt/Eclipse SWT/win32/org/eclipse/swt/internal/win32/TBBUTTONINFO.java;2;0;3;1;0;0;0;3;5;1;3;106;5;5;1;0;0;3;3;106;0;2069;3;2;
/org.eclipse.scripting/src/org/eclipse/scripting/internal/uirenderer/XGRElementUISwtPreferencePage.java;1;0;1;1;0;0;0;1;0;0;1;1424;0;0;1;0;0;1;1;1424;0;1424;1;1;
/org.eclipse.scripting/src/org/eclipse/scripting/ScriptAdapterEventHandler.java;1;0;1;1;0;0;0;1;0;0;1;1424;0;0;1;0;0;1;1;1424;0;1424;1;1;
/org.eclipse.swt/Eclipse SWT/photon/org/eclipse/swt/internal/Converter.java;4;1;5;2;2;2;2;3;45;1;3;106;83;83;1;0;0;3;5;106;0;4701;5;4;
/org.eclipse.jdt.ui.tests.refactoring/resources/ExtractMethodWorkSpace/ExtractMethodTests/invalidSelection/A_test015.java;2;1;3;1;2;2;2;1;0;0;1;49;0;0;1;0;0;1;3;49;0;4419;3;2;
/org.eclipse.jdt.debug/model/org/eclipse/jdt/debug/core/IJavaVariable.java;3;0;8;1;0;0;0;8;47;2;7;187;104;104;2;1;0;8;8;3573;1;3573;7;3;
/org.eclipse.jdt.ui/ui/org/eclipse/jdt/internal/ui/compare/CompilationUnitDelta.java;1;0;4;1;0;0;0;4;99;1;4;1486;101;101;1;0;0;4;4;1486;0;2532;4;1;
/org.eclipse.jdt.ui.examples.projects/examples/org/eclipse/jdt/internal/ui/exampleprojects/ExampleProjectMessages.java;1;0;1;1;0;0;0;1;0;0;1;757;0;0;1;0;0;1;1;757;0;757;1;1;
/org.eclipse.pde.ui/src/org/eclipse/pde/internal/editor/build/BuildForm.java;2;0;5;1;0;0;0;5;8;1;5;1434;17;17;1;0;0;5;5;1434;0;3579;5;2;
/org.eclipse.jdt.ui/core refactoring/org/eclipse/jdt/internal/corext/refactoring/AstNodeData.java;2;0;2;1;0;0;0;2;0;1;2;1939;0;0;1;0;0;2;2;1939;0;3087;2;2;
/org.eclipse.pde.build/src/org/eclipse/pde/internal/build/Cvs.java;3;0;5;1;0;0;0;5;317;1;5;1366;347;347;1;0;0;5;5;1366;0;3089;5;3;
/org.eclipse.scripting/Eclipse Scripting/org/eclipse/scripting/internal/datamodels/XGRDataModelFactory.java;2;0;4;1;0;0;0;4;8;1;4;133;12;12;1;0;0;4;4;133;0;1424;4;2;
/org.eclipse.swt.examples/src/org/eclipse/swt/examples/fileviewer/UpdateWorker.java;2;0;3;2;0;0;0;3;1;2;2;554;1;1;2;1;0;3;3;609;1;609;2;2;
/org.eclipse.debug.core/core/org/eclipse/debug/core/ILaunchConfigurationType.java;3;0;9;1;1;1;1;8;18;1;8;1819;74;74;1;0;0;8;9;1819;0;4650;9;3;
/org.eclipse.swt/Eclipse SWT/gtk/org/eclipse/swt/widgets/MenuItem.java;6;2;22;2;14;11;14;8;67;1;8;2107;384;384;2;0;3;8;22;4047;3;4701;19;6;
/org.eclipse.jdt.ui.tests.refactoring/resources/PasteSourceReference/test2/in/B.java;1;0;1;1;0;0;0;1;0;0;1;2859;0;0;1;0;0;1;1;2859;0;2859;1;1;
/org.eclipse.jdt.ui/core codemanipulation/org/eclipse/jdt/internal/core/codemanipulation/ChangeVisibilityEdit.java;1;0;2;1;0;0;0;2;0;1;2;1800;0;0;1;0;0;2;2;1800;0;1937;2;1;
/org.eclipse.ant.core/src/org/eclipse/ant/internal/core/Task.java;1;0;4;1;0;0;0;4;66;2;3;3452;84;84;2;1;0;4;4;3489;1;3575;3;1;
/org.eclipse.jdt.ui/core extension/org/eclipse/jdt/internal/corext/util/AllTypesCache.java;2;0;6;1;0;0;0;6;13;2;5;2805;28;28;2;1;0;6;6;3148;1;3834;5;2;
/org.eclipse.ui/Eclipse UI Standard Components/org/eclipse/ui/views/internal/framelist/GoIntoAction.java;3;0;4;1;0;0;0;4;8;1;4;257;11;11;1;0;0;4;4;257;0;3816;4;3;
/org.eclipse.jdt.core/compiler/org/eclipse/jdt/internal/compiler/ast/PostfixExpression.java;2;1;14;1;2;2;2;12;101;4;9;455;304;304;4;3;0;12;14;1039;3;4421;11;2;
/org.eclipse.pde.ui/src/org/eclipse/pde/internal/core/ifeature/IFeature.java;1;0;2;1;0;0;0;2;0;1;2;3591;0;0;1;0;0;2;2;3591;0;3607;2;1;
/org.eclipse.ui/Eclipse UI/org/eclipse/ui/IPartService.java;2;0;2;1;0;0;0;2;5;1;2;257;5;5;1;0;0;2;2;257;0;457;2;2;
/org.eclipse.update.ui/src/org/eclipse/update/internal/ui/wizards/NewUpdatesWizard.java;2;2;6;1;6;5;6;0;76;0;0;4294;182;182;2;0;1;0;6;4294;1;4575;5;2;
/org.eclipse.jdt.ui.tests.refactoring/resources/SefWorkSpace/SefTests/base_in/TestPrefixInt.java;1;0;1;1;0;0;0;1;0;0;1;2876;0;0;1;0;0;1;1;2876;0;2876;1;1;
/org.eclipse.jdt.ui.tests.refactoring/resources/SelectionAnalyzerWorkSpace/SelectionAnalyzerTests/invalidSelection/A_test060.java;1;0;1;1;0;0;0;1;0;0;1;1368;0;0;1;0;0;1;1;1368;0;1368;1;1;
/org.eclipse.jdt.ui/ui refactoring/org/eclipse/jdt/internal/ui/refactoring/RefactoringSupportFactory.java;3;1;8;1;4;4;4;4;20;1;4;2804;71;71;1;0;0;4;8;2804;0;4427;8;3;
/org.eclipse.debug.ui/ui/org/eclipse/debug/internal/ui/LaunchConfigurationTypesPreferencePage.java;2;0;9;1;0;0;0;9;32;1;9;2481;66;66;1;0;0;9;9;2481;0;3741;9;2;
/org.eclipse.debug.core/core/org/eclipse/debug/internal/core/DebugCoreMessages.java;1;0;1;1;0;0;0;1;0;0;1;1346;0;0;1;0;0;1;1;1346;0;1346;1;1;
/org.eclipse.team.ui/src/org/eclipse/team/internal/ui/actions/CheckInAction.java;2;1;2;1;2;2;2;0;0;0;0;4020;0;0;1;0;0;0;2;4020;0;4155;2;2;
/org.eclipse.swt/Eclipse SWT/win32/org/eclipse/swt/internal/win32/HDITEM.java;2;0;3;1;0;0;0;3;5;1;3;106;5;5;1;0;0;3;3;106;0;2069;3;2;
/org.eclipse.compare/compare/org/eclipse/patch/PatchCompareInput.java;1;0;3;1;0;0;0;3;40;1;3;1419;40;40;1;0;0;3;3;1419;0;1516;3;1;
/org.eclipse.jdt.ui/ui/org/eclipse/jdt/internal/ui/text/java/AnonymousTypeCompletionProposal.java;4;1;24;1;3;3;3;21;108;2;20;1754;280;280;2;1;0;21;24;3643;1;4621;23;4;
/org.eclipse.pde.build/src/org/eclipse/pde/internal/build/BuildScriptGenerator.java;1;0;7;1;1;1;1;6;137;3;3;3460;163;163;3;3;0;6;7;3571;3;4273;4;1;
/org.eclipse.vcm.core/src/org/eclipse/vcm/internal/core/StateId.java;2;0;2;1;0;0;0;2;6;1;2;0;6;6;1;0;0;2;2;0;0;297;2;2;
/org.eclipse.ui/Eclipse JFace Text/org/eclipse/jface/text/DefaultLineTracker.java;3;0;4;1;0;0;0;4;5;1;4;257;9;9;1;0;0;4;4;257;0;1066;4;3;
/org.eclipse.jdt.core/compiler/org/eclipse/jdt/internal/compiler/ast/CharLiteral.java;2;0;4;1;1;1;1;3;173;1;3;455;189;189;1;0;0;3;4;455;0;4062;4;2;
/org.eclipse.jdt.ui/ui/org/eclipse/jdt/internal/ui/reorg/DeleteResourceAction.java;1;0;4;1;0;0;0;4;39;2;3;2005;43;43;2;1;0;4;4;2243;1;2243;3;1;
/org.eclipse.ui/Eclipse UI Text Editor/org/eclipse/ui/editors/text/IEncodingActionsHelpContextIds.java;1;1;2;1;2;2;2;0;59;0;0;4138;59;59;1;0;0;0;2;4138;0;4838;2;1;
/org.eclipse.pde.runtime/Eclipse PDE Runtime/org/eclipse/pde/internal/runtime/registry/PluginObjectAdapter.java;2;0;3;1;0;0;0;3;4;1;3;267;4;4;1;0;0;3;3;267;0;1434;3;2;
/org.eclipse.jdt.ui.tests.refactoring/resources/DeleteSourceReference/test2/out/A.java;1;0;1;1;0;0;0;1;0;0;1;2857;0;0;1;0;0;1;1;2857;0;2857;1;1;
/org.eclipse.jdt.core/model/org/eclipse/jdt/internal/core/util/DiskCache.java;1;0;11;1;0;0;0;11;332;4;7;455;464;464;4;4;0;11;11;1039;4;2030;7;1;
/org.eclipse.swt/Eclipse SWT Custom Widgets/common/org/eclipse/swt/custom/AnimatedProgress.java;3;2;9;1;4;3;4;5;54;2;4;106;81;81;2;1;1;5;9;2876;2;4701;7;3;
/org.eclipse.jdt.debug/jdi interfaces/com/sun/jdi/request/UserDefinedRequest.java;2;0;2;1;0;0;0;2;6;1;2;2704;6;6;1;0;0;2;2;2704;0;3040;2;2;
/org.eclipse.swt/Eclipse SWT/photon/org/eclipse/swt/internal/photon/PtContainerCallback_t.java;3;0;3;1;0;0;0;3;22;1;3;543;22;22;1;0;0;3;3;543;0;2069;3;3;
/org.eclipse.jdt.debug.ui/ui/org/eclipse/jdt/internal/debug/ui/actions/AddExternalFolderAction.java;1;1;2;1;2;2;2;0;1;0;0;3905;1;1;1;0;0;0;2;3905;0;4423;2;1;
/org.eclipse.scripting/src/org/eclipse/scripting/internal/ScriptStrings.java;1;0;1;1;0;0;0;1;0;0;1;1424;0;0;1;0;0;1;1;1424;0;1424;1;1;
/org.eclipse.jdt.junit/src/org/eclipse/jdt/internal/junit/ui/TabFolderLayout.java;1;0;1;1;0;0;0;1;0;0;1;3171;0;0;1;0;0;1;1;3171;0;3171;1;1;
/org.eclipse.swt/Eclipse SWT/gtk1x/org/eclipse/swt/graphics/DeviceData.java;2;0;2;1;1;1;1;1;6;0;1;2107;6;6;1;0;0;1;2;2107;0;4701;2;2;
/org.eclipse.core.tests.runtime/src/org/eclipse/core/tests/internal/plugins/PlatformURLPerformanceTest.java;4;0;4;1;0;0;0;4;444;1;4;1794;484;484;1;0;0;4;4;1794;0;3476;4;4;
/org.eclipse.jdt.debug/model/org/eclipse/jdt/debug/core/IJavaLineBreakpoint.java;2;0;6;1;0;0;0;6;52;1;6;1035;157;157;1;0;0;6;6;1035;0;3571;6;2;
/org.eclipse.ui.tests/Eclipse UI Tests/org/eclipse/ui/tests/zoom/CloseEditorTest.java;1;0;1;1;0;0;0;1;0;0;1;3633;0;0;1;0;0;1;1;3633;0;3633;1;1;
/org.eclipse.ui/Eclipse UI/org/eclipse/ui/actions/ReadOnlyStateChecker.java;5;0;5;1;0;0;0;5;410;1;5;257;463;463;1;0;0;5;5;257;0;3511;5;5;
/org.eclipse.jdt.ui/ui/org/eclipse/jdt/internal/ui/launcher/AddVMDialog.java;5;0;27;1;0;0;0;27;348;3;21;218;1353;1353;3;6;0;27;27;365;6;1916;21;5;
/org.eclipse.jdt.core/model/org/eclipse/jdt/internal/core/util/ToStringSorter.java;3;1;6;1;2;2;2;4;110;1;4;455;163;163;1;0;0;4;6;455;0;4422;6;3;
/org.eclipse.swt.examples/Eclipse SWT Examples/common/org/eclipse/swt/examples/explorer/Images.java;1;0;2;1;0;0;0;2;0;1;2;107;0;0;1;0;0;2;2;107;0;611;2;1;
/org.eclipse.help/src/org/eclipse/help/internal/context/ContextContribution.java;2;0;7;1;0;0;0;7;54;1;7;1675;140;140;1;0;0;7;7;1675;0;2829;7;2;
/org.eclipse.ui/Eclipse UI Text Editor/org/eclipse/ui/texteditor/DocumentProviderRegistry.java;3;0;3;1;0;0;0;3;252;1;3;257;257;257;1;0;0;3;3;257;0;1066;3;3;
/org.eclipse.pde.ui/src/org/eclipse/pde/internal/parts/StructuredViewerPart.java;1;0;4;1;0;0;0;4;16;1;4;2981;24;24;1;0;0;4;4;2981;0;3579;4;1;
/org.eclipse.ui.tests/Eclipse UI Tests/org/eclipse/ui/tests/navigator/DecoratorTestCase.java;1;1;4;1;2;2;2;2;54;0;1;2290;68;68;2;1;0;2;4;2290;1;4007;3;1;
/org.eclipse.update.core/src/org/eclipse/update/core/model/ContentGroupModel.java;2;0;4;1;0;0;0;4;346;1;4;2409;349;349;1;0;0;4;4;2409;0;3027;4;2;
/org.eclipse.pde.ui/src/org/eclipse/pde/internal/preferences/BuildpathPreferencePage.java;2;0;4;1;0;0;0;4;42;1;4;1434;46;46;1;0;0;4;4;1434;0;3579;4;2;
/org.eclipse.jdt.ui.tests.refactoring/resources/RenameType/test11/out/B.java;1;0;1;1;0;0;0;1;0;0;1;522;0;0;1;0;0;1;1;522;0;522;1;1;
/org.eclipse.swt/Eclipse SWT/photon/org/eclipse/swt/widgets/Table.java;2;0;5;1;0;0;0;5;1296;1;5;106;2197;2197;1;0;0;5;5;106;0;1028;5;2;
/org.eclipse.swt.examples/src/org/eclipse/swt/examples/texteditor/ColorTextEditor.java;1;0;1;1;0;0;0;1;0;0;1;513;0;0;1;0;0;1;1;513;0;513;1;1;
/org.eclipse.jdt.ui.tests.refactoring/resources/InlineTemp/canInline/A_test18_in.java;1;0;1;1;0;0;0;1;0;0;1;3355;0;0;1;0;0;1;1;3355;0;3355;1;1;
/org.eclipse.pde.core/src/org/eclipse/pde/core/plugin/IPluginParent.java;1;0;4;1;2;1;2;2;70;1;2;3591;71;71;2;0;1;2;4;4751;1;4751;3;1;
/org.eclipse.debug.core/core/org/eclipse/debug/core/model/IBreakpoint.java;4;0;15;1;1;1;1;14;148;3;11;1139;345;345;3;3;0;14;15;1725;3;4651;12;4;
/org.eclipse.core.resources/src/org/eclipse/core/internal/indexing/PageStoreException.java;4;1;7;1;3;3;3;4;140;1;4;12;294;294;1;0;0;4;7;12;0;4632;7;4;
/org.eclipse.swt/Eclipse SWT Custom Widgets/common/org/eclipse/swt/custom/StyledTextListener.java;5;0;7;1;1;1;1;6;28;1;6;106;63;63;1;0;0;6;7;106;0;4701;7;5;
/org.eclipse.ui/Eclipse UI/org/eclipse/ui/part/FileEditorInputFactory.java;2;0;2;1;0;0;0;2;9;1;2;257;9;9;1;0;0;2;2;257;0;457;2;2;
/org.eclipse.jdt.debug/eval/org/eclipse/jdt/internal/debug/eval/ast/engine/SourceBasedSourceGenerator.java;2;1;11;1;2;2;2;9;150;2;8;3447;391;391;2;1;0;9;11;3505;1;4692;10;2;
/org.eclipse.jdt.ui.tests.refactoring/resources/ExtractMethodWorkSpace/ExtractMethodTests/expression_out/A_test616.java;1;1;4;1;2;2;2;2;4;1;2;1236;4;4;1;0;0;2;4;1236;0;4419;4;1;
/org.eclipse.swt/Eclipse SWT PI/win32/org/eclipse/swt/internal/win32/MEASUREITEMSTRUCT.java;2;0;2;1;1;1;1;1;6;0;1;2069;6;6;1;0;0;1;2;2069;0;4701;2;2;
/org.eclipse.jdt.ui.tests.refactoring/test cases/org/eclipse/jdt/ui/tests/refactoring/PullUpTests.java;1;0;7;1;2;1;2;5;91;2;4;2406;122;122;2;1;1;5;7;2735;2;4450;5;1;
/org.eclipse.jdt.ui/ui/org/eclipse/jdt/internal/ui/actions/RetargetActionIDs.java;3;0;11;1;2;1;2;9;80;2;7;3533;162;162;2;2;1;9;11;3754;3;3894;8;3;
/org.eclipse.jdt.debug.ui/ui/org/eclipse/jdt/internal/debug/ui/launcher/ZipContentProvider.java;1;0;1;1;1;1;1;0;0;0;0;4101;0;0;1;0;0;0;1;4101;0;4101;1;1;
/org.eclipse.pde.ui/Eclipse PDE UI/org/eclipse/pde/internal/model/jars/JarEntry.java;2;0;5;2;0;0;0;5;12;3;3;267;12;12;3;2;0;5;5;324;2;1434;3;2;
/org.eclipse.jdt.ui.tests.refactoring/resources/RenameType/testFail4/in/A.java;1;0;1;1;0;0;0;1;0;0;1;49;0;0;1;0;0;1;1;49;0;49;1;1;
/org.eclipse.swt.examples.paint/org/eclipse/swt/examples/paint/PaintPlugin.java;3;0;3;1;1;1;1;2;78;1;2;513;78;78;1;0;0;2;3;513;0;4024;3;3;
/org.eclipse.team.cvs.core/src/org/eclipse/team/internal/ccvs/core/streams/CRLFtoLFInputStream.java;2;1;3;1;2;2;2;1;8;0;1;3574;8;8;1;0;0;1;3;3574;0;4169;3;2;
/org.eclipse.jdt.ui/core extension/org/eclipse/jdt/internal/corext/template/TemplateBuffer.java;1;0;1;1;0;0;0;1;0;0;1;2784;0;0;1;0;0;1;1;2784;0;2784;1;1;
/org.eclipse.jdt.core/compiler/org/eclipse/jdt/internal/compiler/classfmt/ClassFileConstants.java;2;0;3;1;1;1;1;2;14;1;2;455;18;18;1;0;0;2;3;455;0;4062;3;2;
/org.eclipse.ant.core/src_ant/org/eclipse/ant/internal/core/ant/ProgressBuildListener.java;1;2;4;1;4;3;4;0;150;0;0;4272;156;156;2;0;1;0;4;4272;1;4436;3;1;
/org.eclipse.ui/Eclipse JFace/org/eclipse/jface/resource/JFaceResources.java;3;0;7;1;0;0;0;7;20;2;6;257;40;40;2;1;0;7;7;1064;1;1286;6;3;
/org.eclipse.jdt.ui/ui/org/eclipse/jdt/internal/ui/search/DeclarationsSearchGroup.java;1;3;9;1;5;3;5;4;35;1;4;1707;116;116;3;0;2;4;9;4140;2;4140;7;1;
/org.eclipse.update/Eclipse Update/org/eclipse/update/internal/core/UMSessionManagerMessage.java;1;0;3;1;0;0;0;3;6;1;3;108;6;6;1;0;0;3;3;108;0;1424;3;1;
/org.eclipse.jdt.core/compiler/org/eclipse/jdt/internal/compiler/lookup/SyntheticAccessMethodBinding.java;2;0;3;1;1;1;1;2;474;1;2;455;493;493;1;0;0;2;3;455;0;4062;3;2;
/org.eclipse.jdt.ui.tests.refactoring/resources/RenameParameters/canRename/A_test8_in.java;1;0;1;1;0;0;0;1;0;0;1;233;0;0;1;0;0;1;1;233;0;233;1;1;
/org.eclipse.ui.tests/Eclipse UI Tests/org/eclipse/ui/tests/navigator/NavigatorTestSuite.java;2;0;2;1;0;0;0;2;2;1;2;1488;2;2;1;0;0;2;2;1488;0;2290;2;2;
/org.eclipse.jdt.ui.tests.refactoring/resources/PasteSourceReference/test3/out/A.java;1;0;1;1;1;1;1;0;0;0;0;4544;0;0;1;0;0;0;1;4544;0;4544;1;1;
/org.eclipse.jdt.ui.tests.refactoring/resources/RenameType/testFail22/in/A.java;1;0;1;1;0;0;0;1;0;0;1;49;0;0;1;0;0;1;1;49;0;49;1;1;
/org.eclipse.swt.examples.controls/src/org/eclipse/swt/examples/controls/DialogTab.java;2;0;2;1;0;0;0;2;0;1;2;391;0;0;1;0;0;2;2;391;0;611;2;2;
/org.eclipse.pde.core/src/org/eclipse/pde/internal/core/schema/SchemaComplexType.java;1;0;2;1;0;0;0;2;2;1;2;3591;2;2;1;0;0;2;2;3591;0;3607;2;1;
/org.eclipse.update.ui/src/org/eclipse/update/ui/internal/model/BackgroundThread.java;1;0;2;1;0;0;0;2;0;1;2;1919;0;0;1;0;0;2;2;1919;0;2797;2;1;
/org.eclipse.scripting.tests/src/org/eclipse/scripting/tests/ScriptTests.java;1;0;1;1;0;0;0;1;0;0;1;1862;0;0;1;0;0;1;1;1862;0;1862;1;1;
/org.eclipse.jdt.ui.tests.refactoring/resources/RenameParameters/cannotRename/A_testFail12.java;1;0;1;1;0;0;0;1;0;0;1;233;0;0;1;0;0;1;1;233;0;233;1;1;
/org.eclipse.jdt.ui.tests.refactoring/resources/RenameType/test4/out/B.java;1;0;1;1;0;0;0;1;0;0;1;522;0;0;1;0;0;1;1;522;0;522;1;1;
/org.eclipse.update.core/src/org/eclipse/core/boot/BootLoader2.java;1;0;4;1;0;0;0;4;24;1;4;1993;29;29;1;0;0;4;4;1993;0;2315;4;1;
/org.eclipse.jdt.ui.tests.refactoring/resources/RenamePrivateField/testFail6/in/A.java;1;0;1;1;0;0;0;1;0;0;1;49;0;0;1;0;0;1;1;49;0;49;1;1;
/org.eclipse.team.cvs.core/src/org/eclipse/team/internal/ccvs/core/CVSRemoteSyncElement.java;1;0;4;1;0;0;0;4;54;3;2;2053;54;54;3;2;0;4;4;2053;2;2156;2;1;
/org.eclipse.core.tests.runtime/src/org/eclipse/core/tests/internal/plugin/c/PluginClass.java;3;0;3;1;0;0;0;3;34;1;3;1794;44;44;1;0;0;3;3;1794;0;3476;3;3;
/org.eclipse.jdt.ui.tests.refactoring/resources/ExtractMethodWorkSpace/ExtractMethodTests/validSelection/A_test245.java;2;1;3;1;2;2;2;1;0;0;1;49;0;0;1;0;0;1;3;49;0;4419;3;2;
/org.eclipse.jdt.core/model/org/eclipse/jdt/core/Flags.java;3;2;16;1;6;4;6;10;144;4;6;455;499;499;4;4;2;10;16;1039;6;4493;10;3;
/org.eclipse.jdt.debug.tests/test programs/org/eclipse/debug/tests/targets/CallLoop.java;1;0;2;1;0;0;0;2;0;1;2;3701;0;0;1;0;0;2;2;3701;0;3719;2;1;
/org.eclipse.jdt.ui.tests.refactoring/resources/MoveMembers/testFail15/in/A.java;1;0;1;1;0;0;0;1;0;0;1;2738;0;0;1;0;0;1;1;2738;0;2738;1;1;
/org.eclipse.jdt.ui.tests.refactoring/resources/ReorderParameters/canReorder/A_test11_in.java;1;0;4;1;0;0;0;4;2;2;3;724;2;2;2;1;0;4;4;724;1;2270;3;1;
/org.eclipse.pde.ui/src/org/eclipse/pde/internal/model/jars/Jars.java;2;0;2;1;0;0;0;2;0;1;2;1434;0;0;1;0;0;2;2;1434;0;2650;2;2;
/org.eclipse.jdt.ui.tests.refactoring/resources/RenameVariables/canRename/A_test19_in.java;1;0;2;1;0;0;0;2;0;1;2;724;0;0;1;0;0;2;2;724;0;1665;2;1;
/org.eclipse.jdt.debug.ui/ui/org/eclipse/jdt/internal/debug/ui/JDIAttachLauncherWizardPage.java;2;0;6;1;0;0;0;6;38;1;6;1915;57;57;1;0;0;6;6;1915;0;3634;6;2;
/org.eclipse.jdt.debug/model/org/eclipse/jdt/internal/debug/core/JavaRunToLineBreakpoint.java;2;0;7;1;0;0;0;7;20;1;7;1035;43;43;1;0;0;7;7;1035;0;2517;7;2;
/org.eclipse.ui/Eclipse UI/org/eclipse/ui/internal/misc/ExternalEditor.java;3;0;3;1;1;1;1;2;20;1;2;257;24;24;1;0;0;2;3;257;0;4120;3;3;
/org.eclipse.scripting/src/org/eclipse/scripting/internal/views/ScriptUIEditor.java;1;0;1;1;0;0;0;1;0;0;1;1424;0;0;1;0;0;1;1;1424;0;1424;1;1;
/org.eclipse.jdt.ui/ui/org/eclipse/jdt/internal/ui/actions/ActionDelegates.java;2;0;8;1;1;1;1;7;24;2;5;3533;53;53;2;2;0;7;8;3754;2;3895;6;2;
/org.eclipse.ui/Eclipse UI/org/eclipse/ui/internal/registry/MarkerResolutionDelegate.java;1;0;2;1;0;0;0;2;0;1;2;2497;0;0;1;0;0;2;2;2497;0;2895;2;1;
/org.eclipse.jdt.ui/ui/org/eclipse/jdt/internal/ui/text/javadoc/StandardDocletPageBuffer.java;4;0;8;1;0;0;0;8;30;1;8;25;50;50;1;0;0;8;8;25;0;2495;8;4;
/org.eclipse.core.resources/src/org/eclipse/core/internal/resources/ResourceTree.java;2;1;11;1;3;3;3;8;394;1;8;3251;513;513;1;0;0;8;11;3251;0;4636;11;2;
/org.eclipse.update.core/src/org/eclipse/update/internal/core/FeatureContentConsumer.java;2;0;4;1;1;1;1;3;9;1;3;2994;14;14;1;0;0;3;4;2994;0;3960;4;2;
/org.eclipse.jdt.core/model/org/eclipse/jdt/internal/core/builder/JavaBuilder.java;5;2;38;2;24;20;24;14;160;2;12;2979;839;839;2;2;4;14;38;3010;6;4669;32;5;
/org.eclipse.jdt.ui/ui/org/eclipse/jdt/internal/ui/viewsupport/ISeverityListener.java;1;0;2;1;0;0;0;2;0;1;2;1004;0;0;1;0;0;2;2;1004;0;1048;2;1;
/org.eclipse.jdt.core/model/org/eclipse/jdt/core/util/IConstantPoolEntry.java;2;2;7;2;6;5;6;1;49;0;1;3629;89;89;2;0;1;1;7;4493;1;4573;6;2;
/org.eclipse.ui.examples.multipageeditor/Eclipse UI Examples MultiPageEditor/org/eclipse/ui/examples/multipageeditor/MPEMessages.java;1;0;2;1;0;0;0;2;0;0;1;931;0;0;2;1;0;2;2;931;1;931;1;1;
/org.eclipse.jdt.ui.tests.refactoring/resources/ExtractMethodWorkSpace/ExtractMethodTests/expression_out/A_test617.java;1;1;3;1;2;2;2;1;22;0;1;1368;22;22;1;0;0;1;3;1368;0;4419;3;1;
/org.eclipse.pde.ui/src/org/eclipse/pde/internal/ui/editor/manifest/DependenciesForm.java;1;0;2;1;0;0;0;2;1;1;2;3579;1;1;1;0;0;2;2;3579;0;3607;2;1;
/org.eclipse.jdt.ui/core refactoring/org/eclipse/jdt/internal/corext/refactoring/util/CodeAnalyzer.java;1;0;3;1;0;0;0;3;61;1;3;2327;63;63;1;0;0;3;3;2327;0;3209;3;1;
/org.eclipse.pde.core/src/org/eclipse/pde/internal/core/BaseProject.java;1;0;2;1;0;0;0;2;0;1;2;3591;0;0;1;0;0;2;2;3591;0;3631;2;1;
/org.eclipse.jdt.ui.tests.refactoring/resources/RenameVariables/canRename/A_test18_out.java;1;0;2;1;0;0;0;2;0;1;2;724;0;0;1;0;0;2;2;724;0;1665;2;1;
/org.eclipse.pde.ui/src/org/eclipse/pde/internal/base/model/feature/IFeatureImport.java;1;0;3;1;0;0;0;3;2;1;3;2952;2;2;1;0;0;3;3;2952;0;3579;3;1;
/org.eclipse.scripting/src/org/eclipse/scripting/internal/views/ScriptUIEditorCompletionProcessor.java;1;0;1;1;0;0;0;1;0;0;1;1424;0;0;1;0;0;1;1;1424;0;1424;1;1;
/org.eclipse.vcm.ui.cvs/src/org/eclipse/vcm/internal/ui/ccvs/FilterOperation.java;2;0;4;1;0;0;0;4;73;1;4;1057;95;95;1;0;0;4;4;1057;0;1591;4;2;
/org.eclipse.jdt.ui.tests.refactoring/resources/RenameType/test20/out/A.java;1;0;2;1;0;0;0;2;0;1;2;49;0;0;1;0;0;2;2;49;0;522;2;1;
/org.eclipse.ui/Eclipse UI/org/eclipse/ui/dialogs/YesNoCancelListSelectionDialog.java;5;0;5;1;0;0;0;5;10;1;5;257;22;22;1;0;0;5;5;257;0;3091;5;5;
/org.eclipse.jdt.ui/ui/org/eclipse/jdt/internal/ui/launcher/OpenOnDeclaringTypeAction.java;2;0;4;1;0;0;0;4;5;1;4;15;9;9;1;0;0;4;4;15;0;1916;4;2;
/org.eclipse.pde.ui/src/org/eclipse/pde/internal/forms/IFormTextListener.java;2;0;2;1;0;0;0;2;0;1;2;1434;0;0;1;0;0;2;2;1434;0;2470;2;2;
/org.eclipse.ui/Eclipse UI/org/eclipse/ui/internal/misc/ShellCommand.java;2;0;2;1;0;0;0;2;5;1;2;257;5;5;1;0;0;2;2;257;0;457;2;2;
/org.eclipse.scripting/Eclipse Scripting/org/eclipse/scripting/internal/uirenderer/XGRElementUISwtLayoutTable.java;2;0;4;1;0;0;0;4;4;1;4;133;6;6;1;0;0;4;4;133;0;1424;4;2;
/org.eclipse.jdt.launching/launching/org/eclipse/jdt/internal/launching/RuntimeClasspathProvider.java;1;1;2;1;2;2;2;0;4;0;0;4127;4;4;1;0;0;0;2;4127;0;4148;2;1;
/org.eclipse.ant.core/src/antlib/org/eclipse/ant/internal/core/ant/Policy.java;1;0;1;1;0;0;0;1;0;0;1;3475;0;0;1;0;0;1;1;3475;0;3475;1;1;
/org.eclipse.pde.ui/src/org/eclipse/pde/internal/ui/editor/manifest/ManifestPropertySheet.java;1;0;2;1;0;0;0;2;16;0;1;3579;16;16;2;1;0;2;2;3579;1;3579;1;1;
/org.eclipse.ui/Eclipse UI Tool Script/org/eclipse/toolscript/ui/internal/ToolScriptBuilderPropertyPage.java;1;1;2;1;2;2;2;0;0;0;0;3920;0;0;1;0;0;0;2;3920;0;4087;2;1;
/org.eclipse.jdt.debug/jdi/org/eclipse/jdi/internal/request/ReenterStepRequestImpl.java;3;0;5;1;0;0;0;5;17;1;5;187;39;39;1;0;0;5;5;187;0;3670;5;3;
/org.eclipse.jdt.ui.tests.refactoring/resources/StructureSelectionAction/A_test18.java;1;0;1;1;0;0;0;1;0;0;1;2139;0;0;1;0;0;1;1;2139;0;2139;1;1;
/org.eclipse.update.ui/src/org/eclipse/update/internal/ui/model/BackgroundThread.java;1;0;2;1;0;0;0;2;0;1;2;2797;0;0;1;0;0;2;2;2797;0;3537;2;1;
/org.eclipse.swt/Eclipse SWT Drag and Drop/photon/org/eclipse/swt/dnd/TextTransfer.java;4;1;10;1;4;4;4;6;59;2;5;106;161;161;2;1;0;6;10;699;1;4824;9;4;
/org.eclipse.update.ui/src/org/eclipse/update/internal/ui/wizards/NewSiteBookmarkWizardPage.java;2;1;5;1;2;2;2;3;37;0;1;3653;54;54;3;2;0;3;5;3653;2;4610;3;2;
/org.eclipse.jdt.ui/ui/org/eclipse/jdt/ui/wizards/NewTypeWizardPage.java;3;2;29;1;13;11;13;16;419;3;13;3089;771;771;3;3;2;16;29;3103;5;4852;24;3;
/org.eclipse.pde.junit/Pde JUnit/org/eclipse/pde/internal/junit/oldlauncher/JUnitPdeLauncherDelegate.java;2;0;2;1;0;0;0;2;0;1;2;2861;0;0;1;0;0;2;2;2861;0;3205;2;2;
/org.eclipse.core.tests.resources/src/org/eclipse/core/tests/resources/ResourceVisitorVerifier.java;1;0;1;1;0;0;0;1;0;0;1;3453;0;0;1;0;0;1;1;3453;0;3453;1;1;
/org.eclipse.jdt.ui/core refactoring/org/eclipse/jdt/internal/corext/refactoring/rename/RenameMethodRefactoring.java;3;1;27;2;5;5;5;22;100;3;18;1939;458;458;3;4;0;22;27;2133;4;4427;23;3;
/org.eclipse.core.boot/src/org/eclipse/core/internal/boot/update/IComponentEntryDescriptor.java;3;0;4;1;0;0;0;4;8;1;4;12;15;15;1;0;0;4;4;12;0;2726;4;3;
/org.eclipse.team.cvs.core/src/org/eclipse/team/internal/ccvs/core/resources/api/IManagedFolder.java;3;0;4;1;0;0;0;4;420;1;4;1978;476;476;1;0;0;4;4;1978;0;2156;4;3;
/org.eclipse.pde.ui/src/org/eclipse/pde/internal/feature/BuildFeatureAction.java;1;0;6;1;0;0;0;6;13;1;6;3113;29;29;1;0;0;6;6;3113;0;3579;6;1;
/org.eclipse.update.ui.forms/src/org/eclipse/update/ui/forms/FormText.java;1;0;7;1;0;0;0;7;299;2;5;1423;342;342;2;2;0;7;7;1542;2;1980;5;1;
/org.eclipse.jdt.ui.tests.refactoring/resources/ExtractMethodWorkSpace/ExtractMethodTests/locals_in/A_test513.java;2;1;4;1;2;2;2;2;7;1;2;369;13;13;1;0;0;2;4;369;0;4419;4;2;
/org.eclipse.update.ui.forms/src/org/eclipse/update/ui/forms/SectionForm.java;1;0;2;1;0;0;0;2;0;1;2;1542;0;0;1;0;0;2;2;1542;0;2474;2;1;
/org.eclipse.debug.ui/ui/org/eclipse/debug/internal/ui/views/console/ConsoleViewEventHandler.java;1;1;2;1;2;2;2;0;140;0;0;3975;140;140;1;0;0;0;2;3975;0;4003;2;1;
/org.eclipse.swt/Eclipse SWT/common/org/eclipse/swt/internal/image/LZWNode.java;2;0;3;1;1;1;1;2;6;1;2;106;12;12;1;0;0;2;3;106;0;4701;3;2;
/org.eclipse.swt.examples.paint/src/org/eclipse/swt/examples/paint/SolidRectangleFigure.java;3;0;4;2;1;1;1;3;53;2;2;566;59;59;2;1;0;3;4;609;1;4705;3;3;
/org.eclipse.team.cvs.core/src/org/eclipse/team/internal/ccvs/core/CVSStatus.java;3;0;12;1;1;1;1;11;25;1;11;2739;58;58;1;0;0;11;12;2739;0;4368;12;3;
/org.eclipse.pde.ui/src/org/eclipse/pde/internal/editor/manifest/NewDependenciesForm.java;1;0;4;1;0;0;0;4;43;2;3;2472;46;46;2;1;0;4;4;2472;1;2650;3;1;
/org.eclipse.ui/Eclipse UI Text Editor/org/eclipse/ui/texteditor/WorkbenchChainedTextFontFieldEditor.java;2;0;4;1;1;1;1;3;62;1;3;1226;84;84;1;0;0;3;4;1226;0;4838;4;2;
/org.eclipse.jdt.ui.tests.refactoring/resources/RenameVirtualMethodInClass/testFail29/in/A.java;1;0;1;1;0;0;0;1;0;0;1;49;0;0;1;0;0;1;1;49;0;49;1;1;
/org.eclipse.compare/compare/org/eclipse/compare/internal/BinaryCompareViewerCreator.java;1;0;2;1;0;0;0;2;5;1;2;14;5;5;1;0;0;2;2;14;0;329;2;1;
/org.eclipse.pde.ui/src/org/eclipse/pde/internal/ui/codegen/StructuredJavaCodeGenerator.java;1;0;1;1;0;0;0;1;0;0;1;3579;0;0;1;0;0;1;1;3579;0;3579;1;1;
/org.eclipse.jdt.ui.tests.refactoring/resources/ExtractMethodWorkSpace/ExtractMethodTests/Test.java;2;1;8;1;2;2;2;6;61;1;6;195;105;105;1;0;0;6;8;195;0;4419;8;2;
/org.eclipse.ui.tests/Eclipse JFace Tests/org/eclipse/jface/tests/viewers/interactive/AddChildAction.java;1;0;1;1;0;0;0;1;0;0;1;1488;0;0;1;0;0;1;1;1488;0;1488;1;1;
/org.eclipse.vcm.core/src/org/eclipse/vcm/internal/core/StateInfo.java;4;0;4;1;0;0;0;4;14;1;4;0;32;32;1;0;0;4;4;0;0;1265;4;4;
/org.eclipse.jdt.ui.tests.refactoring/resources/InlineTemp/canInline/A_test11_in.java;1;0;2;1;0;0;0;2;2;1;2;2758;2;2;1;0;0;2;2;2758;0;3048;2;1;
/org.eclipse.swt/Eclipse SWT PI/win32/org/eclipse/swt/internal/ole/win32/IOleInPlaceActiveObject.java;2;0;2;1;1;1;1;1;6;0;1;2069;6;6;1;0;0;1;2;2069;0;4701;2;2;
/org.eclipse.pde.ui/Eclipse PDE UI/org/eclipse/pde/internal/editor/XMLDoubleClickStrategy.java;2;0;5;2;0;0;0;5;12;3;3;267;12;12;3;2;0;5;5;324;2;1434;3;2;
/org.eclipse.webdav/src/kernel/org/eclipse/webdav/internal/kernel/utils/EnumerationConverter.java;1;0;4;1;1;1;1;3;52;1;3;12;72;72;1;0;0;3;4;12;0;4211;4;1;
/org.eclipse.jdt.ui.tests.refactoring/resources/ExtractMethodWorkSpace/ExtractMethodTests/try_out/A_test458.java;1;1;3;1;2;2;2;1;0;0;1;922;0;0;1;0;0;1;3;922;0;4419;3;1;
/org.eclipse.jdt.ui.tests.refactoring/resources/RenameTemp/cannotRename/A_testFail13.java;1;0;2;1;0;0;0;2;2;1;2;1625;2;2;1;0;0;2;2;1625;0;1652;2;1;
/org.eclipse.ui/Eclipse JFace Text/org/eclipse/jface/text/TextAttribute.java;4;0;6;1;1;1;1;5;56;1;5;257;106;106;1;0;0;5;6;257;0;4838;6;4;
/org.eclipse.jdt.ui.tests.refactoring/resources/PullUpMethods/test9/in/A.java;1;0;3;1;0;0;0;3;2;1;3;2212;2;2;1;0;0;3;3;2212;0;2406;3;1;
/org.eclipse.jdt.debug.ui/ui/org/eclipse/jdt/internal/debug/ui/actions/OpenOnReceivingTypeAction.java;1;0;1;1;0;0;0;1;0;0;1;2384;0;0;1;0;0;1;1;2384;0;2384;1;1;
/org.eclipse.jdt.ui/core refactoring/org/eclipse/jdt/internal/corext/refactoring/changes/TextChange.java;2;0;8;1;1;1;1;7;132;2;6;1939;235;235;2;1;0;7;8;2133;1;4400;7;2;
/org.eclipse.jdt.ui.tests.refactoring/resources/RenameVariables/canRename/A_test26_out.java;1;0;2;1;0;0;0;2;0;1;2;724;0;0;1;0;0;2;2;724;0;1665;2;1;
/org.eclipse.jdt.ui.tests.refactoring/resources/ExtractMethodWorkSpace/ExtractMethodTests/locals_in/A_test540.java;1;1;3;1;2;2;2;1;4;0;1;922;4;4;1;0;0;1;3;922;0;4419;3;1;
/org.eclipse.ant.core/src/org/eclipse/ant/internal/core/old/Policy.java;1;0;1;1;0;0;0;1;0;0;1;3270;0;0;1;0;0;1;1;3270;0;3270;1;1;
/org.eclipse.jdt.ui/ui refactoring/org/eclipse/jdt/internal/ui/refactoring/actions/RefactoringAction.java;3;0;17;2;0;0;0;17;223;2;15;1345;572;572;2;2;0;17;17;1939;2;3807;15;3;
/org.eclipse.pde.ui/src/org/eclipse/pde/internal/forms/renamed/IFormTextListener.java;1;0;2;1;0;0;0;2;0;1;2;2470;0;0;1;0;0;2;2;2470;0;2691;2;1;
/org.eclipse.jdt.ui.tests.refactoring/resources/RenameMethodInInterface/test23/in/A.java;2;0;2;1;0;0;0;2;0;1;2;49;0;0;1;0;0;2;2;49;0;1258;2;2;
/org.eclipse.swt/Eclipse SWT PI/gtk1x/org/eclipse/swt/internal/gtk/GdkEventExpose.java;2;0;2;1;1;1;1;1;3;0;1;2107;3;3;1;0;0;1;2;2107;0;4701;2;2;
/org.eclipse.debug.ui/ui/org/eclipse/debug/internal/ui/preferences/VariableViewsPreferencePage.java;2;1;3;1;3;3;3;0;15;0;0;3975;24;24;1;0;0;0;3;3975;0;4207;3;2;
/org.eclipse.vcm.ui/src/org/eclipse/vcm/internal/ui/sync/MergeAction.java;3;0;9;1;0;0;0;9;122;1;9;48;240;240;1;0;0;9;9;48;0;1659;9;3;
/org.eclipse.help.ui/src/org/eclipse/help/internal/ui/util/StreamConsumer.java;2;0;4;1;1;1;1;3;22;1;3;1420;27;27;1;0;0;3;4;1420;0;4439;4;2;
/org.eclipse.jdt.ui/core refactoring/org/eclipse/jdt/internal/corext/refactoring/nls/changes/DeleteFileChange.java;1;0;2;1;1;1;1;1;16;0;1;1939;16;16;1;0;0;1;2;1939;0;4602;2;1;
/org.eclipse.jdt.debug/jdi interfaces/com/sun/jdi/connect/LaunchingConnector.java;2;0;2;1;0;0;0;2;10;1;2;2704;10;10;1;0;0;2;2;2704;0;3033;2;2;
/org.eclipse.jdt.ui.tests.refactoring/resources/ExtractMethodWorkSpace/ExtractMethodTests/expression_out/A_test607.java;2;1;4;1;2;2;2;2;20;1;2;239;21;21;1;0;0;2;4;239;0;4419;4;2;
/org.eclipse.scripting/src/org/eclipse/scripting/internal/IXGRElementUITableElement.java;1;0;1;1;0;0;0;1;0;0;1;1424;0;0;1;0;0;1;1;1424;0;1424;1;1;
/org.eclipse.core.tests.runtime/src/org/eclipse/core/tests/internal/plugins/PluginResolveTest_2.java;4;0;4;1;0;0;0;4;112;1;4;1794;123;123;1;0;0;4;4;1794;0;3476;4;4;
/org.eclipse.swt/Eclipse SWT PI/win32/org/eclipse/swt/internal/win32/BROWSEINFO.java;2;0;2;1;1;1;1;1;6;0;1;2069;6;6;1;0;0;1;2;2069;0;4701;2;2;
/org.eclipse.jdt.core/dom/org/eclipse/jdt/core/dom/AnonymousClassDeclaration.java;1;0;2;1;0;0;0;2;7;1;2;3049;7;7;1;0;0;2;2;3049;0;3637;2;1;
/org.eclipse.jdt.ui.tests.refactoring/resources/RenameType/test34/out/B.java;1;0;1;1;0;0;0;1;0;0;1;49;0;0;1;0;0;1;1;49;0;49;1;1;
/org.eclipse.jdt.ui.tests.refactoring/resources/ExtractMethodWorkSpace/ExtractMethodTests/expression_out/A_test604.java;2;1;4;1;2;2;2;2;22;1;2;239;23;23;1;0;0;2;4;239;0;4419;4;2;
/org.eclipse.jdt.ui.tests.refactoring/resources/RenameMethodInInterface/testFail33/in/A.java;1;0;1;1;0;0;0;1;0;0;1;49;0;0;1;0;0;1;1;49;0;49;1;1;
/org.eclipse.help/src/SnoopServlet.java;1;0;2;1;0;0;0;2;0;1;2;1882;0;0;1;0;0;2;2;1882;0;1930;2;1;
/org.eclipse.jdt.core/codeassist/org/eclipse/jdt/internal/codeassist/complete/CompletionOnMessageSend.java;2;0;10;1;1;1;1;9;60;4;6;455;213;213;4;3;0;9;10;1039;3;4062;7;2;
/org.eclipse.jdt.debug.ui/ui/org/eclipse/jdt/internal/debug/ui/IHelpContextIds.java;3;1;8;1;2;2;2;6;14;1;6;1915;27;27;1;0;0;6;8;1915;0;4126;8;3;
/org.eclipse.compare/compare/org/eclipse/compare/internal/TimeoutContext.java;1;0;2;1;1;1;1;1;5;0;1;2017;5;5;1;0;0;1;2;2017;0;3914;2;1;
/org.eclipse.jdt.debug/eval/org/eclipse/jdt/internal/debug/eval/model/IInterfaceType.java;2;0;2;1;0;0;0;2;0;1;2;3555;0;0;1;0;0;2;2;3555;0;3645;2;2;
/org.eclipse.ui/Eclipse JFace Text/org/eclipse/jface/text/MarkSelection.java;1;1;2;1;2;2;2;0;14;0;0;4209;21;21;1;0;0;0;2;4209;0;4838;2;1;
/org.eclipse.help/src/org/eclipse/help/IToc.java;2;0;6;1;1;1;1;5;17;1;5;2224;42;42;1;0;0;5;6;2224;0;3938;6;2;
/org.eclipse.jdt.ui.tests.refactoring/resources/RenameType/test20/in/A.java;1;0;1;1;0;0;0;1;0;0;1;49;0;0;1;0;0;1;1;49;0;49;1;1;
/org.eclipse.ui/Eclipse UI/org/eclipse/ui/internal/OpenedPerspectivesMenu.java;3;0;3;1;0;0;0;3;17;1;3;3050;28;28;1;0;0;3;3;3050;0;3853;3;3;
/org.eclipse.pde.ui/src/org/eclipse/pde/internal/editor/feature/BuildFeatureAction.java;1;0;3;1;0;0;0;3;4;1;3;2951;4;4;1;0;0;3;3;2951;0;3113;3;1;
/org.eclipse.ui/Eclipse UI Standard Components/org/eclipse/ui/views/navigator/FilterSelectionAction.java;6;1;12;1;2;2;2;10;32;2;9;257;109;109;2;1;0;10;12;1726;1;4067;11;6;
/org.eclipse.jdt.ui/core refactoring/org/eclipse/jdt/internal/corext/refactoring/code/TempNameUtil.java;2;0;7;1;1;1;1;6;98;1;6;2480;117;117;1;0;0;6;7;2480;0;4015;7;2;
/org.eclipse.pde.ui/templates/popupMenus/java/$actionClass$.java;1;0;1;1;0;0;0;1;0;0;1;3812;0;0;1;0;0;1;1;3812;0;3812;1;1;
/org.eclipse.jdt.ui/core extension/org/eclipse/jdt/internal/corext/template/TemplatePosition.java;1;0;1;1;0;0;0;1;0;0;1;2784;0;0;1;0;0;1;1;2784;0;2784;1;1;
/org.eclipse.jdt.ui.tests.refactoring/resources/SelectionAnalyzerWorkSpace/SelectionAnalyzerTests/invalidSelection/A_test148.java;2;0;2;1;0;0;0;2;0;1;2;1368;0;0;1;0;0;2;2;1368;0;2139;2;2;
/org.eclipse.jdt.ui.tests.refactoring/resources/DeleteSourceReference/test4/in/A.java;1;0;1;1;0;0;0;1;0;0;1;2857;0;0;1;0;0;1;1;2857;0;2857;1;1;
/org.eclipse.pde.ui/src/org/eclipse/pde/internal/base/model/IWritable.java;2;0;3;1;0;0;0;3;4;1;3;1434;4;4;1;0;0;3;3;1434;0;3039;3;2;
/org.eclipse.ui/Eclipse UI/org/eclipse/ui/part/MultiPageEditorActionBarContributor.java;2;0;2;1;0;0;0;2;5;1;2;257;5;5;1;0;0;2;2;257;0;457;2;2;
/org.eclipse.pde.ui/src/org/eclipse/pde/internal/editor/component/ComponentEditor.java;2;0;5;1;0;0;0;5;15;1;5;1434;18;18;1;0;0;5;5;1434;0;2951;5;2;
/org.eclipse.jdt.ui/ui/org/eclipse/jdt/internal/ui/packageview/LibraryFilter.java;3;0;5;1;1;1;1;4;18;1;4;125;32;32;1;0;0;4;5;125;0;4211;5;3;
/org.eclipse.swt.tests/JUnit Tests/org/eclipse/swt/tests/junit/Test_org_eclipse_swt_widgets_TreeItem.java;2;0;3;1;1;1;1;2;331;1;2;1792;337;337;1;0;0;2;3;1792;0;4706;3;2;
/org.eclipse.team.ui/src/org/eclipse/team/ui/sync/TypedBufferedContent.java;1;0;3;1;1;1;1;2;8;1;2;2233;8;8;1;0;0;2;3;2233;0;4005;3;1;
/org.eclipse.pde.ui/Eclipse PDE UI/org/eclipse/pde/internal/wizards/Category.java;2;0;5;2;0;0;0;5;12;3;3;267;12;12;3;2;0;5;5;324;2;1434;3;2;
/org.eclipse.pde.ui/Eclipse PDE UI/org/eclipse/pde/internal/wizards/BaseWizardSelectionPage.java;2;0;5;2;0;0;0;5;12;3;3;267;12;12;3;2;0;5;5;324;2;1434;3;2;
/org.eclipse.ui/Eclipse UI/org/eclipse/ui/internal/registry/MarkerHelpRegistryReader.java;1;0;2;1;0;0;0;2;4;1;2;2497;4;4;1;0;0;2;2;2497;0;2895;2;1;
/org.eclipse.swt/Eclipse SWT Accessibility/common/org/eclipse/swt/accessibility/AccessibleControlAdapter.java;2;0;9;1;1;1;1;8;181;2;7;2791;311;311;2;1;0;8;9;3007;1;4701;8;2;
/org.eclipse.jdt.ui/ui refactoring/org/eclipse/jdt/internal/ui/nls/OrderedMap.java;1;0;2;1;0;0;0;2;0;1;2;1913;0;0;1;0;0;2;2;1913;0;1922;2;1;
/org.eclipse.swt/Eclipse SWT/gtk/org/eclipse/swt/graphics/Font.java;4;1;10;1;4;4;4;6;222;1;6;2107;529;529;1;0;0;6;10;2107;0;4701;10;4;
/org.eclipse.update.examples/src/org/eclipse/update/examples/buildzip/BuildZipFeatureFactory.java;2;0;4;1;0;0;0;4;62;1;4;2553;69;69;1;0;0;4;4;2553;0;2790;4;2;
/org.eclipse.swt/Eclipse SWT/win32/org/eclipse/swt/widgets/Composite.java;8;2;28;2;5;4;5;23;121;2;21;106;584;584;2;2;1;23;28;1895;3;4701;25;8;
/org.eclipse.update.ui.forms/src/org/eclipse/update/ui/forms/AbstractForm.java;1;0;3;1;0;0;0;3;5;1;3;1542;5;5;1;0;0;3;3;1542;0;2474;3;1;
/org.eclipse.pde.ui/src/org/eclipse/pde/model/IWritable.java;1;0;2;1;0;0;0;2;0;1;2;3039;0;0;1;0;0;2;2;3039;0;3579;2;1;
/org.eclipse.jdt.ui/core refactoring/org/eclipse/jdt/internal/core/refactoring/projects/RenameProjectChange.java;1;0;3;1;0;0;0;3;4;2;2;988;4;4;2;1;0;3;3;988;1;1258;2;1;
/org.eclipse.jdt.ui/ui/org/eclipse/jdt/internal/ui/search/JavaSearchResultCollector.java;3;2;30;1;7;6;7;23;64;2;21;15;421;421;2;2;1;23;30;1337;3;4423;27;3;
/org.eclipse.help/src/org/eclipse/help/internal/topics/NavigationWriter.java;2;0;4;1;0;0;0;4;15;1;4;1675;27;27;1;0;0;4;4;1675;0;1857;4;2;
/org.eclipse.jdt.ui/ui/org/eclipse/jdt/internal/ui/text/javadoc/JavaDocScanner.java;3;0;9;1;0;0;0;9;89;1;9;15;189;189;1;0;0;9;9;15;0;3644;9;3;
/org.eclipse.jdt.ui.tests.refactoring/resources/RenameTemp/canRename/A_test42_out.java;1;0;1;1;0;0;0;1;0;0;1;3322;0;0;1;0;0;1;1;3322;0;3322;1;1;
/org.eclipse.help/Eclipse Help/org/eclipse/help/internal/contributions/Context.java;2;0;3;1;0;0;0;3;7;1;3;135;7;7;1;0;0;3;3;135;0;1420;3;2;
/org.eclipse.jdt.core/model/org/eclipse/jdt/internal/core/jdom/DOMImport.java;2;0;11;1;1;1;1;10;269;4;7;455;418;418;4;3;0;10;11;1039;3;4063;8;2;
/org.eclipse.pde.ui/src/org/eclipse/pde/internal/ui/launcher/PluginPathDialog.java;1;0;2;1;1;1;1;1;2;0;1;3579;2;2;1;0;0;1;2;3579;0;4732;2;1;
/org.eclipse.ui/Eclipse UI/org/eclipse/ui/IWorkbenchPart.java;4;0;6;1;1;1;1;5;10;1;5;257;30;30;1;0;0;5;6;257;0;4454;6;4;
/org.eclipse.ui.tests/Eclipse UI Tests/org/eclipse/ui/tests/dialogs/UIPreferencesAuto.java;4;0;5;1;0;0;0;5;17;1;5;1113;33;33;1;0;0;5;5;1113;0;2785;5;4;
/org.eclipse.jdt.ui.tests.refactoring/test cases/org/eclipse/jdt/ui/tests/refactoring/infra/MockSelectionProvider.java;1;0;2;1;0;0;0;2;40;1;2;3739;40;40;1;0;0;2;2;3739;0;3827;2;1;
/org.eclipse.jdt.core/model/org/eclipse/jdt/internal/core/builder/impl/StateSnapV5.java;1;0;11;1;0;0;0;11;1425;4;7;455;1753;1753;4;4;0;11;11;1039;4;2808;7;1;
/org.eclipse.jdt.ui.tests.refactoring/resources/ExtractMethodWorkSpace/ExtractMethodTests/invalidSelection/A_test103.java;2;1;3;1;2;2;2;1;0;0;1;49;0;0;1;0;0;1;3;49;0;4419;3;2;
/org.eclipse.help/src/org/eclipse/help/internal/toc/Link.java;2;0;3;1;0;0;0;3;15;1;3;1857;17;17;1;0;0;3;3;1857;0;3766;3;2;
/org.eclipse.swt.tests/JUnit Tests/org/eclipse/swt/tests/junit/Test_org_eclipse_swt_widgets_Tree.java;2;0;2;1;1;1;1;1;6;0;1;1792;6;6;1;0;0;1;2;1792;0;4706;2;2;
/org.eclipse.team.cvs.core/src/org/eclipse/team/internal/ccvs/core/resources/ICVSFile.java;2;0;7;1;0;0;0;7;77;2;6;2156;114;114;2;1;0;7;7;2156;1;3089;6;2;
/org.eclipse.ui/Eclipse JFace/org/eclipse/jface/resource/CompositeImageDescriptor.java;2;0;2;1;0;0;0;2;5;1;2;257;5;5;1;0;0;2;2;257;0;457;2;2;
/org.eclipse.jdt.ui/ui/org/eclipse/jdt/internal/ui/text/java/hover/JavaProblemHover.java;1;0;5;1;1;1;1;4;28;2;3;3166;55;55;2;1;0;4;5;3166;1;4167;4;1;
/org.eclipse.swt/Eclipse SWT/win32/org/eclipse/swt/internal/win32/TBBUTTON.java;2;0;4;1;0;0;0;4;5;1;4;106;6;6;1;0;0;4;4;106;0;2069;4;2;
/org.eclipse.core.tests.runtime/src/org/eclipse/core/tests/internal/plugins/ExtensiveFragmentTest.java;3;0;3;1;0;0;0;3;1776;1;3;1794;1786;1786;1;0;0;3;3;1794;0;3476;3;3;
/org.eclipse.pde.ui/src/org/eclipse/pde/internal/core/schema/SchemaAttribute.java;1;0;3;1;0;0;0;3;2;1;3;3579;2;2;1;0;0;3;3;3579;0;3607;3;1;
/org.eclipse.pde.ui/src/org/eclipse/pde/internal/ui/elements/ElementLabelProvider.java;1;0;1;1;0;0;0;1;0;0;1;3579;0;0;1;0;0;1;1;3579;0;3579;1;1;
/org.eclipse.jdt.core/compiler/org/eclipse/jdt/internal/compiler/lookup/Binding.java;2;0;4;1;1;1;1;3;57;1;3;455;77;77;1;0;0;3;4;455;0;4062;4;2;
/org.eclipse.update.ui/src/org/eclipse/update/internal/ui/manager/DetailsView.java;2;0;32;1;0;0;0;32;75;2;30;1460;470;470;2;2;0;32;32;1900;2;3537;30;2;
/org.eclipse.jdt.ui/ui/org/eclipse/jdt/internal/ui/wizards/dialogfields/IListAdapter.java;2;0;4;1;0;0;0;4;10;1;4;15;21;21;1;0;0;4;4;15;0;1342;4;2;
/org.eclipse.jdt.core/dom/org/eclipse/jdt/core/dom/EmptyStatement.java;2;0;4;1;0;0;0;4;8;1;4;2669;17;17;1;0;0;4;4;2669;0;3637;4;2;
/org.eclipse.jdt.junit/Eclipse JUnit/org/eclipse/jdt/junit/internal/TabFolderLayout.java;2;0;2;1;0;0;0;2;0;1;2;1531;0;0;1;0;0;2;2;1531;0;2007;2;2;
/org.eclipse.jdt.ui/ui/org/eclipse/jdt/internal/ui/javaeditor/IClassFileEditorInput.java;1;0;1;1;0;0;0;1;0;0;1;1685;0;0;1;0;0;1;1;1685;0;1685;1;1;
/org.eclipse.jdt.ui.tests.refactoring/resources/SefWorkSpace/SefTests/object_out/TestSetterInAssignment.java;1;0;1;1;0;0;0;1;0;0;1;2876;0;0;1;0;0;1;1;2876;0;2876;1;1;
/org.eclipse.jdt.ui.tests.refactoring/resources/MoveMembers/test2/in/B.java;1;0;1;1;0;0;0;1;0;0;1;2738;0;0;1;0;0;1;1;2738;0;2738;1;1;
/org.eclipse.jdt.ui/ui/org/eclipse/jdt/internal/ui/reorg/CopySourceReferencesToClipboardAction.java;3;1;22;2;5;5;5;17;114;2;15;2003;340;340;2;2;0;17;22;2003;2;4621;20;3;
/org.eclipse.pde.core/src/org/eclipse/pde/internal/core/ischema/ISchemaAttributeProvider.java;1;0;1;1;0;0;0;1;0;0;1;3591;0;0;1;0;0;1;1;3591;0;3591;1;1;
/org.eclipse.ant.ui/src/org/eclipse/ant/internal/ui/AddTaskDialog.java;1;0;2;1;0;0;0;2;176;1;2;3492;176;176;1;0;0;2;2;3492;0;3506;2;1;
/org.eclipse.jdt.ui/ui/org/eclipse/jdt/internal/ui/preferences/OverlayPreferenceStore.java;2;0;3;1;0;0;0;3;105;1;3;1864;107;107;1;0;0;3;3;1864;0;3697;3;2;
/org.eclipse.scripting.examples/src/org/eclipse/scripting/examples/ExcaliburWorkbenchNewWizardAdapterScriptEventHandler.java;1;0;1;1;0;0;0;1;0;0;1;1424;0;0;1;0;0;1;1;1424;0;1424;1;1;
/org.eclipse.team.cvs.core/src/org/eclipse/team/internal/ccvs/core/util/ResourceDeltaSyncHandler.java;2;0;9;2;0;0;0;9;270;2;8;3151;522;522;2;1;0;9;9;3398;1;3417;8;2;
/org.eclipse.jdt.ui.tests.refactoring/resources/DeleteSourceReference/A_test2_out.java;1;0;2;1;0;0;0;2;0;1;2;2003;0;0;1;0;0;2;2;2003;0;2857;2;1;
/org.eclipse.jdt.ui.tests.refactoring/resources/ExtractMethodWorkSpace/ExtractMethodTests/validSelection_out/A_test363.java;1;1;3;1;2;2;2;1;20;0;1;2621;20;20;1;0;0;1;3;2621;0;4419;3;1;
/org.eclipse.core.target/src/org/eclipse/core/internal/target/filesystem/FileTarget.java;2;0;13;1;1;1;1;12;618;4;9;12;883;883;4;3;0;12;13;663;3;4196;10;2;
/org.eclipse.jdt.ui.tests.refactoring/resources/RenameVirtualMethodInClass/test22/out/A.java;1;0;1;1;0;0;0;1;0;0;1;49;0;0;1;0;0;1;1;49;0;49;1;1;
/org.eclipse.jdt.ui/core refactoring/org/eclipse/jdt/internal/corext/refactoring/PrettySignature.java;2;0;3;1;0;0;0;3;6;1;3;1939;6;6;1;0;0;3;3;1939;0;3357;3;2;
/org.eclipse.jdt.debug.tests/tests/org/eclipse/jdt/debug/tests/eval/NestedTypeFieldValue_293.java;2;1;3;1;3;3;3;0;12;0;0;4447;14;14;1;0;0;0;3;4447;0;4571;3;2;
/org.eclipse.core.resources/src/org/eclipse/core/internal/resources/ModelObjectReader.java;2;2;8;1;4;3;4;4;442;1;4;12;550;550;2;0;1;4;8;4209;1;4368;7;2;
/org.eclipse.update.tests.core/src/org/eclipse/update/tests/uivalues/TestDejan.java;1;0;3;1;0;0;0;3;9;1;3;1583;9;9;1;0;0;3;3;1583;0;1674;3;1;
/org.eclipse.jdt.ui/ui refactoring/org/eclipse/jdt/internal/ui/refactoring/SourceContextViewer.java;1;0;2;1;0;0;0;2;2;1;2;1927;2;2;1;0;0;2;2;1927;0;2512;2;1;
/org.eclipse.swt/Eclipse SWT/photon/org/eclipse/swt/internal/photon/PhArea_t.java;2;0;3;1;0;0;0;3;6;1;3;106;6;6;1;0;0;3;3;106;0;2069;3;2;
/org.eclipse.update.core/src/org/eclipse/update/internal/core/InternalFeatureReference.java;1;0;2;1;1;1;1;1;0;0;1;3569;0;0;1;0;0;1;2;3569;0;4187;2;1;
/org.eclipse.jdt.core/model/org/eclipse/jdt/internal/core/newbuilder/ClasspathDirectory.java;1;0;9;1;0;0;0;9;14;2;8;1764;37;37;2;1;0;9;9;1807;1;2979;8;1;
/org.eclipse.swt/Eclipse SWT Drag and Drop/gtk/org/eclipse/swt/dnd/TreeDragUnderEffect.java;2;0;2;1;0;0;0;2;0;1;2;2107;0;0;1;0;0;2;2;2107;0;3127;2;2;
/org.eclipse.pde.ui/src/org/eclipse/pde/internal/core/ischema/ISchemaObjectReference.java;1;0;2;1;0;0;0;2;0;1;2;3591;0;0;1;0;0;2;2;3591;0;3607;2;1;
/org.eclipse.jdt.ui/ui/org/eclipse/jdt/ui/actions/NavigateActionGroup.java;1;1;5;1;3;3;3;2;9;0;1;3716;21;21;2;1;0;2;5;3716;1;4770;4;1;
/org.eclipse.jdt.ui.tests.refactoring/resources/DeleteSourceReference/test18/out/A.java;1;0;1;1;1;1;1;0;0;0;0;4383;0;0;1;0;0;0;1;4383;0;4383;1;1;
/org.eclipse.jdt.ui.tests.refactoring/resources/RenameVariables/canRename/A_test2_out.java;1;0;2;1;0;0;0;2;0;1;2;724;0;0;1;0;0;2;2;724;0;1665;2;1;
/org.eclipse.jdt.core/compiler/org/eclipse/jdt/internal/compiler/HierarchyType.java;2;0;4;1;0;0;0;4;105;1;4;455;120;120;1;0;0;4;4;455;0;2790;4;2;
/org.eclipse.scripting/Eclipse Scripting/org/eclipse/scripting/internal/uirenderer/XGRElementUISwtBreak.java;2;0;4;1;0;0;0;4;9;1;4;133;13;13;1;0;0;4;4;133;0;1424;4;2;
/org.eclipse.jdt.ui.tests.refactoring/resources/MoveMembers/testFail19/in/B.java;1;0;1;1;0;0;0;1;0;0;1;2928;0;0;1;0;0;1;1;2928;0;2928;1;1;
/org.eclipse.ui.examples.propertysheet/Eclipse UI Examples PropertySheet/org/eclipse/ui/examples/propertysheet/Name.java;2;0;2;1;0;0;0;2;24;1;2;931;24;24;1;0;0;2;2;931;0;946;2;2;
/org.eclipse.swt.tests/JUnit Tests/org/eclipse/swt/tests/junit/Test_org_eclipse_swt_events_FocusListener.java;2;0;2;1;1;1;1;1;6;0;1;1792;6;6;1;0;0;1;2;1792;0;4706;2;2;
/org.eclipse.pde.ui/src/org/eclipse/pde/internal/ui/editor/PDEFormPage.java;1;0;3;1;0;0;0;3;322;2;2;3579;345;345;2;1;0;3;3;3579;1;3727;2;1;
/org.eclipse.jdt.debug/model/org/eclipse/jdt/internal/debug/core/JDIVariable.java;4;0;15;2;0;0;0;15;35;2;14;187;167;167;2;1;0;15;15;1450;1;2517;14;4;
/org.eclipse.update.core/src/org/eclipse/update/internal/core/Volume.java;1;0;1;1;1;1;1;0;0;0;0;3971;0;0;1;0;0;0;1;3971;0;3971;1;1;
/org.eclipse.jdt.core/model/org/eclipse/jdt/core/util/IInnerClassesAttributeEntry.java;2;2;6;1;5;4;5;1;21;0;1;3629;57;57;2;0;1;1;6;4058;1;4573;5;2;
/org.eclipse.jdt.debug/eval/org/eclipse/jdt/internal/debug/eval/ast/EvaluationArrayType.java;1;0;3;1;0;0;0;3;118;1;3;3329;118;118;1;0;0;3;3;3329;0;3421;3;1;
/org.eclipse.scripting/Eclipse Scripting/org/eclipse/scripting/internal/ScriptPlugin.java;2;0;5;1;0;0;0;5;9;1;5;133;15;15;1;0;0;5;5;133;0;1424;5;2;
/org.eclipse.pde.ui/Eclipse PDE UI/org/eclipse/pde/internal/WorkspaceModelManager.java;2;0;8;2;0;0;0;8;82;3;6;267;128;128;3;2;0;8;8;324;2;1434;6;2;
/org.eclipse.jdt.ui.tests.refactoring/resources/RenameStaticMethod/test6/in/A.java;2;0;3;1;0;0;0;3;4;1;3;49;6;6;1;0;0;3;3;49;0;2248;3;2;
/org.eclipse.help.ui/Eclipse Help UI/org/eclipse/help/internal/ui/Actions.java;4;0;5;1;0;0;0;5;24;1;5;136;37;37;1;0;0;5;5;136;0;1420;5;4;
/org.eclipse.jdt.ui.tests.refactoring/resources/RenameVirtualMethodInClass/testFail33/in/A.java;1;0;1;1;0;0;0;1;0;0;1;49;0;0;1;0;0;1;1;49;0;49;1;1;
/org.eclipse.webdav/src/interface/org/eclipse/webdav/dom/Assert.java;3;0;6;1;1;1;1;5;112;1;5;12;151;151;1;0;0;5;6;12;0;4211;6;3;
/org.eclipse.debug.core/core/org/eclipse/debug/internal/core/InputStreamMonitor.java;3;1;12;2;2;2;2;10;181;2;9;187;248;248;2;1;0;10;12;1708;1;4346;11;3;
/org.eclipse.jdt.ui.tests.refactoring/resources/PullUp/test6/out/A.java;1;0;1;1;0;0;0;1;0;0;1;2406;0;0;1;0;0;1;1;2406;0;2406;1;1;
/org.eclipse.core.target/src/org/eclipse/core/internal/target/filesystem/PushPullTarget.java;2;0;11;1;1;1;1;10;1288;1;10;12;1883;1883;1;0;0;10;11;12;0;4196;11;2;
/org.eclipse.ui/Eclipse UI/org/eclipse/ui/actions/LabelRetargetAction.java;4;1;7;1;4;4;4;3;70;2;2;3176;150;150;2;1;0;3;7;3212;1;4460;6;4;
/org.eclipse.update.ui/src/org/eclipse/update/internal/ui/manager/FeatureList.java;1;0;2;1;0;0;0;2;0;1;2;1440;0;0;1;0;0;2;2;1440;0;1460;2;1;
/org.eclipse.pde.ui/Eclipse PDE UI/org/eclipse/pde/internal/editor/schema/TypeRestrictionCellEditor.java;2;0;5;2;0;0;0;5;12;3;3;267;12;12;3;2;0;5;5;324;2;1434;3;2;
/org.eclipse.update.core/src/org/eclipse/update/internal/core/FeatureParser.java;2;0;7;1;0;0;0;7;84;2;6;1791;89;89;2;1;0;7;7;2004;1;2583;6;2;
/org.eclipse.jdt.debug/eval/org/eclipse/jdt/internal/debug/eval/ast/instructions/InstructionsEvaluationMessages.java;1;0;1;1;0;0;0;1;0;0;1;3677;0;0;1;0;0;1;1;3677;0;3677;1;1;
/org.eclipse.jdt.ui.tests.refactoring/resources/RenameTemp/canRename/A_test31_out.java;1;0;2;1;0;0;0;2;2;1;2;1625;2;2;1;0;0;2;2;1625;0;1652;2;1;
/org.eclipse.jdt.ui/ui/org/eclipse/jdt/internal/ui/reorg/CUSavePolicy.java;6;0;14;2;0;0;0;14;178;2;13;15;417;417;2;1;0;14;14;25;1;1667;13;6;
/org.eclipse.swt/Eclipse SWT OLE Win32/win32/org/eclipse/swt/internal/ole/win32/IOleLink.java;2;0;3;1;0;0;0;3;5;1;3;106;5;5;1;0;0;3;3;106;0;2069;3;2;
/org.eclipse.jdt.ui.tests.refactoring/resources/RenameType/testFailRegression1GCRKMQ/in/Blinky.java;1;0;1;1;0;0;0;1;0;0;1;49;0;0;1;0;0;1;1;49;0;49;1;1;
/org.eclipse.jdt.ui/ui/org/eclipse/jdt/internal/ui/javaeditor/DocumentAdapter.java;2;0;8;2;1;1;1;7;88;2;5;3147;295;295;2;2;0;7;8;3147;2;4137;6;2;
/org.eclipse.ui/Eclipse UI/org/eclipse/ui/internal/registry/PropertyPagesRegistryReader.java;4;0;4;1;0;0;0;4;31;1;4;257;47;47;1;0;0;4;4;257;0;2101;4;4;
/org.eclipse.core.tests.runtime/src/org/eclipse/core/tests/internal/plugins/FragmentResolveTest_2.java;3;0;4;1;0;0;0;4;1052;1;4;1819;1069;1069;1;0;0;4;4;1819;0;3476;4;3;
/org.eclipse.pde.ui/src/org/eclipse/pde/internal/core/ModelDataTransfer.java;1;0;2;1;0;0;0;2;0;0;1;3579;0;0;2;1;0;2;2;3579;1;3579;1;1;
/org.eclipse.compare/compare/org/eclipse/compare/patch/CompareWithPatchAction.java;1;0;3;1;0;0;0;3;2;1;3;1516;2;2;1;0;0;3;3;1516;0;2876;3;1;
/org.eclipse.jdt.ui.tests.refactoring/resources/StructureSelectionAction/A_test9.java;1;0;2;1;0;0;0;2;2;1;2;2139;2;2;1;0;0;2;2;2139;0;2412;2;1;
/org.eclipse.jdt.debug.tests/test programs/org/eclipse/debug/tests/targets/HitCountLooper.java;1;0;2;1;0;0;0;2;0;1;2;3701;0;0;1;0;0;2;2;3701;0;3719;2;1;
/org.eclipse.jdt.ui/ui/org/eclipse/jdt/internal/ui/search/JavaSearchResultLabelProvider.java;3;1;25;1;5;5;5;20;126;2;17;15;673;673;2;3;0;20;25;870;3;4627;22;3;
/org.eclipse.pde.ui/src/org/eclipse/pde/internal/ui/WorkspaceModelManager.java;1;0;3;1;0;0;0;3;27;2;2;3579;27;27;2;1;0;3;3;3579;1;3607;2;1;
/org.eclipse.ui/Eclipse UI/org/eclipse/ui/IViewSite.java;4;0;6;1;0;0;0;6;9;1;6;257;32;32;1;0;0;6;6;257;0;2548;6;4;
/org.eclipse.jdt.debug.tests/tests/org/eclipse/jdt/debug/tests/eval/generator/OtherTestsGenrator.java;2;0;2;2;2;1;2;0;0;0;0;4447;0;0;2;0;1;0;2;4447;1;4447;1;2;
/org.eclipse.ui.tests/Eclipse UI Tests/org/eclipse/ui/tests/api/IFileEditorMappingTest.java;3;0;5;1;0;0;0;5;6;1;5;983;13;13;1;0;0;5;5;983;0;2785;5;3;
/org.eclipse.pde.ui/src/org/eclipse/pde/internal/core/feature/WorkspaceFeatureModel.java;1;0;2;1;0;0;0;2;0;1;2;3579;0;0;1;0;0;2;2;3579;0;3607;2;1;
/org.eclipse.swt.examples.launcher/org/eclipse/swt/examples/launcher/LauncherApplication.java;3;0;3;1;0;0;0;3;81;1;3;513;81;81;1;0;0;3;3;513;0;3690;3;3;
/org.eclipse.swt.tests/JUnit Tests/org/eclipse/swt/tests/junit/Test_org_eclipse_swt_custom_ExtendedModifyListener.java;3;0;3;1;1;1;1;2;69;1;2;1792;75;75;1;0;0;2;3;1792;0;4706;3;3;
/org.eclipse.ui/Eclipse UI/org/eclipse/ui/internal/ModeOption.java;1;0;2;1;0;0;0;2;0;1;2;3128;0;0;1;0;0;2;2;3128;0;3270;2;1;
/org.eclipse.jdt.ui/ui refactoring/org/eclipse/jdt/internal/ui/refactoring/DefaultChangeElement.java;1;0;2;1;0;0;0;2;2;1;2;1800;2;2;1;0;0;2;2;1800;0;1939;2;1;
/org.eclipse.jdt.ui/core refactoring/org/eclipse/jdt/core/refactoring/IUndoManager.java;1;0;5;1;0;0;0;5;8;1;5;15;17;17;1;0;0;5;5;15;0;408;5;1;
/org.eclipse.scripting/Eclipse Scripting/org/eclipse/scripting/internal/datamodels/XGRStringDataNode.java;2;0;4;1;0;0;0;4;92;1;4;133;96;96;1;0;0;4;4;133;0;1424;4;2;
/org.eclipse.jdt.ui.tests.refactoring/resources/ExtractMethodWorkSpace/ExtractMethodTests/validSelection/A_test271.java;2;1;3;1;2;2;2;1;0;0;1;49;0;0;1;0;0;1;3;49;0;4419;3;2;
/org.eclipse.jdt.ui/ui/org/eclipse/jdt/internal/ui/search/JavaTextLabelProvider.java;2;0;6;1;0;0;0;6;44;2;5;1267;82;82;2;1;0;6;6;1267;1;2151;5;2;
/org.eclipse.jdt.ui/ui/org/eclipse/jdt/internal/ui/wizards/buildpaths/NewContainerDialog.java;4;1;10;1;2;2;2;8;21;1;8;15;109;109;1;0;0;8;10;15;0;4630;10;4;
/org.eclipse.team.cvs.core/src/org/eclipse/team/internal/ccvs/core/client/ExpandModules.java;2;0;6;1;1;1;1;5;54;1;5;2933;73;73;1;0;0;5;6;2933;0;4011;6;2;
/org.eclipse.pde.build/src/org/eclipse/pde/internal/build/FetchScriptGeneratorApplication.java;1;1;8;1;2;2;2;6;100;2;5;2977;172;172;2;1;0;6;8;3571;1;4273;7;1;
/org.eclipse.pde.ui/src/org/eclipse/pde/internal/editor/feature/SynchronizeVersionsAction.java;1;0;3;1;0;0;0;3;2;1;3;2951;2;2;1;0;0;3;3;2951;0;3579;3;1;
/org.eclipse.jdt.ui/core extension/org/eclipse/jdt/internal/corext/template/java/JavaContext.java;5;2;13;2;6;5;6;7;72;1;7;2784;239;239;2;0;1;7;13;4567;1;4621;12;5;
/org.eclipse.help.ui/Eclipse Help UI/org/eclipse/help/internal/ui/search/CheckboxLabelProvider.java;2;0;3;1;0;0;0;3;7;1;3;136;7;7;1;0;0;3;3;136;0;1055;3;2;
/org.eclipse.jdt.ui.tests/nls/org/eclipse/jdt/ui/nls/tests/NLSRefactoringTester.java;1;0;5;1;0;0;0;5;21;2;4;1754;23;23;2;1;0;5;5;1921;1;1939;4;1;
/org.eclipse.jdt.ui.tests.refactoring/test cases/org/eclipse/jdt/ui/tests/refactoring/ReorderParametersTests.java;1;1;10;1;2;2;2;8;18;1;8;2270;60;60;1;0;0;8;10;2270;0;4444;10;1;
/org.eclipse.vcm.ui/src/org/eclipse/vcm/internal/ui/IStateInfoProvider.java;2;0;2;2;0;0;0;2;5;0;1;295;5;5;2;1;0;2;2;295;1;295;1;2;
/org.eclipse.core.runtime/src/org/eclipse/core/runtime/IPluginDescriptor.java;4;1;6;1;3;3;3;3;514;1;3;12;598;598;1;0;0;3;6;12;0;4752;6;4;
/org.eclipse.pde.ui/Eclipse PDE UI/org/eclipse/pde/internal/base/model/IWritable.java;2;0;5;2;0;0;0;5;12;3;3;267;12;12;3;2;0;5;5;324;2;1434;3;2;
/org.eclipse.core.tests.resources/src/org/eclipse/core/tests/resources/perf/BenchElementTree.java;3;0;3;1;0;0;0;3;1102;1;3;1794;1108;1108;1;0;0;3;3;1794;0;3420;3;3;
/org.eclipse.vcm.ui/src/org/eclipse/vcm/internal/ui/wizards/NewRepositoryMainPage.java;2;0;2;1;0;0;0;2;0;1;2;1;0;0;1;0;0;2;2;1;0;31;2;2;
/org.eclipse.jdt.ui.tests.refactoring/resources/MoveCU/test0/in/p/A.java;2;0;2;1;0;0;0;2;0;1;2;49;0;0;1;0;0;2;2;49;0;2769;2;2;
/org.eclipse.pde.ui/src/org/eclipse/pde/internal/model/Fragment.java;2;0;8;1;0;0;0;8;212;2;6;1434;268;268;2;2;0;8;8;2730;2;3134;6;2;
/org.eclipse.jdt.ui.tests/test plugin/org/eclipse/jdt/testplugin/util/DialogCheck.java;2;0;2;1;1;1;1;1;30;0;1;2180;30;30;1;0;0;1;2;2180;0;4682;2;2;
/org.eclipse.help.ui/Eclipse Help UI/org/eclipse/help/internal/ui/search/CheckboxTreeContentProvider.java;2;0;3;1;0;0;0;3;7;1;3;136;7;7;1;0;0;3;3;136;0;1055;3;2;
/org.eclipse.update.core/src/org/eclipse/update/core/model/SiteModel.java;2;0;4;1;0;0;0;4;192;2;3;3027;236;236;2;1;0;4;4;3572;1;3572;3;2;
/org.eclipse.jdt.debug/eval/org/eclipse/jdt/internal/debug/eval/ast/instructions/NotOperator.java;3;0;6;1;0;0;0;6;5;1;6;3421;17;17;1;0;0;6;6;3421;0;3677;6;3;
/org.eclipse.search/search/org/eclipse/search/internal/core/text/TextSearchEngine.java;2;0;4;1;1;1;1;3;29;1;3;15;41;41;1;0;0;3;4;15;0;4034;4;2;
/org.eclipse.jdt.core/codeassist/org/eclipse/jdt/internal/codeassist/complete/CompletionOnFieldName.java;3;0;5;1;1;1;1;4;10;1;4;1580;22;22;1;0;0;4;5;1580;0;4062;5;3;
/org.eclipse.ant.ui/src/org/eclipse/ant/internal/ui/AntUIPlugin.java;4;0;13;2;0;0;0;13;378;2;11;14;657;657;2;2;0;13;13;374;2;3606;11;4;
/org.eclipse.core.target/src/org/eclipse/core/target/ITarget.java;2;0;14;1;1;1;1;13;562;6;8;12;765;765;6;5;0;13;14;663;5;4196;9;2;
/org.eclipse.ui/Eclipse UI/org/eclipse/ui/internal/registry/ActionSetRegistry.java;4;0;4;1;0;0;0;4;39;1;4;257;84;84;1;0;0;4;4;257;0;3233;4;4;
/org.eclipse.ui/Eclipse JFace/org/eclipse/jface/viewers/TableViewer.java;4;1;9;1;2;2;2;7;33;1;7;257;92;92;1;0;0;7;9;257;0;4195;9;4;
/org.eclipse.ui/Eclipse UI Standard Components/org/eclipse/ui/wizards/datatransfer/WizardZipFileResourceExportPage1.java;6;0;13;1;1;1;1;12;75;2;10;257;173;173;2;2;0;12;13;2960;2;3912;11;6;
/org.eclipse.pde.build/src/org/eclipse/pde/internal/build/ConfigurationBuildScriptGenerator.java;7;0;23;1;0;0;0;23;634;4;19;245;836;836;4;4;0;23;23;256;4;3089;19;7;
/org.eclipse.ui.examples.readmetool/Eclipse UI Examples Readme Tool/org/eclipse/ui/examples/readmetool/ReadmeContentOutlinePage.java;2;0;7;1;0;0;0;7;32;1;7;932;101;101;1;0;0;7;7;932;0;3579;7;2;
/org.eclipse.swt.examples/org/eclipse/swt/examples/explorer/Images.java;1;0;1;1;0;0;0;1;0;0;1;513;0;0;1;0;0;1;1;513;0;513;1;1;
/org.eclipse.jdt.ui/ui/org/eclipse/jdt/internal/ui/javaeditor/ClassFileEditorInput.java;2;0;4;1;0;0;0;4;5;1;4;15;7;7;1;0;0;4;4;15;0;1685;4;2;
/org.eclipse.jdt.debug/jdi interfaces/com/sun/jdi/AbsentInformationException.java;2;0;3;1;0;0;0;3;4;1;3;2704;7;7;1;0;0;3;3;2704;0;3040;3;2;
/org.eclipse.jdt.ui.tests.refactoring/resources/RenameType/test9/in/A.java;1;0;1;1;0;0;0;1;0;0;1;49;0;0;1;0;0;1;1;49;0;49;1;1;
/org.eclipse.swt.tests/JUnit Tests/org/eclipse/swt/tests/junit/Test_org_eclipse_swt_widgets_Tracker.java;2;0;2;1;1;1;1;1;6;0;1;1792;6;6;1;0;0;1;2;1792;0;4706;2;2;
/org.eclipse.pde.ui/Eclipse PDE UI/org/eclipse/pde/internal/forms/ScrollableForm.java;3;0;8;2;0;0;0;8;20;3;6;267;64;64;3;2;0;8;8;324;2;1434;6;3;
/org.eclipse.debug.core/core/org/eclipse/debug/core/IExpressionListener.java;1;0;2;1;0;0;0;2;6;1;2;2345;6;6;1;0;0;2;2;2345;0;3460;2;1;
/org.eclipse.ui/Eclipse UI/org/eclipse/ui/XMLMemento.java;1;0;2;1;1;1;1;1;40;0;1;3872;40;40;1;0;0;1;2;3872;0;4573;2;1;
/org.eclipse.jdt.ui/core refactoring/org/eclipse/jdt/internal/core/refactoring/packageroots/RenameSourceFolderRefactoring.java;1;0;6;1;0;0;0;6;88;2;5;988;125;125;2;1;0;6;6;988;1;1342;5;1;
/org.eclipse.pde.core/src/org/eclipse/pde/internal/core/PDECore.java;1;0;9;1;1;1;1;8;65;3;5;3591;177;177;3;3;0;8;9;3629;3;4413;6;1;
/org.eclipse.team.tests.cvs.core/src/org/eclipse/team/tests/ccvs/ui/logformatter/Util.java;1;0;1;1;0;0;0;1;0;0;1;3452;0;0;1;0;0;1;1;3452;0;3452;1;1;
/org.eclipse.pde.ui/src/org/eclipse/pde/model/ISourceObject.java;1;0;2;1;0;0;0;2;0;1;2;3039;0;0;1;0;0;2;2;3039;0;3579;2;1;
/org.eclipse.core.tests.runtime/src/org/eclipse/core/tests/internal/plugins/PluginResolveTest_22.java;3;0;3;1;0;0;0;3;110;1;3;1794;120;120;1;0;0;3;3;1794;0;3476;3;3;
/org.eclipse.jdt.core/search/org/eclipse/jdt/internal/core/search/matching/MultipleSearchPattern.java;2;0;3;1;1;1;1;2;43;1;2;455;70;70;1;0;0;2;3;455;0;4063;3;2;
/org.eclipse.jdt.ui.tests.refactoring/resources/RenamePackage/testFail7/in/r/A.java;1;0;1;1;0;0;0;1;0;0;1;1258;0;0;1;0;0;1;1;1258;0;1258;1;1;
/org.eclipse.jdt.ui.tests.refactoring/resources/RenameParameters/canRename/A_test3_out.java;1;0;1;1;0;0;0;1;0;0;1;233;0;0;1;0;0;1;1;233;0;233;1;1;
/org.eclipse.ant.core/src/plugin/org/eclipse/ant/internal/core/AntClassLoader.java;1;0;1;1;0;0;0;1;0;0;1;3475;0;0;1;0;0;1;1;3475;0;3475;1;1;
/org.eclipse.debug.ui/ui/org/eclipse/debug/ui/DebugAction.java;2;0;3;1;0;0;0;3;2;1;3;2205;2;2;1;0;0;3;3;2205;0;2397;3;2;
/org.eclipse.swt/Eclipse SWT/photon/org/eclipse/swt/internal/photon/PgAlpha_t.java;2;0;3;1;0;0;0;3;6;1;3;106;6;6;1;0;0;3;3;106;0;2069;3;2;
/org.eclipse.jdt.ui/ui/org/eclipse/jdt/internal/ui/packageview/RemoveWorkingSetFilterAction.java;2;0;3;1;0;0;0;3;3;1;3;1693;3;3;1;0;0;3;3;1693;0;3678;3;2;
/org.eclipse.jdt.ui.tests.refactoring/resources/MoveMembers/test1/out/A.java;1;0;1;1;0;0;0;1;0;0;1;2738;0;0;1;0;0;1;1;2738;0;2738;1;1;
/org.eclipse.pde.ui/src/org/eclipse/pde/internal/editor/jars/PluginJarsEditor.java;2;0;3;1;0;0;0;3;2;1;3;1434;2;2;1;0;0;3;3;1434;0;2650;3;2;
/org.eclipse.jdt.ui.tests/ui/org/eclipse/jdt/internal/ui/dialogs/tests/MultiElementListSelectorTest.java;2;0;2;1;0;0;0;2;0;1;2;522;0;0;1;0;0;2;2;522;0;1186;2;2;
/org.eclipse.core.resources/src/org/eclipse/core/internal/dtree/NodeComparison.java;1;0;4;1;1;1;1;3;244;1;3;12;279;279;1;0;0;3;4;12;0;4214;4;1;
/org.eclipse.jdt.debug/eval/org/eclipse/jdt/internal/debug/eval/ast/instructions/UnaryMinusOperator.java;3;0;6;1;0;0;0;6;5;1;6;3421;17;17;1;0;0;6;6;3421;0;3677;6;3;
/org.eclipse.pde.core/src/org/eclipse/pde/internal/core/ischema/ISchemaRestriction.java;1;0;1;1;0;0;0;1;0;0;1;3591;0;0;1;0;0;1;1;3591;0;3591;1;1;
/org.eclipse.swt/Eclipse SWT/win32/org/eclipse/swt/internal/win32/TVINSERTSTRUCT.java;2;0;3;1;0;0;0;3;5;1;3;106;5;5;1;0;0;3;3;106;0;2069;3;2;
/org.eclipse.pde.ui/src/org/eclipse/pde/internal/editor/manifest/ManifestExtensionPointPage.java;2;0;4;1;0;0;0;4;4;1;4;1434;6;6;1;0;0;4;4;1434;0;3579;4;2;
/org.eclipse.jdt.debug/eval/org/eclipse/jdt/internal/debug/eval/ast/engine/EqualEqualOperator.java;1;0;2;1;0;0;0;2;0;1;2;3329;0;0;1;0;0;2;2;3329;0;3421;2;1;
/org.eclipse.jdt.ui.tests/test plugin/org/eclipse/jdt/testplugin/test/HelloWorld.java;2;0;4;1;0;0;0;4;38;1;4;49;62;62;1;0;0;4;4;49;0;1228;4;2;
/org.eclipse.jdt.ui/ui refactoring/org/eclipse/jdt/internal/ui/refactoring/nls/search/NLSSearchOperation.java;2;0;3;1;0;0;0;3;6;1;3;1922;10;10;1;0;0;3;3;1922;0;3530;3;2;
/org.eclipse.jdt.ui.tests.refactoring/resources/RenameType/test29/in/A.java;1;0;1;1;0;0;0;1;0;0;1;49;0;0;1;0;0;1;1;49;0;49;1;1;
/org.eclipse.jdt.core/compiler/org/eclipse/jdt/internal/compiler/lookup/BinaryTypeBinding.java;3;1;12;1;2;2;2;10;832;4;7;455;1433;1433;4;3;0;10;12;1039;3;4191;9;3;
/org.eclipse.jdt.ui.tests.refactoring/resources/ExtractMethodWorkSpace/ExtractMethodTests/locals_out/A_test517.java;2;1;5;1;2;2;2;3;21;1;3;369;23;23;1;0;0;3;5;369;0;4419;5;2;
/org.eclipse.ui/Eclipse JFace Text/org/eclipse/jface/text/DefaultPositionUpdater.java;3;0;3;1;0;0;0;3;22;1;3;257;27;27;1;0;0;3;3;257;0;1066;3;3;
/org.eclipse.jdt.ui/core refactoring/org/eclipse/jdt/internal/core/refactoring/cus/RenameCompilationUnitChange.java;2;0;5;1;0;0;0;5;10;1;5;470;23;23;1;0;0;5;5;470;0;1342;5;2;
/org.eclipse.jdt.ui.tests.refactoring/resources/RenameVariables/canRename/A_test23_out.java;1;0;2;1;0;0;0;2;0;1;2;724;0;0;1;0;0;2;2;724;0;1665;2;1;
/org.eclipse.pde.ui/src/org/eclipse/pde/internal/ui/PDEPerspective.java;1;0;3;1;0;0;0;3;10;2;2;3579;12;12;2;1;0;3;3;3579;1;3593;2;1;
/org.eclipse.jdt.ui/ui/org/eclipse/jdt/internal/ui/browsing/PatchedOpenNewWindowAction.java;1;0;2;1;0;0;0;2;0;1;2;3590;0;0;1;0;0;2;2;3590;0;3622;2;1;
/org.eclipse.swt/Eclipse SWT PI/motif/org/eclipse/swt/internal/motif/XmDragProcCallback.java;2;0;2;1;1;1;1;1;6;0;1;2069;6;6;1;0;0;1;2;2069;0;4701;2;2;
/org.eclipse.help.ui.win32/src/org/eclipse/help/ui/internal/browser/win32/IEHost.java;2;1;3;1;3;3;3;0;2;0;0;4427;4;4;1;0;0;0;3;4427;0;4607;3;2;
/org.eclipse.vcm.ui.cvs/src/org/eclipse/vcm/internal/ui/ccvs/FilterProjectDialog.java;1;0;1;1;0;0;0;1;0;0;1;1008;0;0;1;0;0;1;1;1008;0;1008;1;1;
/org.eclipse.jdt.ui/core refactoring/org/eclipse/jdt/internal/corext/refactoring/SearchResultCollector.java;2;0;3;1;1;1;1;2;6;1;2;1939;10;10;1;0;0;2;3;1939;0;4400;3;2;
/org.eclipse.jdt.ui.tests.refactoring/resources/ReorderParameters/canReorder/A_test8_in.java;1;0;3;1;0;0;0;3;0;1;3;724;0;0;1;0;0;3;3;724;0;2270;3;1;
/org.eclipse.ui/Eclipse JFace Text/org/eclipse/jface/text/rules/DefaultDamagerRepairer.java;1;0;3;1;1;1;1;2;17;1;2;3812;19;19;1;0;0;2;3;3812;0;4838;3;1;
/org.eclipse.jdt.debug/jdi/org/eclipse/jdi/internal/jdwp/JdwpClassObjectID.java;2;0;3;1;0;0;0;3;12;1;3;187;13;13;1;0;0;3;3;187;0;3040;3;2;
/org.eclipse.core.boot/src/org/eclipse/core/internal/boot/update/ManifestDescriptorModel.java;2;0;3;1;0;0;0;3;7;1;3;12;7;7;1;0;0;3;3;12;0;2726;3;2;
/org.eclipse.pde.runtime/src/org/eclipse/pde/internal/runtime/registry/PluginPropertySource.java;1;0;1;1;0;0;0;1;0;0;1;1434;0;0;1;0;0;1;1;1434;0;1434;1;1;
/org.eclipse.update.ui/src/org/eclipse/update/internal/ui/model/SimpleFeatureAdapter.java;1;1;4;1;3;3;3;1;16;0;1;2834;30;30;1;0;0;1;4;2834;0;4384;4;1;
/org.eclipse.pde.ui/Eclipse PDE UI/org/eclipse/pde/internal/editor/PDEEditorContributor.java;2;0;6;2;0;0;0;6;12;3;4;267;16;16;3;2;0;6;6;324;2;1434;4;2;
/org.eclipse.update.ui.win32/src/org/eclipse/update/internal/ui/win32/views/WebBrowser.java;1;1;2;1;2;2;2;0;71;0;0;4127;71;71;1;0;0;0;2;4127;0;4217;2;1;
/org.eclipse.jdt.ui.tests.refactoring/resources/ExtractMethodWorkSpace/ExtractMethodTests/validSelection/A_test244.java;2;1;3;1;2;2;2;1;0;0;1;49;0;0;1;0;0;1;3;49;0;4419;3;2;
/org.eclipse.team.cvs.core/src/org/eclipse/team/internal/ccvs/core/resources/api/NotCVSFolderException.java;2;0;2;1;0;0;0;2;0;1;2;1978;0;0;1;0;0;2;2;1978;0;2156;2;2;
/org.eclipse.ui.examples.readmetool/Eclipse UI Examples Readme Tool/org/eclipse/ui/examples/readmetool/MessageUtil.java;1;0;1;1;0;0;0;1;0;0;1;932;0;0;1;0;0;1;1;932;0;932;1;1;
/org.eclipse.jdt.core/model/org/eclipse/jdt/internal/core/builder/ClasspathMultiDirectory.java;3;2;6;2;3;2;3;3;48;1;3;2979;97;97;2;0;1;3;6;4138;1;4138;5;3;
/org.eclipse.swt.examples.paint/org/eclipse/swt/examples/paint/MetaContainer.java;1;0;1;1;0;0;0;1;0;0;1;513;0;0;1;0;0;1;1;513;0;513;1;1;
/org.eclipse.pde.ui/src/org/eclipse/pde/internal/ui/editor/schema/SchemaDocPage.java;1;0;4;1;1;1;1;3;93;2;2;3579;117;117;2;1;0;3;4;3579;1;3922;3;1;
/org.eclipse.jdt.ui/ui/org/eclipse/jdt/ui/actions/WorkingSetFindAction.java;3;1;3;1;3;3;3;0;10;0;0;4141;15;15;1;0;0;0;3;4141;0;4770;3;3;
/org.eclipse.jdt.core/model/org/eclipse/jdt/internal/core/JavaProjectElementInfo.java;3;0;9;1;1;1;1;8;331;1;8;455;669;669;1;0;0;8;9;455;0;4063;9;3;
/org.eclipse.jdt.ui/core refactoring/org/eclipse/jdt/internal/core/refactoring/changes/ReorgRefactoring.java;1;0;2;1;0;0;0;2;0;1;2;1108;0;0;1;0;0;2;2;1108;0;1257;2;1;
/org.eclipse.swt.tests/JUnit Tests/org/eclipse/swt/tests/junit/Test_org_eclipse_swt_dnd_DragSourceListener.java;2;0;2;1;1;1;1;1;6;0;1;1792;6;6;1;0;0;1;2;1792;0;4706;2;2;
/org.eclipse.pde.ui/Eclipse PDE UI/org/eclipse/pde/internal/editor/SystemFileDocumentProvider.java;2;0;8;2;0;0;0;8;12;3;6;267;41;41;3;2;0;8;8;324;2;1434;6;2;
/org.eclipse.ui/Eclipse UI Text Editor/org/eclipse/ui/texteditor/TextEditorTestStub.java;2;0;3;1;0;0;0;3;4;1;3;1034;4;4;1;0;0;3;3;1034;0;1302;3;2;
/org.eclipse.ui/Eclipse UI/org/eclipse/ui/internal/WorkbenchImages.java;7;1;14;1;5;5;5;9;235;1;9;257;313;313;1;0;0;9;14;257;0;4431;14;7;
/org.eclipse.jdt.ui.tests.refactoring/resources/RenameVirtualMethodInClass/test10/out/A.java;1;0;1;1;0;0;0;1;0;0;1;49;0;0;1;0;0;1;1;49;0;49;1;1;
/org.eclipse.jdt.ui.tests.refactoring/test cases/org/eclipse/jdt/ui/tests/refactoring/RenameTypeTests.java;2;1;10;1;2;2;2;8;53;1;8;1896;96;96;1;0;0;8;10;1896;0;4423;10;2;
/org.eclipse.jdt.ui.tests.refactoring/resources/PullUp/test11/out/A.java;1;0;1;1;0;0;0;1;0;0;1;2406;0;0;1;0;0;1;1;2406;0;2406;1;1;
/org.eclipse.ui/Eclipse UI/org/eclipse/ui/dialogs/WizardDataTransferPage.java;4;0;7;1;1;1;1;6;32;1;6;257;83;83;1;0;0;6;7;257;0;3912;7;4;
/org.eclipse.jdt.core/dom/org/eclipse/jdt/core/dom/ArrayType.java;2;1;8;1;2;2;2;6;11;1;6;2669;45;45;1;0;0;6;8;2669;0;4453;8;2;
/org.eclipse.update.core/src/org/eclipse/update/core/IInfo.java;2;0;5;1;0;0;0;5;18;1;5;1577;27;27;1;0;0;5;5;1577;0;2583;5;2;
/org.eclipse.jdt.core/model/org/eclipse/jdt/internal/core/CompilationUnit.java;4;1;66;2;7;7;7;59;1147;4;39;455;2325;2325;4;20;0;59;66;1039;20;4657;46;4;
/org.eclipse.jdt.ui.tests.refactoring/resources/RenameVariables/canRename/A_test12_out.java;1;0;2;1;0;0;0;2;0;1;2;724;0;0;1;0;0;2;2;724;0;1665;2;1;
/org.eclipse.jdt.ui.tests.refactoring/resources/ExtractMethodWorkSpace/ExtractMethodTests/error_in/A_test801.java;1;1;3;1;2;2;2;1;0;0;1;3150;0;0;1;0;0;1;3;3150;0;4419;3;1;
/org.eclipse.jdt.ui.tests.refactoring/resources/MoveMembers/testFail2/in/B.java;1;0;1;1;0;0;0;1;0;0;1;2738;0;0;1;0;0;1;1;2738;0;2738;1;1;
/org.eclipse.vcm.core/src/org/eclipse/vcm/internal/core/VCMException.java;2;0;2;1;0;0;0;2;6;1;2;0;6;6;1;0;0;2;2;0;0;297;2;2;
/org.eclipse.update.ui.forms/src/org/eclipse/update/ui/forms/internal/NoTabsWorkbook.java;1;0;2;1;0;0;0;2;154;1;2;2470;154;154;1;0;0;2;2;2470;0;3628;2;1;
/org.eclipse.jdt.ui.tests/JUnit/junit/util/TestCaseClassLoader.java;2;0;2;1;0;0;0;2;0;1;2;49;0;0;1;0;0;2;2;49;0;1186;2;2;
/org.eclipse.help/src/org/eclipse/help/internal/contributors/xml/XMLTopicContributor.java;2;0;2;1;0;0;0;2;0;1;2;1420;0;0;1;0;0;2;2;1420;0;1675;2;2;
/org.eclipse.pde.ui/src/org/eclipse/pde/internal/editor/schema/DocSection.java;2;0;8;1;0;0;0;8;9;1;8;1434;27;27;1;0;0;8;8;1434;0;3579;8;2;
/org.eclipse.pde.ui/src/org/eclipse/pde/internal/base/model/IModelChangeProvider.java;2;0;4;1;0;0;0;4;6;1;4;1434;8;8;1;0;0;4;4;1434;0;3039;4;2;
/org.eclipse.jdt.ui/ui/org/eclipse/jdt/internal/ui/packageview/AddBookmarkAction.java;4;0;7;1;0;0;0;7;6;1;7;421;19;19;1;0;0;7;7;421;0;3171;7;4;
/org.eclipse.jdt.debug/eval/org/eclipse/jdt/internal/debug/eval/ast/instructions/ReturnInstruction.java;1;2;3;1;3;2;3;0;15;0;0;3915;15;15;2;0;1;0;3;4426;1;4426;2;1;
/org.eclipse.update.core/src/org/eclipse/update/core/Feature.java;2;4;61;2;29;17;29;32;502;3;23;2445;3753;3753;4;9;12;32;61;4381;21;4770;40;2;
/org.eclipse.jdt.ui.tests.refactoring/resources/SefWorkSpace/SefTests/object_in/TestCompoundWrite.java;1;0;1;1;0;0;0;1;0;0;1;2876;0;0;1;0;0;1;1;2876;0;2876;1;1;
/org.eclipse.pde.ui/src/org/eclipse/pde/internal/launcher/WorkbenchLauncherBasicTab.java;1;0;4;1;0;0;0;4;4;2;3;2868;6;6;2;1;0;4;4;3089;1;3089;3;1;
/org.eclipse.jdt.debug/jdi interfaces/com/sun/jdi/PrimitiveType.java;2;0;2;1;0;0;0;2;6;1;2;2704;6;6;1;0;0;2;2;2704;0;3033;2;2;
/org.eclipse.jdt.debug/eval/org/eclipse/jdt/internal/debug/eval/model/EvaluationArrayVariable.java;2;0;4;1;0;0;0;4;5;1;4;3421;9;9;1;0;0;4;4;3421;0;3645;4;2;
/org.eclipse.swt/Eclipse SWT PI/gtk1x/org/eclipse/swt/internal/gtk/GdkRectangle.java;2;0;2;1;1;1;1;1;3;0;1;2107;3;3;1;0;0;1;2;2107;0;4701;2;2;
/org.eclipse.jdt.ui/core refactoring/org/eclipse/jdt/internal/core/refactoring/methods/RenameMethodRefactoring.java;4;0;15;1;0;0;0;15;368;3;13;408;620;620;3;2;0;15;15;408;2;1342;13;4;
/org.eclipse.ui.tests/Eclipse JFace Tests/org/eclipse/jface/tests/viewers/TestLabelProvider.java;1;0;1;1;0;0;0;1;0;0;1;1488;0;0;1;0;0;1;1;1488;0;1488;1;1;
/org.eclipse.jdt.debug.ui/ui/org/eclipse/jdt/internal/debug/ui/display/IInspectAction.java;2;0;2;1;0;0;0;2;0;1;2;2273;0;0;1;0;0;2;2;2273;0;2813;2;2;
/org.eclipse.core.resources/src/org/eclipse/core/internal/watson/ElementTreeReader.java;1;0;4;1;1;1;1;3;248;1;3;12;274;274;1;0;0;3;4;12;0;4214;4;1;
/org.eclipse.help/webapps/examples/WEB-INF/classes/examples/LogTag.java;1;0;2;1;0;0;0;2;0;1;2;1882;0;0;1;0;0;2;2;1882;0;1930;2;1;
/org.eclipse.jdt.ui.tests.refactoring/resources/RenameType/testFail42/in/A.java;1;0;1;1;0;0;0;1;0;0;1;49;0;0;1;0;0;1;1;49;0;49;1;1;
/org.eclipse.swt/Eclipse SWT/photon/org/eclipse/swt/widgets/MenuItem.java;8;1;22;1;11;11;11;11;323;1;11;106;920;920;1;0;0;11;22;106;0;4701;22;8;
/org.eclipse.jdt.debug/eval/org/eclipse/jdt/internal/debug/eval/ast/RuntimeContext.java;1;0;3;1;0;0;0;3;294;1;3;3329;294;294;1;0;0;3;3;3329;0;3421;3;1;
/org.eclipse.scripting/Eclipse Scripting/org/eclipse/scripting/ScriptAdapterWorkbenchPreferencePage.java;2;0;4;1;0;0;0;4;13;1;4;133;19;19;1;0;0;4;4;133;0;1424;4;2;
/org.eclipse.jdt.ui.tests.refactoring/resources/SelectionAnalyzerWorkSpace/SelectionAnalyzerTests/invalidSelection/A_test172.java;1;0;1;1;0;0;0;1;0;0;1;1368;0;0;1;0;0;1;1;1368;0;1368;1;1;
/org.eclipse.swt.examples.layouts/src/org/eclipse/swt/examples/layouts/LayoutView.java;2;0;2;1;1;1;1;1;6;0;1;3451;6;6;1;0;0;1;2;3451;0;4705;2;2;
/org.eclipse.help/src/org/eclipse/help/internal/contributors/ContributionManager.java;2;0;2;1;0;0;0;2;0;1;2;1420;0;0;1;0;0;2;2;1420;0;1675;2;2;
/org.eclipse.update.ui/src/org/eclipse/update/internal/ui/views/ConfigurationView.java;3;3;30;2;21;15;21;9;215;2;7;3572;887;887;3;2;6;9;30;4244;8;4715;22;3;
/org.eclipse.ui/Eclipse UI Text Editor/org/eclipse/ui/texteditor/DefaultRangeIndicator.java;4;0;5;1;1;1;1;4;125;1;4;257;152;152;1;0;0;4;5;257;0;4838;5;4;
/org.eclipse.debug.ui/ui/org/eclipse/debug/internal/ui/launchConfigurations/CommonTab.java;3;0;15;2;0;0;0;15;263;3;10;2571;755;755;3;5;0;15;15;2734;5;3308;10;3;
/org.eclipse.ui.tests/Eclipse UI Tests/org/eclipse/ui/tests/api/ListElementActionFilter.java;1;0;3;1;0;0;0;3;41;2;2;1403;59;59;2;1;0;3;3;1403;1;1452;2;1;
/org.eclipse.swt/Eclipse SWT/carbon/org/eclipse/swt/widgets/ToolItem.java;5;1;6;1;6;6;6;0;41;0;0;4147;69;69;1;0;0;0;6;4147;0;4701;6;5;
/org.eclipse.ui/Eclipse UI Standard Components/org/eclipse/ui/views/navigator/ResourceNavigatorMessages.java;2;0;2;1;0;0;0;2;3;1;2;457;3;3;1;0;0;2;2;457;0;1757;2;2;
/org.eclipse.debug.core/core/org/eclipse/debug/internal/core/DebugCoreUtils.java;2;0;5;1;0;0;0;5;50;1;5;187;75;75;1;0;0;5;5;187;0;2571;5;2;
/org.eclipse.help.tests/src/org/eclipse/help/tests/base/TestNavigationModel.java;1;0;2;1;0;0;0;2;0;1;2;1805;0;0;1;0;0;2;2;1805;0;1857;2;1;
/org.eclipse.jdt.ui/core refactoring/org/eclipse/jdt/internal/core/refactoring/TextUtilities.java;3;0;6;1;0;0;0;6;149;2;5;15;159;159;2;1;0;6;6;25;1;1939;5;3;
/org.eclipse.help/src/org/eclipse/help/internal/contributions/InfoView.java;2;0;2;1;0;0;0;2;0;1;2;1420;0;0;1;0;0;2;2;1420;0;1675;2;2;
/org.eclipse.ui/Eclipse UI Text Editor/org/eclipse/ui/texteditor/IncrementalFindAction.java;1;0;2;1;1;1;1;1;17;0;1;3250;17;17;1;0;0;1;2;3250;0;4838;2;1;
/org.eclipse.jdt.ui.tests.refactoring/resources/RenameVariables/canRename/A_test1_in.java;1;0;2;1;0;0;0;2;0;1;2;724;0;0;1;0;0;2;2;724;0;1665;2;1;
/org.eclipse.jdt.ui.tests.refactoring/resources/ExtractMethodWorkSpace/ExtractMethodTests/locals_out/A_test560.java;1;1;4;1;2;2;2;2;34;1;2;1236;36;36;1;0;0;2;4;1236;0;4419;4;1;
/org.eclipse.core.tests.runtime/src/org/eclipse/core/tests/internal/runtimetests/SampleFFR.java;1;0;3;1;0;0;0;3;10;2;2;3605;13;13;2;1;0;3;3;3605;1;3678;2;1;
/org.eclipse.swt/Eclipse SWT PI/motif/org/eclipse/swt/internal/motif/XmDropProcCallback.java;2;0;2;1;1;1;1;1;6;0;1;2069;6;6;1;0;0;1;2;2069;0;4701;2;2;
/org.eclipse.pde.ui/src/org/eclipse/pde/internal/base/model/feature/IFeaturePlugin.java;1;0;5;1;0;0;0;5;55;1;5;2951;59;59;1;0;0;5;5;2951;0;3579;5;1;
/org.eclipse.jdt.ui.tests.refactoring/resources/RenameType/test41/in/A.java;1;0;1;1;0;0;0;1;0;0;1;49;0;0;1;0;0;1;1;49;0;49;1;1;
/org.eclipse.jdt.core/search/org/eclipse/jdt/internal/core/index/impl/EntryResult.java;2;0;9;1;1;1;1;8;109;4;5;455;181;181;4;3;0;8;9;1039;3;4063;6;2;
/org.eclipse.help.ui.win32/src/org/eclipse/help/ui/internal/browser/win32/IEFactory.java;1;0;1;1;1;1;1;0;0;0;0;4427;0;0;1;0;0;0;1;4427;0;4427;1;1;
/org.eclipse.jdt.ui/ui/org/eclipse/jdt/internal/ui/javaeditor/structureselection/StructureSelectionAnalyzer.java;2;0;2;1;1;1;1;1;0;0;1;3188;0;0;1;0;0;1;2;3188;0;4419;2;2;
/org.eclipse.pde.core/src/org/eclipse/pde/internal/core/IModelProviderEvent.java;1;0;1;1;0;0;0;1;0;0;1;3591;0;0;1;0;0;1;1;3591;0;3591;1;1;
/org.eclipse.webdav/src/kernel/org/eclipse/webdav/internal/kernel/LocatorImpl.java;2;0;3;1;0;0;0;3;5;1;3;12;5;5;1;0;0;3;3;12;0;1874;3;2;
/org.eclipse.ui/Eclipse UI/org/eclipse/ui/internal/SwitchToPerspAction.java;5;0;6;1;0;0;0;6;9;1;6;257;19;19;1;0;0;6;6;257;0;3067;6;5;
/org.eclipse.jdt.ui.tests.refactoring/resources/RenameVariables/canRename/A_test11_out.java;1;0;2;1;0;0;0;2;0;1;2;724;0;0;1;0;0;2;2;724;0;1665;2;1;
/org.eclipse.ui/Eclipse UI/org/eclipse/ui/internal/ViewPane.java;6;1;31;2;5;5;5;26;319;3;22;257;830;830;3;4;0;26;31;2618;4;4363;27;6;
/org.eclipse.ui/Eclipse JFace Text/org/eclipse/jface/text/ITypedRegion.java;3;0;3;1;0;0;0;3;5;1;3;257;7;7;1;0;0;3;3;257;0;1066;3;3;
/org.eclipse.jdt.ui.tests.refactoring/resources/RenameMethodInInterface/test31/out/A.java;1;0;1;1;0;0;0;1;0;0;1;49;0;0;1;0;0;1;1;49;0;49;1;1;
/org.eclipse.jdt.ui.tests.refactoring/resources/SafeDeleteType/testFail17/in/A.java;1;0;1;1;0;0;0;1;0;0;1;49;0;0;1;0;0;1;1;49;0;49;1;1;
/org.eclipse.jdt.ui.tests.refactoring/resources/RenameType/testFail78/in/A.java;1;0;1;1;0;0;0;1;0;0;1;49;0;0;1;0;0;1;1;49;0;49;1;1;
/org.eclipse.jdt.ui.tests.refactoring/resources/ExtractTemp/canExtract/A_test24_out.java;1;0;1;1;0;0;0;1;0;0;1;2637;0;0;1;0;0;1;1;2637;0;2637;1;1;
/org.eclipse.pde.ui/src/org/eclipse/pde/internal/component/ComponentJarWizardPage.java;2;0;3;1;0;0;0;3;27;1;3;1434;27;27;1;0;0;3;3;1434;0;2951;3;2;
/org.eclipse.vcm.ui/src/org/eclipse/vcm/internal/ui/sync/TypedBufferedContent.java;1;0;2;1;0;0;0;2;5;1;2;48;5;5;1;0;0;2;2;48;0;298;2;1;
/org.eclipse.ui/Eclipse UI/org/eclipse/ui/dialogs/TwoPaneElementSelector.java;1;0;2;1;1;1;1;1;6;0;1;3733;6;6;1;0;0;1;2;3733;0;4451;2;1;
/org.eclipse.swt/Eclipse SWT/carbon/org/eclipse/swt/widgets/Group.java;3;1;4;1;4;4;4;0;18;0;0;4147;29;29;1;0;0;0;4;4147;0;4701;4;3;
/org.eclipse.jdt.ui/ui/org/eclipse/jdt/internal/ui/preferences/ImportOrganizePreferencePage.java;5;2;22;2;5;4;5;17;396;2;16;15;639;639;2;1;1;17;22;3048;2;4426;20;5;
/org.eclipse.jdt.core/model/org/eclipse/jdt/internal/core/util/LocalVariableTableEntry.java;2;1;3;1;2;2;2;1;19;0;1;3629;33;33;1;0;0;1;3;3629;0;4422;3;2;
/org.eclipse.pde.ui/src/org/eclipse/pde/internal/ui/view/PluginsLabelProvider.java;1;0;2;1;1;1;1;1;3;0;1;3579;3;3;1;0;0;1;2;3579;0;4751;2;1;
/org.eclipse.swt/Eclipse SWT OLE Win32/win32/org/eclipse/swt/internal/ole/win32/IConnectionPointContainer.java;2;0;3;1;0;0;0;3;5;1;3;106;5;5;1;0;0;3;3;106;0;2069;3;2;
/org.eclipse.jdt.ui/core extension/org/eclipse/jdt/internal/corext/template/java/JavaDocContextType.java;2;0;4;1;1;1;1;3;42;1;3;2784;46;46;1;0;0;3;4;2784;0;4186;4;2;
/org.eclipse.update.ui.forms/src/org/eclipse/update/ui/forms/internal/engine/Locator.java;2;0;4;1;0;0;0;4;8;2;3;2745;17;17;2;1;0;4;4;2745;1;3395;3;2;
/org.eclipse.jdt.debug.tests/tests/org/eclipse/jdt/debug/tests/eval/QualifiedStaticFieldValueTests2.java;2;1;3;1;3;3;3;0;17;0;0;4447;19;19;1;0;0;0;3;4447;0;4571;3;2;
/org.eclipse.jdt.junit/Eclipse JUnit/org/eclipse/jdt/internal/junit/runner/MessageIds.java;2;0;4;1;0;0;0;4;89;1;4;2007;95;95;1;0;0;4;4;2007;0;3205;4;2;
/org.eclipse.pde.ui/src/org/eclipse/pde/internal/ui/editor/schema/NoRestrictionPage.java;1;0;2;1;0;0;0;2;2;1;2;3579;2;2;1;0;0;2;2;3579;0;3591;2;1;
/org.eclipse.jdt.debug.tests/tests/org/eclipse/jdt/debug/tests/eval/NestedTypeFieldValue_506.java;2;1;3;1;3;3;3;0;12;0;0;4447;14;14;1;0;0;0;3;4447;0;4571;3;2;
/org.eclipse.update.core/src/org/eclipse/update/core/WebInstallHandler.java;2;0;5;1;0;0;0;5;57;1;5;2865;100;100;1;0;0;5;5;2865;0;3590;5;2;
/org.eclipse.team.core/src/org/eclipse/team/core/internal/DefaultFileModificationValidator.java;2;0;4;1;0;0;0;4;14;1;4;3456;27;27;1;0;0;4;4;3456;0;3762;4;2;
/org.eclipse.jdt.ui.tests.refactoring/resources/DeleteSourceReferenceEdit/A_test0_out.java;1;0;1;1;0;0;0;1;0;0;1;2857;0;0;1;0;0;1;1;2857;0;2857;1;1;
/org.eclipse.help.ui/src/org/eclipse/help/ui/internal/browser/win32/HelpControlSite.java;2;0;3;1;1;1;1;2;2;1;2;3030;2;2;1;0;0;2;3;3030;0;4427;3;2;
/org.eclipse.ui/Eclipse JFace Text/org/eclipse/jface/text/Position.java;4;1;6;1;2;2;2;4;41;1;4;257;91;91;1;0;0;4;6;257;0;4838;6;4;
/org.eclipse.help.ui/Eclipse Help UI/org/eclipse/help/internal/ui/WorkbenchHelpPlugin.java;3;0;7;1;0;0;0;7;32;1;7;136;75;75;1;0;0;7;7;136;0;1420;7;3;
/org.eclipse.jdt.ui.tests.refactoring/resources/PullUpMethods/test6/out/A.java;1;0;4;1;0;0;0;4;5;1;4;2156;7;7;1;0;0;4;4;2156;0;2406;4;1;
/org.eclipse.ui/Eclipse UI/org/eclipse/ui/help/DialogPageContextComputer.java;3;0;5;1;0;0;0;5;13;1;5;257;22;22;1;0;0;5;5;257;0;3156;5;3;
/org.eclipse.update.core/src/org/eclipse/update/internal/core/SiteParser.java;2;0;6;1;0;0;0;6;78;1;6;1791;147;147;1;0;0;6;6;1791;0;2626;6;2;
/org.eclipse.swt/Eclipse SWT PI/photon/org/eclipse/swt/internal/photon/PgMap_t.java;2;0;2;1;1;1;1;1;6;0;1;2069;6;6;1;0;0;1;2;2069;0;4701;2;2;
/org.eclipse.help/src/org/eclipse/help/internal/topics/TopicsContributorsManager.java;2;0;2;1;0;0;0;2;0;1;2;1675;0;0;1;0;0;2;2;1675;0;1804;2;2;
/org.eclipse.jdt.ui.tests.refactoring/resources/SelectionAnalyzerWorkSpace/SelectionAnalyzerTests/invalidSelection/A_test149.java;2;0;2;1;0;0;0;2;0;1;2;1368;0;0;1;0;0;2;2;1368;0;2139;2;2;
/org.eclipse.debug.core/core/org/eclipse/debug/core/model/Breakpoint.java;4;0;13;1;0;0;0;13;82;1;13;1139;283;283;1;0;0;13;13;1139;0;3833;13;4;
/org.eclipse.jdt.ui/core refactoring/org/eclipse/jdt/internal/core/refactoring/SearchResult.java;3;0;4;1;0;0;0;4;18;1;4;15;23;23;1;0;0;4;4;15;0;1939;4;3;
/org.eclipse.jdt.ui/ui/org/eclipse/jdt/internal/ui/wizards/buildpaths/ZipContentProvider.java;1;0;1;1;0;0;0;1;0;0;1;1258;0;0;1;0;0;1;1;1258;0;1258;1;1;
/org.eclipse.core.resources/src/org/eclipse/core/internal/indexing/PageCacheElement.java;3;0;3;1;0;0;0;3;5;1;3;12;5;5;1;0;0;3;3;12;0;448;3;3;
/org.eclipse.ui/Eclipse JFace/org/eclipse/jface/viewers/IBaseLabelProvider.java;2;0;2;1;0;0;0;2;5;1;2;257;5;5;1;0;0;2;2;257;0;457;2;2;
/org.eclipse.jdt.ui.tests.refactoring/resources/RenameParameters/canRename/A_test2_out.java;1;0;1;1;0;0;0;1;0;0;1;233;0;0;1;0;0;1;1;233;0;233;1;1;
/org.eclipse.ui/Eclipse UI/org/eclipse/ui/internal/NullDecorator.java;1;0;1;1;0;0;0;1;0;0;1;1932;0;0;1;0;0;1;1;1932;0;1932;1;1;
/org.eclipse.jdt.ui/core refactoring/org/eclipse/jdt/internal/corext/refactoring/util/TextChangeManager.java;2;0;2;1;0;0;0;2;10;1;2;1939;10;10;1;0;0;2;2;1939;0;3486;2;2;
/org.eclipse.ui.tests/Eclipse UI Tests/org/eclipse/ui/tests/api/IPerspectiveListenerTest.java;4;0;8;1;0;0;0;8;50;1;8;983;85;85;1;0;0;8;8;983;0;3068;8;4;
/org.eclipse.jdt.ui.tests.refactoring/resources/RenamePrivateField/test5/in/A.java;1;0;1;1;0;0;0;1;0;0;1;2931;0;0;1;0;0;1;1;2931;0;2931;1;1;
/org.eclipse.swt.tests/JUnit Tests/org/eclipse/swt/tests/junit/Test_org_eclipse_swt_widgets_Composite.java;2;0;3;1;1;1;1;2;14;1;2;1792;20;20;1;0;0;2;3;1792;0;4706;3;2;
/org.eclipse.help.ui/src/org/eclipse/help/ui/internal/browser/win32/IEHost.java;2;2;25;1;7;6;7;18;299;1;18;2429;659;659;2;0;1;18;25;4004;1;4427;24;2;
/org.eclipse.update.examples/src/org/eclipse/update/examples/buildzip/BuildZipFeatureParser.java;2;0;10;1;0;0;0;10;194;2;9;2553;234;234;2;1;0;10;10;2859;1;3874;9;2;
/org.eclipse.jdt.ui.tests.refactoring/resources/ExtractMethodWorkSpace/ExtractMethodTests/invalidSelection/A_test013.java;2;1;3;1;2;2;2;1;0;0;1;49;0;0;1;0;0;1;3;49;0;4419;3;2;
/org.eclipse.ui/Eclipse JFace Text/org/eclipse/jface/text/source/IAnnotationModelListenerExtension.java;1;0;2;1;1;1;1;1;24;0;1;3630;24;24;1;0;0;1;2;3630;0;4838;2;1;
/org.eclipse.core.resources/src/org/eclipse/core/internal/resources/SaveManager.java;4;2;34;1;7;6;7;27;2792;2;26;12;4489;4489;2;1;1;27;34;3253;2;4551;32;4;
/org.eclipse.ui/Eclipse JFace/org/eclipse/jface/viewers/ITreeViewerListener.java;2;0;2;1;0;0;0;2;5;1;2;257;5;5;1;0;0;2;2;257;0;457;2;2;
/org.eclipse.jdt.ui.tests.refactoring/resources/ExtractMethodWorkSpace/ExtractMethodTests/semicolon_in/A_test404.java;2;1;4;1;2;2;2;2;12;1;2;80;16;16;1;0;0;2;4;80;0;4419;4;2;
/org.eclipse.swt/Eclipse SWT Custom Widgets/common/org/eclipse/swt/custom/TextChangedListener.java;1;0;2;1;0;0;0;2;0;1;2;106;0;0;1;0;0;2;2;106;0;612;2;1;
/org.eclipse.scripting/Eclipse Scripting/org/eclipse/scripting/internal/datamodels/XGRIncompatibleDataModelException.java;2;0;4;1;0;0;0;4;7;1;4;133;13;13;1;0;0;4;4;133;0;1424;4;2;
/org.eclipse.core.tests.harness/src/org/eclipse/core/tests/harness/DeltaDebugListener.java;3;0;5;1;1;1;1;4;114;1;4;1794;142;142;1;0;0;4;5;1794;0;4516;5;3;
/org.eclipse.ui/Eclipse UI/org/eclipse/ui/IActionBars.java;2;0;2;1;0;0;0;2;5;1;2;257;5;5;1;0;0;2;2;257;0;457;2;2;
/org.eclipse.pde.ui/src/org/eclipse/pde/internal/RunningInstanceManager.java;1;0;2;1;0;0;0;2;0;1;2;3348;0;0;1;0;0;2;2;3348;0;3579;2;1;
/org.eclipse.jdt.ui.tests.refactoring/resources/MoveMembers/test14/in/A.java;1;0;1;1;0;0;0;1;0;0;1;2738;0;0;1;0;0;1;1;2738;0;2738;1;1;
/org.eclipse.swt/Eclipse SWT Drag and Drop/gtk1x/org/eclipse/swt/dnd/Transfer.java;2;0;2;1;0;0;0;2;0;1;2;2107;0;0;1;0;0;2;2;2107;0;3127;2;2;
/org.eclipse.vcm.tests.core.cvs.ssh/src/org/eclipse/vcm/tests/core/ccvs/ssh/BlowfishTest.java;1;0;1;1;0;0;0;1;0;0;1;1688;0;0;1;0;0;1;1;1688;0;1688;1;1;
/org.eclipse.team.cvs.ssh/src/org/eclipse/team/internal/ccvs/ssh/ClientPacket.java;1;0;2;1;0;0;0;2;94;1;2;1978;94;94;1;0;0;2;2;1978;0;3102;2;1;
/org.eclipse.jdt.core/compiler/org/eclipse/jdt/internal/compiler/IHierarchyRequestor.java;1;0;3;1;0;0;0;3;15;1;3;455;15;15;1;0;0;3;3;455;0;2790;3;1;
/org.eclipse.jdt.ui.tests.refactoring/resources/PasteSourceReference/test1/out/B.java;1;0;1;1;0;0;0;1;0;0;1;2064;0;0;1;0;0;1;1;2064;0;2064;1;1;
/org.eclipse.core.tests.runtime/src/org/eclipse/core/tests/internal/plugins/PluginResolveTest_23.java;3;0;3;1;0;0;0;3;110;1;3;1794;120;120;1;0;0;3;3;1794;0;3476;3;3;
/org.eclipse.ui.tests/Eclipse UI Tests/org/eclipse/ui/tests/adaptable/NullLabelDecorator.java;1;0;1;1;0;0;0;1;0;0;1;2863;0;0;1;0;0;1;1;2863;0;2863;1;1;
/org.eclipse.ui.tests/Eclipse JFace Tests/org/eclipse/jface/tests/viewers/AllTests.java;1;0;1;1;0;0;0;1;0;0;1;1488;0;0;1;0;0;1;1;1488;0;1488;1;1;
/org.eclipse.ui/Eclipse JFace/org/eclipse/jface/resource/FileImageDescriptor.java;2;0;2;1;0;0;0;2;7;1;2;257;7;7;1;0;0;2;2;257;0;457;2;2;
/org.eclipse.help/src/org/eclipse/help/internal/protocols/HelpURL.java;2;0;5;2;0;0;0;5;27;2;4;3095;31;31;2;1;0;5;5;3743;1;3743;4;2;
/org.eclipse.jdt.ui/ui/org/eclipse/jdt/internal/ui/snippeteditor/SnippetEditorActionContributor.java;5;0;10;2;0;0;0;10;18;2;9;15;86;86;2;1;0;10;10;759;1;1916;9;5;
/org.eclipse.jdt.ui/core extension/org/eclipse/jdt/internal/corext/codegeneration/OrganizeImportsOperation.java;2;0;4;1;0;0;0;4;21;2;3;2016;21;21;2;1;0;4;4;2031;1;2137;3;2;
/org.eclipse.jdt.debug.ui/ui/org/eclipse/jdt/internal/debug/ui/launcher/JavaApplicationShortcut.java;2;2;5;2;5;4;5;0;9;0;0;4367;20;20;2;0;1;0;5;4402;1;4432;4;2;
/org.eclipse.core.boot/src/org/eclipse/core/internal/boot/update/LogStoreException.java;2;0;3;1;0;0;0;3;7;1;3;12;7;7;1;0;0;3;3;12;0;2726;3;2;
/org.eclipse.jdt.ui.tests.refactoring/test cases/org/eclipse/jdt/ui/tests/refactoring/RenamePackageTests.java;2;0;7;1;0;0;0;7;150;1;7;1896;215;215;1;0;0;7;7;1896;0;3373;7;2;
/org.eclipse.jdt.ui/ui/org/eclipse/jdt/internal/ui/packageview/FrameAction.java;1;0;3;1;0;0;0;3;4;1;3;213;4;4;1;0;0;3;3;213;0;390;3;1;
/org.eclipse.update.core/src/org/eclipse/update/core/model/FeatureReferenceModel.java;2;1;15;1;5;5;5;10;142;1;10;2409;494;494;1;0;0;10;15;2409;0;4424;15;2;
/org.eclipse.jdt.ui.tests.refactoring/resources/DeleteSourceReferenceEdit/A_testField1_in.java;1;0;1;1;0;0;0;1;0;0;1;2857;0;0;1;0;0;1;1;2857;0;2857;1;1;
/org.eclipse.jdt.ui/ui/org/eclipse/jdt/internal/ui/reorg/PasteSourceReferencesAction.java;2;0;11;1;0;0;0;11;137;2;9;2003;338;338;2;2;0;11;11;2003;2;3222;9;2;
/org.eclipse.update.ui.forms/src/org/eclipse/update/ui/forms/internal/engine/HTTPAction.java;1;0;1;1;0;0;0;1;0;0;1;2746;0;0;1;0;0;1;1;2746;0;2746;1;1;
/org.eclipse.debug.ui/ui/org/eclipse/debug/internal/ui/InspectorView.java;3;0;18;2;0;0;0;18;211;4;13;187;476;476;4;5;0;18;18;2307;5;2348;13;3;
/org.eclipse.core.tests.runtime/src/org/eclipse/core/tests/internal/plugins/PluginResolveTest_17.java;3;0;3;1;0;0;0;3;86;1;3;1794;96;96;1;0;0;3;3;1794;0;3476;3;3;
/org.eclipse.tomcat/src/org/eclipse/tomcat/TomcatClassLoader.java;2;0;3;2;0;0;0;3;18;2;2;2409;18;18;2;1;0;3;3;2409;1;3285;2;2;
/org.eclipse.jdt.ui/ui/org/eclipse/jdt/internal/ui/launcher/JavaProjectPropertyPage.java;5;0;7;1;0;0;0;7;78;1;7;15;142;142;1;0;0;7;7;15;0;1916;7;5;
/org.eclipse.jdt.ui/ui/org/eclipse/jdt/ui/wizards/NewJavaProjectWizardPage.java;4;1;26;1;5;5;5;21;125;3;19;15;532;532;3;2;0;21;26;1272;2;4852;24;4;
/org.eclipse.help/src/org/eclipse/help/internal/topics/HrefUtil.java;2;0;3;1;0;0;0;3;16;1;3;1675;16;16;1;0;0;3;3;1675;0;1857;3;2;
/org.eclipse.pde.core/src/org/eclipse/pde/internal/core/schema/FileSchemaDescriptor.java;1;0;2;1;0;0;0;2;21;1;2;3591;21;21;1;0;0;2;2;3591;0;3607;2;1;
/org.eclipse.jdt.debug/eval/org/eclipse/jdt/internal/debug/eval/ast/instructions/ArrayAllocation.java;3;0;6;1;0;0;0;6;28;1;6;3421;44;44;1;0;0;6;6;3421;0;3677;6;3;
/org.eclipse.vcm.core/src/org/eclipse/vcm/internal/core/Repository.java;5;0;9;2;0;0;0;9;56;2;8;0;111;111;2;1;0;9;9;292;1;983;8;5;
/org.eclipse.swt/Eclipse SWT/photon/org/eclipse/swt/internal/photon/PtTextCallback_t.java;2;0;3;1;0;0;0;3;6;1;3;106;6;6;1;0;0;3;3;106;0;2069;3;2;
/org.eclipse.pde.ui/src/org/eclipse/pde/internal/util/CoreUtility.java;1;0;2;1;0;0;0;2;0;1;2;2691;0;0;1;0;0;2;2;2691;0;3579;2;1;
/org.eclipse.scripting/src/org/eclipse/scripting/Renderer.java;1;0;1;1;0;0;0;1;0;0;1;1424;0;0;1;0;0;1;1;1424;0;1424;1;1;
/org.eclipse.jdt.debug/model/org/eclipse/jdt/internal/debug/core/breakpoints/JavaMethodBreakpoint.java;3;3;29;2;5;3;5;24;114;2;20;2646;723;723;3;4;2;24;29;4707;6;4707;23;3;
/org.eclipse.vcm.core.cvs/src/org/eclipse/vcm/internal/core/ccvs/requests/TagMessageHandler.java;2;0;3;1;0;0;0;3;9;1;3;0;15;15;1;0;0;3;3;0;0;415;3;2;
/org.eclipse.jdt.ui/ui/org/eclipse/jdt/internal/ui/actions/OpenSourceReferenceAction.java;4;0;6;1;0;0;0;6;73;1;6;15;91;91;1;0;0;6;6;15;0;1787;6;4;
/org.eclipse.core.tests.runtime/src/org/eclipse/core/tests/internal/plugins/ConflictResolveTest_1.java;3;0;3;1;0;0;0;3;126;1;3;1794;136;136;1;0;0;3;3;1794;0;3476;3;3;
/org.eclipse.jdt.junit/Eclipse JUnit/org/eclipse/jdt/junit/internal/ApplicationWizardPage.java;2;0;2;1;0;0;0;2;0;1;2;1531;0;0;1;0;0;2;2;1531;0;2007;2;2;
/org.eclipse.ui/Eclipse UI Standard Components/org/eclipse/ui/wizards/datatransfer/ExternalProjectImportWizard.java;1;0;2;1;0;0;0;2;4;1;2;3533;4;4;1;0;0;2;2;3533;0;3607;2;1;
/org.eclipse.jdt.ui.tests.refactoring/resources/ExtractMethodWorkSpace/ExtractMethodTests/return_in/A_test713.java;1;1;3;1;2;2;2;1;12;0;1;887;12;12;1;0;0;1;3;887;0;4419;3;1;
/org.eclipse.help.tests/src/org/eclipse/help/tests/launching/DisplayHelpResource_externalHref.java;1;0;1;1;1;1;1;0;0;0;0;4045;0;0;1;0;0;0;1;4045;0;4045;1;1;
/org.eclipse.ui/Eclipse UI Editor Support Win32/org/eclipse/ui/internal/editorsupport/win32/OleEditor.java;1;1;2;1;2;2;2;0;0;0;0;3936;0;0;1;0;0;0;2;3936;0;3952;2;1;
/org.eclipse.team.cvs.core/src/org/eclipse/team/internal/ccvs/core/ICVSResourceVisitor.java;1;0;3;1;0;0;0;3;17;1;3;3012;21;21;1;0;0;3;3;3012;0;3610;3;1;
/org.eclipse.ui.tests/Eclipse JFace Tests/org/eclipse/jface/tests/viewers/TableViewerTest.java;1;0;1;1;0;0;0;1;0;0;1;1488;0;0;1;0;0;1;1;1488;0;1488;1;1;
/org.eclipse.jdt.ui.tests.refactoring/resources/ExtractMethodWorkSpace/ExtractMethodTests/invalidSelection/A_test091.java;2;1;3;1;2;2;2;1;0;0;1;49;0;0;1;0;0;1;3;49;0;4419;3;2;
/org.eclipse.swt/Eclipse SWT/gtk1x/org/eclipse/swt/widgets/ProgressBar.java;3;0;3;1;1;1;1;2;6;1;2;2107;8;8;1;0;0;2;3;2107;0;4701;3;3;
/org.eclipse.pde.ui/src/org/eclipse/pde/ui/templates/TemplateOption.java;1;0;2;1;1;1;1;1;72;0;1;3840;72;72;1;0;0;1;2;3840;0;4752;2;1;
/org.eclipse.jdt.ui.tests.refactoring/resources/ExtractTemp/canExtract/A_test29_out.java;1;0;1;1;0;0;0;1;0;0;1;3210;0;0;1;0;0;1;1;3210;0;3210;1;1;
/org.eclipse.ui/Eclipse UI Standard Components/org/eclipse/ui/views/navigator/NavigatorFrameSource.java;4;0;6;1;1;1;1;5;21;1;5;257;32;32;1;0;0;5;6;257;0;4067;6;4;
/org.eclipse.swt.examples.paint/org/eclipse/swt/examples/paint/RoundedRectangleTool.java;4;0;5;2;1;1;1;4;82;2;3;586;84;84;2;1;0;4;5;609;1;4024;4;4;
/org.eclipse.search/search/org/eclipse/search/internal/ui/SortDropDownAction.java;2;0;11;1;0;0;0;11;92;2;10;15;171;171;2;1;0;11;11;1354;1;2677;10;2;
/org.eclipse.core.tests.resources/src/org/eclipse/core/tests/internal/localstore/BlobStoreTest.java;3;0;3;1;1;1;1;2;460;1;2;1794;480;480;1;0;0;2;3;1794;0;4516;3;3;
/org.eclipse.scripting/Eclipse Scripting/org/eclipse/scripting/internal/IXGRElementUIReadOnly.java;1;0;3;1;0;0;0;3;4;1;3;133;4;4;1;0;0;3;3;133;0;1424;3;1;
/org.eclipse.jdt.ui.tests.refactoring/resources/MoveMembers/test19/in/B.java;1;0;1;1;0;0;0;1;0;0;1;2738;0;0;1;0;0;1;1;2738;0;2738;1;1;
/org.eclipse.vcm.ui.cvs/src/org/eclipse/vcm/internal/ui/ccvs/FilterStreamUndoAction.java;1;0;1;1;0;0;0;1;12;0;1;1436;12;12;1;0;0;1;1;1436;0;1436;1;1;
/org.eclipse.swt.examples/src/org/eclipse/swt/examples/layoutexample/FillLayoutTab.java;3;1;4;1;2;2;2;2;39;1;2;3420;48;48;1;0;0;2;4;3420;0;4705;4;3;
/org.eclipse.core.resources/src/org/eclipse/core/internal/watson/IElementContentVisitor.java;1;0;4;1;1;1;1;3;46;1;3;12;67;67;1;0;0;3;4;12;0;4214;4;1;
/org.eclipse.jdt.ui/ui/org/eclipse/jdt/internal/ui/javaeditor/CompilationUnitEditor.java;10;2;104;3;30;26;30;74;419;4;59;15;4984;4984;4;15;4;74;104;3567;19;4837;85;10;
/org.eclipse.ui/Eclipse UI Standard Components/org/eclipse/ui/views/navigator/ResourceNavigatorMoveAction.java;5;0;7;1;0;0;0;7;40;1;7;257;72;72;1;0;0;7;7;257;0;3561;7;5;
/org.eclipse.ui/Eclipse JFace/org/eclipse/jface/viewers/TableLayout.java;3;0;3;1;0;0;0;3;5;1;3;257;9;9;1;0;0;3;3;257;0;620;3;3;
/org.eclipse.vcm.ui/src/org/eclipse/vcm/internal/ui/sync/MergeResource.java;5;0;10;2;0;0;0;10;17;2;9;48;70;70;2;1;0;10;10;295;1;1419;9;5;
/org.eclipse.compare/compare/org/eclipse/compare/IViewerCreator.java;1;0;2;1;0;0;0;2;5;1;2;14;5;5;1;0;0;2;2;14;0;329;2;1;
/org.eclipse.debug.ui/ui/org/eclipse/debug/internal/ui/actions/AbstractListenerActionDelegate.java;3;2;13;1;4;3;4;9;18;2;8;2919;86;86;2;1;1;9;13;3154;2;4423;11;3;
/org.eclipse.pde.core/src/org/eclipse/pde/internal/core/schema/SchemaObject.java;1;0;2;1;0;0;0;2;10;1;2;3591;10;10;1;0;0;2;2;3591;0;3607;2;1;
/org.eclipse.swt.tests/JUnit Tests/org/eclipse/swt/tests/junit/Test_org_eclipse_swt_custom_StyledTextContent.java;3;0;4;1;1;1;1;3;14;1;3;1792;27;27;1;0;0;3;4;1792;0;4706;4;3;
/org.eclipse.core.tests.runtime/src/org/eclipse/core/tests/internal/plugins/SoftPrereqTest_22.java;3;0;3;1;0;0;0;3;130;1;3;1794;140;140;1;0;0;3;3;1794;0;3476;3;3;
/org.eclipse.vcm.core.cvs/src/org/eclipse/vcm/internal/core/ccvs/requests/IEntryContentIterator.java;2;0;3;1;0;0;0;3;9;1;3;0;14;14;1;0;0;3;3;0;0;327;3;2;
/org.eclipse.jdt.ui.tests.refactoring/resources/RenamePrivateMethod/test26/out/A.java;1;0;1;1;0;0;0;1;0;0;1;49;0;0;1;0;0;1;1;49;0;49;1;1;
/org.eclipse.ui/Eclipse UI/org/eclipse/ui/part/WorkbenchPart.java;4;1;7;1;2;2;2;5;30;1;5;257;71;71;1;0;0;5;7;257;0;4363;7;4;
/org.eclipse.jdt.ui.tests.refactoring/resources/MoveMembers/testFail10/in/B.java;1;0;1;1;0;0;0;1;0;0;1;2738;0;0;1;0;0;1;1;2738;0;2738;1;1;
/org.eclipse.update.core/src/org/eclipse/update/internal/core/obsolete/FeatureExecutable.java;1;0;1;1;0;0;0;1;0;0;1;2463;0;0;1;0;0;1;1;2463;0;2463;1;1;
/org.eclipse.jdt.ui/ui/org/eclipse/jdt/internal/ui/reorg/PasteResourcesFromClipboardAction.java;3;1;12;2;4;4;4;8;75;2;7;3167;196;196;2;1;0;8;12;3826;1;4426;11;3;
/org.eclipse.core.tests.resources/src/org/eclipse/core/tests/internal/resources/TestNature.java;1;0;2;1;0;0;0;2;18;1;2;3075;18;18;1;0;0;2;2;3075;0;3400;2;1;
/org.eclipse.jdt.debug/jdi/org/eclipse/jdi/internal/event/ModificationWatchpointEventImpl.java;2;0;4;1;0;0;0;4;18;1;4;187;32;32;1;0;0;4;4;187;0;3670;4;2;
/org.eclipse.jdt.ui.tests.refactoring/resources/SurroundWithWorkSpace/SurroundWithTests/trycatch_in/TestWrappedLocal2.java;1;0;1;1;0;0;0;1;0;0;1;2327;0;0;1;0;0;1;1;2327;0;2327;1;1;
/org.eclipse.ui/Eclipse UI/org/eclipse/ui/dialogs/MultiElementListSelectionDialog.java;1;0;2;1;0;0;0;2;0;1;2;3733;0;0;1;0;0;2;2;3733;0;3740;2;1;
/org.eclipse.jdt.ui/ui/org/eclipse/jdt/ui/actions/FindDeclarationsInHierarchyAction.java;3;1;3;1;3;3;3;0;9;0;0;4141;13;13;1;0;0;0;3;4141;0;4770;3;3;
/org.eclipse.debug.ui/ui/org/eclipse/debug/internal/ui/AddToInspectorAction.java;3;0;6;1;0;0;0;6;17;1;6;187;40;40;1;0;0;6;6;187;0;2348;6;3;
/org.eclipse.jdt.ui/ui/org/eclipse/jdt/internal/ui/text/javadoc/JavaDocAutoIndentStrategy.java;2;0;5;1;0;0;0;5;18;1;5;15;39;39;1;0;0;5;5;15;0;770;5;2;
/org.eclipse.jdt.core/compiler/org/eclipse/jdt/internal/compiler/problem/AbortCompilation.java;2;0;3;1;1;1;1;2;49;1;2;455;66;66;1;0;0;2;3;455;0;4062;3;2;
/org.eclipse.jdt.debug.ui/ui/org/eclipse/jdt/internal/debug/ui/display/JavaInspectExpression.java;2;0;3;1;0;0;0;3;16;1;3;2347;19;19;1;0;0;3;3;2347;0;3719;3;2;
/org.eclipse.jdt.ui/ui/org/eclipse/jdt/ui/actions/OpenRefactoringWizardAction.java;2;1;4;1;4;4;4;0;11;0;0;3970;19;19;1;0;0;0;4;3970;0;4382;4;2;
/org.eclipse.team.ui/src/org/eclipse/team/ui/actions/UpdateAction.java;1;0;3;1;0;0;0;3;134;1;3;1978;134;134;1;0;0;3;3;1978;0;2434;3;1;
/org.eclipse.vcm.core.cvs/src/org/eclipse/vcm/internal/core/ccvs/utils/StringPair.java;2;0;3;1;0;0;0;3;5;1;3;101;9;9;1;0;0;3;3;101;0;1240;3;2;
/org.eclipse.pde.ui/src/org/eclipse/pde/internal/model/plugin/Fragment.java;1;0;2;1;0;0;0;2;0;1;2;3136;0;0;1;0;0;2;2;3136;0;3579;2;1;
/org.eclipse.help/src/org/eclipse/help/internal/protocols/search/Handler.java;3;0;5;1;0;0;0;5;17;1;5;2318;17;17;1;0;0;5;5;2318;0;2694;5;3;
/org.eclipse.pde.ui/src/org/eclipse/pde/internal/core/plugin/PluginLibrary.java;1;0;3;1;0;0;0;3;10;2;2;3579;10;10;2;1;0;3;3;3579;1;3607;2;1;
/org.eclipse.vcm.ui/src/org/eclipse/vcm/internal/ui/HistoryFilterAction.java;2;0;3;1;0;0;0;3;42;1;3;1131;45;45;1;0;0;3;3;1131;0;1568;3;2;
/org.eclipse.jdt.debug.ui/ui/org/eclipse/jdt/internal/debug/ui/display/DisplayAction.java;2;0;7;1;0;0;0;7;23;1;7;1915;54;54;1;0;0;7;7;1915;0;2813;7;2;
/org.eclipse.help.ui/Eclipse Help UI Win32/org/eclipse/help/internal/ui/win32/HelpControlSite.java;2;0;3;1;0;0;0;3;7;1;3;136;7;7;1;0;0;3;3;136;0;1420;3;2;
/org.eclipse.pde.core/src/org/eclipse/pde/internal/core/ifeature/IFeatureInstallHandler.java;1;0;1;1;0;0;0;1;0;0;1;3591;0;0;1;0;0;1;1;3591;0;3591;1;1;
/org.eclipse.jdt.core/compiler/org/eclipse/jdt/internal/compiler/ast/ExtendedStringLiteral.java;2;0;11;1;1;1;1;10;108;4;7;455;239;239;4;3;0;10;11;1039;3;4062;8;2;
/org.eclipse.jdt.ui.tests.refactoring/resources/RenameType/test31/in/AA.java;1;0;1;1;0;0;0;1;0;0;1;49;0;0;1;0;0;1;1;49;0;49;1;1;
/org.eclipse.jdt.ui.tests.refactoring/resources/RenameType/testFail40/in/A.java;1;0;1;1;0;0;0;1;0;0;1;49;0;0;1;0;0;1;1;49;0;49;1;1;
/org.eclipse.ui/Eclipse UI Standard Components/org/eclipse/ui/views/properties/PropertySheetPageContextComputer.java;3;0;3;1;0;0;0;3;13;1;3;257;18;18;1;0;0;3;3;257;0;3156;3;3;
/org.eclipse.jdt.debug.ui/ui/org/eclipse/jdt/internal/debug/ui/actions/ToggleDelegateAction.java;3;1;10;1;4;4;4;6;81;1;6;2398;139;139;1;0;0;6;10;2398;0;4371;10;3;
/org.eclipse.team.core/src/org/eclipse/team/internal/core/target/LocationMapping.java;3;2;5;2;5;4;5;0;36;0;0;4128;62;62;2;0;1;0;5;4128;1;4636;4;3;
/org.eclipse.jdt.ui/core refactoring/org/eclipse/jdt/core/refactoring/tagging/IRenameRefactoring.java;1;0;5;1;0;0;0;5;7;1;5;15;16;16;1;0;0;5;5;15;0;408;5;1;
/org.eclipse.team.cvs.core/src/org/eclipse/team/internal/ccvs/core/response/custom/DiffErrorHandler.java;2;0;4;1;0;0;0;4;88;1;4;1992;176;176;1;0;0;4;4;1992;0;2607;4;2;
/org.eclipse.scripting.examples/Eclipse Scripting Examples/org/eclipse/scripting/examples/ExcaliburScriptRenderer.java;2;0;4;1;0;0;0;4;4;1;4;134;8;8;1;0;0;4;4;134;0;1424;4;2;
/org.eclipse.ant.core/src/org/eclipse/ant/internal/core/old/EclipseCompilerAdapterFactory.java;1;0;1;1;0;0;0;1;0;0;1;3270;0;0;1;0;0;1;1;3270;0;3270;1;1;
/org.eclipse.debug.ui/ui/org/eclipse/debug/internal/ui/actions/ExecutionAction.java;3;2;15;2;4;3;4;11;154;2;10;2382;428;428;2;1;1;11;15;2481;2;4433;13;3;
/org.eclipse.jdt.ui.tests.refactoring/resources/ExtractTemp/canExtract/A_test16_in.java;1;0;1;1;0;0;0;1;0;0;1;2481;0;0;1;0;0;1;1;2481;0;2481;1;1;
/org.eclipse.vcm.tests.core/src/org/eclipse/vcm/tests/core/base/ITeamStreamTest.java;1;0;1;1;0;0;0;1;0;0;1;1688;0;0;1;0;0;1;1;1688;0;1688;1;1;
/org.eclipse.jdt.ui.tests.refactoring/resources/ExtractMethodWorkSpace/ExtractMethodTests/locals_out/A_test541.java;1;1;3;1;2;2;2;1;4;0;1;922;4;4;1;0;0;1;3;922;0;4419;3;1;
/org.eclipse.jdt.ui.tests.refactoring/resources/RenameType/test56/out/default/B.java;1;0;1;1;0;0;0;1;0;0;1;1547;0;0;1;0;0;1;1;1547;0;1547;1;1;
/org.eclipse.jdt.ui/ui refactoring/org/eclipse/jdt/internal/ui/refactoring/MoveCompilationUnitWizard.java;2;0;9;1;0;0;0;9;24;2;8;15;73;73;2;1;0;9;9;142;1;1258;8;2;
/org.eclipse.jdt.ui/nls/org/eclipse/jdt/internal/ui/nls/model/NLSSubstitution.java;1;0;2;1;0;0;0;2;0;1;2;1880;0;0;1;0;0;2;2;1880;0;1913;2;1;
/org.eclipse.jdt.ui/ui refactoring/org/eclipse/jdt/internal/ui/refactoring/actions/NewTextRefactoringAction.java;1;0;1;1;0;0;0;1;0;0;1;3791;0;0;1;0;0;1;1;3791;0;3791;1;1;
/org.eclipse.pde.ui/Eclipse PDE UI/org/eclipse/pde/internal/base/model/plugin/IJarEntry.java;2;0;5;2;0;0;0;5;12;3;3;267;12;12;3;2;0;5;5;324;2;1434;3;2;
/org.eclipse.swt.tests/JUnit Tests/org/eclipse/swt/tests/junit/Test_org_eclipse_swt_events_DisposeEvent.java;2;0;2;1;1;1;1;1;6;0;1;1792;6;6;1;0;0;1;2;1792;0;4706;2;2;
/org.eclipse.swt/Eclipse SWT PI/win32/org/eclipse/swt/internal/ole/win32/FORMATETC.java;2;0;2;1;1;1;1;1;6;0;1;2069;6;6;1;0;0;1;2;2069;0;4701;2;2;
/org.eclipse.swt/Eclipse SWT/carbon/org/eclipse/swt/widgets/Canvas.java;3;1;4;1;4;4;4;0;10;0;0;4147;20;20;1;0;0;0;4;4147;0;4701;4;3;
/org.eclipse.jdt.ui.tests.refactoring/resources/MoveMembers/test12/out/B.java;1;0;1;1;0;0;0;1;0;0;1;2738;0;0;1;0;0;1;1;2738;0;2738;1;1;
/org.eclipse.pde.ui/Eclipse PDE UI/org/eclipse/pde/internal/model/build/WorkspaceBuildModel.java;2;0;8;2;0;0;0;8;12;3;6;267;24;24;3;2;0;8;8;324;2;1434;6;2;
/org.eclipse.jdt.core/model/org/eclipse/jdt/core/util/ClassFormatException.java;2;1;6;1;5;5;5;1;18;0;1;3629;38;38;1;0;0;1;6;3629;0;4493;6;2;
/org.eclipse.jdt.launching/launching/org/eclipse/jdt/internal/launching/StandardVMRunner.java;4;2;17;1;8;7;8;9;74;1;9;3122;260;260;2;0;1;9;17;4214;1;4449;16;4;
/org.eclipse.jdt.ui.tests.refactoring/resources/MoveMembers/test10/in/A.java;1;0;1;1;0;0;0;1;0;0;1;2738;0;0;1;0;0;1;1;2738;0;2738;1;1;
/org.eclipse.jdt.core/compiler/org/eclipse/jdt/internal/compiler/codegen/CaseLabel.java;2;0;4;1;1;1;1;3;126;1;3;455;143;143;1;0;0;3;4;455;0;4062;4;2;
/org.eclipse.jdt.launching/launching/org/eclipse/jdt/launching/AbstractVMConnector.java;1;0;2;1;0;0;0;2;0;1;2;3401;0;0;1;0;0;2;2;3401;0;3453;2;1;
/org.eclipse.help.ui/src/org/eclipse/help/ui/internal/HyperlinkAdapter.java;1;0;1;1;1;1;1;0;0;0;0;4439;0;0;1;0;0;0;1;4439;0;4439;1;1;
/org.eclipse.core.resources/src/org/eclipse/core/internal/watson/ElementSubtree.java;2;0;5;1;1;1;1;4;156;1;4;12;185;185;1;0;0;4;5;12;0;4214;5;2;
/org.eclipse.jdt.core/dom/org/eclipse/jdt/core/dom/CharacterLiteral.java;3;1;15;2;2;2;2;13;79;2;11;2669;213;213;2;2;0;13;15;2773;2;4421;13;3;
/org.eclipse.jdt.ui/ui/org/eclipse/jdt/internal/ui/util/CoreUtility.java;3;0;4;1;1;1;1;3;38;1;3;15;65;65;1;0;0;3;4;15;0;4117;4;3;
/org.eclipse.jdt.ui.tests.refactoring/resources/DeleteSourceReferenceEdit/A_test1_out.java;1;0;1;1;0;0;0;1;0;0;1;2857;0;0;1;0;0;1;1;2857;0;2857;1;1;
/org.eclipse.jdt.launching/launching/org/eclipse/jdt/internal/launching/StandardVMType.java;2;1;7;1;5;5;5;2;2;1;2;3122;12;12;1;0;0;2;7;3122;0;4693;7;2;
/org.eclipse.jdt.ui.tests.refactoring/resources/RenameType/test33/out/B.java;1;0;1;1;0;0;0;1;0;0;1;522;0;0;1;0;0;1;1;522;0;522;1;1;
/org.eclipse.jdt.ui/ui debug/org/eclipse/jdt/internal/debug/ui/display/DisplayViewerConfiguration.java;3;0;6;2;0;0;0;6;41;2;5;1364;68;68;2;1;0;6;6;1407;1;1916;5;3;
/org.eclipse.jdt.ui.tests.refactoring/resources/RenameTemp/canRename/A_test22_in.java;1;0;2;1;0;0;0;2;2;1;2;1625;2;2;1;0;0;2;2;1625;0;1652;2;1;
/org.eclipse.swt/Eclipse SWT PI/photon/org/eclipse/swt/internal/photon/PtFileSelectionInfo_t.java;2;0;2;1;1;1;1;1;6;0;1;2069;6;6;1;0;0;1;2;2069;0;4701;2;2;
/org.eclipse.debug.ui/ui/org/eclipse/debug/internal/ui/EnableDisableBreakpointAction.java;3;0;16;1;0;0;0;16;57;1;16;187;196;196;1;0;0;16;16;187;0;2382;16;3;
/org.eclipse.core.tests.resources/src/org/eclipse/core/tests/internal/indexing/IntegratedPageStoreTest.java;3;0;3;1;1;1;1;2;24;1;2;1794;34;34;1;0;0;2;3;1794;0;4516;3;3;
/org.eclipse.pde.ui/src/org/eclipse/pde/internal/wizards/imports/BinaryProjectDecorator.java;1;0;4;1;0;0;0;4;2;1;4;2847;4;4;1;0;0;4;4;2847;0;3579;4;1;
/org.eclipse.swt.tests/JUnit Tests/org/eclipse/swt/tests/junit/Test_org_eclipse_swt_events_MenuAdapter.java;2;0;2;1;1;1;1;1;6;0;1;1792;6;6;1;0;0;1;2;1792;0;4706;2;2;
/org.eclipse.jdt.ui.tests.refactoring/resources/ExtractMethodWorkSpace/ExtractMethodTests/try_in/A_test450.java;2;1;4;1;2;2;2;2;18;1;2;65;19;19;1;0;0;2;4;65;0;4419;4;2;
/org.eclipse.jdt.core/model/org/eclipse/jdt/internal/core/util/CodeAttribute.java;3;2;6;2;4;3;4;2;23;0;1;3629;63;63;2;1;1;2;6;3629;2;4421;4;3;
/org.eclipse.scripting/Eclipse Scripting/org/eclipse/scripting/IDataModel.java;2;0;5;1;0;0;0;5;13;1;5;133;20;20;1;0;0;5;5;133;0;1424;5;2;
/org.eclipse.jdt.ui/ui/org/eclipse/jdt/internal/ui/text/link/LinkedPositionManager.java;2;0;8;2;0;0;0;8;113;2;6;1720;316;316;2;2;0;8;8;1720;2;2098;6;2;
/org.eclipse.jdt.debug/jdi/org/eclipse/jdi/internal/connect/SocketRawLaunchingConnectorImpl.java;3;0;7;1;1;1;1;6;24;1;6;187;80;80;1;0;0;6;7;187;0;4423;7;3;
/org.eclipse.swt.examples/src/org/eclipse/swt/examples/imageanalyzer/ImageAnalyzer.java;6;1;15;1;4;4;4;11;1858;1;11;554;2696;2696;1;0;0;11;15;554;0;4725;15;6;
/org.eclipse.jdt.debug/model/org/eclipse/jdt/internal/debug/core/JDIVoidValue.java;4;0;8;1;0;0;0;8;17;1;8;187;60;60;1;0;0;8;8;187;0;2517;8;4;
/org.eclipse.swt/Eclipse SWT Custom Widgets/common_j2se/org/eclipse/swt/custom/ViewForm.java;1;0;1;1;0;0;0;1;0;0;1;1378;0;0;1;0;0;1;1;1378;0;1378;1;1;
/org.eclipse.webdav/src/interface/org/eclipse/webdav/IServerFactory.java;2;0;4;1;1;1;1;3;52;1;3;1635;94;94;1;0;0;3;4;1635;0;4211;4;2;
/org.eclipse.pde.ui/src/org/eclipse/pde/internal/feature/BuildConsoleViewer.java;1;0;2;1;0;0;0;2;0;1;2;2951;0;0;1;0;0;2;2;2951;0;3579;2;1;
/org.eclipse.jdt.ui/ui/org/eclipse/jdt/ui/JavaElementContentProvider.java;6;2;32;2;10;8;10;22;297;1;22;15;669;669;2;0;2;22;32;4418;2;4810;30;6;
/org.eclipse.core.target/src/org/eclipse/core/internal/target/DeploymentStatus.java;2;0;6;1;1;1;1;5;188;1;5;12;263;263;1;0;0;5;6;12;0;4196;6;2;
/org.eclipse.swt/Eclipse SWT/common/org/eclipse/swt/internal/image/LEDataInputStream.java;3;0;5;1;1;1;1;4;134;1;4;106;231;231;1;0;0;4;5;106;0;4701;5;3;
/org.eclipse.jdt.debug.tests/tests/org/eclipse/jdt/debug/tests/eval/NestedTypeFieldValue_653.java;2;1;3;1;3;3;3;0;12;0;0;4447;14;14;1;0;0;0;3;4447;0;4571;3;2;
/org.eclipse.jdt.launching/launching/org/eclipse/jdt/internal/launching/StandardVMDebugger.java;3;2;17;2;9;7;9;8;119;2;7;3122;260;260;2;1;2;8;17;3511;3;4449;14;3;
/org.eclipse.core.resources/src/org/eclipse/core/internal/indexing/PageStore.java;3;1;7;1;2;2;2;5;1106;1;5;12;2006;2006;1;0;0;5;7;12;0;4632;7;3;
/org.eclipse.scripting/src/org/eclipse/scripting/internal/IXGRDataModel.java;1;0;1;1;0;0;0;1;0;0;1;1424;0;0;1;0;0;1;1;1424;0;1424;1;1;
/org.eclipse.jdt.ui.tests.refactoring/resources/PullUpMethods/testFail6/in/A.java;1;0;2;1;0;0;0;2;0;1;2;2156;0;0;1;0;0;2;2;2156;0;2406;2;1;
/org.eclipse.compare/compare/org/eclipse/compare/BufferedContent.java;2;0;3;1;0;0;0;3;5;1;3;14;8;8;1;0;0;3;3;14;0;1802;3;2;
/org.eclipse.jdt.ui.tests.refactoring/resources/ExtractMethodWorkSpace/ExtractMethodTests/X.java;2;1;5;1;2;2;2;3;42;1;3;511;96;96;1;0;0;3;5;511;0;4419;5;2;
/org.eclipse.jdt.ui/core refactoring/org/eclipse/jdt/internal/core/refactoring/util/AST.java;1;0;3;1;0;0;0;3;4;1;3;1453;4;4;1;0;0;3;3;1453;0;1939;3;1;
/org.eclipse.jdt.core/eval/org/eclipse/jdt/internal/eval/CodeSnippetThisReference.java;2;1;14;1;2;2;2;12;137;4;8;455;193;193;4;4;0;12;14;1039;4;4062;10;2;
/org.eclipse.help/src/org/eclipse/help/internal/protocols/TocURL.java;2;0;5;1;0;0;0;5;45;1;5;3095;107;107;1;0;0;5;5;3095;0;3776;5;2;
/org.eclipse.jdt.ui.tests.refactoring/resources/SelectionAnalyzerWorkSpace/SelectionAnalyzerTests/validSelection/A_test284.java;1;0;1;1;0;0;0;1;0;0;1;1368;0;0;1;0;0;1;1;1368;0;1368;1;1;
/org.eclipse.debug.ui/ui/org/eclipse/debug/internal/ui/actions/RunLastAction.java;3;1;3;1;3;3;3;0;14;0;0;4043;25;25;1;0;0;0;3;4043;0;4567;3;3;
/org.eclipse.jdt.ui/core refactoring/org/eclipse/jdt/internal/corext/refactoring/sef/EncapsulatePostfixAccess.java;1;0;3;1;0;0;0;3;4;1;3;2876;6;6;1;0;0;3;3;2876;0;3150;3;1;
/org.eclipse.ui.externaltools/External Tools/org/eclipse/ui/externaltools/internal/ui/AntTreeContentProvider.java;1;1;2;1;2;2;2;0;0;0;0;4090;0;0;1;0;0;0;2;4090;0;4145;2;1;
/org.eclipse.ui/Eclipse JFace/org/eclipse/jface/preference/PreferenceDialog.java;6;2;30;2;7;6;7;23;121;3;18;257;513;513;3;5;1;23;30;1095;6;4452;24;6;
/org.eclipse.jdt.debug.tests/test plugin/org/eclipse/jdt/debug/testplugin/JavaTestSetup.java;2;1;3;1;2;2;2;1;24;0;1;3701;24;24;1;0;0;1;3;3701;0;4566;3;2;
/org.eclipse.scripting/src/org/eclipse/scripting/internal/IXGRElementUILayoutTableElement.java;1;0;1;1;0;0;0;1;0;0;1;1424;0;0;1;0;0;1;1;1424;0;1424;1;1;
/org.eclipse.pde.ui/src/org/eclipse/pde/internal/component/BuildPluginWizardPage.java;2;0;3;1;0;0;0;3;25;1;3;1434;25;25;1;0;0;3;3;1434;0;2951;3;2;
/org.eclipse.pde.ui/src/org/eclipse/pde/internal/editor/component/ComponentPropertySource.java;2;0;2;1;0;0;0;2;0;1;2;1434;0;0;1;0;0;2;2;1434;0;2951;2;2;
/org.eclipse.jdt.ui/core refactoring/org/eclipse/jdt/internal/core/refactoring/changes/DeleteChange.java;1;0;2;1;0;0;0;2;0;1;2;1108;0;0;1;0;0;2;2;1108;0;1257;2;1;
/org.eclipse.update.ui/src/org/eclipse/update/internal/ui/security/BannerPage.java;1;0;1;1;0;0;0;1;0;0;1;3872;0;0;1;0;0;1;1;3872;0;3872;1;1;
/org.eclipse.pde.ui/src/org/eclipse/pde/internal/ui/editor/manifest/ManifestExtensionsPage.java;1;0;1;1;0;0;0;1;0;0;1;3579;0;0;1;0;0;1;1;3579;0;3579;1;1;
/org.eclipse.jdt.core/model/org/eclipse/jdt/internal/core/builder/impl/StateSnapV6.java;1;0;3;1;0;0;0;3;93;1;3;455;93;93;1;0;0;3;3;455;0;2808;3;1;
/org.eclipse.ui/Eclipse UI Standard Components/org/eclipse/ui/views/navigator/ResourceSelectionUtil.java;2;1;4;1;2;2;2;2;21;1;2;1832;43;43;1;0;0;2;4;1832;0;3917;4;2;
/org.eclipse.update.ui/src/org/eclipse/update/ui/internal/manager/MainForm.java;1;0;2;1;0;0;0;2;0;0;1;1426;0;0;2;1;0;2;2;1426;1;1426;1;1;
/org.eclipse.vcm.ui/src/org/eclipse/vcm/internal/ui/actions/UpdateAction.java;1;0;1;1;0;0;0;1;0;0;1;1451;0;0;1;0;0;1;1;1451;0;1451;1;1;
/org.eclipse.jdt.debug/model/org/eclipse/jdt/internal/debug/core/breakpoints/JavaExceptionBreakpoint.java;3;0;20;2;1;1;1;19;184;2;16;2517;675;675;2;3;0;19;20;2517;3;4063;17;3;
/org.eclipse.jdt.ui.tests.refactoring/resources/RenameMethodInInterface/test41/in/A.java;1;0;1;1;0;0;0;1;0;0;1;49;0;0;1;0;0;1;1;49;0;49;1;1;
/org.eclipse.jdt.ui.tests.refactoring/resources/RenamePrivateMethod/test10/in/A.java;1;0;1;1;0;0;0;1;0;0;1;49;0;0;1;0;0;1;1;49;0;49;1;1;
/org.eclipse.core.runtime/src/org/eclipse/core/runtime/IAdaptable.java;3;0;4;1;1;1;1;3;80;1;3;12;101;101;1;0;0;3;4;12;0;4214;4;3;
/org.eclipse.pde.ui/src/org/eclipse/pde/internal/schema/SchemaObject.java;2;0;6;1;0;0;0;6;193;1;6;1434;204;204;1;0;0;6;6;1434;0;3579;6;2;
/org.eclipse.jdt.ui.tests.refactoring/resources/MoveMembers/test18/in/A.java;1;0;1;1;0;0;0;1;0;0;1;2738;0;0;1;0;0;1;1;2738;0;2738;1;1;
/org.eclipse.jdt.ui.tests.refactoring/resources/PullUp/test9/in/A.java;1;0;1;1;0;0;0;1;0;0;1;2406;0;0;1;0;0;1;1;2406;0;2406;1;1;
/org.eclipse.team.cvs.core/src/org/eclipse/team/internal/ccvs/core/client/listeners/LogListener.java;3;1;9;1;2;2;2;7;141;1;7;2572;216;216;1;0;0;7;9;2572;0;4249;9;3;
/org.eclipse.jdt.debug.ui/ui/org/eclipse/jdt/internal/debug/ui/JDIDebugUIAdapterFactory.java;1;0;2;1;1;1;1;1;2;0;1;2378;2;2;1;0;0;1;2;2378;0;4431;2;1;
/org.eclipse.jdt.ui/ui/org/eclipse/jdt/internal/ui/packageview/EmptyPackageFilter.java;2;0;3;1;1;1;1;2;9;1;2;15;9;9;1;0;0;2;3;15;0;4211;3;2;
/org.eclipse.jdt.ui.tests.refactoring/resources/RenamePrivateMethod/testFail2/in/A.java;1;0;1;1;0;0;0;1;0;0;1;49;0;0;1;0;0;1;1;49;0;49;1;1;
/org.eclipse.pde.ui/src/org/eclipse/pde/internal/model/component/WorkspaceComponentModel.java;2;0;3;1;0;0;0;3;25;1;3;1434;25;25;1;0;0;3;3;1434;0;2951;3;2;
/org.eclipse.pde.core/src/org/eclipse/pde/core/build/IBuild.java;1;0;3;1;2;1;2;1;40;0;1;3591;40;40;2;0;1;1;3;4751;1;4751;2;1;
/org.eclipse.ui/Eclipse JFace/org/eclipse/jface/dialogs/ProgressIndicator.java;2;0;2;1;0;0;0;2;5;1;2;257;5;5;1;0;0;2;2;257;0;457;2;2;
/org.eclipse.scripting/src/org/eclipse/scripting/internal/views/ScriptUIEditorDesignerCanvas.java;1;0;1;1;0;0;0;1;0;0;1;1424;0;0;1;0;0;1;1;1424;0;1424;1;1;
/org.eclipse.jdt.ui/ui/org/eclipse/jdt/internal/ui/preferences/ImportOrganizeInputDialog.java;4;0;10;1;1;1;1;9;16;1;9;1272;69;69;1;0;0;9;10;1272;0;4630;10;4;
/org.eclipse.pde.ui/src/org/eclipse/pde/internal/ui/editor/schema/SchemaEditor.java;1;0;4;1;0;0;0;4;26;2;3;3579;44;44;2;1;0;4;4;3579;1;3802;3;1;
/org.eclipse.ui/Eclipse JFace Text/org/eclipse/jface/text/rules/ICharacterScanner.java;3;0;3;1;0;0;0;3;15;1;3;257;20;20;1;0;0;3;3;257;0;1066;3;3;
/org.eclipse.core.resources/src/org/eclipse/core/internal/dtree/DataTreeLookup.java;2;0;6;1;1;1;1;5;134;1;5;12;227;227;1;0;0;5;6;12;0;4214;6;2;
/org.eclipse.jdt.ui.tests.refactoring/test cases/org/eclipse/jdt/ui/tests/refactoring/infra/TestExceptionHandler.java;1;0;2;1;0;0;0;2;2;1;2;1896;2;2;1;0;0;2;2;1896;0;1939;2;1;
/org.eclipse.jdt.junit/src/org/eclipse/jdt/internal/junit/util/SWTUtil.java;1;0;1;1;1;1;1;0;0;0;0;4161;0;0;1;0;0;0;1;4161;0;4161;1;1;
/org.eclipse.ui/Eclipse UI/org/eclipse/ui/IActionDelegateWithEvent.java;1;0;1;1;0;0;0;1;0;0;1;2329;0;0;1;0;0;1;1;2329;0;2329;1;1;
/org.eclipse.debug.ui/ui/org/eclipse/debug/internal/ui/DebugActionGroupsManager.java;3;0;11;1;1;1;1;10;73;2;8;3257;164;164;2;2;0;10;11;3629;2;3975;9;3;
/org.eclipse.jdt.debug/eval/org/eclipse/jdt/debug/eval/ast/model/IType.java;1;0;2;1;0;0;0;2;0;1;2;3329;0;0;1;0;0;2;2;3329;0;3421;2;1;
/org.eclipse.jdt.ui.tests.refactoring/resources/RenameType/test30/out/A.java;1;0;2;1;0;0;0;2;0;1;2;49;0;0;1;0;0;2;2;49;0;522;2;1;
/org.eclipse.team.webdav/src/org/eclipse/team/internal/webdav/ui/WebDavConfigurationWizard.java;3;3;17;2;17;13;17;0;132;0;0;4073;303;303;3;0;4;0;17;4149;4;4636;13;3;
/org.eclipse.pde.ui/src/org/eclipse/pde/internal/editor/SubActionBars.java;2;0;2;1;0;0;0;2;0;1;2;1434;0;0;1;0;0;2;2;1434;0;3579;2;2;
/org.eclipse.update.tests.core/src/org/eclipse/update/tests/implementation/SiteFTP.java;2;0;16;1;0;0;0;16;78;2;15;2291;196;196;2;1;0;16;16;2434;1;3575;15;2;
/org.eclipse.swt.examples/src/org/eclipse/swt/examples/explorer/TreeExpandDropListener.java;1;0;1;1;0;0;0;1;0;0;1;513;0;0;1;0;0;1;1;513;0;513;1;1;
/org.eclipse.jdt.debug/eval/org/eclipse/jdt/internal/debug/eval/ast/EvaluationVM.java;1;0;3;1;0;0;0;3;320;1;3;3329;320;320;1;0;0;3;3;3329;0;3421;3;1;
/org.eclipse.compare/compare/org/eclipse/compare/internal/ViewerSwitchingCancelled.java;1;0;1;1;0;0;0;1;0;0;1;1802;0;0;1;0;0;1;1;1802;0;1802;1;1;
/org.eclipse.jdt.ui.tests.refactoring/resources/ExtractMethodWorkSpace/ExtractMethodTests/locals_out/A_test522.java;1;1;4;1;2;2;2;2;42;1;2;1851;45;45;1;0;0;2;4;1851;0;4419;4;1;
/org.eclipse.pde.ui/src/org/eclipse/pde/internal/model/feature/VersionableObject.java;1;0;4;1;0;0;0;4;53;2;3;2951;57;57;2;1;0;4;4;2951;1;3579;3;1;
/org.eclipse.scripting/Eclipse Scripting/org/eclipse/scripting/internal/views/ScriptDevelopmentPreferencePageWorkbenchImport.java;2;0;4;1;0;0;0;4;4;1;4;133;8;8;1;0;0;4;4;133;0;1424;4;2;
/org.eclipse.jdt.ui.tests.refactoring/resources/ExtractMethodWorkSpace/ExtractMethodTests/validSelection/A_test306.java;2;1;3;1;2;2;2;1;0;0;1;49;0;0;1;0;0;1;3;49;0;4419;3;2;
/org.eclipse.ui/Eclipse JFace Text/org/eclipse/jface/text/ITextSelection.java;3;0;3;1;0;0;0;3;29;1;3;257;34;34;1;0;0;3;3;257;0;1066;3;3;
/org.eclipse.swt/Eclipse SWT Program/motif/org/eclipse/swt/program/Program.java;11;1;20;2;3;3;3;17;1710;1;17;106;1863;1863;1;0;0;17;20;106;0;4701;20;11;
/org.eclipse.swt/Eclipse SWT OLE Win32/win32/org/eclipse/swt/internal/ole/win32/IViewObject2.java;2;0;3;1;0;0;0;3;5;1;3;106;5;5;1;0;0;3;3;106;0;2069;3;2;
/org.eclipse.pde.ui/src/org/eclipse/pde/internal/base/model/component/IComponentURL.java;2;0;2;1;0;0;0;2;0;1;2;1434;0;0;1;0;0;2;2;1434;0;2951;2;2;
/org.eclipse.vcm.ui.cvs/src/org/eclipse/vcm/internal/ui/ccvs/GenerateDiffFileOperation.java;1;0;4;1;0;0;0;4;104;3;2;1549;104;104;3;2;0;4;4;1556;2;1556;2;1;
/org.eclipse.swt.tests/JUnit Tests/org/eclipse/swt/tests/junit/Test_org_eclipse_swt_custom_TableTreeEditor.java;2;0;2;1;1;1;1;1;6;0;1;1792;6;6;1;0;0;1;2;1792;0;4706;2;2;
/org.eclipse.core.tests.runtime/src/org/eclipse/core/tests/internal/plugins/PluginXmlTest.java;4;0;4;1;0;0;0;4;304;1;4;1794;319;319;1;0;0;4;4;1794;0;3476;4;4;
/org.eclipse.swt/Eclipse SWT PI/photon/org/eclipse/swt/internal/photon/PtColorSelectInfo_t.java;2;0;2;1;1;1;1;1;6;0;1;2069;6;6;1;0;0;1;2;2069;0;4701;2;2;
/org.eclipse.update/Eclipse Update/org/eclipse/update/internal/ui/KeyStores.java;2;0;4;1;0;0;0;4;165;1;4;108;169;169;1;0;0;4;4;108;0;1424;4;2;
/org.eclipse.ui/Eclipse UI Standard Components/org/eclipse/ui/views/tasklist/IMarkerConstants.java;3;0;4;1;1;1;1;3;12;1;3;257;19;19;1;0;0;3;4;257;0;4269;4;3;
/org.eclipse.swt/Eclipse SWT/win32/org/eclipse/swt/internal/win32/ACCEL.java;2;0;3;1;0;0;0;3;5;1;3;106;5;5;1;0;0;3;3;106;0;2069;3;2;
/org.eclipse.swt/Eclipse SWT/common/org/eclipse/swt/internal/image/PngPlteChunk.java;3;0;4;1;1;1;1;3;12;1;3;106;21;21;1;0;0;3;4;106;0;4701;4;3;
/org.eclipse.vcm.ui.cvs/src/org/eclipse/vcm/internal/ui/ccvs/RemoveVersionAction.java;1;0;3;1;0;0;0;3;136;1;3;1231;142;142;1;0;0;3;3;1231;0;1260;3;1;
/org.eclipse.jdt.ui/core refactoring/org/eclipse/jdt/internal/corext/refactoring/changes/DeleteSourceManipulationChange.java;2;0;4;1;1;1;1;3;34;1;3;1939;43;43;1;0;0;3;4;1939;0;3947;4;2;
/org.eclipse.pde.build/src/org/eclipse/pde/internal/build/ExecTask.java;3;0;5;1;0;0;0;5;26;1;5;1331;31;31;1;0;0;5;5;1331;0;3089;5;3;
/org.eclipse.jdt.ui.tests.refactoring/resources/RenameType/testFail51/in/A.java;1;0;1;1;0;0;0;1;0;0;1;49;0;0;1;0;0;1;1;49;0;49;1;1;
/org.eclipse.jdt.ui.tests.refactoring/resources/ExtractMethodWorkSpace/ExtractMethodTests/locals_in/A_test512.java;2;1;5;1;2;2;2;3;11;1;3;254;21;21;1;0;0;3;5;254;0;4419;5;2;
/org.eclipse.swt.examples/org/eclipse/swt/examples/controlexample/LabelTab.java;6;1;8;1;3;3;3;5;269;1;5;513;524;524;1;0;0;5;8;513;0;4024;8;6;
/org.eclipse.pde.ui/src/org/eclipse/pde/internal/ui/preferences/TextOption.java;1;0;2;1;0;0;0;2;0;1;2;3579;0;0;1;0;0;2;2;3579;0;3634;2;1;
/org.eclipse.update.ui.forms/src/org/eclipse/update/ui/forms/internal/engine/ParagraphSegment.java;1;0;1;1;0;0;0;1;0;0;1;2745;0;0;1;0;0;1;1;2745;0;2745;1;1;
/org.eclipse.jdt.ui/ui refactoring/org/eclipse/jdt/internal/ui/nls/ExternalizeWizardPage2.java;1;0;2;1;0;0;0;2;0;1;2;1913;0;0;1;0;0;2;2;1913;0;1922;2;1;
/org.eclipse.jdt.ui/ui/org/eclipse/jdt/internal/ui/launcher/JavaUISourceLocator.java;2;0;2;1;0;0;0;2;0;1;2;1739;0;0;1;0;0;2;2;1739;0;1916;2;2;
/org.eclipse.compare/compare/org/eclipse/compare/structuremergeviewer/IStructureComparator.java;1;0;2;1;0;0;0;2;5;1;2;14;5;5;1;0;0;2;2;14;0;329;2;1;
/org.eclipse.jdt.ui/core extension/org/eclipse/jdt/internal/corext/dom/SelectionAnalyzer.java;2;0;4;1;1;1;1;3;12;1;3;3006;27;27;1;0;0;3;4;3006;0;4419;4;2;
/org.eclipse.swt/Eclipse SWT PI/gtk/org/eclipse/swt/internal/gtk/GtkItem.java;1;0;2;1;0;0;0;2;0;1;2;2107;0;0;1;0;0;2;2;2107;0;3209;2;1;
/org.eclipse.jdt.core/model/org/eclipse/jdt/internal/core/builder/impl/DeltaImpl.java;1;0;11;1;0;0;0;11;546;4;7;455;928;928;4;4;0;11;11;1039;4;2808;7;1;
/org.eclipse.pde.ui/Eclipse PDE UI/org/eclipse/pde/internal/editor/schema/NewAttributeAction.java;2;0;5;2;0;0;0;5;12;3;3;267;12;12;3;2;0;5;5;324;2;1434;3;2;
/org.eclipse.ui/Eclipse UI/org/eclipse/ui/actions/NewWizardAction.java;6;0;7;1;1;1;1;6;46;1;6;257;69;69;1;0;0;6;7;257;0;4368;7;6;
/org.eclipse.jdt.ui.tests.refactoring/resources/RenameVariables/canRename/A_test19_out.java;1;0;2;1;0;0;0;2;0;1;2;724;0;0;1;0;0;2;2;724;0;1665;2;1;
/org.eclipse.jdt.ui.tests.refactoring/resources/SelectionAnalyzerWorkSpace/SelectionAnalyzerTests/validSelection/A_test130_.java;1;0;1;1;0;0;0;1;0;0;1;2139;0;0;1;0;0;1;1;2139;0;2139;1;1;
/org.eclipse.jdt.ui/core refactoring/org/eclipse/jdt/internal/corext/refactoring/base/FileContext.java;2;0;3;1;1;1;1;2;4;1;2;1939;6;6;1;0;0;2;3;1939;0;4014;3;2;
/org.eclipse.team.cvs.core/src/org/eclipse/team/internal/ccvs/core/IConnectionMethod.java;2;0;4;1;0;0;0;4;62;1;4;1978;126;126;1;0;0;4;4;1978;0;3610;4;2;
/org.eclipse.jdt.debug/eval/org/eclipse/jdt/internal/debug/eval/ast/engine/PushChar.java;1;0;3;1;0;0;0;3;56;1;3;3329;56;56;1;0;0;3;3;3329;0;3421;3;1;
/org.eclipse.scripting/src/org/eclipse/scripting/internal/IXGRElementUIReadOnly.java;1;0;1;1;0;0;0;1;0;0;1;1424;0;0;1;0;0;1;1;1424;0;1424;1;1;
/org.eclipse.swt/Eclipse SWT/win32/org/eclipse/swt/widgets/Text.java;9;3;24;1;9;6;9;15;131;1;15;106;422;422;3;0;3;15;24;4554;3;4701;21;9;
/org.eclipse.update.ui/src/org/eclipse/update/internal/ui/manager/NewSearchDialog.java;1;0;3;1;0;0;0;3;6;2;2;3553;6;6;2;1;0;3;3;3653;1;3653;2;1;
/org.eclipse.jdt.ui/ui/org/eclipse/jdt/internal/ui/snippeteditor/ScrapbookLauncher.java;5;0;14;1;0;0;0;14;86;1;14;15;314;314;1;0;0;14;14;15;0;1313;14;5;
/org.eclipse.swt/Eclipse SWT PI/win32/org/eclipse/swt/internal/ole/win32/IEnumSTATSTG.java;2;0;2;1;1;1;1;1;6;0;1;2069;6;6;1;0;0;1;2;2069;0;4701;2;2;
/org.eclipse.jdt.ui.tests.refactoring/resources/PullUp/testFail2/in/A.java;1;0;1;1;0;0;0;1;0;0;1;2406;0;0;1;0;0;1;1;2406;0;2406;1;1;
/org.eclipse.swt/Eclipse SWT/gtk/org/eclipse/swt/widgets/Sash.java;6;1;14;1;4;4;4;10;295;3;8;2107;659;659;3;2;0;10;14;3384;2;4701;12;6;
/org.eclipse.jdt.ui.tests.refactoring/resources/SelectionAnalyzerWorkSpace/SelectionAnalyzerTests/invalidSelection/A_test142.java;2;0;2;1;0;0;0;2;0;1;2;1368;0;0;1;0;0;2;2;1368;0;2139;2;2;
/org.eclipse.jdt.ui.tests/test plugin/org/eclipse/jdt/testplugin/Main.java;1;0;1;1;0;0;0;1;0;0;1;2439;0;0;1;0;0;1;1;2439;0;2439;1;1;
/org.eclipse.pde.ui/src/org/eclipse/pde/internal/ui/editor/PDEMultiPageEditor.java;1;1;7;1;3;3;3;4;62;2;3;3579;144;144;2;1;0;4;7;3579;1;4711;6;1;
/org.eclipse.ui/Eclipse JFace Text/org/eclipse/jface/text/AbstractHoverInformationControlManager.java;2;2;9;1;7;6;7;2;232;1;2;1435;630;630;2;0;1;2;9;4423;1;4838;8;2;
/org.eclipse.ui/Eclipse UI/org/eclipse/ui/internal/dialogs/InternalBase64Encoder.java;2;0;2;1;0;0;0;2;11;1;2;257;11;11;1;0;0;2;2;257;0;457;2;2;
/org.eclipse.help/Eclipse Help/org/eclipse/help/internal/util/TableOfContentsGenerator.java;3;0;5;1;0;0;0;5;7;1;5;135;11;11;1;0;0;5;5;135;0;1420;5;3;
/org.eclipse.jdt.ui.tests.refactoring/resources/RenameNonPrivateField/testFail3/in/A.java;1;0;1;1;0;0;0;1;0;0;1;49;0;0;1;0;0;1;1;49;0;49;1;1;
/org.eclipse.webdav/src/interface/org/eclipse/webdav/dom/PropStat.java;3;0;5;1;1;1;1;4;274;1;4;12;335;335;1;0;0;4;5;12;0;4211;5;3;
/org.eclipse.jdt.ui/core refactoring/org/eclipse/jdt/internal/core/refactoring/changes/MoveRefactoring.java;1;0;2;1;0;0;0;2;0;1;2;1108;0;0;1;0;0;2;2;1108;0;1257;2;1;
/org.eclipse.jdt.core/compiler/org/eclipse/jdt/internal/compiler/impl/ConfigurableProblems.java;1;0;11;1;0;0;0;11;12;4;8;455;26;26;4;3;0;11;11;1039;3;1564;8;1;
/org.eclipse.ui/Eclipse UI Standard Components/org/eclipse/ui/wizards/datatransfer/WizardFileSystemResourceExportPage1.java;5;0;13;1;1;1;1;12;72;2;9;257;260;260;2;3;0;12;13;2271;3;3912;10;5;
/org.eclipse.jdt.ui/ui/org/eclipse/jdt/internal/ui/JavaDebugLayout.java;2;0;4;1;0;0;0;4;9;1;4;15;16;16;1;0;0;4;4;15;0;1199;4;2;
/org.eclipse.pde.ui/src/org/eclipse/pde/internal/core/ifeature/IFeatureObject.java;1;0;2;1;0;0;0;2;0;1;2;3591;0;0;1;0;0;2;2;3591;0;3607;2;1;
/org.eclipse.pde.ui/Eclipse PDE UI/org/eclipse/pde/internal/editor/text/PDECommentScanner.java;2;0;5;2;0;0;0;5;12;3;3;267;12;12;3;2;0;5;5;324;2;1434;3;2;
/org.eclipse.jdt.ui.tests.refactoring/resources/ExtractMethodWorkSpace/ExtractMethodTests/locals_out/A_test568.java;1;1;2;1;2;2;2;0;0;0;0;4383;0;0;1;0;0;0;2;4383;0;4419;2;1;
/org.eclipse.ui/Eclipse JFace/org/eclipse/jface/viewers/ISelectionActivatedListener.java;1;0;1;1;0;0;0;1;0;0;1;878;0;0;1;0;0;1;1;878;0;878;1;1;
/org.eclipse.jdt.ui.tests.refactoring/resources/DeleteSourceReference/test1/in/A.java;1;0;1;1;0;0;0;1;0;0;1;2857;0;0;1;0;0;1;1;2857;0;2857;1;1;
/org.eclipse.jdt.ui.tests.refactoring/resources/InlineTemp/canInline/A_test17_in.java;1;0;1;1;0;0;0;1;0;0;1;3355;0;0;1;0;0;1;1;3355;0;3355;1;1;
/org.eclipse.ui/Eclipse UI/org/eclipse/ui/internal/dialogs/TasksPreferencePage.java;1;0;1;1;0;0;0;1;0;0;1;949;0;0;1;0;0;1;1;949;0;949;1;1;
/org.eclipse.swt/Eclipse SWT PI/photon/org/eclipse/swt/internal/photon/PhDim_t.java;2;0;2;1;1;1;1;1;6;0;1;2069;6;6;1;0;0;1;2;2069;0;4701;2;2;
/org.eclipse.jdt.core/codeassist/org/eclipse/jdt/internal/codeassist/complete/CompletionOnQualifiedExceptionReference.java;2;1;11;1;2;2;2;9;36;4;6;455;137;137;4;3;0;9;11;1039;3;4421;8;2;
/org.eclipse.jdt.ui/ui/org/eclipse/jdt/internal/ui/packageview/FrameForwardAction.java;1;0;3;1;0;0;0;3;4;1;3;213;4;4;1;0;0;3;3;213;0;390;3;1;
/org.eclipse.jdt.ui.tests/refactoring/org/eclipse/jdt/refactoring/tests/infra/TextBufferChangeCreator.java;2;0;4;1;0;0;0;4;5;1;4;49;9;9;1;0;0;4;4;49;0;1896;4;2;
/org.eclipse.swt.tests/JUnit Tests/org/eclipse/swt/tests/junit/Test_org_eclipse_swt_events_KeyListener.java;2;0;2;1;1;1;1;1;6;0;1;1792;6;6;1;0;0;1;2;1792;0;4706;2;2;
/org.eclipse.ui/Eclipse JFace/org/eclipse/jface/resource/JFaceColors.java;1;0;8;1;1;1;1;7;96;2;5;2429;182;182;2;2;0;7;8;2429;2;4380;6;1;
/org.eclipse.vcm.core/src/org/eclipse/vcm/internal/core/base/ISharingManager.java;5;0;6;1;0;0;0;6;59;1;6;0;114;114;1;0;0;6;6;0;0;1290;6;5;
/org.eclipse.swt.examples.paint/src/org/eclipse/swt/examples/paint/BasicPaintSession.java;3;0;3;1;1;1;1;2;10;1;2;513;16;16;1;0;0;2;3;513;0;4705;3;3;
/org.eclipse.pde.ui/src/org/eclipse/pde/internal/model/ExternalPluginModelBase.java;2;0;5;1;0;0;0;5;21;1;5;1434;30;30;1;0;0;5;5;1434;0;3136;5;2;
/org.eclipse.jdt.core/model/org/eclipse/jdt/internal/core/MemberElementInfo.java;2;2;5;1;3;2;3;2;123;1;2;455;248;248;2;0;1;2;5;3960;1;4063;4;2;
/org.eclipse.pde.ui/src/org/eclipse/pde/internal/editor/component/ComponentReferencePage.java;2;0;4;1;0;0;0;4;4;1;4;1434;6;6;1;0;0;4;4;1434;0;2951;4;2;
/org.eclipse.pde.ui/Eclipse PDE UI/org/eclipse/pde/internal/editor/XMLConfiguration.java;2;0;5;2;0;0;0;5;12;3;3;267;12;12;3;2;0;5;5;324;2;1434;3;2;
/org.eclipse.jdt.core/dom/org/eclipse/jdt/core/dom/CastExpression.java;2;1;6;1;2;2;2;4;16;1;4;2669;46;46;1;0;0;4;6;2669;0;4453;6;2;
/org.eclipse.swt/Eclipse SWT Custom Widgets/common_j2se/org/eclipse/swt/custom/CTabItem.java;1;0;1;1;0;0;0;1;0;0;1;1378;0;0;1;0;0;1;1;1378;0;1378;1;1;
/org.eclipse.compare/compare/org/eclipse/compare/NavigationAction.java;1;1;3;1;3;3;3;0;28;0;0;4451;37;37;1;0;0;0;3;4451;0;4820;3;1;
/org.eclipse.jdt.core/model/org/eclipse/jdt/internal/core/Problem.java;1;0;10;1;0;0;0;10;356;4;7;455;401;401;4;3;0;10;10;1039;3;2849;7;1;
/org.eclipse.jdt.ui.tests.refactoring/resources/MoveMembers/testFail14/in/A.java;1;0;1;1;0;0;0;1;0;0;1;2738;0;0;1;0;0;1;1;2738;0;2738;1;1;
/org.eclipse.vcm.ui/src/org/eclipse/vcm/internal/ui/VCMPreferencePage.java;5;0;13;2;0;0;0;13;13;2;12;1;75;75;2;1;0;13;13;295;1;1637;12;5;
/org.eclipse.jdt.ui.tests/ui/com/ibm/jdt/internal/ui/dialogs/tests/TwoPaneElementSelectorTest.java;1;0;3;1;0;0;0;3;4;1;3;255;4;4;1;0;0;3;3;255;0;522;3;1;
/org.eclipse.jdt.ui/ui debug/org/eclipse/jdt/internal/debug/ui/Timer.java;2;0;2;1;0;0;0;2;0;1;2;1805;0;0;1;0;0;2;2;1805;0;1916;2;2;
/org.eclipse.team.cvs.core/src/org/eclipse/team/internal/ccvs/core/resources/RemoteFolderTreeBuilder.java;3;1;19;1;7;7;7;12;588;1;12;3012;874;874;1;0;0;12;19;3012;0;4450;19;3;
/org.eclipse.help.webapp/src/org/eclipse/help/internal/proxy/protocol/links/Handler.java;1;0;1;1;0;0;0;1;0;0;1;3454;0;0;1;0;0;1;1;3454;0;3454;1;1;
/org.eclipse.update.ui/src/org/eclipse/update/ui/internal/model/UpdateSearchOperation.java;1;0;2;1;0;0;0;2;0;1;2;1916;0;0;1;0;0;2;2;1916;0;2797;2;1;
/org.eclipse.pde.ui/Eclipse PDE UI/org/eclipse/pde/internal/editor/component/PluginSection.java;2;0;7;2;0;0;0;7;12;3;5;267;23;23;3;2;0;7;7;324;2;1434;5;2;
/org.eclipse.swt/Eclipse SWT Drag and Drop/gtk/org/eclipse/swt/dnd/TransferData.java;3;1;6;1;4;4;4;2;36;1;2;2107;72;72;1;0;0;2;6;2107;0;4701;6;3;
/org.eclipse.team.cvs.ui/src/org/eclipse/team/internal/ccvs/ui/actions/NewCVSRepositoryAction.java;1;0;2;1;1;1;1;1;3;0;1;3555;3;3;1;0;0;1;2;3555;0;3960;2;1;
/org.eclipse.swt/Eclipse SWT Custom Widgets/common_j2se/org/eclipse/swt/custom/LineBackgroundEvent.java;1;0;1;1;0;0;0;1;0;0;1;1378;0;0;1;0;0;1;1;1378;0;1378;1;1;
/org.eclipse.swt/Eclipse SWT Drag and Drop/emulated/org/eclipse/swt/dnd/FileTransfer.java;2;1;5;1;4;4;4;1;47;0;1;3126;69;69;1;0;0;1;5;3126;0;4824;5;2;
/org.eclipse.jdt.ui/core refactoring/org/eclipse/jdt/internal/core/refactoring/changes/CopyRefactoring.java;1;0;2;1;0;0;0;2;0;1;2;1108;0;0;1;0;0;2;2;1108;0;1257;2;1;
/org.eclipse.jdt.core/model/org/eclipse/jdt/internal/core/SearchableEnvironmentRequestor.java;2;0;3;1;1;1;1;2;109;1;2;455;127;127;1;0;0;2;3;455;0;4063;3;2;
/org.eclipse.pde.ui/src/org/eclipse/pde/internal/editor/manifest/PluginAdapterFactory.java;2;0;5;1;0;0;0;5;5;1;5;1434;9;9;1;0;0;5;5;1434;0;3579;5;2;
/org.eclipse.jdt.debug/eval/org/eclipse/jdt/internal/debug/eval/ast/engine/GreaterEqualOperator.java;1;0;2;1;0;0;0;2;0;1;2;3329;0;0;1;0;0;2;2;3329;0;3421;2;1;
/org.eclipse.help/src/org/eclipse/help/internal/protocols/LinksURL.java;2;0;5;1;0;0;0;5;4;1;5;2694;9;9;1;0;0;5;5;2694;0;3776;5;2;
/org.eclipse.jdt.ui.tests.refactoring/resources/RenamePrivateField/testFail0/in/A.java;1;0;1;1;0;0;0;1;0;0;1;49;0;0;1;0;0;1;1;49;0;49;1;1;
/org.eclipse.jdt.ui.tests.refactoring/resources/ExtractMethodWorkSpace/ExtractMethodTests/try_in/A_test456.java;2;1;3;1;2;2;2;1;8;0;1;511;8;8;1;0;0;1;3;511;0;4419;3;2;
/org.eclipse.jdt.ui.tests.refactoring/resources/ExtractMethodWorkSpace/ExtractMethodTests/semicolon_in/A_test407.java;1;1;3;1;2;2;2;1;4;0;1;1236;4;4;1;0;0;1;3;1236;0;4419;3;1;
/org.eclipse.debug.core/core/org/eclipse/debug/core/model/IStorage.java;1;0;2;1;0;0;0;2;0;1;2;1950;0;0;1;0;0;2;2;1950;0;1963;2;1;
/org.eclipse.core.boot/src/org/eclipse/core/boot/BootLoader.java;6;1;16;2;4;4;4;12;752;2;11;12;1181;1181;2;1;0;12;16;2802;1;4705;15;6;
/org.eclipse.ui/Eclipse UI/org/eclipse/ui/IActionDelegate2.java;1;0;2;1;0;0;0;2;0;0;1;2325;0;0;2;1;0;2;2;2325;1;2325;1;1;
/org.eclipse.jdt.ui.tests.refactoring/resources/RenameMethodInInterface/test27/out/A.java;1;0;1;1;0;0;0;1;0;0;1;49;0;0;1;0;0;1;1;49;0;49;1;1;
/org.eclipse.core.resources/src_ant/org/eclipse/core/resources/ant/EclipseCopy.java;2;1;4;1;2;2;2;2;42;1;2;3509;63;63;1;0;0;2;4;3509;0;4646;4;2;
/org.eclipse.jdt.ui/core refactoring/org/eclipse/jdt/internal/core/refactoring/code/flow/GenericSequentialFlowInfo.java;1;0;2;1;0;0;0;2;0;1;2;1236;0;0;1;0;0;2;2;1236;0;1939;2;1;
/org.eclipse.pde.ui/src/org/eclipse/pde/internal/core/schema/SchemaComplexType.java;1;0;4;1;0;0;0;4;8;2;3;3579;10;10;2;1;0;4;4;3579;1;3607;3;1;
/org.eclipse.core.resources/src/org/eclipse/core/internal/indexing/IReferable.java;3;0;3;1;0;0;0;3;5;1;3;12;5;5;1;0;0;3;3;12;0;448;3;3;
/org.eclipse.ui/Eclipse JFace Text/org/eclipse/jface/text/IDocument.java;4;0;5;1;0;0;0;5;585;1;5;257;624;624;1;0;0;5;5;257;0;1739;5;4;
/org.eclipse.jdt.ui/core refactoring/org/eclipse/jdt/internal/corext/refactoring/code/ExtractTempRefactoring.java;3;1;30;1;4;4;4;26;220;2;24;2480;1037;1037;2;2;0;26;30;2480;2;4420;28;3;
/org.eclipse.team.core/src/org/eclipse/team/internal/core/InfiniteSubProgressMonitor.java;1;2;3;1;3;2;3;0;11;0;0;4406;13;13;2;0;1;0;3;4406;1;4550;2;1;
/org.eclipse.update.ui/src/org/eclipse/update/internal/ui/model/MissingFeature.java;3;1;13;1;2;2;2;11;20;1;11;2797;108;108;1;0;0;11;13;2797;0;4448;13;3;
/org.eclipse.jdt.ui.tests.refactoring/resources/SelectionAnalyzerWorkSpace/SelectionAnalyzerTests/invalidSelection/A_test014.java;1;0;1;1;0;0;0;1;0;0;1;1368;0;0;1;0;0;1;1;1368;0;1368;1;1;
/org.eclipse.update.ui/src/org/eclipse/update/internal/ui/manager/SiteBookmarkPropertySource.java;1;0;6;1;0;0;0;6;87;1;6;1477;108;108;1;0;0;6;6;1477;0;3537;6;1;
/org.eclipse.scripting/Eclipse Scripting/org/eclipse/scripting/internal/views/ScriptConsole.java;2;0;4;1;0;0;0;4;13;1;4;133;25;25;1;0;0;4;4;133;0;1424;4;2;
/org.eclipse.jdt.debug/eval/org/eclipse/jdt/internal/debug/eval/model/EvaluationVariable.java;2;0;3;1;0;0;0;3;3;1;3;3421;3;3;1;0;0;3;3;3421;0;3645;3;2;
/org.eclipse.core.tests.runtime/src/org/eclipse/core/tests/internal/plugins/RegressionResolveTest_7.java;3;0;3;1;0;0;0;3;132;1;3;1794;142;142;1;0;0;3;3;1794;0;3476;3;3;
/org.eclipse.team.cvs.ui/src/org/eclipse/team/internal/ccvs/ui/wizards/GenerateDiffFileWizard.java;3;1;14;1;5;5;5;9;461;2;8;1992;562;562;2;1;0;9;14;2420;1;4626;13;3;
/org.eclipse.compare/compare/org/eclipse/compare/internal/StoppableThread.java;1;0;2;1;0;0;0;2;0;1;2;1009;0;0;1;0;0;2;2;1009;0;2017;2;1;
/org.eclipse.jdt.debug/eval/org/eclipse/jdt/internal/debug/eval/ast/engine/SendStaticMessage.java;1;0;3;1;0;0;0;3;114;1;3;3329;114;114;1;0;0;3;3;3329;0;3421;3;1;
/org.eclipse.team.cvs.core/src/org/eclipse/team/internal/ccvs/core/resources/ICVSSynchronizer.java;1;0;3;1;0;0;0;3;10;1;3;2690;10;10;1;0;0;3;3;2690;0;3089;3;1;
/org.eclipse.ui/Eclipse JFace Text/org/eclipse/jface/text/DocumentEvent.java;3;0;3;1;0;0;0;3;20;1;3;257;25;25;1;0;0;3;3;257;0;1066;3;3;
/org.eclipse.jdt.ui.tests.refactoring/resources/RenamePrivateMethod/test17/out/A.java;1;0;1;1;0;0;0;1;0;0;1;49;0;0;1;0;0;1;1;49;0;49;1;1;
/org.eclipse.update.ui/src/org/eclipse/update/internal/ui/model/IConfiguredFeatureAdapter.java;2;0;2;1;0;0;0;2;2;1;2;2834;2;2;1;0;0;2;2;2834;0;2994;2;2;
/org.eclipse.jdt.core/model/org/eclipse/jdt/internal/core/builder/IImageBuilder.java;1;0;4;1;0;0;0;4;34;1;4;455;56;56;1;0;0;4;4;455;0;2808;4;1;
/org.eclipse.jdt.ui.tests.refactoring/resources/RenameType/test44/out/A.java;1;0;2;1;0;0;0;2;0;1;2;49;0;0;1;0;0;2;2;49;0;522;2;1;
/org.eclipse.swt/Eclipse SWT PI/gtk/org/eclipse/swt/internal/gtk/GtkCListRow.java;2;0;5;1;2;1;2;3;7;1;3;2107;19;19;2;0;1;3;5;4701;1;4701;4;2;
/org.eclipse.jdt.core/compiler/org/eclipse/jdt/internal/compiler/ast/OR_OR_Expression.java;2;0;7;1;1;1;1;6;538;2;5;455;1123;1123;2;1;0;6;7;1284;1;4062;6;2;
/org.eclipse.jdt.core/compiler/org/eclipse/jdt/internal/compiler/ast/NumberLiteral.java;2;0;4;1;1;1;1;3;40;1;3;455;60;60;1;0;0;3;4;455;0;4062;4;2;
/org.eclipse.jdt.ui.tests.refactoring/resources/RenameStaticMethod/test5/in/A.java;1;0;1;1;0;0;0;1;0;0;1;49;0;0;1;0;0;1;1;49;0;49;1;1;
/org.eclipse.core.boot/src/org/eclipse/core/internal/boot/URLContentFilter.java;2;0;4;1;1;1;1;3;170;1;3;12;213;213;1;0;0;3;4;12;0;4214;4;2;
/org.eclipse.pde.ui/src/org/eclipse/pde/internal/model/IModelProviderListener.java;1;0;2;1;0;0;0;2;0;1;2;3136;0;0;1;0;0;2;2;3136;0;3579;2;1;
/org.eclipse.team.cvs.core/src/org/eclipse/team/internal/ccvs/core/util/ResourceDeltaVisitor.java;3;0;16;1;0;0;0;16;489;2;15;1978;1463;1463;2;1;0;16;16;2275;1;3701;15;3;
/org.eclipse.scripting/Eclipse Scripting/org/eclipse/scripting/internal/uirenderer/XGRFontManager.java;2;0;4;1;0;0;0;4;8;1;4;133;14;14;1;0;0;4;4;133;0;1424;4;2;
/org.eclipse.team.cvs.ssh/src/org/eclipse/team/internal/ccvs/ssh/SSHMethod.java;3;0;3;1;0;0;0;3;52;1;3;1978;58;58;1;0;0;3;3;1978;0;3610;3;3;
/org.eclipse.pde.ui/Eclipse PDE UI/org/eclipse/pde/internal/editor/component/ComponentPropertySource.java;2;0;5;2;0;0;0;5;12;3;3;267;12;12;3;2;0;5;5;324;2;1434;3;2;
/org.eclipse.help/src/org/eclipse/help/internal/toc/Anchor.java;2;0;3;1;0;0;0;3;19;1;3;1857;21;21;1;0;0;3;3;1857;0;3766;3;2;
/org.eclipse.vcm.ui/src/org/eclipse/vcm/internal/ui/sync/VCMFile.java;4;0;14;2;0;0;0;14;297;2;11;48;414;414;2;3;0;14;14;62;3;1659;11;4;
/org.eclipse.jdt.ui.tests.refactoring/resources/RenameParameters/canRename/A_test18_out.java;1;0;1;1;0;0;0;1;0;0;1;233;0;0;1;0;0;1;1;233;0;233;1;1;
/org.eclipse.jdt.ui/ui/org/eclipse/jdt/internal/ui/javaeditor/ClassFileEditorActionContributor.java;7;1;15;1;4;4;4;11;72;2;10;15;278;278;2;1;0;11;15;2619;1;4400;14;7;
/org.eclipse.jdt.ui.tests.refactoring/resources/RenameType/test4/in/A.java;1;0;1;1;0;0;0;1;0;0;1;49;0;0;1;0;0;1;1;49;0;49;1;1;
/org.eclipse.jdt.ui/ui refactoring/org/eclipse/jdt/internal/ui/refactoring/CopyInputPage.java;1;0;1;1;0;0;0;1;0;0;1;1108;0;0;1;0;0;1;1;1108;0;1108;1;1;
/org.eclipse.update.core/src/org/eclipse/update/internal/core/obsolete/DefaultFeature.java;1;0;1;1;0;0;0;1;0;0;1;2463;0;0;1;0;0;1;1;2463;0;2463;1;1;
/org.eclipse.jdt.ui.tests.refactoring/resources/SelectionAnalyzerWorkSpace/SelectionAnalyzerTests/invalidSelection/A_test181.java;2;0;2;1;0;0;0;2;0;1;2;1368;0;0;1;0;0;2;2;1368;0;2139;2;2;
/org.eclipse.jdt.core/compiler/org/eclipse/jdt/internal/compiler/lookup/FieldBinding.java;2;0;4;1;1;1;1;3;377;1;3;455;438;438;1;0;0;3;4;455;0;4062;4;2;
/org.eclipse.core.boot/src/org/eclipse/core/internal/boot/EclipseURLHandlerFactory.java;1;0;2;1;0;0;0;2;0;1;2;12;0;0;1;0;0;2;2;12;0;23;2;1;
/org.eclipse.jdt.ui.tests.refactoring/resources/ExtractMethodWorkSpace/ExtractMethodTests/invalidSelection/A_test153.java;2;1;4;1;2;2;2;2;12;1;2;254;14;14;1;0;0;2;4;254;0;4419;4;2;
/org.eclipse.jdt.ui.tests.refactoring/resources/RenameTemp/canRename/A_test21_in.java;1;0;2;1;0;0;0;2;2;1;2;1625;2;2;1;0;0;2;2;1625;0;1652;2;1;
/org.eclipse.jdt.ui.tests.refactoring/resources/RenameVirtualMethodInClass/test29/out/A.java;1;0;1;1;0;0;0;1;0;0;1;49;0;0;1;0;0;1;1;49;0;49;1;1;
/org.eclipse.jdt.ui.tests.refactoring/resources/SefWorkSpace/SefTests/object_out/TestSimpleWrite.java;1;0;1;1;0;0;0;1;0;0;1;2155;0;0;1;0;0;1;1;2155;0;2155;1;1;
/org.eclipse.scripting/src/org/eclipse/scripting/internal/IXGRElementUILayoutElement.java;1;0;1;1;0;0;0;1;0;0;1;1424;0;0;1;0;0;1;1;1424;0;1424;1;1;
/org.eclipse.team.cvs.ui/src/org/eclipse/team/internal/ccvs/ui/wizards/BranchWizard.java;3;0;22;3;1;1;1;21;86;3;16;2578;376;376;3;5;0;21;22;3676;5;3957;17;3;
/org.eclipse.jdt.ui/ui/org/eclipse/jdt/internal/ui/javaeditor/TogglePresentationAction.java;6;2;14;2;4;3;4;10;68;1;10;15;221;221;2;0;1;10;14;4182;1;4213;13;6;
/org.eclipse.ui.tests/Eclipse UI Tests/org/eclipse/ui/tests/api/IWorkbenchTest.java;4;0;14;1;0;0;0;14;214;1;14;803;503;503;1;0;0;14;14;803;0;3067;14;4;
/org.eclipse.swt.examples.controls/org/eclipse/swt/examples/controls/SliderTab.java;2;0;3;1;0;0;0;3;226;1;3;513;226;226;1;0;0;3;3;513;0;970;3;2;
/org.eclipse.update.ui/src/org/eclipse/update/internal/ui/manager/DiscoveryFolderForm.java;1;0;2;1;0;0;0;2;0;1;2;3517;0;0;1;0;0;2;2;3517;0;3662;2;1;
/org.eclipse.swt/Eclipse SWT/common/org/eclipse/swt/widgets/Listener.java;3;1;4;1;2;2;2;2;6;1;2;106;12;12;1;0;0;2;4;106;0;4701;4;3;
/org.eclipse.team.ui/src/org/eclipse/team/ui/TeamUI.java;1;0;1;1;1;1;1;0;0;0;0;4189;0;0;1;0;0;0;1;4189;0;4189;1;1;
/org.eclipse.jdt.core/model/org/eclipse/jdt/internal/core/builder/impl/TypeNode.java;1;0;10;1;0;0;0;10;23;4;6;455;41;41;4;4;0;10;10;1039;4;2808;6;1;
/org.eclipse.team.cvs.core/src/org/eclipse/team/internal/ccvs/core/client/listeners/AdminKSubstListener.java;2;0;5;1;0;0;0;5;12;1;5;3206;29;29;1;0;0;5;5;3206;0;3610;5;2;
/org.eclipse.jdt.core/model/org/eclipse/jdt/internal/core/builder/ImageBuilderInternalException.java;2;0;2;1;1;1;1;1;15;0;1;2979;15;15;1;0;0;1;2;2979;0;4063;2;2;
/org.eclipse.jdt.core/dom/org/eclipse/jdt/core/dom/CopyPositionsMatcher.java;1;0;2;1;1;1;1;1;0;0;1;3084;0;0;1;0;0;1;2;3084;0;4410;2;1;
/org.eclipse.jdt.ui.tests.refactoring/resources/MultiMove/test2/out/p2/C.java;1;0;2;1;0;0;0;2;1;1;2;1157;1;1;1;0;0;2;2;1157;0;2584;2;1;
/org.eclipse.ui/Eclipse UI/org/eclipse/ui/internal/ContainerPlaceholder.java;2;0;2;1;0;0;0;2;7;1;2;257;7;7;1;0;0;2;2;257;0;457;2;2;
/org.eclipse.jdt.ui.tests.refactoring/resources/RenameMethodInInterface/testFail19/in/A.java;1;0;1;1;0;0;0;1;0;0;1;49;0;0;1;0;0;1;1;49;0;49;1;1;
/org.eclipse.jdt.ui.tests.refactoring/resources/ReorderParameters/canReorder/A_test2_in.java;1;0;3;1;0;0;0;3;0;1;3;724;0;0;1;0;0;3;3;724;0;2270;3;1;
/org.eclipse.pde.ui/src/org/eclipse/pde/internal/editor/manifest/PointGraphSection.java;2;0;4;1;0;0;0;4;4;1;4;1434;6;6;1;0;0;4;4;1434;0;3050;4;2;
/org.eclipse.ui/Eclipse JFace/org/eclipse/jface/action/MenuManager.java;5;1;16;2;3;3;3;13;191;3;9;257;634;634;3;4;0;13;16;3447;4;4746;12;5;
/org.eclipse.jdt.core/compiler/org/eclipse/jdt/internal/compiler/ast/FalseLiteral.java;2;0;4;1;1;1;1;3;106;1;3;455;124;124;1;0;0;3;4;455;0;4062;4;2;
/org.eclipse.jdt.core/model/org/eclipse/jdt/internal/core/Util.java;4;2;29;1;6;5;6;23;1037;4;19;455;1869;1869;4;4;1;23;29;1039;5;4380;24;4;
/org.eclipse.jdt.debug.tests/tests/org/eclipse/jdt/debug/tests/eval/Tests.java;2;1;2;1;2;2;2;0;18;0;0;4447;18;18;1;0;0;0;2;4447;0;4454;2;2;
/org.eclipse.pde.ui/src/org/eclipse/pde/internal/wizards/templates/FirstTemplateWizardPage.java;1;0;4;1;0;0;0;4;8;1;4;3240;9;9;1;0;0;4;4;3240;0;3579;4;1;
/org.eclipse.swt/Eclipse SWT/win32/org/eclipse/swt/internal/win32/OPENFILENAME.java;2;0;3;1;0;0;0;3;5;1;3;106;5;5;1;0;0;3;3;106;0;2069;3;2;
/org.eclipse.swt/Eclipse SWT/win32/org/eclipse/swt/widgets/MessageBox.java;8;2;11;1;4;3;4;7;78;1;7;106;111;111;2;0;1;7;11;4557;1;4701;10;8;
/org.eclipse.ui/Eclipse UI/org/eclipse/ui/part/IContributedContentsView.java;2;0;2;1;0;0;0;2;5;1;2;257;5;5;1;0;0;2;2;257;0;457;2;2;
/org.eclipse.jdt.ui/ui/org/eclipse/jdt/internal/ui/search/GotoMarkerAction.java;5;2;17;2;3;2;3;14;88;1;14;15;398;398;2;0;1;14;17;4627;1;4627;16;5;
/org.eclipse.jdt.launching/launching/org/eclipse/jdt/launching/sourcelookup/JavaSourceLocator.java;3;4;36;2;23;15;23;13;154;3;10;2372;840;840;4;3;8;13;36;4123;11;4536;25;3;
/org.eclipse.pde.ui/templates/editor/java/XMLDocumentProvider.java;1;0;3;1;2;1;2;1;8;0;1;3812;8;8;2;0;1;1;3;4316;1;4316;2;1;
/org.eclipse.ant.ui/src/org/eclipse/ant/internal/ui/JarsPage.java;1;0;1;1;0;0;0;1;0;0;1;3437;0;0;1;0;0;1;1;3437;0;3437;1;1;
/org.eclipse.jdt.ui/ui refactoring/org/eclipse/jdt/internal/ui/refactoring/nls/search/NLSSearchResultLabelProvider.java;2;0;4;1;0;0;0;4;82;2;3;1922;96;96;2;1;0;4;4;3528;1;3528;3;2;
/org.eclipse.pde.ui/src/org/eclipse/pde/internal/wizards/templates/TemplateOption.java;1;0;5;1;0;0;0;5;29;2;4;3278;49;49;2;1;0;5;5;3425;1;3579;4;1;
/org.eclipse.ui/Eclipse UI/org/eclipse/ui/IEditorSite.java;3;0;3;1;0;0;0;3;12;1;3;257;17;17;1;0;0;3;3;257;0;3055;3;3;
/org.eclipse.swt.tests/JUnit Tests/org/eclipse/swt/tests/junit/Test_org_eclipse_swt_dnd_Transfer.java;2;0;2;1;1;1;1;1;6;0;1;1792;6;6;1;0;0;1;2;1792;0;4706;2;2;
/org.eclipse.ui/Eclipse JFace/org/eclipse/jface/action/IToolBarManager.java;2;0;2;1;0;0;0;2;5;1;2;257;5;5;1;0;0;2;2;257;0;457;2;2;
/org.eclipse.jdt.ui.tests.refactoring/resources/ExtractMethodWorkSpace/ExtractMethodTests/wiki_in/A_test2003.java;1;1;3;1;2;2;2;1;36;0;1;1236;36;36;1;0;0;1;3;1236;0;4419;3;1;
/org.eclipse.jdt.ui.tests.refactoring/resources/RenameMethodInInterface/testFail17/in/A.java;1;0;1;1;0;0;0;1;0;0;1;49;0;0;1;0;0;1;1;49;0;49;1;1;
/org.eclipse.core.tests.runtime/src/org/eclipse/core/tests/internal/plugins/PluginResolveTest_14.java;3;0;3;1;0;0;0;3;142;1;3;1794;152;152;1;0;0;3;3;1794;0;3476;3;3;
/org.eclipse.jdt.core/compiler/org/eclipse/jdt/internal/compiler/codegen/FloatCache.java;2;1;12;1;2;2;2;10;243;4;6;455;351;351;4;4;0;10;12;1039;4;4062;8;2;
/org.eclipse.swt/Eclipse SWT Custom Widgets/common/org/eclipse/swt/custom/StyleRange.java;3;0;4;1;1;1;1;3;7;1;3;106;16;16;1;0;0;3;4;106;0;4701;4;3;
/org.eclipse.pde.ui/src/org/eclipse/pde/internal/editor/manifest/ResourceAttributeValue.java;2;0;2;1;0;0;0;2;0;1;2;1434;0;0;1;0;0;2;2;1434;0;3579;2;2;
/org.eclipse.jdt.ui/test/Foo.java;1;0;1;1;0;0;0;1;0;0;1;1893;0;0;1;0;0;1;1;1893;0;1893;1;1;
/org.eclipse.jdt.debug.ui/ui/org/eclipse/jdt/internal/debug/ui/snippeteditor/RunAction.java;2;2;6;1;3;2;3;3;117;1;3;1915;131;131;2;0;1;3;6;3900;1;3935;5;2;
/org.eclipse.help/src/org/eclipse/help/internal/contributors1_0/Contributor.java;1;0;2;1;0;0;0;2;0;1;2;1675;0;0;1;0;0;2;2;1675;0;2217;2;1;
/org.eclipse.jdt.ui/ui/org/eclipse/jdt/internal/ui/dialogs/TypeCache.java;4;0;7;2;0;0;0;7;21;2;6;431;62;62;2;1;0;7;7;468;1;1878;6;4;
/org.eclipse.jdt.ui/ui/org/eclipse/jdt/internal/ui/util/DocumentManager.java;2;0;5;1;0;0;0;5;46;1;5;15;53;53;1;0;0;5;5;15;0;2218;5;2;
/org.eclipse.swt.examples/src/org/eclipse/swt/examples/explorer/ComboView.java;1;0;1;1;0;0;0;1;0;0;1;547;0;0;1;0;0;1;1;547;0;547;1;1;
/org.eclipse.swt/Eclipse SWT PI/win32/org/eclipse/swt/internal/win32/LVHITTESTINFO.java;2;0;2;1;1;1;1;1;6;0;1;2069;6;6;1;0;0;1;2;2069;0;4701;2;2;
/org.eclipse.jdt.ui/core refactoring/org/eclipse/jdt/internal/core/refactoring/changes/CompilationUnitReorgChange.java;2;0;4;1;0;0;0;4;4;1;4;1342;6;6;1;0;0;4;4;1342;0;1939;4;2;
/org.eclipse.scripting/Eclipse Scripting/org/eclipse/scripting/internal/views/ScriptUIEditorDesignerCanvas.java;2;0;5;1;0;0;0;5;25;1;5;133;57;57;1;0;0;5;5;133;0;1424;5;2;
/org.eclipse.team.cvs.core/src/org/eclipse/team/internal/ccvs/core/ICVSRepositoryLocation.java;3;0;14;1;1;1;1;13;186;2;11;1978;571;571;2;2;0;13;14;2049;2;4121;12;3;
/org.eclipse.swt/Eclipse SWT/carbon/org/eclipse/swt/widgets/MessageBox.java;3;1;4;1;4;4;4;0;9;0;0;4147;19;19;1;0;0;0;4;4147;0;4701;4;3;
/org.eclipse.pde.ui/Eclipse PDE UI/org/eclipse/pde/internal/editor/SystemFileEditorInput.java;2;0;5;2;0;0;0;5;12;3;3;267;12;12;3;2;0;5;5;324;2;1434;3;2;
/org.eclipse.swt/Eclipse SWT/carbon/org/eclipse/swt/graphics/Color.java;3;1;4;1;4;4;4;0;33;0;0;4147;46;46;1;0;0;0;4;4147;0;4701;4;3;
/org.eclipse.jdt.ui/ui/org/eclipse/jdt/internal/ui/compare/JavaParseTreeBuilder.java;3;0;11;1;0;0;0;11;42;1;11;15;125;125;1;0;0;11;11;15;0;3210;11;3;
/org.eclipse.swt/Eclipse SWT/carbon/org/eclipse/swt/graphics/FontData.java;3;1;4;1;4;4;4;0;6;0;0;4147;16;16;1;0;0;0;4;4147;0;4701;4;3;
/org.eclipse.jdt.ui/core refactoring/org/eclipse/jdt/internal/core/refactoring/code/flow/WhileFlowInfo.java;1;0;3;1;0;0;0;3;3;1;3;1236;3;3;1;0;0;3;3;1236;0;1939;3;1;
/org.eclipse.pde.ui/src/org/eclipse/pde/internal/editor/schema/SchemaForm.java;2;0;6;1;0;0;0;6;16;1;6;1434;36;36;1;0;0;6;6;1434;0;3579;6;2;
/org.eclipse.pde.ui/src/org/eclipse/pde/internal/editor/text/TextUtil.java;2;0;3;1;0;0;0;3;2;1;3;1434;2;2;1;0;0;3;3;1434;0;3579;3;2;
/org.eclipse.compare/compare/org/eclipse/compare/rangedifferencer/RangeDifference.java;1;0;2;1;0;0;0;2;5;1;2;14;5;5;1;0;0;2;2;14;0;329;2;1;
/org.eclipse.help/src/org/eclipse/help/internal/search/QueryWordsToken.java;2;0;4;1;0;0;0;4;25;2;3;3186;51;51;2;1;0;4;4;3186;1;3218;3;2;
/org.eclipse.compare/compare/org/eclipse/compare/structuremergeviewer/ICompareInputChangeListener.java;1;0;2;1;0;0;0;2;5;1;2;14;5;5;1;0;0;2;2;14;0;329;2;1;
/org.eclipse.swt.tests/JUnit Tests/org/eclipse/swt/tests/junit/Test_org_eclipse_swt_graphics_Device.java;2;0;2;1;1;1;1;1;6;0;1;1792;6;6;1;0;0;1;2;1792;0;4706;2;2;
/org.eclipse.swt.examples.paint/src/org/eclipse/swt/examples/paint/LineTool.java;4;0;5;2;1;1;1;4;62;2;3;513;70;70;2;1;0;4;5;609;1;4705;4;4;
/org.eclipse.pde.core/src/org/eclipse/pde/core/IModelChangedEvent.java;1;0;3;1;2;1;2;1;72;0;1;3591;72;72;2;0;1;1;3;4751;1;4751;2;1;
/org.eclipse.jdt.ui/ui/org/eclipse/jdt/internal/ui/text/java/hover/JavaTypeHover.java;4;0;19;1;1;1;1;18;172;2;17;15;625;625;2;1;0;18;19;2495;1;4443;18;4;
/org.eclipse.team.core/src/org/eclipse/team/core/ITeamValidator.java;2;0;2;1;0;0;0;2;0;1;2;2123;0;0;1;0;0;2;2;2123;0;2155;2;2;
/org.eclipse.swt/Eclipse SWT PI/win32/org/eclipse/swt/internal/ole/win32/IConnectionPointContainer.java;2;0;2;1;1;1;1;1;6;0;1;2069;6;6;1;0;0;1;2;2069;0;4701;2;2;
/org.eclipse.jdt.debug/jdi/org/eclipse/jdi/internal/VoidTypeImpl.java;2;0;5;1;0;0;0;5;13;1;5;187;29;29;1;0;0;5;5;187;0;3678;5;2;
/org.eclipse.team.cvs.ui/src/org/eclipse/team/internal/ccvs/ui/sync/AddSyncAction.java;2;2;6;2;6;5;6;0;43;0;0;4055;78;78;2;0;1;0;6;4055;1;4455;5;2;
/org.eclipse.ui/Eclipse UI/org/eclipse/ui/actions/BuildAction.java;6;0;9;1;1;1;1;8;101;1;8;257;222;222;1;0;0;8;9;257;0;4082;9;6;
/org.eclipse.jdt.ui.tests.refactoring/resources/ExtractMethodWorkSpace/ExtractMethodTests/locals_in/A_test519.java;2;1;4;1;2;2;2;2;9;1;2;511;9;9;1;0;0;2;4;511;0;4419;4;2;
/org.eclipse.vcm.core.cvs/src/org/eclipse/vcm/internal/core/ccvs/VersionInfo.java;1;0;4;1;0;0;0;4;19;1;4;199;23;23;1;0;0;4;4;199;0;1265;4;1;
/org.eclipse.jdt.debug/model/org/eclipse/jdt/internal/debug/core/model/JDIValue.java;3;0;7;2;1;1;1;6;7;3;4;2517;21;21;3;2;0;6;7;2517;2;4423;5;3;
/org.eclipse.swt/Eclipse SWT/common_j2se/org/eclipse/swt/internal/EventObjectCompatibility.java;2;0;2;1;0;0;0;2;0;1;2;1438;0;0;1;0;0;2;2;1438;0;1561;2;2;
/org.eclipse.swt.examples/Eclipse SWT Examples/common/org/eclipse/swt/examples/explorer/ShellContainer.java;1;0;1;1;0;0;0;1;0;0;1;480;0;0;1;0;0;1;1;480;0;480;1;1;
/org.eclipse.core.tests.resources/src/org/eclipse/core/tests/internal/indexing/IntegratedTestEnvironment.java;3;0;3;1;1;1;1;2;46;1;2;1794;56;56;1;0;0;2;3;1794;0;4516;3;3;
/org.eclipse.jdt.ui.tests.refactoring/resources/RenameTemp/canRename/A_test1_out.java;1;0;2;1;0;0;0;2;2;1;2;1625;2;2;1;0;0;2;2;1625;0;1652;2;1;
/org.eclipse.ui/Eclipse UI/org/eclipse/ui/internal/IMarkerImageProvider.java;2;0;2;1;0;0;0;2;5;1;2;257;5;5;1;0;0;2;2;257;0;457;2;2;
/org.eclipse.swt/Eclipse SWT PI/win32/org/eclipse/swt/internal/ole/win32/DISPPARAMS.java;2;0;2;1;1;1;1;1;6;0;1;2069;6;6;1;0;0;1;2;2069;0;4701;2;2;
/org.eclipse.jdt.ui/ui/org/eclipse/jdt/ui/actions/FindReferencesAction.java;2;1;5;1;5;5;5;0;39;0;0;4141;69;69;1;0;0;0;5;4141;0;4770;5;2;
/org.eclipse.update.ui/src/org/eclipse/update/internal/ui/parts/VolumeLabelProvider.java;1;0;1;1;1;1;1;0;0;0;0;4100;0;0;1;0;0;0;1;4100;0;4100;1;1;
/org.eclipse.core.resources/src/org/eclipse/core/internal/filesystem/FileSystemStore2.java;1;0;1;1;0;0;0;1;0;0;1;653;0;0;1;0;0;1;1;653;0;653;1;1;
/org.eclipse.ui.tests/Eclipse JFace Tests/org/eclipse/jface/tests/viewers/interactive/DeleteSiblingsAction.java;1;0;1;1;0;0;0;1;0;0;1;1488;0;0;1;0;0;1;1;1488;0;1488;1;1;
/org.eclipse.jdt.ui.tests.refactoring/resources/RenameNonPrivateField/test9/in/A.java;1;0;1;1;0;0;0;1;0;0;1;49;0;0;1;0;0;1;1;49;0;49;1;1;
/org.eclipse.jdt.ui/ui refactoring/org/eclipse/jdt/internal/ui/refactoring/actions/ListDialog.java;2;0;5;1;0;0;0;5;82;1;5;1406;105;105;1;0;0;5;5;1406;0;2775;5;2;
/org.eclipse.jdt.junit/Eclipse JUnit/org/eclipse/jdt/internal/junit/ui/JUnitLauncher.java;2;0;3;1;0;0;0;3;42;1;3;2143;42;42;1;0;0;3;3;2143;0;3313;3;2;
/org.eclipse.pde.ui/src/org/eclipse/pde/internal/ui/ischema/IMetaElement.java;1;0;2;1;0;0;0;2;0;1;2;3579;0;0;1;0;0;2;2;3579;0;3591;2;1;
/org.eclipse.jdt.debug/jdi interfaces/com/sun/jdi/IncompatibleThreadStateException.java;2;0;2;1;0;0;0;2;7;1;2;2704;7;7;1;0;0;2;2;2704;0;3033;2;2;
/org.eclipse.pde.ui/src/org/eclipse/pde/internal/ui/editor/feature/NewFeaturePluginWizard.java;1;0;3;1;1;1;1;2;2;1;2;3579;2;2;1;0;0;2;3;3579;0;4262;3;1;
/org.eclipse.debug.ui/ui/org/eclipse/debug/internal/ui/CopyVariablesToClipboardActionDelegate.java;2;0;8;1;0;0;0;8;48;2;7;960;109;109;2;1;0;8;8;2350;1;2382;7;2;
/org.eclipse.update.ui.forms/src/org/eclipse/update/ui/forms/internal/AbstractSectionForm.java;1;1;12;1;3;3;3;9;248;2;8;2470;463;463;2;1;0;9;12;3727;1;4628;11;1;
/org.eclipse.jdt.ui/core refactoring/org/eclipse/jdt/internal/corext/refactoring/util/GetterSetterUtil.java;1;0;2;1;0;0;0;2;0;1;2;2804;0;0;1;0;0;2;2;2804;0;2931;2;1;
/org.eclipse.jdt.ui.tests.refactoring/resources/RenameStaticMethod/test1/out/A.java;2;0;2;1;0;0;0;2;1;1;2;49;1;1;1;0;0;2;2;49;0;1297;2;2;
/org.eclipse.jdt.ui.tests.refactoring/resources/ExtractMethodWorkSpace/ExtractMethodTests/invalidSelection/A_test121.java;2;1;5;1;2;2;2;3;16;1;3;65;25;25;1;0;0;3;5;65;0;4419;5;2;
/org.eclipse.scripting/Eclipse Scripting/org/eclipse/scripting/internal/views/ScriptDevelopmentPreferencePage.java;2;0;6;1;0;0;0;6;326;2;5;133;354;354;2;1;0;6;6;756;1;1424;5;2;
/org.eclipse.pde.runtime/Eclipse PDE Runtime/org/eclipse/pde/internal/runtime/registry/LibraryPropertySource.java;2;0;3;1;0;0;0;3;4;1;3;267;4;4;1;0;0;3;3;267;0;1434;3;2;
/org.eclipse.ui/Eclipse UI Standard Components/org/eclipse/ui/views/properties/PropertiesMessages.java;1;0;1;1;0;0;0;1;0;0;1;457;0;0;1;0;0;1;1;457;0;457;1;1;
/org.eclipse.core.resources/src/org/eclipse/core/internal/dtree/DataTreeWriter.java;2;0;5;1;1;1;1;4;354;1;4;12;386;386;1;0;0;4;5;12;0;4214;5;2;
/org.eclipse.ui/Eclipse JFace/org/eclipse/jface/action/IMenuManager.java;3;0;3;1;0;0;0;3;6;1;3;257;11;11;1;0;0;3;3;257;0;3450;3;3;
/org.eclipse.swt/Eclipse SWT Custom Widgets/common_j2se/org/eclipse/swt/custom/ExtendedModifyListener.java;1;0;1;1;0;0;0;1;0;0;1;1378;0;0;1;0;0;1;1;1378;0;1378;1;1;
/org.eclipse.core.resources/src/org/eclipse/core/internal/dtree/TestHelper.java;1;0;4;1;1;1;1;3;36;1;3;12;57;57;1;0;0;3;4;12;0;4214;4;1;
/org.eclipse.jdt.debug.ui/ui/org/eclipse/jdt/internal/debug/ui/snippeteditor/RunSnippetAction.java;1;0;1;1;1;1;1;0;0;0;0;3935;0;0;1;0;0;0;1;3935;0;3935;1;1;
/org.eclipse.jdt.ui.tests.refactoring/resources/RenameType/testIllegalTypeName2/in/A.java;1;0;1;1;0;0;0;1;0;0;1;49;0;0;1;0;0;1;1;49;0;49;1;1;
/org.eclipse.jdt.ui.tests.refactoring/resources/RenameVirtualMethodInClass/testFail15/in/A.java;1;0;1;1;0;0;0;1;0;0;1;49;0;0;1;0;0;1;1;49;0;49;1;1;
/org.eclipse.pde.ui/src/org/eclipse/pde/internal/wizards/project/PluginCodeGeneratorWizard.java;2;0;4;1;0;0;0;4;3;1;4;1434;5;5;1;0;0;4;4;1434;0;3240;4;2;
/org.eclipse.team.tests.cvs.core/src/org/eclipse/team/tests/ccvs/ui/logformatter/TaskEntry.java;2;0;3;1;0;0;0;3;82;1;3;2977;84;84;1;0;0;3;3;2977;0;3873;3;2;
/org.eclipse.scripting/src/org/eclipse/scripting/internal/views/ScriptDevelopmentWizardPageIconName.java;1;0;1;1;0;0;0;1;0;0;1;1424;0;0;1;0;0;1;1;1424;0;1424;1;1;
/org.eclipse.jdt.debug.tests/tests/org/eclipse/jdt/debug/tests/eval/generator/TestGenerator.java;2;1;3;1;3;3;3;0;40;0;0;4447;61;61;1;0;0;0;3;4447;0;4571;3;2;
/org.eclipse.vcm.ui.cvs/src/org/eclipse/vcm/internal/ui/ccvs/RepositoryConnectionAction.java;3;0;4;1;0;0;0;4;4;1;4;33;8;8;1;0;0;4;4;33;0;297;4;3;
/org.eclipse.jdt.ui.tests.refactoring/resources/MoveMembers/testFail16/in/B.java;1;0;1;1;0;0;0;1;0;0;1;2738;0;0;1;0;0;1;1;2738;0;2738;1;1;
/org.eclipse.jdt.core/compiler/org/eclipse/jdt/internal/compiler/problem/DefaultProblemFactory.java;2;0;17;2;1;1;1;16;214;4;10;455;380;380;4;6;0;16;17;1039;6;4062;11;2;
/org.eclipse.ui/Eclipse UI/org/eclipse/ui/internal/registry/Accelerator.java;3;0;7;1;0;0;0;7;162;1;7;3055;428;428;1;0;0;7;7;3055;0;3607;7;3;
/org.eclipse.scripting/src/org/eclipse/scripting/internal/views/ScriptConsoleClearAction.java;1;0;1;1;0;0;0;1;0;0;1;1424;0;0;1;0;0;1;1;1424;0;1424;1;1;
/org.eclipse.ui.tests/Eclipse JFace Tests/org/eclipse/jface/tests/viewers/interactive/TestList.java;1;0;1;1;0;0;0;1;0;0;1;1488;0;0;1;0;0;1;1;1488;0;1488;1;1;
/org.eclipse.pde.ui/src/org/eclipse/pde/internal/preferences/AdvancedTracingPreferencePage.java;2;0;6;1;0;0;0;6;33;2;5;1434;40;40;2;1;0;6;6;3035;1;3579;5;2;
/org.eclipse.jdt.ui.tests.refactoring/resources/InlineTemp/cannotInline/A_testFail8.java;1;0;1;1;0;0;0;1;0;0;1;3357;0;0;1;0;0;1;1;3357;0;3357;1;1;
/org.eclipse.swt/Eclipse SWT/emulated/treetable/org/eclipse/swt/widgets/SelectableItem.java;3;1;3;1;2;2;2;1;6;0;1;1028;8;8;1;0;0;1;3;1028;0;4701;3;3;
/org.eclipse.jdt.ui.tests/examples/org/eclipse/jdt/ui/examples/StringInputDialogExample.java;1;0;2;1;0;0;0;2;0;1;2;1186;0;0;1;0;0;2;2;1186;0;1276;2;1;
/org.eclipse.jdt.ui.tests.refactoring/resources/ExtractMethodWorkSpace/ExtractMethodTests/locals_in/A_test522.java;1;1;3;1;2;2;2;1;32;0;1;1851;32;32;1;0;0;1;3;1851;0;4419;3;1;
/org.eclipse.swt/Eclipse SWT/photon/org/eclipse/swt/graphics/Cursor.java;4;1;7;1;3;3;3;4;110;1;4;106;274;274;1;0;0;4;7;106;0;4701;7;4;
/org.eclipse.jdt.ui.tests.refactoring/resources/RenameType/test47/out/B.java;1;0;1;1;0;0;0;1;0;0;1;522;0;0;1;0;0;1;1;522;0;522;1;1;
/org.eclipse.compare/compare/org/eclipse/compare/structuremergeviewer/Differencer.java;2;0;7;1;0;0;0;7;30;1;7;14;68;68;1;0;0;7;7;14;0;1513;7;2;
/org.eclipse.pde.ui/src/org/eclipse/pde/internal/base/model/feature/IFeatureObject.java;1;0;5;1;0;0;0;5;3;2;4;2951;7;7;2;1;0;5;5;2951;1;3579;4;1;
/org.eclipse.pde.ui/src/org/eclipse/pde/internal/ui/wizards/extension/NewExtensionWizard.java;1;0;1;1;0;0;0;1;0;0;1;3579;0;0;1;0;0;1;1;3579;0;3579;1;1;
/org.eclipse.jdt.ui.tests/JUnit/junit/framework/Assert.java;2;0;2;1;0;0;0;2;0;1;2;49;0;0;1;0;0;2;2;49;0;1186;2;2;
/org.eclipse.ui/Eclipse UI/org/eclipse/ui/internal/EditorPluginAction.java;3;0;7;1;0;0;0;7;33;1;7;257;54;54;1;0;0;7;7;257;0;2254;7;3;
/org.eclipse.jdt.ui/core refactoring/org/eclipse/jdt/internal/core/nls/model/NLSRefactoring.java;1;0;2;1;0;0;0;2;0;1;2;1913;0;0;1;0;0;2;2;1913;0;1922;2;1;
/org.eclipse.ui/Eclipse UI/org/eclipse/ui/internal/model/WorkbenchStatusList.java;2;0;2;1;0;0;0;2;4;1;2;257;4;4;1;0;0;2;2;257;0;457;2;2;
/org.eclipse.jdt.ui.tests.refactoring/resources/SafeDeleteType/testFail21/in/A.java;1;0;1;1;0;0;0;1;0;0;1;49;0;0;1;0;0;1;1;49;0;49;1;1;
/org.eclipse.core.boot/src/org/eclipse/core/internal/boot/update/URLNamePair.java;2;0;3;1;0;0;0;3;7;1;3;12;7;7;1;0;0;3;3;12;0;2726;3;2;
/org.eclipse.jdt.debug/model/org/eclipse/jdt/debug/core/IJavaWatchpoint.java;2;0;12;1;1;1;1;11;66;3;9;1035;151;151;3;2;0;11;12;1480;2;4423;10;2;
/org.eclipse.pde.ui/Eclipse PDE UI/org/eclipse/pde/internal/editor/build/BuildPropertiesEditor.java;2;0;8;2;0;0;0;8;19;3;6;267;35;35;3;2;0;8;8;324;2;1434;6;2;
/org.eclipse.debug.ui/ui/org/eclipse/debug/internal/ui/DefaultLabelProvider.java;4;1;16;1;2;2;2;14;270;2;12;2021;396;396;2;2;0;14;16;2343;2;4193;14;4;
/org.eclipse.pde.ui/src/org/eclipse/pde/internal/wizards/templates/TemplateSelectionPage.java;1;0;3;1;0;0;0;3;2;2;2;3442;2;2;2;1;0;3;3;3442;1;3579;2;1;
/org.eclipse.jdt.ui/ui/org/eclipse/jdt/internal/ui/JavaUIMessages.java;2;0;2;1;0;0;0;2;12;1;2;740;12;12;1;0;0;2;2;740;0;949;2;2;
/org.eclipse.jdt.ui/ui/org/eclipse/jdt/internal/ui/IResourceLocator.java;2;0;3;1;1;1;1;2;9;1;2;15;13;13;1;0;0;2;3;15;0;4400;3;2;
/org.eclipse.vcm.ui.cvs/src/org/eclipse/vcm/internal/ui/ccvs/ModuleAliasProjectFilter.java;1;0;4;1;0;0;0;4;90;1;4;1424;108;108;1;0;0;4;4;1424;0;1578;4;1;
/org.eclipse.help/src/org/eclipse/help/ILiveHelpAction.java;1;0;2;1;1;1;1;1;6;0;1;3048;6;6;1;0;0;1;2;3048;0;3938;2;1;
/org.eclipse.jdt.core/model/org/eclipse/jdt/internal/core/builder/impl/TypeHierarchyIndictment.java;1;0;11;1;0;0;0;11;36;4;7;455;63;63;4;4;0;11;11;1039;4;2808;7;1;
/org.eclipse.jdt.ui.tests.refactoring/resources/RenameTemp/cannotRename/A_testFail12.java;1;0;3;1;0;0;0;3;2;1;3;1625;4;4;1;0;0;3;3;1625;0;3265;3;1;
/org.eclipse.jdt.ui/ui/org/eclipse/jdt/internal/ui/viewsupport/IOverlayDescriptor.java;2;0;3;1;0;0;0;3;8;1;3;15;8;8;1;0;0;3;3;15;0;1310;3;2;
/org.eclipse.swt.examples.paint/org/eclipse/swt/examples/paint/PaintStatus.java;2;0;3;2;0;0;0;3;91;2;2;513;91;91;2;1;0;3;3;609;1;609;2;2;
/org.eclipse.jdt.ui/ui/org/eclipse/jdt/internal/ui/typehierarchy/SuperTypeHierarchyViewer.java;2;0;9;1;0;0;0;9;12;1;9;15;51;51;1;0;0;9;9;15;0;3150;9;2;
/org.eclipse.ui.tests/UI Test Utils/org/eclipse/ui/tests/util/DialogCheck.java;1;0;1;1;0;0;0;1;0;0;1;2785;0;0;1;0;0;1;1;2785;0;2785;1;1;
/org.eclipse.jdt.core/eval/org/eclipse/jdt/internal/eval/CodeSnippetSkeleton.java;2;1;13;1;2;2;2;11;173;4;7;455;395;395;4;4;0;11;13;1039;4;4404;9;2;
/org.eclipse.ui/Eclipse JFace Text/org/eclipse/jface/text/source/AnnotationModelEvent.java;1;0;2;1;1;1;1;1;27;0;1;3630;27;27;1;0;0;1;2;3630;0;4838;2;1;
/org.eclipse.team.ftp/src/org/eclipse/team/internal/ftp/client/FTPCommunicationException.java;1;1;2;1;2;2;2;0;4;0;0;4169;4;4;1;0;0;0;2;4169;0;4241;2;1;
/org.eclipse.pde.ui/Eclipse PDE UI/org/eclipse/pde/internal/editor/schema/SchemaContentProvider.java;2;0;5;2;0;0;0;5;12;3;3;267;12;12;3;2;0;5;5;324;2;1434;3;2;
/org.eclipse.jdt.ui.tests.refactoring/resources/RenameType/test12/out/B.java;1;0;1;1;0;0;0;1;0;0;1;522;0;0;1;0;0;1;1;522;0;522;1;1;
/org.eclipse.core.target/src/org/eclipse/core/internal/target/TargetDefinition.java;1;0;4;1;1;1;1;3;120;1;3;681;157;157;1;0;0;3;4;681;0;4196;4;1;
/org.eclipse.swt/Eclipse SWT PI/win32/org/eclipse/swt/internal/ole/win32/IOleInPlaceObject.java;2;1;3;1;2;2;2;1;6;0;1;2069;12;12;1;0;0;1;3;2069;0;4701;3;2;
/org.eclipse.ui/Eclipse UI/org/eclipse/ui/internal/ShortcutBarPart.java;3;0;3;1;0;0;0;3;206;1;3;257;212;212;1;0;0;3;3;257;0;3151;3;3;
/org.eclipse.update/Eclipse Update/org/eclipse/update/internal/ui/UMWizardURLNamePairComparator.java;2;0;4;1;0;0;0;4;96;1;4;108;100;100;1;0;0;4;4;108;0;1424;4;2;
/org.eclipse.swt/Eclipse SWT/photon/org/eclipse/swt/widgets/Button.java;8;1;20;2;4;4;4;16;171;2;12;106;520;520;2;4;0;16;20;609;4;4701;16;8;
/org.eclipse.jdt.ui/ui/org/eclipse/jdt/internal/ui/snippeteditor/ScrapbookMain.java;3;0;7;1;0;0;0;7;53;1;7;15;106;106;1;0;0;7;7;15;0;1916;7;3;
/org.eclipse.update.core/src/org/eclipse/update/core/ListenersList.java;1;0;2;1;0;0;0;2;0;1;2;1451;0;0;1;0;0;2;2;1451;0;1643;2;1;
/org.eclipse.jdt.ui.tests.refactoring/resources/MoveMembers/testFail21/in/B.java;1;0;1;1;0;0;0;1;0;0;1;2928;0;0;1;0;0;1;1;2928;0;2928;1;1;
/org.eclipse.swt/Eclipse SWT/motif/org/eclipse/swt/widgets/SelectableItem.java;2;0;4;1;0;0;0;4;24;1;4;106;38;38;1;0;0;4;4;106;0;1028;4;2;
/org.eclipse.pde.ui/src/org/eclipse/pde/internal/ui/editor/manifest/RequiresSection.java;1;0;4;1;0;0;0;4;26;2;3;3579;41;41;2;1;0;4;4;3579;1;3668;3;1;
/org.eclipse.pde.ui/src/org/eclipse/pde/internal/ui/wizards/templates/NewPluginTemplateWizard.java;1;0;3;1;0;0;0;3;2;1;3;3579;2;2;1;0;0;3;3;3579;0;3840;3;1;
/org.eclipse.jdt.ui/ui/org/eclipse/jdt/internal/ui/javadocexport/JavadocTreeWizardPage.java;5;1;21;1;7;7;7;14;451;2;12;2878;1567;1567;2;2;0;14;21;2878;2;4630;19;5;
/org.eclipse.jdt.debug/eval/org/eclipse/jdt/internal/debug/eval/ast/instructions/LessEqualOperator.java;3;0;7;1;1;1;1;6;36;1;6;3421;50;50;1;0;0;6;7;3421;0;3955;7;3;
/org.eclipse.jdt.ui.tests.refactoring/resources/SelectionAnalyzerWorkSpace/SelectionAnalyzerTests/invalidSelection/A_test107.java;1;0;1;1;0;0;0;1;0;0;1;1368;0;0;1;0;0;1;1;1368;0;1368;1;1;
/org.eclipse.swt/Eclipse SWT Drag and Drop/photon/org/eclipse/swt/dnd/TransferData.java;3;1;7;1;3;3;3;4;39;1;4;106;78;78;1;0;0;4;7;106;0;4701;7;3;
/org.eclipse.debug.core/core/org/eclipse/debug/core/ILineBreakpoint.java;1;0;2;1;0;0;0;2;0;1;2;1035;0;0;1;0;0;2;2;1035;0;1139;2;1;
/org.eclipse.swt/Eclipse SWT/motif/org/eclipse/swt/widgets/Header.java;3;0;4;1;0;0;0;4;10;1;4;106;16;16;1;0;0;4;4;106;0;1087;4;3;
/org.eclipse.swt/Eclipse SWT/win32/org/eclipse/swt/internal/win32/OSVERSIONINFO.java;2;0;3;1;0;0;0;3;17;1;3;1507;17;17;1;0;0;3;3;1507;0;2069;3;2;
/org.eclipse.jdt.ui/ui/org/eclipse/jdt/internal/ui/launcher/VMStandin.java;2;0;3;1;0;0;0;3;2;1;3;413;2;2;1;0;0;3;3;413;0;1916;3;2;
/org.eclipse.jdt.ui/ui/org/eclipse/jdt/internal/ui/text/LineWrappingTextPresenter.java;1;0;3;1;0;0;0;3;5;1;3;1384;5;5;1;0;0;3;3;1384;0;1482;3;1;
/org.eclipse.team.cvs.ui/src/org/eclipse/team/internal/ccvs/ui/actions/OpenRemoteFileAction.java;3;1;12;1;3;3;3;9;202;1;9;1978;281;281;1;0;0;9;12;1978;0;4823;12;3;
/org.eclipse.vcm.ui/src/org/eclipse/vcm/internal/ui/syncdialog/Repository.java;2;0;6;2;0;0;0;6;16;3;4;1;32;32;3;2;0;6;6;1;2;68;4;2;
/org.eclipse.jdt.debug.ui/ui/org/eclipse/jdt/internal/debug/ui/launcher/UnresolvedJREStatusHandler.java;2;2;5;1;5;4;5;0;14;0;0;4148;35;35;2;0;1;0;5;4347;1;4393;4;2;
/org.eclipse.compare/compare/org/eclipse/compare/CompareUI.java;3;1;9;1;2;2;2;7;57;1;7;14;96;96;1;0;0;7;9;14;0;4820;9;3;
/org.eclipse.ui/Eclipse UI/org/eclipse/ui/internal/WorkingSetComparator.java;1;0;2;1;0;0;0;2;35;1;2;3287;35;35;1;0;0;2;2;3287;0;3494;2;1;
/org.eclipse.scripting/src/org/eclipse/scripting/ScriptAdapterDelegatingPreferencePage.java;1;0;1;1;0;0;0;1;0;0;1;1424;0;0;1;0;0;1;1;1424;0;1424;1;1;
/org.eclipse.ui/Eclipse UI/org/eclipse/ui/dialogs/ISelectionValidator.java;2;0;2;1;0;0;0;2;5;1;2;257;5;5;1;0;0;2;2;257;0;457;2;2;
/org.eclipse.jdt.ui.tests.refactoring/resources/RenamePackage/testReadOnly/in/r/A.java;1;0;1;1;0;0;0;1;0;0;1;1930;0;0;1;0;0;1;1;1930;0;1930;1;1;
/org.eclipse.jdt.ui.tests.refactoring/resources/StructureSelectionAction/A_test19.java;1;0;1;1;0;0;0;1;0;0;1;2139;0;0;1;0;0;1;1;2139;0;2139;1;1;
/org.eclipse.pde.ui/src/org/eclipse/pde/internal/editor/manifest/NullMenuManager.java;2;0;4;1;0;0;0;4;190;1;4;1434;192;192;1;0;0;4;4;1434;0;3579;4;2;
/org.eclipse.scripting/src/org/eclipse/scripting/internal/uirenderer/XGRElementUISwtPropertySheet.java;1;0;1;1;0;0;0;1;0;0;1;1424;0;0;1;0;0;1;1;1424;0;1424;1;1;
/org.eclipse.help/Eclipse Help/org/eclipse/help/internal/contributors/xml/XMLViewContributor.java;2;0;3;1;0;0;0;3;7;1;3;135;7;7;1;0;0;3;3;135;0;1420;3;2;
/org.eclipse.ui/Eclipse UI/org/eclipse/ui/IFolderLayout.java;3;0;3;1;0;0;0;3;28;1;3;257;33;33;1;0;0;3;3;257;0;3528;3;3;
/org.eclipse.jdt.ui.tests.refactoring/resources/SelectionAnalyzerWorkSpace/SelectionAnalyzerTests/validSelection/A_test260.java;1;0;1;1;0;0;0;1;0;0;1;1368;0;0;1;0;0;1;1;1368;0;1368;1;1;
/org.eclipse.jdt.debug.tests/test programs/MethodEntryRunner.java;1;0;2;1;0;0;0;2;0;1;2;3701;0;0;1;0;0;2;2;3701;0;3719;2;1;
/org.eclipse.jdt.ui.tests.refactoring/resources/RenameType/test23/in/A.java;1;0;1;1;0;0;0;1;0;0;1;49;0;0;1;0;0;1;1;49;0;49;1;1;
/org.eclipse.jdt.ui.tests.refactoring/resources/RenameNonPrivateField/testFail5/in/A.java;1;0;1;1;0;0;0;1;0;0;1;49;0;0;1;0;0;1;1;49;0;49;1;1;
/org.eclipse.jdt.debug.ui/ui/org/eclipse/jdt/internal/debug/ui/SuspendTimeoutStatusHandler.java;2;1;2;1;2;2;2;0;12;0;0;4387;12;12;1;0;0;0;2;4387;0;4567;2;2;
/org.eclipse.update.ui.forms/src/org/eclipse/update/ui/forms/internal/engine/TextModel.java;2;1;12;1;3;3;3;9;213;2;7;2745;453;453;2;2;0;9;12;2745;2;4365;10;2;
/org.eclipse.jdt.ui.tests.refactoring/resources/RenameMethodInInterface/test5/in/A.java;1;0;1;1;0;0;0;1;0;0;1;49;0;0;1;0;0;1;1;49;0;49;1;1;
/org.eclipse.compare/compare/org/eclipse/compare/patch/CheckboxTreeAndListGroup.java;1;0;2;1;0;0;0;2;0;1;2;1802;0;0;1;0;0;2;2;1802;0;1830;2;1;
/org.eclipse.core.resources/src/org/eclipse/core/internal/filesystem/FileSystemFile.java;1;0;1;1;0;0;0;1;0;0;1;653;0;0;1;0;0;1;1;653;0;653;1;1;
/org.eclipse.jdt.debug/eval/org/eclipse/jdt/internal/debug/eval/ast/ASTEvaluationEngine.java;1;0;5;1;0;0;0;5;111;3;3;3386;125;125;3;2;0;5;5;3396;2;3421;3;1;
/org.eclipse.webdav/src/kernel/org/eclipse/webdav/internal/kernel/utils/EnumerationFilter.java;1;0;4;1;1;1;1;3;34;1;3;12;54;54;1;0;0;3;4;12;0;4211;4;1;
/org.eclipse.swt/Eclipse SWT PI/win32/org/eclipse/swt/internal/win32/INITCOMMONCONTROLSEX.java;2;0;2;1;1;1;1;1;6;0;1;2069;6;6;1;0;0;1;2;2069;0;4701;2;2;
/org.eclipse.jdt.core/compiler/org/eclipse/jdt/internal/compiler/ast/Reference.java;2;1;12;1;2;2;2;10;147;4;7;455;252;252;4;3;0;10;12;1039;3;4421;9;2;
/org.eclipse.jdt.ui/ui/org/eclipse/jdt/internal/ui/text/template/TemplateLabelProvider.java;1;0;6;1;1;1;1;5;12;1;5;1469;37;37;1;0;0;5;6;1469;0;4275;6;1;
/org.eclipse.pde.ui/src/org/eclipse/pde/internal/core/plugin/PluginElement.java;1;0;4;1;0;0;0;4;13;2;3;3579;15;15;2;1;0;4;4;3579;1;3607;3;1;
/org.eclipse.scripting/Eclipse Scripting/org/eclipse/scripting/ScriptAbstractPreferencePage.java;2;0;5;1;0;0;0;5;42;1;5;133;91;91;1;0;0;5;5;133;0;1424;5;2;
/org.eclipse.jdt.ui.tests.refactoring/test cases/org/eclipse/jdt/ui/tests/actions/PasteSourceReferenceActionTests.java;1;1;12;1;2;2;2;10;158;2;9;2003;352;352;2;1;0;10;12;2003;1;4563;11;1;
/org.eclipse.jdt.ui.tests/refactoring/org/eclipse/jdt/refactoring/tests/RenameNonPrivateFieldTests.java;4;0;18;1;0;0;0;18;30;1;18;49;171;171;1;0;0;18;18;49;0;1896;18;4;
/org.eclipse.jdt.ui/core refactoring/org/eclipse/jdt/internal/core/refactoring/methods/RenameStaticMethodRefactoring.java;2;0;7;1;0;0;0;7;52;1;7;408;80;80;1;0;0;7;7;408;0;1342;7;2;
/org.eclipse.update.tests.core/src/org/eclipse/update/tests/nestedfeatures/TestInstall.java;2;2;5;1;5;4;5;0;259;0;0;3974;264;264;2;0;1;0;5;3974;1;4324;4;2;
/org.eclipse.core.resources/src/org/eclipse/core/internal/watson/ElementTree.java;2;0;10;1;1;1;1;9;1866;1;9;12;2006;2006;1;0;0;9;10;12;0;4214;10;2;
/org.eclipse.jdt.ui/core refactoring/org/eclipse/jdt/core/refactoring/fields/RenameFieldASTAnalyzer.java;1;0;3;1;0;0;0;3;5;1;3;28;5;5;1;0;0;3;3;28;0;408;3;1;
/org.eclipse.update.ui/src/org/eclipse/update/ui/internal/model/ModelObject.java;1;0;4;1;0;0;0;4;18;1;4;1526;23;23;1;0;0;4;4;1526;0;2797;4;1;
/org.eclipse.jdt.ui/ui/org/eclipse/jdt/internal/ui/text/SingleCharReader.java;2;0;3;1;0;0;0;3;2;1;3;1384;2;2;1;0;0;3;3;1384;0;2495;3;2;
/org.eclipse.pde.ui/Eclipse PDE UI/org/eclipse/pde/internal/forms/IFormSelectionListener.java;2;0;5;2;0;0;0;5;12;3;3;267;12;12;3;2;0;5;5;324;2;1434;3;2;
/org.eclipse.pde.ui/src/org/eclipse/pde/internal/model/component/Component.java;2;0;2;1;0;0;0;2;0;1;2;1434;0;0;1;0;0;2;2;1434;0;2951;2;2;
/org.eclipse.pde.ui/Eclipse PDE UI/org/eclipse/pde/internal/builders/ManifestConsistencyChecker.java;2;0;6;2;0;0;0;6;30;3;4;267;42;42;3;2;0;6;6;324;2;1434;4;2;
/org.eclipse.jdt.debug.ui/ui/org/eclipse/jdt/internal/debug/ui/display/EvaluateAction.java;2;0;19;1;0;0;0;19;272;2;18;1915;665;665;2;1;0;19;19;2187;1;2813;18;2;
/org.eclipse.jdt.ui.tests/test plugin/org/eclipse/jdt/testplugin/util/VerifyDialog.java;2;0;2;1;1;1;1;1;24;0;1;2180;24;24;1;0;0;1;2;2180;0;4682;2;2;
/org.eclipse.swt.examples.controls/org/eclipse/swt/examples/controls/SashTab.java;2;0;3;1;0;0;0;3;158;1;3;513;158;158;1;0;0;3;3;513;0;970;3;2;
/org.eclipse.pde.ui/src/org/eclipse/pde/internal/core/build/BuildModelFactory.java;1;0;2;1;0;0;0;2;0;1;2;3579;0;0;1;0;0;2;2;3579;0;3607;2;1;
/org.eclipse.jdt.ui.tests.refactoring/resources/SelectionAnalyzerWorkSpace/SelectionAnalyzerTests/validSelection/A_test275.java;1;0;1;1;0;0;0;1;0;0;1;1368;0;0;1;0;0;1;1;1368;0;1368;1;1;
/org.eclipse.pde.ui/Eclipse PDE UI/org/eclipse/pde/internal/preferences/RuntimeOption.java;2;0;5;2;0;0;0;5;57;3;3;267;57;57;3;2;0;5;5;324;2;1434;3;2;
/org.eclipse.jdt.launching/launching/org/eclipse/jdt/launching/ProjectSourceLocator.java;3;1;13;1;2;2;2;11;298;3;9;2022;411;411;3;2;0;11;13;2378;2;3958;11;3;
/org.eclipse.jdt.core/dom/org/eclipse/jdt/core/dom/Expression.java;2;0;3;1;0;0;0;3;2;1;3;2669;3;3;1;0;0;3;3;2669;0;3816;3;2;
/org.eclipse.jdt.debug.tests/tests/org/eclipse/jdt/debug/tests/eval/ArrayAllocationTests.java;2;2;3;2;3;2;3;0;17;0;0;4447;19;19;2;0;1;0;3;4447;1;4571;2;2;
/org.eclipse.vcm.core/src/org/eclipse/vcm/internal/core/DeepVersionHandle.java;4;0;6;1;0;0;0;6;29;1;6;0;54;54;1;0;0;6;6;0;0;983;6;4;
/org.eclipse.ui/Eclipse JFace/org/eclipse/jface/action/ActionContributionItem.java;5;0;12;2;0;0;0;12;112;3;8;257;230;230;3;4;0;12;12;3447;4;3447;8;5;
/org.eclipse.core.tests.runtime/src/org/eclipse/core/tests/internal/runtime/LogSerializationTest.java;2;0;6;1;1;1;1;5;364;1;5;1822;490;490;1;0;0;5;6;1822;0;4127;6;2;
/org.eclipse.pde.ui/src/org/eclipse/pde/internal/base/schema/ISchemaCompositor.java;2;0;2;1;0;0;0;2;0;1;2;1434;0;0;1;0;0;2;2;1434;0;3579;2;2;
/org.eclipse.jdt.ui/ui/org/eclipse/jdt/internal/ui/text/java/JavaFormattingStrategy.java;4;0;21;1;0;0;0;21;109;2;20;15;419;419;2;1;0;21;21;215;1;3833;20;4;
/org.eclipse.jdt.core/model/org/eclipse/jdt/internal/core/builder/impl/TypeCollaboratorIndictment.java;1;0;11;1;0;0;0;11;33;4;7;455;60;60;4;4;0;11;11;1039;4;2808;7;1;
/org.eclipse.pde.ui/src/org/eclipse/pde/internal/base/model/IModelProviderEvent.java;2;0;4;1;0;0;0;4;45;1;4;1434;47;47;1;0;0;4;4;1434;0;3136;4;2;
/org.eclipse.team.cvs.core/src/org/eclipse/team/internal/ccvs/core/resources/api/IManagedFile.java;3;0;3;1;0;0;0;3;236;1;3;1978;236;236;1;0;0;3;3;1978;0;2156;3;3;
/org.eclipse.swt/Eclipse SWT Custom Widgets/common/org/eclipse/swt/custom/ExtendedModifyListener.java;4;0;5;1;1;1;1;4;6;1;4;106;19;19;1;0;0;4;5;106;0;4701;5;4;
/org.eclipse.jdt.ui.tests.refactoring/resources/RenameTemp/canRename/A_test28_out.java;1;0;2;1;0;0;0;2;2;1;2;1625;2;2;1;0;0;2;2;1625;0;1652;2;1;
/org.eclipse.jdt.ui/core extension/org/eclipse/jdt/internal/corext/javadoc/JavaDocCommentReader.java;2;0;2;1;1;1;1;1;6;0;1;2495;6;6;1;0;0;1;2;2495;0;4400;2;2;
/org.eclipse.help/src/JspUtil.java;1;0;2;1;0;0;0;2;0;1;2;1882;0;0;1;0;0;2;2;1882;0;1930;2;1;
/org.eclipse.jdt.core/model/org/eclipse/jdt/internal/core/newbuilder/IncrementalImageBuilder.java;1;0;24;1;0;0;0;24;298;2;21;1764;1013;1013;2;3;0;24;24;1961;3;2975;21;1;
/org.eclipse.jdt.ui.tests.refactoring/resources/RenameMethodInInterface/testFail31/in/A.java;1;0;1;1;0;0;0;1;0;0;1;49;0;0;1;0;0;1;1;49;0;49;1;1;
/org.eclipse.pde.ui/src/org/eclipse/pde/internal/ui/wizards/templates/NewPluginTemplateChoiceWizard.java;1;0;3;1;0;0;0;3;9;1;3;3579;10;10;1;0;0;3;3;3579;0;3819;3;1;
/org.eclipse.ui/Eclipse JFace Text/org/eclipse/jface/text/ILineTracker.java;3;0;3;1;0;0;0;3;87;1;3;257;92;92;1;0;0;3;3;257;0;1066;3;3;
/org.eclipse.jdt.ui.tests.refactoring/resources/ExtractMethodWorkSpace/ExtractMethodTests/validSelection/A_test303.java;2;1;3;1;2;2;2;1;0;0;1;49;0;0;1;0;0;1;3;49;0;4419;3;2;
/org.eclipse.jdt.ui.tests.refactoring/resources/RenameVirtualMethodInClass/testFail7/in/A.java;1;0;1;1;0;0;0;1;0;0;1;49;0;0;1;0;0;1;1;49;0;49;1;1;
/org.eclipse.compare/compare/org/eclipse/compare/internal/ReplaceWithEditionAction.java;2;0;6;1;0;0;0;6;113;1;6;14;193;193;1;0;0;6;6;14;0;918;6;2;
/org.eclipse.jdt.debug/jdi/org/eclipse/jdi/internal/connect/SocketLaunchingConnectorImpl.java;3;0;7;1;1;1;1;6;52;1;6;187;116;116;1;0;0;6;7;187;0;4423;7;3;
/org.eclipse.core.tests.resources/src/org/eclipse/core/tests/internal/watson/DeltaFlatteningTest.java;3;0;3;1;1;1;1;2;172;1;2;1794;190;190;1;0;0;2;3;1794;0;4516;3;3;
/org.eclipse.ui/Eclipse UI/org/eclipse/ui/IViewReference.java;1;1;2;1;2;2;2;0;25;0;0;4063;25;25;1;0;0;0;2;4063;0;4082;2;1;
/org.eclipse.pde.ui/Eclipse PDE UI/org/eclipse/pde/internal/editor/manifest/DetailChildrenSection.java;2;0;7;2;0;0;0;7;12;3;5;267;16;16;3;2;0;7;7;324;2;1434;5;2;
/org.eclipse.team.cvs.core/src/org/eclipse/team/internal/ccvs/core/client/PruneFolderVisitor.java;2;0;10;1;2;1;2;8;37;1;8;2572;113;113;2;0;1;8;10;4042;1;4042;9;2;
/org.eclipse.jdt.ui.tests.refactoring/resources/ExtractMethodWorkSpace/ExtractMethodTests/invalidSelection/A_test040.java;2;1;4;1;2;2;2;2;2;1;2;49;2;2;1;0;0;2;4;49;0;4419;4;2;
/org.eclipse.core.runtime/src/org/eclipse/core/internal/plugins/PluginParser.java;5;3;26;2;6;4;6;20;1968;2;18;12;3369;3369;3;2;2;20;26;4212;4;4855;22;5;
/org.eclipse.jdt.debug.ui/ui/org/eclipse/jdt/internal/debug/ui/actions/ManageMethodEntryBreakpointAction.java;3;0;6;1;0;0;0;6;35;1;6;2215;65;65;1;0;0;6;6;2215;0;2761;6;3;
/org.eclipse.pde.ui/src/org/eclipse/pde/internal/editor/manifest/ResourceAttributeDescriptor.java;2;0;2;1;0;0;0;2;0;1;2;1434;0;0;1;0;0;2;2;1434;0;3579;2;2;
/org.eclipse.debug.ui/ui/org/eclipse/debug/internal/ui/TerminateActionDelegate.java;3;0;7;1;0;0;0;7;44;1;7;187;72;72;1;0;0;7;7;187;0;2382;7;3;
/org.eclipse.pde.ui/src/org/eclipse/pde/internal/editor/schema/NoRestrictionPage.java;2;0;2;1;0;0;0;2;0;1;2;1434;0;0;1;0;0;2;2;1434;0;3579;2;2;
/org.eclipse.swt.examples/src/org/eclipse/swt/examples/controlexample/LabelTab.java;6;1;8;1;3;3;3;5;269;1;5;513;530;530;1;0;0;5;8;513;0;4705;8;6;
/org.eclipse.scripting/Eclipse Scripting/org/eclipse/scripting/internal/views/ScriptDevelopmentPreferencePageWorkbenchPopupMenu.java;2;0;5;1;0;0;0;5;21;1;5;133;30;30;1;0;0;5;5;133;0;1424;5;2;
/org.eclipse.help.ui/Eclipse Help UI/org/eclipse/help/internal/ui/search/AdvancedSearchDialog.java;2;0;4;2;0;0;0;4;16;2;3;136;16;16;2;1;0;4;4;323;1;1055;3;2;
/org.eclipse.update.ui/src/org/eclipse/update/internal/ui/NewUpdatesAction.java;1;3;4;1;4;2;4;0;91;0;0;4197;91;91;3;0;2;0;4;4288;2;4288;2;1;
/org.eclipse.team.cvs.ui/src/org/eclipse/team/internal/ccvs/ui/actions/CommitAction.java;3;1;18;1;2;2;2;16;197;3;14;1978;319;319;3;2;0;16;18;2029;2;4021;16;3;
/org.eclipse.team.core/src/org/eclipse/team/core/ITeamNature.java;3;0;3;1;0;0;0;3;118;1;3;1978;118;118;1;0;0;3;3;1978;0;3213;3;3;
/org.eclipse.core.tests.runtime/src/org/eclipse/core/tests/internal/plugins/GetPluginPathTest.java;4;0;5;1;1;1;1;4;106;1;4;1794;132;132;1;0;0;4;5;1794;0;4005;5;4;
/org.eclipse.pde.ui/src/org/eclipse/pde/internal/model/plugin/PluginElement.java;1;0;2;1;0;0;0;2;0;1;2;3136;0;0;1;0;0;2;2;3136;0;3579;2;1;
/org.eclipse.jdt.ui/ui/org/eclipse/jdt/internal/ui/typehierarchy/MethodsViewerFilter.java;3;0;9;2;0;0;0;9;27;2;8;15;85;85;2;1;0;9;9;2267;1;3123;8;3;
/org.eclipse.jdt.ui/core refactoring/org/eclipse/jdt/internal/corext/refactoring/util/AbstractExceptionAnalyzer.java;2;0;6;1;0;0;0;6;118;1;6;2327;179;179;1;0;0;6;6;2327;0;3737;6;2;
/org.eclipse.help.ui/src/org/eclipse/help/ui/internal/WorkbenchHelpPlugin.java;1;0;1;1;1;1;1;0;0;0;0;4439;0;0;1;0;0;0;1;4439;0;4439;1;1;
/org.eclipse.team.tests.cvs.core/src/org/eclipse/team/tests/ccvs/ui/logformatter/Result.java;1;0;1;1;0;0;0;1;0;0;1;3452;0;0;1;0;0;1;1;3452;0;3452;1;1;
/org.eclipse.jdt.ui/core refactoring/org/eclipse/jdt/internal/core/refactoring/CreateCompilationUnitChange.java;3;0;7;1;0;0;0;7;60;1;7;15;76;76;1;0;0;7;7;15;0;1257;7;3;
/org.eclipse.pde.build/src/org/eclipse/pde/internal/build/antwrappers/ExecTask.java;2;0;2;1;0;0;0;2;0;1;2;2859;0;0;1;0;0;2;2;2859;0;2900;2;2;
/org.eclipse.jdt.ui/ui/org/eclipse/jdt/internal/ui/javadocexport/JavadocWizard.java;3;1;23;1;5;5;5;18;258;3;14;2878;1314;1314;3;4;0;18;23;3247;4;4621;19;3;
/org.eclipse.jdt.ui/core refactoring/org/eclipse/jdt/internal/core/refactoring/rename/WorkingCopyUtil.java;1;0;2;1;0;0;0;2;0;1;2;1877;0;0;1;0;0;2;2;1877;0;1910;2;1;
/org.eclipse.update.ui/src/org/eclipse/update/internal/ui/model/UpdateModel.java;2;1;11;1;2;2;2;9;79;1;9;2797;145;145;1;0;0;9;11;2797;0;4722;11;2;
/org.eclipse.team.ftp/src/org/eclipse/team/internal/ftp/FTPServerLocation.java;1;1;3;1;3;3;3;0;19;0;0;4169;19;19;1;0;0;0;3;4169;0;4285;3;1;
/org.eclipse.update/src/org/eclipse/update/internal/ui/UMWizardPageInstallable.java;1;0;1;1;0;0;0;1;0;0;1;1424;0;0;1;0;0;1;1;1424;0;1424;1;1;
/org.eclipse.ui/Eclipse UI Standard Components/org/eclipse/ui/views/tasklist/MarkCompletedAction.java;3;1;3;1;2;2;2;1;19;0;1;3088;20;20;1;0;0;1;3;3088;0;4608;3;3;
/org.eclipse.jdt.debug.ui/ui/org/eclipse/jdt/internal/debug/ui/launcher/JavaArgumentsTab.java;3;2;18;2;4;3;4;14;222;2;13;2607;641;641;2;1;1;14;18;3313;2;4098;16;3;
/org.eclipse.ui.tests/Eclipse UI Tests/org/eclipse/ui/tests/api/MockViewActionDelegate.java;1;0;3;1;0;0;0;3;3;1;3;1081;5;5;1;0;0;3;3;1081;0;1456;3;1;
/org.eclipse.pde.ui/src/org/eclipse/pde/internal/editor/feature/OpenReferenceAction.java;1;0;4;1;0;0;0;4;12;1;4;2951;14;14;1;0;0;4;4;2951;0;3579;4;1;
/org.eclipse.core.resources/src/org/eclipse/core/internal/indexing/StoredObject.java;3;0;6;1;1;1;1;5;335;1;5;12;665;665;1;0;0;5;6;12;0;4214;6;3;
/org.eclipse.jdt.ui.tests.refactoring/resources/SefWorkSpace/SefTests/object_in/TestSimpleWrite.java;1;0;1;1;0;0;0;1;0;0;1;2155;0;0;1;0;0;1;1;2155;0;2155;1;1;
/org.eclipse.jdt.core/codeassist/org/eclipse/jdt/internal/codeassist/select/SelectionOnLocalName.java;3;0;3;1;1;1;1;2;18;1;2;3350;20;20;1;0;0;2;3;3350;0;4062;3;3;
/org.eclipse.jdt.debug/eval/org/eclipse/jdt/internal/debug/eval/model/EvaluationArray.java;2;0;3;1;0;0;0;3;2;1;3;3421;2;2;1;0;0;3;3;3421;0;3645;3;2;
/org.eclipse.jdt.ui.tests.refactoring/resources/RenameType/test19/out/B.java;1;0;1;1;0;0;0;1;0;0;1;522;0;0;1;0;0;1;1;522;0;522;1;1;
/org.eclipse.jdt.ui.tests.refactoring/resources/ExtractMethodWorkSpace/ExtractMethodTests/expression_in/A_test620.java;1;1;3;1;2;2;2;1;0;0;1;3741;0;0;1;0;0;1;3;3741;0;4419;3;1;
/org.eclipse.swt/Eclipse SWT/common/org/eclipse/swt/internal/image/PngChunkReader.java;2;0;3;1;1;1;1;2;10;1;2;106;16;16;1;0;0;2;3;106;0;4701;3;2;
/org.eclipse.jdt.ui.tests.refactoring/resources/RenameVirtualMethodInClass/test19/out/A.java;1;0;1;1;0;0;0;1;0;0;1;49;0;0;1;0;0;1;1;49;0;49;1;1;
/org.eclipse.jdt.ui/ui/org/eclipse/jdt/internal/ui/jarpackager/LibraryFilter.java;1;0;3;1;0;0;0;3;11;1;3;902;11;11;1;0;0;3;3;902;0;3529;3;1;
/org.eclipse.team.ui/src/org/eclipse/team/ui/actions/TeamAction.java;3;0;11;1;1;1;1;10;596;2;9;1978;738;738;2;1;0;10;11;2029;1;4020;10;3;
/org.eclipse.help/Eclipse Help/org/eclipse/help/internal/HelpSystem.java;4;0;11;3;0;0;0;11;77;3;9;135;174;174;3;2;0;11;11;317;2;1420;9;4;
/org.eclipse.swt/Eclipse SWT/common/org/eclipse/swt/events/VerifyListener.java;4;0;5;1;1;1;1;4;6;1;4;106;18;18;1;0;0;4;5;106;0;4701;5;4;
/org.eclipse.ui/Eclipse UI Text Editor/org/eclipse/ui/editors/text/TextEditorActionContributor.java;1;1;5;1;5;5;5;0;39;0;0;3915;110;110;1;0;0;0;5;3915;0;4838;5;1;
/org.eclipse.jdt.ui/ui/org/eclipse/jdt/internal/ui/viewsupport/AppearanceAwareLabelProvider.java;2;1;3;1;3;3;3;0;3;0;0;4018;5;5;1;0;0;0;3;4018;0;4164;3;2;
/org.eclipse.ui/Eclipse UI/org/eclipse/ui/dialogs/AbstractElementListSelectionDialog.java;1;0;2;1;0;0;0;2;9;1;2;3733;9;9;1;0;0;2;2;3733;0;3740;2;1;
/org.eclipse.help/src/org/eclipse/help/internal/search/SearchResult.java;3;0;16;1;1;1;1;15;81;2;14;2318;239;239;2;1;0;15;16;3427;1;4000;15;3;
/org.eclipse.jdt.ui.tests.refactoring/resources/RenameParameters/canRename/A_test20_out.java;2;0;2;1;0;0;0;2;4;1;2;233;4;4;1;0;0;2;2;233;0;952;2;2;
/org.eclipse.jdt.debug.tests/test programs/org/eclipse/debug/tests/targets/Looper.java;1;0;2;1;0;0;0;2;0;1;2;3701;0;0;1;0;0;2;2;3701;0;3719;2;1;
/org.eclipse.jdt.ui/ui/org/eclipse/jdt/internal/ui/search/FindReferencesAction.java;2;2;11;1;5;4;5;6;33;1;6;15;135;135;2;0;1;6;11;4140;1;4140;10;2;
/org.eclipse.jdt.ui/core refactoring/org/eclipse/jdt/internal/corext/refactoring/rename/RenameRefactoringASTAnalyzer.java;2;0;2;1;0;0;0;2;0;1;2;1939;0;0;1;0;0;2;2;1939;0;3414;2;2;
/org.eclipse.ui/Eclipse JFace/org/eclipse/jface/preference/FieldEditorPreferencePage.java;3;0;3;1;0;0;0;3;7;1;3;257;12;12;1;0;0;3;3;257;0;2590;3;3;
/org.eclipse.jdt.ui/core refactoring/org/eclipse/jdt/internal/core/refactoring/code/flow/LocalFlowInfo.java;1;0;2;1;0;0;0;2;0;1;2;1236;0;0;1;0;0;2;2;1236;0;1939;2;1;
/org.eclipse.pde.ui/src/org/eclipse/pde/internal/launcher/WorkbenchLauncherWizard.java;1;0;6;1;0;0;0;6;121;1;6;2560;225;225;1;0;0;6;6;2560;0;3579;6;1;
/org.eclipse.swt.examples.paint/org/eclipse/swt/examples/paint/PencilTool.java;3;0;4;2;1;1;1;3;72;2;2;513;72;72;2;1;0;3;4;609;1;4024;3;3;
/org.eclipse.jdt.debug/model/org/eclipse/jdt/debug/core/IJavaMethodEntryBreakpoint.java;2;0;6;1;1;1;1;5;97;1;5;1035;145;145;1;0;0;5;6;1035;0;4768;6;2;
/org.eclipse.swt/Eclipse SWT/motif/org/eclipse/swt/internal/motif/GNOME.java;2;0;3;1;0;0;0;3;6;1;3;106;6;6;1;0;0;3;3;106;0;2069;3;2;
/org.eclipse.swt/Eclipse SWT PI/photon/org/eclipse/swt/internal/photon/PhRect_t.java;2;0;2;1;1;1;1;1;6;0;1;2069;6;6;1;0;0;1;2;2069;0;4701;2;2;
/org.eclipse.debug.ui/ui/org/eclipse/debug/internal/ui/preferences/DebugActionGroupsPreferencePage.java;2;2;5;1;5;4;5;0;11;0;0;3975;28;28;2;0;1;0;5;4164;1;4207;4;2;
/org.eclipse.ui.tests/Eclipse UI Tests/org/eclipse/ui/tests/internal/TestDecoratorContributor.java;1;0;1;1;0;0;0;1;0;0;1;2290;0;0;1;0;0;1;1;2290;0;2290;1;1;
/org.eclipse.jdt.debug/model/org/eclipse/jdt/debug/core/IJavaClassType.java;3;0;10;2;0;0;0;10;21;2;9;1675;90;90;2;1;0;10;10;3154;1;3774;9;3;
/org.eclipse.ui/Eclipse UI/org/eclipse/ui/internal/PlatformInfo.java;2;0;6;1;0;0;0;6;84;1;6;1100;149;149;1;0;0;6;6;1100;0;3607;6;2;
/org.eclipse.debug.ui/ui/org/eclipse/debug/internal/ui/views/IDebugExceptionHandler.java;1;0;1;1;0;0;0;1;0;0;1;2670;0;0;1;0;0;1;1;2670;0;2670;1;1;
/org.eclipse.jdt.junit/src/org/eclipse/jdt/junit/wizards/JUnitWizard.java;2;0;6;1;0;0;0;6;19;3;4;3247;30;30;3;2;0;6;6;3394;2;3527;4;2;
/org.eclipse.pde.core/src/org/eclipse/pde/internal/core/build/BuildEntry.java;1;0;2;1;1;1;1;1;230;0;1;3591;230;230;1;0;0;1;2;3591;0;4583;2;1;
/org.eclipse.jdt.ui/ui/org/eclipse/jdt/internal/ui/dialogs/SelectionStatusDialog.java;5;0;17;1;1;1;1;16;45;2;15;15;171;171;2;1;0;16;17;1298;1;4015;16;5;
/org.eclipse.swt/Eclipse SWT OLE Win32/win32/org/eclipse/swt/internal/ole/win32/VARDESC1.java;2;0;3;1;0;0;0;3;6;1;3;106;6;6;1;0;0;3;3;106;0;2069;3;2;
/org.eclipse.ui/Eclipse UI/org/eclipse/ui/internal/dialogs/BuildOrderPreferencePage.java;6;0;11;1;1;1;1;10;122;1;10;257;281;281;1;0;0;10;11;257;0;4235;11;6;
/org.eclipse.swt.examples/src/org/eclipse/swt/examples/imageexample/ImageAnalyzer.java;1;0;1;1;0;0;0;1;0;0;1;513;0;0;1;0;0;1;1;513;0;513;1;1;
/org.eclipse.pde.build/src/org/eclipse/pde/internal/build/AbstractScriptGenerator.java;1;1;9;1;2;2;2;7;262;2;6;2896;565;565;2;1;0;7;9;3571;1;4174;8;1;
/org.eclipse.swt/Eclipse SWT Custom Widgets/common_j2se/org/eclipse/swt/custom/TextChangeListener.java;1;0;1;1;0;0;0;1;0;0;1;1378;0;0;1;0;0;1;1;1378;0;1378;1;1;
/org.eclipse.pde.ui/Eclipse PDE UI/org/eclipse/pde/internal/wizards/project/NewProjectWizard.java;2;0;8;2;0;0;0;8;19;3;6;267;36;36;3;2;0;8;8;324;2;1434;6;2;
/org.eclipse.jdt.ui.tests.refactoring/resources/ExtractMethodWorkSpace/ExtractMethodTests/semicolon_out/A_test408.java;1;0;2;1;0;0;0;2;0;1;2;1236;0;0;1;0;0;2;2;1236;0;3106;2;1;
/org.eclipse.jdt.ui/ui/org/eclipse/jdt/internal/ui/viewsupport/IErrorTickProvider.java;1;0;3;1;0;0;0;3;4;1;3;1241;4;4;1;0;0;3;3;1241;0;2581;3;1;
/org.eclipse.ui/Eclipse UI/org/eclipse/ui/internal/NewWizardShortcutAction.java;5;0;7;1;0;0;0;7;48;1;7;257;70;70;1;0;0;7;7;257;0;3702;7;5;
/org.eclipse.jdt.ui.tests.refactoring/resources/SefWorkSpace/SefTests/object_in/TestCompoundWrite3.java;1;0;1;1;0;0;0;1;0;0;1;2876;0;0;1;0;0;1;1;2876;0;2876;1;1;
/org.eclipse.ui/Eclipse UI/org/eclipse/ui/IWorkbenchSite.java;2;0;2;1;0;0;0;2;5;1;2;3633;5;5;1;0;0;2;2;3633;0;3642;2;2;
/org.eclipse.jdt.core/eval/org/eclipse/jdt/internal/eval/CodeSnippetFieldReference.java;2;0;8;1;1;1;1;7;584;1;7;455;763;763;1;0;0;7;8;455;0;4062;8;2;
/org.eclipse.team.cvs.core/src/org/eclipse/team/internal/ccvs/core/connection/UserInfo.java;2;0;2;1;0;0;0;2;2;1;2;2791;2;2;1;0;0;2;2;2791;0;3610;2;2;
/org.eclipse.jdt.ui.tests.refactoring/resources/ExtractMethodWorkSpace/ExtractMethodTests/invalidSelection/A_test060.java;2;1;5;1;2;2;2;3;2;1;3;49;4;4;1;0;0;3;5;49;0;4419;5;2;
/org.eclipse.pde.ui/src/org/eclipse/pde/internal/wizards/Category.java;2;0;2;1;0;0;0;2;0;1;2;1434;0;0;1;0;0;2;2;1434;0;3579;2;2;
/org.eclipse.webdav/src/kernel/org/eclipse/webdav/internal/kernel/DAV4JSystemException.java;2;0;3;1;0;0;0;3;5;1;3;12;5;5;1;0;0;3;3;12;0;1874;3;2;
/org.eclipse.ui/Eclipse UI/org/eclipse/ui/internal/ShowPartPaneMenuAction.java;3;0;5;1;1;1;1;4;34;2;3;1915;43;43;2;1;0;4;5;3212;1;4730;4;3;
/org.eclipse.compare/compare/org/eclipse/compare/ResourceNode.java;2;0;5;1;0;0;0;5;25;1;5;14;49;49;1;0;0;5;5;14;0;761;5;2;
/org.eclipse.core.tests.resources/src/org/eclipse/core/tests/internal/resources/AllTests.java;3;0;3;1;0;0;0;3;62;1;3;1794;67;67;1;0;0;3;3;1794;0;3420;3;3;
/org.eclipse.jdt.core/codeassist/org/eclipse/jdt/internal/codeassist/complete/CompletionOnLocalName.java;3;0;5;1;1;1;1;4;10;1;4;1580;22;22;1;0;0;4;5;1580;0;4062;5;3;
/org.eclipse.ui/Eclipse UI/org/eclipse/ui/internal/misc/OverlayComposite.java;2;0;2;1;0;0;0;2;5;1;2;257;5;5;1;0;0;2;2;257;0;457;2;2;
/org.eclipse.team.cvs.core/src/org/eclipse/team/internal/ccvs/core/util/SyncFileChangeListener.java;2;1;6;1;2;2;2;4;33;2;3;3417;66;66;2;1;0;4;6;3417;1;4707;5;2;
/org.eclipse.help.ui/src/org/eclipse/help/internal/ui/HelpContentsActionExperimental.java;2;0;5;1;0;0;0;5;7;2;4;2429;8;8;2;1;0;5;5;2586;1;2830;4;2;
/org.eclipse.jdt.ui.tests.refactoring/resources/RenameMethodInInterface/test29/in/A.java;1;0;1;1;0;0;0;1;0;0;1;49;0;0;1;0;0;1;1;49;0;49;1;1;
/org.eclipse.help/src/org/eclipse/help/internal/context/ContextsNode.java;1;0;2;1;0;0;0;2;12;1;2;2829;12;12;1;0;0;2;2;2829;0;3839;2;1;
/org.eclipse.core.resources/src/org/eclipse/core/internal/indexing/IndexedStore.java;4;1;10;1;4;4;4;6;868;1;6;12;1009;1009;1;0;0;6;10;12;0;4632;10;4;
/org.eclipse.jdt.core/compiler/org/eclipse/jdt/internal/compiler/lookup/MemberTypeBinding.java;2;0;10;1;1;1;1;9;56;4;6;455;92;92;4;3;0;9;10;1039;3;4062;7;2;
/org.eclipse.pde.core/src/org/eclipse/pde/internal/core/plugin/ExternalPluginModelBase.java;1;0;3;1;0;0;0;3;15;1;3;3591;17;17;1;0;0;3;3;3591;0;3618;3;1;
/org.eclipse.team.cvs.ui/src/org/eclipse/team/internal/ccvs/ui/CVSProjectSetSerializer.java;1;0;3;1;1;1;1;2;180;1;2;3728;325;325;1;0;0;2;3;3728;0;3973;3;1;
/org.eclipse.ui/Eclipse UI Standard Components/org/eclipse/ui/views/navigator/INavigatorHelpContextIds.java;3;0;4;1;0;0;0;4;18;1;4;620;25;25;1;0;0;4;4;620;0;2989;4;3;
/org.eclipse.pde.core/src/org/eclipse/pde/internal/core/schema/ChoiceRestriction.java;1;0;2;1;0;0;0;2;9;1;2;3591;9;9;1;0;0;2;2;3591;0;3607;2;1;
/org.eclipse.ui/Eclipse UI/org/eclipse/ui/internal/PluginActionSet.java;2;0;3;1;0;0;0;3;9;1;3;257;13;13;1;0;0;3;3;257;0;3194;3;2;
/org.eclipse.jdt.core/model/org/eclipse/jdt/internal/core/builder/impl/TypeImpl.java;1;0;10;1;0;0;0;10;909;4;6;455;963;963;4;4;0;10;10;1039;4;2808;6;1;
/org.eclipse.jdt.ui.tests.refactoring/resources/MoveMembers/test1/in/A.java;1;0;1;1;0;0;0;1;0;0;1;2738;0;0;1;0;0;1;1;2738;0;2738;1;1;
/org.eclipse.ant.core/src/org/eclipse/ant/core/CommandDataType.java;3;0;4;1;0;0;0;4;322;1;4;896;326;326;1;0;0;4;4;896;0;3489;4;3;
/org.eclipse.jdt.ui.tests.refactoring/resources/RenameType/test30/out/AA.java;1;0;1;1;0;0;0;1;0;0;1;49;0;0;1;0;0;1;1;49;0;49;1;1;
/org.eclipse.jdt.ui/ui/org/eclipse/jdt/ui/IJavaElementSearchConstants.java;3;0;4;1;1;1;1;3;16;1;3;15;32;32;1;0;0;3;4;15;0;4810;4;3;
/org.eclipse.pde/src/org/eclipse/pde/internal/builders/PluginErrorReporter.java;1;0;2;1;0;0;0;2;130;1;2;3631;130;130;1;0;0;2;2;3631;0;3802;2;1;
/org.eclipse.jdt.ui.tests.refactoring/resources/SelectionAnalyzerWorkSpace/SelectionAnalyzerTests/invalidSelection/A_test106.java;2;0;3;1;0;0;0;3;0;1;3;1368;0;0;1;0;0;3;3;1368;0;2327;3;2;
/org.eclipse.jdt.ui.tests/refactoring/org/eclipse/jdt/refactoring/tests/RenameResourceChangeTests.java;3;0;6;1;0;0;0;6;67;1;6;1114;108;108;1;0;0;6;6;1114;0;1896;6;3;
/org.eclipse.update.ui.forms/src/org/eclipse/update/ui/forms/IForm.java;1;0;3;1;0;0;0;3;5;1;3;1542;5;5;1;0;0;3;3;1542;0;2474;3;1;
/org.eclipse.pde.ui/src/org/eclipse/pde/internal/model/WorkspaceFragmentModel.java;2;0;3;1;0;0;0;3;2;1;3;1434;2;2;1;0;0;3;3;1434;0;3136;3;2;
/org.eclipse.jdt.junit/src/org/eclipse/jdt/internal/junit/ui/CopyTraceAction.java;2;0;4;1;1;1;1;3;4;1;3;3171;7;7;1;0;0;3;4;3171;0;4634;4;2;
/org.eclipse.swt/Eclipse SWT/motif/org/eclipse/swt/widgets/Canvas.java;7;1;10;1;3;3;3;7;220;1;7;106;517;517;1;0;0;7;10;106;0;4701;10;7;
/org.eclipse.vcm.ui/src/org/eclipse/vcm/internal/ui/HistoryInput.java;1;0;1;1;0;0;0;1;0;0;1;1056;0;0;1;0;0;1;1;1056;0;1056;1;1;
/org.eclipse.debug.ui/ui/org/eclipse/debug/internal/ui/views/variables/VariablesViewContentProvider.java;1;1;2;1;2;2;2;0;428;0;0;3975;428;428;1;0;0;0;2;3975;0;4003;2;1;
/org.eclipse.jdt.debug/eval/org/eclipse/jdt/internal/debug/eval/ast/instructions/ArrayAccess.java;3;0;7;1;0;0;0;7;10;2;6;3421;26;26;2;1;0;7;7;3832;1;3832;6;3;
/org.eclipse.team.ui/src/org/eclipse/team/internal/ui/target/PutSyncAction.java;4;3;8;1;8;5;8;0;28;0;0;4227;59;59;3;0;3;0;8;4244;3;4636;5;4;
/org.eclipse.help/src/EclipseServlet.java;1;0;2;1;0;0;0;2;0;1;2;1882;0;0;1;0;0;2;2;1882;0;1930;2;1;
/org.eclipse.jdt.ui.tests.refactoring/resources/ReorderParameters/canReorder/A_test9_out.java;1;0;3;1;0;0;0;3;0;1;3;724;0;0;1;0;0;3;3;724;0;2270;3;1;
/org.eclipse.vcm.ui/src/org/eclipse/vcm/internal/ui/VCMIgnorePreferencePage.java;2;0;5;2;0;0;0;5;6;2;4;373;10;10;2;1;0;5;5;438;1;1418;4;2;
/org.eclipse.jdt.ui/ui/org/eclipse/jdt/internal/ui/util/SequenceArrayIterator.java;2;0;4;1;0;0;0;4;6;1;4;15;11;11;1;0;0;4;4;15;0;1199;4;2;
/org.eclipse.jdt.debug.ui/ui/org/eclipse/jdt/internal/debug/ui/JavaHotCodeReplaceListener.java;3;1;9;1;2;2;2;7;15;2;6;3329;57;57;2;1;0;7;9;3853;1;4257;8;3;
/org.eclipse.jdt.ui.tests.refactoring/resources/RenameTemp/canRename/A_test27_in.java;1;0;2;1;0;0;0;2;2;1;2;1625;2;2;1;0;0;2;2;1625;0;1652;2;1;
/org.eclipse.jdt.ui.tests.refactoring/resources/RenameTemp/canRename/A_test16_in.java;1;0;2;1;0;0;0;2;2;1;2;1625;2;2;1;0;0;2;2;1625;0;1652;2;1;
/org.eclipse.swt.examples/src/org/eclipse/swt/examples/controlexample/TableTab.java;6;1;9;1;4;4;4;5;289;1;5;513;776;776;1;0;0;5;9;513;0;4705;9;6;
/org.eclipse.ui/Eclipse JFace/org/eclipse/jface/wizard/IWizardPage.java;2;0;2;1;0;0;0;2;5;1;2;257;5;5;1;0;0;2;2;257;0;457;2;2;
/org.eclipse.jdt.ui/ui/org/eclipse/jdt/internal/ui/compare/JavaMergeViewer.java;2;1;6;1;3;3;3;3;207;1;3;15;294;294;1;0;0;3;6;15;0;4574;6;2;
/org.eclipse.search/search/org/eclipse/search/internal/ui/util/ListContentProvider.java;1;0;1;1;0;0;0;1;0;0;1;1494;0;0;1;0;0;1;1;1494;0;1494;1;1;
/org.eclipse.jdt.ui.tests.refactoring/resources/RenameParameters/cannotRename/A_testFail10.java;1;0;1;1;0;0;0;1;0;0;1;233;0;0;1;0;0;1;1;233;0;233;1;1;
/org.eclipse.swt/Eclipse SWT Drag and Drop/photon/org/eclipse/swt/dnd/Transfer.java;3;1;8;1;4;4;4;4;75;1;4;106;185;185;1;0;0;4;8;106;0;4830;8;3;
/org.eclipse.help/Eclipse Help/org/eclipse/help/internal/contributors/ActionContributor.java;2;0;3;1;0;0;0;3;7;1;3;135;7;7;1;0;0;3;3;135;0;1420;3;2;
/org.eclipse.jdt.ui/ui/org/eclipse/jdt/internal/ui/javadocexport/JavadocTreeViewerFilter.java;1;0;3;1;0;0;0;3;24;1;3;2878;24;24;1;0;0;3;3;2878;0;3588;3;1;
/org.eclipse.jdt.debug/eval/org/eclipse/jdt/internal/debug/eval/ast/engine/PostfixMinusMinusOperator.java;1;0;3;1;0;0;0;3;2;1;3;3329;2;2;1;0;0;3;3;3329;0;3421;3;1;
/org.eclipse.team.cvs.ui/src/org/eclipse/team/internal/ccvs/ui/HistorySorter.java;3;0;6;1;1;1;1;5;12;1;5;1991;44;44;1;0;0;5;6;1991;0;4124;6;3;
/org.eclipse.jdt.ui/ui refactoring/org/eclipse/jdt/internal/ui/refactoring/actions/TextSelectionRefactoringAction.java;2;0;4;2;1;1;1;3;45;2;2;3791;45;45;2;1;0;3;4;3826;1;3970;3;2;
/org.eclipse.jdt.ui.tests.refactoring/resources/InlineTemp/cannotInline/A_testFail5.java;1;0;1;1;0;0;0;1;0;0;1;2015;0;0;1;0;0;1;1;2015;0;2015;1;1;
/org.eclipse.jdt.ui.tests.refactoring/resources/RenameVariables/canRename/A_test22_in.java;1;0;2;1;0;0;0;2;0;1;2;724;0;0;1;0;0;2;2;724;0;1665;2;1;
/org.eclipse.core.resources/src/org/eclipse/core/internal/indexing/ObjectPage.java;3;0;7;1;1;1;1;6;520;1;6;12;1057;1057;1;0;0;6;7;12;0;4214;7;3;
/org.eclipse.jdt.ui.tests.refactoring/resources/RenameNonPrivateField/testBug5821/in/A.java;1;0;1;1;0;0;0;1;0;0;1;2096;0;0;1;0;0;1;1;2096;0;2096;1;1;
/org.eclipse.jdt.debug/jdi interfaces/com/sun/jdi/StackFrame.java;2;0;2;1;0;0;0;2;23;1;2;2704;23;23;1;0;0;2;2;2704;0;3033;2;2;
/org.eclipse.jdt.ui.tests.refactoring/resources/SelectionAnalyzerWorkSpace/SelectionAnalyzerTests/validSelection/A_test261.java;1;0;1;1;0;0;0;1;0;0;1;1368;0;0;1;0;0;1;1;1368;0;1368;1;1;
/org.eclipse.search/search/org/eclipse/search/internal/ui/SearchResultViewer.java;2;2;53;1;15;12;15;38;111;2;33;15;1044;1044;2;5;3;38;53;78;8;4619;45;2;
/org.eclipse.tomcat/src/org/eclipse/tomcat/internal/PortTrackingServerSocketFactory.java;2;0;2;1;0;0;0;2;8;1;2;3297;8;8;1;0;0;2;2;3297;0;3306;2;2;
/org.eclipse.update.ui/src/org/eclipse/update/internal/ui/parts/SWTUtil.java;1;0;1;1;0;0;0;1;0;0;1;3584;0;0;1;0;0;1;1;3584;0;3584;1;1;
/org.eclipse.jdt.core/model/org/eclipse/jdt/internal/core/BinaryMember.java;3;1;6;1;2;2;2;4;190;1;4;455;219;219;1;0;0;4;6;455;0;4322;6;3;
/org.eclipse.swt/Eclipse SWT PI/gtk/org/eclipse/swt/internal/gtk/GdkEventExpose.java;2;0;6;1;2;1;2;4;19;1;4;2107;42;42;2;0;1;4;6;4701;1;4701;5;2;
/org.eclipse.ui/Eclipse UI Text Editor/org/eclipse/ui/texteditor/IDocumentProvider.java;4;0;4;1;1;1;1;3;144;1;3;257;176;176;1;0;0;3;4;257;0;4853;4;4;
/org.eclipse.jdt.ui.tests/test plugin/org/eclipse/jdt/testplugin/util/FailureDialog.java;2;0;2;1;1;1;1;1;9;0;1;2180;9;9;1;0;0;1;2;2180;0;4682;2;2;
/org.eclipse.ui/Eclipse UI/org/eclipse/ui/internal/misc/ProgramImageDescriptor.java;2;0;2;1;0;0;0;2;5;1;2;257;5;5;1;0;0;2;2;257;0;457;2;2;
/org.eclipse.core.tests.runtime/src/org/eclipse/core/tests/internal/plugins/PluginResolveTest_24.java;3;0;3;1;0;0;0;3;110;1;3;1794;120;120;1;0;0;3;3;1794;0;3476;3;3;
/org.eclipse.team.ftp/src/org/eclipse/team/internal/ftp/client/IFTPClientListener.java;1;0;1;1;1;1;1;0;0;0;0;4169;0;0;1;0;0;0;1;4169;0;4169;1;1;
/org.eclipse.jdt.ui.tests.refactoring/resources/RenameVirtualMethodInClass/test20/in/A.java;1;0;1;1;0;0;0;1;0;0;1;49;0;0;1;0;0;1;1;49;0;49;1;1;
/org.eclipse.swt.examples.paint/src/org/eclipse/swt/examples/paint/PointFigure.java;2;0;2;1;1;1;1;1;6;0;1;615;6;6;1;0;0;1;2;615;0;4705;2;2;
/org.eclipse.pde.ui/src/org/eclipse/pde/internal/base/model/ModelProviderEvent.java;2;0;4;1;0;0;0;4;53;1;4;1434;55;55;1;0;0;4;4;1434;0;3136;4;2;
/org.eclipse.scripting/src/org/eclipse/scripting/internal/ScriptConstants.java;1;0;1;1;0;0;0;1;0;0;1;1424;0;0;1;0;0;1;1;1424;0;1424;1;1;
/org.eclipse.jdt.debug/eval/org/eclipse/jdt/internal/debug/eval/ast/EvaluationValue.java;1;0;3;1;0;0;0;3;184;1;3;3329;184;184;1;0;0;3;3;3329;0;3421;3;1;
/org.eclipse.jdt.ui.tests.refactoring/resources/RenameNonPrivateField/test6/out/A.java;2;0;2;1;0;0;0;2;4;1;2;49;4;4;1;0;0;2;2;49;0;1297;2;2;
/org.eclipse.team.cvs.core/src/org/eclipse/team/internal/ccvs/core/client/Diff.java;2;0;9;2;1;1;1;8;57;2;7;2572;102;102;2;1;0;8;9;3089;1;4382;8;2;
/org.eclipse.pde.ui/Eclipse PDE UI/org/eclipse/pde/internal/editor/schema/SchemaDoubleClickStrategy.java;2;0;5;2;0;0;0;5;12;3;3;267;12;12;3;2;0;5;5;324;2;1434;3;2;
/org.eclipse.jdt.ui.tests.refactoring/resources/ExtractTemp/canExtract/A_test25_out.java;1;0;1;1;0;0;0;1;0;0;1;2807;0;0;1;0;0;1;1;2807;0;2807;1;1;
/org.eclipse.jdt.ui.tests.refactoring/resources/MoveMembers/test22/in/A.java;1;0;1;1;0;0;0;1;0;0;1;2738;0;0;1;0;0;1;1;2738;0;2738;1;1;
/org.eclipse.jdt.debug.ui/ui/org/eclipse/jdt/internal/debug/ui/actions/EvaluateAction.java;3;2;29;2;5;4;5;24;85;3;19;2813;557;557;3;5;1;24;29;3791;6;4423;23;3;
/org.eclipse.core.boot/src/org/eclipse/core/internal/boot/update/XmlLiteAttribute.java;2;0;3;1;0;0;0;3;7;1;3;12;7;7;1;0;0;3;3;12;0;2726;3;2;
/org.eclipse.ant.ui/src/org/eclipse/ant/internal/ui/BuildCanceledException.java;3;0;6;1;0;0;0;6;32;2;5;14;61;61;2;1;0;6;6;326;1;3606;5;3;
/org.eclipse.help.ui/src/org/eclipse/help/internal/ui/IBrowser.java;2;0;4;1;0;0;0;4;25;1;4;1420;29;29;1;0;0;4;4;1420;0;3030;4;2;
/org.eclipse.swt.examples/org/eclipse/swt/examples/controlexample/DialogTab.java;4;1;7;1;2;2;2;5;762;1;5;513;1272;1272;1;0;0;5;7;513;0;4024;7;4;
/org.eclipse.help/Eclipse Help/org/eclipse/help/IHelpTopic.java;2;0;4;1;0;0;0;4;7;1;4;135;13;13;1;0;0;4;4;135;0;1420;4;2;
/org.eclipse.jdt.debug/eval/org/eclipse/jdt/internal/debug/eval/ast/engine/MultiplyAssignmentOperator.java;1;0;2;1;0;0;0;2;0;1;2;3329;0;0;1;0;0;2;2;3329;0;3421;2;1;
/org.eclipse.ui/Eclipse UI/org/eclipse/ui/internal/registry/Category.java;3;0;7;1;0;0;0;7;176;1;7;257;266;266;1;0;0;7;7;257;0;3609;7;3;
/org.eclipse.jdt.ui/core refactoring/org/eclipse/jdt/internal/corext/refactoring/code/SemicolonAnalyzer.java;1;0;4;1;0;0;0;4;39;1;4;2327;41;41;1;0;0;4;4;2327;0;3106;4;1;
/org.eclipse.help/Eclipse Help/org/eclipse/help/internal/search/XMLSearchContributor.java;3;0;4;1;0;0;0;4;4;1;4;135;8;8;1;0;0;4;4;135;0;1188;4;3;
/org.eclipse.swt.tests/JUnit Tests/org/eclipse/swt/tests/junit/SwtTestCase.java;2;0;2;1;1;1;1;1;6;0;1;1792;6;6;1;0;0;1;2;1792;0;4706;2;2;
/org.eclipse.vcm.core/src/org/eclipse/vcm/internal/core/base/IServerResourceEventListener.java;1;0;1;1;0;0;0;1;0;0;1;951;0;0;1;0;0;1;1;951;0;951;1;1;
/org.eclipse.jdt.core/model/org/eclipse/jdt/internal/core/CreateImportOperation.java;3;1;12;1;2;2;2;10;168;4;7;455;221;221;4;3;0;10;12;1039;3;4063;9;3;
/org.eclipse.jdt.ui/ui refactoring/org/eclipse/jdt/internal/ui/refactoring/nls/search/INLSSearchUIConstants.java;2;0;2;1;0;0;0;2;0;1;2;1922;0;0;1;0;0;2;2;1922;0;2155;2;2;
/org.eclipse.pde.ui/src/org/eclipse/pde/internal/ui/editor/text/TextUtil.java;1;0;2;1;0;0;0;2;10;0;1;3579;10;10;2;1;0;2;2;3579;1;3579;1;1;
/org.eclipse.jdt.debug/eval/org/eclipse/jdt/debug/eval/model/IVariable.java;2;0;2;1;0;0;0;2;0;1;2;3421;0;0;1;0;0;2;2;3421;0;3555;2;2;
/org.eclipse.ui.tests/Eclipse UI Tests/org/eclipse/ui/tests/adaptable/TestNavigatorActionGroup.java;1;0;1;1;1;1;1;0;0;0;0;4068;0;0;1;0;0;0;1;4068;0;4068;1;1;
/org.eclipse.pde.ui/src/org/eclipse/pde/internal/model/ExternalPluginModel.java;2;0;3;1;0;0;0;3;2;1;3;1434;2;2;1;0;0;3;3;1434;0;3136;3;2;
/org.eclipse.swt.examples.paint/src/org/eclipse/swt/examples/paint/SegmentedPaintSession.java;3;0;4;2;1;1;1;3;163;2;2;586;169;169;2;1;0;3;4;609;1;4705;3;3;
/org.eclipse.compare/compare/org/eclipse/compare/internal/TextMergeViewerCreator.java;1;0;2;1;0;0;0;2;5;1;2;14;5;5;1;0;0;2;2;14;0;329;2;1;
/org.eclipse.jdt.ui/core refactoring/org/eclipse/jdt/internal/corext/refactoring/changes/CopyResourceChange.java;2;0;3;1;1;1;1;2;18;1;2;1939;23;23;1;0;0;2;3;1939;0;4212;3;2;
/org.eclipse.update.tests.core/src/org/eclipse/update/tests/api/TestDefaultExecutableFeatureAPI.java;2;0;20;2;1;1;1;19;94;3;15;1531;367;367;3;4;0;19;20;2583;4;3903;16;2;
/org.eclipse.core.boot/src/org/eclipse/core/internal/boot/PlatformURLHandlerFactoryProxy.java;2;0;4;1;1;1;1;3;64;1;3;23;84;84;1;0;0;3;4;23;0;4214;4;2;
/org.eclipse.pde.junit/src/org/eclipse/pde/internal/junit/launcher/JUnitPdeLaunchConfiguration.java;1;1;5;1;3;3;3;2;3;1;2;3171;8;8;1;0;0;2;5;3171;0;4370;5;1;
/org.eclipse.jdt.ui.tests.refactoring/resources/RenamePackage/testFail10/in/p/A.java;2;0;2;1;0;0;0;2;0;1;2;91;0;0;1;0;0;2;2;91;0;1258;2;2;
/org.eclipse.jdt.ui.tests.refactoring/resources/ExtractMethodWorkSpace/ExtractMethodTests/locals_out/A_test514.java;2;1;4;1;2;2;2;2;11;1;2;369;15;15;1;0;0;2;4;369;0;4419;4;2;
/org.eclipse.jdt.ui.tests.refactoring/resources/SelectionAnalyzerWorkSpace/SelectionAnalyzerTests/invalidSelection/A_test084.java;1;0;1;1;0;0;0;1;0;0;1;1368;0;0;1;0;0;1;1;1368;0;1368;1;1;
/org.eclipse.jdt.ui.tests.refactoring/resources/RenameVariables/canRename/A_test18_in.java;1;0;2;1;0;0;0;2;0;1;2;724;0;0;1;0;0;2;2;724;0;1665;2;1;
/org.eclipse.core.resources/src/org/eclipse/core/internal/watson/ElementDelta.java;1;0;4;1;1;1;1;3;284;1;3;12;307;307;1;0;0;3;4;12;0;4214;4;1;
/org.eclipse.vcm.core/src/org/eclipse/vcm/internal/core/VersionHistory.java;3;0;3;1;0;0;0;3;7;1;3;0;13;13;1;0;0;3;3;0;0;297;3;3;
/org.eclipse.jdt.ui/ui refactoring/org/eclipse/jdt/internal/ui/refactoring/code/ExtractMethodInputPage.java;4;1;16;1;2;2;2;14;123;3;12;15;230;230;3;2;0;14;16;192;2;4146;14;4;
/org.eclipse.jdt.debug/model/org/eclipse/jdt/debug/core/IJavaFieldVariable.java;2;0;5;1;1;1;1;4;45;1;4;3104;64;64;1;0;0;4;5;3104;0;4423;5;2;
/org.eclipse.ui/Eclipse JFace/org/eclipse/jface/viewers/IBatchLabelDecorator.java;1;0;3;1;0;0;0;3;6;2;2;3404;6;6;2;1;0;3;3;3413;1;3413;2;1;
/org.eclipse.jdt.ui.tests.refactoring/resources/RenameVariables/canRename/A_in.java;1;0;2;1;0;0;0;2;0;1;2;724;0;0;1;0;0;2;2;724;0;1665;2;1;
/org.eclipse.swt/Eclipse SWT/common/org/eclipse/swt/internal/image/JPEGHuffmanTable.java;2;0;3;1;1;1;1;2;6;1;2;106;10;10;1;0;0;2;3;106;0;4701;3;2;
/org.eclipse.jdt.ui/ui/org/eclipse/jdt/internal/ui/viewsupport/ResourceToItemMapper.java;1;1;3;1;3;3;3;0;16;0;0;3999;26;26;1;0;0;0;3;3999;0;4138;3;1;
/org.eclipse.ui/Eclipse UI/org/eclipse/ui/internal/model/WorkbenchAdapterFactory.java;2;0;2;1;0;0;0;2;5;1;2;257;5;5;1;0;0;2;2;257;0;457;2;2;
/org.eclipse.ant.core/src/org/eclipse/ant/internal/core/old/EclipseFileUtils.java;1;0;1;1;0;0;0;1;0;0;1;3270;0;0;1;0;0;1;1;3270;0;3270;1;1;
/org.eclipse.jdt.debug.ui/ui/org/eclipse/jdt/internal/debug/ui/actions/MoveUpAction.java;1;1;3;1;2;2;2;1;2;0;1;3875;4;4;1;0;0;1;3;3875;0;4101;3;1;
/org.eclipse.swt/Eclipse SWT/common_j2se/org/eclipse/swt/internal/EventListenerCompatability.java;1;0;1;1;0;0;0;1;0;0;1;1397;0;0;1;0;0;1;1;1397;0;1397;1;1;
/org.eclipse.jdt.ui.tests/ui/org/eclipse/jdt/ui/tests/dialogs/PreferencesTest.java;2;0;8;1;0;0;0;8;38;3;6;1189;56;56;3;2;0;8;8;2180;2;3163;6;2;
/org.eclipse.ui/Eclipse UI/org/eclipse/ui/internal/dialogs/ListContentProvider.java;1;0;2;1;0;0;0;2;51;1;2;3287;51;51;1;0;0;2;2;3287;0;3494;2;1;
/org.eclipse.team.cvs.ui/src/org/eclipse/team/internal/ccvs/ui/actions/ShowResourceInHistoryAction.java;2;0;8;1;1;1;1;7;28;1;7;2158;62;62;1;0;0;7;8;2158;0;4021;8;2;
/org.eclipse.jdt.ui.tests.refactoring/test cases/org/eclipse/jdt/ui/tests/refactoring/AllRefactoringTests.java;2;0;9;1;0;0;0;9;37;1;9;1896;63;63;1;0;0;9;9;1896;0;2738;9;2;
/org.eclipse.jdt.ui.tests.refactoring/resources/SelectionAnalyzerWorkSpace/SelectionAnalyzerTests/invalidSelection/A_test070.java;1;0;1;1;0;0;0;1;0;0;1;1368;0;0;1;0;0;1;1;1368;0;1368;1;1;
/org.eclipse.pde.ui/src/org/eclipse/pde/internal/ui/feature/NewFeatureProjectWizard.java;1;1;8;1;3;3;3;5;342;1;5;3579;362;362;1;0;0;5;8;3579;0;4154;8;1;
/org.eclipse.swt/Eclipse SWT PI/gtk/org/eclipse/swt/internal/gtk/GtkWidget.java;1;0;2;1;0;0;0;2;0;1;2;2107;0;0;1;0;0;2;2;2107;0;3209;2;1;
/org.eclipse.update.core/src/org/eclipse/update/internal/core/SiteFile.java;2;3;40;1;12;8;12;28;402;2;26;1791;1926;1926;3;2;4;28;40;4379;6;4448;34;2;
/org.eclipse.core.boot/src/org/eclipse/core/internal/boot/update/Log.java;2;0;3;1;0;0;0;3;7;1;3;12;7;7;1;0;0;3;3;12;0;2726;3;2;
/org.eclipse.update.core/src/org/eclipse/update/internal/core/Info.java;2;0;4;1;0;0;0;4;9;1;4;1577;18;18;1;0;0;4;4;1577;0;2583;4;2;
/org.eclipse.search/search/org/eclipse/search/ui/ISearchPageContainer.java;2;0;7;1;0;0;0;7;63;1;7;15;120;120;1;0;0;7;7;15;0;3760;7;2;
/org.eclipse.vcm.core.cvs/src/org/eclipse/vcm/internal/core/ccvs/client/PServerConnectionMethod.java;3;0;4;1;0;0;0;4;8;1;4;197;12;12;1;0;0;4;4;197;0;1262;4;3;
/org.eclipse.pde.ui/Eclipse PDE UI/org/eclipse/pde/internal/BaseProject.java;2;0;5;2;0;0;0;5;21;3;3;267;21;21;3;2;0;5;5;324;2;1434;3;2;
/org.eclipse.swt.tests/JUnit Tests/org/eclipse/swt/tests/junit/Test_org_eclipse_swt_events_TreeListener.java;2;0;2;1;1;1;1;1;6;0;1;1792;6;6;1;0;0;1;2;1792;0;4706;2;2;
/org.eclipse.jdt.ui/ui/org/eclipse/jdt/internal/ui/dnd/BasicSelectionTransferDragAdapter.java;3;0;3;1;0;0;0;3;15;1;3;949;17;17;1;0;0;3;3;949;0;3810;3;3;
/org.eclipse.swt/Eclipse SWT/common/org/eclipse/swt/events/FocusListener.java;4;0;5;1;1;1;1;4;6;1;4;106;18;18;1;0;0;4;5;106;0;4701;5;4;
/org.eclipse.ui/Eclipse UI/org/eclipse/ui/internal/dialogs/FakePerspectiveActionSet.java;2;0;2;1;0;0;0;2;4;1;2;257;4;4;1;0;0;2;2;257;0;457;2;2;
/org.eclipse.update.examples/src/org/eclipse/update/examples/buildzip/BuildZipPluginParser.java;2;0;2;1;0;0;0;2;85;1;2;2553;85;85;1;0;0;2;2;2553;0;2583;2;2;
/org.eclipse.jdt.ui.tests.refactoring/resources/SefWorkSpace/SefTests/object_in/TestArrayRead.java;1;0;1;1;0;0;0;1;0;0;1;2615;0;0;1;0;0;1;1;2615;0;2615;1;1;
/org.eclipse.ant.core/src/org/eclipse/ant/internal/core/old/AntRunner.java;1;0;1;1;0;0;0;1;0;0;1;3270;0;0;1;0;0;1;1;3270;0;3270;1;1;
/org.eclipse.swt/Eclipse SWT/motif/org/eclipse/swt/internal/motif/XFontStruct.java;2;0;3;1;0;0;0;3;4;1;3;106;4;4;1;0;0;3;3;106;0;2069;3;2;
/org.eclipse.help/src/org/eclipse/help/internal/protocols/HelpURLHandler.java;1;0;2;1;0;0;0;2;0;1;2;2694;0;0;1;0;0;2;2;2694;0;2773;2;1;
/org.eclipse.jdt.ui.tests.refactoring/resources/PullUpMethods/test0/out/A.java;1;0;4;1;0;0;0;4;3;1;4;2156;5;5;1;0;0;4;4;2156;0;2406;4;1;
/org.eclipse.team.cvs.core/src/org/eclipse/team/internal/ccvs/core/response/custom/LogHandler.java;3;0;3;1;0;0;0;3;8;1;3;1978;8;8;1;0;0;3;3;1978;0;2607;3;3;
/org.eclipse.jdt.ui.tests.refactoring/resources/RenameVariables/canRename/A_test21_out.java;1;0;2;1;0;0;0;2;0;1;2;724;0;0;1;0;0;2;2;724;0;1665;2;1;
/org.eclipse.swt/Eclipse SWT OLE Win32/win32/org/eclipse/swt/ole/win32/OleClientSite.java;3;1;14;1;7;7;7;7;118;1;7;106;350;350;1;0;0;7;14;106;0;4701;14;3;
/org.eclipse.jdt.junit/Eclipse JUnit/org/eclipse/jdt/junit/internal/TestApplication.java;2;0;3;1;0;0;0;3;88;1;3;1511;94;94;1;0;0;3;3;1511;0;2007;3;2;
/org.eclipse.jdt.core/compiler/org/eclipse/jdt/internal/compiler/ClassFile.java;2;1;32;2;2;2;2;30;29460;4;21;455;49621;49621;4;9;0;30;32;1039;9;4062;23;2;
/org.eclipse.jdt.ui.tests.refactoring/resources/MoveMembers/test21/out/A.java;1;0;1;1;0;0;0;1;0;0;1;2738;0;0;1;0;0;1;1;2738;0;2738;1;1;
/org.eclipse.swt.examples.launcher/org/eclipse/swt/examples/launcher/ImportProjectTask.java;3;0;3;1;0;0;0;3;290;1;3;513;290;290;1;0;0;3;3;513;0;3690;3;3;
/org.eclipse.team.cvs.core/src/org/eclipse/team/internal/ccvs/core/util/AssertionFailedException.java;1;0;2;1;0;0;0;2;56;1;2;1978;56;56;1;0;0;2;2;1978;0;3102;2;1;
/org.eclipse.pde.ui/src/org/eclipse/pde/internal/base/model/plugin/IFragment.java;2;0;3;1;0;0;0;3;18;1;3;1434;18;18;1;0;0;3;3;1434;0;3039;3;2;
/org.eclipse.jdt.debug/jdi/org/eclipse/jdi/internal/request/StepRequestImpl.java;3;0;5;1;0;0;0;5;12;1;5;187;32;32;1;0;0;5;5;187;0;3670;5;3;
/org.eclipse.scripting/Eclipse Scripting/org/eclipse/scripting/internal/RegistryWriter.java;1;0;3;1;0;0;0;3;7;1;3;133;7;7;1;0;0;3;3;133;0;1424;3;1;
/org.eclipse.jdt.ui.tests.refactoring/resources/SelectionAnalyzerWorkSpace/SelectionAnalyzerTests/invalidSelection/A_test173.java;1;0;1;1;0;0;0;1;0;0;1;1368;0;0;1;0;0;1;1;1368;0;1368;1;1;
/org.eclipse.jdt.ui/ui/org/eclipse/jdt/internal/ui/dialogs/IStatusChangeListener.java;3;0;5;1;0;0;0;5;5;1;5;144;11;11;1;0;0;5;5;144;0;1275;5;3;
/org.eclipse.jdt.ui/core refactoring/org/eclipse/jdt/internal/corext/refactoring/changes/RenamePackageChange.java;1;0;2;1;1;1;1;1;2;0;1;1939;2;2;1;0;0;1;2;1939;0;4379;2;1;
/org.eclipse.swt/Eclipse SWT PI/gtk/org/eclipse/swt/internal/gtk/GtkCTree.java;1;0;3;1;0;0;0;3;8;1;3;2107;8;8;1;0;0;3;3;2107;0;3869;3;1;
/org.eclipse.jdt.debug.ui/ui/org/eclipse/jdt/internal/debug/ui/actions/ShowStaticFieldsAction.java;3;1;14;1;2;2;2;12;74;2;11;1915;156;156;2;1;0;12;14;2328;1;3933;13;3;
/org.eclipse.vcm.ui/src/org/eclipse/vcm/internal/ui/actions/CompareWithBaseVersionAction.java;3;0;7;2;0;0;0;7;9;2;5;1;26;26;2;2;0;7;7;297;2;1232;5;3;
/org.eclipse.jdt.ui/ui/org/eclipse/jdt/ui/actions/FindWriteReferencesInWorkingSetAction.java;3;1;3;1;3;3;3;0;18;0;0;4141;22;22;1;0;0;0;3;4141;0;4770;3;3;
/org.eclipse.help/src/org/eclipse/help/internal/util/ContextResources.java;2;0;3;1;0;0;0;3;11;1;3;1533;11;11;1;0;0;3;3;1533;0;3075;3;2;
/org.eclipse.help.webapp/src/org/eclipse/help/servlet/Links.java;2;0;7;2;0;0;0;7;48;2;6;2573;82;82;2;1;0;7;7;3402;1;3449;6;2;
/org.eclipse.jdt.ui.tests.refactoring/resources/SelectionAnalyzerWorkSpace/SelectionAnalyzerTests/invalidSelection/A_test114.java;1;0;1;1;0;0;0;1;0;0;1;1368;0;0;1;0;0;1;1;1368;0;1368;1;1;
/org.eclipse.jdt.ui.tests/refactoring/org/eclipse/jdt/refactoring/tests/NullRefactoring.java;3;0;5;1;0;0;0;5;6;1;5;49;15;15;1;0;0;5;5;49;0;1896;5;3;
/org.eclipse.jdt.ui.tests.refactoring/resources/RenameParameters/canRename/A_test32_out.java;1;0;1;1;0;0;0;1;0;0;1;348;0;0;1;0;0;1;1;348;0;348;1;1;
/org.eclipse.jdt.ui.tests.refactoring/resources/PullUp/test12/out/A.java;1;0;2;1;0;0;0;2;2;1;2;2406;2;2;1;0;0;2;2;2406;0;2738;2;1;
/org.eclipse.jdt.ui/ui/org/eclipse/jdt/ui/actions/FindDeclarationsAction.java;2;1;2;1;2;2;2;0;9;0;0;4141;9;9;1;0;0;0;2;4141;0;4770;2;2;
/org.eclipse.pde.ui/src/org/eclipse/pde/internal/base/schema/IMetaElement.java;2;0;3;1;0;0;0;3;10;1;3;1434;10;10;1;0;0;3;3;1434;0;3579;3;2;
/org.eclipse.jdt.ui.tests.refactoring/resources/ExtractTemp/canExtract/A_test14_in.java;1;0;1;1;0;0;0;1;0;0;1;2481;0;0;1;0;0;1;1;2481;0;2481;1;1;
/org.eclipse.jdt.ui.tests.refactoring/resources/ExtractMethodWorkSpace/ExtractMethodTests/expression_out/A_test606.java;2;1;4;1;2;2;2;2;26;1;2;239;27;27;1;0;0;2;4;239;0;4419;4;2;
/org.eclipse.update.core/src/org/eclipse/update/internal/core/SiteFileContentProvider.java;2;0;13;1;0;0;0;13;115;2;12;2467;190;190;2;1;0;13;13;3027;1;3848;12;2;
/org.eclipse.jdt.debug/model/org/eclipse/jdt/debug/core/IJavaExceptionBreakpoint.java;3;0;11;1;0;0;0;11;74;1;11;1035;233;233;1;0;0;11;11;1035;0;3560;11;3;
/org.eclipse.swt.tests/JUnit Tests/org/eclipse/swt/tests/junit/Test_org_eclipse_swt_widgets_Shell.java;2;0;2;1;1;1;1;1;6;0;1;1792;6;6;1;0;0;1;2;1792;0;4706;2;2;
/org.eclipse.scripting/src/org/eclipse/scripting/internal/views/ScriptUIPreviewEditorContent.java;1;0;1;1;0;0;0;1;0;0;1;1424;0;0;1;0;0;1;1;1424;0;1424;1;1;
/org.eclipse.team.examples.filesystem/src/org/eclipse/team/examples/filesystem/ui/DisconnectAction.java;1;0;1;1;1;1;1;0;0;0;0;4674;0;0;1;0;0;0;1;4674;0;4674;1;1;
/org.eclipse.jdt.ui/ui/org/eclipse/jdt/internal/ui/workingsets/WorkingSetMenuContributionItem.java;1;1;3;1;3;3;3;0;16;0;0;4384;18;18;1;0;0;0;3;4384;0;4451;3;1;
/org.eclipse.swt/Eclipse SWT/win32/org/eclipse/swt/widgets/Tree.java;9;3;39;2;10;6;10;29;221;2;27;106;674;674;3;2;4;29;39;4556;6;4701;33;9;
/org.eclipse.swt/Eclipse SWT Drag and Drop/emulated/org/eclipse/swt/dnd/RTFTransfer.java;2;1;5;1;4;4;4;1;50;0;1;3126;64;64;1;0;0;1;5;3126;0;4824;5;2;
/org.eclipse.jdt.ui/core refactoring/org/eclipse/jdt/internal/corext/refactoring/changes/MovePackageChange.java;2;0;3;1;1;1;1;2;9;1;2;1939;15;15;1;0;0;2;3;1939;0;4212;3;2;
/org.eclipse.jdt.ui/ui/org/eclipse/jdt/internal/ui/viewsupport/IAdornmentProvider.java;2;0;3;1;1;1;1;2;4;1;2;3068;4;4;1;0;0;2;3;3068;0;4018;3;2;
/org.eclipse.jdt.ui.tests.refactoring/resources/DeleteSourceReference/A_testField2_in.java;1;0;2;1;0;0;0;2;0;1;2;2003;0;0;1;0;0;2;2;2003;0;2857;2;1;
/org.eclipse.jdt.debug/jdi/org/eclipse/jdi/hcr/EventRequestManager.java;1;0;2;1;0;0;0;2;12;1;2;187;12;12;1;0;0;2;2;187;0;366;2;1;
/org.eclipse.pde.ui/src/org/eclipse/pde/internal/editor/manifest/NewDependencyWizard.java;1;0;6;1;0;0;0;6;8;1;6;2491;14;14;1;0;0;6;6;2491;0;3579;6;1;
/org.eclipse.core.boot/src/org/eclipse/core/internal/boot/update/IIdVersionPair.java;2;0;3;1;0;0;0;3;4;1;3;12;4;4;1;0;0;3;3;12;0;2726;3;2;
/org.eclipse.jdt.ui.tests.refactoring/resources/InlineTemp/canInline/A_test9_in.java;1;0;1;1;0;0;0;1;0;0;1;2051;0;0;1;0;0;1;1;2051;0;2051;1;1;
/org.eclipse.jdt.ui/core refactoring/org/eclipse/jdt/internal/corext/refactoring/rename/RenameStaticMethodRefactoring.java;2;1;6;1;2;2;2;4;9;1;4;1939;24;24;1;0;0;4;6;1939;0;4401;6;2;
/org.eclipse.core.tests.runtime/src/org/eclipse/core/tests/plugintests/CmdLineAndPluginLocalAndPrimaryFeatureTest.java;1;0;1;1;1;1;1;0;0;0;0;4006;0;0;1;0;0;0;1;4006;0;4006;1;1;
/org.eclipse.pde.ui/Eclipse PDE UI/org/eclipse/pde/internal/editor/schema/TypeRestrictionDialog.java;2;0;5;2;0;0;0;5;12;3;3;267;12;12;3;2;0;5;5;324;2;1434;3;2;
/org.eclipse.jdt.ui/core refactoring/org/eclipse/jdt/internal/core/refactoring/rename/RenameStaticMethodRefactoring.java;2;0;3;1;0;0;0;3;7;1;3;1342;7;7;1;0;0;3;3;1342;0;1939;3;2;
/org.eclipse.jdt.ui.tests/test plugin/org/eclipse/jdt/testplugin/util/IDialogTestPass.java;2;0;2;1;1;1;1;1;9;0;1;2180;9;9;1;0;0;1;2;2180;0;4682;2;2;
/org.eclipse.core.tests.harness/src/org/eclipse/core/tests/harness/PerformanceTimer.java;3;0;4;1;1;1;1;3;106;1;3;1794;129;129;1;0;0;3;4;1794;0;4516;4;3;
/org.eclipse.jdt.ui.tests.refactoring/resources/ExtractMethodWorkSpace/ExtractMethodTests/invalidSelection/A_test145.java;1;1;3;1;2;2;2;1;24;0;1;887;24;24;1;0;0;1;3;887;0;4419;3;1;
/org.eclipse.jdt.debug/model/org/eclipse/jdt/internal/debug/core/Timer.java;2;0;7;1;0;0;0;7;107;1;7;187;229;229;1;0;0;7;7;187;0;2158;7;2;
/org.eclipse.jdt.ui/core refactoring/org/eclipse/jdt/internal/corext/refactoring/code/flow/ReturnFlowInfo.java;1;0;3;1;0;0;0;3;24;1;3;1939;26;26;1;0;0;3;3;1939;0;3150;3;1;
/org.eclipse.team.tests.core/src/org/eclipse/team/tests/ftp/FTPClientTest.java;1;0;1;1;1;1;1;0;0;0;0;4212;0;0;1;0;0;0;1;4212;0;4212;1;1;
/org.eclipse.core.resources/src/org/eclipse/core/internal/events/ResourceDelta.java;3;2;15;2;4;3;4;11;998;1;11;12;1401;1401;2;0;1;11;15;4633;1;4633;14;3;
/org.eclipse.jdt.ui/ui/org/eclipse/jdt/internal/ui/reorg/ReorgGroup.java;4;0;25;2;0;0;0;25;103;3;20;15;444;444;3;5;0;25;25;1338;5;3807;20;4;
/org.eclipse.jdt.ui.tests.refactoring/resources/ExtractMethodWorkSpace/ExtractMethodTests/return_in/A_test706.java;1;1;3;1;2;2;2;1;18;0;1;887;18;18;1;0;0;1;3;887;0;4419;3;1;
/org.eclipse.jdt.debug.tests/testprograms/StepFilterThree.java;2;1;2;1;2;2;2;0;13;0;0;4510;13;13;1;0;0;0;2;4510;0;4571;2;2;
/org.eclipse.jdt.ui/core refactoring/org/eclipse/jdt/internal/corext/refactoring/util/StatementAnalyzer.java;2;1;8;1;2;2;2;6;23;1;6;3106;72;72;1;0;0;6;8;3106;0;4421;8;2;
/org.eclipse.pde.ui/src/org/eclipse/pde/internal/core/IModelUndoManager.java;1;0;2;1;0;0;0;2;0;0;1;3579;0;0;2;1;0;2;2;3579;1;3579;1;1;
/org.eclipse.jdt.ui.tests.refactoring/resources/PullUpMethods/testFailTemplate/in/A.java;1;0;2;1;0;0;0;2;0;1;2;2156;0;0;1;0;0;2;2;2156;0;2406;2;1;
/org.eclipse.jdt.ui.tests.refactoring/resources/RenameType/test55/out/A.java;1;0;1;1;0;0;0;1;0;0;1;1284;0;0;1;0;0;1;1;1284;0;1284;1;1;
/org.eclipse.jdt.ui.tests.refactoring/test cases/org/eclipse/jdt/ui/tests/refactoring/SelectionAnalyzerTestSetup.java;1;0;2;1;0;0;0;2;2;1;2;1896;2;2;1;0;0;2;2;1896;0;1939;2;1;
/org.eclipse.pde.build/src/plugin/org/eclipse/pde/internal/core/PluginBuildScriptGenerator.java;1;0;1;1;0;0;0;1;0;0;1;3475;0;0;1;0;0;1;1;3475;0;3475;1;1;
/org.eclipse.jdt.ui.tests.refactoring/resources/SelectionAnalyzerWorkSpace/SelectionAnalyzerTests/selection/A_test2.java;1;0;1;1;0;0;0;1;0;0;1;1368;0;0;1;0;0;1;1;1368;0;1368;1;1;
/org.eclipse.ui.examples.javaeditor/Eclipse Java Editor Example/org/eclipse/ui/examples/javaeditor/JavaTextHover.java;1;0;1;1;0;0;0;1;0;0;1;1067;0;0;1;0;0;1;1;1067;0;1067;1;1;
/org.eclipse.jdt.debug/jdi/org/eclipse/jdi/internal/jdwp/JdwpID.java;2;0;4;1;0;0;0;4;12;1;4;187;25;25;1;0;0;4;4;187;0;3670;4;2;
/org.eclipse.pde.ui/src/org/eclipse/pde/internal/base/model/feature/IFeature.java;1;0;7;1;0;0;0;7;100;3;5;2951;135;135;3;2;0;7;7;2951;2;3579;5;1;
/org.eclipse.update.ui/src/org/eclipse/update/internal/ui/pages/UnknownObjectPage.java;1;0;2;1;0;0;0;2;3;1;2;3537;3;3;1;0;0;2;2;3537;0;3662;2;1;
/org.eclipse.jdt.ui.tests.refactoring/resources/SelectionAnalyzerWorkSpace/SelectionAnalyzerTests/validSelection/A_test233.java;1;0;1;1;0;0;0;1;0;0;1;1368;0;0;1;0;0;1;1;1368;0;1368;1;1;
/org.eclipse.jdt.ui.tests.refactoring/resources/RenameNonPrivateField/test13/out/A.java;1;0;1;1;0;0;0;1;0;0;1;951;0;0;1;0;0;1;1;951;0;951;1;1;
/org.eclipse.jdt.ui.tests.refactoring/resources/RenameTemp/canRename/A_test2_in.java;1;0;1;1;0;0;0;1;0;0;1;1625;0;0;1;0;0;1;1;1625;0;1625;1;1;
/org.eclipse.ui/Eclipse UI/org/eclipse/ui/internal/PerspectiveListenerListOld.java;3;0;5;1;1;1;1;4;10;1;4;257;23;23;1;0;0;4;5;257;0;4363;5;3;
/org.eclipse.jdt.debug.tests/tests/org/eclipse/jdt/debug/tests/core/SourceLocationTests.java;2;1;3;1;3;3;3;0;14;0;0;4173;16;16;1;0;0;0;3;4173;0;4536;3;2;
/org.eclipse.team.tests.cvs.core/src/org/eclipse/team/tests/ccvs/ui/FakeSelectionProvider.java;1;0;1;1;0;0;0;1;0;0;1;2977;0;0;1;0;0;1;1;2977;0;2977;1;1;
/org.eclipse.jdt.ui.tests.refactoring/resources/MoveMembers/testFail21/in/A.java;1;0;1;1;0;0;0;1;0;0;1;2928;0;0;1;0;0;1;1;2928;0;2928;1;1;
/org.eclipse.jdt.ui/core extension/org/eclipse/jdt/internal/corext/textmanipulation/TextBufferEditor.java;2;0;7;1;0;0;0;7;15;1;7;2137;29;29;1;0;0;7;7;2137;0;3870;7;2;
/org.eclipse.debug.ui/ui/org/eclipse/debug/internal/ui/TerminateAndRemoveActionDelegate.java;3;0;12;1;0;0;0;12;41;1;12;187;98;98;1;0;0;12;12;187;0;2382;12;3;
/org.eclipse.team.cvs.core/src/org/eclipse/team/internal/ccvs/core/response/DumpHandler.java;3;0;3;1;0;0;0;3;4;1;3;1978;4;4;1;0;0;3;3;1978;0;2607;3;3;
/org.eclipse.jdt.ui/ui refactoring/org/eclipse/jdt/internal/ui/refactoring/nls/search/GroupByKeyComputer.java;2;0;2;1;0;0;0;2;0;1;2;1922;0;0;1;0;0;2;2;1922;0;2155;2;2;
/org.eclipse.jdt.ui.tests.refactoring/resources/SelectionAnalyzerWorkSpace/SelectionAnalyzerTests/invalidSelection/A_test047.java;1;0;1;1;0;0;0;1;0;0;1;1368;0;0;1;0;0;1;1;1368;0;1368;1;1;
/org.eclipse.jdt.debug/model/org/eclipse/jdt/internal/debug/core/JavaPatternBreakpoint.java;4;0;21;1;0;0;0;21;80;1;21;1280;284;284;1;0;0;21;21;1280;0;2517;21;4;
/org.eclipse.jdt.ui/ui/org/eclipse/jdt/internal/ui/reorg/ReorgExceptionHandler.java;3;1;8;1;3;3;3;5;78;1;5;1258;103;103;1;0;0;5;8;1258;0;4426;8;3;
/org.eclipse.jdt.ui.tests.refactoring/resources/PullUpMethods/test3/out/A.java;1;0;3;1;0;0;0;3;6;1;3;2156;6;6;1;0;0;3;3;2156;0;2406;3;1;
/org.eclipse.jdt.ui.tests.refactoring/resources/RenameMethodInInterface/testFail28/in/A.java;1;0;1;1;0;0;0;1;0;0;1;49;0;0;1;0;0;1;1;49;0;49;1;1;
/org.eclipse.ui/Eclipse UI/org/eclipse/ui/internal/dialogs/EventLoopProgressMonitor.java;3;0;3;1;0;0;0;3;47;1;3;257;51;51;1;0;0;3;3;257;0;3683;3;3;
/org.eclipse.ui/Eclipse UI Standard Components/org/eclipse/ui/views/framelist/BackAction.java;2;0;2;1;1;1;1;1;4;0;1;3498;4;4;1;0;0;1;2;3498;0;4609;2;2;
/org.eclipse.jdt.debug/eval/org/eclipse/jdt/internal/debug/eval/model/IValue.java;2;0;2;1;0;0;0;2;0;1;2;3555;0;0;1;0;0;2;2;3555;0;3645;2;2;
/org.eclipse.pde.ui/src/org/eclipse/pde/internal/editor/component/ReferencePropertySource.java;2;0;2;1;0;0;0;2;0;1;2;1434;0;0;1;0;0;2;2;1434;0;2951;2;2;
/org.eclipse.swt/Eclipse SWT/gtk1x/org/eclipse/swt/widgets/WidgetTable.java;2;0;2;1;1;1;1;1;6;0;1;2107;6;6;1;0;0;1;2;2107;0;4701;2;2;
/org.eclipse.debug.core/core/org/eclipse/debug/core/IDebugEventSetListener.java;1;0;2;1;0;0;0;2;14;1;2;3362;14;14;1;0;0;2;2;3362;0;3460;2;1;
/org.eclipse.jdt.core/compiler/org/eclipse/jdt/internal/compiler/env/NameEnvironmentAnswer.java;2;0;10;1;1;1;1;9;714;4;6;455;1208;1208;4;3;0;9;10;1039;3;4062;7;2;
/org.eclipse.swt/Eclipse SWT/gtk1x/org/eclipse/swt/widgets/Control.java;4;0;7;1;1;1;1;6;79;1;6;2107;143;143;1;0;0;6;7;2107;0;4701;7;4;
/org.eclipse.core.resources/src/org/eclipse/core/internal/utils/Assert.java;1;0;4;1;1;1;1;3;196;1;3;12;231;231;1;0;0;3;4;12;0;4214;4;1;
/org.eclipse.ui.tests/Eclipse UI Tests/org/eclipse/ui/tests/api/MockEditorPart.java;3;0;10;2;0;0;0;10;26;2;9;1002;54;54;2;1;0;10;10;1002;1;2785;9;3;
/org.eclipse.ant.core/src/org/eclipse/ant/core/EclipseAnt.java;5;0;10;2;0;0;0;10;692;2;9;14;1458;1458;2;1;0;10;10;493;1;3489;9;5;
/org.eclipse.ui.examples.javaeditor/Eclipse Java Editor Example/org/eclipse/ui/examples/javaeditor/java/JavaAutoIndentStrategy.java;1;0;1;1;0;0;0;1;0;0;1;1067;0;0;1;0;0;1;1;1067;0;1067;1;1;
/org.eclipse.help.ui/src/org/eclipse/help/internal/ui/NavigationWorkbook.java;2;0;2;1;0;0;0;2;0;1;2;1420;0;0;1;0;0;2;2;1420;0;1675;2;2;
/org.eclipse.core.tests.resources.saveparticipant/src/org/eclipse/core/tests/resources/saveparticipant/SaveManagerTest.java;3;0;5;1;0;0;0;5;226;1;5;1794;279;279;1;0;0;5;5;1794;0;3475;5;3;
/org.eclipse.swt.examples.controls/org/eclipse/swt/examples/controls/TreeTab.java;2;0;3;1;0;0;0;3;113;1;3;513;113;113;1;0;0;3;3;513;0;970;3;2;
/org.eclipse.pde.ui/src/org/eclipse/pde/core/build/IBuildEntry.java;1;0;2;1;0;0;0;2;0;1;2;3579;0;0;1;0;0;2;2;3579;0;3607;2;1;
/org.eclipse.pde.ui/Eclipse PDE UI/org/eclipse/pde/internal/base/schema/ISchemaObjectReference.java;2;0;5;2;0;0;0;5;12;3;3;267;12;12;3;2;0;5;5;324;2;1434;3;2;
/org.eclipse.jdt.ui/nls/org/eclipse/jdt/internal/ui/nls/search/ExceptionHandler.java;1;0;2;1;0;0;0;2;0;1;2;1880;0;0;1;0;0;2;2;1880;0;1913;2;1;
/org.eclipse.core.tests.harness/src/org/eclipse/core/tests/harness/EclipseWorkspaceTest.java;3;0;9;1;1;1;1;8;1692;1;8;1794;1866;1866;1;0;0;8;9;1794;0;4516;9;3;
/org.eclipse.jdt.ui/ui/org/eclipse/jdt/internal/ui/javaeditor/AnnotationErrorTickUpdater.java;1;0;2;1;0;0;0;2;0;1;2;1080;0;0;1;0;0;2;2;1080;0;1256;2;1;
/org.eclipse.ui/Eclipse UI Standard Components/org/eclipse/ui/views/tasklist/ITaskListResourceAdapter.java;2;0;4;2;0;0;0;4;25;2;3;2139;30;30;2;1;0;4;4;2198;1;2198;3;2;
/org.eclipse.pde.ui/src/org/eclipse/pde/internal/launcher/WorkbenchLauncherWizardBasicPage.java;1;0;12;1;0;0;0;12;109;1;12;2560;396;396;1;0;0;12;12;2560;0;3579;12;1;
/org.eclipse.pde.ui/src/org/eclipse/pde/internal/ui/parts/ModifiedTextCellEditor.java;1;0;1;1;0;0;0;1;0;0;1;3579;0;0;1;0;0;1;1;3579;0;3579;1;1;
/org.eclipse.pde.ui/src/org/eclipse/pde/core/ISourceObject.java;1;0;2;1;0;0;0;2;0;1;2;3579;0;0;1;0;0;2;2;3579;0;3607;2;1;
/org.eclipse.pde.ui/Eclipse PDE UI/org/eclipse/pde/internal/preferences/TextOption.java;2;0;5;2;0;0;0;5;33;3;3;267;33;33;3;2;0;5;5;324;2;1434;3;2;
/org.eclipse.jdt.ui/ui/org/eclipse/jdt/internal/ui/packageview/ShowLibrariesAction.java;3;0;7;1;1;1;1;6;15;1;6;125;32;32;1;0;0;6;7;125;0;4211;7;3;
/org.eclipse.ui/Eclipse UI/org/eclipse/ui/internal/Semaphore.java;3;0;3;1;0;0;0;3;15;1;3;257;20;20;1;0;0;3;3;257;0;941;3;3;
/org.eclipse.jdt.ui.tests.refactoring/resources/ExtractMethodWorkSpace/ExtractMethodTests/validSelection/A_test305.java;2;1;3;1;2;2;2;1;0;0;1;49;0;0;1;0;0;1;3;49;0;4419;3;2;
/org.eclipse.swt.examples.paint/src/org/eclipse/swt/examples/paint/Meta.java;1;0;1;1;0;0;0;1;0;0;1;450;0;0;1;0;0;1;1;450;0;450;1;1;
/org.eclipse.jdt.ui/core refactoring/org/eclipse/jdt/internal/corext/refactoring/structure/RenameParameterASTAnalyzer.java;2;0;3;1;0;0;0;3;2;1;3;2630;2;2;1;0;0;3;3;2630;0;3394;3;2;
/org.eclipse.update.ui/src/org/eclipse/update/ui/internal/model/MyComputerFile.java;1;0;3;1;0;0;0;3;6;2;2;2651;6;6;2;1;0;3;3;2651;1;2797;2;1;
/org.eclipse.pde.ui/src/org/eclipse/pde/internal/ui/editor/text/TagRule.java;1;0;2;1;0;0;0;2;3;1;2;3579;3;3;1;0;0;2;2;3579;0;3870;2;1;
/org.eclipse.swt.tests/JUnit Tests/org/eclipse/swt/tests/junit/Test_org_eclipse_swt_custom_BidiSegmentListener.java;3;0;3;1;1;1;1;2;7;1;2;1792;13;13;1;0;0;2;3;1792;0;4706;3;3;
/org.eclipse.debug.ui/ui/org/eclipse/debug/internal/ui/DebugHistoryMenuAction.java;1;0;2;1;0;0;0;2;0;1;2;2254;0;0;1;0;0;2;2;2254;0;2382;2;1;
/org.eclipse.pde.ui/Eclipse PDE UI/org/eclipse/pde/internal/editor/component/PluginReference.java;2;0;6;2;0;0;0;6;12;3;4;267;18;18;3;2;0;6;6;324;2;1434;4;2;
/org.eclipse.ui/Eclipse UI/org/eclipse/ui/dialogs/ContainerSelectionDialog.java;5;0;7;1;0;0;0;7;23;1;7;257;69;69;1;0;0;7;7;257;0;3633;7;5;
/org.eclipse.jdt.ui/ui/org/eclipse/jdt/internal/ui/packageview/ShowInNavigator.java;1;0;3;1;0;0;0;3;22;1;3;15;22;22;1;0;0;3;3;15;0;204;3;1;
/org.eclipse.ui/Eclipse UI/org/eclipse/ui/internal/ViewFactory.java;4;2;9;1;5;4;5;4;282;1;4;257;364;364;2;0;1;4;9;4082;1;4604;8;4;
/org.eclipse.jdt.core/compiler/org/eclipse/jdt/internal/compiler/parser/ParserBasicInformation.java;2;0;11;1;1;1;1;10;210;4;7;455;382;382;4;3;0;10;11;1039;3;4062;8;2;
/org.eclipse.ui/Eclipse UI/org/eclipse/ui/internal/ExportResourcesAction.java;5;0;6;1;0;0;0;6;13;1;6;257;21;21;1;0;0;6;6;257;0;3739;6;5;
/org.eclipse.jdt.ui/core refactoring/org/eclipse/jdt/core/refactoring/fields/RenameFieldRefactoring.java;1;0;10;1;0;0;0;10;61;2;8;28;104;104;2;2;0;10;10;106;2;408;8;1;
/org.eclipse.ui.externaltools/External Tools/org/eclipse/ui/externaltools/internal/core/ExternalToolsBuilder.java;2;1;5;1;5;5;5;0;6;0;0;4090;15;15;1;0;0;0;5;4090;0;4729;5;2;
/org.eclipse.swt/Eclipse SWT OLE Win32/win32/org/eclipse/swt/internal/ole/win32/CAUUID.java;2;0;3;1;0;0;0;3;5;1;3;106;5;5;1;0;0;3;3;106;0;2069;3;2;
/org.eclipse.jdt.ui.tests.refactoring/resources/RenameTemp/cannotRename/A_testFail29.java;1;0;1;1;0;0;0;1;0;0;1;3465;0;0;1;0;0;1;1;3465;0;3465;1;1;
/org.eclipse.scripting/src/org/eclipse/scripting/internal/datamodels/XGRStringDataNode.java;1;0;1;1;0;0;0;1;0;0;1;1424;0;0;1;0;0;1;1;1424;0;1424;1;1;
/org.eclipse.ui/Eclipse JFace Text/org/eclipse/jface/text/ChildDocumentManager.java;3;0;4;1;0;0;0;4;89;1;4;257;98;98;1;0;0;4;4;257;0;1066;4;3;
/org.eclipse.pde.junit/Pde JUnit/org/eclipse/pde/internal/junit/ui/RemotePluginTestRunner.java;2;0;2;1;0;0;0;2;0;1;2;2399;0;0;1;0;0;2;2;2399;0;3205;2;2;
/org.eclipse.swt/Eclipse SWT PI/gtk1x/org/eclipse/swt/internal/gtk/GdkEventKey.java;2;0;2;1;1;1;1;1;3;0;1;2107;3;3;1;0;0;1;2;2107;0;4701;2;2;
/org.eclipse.jdt.ui.tests.refactoring/resources/RenameTemp/cannotRename/A_testFail11.java;1;0;2;1;0;0;0;2;2;1;2;1625;2;2;1;0;0;2;2;1625;0;1652;2;1;
/org.eclipse.jdt.ui.tests.refactoring/resources/PullUpMethods/testFail8/in/A.java;1;0;2;1;0;0;0;2;0;1;2;2156;0;0;1;0;0;2;2;2156;0;2406;2;1;
/org.eclipse.vcm.core.cvs/src/org/eclipse/vcm/internal/core/ccvs/CommitEntryIterator.java;4;0;8;1;0;0;0;8;34;2;7;0;113;113;2;1;0;8;8;390;1;1568;7;4;
/org.eclipse.pde.ui/Eclipse PDE UI/org/eclipse/pde/internal/editor/manifest/ManifestDependenciesPage.java;2;0;6;2;0;0;0;6;12;3;4;267;17;17;3;2;0;6;6;324;2;1434;4;2;
/org.eclipse.help/src/RequestHeaderExample.java;1;0;2;1;0;0;0;2;0;1;2;1882;0;0;1;0;0;2;2;1882;0;1930;2;1;
/org.eclipse.swt.examples/src/org/eclipse/swt/examples/layoutexample/LayoutExample.java;2;0;4;1;1;1;1;3;25;1;3;3420;33;33;1;0;0;3;4;3420;0;4705;4;2;
/org.eclipse.jdt.ui/core refactoring/org/eclipse/jdt/internal/corext/refactoring/nls/NLSHolder.java;2;2;10;1;3;2;3;7;39;2;6;1939;85;85;2;1;1;7;10;2659;2;4379;8;2;
/org.eclipse.core.resources/src/org/eclipse/core/internal/localstore/FileSystemStore.java;5;1;25;1;4;4;4;21;642;2;18;12;1157;1157;2;3;0;21;25;35;3;4454;22;5;
/org.eclipse.update.core/src/org/eclipse/update/core/internal/InternalSiteManager.java;1;0;2;1;0;0;0;2;0;0;1;1423;0;0;2;1;0;2;2;1423;1;1423;1;1;
/org.eclipse.team.tests.cvs.core/src/org/eclipse/team/tests/ccvs/core/compatible/BasicTest.java;2;0;10;1;0;0;0;10;53;1;10;2536;136;136;1;0;0;10;10;2536;0;3455;10;2;
/org.eclipse.ui/Eclipse UI/org/eclipse/ui/internal/Perspective.java;9;4;51;2;18;13;18;33;159;2;29;257;1068;1068;4;4;5;33;51;4257;9;4706;42;9;
/org.eclipse.pde.ui/src/org/eclipse/pde/internal/editor/manifest/DependenciesForm.java;2;0;9;1;0;0;0;9;140;1;9;1434;222;222;1;0;0;9;9;1434;0;3579;9;2;
/org.eclipse.jdt.ui/ui/org/eclipse/jdt/internal/ui/viewsupport/IProblemChangedListener.java;2;1;6;1;3;3;3;3;9;1;3;1035;35;35;1;0;0;3;6;1035;0;4145;6;2;
/org.eclipse.swt/Eclipse SWT PI/common_j2se/org/eclipse/swt/internal/Library.java;4;1;34;2;13;13;13;21;67;2;20;2069;133;133;2;1;0;21;34;2679;1;4701;33;4;
/org.eclipse.jdt.core/compiler/org/eclipse/jdt/internal/compiler/lookup/ReferenceBinding.java;3;0;17;2;1;1;1;16;1069;4;11;455;1265;1265;4;5;0;16;17;1039;5;4062;12;3;
/org.eclipse.scripting/Eclipse Scripting/org/eclipse/scripting/internal/IXGRElementUIDataPresentationElement.java;1;0;3;1;0;0;0;3;4;1;3;133;4;4;1;0;0;3;3;133;0;1424;3;1;
/org.eclipse.help.ui/src/org/eclipse/help/ui/internal/browser/win32/ICommandStateChangedListener.java;2;0;2;1;1;1;1;1;0;0;1;3053;0;0;1;0;0;1;2;3053;0;4427;2;2;
/org.eclipse.jdt.debug/eval/org/eclipse/jdt/debug/eval/ast/model/IVariable.java;1;0;2;1;0;0;0;2;0;1;2;3329;0;0;1;0;0;2;2;3329;0;3421;2;1;
/org.eclipse.update.ui/src/org/eclipse/update/internal/ui/manager/NewFolderDialog.java;1;0;2;1;0;0;0;2;0;1;2;3517;0;0;1;0;0;2;2;3517;0;3658;2;1;
/org.eclipse.core.resources/src/org/eclipse/core/internal/resources/IValidator.java;1;0;1;1;0;0;0;1;0;0;1;824;0;0;1;0;0;1;1;824;0;824;1;1;
/org.eclipse.swt.examples/org/eclipse/swt/examples/layoutexample/NameDialog.java;1;0;2;1;0;0;0;2;55;1;2;3420;55;55;1;0;0;2;2;3420;0;3583;2;1;
/org.eclipse.update.ui/src/org/eclipse/update/internal/ui/model/UIModelObject.java;1;0;1;1;0;0;0;1;0;0;1;3740;0;0;1;0;0;1;1;3740;0;3740;1;1;
/org.eclipse.pde.core/src/org/eclipse/pde/internal/core/plugin/WorkspacePluginModelBase.java;1;0;4;1;1;1;1;3;5;1;3;3591;10;10;1;0;0;3;4;3591;0;4711;4;1;
/org.eclipse.pde/src/org/eclipse/pde/internal/builders/ExtensionPointSchemaBuilder.java;1;0;2;1;0;0;0;2;295;1;2;3631;295;295;1;0;0;2;2;3631;0;3802;2;1;
/org.eclipse.scripting/src/org/eclipse/scripting/internal/uirenderer/XGRElementUISwtButton.java;1;0;1;1;0;0;0;1;0;0;1;1424;0;0;1;0;0;1;1;1424;0;1424;1;1;
/org.eclipse.jdt.debug/model/org/eclipse/jdt/internal/debug/core/hcr/ProjectBuildWatcher.java;2;0;3;2;0;0;0;3;12;1;3;2585;19;19;1;0;0;3;3;2585;0;3399;3;2;
/org.eclipse.jdt.core/model/org/eclipse/jdt/internal/core/builder/impl/IncrementalImageBuilder.java;1;0;15;1;0;0;0;15;3147;4;11;455;3499;3499;4;4;0;15;15;1039;4;2808;11;1;
/org.eclipse.ui/Eclipse UI/org/eclipse/ui/internal/misc/ContainerContentProvider.java;3;0;3;1;0;0;0;3;24;1;3;257;29;29;1;0;0;3;3;257;0;1383;3;3;
/org.eclipse.update.ui/src/org/eclipse/update/ui/internal/model/MyComputerDirectory.java;1;0;4;1;0;0;0;4;7;1;4;2651;8;8;1;0;0;4;4;2651;0;2797;4;1;
/org.eclipse.jdt.debug/eval/org/eclipse/jdt/internal/debug/eval/ast/engine/PushNull.java;1;0;3;1;0;0;0;3;48;1;3;3329;48;48;1;0;0;3;3;3329;0;3421;3;1;
/org.eclipse.swt/Eclipse SWT/carbon/org/eclipse/swt/widgets/Scrollable.java;4;1;5;1;5;5;5;0;16;0;0;4147;31;31;1;0;0;0;5;4147;0;4701;5;4;
/org.eclipse.ui/Eclipse JFace Text/org/eclipse/jface/text/TextPresentation.java;4;1;6;1;2;2;2;4;220;1;4;257;323;323;1;0;0;4;6;257;0;4838;6;4;
/org.eclipse.jdt.ui/core refactoring/org/eclipse/jdt/core/refactoring/types/TypeRefactoring.java;1;0;5;1;0;0;0;5;8;1;5;15;17;17;1;0;0;5;5;15;0;408;5;1;
/org.eclipse.debug.ui/ui/org/eclipse/debug/internal/ui/SuspendActionDelegate.java;3;0;7;1;0;0;0;7;42;1;7;187;70;70;1;0;0;7;7;187;0;2382;7;3;
/org.eclipse.team.tests.cvs.core/src/org/eclipse/team/tests/ccvs/ui/LoggingTestRunner.java;1;0;1;1;0;0;0;1;0;0;1;3068;0;0;1;0;0;1;1;3068;0;3068;1;1;
/org.eclipse.jdt.core/model/org/eclipse/jdt/internal/core/builder/impl/NonStateSpecificHandleImpl.java;1;0;10;1;0;0;0;10;194;4;6;455;230;230;4;4;0;10;10;1039;4;2808;6;1;
/org.eclipse.scripting/src/org/eclipse/scripting/internal/datamodels/XGRXmlElementsAndAttributesDataNode.java;1;0;1;1;0;0;0;1;0;0;1;1424;0;0;1;0;0;1;1;1424;0;1424;1;1;
/org.eclipse.ui.tests/Eclipse UI Tests/org/eclipse/ui/tests/api/ListView.java;1;0;6;1;0;0;0;6;68;2;4;1403;182;182;2;2;0;6;6;1403;2;2033;4;1;
/org.eclipse.jdt.debug/jdi/org/eclipse/jdi/internal/request/AccessWatchpointRequestImpl.java;2;0;4;1;0;0;0;4;12;1;4;187;25;25;1;0;0;4;4;187;0;3670;4;2;
/org.eclipse.pde.build/src/antlib/org/eclipse/pde/internal/core/tasks/BuildManifestTask.java;1;0;1;1;0;0;0;1;0;0;1;3475;0;0;1;0;0;1;1;3475;0;3475;1;1;
/org.eclipse.jdt.ui/ui/org/eclipse/jdt/internal/ui/reorg/JdtDeleteResourceAction.java;1;0;5;1;0;0;0;5;35;2;4;2244;61;61;2;1;0;5;5;2770;1;3222;4;1;
/org.eclipse.core.tests.resources/src/org/eclipse/core/tests/internal/localstore/RefreshLocalTest.java;3;1;5;1;2;2;2;3;302;1;3;1794;366;366;1;0;0;3;5;1794;0;4524;5;3;
/org.eclipse.debug.ui/ui/org/eclipse/debug/internal/ui/views/console/ConsoleDocument.java;3;1;4;1;4;4;4;0;1162;0;0;3975;1279;1279;1;0;0;0;4;3975;0;4594;4;3;
/org.eclipse.scripting/Eclipse Scripting/org/eclipse/scripting/ScriptAdapterDelegatingPreferencePage.java;2;0;4;1;0;0;0;4;16;1;4;133;23;23;1;0;0;4;4;133;0;1424;4;2;
/org.eclipse.jdt.ui.tests.refactoring/resources/SelectionAnalyzerWorkSpace/SelectionAnalyzerTests/invalidSelection/A_testx.java;1;0;2;1;0;0;0;2;0;1;2;1368;0;0;1;0;0;2;2;1368;0;2155;2;1;
/org.eclipse.swt/Eclipse SWT/common/org/eclipse/swt/events/SelectionListener.java;4;0;5;1;1;1;1;4;6;1;4;106;18;18;1;0;0;4;5;106;0;4701;5;4;
/org.eclipse.jdt.core/model/org/eclipse/jdt/internal/core/IncrementalReconcilerRequestor.java;1;0;2;1;0;0;0;2;0;1;2;455;0;0;1;0;0;2;2;455;0;632;2;1;
/org.eclipse.jdt.ui.tests.refactoring/resources/ExtractTemp/canExtract/A_test8_out.java;1;0;1;1;0;0;0;1;0;0;1;2481;0;0;1;0;0;1;1;2481;0;2481;1;1;
/org.eclipse.ant.core/src/antlib/org/eclipse/ant/internal/core/ant/InternalAntRunner.java;1;0;1;1;0;0;0;1;0;0;1;3475;0;0;1;0;0;1;1;3475;0;3475;1;1;
/org.eclipse.swt/Eclipse SWT/photon/org/eclipse/swt/widgets/FontDialog.java;4;1;9;1;3;3;3;6;87;2;5;106;108;108;2;1;0;6;9;2064;1;4701;8;4;
/org.eclipse.jdt.core/ant/org/eclipse/jdt/internal/core/ant/Jdtcom.java;1;0;2;1;0;0;0;2;0;1;2;3285;0;0;1;0;0;2;2;3285;0;3526;2;1;
/org.eclipse.jdt.ui.tests.refactoring/resources/DeleteSourceReference/A_testField4_in.java;1;0;2;1;0;0;0;2;0;1;2;2003;0;0;1;0;0;2;2;2003;0;2857;2;1;
/org.eclipse.swt.examples/Eclipse SWT Examples/common/org/eclipse/swt/examples/controlexample/ComboTab.java;1;0;2;1;0;0;0;2;0;1;2;107;0;0;1;0;0;2;2;107;0;611;2;1;
/org.eclipse.webdav/src/kernel/org/eclipse/webdav/internal/kernel/ConditionTerm.java;3;0;6;1;1;1;1;5;316;1;5;12;609;609;1;0;0;5;6;12;0;4211;6;3;
/org.eclipse.jdt.ui/ui/org/eclipse/jdt/ui/actions/WriteReferencesSearchGroup.java;2;2;4;2;4;3;4;0;26;0;0;4146;34;34;2;0;1;0;4;4146;1;4770;3;2;
/org.eclipse.update.ui/src/org/eclipse/update/internal/ui/manager/HistoryPage.java;1;0;2;1;0;0;0;2;0;1;2;1428;0;0;1;0;0;2;2;1428;0;1460;2;1;
/org.eclipse.swt.examples.layouts/src/org/eclipse/swt/examples/layouts/LayoutPlugin.java;2;0;2;1;1;1;1;1;6;0;1;3451;6;6;1;0;0;1;2;3451;0;4705;2;2;
/org.eclipse.debug.ui/ui/org/eclipse/debug/internal/ui/actions/CopyToClipboardActionDelegate.java;2;1;14;1;2;2;2;12;43;1;12;2382;180;180;1;0;0;12;14;2382;0;4163;14;2;
/org.eclipse.swt.examples/org/eclipse/swt/examples/fileviewer/TreeExpandDropListener.java;2;0;3;2;0;0;0;3;84;2;2;554;84;84;2;1;0;3;3;609;1;609;2;2;
/org.eclipse.ui/Eclipse UI/org/eclipse/ui/IPropertyListener.java;2;0;2;1;0;0;0;2;8;1;2;257;8;8;1;0;0;2;2;257;0;457;2;2;
/org.eclipse.team.cvs.core/src/org/eclipse/team/internal/ccvs/core/resources/FilePropertiesContainer.java;3;0;3;1;0;0;0;3;553;1;3;1978;553;553;1;0;0;3;3;1978;0;2156;3;3;
/org.eclipse.swt/Eclipse SWT/photon/org/eclipse/swt/widgets/Control.java;7;2;40;2;14;13;14;26;1143;4;19;106;2845;2845;4;7;1;26;40;3008;8;4701;32;7;
/org.eclipse.team.ui/src/org/eclipse/team/internal/ui/sync/ITeamNode.java;1;0;4;1;1;1;1;3;14;2;2;2054;26;26;2;1;0;3;4;2231;1;4005;3;1;
/org.eclipse.core.runtime/src/org/eclipse/core/runtime/MultiStatus.java;3;0;4;1;1;1;1;3;258;1;3;12;285;285;1;0;0;3;4;12;0;4214;4;3;
/org.eclipse.jdt.ui.tests.refactoring/resources/MoveMembers/test3/in/A.java;1;0;1;1;0;0;0;1;0;0;1;2738;0;0;1;0;0;1;1;2738;0;2738;1;1;
/org.eclipse.scripting/Eclipse Scripting/org/eclipse/scripting/internal/views/ScriptUIEditorContextContributor.java;2;0;5;1;0;0;0;5;53;1;5;133;71;71;1;0;0;5;5;133;0;1424;5;2;
/org.eclipse.jdt.ui.tests.refactoring/resources/ExtractMethodWorkSpace/ExtractMethodTests/return_in/A_test705.java;1;1;3;1;2;2;2;1;18;0;1;887;18;18;1;0;0;1;3;887;0;4419;3;1;
/org.eclipse.jdt.ui.tests.refactoring/resources/RenameType/testFail24/in/B.java;1;0;1;1;0;0;0;1;0;0;1;49;0;0;1;0;0;1;1;49;0;49;1;1;
/org.eclipse.core.resources/src/org/eclipse/core/internal/dtree/AbstractDataTree.java;2;0;7;1;1;1;1;6;638;1;6;12;1171;1171;1;0;0;6;7;12;0;4214;7;2;
/org.eclipse.jdt.ui/core refactoring/org/eclipse/jdt/internal/core/refactoring/code/CommentAnalyzer.java;3;0;4;1;0;0;0;4;7;1;4;408;8;8;1;0;0;4;4;408;0;1939;4;3;
/org.eclipse.jdt.ui.tests.refactoring/resources/MoveMembers/test15/out/A.java;1;0;1;1;0;0;0;1;0;0;1;2738;0;0;1;0;0;1;1;2738;0;2738;1;1;
/org.eclipse.jdt.ui.tests.refactoring/resources/DeleteSourceReferenceEdit/A_testField2_in.java;1;0;1;1;0;0;0;1;0;0;1;2857;0;0;1;0;0;1;1;2857;0;2857;1;1;
/org.eclipse.pde.junit/Pde JUnit/org/eclipse/pde/internal/junit/launcher/JUnitPdeMainTab.java;3;0;4;1;0;0;0;4;353;1;4;2861;356;356;1;0;0;4;4;2861;0;3205;4;3;
/org.eclipse.pde.build/src/org/eclipse/pde/internal/build/AbstractApplication.java;1;1;9;1;3;3;3;6;104;2;5;2896;149;149;2;1;0;6;9;3571;1;4273;8;1;
/org.eclipse.jdt.ui.tests.refactoring/resources/StructureSelectionAction/A_test21.java;1;0;1;1;0;0;0;1;0;0;1;3003;0;0;1;0;0;1;1;3003;0;3003;1;1;
/org.eclipse.jdt.debug.ui/ui/org/eclipse/jdt/internal/debug/ui/actions/ExitToggleAction.java;2;0;2;1;0;0;0;2;1;1;2;2646;1;1;1;0;0;2;2;2646;0;2844;2;2;
/org.eclipse.jdt.ui/ui/org/eclipse/jdt/internal/ui/text/java/ProposalInfo.java;5;1;17;1;2;2;2;15;92;2;14;25;294;294;2;1;0;15;17;25;1;4621;16;5;
/org.eclipse.search/search/org/eclipse/search/internal/ui/SearchPreferencePage.java;1;1;4;1;4;4;4;0;77;0;0;4148;120;120;1;0;0;0;4;4148;0;4449;4;1;
/org.eclipse.swt.examples.paint/org/eclipse/swt/examples/paint/PaintViewAction.java;1;0;1;1;0;0;0;1;0;0;1;513;0;0;1;0;0;1;1;513;0;513;1;1;
/org.eclipse.jdt.debug/eval/org/eclipse/jdt/internal/debug/eval/ast/engine/MinusOperator.java;1;0;2;1;0;0;0;2;0;1;2;3329;0;0;1;0;0;2;2;3329;0;3421;2;1;
/org.eclipse.core.runtime/src/org/eclipse/core/runtime/model/URLModel.java;3;1;5;1;2;2;2;3;66;1;3;82;88;88;1;0;0;3;5;82;0;4824;5;3;
/org.eclipse.jdt.ui/core extension/org/eclipse/jdt/internal/corext/dom/SelectionMapper.java;1;0;2;1;0;0;0;2;0;1;2;2876;0;0;1;0;0;2;2;2876;0;3006;2;1;
/org.eclipse.pde.ui/src/org/eclipse/pde/internal/wizards/templates/IVariableProvider.java;1;0;2;1;0;0;0;2;0;1;2;3388;0;0;1;0;0;2;2;3388;0;3579;2;1;
/org.eclipse.swt/Eclipse SWT PI/gtk/org/eclipse/swt/internal/gtk/GdkGCValues.java;2;0;4;1;2;1;2;2;7;1;2;2107;9;9;2;0;1;2;4;4701;1;4701;3;2;
/org.eclipse.compare/compare/org/eclipse/compare/internal/CompareViewerSwitchingPane.java;2;0;5;1;0;0;0;5;42;1;5;14;62;62;1;0;0;5;5;14;0;1802;5;2;
/org.eclipse.ui/Eclipse UI/org/eclipse/ui/internal/CloseAllAction.java;4;0;8;1;1;1;1;7;52;2;6;257;73;73;2;1;0;7;8;3212;1;4082;7;4;
/org.eclipse.ui/Eclipse JFace Text/org/eclipse/jface/text/contentassist/ContextInformationPopup.java;5;1;15;1;3;3;3;12;464;1;12;257;1071;1071;1;0;0;12;15;257;0;4838;15;5;
/org.eclipse.pde.build/src/antlib/org/eclipse/pde/internal/core/tasks/FetchTask.java;1;0;1;1;0;0;0;1;0;0;1;3475;0;0;1;0;0;1;1;3475;0;3475;1;1;
/org.eclipse.jdt.ui/core refactoring/org/eclipse/jdt/internal/core/refactoring/rename/RefactoringASTAnalyzer.java;1;0;2;1;0;0;0;2;0;0;1;1910;0;0;2;1;0;2;2;1910;1;1910;1;1;
/org.eclipse.jdt.launching/launching/org/eclipse/jdt/launching/sourcelookup/IJavaSourceLocation.java;2;1;7;1;2;2;2;5;20;2;4;2372;40;40;2;1;0;5;7;2372;1;4198;6;2;
/org.eclipse.swt/Eclipse SWT PI/win32/org/eclipse/swt/internal/win32/OSVERSIONINFO.java;3;0;3;1;1;1;1;2;6;1;2;2069;10;10;1;0;0;2;3;2069;0;4701;3;3;
/org.eclipse.jdt.debug.ui/ui/org/eclipse/jdt/internal/debug/ui/actions/ExceptionUncaughtToggleAction.java;2;0;3;1;0;0;0;3;23;1;3;1915;28;28;1;0;0;3;3;1915;0;2844;3;2;
/org.eclipse.scripting/src/org/eclipse/scripting/internal/PluginParser.java;1;0;1;1;0;0;0;1;0;0;1;1424;0;0;1;0;0;1;1;1424;0;1424;1;1;
/org.eclipse.jdt.core/compiler/org/eclipse/jdt/internal/compiler/impl/ITypeRequestor.java;2;0;9;1;1;1;1;8;246;4;5;455;414;414;4;3;0;8;9;1039;3;4062;6;2;
/org.eclipse.team.cvs.ssh/src/org/eclipse/team/internal/ccvs/ssh/Blowfish.java;1;0;2;1;0;0;0;2;2428;1;2;1978;2428;2428;1;0;0;2;2;1978;0;3102;2;1;
/org.eclipse.pde.ui/src/org/eclipse/pde/internal/ui/wizards/templates/PluginReference.java;1;0;1;1;0;0;0;1;0;0;1;3579;0;0;1;0;0;1;1;3579;0;3579;1;1;
/org.eclipse.jdt.ui/ui/org/eclipse/jdt/internal/ui/actions/StructuredSelectionProvider.java;4;0;12;2;1;1;1;11;136;2;10;1639;303;303;2;1;0;11;12;1683;1;4161;11;4;
/org.eclipse.help.ui/src/org/eclipse/help/ui/internal/browser/win32/IDocumentCompleteListener.java;2;0;2;1;1;1;1;1;0;0;1;3053;0;0;1;0;0;1;2;3053;0;4427;2;2;
/org.eclipse.jdt.ui/ui/org/eclipse/jdt/internal/ui/preferences/ZipTreeNode.java;2;0;6;1;0;0;0;6;8;1;6;15;24;24;1;0;0;6;6;15;0;1258;6;2;
/org.eclipse.pde.ui/src/org/eclipse/pde/internal/editor/manifest/ExtensionsPropertySheet.java;2;0;4;1;0;0;0;4;2;1;4;1434;3;3;1;0;0;4;4;1434;0;3579;4;2;
/org.eclipse.jdt.ui/core refactoring/org/eclipse/jdt/internal/core/refactoring/packages/RenamePackageRefactoring.java;4;0;13;1;0;0;0;13;223;2;12;408;368;368;2;1;0;13;13;959;1;1342;12;4;
/org.eclipse.jdt.ui.tests.refactoring/resources/DeleteSourceReference/test2/in/A.java;1;0;1;1;0;0;0;1;0;0;1;2857;0;0;1;0;0;1;1;2857;0;2857;1;1;
/org.eclipse.jdt.ui.tests.refactoring/resources/RenameTemp/cannotRename/A_testFail21.java;1;0;2;1;0;0;0;2;2;1;2;1625;2;2;1;0;0;2;2;1625;0;1652;2;1;
/org.eclipse.jdt.ui/ui/org/eclipse/jdt/internal/ui/preferences/CompilerPreferencePage.java;5;2;24;2;9;6;9;15;271;2;14;916;1135;1135;2;1;3;15;24;3465;4;4425;20;5;
/org.eclipse.swt/Eclipse SWT/photon/org/eclipse/swt/widgets/Widget.java;8;2;17;1;7;6;7;10;310;1;10;106;726;726;2;0;1;10;17;4606;1;4730;16;8;
/org.eclipse.jdt.ui.tests.refactoring/resources/ExtractMethodWorkSpace/ExtractMethodTests/expression_out/A_test620.java;1;1;3;1;2;2;2;1;0;0;1;3741;0;0;1;0;0;1;3;3741;0;4419;3;1;
/org.eclipse.swt/Eclipse SWT PI/win32/org/eclipse/swt/internal/ole/win32/ITypeInfo.java;2;0;2;1;1;1;1;1;6;0;1;2069;6;6;1;0;0;1;2;2069;0;4701;2;2;
/org.eclipse.webdav/src/kernel/org/eclipse/webdav/internal/kernel/Precondition.java;3;0;6;1;1;1;1;5;370;1;5;12;709;709;1;0;0;5;6;12;0;4211;6;3;
/org.eclipse.ui/Eclipse UI/org/eclipse/ui/dialogs/ListSelectionDialog.java;5;0;10;1;1;1;1;9;12;1;9;257;61;61;1;0;0;9;10;257;0;3954;10;5;
/org.eclipse.jdt.ui.tests.refactoring/resources/ExtractMethodWorkSpace/ExtractMethodTests/invalidSelection/A_test160.java;2;1;3;1;2;2;2;1;0;0;1;296;0;0;1;0;0;1;3;296;0;4419;3;2;
/org.eclipse.pde.ui/src/org/eclipse/pde/internal/ui/editor/schema/TypeRestrictionDialog.java;1;0;2;1;0;0;0;2;2;1;2;3579;2;2;1;0;0;2;2;3579;0;3591;2;1;
/org.eclipse.jdt.debug.ui/ui/org/eclipse/jdt/internal/debug/ui/display/IDisplayAction.java;2;0;2;1;0;0;0;2;0;1;2;2273;0;0;1;0;0;2;2;2273;0;2813;2;2;
/org.eclipse.jdt.debug/model/org/eclipse/jdt/debug/core/IJavaPrimitiveValue.java;2;0;3;1;0;0;0;3;6;1;3;2010;8;8;1;0;0;3;3;2010;0;3572;3;2;
/org.eclipse.update.core/src/org/eclipse/update/internal/core/LocalSite.java;2;0;6;1;0;0;0;6;91;2;5;1623;99;99;2;1;0;6;6;1643;1;1791;5;2;
/org.eclipse.jdt.ui.tests/test plugin/org/eclipse/jdt/testplugin/NewMain.java;2;0;4;1;0;0;0;4;13;1;4;49;19;19;1;0;0;4;4;49;0;2439;4;2;
/org.eclipse.ui/Eclipse JFace Text/org/eclipse/jface/text/IMarkSelection.java;1;1;2;1;2;2;2;0;26;0;0;4209;36;36;1;0;0;0;2;4209;0;4838;2;1;
/org.eclipse.jdt.ui/ui refactoring/org/eclipse/jdt/internal/ui/refactoring/ExtractTempWizard.java;2;0;2;1;0;0;0;2;1;1;2;2480;1;1;1;0;0;2;2;2480;0;2874;2;2;
/org.eclipse.pde.ui/src/org/eclipse/pde/internal/ui/wizards/templates/PerspectiveExtensionsTemplate.java;1;2;8;1;4;3;4;4;147;1;4;3812;267;267;2;0;1;4;8;4316;1;4706;7;1;
/org.eclipse.swt/Eclipse SWT/emulated/treetable/org/eclipse/swt/widgets/Tree.java;7;2;12;1;5;4;5;7;156;1;7;1028;198;198;2;0;1;7;12;4557;1;4701;11;7;
/org.eclipse.jdt.ui/ui/org/eclipse/jdt/internal/ui/javaeditor/ClassFileMarkerRulerAction.java;2;0;4;1;0;0;0;4;21;1;4;15;34;34;1;0;0;4;4;15;0;1685;4;2;
/org.eclipse.swt/Eclipse SWT PI/gtk1x/org/eclipse/swt/internal/gtk/GtkCheckMenuItem.java;2;0;2;1;1;1;1;1;3;0;1;2107;3;3;1;0;0;1;2;2107;0;4701;2;2;
/org.eclipse.swt/Eclipse SWT/win32/org/eclipse/swt/graphics/Color.java;4;1;5;1;3;3;3;2;25;1;2;106;36;36;1;0;0;2;5;106;0;4701;5;4;
/org.eclipse.jdt.core/compiler/org/eclipse/jdt/internal/compiler/lookup/ProblemBinding.java;2;0;3;1;1;1;1;2;80;1;2;455;96;96;1;0;0;2;3;455;0;4062;3;2;
/org.eclipse.ui/Eclipse UI/org/eclipse/ui/internal/dialogs/ProjectReferencePage.java;6;0;9;2;0;0;0;9;19;2;8;257;42;42;2;1;0;9;9;3699;1;3699;8;6;
/org.eclipse.jdt.core/model/org/eclipse/jdt/internal/core/builder/ClasspathLocation.java;2;0;3;1;1;1;1;2;15;1;2;2979;19;19;1;0;0;2;3;2979;0;4063;3;2;
/org.eclipse.jdt.debug/eval/org/eclipse/jdt/internal/debug/eval/ast/engine/SourceEvaluationSourceGenerator.java;1;0;2;1;0;0;0;2;0;1;2;3421;0;0;1;0;0;2;2;3421;0;3447;2;1;
/org.eclipse.scripting/src/org/eclipse/scripting/internal/views/ScriptDevelopmentWizard.java;1;0;1;1;0;0;0;1;0;0;1;1424;0;0;1;0;0;1;1;1424;0;1424;1;1;
/org.eclipse.jdt.ui/core extension/org/eclipse/jdt/internal/corext/codemanipulation/TextBufferEditor.java;2;0;5;2;0;0;0;5;175;3;3;1937;185;185;3;2;0;5;5;2133;2;2133;3;2;
/org.eclipse.jdt.ui.tests/JUnit/junit/samples/money/IMoney.java;2;0;2;1;0;0;0;2;0;1;2;49;0;0;1;0;0;2;2;49;0;1186;2;2;
/org.eclipse.jdt.ui.tests.refactoring/resources/SelectionAnalyzerWorkSpace/SelectionAnalyzerTests/validSelection/A_test142_.java;1;0;1;1;0;0;0;1;0;0;1;2139;0;0;1;0;0;1;1;2139;0;2139;1;1;
/org.eclipse.swt/Eclipse SWT PI/win32/org/eclipse/swt/internal/win32/DLLVERSIONINFO.java;2;0;2;1;1;1;1;1;6;0;1;2069;6;6;1;0;0;1;2;2069;0;4701;2;2;
/org.eclipse.update.ui/src/org/eclipse/update/internal/ui/manager/UpdatePerspective.java;2;0;7;1;0;0;0;7;42;1;7;1460;72;72;1;0;0;7;7;1460;0;3662;7;2;
/org.eclipse.jdt.core/model/org/eclipse/jdt/internal/core/CompilationUnitProblemFinder.java;3;2;11;1;6;5;6;5;30;1;5;3378;80;80;2;0;1;5;11;3998;1;4421;10;3;
/org.eclipse.jdt.ui.tests.refactoring/resources/ExtractMethodWorkSpace/ExtractMethodTests/expression_in/B.java;1;1;3;1;2;2;2;1;0;0;1;3741;0;0;1;0;0;1;3;3741;0;4419;3;1;
/org.eclipse.jdt.ui/ui/org/eclipse/jdt/ui/actions/OpenJavaPerspectiveAction.java;2;1;4;1;4;4;4;0;14;0;0;4183;27;27;1;0;0;0;4;4183;0;4770;4;2;
/org.eclipse.debug.core/core/org/eclipse/debug/internal/core/BreakpointManager.java;4;2;46;3;4;3;4;42;242;3;31;187;1133;1133;3;11;1;42;46;1708;12;4825;34;4;
/org.eclipse.jdt.ui/ui/org/eclipse/jdt/internal/ui/javadocexport/JavadocWriter.java;2;0;9;1;1;1;1;8;148;1;8;3070;282;282;1;0;0;8;9;3070;0;4404;9;2;
/org.eclipse.ui/Eclipse UI/org/eclipse/ui/internal/registry/ProjectImageRegistry.java;1;0;1;1;0;0;0;1;0;0;1;620;0;0;1;0;0;1;1;620;0;620;1;1;
/org.eclipse.compare/compare/org/eclipse/compare/internal/ImageMergeViewerCreator.java;1;0;2;1;0;0;0;2;5;1;2;14;5;5;1;0;0;2;2;14;0;329;2;1;
/org.eclipse.jdt.ui.tests/JUnit/junit/util/StringUtil.java;2;0;2;1;0;0;0;2;0;1;2;49;0;0;1;0;0;2;2;49;0;1186;2;2;
/org.eclipse.scripting/src/org/eclipse/scripting/internal/views/ScriptUIEditorWordDetector.java;1;0;1;1;0;0;0;1;0;0;1;1424;0;0;1;0;0;1;1;1424;0;1424;1;1;
/org.eclipse.jdt.ui.tests.refactoring/resources/SefWorkSpace/SefTests/object_out/TestSimpleReadWrite.java;1;0;1;1;0;0;0;1;0;0;1;2155;0;0;1;0;0;1;1;2155;0;2155;1;1;
/org.eclipse.vcm.ui/src/org/eclipse/vcm/internal/ui/FileEditionEditorInput.java;3;0;5;2;0;0;0;5;12;2;4;1;28;28;2;1;0;5;5;1;1;1156;4;3;
/org.eclipse.jdt.debug.ui/ui/org/eclipse/jdt/internal/debug/ui/display/DetailsCompletionProcessor.java;1;0;8;1;1;1;1;7;15;1;7;3327;39;39;1;0;0;7;8;3327;0;4409;8;1;
/org.eclipse.jdt.ui.tests.refactoring/resources/SelectionAnalyzerWorkSpace/SelectionAnalyzerTests/invalidSelection/A_test170.java;1;0;1;1;0;0;0;1;0;0;1;1368;0;0;1;0;0;1;1;1368;0;1368;1;1;
/org.eclipse.ui/Eclipse UI Standard Components/org/eclipse/ui/views/bookmarkexplorer/BookmarkLabelProvider.java;2;0;2;1;0;0;0;2;17;1;2;257;17;17;1;0;0;2;2;257;0;457;2;2;
/org.eclipse.jdt.debug/eval/org/eclipse/jdt/internal/debug/eval/ast/instructions/Cast.java;3;0;10;2;0;0;0;10;40;2;9;3421;87;87;2;1;0;10;10;3831;1;3831;9;3;
/org.eclipse.jdt.debug/eval/org/eclipse/jdt/internal/debug/eval/ast/engine/XorOperator.java;1;0;2;1;0;0;0;2;0;1;2;3329;0;0;1;0;0;2;2;3329;0;3421;2;1;
/org.eclipse.webdav/src/client/org/eclipse/webdav/client/PropertyStatus.java;2;0;4;1;1;1;1;3;146;1;3;12;180;180;1;0;0;3;4;12;0;4211;4;2;
/org.eclipse.pde.ui/src/org/eclipse/pde/internal/ui/preferences/StringFieldEditorWithSpace.java;1;0;2;1;0;0;0;2;0;1;2;3579;0;0;1;0;0;2;2;3579;0;3634;2;1;
/org.eclipse.core.tests.resources/src/org/eclipse/core/tests/resources/MarkerTest.java;3;0;10;1;1;1;1;9;3738;2;8;1794;3853;3853;2;1;0;9;10;3415;1;4516;9;3;
/org.eclipse.ui/Eclipse JFace/org/eclipse/jface/action/IStatusLineManager.java;3;0;3;1;0;0;0;3;5;1;3;257;7;7;1;0;0;3;3;257;0;2502;3;3;
/org.eclipse.jdt.core/compiler/org/eclipse/jdt/internal/compiler/parser/RecoveredStatement.java;2;0;10;1;1;1;1;9;74;4;6;455;111;111;4;3;0;9;10;1039;3;4062;7;2;
/org.eclipse.debug.ui/ui/org/eclipse/debug/internal/ui/TerminateAllAction.java;3;0;10;2;0;0;0;10;16;2;9;187;57;57;2;1;0;10;10;346;1;2382;9;3;
/org.eclipse.jdt.debug/eval/org/eclipse/jdt/internal/debug/eval/ast/instructions/PushBoolean.java;2;0;3;1;0;0;0;3;2;1;3;3421;4;4;1;0;0;3;3;3421;0;3677;3;2;
/org.eclipse.jdt.debug/jdi interfaces/com/sun/jdi/IntegerType.java;2;0;2;1;0;0;0;2;6;1;2;2704;6;6;1;0;0;2;2;2704;0;3033;2;2;
/org.eclipse.pde.ui/src/org/eclipse/pde/internal/core/ischema/ISchemaCompositor.java;1;0;2;1;0;0;0;2;0;1;2;3591;0;0;1;0;0;2;2;3591;0;3607;2;1;
/org.eclipse.core.tests.runtime/src/org/eclipse/core/tests/internal/plugins/PluginResolveTest_1.java;3;0;3;1;0;0;0;3;128;1;3;1794;138;138;1;0;0;3;3;1794;0;3476;3;3;
/org.eclipse.jdt.ui/ui/org/eclipse/jdt/internal/ui/preferences/SourceAttachmentPropertyPage.java;5;1;24;1;2;2;2;22;107;2;20;15;559;559;2;2;0;22;24;1225;2;4450;22;5;
/org.eclipse.ui/Eclipse UI/org/eclipse/ui/internal/registry/IViewRegistry.java;2;0;2;1;0;0;0;2;5;1;2;257;5;5;1;0;0;2;2;257;0;457;2;2;
/org.eclipse.jdt.ui.tests.refactoring/resources/ExtractTemp/canExtract/A_test18_out.java;1;0;1;1;0;0;0;1;0;0;1;2481;0;0;1;0;0;1;1;2481;0;2481;1;1;
/org.eclipse.jdt.debug.ui/ui/org/eclipse/jdt/internal/debug/ui/launcher/VMPropertyPage.java;2;0;6;2;2;1;2;4;4;1;4;1915;15;15;2;0;1;4;6;4126;1;4126;5;2;
/org.eclipse.core.runtime/src/org/eclipse/core/runtime/PathOld.java;1;0;1;1;0;0;0;1;0;0;1;950;0;0;1;0;0;1;1;950;0;950;1;1;
/org.eclipse.core.runtime/src/org/eclipse/core/internal/runtime/EclipseURLPluginConnection.java;1;0;2;1;0;0;0;2;0;1;2;12;0;0;1;0;0;2;2;12;0;23;2;1;
/org.eclipse.team.tests.core/src/org/eclipse/team/tests/core/AllTargetTests.java;1;1;2;1;2;2;2;0;1;0;0;4326;1;1;1;0;0;0;2;4326;0;4373;2;1;
/org.eclipse.update.tests.core/src/org/eclipse/update/tests/reconciliation/AllReconciliationTests.java;1;0;1;1;0;0;0;1;0;0;1;2937;0;0;1;0;0;1;1;2937;0;2937;1;1;
/org.eclipse.ui/Eclipse UI/org/eclipse/ui/internal/IPerspectiveListener.java;3;0;3;1;0;0;0;3;5;1;3;257;5;5;1;0;0;3;3;257;0;2419;3;3;
/org.eclipse.jdt.ui.tests.refactoring/resources/MoveCU/test2/out/p/B.java;2;0;2;1;0;0;0;2;0;1;2;49;0;0;1;0;0;2;2;49;0;2769;2;2;
/org.eclipse.pde.ui/src/org/eclipse/pde/internal/base/schema/ISchemaType.java;2;0;2;1;0;0;0;2;0;1;2;1434;0;0;1;0;0;2;2;1434;0;3579;2;2;
/org.eclipse.jdt.ui/ui/org/eclipse/jdt/internal/ui/browsing/JavaBrowsingPart.java;6;5;80;3;32;19;32;48;185;4;30;2878;2006;2006;5;18;13;48;80;4014;31;4626;49;6;
/org.eclipse.pde.junit/Pde JUnit/org/eclipse/pde/internal/junit/ui/JUnitPdePlugin.java;2;0;3;1;0;0;0;3;14;1;3;2399;14;14;1;0;0;3;3;2399;0;3205;3;2;
/org.eclipse.update.core/src/org/eclipse/update/internal/core/FileSite.java;1;0;12;1;0;0;0;12;129;2;9;1451;386;386;2;3;0;12;12;1451;3;1791;9;1;
/org.eclipse.swt/Eclipse SWT Custom Widgets/common/org/eclipse/swt/custom/SashForm.java;3;2;11;1;5;4;5;6;113;2;5;106;171;171;2;1;1;6;11;2876;2;4701;9;3;
/org.eclipse.jdt.ui.tests.refactoring/resources/SelectionAnalyzerWorkSpace/SelectionAnalyzerTests/validSelection/A_test286.java;1;0;1;1;0;0;0;1;0;0;1;1368;0;0;1;0;0;1;1;1368;0;1368;1;1;
/org.eclipse.ant.core/src/org/eclipse/ant/internal/core/old/IncrementalBuild.java;1;0;1;1;0;0;0;1;0;0;1;3270;0;0;1;0;0;1;1;3270;0;3270;1;1;
/org.eclipse.core.tests.runtime/src/org/eclipse/core/tests/internal/plugins/ConflictResolveTest_2.java;3;0;3;1;0;0;0;3;126;1;3;1794;136;136;1;0;0;3;3;1794;0;3476;3;3;
/org.eclipse.core.tests.runtime/src/org/eclipse/core/tests/internal/plugin/b/api/ApiClass.java;3;0;3;1;0;0;0;3;10;1;3;1794;20;20;1;0;0;3;3;1794;0;3476;3;3;
/org.eclipse.vcm.core.cvs/src/org/eclipse/vcm/internal/core/ccvs/client/ResponseHandler.java;2;0;2;1;0;0;0;2;6;1;2;0;6;6;1;0;0;2;2;0;0;298;2;2;
/org.eclipse.swt/Eclipse SWT/win32/org/eclipse/swt/internal/win32/BITMAP.java;2;0;3;1;0;0;0;3;5;1;3;106;5;5;1;0;0;3;3;106;0;2069;3;2;
/org.eclipse.jdt.ui.tests.refactoring/resources/RenameParameters/canRename/A_test21_out.java;2;0;2;1;0;0;0;2;3;1;2;233;3;3;1;0;0;2;2;233;0;952;2;2;
/org.eclipse.jdt.core/compiler/org/eclipse/jdt/internal/compiler/ast/AbstractVariableDeclaration.java;2;1;13;1;2;2;2;11;36;4;8;455;145;145;4;3;0;11;13;1039;3;4418;10;2;
/org.eclipse.debug.ui/ui/org/eclipse/debug/internal/ui/actions/RelaunchActionDelegate.java;4;1;21;2;3;3;3;18;89;2;16;2382;334;334;2;2;0;18;21;2877;2;4423;19;4;
/org.eclipse.jdt.ui/ui/org/eclipse/jdt/internal/ui/util/OpenHierarchyPerspectiveHelper.java;1;0;2;1;0;0;0;2;0;1;2;412;0;0;1;0;0;2;2;412;0;421;2;1;
/org.eclipse.ui/Eclipse UI/org/eclipse/ui/internal/SystemSummaryActionDelegate.java;2;1;2;1;2;2;2;0;0;0;0;4387;0;0;1;0;0;0;2;4387;0;4456;2;2;
/org.eclipse.jdt.debug.tests/tests/org/eclipse/jdt/debug/tests/eval/TypeHierarchy_21_4.java;2;1;3;1;3;3;3;0;13;0;0;4447;15;15;1;0;0;0;3;4447;0;4571;3;2;
/org.eclipse.jdt.core/model/org/eclipse/jdt/internal/core/BinaryMethod.java;4;0;18;1;1;1;1;17;270;4;13;455;585;585;4;4;0;17;18;1039;4;4063;14;4;
/org.eclipse.ui/Eclipse UI/org/eclipse/ui/internal/IObjectContributor.java;3;0;3;1;0;0;0;3;5;1;3;257;10;10;1;0;0;3;3;257;0;2050;3;3;
/org.eclipse.pde.ui/src/org/eclipse/pde/ui/BuildPathUtil.java;1;1;5;1;3;3;3;2;44;1;2;3579;112;112;1;0;0;2;5;3579;0;4752;5;1;
/org.eclipse.swt/Eclipse SWT PI/photon/org/eclipse/swt/internal/photon/PgAlpha_t.java;2;0;2;1;1;1;1;1;6;0;1;2069;6;6;1;0;0;1;2;2069;0;4701;2;2;
/org.eclipse.ui/Eclipse UI/org/eclipse/ui/internal/SplashManager.java;3;0;3;1;1;1;1;2;4;1;2;257;6;6;1;0;0;2;3;257;0;4210;3;3;
/org.eclipse.jdt.core/model/org/eclipse/jdt/core/util/IOpcodeMnemonics.java;2;1;4;1;3;3;3;1;18;0;1;3629;34;34;1;0;0;1;4;3629;0;4573;4;2;
/org.eclipse.scripting/src/org/eclipse/scripting/internal/views/ScriptDevelopmentPreferencePage.java;1;0;1;1;0;0;0;1;0;0;1;1424;0;0;1;0;0;1;1;1424;0;1424;1;1;
/org.eclipse.ui.tests/Eclipse UI Tests/org/eclipse/ui/tests/api/Tool.java;2;0;6;1;0;0;0;6;48;2;5;983;55;55;2;1;0;6;6;1007;1;1073;5;2;
/org.eclipse.pde.ui/src/org/eclipse/pde/internal/PDEProblemFinder.java;2;0;2;1;0;0;0;2;0;1;2;1434;0;0;1;0;0;2;2;1434;0;2691;2;2;
/org.eclipse.swt/Eclipse SWT PI/photon/org/eclipse/swt/internal/photon/PtCallbackInfo_t.java;2;0;2;1;1;1;1;1;6;0;1;2069;6;6;1;0;0;1;2;2069;0;4701;2;2;
/org.eclipse.jdt.core/model/org/eclipse/jdt/internal/core/util/ConstantValueAttribute.java;2;1;4;1;3;3;3;1;18;0;1;3629;34;34;1;0;0;1;4;3629;0;4422;4;2;
/org.eclipse.jdt.debug/model/org/eclipse/jdt/internal/debug/core/breakpoints/JavaLineBreakpoint.java;3;2;33;2;6;5;6;27;297;3;21;2517;1015;1015;3;6;1;27;33;3790;7;4565;26;3;
/org.eclipse.ui/Eclipse UI/org/eclipse/ui/IWorkbenchWindowPulldownDelegate2.java;1;0;1;1;0;0;0;1;0;0;1;3840;0;0;1;0;0;1;1;3840;0;3840;1;1;
/org.eclipse.update.ui/src/org/eclipse/update/internal/ui/wizards/InstallDeltaWizardPage.java;2;2;10;1;10;8;10;0;104;0;0;4082;248;248;2;0;2;0;10;4194;2;4610;8;2;
/org.eclipse.swt/Eclipse SWT Drag and Drop/gtk1x/org/eclipse/swt/dnd/DragSource.java;2;0;2;1;0;0;0;2;0;1;2;2107;0;0;1;0;0;2;2;2107;0;3127;2;2;
/org.eclipse.jdt.ui/ui/org/eclipse/jdt/internal/ui/launcher/MultiMainTypeSelectionDialog.java;3;0;5;1;0;0;0;5;15;1;5;1290;21;21;1;0;0;5;5;1290;0;1916;5;3;
/org.eclipse.core.runtime/src/org/eclipse/core/internal/plugins/IModel.java;4;0;10;2;2;1;2;8;252;1;8;12;517;517;2;0;1;8;10;4213;1;4213;9;4;
/org.eclipse.vcm.core/src/org/eclipse/vcm/internal/core/base/IVCMProvider.java;3;0;3;1;0;0;0;3;7;1;3;0;12;12;1;0;0;3;3;0;0;1240;3;3;
/org.eclipse.jdt.debug/eval/org/eclipse/jdt/internal/debug/eval/ast/engine/ArrayInstruction.java;1;0;3;1;0;0;0;3;2;1;3;3329;2;2;1;0;0;3;3;3329;0;3421;3;1;
/org.eclipse.core.tests.resources/src/org/eclipse/core/tests/resources/usecase/Snapshot3Test.java;3;0;7;1;0;0;0;7;133;2;6;1794;173;173;2;1;0;7;7;3415;1;3475;6;3;
/org.eclipse.core.tests.resources.saveparticipant/src/org/eclipse/core/tests/resources/saveparticipant/SaveManager1Test.java;3;0;5;1;1;1;1;4;666;1;4;1794;697;697;1;0;0;4;5;1794;0;4748;5;3;
/org.eclipse.jdt.debug/eval/org/eclipse/jdt/internal/debug/eval/ast/engine/PushInt.java;1;0;3;1;0;0;0;3;56;1;3;3329;56;56;1;0;0;3;3;3329;0;3421;3;1;
/org.eclipse.ui/Eclipse JFace/org/eclipse/jface/resource/DataFormatException.java;2;0;2;1;0;0;0;2;5;1;2;257;5;5;1;0;0;2;2;257;0;457;2;2;
/org.eclipse.jdt.core/model/org/eclipse/jdt/internal/core/hierarchy/RegionBasedHierarchyBuilder.java;3;0;9;1;1;1;1;8;359;1;8;455;903;903;1;0;0;8;9;455;0;4063;9;3;
/org.eclipse.team.core/src/org/eclipse/team/internal/core/target/Site.java;1;0;1;1;1;1;1;0;0;0;0;4636;0;0;1;0;0;0;1;4636;0;4636;1;1;
/org.eclipse.swt/Eclipse SWT/common_j2me/org/eclipse/swt/internal/SWTEventListener.java;2;0;2;1;1;1;1;1;6;0;1;1561;6;6;1;0;0;1;2;1561;0;4701;2;2;
/org.eclipse.jdt.debug/jdi/org/eclipse/jdi/internal/BooleanTypeImpl.java;2;0;4;1;0;0;0;4;13;1;4;187;27;27;1;0;0;4;4;187;0;3670;4;2;
/org.eclipse.jdt.ui/ui/org/eclipse/jdt/ui/actions/ShowInNavigatorViewAction.java;2;1;11;1;6;6;6;5;72;2;4;3533;185;185;2;1;0;5;11;3641;1;4770;10;2;
/org.eclipse.jdt.ui/ui/org/eclipse/jdt/internal/ui/preferences/NewJavaProjectPreferencePage.java;3;2;3;2;3;2;3;0;4;0;0;4450;6;6;2;0;1;0;3;4450;1;4630;2;3;
/org.eclipse.team.cvs.ui/src/org/eclipse/team/internal/ccvs/ui/CVSAddResolutionGenerator.java;3;0;5;1;0;0;0;5;142;2;4;3175;156;156;2;1;0;5;5;3402;1;3610;4;3;
/org.eclipse.jdt.ui/core refactoring/org/eclipse/jdt/internal/corext/refactoring/rename/RefactoringScanner.java;2;0;6;1;0;0;0;6;49;1;6;1939;80;80;1;0;0;6;6;1939;0;3700;6;2;
/org.eclipse.pde.ui/src/org/eclipse/pde/internal/model/feature/Feature.java;1;0;11;1;0;0;0;11;344;3;8;2951;495;495;3;3;0;11;11;2951;3;3579;8;1;
/org.eclipse.team.ui/src/org/eclipse/team/ui/sync/ChangedTeamContainer.java;3;0;7;1;1;1;1;6;8;1;6;2233;25;25;1;0;0;6;7;2233;0;4005;7;3;
/org.eclipse.jdt.ui.tests.refactoring/resources/SelectionAnalyzerWorkSpace/SelectionAnalyzerTests/validSelection/A_test230.java;1;0;1;1;0;0;0;1;0;0;1;1368;0;0;1;0;0;1;1;1368;0;1368;1;1;
/org.eclipse.jdt.ui/core refactoring/org/eclipse/jdt/internal/core/refactoring/projects/RenameResourceChange.java;1;0;1;1;0;0;0;1;0;0;1;990;0;0;1;0;0;1;1;990;0;990;1;1;
/org.eclipse.jdt.debug/model/org/eclipse/jdt/internal/debug/core/model/JDINullValue.java;3;0;3;2;0;0;0;3;15;2;2;2517;21;21;2;1;0;3;3;2517;1;2720;2;3;
/org.eclipse.pde.ui/Eclipse PDE UI/org/eclipse/pde/internal/wizards/WizardNode.java;2;0;5;2;0;0;0;5;12;3;3;267;12;12;3;2;0;5;5;324;2;1434;3;2;
/org.eclipse.swt/Eclipse SWT/motif/org/eclipse/swt/widgets/WidgetTable.java;3;1;4;1;2;2;2;2;8;1;2;106;16;16;1;0;0;2;4;106;0;4701;4;3;
/org.eclipse.jdt.debug/eval/org/eclipse/jdt/internal/debug/eval/ast/EvaluationType.java;1;0;3;1;0;0;0;3;212;1;3;3329;212;212;1;0;0;3;3;3329;0;3421;3;1;
/org.eclipse.vcm.core/src/org/eclipse/vcm/internal/core/base/ISyncInfo.java;2;0;2;1;0;0;0;2;5;1;2;0;5;5;1;0;0;2;2;0;0;297;2;2;
/org.eclipse.swt/Eclipse SWT Drag and Drop/common/org/eclipse/swt/dnd/DragSourceListener.java;4;1;7;1;2;2;2;5;35;1;5;106;64;64;1;0;0;5;7;106;0;4824;7;4;
/org.eclipse.team.cvs.ui/src/org/eclipse/team/internal/ccvs/ui/wizards/GenerateDiffFileOperation.java;3;0;11;1;0;0;0;11;78;1;11;1992;141;141;1;0;0;11;11;1992;0;3857;11;3;
/org.eclipse.pde.ui/src/org/eclipse/pde/internal/OverlayIcon.java;2;0;2;1;0;0;0;2;0;1;2;1434;0;0;1;0;0;2;2;1434;0;2691;2;2;
/org.eclipse.jdt.ui.tests.refactoring/resources/PullUp/testFailTemplate/in/A.java;1;0;1;1;0;0;0;1;0;0;1;2406;0;0;1;0;0;1;1;2406;0;2406;1;1;
/org.eclipse.jdt.ui.tests.refactoring/resources/RenameVariables/canRename/A_test8_out.java;1;0;2;1;0;0;0;2;0;1;2;724;0;0;1;0;0;2;2;724;0;1665;2;1;
/org.eclipse.jdt.ui.tests.refactoring/resources/SafeDeleteType/testFail12/in/A.java;1;0;1;1;0;0;0;1;0;0;1;49;0;0;1;0;0;1;1;49;0;49;1;1;
/org.eclipse.pde.ui/src/org/eclipse/pde/internal/wizards/WizardCollectionSorter.java;2;0;2;1;0;0;0;2;0;1;2;1434;0;0;1;0;0;2;2;1434;0;3579;2;2;
/org.eclipse.jdt.ui/ui/org/eclipse/jdt/internal/ui/viewsupport/JavaSourceElementSorter.java;1;0;2;1;0;0;0;2;0;1;2;1383;0;0;1;0;0;2;2;1383;0;1559;2;1;
/org.eclipse.jdt.ui.tests.refactoring/resources/ExtractMethodWorkSpace/ExtractMethodTests/expression_in/A_test617.java;1;1;3;1;2;2;2;1;16;0;1;1368;16;16;1;0;0;1;3;1368;0;4419;3;1;
/org.eclipse.pde.ui/src/org/eclipse/pde/internal/ui/editor/schema/ICloneablePropertySource.java;1;0;1;1;0;0;0;1;0;0;1;3579;0;0;1;0;0;1;1;3579;0;3579;1;1;
/org.eclipse.pde.ui/src/org/eclipse/pde/internal/core/build/BuildModel.java;1;0;3;1;0;0;0;3;14;2;2;3579;14;14;2;1;0;3;3;3579;1;3607;2;1;
/org.eclipse.jdt.ui.tests.refactoring/resources/InlineTemp/canInline/A_test3_in.java;1;0;1;1;0;0;0;1;0;0;1;2015;0;0;1;0;0;1;1;2015;0;2015;1;1;
/org.eclipse.jdt.ui.tests.refactoring/resources/RenamePrivateMethod/testAnon0/out/A.java;1;0;1;1;0;0;0;1;0;0;1;49;0;0;1;0;0;1;1;49;0;49;1;1;
/org.eclipse.jdt.launching/launching/org/eclipse/jdt/internal/launching/CompositeId.java;1;0;1;1;0;0;0;1;0;0;1;2022;0;0;1;0;0;1;1;2022;0;2022;1;1;
/org.eclipse.jdt.core/model/org/eclipse/jdt/internal/core/builder/impl/AbstractMemberHandle.java;1;0;10;1;0;0;0;10;65;4;7;455;103;103;4;3;0;10;10;1039;3;2808;7;1;
/org.eclipse.jdt.ui/ui debug/org/eclipse/jdt/internal/debug/ui/BreakpointHitCountAction.java;2;0;10;1;0;0;0;10;41;1;10;15;141;141;1;0;0;10;10;15;0;1916;10;2;
/org.eclipse.vcm.ui/src/org/eclipse/vcm/internal/ui/ProjectVersionSelectionDialog.java;4;0;7;2;0;0;0;7;48;2;5;1;84;84;2;2;0;7;7;1;2;1171;5;4;
/org.eclipse.help/src/org/eclipse/help/internal/contributions/xml1_0/HelpTopic.java;1;0;3;1;0;0;0;3;1;1;3;1675;1;1;1;0;0;3;3;1675;0;2217;3;1;
/org.eclipse.swt/Eclipse SWT PI/gtk/org/eclipse/swt/internal/gtk/GtkFileSelection.java;1;0;2;1;0;0;0;2;0;1;2;2107;0;0;1;0;0;2;2;2107;0;3209;2;1;
/org.eclipse.swt/Eclipse SWT PI/motif/org/eclipse/swt/internal/motif/XmTextBlockRec.java;2;0;2;1;1;1;1;1;6;0;1;2069;6;6;1;0;0;1;2;2069;0;4701;2;2;
/org.eclipse.ui/Eclipse UI/org/eclipse/ui/internal/dialogs/ZipFileResourceExportOperation.java;2;0;2;1;0;0;0;2;26;1;2;257;26;26;1;0;0;2;2;257;0;457;2;2;
/org.eclipse.scripting/Eclipse Scripting/org/eclipse/scripting/internal/views/ScriptUIEditorDesigner.java;2;0;4;1;0;0;0;4;10;1;4;133;19;19;1;0;0;4;4;133;0;1424;4;2;
/org.eclipse.jdt.ui/core refactoring/org/eclipse/jdt/internal/corext/refactoring/changes/MoveCompilationUnitChange.java;2;0;2;1;1;1;1;1;16;0;1;1939;16;16;1;0;0;1;2;1939;0;4212;2;2;
/org.eclipse.help.ui/src/org/eclipse/help/internal/ui/HelpContentsAction.java;2;0;9;1;1;1;1;8;25;1;8;1675;89;89;1;0;0;8;9;1675;0;4439;9;2;
/org.eclipse.team.tests.cvs.core/src/org/eclipse/team/tests/ccvs/ui/benchmark/WorkflowTests.java;1;0;5;1;0;0;0;5;176;1;5;2977;191;191;1;0;0;5;5;2977;0;3610;5;1;
/org.eclipse.swt/Eclipse SWT Drag and Drop/photon/org/eclipse/swt/dnd/DragSource.java;3;1;7;1;4;4;4;3;112;1;3;106;296;296;1;0;0;3;7;106;0;4824;7;3;
/org.eclipse.core.tests.harness/src/org/eclipse/core/tests/harness/SessionTestApplication.java;2;0;3;1;1;1;1;2;94;1;2;2289;108;108;1;0;0;2;3;2289;0;4516;3;2;
/org.eclipse.vcm.core.cvs/src/org/eclipse/vcm/internal/core/ccvs/requests/StatusErrorHandler.java;2;0;2;1;0;0;0;2;6;1;2;0;6;6;1;0;0;2;2;0;0;298;2;2;
/org.eclipse.jdt.core/model/org/eclipse/jdt/internal/core/Assert.java;2;0;9;1;1;1;1;8;161;4;5;455;266;266;4;3;0;8;9;1039;3;4063;6;2;
/org.eclipse.jdt.debug/eval/org/eclipse/jdt/internal/debug/eval/ast/instructions/InstanceOfOperator.java;3;1;11;1;3;3;3;8;12;1;8;3421;51;51;1;0;0;8;11;3421;0;4423;11;3;
/org.eclipse.ui/Eclipse UI/org/eclipse/ui/internal/WWinPluginAction.java;6;1;15;1;3;3;3;12;177;2;9;257;380;380;2;3;0;12;15;2036;3;4630;12;6;
/org.eclipse.jdt.debug.ui/ui/org/eclipse/jdt/internal/debug/ui/actions/RunToLineActionDelegate.java;2;1;8;1;8;8;8;0;14;0;0;3935;48;48;1;0;0;0;8;3935;0;4581;8;2;
/org.eclipse.jdt.ui.tests/ui/org/eclipse/jdt/internal/ui/dialogs/tests/TwoPaneElementSelectorTest.java;2;0;2;1;0;0;0;2;0;1;2;522;0;0;1;0;0;2;2;522;0;1186;2;2;
/org.eclipse.jdt.ui.tests.refactoring/resources/RenameVariables/cannotRename/A_testFail17.java;1;0;2;1;0;0;0;2;0;1;2;724;0;0;1;0;0;2;2;724;0;1665;2;1;
/org.eclipse.ui/Eclipse UI/org/eclipse/ui/IImportWizard.java;2;0;2;1;0;0;0;2;5;1;2;257;5;5;1;0;0;2;2;257;0;457;2;2;
/org.eclipse.jdt.ui.tests.refactoring/resources/SurroundWithWorkSpace/SurroundWithTests/trycatch_in/TestExceptionOrder.java;1;0;1;1;0;0;0;1;0;0;1;2327;0;0;1;0;0;1;1;2327;0;2327;1;1;
/org.eclipse.jdt.ui.tests.refactoring/resources/RenameVirtualMethodInClass/test29/in/A.java;1;0;1;1;0;0;0;1;0;0;1;49;0;0;1;0;0;1;1;49;0;49;1;1;
/org.eclipse.team.cvs.ui/src/org/eclipse/team/internal/ccvs/ui/CVSFilePropertiesPage.java;3;0;15;2;1;1;1;14;40;2;13;2448;142;142;2;1;0;14;15;3610;1;4829;14;3;
/org.eclipse.jdt.ui/core refactoring/org/eclipse/jdt/internal/core/refactoring/tagging/ITextUpdatingRefactoring.java;2;0;3;1;0;0;0;3;2;1;3;1547;2;2;1;0;0;3;3;1547;0;1939;3;2;
/org.eclipse.team.cvs.core/src/org/eclipse/team/internal/ccvs/core/resources/CVSResource.java;3;0;4;1;0;0;0;4;595;1;4;1978;618;618;1;0;0;4;4;1978;0;2156;4;3;
/org.eclipse.swt/Eclipse SWT Custom Widgets/common_j2se/org/eclipse/swt/custom/StyledTextEvent.java;1;0;1;1;0;0;0;1;0;0;1;1378;0;0;1;0;0;1;1;1378;0;1378;1;1;
/org.eclipse.pde.core/src/org/eclipse/pde/internal/core/schema/SchemaSimpleType.java;1;0;2;1;0;0;0;2;2;1;2;3591;2;2;1;0;0;2;2;3591;0;3607;2;1;
/org.eclipse.help/webapps/examples/WEB-INF/classes/compressionFilters/CompressionServletResponseWrapper.java;1;0;2;1;0;0;0;2;0;1;2;1882;0;0;1;0;0;2;2;1882;0;1930;2;1;
/org.eclipse.jdt.ui/ui/org/eclipse/jdt/internal/ui/dialogs/IStatusInfoChangeListener.java;1;0;2;1;0;0;0;2;0;1;2;15;0;0;1;0;0;2;2;15;0;144;2;1;
/org.eclipse.ui/Eclipse UI/org/eclipse/ui/internal/dialogs/WorkbenchWizardNode.java;3;0;4;1;1;1;1;3;39;1;3;257;90;90;1;0;0;3;4;257;0;4364;4;3;
/org.eclipse.jdt.ui/core refactoring/org/eclipse/jdt/internal/corext/refactoring/rename/RenameTempOccurrenceOffsetFinder.java;2;0;2;1;0;0;0;2;0;1;2;1939;0;0;1;0;0;2;2;1939;0;2015;2;2;
/org.eclipse.core.tests.runtime/src/org/eclipse/core/tests/internal/plugins/PluginResolveTest.java;3;0;3;1;0;0;0;3;102;1;3;1794;112;112;1;0;0;3;3;1794;0;3476;3;3;
/org.eclipse.team.tests.cvs.core/src/org/eclipse/team/tests/ccvs/core/cvsresources/AllTests.java;2;0;4;1;0;0;0;4;8;1;4;2536;12;12;1;0;0;4;4;2536;0;3250;4;2;
/org.eclipse.jdt.ui/ui/org/eclipse/jdt/internal/ui/javaeditor/EditorUtility.java;9;2;31;2;11;9;11;20;74;3;17;15;442;442;3;3;2;20;31;387;5;4564;26;9;
/org.eclipse.vcm.core/src/org/eclipse/vcm/internal/core/PlatformVCMProvider.java;5;0;11;2;0;0;0;11;80;3;9;0;221;221;3;2;0;11;11;292;2;1240;9;5;
/org.eclipse.jdt.ui.tests.refactoring/resources/RenameType/test21/out/A.java;1;0;2;1;0;0;0;2;0;1;2;49;0;0;1;0;0;2;2;49;0;522;2;1;
/org.eclipse.jdt.ui.tests.refactoring/resources/RenameParameters/canRename/A_test23_out.java;1;0;1;1;0;0;0;1;0;0;1;233;0;0;1;0;0;1;1;233;0;233;1;1;
/org.eclipse.jdt.ui.tests.refactoring/resources/DeleteSourceReference/test17/in/A.java;1;0;1;1;1;1;1;0;0;0;0;4141;0;0;1;0;0;0;1;4141;0;4141;1;1;
/org.eclipse.core.resources/src/org/eclipse/core/resources/IFileState.java;1;0;4;1;1;1;1;3;214;1;3;12;235;235;1;0;0;3;4;12;0;4214;4;1;
/org.eclipse.ui/Eclipse UI/org/eclipse/ui/internal/dialogs/FileExtensionDialog.java;4;0;8;1;0;0;0;8;250;1;8;257;308;308;1;0;0;8;8;257;0;3607;8;4;
/org.eclipse.jdt.ui.tests.refactoring/resources/RenameNonPrivateField/test5/out/A.java;1;0;1;1;0;0;0;1;0;0;1;49;0;0;1;0;0;1;1;49;0;49;1;1;
/org.eclipse.update.core/src/org/eclipse/update/core/IURLEntry.java;2;0;4;1;0;0;0;4;42;2;3;2419;77;77;2;1;0;4;4;3574;1;3574;3;2;
/org.eclipse.team.cvs.core/src/org/eclipse/team/internal/ccvs/core/client/Import.java;2;0;10;2;0;0;0;10;52;2;9;2572;116;116;2;1;0;10;10;3089;1;3610;9;2;
/org.eclipse.jdt.debug.ui/ui/org/eclipse/jdt/debug/ui/JavaDebugUI.java;3;0;16;1;0;0;0;16;206;2;15;1915;443;443;2;1;0;16;16;2220;1;3683;15;3;
/org.eclipse.jdt.ui.tests.refactoring/resources/RenameType/testFail80/in/A.java;1;0;1;1;0;0;0;1;0;0;1;49;0;0;1;0;0;1;1;49;0;49;1;1;
/org.eclipse.pde.ui/Eclipse PDE UI/org/eclipse/pde/internal/preferences/StringFieldEditorWithSpace.java;2;0;3;1;0;0;0;3;2;1;3;482;2;2;1;0;0;3;3;482;0;1434;3;2;
/org.eclipse.core.tests.runtime/src/org/eclipse/core/tests/internal/runtimetests/SampleLFB.java;1;0;2;1;0;0;0;2;10;1;2;3611;10;10;1;0;0;2;2;3611;0;3678;2;1;
/org.eclipse.jdt.ui.tests.refactoring/resources/RenameVariables/canRename/A_test24_out.java;1;0;2;1;0;0;0;2;0;1;2;724;0;0;1;0;0;2;2;724;0;1665;2;1;
/org.eclipse.jdt.debug/model/org/eclipse/jdt/internal/debug/core/model/JDIDebugElement.java;3;1;19;2;5;5;5;14;44;3;10;2517;165;165;3;4;0;14;19;2517;4;4423;15;3;
/org.eclipse.update.ui/src/org/eclipse/update/internal/ui/model/AvailableUpdates.java;2;0;9;1;0;0;0;9;9;1;9;2797;24;24;1;0;0;9;9;2797;0;3561;9;2;
/org.eclipse.swt/Eclipse SWT Accessibility/common/org/eclipse/swt/accessibility/AccessibleAdapter.java;2;0;6;1;1;1;1;5;76;2;4;2791;164;164;2;1;0;5;6;3007;1;4701;5;2;
/org.eclipse.swt.examples/src/org/eclipse/swt/examples/fileviewer/IconCache.java;4;0;5;1;1;1;1;4;149;1;4;554;189;189;1;0;0;4;5;554;0;4705;5;4;
/org.eclipse.pde.ui/src/org/eclipse/pde/internal/core/plugin/ImportObject.java;1;0;2;1;0;0;0;2;0;1;2;3579;0;0;1;0;0;2;2;3579;0;3607;2;1;
/org.eclipse.jdt.ui.tests.refactoring/resources/PullUp/test13/out/A.java;1;0;1;1;0;0;0;1;0;0;1;2406;0;0;1;0;0;1;1;2406;0;2406;1;1;
/org.eclipse.scripting/src/org/eclipse/scripting/internal/IXGRElementUI.java;1;0;1;1;0;0;0;1;0;0;1;1424;0;0;1;0;0;1;1;1424;0;1424;1;1;
/org.eclipse.jdt.ui/ui/org/eclipse/jdt/internal/ui/reorg/SimpleSelectionProvider.java;1;0;2;1;0;0;0;2;6;1;2;3680;6;6;1;0;0;2;2;3680;0;3739;2;1;
/org.eclipse.jdt.ui.tests.refactoring/resources/MoveCU/test2/in/p/A.java;2;0;2;1;0;0;0;2;0;1;2;49;0;0;1;0;0;2;2;49;0;2769;2;2;
/org.eclipse.jdt.ui/ui refactoring/org/eclipse/jdt/internal/ui/refactoring/actions/RefactoringErrorDialog.java;2;0;3;1;0;0;0;3;4;1;3;2510;4;4;1;0;0;3;3;2510;0;3502;3;2;
/org.eclipse.ui.tests/Eclipse JFace Tests/org/eclipse/jface/tests/viewers/AbstractTreeViewerTest.java;1;0;1;1;0;0;0;1;0;0;1;1488;0;0;1;0;0;1;1;1488;0;1488;1;1;
/org.eclipse.jdt.core/compiler/org/eclipse/jdt/internal/compiler/SourceElementRequestorAdapter.java;2;0;5;1;1;1;1;4;14;2;3;1410;20;20;2;1;0;4;5;3084;1;4062;4;2;
/org.eclipse.update.ui.forms/src/org/eclipse/update/ui/forms/internal/engine/ITextModel.java;1;0;2;1;0;0;0;2;2;0;1;2745;2;2;2;1;0;2;2;2745;1;2745;1;1;
/org.eclipse.jdt.core/model/org/eclipse/jdt/internal/core/builder/impl/PrimitiveTypeHandleImpl.java;1;0;10;1;0;0;0;10;431;4;6;455;773;773;4;4;0;10;10;1039;4;2808;6;1;
/org.eclipse.jdt.ui/core extension/org/eclipse/jdt/internal/corext/codegeneration/IRequestQuery.java;2;0;2;1;0;0;0;2;0;1;2;2016;0;0;1;0;0;2;2;2016;0;2137;2;2;
/org.eclipse.ui/Eclipse JFace/org/eclipse/jface/resource/URLImageDescriptor.java;3;0;3;1;0;0;0;3;5;1;3;257;7;7;1;0;0;3;3;257;0;710;3;3;
/org.eclipse.jdt.debug.ui/ui/org/eclipse/jdt/internal/debug/ui/actions/DisplayAction.java;3;0;14;3;1;1;1;13;75;4;10;2813;238;238;4;3;0;13;14;3740;3;3901;11;3;
/org.eclipse.pde.ui/src/org/eclipse/pde/internal/model/plugin/ExternalFragmentModel.java;1;0;2;1;0;0;0;2;0;1;2;3136;0;0;1;0;0;2;2;3136;0;3579;2;1;
/org.eclipse.jdt.debug/jdi interfaces/com/sun/jdi/Type.java;2;0;2;1;0;0;0;2;6;1;2;2704;6;6;1;0;0;2;2;2704;0;3033;2;2;
/org.eclipse.debug.ui/ui/org/eclipse/debug/internal/ui/preferences/DebugActionGroupsContentProvider.java;1;0;1;1;1;1;1;0;0;0;0;3975;0;0;1;0;0;0;1;3975;0;3975;1;1;
/org.eclipse.debug.ui/ui/org/eclipse/debug/internal/ui/views/ConsoleViewEventHandler.java;3;0;8;2;1;1;1;7;31;2;6;2349;66;66;2;1;0;7;8;2794;1;3975;7;3;
/org.eclipse.jdt.ui/ui/org/eclipse/jdt/internal/ui/launcher/VMContentProvider.java;2;0;6;1;0;0;0;6;36;2;4;218;54;54;2;2;0;6;6;218;2;1916;4;2;
/org.eclipse.jdt.ui.tests.refactoring/test cases/org/eclipse/jdt/ui/tests/refactoring/infra/MockWorkbenchSite.java;1;0;1;1;0;0;0;1;0;0;1;3826;0;0;1;0;0;1;1;3826;0;3826;1;1;
/org.eclipse.jdt.debug.ui/ui/org/eclipse/jdt/internal/debug/ui/launcher/AddExceptionAction.java;2;0;2;1;0;0;0;2;0;1;2;1915;0;0;1;0;0;2;2;1915;0;2384;2;2;
/org.eclipse.help/src/org/eclipse/help/internal/contributors/xml/XMLContributor.java;2;0;2;1;0;0;0;2;0;1;2;1420;0;0;1;0;0;2;2;1420;0;1675;2;2;
/org.eclipse.jdt.ui/core refactoring/org/eclipse/jdt/internal/core/refactoring/methods/RenameVirtualMethodRefactoring.java;2;0;12;1;0;0;0;12;190;2;11;408;288;288;2;1;0;12;12;951;1;1342;11;2;
/org.eclipse.pde.ui/src/org/eclipse/pde/internal/ui/elements/ListContentProvider.java;1;0;1;1;0;0;0;1;0;0;1;3579;0;0;1;0;0;1;1;3579;0;3579;1;1;
/org.eclipse.jdt.ui/core codemanipulation/org/eclipse/jdt/internal/core/codemanipulation/TextPosition.java;1;0;2;1;0;0;0;2;0;1;2;1800;0;0;1;0;0;2;2;1800;0;1937;2;1;
/org.eclipse.team.cvs.ui/src/org/eclipse/team/internal/ccvs/ui/AlternateUserValidationDialog.java;1;0;1;1;1;1;1;0;0;0;0;4122;0;0;1;0;0;0;1;4122;0;4122;1;1;
/org.eclipse.scripting/src/org/eclipse/scripting/internal/views/ScriptUIEditorXmlParserException.java;1;0;1;1;0;0;0;1;0;0;1;1424;0;0;1;0;0;1;1;1424;0;1424;1;1;
/org.eclipse.swt.tests/JUnit Tests/org/eclipse/swt/tests/junit/Test_org_eclipse_swt_widgets_CoolItem.java;2;0;2;1;1;1;1;1;6;0;1;1792;6;6;1;0;0;1;2;1792;0;4706;2;2;
/org.eclipse.pde.ui/Eclipse PDE UI/org/eclipse/pde/internal/editor/text/IPDEColorConstants.java;2;0;5;2;0;0;0;5;12;3;3;267;12;12;3;2;0;5;5;324;2;1434;3;2;
/org.eclipse.jdt.ui/core refactoring/org/eclipse/jdt/internal/corext/refactoring/text/SimpleTextChange.java;1;0;2;1;0;0;0;2;0;1;2;1939;0;0;1;0;0;2;2;1939;0;2216;2;1;
/org.eclipse.jdt.ui/ui/org/eclipse/jdt/internal/ui/jarpackager/JarPackage.java;4;0;25;1;0;0;0;25;117;3;21;239;504;504;3;4;0;25;25;433;4;3529;21;4;
/org.eclipse.ui/Eclipse UI/org/eclipse/ui/internal/dialogs/MultiStepReviewWizardPage.java;2;0;5;1;0;0;0;5;40;1;5;3211;58;58;1;0;0;5;5;3211;0;3607;5;2;
/org.eclipse.jdt.ui/ui/org/eclipse/jdt/internal/ui/text/java/IProblemRequestorExtension.java;1;0;3;1;1;1;1;2;25;1;2;3418;25;25;1;0;0;2;3;3418;0;4036;3;1;
/org.eclipse.ui.tests/Eclipse UI Tests/org/eclipse/ui/tests/api/MockWorkbenchPart.java;3;0;12;2;0;0;0;12;85;2;9;993;185;185;2;3;0;12;12;1002;3;2785;9;3;
/org.eclipse.ui/Eclipse UI/org/eclipse/ui/internal/dialogs/SimpleListContentProvider.java;2;0;2;1;0;0;0;2;4;1;2;257;4;4;1;0;0;2;2;257;0;457;2;2;
/org.eclipse.jdt.ui.tests.refactoring/resources/ExtractTemp/canExtract/A_test31_out.java;1;0;1;1;0;0;0;1;0;0;1;3210;0;0;1;0;0;1;1;3210;0;3210;1;1;
/org.eclipse.jdt.ui/core refactoring/org/eclipse/jdt/internal/corext/refactoring/code/InlineTempRefactoring.java;3;2;24;1;8;6;8;16;180;1;16;2062;514;514;2;0;2;16;24;4357;2;4427;22;3;
/org.eclipse.jdt.ui/ui/org/eclipse/jdt/internal/ui/reorg/NoReorgSupport.java;2;0;5;1;0;0;0;5;5;1;5;15;12;12;1;0;0;5;5;15;0;1258;5;2;
/org.eclipse.jdt.ui.tests.refactoring/resources/RenameType/test47/in/A.java;1;0;1;1;0;0;0;1;0;0;1;49;0;0;1;0;0;1;1;49;0;49;1;1;
/org.eclipse.team.cvs.ui/src/org/eclipse/team/internal/ccvs/ui/CVSPreferencesPage.java;3;2;30;2;11;9;11;19;69;2;16;2394;614;614;2;3;2;19;30;2726;5;4829;25;3;
/org.eclipse.jdt.ui/ui/org/eclipse/jdt/internal/ui/javaeditor/structureselection/StructureSelectHistroyAction.java;2;0;2;1;0;0;0;2;0;1;2;3188;0;0;1;0;0;2;2;3188;0;3567;2;2;
/org.eclipse.jdt.debug/jdi/org/eclipse/jdi/internal/jdwp/JdwpClassID.java;2;0;3;1;0;0;0;3;12;1;3;187;13;13;1;0;0;3;3;187;0;3040;3;2;
/org.eclipse.jdt.ui.tests.refactoring/test cases/org/eclipse/jdt/ui/tests/nls/CellEditorTester.java;1;0;1;1;0;0;0;1;0;0;1;2015;0;0;1;0;0;1;1;2015;0;2015;1;1;
/org.eclipse.jdt.ui.tests.refactoring/resources/RenameTemp/cannotRename/A_testFail15.java;1;0;2;1;0;0;0;2;2;1;2;1625;2;2;1;0;0;2;2;1625;0;1652;2;1;
/org.eclipse.swt/Eclipse SWT PI/win32/org/eclipse/swt/internal/win32/MENUINFO.java;2;0;2;1;1;1;1;1;6;0;1;2069;6;6;1;0;0;1;2;2069;0;4701;2;2;
/org.eclipse.help/Eclipse Help/org/eclipse/help/internal/server/CSSEmbedProcessor.java;3;0;5;1;0;0;0;5;40;1;5;135;49;49;1;0;0;5;5;135;0;1420;5;3;
/org.eclipse.jdt.ui/core refactoring/org/eclipse/jdt/internal/core/nls/changes/CreateTextFileChange.java;1;0;2;1;0;0;0;2;0;1;2;1913;0;0;1;0;0;2;2;1913;0;1922;2;1;
/org.eclipse.pde.ui/src/org/eclipse/pde/internal/ui/editor/manifest/ManifestPropertySource.java;1;0;2;1;0;0;0;2;14;0;1;3579;14;14;2;1;0;2;2;3579;1;3579;1;1;
/org.eclipse.jdt.core/dom/org/eclipse/jdt/core/dom/IVariableBinding.java;2;0;4;1;0;0;0;4;4;1;4;2669;9;9;1;0;0;4;4;2669;0;3797;4;2;
/org.eclipse.pde.ui/src/org/eclipse/pde/internal/forms/renamed/FormWidgetFactory.java;1;0;2;1;0;0;0;2;0;1;2;2470;0;0;1;0;0;2;2;2470;0;2691;2;1;
/org.eclipse.ui/Eclipse JFace/org/eclipse/jface/preference/DirectoryFieldEditor.java;2;0;2;1;0;0;0;2;5;1;2;257;5;5;1;0;0;2;2;257;0;457;2;2;
/org.eclipse.core.boot/src/org/eclipse/core/internal/boot/update/UMProxy.java;2;0;3;1;0;0;0;3;6;1;3;23;6;6;1;0;0;3;3;23;0;2726;3;2;
/org.eclipse.pde.ui/src/org/eclipse/pde/internal/editor/ModelUndoManager.java;1;0;4;1;0;0;0;4;1;1;4;2851;2;2;1;0;0;4;4;2851;0;3579;4;1;
/org.eclipse.scripting/Eclipse Scripting/org/eclipse/scripting/internal/views/ScriptUIEditorDoubleClickSelector.java;1;0;3;1;0;0;0;3;7;1;3;133;7;7;1;0;0;3;3;133;0;1424;3;1;
/org.eclipse.ui.tests/Eclipse UI Tests/org/eclipse/ui/tests/navigator/ResourceNavigatorTest.java;3;0;4;1;1;1;1;3;9;1;3;1488;13;13;1;0;0;3;4;1488;0;4172;4;3;
/org.eclipse.ui/Eclipse JFace/org/eclipse/jface/viewers/ICombinedLabelProvider.java;2;0;3;1;1;1;1;2;2;1;2;3420;2;2;1;0;0;2;3;3420;0;4006;3;2;
/org.eclipse.jdt.ui/ui/org/eclipse/jdt/internal/ui/preferences/BuildPathsPropertyPage.java;5;1;14;1;4;4;4;10;146;2;9;15;261;261;2;1;0;10;14;1272;1;4621;13;5;
/org.eclipse.jdt.ui.tests.refactoring/resources/RenameTemp/canRename/A_test24_in.java;1;0;2;1;0;0;0;2;2;1;2;1625;2;2;1;0;0;2;2;1625;0;1652;2;1;
/org.eclipse.update.core/src/org/eclipse/update/internal/core/DefaultPluginParser.java;1;0;2;1;0;0;0;2;0;0;1;2758;0;0;2;1;0;2;2;2758;1;2758;1;1;
/org.eclipse.scripting/Eclipse Scripting/org/eclipse/scripting/internal/uirenderer/ScriptViewport.java;2;0;4;1;0;0;0;4;16;1;4;133;31;31;1;0;0;4;4;133;0;1424;4;2;
/org.eclipse.jdt.ui/ui/org/eclipse/jdt/internal/ui/filters/FilterDescriptor.java;2;1;4;1;4;4;4;0;15;0;0;4211;30;30;1;0;0;0;4;4211;0;4627;4;2;
/org.eclipse.team.cvs.core/src/org/eclipse/team/internal/ccvs/core/resources/RemoteFolder.java;3;1;48;3;2;2;2;46;1148;5;38;1978;4194;4194;5;8;0;46;48;2049;8;4081;40;3;
/org.eclipse.scripting/src/org/eclipse/scripting/internal/uirenderer/XGRElementUISwtTable.java;1;0;1;1;0;0;0;1;0;0;1;1424;0;0;1;0;0;1;1;1424;0;1424;1;1;
/org.eclipse.team.cvs.core/src/org/eclipse/team/internal/ccvs/core/client/FileInputStreamWrapper.java;2;0;3;1;0;0;0;3;188;1;3;3267;188;188;1;0;0;3;3;3267;0;3574;3;2;
/org.eclipse.scripting/Eclipse Scripting/org/eclipse/scripting/internal/views/ScriptUIEditorTreeContentProvider.java;2;0;4;1;0;0;0;4;4;1;4;133;5;5;1;0;0;4;4;133;0;1424;4;2;
/org.eclipse.core.boot/src/org/eclipse/core/internal/boot/PlatformURLHandlerFactory.java;3;0;5;1;1;1;1;4;114;1;4;23;175;175;1;0;0;4;5;23;0;4214;5;3;
/org.eclipse.jdt.ui.tests.refactoring/resources/SelectionAnalyzerWorkSpace/SelectionAnalyzerTests/validSelection/A_test091_.java;1;0;1;1;0;0;0;1;0;0;1;2139;0;0;1;0;0;1;1;2139;0;2139;1;1;
/org.eclipse.ui/Eclipse UI Text Editor/org/eclipse/ui/texteditor/TextNavigationAction.java;1;0;2;1;1;1;1;1;31;0;1;3250;31;31;1;0;0;1;2;3250;0;4838;2;1;
/org.eclipse.help/src/org/eclipse/help/internal/contributors1_0/ContributionManager.java;1;0;2;1;0;0;0;2;0;1;2;1675;0;0;1;0;0;2;2;1675;0;2217;2;1;
/org.eclipse.swt/Eclipse SWT/win32/org/eclipse/swt/internal/Converter.java;3;0;4;1;1;1;1;3;7;1;3;106;15;15;1;0;0;3;4;106;0;4701;4;3;
/org.eclipse.ui.tests/Eclipse UI Tests/org/eclipse/ui/tests/zoom/ActivateTest.java;1;0;1;1;0;0;0;1;0;0;1;3633;0;0;1;0;0;1;1;3633;0;3633;1;1;
/org.eclipse.jdt.ui.tests.refactoring/resources/RenameMethodInInterface/testFail23/in/A.java;1;0;1;1;0;0;0;1;0;0;1;49;0;0;1;0;0;1;1;49;0;49;1;1;
/org.eclipse.team.cvs.core/src/org/eclipse/team/internal/ccvs/core/resources/ICVSResource.java;2;0;6;1;0;0;0;6;77;2;5;2156;92;92;2;1;0;6;6;2156;1;3089;5;2;
/org.eclipse.pde.ui/src/org/eclipse/pde/ui/templates/TemplateField.java;1;0;2;1;1;1;1;1;42;0;1;3840;42;42;1;0;0;1;2;3840;0;4752;2;1;
/org.eclipse.pde.ui/Eclipse PDE UI/org/eclipse/pde/internal/editor/schema/SchemaObjectPropertySource.java;2;0;5;2;0;0;0;5;12;3;3;267;12;12;3;2;0;5;5;324;2;1434;3;2;
/org.eclipse.pde.ui/src/org/eclipse/pde/internal/ui/NoPDENatureDialog.java;1;0;2;1;0;0;0;2;0;1;2;3579;0;0;1;0;0;2;2;3579;0;3607;2;1;
/org.eclipse.jdt.debug.tests/tests/org/eclipse/jdt/debug/tests/core/ClasspathProviderTests.java;2;1;2;1;2;2;2;0;31;0;0;4127;31;31;1;0;0;0;2;4127;0;4328;2;2;
/org.eclipse.swt.tests/JUnit Tests/org/eclipse/swt/tests/junit/Test_org_eclipse_swt_graphics_FontData.java;3;1;3;1;2;2;2;1;14;0;1;1792;20;20;1;0;0;1;3;1792;0;4706;3;3;
/org.eclipse.jdt.ui/ui/org/eclipse/jdt/internal/ui/wizards/buildpaths/CPVariableElement.java;3;0;6;1;0;0;0;6;22;1;6;159;46;46;1;0;0;6;6;159;0;3737;6;3;
/org.eclipse.jdt.ui.tests/refactoring/org/eclipse/jdt/refactoring/tests/AllRefactoringTests.java;4;0;10;1;0;0;0;10;16;1;10;49;46;46;1;0;0;10;10;49;0;1896;10;4;
/org.eclipse.pde.ui/src/org/eclipse/pde/internal/core/feature/VersionableObject.java;1;0;3;1;0;0;0;3;2;1;3;3579;2;2;1;0;0;3;3;3579;0;3607;3;1;
/org.eclipse.core.tests.runtime/src/org/eclipse/core/tests/internal/runtimetests/SampleLPR.java;1;0;2;1;0;0;0;2;10;1;2;3611;10;10;1;0;0;2;2;3611;0;3678;2;1;
/org.eclipse.help.ui/src/org/eclipse/help/internal/ui/HelpActionSet.java;2;0;2;1;0;0;0;2;0;1;2;1420;0;0;1;0;0;2;2;1420;0;1675;2;2;
/org.eclipse.jdt.ui.tests.refactoring/resources/ExtractMethodWorkSpace/ExtractMethodTests/return_out/A_test705.java;1;1;3;1;2;2;2;1;24;0;1;887;24;24;1;0;0;1;3;887;0;4419;3;1;
/org.eclipse.jdt.ui/core extension/org/eclipse/jdt/internal/corext/codemanipulation/AddMemberEdit.java;2;0;6;1;0;0;0;6;9;2;4;1937;19;19;2;2;0;6;6;1937;2;2133;4;2;
/org.eclipse.ui.examples.javaeditor/Java Editor Example/org/eclipse/ui/examples/javaeditor/PresentationAction.java;1;0;2;1;0;0;0;2;0;0;1;1066;0;0;2;1;0;2;2;1066;1;1066;1;1;
/org.eclipse.jdt.ui.tests.refactoring/resources/SelectionAnalyzerWorkSpace/SelectionAnalyzerTests/invalidSelection/A_test080.java;2;0;2;1;0;0;0;2;0;1;2;1368;0;0;1;0;0;2;2;1368;0;2139;2;2;
/org.eclipse.jdt.ui.tests.refactoring/resources/ExtractMethodWorkSpace/ExtractMethodTests/locals_out/A_test567.java;1;1;2;1;2;2;2;0;0;0;0;4383;0;0;1;0;0;0;2;4383;0;4419;2;1;
/org.eclipse.jdt.ui.tests.refactoring/resources/MoveMembers/test5/out/A.java;1;0;1;1;0;0;0;1;0;0;1;2738;0;0;1;0;0;1;1;2738;0;2738;1;1;
/org.eclipse.update.core/src/org/eclipse/update/configuration/IActivity.java;2;0;8;1;1;1;1;7;158;2;6;2994;273;273;2;1;0;7;8;3596;1;4687;7;2;
/org.eclipse.jdt.ui.tests.refactoring/resources/ExtractMethodWorkSpace/ExtractMethodTests/locals_in/A_test536.java;1;1;3;1;2;2;2;1;24;0;1;922;24;24;1;0;0;1;3;922;0;4419;3;1;
/org.eclipse.jdt.ui.tests.refactoring/resources/RenameType/test12/out/A.java;1;0;2;1;0;0;0;2;0;1;2;49;0;0;1;0;0;2;2;49;0;522;2;1;
/org.eclipse.pde.core/src/org/eclipse/pde/internal/core/ifeature/IFeatureURLElement.java;1;0;1;1;0;0;0;1;0;0;1;3591;0;0;1;0;0;1;1;3591;0;3591;1;1;
/org.eclipse.team.cvs.core/src/org/eclipse/team/internal/ccvs/core/commands/PruneFolderVisitor.java;3;0;4;1;0;0;0;4;22;1;4;1978;24;24;1;0;0;4;4;1978;0;2607;4;3;
/org.eclipse.update/Eclipse Update/org/eclipse/update/internal/ui/UMWizardPageURLComplete.java;2;0;4;1;0;0;0;4;185;1;4;108;189;189;1;0;0;4;4;108;0;1424;4;2;
/org.eclipse.jdt.ui/ui/org/eclipse/jdt/ui/ITypeHierarchyViewPart.java;3;0;6;1;1;1;1;5;28;1;5;15;57;57;1;0;0;5;6;15;0;4810;6;3;
/org.eclipse.swt.tests/JUnit Tests/org/eclipse/swt/tests/junit/Test_org_eclipse_swt_printing_PrinterData.java;2;0;2;1;1;1;1;1;6;0;1;1792;6;6;1;0;0;1;2;1792;0;4706;2;2;
/org.eclipse.jdt.ui/core extension/org/eclipse/jdt/internal/corext/template/java/JavaTemplateMessages.java;1;0;1;1;0;0;0;1;0;0;1;3683;0;0;1;0;0;1;1;3683;0;3683;1;1;
/org.eclipse.jdt.ui/core refactoring/org/eclipse/jdt/internal/corext/refactoring/base/JavaSourceContext.java;2;0;8;1;1;1;1;7;75;1;7;1939;97;97;1;0;0;7;8;1939;0;4014;8;2;
/org.eclipse.jdt.ui.tests.refactoring/resources/ExtractMethodWorkSpace/ExtractMethodTests/invalidSelection/A_test084.java;2;1;3;1;2;2;2;1;0;0;1;49;0;0;1;0;0;1;3;49;0;4419;3;2;
/org.eclipse.core.tests.harness/src/org/eclipse/core/tests/harness/TestProgressMonitor.java;3;0;4;1;1;1;1;3;98;1;3;1794;118;118;1;0;0;3;4;1794;0;4516;4;3;
/org.eclipse.swt/Eclipse SWT PI/gtk/org/eclipse/swt/internal/gtk/GdkEventCrossing.java;2;2;3;1;3;2;3;0;7;0;0;4633;7;7;2;0;1;0;3;4701;1;4701;2;2;
/org.eclipse.jdt.ui.tests.refactoring/resources/SefWorkSpace/SefTests/object_in/TestSimpleReadWrite.java;1;0;1;1;0;0;0;1;0;0;1;2155;0;0;1;0;0;1;1;2155;0;2155;1;1;
/org.eclipse.pde.ui/Eclipse PDE UI/org/eclipse/pde/internal/schema/SchemaRegistry.java;2;0;8;2;0;0;0;8;12;3;5;267;20;20;3;3;0;8;8;324;3;1434;5;2;
/org.eclipse.jdt.junit/Eclipse JUnit/org/eclipse/jdt/internal/junit/launcher/JUnitLaunchConfiguration.java;2;0;3;1;0;0;0;3;3;1;3;2861;3;3;1;0;0;3;3;2861;0;3084;3;2;
/org.eclipse.swt.tests/JUnit Tests/org/eclipse/swt/tests/junit/Test_org_eclipse_swt_graphics_Drawable.java;2;0;2;1;1;1;1;1;6;0;1;1792;6;6;1;0;0;1;2;1792;0;4706;2;2;
/org.eclipse.scripting/src/org/eclipse/scripting/internal/ScriptReaderFileSystemFile.java;1;0;1;1;0;0;0;1;0;0;1;1424;0;0;1;0;0;1;1;1424;0;1424;1;1;
/org.eclipse.core.tests.resources/src/org/eclipse/core/tests/resources/usecase/SignaledBuilder.java;3;0;3;1;0;0;0;3;104;1;3;1794;117;117;1;0;0;3;3;1794;0;3420;3;3;
/org.eclipse.jdt.ui.tests.refactoring/resources/RenameParameters/canRename/A_test30_out.java;1;0;1;1;0;0;0;1;0;0;1;233;0;0;1;0;0;1;1;233;0;233;1;1;
/org.eclipse.jdt.ui.tests.refactoring/resources/RenameType/test19/in/A.java;1;0;1;1;0;0;0;1;0;0;1;49;0;0;1;0;0;1;1;49;0;49;1;1;
/org.eclipse.jdt.ui.tests.refactoring/resources/PullUp/testFail10/in/A.java;1;0;1;1;0;0;0;1;0;0;1;2406;0;0;1;0;0;1;1;2406;0;2406;1;1;
/org.eclipse.webdav/src/kernel/org/eclipse/webdav/internal/kernel/QualifiedNameImpl.java;1;0;4;1;1;1;1;3;184;1;3;12;213;213;1;0;0;3;4;12;0;4211;4;1;
/org.eclipse.jdt.debug/model/org/eclipse/jdt/internal/debug/core/DebugJavaUtils.java;3;0;8;1;0;0;0;8;487;1;8;187;645;645;1;0;0;8;8;187;0;1433;8;3;
/org.eclipse.jdt.debug/eval/org/eclipse/jdt/debug/eval/ast/model/IPrimitiveValue.java;1;0;3;1;0;0;0;3;2;1;3;3329;2;2;1;0;0;3;3;3329;0;3421;3;1;
/org.eclipse.vcm.core.cvs/src/org/eclipse/vcm/internal/core/ccvs/IUserAuthenticator.java;4;0;7;1;0;0;0;7;45;1;7;0;98;98;1;0;0;7;7;0;0;1682;7;4;
/org.eclipse.search/search/org/eclipse/search/internal/ui/SearchResultViewEntry.java;2;0;7;1;2;1;2;5;18;1;5;15;57;57;2;0;1;5;7;4147;1;4147;6;2;
/org.eclipse.pde.ui/Eclipse PDE UI/org/eclipse/pde/internal/editor/manifest/ManifestSourcePage.java;2;0;5;2;0;0;0;5;12;3;3;267;12;12;3;2;0;5;5;324;2;1434;3;2;
/org.eclipse.team.cvs.ui/src/org/eclipse/team/internal/ccvs/ui/actions/OpenLogEntryAction.java;3;1;10;1;3;3;3;7;40;1;7;1994;110;110;1;0;0;7;10;1994;0;4829;10;3;
/org.eclipse.ui/Eclipse UI/org/eclipse/ui/internal/EditorPresentation.java;5;1;10;1;3;3;3;7;68;1;7;257;181;181;1;0;0;7;10;257;0;4568;10;5;
/org.eclipse.pde.ui/src/org/eclipse/pde/internal/editor/feature/SynchronizeVersionsWizardPage.java;1;0;5;1;0;0;0;5;31;2;4;2951;34;34;2;1;0;5;5;3136;1;3579;4;1;
/org.eclipse.ui/Eclipse UI/org/eclipse/ui/actions/CreateFileAction.java;5;0;5;1;0;0;0;5;14;1;5;257;23;23;1;0;0;5;5;257;0;3029;5;5;
/org.eclipse.update.core/src/org/eclipse/update/core/ISiteChangedListener.java;2;0;4;1;0;0;0;4;9;1;4;1428;13;13;1;0;0;4;4;1428;0;3018;4;2;
/org.eclipse.jdt.ui/ui/org/eclipse/jdt/internal/ui/util/PortingFinder.java;2;0;3;1;0;0;0;3;8;1;3;15;8;8;1;0;0;3;3;15;0;1199;3;2;
/org.eclipse.ui/Eclipse UI Tool Script/org/eclipse/toolscript/core/internal/AntScriptRunner.java;1;2;7;1;7;6;7;0;17;0;0;3920;41;41;2;0;1;0;7;4060;1;4087;6;1;
/org.eclipse.jdt.junit/src/org/eclipse/jdt/internal/junit/ui/JUnitMessages.java;1;0;1;1;0;0;0;1;0;0;1;3659;0;0;1;0;0;1;1;3659;0;3659;1;1;
/org.eclipse.jdt.ui/ui/org/eclipse/jdt/internal/ui/packageview/OpenResourceAction.java;6;0;11;1;1;1;1;10;35;1;10;15;105;105;1;0;0;10;11;15;0;4630;11;6;
/org.eclipse.jdt.debug.tests/tests/org/eclipse/jdt/debug/tests/eval/StaticFieldValueTests2.java;2;1;3;1;3;3;3;0;17;0;0;4447;19;19;1;0;0;0;3;4447;0;4571;3;2;
/org.eclipse.jdt.ui/ui/org/eclipse/jdt/ui/ISharedImages.java;2;1;4;1;2;2;2;2;14;1;2;15;26;26;1;0;0;2;4;15;0;4852;4;2;
/org.eclipse.update.ui.forms/src/org/eclipse/update/ui/forms/internal/SelectableControl.java;1;0;2;1;0;0;0;2;2;1;2;2470;2;2;1;0;0;2;2;2470;0;3159;2;1;
/org.eclipse.jdt.ui/ui/org/eclipse/jdt/internal/ui/launcher/MainMethodFinder.java;4;0;9;1;0;0;0;9;159;1;9;15;249;249;1;0;0;9;9;15;0;1916;9;4;
/org.eclipse.pde.ui/Eclipse PDE UI/org/eclipse/pde/internal/model/jars/ExternalJarsModel.java;2;0;5;2;0;0;0;5;12;3;3;267;12;12;3;2;0;5;5;324;2;1434;3;2;
/org.eclipse.swt/Eclipse SWT Custom Widgets/common/org/eclipse/swt/custom/ViewForm.java;3;2;11;1;5;4;5;6;126;2;5;106;253;253;2;1;1;6;11;2876;2;4701;9;3;
/org.eclipse.jdt.ui/core refactoring/org/eclipse/jdt/internal/corext/refactoring/surround/LocalDeclarationAnalyzer.java;1;1;4;1;2;2;2;2;52;1;2;2327;60;60;1;0;0;2;4;2327;0;4000;4;1;
/org.eclipse.jdt.junit/Eclipse JUnit/org/eclipse/jdt/internal/junit/oldlauncher/JUnitLaunchWizard.java;2;0;2;1;0;0;0;2;0;1;2;2861;0;0;1;0;0;2;2;2861;0;3205;2;2;
/org.eclipse.help/src/org/eclipse/help/internal/search/ISearchQuery.java;1;0;1;1;1;1;1;0;0;0;0;4000;0;0;1;0;0;0;1;4000;0;4000;1;1;
/org.eclipse.ui/Eclipse JFace/org/eclipse/jface/viewers/ICellEditorValidator.java;2;0;2;1;0;0;0;2;5;1;2;257;5;5;1;0;0;2;2;257;0;457;2;2;
/org.eclipse.core.resources/src/org/eclipse/core/internal/resources/MarkerTypeDefinition.java;2;0;4;1;1;1;1;3;184;1;3;12;231;231;1;0;0;3;4;12;0;4213;4;2;
/org.eclipse.core.tests.runtime/src/org/eclipse/core/tests/internal/plugins/PluginResolveTest_4.java;4;0;4;1;0;0;0;4;114;1;4;1794;129;129;1;0;0;4;4;1794;0;3476;4;4;
/org.eclipse.jdt.ui/ui refactoring/org/eclipse/jdt/internal/ui/refactoring/MergeTextViewerContentProvider.java;3;0;7;1;0;0;0;7;18;1;7;15;41;41;1;0;0;7;7;15;0;1939;7;3;
/org.eclipse.team.cvs.ui/src/org/eclipse/team/internal/ccvs/ui/AdaptableList.java;1;0;2;1;0;0;0;2;0;1;2;1978;0;0;1;0;0;2;2;1978;0;2005;2;1;
/org.eclipse.help/src/org/eclipse/help/internal/protocols/LinksURLConnection.java;1;0;1;1;0;0;0;1;0;0;1;2694;0;0;1;0;0;1;1;2694;0;2694;1;1;
/org.eclipse.core.boot/src/org/eclipse/core/internal/boot/update/ComponentDescriptor.java;4;0;7;2;0;0;0;7;29;2;6;12;68;68;2;1;0;7;7;324;1;2726;6;4;
/org.eclipse.help/Eclipse Help/org/eclipse/help/internal/server/HelpHttpResponse.java;3;0;4;1;0;0;0;4;7;1;4;135;9;9;1;0;0;4;4;135;0;1420;4;3;
/org.eclipse.jdt.core/model/org/eclipse/jdt/internal/core/newbuilder/ProblemFactory.java;1;0;4;1;0;0;0;4;3;1;4;1764;6;6;1;0;0;4;4;1764;0;2979;4;1;
/org.eclipse.ui/Eclipse UI/org/eclipse/ui/internal/dialogs/SelectPerspectiveDialog.java;5;0;5;1;0;0;0;5;9;1;5;257;27;27;1;0;0;5;5;257;0;3029;5;5;
/org.eclipse.vcm.core.cvs/src/org/eclipse/vcm/internal/core/ccvs/requests/LogHandler.java;3;0;6;1;0;0;0;6;63;1;6;0;117;117;1;0;0;6;6;0;0;1240;6;3;
/org.eclipse.ui/Eclipse UI/org/eclipse/ui/actions/CopyProjectAction.java;4;0;6;1;0;0;0;6;58;1;6;257;69;69;1;0;0;6;6;257;0;3607;6;4;
/org.eclipse.jdt.ui/ui/org/eclipse/jdt/ui/actions/ReferencesSearchGroup.java;2;2;5;2;5;4;5;0;25;0;0;4146;41;41;2;0;1;0;5;4146;1;4770;4;2;
/org.eclipse.jdt.debug/jdi interfaces/com/sun/jdi/event/MethodExitEvent.java;2;0;2;1;0;0;0;2;11;1;2;2704;11;11;1;0;0;2;2;2704;0;3040;2;2;
/org.eclipse.pde.ui/src/org/eclipse/pde/internal/ui/editor/manifest/DetailExtensionPointSection.java;1;1;8;1;2;2;2;6;34;2;5;3579;59;59;2;1;0;6;8;3579;1;4567;7;1;
/org.eclipse.jdt.ui.tests.refactoring/resources/RenameType/test3/out/A.java;1;0;2;1;0;0;0;2;0;1;2;49;0;0;1;0;0;2;2;49;0;522;2;1;
/org.eclipse.team.ui/src/org/eclipse/team/internal/ui/TeamWizardPage.java;1;0;2;1;0;0;0;2;107;1;2;3728;107;107;1;0;0;2;2;3728;0;3812;2;1;
/org.eclipse.jdt.launching.j9/j9/org/eclipse/jdt/internal/launching/j9/J9VMRunner.java;2;2;10;1;5;4;5;5;42;1;5;3314;98;98;2;0;1;5;10;4214;1;4449;9;2;
/org.eclipse.ui/Eclipse UI/org/eclipse/ui/part/DrillDownAdapter.java;2;0;2;1;0;0;0;2;19;1;2;257;19;19;1;0;0;2;2;257;0;457;2;2;
/org.eclipse.swt/Eclipse SWT PI/gtk1x/org/eclipse/swt/internal/gtk/GtkStyleClass.java;2;0;2;1;1;1;1;1;3;0;1;2107;3;3;1;0;0;1;2;2107;0;4701;2;2;
/org.eclipse.debug.ui/ui/org/eclipse/debug/internal/ui/ShowQualifiedAction.java;3;0;10;1;0;0;0;10;24;1;10;187;74;74;1;0;0;10;10;187;0;2382;10;3;
/org.eclipse.swt/Eclipse SWT Custom Widgets/common/org/eclipse/swt/custom/TableEditor.java;2;0;5;1;1;1;1;4;50;2;3;106;60;60;2;1;0;4;5;3051;1;4701;4;2;
/org.eclipse.jdt.ui.tests.refactoring/resources/RenameParameters/canRename/A_test34_out.java;1;0;1;1;0;0;0;1;0;0;1;2751;0;0;1;0;0;1;1;2751;0;2751;1;1;
/org.eclipse.jdt.junit/Eclipse JUnit/org/eclipse/jdt/internal/junit/launcher/TestSelectionDialog.java;2;0;4;1;0;0;0;4;180;1;4;2861;180;180;1;0;0;4;4;2861;0;3205;4;2;
/org.eclipse.pde.runtime/src/org/eclipse/pde/internal/runtime/registry/PropertiesAction.java;1;0;1;1;0;0;0;1;0;0;1;1434;0;0;1;0;0;1;1;1434;0;1434;1;1;
/org.eclipse.jdt.core/search/org/eclipse/jdt/internal/core/index/impl/IndexSummary.java;3;0;11;1;1;1;1;10;274;4;7;455;356;356;4;3;0;10;11;1039;3;4063;8;3;
/org.eclipse.pde.build/src/org/eclipse/pde/internal/build/ModelRegistry.java;5;0;10;1;0;0;0;10;153;2;9;245;350;350;2;1;0;10;10;349;1;3089;9;5;
/org.eclipse.swt.examples/Eclipse SWT Examples/common/org/eclipse/swt/examples/controlexample/ProgressBarTab.java;1;0;2;1;0;0;0;2;0;1;2;107;0;0;1;0;0;2;2;107;0;611;2;1;
/org.eclipse.jdt.ui.tests.refactoring/resources/RenameParameters/canRename/A_test10_out.java;1;0;1;1;0;0;0;1;0;0;1;233;0;0;1;0;0;1;1;233;0;233;1;1;
/org.eclipse.jdt.core/model/org/eclipse/jdt/internal/core/builder/ClasspathJar.java;4;2;7;2;3;2;3;4;87;2;3;2979;157;157;2;1;1;4;7;2979;2;4629;5;4;
/org.eclipse.jdt.ui.tests.refactoring/resources/RenameType/testFail27/in/B.java;1;0;1;1;0;0;0;1;0;0;1;49;0;0;1;0;0;1;1;49;0;49;1;1;
/org.eclipse.ui/Eclipse JFace/org/eclipse/jface/util/Assert.java;4;0;5;1;1;1;1;4;5;1;4;257;11;11;1;0;0;4;5;257;0;4162;5;4;
/org.eclipse.pde.ui/src/org/eclipse/pde/internal/ui/editor/feature/DataSection.java;1;1;7;1;2;2;2;5;44;2;4;3579;97;97;2;1;0;5;7;3579;1;4067;6;1;
/org.eclipse.jdt.core/compiler/org/eclipse/jdt/internal/compiler/codegen/Label.java;2;0;16;1;1;1;1;15;376;4;9;455;553;553;4;6;0;15;16;1039;6;4062;10;2;
/org.eclipse.jdt.debug/model/org/eclipse/jdt/internal/debug/core/JDIObjectValue.java;3;0;5;1;0;0;0;5;43;1;5;1675;55;55;1;0;0;5;5;1675;0;2517;5;3;
/org.eclipse.pde.ui/src/org/eclipse/pde/internal/view/PluginsView.java;1;0;3;1;0;0;0;3;348;2;2;3445;348;348;2;1;0;3;3;3445;1;3579;2;1;
/org.eclipse.jdt.core/model/org/eclipse/jdt/internal/core/util/StringHashtableOfInt.java;3;1;11;1;2;2;2;9;212;4;6;455;285;285;4;3;0;9;11;1039;3;4422;8;3;
/org.eclipse.jdt.core/model/org/eclipse/jdt/internal/core/MoveResourceElementsOperation.java;2;0;9;1;1;1;1;8;45;4;5;455;77;77;4;3;0;8;9;1039;3;4063;6;2;
/org.eclipse.jdt.core/model/org/eclipse/jdt/internal/core/JarPackageFragmentRootInfo.java;2;0;3;1;1;1;1;2;45;1;2;455;61;61;1;0;0;2;3;455;0;4063;3;2;
/org.eclipse.ui/Eclipse UI Standard Components/org/eclipse/ui/views/navigator/WorkbenchStateActionFactory.java;2;0;7;1;1;1;1;6;12;2;4;1830;30;30;2;2;0;6;7;1830;2;4067;5;2;
/org.eclipse.scripting/Eclipse Scripting/org/eclipse/scripting/internal/views/ScriptUIEditorCodeScanner.java;2;0;5;1;0;0;0;5;18;1;5;133;39;39;1;0;0;5;5;133;0;1424;5;2;
/org.eclipse.ui/Eclipse UI/org/eclipse/ui/internal/ObjectActionContributorManager.java;5;0;14;2;2;1;2;12;120;2;11;257;278;278;2;1;1;12;14;1943;2;3974;12;5;
/org.eclipse.team.ui/src/org/eclipse/team/internal/ui/sync/TypedBufferedContent.java;1;0;3;1;1;1;1;2;8;1;2;2054;8;8;1;0;0;2;3;2054;0;4005;3;1;
/org.eclipse.core.tests.resources/src/org/eclipse/core/tests/resources/session/TestSaveCreateProject.java;2;0;3;1;0;0;0;3;96;1;3;2390;106;106;1;0;0;3;3;2390;0;3475;3;2;
/org.eclipse.pde.ui/src/org/eclipse/pde/internal/core/builders/ManifestParser.java;1;0;2;1;0;0;0;2;0;1;2;3579;0;0;1;0;0;2;2;3579;0;3607;2;1;
/org.eclipse.pde.ui/src/org/eclipse/pde/internal/ui/editor/manifest/JarsSection.java;1;0;6;1;1;1;1;5;153;2;4;3579;184;184;2;1;0;5;6;3579;1;4568;5;1;
/org.eclipse.debug.ui/ui/org/eclipse/debug/ui/actions/RunAction.java;3;0;5;1;1;1;1;4;9;1;4;2397;21;21;1;0;0;4;5;2397;0;4374;5;3;
/org.eclipse.jdt.ui.tests.refactoring/resources/DeleteSourceReference/A_test4_in.java;1;0;2;1;0;0;0;2;0;1;2;2003;0;0;1;0;0;2;2;2003;0;2857;2;1;
/org.eclipse.jdt.ui.tests.refactoring/resources/ExtractMethodWorkSpace/ExtractMethodTests/locals_in/A_test511.java;2;1;4;1;2;2;2;2;7;1;2;226;13;13;1;0;0;2;4;226;0;4419;4;2;
/org.eclipse.debug.ui/ui/org/eclipse/debug/internal/ui/actions/StepIntoActionDelegate.java;2;0;4;1;1;1;1;3;36;1;3;2382;46;46;1;0;0;3;4;2382;0;4163;4;2;
/org.eclipse.jdt.ui.tests.refactoring/resources/RenameMethodInInterface/testFail24/in/A.java;1;0;1;1;0;0;0;1;0;0;1;49;0;0;1;0;0;1;1;49;0;49;1;1;
/org.eclipse.pde.ui/src/org/eclipse/pde/internal/feature/FeatureJarWizard.java;1;0;3;1;0;0;0;3;2;1;3;2951;2;2;1;0;0;3;3;2951;0;3113;3;1;
/org.eclipse.pde.ui/Eclipse PDE UI/org/eclipse/pde/internal/model/build/BuildEntry.java;2;0;6;2;0;0;0;6;18;3;4;267;30;30;3;2;0;6;6;324;2;1434;4;2;
/org.eclipse.jdt.debug.ui/ui/org/eclipse/jdt/internal/debug/ui/actions/ShowQualifiedAction.java;2;1;7;1;2;2;2;5;17;1;5;2398;53;53;1;0;0;5;7;2398;0;3958;7;2;
/org.eclipse.jdt.debug/jdi/org/eclipse/jdi/internal/MirrorImpl.java;2;0;6;1;0;0;0;6;36;1;6;187;89;89;1;0;0;6;6;187;0;3678;6;2;
/org.eclipse.jdt.core/model/org/eclipse/jdt/internal/core/hierarchy/IndexBasedHierarchyBuilder.java;3;2;30;1;4;3;4;26;860;4;20;455;1592;1592;4;6;1;26;30;1039;7;4421;23;3;
/org.eclipse.jdt.ui.tests.refactoring/resources/RenamePrivateMethod/test26/in/A.java;1;0;2;1;0;0;0;2;2;1;2;49;2;2;1;0;0;2;2;49;0;512;2;1;
/org.eclipse.jdt.debug/eval/org/eclipse/jdt/internal/debug/eval/ast/instructions/XfixOperator.java;2;0;3;1;1;1;1;2;4;1;2;3421;7;7;1;0;0;2;3;3421;0;4423;3;2;
/org.eclipse.ui/Eclipse UI Standard Components/org/eclipse/ui/views/framelist/UpAction.java;2;0;2;1;1;1;1;1;2;0;1;3498;2;2;1;0;0;1;2;3498;0;4609;2;2;
/org.eclipse.team.cvs.core/src/org/eclipse/team/internal/ccvs/core/connection/CVSAuthenticationException.java;2;0;3;1;1;1;1;2;108;1;2;1978;127;127;1;0;0;2;3;1978;0;4368;3;2;
/org.eclipse.pde.build/src/org/eclipse/pde/internal/build/tasks/InitTemplate.java;1;0;4;1;0;0;0;4;37;1;4;2901;42;42;1;0;0;4;4;2901;0;3509;4;1;
/org.eclipse.ui/Eclipse UI/org/eclipse/ui/internal/OpenPreferencesAction.java;4;0;5;1;1;1;1;4;10;1;4;257;27;27;1;0;0;4;5;257;0;4447;5;4;
/org.eclipse.jdt.core/compiler/org/eclipse/jdt/internal/compiler/flow/SwitchFlowContext.java;2;0;11;1;1;1;1;10;61;4;7;455;159;159;4;3;0;10;11;1039;3;4062;8;2;
/org.eclipse.update/src/org/eclipse/update/internal/ui/UMApplicationUserInterfaceProperties.java;1;0;1;1;0;0;0;1;0;0;1;1424;0;0;1;0;0;1;1;1424;0;1424;1;1;
/org.eclipse.swt/Eclipse SWT/motif/org/eclipse/swt/graphics/Device.java;5;1;11;1;3;3;3;8;330;1;8;106;412;412;1;0;0;8;11;106;0;4701;11;5;
/org.eclipse.jdt.ui.tests.refactoring/resources/PullUpMethods/test12/in/A.java;1;0;2;1;0;0;0;2;0;1;2;2212;0;0;1;0;0;2;2;2212;0;2406;2;1;
/org.eclipse.help.webapp/src/org/eclipse/help/servlet/Eclipse.java;2;0;12;2;2;1;2;10;224;2;9;2409;304;304;2;1;1;10;12;2409;2;4323;10;2;
/org.eclipse.pde.ui/src/org/eclipse/pde/internal/core/feature/IdentifiableObject.java;1;0;3;1;0;0;0;3;2;1;3;3579;2;2;1;0;0;3;3;3579;0;3607;3;1;
/org.eclipse.jdt.core/model/org/eclipse/jdt/internal/core/util/InnerClassesAttribute.java;3;2;5;2;3;2;3;2;18;0;1;3629;40;40;2;1;1;2;5;3629;2;4421;3;3;
/org.eclipse.update.ui/src/org/eclipse/update/internal/ui/manager/InstallPage.java;1;0;2;1;0;0;0;2;0;1;2;1428;0;0;1;0;0;2;2;1428;0;1460;2;1;
/org.eclipse.jdt.ui.tests.refactoring/resources/InlineTemp/canInline/A_test14_in.java;1;0;1;1;0;0;0;1;0;0;1;3048;0;0;1;0;0;1;1;3048;0;3048;1;1;
/org.eclipse.help/src/SessionExample.java;1;0;2;1;0;0;0;2;0;1;2;1882;0;0;1;0;0;2;2;1882;0;1930;2;1;
/org.eclipse.ui.tests/Eclipse UI Tests/org/eclipse/ui/tests/api/Man.java;1;0;2;1;0;0;0;2;0;1;2;881;0;0;1;0;0;2;2;881;0;983;2;1;
/org.eclipse.pde.ui/Eclipse PDE UI/org/eclipse/pde/internal/model/ExternalFragmentModel.java;2;0;5;2;0;0;0;5;12;3;3;267;12;12;3;2;0;5;5;324;2;1434;3;2;
/org.eclipse.jdt.ui/ui/org/eclipse/jdt/internal/ui/text/java/MethodStubCompletionProposal.java;2;0;7;1;1;1;1;6;115;3;4;3647;136;136;3;2;0;6;7;3845;2;3914;5;2;
/org.eclipse.jdt.ui/ui refactoring/org/eclipse/jdt/internal/ui/refactoring/sef/SelfEncapsulateFieldInputPage.java;3;3;15;1;5;3;5;10;64;2;9;1453;268;268;3;1;2;10;15;4396;3;4421;12;3;
/org.eclipse.swt/Eclipse SWT Custom Widgets/common/org/eclipse/swt/custom/PopupList.java;2;0;3;1;1;1;1;2;6;1;2;106;11;11;1;0;0;2;3;106;0;4701;3;2;
/org.eclipse.jdt.ui.tests.refactoring/resources/RenameVariables/canRename/A_test17_in.java;1;0;2;1;0;0;0;2;0;1;2;724;0;0;1;0;0;2;2;724;0;1665;2;1;
/org.eclipse.jdt.ui/ui/org/eclipse/jdt/internal/ui/compare/JavaReplaceWithEditionAction.java;3;2;24;2;5;3;5;19;112;2;15;15;616;616;2;4;2;19;24;77;6;4450;18;3;
/org.eclipse.jdt.ui.tests.refactoring/resources/StructureSelectionAction/A_test23.java;1;0;1;1;0;0;0;1;0;0;1;3020;0;0;1;0;0;1;1;3020;0;3020;1;1;
/org.eclipse.jdt.ui.tests.refactoring/resources/RenameTemp/canRename/A_test47_in.java;1;0;1;1;1;1;1;0;0;0;0;4400;0;0;1;0;0;0;1;4400;0;4400;1;1;
/org.eclipse.pde.ui/src/org/eclipse/pde/internal/ui/wizards/templates/HelloWorldTemplate.java;1;1;7;1;3;3;3;4;81;1;4;3579;169;169;1;0;0;4;7;3579;0;4316;7;1;
/org.eclipse.swt/Eclipse SWT/photon/org/eclipse/swt/internal/photon/PtScrollbarCallback_t.java;2;0;3;1;0;0;0;3;6;1;3;106;6;6;1;0;0;3;3;106;0;2069;3;2;
/org.eclipse.jdt.debug.tests/tests/org/eclipse/jdt/debug/tests/eval/NestedTypeFieldValue_192.java;2;1;3;1;3;3;3;0;12;0;0;4447;14;14;1;0;0;0;3;4447;0;4571;3;2;
/org.eclipse.ui/Eclipse UI/org/eclipse/ui/internal/SystemSummaryEditorInput.java;1;0;1;1;1;1;1;0;0;0;0;4387;0;0;1;0;0;0;1;4387;0;4387;1;1;
/org.eclipse.update.tests.core/src/org/eclipse/update/tests/regularInstall/MultipleTestLocalSite.java;1;0;1;1;0;0;0;1;0;0;1;2634;0;0;1;0;0;1;1;2634;0;2634;1;1;
/org.eclipse.ui.externaltools/External Tools/org/eclipse/ui/externaltools/internal/ui/ToolsPreferencePage.java;1;0;2;1;2;1;2;0;2;0;0;4123;2;2;2;0;1;0;2;4123;1;4123;1;1;
/org.eclipse.jdt.ui.tests.refactoring/resources/InlineTemp/canInline/A_test21_out.java;1;0;1;1;1;1;1;0;0;0;0;4403;0;0;1;0;0;0;1;4403;0;4403;1;1;
/org.eclipse.ui.tests/Eclipse JFace Tests/org/eclipse/jface/tests/viewers/interactive/TestTableTreeLabelProvider.java;1;0;1;1;0;0;0;1;0;0;1;1488;0;0;1;0;0;1;1;1488;0;1488;1;1;
/org.eclipse.ui/Eclipse UI/org/eclipse/ui/IEditorReference.java;1;1;2;1;2;2;2;0;44;0;0;4063;44;44;1;0;0;0;2;4063;0;4082;2;1;
/org.eclipse.core.tests.resources/src/org/eclipse/core/tests/resources/regression/PR_1GALH44_3Test.java;3;0;4;1;0;0;0;4;12;1;4;1794;20;20;1;0;0;4;4;1794;0;3287;4;3;
/org.eclipse.jdt.debug/eval/org/eclipse/jdt/internal/debug/eval/model/EvaluationValue.java;2;0;3;1;0;0;0;3;2;1;3;3421;2;2;1;0;0;3;3;3421;0;3645;3;2;
/org.eclipse.jdt.ui.tests.refactoring/resources/SelectionAnalyzerWorkSpace/SelectionAnalyzerTests/invalidSelection/A_test103.java;2;0;3;1;0;0;0;3;0;1;3;1368;0;0;1;0;0;3;3;1368;0;2327;3;2;
/org.eclipse.jdt.ui.tests.refactoring/resources/SelectionAnalyzerWorkSpace/SelectionAnalyzerTests/invalidSelection/A_test109.java;1;0;1;1;0;0;0;1;0;0;1;1368;0;0;1;0;0;1;1;1368;0;1368;1;1;
/org.eclipse.compare/compare/org/eclipse/compare/internal/MergeViewerAction.java;1;0;1;1;0;0;0;1;0;0;1;329;0;0;1;0;0;1;1;329;0;329;1;1;
/org.eclipse.jdt.debug/jdi interfaces/com/sun/jdi/ArrayType.java;2;0;2;1;0;0;0;2;10;1;2;2704;10;10;1;0;0;2;2;2704;0;3033;2;2;
/org.eclipse.ui/Eclipse UI Text Editor/org/eclipse/ui/texteditor/ITextEditorExtension.java;2;1;6;1;4;4;4;2;49;1;2;2017;100;100;1;0;0;2;6;2017;0;4838;6;2;
/org.eclipse.jdt.ui.tests.refactoring/test cases/org/eclipse/jdt/ui/tests/refactoring/AllTests.java;2;0;6;1;0;0;0;6;13;1;6;1896;21;21;1;0;0;6;6;1896;0;2583;6;2;
/org.eclipse.help.ui/src/org/eclipse/help/internal/ui/win32/BrowserFactory.java;2;0;2;1;0;0;0;2;0;1;2;1420;0;0;1;0;0;2;2;1420;0;3030;2;2;
/org.eclipse.jdt.ui/core extension/org/eclipse/jdt/internal/corext/template/TemplateTranslator.java;2;0;2;1;1;1;1;1;2;0;1;2784;2;2;1;0;0;1;2;2784;0;4400;2;2;
/org.eclipse.jdt.ui/ui/org/eclipse/jdt/internal/ui/wizards/buildpaths/ZipLabelProvider.java;1;0;1;1;0;0;0;1;0;0;1;1258;0;0;1;0;0;1;1;1258;0;1258;1;1;
/org.eclipse.jdt.ui.tests/ui/org/eclipse/jdt/ui/tests/TypeHierarchyTest.java;2;0;4;1;0;0;0;4;6;2;3;522;9;9;2;1;0;4;4;1186;1;1186;3;2;
/org.eclipse.search/search/org/eclipse/search/internal/workingsets/WorkingSetMessages.java;1;0;3;1;0;0;0;3;3;1;3;1737;3;3;1;0;0;3;3;1737;0;3849;3;1;
/org.eclipse.jdt.core/compiler/org/eclipse/jdt/internal/compiler/problem/ProblemReporter.java;4;1;45;2;4;4;4;41;4697;5;30;455;6814;6814;5;11;0;41;45;3080;11;4419;34;4;
/org.eclipse.core.boot/src/org/eclipse/core/internal/boot/PlatformURLConfigurationConnection.java;3;0;3;1;0;0;0;3;15;1;3;23;15;15;1;0;0;3;3;23;0;2726;3;3;
/org.eclipse.jdt.ui.tests.refactoring/resources/MoveMembers/testFail13/in/B.java;1;0;1;1;0;0;0;1;0;0;1;2738;0;0;1;0;0;1;1;2738;0;2738;1;1;
/org.eclipse.update.core/src/org/eclipse/update/internal/security/KeyStores.java;1;0;6;1;1;1;1;5;136;1;5;3122;202;202;1;0;0;5;6;3122;0;4104;6;1;
/org.eclipse.ui/Eclipse UI Standard Components/org/eclipse/ui/views/properties/IPropertySourceProvider.java;2;0;2;1;0;0;0;2;5;1;2;257;5;5;1;0;0;2;2;257;0;457;2;2;
/org.eclipse.update/src/org/eclipse/update/internal/ui/UMApplicationUserInterface.java;1;0;1;1;0;0;0;1;0;0;1;1424;0;0;1;0;0;1;1;1424;0;1424;1;1;
/org.eclipse.ui/Eclipse UI/org/eclipse/ui/internal/WorkingSetFactory.java;1;0;4;1;0;0;0;4;57;1;4;3402;68;68;1;0;0;4;4;3402;0;3870;4;1;
/org.eclipse.ant.ui/src/org/eclipse/ant/internal/ui/AntClasspathPreferencePage.java;1;0;1;1;0;0;0;1;0;0;1;3437;0;0;1;0;0;1;1;3437;0;3437;1;1;
/org.eclipse.jdt.debug.ui/ui/org/eclipse/jdt/internal/debug/ui/launcher/RuntimeClasspathViewer.java;1;1;6;1;5;5;5;1;25;0;1;3875;68;68;1;0;0;1;6;3875;0;4224;6;1;
/org.eclipse.jdt.ui/core extension/org/eclipse/jdt/internal/corext/dom/ASTNodes.java;3;2;10;2;4;3;4;6;55;1;6;3106;152;152;2;0;1;6;10;4382;1;4421;9;3;
/org.eclipse.swt.tests/JUnit Tests/org/eclipse/swt/tests/junit/Test_org_eclipse_swt_widgets_Widget.java;2;0;2;1;1;1;1;1;6;0;1;1792;6;6;1;0;0;1;2;1792;0;4706;2;2;
/org.eclipse.swt/Eclipse SWT Drag and Drop/motif/org/eclipse/swt/dnd/FileTransfer.java;3;1;8;1;6;6;6;2;78;1;2;106;215;215;1;0;0;2;8;106;0;4824;8;3;
/org.eclipse.pde.ui/src/org/eclipse/pde/internal/ui/editor/build/BuildPropertiesEditor.java;1;1;5;1;2;2;2;3;190;2;2;3579;230;230;2;1;0;3;5;3579;1;4545;4;1;
/org.eclipse.jdt.debug/eval/org/eclipse/jdt/internal/debug/eval/model/IVariable.java;2;0;2;1;0;0;0;2;0;1;2;3555;0;0;1;0;0;2;2;3555;0;3645;2;2;
/org.eclipse.jdt.junit/Eclipse JUnit/org/eclipse/jdt/internal/junit/oldlauncher/JUnitLaunchWizardPage.java;2;0;2;1;0;0;0;2;0;1;2;2861;0;0;1;0;0;2;2;2861;0;3205;2;2;
/org.eclipse.jdt.ui.tests.refactoring/resources/ReorderParameters/canReorder/A_test17_in.java;1;0;1;1;0;0;0;1;0;0;1;2296;0;0;1;0;0;1;1;2296;0;2296;1;1;
/org.eclipse.update.ui/src/org/eclipse/update/internal/transform/TransformManager.java;1;0;2;1;0;0;0;2;0;1;2;1526;0;0;1;0;0;2;2;1526;0;1596;2;1;
/org.eclipse.core.runtime/src/org/eclipse/core/runtime/model/LibraryModel.java;4;0;7;1;1;1;1;6;236;1;6;12;399;399;1;0;0;6;7;12;0;4214;7;4;
/org.eclipse.scripting/src/org/eclipse/scripting/internal/uirenderer/XGRElementUISwtComboBox.java;1;0;1;1;0;0;0;1;0;0;1;1424;0;0;1;0;0;1;1;1424;0;1424;1;1;
/org.eclipse.swt/Eclipse SWT/carbon/org/eclipse/swt/widgets/ToolBar.java;4;1;5;1;5;5;5;0;32;0;0;4147;45;45;1;0;0;0;5;4147;0;4701;5;4;
/org.eclipse.jdt.core/dom/org/eclipse/jdt/core/dom/IPackageBinding.java;2;0;2;1;0;0;0;2;2;1;2;2669;2;2;1;0;0;2;2;2669;0;2702;2;2;
/org.eclipse.jdt.ui/core refactoring/org/eclipse/jdt/internal/corext/refactoring/TextUtilities.java;1;0;2;1;0;0;0;2;0;1;2;1939;0;0;1;0;0;2;2;1939;0;2216;2;1;
/org.eclipse.jdt.ui.tests/JUnit/junit/samples/SimpleTest.java;2;0;2;1;0;0;0;2;0;1;2;49;0;0;1;0;0;2;2;49;0;1186;2;2;
/org.eclipse.help.ui/Eclipse Help UI/org/eclipse/help/internal/ui/DefaultHelp.java;4;0;10;1;0;0;0;10;43;1;10;136;84;84;1;0;0;10;10;136;0;1420;10;4;
/org.eclipse.jdt.launching/launching/org/eclipse/jdt/launching/IRuntimeClasspathEntry.java;1;2;15;1;13;10;13;2;58;0;1;3856;243;243;2;1;3;2;15;3856;4;4650;11;1;
/org.eclipse.pde.ui/Eclipse PDE UI/org/eclipse/pde/internal/base/schema/ISchemaAttribute.java;2;0;5;2;0;0;0;5;12;3;3;267;12;12;3;2;0;5;5;324;2;1434;3;2;
/org.eclipse.jdt.ui.tests.refactoring/resources/StructureSelectionAction/A_test24.java;1;0;1;1;0;0;0;1;0;0;1;3226;0;0;1;0;0;1;1;3226;0;3226;1;1;
/org.eclipse.jdt.ui.tests.refactoring/resources/RenamePackage/testFail11/in/p/A.java;2;0;2;1;0;0;0;2;0;1;2;91;0;0;1;0;0;2;2;91;0;1258;2;2;
/org.eclipse.team.cvs.core/src/org/eclipse/team/internal/ccvs/core/commands/Checkout.java;3;0;6;1;0;0;0;6;190;1;6;1978;348;348;1;0;0;6;6;1978;0;2607;6;3;
/org.eclipse.core.tests.runtime/src/org/eclipse/core/tests/internal/plugins/FragmentResolveTest_1.java;3;0;4;1;0;0;0;4;746;1;4;1819;763;763;1;0;0;4;4;1819;0;3476;4;3;
/org.eclipse.pde.build/src/plugin/org/eclipse/pde/internal/core/ant/FileSet.java;1;0;1;1;0;0;0;1;0;0;1;3475;0;0;1;0;0;1;1;3475;0;3475;1;1;
/org.eclipse.swt/Eclipse SWT/motif/org/eclipse/swt/internal/motif/XmAnyCallbackStruct.java;2;0;3;1;0;0;0;3;4;1;3;106;4;4;1;0;0;3;3;106;0;2069;3;2;
/org.eclipse.team.cvs.core/src/org/eclipse/team/internal/ccvs/core/util/ProjectDescriptionManager.java;3;0;16;1;1;1;1;15;395;2;13;1978;763;763;2;2;0;15;16;2460;2;4632;14;3;
/org.eclipse.jdt.ui.tests.refactoring/resources/ExtractMethodWorkSpace/ExtractMethodTests/locals_in/A_test551.java;1;1;3;1;2;2;2;1;24;0;1;1236;24;24;1;0;0;1;3;1236;0;4419;3;1;
/org.eclipse.team.ftp/src/org/eclipse/team/internal/ftp/client/FTPFileNotAvailableException.java;1;1;2;1;2;2;2;0;0;0;0;4169;0;0;1;0;0;0;2;4169;0;4327;2;1;
/org.eclipse.swt.examples.paint/org/eclipse/swt/examples/paint/AirbrushTool.java;3;0;4;2;1;1;1;3;114;2;2;513;114;114;2;1;0;3;4;609;1;4024;3;3;
/org.eclipse.jdt.ui/ui/org/eclipse/jdt/internal/ui/wizards/NewSnippetFileCreationWizard.java;1;0;2;1;0;0;0;2;4;1;2;1342;4;4;1;0;0;2;2;1342;0;3089;2;1;
/org.eclipse.pde.ui/src/org/eclipse/pde/internal/ui/editor/XMLDoubleClickStrategy.java;1;0;2;1;0;0;0;2;125;1;2;3579;125;125;1;0;0;2;2;3579;0;3636;2;1;
/org.eclipse.help/src/org/eclipse/help/internal/server/PluginURL.java;3;0;10;2;0;0;0;10;63;2;9;1420;139;139;2;1;0;10;10;2319;1;3095;9;3;
/org.eclipse.scripting/Eclipse Scripting/org/eclipse/scripting/internal/ScriptLanguageDescriptor.java;1;0;3;1;0;0;0;3;4;1;3;133;4;4;1;0;0;3;3;133;0;1424;3;1;
/org.eclipse.jdt.ui/ui/org/eclipse/jdt/internal/ui/text/javadoc/SingleCharReader.java;2;0;4;1;0;0;0;4;12;1;4;15;17;17;1;0;0;4;4;15;0;1670;4;2;
/org.eclipse.ui/Eclipse JFace Text/org/eclipse/jface/text/IAutoIndentStrategy.java;3;0;3;1;0;0;0;3;5;1;3;257;9;9;1;0;0;3;3;257;0;1066;3;3;
/org.eclipse.jdt.core/dom/org/eclipse/jdt/core/dom/IBinding.java;2;0;4;1;1;1;1;3;2;1;3;2669;6;6;1;0;0;3;4;2669;0;4058;4;2;
/org.eclipse.ui/Eclipse UI Standard Components/org/eclipse/ui/views/bookmarkexplorer/OpenBookmarkAction.java;4;0;8;1;0;0;0;8;38;2;7;257;60;60;2;1;0;8;8;2590;1;3739;7;4;
/org.eclipse.swt/Eclipse SWT/carbon/org/eclipse/swt/widgets/TabItem.java;3;1;4;1;4;4;4;0;10;0;0;4305;21;21;1;0;0;0;4;4305;0;4701;4;3;
/org.eclipse.jdt.ui.tests.refactoring/resources/RenameParameters/canRename/A_test16_out.java;1;0;1;1;0;0;0;1;0;0;1;233;0;0;1;0;0;1;1;233;0;233;1;1;
/org.eclipse.ui/Eclipse JFace Text/org/eclipse/jface/text/rules/WhitespaceRule.java;3;0;3;1;0;0;0;3;5;1;3;257;8;8;1;0;0;3;3;257;0;1066;3;3;
/org.eclipse.jdt.ui.tests.refactoring/resources/ExtractMethodWorkSpace/ExtractMethodTests/return_in/A_test726.java;1;1;3;1;2;2;2;1;40;0;1;2684;40;40;1;0;0;1;3;2684;0;4419;3;1;
/org.eclipse.ui/Eclipse JFace Text/org/eclipse/jface/text/rules/IPartitionTokenScanner.java;1;0;2;1;1;1;1;1;34;0;1;3812;34;34;1;0;0;1;2;3812;0;4838;2;1;
/org.eclipse.jdt.launching/launching/org/eclipse/jdt/launching/VMRunner.java;1;0;2;1;0;0;0;2;6;1;2;3092;6;6;1;0;0;2;2;3092;0;3122;2;1;
/org.eclipse.ui/Eclipse UI/org/eclipse/ui/WorkingSetFilter.java;1;0;1;1;0;0;0;1;0;0;1;3287;0;0;1;0;0;1;1;3287;0;3287;1;1;
/org.eclipse.pde.ui/src/org/eclipse/pde/internal/elements/TreeContentProvider.java;2;0;2;1;0;0;0;2;0;1;2;1434;0;0;1;0;0;2;2;1434;0;3579;2;2;
/org.eclipse.jdt.ui/core refactoring/org/eclipse/jdt/internal/core/refactoring/rename/ParameterOffsetFinder.java;2;0;3;1;0;0;0;3;30;1;3;1342;30;30;1;0;0;3;3;1342;0;1939;3;2;
/org.eclipse.jdt.debug/jdi/org/eclipse/jdi/internal/jdwp/JdwpFieldID.java;2;0;3;1;0;0;0;3;12;1;3;187;13;13;1;0;0;3;3;187;0;3040;3;2;
/org.eclipse.jdt.ui.tests.refactoring/resources/RenamePackage/test3/in/p/r/B.java;2;0;2;1;0;0;0;2;0;1;2;91;0;0;1;0;0;2;2;91;0;1258;2;2;
/org.eclipse.ui/Eclipse UI/org/eclipse/ui/internal/misc/ResourceAndContainerGroup.java;5;0;8;1;1;1;1;7;39;1;7;257;92;92;1;0;0;7;8;257;0;3899;8;5;
/org.eclipse.jdt.debug.tests/testprograms/EvalSimpleTests.java;2;1;2;1;2;2;2;0;70;0;0;4447;70;70;1;0;0;0;2;4447;0;4571;2;2;
/org.eclipse.jdt.core/dom/org/eclipse/jdt/core/dom/FieldDeclaration.java;3;1;11;2;2;2;2;9;19;2;7;2669;68;68;2;2;0;9;11;2877;2;4453;9;3;
/org.eclipse.jdt.ui/ui refactoring/org/eclipse/jdt/internal/ui/refactoring/actions/NewOpenRefactoringWizardAction.java;1;0;2;1;0;0;0;2;0;1;2;3754;0;0;1;0;0;2;2;3754;0;3791;2;1;
/org.eclipse.jdt.debug/jdi interfaces/com/sun/jdi/ShortType.java;2;0;2;1;0;0;0;2;6;1;2;2704;6;6;1;0;0;2;2;2704;0;3033;2;2;
/org.eclipse.core.resources/src/org/eclipse/core/internal/indexing/IndexAnchor.java;3;1;7;1;2;2;2;5;454;1;5;12;876;876;1;0;0;5;7;12;0;4632;7;3;
/org.eclipse.swt/Eclipse SWT PI/gtk/org/eclipse/swt/internal/gtk/GtkCTreeRow.java;2;0;5;1;2;1;2;3;9;1;3;2107;25;25;2;0;1;3;5;4701;1;4701;4;2;
/org.eclipse.jdt.ui.tests/refactoring/org/eclipse/jdt/refactoring/tests/RefactoringScannerTests.java;2;0;2;1;0;0;0;2;0;1;2;1547;0;0;1;0;0;2;2;1547;0;1896;2;2;
/org.eclipse.ui/Eclipse UI/org/eclipse/ui/internal/dialogs/PropertyPageManager.java;2;0;2;1;0;0;0;2;5;1;2;257;5;5;1;0;0;2;2;257;0;457;2;2;
/org.eclipse.swt.tests/JUnit Tests/org/eclipse/swt/tests/junit/Test_org_eclipse_swt_custom_TableEditor.java;2;0;2;1;1;1;1;1;6;0;1;1792;6;6;1;0;0;1;2;1792;0;4706;2;2;
/org.eclipse.jdt.ui/core refactoring/org/eclipse/jdt/internal/core/refactoring/sef/EncapsulateReadAccess.java;1;0;6;1;0;0;0;6;29;2;5;1453;45;45;2;1;0;6;6;1937;1;1937;5;1;
/org.eclipse.jdt.ui.tests.refactoring/resources/SefWorkSpace/SefTests/base_out/TestPrefixBoolean.java;1;0;1;1;0;0;0;1;0;0;1;2876;0;0;1;0;0;1;1;2876;0;2876;1;1;
/org.eclipse.update.core/src/org/eclipse/update/internal/core/FeaturePackagedContentProvider.java;2;1;32;2;7;7;7;25;287;4;21;2448;1289;1289;4;4;0;25;32;2583;4;4433;28;2;
/org.eclipse.jdt.ui/ui/org/eclipse/jdt/internal/ui/wizards/buildpaths/BuildPathsBlock.java;5;2;77;2;13;11;13;64;267;3;50;15;2034;2034;3;14;2;64;77;172;16;4621;61;5;
/org.eclipse.ui/Eclipse UI Standard Components/org/eclipse/ui/views/properties/CopyPropertyAction.java;1;0;1;1;0;0;0;1;0;0;1;3091;0;0;1;0;0;1;1;3091;0;3091;1;1;
/org.eclipse.ui/Eclipse JFace Text/org/eclipse/jface/text/TextViewerHoverManager.java;2;2;10;1;7;6;7;3;101;1;3;1435;210;210;2;0;1;3;10;4377;1;4853;9;2;
/org.eclipse.pde.ui/Eclipse PDE UI/org/eclipse/pde/internal/editor/schema/AttributePropertySource.java;2;0;6;2;0;0;0;6;12;3;4;267;13;13;3;2;0;6;6;324;2;1434;4;2;
/org.eclipse.core.tests.resources/src/org/eclipse/core/tests/internal/indexing/BasicPageStoreTest.java;3;0;4;1;1;1;1;3;650;1;3;1794;662;662;1;0;0;3;4;1794;0;4516;4;3;
/org.eclipse.jdt.core/model/org/eclipse/jdt/internal/core/eval/EvaluationContextWrapper.java;3;2;29;1;3;2;3;26;550;4;21;455;1127;1127;4;5;1;26;29;1039;6;4063;23;3;
/org.eclipse.swt/Eclipse SWT/gtk/org/eclipse/swt/widgets/List.java;6;3;27;2;11;9;11;16;1211;3;13;2107;2058;2058;3;3;2;16;27;3471;5;4701;22;6;
/org.eclipse.pde.ui/templates/multiPageEditor/java/$contributorClassName$.java;1;0;1;1;0;0;0;1;0;0;1;3442;0;0;1;0;0;1;1;3442;0;3442;1;1;
/org.eclipse.ui.examples.javaeditor/Eclipse Java Editor Example/org/eclipse/ui/examples/javaeditor/java/JavaPartitionScanner.java;1;0;1;1;0;0;0;1;0;0;1;1067;0;0;1;0;0;1;1;1067;0;1067;1;1;
/org.eclipse.team.cvs.ui/src/org/eclipse/team/internal/ccvs/ui/model/CVSRepositoryRootElement.java;2;0;4;1;0;0;0;4;4;1;4;2126;9;9;1;0;0;4;4;2126;0;3610;4;2;
/org.eclipse.jdt.ui/ui/org/eclipse/jdt/internal/ui/javaeditor/EvaluateAction.java;1;0;5;1;0;0;0;5;78;1;5;15;107;107;1;0;0;5;5;15;0;345;5;1;
/org.eclipse.ui/Eclipse JFace Text/org/eclipse/jface/text/IDocumentAdapterExtension.java;1;1;2;1;2;2;2;0;25;0;0;4423;25;25;1;0;0;0;2;4423;0;4838;2;1;
/org.eclipse.jdt.debug/jdi/org/eclipse/jdi/internal/connect/PacketReceiveManager.java;2;0;4;1;0;0;0;4;17;1;4;187;33;33;1;0;0;4;4;187;0;3677;4;2;
/org.eclipse.ui/Eclipse JFace/org/eclipse/jface/viewers/ComboBoxCellEditor.java;4;0;6;1;1;1;1;5;13;1;5;257;27;27;1;0;0;5;6;257;0;4211;6;4;
/org.eclipse.jdt.ui/ui/org/eclipse/jdt/internal/ui/JavaPlugin.java;11;4;67;2;13;8;13;54;70;2;46;15;725;725;4;8;5;54;67;4139;13;4621;54;11;
/org.eclipse.vcm.core.cvs/src/org/eclipse/vcm/internal/core/ccvs/CatchupEntryIterator.java;2;0;3;1;0;0;0;3;16;1;3;0;21;21;1;0;0;3;3;0;0;298;3;2;
/org.eclipse.team.cvs.ui/src/org/eclipse/team/internal/ccvs/ui/actions/IgnoreAction.java;2;0;6;2;1;1;1;5;30;1;5;2866;77;77;1;0;0;5;6;2866;0;4021;6;2;
/org.eclipse.ui/Eclipse UI Standard Components/org/eclipse/ui/views/navigator/GotoActionContributionFactory.java;1;0;2;1;0;0;0;2;0;1;2;1726;0;0;1;0;0;2;2;1726;0;1757;2;1;
/org.eclipse.jdt.ui.tests.refactoring/resources/ExtractMethodWorkSpace/ExtractMethodTests/validSelection/A_test302.java;2;1;3;1;2;2;2;1;0;0;1;49;0;0;1;0;0;1;3;49;0;4419;3;2;
/org.eclipse.jdt.ui.tests.refactoring/resources/InlineTemp/canInline/A_test0_out.java;1;0;1;1;0;0;0;1;0;0;1;2015;0;0;1;0;0;1;1;2015;0;2015;1;1;
/org.eclipse.jdt.ui.tests.refactoring/resources/SelectionAnalyzerWorkSpace/SelectionAnalyzerTests/validSelection/A_test240.java;1;0;1;1;0;0;0;1;0;0;1;1368;0;0;1;0;0;1;1;1368;0;1368;1;1;
/org.eclipse.ui/Eclipse UI/org/eclipse/ui/internal/dialogs/WelcomeDialog.java;2;0;2;1;0;0;0;2;0;1;2;257;0;0;1;0;0;2;2;257;0;457;2;2;
/org.eclipse.ui.tests/Eclipse UI Tests/org/eclipse/ui/tests/api/IEditorPartTest.java;2;0;3;1;0;0;0;3;2;1;3;1453;4;4;1;0;0;3;3;1453;0;2785;3;2;
/org.eclipse.debug.core/core/org/eclipse/debug/core/Launch.java;4;1;24;2;3;3;3;21;239;2;18;187;705;705;2;3;0;21;24;1724;3;4650;21;4;
/org.eclipse.core.boot/src/org/eclipse/core/internal/boot/update/IUMRegistry.java;2;0;4;1;0;0;0;4;37;1;4;12;44;44;1;0;0;4;4;12;0;2726;4;2;
/org.eclipse.jdt.debug/jdi/org/eclipse/jdi/internal/event/VMDisconnectEventImpl.java;2;0;4;1;0;0;0;4;16;1;4;187;30;30;1;0;0;4;4;187;0;3670;4;2;
/org.eclipse.update.ui/src/org/eclipse/update/ui/internal/UpdateUIPluginImages.java;1;0;2;1;0;0;0;2;0;0;1;1426;0;0;2;1;0;2;2;1426;1;1426;1;1;
/org.eclipse.jdt.ui/ui/org/eclipse/jdt/ui/actions/FindWriteReferencesInHierarchyAction.java;3;1;3;1;3;3;3;0;9;0;0;4141;13;13;1;0;0;0;3;4141;0;4770;3;3;
/org.eclipse.jdt.ui.tests.refactoring/resources/ExtractMethodWorkSpace/ExtractMethodTests/locals_in/A_test507.java;2;1;4;1;2;2;2;2;20;1;2;80;36;36;1;0;0;2;4;80;0;4419;4;2;
/org.eclipse.pde.ui/src/org/eclipse/pde/internal/ui/wizards/extension/NewSchemaFileWizard.java;1;0;1;1;0;0;0;1;0;0;1;3579;0;0;1;0;0;1;1;3579;0;3579;1;1;
/org.eclipse.swt.examples.paint/org/eclipse/swt/examples/paint/MetaLine.java;1;0;1;1;0;0;0;1;0;0;1;513;0;0;1;0;0;1;1;513;0;513;1;1;
/org.eclipse.ui/Eclipse UI/org/eclipse/ui/internal/SaveAllAction.java;5;1;9;1;2;2;2;7;47;2;6;257;123;123;2;1;0;7;9;3212;1;4082;8;5;
/org.eclipse.vcm.ui.cvs/src/org/eclipse/vcm/internal/ui/ccvs/DefineVersionDialog.java;1;0;2;1;0;0;0;2;215;1;2;663;215;215;1;0;0;2;2;663;0;1240;2;1;
/org.eclipse.jdt.ui.tests.refactoring/resources/RenameMethodInInterface/test0/out/A.java;1;0;1;1;0;0;0;1;0;0;1;49;0;0;1;0;0;1;1;49;0;49;1;1;
/org.eclipse.core.tests.resources/src/org/eclipse/core/tests/resources/session/Test1GALH44.java;1;0;2;1;0;0;0;2;11;1;2;3287;11;11;1;0;0;2;2;3287;0;3475;2;1;
/org.eclipse.help.ui/src/org/eclipse/help/internal/ui/IHyperlinkListener.java;2;0;3;1;1;1;1;2;2;1;2;1420;2;2;1;0;0;2;3;1420;0;4439;3;2;
/org.eclipse.jdt.ui.tests.refactoring/resources/StructureSelectionAction/A_test6.java;1;0;1;1;0;0;0;1;0;0;1;2139;0;0;1;0;0;1;1;2139;0;2139;1;1;
/org.eclipse.help/src/org/eclipse/help/internal/topics/NavigationElement.java;2;0;4;1;0;0;0;4;42;1;4;1675;43;43;1;0;0;4;4;1675;0;1857;4;2;
/org.eclipse.scripting/Eclipse Scripting/org/eclipse/scripting/IToolkit.java;2;0;4;1;0;0;0;4;14;1;4;133;18;18;1;0;0;4;4;133;0;1424;4;2;
/org.eclipse.jdt.ui.tests.refactoring/resources/PullUpMethods/testFail9/in/B.java;1;0;2;1;0;0;0;2;0;1;2;2156;0;0;1;0;0;2;2;2156;0;2406;2;1;
/org.eclipse.jdt.debug/jdi/org/eclipse/jdi/internal/event/EventQueueImpl.java;2;0;4;1;0;0;0;4;20;1;4;187;34;34;1;0;0;4;4;187;0;3670;4;2;
/org.eclipse.team.cvs.core/src/org/eclipse/team/internal/ccvs/core/resources/NotCVSFolderException.java;1;0;2;1;0;0;0;2;0;1;2;2156;0;0;1;0;0;2;2;2156;0;3089;2;1;
/org.eclipse.jdt.ui.tests.refactoring/resources/RenamePrivateMethod/test18/in/C.java;1;0;1;1;0;0;0;1;0;0;1;49;0;0;1;0;0;1;1;49;0;49;1;1;
/org.eclipse.swt.examples.launcher/org/eclipse/swt/examples/launcher/ViewLaunchDelegate.java;3;0;3;1;0;0;0;3;23;1;3;513;23;23;1;0;0;3;3;513;0;3690;3;3;
/org.eclipse.core.resources/src/org/eclipse/core/internal/resources/MarkerSet.java;2;0;7;1;1;1;1;6;386;1;6;12;443;443;1;0;0;6;7;12;0;4213;7;2;
/org.eclipse.jdt.ui.tests.refactoring/test cases/org/eclipse/jdt/ui/nls/tests/NLSElementTester.java;1;0;2;1;0;0;0;2;0;1;2;1939;0;0;1;0;0;2;2;1939;0;2015;2;1;
/org.eclipse.help/src/org/eclipse/help/internal/toc/ITocNode.java;2;0;2;1;0;0;0;2;2;1;2;1857;2;2;1;0;0;2;2;1857;0;3609;2;2;
/org.eclipse.webdav/src/interface/org/eclipse/webdav/Locator.java;3;0;3;1;0;0;0;3;12;1;3;12;12;12;1;0;0;3;3;12;0;1874;3;3;
/org.eclipse.swt/Eclipse SWT/carbon/org/eclipse/swt/widgets/Composite.java;4;2;6;1;6;5;6;0;65;0;0;4147;94;94;2;0;1;0;6;4605;1;4701;5;4;
/org.eclipse.pde.ui/src/org/eclipse/pde/internal/ui/wizards/templates/PerspectiveExtensionsNewWizard.java;1;0;3;1;0;0;0;3;8;1;3;3812;9;9;1;0;0;3;3;3812;0;3870;3;1;
/org.eclipse.update.core/src/org/eclipse/update/core/Copy_2_of_ISiteChangedListener.java;1;0;2;1;0;0;0;2;0;0;1;1863;0;0;2;1;0;2;2;1863;1;1863;1;1;
/org.eclipse.ui/Eclipse UI Text Editor/org/eclipse/ui/texteditor/StatusLineContributionItem.java;1;1;5;1;2;2;2;3;47;1;3;2017;57;57;1;0;0;3;5;2017;0;4838;5;1;
/org.eclipse.ui/Eclipse UI Standard Components/org/eclipse/ui/views/navigator/CopyFilesAndFoldersOperation.java;3;0;5;1;2;1;2;3;8;1;3;2830;16;16;2;0;1;3;5;4207;1;4207;4;3;
/org.eclipse.team.cvs.core/src/org/eclipse/team/internal/ccvs/core/resources/api/IManagedVisitor.java;2;0;2;1;0;0;0;2;0;1;2;1978;0;0;1;0;0;2;2;1978;0;2156;2;2;
/org.eclipse.jdt.debug/eval/org/eclipse/jdt/internal/debug/eval/ast/engine/PushFieldVariable.java;1;0;3;1;0;0;0;3;154;1;3;3329;154;154;1;0;0;3;3;3329;0;3421;3;1;
/org.eclipse.team.cvs.ui/src/org/eclipse/team/internal/ccvs/ui/actions/RemoveRootAction.java;3;1;13;1;3;3;3;10;38;1;10;1997;126;126;1;0;0;10;13;1997;0;4569;13;3;
/org.eclipse.update.core/src/org/eclipse/update/core/IFeatureVerification.java;1;0;2;1;0;0;0;2;0;1;2;3122;0;0;1;0;0;2;2;3122;0;3255;2;1;
/org.eclipse.team.cvs.core/src/org/eclipse/team/internal/ccvs/core/ICVSRemoteResource.java;3;0;11;2;1;1;1;10;96;2;9;2049;214;214;2;1;0;10;11;2049;1;4081;10;3;
/org.eclipse.jdt.ui/ui/org/eclipse/jdt/internal/ui/snippeteditor/ScrapbookEventFilter.java;3;0;8;1;0;0;0;8;25;1;8;15;47;47;1;0;0;8;8;15;0;1916;8;3;
/org.eclipse.jdt.ui/ui/org/eclipse/jdt/internal/ui/JavaUIException.java;1;0;2;1;0;0;0;2;8;1;2;15;8;8;1;0;0;2;2;15;0;329;2;1;
/org.eclipse.jdt.core/compiler/org/eclipse/jdt/internal/compiler/codegen/AttributeNamesConstants.java;2;0;4;1;1;1;1;3;59;1;3;455;83;83;1;0;0;3;4;455;0;4062;4;2;
/org.eclipse.jdt.ui/ui/org/eclipse/jdt/internal/ui/browsing/LexicalSortingAction.java;2;1;4;1;2;2;2;2;17;1;2;3378;25;25;1;0;0;2;4;3378;0;4630;4;2;
/org.eclipse.pde.ui/src/org/eclipse/pde/internal/ui/editor/build/BuildForm.java;1;0;2;1;0;0;0;2;8;0;1;3579;8;8;2;1;0;2;2;3579;1;3579;1;1;
/org.eclipse.update.ui/src/org/eclipse/update/internal/ui/forms/CategoryForm.java;2;2;5;2;3;2;3;2;34;1;2;3662;40;40;2;0;1;2;5;4606;1;4606;4;2;
/org.eclipse.core.tests.resources/src/org/eclipse/core/tests/internal/builders/TestBuilder.java;3;0;7;2;0;0;0;7;283;2;5;1794;323;323;2;2;0;7;7;3400;2;3419;5;3;
/org.eclipse.pde.ui/src/org/eclipse/pde/internal/editor/jars/LibrarySection.java;2;0;3;1;0;0;0;3;2;1;3;1434;2;2;1;0;0;3;3;1434;0;2650;3;2;
/org.eclipse.jdt.ui/ui/org/eclipse/jdt/internal/ui/text/correction/ASTResolving.java;2;0;11;1;1;1;1;10;143;2;9;3507;316;316;2;1;0;10;11;3759;1;4021;10;2;
/org.eclipse.swt/Eclipse SWT Accessibility/common/org/eclipse/swt/accessibility/ACC.java;2;0;6;1;1;1;1;5;137;2;4;3007;190;190;2;1;0;5;6;3007;1;4701;5;2;
/org.eclipse.pde.build/src/org/eclipse/pde/internal/build/JDTCompilerAdapter.java;5;0;8;1;0;0;0;8;208;1;8;245;221;221;1;0;0;8;8;245;0;3509;8;5;
/org.eclipse.swt.examples/src/org/eclipse/swt/examples/controlexample/DialogTab.java;4;1;7;1;2;2;2;5;762;1;5;513;1278;1278;1;0;0;5;7;513;0;4705;7;4;
/org.eclipse.jdt.debug.ui/ui/org/eclipse/jdt/internal/debug/ui/display/DisplayResultCollector.java;1;0;3;1;0;0;0;3;21;2;2;2620;21;21;2;1;0;3;3;2620;1;3517;2;1;
/org.eclipse.pde.ui/Eclipse PDE UI/org/eclipse/pde/internal/base/model/component/IComponentFragment.java;2;0;5;2;0;0;0;5;12;3;3;267;12;12;3;2;0;5;5;324;2;1434;3;2;
/org.eclipse.jdt.core/model/org/eclipse/jdt/internal/core/builder/impl/NewBuilderType.java;1;0;11;1;0;0;0;11;84;4;7;455;110;110;4;4;0;11;11;1039;4;2808;7;1;
/org.eclipse.swt.examples/src/org/eclipse/swt/examples/helloworld/HelloWorld1.java;4;0;5;1;1;1;1;4;26;1;4;513;70;70;1;0;0;4;5;513;0;4705;5;4;
/org.eclipse.jdt.ui/ui refactoring/org/eclipse/jdt/internal/ui/refactoring/PullUpTreeViewer.java;2;0;5;1;1;1;1;4;39;1;4;2406;56;56;1;0;0;4;5;2406;0;4039;5;2;
/org.eclipse.jdt.ui/core refactoring/org/eclipse/jdt/internal/core/refactoring/packages/RenameProjectRefactoring.java;1;0;1;1;0;0;0;1;0;0;1;988;0;0;1;0;0;1;1;988;0;988;1;1;
/org.eclipse.help/Eclipse Help/org/eclipse/help/internal/util/Resources.java;3;0;4;1;0;0;0;4;7;1;4;135;9;9;1;0;0;4;4;135;0;1420;4;3;
/org.eclipse.pde.ui/src/org/eclipse/pde/internal/ui/editor/schema/SchemaObjectPropertySource.java;1;0;2;1;0;0;0;2;2;1;2;3579;2;2;1;0;0;2;2;3579;0;3591;2;1;
/org.eclipse.pde.ui/Eclipse PDE UI/org/eclipse/pde/internal/base/model/IModelProviderEvent.java;2;0;6;2;0;0;0;6;12;3;4;267;18;18;3;2;0;6;6;324;2;1434;4;2;
/org.eclipse.jdt.ui/ui/org/eclipse/jdt/internal/ui/jarpackager/CheckboxTreeAndListGroup.java;3;0;14;1;0;0;0;14;80;2;13;320;254;254;2;1;0;14;14;3570;1;3591;13;3;
/org.eclipse.pde.ui/src/org/eclipse/pde/internal/ui/editor/manifest/NewDependencyWizard.java;1;0;1;1;0;0;0;1;0;0;1;3579;0;0;1;0;0;1;1;3579;0;3579;1;1;
/org.eclipse.search/search/org/eclipse/search/internal/ui/OpenFileSearchPageAction.java;1;2;3;1;3;2;3;0;38;0;0;4001;40;40;2;0;1;0;3;4001;1;4014;2;1;
/org.eclipse.ui/Eclipse UI/org/eclipse/ui/internal/dialogs/AboutFeaturesDialog.java;1;2;13;1;13;10;13;0;215;0;0;3980;648;648;2;0;3;0;13;4040;3;4637;10;1;
/org.eclipse.pde.ui/src/org/eclipse/pde/internal/pluginsview/PluginsViewSorter.java;1;0;2;1;0;0;0;2;0;1;2;2650;0;0;1;0;0;2;2;2650;0;2978;2;1;
/org.eclipse.compare/compare/org/eclipse/compare/internal/CompareMessages.java;1;0;1;1;0;0;0;1;0;0;1;2580;0;0;1;0;0;1;1;2580;0;2580;1;1;
/org.eclipse.vcm.ui/src/org/eclipse/vcm/internal/ui/wizards/VCMWizardPage.java;3;0;3;1;0;0;0;3;5;1;3;1;7;7;1;0;0;3;3;1;0;298;3;3;
/org.eclipse.vcm.ui/src/org/eclipse/vcm/internal/ui/IWorkbenchVCMConstants.java;5;0;21;2;0;0;0;21;44;2;17;1;127;127;2;4;0;21;21;239;4;1637;17;5;
/org.eclipse.jdt.debug.tests/tests/org/eclipse/jdt/debug/tests/CloseWorkbenchDecorator.java;1;0;2;1;0;0;0;2;0;1;2;3701;0;0;1;0;0;2;2;3701;0;3749;2;1;
/org.eclipse.jdt.ui.tests.refactoring/resources/InlineTemp/canInline/A_test13_in.java;1;0;2;1;0;0;0;2;2;1;2;2758;2;2;1;0;0;2;2;2758;0;3048;2;1;
/org.eclipse.swt/Eclipse SWT/photon/org/eclipse/swt/widgets/Display.java;8;1;26;2;7;7;7;19;489;2;15;106;1194;1194;2;4;0;19;26;621;4;4701;22;8;
/org.eclipse.core.boot/src/org/eclipse/core/internal/boot/update/Assert.java;2;0;2;1;0;0;0;2;0;1;2;12;0;0;1;0;0;2;2;12;0;323;2;2;
/org.eclipse.jdt.core/compiler/org/eclipse/jdt/internal/compiler/flow/FinallyFlowContext.java;2;0;6;1;1;1;1;5;105;1;5;455;244;244;1;0;0;5;6;455;0;4062;6;2;
/org.eclipse.jdt.ui.tests.refactoring/resources/RenameType/test0/out/A.java;1;0;2;1;0;0;0;2;0;1;2;49;0;0;1;0;0;2;2;49;0;522;2;1;
/org.eclipse.jdt.ui/ui/org/eclipse/jdt/ui/actions/GenerateActionGroup.java;5;2;23;1;18;15;18;5;104;1;5;3533;484;484;2;0;3;5;23;3894;3;4770;20;5;
/org.eclipse.debug.ui/ui/org/eclipse/debug/internal/ui/actions/DebugLastAction.java;3;1;3;1;3;3;3;0;14;0;0;4043;25;25;1;0;0;0;3;4043;0;4567;3;3;
/org.eclipse.swt/Eclipse SWT PI/gtk/org/eclipse/swt/internal/gtk/GtkCList.java;1;0;3;1;0;0;0;3;8;1;3;2107;8;8;1;0;0;3;3;2107;0;3869;3;1;
/org.eclipse.jdt.ui.tests.refactoring/resources/RenameMethodInInterface/test36/out/A.java;1;0;1;1;0;0;0;1;0;0;1;49;0;0;1;0;0;1;1;49;0;49;1;1;
/org.eclipse.ui.examples.javaeditor/Java Editor Example/org/eclipse/ui/examples/javaeditor/javadoc/JavaDocCompletionProcessor.java;1;0;2;1;0;0;0;2;0;0;1;1066;0;0;2;1;0;2;2;1066;1;1066;1;1;
/org.eclipse.compare/compare/org/eclipse/compare/internal/MergeViewerContentProvider.java;2;0;4;1;0;0;0;4;11;1;4;14;20;20;1;0;0;4;4;14;0;3064;4;2;
/org.eclipse.core.tests.resources/src/org/eclipse/core/tests/resources/session/TestCloseNoSave.java;2;0;6;1;0;0;0;6;114;2;5;2367;143;143;2;1;0;6;6;3415;1;3475;5;2;
/org.eclipse.core.tests.resources.saveparticipant/src/org/eclipse/core/tests/resources/saveparticipant/SaveManager2Test.java;3;0;4;1;0;0;0;4;314;1;4;1794;334;334;1;0;0;4;4;1794;0;3475;4;3;
/org.eclipse.ui/Eclipse UI/org/eclipse/ui/internal/PartPluginAction.java;4;0;5;1;0;0;0;5;21;1;5;257;36;36;1;0;0;5;5;257;0;2235;5;4;
/org.eclipse.jdt.core/compiler/org/eclipse/jdt/internal/compiler/ast/FieldReference.java;2;1;23;1;2;2;2;21;868;4;18;455;1794;1794;4;3;0;21;23;1039;3;4421;20;2;
/org.eclipse.team.cvs.ui/src/org/eclipse/team/internal/ccvs/ui/actions/UpdateAction.java;3;1;15;1;2;2;2;13;158;1;13;1978;248;248;1;0;0;13;15;1978;0;4021;15;3;
/org.eclipse.ui.tests/Eclipse UI Tests/org/eclipse/ui/tests/adaptable/TestAdaptableContentProvider.java;1;0;1;1;0;0;0;1;0;0;1;2863;0;0;1;0;0;1;1;2863;0;2863;1;1;
/org.eclipse.jdt.launching/launching/org/eclipse/jdt/launching/WorkspaceSourceLocator.java;2;0;4;1;0;0;0;4;13;1;4;2022;21;21;1;0;0;4;4;2022;0;3683;4;2;
/org.eclipse.team.cvs.core/src/org/eclipse/team/internal/ccvs/core/client/ModifiedFileSender.java;2;0;4;1;0;0;0;4;31;1;4;3023;37;37;1;0;0;4;4;3023;0;3610;4;2;
/org.eclipse.swt/Eclipse SWT/win32/org/eclipse/swt/internal/win32/TCITEM.java;2;0;3;1;0;0;0;3;5;1;3;106;5;5;1;0;0;3;3;106;0;2069;3;2;
/org.eclipse.ui/Eclipse UI/org/eclipse/ui/internal/PartSashContainer.java;3;0;7;2;2;1;2;5;58;1;5;257;108;108;2;0;1;5;7;4430;1;4430;6;3;
/org.eclipse.vcm.core/src/org/eclipse/vcm/internal/core/base/IResourceTree.java;1;0;1;1;0;0;0;1;0;0;1;55;0;0;1;0;0;1;1;55;0;55;1;1;
/org.eclipse.pde.core/src/org/eclipse/pde/internal/core/EclipseHomeInitializer.java;1;0;1;1;0;0;0;1;0;0;1;3618;0;0;1;0;0;1;1;3618;0;3618;1;1;
/org.eclipse.scripting/Eclipse Scripting/org/eclipse/scripting/internal/datamodels/XGRXmlSaxHandler.java;2;0;5;1;0;0;0;5;157;1;5;133;162;162;1;0;0;5;5;133;0;1424;5;2;
/org.eclipse.ui/Eclipse UI/org/eclipse/ui/actions/ActionContext.java;1;0;2;1;1;1;1;1;23;0;1;3451;23;23;1;0;0;1;2;3451;0;4170;2;1;
/org.eclipse.ui/Eclipse UI/org/eclipse/ui/internal/PageListenerList.java;3;0;3;1;1;1;1;2;12;1;2;257;17;17;1;0;0;2;3;257;0;4363;3;3;
/org.eclipse.jdt.ui.tests.refactoring/resources/RenameType/testFail43/in/A.java;1;0;1;1;0;0;0;1;0;0;1;49;0;0;1;0;0;1;1;49;0;49;1;1;
/org.eclipse.team.ui/src/org/eclipse/team/ui/ITeamDecorator.java;2;0;2;1;0;0;0;2;0;1;2;1978;0;0;1;0;0;2;2;1978;0;2513;2;2;
/org.eclipse.jdt.ui/core refactoring/org/eclipse/jdt/internal/core/refactoring/SimpleCountingCollector.java;1;0;2;1;0;0;0;2;0;1;2;15;0;0;1;0;0;2;2;15;0;47;2;1;
/org.eclipse.ui/Eclipse UI Standard Components/org/eclipse/ui/wizards/datatransfer/ImportOperation.java;6;0;8;1;0;0;0;8;39;1;8;257;155;155;1;0;0;8;8;257;0;3837;8;6;
/org.eclipse.jdt.ui.tests.refactoring/resources/MoveMembers/test18/out/A.java;1;0;1;1;0;0;0;1;0;0;1;2738;0;0;1;0;0;1;1;2738;0;2738;1;1;
/org.eclipse.jdt.ui/ui/org/eclipse/jdt/internal/ui/JavaElementProperties.java;3;0;5;1;0;0;0;5;9;1;5;15;21;21;1;0;0;5;5;15;0;2412;5;3;
/org.eclipse.jdt.ui.tests.refactoring/resources/RenameVariables/canRename/A_test6_out.java;1;0;2;1;0;0;0;2;0;1;2;724;0;0;1;0;0;2;2;724;0;1665;2;1;
/org.eclipse.pde.ui/src/org/eclipse/pde/internal/forms/FormText.java;2;0;2;1;0;0;0;2;0;1;2;1434;0;0;1;0;0;2;2;1434;0;2470;2;2;
/org.eclipse.jdt.debug/jdi/org/eclipse/jdi/internal/event/ClassPrepareEventImpl.java;2;0;4;1;0;0;0;4;20;1;4;187;36;36;1;0;0;4;4;187;0;3670;4;2;
/org.eclipse.ui/Eclipse UI/org/eclipse/ui/internal/misc/ContainerSelectionGroup.java;5;0;9;1;0;0;0;9;23;1;9;257;46;46;1;0;0;9;9;257;0;3844;9;5;
/org.eclipse.jdt.ui.tests.refactoring/resources/SafeDeleteType/testFail15/in/A.java;1;0;1;1;0;0;0;1;0;0;1;49;0;0;1;0;0;1;1;49;0;49;1;1;
/org.eclipse.jdt.ui.tests.refactoring/resources/RenamePackage/testFail9/in/r/A.java;1;0;1;1;0;0;0;1;0;0;1;1258;0;0;1;0;0;1;1;1258;0;1258;1;1;
/org.eclipse.jdt.ui/ui/org/eclipse/jdt/internal/ui/wizards/NewGroup.java;5;1;19;2;2;2;2;17;65;3;13;15;200;200;3;4;0;17;19;432;4;4140;15;5;
/org.eclipse.jdt.debug/model/org/eclipse/jdt/internal/debug/core/breakpoints/JavaBreakpoint.java;3;1;42;2;6;6;6;36;146;3;29;2517;1134;1134;3;7;0;36;42;2973;7;4547;35;3;
/org.eclipse.jdt.ui.tests.refactoring/resources/RenameVariables/cannotRename/A_testFail1.java;1;0;2;1;0;0;0;2;0;1;2;724;0;0;1;0;0;2;2;724;0;1665;2;1;
/org.eclipse.jdt.ui.tests.refactoring/resources/RenamePrivateMethod/testFail4/in/A.java;2;0;2;1;0;0;0;2;0;1;2;49;0;0;1;0;0;2;2;49;0;1092;2;2;
/org.eclipse.jdt.ui/ui refactoring/org/eclipse/jdt/internal/ui/refactoring/RenameParametersWizardPage.java;3;0;15;1;0;0;0;15;367;2;13;233;778;778;2;2;0;15;15;415;2;2630;13;3;
/org.eclipse.team.cvs.ui/src/org/eclipse/team/internal/ccvs/ui/OverlayIconCache.java;3;0;3;1;1;1;1;2;98;1;2;3704;100;100;1;0;0;2;3;3704;0;4005;3;3;
/org.eclipse.pde.ui/src/org/eclipse/pde/internal/elements/ElementLabelProvider.java;2;0;2;1;0;0;0;2;0;1;2;1434;0;0;1;0;0;2;2;1434;0;3579;2;2;
/org.eclipse.jdt.ui/ui/org/eclipse/jdt/internal/ui/javaeditor/IJavaEditorActionConstants.java;3;0;4;1;1;1;1;3;30;1;3;3397;54;54;1;0;0;3;4;3397;0;4597;4;3;
/org.eclipse.jdt.junit/src/org/eclipse/jdt/internal/junit/ui/ProgressImages.java;2;1;6;1;4;4;4;2;82;1;2;3667;112;112;1;0;0;2;6;3667;0;4423;6;2;
/org.eclipse.ui/Eclipse UI Editor Support/org/eclipse/ui/internal/editorsupport/OleEditor.java;3;0;12;1;1;1;1;11;780;2;10;257;1124;1124;2;1;0;11;12;2426;1;3936;11;3;
/org.eclipse.ant.ui/src/org/eclipse/ant/internal/ui/CustomizeAntPreferencePage.java;1;0;3;1;0;0;0;3;101;1;3;3476;103;103;1;0;0;3;3;3476;0;3506;3;1;
/org.eclipse.ui/Eclipse JFace/org/eclipse/jface/action/IContributionManager.java;3;0;3;1;0;0;0;3;7;1;3;257;12;12;1;0;0;3;3;257;0;3447;3;3;
/org.eclipse.pde.ui/src/org/eclipse/pde/internal/editor/build/BuildPage.java;2;0;4;1;0;0;0;4;4;1;4;1434;6;6;1;0;0;4;4;1434;0;3579;4;2;
/org.eclipse.swt/Eclipse SWT/motif/org/eclipse/swt/widgets/Tree.java;2;0;5;1;0;0;0;5;637;1;5;106;1068;1068;1;0;0;5;5;106;0;1028;5;2;
/org.eclipse.swt/Eclipse SWT Custom Widgets/common/org/eclipse/swt/custom/CLabel.java;4;2;19;1;4;3;4;15;192;2;13;106;537;537;2;2;1;15;19;2876;3;4701;16;4;
/org.eclipse.core.tests.runtime/src/org/eclipse/core/tests/internal/plugins/ActivationTest_NoRef.java;4;0;4;1;0;0;0;4;122;1;4;1794;152;152;1;0;0;4;4;1794;0;3476;4;4;
/org.eclipse.swt.examples.controls/org/eclipse/swt/examples/controls/ProgressBarTab.java;2;0;3;1;0;0;0;3;107;1;3;513;107;107;1;0;0;3;3;513;0;970;3;2;
/org.eclipse.jdt.ui.tests.refactoring/resources/ExtractTemp/cannotExtract/A_testFail16.java;1;0;1;1;0;0;0;1;0;0;1;3374;0;0;1;0;0;1;1;3374;0;3374;1;1;
/org.eclipse.ui/Eclipse UI/org/eclipse/ui/IWorkbenchWindow.java;5;0;6;1;0;0;0;6;60;2;5;257;104;104;2;1;0;6;6;2247;1;3050;5;5;
/org.eclipse.jdt.core/compiler/org/eclipse/jdt/internal/compiler/parser/NLSLine.java;2;0;6;1;1;1;1;5;28;2;4;979;40;40;2;1;0;5;6;1046;1;4062;5;2;
/org.eclipse.jdt.core/model/org/eclipse/jdt/internal/core/TypeVector.java;2;0;9;1;1;1;1;8;194;4;5;455;262;262;4;3;0;8;9;1039;3;4063;6;2;
/org.eclipse.jdt.ui.tests.refactoring/resources/RenameType/test14/in/A.java;1;0;1;1;0;0;0;1;0;0;1;49;0;0;1;0;0;1;1;49;0;49;1;1;
/org.eclipse.ui/Eclipse UI/org/eclipse/ui/internal/LayoutPartSash.java;4;0;5;1;0;0;0;5;71;1;5;257;127;127;1;0;0;5;5;257;0;3427;5;4;
/org.eclipse.jdt.core/compiler/org/eclipse/jdt/internal/compiler/codegen/IntegerCache.java;2;1;12;1;2;2;2;10;295;4;6;455;404;404;4;4;0;10;12;1039;4;4062;8;2;
/org.eclipse.team.cvs.core/src/org/eclipse/team/internal/ccvs/core/client/TagFileSender.java;2;0;7;2;0;0;0;7;43;2;6;3023;62;62;2;1;0;7;7;3206;1;3610;6;2;
/org.eclipse.debug.ui/ui/org/eclipse/debug/internal/ui/ConsoleDocument.java;4;0;18;2;0;0;0;18;291;2;16;187;774;774;2;2;0;18;18;721;2;2338;16;4;
/org.eclipse.jdt.ui/ui refactoring/org/eclipse/jdt/internal/ui/refactoring/actions/ModifyParametersAction.java;2;0;5;2;1;1;1;4;13;3;2;3807;13;13;3;2;0;4;5;3826;2;3970;3;2;
/org.eclipse.ui/Eclipse UI Standard Components/org/eclipse/ui/views/navigator/GotoActionGroup.java;2;1;6;1;3;3;3;3;21;1;3;3451;63;63;1;0;0;3;6;3451;0;4547;6;2;
/org.eclipse.jdt.core/batch/org/eclipse/jdt/internal/compiler/batch/ClasspathJar.java;3;0;18;2;1;1;1;17;460;4;11;455;832;832;4;6;0;17;18;1039;6;4061;12;3;
/org.eclipse.ui/Eclipse UI/org/eclipse/ui/IActionDelegate.java;3;0;3;1;0;0;0;3;6;1;3;257;11;11;1;0;0;3;3;257;0;2235;3;3;
/org.eclipse.jdt.debug/model/org/eclipse/jdt/internal/debug/core/breakpoints/JavaTargetPatternBreakpoint.java;2;0;3;1;1;1;1;2;13;1;2;3488;23;23;1;0;0;2;3;3488;0;4547;3;2;
/org.eclipse.jdt.core/model/org/eclipse/jdt/internal/core/builder/impl/BuilderType.java;1;0;3;1;0;0;0;3;315;1;3;455;315;315;1;0;0;3;3;455;0;2808;3;1;
/org.eclipse.swt/Eclipse SWT Custom Widgets/common/org/eclipse/swt/custom/BidiSegmentEvent.java;2;0;2;1;1;1;1;1;6;0;1;1624;6;6;1;0;0;1;2;1624;0;4701;2;2;
/org.eclipse.jdt.ui.tests.refactoring/resources/PullUpMethods/testFail12/in/A.java;1;0;2;1;0;0;0;2;0;1;2;2212;0;0;1;0;0;2;2;2212;0;2406;2;1;
/org.eclipse.core.runtime/src/org/eclipse/core/runtime/SubProgressMonitor.java;3;0;4;1;1;1;1;3;328;1;3;12;353;353;1;0;0;3;4;12;0;4214;4;3;
/org.eclipse.scripting/src/org/eclipse/scripting/internal/views/ScriptUIEditorIntegerTransfer.java;1;0;1;1;0;0;0;1;0;0;1;1424;0;0;1;0;0;1;1;1424;0;1424;1;1;
/org.eclipse.update.core/src/org/eclipse/update/internal/core/InstallHandlerEntry.java;2;0;2;1;0;0;0;2;0;1;2;2981;0;0;1;0;0;2;2;2981;0;3398;2;2;
/org.eclipse.pde.ui/src/org/eclipse/pde/internal/TargetPlatform.java;1;0;7;1;0;0;0;7;87;1;7;3103;127;127;1;0;0;7;7;3103;0;3579;7;1;
/org.eclipse.swt.examples/src/org/eclipse/swt/examples/controlexample/Tab.java;6;2;11;1;7;6;7;4;958;1;4;513;3253;3253;2;0;1;4;11;3914;1;4705;10;6;
/org.eclipse.pde.ui/src/org/eclipse/pde/internal/ui/editor/feature/InfoFormPage.java;1;0;1;1;0;0;0;1;0;0;1;3579;0;0;1;0;0;1;1;3579;0;3579;1;1;
/org.eclipse.core.runtime/src/org/eclipse/core/internal/runtime/AuthorizationDatabase.java;5;1;9;1;2;2;2;7;584;2;6;12;660;660;2;1;0;7;9;374;1;4213;8;5;
/org.eclipse.update.ui.forms/src/org/eclipse/update/ui/forms/internal/engine/IObjectReference.java;1;0;1;1;0;0;0;1;0;0;1;2745;0;0;1;0;0;1;1;2745;0;2745;1;1;
/org.eclipse.jdt.core/compiler/org/eclipse/jdt/internal/compiler/flow/UnconditionalFlowInfo.java;2;0;14;1;1;1;1;13;846;4;10;455;921;921;4;3;0;13;14;1039;3;4062;11;2;
/org.eclipse.jdt.ui.tests.refactoring/resources/RenameNonPrivateField/test9/out/A.java;1;0;1;1;0;0;0;1;0;0;1;49;0;0;1;0;0;1;1;49;0;49;1;1;
/org.eclipse.jdt.ui/core refactoring/org/eclipse/jdt/core/refactoring/cus/MoveCompilationUnitChange.java;1;0;4;1;0;0;0;4;34;1;4;15;39;39;1;0;0;4;4;15;0;408;4;1;
/org.eclipse.ui/Eclipse UI Standard Components/org/eclipse/ui/views/navigator/TestDecorator.java;3;0;3;1;0;0;0;3;6;1;3;257;6;6;1;0;0;3;3;257;0;925;3;3;
/org.eclipse.help/Eclipse Help/org/eclipse/help/internal/protocols/help/HelpURLConnection.java;3;0;3;1;0;0;0;3;12;1;3;1070;12;12;1;0;0;3;3;1070;0;1420;3;3;
/org.eclipse.ui.examples.javaeditor/Eclipse Java Editor Example/org/eclipse/ui/examples/javaeditor/PresentationAction.java;1;0;1;1;0;0;0;1;0;0;1;1067;0;0;1;0;0;1;1;1067;0;1067;1;1;
/org.eclipse.jdt.debug/model/org/eclipse/jdt/internal/debug/core/JavaMethodEntryBreakpoint.java;3;0;19;2;0;0;0;19;251;2;16;1035;556;556;2;3;0;19;19;1035;3;2517;16;3;
/org.eclipse.swt/Eclipse SWT Custom Widgets/common_j2se/org/eclipse/swt/custom/DefaultLineStyler.java;1;0;1;1;0;0;0;1;0;0;1;1378;0;0;1;0;0;1;1;1378;0;1378;1;1;
/org.eclipse.jdt.ui.tests.refactoring/resources/RenameStaticMethod/testFail6/in/A.java;1;0;1;1;0;0;0;1;0;0;1;49;0;0;1;0;0;1;1;49;0;49;1;1;
/org.eclipse.jdt.ui/core refactoring/org/eclipse/jdt/internal/corext/refactoring/rename/RenameCompilationUnitRefactoring.java;2;0;7;1;1;1;1;6;34;1;6;1939;72;72;1;0;0;6;7;1939;0;4212;7;2;
/org.eclipse.jdt.debug/jdi interfaces/com/sun/jdi/VoidType.java;2;0;2;1;0;0;0;2;6;1;2;2704;6;6;1;0;0;2;2;2704;0;3033;2;2;
/org.eclipse.pde.ui/src/org/eclipse/pde/internal/core/ifeature/IVersonable.java;1;0;2;1;0;0;0;2;0;1;2;3591;0;0;1;0;0;2;2;3591;0;3607;2;1;
/org.eclipse.pde.ui/src/org/eclipse/pde/internal/editor/schema/DescriptionSection.java;2;0;8;1;0;0;0;8;9;1;8;1434;18;18;1;0;0;8;8;1434;0;3579;8;2;
/org.eclipse.jdt.core/model/org/eclipse/jdt/internal/core/builder/impl/ProblemFactory.java;1;0;12;1;0;0;0;12;189;4;8;455;407;407;4;4;0;12;12;1039;4;2808;8;1;
/org.eclipse.team.cvs.ui/src/org/eclipse/team/internal/ccvs/ui/wizards/RepositorySelectionPage.java;3;1;7;1;2;2;2;5;6;1;5;2577;22;22;1;0;0;5;7;2577;0;4626;7;3;
/org.eclipse.jdt.ui.tests.refactoring/resources/ExtractMethodWorkSpace/ExtractMethodTests/semicolon_in/A_test402.java;2;1;3;1;2;2;2;1;0;0;1;49;0;0;1;0;0;1;3;49;0;4419;3;2;
/org.eclipse.jdt.ui.tests.refactoring/resources/RenameMethodInInterface/test3/in/A.java;1;0;1;1;0;0;0;1;0;0;1;49;0;0;1;0;0;1;1;49;0;49;1;1;
/org.eclipse.pde.core/src/org/eclipse/pde/internal/core/plugin/AttributeChangedEvent.java;1;0;1;1;0;0;0;1;0;0;1;3591;0;0;1;0;0;1;1;3591;0;3591;1;1;
/org.eclipse.jdt.ui.tests.refactoring/resources/RenameType/test13/in/A.java;1;0;1;1;0;0;0;1;0;0;1;49;0;0;1;0;0;1;1;49;0;49;1;1;
/org.eclipse.jdt.ui.tests.refactoring/resources/ExtractMethodWorkSpace/ExtractMethodTests/nested_in/A_test652.java;2;1;3;1;2;2;2;1;20;0;1;354;20;20;1;0;0;1;3;354;0;4419;3;2;
/org.eclipse.team.ui/src/org/eclipse/team/internal/ui/sync/UnchangedTeamContainer.java;1;0;4;1;1;1;1;3;34;2;2;2054;62;62;2;1;0;3;4;2231;1;4005;3;1;
/org.eclipse.update/src/org/eclipse/update/internal/ui/UMWizardTreeItem.java;1;0;1;1;0;0;0;1;0;0;1;1424;0;0;1;0;0;1;1;1424;0;1424;1;1;
/org.eclipse.jdt.junit/Eclipse JUnit/org/eclipse/jdt/internal/junit/ui/ApplicationWizardPage.java;1;0;2;1;0;0;0;2;0;1;2;2007;0;0;1;0;0;2;2;2007;0;2143;2;1;
/org.eclipse.pde.ui/Eclipse PDE UI/org/eclipse/pde/internal/model/build/Build.java;2;0;5;2;0;0;0;5;12;3;3;267;12;12;3;2;0;5;5;324;2;1434;3;2;
/org.eclipse.pde.ui/src/org/eclipse/pde/internal/editor/text/PDEScanner.java;2;0;2;1;0;0;0;2;0;1;2;1434;0;0;1;0;0;2;2;1434;0;3579;2;2;
/org.eclipse.ui.tests/Eclipse UI Tests/org/eclipse/ui/tests/dialogs/PreferenceDialogWrapper.java;1;0;1;1;0;0;0;1;0;0;1;1113;0;0;1;0;0;1;1;1113;0;1113;1;1;
/org.eclipse.jdt.ui/ui refactoring/org/eclipse/jdt/internal/ui/refactoring/RefactoringMessages.java;3;0;4;1;0;0;0;4;10;1;4;717;27;27;1;0;0;4;4;717;0;2684;4;3;
/org.eclipse.ant.core/src/org/eclipse/ant/internal/core/old/DeleteProject.java;1;0;1;1;0;0;0;1;0;0;1;3270;0;0;1;0;0;1;1;3270;0;3270;1;1;
/org.eclipse.jdt.ui.tests.refactoring/resources/ExtractTemp/canExtract/A_test34_in.java;1;0;1;1;0;0;0;1;0;0;1;3227;0;0;1;0;0;1;1;3227;0;3227;1;1;
/org.eclipse.pde.ui/src/org/eclipse/pde/internal/view/FileAdapterPropertySource.java;1;0;2;1;0;0;0;2;0;1;2;3446;0;0;1;0;0;2;2;3446;0;3579;2;1;
/org.eclipse.jdt.ui.tests.refactoring/resources/MoveCU/testFail6/in/p/B.java;2;0;2;1;0;0;0;2;0;1;2;49;0;0;1;0;0;2;2;49;0;2769;2;2;
/org.eclipse.core.boot/src/org/eclipse/core/internal/boot/update/UMRegistryModel.java;3;0;8;2;0;0;0;8;275;3;6;12;308;308;3;2;0;8;8;324;2;2726;6;3;
/org.eclipse.team.cvs.core/src/org/eclipse/team/internal/ccvs/core/resources/FolderSyncInfo.java;2;0;7;2;0;0;0;7;163;2;5;2156;183;183;2;2;0;7;7;2214;2;2690;5;2;
/org.eclipse.core.tests.resources/src/org/eclipse/core/tests/internal/indexing/TestObject.java;3;0;4;1;1;1;1;3;222;1;3;1794;267;267;1;0;0;3;4;1794;0;4516;4;3;
/org.eclipse.jdt.ui.tests.refactoring/resources/SelectionAnalyzerWorkSpace/SelectionAnalyzerTests/validSelection/A_test262.java;1;0;1;1;0;0;0;1;0;0;1;1368;0;0;1;0;0;1;1;1368;0;1368;1;1;
/org.eclipse.vcm.core/src/org/eclipse/vcm/internal/core/Subscriber.java;6;0;22;3;0;0;0;22;331;4;16;0;595;595;4;6;0;22;22;292;6;1584;16;6;
/org.eclipse.jdt.ui.tests.refactoring/resources/RenameParameters/cannotRename/A_testFail14.java;1;0;1;1;0;0;0;1;0;0;1;233;0;0;1;0;0;1;1;233;0;233;1;1;
/org.eclipse.vcm.core/src/org/eclipse/vcm/internal/core/VCMStatus.java;2;0;3;1;0;0;0;3;12;1;3;0;17;17;1;0;0;3;3;0;0;297;3;2;
/org.eclipse.jdt.ui/core refactoring/org/eclipse/jdt/internal/corext/refactoring/rename/RenameAnalyzeUtil.java;1;1;3;1;2;2;2;1;6;0;1;3825;10;10;1;0;0;1;3;3825;0;4014;3;1;
/org.eclipse.jdt.ui.tests.refactoring/resources/ExtractMethodWorkSpace/ExtractMethodTests/invalidSelection/A_test070.java;2;1;3;1;2;2;2;1;0;0;1;49;0;0;1;0;0;1;3;49;0;4419;3;2;
/org.eclipse.update.core/src/org/eclipse/update/core/model/ContentEntryModel.java;2;0;6;1;0;0;0;6;195;2;5;2409;407;407;2;1;0;6;6;3570;1;3570;5;2;
/org.eclipse.jdt.ui/ui debug/org/eclipse/jdt/internal/debug/ui/ExceptionAction.java;2;0;7;1;0;0;0;7;80;1;7;15;150;150;1;0;0;7;7;15;0;1916;7;2;
/org.eclipse.swt.examples/Eclipse SWT Examples/common/org/eclipse/swt/examples/helloworld/HelloWorld5.java;1;0;2;1;0;0;0;2;0;1;2;107;0;0;1;0;0;2;2;107;0;611;2;1;
/org.eclipse.pde.ui/Eclipse PDE UI/org/eclipse/pde/internal/wizards/project/ConvertedProjectsPage.java;2;0;6;2;0;0;0;6;12;3;4;267;16;16;3;2;0;6;6;324;2;1434;4;2;
/org.eclipse.compare/compare/org/eclipse/compare/internal/IViewerDescriptor.java;1;0;2;1;0;0;0;2;5;1;2;14;5;5;1;0;0;2;2;14;0;329;2;1;
/org.eclipse.core.tests.runtime/src/org/eclipse/core/tests/internal/plugins/PluginResolveTest_5.java;4;0;4;1;0;0;0;4;110;1;4;1794;125;125;1;0;0;4;4;1794;0;3476;4;4;
/org.eclipse.jdt.ui.tests.refactoring/resources/ExtractMethodWorkSpace/ExtractMethodTests/try_in/A_test461.java;1;1;3;1;2;2;2;1;26;0;1;2634;26;26;1;0;0;1;3;2634;0;4419;3;1;
/org.eclipse.pde.ui/src/org/eclipse/pde/internal/core/ischema/ISchemaElement.java;1;0;2;1;0;0;0;2;0;1;2;3591;0;0;1;0;0;2;2;3591;0;3607;2;1;
/org.eclipse.jdt.ui/ui/org/eclipse/jdt/internal/ui/actions/AbstractOpenWizardAction.java;3;0;10;1;0;0;0;10;68;1;10;15;180;180;1;0;0;10;10;15;0;1941;10;3;
/org.eclipse.pde.runtime/Eclipse PDE Runtime/org/eclipse/pde/internal/runtime/registry/RegistryPropertySource.java;2;0;3;1;0;0;0;3;4;1;3;267;4;4;1;0;0;3;3;267;0;1434;3;2;
/org.eclipse.vcm.ui/src/org/eclipse/vcm/internal/ui/ResourceEditionNode.java;3;0;8;1;0;0;0;8;60;3;6;1;112;112;3;2;0;8;8;83;2;531;6;3;
/org.eclipse.update.ui/src/org/eclipse/update/internal/ui/security/JarVerificationService.java;1;0;15;1;0;0;0;15;128;2;14;3122;619;619;2;1;0;15;15;3355;1;3853;14;1;
/org.eclipse.pde.ui/Eclipse PDE UI/org/eclipse/pde/internal/editor/manifest/JarsSection.java;2;0;7;2;0;0;0;7;12;3;5;267;16;16;3;2;0;7;7;324;2;1434;5;2;
/org.eclipse.pde.build/src/plugin/org/eclipse/pde/internal/core/ant/ConditionTask.java;1;0;1;1;0;0;0;1;0;0;1;3475;0;0;1;0;0;1;1;3475;0;3475;1;1;
/org.eclipse.ui/Eclipse UI Text Editor/org/eclipse/ui/editors/text/IStorageDocumentProvider.java;1;1;2;1;2;2;2;0;30;0;0;4138;30;30;1;0;0;0;2;4138;0;4838;2;1;
/org.eclipse.pde.build/src/plugin/org/eclipse/pde/internal/core/ModelBuildScriptGenerator.java;1;0;1;1;0;0;0;1;0;0;1;3475;0;0;1;0;0;1;1;3475;0;3475;1;1;
/org.eclipse.ui/Eclipse UI/org/eclipse/ui/internal/registry/ActionDefinition.java;2;0;4;1;0;0;0;4;37;1;4;3055;47;47;1;0;0;4;4;3055;0;3270;4;2;
/org.eclipse.swt.tests/JUnit Tests/org/eclipse/swt/tests/junit/Test_org_eclipse_swt_custom_VerifyKeyListener.java;2;0;2;1;1;1;1;1;6;0;1;1792;6;6;1;0;0;1;2;1792;0;4706;2;2;
/org.eclipse.ui/Eclipse UI/org/eclipse/ui/internal/HistoryAction.java;1;0;1;1;0;0;0;1;0;0;1;957;0;0;1;0;0;1;1;957;0;957;1;1;
/org.eclipse.swt/Eclipse SWT PI/win32/org/eclipse/swt/internal/ole/win32/DVTARGETDEVICE.java;2;0;2;1;1;1;1;1;6;0;1;2069;6;6;1;0;0;1;2;2069;0;4701;2;2;
/org.eclipse.jdt.ui/ui/org/eclipse/jdt/internal/ui/wizards/NewPackageRootCreationWizardPage.java;4;0;15;1;0;0;0;15;152;2;12;15;363;363;2;3;0;15;15;411;3;1342;12;4;
/org.eclipse.update.ui/src/org/eclipse/update/internal/ui/forms/SearchForm.java;2;1;12;1;6;6;6;6;106;4;3;3662;218;218;4;3;0;6;12;3662;3;4730;9;2;
/org.eclipse.debug.ui/ui/org/eclipse/debug/internal/ui/preferences/DebugActionGroupsActionContentProvider.java;2;1;2;1;2;2;2;0;5;0;0;3975;5;5;1;0;0;0;2;3975;0;4207;2;2;
/org.eclipse.jdt.ui.tests.refactoring/resources/RenameType/test48/out/A.java;1;0;2;1;0;0;0;2;0;1;2;49;0;0;1;0;0;2;2;49;0;522;2;1;
/org.eclipse.update.ui/src/org/eclipse/update/internal/ui/security/UserValidationDialog.java;2;0;3;1;1;1;1;2;19;1;2;3212;22;22;1;0;0;2;3;3212;0;4610;3;2;
/org.eclipse.scripting/Eclipse Scripting/org/eclipse/scripting/internal/Script.java;2;0;4;1;0;0;0;4;18;1;4;133;30;30;1;0;0;4;4;133;0;1424;4;2;
/org.eclipse.jdt.debug.ui/ui/org/eclipse/jdt/internal/debug/ui/launcher/OpenOnVariableAction.java;2;0;2;1;0;0;0;2;0;1;2;1915;0;0;1;0;0;2;2;1915;0;2384;2;2;
/org.eclipse.jdt.ui.tests.refactoring/resources/RenameTemp/cannotRename/A_testFail19.java;1;0;2;1;0;0;0;2;2;1;2;1625;2;2;1;0;0;2;2;1625;0;1652;2;1;
/org.eclipse.jdt.ui.tests.refactoring/resources/ExtractMethodWorkSpace/ExtractMethodTests/semicolon_out/A_test400.java;2;1;4;1;2;2;2;2;4;1;2;49;4;4;1;0;0;2;4;49;0;4419;4;2;
/org.eclipse.pde.ui/src/org/eclipse/pde/internal/ui/editor/feature/SynchronizeVersionsWizardPage.java;1;0;5;1;1;1;1;4;37;2;3;3579;53;53;2;1;0;4;5;3579;1;4549;4;1;
/org.eclipse.pde.ui/Eclipse PDE UI/org/eclipse/pde/internal/schema/RepeatableSchemaObject.java;2;0;5;2;0;0;0;5;12;3;3;267;12;12;3;2;0;5;5;324;2;1434;3;2;
/org.eclipse.team.cvs.ui/src/org/eclipse/team/internal/ccvs/ui/RepositoriesView.java;3;1;33;2;9;9;9;24;367;3;20;1978;822;822;3;4;0;24;33;2722;4;4829;29;3;
/org.eclipse.help.ui/Eclipse Help UI/org/eclipse/help/internal/ui/NavigationPage.java;2;0;5;1;0;0;0;5;7;1;5;136;11;11;1;0;0;5;5;136;0;1420;5;2;
/org.eclipse.jdt.debug/model/org/eclipse/jdt/internal/debug/core/JDIClassObjectValue.java;2;0;2;1;0;0;0;2;0;1;2;1675;0;0;1;0;0;2;2;1675;0;2517;2;2;
/org.eclipse.swt/Eclipse SWT/gtk/org/eclipse/swt/widgets/Composite.java;5;2;29;2;9;8;9;20;323;2;16;2107;1626;1626;2;4;1;20;29;3604;5;4701;24;5;
/org.eclipse.jdt.ui/ui/org/eclipse/jdt/internal/ui/MarkerAdapterFactory.java;2;0;3;1;0;0;0;3;13;1;3;15;21;21;1;0;0;3;3;15;0;1172;3;2;
/org.eclipse.ui/Eclipse UI Standard Components/org/eclipse/ui/wizards/datatransfer/WizardExternalProjectImportPage.java;1;1;7;1;3;3;3;4;68;1;4;3533;222;222;1;0;0;4;7;3533;0;4567;7;1;
/org.eclipse.vcm.ui/src/org/eclipse/vcm/internal/ui/sync/SyncSet.java;5;0;14;2;0;0;0;14;45;2;12;100;280;280;2;2;0;14;14;295;2;1659;12;5;
/org.eclipse.jdt.ui.tests.refactoring/resources/ExtractTemp/canExtract/A_test39_out.java;1;0;1;1;1;1;1;0;0;0;0;4763;0;0;1;0;0;0;1;4763;0;4763;1;1;
/org.eclipse.core.tests.resources/src/org/eclipse/core/tests/resources/IFolderTest.java;3;1;6;1;2;2;2;4;524;1;4;1794;590;590;1;0;0;4;6;1794;0;4772;6;3;
/org.eclipse.jdt.ui/ui/org/eclipse/jdt/internal/ui/typehierarchy/TraditionalHierarchyViewer.java;3;0;17;1;1;1;1;16;101;2;13;15;288;288;2;3;0;16;17;328;3;4361;14;3;
/org.eclipse.swt.tests/JUnit Tests/org/eclipse/swt/tests/junit/Test_org_eclipse_swt_layout_GridLayout.java;2;0;2;1;1;1;1;1;6;0;1;1792;6;6;1;0;0;1;2;1792;0;4706;2;2;
/org.eclipse.swt/Eclipse SWT OLE Win32/win32/org/eclipse/swt/ole/win32/OleControlSite.java;2;1;11;1;4;4;4;7;192;1;7;106;427;427;1;0;0;7;11;106;0;4701;11;2;
/org.eclipse.vcm.core.cvs/src/org/eclipse/vcm/internal/core/ccvs/client/ValidRequestsHandler.java;2;0;2;1;0;0;0;2;6;1;2;0;6;6;1;0;0;2;2;0;0;298;2;2;
/org.eclipse.vcm.ui/src/org/eclipse/vcm/internal/ui/sync/ChangedVCMContainer.java;2;0;8;1;0;0;0;8;75;1;8;48;118;118;1;0;0;8;8;48;0;331;8;2;
/org.eclipse.help/Eclipse Help/org/eclipse/help/internal/Help.java;2;0;3;1;0;0;0;3;7;1;3;135;7;7;1;0;0;3;3;135;0;1420;3;2;
/org.eclipse.ui.tests/Eclipse JFace Tests/org/eclipse/jface/tests/viewers/CheckboxTreeViewerTest.java;1;0;2;1;0;0;0;2;5;1;2;1488;5;5;1;0;0;2;2;1488;0;2017;2;1;
/org.eclipse.jdt.ui.tests.refactoring/resources/ExtractMethodWorkSpace/ExtractMethodTests/nested_in/A_test651.java;2;1;3;1;2;2;2;1;16;0;1;354;16;16;1;0;0;1;3;354;0;4419;3;2;
/org.eclipse.jdt.core/compiler/org/eclipse/jdt/internal/compiler/env/IDependent.java;2;2;6;1;3;2;3;3;22;1;3;455;59;59;2;0;1;3;6;3959;1;4062;5;2;
/org.eclipse.pde.ui/src/org/eclipse/pde/core/build/IBuildModel.java;1;0;3;1;0;0;0;3;7;2;2;3579;7;7;2;1;0;3;3;3579;1;3607;2;1;
/org.eclipse.update.examples/src/org/eclipse/update/examples/buildzip/ZipSiteFactory.java;2;0;3;1;0;0;0;3;6;1;3;2689;6;6;1;0;0;3;3;2689;0;2762;3;2;
/org.eclipse.jdt.core/model/org/eclipse/jdt/core/IOpenable.java;2;1;4;1;2;2;2;2;217;1;2;455;269;269;1;0;0;2;4;455;0;4061;4;2;
/org.eclipse.search/search/org/eclipse/search/internal/ui/ResourcenameSorter.java;2;0;4;1;0;0;0;4;9;1;4;15;13;13;1;0;0;4;4;15;0;1117;4;2;
/org.eclipse.scripting/Eclipse Scripting/org/eclipse/scripting/internal/views/ScriptUIEditorModelElement.java;2;0;8;1;0;0;0;8;142;2;7;133;242;242;2;1;0;8;8;555;1;1424;7;2;
/org.eclipse.team.cvs.ui/src/org/eclipse/team/internal/ccvs/ui/actions/DefineVersionAction.java;2;0;8;1;1;1;1;7;15;1;7;2126;44;44;1;0;0;7;8;2126;0;4021;8;2;
/org.eclipse.jdt.ui.tests.refactoring/resources/RenameType/testFail32/in/A.java;1;0;1;1;0;0;0;1;0;0;1;49;0;0;1;0;0;1;1;49;0;49;1;1;
/org.eclipse.jdt.debug/jdi/org/eclipse/jdi/internal/ByteValueImpl.java;2;0;4;1;0;0;0;4;19;1;4;187;37;37;1;0;0;4;4;187;0;3670;4;2;
/org.eclipse.swt/Eclipse SWT/photon/org/eclipse/swt/widgets/TableColumn.java;2;0;5;1;0;0;0;5;328;1;5;106;726;726;1;0;0;5;5;106;0;1028;5;2;
/org.eclipse.jdt.ui.tests.refactoring/resources/InlineTemp/canInline/A_test17_out.java;1;0;1;1;0;0;0;1;0;0;1;3355;0;0;1;0;0;1;1;3355;0;3355;1;1;
/org.eclipse.jdt.ui.tests.refactoring/resources/ExtractMethodWorkSpace/ExtractMethodTests/semicolon_in/A_test400.java;2;1;4;1;2;2;2;2;2;1;2;49;2;2;1;0;0;2;4;49;0;4419;4;2;
/org.eclipse.team.cvs.core/src/org/eclipse/team/internal/ccvs/core/resources/CVSEntryLineTag.java;3;0;7;1;0;0;0;7;116;1;7;2156;144;144;1;0;0;7;7;2156;0;3812;7;3;
/org.eclipse.help/Eclipse Help/org/eclipse/help/internal/contributors/TopicContributor.java;2;0;3;1;0;0;0;3;7;1;3;135;7;7;1;0;0;3;3;135;0;1420;3;2;
/org.eclipse.ui/Eclipse UI/org/eclipse/ui/internal/IPerspectiveService.java;3;0;3;1;0;0;0;3;5;1;3;257;9;9;1;0;0;3;3;257;0;2419;3;3;
/org.eclipse.jdt.debug.tests/test programs/org/eclipse/debug/tests/targets/HelloLauncherWithArgs.java;1;0;2;1;0;0;0;2;0;1;2;3701;0;0;1;0;0;2;2;3701;0;3719;2;1;
/org.eclipse.team.ftp/src/org/eclipse/team/internal/ftp/client/PutFileWorker.java;1;1;4;1;4;4;4;0;5;0;0;4169;9;9;1;0;0;0;4;4169;0;4573;4;1;
/org.eclipse.team.cvs.core/src/org/eclipse/team/internal/ccvs/core/commands/Command.java;3;0;11;2;0;0;0;11;1451;2;10;1978;2210;2210;2;1;0;11;11;2375;1;2607;10;3;
/org.eclipse.swt.examples/org/eclipse/swt/examples/controlexample/ScrollableTab.java;4;0;5;1;1;1;1;4;72;1;4;513;129;129;1;0;0;4;5;513;0;4024;5;4;
/org.eclipse.pde.ui/src/org/eclipse/pde/internal/ui/util/ArraySorter.java;1;0;1;1;0;0;0;1;0;0;1;3579;0;0;1;0;0;1;1;3579;0;3579;1;1;
/org.eclipse.team.tests.cvs.core/src/org/eclipse/team/tests/ccvs/ui/logformatter/RootEntry.java;1;0;1;1;0;0;0;1;0;0;1;2977;0;0;1;0;0;1;1;2977;0;2977;1;1;
/org.eclipse.pde.core/src/org/eclipse/pde/internal/core/feature/FeatureURLElement.java;1;0;2;1;1;1;1;1;125;0;1;3591;125;125;1;0;0;1;2;3591;0;3994;2;1;
/org.eclipse.jdt.core/search/org/eclipse/jdt/internal/core/search/indexing/RemoveFolderFromIndex.java;3;1;4;1;3;3;3;1;25;0;1;3187;32;32;1;0;0;1;4;3187;0;4525;4;3;
/org.eclipse.jdt.ui.tests.refactoring/resources/RenameType/testFail86/in/A.java;1;0;1;1;0;0;0;1;0;0;1;49;0;0;1;0;0;1;1;49;0;49;1;1;
/org.eclipse.help.ui/src/org/eclipse/help/ui/internal/HyperlinkHandler.java;1;0;1;1;1;1;1;0;0;0;0;4439;0;0;1;0;0;0;1;4439;0;4439;1;1;
/org.eclipse.jdt.debug.tests/tests/org/eclipse/jdt/debug/tests/EvalTestSuite.java;1;1;2;1;2;2;2;0;3;0;0;4447;3;3;1;0;0;0;2;4447;0;4568;2;1;
/org.eclipse.core.tests.resources/src/org/eclipse/core/tests/resources/IResourceChangeListenerTest.java;3;2;12;2;6;5;6;6;1126;2;5;1794;1649;1649;2;1;1;6;12;3415;2;4645;10;3;
/org.eclipse.ant.core/src/org/eclipse/ant/core/EclipseJavac.java;4;0;8;1;0;0;0;8;306;1;8;14;399;399;1;0;0;8;8;14;0;3489;8;4;
/org.eclipse.jdt.core/dom/org/eclipse/jdt/core/dom/TypeLiteral.java;2;1;6;1;2;2;2;4;9;1;4;2669;29;29;1;0;0;4;6;2669;0;4453;6;2;
/org.eclipse.pde.ui/Eclipse PDE UI/org/eclipse/pde/internal/editor/manifest/NullToolBarManager.java;2;0;5;2;0;0;0;5;12;3;3;267;12;12;3;2;0;5;5;324;2;1434;3;2;
/org.eclipse.jdt.ui.tests.refactoring/resources/RenameParameters/canRename/A_test35_out.java;1;0;1;1;0;0;0;1;0;0;1;2757;0;0;1;0;0;1;1;2757;0;2757;1;1;
/org.eclipse.update.ui/src/org/eclipse/update/ui/UpdateUIPlugin.java;1;0;2;1;0;0;0;2;0;0;1;1423;0;0;2;1;0;2;2;1423;1;1423;1;1;
/org.eclipse.team.cvs.ui/src/org/eclipse/team/internal/ccvs/ui/model/BranchTag.java;3;0;9;2;0;0;0;9;31;2;8;2126;77;77;2;1;0;9;9;2726;1;3791;8;3;
/org.eclipse.pde.ui/Eclipse PDE UI/org/eclipse/pde/internal/editor/manifest/ManifestRuntimePage.java;2;0;5;2;0;0;0;5;12;3;3;267;12;12;3;2;0;5;5;324;2;1434;3;2;
/org.eclipse.jdt.junit/src/org/eclipse/jdt/internal/junit/ui/ITestRunView.java;1;0;2;1;1;1;1;1;5;0;1;3171;5;5;1;0;0;1;2;3171;0;4276;2;1;
/org.eclipse.jdt.ui/ui/org/eclipse/jdt/internal/ui/text/java/ProposalContextInformation.java;1;0;2;1;1;1;1;1;16;0;1;1137;16;16;1;0;0;1;2;1137;0;4632;2;1;
/org.eclipse.pde.ui/src/org/eclipse/pde/core/IModelChangeProvider.java;1;0;2;1;0;0;0;2;0;1;2;3579;0;0;1;0;0;2;2;3579;0;3607;2;1;
/org.eclipse.pde.ui/src/org/eclipse/pde/internal/ui/wizards/templates/DefaultCodeGenerationPage.java;1;0;7;1;1;1;1;6;49;3;3;3579;77;77;3;3;0;6;7;3629;3;4567;4;1;
/org.eclipse.jdt.ui/ui refactoring/org/eclipse/jdt/internal/ui/refactoring/nls/search/NLSSearchPage.java;6;2;21;1;11;10;11;10;62;2;9;1922;199;199;2;1;1;10;21;3527;2;4630;19;6;
/org.eclipse.ui/Eclipse JFace Text/org/eclipse/jface/text/source/ISourceViewer.java;4;0;5;1;1;1;1;4;57;1;4;257;85;85;1;0;0;4;5;257;0;4838;5;4;
/org.eclipse.team.ui/src/org/eclipse/team/internal/ui/target/SiteSelectionPage.java;4;2;10;2;10;8;10;0;46;0;0;4164;137;137;2;0;2;0;10;4164;2;4636;8;4;
/org.eclipse.jdt.ui/core extension/org/eclipse/jdt/internal/corext/javadoc/SingleCharReader.java;2;0;2;1;1;1;1;1;2;0;1;2495;2;2;1;0;0;1;2;2495;0;4400;2;2;
/org.eclipse.swt/Eclipse SWT Accessibility/common/org/eclipse/swt/accessibility/AccessibleControlListener.java;2;0;11;1;1;1;1;10;271;4;6;2781;369;369;4;4;0;10;11;3121;4;4701;7;2;
/org.eclipse.update.core/src/org/eclipse/update/core/IContentConsumer.java;2;0;5;1;1;1;1;4;47;1;4;2434;88;88;1;0;0;4;5;2434;0;4207;5;2;
/org.eclipse.core.resources/src/org/eclipse/core/internal/indexing/ObjectStoreException.java;4;1;7;1;3;3;3;4;158;1;4;12;344;344;1;0;0;4;7;12;0;4632;7;4;
/org.eclipse.pde.ui/src/org/eclipse/pde/internal/ui/wizards/templates/TemplateSelectionPage.java;1;0;7;1;1;1;1;6;147;1;6;3579;200;200;1;0;0;6;7;3579;0;4316;7;1;
/org.eclipse.help/Eclipse Help/org/eclipse/help/internal/contributions/xml/HelpContextTopic.java;1;0;2;1;0;0;0;2;0;1;2;374;0;0;1;0;0;2;2;374;0;1085;2;1;
/org.eclipse.jdt.ui.tests.refactoring/resources/SelectionAnalyzerWorkSpace/SelectionAnalyzerTests/invalidSelection/A_test160.java;1;0;1;1;0;0;0;1;0;0;1;1368;0;0;1;0;0;1;1;1368;0;1368;1;1;
/org.eclipse.swt/Eclipse SWT/gtk/org/eclipse/swt/graphics/Device.java;5;1;14;2;3;3;3;11;363;2;9;2107;706;706;2;2;0;11;14;2123;2;4701;12;5;
/org.eclipse.jdt.ui/ui/org/eclipse/jdt/internal/ui/javadocexport/JavadocCheckboxTreeAndListGroup.java;3;0;4;1;1;1;1;3;68;1;3;2878;70;70;1;0;0;3;4;2878;0;4404;4;3;
/org.eclipse.jdt.ui/ui/org/eclipse/jdt/internal/ui/wizards/dialogfields/ListDialogField.java;2;0;23;1;0;0;0;23;244;3;21;15;731;731;3;2;0;23;23;218;2;3084;21;2;
/org.eclipse.jdt.debug/model/org/eclipse/jdt/internal/debug/pattern/PatternDebugTarget.java;1;0;1;1;0;0;0;1;0;0;1;971;0;0;1;0;0;1;1;971;0;971;1;1;
/org.eclipse.vcm.ui.cvs/src/org/eclipse/vcm/internal/ui/ccvs/CVSUIAdapter.java;4;0;10;2;0;0;0;10;39;2;8;1;73;73;2;2;0;10;10;1;2;317;8;4;
/org.eclipse.core.runtime/src/org/eclipse/core/runtime/model/Factory.java;4;0;8;1;1;1;1;7;312;1;7;12;399;399;1;0;0;7;8;12;0;4214;8;4;
/org.eclipse.ui/Eclipse JFace Text/org/eclipse/jface/text/DocumentCommand.java;3;0;3;1;0;0;0;3;38;1;3;257;43;43;1;0;0;3;3;257;0;1066;3;3;
/org.eclipse.jdt.core/dom/org/eclipse/jdt/core/dom/ASTVisitor.java;2;0;7;1;1;1;1;6;41;2;5;2669;66;66;2;1;0;6;7;2701;1;4058;6;2;
/org.eclipse.pde.ui/Eclipse PDE UI/org/eclipse/pde/internal/editor/schema/NewReferenceAction.java;2;0;5;2;0;0;0;5;12;3;3;267;12;12;3;2;0;5;5;324;2;1434;3;2;
/org.eclipse.help/src/org/eclipse/help/internal/search/SearchManager.java;3;3;16;2;6;3;6;10;263;1;10;2318;624;624;3;0;3;10;16;4000;3;4025;13;3;
/org.eclipse.swt/Eclipse SWT/carbon/org/eclipse/swt/widgets/ScrollBar.java;4;1;5;1;5;5;5;0;36;0;0;4147;77;77;1;0;0;0;5;4147;0;4701;5;4;
/org.eclipse.jdt.ui/ui/org/eclipse/jdt/ui/actions/ExtractMethodAction.java;2;1;7;1;7;7;7;0;51;0;0;3970;76;76;1;0;0;0;7;3970;0;4770;7;2;
/org.eclipse.team.cvs.core/src/org/eclipse/team/internal/ccvs/core/CVSTeamProvider.java;4;1;101;4;12;12;12;89;2211;5;60;1978;8984;8984;5;29;0;89;101;2049;29;4632;72;4;
/org.eclipse.jdt.debug/model/org/eclipse/jdt/internal/debug/core/model/JDIArrayPartition.java;2;0;3;2;0;0;0;3;6;0;1;2517;6;6;3;2;0;3;3;2517;2;2517;1;2;
/org.eclipse.ui/Eclipse UI Standard Components/org/eclipse/ui/views/internal/framelist/FrameAction.java;3;0;5;1;0;0;0;5;8;1;5;257;18;18;1;0;0;5;5;257;0;3816;5;3;
/org.eclipse.pde.ui/src/org/eclipse/pde/internal/editor/manifest/JavaAttributeDescriptor.java;2;0;2;1;0;0;0;2;0;1;2;1434;0;0;1;0;0;2;2;1434;0;3579;2;2;
/org.eclipse.jdt.ui.tests.refactoring/resources/PullUp/test18/out/A.java;1;0;1;1;0;0;0;1;0;0;1;2406;0;0;1;0;0;1;1;2406;0;2406;1;1;
/org.eclipse.jdt.ui/ui/org/eclipse/jdt/internal/ui/jarpackager/ManifestFactory.java;2;0;7;1;0;0;0;7;11;2;6;239;28;28;2;1;0;7;7;320;1;2131;6;2;
/org.eclipse.ui/Eclipse UI/org/eclipse/ui/internal/ActionSetSeparator.java;2;0;2;1;0;0;0;2;4;1;2;457;4;4;1;0;0;2;2;457;0;620;2;2;
/org.eclipse.help/src/org/eclipse/help/internal/contributions/xml/HelpTopic.java;2;0;2;1;0;0;0;2;0;1;2;1420;0;0;1;0;0;2;2;1420;0;1675;2;2;
/org.eclipse.jdt.ui.tests.refactoring/resources/PullUpMethods/testFail3/in/A.java;1;0;2;1;0;0;0;2;0;1;2;2156;0;0;1;0;0;2;2;2156;0;2406;2;1;
/org.eclipse.pde.ui/Eclipse PDE UI/org/eclipse/pde/internal/launcher/WorkbenchLauncher.java;2;0;12;2;0;0;0;12;49;3;10;267;113;113;3;2;0;12;12;324;2;1434;10;2;
/org.eclipse.team.cvs.core/src/org/eclipse/team/internal/ccvs/core/util/DumpDeltaVisitor.java;2;0;4;1;0;0;0;4;76;2;3;2049;81;81;2;1;0;4;4;2049;1;2253;3;2;
/org.eclipse.jdt.ui/core refactoring/org/eclipse/jdt/internal/core/refactoring/changes/AbstractTextChange.java;1;0;4;1;0;0;0;4;57;2;3;1800;63;63;2;1;0;4;4;1937;1;1937;3;1;
/org.eclipse.jdt.ui.tests.refactoring/resources/RenameType/test30/in/AA.java;1;0;1;1;0;0;0;1;0;0;1;49;0;0;1;0;0;1;1;49;0;49;1;1;
/org.eclipse.core.boot/src/org/eclipse/core/internal/boot/update/LogEntryProperty.java;3;0;4;2;0;0;0;4;17;2;3;12;17;17;2;1;0;4;4;323;1;2726;3;3;
/org.eclipse.update/src/org/eclipse/update/internal/ui/UMDialog.java;1;0;1;1;0;0;0;1;0;0;1;1424;0;0;1;0;0;1;1;1424;0;1424;1;1;
/org.eclipse.jdt.ui.tests/refactoring/org/eclipse/jdt/refactoring/tests/UndoManagerTests.java;4;0;9;1;0;0;0;9;59;1;9;49;99;99;1;0;0;9;9;49;0;1896;9;4;
/org.eclipse.jdt.ui/ui/org/eclipse/jdt/ui/actions/DeclarationsSearchGroup.java;2;2;5;2;5;4;5;0;25;0;0;4146;39;39;2;0;1;0;5;4146;1;4770;4;2;
/org.eclipse.core.tests.resources/src/org/eclipse/core/tests/internal/watson/ElementTreeTest.java;3;0;4;1;1;1;1;3;1912;1;3;1794;1939;1939;1;0;0;3;4;1794;0;4516;4;3;
/org.eclipse.pde.ui/src/org/eclipse/pde/internal/model/WorkspacePluginModel.java;2;0;3;1;0;0;0;3;2;1;3;1434;2;2;1;0;0;3;3;1434;0;3136;3;2;
/org.eclipse.pde.ui/src/org/eclipse/pde/internal/PDEPluginImages.java;2;0;18;1;0;0;0;18;38;2;16;1434;130;130;2;2;0;18;18;2894;2;3579;16;2;
/org.eclipse.jdt.ui.tests.refactoring/resources/RenameParameters/canRename/A_test19_out.java;1;0;1;1;0;0;0;1;0;0;1;233;0;0;1;0;0;1;1;233;0;233;1;1;
/org.eclipse.pde.ui/src/org/eclipse/pde/internal/editor/manifest/RuntimeSection.java;2;0;5;1;0;0;0;5;6;1;5;1434;14;14;1;0;0;5;5;1434;0;3579;5;2;
/org.eclipse.ui/Eclipse UI/org/eclipse/ui/internal/misc/ActivatorBarLayout.java;2;0;2;1;0;0;0;2;5;1;2;257;5;5;1;0;0;2;2;257;0;457;2;2;
/org.eclipse.team.tests.cvs.core/src/org/eclipse/team/tests/ccvs/core/compatible/ConflictTest.java;2;0;6;2;0;0;0;6;18;2;5;2536;58;58;2;1;0;6;6;2989;1;3423;5;2;
/org.eclipse.jdt.ui.tests.refactoring/resources/ExtractMethodWorkSpace/ExtractMethodTests/invalidSelection/A_test148.java;1;1;3;1;2;2;2;1;28;0;1;887;28;28;1;0;0;1;3;887;0;4419;3;1;
/org.eclipse.team.cvs.ui/src/org/eclipse/team/internal/ccvs/ui/wizards/ConfigurationWizardMainPage.java;3;1;21;1;7;7;7;14;1230;2;13;1978;2096;2096;2;1;0;14;21;2722;1;4731;20;3;
/org.eclipse.team.cvs.ui/src/org/eclipse/team/internal/ccvs/ui/model/RemoteVersionModule.java;2;0;4;1;0;0;0;4;97;1;4;3559;105;105;1;0;0;4;4;3559;0;3644;4;2;
/org.eclipse.debug.ui/ui/org/eclipse/debug/internal/ui/views/DebugSelectionManager.java;2;0;6;1;0;0;0;6;99;2;5;2324;176;176;2;1;0;6;6;2324;1;3186;5;2;
/org.eclipse.jdt.debug.tests/testprograms/StepFilterTwo.java;2;1;2;1;2;2;2;0;11;0;0;4510;11;11;1;0;0;0;2;4510;0;4571;2;2;
/org.eclipse.swt/Eclipse SWT/common/org/eclipse/swt/events/TreeEvent.java;2;0;3;1;1;1;1;2;6;1;2;106;10;10;1;0;0;2;3;106;0;4701;3;2;
/org.eclipse.ui/Eclipse UI/org/eclipse/ui/internal/dialogs/PropertyPageNode.java;3;0;3;1;1;1;1;2;18;1;2;257;23;23;1;0;0;2;3;257;0;4429;3;3;
/org.eclipse.core.tests.resources/src/org/eclipse/core/tests/resources/session/SampleSessionTest.java;2;0;3;1;0;0;0;3;68;1;3;2289;78;78;1;0;0;3;3;2289;0;3475;3;2;
/org.eclipse.debug.ui/ui/org/eclipse/debug/internal/ui/OpenMarkerAction.java;3;0;5;1;0;0;0;5;6;1;5;187;11;11;1;0;0;5;5;187;0;2382;5;3;
/org.eclipse.jdt.core/model/org/eclipse/jdt/internal/core/SourceRange.java;2;0;9;1;1;1;1;8;59;4;5;455;131;131;4;3;0;8;9;1039;3;4063;6;2;
/org.eclipse.help.ui/src/org/eclipse/help/ui/internal/OpenHelpSearchPageAction.java;1;0;1;1;1;1;1;0;0;0;0;4439;0;0;1;0;0;0;1;4439;0;4439;1;1;
/org.eclipse.team.tests.cvs.core/src/org/eclipse/team/tests/ccvs/ui/LoggingTestResult.java;1;0;4;1;0;0;0;4;85;1;4;2977;127;127;1;0;0;4;4;2977;0;3311;4;1;
/org.eclipse.debug.ui/ui/org/eclipse/debug/internal/ui/StringMatcher.java;4;0;8;1;1;1;1;7;13;1;7;187;40;40;1;0;0;7;8;187;0;3975;8;4;
/org.eclipse.update.ui/src/org/eclipse/update/internal/ui/forms/RevertSection.java;2;1;6;1;5;5;5;1;131;0;1;3662;166;166;1;0;0;1;6;3662;0;4606;6;2;
/org.eclipse.jdt.debug.ui/ui/org/eclipse/jdt/internal/debug/ui/SourceAttachmentWizard.java;2;0;3;1;0;0;0;3;14;1;3;1915;14;14;1;0;0;3;3;1915;0;2355;3;2;
/org.eclipse.update.core/src/org/eclipse/update/core/IInstallHandlerReference.java;2;0;4;1;0;0;0;4;6;1;4;2004;8;8;1;0;0;4;4;2004;0;2981;4;2;
/org.eclipse.team.cvs.core/src/org/eclipse/team/internal/ccvs/core/client/listeners/StatusListener.java;2;0;10;1;1;1;1;9;89;1;9;2572;159;159;1;0;0;9;10;2572;0;4368;10;2;
/org.eclipse.jdt.ui.tests.refactoring/resources/ExtractTemp/canExtract/A_test19_out.java;1;0;1;1;0;0;0;1;0;0;1;2481;0;0;1;0;0;1;1;2481;0;2481;1;1;
/org.eclipse.swt/Eclipse SWT/win32/org/eclipse/swt/internal/win32/TEXTMETRIC.java;2;0;4;1;0;0;0;4;18;1;4;106;23;23;1;0;0;4;4;106;0;2069;4;2;
/org.eclipse.pde.ui/src/org/eclipse/pde/internal/core/feature/FeatureImport.java;1;0;3;1;0;0;0;3;2;1;3;3579;2;2;1;0;0;3;3;3579;0;3607;3;1;
/org.eclipse.pde.ui/src/org/eclipse/pde/internal/ui/editor/schema/SchemaDoubleClickStrategy.java;1;0;1;1;0;0;0;1;0;0;1;3579;0;0;1;0;0;1;1;3579;0;3579;1;1;
/org.eclipse.scripting/src/org/eclipse/scripting/internal/views/ScriptUIEditorTextHover.java;1;0;1;1;0;0;0;1;0;0;1;1424;0;0;1;0;0;1;1;1424;0;1424;1;1;
/org.eclipse.ui/Eclipse UI Tool Script/org/eclipse/toolscript/ui/internal/AntTreeLabelProvider.java;1;1;2;1;2;2;2;0;0;0;0;4065;0;0;1;0;0;0;2;4065;0;4087;2;1;
/org.eclipse.pde.ui/src/org/eclipse/pde/internal/core/ischema/IMetaAttribute.java;1;0;2;1;0;0;0;2;0;1;2;3591;0;0;1;0;0;2;2;3591;0;3607;2;1;
/org.eclipse.jdt.ui/ui refactoring/org/eclipse/jdt/internal/ui/nls/search/LineReader.java;1;0;2;1;0;0;0;2;0;1;2;1913;0;0;1;0;0;2;2;1913;0;1922;2;1;
/org.eclipse.jdt.ui.tests.refactoring/resources/RenameStaticMethod/test9/out/A.java;1;0;1;1;0;0;0;1;0;0;1;1274;0;0;1;0;0;1;1;1274;0;1274;1;1;
/org.eclipse.team.cvs.core/src/org/eclipse/team/internal/ccvs/core/util/AddDeleteMoveListener.java;2;1;15;2;4;4;4;11;261;2;10;3417;540;540;2;1;0;11;15;3610;1;4632;14;2;
/org.eclipse.pde.ui/src/org/eclipse/pde/internal/BaseProject.java;2;0;2;1;0;0;0;2;0;1;2;1434;0;0;1;0;0;2;2;1434;0;3579;2;2;
/org.eclipse.jdt.ui/ui/org/eclipse/jdt/internal/ui/filters/EmptyInnerPackageFilter.java;1;1;2;1;2;2;2;0;2;0;0;4211;2;2;1;0;0;0;2;4211;0;4441;2;1;
/org.eclipse.jdt.ui.tests.refactoring/resources/ExtractMethodWorkSpace/ExtractMethodTests/try_out/A_test462.java;1;1;4;1;2;2;2;2;34;1;2;2634;36;36;1;0;0;2;4;2634;0;4419;4;1;
/org.eclipse.core.runtime/src/org/eclipse/core/internal/runtime/Cipher.java;4;0;6;2;2;1;2;4;212;1;4;12;228;228;2;0;1;4;6;4213;1;4213;5;4;
/org.eclipse.core.tests.runtime/src/org/eclipse/core/tests/internal/plugins/PluginResolveTest_31.java;3;0;3;1;0;0;0;3;110;1;3;1794;120;120;1;0;0;3;3;1794;0;3476;3;3;
/org.eclipse.jdt.ui.tests.refactoring/resources/RenameParameters/canRename/A_test26_out.java;1;0;1;1;0;0;0;1;0;0;1;233;0;0;1;0;0;1;1;233;0;233;1;1;
/org.eclipse.core.resources/src/org/eclipse/core/resources/team/IResourceTree.java;1;0;5;1;0;0;0;5;873;2;4;3195;1129;1129;2;1;0;5;5;3243;1;3360;4;1;
/org.eclipse.core.tests.resources/src/org/eclipse/core/tests/internal/dtree/AllTests.java;3;0;3;1;0;0;0;3;46;1;3;1794;51;51;1;0;0;3;3;1794;0;3420;3;3;
/org.eclipse.pde.ui/src/org/eclipse/pde/internal/editor/manifest/DetailExtensionPointSection.java;2;0;11;1;0;0;0;11;375;2;10;1434;533;533;2;1;0;11;11;3035;1;3579;10;2;
/org.eclipse.webdav/src/interface/org/eclipse/webdav/ServerFactory.java;3;0;3;1;0;0;0;3;12;1;3;12;12;12;1;0;0;3;3;12;0;1874;3;3;
/org.eclipse.jdt.core/compiler/org/eclipse/jdt/internal/compiler/lookup/ClassScope.java;3;1;20;1;2;2;2;18;8916;4;14;455;15111;15111;4;4;0;18;20;1039;4;4062;16;3;
/org.eclipse.team.core/src/org/eclipse/team/internal/core/Assert.java;2;1;3;1;3;3;3;0;5;0;0;4019;7;7;1;0;0;0;3;4019;0;4249;3;2;
/org.eclipse.jdt.ui.tests.refactoring/resources/RenameTemp/canRename/A_test33_out.java;1;0;3;1;0;0;0;3;4;1;3;1625;6;6;1;0;0;3;3;1625;0;2481;3;1;
/org.eclipse.jdt.ui/ui/org/eclipse/jdt/internal/ui/compare/JavaHistoryEditorAction.java;1;1;2;1;2;2;2;0;43;0;0;4161;43;43;1;0;0;0;2;4161;0;4546;2;1;
/org.eclipse.jdt.ui/ui/org/eclipse/jdt/internal/ui/search/JavaElementAction.java;6;1;27;2;3;3;3;24;155;2;22;355;636;636;2;2;0;24;27;1238;2;4123;25;6;
/org.eclipse.team.tests.cvs.core/src/org/eclipse/team/tests/ccvs/core/cvsresources/LocalFolderTest.java;2;0;6;1;0;0;0;6;48;1;6;2536;84;84;1;0;0;6;6;2536;0;3089;6;2;
/org.eclipse.compare/compare/org/eclipse/compare/patch/LineReader.java;1;0;5;1;0;0;0;5;17;1;5;1516;35;35;1;0;0;5;5;1516;0;2876;5;1;
/org.eclipse.jdt.ui.tests.refactoring/test cases/org/eclipse/jdt/ui/tests/refactoring/RenamePrivateFieldTests.java;2;0;6;1;0;0;0;6;42;1;6;1896;129;129;1;0;0;6;6;1896;0;2931;6;2;
/org.eclipse.team.cvs.ui/src/org/eclipse/team/internal/ccvs/ui/wizards/ConfigurationWizardAutoconnectPage.java;3;1;15;2;2;2;2;13;66;2;11;2577;165;165;2;2;0;13;15;2756;2;4455;13;3;
/org.eclipse.jdt.debug/jdi interfaces/com/sun/jdi/Location.java;3;0;3;1;0;0;0;3;8;1;3;2704;10;10;1;0;0;3;3;2704;0;3033;3;3;
/org.eclipse.jdt.ui.tests/refactoring/org/eclipse/jdt/refactoring/tests/RenameParametersTests.java;4;0;15;1;0;0;0;15;24;2;13;233;99;99;2;2;0;15;15;233;2;1896;13;4;
/org.eclipse.jdt.ui/core refactoring/org/eclipse/jdt/internal/core/refactoring/sef/AccessAnalyzer.java;1;0;5;1;0;0;0;5;98;1;5;1453;144;144;1;0;0;5;5;1453;0;1939;5;1;
/org.eclipse.scripting/Eclipse Scripting/org/eclipse/scripting/internal/uirenderer/XGRElementUISwtScriptPreferencePage.java;2;0;4;1;0;0;0;4;36;1;4;133;40;40;1;0;0;4;4;133;0;1424;4;2;
/org.eclipse.ui.examples.javaeditor/Eclipse Java Editor Example/org/eclipse/ui/examples/javaeditor/javadoc/JavaDocCompletionProcessor.java;1;0;1;1;0;0;0;1;0;0;1;1067;0;0;1;0;0;1;1;1067;0;1067;1;1;
/org.eclipse.jdt.ui/ui/org/eclipse/jdt/internal/ui/actions/AddTaskAction.java;2;1;3;1;3;3;3;0;22;0;0;4187;25;25;1;0;0;0;3;4187;0;4630;3;2;
/org.eclipse.jdt.debug/eval/org/eclipse/jdt/debug/eval/model/ICompiledExpression.java;2;0;2;1;0;0;0;2;0;1;2;3421;0;0;1;0;0;2;2;3421;0;3555;2;2;
/org.eclipse.core.tests.resources/src/org/eclipse/core/tests/resources/regression/Bug_6708.java;2;0;3;1;1;1;1;2;100;1;2;2181;110;110;1;0;0;2;3;2181;0;4516;3;2;
/org.eclipse.jdt.ui.tests.refactoring/resources/SurroundWithWorkSpace/SurroundWithTests/trycatch_out/TestWrappedLocal1.java;1;0;2;1;0;0;0;2;7;1;2;2327;7;7;1;0;0;2;2;2327;0;3870;2;1;
/org.eclipse.ui.tests/Eclipse JFace Tests/org/eclipse/jface/tests/viewers/TableTreeViewerTest.java;1;0;1;1;0;0;0;1;0;0;1;1488;0;0;1;0;0;1;1;1488;0;1488;1;1;
/org.eclipse.jdt.ui/ui/org/eclipse/jdt/internal/ui/wizards/buildpaths/VariableSelectionDialog.java;1;0;4;1;0;0;0;4;49;2;3;159;49;49;2;1;0;4;4;172;1;190;3;1;
/org.eclipse.pde.core/src/org/eclipse/pde/internal/core/build/WorkspaceBuildModel.java;1;1;4;1;2;2;2;2;3;1;2;3591;7;7;1;0;0;2;4;3591;0;4711;4;1;
/org.eclipse.swt.tests/JUnit Tests/org/eclipse/swt/tests/junit/Test_org_eclipse_swt_widgets_ScrollBar.java;2;0;2;1;1;1;1;1;6;0;1;1792;6;6;1;0;0;1;2;1792;0;4706;2;2;
/org.eclipse.jdt.ui/ui/org/eclipse/jdt/internal/ui/wizards/OpenProjectWizardAction.java;3;0;5;1;1;1;1;4;12;1;4;15;32;32;1;0;0;4;5;15;0;4630;5;3;
/org.eclipse.jdt.ui.tests.refactoring/resources/ExtractMethodWorkSpace/ExtractMethodTests/try_in/A_test462.java;1;1;4;1;2;2;2;2;28;1;2;2634;29;29;1;0;0;2;4;2634;0;4419;4;1;
/org.eclipse.pde.ui/Eclipse PDE UI/org/eclipse/pde/internal/wizards/extension/BaseExtensionPointMainPage.java;2;0;8;2;0;0;0;8;15;3;6;267;44;44;3;2;0;8;8;324;2;1434;6;2;
/org.eclipse.swt/Eclipse SWT PI/gtk/org/eclipse/swt/internal/gtk/GtkCListColumn.java;2;0;5;1;2;1;2;3;15;1;3;2107;27;27;2;0;1;3;5;4701;1;4701;4;2;
/org.eclipse.jdt.debug/model/org/eclipse/jdt/internal/debug/core/JDIDebugModelMessages.java;2;0;2;1;0;0;0;2;0;1;2;1362;0;0;1;0;0;2;2;1362;0;2523;2;2;
/org.eclipse.jdt.ui.tests.refactoring/resources/ExtractMethodWorkSpace/ExtractMethodTests/locals_in/A_test566.java;1;1;2;1;2;2;2;0;0;0;0;4383;0;0;1;0;0;0;2;4383;0;4419;2;1;
/org.eclipse.jdt.debug.tests/tests/org/eclipse/jdt/debug/tests/eval/NestedTypeFieldValue_444.java;2;1;3;1;3;3;3;0;12;0;0;4447;14;14;1;0;0;0;3;4447;0;4571;3;2;
/org.eclipse.pde.ui/src/org/eclipse/pde/internal/forms/renamed/HyperlinkHandler.java;1;0;2;1;0;0;0;2;0;1;2;2470;0;0;1;0;0;2;2;2470;0;2691;2;1;
/org.eclipse.ui/Eclipse UI/org/eclipse/ui/internal/PluginActionBuilder.java;5;1;8;1;2;2;2;6;234;2;5;257;289;289;2;1;0;6;8;2033;1;4293;7;5;
/org.eclipse.jdt.ui/core refactoring/org/eclipse/jdt/internal/core/refactoring/text/ITextBufferChangeCreator.java;2;0;3;1;0;0;0;3;2;1;3;408;2;2;1;0;0;3;3;408;0;1939;3;2;
/org.eclipse.ant.core/src/org/eclipse/ant/internal/core/old/EclipseProject.java;1;0;1;1;0;0;0;1;0;0;1;3270;0;0;1;0;0;1;1;3270;0;3270;1;1;
/org.eclipse.pde.ui/src/org/eclipse/pde/internal/ui/model/ifeature/IFeatureURL.java;1;0;2;1;0;0;0;2;0;1;2;3579;0;0;1;0;0;2;2;3579;0;3591;2;1;
/org.eclipse.ant.core/src/plugin/org/eclipse/ant/internal/core/Type.java;1;0;1;1;0;0;0;1;0;0;1;3475;0;0;1;0;0;1;1;3475;0;3475;1;1;
/org.eclipse.jdt.debug/jdi interfaces/com/sun/jdi/CharType.java;2;0;2;1;0;0;0;2;6;1;2;2704;6;6;1;0;0;2;2;2704;0;3033;2;2;
/org.eclipse.swt/Eclipse SWT Drag and Drop/emulated/org/eclipse/swt/dnd/Transfer.java;2;1;5;1;4;4;4;1;58;0;1;3126;110;110;1;0;0;1;5;3126;0;4830;5;2;
/org.eclipse.compare/compare/org/eclipse/compare/IContentChangeListener.java;1;0;2;1;0;0;0;2;5;1;2;14;5;5;1;0;0;2;2;14;0;329;2;1;
/org.eclipse.swt/Eclipse SWT/motif/org/eclipse/swt/internal/motif/OS.java;7;0;13;1;0;0;0;13;64;1;13;106;202;202;1;0;0;13;13;106;0;2069;13;7;
/org.eclipse.swt/Eclipse SWT/win32/org/eclipse/swt/widgets/ToolItem.java;9;2;24;2;6;5;6;18;89;2;16;106;389;389;2;2;1;18;24;1085;3;4701;21;9;
/org.eclipse.pde.ui/src/org/eclipse/pde/internal/ui/wizards/imports/PluginImportWizardFirstPage.java;1;1;5;1;3;3;3;2;110;1;2;3579;215;215;1;0;0;2;5;3579;0;4702;5;1;
/org.eclipse.jdt.ui.tests.refactoring/resources/ExtractMethodWorkSpace/ExtractMethodTests/branch_in/A_test752.java;1;1;3;1;2;2;2;1;26;0;1;1851;26;26;1;0;0;1;3;1851;0;4419;3;1;
/org.eclipse.update.ui.forms/src/org/eclipse/update/ui/forms/FormWidgetFactory.java;1;0;5;1;0;0;0;5;7;1;5;1423;13;13;1;0;0;5;5;1423;0;2474;5;1;
/org.eclipse.scripting/Eclipse Scripting/org/eclipse/scripting/internal/uirenderer/XGRNode.java;2;0;4;1;0;0;0;4;19;1;4;133;27;27;1;0;0;4;4;133;0;1424;4;2;
/org.eclipse.swt/Eclipse SWT PI/gtk1x/org/eclipse/swt/internal/gtk/GtkRequisition.java;2;0;2;1;1;1;1;1;3;0;1;2107;3;3;1;0;0;1;2;2107;0;4701;2;2;
/org.eclipse.ui/Eclipse UI Standard Components/org/eclipse/ui/views/tasklist/MarkerAttributeCache.java;1;0;1;1;0;0;0;1;0;0;1;949;0;0;1;0;0;1;1;949;0;949;1;1;
/org.eclipse.pde.ui/src/org/eclipse/pde/internal/launcher/BasicLauncherTab.java;1;0;5;1;0;0;0;5;22;1;5;3093;40;40;1;0;0;5;5;3093;0;3579;5;1;
/org.eclipse.jdt.ui.tests.refactoring/resources/RenamePackage/testFail5/in/r/A.java;1;0;1;1;0;0;0;1;0;0;1;1258;0;0;1;0;0;1;1;1258;0;1258;1;1;
/org.eclipse.ui.tests/Eclipse UI Tests/org/eclipse/ui/tests/api/MockSelectionProvider.java;1;0;3;1;0;0;0;3;10;1;3;1080;12;12;1;0;0;3;3;1080;0;2236;3;1;
/org.eclipse.pde.ui/src/org/eclipse/pde/internal/editor/manifest/LibrarySection.java;2;0;13;1;0;0;0;13;487;2;11;1434;568;568;2;2;0;13;13;3035;2;3579;11;2;
/org.eclipse.jdt.ui.tests.refactoring/resources/PullUp/testFail9/in/B.java;1;0;1;1;0;0;0;1;0;0;1;2406;0;0;1;0;0;1;1;2406;0;2406;1;1;
/org.eclipse.swt/Eclipse SWT/common/org/eclipse/swt/internal/image/WinICOFileFormat.java;3;0;4;1;1;1;1;3;7;1;3;106;16;16;1;0;0;3;4;106;0;4701;4;3;
/org.eclipse.vcm.core.cvs/src/org/eclipse/vcm/internal/core/ccvs/FileUtil.java;2;0;2;1;0;0;0;2;5;1;2;0;5;5;1;0;0;2;2;0;0;298;2;2;
/org.eclipse.scripting/Eclipse Scripting/org/eclipse/scripting/internal/ScriptPlatform.java;1;0;3;1;0;0;0;3;4;1;3;133;4;4;1;0;0;3;3;133;0;1424;3;1;
/org.eclipse.core.resources/src/org/eclipse/core/internal/watson/IDeltaFilter.java;1;0;4;1;1;1;1;3;42;1;3;12;63;63;1;0;0;3;4;12;0;4214;4;1;
/org.eclipse.swt.examples.controls/org/eclipse/swt/examples/controls/ComboTab.java;2;0;3;1;0;0;0;3;107;1;3;513;107;107;1;0;0;3;3;513;0;970;3;2;
/org.eclipse.jdt.ui/core refactoring/org/eclipse/jdt/internal/core/refactoring/text/AbstractTextBufferChange.java;4;0;7;1;0;0;0;7;39;1;7;408;73;73;1;0;0;7;7;408;0;1939;7;4;
/org.eclipse.update.core/src/org/eclipse/update/core/FeatureContentProvider.java;2;2;28;2;8;5;8;20;458;2;17;2442;1590;1590;2;3;3;20;28;2757;6;4421;22;2;
/org.eclipse.scripting/Eclipse Scripting/org/eclipse/scripting/internal/uirenderer/XGRResources.java;2;0;4;1;0;0;0;4;40;1;4;133;48;48;1;0;0;4;4;133;0;1424;4;2;
/org.eclipse.ui/Eclipse UI/org/eclipse/ui/internal/AbstractSelectionService.java;3;2;5;1;4;3;4;1;81;0;1;2999;106;106;2;0;1;1;5;4193;1;4747;4;3;
/org.eclipse.jdt.ui/core refactoring/org/eclipse/jdt/internal/core/refactoring/RenameResourceChange.java;3;0;10;1;0;0;0;10;36;2;9;15;62;62;2;1;0;10;10;325;1;1939;9;3;
/org.eclipse.ui/Eclipse UI/org/eclipse/ui/internal/PageSelectionService.java;1;0;1;1;0;0;0;1;0;0;1;2999;0;0;1;0;0;1;1;2999;0;2999;1;1;
/org.eclipse.jdt.debug/model/org/eclipse/jdt/internal/debug/core/ExceptionBreakpoint.java;1;0;1;1;0;0;0;1;0;0;1;831;0;0;1;0;0;1;1;831;0;831;1;1;
/org.eclipse.pde.ui/Eclipse PDE UI/org/eclipse/pde/internal/schema/SchemaElementReference.java;2;0;6;2;0;0;0;6;35;3;4;267;47;47;3;2;0;6;6;324;2;1434;4;2;
/org.eclipse.jdt.ui.tests.refactoring/resources/RenameType/test27/out/B.java;1;0;1;1;0;0;0;1;0;0;1;522;0;0;1;0;0;1;1;522;0;522;1;1;
/org.eclipse.jdt.debug.ui/ui/org/eclipse/jdt/internal/debug/ui/display/IDataDisplay.java;2;0;2;1;0;0;0;2;11;1;2;1915;11;11;1;0;0;2;2;1915;0;2084;2;2;
/org.eclipse.ui/Eclipse UI Standard Components/org/eclipse/ui/views/framelist/IFrameListHelpContextIds.java;1;0;1;1;1;1;1;0;0;0;0;4609;0;0;1;0;0;0;1;4609;0;4609;1;1;
/org.eclipse.ant.core/src/plugin/org/eclipse/ant/core/IAntCoreConstants.java;1;0;1;1;0;0;0;1;0;0;1;3475;0;0;1;0;0;1;1;3475;0;3475;1;1;
/org.eclipse.jdt.ui.tests.refactoring/test cases/org/eclipse/jdt/ui/tests/actions/SourceReferenceTestUtil.java;2;1;14;2;3;3;3;11;16;2;10;2860;77;77;2;1;0;11;14;3826;1;4278;13;2;
/org.eclipse.jdt.debug.ui/ui/org/eclipse/jdt/internal/debug/ui/actions/BreakpointThreadToggleAction.java;2;0;5;1;1;1;1;4;7;2;3;2666;11;11;2;1;0;4;5;3362;1;4126;4;2;
/org.eclipse.debug.ui/ui/org/eclipse/debug/internal/ui/ToggleFilterAction.java;1;0;2;1;0;0;0;2;0;1;2;2317;0;0;1;0;0;2;2;2317;0;2382;2;1;
/org.eclipse.jdt.junit/Eclipse JUnit/org/eclipse/jdt/internal/junit/ui/ApplicationWizard.java;1;0;2;1;0;0;0;2;0;1;2;2007;0;0;1;0;0;2;2;2007;0;2143;2;1;
/org.eclipse.core.resources/src/org/eclipse/core/internal/dtree/NoDataDeltaNode.java;2;0;6;1;1;1;1;5;222;2;4;12;443;443;2;1;0;5;6;1241;1;4214;5;2;
/org.eclipse.update.core/src/org/eclipse/update/internal/core/ContentConsumer.java;1;0;2;1;0;0;0;2;8;1;2;2994;8;8;1;0;0;2;2;2994;0;3596;2;1;
/org.eclipse.jdt.ui.tests.refactoring/resources/RenamePackage/test3/out/p/r/B.java;2;0;2;1;0;0;0;2;0;1;2;91;0;0;1;0;0;2;2;91;0;1258;2;2;
/org.eclipse.ui/Eclipse JFace/org/eclipse/jface/action/ContributionManager.java;3;1;7;2;2;2;2;5;50;3;3;257;85;85;3;2;0;5;7;3447;2;4400;5;3;
/org.eclipse.ui/Eclipse UI/org/eclipse/ui/internal/dialogs/ActionSetSorter.java;3;0;5;1;1;1;1;4;22;1;4;257;54;54;1;0;0;4;5;257;0;4042;5;3;
/org.eclipse.pde.ui/src/org/eclipse/pde/internal/editor/manifest/NewElementAction.java;2;0;6;1;0;0;0;6;5;1;6;1434;10;10;1;0;0;6;6;1434;0;3579;6;2;
/org.eclipse.vcm.core.cvs/src/org/eclipse/vcm/internal/core/ccvs/requests/IModuleNamesListener.java;2;0;2;1;0;0;0;2;15;1;2;1008;15;15;1;0;0;2;2;1008;0;1277;2;2;
/org.eclipse.swt/Eclipse SWT/win32/org/eclipse/swt/internal/win32/SIZE.java;2;0;3;1;0;0;0;3;5;1;3;106;5;5;1;0;0;3;3;106;0;2069;3;2;
/org.eclipse.jdt.ui.tests.refactoring/resources/RenameParameters/cannotRename/A_testFail6.java;1;0;1;1;0;0;0;1;0;0;1;233;0;0;1;0;0;1;1;233;0;233;1;1;
/org.eclipse.team.cvs.ui/src/org/eclipse/team/internal/ccvs/ui/model/GroupedByVersionCategory.java;2;0;4;1;0;0;0;4;109;1;4;3559;116;116;1;0;0;4;4;3559;0;3644;4;2;
/org.eclipse.jdt.ui.tests.refactoring/resources/ExtractTemp/canExtract/A_test19_in.java;1;0;1;1;0;0;0;1;0;0;1;2481;0;0;1;0;0;1;1;2481;0;2481;1;1;
/org.eclipse.jdt.ui.tests.refactoring/resources/ExtractMethodWorkSpace/ExtractMethodTests/locals_out/A_test500.java;2;1;4;1;2;2;2;2;20;1;2;80;22;22;1;0;0;2;4;80;0;4419;4;2;
/org.eclipse.pde.ui/src/org/eclipse/pde/internal/feature/BuildComponentJarAction.java;1;0;2;1;0;0;0;2;0;1;2;2951;0;0;1;0;0;2;2;2951;0;3031;2;1;
/org.eclipse.jdt.ui.tests.refactoring/resources/RenamePackage/testFail3/in/r/A.java;1;0;1;1;0;0;0;1;0;0;1;1258;0;0;1;0;0;1;1;1258;0;1258;1;1;
/org.eclipse.pde.ui/src/org/eclipse/pde/internal/forms/IHyperlinkListener.java;2;0;2;1;0;0;0;2;0;1;2;1434;0;0;1;0;0;2;2;1434;0;2470;2;2;
/org.eclipse.vcm.core/src/org/eclipse/vcm/internal/core/SharingManager.java;7;0;37;2;0;0;0;37;394;3;29;0;1280;1280;3;8;0;37;37;158;8;1742;29;7;
/org.eclipse.update.core/src/org/eclipse/update/internal/core/SiteFilePluginContentConsumer.java;2;1;24;2;9;9;9;15;167;2;14;2501;527;527;2;1;0;15;24;2791;1;4747;23;2;
/org.eclipse.debug.ui/ui/org/eclipse/debug/internal/ui/LaunchHistoryElement.java;3;0;4;1;0;0;0;4;40;2;3;963;73;73;2;1;0;4;4;963;1;2988;3;3;
/org.eclipse.jdt.debug.ui/ui/org/eclipse/jdt/internal/debug/ui/actions/AbstractManageBreakpointActionDelegate.java;1;1;4;1;4;4;4;0;81;0;0;4025;182;182;1;0;0;0;4;4025;0;4692;4;1;
/org.eclipse.jdt.debug.tests/tests/org/eclipse/jdt/debug/tests/eval/ArrayValueTests.java;2;2;3;2;3;2;3;0;17;0;0;4447;19;19;2;0;1;0;3;4447;1;4571;2;2;
/org.eclipse.pde.ui/Eclipse PDE UI/org/eclipse/pde/internal/CoreUtility.java;2;0;6;2;0;0;0;6;14;3;4;267;26;26;3;2;0;6;6;324;2;1434;4;2;
/org.eclipse.swt.examples/src/org/eclipse/swt/examples/texteditor/TextEditor.java;6;1;7;1;2;2;2;5;355;1;5;540;452;452;1;0;0;5;7;540;0;4705;7;6;
/org.eclipse.debug.core/core/org/eclipse/debug/core/model/IDebugTarget.java;3;0;13;1;1;1;1;12;27;1;12;187;122;122;1;0;0;12;13;187;0;4651;13;3;
/org.eclipse.jdt.ui.tests.refactoring/resources/ExtractTemp/canExtract/A_test27_out.java;1;0;1;1;0;0;0;1;0;0;1;3105;0;0;1;0;0;1;1;3105;0;3105;1;1;
/org.eclipse.core.tests.resources/src/org/eclipse/core/tests/internal/localstore/SafeFileInputOutputStreamTest.java;3;0;4;1;1;1;1;3;346;1;3;1794;376;376;1;0;0;3;4;1794;0;4516;4;3;
/org.eclipse.swt.tests/JUnit Tests/org/eclipse/swt/tests/junit/Test_org_eclipse_swt_widgets_ProgressBar.java;2;0;2;1;1;1;1;1;6;0;1;1792;6;6;1;0;0;1;2;1792;0;4706;2;2;
/org.eclipse.ui.tests/Eclipse UI Tests/org/eclipse/ui/tests/api/SessionTest1.java;1;0;2;1;0;0;0;2;0;1;2;1041;0;0;1;0;0;2;2;1041;0;1067;2;1;
/org.eclipse.jdt.core/search/org/eclipse/jdt/internal/core/search/matching/DeclarationOfAccessedFieldsPattern.java;3;1;6;1;2;2;2;4;38;1;4;1944;65;65;1;0;0;4;6;1944;0;4421;6;3;
/org.eclipse.team.tests.cvs.core/src/org/eclipse/team/tests/ccvs/ui/DummyPromptCondition.java;3;1;3;1;2;2;2;1;10;0;1;3835;12;12;1;0;0;1;3;3835;0;4545;3;3;
/org.eclipse.scripting/Eclipse Scripting/org/eclipse/scripting/internal/uirenderer/XGRElementUISwtFieldSet.java;2;0;4;1;0;0;0;4;4;1;4;133;5;5;1;0;0;4;4;133;0;1424;4;2;
/org.eclipse.jdt.ui/core extension/org/eclipse/jdt/internal/corext/template/SimpleTemplateVariable.java;1;0;1;1;0;0;0;1;0;0;1;2784;0;0;1;0;0;1;1;2784;0;2784;1;1;
/org.eclipse.jdt.ui/ui refactoring/org/eclipse/jdt/internal/ui/refactoring/actions/RenameAction.java;2;0;4;1;1;1;1;3;26;2;2;3791;33;33;2;1;0;3;4;3791;1;3970;3;2;
/org.eclipse.vcm.ui/src/org/eclipse/vcm/internal/ui/adapter/IRepositoryUIAdapter.java;2;0;4;1;0;0;0;4;5;1;4;1;12;12;1;0;0;4;4;1;0;298;4;2;
/org.eclipse.jdt.ui/ui/org/eclipse/jdt/internal/ui/search/FindWriteReferencesAction.java;1;2;6;1;4;3;4;2;31;1;2;1707;52;52;2;0;1;2;6;4140;1;4140;5;1;
/org.eclipse.pde.ui/Eclipse PDE UI/org/eclipse/pde/internal/elements/DefaultElement.java;2;0;5;2;0;0;0;5;12;3;3;267;12;12;3;2;0;5;5;324;2;1434;3;2;
/org.eclipse.vcm.ui/src/org/eclipse/vcm/internal/ui/syncdialog/CatchupReleaseViewer.java;2;0;2;1;0;0;0;2;0;1;2;1;0;0;1;0;0;2;2;1;0;68;2;2;
/org.eclipse.swt/Eclipse SWT/motif/org/eclipse/swt/internal/motif/XRectangle.java;2;0;3;1;0;0;0;3;4;1;3;106;4;4;1;0;0;3;3;106;0;2069;3;2;
/org.eclipse.debug.ui/ui/org/eclipse/debug/internal/ui/actions/TerminateActionDelegate.java;2;0;7;1;1;1;1;6;44;1;6;2382;86;86;1;0;0;6;7;2382;0;4163;7;2;
/org.eclipse.ant.core/src/org/eclipse/ant/core/AntPlugin.java;5;0;9;2;0;0;0;9;374;2;8;14;693;693;2;1;0;9;9;493;1;3489;8;5;
/org.eclipse.jdt.ui/core refactoring/org/eclipse/jdt/internal/corext/refactoring/base/IChangeExceptionHandler.java;1;0;1;1;0;0;0;1;0;0;1;1939;0;0;1;0;0;1;1;1939;0;1939;1;1;
/org.eclipse.jdt.ui.tests.refactoring/resources/ReorderParameters/canReorder/A_test8_out.java;1;0;3;1;0;0;0;3;0;1;3;724;0;0;1;0;0;3;3;724;0;2270;3;1;
/org.eclipse.jdt.ui.tests.refactoring/resources/RenameVariables/canRename/A_test8_in.java;1;0;2;1;0;0;0;2;0;1;2;724;0;0;1;0;0;2;2;724;0;1665;2;1;
/org.eclipse.jdt.ui/ui/org/eclipse/jdt/internal/ui/typehierarchy/SubTypeHierarchyViewer.java;2;0;11;1;0;0;0;11;23;2;10;15;70;70;2;1;0;11;11;2462;1;3150;10;2;
/org.eclipse.jdt.core/model/org/eclipse/jdt/internal/core/SourceRefElementInfo.java;2;1;4;1;2;2;2;2;67;1;2;455;97;97;1;0;0;2;4;455;0;4063;4;2;
/org.eclipse.jdt.ui.tests.refactoring/resources/RenameType/test55/in/A.java;1;0;1;1;0;0;0;1;0;0;1;1284;0;0;1;0;0;1;1;1284;0;1284;1;1;
/org.eclipse.core.resources/src/org/eclipse/core/internal/events/NodeIDMap.java;2;0;5;1;1;1;1;4;512;1;4;1006;789;789;1;0;0;4;5;1006;0;4214;5;2;
/org.eclipse.jdt.core/model/org/eclipse/jdt/core/eval/IGlobalVariable.java;2;0;4;1;1;1;1;3;48;1;3;455;77;77;1;0;0;3;4;455;0;4061;4;2;
/org.eclipse.ui/Eclipse JFace/org/eclipse/jface/viewers/ViewerSorter.java;2;0;2;1;0;0;0;2;5;1;2;257;5;5;1;0;0;2;2;257;0;457;2;2;
/org.eclipse.core.tests.runtime/src/org/eclipse/core/tests/internal/plugins/SoftPrereqTest_6.java;3;0;3;1;0;0;0;3;178;1;3;1794;188;188;1;0;0;3;3;1794;0;3476;3;3;
/org.eclipse.debug.core/core/org/eclipse/debug/core/IDebugStatusConstants.java;2;0;3;1;0;0;0;3;5;1;3;187;5;5;1;0;0;3;3;187;0;1724;3;2;
/org.eclipse.pde.ui/src/org/eclipse/pde/internal/editor/IOpenablePropertySource.java;2;0;2;1;0;0;0;2;0;1;2;1434;0;0;1;0;0;2;2;1434;0;3579;2;2;
/org.eclipse.pde.ui/Eclipse PDE UI/org/eclipse/pde/internal/PDEProblemFinder.java;2;0;2;1;0;0;0;2;0;1;2;518;0;0;1;0;0;2;2;518;0;1434;2;2;
/org.eclipse.jdt.ui.tests.refactoring/resources/ExtractMethodWorkSpace/ExtractMethodTests/locals_in/A_test504.java;2;1;4;1;2;2;2;2;16;1;2;80;16;16;1;0;0;2;4;80;0;4419;4;2;
/org.eclipse.jdt.ui.tests.refactoring/resources/PullUp/testFail6/in/A.java;1;0;1;1;0;0;0;1;0;0;1;2406;0;0;1;0;0;1;1;2406;0;2406;1;1;
/org.eclipse.help.ui.win32/src/org/eclipse/help/ui/internal/browser/win32/IEBrowserAdapter.java;2;1;3;1;3;3;3;0;4;0;0;4427;7;7;1;0;0;0;3;4427;0;4729;3;2;
/org.eclipse.team.cvs.core/src/org/eclipse/team/ccvs/core/IRemoteFolder.java;2;0;3;1;0;0;0;3;6;1;3;1978;6;6;1;0;0;3;3;1978;0;2049;3;2;
/org.eclipse.update.ui/src/org/eclipse/update/internal/ui/manager/FeatureSection.java;1;0;3;1;0;0;0;3;100;2;2;1436;100;100;2;1;0;3;3;1436;1;1457;2;1;
/org.eclipse.ant.core/src/org/eclipse/ant/core/IAntRunnerListener.java;3;0;3;1;0;0;0;3;2;1;3;981;2;2;1;0;0;3;3;981;0;3489;3;3;
/org.eclipse.jdt.ui.tests.refactoring/resources/RenameType/test58/in/A.java;1;1;2;1;2;2;2;0;2;0;0;4291;2;2;1;0;0;0;2;4291;0;4423;2;1;
/org.eclipse.jdt.debug.tests/tests/org/eclipse/jdt/debug/tests/eval/TestsArrays.java;2;2;4;2;4;3;4;0;12;0;0;4447;18;18;2;0;1;0;4;4568;1;4568;3;2;
/org.eclipse.scripting/Eclipse Scripting/org/eclipse/scripting/internal/views/ScriptDevelopmentWizardPageScriptName.java;2;0;4;1;0;0;0;4;19;1;4;133;38;38;1;0;0;4;4;133;0;1424;4;2;
/org.eclipse.debug.core/core/org/eclipse/debug/internal/core/RuntimeProcess.java;3;1;19;2;2;2;2;17;67;2;14;187;249;249;2;3;0;17;19;507;3;4423;16;3;
/org.eclipse.jdt.ui.tests.refactoring/resources/RenameType/testFail20/in/AA.java;1;0;1;1;0;0;0;1;0;0;1;49;0;0;1;0;0;1;1;49;0;49;1;1;
/org.eclipse.jdt.core/dom/org/eclipse/jdt/core/dom/QualifiedName.java;2;1;9;1;3;3;3;6;16;1;6;2669;60;60;1;0;0;6;9;2669;0;4453;9;2;
/org.eclipse.update.core/src/org/eclipse/update/core/Site.java;2;2;45;1;11;10;11;34;374;3;29;2465;2131;2131;3;5;1;34;45;2790;6;4408;39;2;
/org.eclipse.scripting/Eclipse Scripting/org/eclipse/scripting/internal/IXGRElementUIListener.java;1;0;3;1;0;0;0;3;4;1;3;133;4;4;1;0;0;3;3;133;0;1424;3;1;
/org.eclipse.update.tests.core/src/org/eclipse/update/tests/regularInstall/TestGetFeature.java;1;0;6;1;0;0;0;6;16;2;5;1531;45;45;2;1;0;6;6;1638;1;1791;5;1;
/org.eclipse.pde.ui/src/org/eclipse/pde/internal/ui/codegen/AttributeClassCodeGenerator.java;1;0;2;1;0;0;0;2;2;1;2;3579;2;2;1;0;0;2;2;3579;0;3591;2;1;
/org.eclipse.jdt.ui.tests.refactoring/resources/ExtractMethodWorkSpace/ExtractMethodTests/validSelection_in/A_test360.java;1;1;3;1;2;2;2;1;16;0;1;2621;16;16;1;0;0;1;3;2621;0;4419;3;1;
/org.eclipse.help/src/org/eclipse/help/internal/protocols/links/Handler.java;1;0;2;1;0;0;0;2;0;1;2;2572;0;0;1;0;0;2;2;2572;0;2694;2;1;
/org.eclipse.jdt.ui.tests.refactoring/resources/ExtractMethodWorkSpace/ExtractMethodTests/locals_out/A_test524.java;1;1;4;1;2;2;2;2;50;1;2;2684;52;52;1;0;0;2;4;2684;0;4419;4;1;
/org.eclipse.jdt.ui.tests.refactoring/resources/RenamePrivateMethod/test2/in/A.java;1;0;1;1;0;0;0;1;0;0;1;49;0;0;1;0;0;1;1;49;0;49;1;1;
/org.eclipse.swt/Eclipse SWT PI/win32/org/eclipse/swt/internal/win32/TVHITTESTINFO.java;2;0;2;1;1;1;1;1;6;0;1;2069;6;6;1;0;0;1;2;2069;0;4701;2;2;
/org.eclipse.jdt.ui.tests.refactoring/resources/RenameParameters/canRename/A_test30_in.java;1;0;1;1;0;0;0;1;0;0;1;233;0;0;1;0;0;1;1;233;0;233;1;1;
/org.eclipse.jdt.core/compiler/org/eclipse/jdt/internal/compiler/ast/AnonymousLocalTypeDeclaration.java;2;1;14;1;2;2;2;12;264;4;9;455;565;565;4;3;0;12;14;1039;3;4418;11;2;
/org.eclipse.pde.ui/Eclipse PDE UI/org/eclipse/pde/internal/editor/jars/JarsOutlinePage.java;2;0;5;2;0;0;0;5;12;3;3;267;12;12;3;2;0;5;5;324;2;1434;3;2;
/org.eclipse.pde.ui/src/org/eclipse/pde/internal/ui/editor/manifest/ExtensionPointSection.java;1;0;3;1;0;0;0;3;6;2;2;3579;8;8;2;1;0;3;3;3579;1;3668;2;1;
/org.eclipse.jdt.core/model/org/eclipse/jdt/core/IImportContainer.java;2;1;6;1;3;3;3;3;24;1;3;455;67;67;1;0;0;3;6;455;0;4421;6;2;
/org.eclipse.jdt.core/model/org/eclipse/jdt/internal/core/IPathRequestor.java;2;0;4;1;1;1;1;3;19;1;3;455;26;26;1;0;0;3;4;455;0;4063;4;2;
/org.eclipse.jdt.ui/ui/org/eclipse/jdt/internal/ui/snippeteditor/DisplayAction.java;4;0;7;1;0;0;0;7;17;1;7;15;39;39;1;0;0;7;7;15;0;1916;7;4;
/org.eclipse.webdav/src/client/org/eclipse/webdav/client/URLTable.java;3;0;5;1;1;1;1;4;548;1;4;12;937;937;1;0;0;4;5;12;0;4211;5;3;
/org.eclipse.jdt.core/model/org/eclipse/jdt/internal/core/builder/BatchImageBuilder.java;3;2;11;2;5;4;5;6;36;1;6;2979;60;60;2;0;1;6;11;4063;1;4378;10;3;
/org.eclipse.update.ui/src/org/eclipse/update/ui/model/IUpdateModelChangedListener.java;1;0;3;1;0;0;0;3;2;1;3;1460;2;2;1;0;0;3;3;1460;0;1526;3;1;
/org.eclipse.compare/compare/org/eclipse/compare/HistoryItem.java;1;0;3;1;0;0;0;3;5;1;3;14;8;8;1;0;0;3;3;14;0;365;3;1;
/org.eclipse.swt.examples/src/org/eclipse/swt/examples/controlexample/TreeTab.java;5;1;6;1;3;3;3;3;191;1;3;513;384;384;1;0;0;3;6;513;0;4705;6;5;
/org.eclipse.ui/Eclipse UI/org/eclipse/ui/IPerspectiveFactory.java;2;0;2;1;0;0;0;2;13;1;2;257;13;13;1;0;0;2;2;257;0;457;2;2;
/org.eclipse.debug.core/core/org/eclipse/debug/core/model/IStorageRetrieval.java;1;0;2;1;0;0;0;2;0;1;2;1950;0;0;1;0;0;2;2;1950;0;1963;2;1;
/org.eclipse.jdt.debug/jdi interfaces/com/sun/jdi/BooleanType.java;2;0;2;1;0;0;0;2;6;1;2;2704;6;6;1;0;0;2;2;2704;0;3033;2;2;
/org.eclipse.jdt.ui.tests.refactoring/resources/PullUpMethods/testFail1/in/A.java;1;0;2;1;0;0;0;2;0;1;2;2156;0;0;1;0;0;2;2;2156;0;2406;2;1;
/org.eclipse.pde.runtime/src/org/eclipse/pde/internal/runtime/registry/RegistryBrowserContentProvider.java;2;0;2;1;0;0;0;2;15;1;2;1434;15;15;1;0;0;2;2;1434;0;3178;2;2;
/org.eclipse.ui/Eclipse JFace Text/org/eclipse/jface/text/AbstractInformationControlManager.java;2;1;11;1;6;6;6;5;144;1;5;1435;301;301;1;0;0;5;11;1435;0;4853;11;2;
/org.eclipse.jdt.ui.tests.refactoring/resources/ExtractTemp/canExtract/A_test10_in.java;1;0;1;1;0;0;0;1;0;0;1;2481;0;0;1;0;0;1;1;2481;0;2481;1;1;
/org.eclipse.swt.examples/org/eclipse/swt/examples/layoutexample/FormLayoutTab.java;2;1;6;1;2;2;2;4;170;1;4;3420;398;398;1;0;0;4;6;3420;0;4024;6;2;
/org.eclipse.jdt.core/compiler/org/eclipse/jdt/internal/compiler/codegen/ObjectCache.java;2;1;12;1;2;2;2;10;278;4;6;455;387;387;4;4;0;10;12;1039;4;4062;8;2;
/org.eclipse.team.ui/src/org/eclipse/team/internal/ui/actions/GetAction.java;2;1;2;1;2;2;2;0;0;0;0;4020;0;0;1;0;0;0;2;4020;0;4155;2;2;
/org.eclipse.jdt.ui/ui/org/eclipse/jdt/internal/ui/wizards/NewSourceFolderCreationWizardPage.java;1;0;8;1;0;0;0;8;41;3;6;1342;82;82;3;2;0;8;8;3084;2;3084;6;1;
/org.eclipse.jdt.debug/jdi interfaces/com/sun/jdi/ClassLoaderReference.java;2;0;2;1;0;0;0;2;10;1;2;2704;10;10;1;0;0;2;2;2704;0;3033;2;2;
/org.eclipse.jdt.core/compiler/org/eclipse/jdt/internal/compiler/problem/ShouldNotImplement.java;2;0;4;1;1;1;1;3;15;1;3;455;38;38;1;0;0;3;4;455;0;4062;4;2;
/org.eclipse.core.target/src/org/eclipse/core/internal/target/filesystem/RefreshVisitor.java;2;0;5;1;0;0;0;5;9;1;5;12;22;22;1;0;0;5;5;12;0;713;5;2;
/org.eclipse.jdt.ui.tests/JUnit/junit/ui/TestRunner.java;2;0;2;1;0;0;0;2;0;1;2;49;0;0;1;0;0;2;2;49;0;1186;2;2;
/org.eclipse.swt/Eclipse SWT/gtk/org/eclipse/swt/graphics/Image.java;6;1;13;2;4;4;4;9;716;2;8;2107;1437;1437;2;1;0;9;13;3326;1;4701;12;6;
/org.eclipse.jdt.ui/ui/org/eclipse/jdt/internal/ui/jarpackager/JarPackageWizard.java;4;0;27;1;1;1;1;26;137;2;22;239;609;609;2;4;0;26;27;239;4;4627;23;4;
/org.eclipse.jdt.ui/ui/org/eclipse/jdt/internal/ui/text/correction/SimilarElement.java;1;0;2;1;0;0;0;2;6;1;2;3531;6;6;1;0;0;2;2;3531;0;3570;2;1;
/org.eclipse.vcm.core/src/org/eclipse/vcm/internal/core/base/IVCMEvent.java;4;0;5;1;0;0;0;5;25;1;5;0;35;35;1;0;0;5;5;0;0;1265;5;4;
/org.eclipse.jdt.ui.tests.refactoring/resources/RenameType/test37/in/A.java;1;0;1;1;0;0;0;1;0;0;1;49;0;0;1;0;0;1;1;49;0;49;1;1;
/org.eclipse.jdt.launching/launching/org/eclipse/jdt/launching/IVMInstallType.java;1;1;6;1;5;5;5;1;22;0;1;2022;69;69;1;0;0;1;6;2022;0;4650;6;1;
/org.eclipse.help/src/org/eclipse/help/internal/contributors/xml/ContributionFactory.java;2;0;2;1;0;0;0;2;0;1;2;1420;0;0;1;0;0;2;2;1420;0;1675;2;2;
/org.eclipse.pde.ui/Eclipse PDE UI/org/eclipse/pde/internal/component/BuildPluginAction.java;2;0;2;1;0;0;0;2;0;1;2;512;0;0;1;0;0;2;2;512;0;1434;2;2;
/org.eclipse.core.runtime/src/org/eclipse/core/runtime/ILogListener.java;3;0;4;1;1;1;1;3;56;1;3;12;77;77;1;0;0;3;4;12;0;4214;4;3;
/org.eclipse.update.core/src/org/eclipse/update/core/AbstractSite.java;1;0;13;1;0;0;0;13;125;3;8;1451;372;372;3;5;0;13;13;1577;5;1638;8;1;
/org.eclipse.ui/Eclipse JFace/org/eclipse/jface/window/WindowManager.java;2;0;2;1;0;0;0;2;5;1;2;257;5;5;1;0;0;2;2;257;0;457;2;2;
/org.eclipse.jdt.ui/ui/org/eclipse/jdt/internal/ui/JavaPluginImages.java;8;2;46;2;8;5;8;38;300;3;29;15;832;832;3;9;3;38;46;433;12;4454;34;8;
/org.eclipse.jdt.ui/core refactoring/org/eclipse/jdt/internal/corext/refactoring/structure/ReferenceFinderUtil.java;1;1;5;1;2;2;2;3;68;1;3;2637;102;102;1;0;0;3;5;2637;0;4422;5;1;
/org.eclipse.ui.examples.propertysheet/Eclipse UI Examples PropertySheet/org/eclipse/ui/examples/propertysheet/Address.java;2;0;2;1;0;0;0;2;36;1;2;931;36;36;1;0;0;2;2;931;0;946;2;2;
/org.eclipse.swt.examples/src/org/eclipse/swt/examples/helloworld/HelloWorld4.java;4;0;5;1;1;1;1;4;35;1;4;513;79;79;1;0;0;4;5;513;0;4705;5;4;
/org.eclipse.jdt.debug.tests/tests/org/eclipse/jdt/debug/tests/eval/ByteAssignmentOperatorsTests.java;2;2;3;2;3;2;3;0;18;0;0;4447;20;20;2;0;1;0;3;4447;1;4571;2;2;
/org.eclipse.pde.runtime/src/org/eclipse/pde/internal/runtime/registry/PluginObjectAdapter.java;1;0;1;1;0;0;0;1;0;0;1;1434;0;0;1;0;0;1;1;1434;0;1434;1;1;
/org.eclipse.update.ui/src/org/eclipse/update/internal/ui/manager/InstallConfigurationPage.java;1;0;2;1;0;0;0;2;0;1;2;2827;0;0;1;0;0;2;2;2827;0;3537;2;1;
/org.eclipse.core.tests.resources/src/org/eclipse/core/tests/resources/AllTests.java;3;0;7;1;1;1;1;6;83;2;5;1794;101;101;2;1;0;6;7;3415;1;4516;6;3;
/org.eclipse.pde.core/src/org/eclipse/pde/internal/core/build/Build.java;1;0;1;1;0;0;0;1;0;0;1;3591;0;0;1;0;0;1;1;3591;0;3591;1;1;
/org.eclipse.ui/Eclipse UI Text Editor/org/eclipse/ui/texteditor/TextOperationAction.java;4;1;7;1;3;3;3;4;29;1;4;257;114;114;1;0;0;4;7;257;0;4838;7;4;
/org.eclipse.ant.ui/src/org/eclipse/ant/internal/ui/CustomizeAntPage.java;1;0;3;1;0;0;0;3;148;1;3;3476;168;168;1;0;0;3;3;3476;0;3506;3;1;
/org.eclipse.ui/Eclipse JFace/org/eclipse/jface/util/OpenStrategy.java;2;1;10;1;6;6;6;4;247;1;4;3576;494;494;1;0;0;4;10;3576;0;4625;10;2;
/org.eclipse.ui/Eclipse UI/org/eclipse/ui/internal/EditorActionBuilder.java;4;1;4;1;2;2;2;2;9;1;2;257;15;15;1;0;0;2;4;257;0;4293;4;4;
/org.eclipse.pde.ui/src/org/eclipse/pde/internal/model/IModelProvider.java;1;0;2;1;0;0;0;2;0;1;2;3136;0;0;1;0;0;2;2;3136;0;3579;2;1;
/org.eclipse.pde.core/src/org/eclipse/pde/core/plugin/IFragmentModel.java;1;0;3;1;2;1;2;1;16;0;1;3591;16;16;2;0;1;1;3;4751;1;4751;2;1;
/org.eclipse.jdt.ui/ui refactoring/org/eclipse/jdt/internal/ui/nls/search/NLSSearchResultLabelProvider.java;1;0;2;1;0;0;0;2;0;1;2;1913;0;0;1;0;0;2;2;1913;0;1922;2;1;
/org.eclipse.compare/compare/org/eclipse/patch/PatchParser.java;1;0;3;1;0;0;0;3;2;1;3;1419;2;2;1;0;0;3;3;1419;0;1516;3;1;
/org.eclipse.jdt.core/model/org/eclipse/jdt/internal/core/builder/SimpleLookupTable.java;3;1;4;1;2;2;2;2;15;1;2;2979;19;19;1;0;0;2;4;2979;0;4210;4;3;
/org.eclipse.ui/Eclipse UI Tool Script Ant/org/eclipse/toolscript/ui/internal/ant/AntBuildLogger.java;1;0;1;1;1;1;1;0;0;0;0;4087;0;0;1;0;0;0;1;4087;0;4087;1;1;
/org.eclipse.ui/Eclipse UI/org/eclipse/ui/IEditorDescriptor.java;2;0;3;1;1;1;1;2;5;1;2;257;7;7;1;0;0;2;3;257;0;4082;3;2;
/org.eclipse.ui/Eclipse UI/org/eclipse/ui/internal/LockToolBarAction.java;1;0;3;1;1;1;1;2;15;1;2;3706;29;29;1;0;0;2;3;3706;0;4024;3;1;
/org.eclipse.ui/Eclipse UI/org/eclipse/ui/internal/misc/Assert.java;2;0;2;1;0;0;0;2;15;1;2;257;15;15;1;0;0;2;2;257;0;457;2;2;
/org.eclipse.ui/Eclipse UI/org/eclipse/ui/IPersistableElement.java;2;0;2;1;0;0;0;2;5;1;2;257;5;5;1;0;0;2;2;257;0;457;2;2;
/org.eclipse.core.tests.runtime/src/org/eclipse/core/tests/runtime/CoreExceptionTest.java;3;0;3;1;0;0;0;3;76;1;3;1794;86;86;1;0;0;3;3;1794;0;3476;3;3;
/org.eclipse.team.cvs.core/src/org/eclipse/team/internal/ccvs/core/streams/PollingInputStream.java;2;1;5;1;2;2;2;3;42;1;3;3574;85;85;1;0;0;3;5;3574;0;4169;5;2;
/org.eclipse.ui/Eclipse UI/org/eclipse/ui/internal/dialogs/RemoveCapabilitiesWizard.java;1;0;3;1;0;0;0;3;13;1;3;3249;13;13;1;0;0;3;3;3249;0;3506;3;1;
/org.eclipse.jdt.ui/ui/org/eclipse/jdt/internal/ui/browsing/MembersFilterAction.java;2;0;3;1;0;0;0;3;2;1;3;3024;2;2;1;0;0;3;3;3024;0;3151;3;2;
/org.eclipse.jdt.ui/ui/org/eclipse/jdt/internal/ui/viewsupport/JavaElementLabels.java;4;1;17;1;3;3;3;14;165;3;12;1718;391;391;3;2;0;14;17;1718;2;4621;15;4;
/org.eclipse.team.cvs.core/src/org/eclipse/team/internal/ccvs/core/util/FileUtil.java;3;0;8;2;0;0;0;8;74;2;7;2156;160;160;2;1;0;8;8;2791;1;3399;7;3;
/org.eclipse.compare/compare/org/eclipse/compare/CompareConfiguration.java;2;1;18;1;2;2;2;16;54;2;15;14;284;284;2;1;0;16;18;430;1;4820;17;2;
/org.eclipse.webdav/src/client/org/eclipse/webdav/client/DAVClient.java;3;0;5;1;1;1;1;4;172;1;4;12;346;346;1;0;0;4;5;12;0;4211;5;3;
/org.eclipse.jdt.ui.tests.refactoring/resources/ExtractMethodWorkSpace/ExtractMethodTests/testing/E.java;1;1;3;1;2;2;2;1;28;0;1;2155;28;28;1;0;0;1;3;2155;0;4419;3;1;
/org.eclipse.jdt.ui/ui/org/eclipse/jdt/internal/ui/reorg/JavaElementTransfer.java;1;0;2;1;0;0;0;2;0;1;2;2049;0;0;1;0;0;2;2;2049;0;2064;2;1;
/org.eclipse.jdt.ui/core refactoring/org/eclipse/jdt/internal/core/refactoring/code/flow/InputFlowAnalyzer.java;1;0;4;1;0;0;0;4;20;1;4;1236;31;31;1;0;0;4;4;1236;0;1939;4;1;
/org.eclipse.core.tests.resources/src/org/eclipse/core/tests/internal/watson/TestDeltaFilter.java;3;0;4;1;1;1;1;3;44;1;3;1794;65;65;1;0;0;3;4;1794;0;4516;4;3;
/org.eclipse.help.webapp/src/org/eclipse/help/servlet/IFilter.java;1;0;2;1;0;0;0;2;2;1;2;2410;2;2;1;0;0;2;2;2410;0;3609;2;1;
/org.eclipse.jdt.ui.tests.refactoring/resources/SurroundWithWorkSpace/SurroundWithTests/trycatch_in/TestAlreadyCaught.java;1;0;1;1;0;0;0;1;0;0;1;2327;0;0;1;0;0;1;1;2327;0;2327;1;1;
/org.eclipse.core.runtime/src/org/eclipse/core/internal/runtime/PreferenceExporter.java;2;1;6;1;6;6;6;0;83;0;0;4409;155;155;1;0;0;0;6;4409;0;4772;6;2;
/org.eclipse.team.webdav/src/org/eclipse/team/internal/webdav/core/WebDavTargetLocationFactory.java;2;0;2;2;2;1;2;0;0;0;0;4128;0;0;2;0;1;0;2;4128;1;4128;1;2;
/org.eclipse.vcm.ui/src/org/eclipse/vcm/internal/ui/RepositorySorter.java;2;0;7;1;0;0;0;7;37;2;6;81;55;55;2;1;0;7;7;164;1;1171;6;2;
/org.eclipse.jdt.ui/ui/org/eclipse/jdt/internal/ui/wizards/buildpaths/BuildPathBasePage.java;1;0;3;1;0;0;0;3;4;1;3;15;6;6;1;0;0;3;3;15;0;328;3;1;
/org.eclipse.pde.ui/src/org/eclipse/pde/internal/pluginsview/PluginsViewContentProvider.java;1;0;2;1;0;0;0;2;0;1;2;2650;0;0;1;0;0;2;2;2650;0;2978;2;1;
/org.eclipse.ui/Eclipse UI/org/eclipse/ui/IStartup.java;1;0;1;1;1;1;1;0;0;0;0;4149;0;0;1;0;0;0;1;4149;0;4149;1;1;
/org.eclipse.jdt.ui.tests.refactoring/resources/RenameType/test30/out/B.java;1;0;1;1;0;0;0;1;0;0;1;522;0;0;1;0;0;1;1;522;0;522;1;1;
/org.eclipse.jdt.ui.tests.refactoring/resources/MoveCU/test2/out/p1/C.java;2;0;2;1;0;0;0;2;0;1;2;49;0;0;1;0;0;2;2;49;0;2769;2;2;
/org.eclipse.jdt.ui.tests.refactoring/resources/RenameType/test48/in/A.java;1;0;1;1;0;0;0;1;0;0;1;49;0;0;1;0;0;1;1;49;0;49;1;1;
/org.eclipse.jdt.ui.tests.refactoring/resources/ExtractMethodWorkSpace/ExtractMethodTests/locals_in/A_test502.java;2;1;4;1;2;2;2;2;19;1;2;80;21;21;1;0;0;2;4;80;0;4419;4;2;
/org.eclipse.core.tests.resources/src/org/eclipse/core/tests/internal/utils/QueueTest.java;3;0;3;1;0;0;0;3;238;1;3;1794;246;246;1;0;0;3;3;1794;0;3420;3;3;
/org.eclipse.jdt.ui/ui/org/eclipse/jdt/internal/ui/search/FindReferencesInWorkingSetAction.java;1;2;9;1;4;3;4;5;54;1;5;1707;184;184;2;0;1;5;9;4140;1;4140;8;1;
/org.eclipse.pde.ui/src/org/eclipse/pde/internal/base/model/feature/IFeatureURLElement.java;1;0;2;1;0;0;0;2;0;1;2;2951;0;0;1;0;0;2;2;2951;0;3579;2;1;
/org.eclipse.jdt.debug/jdi/org/eclipse/jdi/internal/request/MethodEntryRequestImpl.java;2;0;4;1;0;0;0;4;12;1;4;187;25;25;1;0;0;4;4;187;0;3670;4;2;
/org.eclipse.swt.tests/JUnit Tests/org/eclipse/swt/tests/junit/Test_org_eclipse_swt_widgets_Control.java;2;0;2;1;1;1;1;1;6;0;1;1792;6;6;1;0;0;1;2;1792;0;4706;2;2;
/org.eclipse.update.ui.forms/src/org/eclipse/update/ui/forms/internal/SectionForm.java;2;1;4;1;2;2;2;2;195;1;2;2470;197;197;1;0;0;2;4;2470;0;4370;4;2;
/org.eclipse.pde.ui/src/org/eclipse/pde/internal/ui/editor/build/BuildOutlinePage.java;1;0;2;1;0;0;0;2;17;0;1;3579;17;17;2;1;0;2;2;3579;1;3579;1;1;
/org.eclipse.pde.ui/src/org/eclipse/pde/model/plugin/IPluginBase.java;1;0;3;1;0;0;0;3;13;1;3;3039;13;13;1;0;0;3;3;3039;0;3579;3;1;
/org.eclipse.pde.ui/src/org/eclipse/pde/internal/ui/util/CoreUtility.java;1;0;1;1;0;0;0;1;0;0;1;3579;0;0;1;0;0;1;1;3579;0;3579;1;1;
/org.eclipse.compare/compare/org/eclipse/compare/internal/ListDialog.java;1;0;1;1;0;0;0;1;0;0;1;2876;0;0;1;0;0;1;1;2876;0;2876;1;1;
/org.eclipse.jdt.ui/ui/org/eclipse/jdt/internal/ui/reorg/RenameAction.java;5;0;21;1;0;0;0;21;186;2;20;15;394;394;2;1;0;21;21;130;1;3791;20;5;
/org.eclipse.jdt.ui.tests.refactoring/resources/RenamePackage/testFail0/in/p/A.java;2;0;2;1;0;0;0;2;0;1;2;49;0;0;1;0;0;2;2;49;0;1258;2;2;
/org.eclipse.ui/Eclipse JFace/org/eclipse/jface/dialogs/InputDialog.java;4;0;5;1;1;1;1;4;10;1;4;257;19;19;1;0;0;4;5;257;0;4267;5;4;
/org.eclipse.pde.ui/Eclipse PDE UI/org/eclipse/pde/internal/model/jars/WorkspaceJarsModel.java;2;0;8;2;0;0;0;8;12;3;6;267;26;26;3;2;0;8;8;324;2;1434;6;2;
/org.eclipse.jdt.core/compiler/org/eclipse/jdt/internal/compiler/ast/OperatorExpression.java;2;1;16;1;2;2;2;14;3440;4;11;455;8451;8451;4;3;0;14;16;1039;3;4421;13;2;
/org.eclipse.ui/Eclipse UI/org/eclipse/ui/IWorkbenchPage.java;4;2;15;1;4;3;4;11;40;1;11;257;269;269;2;0;1;11;15;4451;1;4451;14;4;
/org.eclipse.pde.ui/Eclipse PDE UI/org/eclipse/pde/internal/forms/FormText.java;2;0;6;2;0;0;0;6;14;3;4;267;26;26;3;2;0;6;6;324;2;1434;4;2;
/org.eclipse.ui.tests/Eclipse UI Tests/org/eclipse/ui/tests/dialogs/TextEditorTestStub.java;1;0;1;1;0;0;0;1;0;0;1;1274;0;0;1;0;0;1;1;1274;0;1274;1;1;
/org.eclipse.swt/Eclipse SWT OLE Win32/win32/org/eclipse/swt/ole/win32/OleFrame.java;4;1;11;1;2;2;2;9;88;2;8;106;267;267;2;1;0;9;11;3206;1;4701;10;4;
/org.eclipse.help/src/org/eclipse/help/internal/context/Contexts.java;1;0;1;1;0;0;0;1;0;0;1;2829;0;0;1;0;0;1;1;2829;0;2829;1;1;
/org.eclipse.jdt.ui/ui/org/eclipse/jdt/internal/ui/wizards/NewWizardMessages.java;1;0;2;1;0;0;0;2;7;1;2;752;7;7;1;0;0;2;2;752;0;1342;2;1;
/org.eclipse.ant.ui/src/org/eclipse/ant/internal/ui/Policy.java;4;0;8;1;0;0;0;8;214;2;7;326;291;291;2;1;0;8;8;326;1;3723;7;4;
/org.eclipse.jdt.ui/core refactoring/org/eclipse/jdt/internal/corext/refactoring/util/CodeBlock.java;1;0;3;1;0;0;0;3;4;2;2;3845;4;4;2;1;0;3;3;3870;1;3870;2;1;
/org.eclipse.swt/Eclipse SWT OLE Win32/win32/org/eclipse/swt/internal/ole/win32/GUID.java;2;0;3;1;0;0;0;3;5;1;3;106;5;5;1;0;0;3;3;106;0;2069;3;2;
/org.eclipse.ui/Eclipse UI Standard Components/org/eclipse/ui/views/properties/PropertySheetCategory.java;3;0;3;1;0;0;0;3;18;1;3;257;23;23;1;0;0;3;3;257;0;1896;3;3;
/org.eclipse.jdt.ui/ui/org/eclipse/jdt/internal/ui/search/JavaSearchSubGroup.java;2;4;13;1;6;3;6;7;44;1;7;1707;137;137;4;0;3;7;13;4137;3;4137;10;2;
/org.eclipse.update.core/src/org/eclipse/update/core/CopyOfISiteChangedListener.java;1;0;2;1;0;0;0;2;0;0;1;1863;0;0;2;1;0;2;2;1863;1;1863;1;1;
/org.eclipse.pde.core/src/org/eclipse/pde/internal/core/builders/ExtensionPointSchemaBuilder.java;1;0;4;1;0;0;0;4;31;2;3;3591;33;33;2;1;0;4;4;3629;1;3629;3;1;
/org.eclipse.jdt.core/eval/org/eclipse/jdt/internal/eval/CodeSnippetClassFile.java;2;0;9;1;1;1;1;8;403;2;7;455;442;442;2;1;0;8;9;3084;1;4062;8;2;
/org.eclipse.pde.ui/src/org/eclipse/pde/core/plugin/IPluginImport.java;1;0;2;1;0;0;0;2;0;1;2;3579;0;0;1;0;0;2;2;3579;0;3607;2;1;
/org.eclipse.jdt.ui/ui/org/eclipse/jdt/internal/ui/search/FindReadReferencesInWorkingSetAction.java;1;2;9;1;4;3;4;5;52;1;5;1707;96;96;2;0;1;5;9;4140;1;4140;8;1;
/org.eclipse.jdt.ui.tests.refactoring/resources/RenameVariables/canRename/A_test25_out.java;1;0;2;1;0;0;0;2;0;1;2;724;0;0;1;0;0;2;2;724;0;1665;2;1;
/org.eclipse.pde/src/org/eclipse/pde/internal/builders/DependencyLoop.java;1;0;1;1;0;0;0;1;0;0;1;3631;0;0;1;0;0;1;1;3631;0;3631;1;1;
/org.eclipse.ui/Eclipse UI Standard Components/org/eclipse/ui/views/properties/IPropertyDescriptor.java;3;0;3;1;0;0;0;3;21;1;3;257;26;26;1;0;0;3;3;257;0;3029;3;3;
/org.eclipse.swt.tests/JUnit Tests/org/eclipse/swt/tests/junit/Test_org_eclipse_swt_graphics_ImageLoader.java;2;0;2;1;1;1;1;1;6;0;1;1792;6;6;1;0;0;1;2;1792;0;4706;2;2;
/org.eclipse.team.cvs.core/src/org/eclipse/team/internal/ccvs/core/connection/ResourceStatus.java;2;0;2;1;0;0;0;2;0;1;2;1978;0;0;1;0;0;2;2;1978;0;3089;2;2;
/org.eclipse.jdt.ui/core extension/org/eclipse/jdt/internal/corext/codemanipulation/CodeBlock.java;1;0;1;1;0;0;0;1;0;0;1;3870;0;0;1;0;0;1;1;3870;0;3870;1;1;
/org.eclipse.swt/Eclipse SWT/photon/org/eclipse/swt/internal/photon/PhDim_t.java;2;0;3;1;0;0;0;3;6;1;3;106;6;6;1;0;0;3;3;106;0;2069;3;2;
/org.eclipse.debug.core/core/org/eclipse/debug/core/ILaunchConfigurationListener.java;2;0;4;1;0;0;0;4;10;1;4;2180;18;18;1;0;0;4;4;2180;0;3460;4;2;
/org.eclipse.jdt.ui.tests.refactoring/resources/ExtractMethodWorkSpace/ExtractMethodTests/selection/A_test4.java;2;1;3;1;2;2;2;1;0;0;1;49;0;0;1;0;0;1;3;49;0;4419;3;2;
/org.eclipse.jdt.debug/jdi/org/eclipse/jdi/internal/jdwp/JdwpClassLoaderID.java;2;0;3;1;0;0;0;3;12;1;3;187;13;13;1;0;0;3;3;187;0;3040;3;2;
/org.eclipse.help/src/org/eclipse/help/internal/toc/TocManager.java;2;0;11;1;0;0;0;11;152;2;10;1857;325;325;2;1;0;11;11;3743;1;3875;10;2;
/org.eclipse.jdt.debug/model/org/eclipse/jdt/internal/debug/core/JDIArrayPartition.java;4;0;10;2;0;0;0;10;107;2;9;187;247;247;2;1;0;10;10;1471;1;2517;9;4;
/org.eclipse.jdt.ui/ui/org/eclipse/jdt/internal/ui/typehierarchy/HierarchyAdornmentProvider.java;3;1;6;1;2;2;2;4;22;1;4;3103;46;46;1;0;0;4;6;3103;0;4018;6;3;
/org.eclipse.pde.ui/src/org/eclipse/pde/internal/Sorter.java;2;0;3;1;0;0;0;3;1;1;3;1434;1;1;1;0;0;3;3;1434;0;2691;3;2;
/org.eclipse.team.cvs.core/src/org/eclipse/team/internal/ccvs/core/response/Updated.java;3;0;7;1;0;0;0;7;265;1;7;1978;304;304;1;0;0;7;7;1978;0;2607;7;3;
/org.eclipse.ui/Eclipse UI/org/eclipse/ui/dialogs/FileEditorMappingLabelProvider.java;2;0;2;1;0;0;0;2;5;1;2;257;5;5;1;0;0;2;2;257;0;457;2;2;
/org.eclipse.jdt.debug.ui/ui/org/eclipse/jdt/internal/debug/ui/actions/RuntimeClasspathAction.java;3;1;3;1;2;2;2;1;15;0;1;3875;18;18;1;0;0;1;3;3875;0;4225;3;3;
/org.eclipse.update.core/src/org/eclipse/update/core/NonPluginEntry.java;2;0;4;1;0;0;0;4;28;2;3;2462;54;54;2;1;0;4;4;3570;1;3570;3;2;
/org.eclipse.jdt.ui.tests.refactoring/resources/RenameType/test18/out/A.java;1;0;2;1;0;0;0;2;0;1;2;49;0;0;1;0;0;2;2;49;0;522;2;1;
/org.eclipse.swt/Eclipse SWT/photon/org/eclipse/swt/internal/photon/PhTile_t.java;2;0;3;1;0;0;0;3;6;1;3;106;6;6;1;0;0;3;3;106;0;2069;3;2;
/org.eclipse.scripting/src/org/eclipse/scripting/internal/IXGRElementEventGeneratorOnSubmit.java;1;0;1;1;0;0;0;1;0;0;1;1424;0;0;1;0;0;1;1;1424;0;1424;1;1;
/org.eclipse.jdt.core/model/org/eclipse/jdt/internal/core/CopyElementsOperation.java;2;0;12;1;1;1;1;11;426;4;8;455;511;511;4;3;0;11;12;1039;3;4063;9;2;
/org.eclipse.jdt.ui.tests.refactoring/resources/PullUpMethods/test5/out/B.java;1;0;3;1;0;0;0;3;2;1;3;2156;2;2;1;0;0;3;3;2156;0;2406;3;1;
/org.eclipse.jdt.core/model/org/eclipse/jdt/internal/core/builder/impl/BuilderEnvironment.java;1;0;5;1;0;0;0;5;202;1;5;455;206;206;1;0;0;5;5;455;0;2808;5;1;
/org.eclipse.ui/Eclipse UI/org/eclipse/ui/internal/ShowMenuAction.java;2;0;3;1;0;0;0;3;8;1;3;1863;8;8;1;0;0;3;3;1863;0;1915;3;2;
/org.eclipse.jdt.ui/ui/org/eclipse/jdt/internal/ui/text/SubstitutionTextReader.java;3;1;5;1;2;2;2;3;7;1;3;1384;13;13;1;0;0;3;5;1384;0;4632;5;3;
/org.eclipse.jdt.ui.tests.refactoring/resources/ExtractMethodWorkSpace/ExtractMethodTests/selection/A_test1.java;2;1;3;1;2;2;2;1;0;0;1;49;0;0;1;0;0;1;3;49;0;4419;3;2;
/org.eclipse.jdt.ui/ui/org/eclipse/jdt/internal/ui/actions/WorkbenchRunnableWrapper.java;2;0;4;1;0;0;0;4;5;1;4;1416;7;7;1;0;0;4;4;1416;0;2218;4;2;
/org.eclipse.ui/Eclipse UI Tool Script/org/eclipse/toolscript/ui/internal/ToolScriptMessages.java;1;1;3;1;2;2;2;1;8;0;1;3766;8;8;1;0;0;1;3;3766;0;4087;3;1;
/org.eclipse.swt/Eclipse SWT Drag and Drop/win32/org/eclipse/swt/dnd/TableDragUnderEffect.java;2;0;5;1;1;1;1;4;59;1;4;106;113;113;1;0;0;4;5;106;0;4701;5;2;
/org.eclipse.compare/compare/org/eclipse/compare/structuremergeviewer/IDiffElement.java;1;0;2;1;0;0;0;2;5;1;2;14;5;5;1;0;0;2;2;14;0;329;2;1;
/org.eclipse.help/Eclipse Help/org/eclipse/help/internal/contributors/xml/XMLActionContributor.java;2;0;3;1;0;0;0;3;7;1;3;135;7;7;1;0;0;3;3;135;0;1420;3;2;
/org.eclipse.pde.ui/src/org/eclipse/pde/internal/ui/ischema/ISchemaType.java;1;0;2;1;0;0;0;2;0;1;2;3579;0;0;1;0;0;2;2;3579;0;3591;2;1;
/org.eclipse.jdt.ui.tests.refactoring/resources/DeleteSourceReference/A_testField4_out.java;1;0;2;1;0;0;0;2;0;1;2;2003;0;0;1;0;0;2;2;2003;0;2857;2;1;
/org.eclipse.update.ui.forms/src/org/eclipse/update/ui/forms/internal/ToggleControl.java;1;0;2;1;0;0;0;2;10;1;2;2470;10;10;1;0;0;2;2;2470;0;3078;2;1;
/org.eclipse.jdt.ui.tests.refactoring/resources/ExtractMethodWorkSpace/ExtractMethodTests/return_in/A_test717.java;1;1;3;1;2;2;2;1;24;0;1;1236;24;24;1;0;0;1;3;1236;0;4419;3;1;
/org.eclipse.update/Eclipse Update/org/eclipse/update/internal/ui/UMWizardProductComponentNew.java;2;0;5;1;0;0;0;5;6;1;5;108;12;12;1;0;0;5;5;108;0;1424;5;2;
/org.eclipse.jdt.ui.tests.refactoring/resources/ExtractMethodWorkSpace/ExtractMethodTests/branch_in/A_test750.java;1;1;3;1;2;2;2;1;26;0;1;1851;26;26;1;0;0;1;3;1851;0;4419;3;1;
/org.eclipse.jdt.ui.tests.refactoring/resources/RenameTemp/canRename/A_test27_out.java;1;0;2;1;0;0;0;2;2;1;2;1625;2;2;1;0;0;2;2;1625;0;1652;2;1;
/org.eclipse.ui.tests/Eclipse UI Tests/org/eclipse/ui/tests/api/IEditorSiteTest.java;2;0;4;1;0;0;0;4;2;1;4;1097;6;6;1;0;0;4;4;1097;0;2785;4;2;
/org.eclipse.jdt.core/compiler/org/eclipse/jdt/internal/compiler/lookup/NestedTypeBinding.java;2;0;4;1;1;1;1;3;388;1;3;455;449;449;1;0;0;3;4;455;0;4062;4;2;
/org.eclipse.update.core/src/org/eclipse/update/internal/core/SiteFileContentConsumer.java;2;2;25;1;13;12;13;12;133;1;12;2467;663;663;2;0;1;12;25;4084;1;4747;24;2;
/org.eclipse.jdt.ui.tests.refactoring/resources/RenameMethodInInterface/test30/out/A.java;1;0;1;1;0;0;0;1;0;0;1;49;0;0;1;0;0;1;1;49;0;49;1;1;
/org.eclipse.jdt.ui.tests.refactoring/resources/ExtractMethodWorkSpace/ExtractMethodTests/locals_out/A_test557.java;1;1;3;1;2;2;2;1;32;0;1;1236;32;32;1;0;0;1;3;1236;0;4419;3;1;
/org.eclipse.jdt.ui/ui/org/eclipse/jdt/internal/ui/preferences/AppearancePreferencePage.java;4;3;12;3;8;4;8;4;75;1;4;3068;206;206;3;0;4;4;12;4181;4;4425;8;4;
/org.eclipse.help.ui/src/org/eclipse/help/internal/ui/TopicTreePrinter.java;2;0;7;2;0;0;0;7;229;2;5;1677;270;270;2;2;0;7;7;1677;2;3030;5;2;
/org.eclipse.ui/Eclipse UI/org/eclipse/ui/IActionFilter.java;2;0;2;1;0;0;0;2;5;1;2;257;5;5;1;0;0;2;2;257;0;457;2;2;
/org.eclipse.jdt.core/model/org/eclipse/jdt/internal/core/builder/impl/PackageImpl.java;1;0;10;1;0;0;0;10;310;4;6;455;400;400;4;4;0;10;10;1039;4;2808;6;1;
/org.eclipse.jdt.ui.tests.refactoring/resources/RenameTemp/canRename/A_test19_in.java;1;0;2;1;0;0;0;2;2;1;2;1625;2;2;1;0;0;2;2;1625;0;1652;2;1;
/org.eclipse.jdt.ui/core extension/org/eclipse/jdt/internal/corext/codemanipulation/OrganizeImportsOperation.java;3;3;17;1;7;5;7;10;474;1;10;2137;681;681;3;0;2;10;17;4396;2;4621;15;3;
/org.eclipse.core.tests.runtime/src/org/eclipse/core/tests/internal/plugins/SoftPrereqTest_14.java;3;0;3;1;0;0;0;3;106;1;3;1794;116;116;1;0;0;3;3;1794;0;3476;3;3;
/org.eclipse.jdt.ui.tests.refactoring/resources/SurroundWithWorkSpace/SurroundWithTests/trycatch_out/TestWrappedLocal5.java;1;0;1;1;0;0;0;1;0;0;1;3870;0;0;1;0;0;1;1;3870;0;3870;1;1;
/org.eclipse.jdt.junit/src/org/eclipse/jdt/junit/wizards/NewTestSuiteCreationWizard.java;2;0;8;1;0;0;0;8;12;4;5;3247;21;21;4;3;0;8;8;3392;3;3527;5;2;
/org.eclipse.pde.ui/src/org/eclipse/pde/internal/core/IModelProvider.java;1;0;2;1;0;0;0;2;0;1;2;3579;0;0;1;0;0;2;2;3579;0;3607;2;1;
/org.eclipse.pde.ui/src/org/eclipse/pde/internal/wizards/templates/PreferencePageTemplate.java;1;0;2;1;0;0;0;2;0;1;2;3442;0;0;1;0;0;2;2;3442;0;3579;2;1;
/org.eclipse.jdt.debug/jdi interfaces/com/sun/jdi/ClassType.java;2;0;2;1;0;0;0;2;22;1;2;2704;22;22;1;0;0;2;2;2704;0;3033;2;2;
/org.eclipse.update.ui/src/org/eclipse/update/internal/ui/search/UpdateSearchSite.java;1;0;2;1;0;0;0;2;0;1;2;3537;0;0;1;0;0;2;2;3537;0;3657;2;1;
/org.eclipse.team.core/src/org/eclipse/team/internal/core/MoveDeleteManager.java;1;0;1;1;0;0;0;1;0;0;1;3762;0;0;1;0;0;1;1;3762;0;3762;1;1;
/org.eclipse.swt/Eclipse SWT PI/gtk/org/eclipse/swt/internal/gtk/GdkImage.java;2;0;4;1;2;1;2;2;10;1;2;3252;17;17;2;0;1;2;4;4701;1;4701;3;2;
/org.eclipse.vcm.ui/src/org/eclipse/vcm/internal/ui/merge/MergeCompareInput.java;3;0;8;2;0;0;0;8;24;2;6;1;67;67;2;2;0;8;8;297;2;491;6;3;
/org.eclipse.swt/Eclipse SWT PI/win32/org/eclipse/swt/internal/win32/NMHEADER.java;2;0;2;1;1;1;1;1;6;0;1;2069;6;6;1;0;0;1;2;2069;0;4701;2;2;
/org.eclipse.debug.ui/ui/org/eclipse/debug/ui/actions/DebugAction.java;3;0;5;1;1;1;1;4;10;1;4;2397;22;22;1;0;0;4;5;2397;0;4374;5;3;
/org.eclipse.pde.ui/src/org/eclipse/pde/internal/editor/manifest/PluginSpecSection.java;2;0;8;1;0;0;0;8;80;1;8;1434;135;135;1;0;0;8;8;1434;0;3579;8;2;
/org.eclipse.help.ui/Eclipse Help UI/org/eclipse/help/internal/ui/HelpActionSet.java;3;0;4;1;0;0;0;4;4;1;4;136;5;5;1;0;0;4;4;136;0;1420;4;3;
/org.eclipse.swt/Eclipse SWT/photon/org/eclipse/swt/internal/photon/PhCursorDef_t.java;3;0;3;1;0;0;0;3;36;1;3;574;36;36;1;0;0;3;3;574;0;2069;3;3;
/org.eclipse.jdt.ui/nls/org/eclipse/jdt/internal/ui/nls/MultiStateCellEditor.java;1;0;2;1;0;0;0;2;0;1;2;1880;0;0;1;0;0;2;2;1880;0;1913;2;1;
/org.eclipse.jdt.debug/jdi/org/eclipse/jdi/hcr/VirtualMachine.java;1;0;2;1;0;0;0;2;12;1;2;187;12;12;1;0;0;2;2;187;0;366;2;1;
/org.eclipse.jdt.ui.tests.refactoring/resources/ExtractMethodWorkSpace/ExtractMethodTests/locals_out/A_test515.java;2;1;5;1;2;2;2;3;13;1;3;369;19;19;1;0;0;3;5;369;0;4419;5;2;
/org.eclipse.update.ui/src/org/eclipse/update/internal/ui/forms/UnknownObjectForm.java;1;0;4;1;1;1;1;3;84;1;3;3662;125;125;1;0;0;3;4;3662;0;4100;4;1;
/org.eclipse.update.core/src/org/eclipse/update/internal/core/Category.java;2;0;3;1;0;0;0;3;21;1;3;1791;21;21;1;0;0;3;3;1791;0;2583;3;2;
/org.eclipse.jdt.core/model/org/eclipse/jdt/core/IBuffer.java;3;2;10;1;4;3;4;6;397;1;6;455;501;501;2;0;1;6;10;4058;1;4573;9;3;
/org.eclipse.jdt.ui/core refactoring/org/eclipse/jdt/internal/corext/refactoring/structure/SuperReferenceFinder.java;2;0;9;1;1;1;1;8;135;1;8;2270;191;191;1;0;0;8;9;2270;0;4452;9;2;
/org.eclipse.vcm.ui/src/org/eclipse/vcm/internal/ui/VersionCollator.java;1;0;1;1;0;0;0;1;0;0;1;1171;0;0;1;0;0;1;1;1171;0;1171;1;1;
/org.eclipse.swt/Eclipse SWT/emulated/treetable/org/eclipse/swt/widgets/SelectableItemWidget.java;7;1;9;1;2;2;2;7;14;1;7;1028;38;38;1;0;0;7;9;1028;0;4701;9;7;
/org.eclipse.core.resources/src/org/eclipse/core/internal/resources/ProjectImporterExporter.java;1;0;2;1;0;0;0;2;0;0;1;1394;0;0;2;1;0;2;2;1394;1;1394;1;1;
/org.eclipse.pde.ui/src/org/eclipse/pde/internal/editor/schema/ElementSection.java;2;0;7;1;0;0;0;7;103;2;6;1434;154;154;2;1;0;7;7;3035;1;3579;6;2;
/org.eclipse.scripting/src/org/eclipse/scripting/internal/views/ScriptUIEditorDocScanner.java;1;0;1;1;0;0;0;1;0;0;1;1424;0;0;1;0;0;1;1;1424;0;1424;1;1;
/org.eclipse.jdt.ui/ui/org/eclipse/jdt/internal/ui/launcher/JavaLauncher.java;5;0;14;1;0;0;0;14;45;2;13;15;183;183;2;1;0;14;14;218;1;1916;13;5;
/org.eclipse.jdt.ui.tests.refactoring/resources/SelectionAnalyzerWorkSpace/SelectionAnalyzerTests/validSelection/A_test231.java;1;0;1;1;0;0;0;1;0;0;1;1368;0;0;1;0;0;1;1;1368;0;1368;1;1;
/org.eclipse.scripting/Eclipse Scripting/org/eclipse/scripting/internal/ScriptEngineJavaScript.java;2;0;3;1;0;0;0;3;4;1;3;133;4;4;1;0;0;3;3;133;0;756;3;2;
/org.eclipse.scripting/Eclipse Scripting/org/eclipse/scripting/ICancel.java;1;0;3;1;0;0;0;3;7;1;3;133;7;7;1;0;0;3;3;133;0;1424;3;1;
/org.eclipse.debug.ui/ui/org/eclipse/debug/internal/ui/actions/SelectAllExpressionsAction.java;2;0;5;1;0;0;0;5;5;1;5;3178;13;13;1;0;0;5;5;3178;0;3730;5;2;
/org.eclipse.jdt.debug/jdi/org/eclipse/jdi/internal/MethodImpl.java;3;1;13;1;2;2;2;11;48;1;11;187;226;226;1;0;0;11;13;187;0;4258;13;3;
/org.eclipse.pde.ui/src/org/eclipse/pde/internal/ui/PDEPluginImages.java;1;1;4;1;3;3;3;1;7;0;1;3579;9;9;1;0;0;1;4;3579;0;4751;4;1;
/org.eclipse.update.ui/src/org/eclipse/update/internal/ui/UpdateURLParser.java;1;0;2;1;0;0;0;2;0;1;2;1526;0;0;1;0;0;2;2;1526;0;1570;2;1;
/org.eclipse.jdt.ui/ui/org/eclipse/jdt/internal/ui/javaeditor/structureselection/StructureSelectNextAction.java;2;1;7;2;2;2;2;5;9;2;4;3188;41;41;2;1;0;5;7;3188;1;4630;6;2;
/org.eclipse.swt/Eclipse SWT/win32/org/eclipse/swt/internal/win32/DROPFILES.java;2;0;2;1;0;0;0;2;0;1;2;1831;0;0;1;0;0;2;2;1831;0;2069;2;2;
/org.eclipse.team.cvs.ui/src/org/eclipse/team/internal/ccvs/ui/ReleaseCommentDialog.java;2;0;6;1;1;1;1;5;182;1;5;1978;222;222;1;0;0;5;6;1978;0;4165;6;2;
/org.eclipse.scripting.adapters.javascript/Eclipse Scripting Javascript Adapter/org/eclipse/scripting/adapters/javascript/ScriptEngineJavaScript.java;2;0;2;1;0;0;0;2;0;1;2;756;0;0;1;0;0;2;2;756;0;1424;2;2;
/org.eclipse.jdt.junit/Eclipse JUnit/org/eclipse/jdt/junit/internal/CounterPanel.java;2;0;2;1;0;0;0;2;0;1;2;1531;0;0;1;0;0;2;2;1531;0;2007;2;2;
/org.eclipse.jdt.ui.tests.refactoring/resources/ExtractTemp/cannotExtract/A_testFail20.java;1;0;1;1;0;0;0;1;0;0;1;3638;0;0;1;0;0;1;1;3638;0;3638;1;1;
/org.eclipse.scripting/src/org/eclipse/scripting/internal/views/ScriptUIEditorCodeScanner.java;1;0;1;1;0;0;0;1;0;0;1;1424;0;0;1;0;0;1;1;1424;0;1424;1;1;
/org.eclipse.ui/Eclipse UI Standard Components/org/eclipse/ui/views/internal/navigator/OpenActionContributionFactory.java;1;0;2;1;0;0;0;2;0;1;2;1757;0;0;1;0;0;2;2;1757;0;1830;2;1;
/org.eclipse.jdt.ui/ui refactoring/org/eclipse/jdt/internal/ui/refactoring/actions/OpenRefactoringWizardAction.java;3;0;21;2;1;1;1;20;135;3;13;1258;405;405;3;7;0;20;21;1338;7;3970;14;3;
/org.eclipse.update.core/src/org/eclipse/update/internal/core/FeatureExecutableContentConsumer.java;2;2;14;2;9;8;9;5;95;1;5;2448;387;387;2;0;1;5;14;3957;1;4385;13;2;
/org.eclipse.pde.ui/src/org/eclipse/pde/internal/wizards/imports/UpdateClasspathAction.java;1;0;10;1;0;0;0;10;153;1;10;2522;376;376;1;0;0;10;10;2522;0;3579;10;1;
/org.eclipse.team.cvs.core/src/org/eclipse/team/internal/ccvs/core/ICVSRemoteFile.java;3;0;8;1;0;0;0;8;74;1;8;2049;173;173;1;0;0;8;8;2049;0;3610;8;3;
/org.eclipse.jdt.debug.tests/test programs/HitCountLooper.java;1;0;2;1;0;0;0;2;0;1;2;3701;0;0;1;0;0;2;2;3701;0;3719;2;1;
/org.eclipse.help/src/org/eclipse/help/internal/contributions1_0/InfoView.java;2;0;3;1;0;0;0;3;6;1;3;1675;6;6;1;0;0;3;3;1675;0;2217;3;2;
/org.eclipse.team.cvs.core/src/org/eclipse/team/internal/ccvs/core/util/ListFileFilter.java;2;0;2;1;0;0;0;2;0;1;2;1978;0;0;1;0;0;2;2;1978;0;2690;2;2;
/org.eclipse.pde.core/src/org/eclipse/pde/internal/core/feature/Feature.java;1;1;3;1;2;2;2;1;147;0;1;3591;183;183;1;0;0;1;3;3591;0;3994;3;1;
/org.eclipse.swt.examples/src/org/eclipse/swt/examples/addressbook/DataEntryDialog.java;3;0;3;1;1;1;1;2;157;1;2;513;163;163;1;0;0;2;3;513;0;4705;3;3;
/org.eclipse.jdt.core/model/org/eclipse/jdt/internal/core/SelectionRequestor.java;3;1;24;1;3;3;3;21;458;4;16;455;724;724;4;5;0;21;24;1039;5;4668;19;3;
/org.eclipse.vcm.core.cvs/src/org/eclipse/vcm/internal/core/ccvs/requests/CheckoutUpdateHandler.java;3;0;4;1;0;0;0;4;14;1;4;0;20;20;1;0;0;4;4;0;0;423;4;3;
/org.eclipse.ui/Eclipse UI/org/eclipse/ui/IWorkbenchPreferenceConstants.java;5;0;6;1;1;1;1;5;79;1;5;457;140;140;1;0;0;5;6;457;0;4211;6;5;
/org.eclipse.help/Eclipse Help/org/eclipse/help/internal/contributions/xml/HelpAction.java;2;0;3;1;0;0;0;3;7;1;3;135;7;7;1;0;0;3;3;135;0;1420;3;2;
/org.eclipse.jdt.ui/ui/org/eclipse/jdt/internal/ui/preferences/ClasspathVariablesPreferencePage.java;4;0;21;1;1;1;1;20;136;2;19;133;361;361;2;1;0;20;21;1272;1;4181;20;4;
/org.eclipse.jdt.debug/eval/org/eclipse/jdt/internal/debug/eval/ast/instructions/NoOp.java;3;0;6;1;0;0;0;6;4;1;6;3421;11;11;1;0;0;6;6;3421;0;3677;6;3;
/org.eclipse.core.tests.runtime/src/org/eclipse/core/tests/internal/plugins/SoftPrereqTest_8.java;3;0;3;1;0;0;0;3;124;1;3;1794;134;134;1;0;0;3;3;1794;0;3476;3;3;
/org.eclipse.jdt.ui.tests.refactoring/resources/DeleteSourceReference/test3/in/A.java;1;0;1;1;0;0;0;1;0;0;1;2857;0;0;1;0;0;1;1;2857;0;2857;1;1;
/org.eclipse.jdt.debug/eval/org/eclipse/jdt/internal/debug/eval/ast/engine/Instruction.java;1;0;4;1;0;0;0;4;498;1;4;3329;527;527;1;0;0;4;4;3329;0;3421;4;1;
/org.eclipse.help.ui/src/org/eclipse/help/internal/ui/win32/TopicTreePrinter.java;2;0;2;2;0;0;0;2;0;0;1;1675;0;0;2;1;0;2;2;1675;1;1675;1;2;
/org.eclipse.jdt.core/model/org/eclipse/jdt/internal/core/builder/impl/TypeImplSWH.java;1;0;10;1;0;0;0;10;904;4;6;455;922;922;4;4;0;10;10;1039;4;2808;6;1;
/org.eclipse.team.cvs.ui/src/org/eclipse/team/internal/ccvs/ui/wizards/ConnectionWizard.java;1;0;4;1;0;0;0;4;104;1;4;1978;105;105;1;0;0;4;4;1978;0;2577;4;1;
/org.eclipse.jdt.ui/ui/org/eclipse/jdt/internal/ui/javaeditor/JavaEditor.java;12;2;69;2;13;12;13;56;193;3;44;15;1448;1448;3;12;1;56;69;344;13;4837;56;12;
/org.eclipse.jdt.core/compiler/org/eclipse/jdt/internal/compiler/lookup/ImportBinding.java;2;1;11;1;2;2;2;9;49;4;6;455;111;111;4;3;0;9;11;1039;3;4420;8;2;
/org.eclipse.search/search/org/eclipse/search/internal/ui/SearchPageDescriptor.java;2;1;10;1;2;2;2;8;56;1;8;15;146;146;1;0;0;8;10;15;0;4012;10;2;
/org.eclipse.jdt.debug/jdi/org/eclipse/jdi/internal/request/ClassUnloadRequestImpl.java;2;0;4;1;0;0;0;4;12;1;4;187;26;26;1;0;0;4;4;187;0;3670;4;2;
/org.eclipse.scripting/Eclipse Scripting/org/eclipse/scripting/internal/uirenderer/XGRElementUISwtComposite.java;2;0;5;1;0;0;0;5;30;1;5;133;43;43;1;0;0;5;5;133;0;1424;5;2;
/org.eclipse.scripting/src/org/eclipse/scripting/internal/views/ScriptDevelopmentWizardPageScriptLanguage.java;1;0;1;1;0;0;0;1;0;0;1;1424;0;0;1;0;0;1;1;1424;0;1424;1;1;
/org.eclipse.jdt.ui/core refactoring/org/eclipse/jdt/internal/corext/refactoring/util/IParentProvider.java;2;0;2;1;0;0;0;2;0;1;2;1939;0;0;1;0;0;2;2;1939;0;3357;2;2;
/org.eclipse.core.tests.resources/src/org/eclipse/core/tests/resources/Comparator.java;3;0;3;1;1;1;1;2;384;1;2;1794;399;399;1;0;0;2;3;1794;0;4516;3;3;
/org.eclipse.jdt.ui.tests.refactoring/resources/ExtractMethodWorkSpace/ExtractMethodTests/locals_in/A_test539.java;1;1;3;1;2;2;2;1;4;0;1;922;4;4;1;0;0;1;3;922;0;4419;3;1;
/org.eclipse.ant.core/src/org/eclipse/ant/core/toolscripts/ExternalToolScript.java;1;0;3;1;0;0;0;3;41;1;3;2919;41;41;1;0;0;3;3;2919;0;2979;3;1;
/org.eclipse.vcm.ui/src/org/eclipse/vcm/internal/ui/model/TeamStreamsCategory.java;3;0;4;1;0;0;0;4;15;1;4;1;23;23;1;0;0;4;4;1;0;1273;4;3;
/org.eclipse.compare/compare/org/eclipse/compare/patch/Patcher.java;1;0;7;1;0;0;0;7;177;1;7;1802;425;425;1;0;0;7;7;1802;0;2876;7;1;
/org.eclipse.core.tests.runtime/src/org/eclipse/core/tests/internal/plugins/ExtensiveRequiresTest.java;3;0;3;1;0;0;0;3;840;1;3;1794;850;850;1;0;0;3;3;1794;0;3476;3;3;
/org.eclipse.ui/Eclipse UI/org/eclipse/ui/internal/registry/ViewRegistry.java;3;0;4;1;0;0;0;4;9;1;4;257;17;17;1;0;0;4;4;257;0;3119;4;3;
/org.eclipse.pde.ui/src/org/eclipse/pde/core/plugin/IPluginModelFactory.java;1;0;2;1;0;0;0;2;0;1;2;3579;0;0;1;0;0;2;2;3579;0;3607;2;1;
/org.eclipse.jdt.debug/model/org/eclipse/jdt/internal/debug/core/Watchpoint.java;1;0;1;1;0;0;0;1;0;0;1;831;0;0;1;0;0;1;1;831;0;831;1;1;
/org.eclipse.swt.examples/org/eclipse/swt/examples/imageanalyzer/ImageAnalyzer.java;5;0;12;1;1;1;1;11;1858;1;11;554;2525;2525;1;0;0;11;12;554;0;4024;12;5;
/org.eclipse.scripting/src/org/eclipse/scripting/internal/ScriptPlatform.java;1;0;1;1;0;0;0;1;0;0;1;1424;0;0;1;0;0;1;1;1424;0;1424;1;1;
/org.eclipse.ui.externaltools/External Tools/org/eclipse/ui/externaltools/internal/ui/LogConsoleView.java;2;2;9;1;9;8;9;0;4;0;0;4090;16;16;2;0;1;0;9;4426;1;4462;8;2;
/org.eclipse.jdt.core/model/org/eclipse/jdt/core/IJavaModelMarker.java;3;2;18;1;6;5;6;12;72;4;8;455;220;220;4;4;1;12;18;1039;5;4493;13;3;
/org.eclipse.jdt.ui.tests.refactoring/resources/RenameType/testFail44/in/A.java;1;0;1;1;0;0;0;1;0;0;1;49;0;0;1;0;0;1;1;49;0;49;1;1;
/org.eclipse.jdt.ui.tests.refactoring/resources/RenamePrivateMethod/test11/in/A.java;1;0;1;1;0;0;0;1;0;0;1;49;0;0;1;0;0;1;1;49;0;49;1;1;
/org.eclipse.jdt.ui.tests.refactoring/resources/ReorderParameters/canReorder/A_test18_in.java;1;0;1;1;0;0;0;1;0;0;1;2296;0;0;1;0;0;1;1;2296;0;2296;1;1;
/org.eclipse.jdt.debug/jdi interfaces/com/sun/jdi/ThreadReference.java;2;0;2;1;0;0;0;2;20;1;2;2704;20;20;1;0;0;2;2;2704;0;3033;2;2;
/org.eclipse.pde.build/src/antlib/org/eclipse/pde/internal/core/tasks/PluginLocationTask.java;1;0;1;1;0;0;0;1;0;0;1;3475;0;0;1;0;0;1;1;3475;0;3475;1;1;
/org.eclipse.help/src/org/eclipse/help/internal/search/SearchResults.java;1;1;2;1;2;2;2;0;3;0;0;4002;3;3;1;0;0;0;2;4002;0;4043;2;1;
/org.eclipse.jdt.debug.tests/tests/org/eclipse/jdt/debug/tests/eval/NestedTypeFieldValue_615.java;2;1;3;1;3;3;3;0;12;0;0;4447;14;14;1;0;0;0;3;4447;0;4571;3;2;
/org.eclipse.swt/Eclipse SWT PI/win32/org/eclipse/swt/internal/win32/NMTVCUSTOMDRAW.java;1;0;2;1;1;1;1;1;6;0;1;3122;6;6;1;0;0;1;2;3122;0;4701;2;1;
/org.eclipse.update.ui/src/org/eclipse/update/internal/ui/parts/BrowserControlSite.java;1;0;10;1;1;1;1;9;88;3;7;1477;279;279;3;2;0;9;10;1828;2;4127;8;1;
/org.eclipse.jdt.debug.tests/tests/org/eclipse/jdt/debug/tests/eval/NestedTypeFieldValue_713.java;2;1;3;1;3;3;3;0;12;0;0;4447;14;14;1;0;0;0;3;4447;0;4571;3;2;
/org.eclipse.jdt.debug.ui/ui/org/eclipse/jdt/internal/debug/ui/launcher/JavaUISourceLocator.java;2;0;5;1;0;0;0;5;27;1;5;1915;47;47;1;0;0;5;5;1915;0;2779;5;2;
/org.eclipse.ui.examples.javaeditor/Java Editor Example/org/eclipse/ui/examples/javaeditor/JavaAnnotationHover.java;1;0;2;1;0;0;0;2;0;0;1;1066;0;0;2;1;0;2;2;1066;1;1066;1;1;
/org.eclipse.jdt.core/model/org/eclipse/jdt/internal/core/builder/BuildEvent.java;1;0;4;1;0;0;0;4;16;1;4;455;24;24;1;0;0;4;4;455;0;2808;4;1;
/org.eclipse.jdt.ui/ui/org/eclipse/jdt/internal/ui/compare/LocalHistoryActionGroup.java;1;1;2;1;2;2;2;0;20;0;0;4161;20;20;1;0;0;0;2;4161;0;4546;2;1;
/org.eclipse.update.tests.core/src/org/eclipse/update/tests/api/TestNestedFeatureAPI.java;1;1;2;1;2;2;2;0;56;0;0;3973;56;56;1;0;0;0;2;3973;0;4022;2;1;
/org.eclipse.team.core/src/org/eclipse/team/core/internal/DefaultMoveDeleteHook.java;2;0;3;1;0;0;0;3;95;1;3;3261;95;95;1;0;0;3;3;3261;0;3762;3;2;
/org.eclipse.pde.ui/Eclipse PDE UI/org/eclipse/pde/internal/editor/schema/NoRestrictionPage.java;2;0;5;2;0;0;0;5;12;3;3;267;12;12;3;2;0;5;5;324;2;1434;3;2;
/org.eclipse.ant.ui/src/org/eclipse/ant/internal/ui/AntConsole.java;5;0;21;2;0;0;0;21;33;6;14;360;81;81;6;7;0;21;21;369;7;3606;14;5;
/org.eclipse.update.core/src/org/eclipse/update/internal/core/SiteLocalParser.java;2;0;10;1;0;0;0;10;62;2;9;2010;94;94;2;1;0;10;10;2067;1;2764;9;2;
/org.eclipse.jdt.ui/ui/org/eclipse/jdt/internal/ui/wizards/OpenPackageWizardAction.java;4;1;7;1;2;2;2;5;13;1;5;15;29;29;1;0;0;5;7;15;0;4630;7;4;
/org.eclipse.team.cvs.ui/src/org/eclipse/team/internal/ccvs/ui/model/RemoteContentProvider.java;3;0;6;1;0;0;0;6;64;1;6;1978;91;91;1;0;0;6;6;1978;0;3610;6;3;
/org.eclipse.scripting/Eclipse Scripting/org/eclipse/scripting/internal/ScriptManager.java;2;0;10;1;0;0;0;10;767;2;9;133;839;839;2;1;0;10;10;774;1;1424;9;2;
/org.eclipse.jdt.debug.tests/test programs/org/eclipse/debug/tests/targets/HelloLauncherWithArg.java;1;0;2;1;0;0;0;2;0;1;2;3701;0;0;1;0;0;2;2;3701;0;3719;2;1;
/org.eclipse.pde.ui/Eclipse PDE UI/org/eclipse/pde/internal/editor/manifest/ManifestExtensionsPage.java;2;0;5;2;0;0;0;5;12;3;3;267;12;12;3;2;0;5;5;324;2;1434;3;2;
/org.eclipse.jdt.ui.tests.refactoring/resources/ExtractMethodWorkSpace/ExtractMethodTests/return_in/A_test723.java;1;1;3;1;2;2;2;1;22;0;1;2580;22;22;1;0;0;1;3;2580;0;4419;3;1;
/org.eclipse.core.resources/src/org/eclipse/core/internal/resources/NatureManager.java;1;0;5;1;1;1;1;4;42;1;4;3075;108;108;1;0;0;4;5;3075;0;4213;5;1;
/org.eclipse.ui/Eclipse UI Tool Script/org/eclipse/toolscript/ui/internal/ToolScriptConfigureAction.java;1;1;6;1;5;5;5;1;142;0;1;3766;187;187;1;0;0;1;6;3766;0;4087;6;1;
/org.eclipse.pde.ui/src/org/eclipse/pde/internal/pluginsview/EnableAction.java;1;0;2;1;0;0;0;2;0;1;2;2650;0;0;1;0;0;2;2;2650;0;2978;2;1;
/org.eclipse.pde.ui/src/org/eclipse/pde/internal/forms/ScrollableForm.java;2;0;2;1;0;0;0;2;0;1;2;1434;0;0;1;0;0;2;2;1434;0;2470;2;2;
/org.eclipse.jdt.ui/ui/org/eclipse/jdt/internal/ui/packageview/FileTransferDragAdapter.java;6;0;10;1;1;1;1;9;37;1;9;15;126;126;1;0;0;9;10;15;0;4158;10;6;
/org.eclipse.debug.ui/ui/org/eclipse/debug/internal/ui/ResumeActionDelegate.java;3;0;7;1;0;0;0;7;43;1;7;187;70;70;1;0;0;7;7;187;0;2382;7;3;
/org.eclipse.swt.examples/org/eclipse/swt/examples/explorer/FileDisplayInfo.java;1;0;1;1;0;0;0;1;0;0;1;548;0;0;1;0;0;1;1;548;0;548;1;1;
/org.eclipse.pde.ui/src/org/eclipse/pde/internal/util/PDEProblemFinder.java;1;0;2;1;0;0;0;2;0;1;2;2691;0;0;1;0;0;2;2;2691;0;3579;2;1;
/org.eclipse.update.ui/src/org/eclipse/update/internal/ui/search/SearchCategory.java;1;0;1;1;0;0;0;1;0;0;1;3553;0;0;1;0;0;1;1;3553;0;3553;1;1;
/org.eclipse.ui/Eclipse UI/org/eclipse/ui/internal/dialogs/ZipFileResourceExporter.java;2;0;2;1;0;0;0;2;23;1;2;257;23;23;1;0;0;2;2;257;0;457;2;2;
/org.eclipse.jdt.junit/src/org/eclipse/jdt/internal/junit/launcher/JUnitMainTab.java;3;1;11;1;4;4;4;7;188;1;7;3171;485;485;1;0;0;7;11;3171;0;4600;11;3;
/org.eclipse.jdt.junit/Eclipse JUnit/org/eclipse/jdt/internal/junit/util/TestSearchEngine.java;2;0;2;1;0;0;0;2;0;1;2;2861;0;0;1;0;0;2;2;2861;0;3205;2;2;
/org.eclipse.swt/Eclipse SWT Custom Widgets/common/org/eclipse/swt/custom/TableCursor.java;2;2;8;1;4;3;4;4;309;2;3;2680;531;531;2;1;1;4;8;2876;2;4701;6;2;
/org.eclipse.jdt.ui/ui/org/eclipse/jdt/ui/actions/ImportActionGroup.java;1;1;6;1;6;6;6;0;63;0;0;3894;126;126;1;0;0;0;6;3894;0;4770;6;1;
/org.eclipse.update/src/org/eclipse/update/internal/ui/UMWizardPageLaunchHistoryComplete.java;1;0;1;1;0;0;0;1;0;0;1;1424;0;0;1;0;0;1;1;1424;0;1424;1;1;
/org.eclipse.jdt.ui/ui/org/eclipse/jdt/internal/ui/dialogs/ListDialog.java;1;0;1;1;1;1;1;0;0;0;0;4084;0;0;1;0;0;0;1;4084;0;4084;1;1;
/org.eclipse.jdt.ui.tests.refactoring/resources/ExtractMethodWorkSpace/ExtractMethodTests/wiki_out/A_test2003.java;1;1;3;1;2;2;2;1;44;0;1;1236;44;44;1;0;0;1;3;1236;0;4419;3;1;
/org.eclipse.jdt.ui/ui/org/eclipse/jdt/internal/ui/search/PathNameSorter.java;1;0;3;1;0;0;0;3;28;1;3;1272;30;30;1;0;0;3;3;1272;0;1478;3;1;
/org.eclipse.jdt.ui.tests.refactoring/resources/RenameMethodInInterface/testFail5/in/A.java;1;0;1;1;0;0;0;1;0;0;1;49;0;0;1;0;0;1;1;49;0;49;1;1;
/org.eclipse.jdt.junit/Eclipse JUnit/org/eclipse/jdt/internal/junit/launcher/JavaEnvironmentTab.java;2;0;2;1;0;0;0;2;0;1;2;2861;0;0;1;0;0;2;2;2861;0;3068;2;2;
/org.eclipse.team.tests.cvs.core/src/org/eclipse/team/tests/ccvs/ui/logformatter/PrintSummaryVisitor.java;1;0;3;1;0;0;0;3;4;1;3;2977;4;4;1;0;0;3;3;2977;0;3452;3;1;
/org.eclipse.jdt.debug/jdi interfaces/com/sun/jdi/event/Event.java;2;0;2;1;0;0;0;2;9;1;2;2704;9;9;1;0;0;2;2;2704;0;3040;2;2;
/org.eclipse.jdt.ui/ui/org/eclipse/jdt/internal/ui/search/OpenJavaSearchPageAction.java;1;0;2;1;2;1;2;0;44;0;0;4001;44;44;2;0;1;0;2;4001;1;4001;1;1;
/org.eclipse.pde.ui/Eclipse PDE UI/org/eclipse/pde/internal/wizards/extension/NewExtensionMainPage.java;2;0;5;2;0;0;0;5;12;3;3;267;12;12;3;2;0;5;5;324;2;1434;3;2;
/org.eclipse.pde.ui/Eclipse PDE UI/org/eclipse/pde/internal/base/model/IModelChangedEvent.java;2;0;5;2;0;0;0;5;12;3;3;267;12;12;3;2;0;5;5;324;2;1434;3;2;
/org.eclipse.team.tests.cvs.core/src/org/eclipse/team/tests/ccvs/ui/logformatter/PrintCSVDiffVisitor.java;2;0;2;1;0;0;0;2;4;1;2;3452;4;4;1;0;0;2;2;3452;0;3873;2;2;
/org.eclipse.jdt.debug/eval/org/eclipse/jdt/internal/debug/eval/EvaluationMessages.java;1;0;2;1;0;0;0;2;15;1;2;1944;15;15;1;0;0;2;2;1944;0;3677;2;1;
/org.eclipse.jdt.ui/core refactoring/org/eclipse/jdt/internal/corext/refactoring/util/ParentProvider.java;2;0;3;1;0;0;0;3;9;1;3;1939;9;9;1;0;0;3;3;1939;0;3087;3;2;
/org.eclipse.pde.ui/Eclipse PDE UI/org/eclipse/pde/internal/codegen/JavaCodeGenerator.java;2;0;8;2;0;0;0;8;12;3;6;267;24;24;3;2;0;8;8;324;2;1434;6;2;
/org.eclipse.swt/Eclipse SWT/gtk1x/org/eclipse/swt/widgets/List.java;5;0;7;1;1;1;1;6;260;1;6;2107;307;307;1;0;0;6;7;2107;0;4701;7;5;
/org.eclipse.scripting/Eclipse Scripting/org/eclipse/scripting/internal/IXGRElementEventGeneratorOnChange.java;1;0;3;1;0;0;0;3;4;1;3;133;4;4;1;0;0;3;3;133;0;1424;3;1;
/org.eclipse.pde.ui/Eclipse PDE UI/org/eclipse/pde/internal/model/WorkspacePluginModel.java;2;0;5;2;0;0;0;5;12;3;3;267;12;12;3;2;0;5;5;324;2;1434;3;2;
/org.eclipse.jdt.ui/core refactoring/org/eclipse/jdt/internal/core/refactoring/nls/Messages.java;1;0;2;1;0;0;0;2;4;0;1;1922;4;4;2;1;0;2;2;1922;1;1922;1;1;
/org.eclipse.jdt.ui/core refactoring/org/eclipse/jdt/core/refactoring/types/RenameTypeASTAnalyzer.java;1;0;6;1;0;0;0;6;225;2;5;15;237;237;2;1;0;6;6;25;1;408;5;1;
/org.eclipse.pde.ui/src/org/eclipse/pde/internal/editor/jars/JarsEditorContributor.java;2;0;2;1;0;0;0;2;0;1;2;1434;0;0;1;0;0;2;2;1434;0;2650;2;2;
/org.eclipse.jdt.ui.tests.refactoring/test cases/org/eclipse/jdt/ui/tests/actions/CopyResourcesToClipboardActionTest.java;2;1;10;2;3;3;3;7;17;2;6;3168;59;59;2;1;0;7;10;3826;1;4278;9;2;
/org.eclipse.jdt.ui.tests/refactoring/org/eclipse/jdt/refactoring/tests/AllTests.java;3;0;6;1;0;0;0;6;9;1;6;1114;17;17;1;0;0;6;6;1114;0;1896;6;3;
/org.eclipse.help/Eclipse Help/org/eclipse/help/internal/util/RuntimeHelpStatus.java;3;0;4;1;0;0;0;4;7;1;4;135;11;11;1;0;0;4;4;135;0;1420;4;3;
/org.eclipse.pde.ui/src/org/eclipse/pde/internal/core/FileAdapter.java;1;0;5;1;0;0;0;5;27;2;3;3445;41;41;2;2;0;5;5;3445;2;3607;3;1;
/org.eclipse.jdt.launching/launching/org/eclipse/jdt/launching/LibraryLocation.java;1;2;7;1;6;5;6;1;9;0;1;2022;22;22;2;0;1;1;7;4650;1;4650;6;1;
/org.eclipse.team.cvs.core/src/org/eclipse/team/internal/ccvs/core/client/Commit.java;2;0;11;2;0;0;0;11;59;2;10;2572;113;113;2;1;0;11;11;3089;1;3838;10;2;
/org.eclipse.team.cvs.core/src/org/eclipse/team/internal/ccvs/core/util/OrphanedFolderListener.java;2;0;5;2;0;0;0;5;45;2;4;2937;71;71;2;1;0;5;5;3089;1;3251;4;2;
/org.eclipse.jdt.core/model/org/eclipse/jdt/internal/core/builder/impl/PackageElement.java;1;0;3;1;0;0;0;3;31;1;3;455;31;31;1;0;0;3;3;455;0;2808;3;1;
/org.eclipse.ui/Eclipse UI Standard Components/org/eclipse/ui/wizards/datatransfer/FileSystemExportWizard.java;3;0;4;1;0;0;0;4;30;1;4;257;54;54;1;0;0;4;4;257;0;2810;4;3;
/org.eclipse.scripting/Eclipse Scripting/org/eclipse/scripting/internal/views/ScriptUIEditorXmlAttribute.java;2;0;4;1;0;0;0;4;8;1;4;133;15;15;1;0;0;4;4;133;0;1424;4;2;
/org.eclipse.core.resources/src/org/eclipse/core/internal/indexing/IndexCursor.java;2;0;4;1;1;1;1;3;896;1;3;12;916;916;1;0;0;3;4;12;0;4214;4;2;
/org.eclipse.pde.ui/src/org/eclipse/pde/internal/ui/editor/feature/IncludeFeaturesWizard.java;1;0;1;1;1;1;1;0;0;0;0;3982;0;0;1;0;0;0;1;3982;0;3982;1;1;
/org.eclipse.core.tests.runtime/src/org/eclipse/core/tests/internal/plugins/JarSearchTests.java;3;0;3;1;0;0;0;3;94;1;3;2448;104;104;1;0;0;3;3;2448;0;3476;3;3;
/org.eclipse.core.tests.runtime/src/org/eclipse/core/tests/internal/plugin/a/ExtensionDirectCompilerReferenceToOtherClass.java;3;0;3;1;0;0;0;3;20;1;3;1794;30;30;1;0;0;3;3;1794;0;3476;3;3;
/org.eclipse.jdt.debug/model/org/eclipse/jdt/internal/debug/core/breakpoints/JavaPatternBreakpoint.java;3;0;16;2;0;0;0;16;98;2;14;2517;275;275;2;2;0;16;16;2517;2;3507;14;3;
/org.eclipse.ui/Eclipse UI/org/eclipse/ui/internal/ExceptionHandler.java;2;0;9;1;1;1;1;8;55;1;8;2727;196;196;1;0;0;8;9;2727;0;4024;9;2;
/org.eclipse.pde.ui/src/org/eclipse/pde/internal/base/model/plugin/IJarEntry.java;2;0;2;1;0;0;0;2;0;1;2;1434;0;0;1;0;0;2;2;1434;0;2691;2;2;
/org.eclipse.ui/Eclipse JFace/org/eclipse/jface/viewers/LabelProvider.java;2;0;2;1;0;0;0;2;5;1;2;257;5;5;1;0;0;2;2;257;0;457;2;2;
/org.eclipse.jdt.ui.tests.refactoring/resources/RenameType/test6/out/B.java;1;0;1;1;0;0;0;1;0;0;1;522;0;0;1;0;0;1;1;522;0;522;1;1;
/org.eclipse.scripting/src/org/eclipse/scripting/internal/ScriptObjectDescriptor.java;1;0;1;1;0;0;0;1;0;0;1;1424;0;0;1;0;0;1;1;1424;0;1424;1;1;
/org.eclipse.jdt.core/compiler/org/eclipse/jdt/internal/compiler/util/HashtableOfObject.java;2;0;18;1;1;1;1;17;169;4;12;455;487;487;4;5;0;17;18;1039;5;4062;13;2;
/org.eclipse.jdt.ui/ui/org/eclipse/jdt/internal/ui/compare/CompareDialog.java;2;1;4;1;2;2;2;2;30;1;2;3210;62;62;1;0;0;2;4;3210;0;4630;4;2;
/org.eclipse.team.ui/src/org/eclipse/team/internal/ui/ConfigureProjectWizardMainPage.java;3;1;9;1;4;4;4;5;282;1;5;1978;350;350;1;0;0;5;9;1978;0;4626;9;3;
/org.eclipse.jdt.ui.tests.refactoring/resources/RenameType/test50/out/A.java;1;0;2;1;0;0;0;2;0;1;2;49;0;0;1;0;0;2;2;49;0;522;2;1;
/org.eclipse.jdt.ui/core refactoring/org/eclipse/jdt/internal/corext/refactoring/changes/CopyCompilationUnitChange.java;2;0;3;1;1;1;1;2;9;1;2;1939;14;14;1;0;0;2;3;1939;0;4212;3;2;
/org.eclipse.jdt.core/model/org/eclipse/jdt/internal/core/jdom/DOMMethod.java;2;0;11;1;1;1;1;10;1284;4;7;455;1580;1580;4;3;0;10;11;1039;3;4063;8;2;
/org.eclipse.jdt.ui/ui/org/eclipse/jdt/internal/ui/wizards/OpenInterfaceWizardAction.java;4;1;6;1;2;2;2;4;12;1;4;15;27;27;1;0;0;4;6;15;0;4630;6;4;
/org.eclipse.jdt.ui.tests.refactoring/resources/RenameType/test17/out/B.java;1;0;1;1;0;0;0;1;0;0;1;522;0;0;1;0;0;1;1;522;0;522;1;1;
/org.eclipse.pde.ui/Eclipse PDE UI/org/eclipse/pde/internal/editor/manifest/ResourceAttributeValue.java;2;0;5;2;0;0;0;5;12;3;3;267;12;12;3;2;0;5;5;324;2;1434;3;2;
/org.eclipse.core.tests.runtime/src/org/eclipse/core/tests/internal/plugins/FragmentResolveTest_3.java;3;0;4;1;0;0;0;4;190;1;4;1819;201;201;1;0;0;4;4;1819;0;3476;4;3;
/org.eclipse.pde.ui/Eclipse PDE UI/org/eclipse/pde/internal/editor/manifest/ResourceAttributeCellEditor.java;2;0;5;2;0;0;0;5;12;3;3;267;12;12;3;2;0;5;5;324;2;1434;3;2;
/org.eclipse.jdt.ui.tests.refactoring/resources/RenameType/test17/out/A.java;1;0;2;1;0;0;0;2;0;1;2;49;0;0;1;0;0;2;2;49;0;522;2;1;
/org.eclipse.ant.ui/src/org/eclipse/ant/internal/ui/AntLaunchWizardPage.java;4;0;18;2;0;0;0;18;102;3;14;300;214;214;3;4;0;18;18;326;4;3606;14;4;
/org.eclipse.swt/Eclipse SWT/common/org/eclipse/swt/events/MouseMoveListener.java;4;0;5;1;1;1;1;4;6;1;4;106;18;18;1;0;0;4;5;106;0;4701;5;4;
/org.eclipse.jdt.ui/ui/org/eclipse/jdt/internal/ui/packageview/ISeverityListener.java;2;0;3;1;0;0;0;3;4;1;3;15;4;4;1;0;0;3;3;15;0;1004;3;2;
/org.eclipse.jdt.ui.tests.refactoring/resources/SurroundWithWorkSpace/SurroundWithTests/trycatch_in/TestThisConstructorCall.java;1;0;1;1;0;0;0;1;0;0;1;3209;0;0;1;0;0;1;1;3209;0;3209;1;1;
/org.eclipse.swt.examples/Eclipse SWT Examples/common/org/eclipse/swt/examples/helloworld/HelloWorld3.java;1;0;2;1;0;0;0;2;0;1;2;107;0;0;1;0;0;2;2;107;0;611;2;1;
/org.eclipse.jdt.core/model/org/eclipse/jdt/internal/core/builder/IImageContext.java;1;0;4;1;0;0;0;4;34;1;4;455;63;63;1;0;0;4;4;455;0;2808;4;1;
/org.eclipse.team.tests.cvs.core/src/org/eclipse/team/tests/ccvs/core/AllTests.java;2;0;3;1;0;0;0;3;6;1;3;2536;8;8;1;0;0;3;3;2536;0;3287;3;2;
/org.eclipse.ui/Eclipse JFace Text/org/eclipse/jface/text/source/VisualAnnotationModel.java;3;0;3;1;0;0;0;3;28;1;3;257;33;33;1;0;0;3;3;257;0;1066;3;3;
/org.eclipse.jdt.ui.tests.refactoring/resources/PullUpMethods/test12/out/B.java;1;0;2;1;0;0;0;2;0;1;2;2212;0;0;1;0;0;2;2;2212;0;2406;2;1;
/org.eclipse.swt.tests/JUnit Tests/org/eclipse/swt/tests/junit/Test_org_eclipse_swt_events_MouseMoveListener.java;2;0;2;1;1;1;1;1;6;0;1;1792;6;6;1;0;0;1;2;1792;0;4706;2;2;
/org.eclipse.pde.ui/src/org/eclipse/pde/internal/editor/manifest/ManifestPropertySource.java;2;0;3;1;0;0;0;3;2;1;3;1434;2;2;1;0;0;3;3;1434;0;3579;3;2;
/org.eclipse.jdt.ui/ui/org/eclipse/jdt/internal/ui/packageview/PackageExplorerLabelProvider.java;2;0;7;1;0;0;0;7;20;3;5;2321;35;35;3;2;0;7;7;2581;2;3103;5;2;
/org.eclipse.swt.examples.controls/org/eclipse/swt/examples/controls/AlignableTab.java;2;0;3;1;0;0;0;3;76;1;3;513;76;76;1;0;0;3;3;513;0;970;3;2;
/org.eclipse.pde.build/src/org/eclipse/pde/internal/build/CVSPass.java;3;0;6;1;0;0;0;6;190;1;6;1331;222;222;1;0;0;6;6;1331;0;3089;6;3;
/org.eclipse.vcm.ui/src/org/eclipse/vcm/internal/ui/adapter/ChangeSet.java;2;0;2;1;0;0;0;2;5;1;2;1;5;5;1;0;0;2;2;1;0;298;2;2;
/org.eclipse.swt/Eclipse SWT Custom Widgets/common_j2se/org/eclipse/swt/custom/TableTree.java;1;0;1;1;0;0;0;1;0;0;1;1378;0;0;1;0;0;1;1;1378;0;1378;1;1;
/org.eclipse.ui/Eclipse UI/org/eclipse/ui/internal/model/WorkbenchAdapter.java;2;0;2;1;0;0;0;2;8;1;2;257;8;8;1;0;0;2;2;257;0;457;2;2;
/org.eclipse.jdt.ui/ui/org/eclipse/jdt/internal/ui/IPreferencesConstants.java;6;0;18;1;1;1;1;17;22;3;15;15;102;102;3;2;0;17;18;412;2;4186;16;6;
/org.eclipse.jdt.ui.tests.refactoring/resources/RenameVirtualMethodInClass/testFail31/in/A.java;1;0;1;1;0;0;0;1;0;0;1;49;0;0;1;0;0;1;1;49;0;49;1;1;
/org.eclipse.jdt.debug.ui/ui/org/eclipse/jdt/debug/ui/IJavaDebugUIConstants.java;4;2;7;2;3;2;3;4;37;1;4;2813;75;75;2;0;1;4;7;3959;1;4659;6;4;
/org.eclipse.ui/Eclipse UI/org/eclipse/ui/internal/SaveAsAction.java;3;0;3;1;0;0;0;3;15;1;3;257;17;17;1;0;0;3;3;257;0;3029;3;3;
/org.eclipse.jdt.ui.tests.refactoring/resources/RenameMethodInInterface/test43/in/A.java;1;0;1;1;0;0;0;1;0;0;1;49;0;0;1;0;0;1;1;49;0;49;1;1;
/org.eclipse.ui/Eclipse UI/org/eclipse/ui/internal/misc/AcceleratorHook.java;3;0;4;1;0;0;0;4;22;2;3;257;28;28;2;1;0;4;4;1436;1;1436;3;3;
/org.eclipse.pde.core/src/org/eclipse/pde/core/plugin/IPluginExtensionPoint.java;1;0;3;1;2;1;2;1;38;0;1;3591;38;38;2;0;1;1;3;4751;1;4751;2;1;
/org.eclipse.jdt.ui/core extension/org/eclipse/jdt/internal/corext/codemanipulation/TextEditNodeComparator.java;1;0;2;1;0;0;0;2;0;0;1;2133;0;0;2;1;0;2;2;2133;1;2133;1;1;
/org.eclipse.ui/Eclipse UI Text Editor/org/eclipse/ui/texteditor/IDocumentProviderExtension.java;1;1;7;1;3;3;3;4;39;1;4;2102;132;132;1;0;0;4;7;2102;0;4838;7;1;
/org.eclipse.jdt.core/compiler/org/eclipse/jdt/internal/compiler/ast/DoStatement.java;2;0;13;1;1;1;1;12;277;4;9;455;665;665;4;3;0;12;13;1039;3;4062;10;2;
/org.eclipse.compare/compare/org/eclipse/compare/internal/IStructureCreatorDescriptor.java;1;0;2;1;0;0;0;2;5;1;2;14;5;5;1;0;0;2;2;14;0;329;2;1;
/org.eclipse.jdt.ui/ui/org/eclipse/jdt/internal/ui/util/TwoArrayQuickSort.java;3;0;4;1;0;0;0;4;4;1;4;15;6;6;1;0;0;4;4;15;0;1199;4;3;
/org.eclipse.jdt.ui.tests.refactoring/resources/ExtractMethodWorkSpace/ExtractMethodTests/wiki_out/A_test2001.java;1;1;4;1;2;2;2;2;36;1;2;1236;37;37;1;0;0;2;4;1236;0;4419;4;1;
/org.eclipse.jdt.ui.tests/JUnit/junit/util/Version.java;2;0;2;1;0;0;0;2;0;1;2;49;0;0;1;0;0;2;2;49;0;1186;2;2;
/org.eclipse.ui/Eclipse UI/org/eclipse/ui/internal/IHelpContextIds.java;9;2;21;2;6;5;6;15;180;2;13;257;324;324;2;2;1;15;21;3186;3;4730;18;9;
/org.eclipse.pde.ui/Eclipse PDE UI/org/eclipse/pde/internal/builders/ComponentConsistencyChecker.java;2;0;7;2;0;0;0;7;19;3;5;267;33;33;3;2;0;7;7;324;2;1434;5;2;
/org.eclipse.jdt.junit/Eclipse JUnit/org/eclipse/jdt/internal/junit/launcher/JUnitBaseLaunchConfiguration.java;2;0;5;2;0;0;0;5;276;2;4;2861;302;302;2;1;0;5;5;3068;1;3150;4;2;
/org.eclipse.pde.ui/src/org/eclipse/pde/internal/forms/IFormSelectionListener.java;2;0;2;1;0;0;0;2;0;1;2;1434;0;0;1;0;0;2;2;1434;0;2470;2;2;
/org.eclipse.ui.tests/UI Test Utils/org/eclipse/ui/tests/internal/util/VerifyDialog.java;1;0;1;1;0;0;0;1;0;0;1;2785;0;0;1;0;0;1;1;2785;0;2785;1;1;
/org.eclipse.jdt.ui.tests.refactoring/resources/RenameTemp/canRename/A_test31_in.java;1;0;2;1;0;0;0;2;2;1;2;1625;2;2;1;0;0;2;2;1625;0;1652;2;1;
/org.eclipse.ui/Eclipse UI/org/eclipse/ui/internal/ImportResourcesAction.java;5;0;6;1;0;0;0;6;13;1;6;257;21;21;1;0;0;6;6;257;0;3739;6;5;
/org.eclipse.jdt.ui/core refactoring/org/eclipse/jdt/internal/corext/refactoring/changes/CreatePackageChange.java;2;0;4;1;0;0;0;4;5;1;4;3308;9;9;1;0;0;4;4;3308;0;3646;4;2;
/org.eclipse.ui/Eclipse UI Standard Components/org/eclipse/ui/wizards/newresource/BasicNewFolderResourceWizard.java;2;0;3;1;0;0;0;3;15;1;3;257;22;22;1;0;0;3;3;257;0;2568;3;2;
/org.eclipse.core.runtime/src/org/eclipse/core/runtime/PlatformObject.java;3;0;4;1;1;1;1;3;110;1;3;12;131;131;1;0;0;3;4;12;0;4214;4;3;
/org.eclipse.jdt.debug.tests/tests/org/eclipse/jdt/debug/tests/AutomatedSuite.java;4;3;18;2;15;11;15;3;46;1;3;3701;121;121;3;0;4;3;18;4307;4;4524;14;4;
/org.eclipse.swt.examples/Eclipse SWT Examples/common/org/eclipse/swt/examples/texteditor/Images.java;1;0;2;1;0;0;0;2;0;1;2;107;0;0;1;0;0;2;2;107;0;611;2;1;
/org.eclipse.ui/Eclipse JFace Text/org/eclipse/jface/text/ConfigurableLineTracker.java;3;0;3;1;0;0;0;3;5;1;3;257;7;7;1;0;0;3;3;257;0;1066;3;3;
/org.eclipse.jdt.ui.tests.refactoring/resources/RenameVirtualMethodInClass/test22/in/A.java;1;0;1;1;0;0;0;1;0;0;1;49;0;0;1;0;0;1;1;49;0;49;1;1;
/org.eclipse.jdt.ui.tests.refactoring/resources/PullUp/testFail8/in/B.java;1;0;1;1;0;0;0;1;0;0;1;2406;0;0;1;0;0;1;1;2406;0;2406;1;1;
/org.eclipse.swt.tests/JUnit Tests/org/eclipse/swt/tests/junit/Test_org_eclipse_swt_custom_LineStyleEvent.java;2;0;2;1;1;1;1;1;6;0;1;1792;6;6;1;0;0;1;2;1792;0;4706;2;2;
/org.eclipse.jdt.ui.tests.refactoring/resources/RenameMethodInInterface/test33/out/A.java;1;0;1;1;0;0;0;1;0;0;1;49;0;0;1;0;0;1;1;49;0;49;1;1;
/org.eclipse.jdt.debug/model/org/eclipse/jdt/internal/debug/core/JDIDebugElement.java;3;0;19;2;0;0;0;19;200;2;17;187;536;536;2;2;0;19;19;1433;2;2517;17;3;
/org.eclipse.jdt.ui/ui debug/org/eclipse/jdt/internal/debug/ui/display/DisplayViewAction.java;4;0;5;1;0;0;0;5;17;2;4;345;25;25;2;1;0;5;5;345;1;1916;4;4;
/org.eclipse.ui/Eclipse JFace/org/eclipse/jface/dialogs/IMessageProvider.java;1;0;1;1;0;0;0;1;0;0;1;3680;0;0;1;0;0;1;1;3680;0;3680;1;1;
/org.eclipse.jdt.ui.tests.refactoring/resources/ExtractMethodWorkSpace/ExtractMethodTests/return_out/A_test708.java;1;1;3;1;2;2;2;1;24;0;1;887;24;24;1;0;0;1;3;887;0;4419;3;1;
/org.eclipse.jdt.ui.tests.refactoring/resources/RenameType/testFail49/in/A.java;1;0;1;1;0;0;0;1;0;0;1;49;0;0;1;0;0;1;1;49;0;49;1;1;
/org.eclipse.core.boot/src/org/eclipse/core/internal/boot/update/XmlLiteException.java;2;0;3;1;0;0;0;3;7;1;3;12;7;7;1;0;0;3;3;12;0;2726;3;2;
/org.eclipse.search/search/org/eclipse/search/internal/ui/util/ExceptionHandler.java;2;0;9;1;0;0;0;9;164;2;7;15;261;261;2;2;0;9;9;52;2;1755;7;2;
/org.eclipse.jdt.debug/eval/org/eclipse/jdt/internal/debug/eval/ast/engine/ArrayAllocation.java;1;0;3;1;0;0;0;3;2;1;3;3329;2;2;1;0;0;3;3;3329;0;3421;3;1;
/org.eclipse.pde.ui/src/org/eclipse/pde/internal/ui/wizards/templates/EditorTemplate.java;1;1;6;1;2;2;2;4;82;1;4;3812;134;134;1;0;0;4;6;3812;0;4370;6;1;
/org.eclipse.vcm.ui/src/org/eclipse/vcm/internal/ui/syncdialog/VCMFile.java;2;0;2;1;0;0;0;2;0;1;2;1;0;0;1;0;0;2;2;1;0;68;2;2;
/org.eclipse.swt.examples.controls/org/eclipse/swt/examples/controls/ScrollableTab.java;2;0;4;1;0;0;0;4;48;1;4;513;50;50;1;0;0;4;4;513;0;970;4;2;
/org.eclipse.pde.build/src/org/eclipse/pde/internal/build/ScriptGeneratorConstants.java;5;0;11;1;0;0;0;11;31;1;11;245;112;112;1;0;0;11;11;245;0;3089;11;5;
/org.eclipse.pde.ui/Eclipse PDE UI/org/eclipse/pde/internal/editor/schema/SchemaDocPage.java;2;0;5;2;0;0;0;5;12;3;3;267;12;12;3;2;0;5;5;324;2;1434;3;2;
/org.eclipse.help/src/org/eclipse/help/internal/contributions1_0/Contribution.java;2;0;5;1;0;0;0;5;10;1;5;1675;15;15;1;0;0;5;5;1675;0;2217;5;2;
/org.eclipse.core.resources/src/org/eclipse/core/internal/watson/IElementTreeData.java;1;0;4;1;1;1;1;3;34;1;3;12;55;55;1;0;0;3;4;12;0;4214;4;1;
/org.eclipse.jdt.debug.ui/ui/org/eclipse/jdt/internal/debug/ui/JDIModelPresentation.java;3;2;73;2;9;8;9;64;233;4;48;1915;1927;1927;4;16;1;64;73;2661;17;4768;56;3;
/org.eclipse.jdt.ui/ui/org/eclipse/jdt/internal/ui/text/javadoc/JavaDocCompletionProcessor.java;6;1;16;1;2;2;2;14;224;2;12;15;442;442;2;2;0;14;16;1605;2;4621;14;6;
/org.eclipse.jdt.ui.tests.refactoring/resources/ExtractMethodWorkSpace/ExtractMethodTests/invalidSelection/A_test115.java;2;1;3;1;2;2;2;1;0;0;1;49;0;0;1;0;0;1;3;49;0;4419;3;2;
/org.eclipse.team.cvs.ssh/src/org/eclipse/team/internal/ccvs/ssh/Cipher.java;2;0;2;1;0;0;0;2;38;1;2;1978;38;38;1;0;0;2;2;1978;0;2963;2;2;
/org.eclipse.jdt.ui/core refactoring/org/eclipse/jdt/internal/core/refactoring/base/RefactoringStatus.java;3;0;8;1;0;0;0;8;109;2;6;408;250;250;2;2;0;8;8;943;2;1939;6;3;
/org.eclipse.jdt.ui/core refactoring/org/eclipse/jdt/internal/corext/refactoring/code/ExceptionAnalyzer.java;1;0;8;1;1;1;1;7;194;1;7;1939;296;296;1;0;0;7;8;1939;0;4422;8;1;
/org.eclipse.team.examples.filesystem/src/org/eclipse/team/examples/filesystem/ui/GetAction.java;1;1;2;1;2;2;2;0;2;0;0;4674;2;2;1;0;0;0;2;4674;0;4727;2;1;
/org.eclipse.help/Eclipse Help/org/eclipse/help/internal/contributors/xml/ContributionParser.java;3;0;4;1;0;0;0;4;7;1;4;135;13;13;1;0;0;4;4;135;0;1420;4;3;
/org.eclipse.ui/Eclipse UI Tool Script/org/eclipse/toolscript/ui/internal/AntRunBuildActionDelegate.java;1;1;3;1;3;3;3;0;31;0;0;4022;31;31;1;0;0;0;3;4022;0;4087;3;1;
/org.eclipse.pde.core/src/org/eclipse/pde/internal/core/ischema/ISchemaComplexType.java;1;0;1;1;0;0;0;1;0;0;1;3591;0;0;1;0;0;1;1;3591;0;3591;1;1;
/org.eclipse.pde.ui/Eclipse PDE UI/org/eclipse/pde/internal/preferences/ExternalPluginsBlock.java;3;0;6;2;0;0;0;6;12;3;4;267;16;16;3;2;0;6;6;324;2;1434;4;3;
/org.eclipse.pde.ui/src/org/eclipse/pde/internal/model/plugin/ExternalPluginModel.java;1;0;2;1;0;0;0;2;0;1;2;3136;0;0;1;0;0;2;2;3136;0;3579;2;1;
/org.eclipse.jdt.ui/ui/org/eclipse/jdt/internal/ui/EditorInputAdapterFactory.java;3;0;4;1;0;0;0;4;27;1;4;15;42;42;1;0;0;4;4;15;0;2481;4;3;
/org.eclipse.pde.ui/src/org/eclipse/pde/internal/ui/editor/schema/GrammarPropertySource.java;1;0;2;1;0;0;0;2;2;1;2;3579;2;2;1;0;0;2;2;3579;0;3591;2;1;
/org.eclipse.debug.ui/ui/org/eclipse/debug/internal/ui/views/variables/VariablesViewer.java;2;2;3;2;3;2;3;0;272;0;0;3975;272;272;2;0;1;0;3;4003;1;4003;2;2;
/org.eclipse.jdt.ui.tests.refactoring/resources/RenamePrivateMethod/test15/out/A.java;1;0;1;1;0;0;0;1;0;0;1;49;0;0;1;0;0;1;1;49;0;49;1;1;
/org.eclipse.core.tests.runtime/src/org/eclipse/core/tests/internal/plugins/SoftPrereqTest_21.java;3;0;3;1;0;0;0;3;212;1;3;1794;222;222;1;0;0;3;3;1794;0;3476;3;3;
/org.eclipse.jdt.core/search/org/eclipse/jdt/internal/core/search/matching/SuperTypeNamesCollector.java;3;2;19;2;5;4;5;14;240;3;12;1679;520;520;3;2;1;14;19;1767;3;4421;16;3;
/org.eclipse.jdt.ui/ui/org/eclipse/jdt/internal/ui/search/JavaSearchPageScoreComputer.java;3;0;6;1;1;1;1;5;9;1;5;15;19;19;1;0;0;5;6;15;0;4627;6;3;
/org.eclipse.team.core/src/org/eclipse/team/core/target/ITargetFactory.java;2;1;2;1;2;2;2;0;2;0;0;4113;2;2;1;0;0;0;2;4113;0;4128;2;2;
/org.eclipse.ui/Eclipse UI/org/eclipse/ui/internal/ShowFastViewContribution.java;5;0;5;1;1;1;1;4;109;1;4;257;130;130;1;0;0;4;5;257;0;3975;5;5;
/org.eclipse.jdt.ui.tests.refactoring/resources/MoveCU/testFail5/in/p/A.java;2;0;2;1;0;0;0;2;0;1;2;49;0;0;1;0;0;2;2;49;0;2769;2;2;
/org.eclipse.jdt.ui/core refactoring/org/eclipse/jdt/internal/core/refactoring/code/flow/FlowInfo.java;1;0;3;1;0;0;0;3;149;1;3;1236;149;149;1;0;0;3;3;1236;0;1939;3;1;
/org.eclipse.jdt.debug.ui/ui/org/eclipse/jdt/internal/debug/ui/actions/ModificationWatchpointToggleAction.java;1;0;2;1;0;0;0;2;21;1;2;1915;21;21;1;0;0;2;2;1915;0;2646;2;1;
/org.eclipse.swt/Eclipse SWT/win32/org/eclipse/swt/internal/win32/PRINTDLG.java;2;0;3;1;0;0;0;3;7;1;3;106;7;7;1;0;0;3;3;106;0;2069;3;2;
/org.eclipse.jdt.ui/ui/org/eclipse/jdt/internal/ui/wizards/buildpaths/ChooseVariableDialog.java;3;0;8;1;0;0;0;8;17;1;8;238;36;36;1;0;0;8;8;238;0;3680;8;3;
/org.eclipse.jdt.debug.ui/ui/org/eclipse/jdt/internal/debug/ui/display/InspectAction.java;2;0;6;2;0;0;0;6;60;3;4;1915;83;83;3;2;0;6;6;2347;2;2813;4;2;
/org.eclipse.team.cvs.core/src/org/eclipse/team/internal/ccvs/core/client/StaticHandler.java;2;0;6;1;0;0;0;6;59;1;6;2572;75;75;1;0;0;6;6;2572;0;3610;6;2;
/org.eclipse.core.resources/src/org/eclipse/core/internal/localstore/IUnifiedTreeVisitor.java;2;0;4;1;1;1;1;3;28;1;3;12;47;47;1;0;0;3;4;12;0;4214;4;2;
/org.eclipse.pde.core/src/org/eclipse/pde/internal/core/feature/VersionableObject.java;1;0;2;1;1;1;1;1;8;0;1;3591;8;8;1;0;0;1;2;3591;0;3994;2;1;
/org.eclipse.team.cvs.core/src/org/eclipse/team/internal/ccvs/core/resources/LocalFolder.java;2;0;12;1;0;0;0;12;31;1;12;2156;110;110;1;0;0;12;12;2156;0;3089;12;2;
/org.eclipse.jdt.ui.tests/ui/org/eclipse/jdt/ui/tests/core/JavaDocTestCase.java;1;0;4;1;0;0;0;4;111;1;4;1189;112;112;1;0;0;4;4;1189;0;1969;4;1;
/org.eclipse.pde.ui/Eclipse PDE UI/org/eclipse/pde/internal/schema/DocumentSection.java;2;0;6;2;0;0;0;6;12;3;4;267;13;13;3;2;0;6;6;324;2;1434;4;2;
/org.eclipse.pde.ui/src/org/eclipse/pde/internal/ui/editor/text/NonRuleBasedDamagerRepairer.java;1;0;1;1;0;0;0;1;0;0;1;3870;0;0;1;0;0;1;1;3870;0;3870;1;1;
/org.eclipse.pde.ui/src/org/eclipse/pde/internal/wizards/extension/NewExtensionWizard.java;2;0;5;1;0;0;0;5;60;2;4;1434;62;62;2;1;0;5;5;3035;1;3579;4;2;
/org.eclipse.pde.ui/Eclipse PDE UI/org/eclipse/pde/internal/base/model/plugin/IPluginBase.java;2;0;5;2;0;0;0;5;18;3;3;267;18;18;3;2;0;5;5;324;2;1434;3;2;
/org.eclipse.help.webapp/src/org/eclipse/help/servlet/Search.java;3;0;13;2;0;0;0;13;148;3;10;2409;621;621;3;3;0;13;13;3402;3;3449;10;3;
/org.eclipse.jdt.debug/jdi/org/eclipse/jdi/internal/jdwp/JdwpFrameID.java;2;0;3;1;0;0;0;3;12;1;3;187;13;13;1;0;0;3;3;187;0;3040;3;2;
/org.eclipse.core.resources/src/org/eclipse/core/internal/indexing/StoreException.java;1;0;1;1;1;1;1;0;0;0;0;4632;0;0;1;0;0;0;1;4632;0;4632;1;1;
/org.eclipse.jdt.ui.tests.refactoring/resources/ExtractMethodWorkSpace/ExtractMethodTests/invalidSelection/A_test130.java;2;1;3;1;2;2;2;1;20;0;1;80;20;20;1;0;0;1;3;80;0;4419;3;2;
/org.eclipse.jdt.core/eval/org/eclipse/jdt/internal/eval/Evaluator.java;2;0;18;1;1;1;1;17;256;4;11;455;333;333;4;6;0;17;18;1039;6;4062;12;2;
/org.eclipse.jdt.ui/ui debug/org/eclipse/jdt/internal/debug/ui/SourceAttachmentWizardPage.java;4;0;14;1;0;0;0;14;327;2;13;154;607;607;2;1;0;14;14;171;1;1916;13;4;
/org.eclipse.jdt.launching/launching/org/eclipse/jdt/launching/AbstractJavaLaunchConfigurationDelegate.java;3;2;28;2;20;15;20;8;89;1;8;3213;704;704;2;0;5;8;28;3956;5;4449;23;3;
/org.eclipse.pde.ui/src/org/eclipse/pde/internal/ui/editor/feature/URLSection.java;1;0;4;1;0;0;0;4;27;2;3;3579;50;50;2;1;0;4;4;3579;1;3793;3;1;
/org.eclipse.jdt.ui/ui debug/org/eclipse/jdt/internal/debug/ui/ModificationWatchpointToggleAction.java;2;0;5;1;0;0;0;5;11;1;5;965;15;15;1;0;0;5;5;965;0;1916;5;2;
/org.eclipse.pde.ui/Eclipse PDE UI/org/eclipse/pde/internal/base/model/plugin/IPluginObject.java;2;0;5;2;0;0;0;5;12;3;3;267;12;12;3;2;0;5;5;324;2;1434;3;2;
/org.eclipse.pde.ui/src/org/eclipse/pde/internal/view/ModelEntryPropertySource.java;1;0;2;1;0;0;0;2;0;1;2;3446;0;0;1;0;0;2;2;3446;0;3579;2;1;
/org.eclipse.jdt.ui/ui refactoring/org/eclipse/jdt/internal/ui/refactoring/nls/ExternalizeWizardPage2.java;3;1;11;1;2;2;2;9;58;2;7;1922;118;118;2;2;0;9;11;1922;2;4631;9;3;
/org.eclipse.pde.ui/src/org/eclipse/pde/internal/core/ischema/ISchemaSimpleType.java;1;0;2;1;0;0;0;2;0;1;2;3591;0;0;1;0;0;2;2;3591;0;3607;2;1;
/org.eclipse.jdt.ui/ui/org/eclipse/jdt/ui/actions/FindImplementorsInWorkingSetAction.java;3;1;3;1;3;3;3;0;18;0;0;4141;22;22;1;0;0;0;3;4141;0;4770;3;3;
/org.eclipse.jdt.ui.tests.refactoring/resources/SelectionAnalyzerWorkSpace/SelectionAnalyzerTests/validSelection/A_test131_.java;2;0;2;1;0;0;0;2;0;1;2;2243;0;0;1;0;0;2;2;2243;0;2327;2;2;
/org.eclipse.help/src/org/eclipse/help/internal/contributions/Insert.java;2;0;2;1;0;0;0;2;0;1;2;1420;0;0;1;0;0;2;2;1420;0;1675;2;2;
/org.eclipse.jdt.ui/core extension/org/eclipse/jdt/internal/corext/codegeneration/CodeGenerationSettings.java;2;0;4;1;0;0;0;4;8;2;3;2016;11;11;2;1;0;4;4;2016;1;2137;3;2;
/org.eclipse.jdt.junit/src/org/eclipse/jdt/junit/wizards/NewTestCaseCreationWizardPage.java;2;0;16;1;0;0;0;16;199;5;5;3247;424;424;5;11;0;16;16;3370;11;3527;5;2;
/org.eclipse.jdt.ui/ui/org/eclipse/jdt/internal/ui/wizards/NewInterfaceCreationWizardPage.java;2;0;19;1;0;0;0;19;127;3;17;15;302;302;3;2;0;19;19;3084;2;3084;17;2;
/org.eclipse.update.ui.forms/src/org/eclipse/update/ui/forms/internal/engine/IImageSegment.java;1;0;1;1;0;0;0;1;0;0;1;2745;0;0;1;0;0;1;1;2745;0;2745;1;1;
/org.eclipse.jdt.junit/src/org/eclipse/jdt/internal/junit/ui/FailureTraceView.java;2;1;5;1;2;2;2;3;54;1;3;3171;82;82;1;0;0;3;5;3171;0;4254;5;2;
/org.eclipse.jdt.ui.tests.refactoring/resources/SelectionAnalyzerWorkSpace/SelectionAnalyzerTests/invalidSelection/A_test043.java;1;0;1;1;0;0;0;1;0;0;1;1368;0;0;1;0;0;1;1;1368;0;1368;1;1;
/org.eclipse.jdt.core/model/org/eclipse/jdt/internal/core/util/SourceFileAttribute.java;2;1;4;1;3;3;3;1;19;0;1;3629;35;35;1;0;0;1;4;3629;0;4422;4;2;
/org.eclipse.jdt.ui.tests.refactoring/resources/RenameNonPrivateField/testFail12/in/A.java;1;0;1;1;0;0;0;1;0;0;1;49;0;0;1;0;0;1;1;49;0;49;1;1;
/org.eclipse.ui/Eclipse UI/org/eclipse/ui/IMemento.java;4;0;5;1;0;0;0;5;18;1;5;257;40;40;1;0;0;5;5;257;0;3871;5;4;
/org.eclipse.jdt.core/search/org/eclipse/jdt/internal/core/index/impl/IIndexConstants.java;3;0;16;1;1;1;1;15;15;4;11;455;61;61;4;4;0;15;16;1039;4;4063;12;3;
/org.eclipse.pde.ui/src/org/eclipse/pde/internal/model/jars/JarsObject.java;2;0;2;1;0;0;0;2;0;1;2;1434;0;0;1;0;0;2;2;1434;0;2650;2;2;
/org.eclipse.jdt.debug/jdi/org/eclipse/jdi/internal/request/WatchpointRequestImpl.java;3;0;4;1;0;0;0;4;12;1;4;187;25;25;1;0;0;4;4;187;0;3040;4;3;
/org.eclipse.ui/Eclipse UI/org/eclipse/ui/part/ISetSelectionTarget.java;2;0;2;1;0;0;0;2;5;1;2;257;5;5;1;0;0;2;2;257;0;457;2;2;
/org.eclipse.jdt.ui/nls/org/eclipse/jdt/internal/ui/nls/search/NLSSearchOperation.java;1;0;2;1;0;0;0;2;0;1;2;1880;0;0;1;0;0;2;2;1880;0;1913;2;1;
/org.eclipse.jdt.core/model/org/eclipse/jdt/internal/core/builder/StateSpecificException.java;1;0;4;1;0;0;0;4;22;1;4;455;28;28;1;0;0;4;4;455;0;2808;4;1;
/org.eclipse.jdt.ui.tests.refactoring/resources/ExtractMethodWorkSpace/ExtractMethodTests/T7368.java;1;1;3;1;2;2;2;1;0;0;1;3168;0;0;1;0;0;1;3;3168;0;4419;3;1;
/org.eclipse.pde.ui/src/org/eclipse/pde/internal/ui/editor/ModelDataTransfer.java;1;0;2;1;1;1;1;1;3;0;1;3583;3;3;1;0;0;1;2;3583;0;4552;2;1;
/org.eclipse.jdt.ui/ui refactoring/org/eclipse/jdt/internal/ui/refactoring/nls/ExternalizeWizardPage.java;2;1;15;1;3;3;3;12;63;2;9;1922;173;173;2;3;0;12;15;1922;3;4631;12;2;
/org.eclipse.help.ui/src/org/eclipse/help/internal/ui/ICommandStateChangedListener.java;2;0;2;1;0;0;0;2;0;1;2;2740;0;0;1;0;0;2;2;2740;0;3053;2;2;
/org.eclipse.jdt.core/model/org/eclipse/jdt/internal/core/NameLookup.java;3;1;26;1;5;5;5;21;473;4;17;455;1232;1232;4;4;0;21;26;1039;4;4320;22;3;
/org.eclipse.jdt.launching/launching/org/eclipse/jdt/launching/IVMInstall.java;2;1;10;1;7;7;7;3;21;1;3;2022;110;110;1;0;0;3;10;2022;0;4650;10;2;
/org.eclipse.scripting/src/org/eclipse/scripting/internal/uirenderer/XGRElementUISwtTextFieldHidden.java;1;0;1;1;0;0;0;1;0;0;1;1424;0;0;1;0;0;1;1;1424;0;1424;1;1;
/org.eclipse.update.ui/src/org/eclipse/update/internal/ui/manager/MainPage.java;1;0;6;1;0;0;0;6;5;1;6;1428;13;13;1;0;0;6;6;1428;0;3537;6;1;
/org.eclipse.swt/Eclipse SWT/motif/org/eclipse/swt/widgets/SelectableItemWidget.java;4;0;7;2;0;0;0;7;48;2;6;106;106;106;2;1;0;7;7;1023;1;1023;6;4;
/org.eclipse.scripting.examples/Eclipse Scripting Examples/org/eclipse/scripting/examples/ExcaliburWorkbenchNewWizardAdapterScriptEventHandler.java;2;0;4;1;0;0;0;4;5;1;4;134;9;9;1;0;0;4;4;134;0;1424;4;2;
/org.eclipse.help/src/org/eclipse/help/internal/protocols/LinksURLHandler.java;1;0;2;1;0;0;0;2;0;1;2;2694;0;0;1;0;0;2;2;2694;0;2773;2;1;
/org.eclipse.pde.ui/src/org/eclipse/pde/internal/editor/text/PDEWhitespaceDetector.java;2;0;2;1;0;0;0;2;0;1;2;1434;0;0;1;0;0;2;2;1434;0;3579;2;2;
/org.eclipse.team.ui/src/org/eclipse/team/ui/sync/SyncCompareInput.java;3;1;21;2;4;4;4;17;43;2;14;2233;227;227;2;3;0;17;21;2271;3;4005;18;3;
/org.eclipse.swt.tests/JUnit Tests/org/eclipse/swt/tests/junit/Test_org_eclipse_swt_custom_StyleRange.java;2;0;2;1;1;1;1;1;6;0;1;1792;6;6;1;0;0;1;2;1792;0;4706;2;2;
/org.eclipse.swt/Eclipse SWT Program/gtk1x/org/eclipse/swt/program/Program.java;2;0;2;1;1;1;1;1;6;0;1;2107;6;6;1;0;0;1;2;2107;0;4701;2;2;
/org.eclipse.update.core/src/org/eclipse/update/examples/buildzip/BuildZipPluginParser.java;1;0;1;1;0;0;0;1;0;0;1;2472;0;0;1;0;0;1;1;2472;0;2472;1;1;
/org.eclipse.update.ui/src/org/eclipse/update/internal/ui/model/IUpdateModelChangedListener.java;1;0;2;1;0;0;0;2;4;1;2;2797;4;4;1;0;0;2;2;2797;0;3517;2;1;
/org.eclipse.jdt.core/compiler/org/eclipse/jdt/internal/compiler/ast/ImportReference.java;2;2;15;1;4;3;4;11;72;5;7;455;141;141;5;4;1;11;15;1037;5;4419;10;2;
/org.eclipse.team.cvs.core/src/org/eclipse/team/internal/ccvs/core/requests/ValidRequestHandler.java;3;0;3;1;0;0;0;3;4;1;3;1978;4;4;1;0;0;3;3;1978;0;2607;3;3;
/org.eclipse.jdt.ui/ui/org/eclipse/jdt/internal/ui/packageview/BinaryProjectFilter.java;2;0;3;1;0;0;0;3;25;2;2;1368;25;25;2;1;0;3;3;1368;1;3657;2;2;
/org.eclipse.ui/Eclipse JFace Text/org/eclipse/jface/text/IRegion.java;3;0;3;1;0;0;0;3;5;1;3;257;6;6;1;0;0;3;3;257;0;1066;3;3;
/org.eclipse.team.ftp/src/org/eclipse/team/internal/ftp/client/PortDataConnection.java;1;1;2;1;2;2;2;0;104;0;0;4535;104;104;1;0;0;0;2;4535;0;4573;2;1;
/org.eclipse.jdt.ui/ui/org/eclipse/jdt/internal/ui/reorg/PackageFragmentRootNamingPolicy.java;3;0;4;1;0;0;0;4;7;1;4;15;12;12;1;0;0;4;4;15;0;1258;4;3;
/org.eclipse.webdav/src/kernel/org/eclipse/webdav/internal/kernel/ContextFactory.java;2;0;4;1;1;1;1;3;70;1;3;1635;121;121;1;0;0;3;4;1635;0;4211;4;2;
/org.eclipse.jdt.ui.tests.refactoring/resources/RenameType/test21/in/A.java;1;0;1;1;0;0;0;1;0;0;1;49;0;0;1;0;0;1;1;49;0;49;1;1;
/org.eclipse.swt/Eclipse SWT/win32/org/eclipse/swt/graphics/Image.java;9;1;24;2;4;4;4;20;160;2;18;106;586;586;2;2;0;20;24;2627;2;4701;22;9;
/org.eclipse.ui/Eclipse UI/org/eclipse/ui/internal/DecoratorActionFactory.java;2;0;3;1;0;0;0;3;29;1;3;2029;29;29;1;0;0;3;3;2029;0;3505;3;2;
/org.eclipse.jdt.ui.tests.refactoring/resources/ReorgTests/A.java;1;0;1;1;0;0;0;1;0;0;1;1301;0;0;1;0;0;1;1;1301;0;1301;1;1;
/org.eclipse.ui/Eclipse UI/org/eclipse/ui/internal/dialogs/WelcomeItem.java;3;0;3;1;0;0;0;3;38;1;3;457;42;42;1;0;0;3;3;457;0;3589;3;3;
/org.eclipse.core.tests.resources/src/org/eclipse/core/tests/internal/localstore/CopyTest.java;3;0;3;1;1;1;1;2;268;1;2;1794;284;284;1;0;0;2;3;1794;0;4516;3;3;
/org.eclipse.jdt.ui/ui/org/eclipse/jdt/internal/ui/wizards/buildpaths/CPVariableElementLabelProvider.java;2;0;8;1;0;0;0;8;14;1;8;159;56;56;1;0;0;8;8;159;0;1668;8;2;
/org.eclipse.jdt.core/eval/org/eclipse/jdt/internal/eval/EvaluationContext.java;3;2;23;2;4;3;4;19;1881;4;12;455;2895;2895;4;7;1;19;23;1039;8;4062;15;3;
/org.eclipse.core.tests.resources/src/org/eclipse/core/tests/resources/IWorkspaceTest.java;3;1;15;2;3;3;3;12;1930;2;11;1794;2414;2414;2;1;0;12;15;3251;1;4772;14;3;
/org.eclipse.pde.ui/src/org/eclipse/pde/internal/editor/SystemFileDocumentProvider.java;2;0;2;1;0;0;0;2;0;1;2;1434;0;0;1;0;0;2;2;1434;0;3579;2;2;
/org.eclipse.jdt.debug/eval/org/eclipse/jdt/internal/debug/eval/ast/instructions/AssignmentOperator.java;3;0;7;1;1;1;1;6;14;1;6;3421;32;32;1;0;0;6;7;3421;0;3955;7;3;
/org.eclipse.jdt.ui.tests.refactoring/test cases/org/eclipse/jdt/ui/tests/refactoring/RenameVirtualMethodInClassTests.java;2;0;6;1;1;1;1;5;8;1;5;1896;27;27;1;0;0;5;6;1896;0;4466;6;2;
/org.eclipse.swt/Eclipse SWT/win32/org/eclipse/swt/internal/win32/SHELLEXECUTEINFO.java;2;0;3;1;0;0;0;3;33;1;3;1507;33;33;1;0;0;3;3;1507;0;2069;3;2;
/org.eclipse.team.tests.core/src/org/eclipse/team/tests/core/AllTeamTests.java;2;1;5;1;4;4;4;1;15;0;1;3306;20;20;1;0;0;1;5;3306;0;4545;5;2;
/org.eclipse.jdt.ui/ui debug/org/eclipse/jdt/internal/debug/ui/display/DisplayMessages.java;2;0;2;1;0;0;0;2;0;1;2;761;0;0;1;0;0;2;2;761;0;1916;2;2;
/org.eclipse.jdt.ui.tests.refactoring/resources/RenameMethodInInterface/testFail29/in/A.java;1;0;1;1;0;0;0;1;0;0;1;49;0;0;1;0;0;1;1;49;0;49;1;1;
/org.eclipse.pde.ui/src/org/eclipse/pde/internal/ui/wizards/templates/PreprocessorParser.java;1;0;3;1;1;1;1;2;14;1;2;3579;16;16;1;0;0;2;3;3579;0;3902;3;1;
/org.eclipse.core.tests.runtime/src/org/eclipse/core/tests/internal/plugins/SoftPrereqTest_20.java;3;0;3;1;0;0;0;3;184;1;3;1794;194;194;1;0;0;3;3;1794;0;3476;3;3;
/org.eclipse.webdav/src/client/org/eclipse/webdav/internal/authentication/BasicAuthority.java;3;0;5;1;1;1;1;4;238;1;4;12;445;445;1;0;0;4;5;12;0;4211;5;3;
/org.eclipse.pde.ui/src/org/eclipse/pde/internal/builders/DependencyLoopFinder.java;1;0;4;1;0;0;0;4;35;1;4;2477;37;37;1;0;0;4;4;2477;0;3579;4;1;
/org.eclipse.help.ui/src/org/eclipse/help/ui/internal/DefaultHelp.java;1;1;2;1;2;2;2;0;11;0;0;4439;11;11;1;0;0;0;2;4439;0;4452;2;1;
/org.eclipse.ui/Eclipse UI/org/eclipse/ui/internal/model/ResourceFactory.java;2;0;2;1;0;0;0;2;9;1;2;257;9;9;1;0;0;2;2;257;0;457;2;2;
/org.eclipse.jdt.ui/ui/org/eclipse/jdt/internal/ui/search/SearchViewActionGroup.java;1;0;1;1;1;1;1;0;0;0;0;4165;0;0;1;0;0;0;1;4165;0;4165;1;1;
/org.eclipse.jdt.ui.tests.refactoring/resources/MultiMove/test2/out/p1/B.java;1;0;2;1;0;0;0;2;2;1;2;1157;2;2;1;0;0;2;2;1157;0;2212;2;1;
/org.eclipse.ui.examples.multipageeditor/Eclipse UI Examples MultiPageEditor/org/eclipse/ui/examples/multipageeditor/MultiPageEditorExample.java;1;0;3;1;0;0;0;3;24;0;1;928;24;24;3;2;0;3;3;928;2;928;1;1;
/org.eclipse.update.ui/src/org/eclipse/update/internal/ui/manager/SnapshotForm.java;1;0;9;1;0;0;0;9;24;2;8;2107;60;60;2;1;0;9;9;2172;1;2827;8;1;
/org.eclipse.jdt.core/compiler/org/eclipse/jdt/internal/compiler/ast/AbstractMethodDeclaration.java;3;1;29;1;3;3;3;26;581;4;19;455;1615;1615;4;7;0;26;29;1039;7;4282;22;3;
/org.eclipse.pde.core/src/org/eclipse/pde/internal/core/plugin/PluginElement.java;1;0;3;1;0;0;0;3;372;1;3;3591;374;374;1;0;0;3;3;3591;0;3687;3;1;
/org.eclipse.jdt.ui/ui/org/eclipse/jdt/internal/ui/actions/AddGetterSetterAction.java;5;0;21;2;1;1;1;20;152;2;19;15;471;471;2;1;0;20;21;740;1;3968;20;5;
/org.eclipse.jdt.ui.tests/nls/org/eclipse/jdt/ui/nls/tests/AllTests.java;1;0;2;1;0;0;0;2;0;1;2;1754;0;0;1;0;0;2;2;1754;0;1939;2;1;
/org.eclipse.scripting/src/org/eclipse/scripting/internal/views/ScriptUIEditorAnnotationHover.java;1;0;1;1;0;0;0;1;0;0;1;1424;0;0;1;0;0;1;1;1424;0;1424;1;1;
/org.eclipse.jdt.ui/ui/org/eclipse/jdt/internal/ui/snippeteditor/JavaSnippetCompletionProcessor.java;6;0;11;2;0;0;0;11;24;2;10;15;72;72;2;1;0;11;11;1632;1;1916;10;6;
/org.eclipse.ui/Eclipse JFace/org/eclipse/jface/viewers/IContentProvider.java;3;0;3;1;0;0;0;3;10;1;3;257;15;15;1;0;0;3;3;257;0;2914;3;3;
/org.eclipse.swt/Eclipse SWT PI/gtk/org/eclipse/swt/internal/gtk/GdkVisual.java;2;0;5;1;2;1;2;3;7;1;3;2107;18;18;2;0;1;3;5;4701;1;4701;4;2;
/org.eclipse.jdt.ui/core refactoring/org/eclipse/jdt/internal/corext/refactoring/code/ExpressionAnalyzer.java;1;0;2;1;0;0;0;2;0;1;2;1939;0;0;1;0;0;2;2;1939;0;2327;2;1;
/org.eclipse.swt/Eclipse SWT/photon/org/eclipse/swt/widgets/Sash.java;6;1;13;1;5;5;5;8;87;2;7;106;235;235;2;1;0;8;13;2064;1;4701;12;6;
/org.eclipse.jdt.ui.tests.refactoring/resources/ExtractMethodWorkSpace/ExtractMethodTests/return_in/A_test716.java;1;1;3;1;2;2;2;1;20;0;1;1236;20;20;1;0;0;1;3;1236;0;4419;3;1;
/org.eclipse.team.ui/src/org/eclipse/team/internal/ui/TextPreferencePage.java;3;2;11;1;4;3;4;7;4;1;7;2797;20;20;2;0;1;7;11;4123;1;4455;10;3;
/org.eclipse.swt/Eclipse SWT/common_j2se/org/eclipse/swt/internal/SerializableCompatability.java;1;0;1;1;0;0;0;1;0;0;1;1378;0;0;1;0;0;1;1;1378;0;1378;1;1;
/org.eclipse.jdt.ui/ui debug/org/eclipse/jdt/internal/debug/ui/display/IDataDisplay.java;3;0;6;1;0;0;0;6;14;2;5;345;26;26;2;1;0;6;6;345;1;1916;5;3;
/org.eclipse.update.ui/src/org/eclipse/update/internal/ui/views/WebBrowserView.java;1;0;4;1;1;1;1;3;30;1;3;3572;39;39;1;0;0;3;4;3572;0;4127;4;1;
/org.eclipse.pde.build/src/org/eclipse/pde/internal/build/FileSet.java;1;0;3;1;0;0;0;3;64;1;3;2901;64;64;1;0;0;3;3;2901;0;3128;3;1;
/org.eclipse.jdt.ui.tests.refactoring/resources/MultiMove/test0/out/p2/B.java;1;0;3;1;0;0;0;3;3;1;3;1157;5;5;1;0;0;3;3;1157;0;2682;3;1;
/org.eclipse.team.tests.core/src/org/eclipse/team/tests/core/RepositoryProviderTests.java;2;1;9;1;2;2;2;7;298;4;4;3271;371;371;4;3;0;7;9;3271;3;4545;6;2;
/org.eclipse.ant.core/src/plugin/org/eclipse/ant/internal/core/Policy.java;1;0;1;1;0;0;0;1;0;0;1;3475;0;0;1;0;0;1;1;3475;0;3475;1;1;
/org.eclipse.vcm.ui.cvs/src/org/eclipse/vcm/internal/ui/ccvs/RemoteModule.java;1;0;2;1;0;0;0;2;109;1;2;1424;109;109;1;0;0;2;2;1424;0;1436;2;1;
/org.eclipse.scripting/src/org/eclipse/scripting/internal/IXGRElementUISizable.java;1;0;1;1;0;0;0;1;0;0;1;1424;0;0;1;0;0;1;1;1424;0;1424;1;1;
/org.eclipse.core.tests.resources/src/org/eclipse/core/tests/internal/watson/AllTests.java;3;0;3;1;1;1;1;2;64;1;2;1794;74;74;1;0;0;2;3;1794;0;4516;3;3;
/org.eclipse.jdt.debug/eval/org/eclipse/jdt/internal/debug/eval/ast/instructions/XorAssignmentOperator.java;2;0;5;1;1;1;1;4;4;1;4;3421;10;10;1;0;0;4;5;3421;0;3955;5;2;
/org.eclipse.jdt.ui/ui/org/eclipse/jdt/internal/ui/typehierarchy/MethodsViewer.java;7;2;56;2;11;10;11;45;113;3;36;15;1298;1298;3;9;1;45;56;236;10;4621;46;7;
/org.eclipse.swt/Eclipse SWT OLE Win32/win32/org/eclipse/swt/internal/ole/win32/FUNCDESC2.java;2;0;3;1;0;0;0;3;6;1;3;106;6;6;1;0;0;3;3;106;0;2069;3;2;
/org.eclipse.jdt.debug/eval/org/eclipse/jdt/internal/debug/eval/ast/engine/ASTInstructionCompiler.java;2;2;20;2;7;6;7;13;305;3;10;3421;732;732;3;3;1;13;20;3811;4;4568;16;2;
/org.eclipse.jdt.debug.ui/ui/org/eclipse/jdt/internal/debug/ui/actions/MoveDownAction.java;1;1;3;1;2;2;2;1;2;0;1;3875;3;3;1;0;0;1;3;3875;0;4423;3;1;
/org.eclipse.team.cvs.core/src/org/eclipse/team/internal/ccvs/core/client/NullCopyHandler.java;2;0;2;1;0;0;0;2;0;1;2;2828;0;0;1;0;0;2;2;2828;0;3452;2;2;
/org.eclipse.jdt.core/search/org/eclipse/jdt/internal/core/index/IIndexer.java;2;0;4;1;1;1;1;3;15;1;3;455;28;28;1;0;0;3;4;455;0;4063;4;2;
/org.eclipse.core.tests.resources/src/org/eclipse/core/tests/resources/regression/PR_1GEAB3C_Test.java;3;0;6;1;1;1;1;5;166;2;4;1794;192;192;2;1;0;5;6;3415;1;4516;5;3;
/org.eclipse.swt/Eclipse SWT/motif/org/eclipse/swt/internal/motif/XCrossingEvent.java;2;0;3;1;0;0;0;3;4;1;3;106;4;4;1;0;0;3;3;106;0;2069;3;2;
/org.eclipse.jdt.ui.tests.refactoring/resources/SurroundWithWorkSpace/SurroundWithTests/trycatch_in/TestWrappedLocal6.java;1;0;1;1;0;0;0;1;0;0;1;3870;0;0;1;0;0;1;1;3870;0;3870;1;1;
/org.eclipse.pde.ui/src/org/eclipse/pde/internal/model/plugin/PluginParent.java;1;0;2;1;0;0;0;2;0;1;2;3136;0;0;1;0;0;2;2;3136;0;3579;2;1;
/org.eclipse.update/Eclipse Update/org/eclipse/update/internal/ui/JarVerifier.java;2;0;5;1;0;0;0;5;585;1;5;108;602;602;1;0;0;5;5;108;0;1424;5;2;
/org.eclipse.team.cvs.ui/src/org/eclipse/team/internal/ccvs/ui/actions/AutoDefineTagsAction.java;3;0;11;2;0;0;0;11;61;4;8;1997;174;174;4;3;0;11;11;2049;3;3577;8;3;
/org.eclipse.jdt.ui.tests/JUnit/junit/tests/ExceptionTestCaseTest.java;2;0;2;1;0;0;0;2;0;1;2;49;0;0;1;0;0;2;2;49;0;1186;2;2;
/org.eclipse.jdt.ui.tests.refactoring/resources/MoveMembers/test11/out/B.java;1;0;1;1;0;0;0;1;0;0;1;2738;0;0;1;0;0;1;1;2738;0;2738;1;1;
/org.eclipse.jdt.ui/ui/org/eclipse/jdt/internal/ui/javaeditor/structureselection/StructureSelectionAction.java;2;1;11;2;4;4;4;7;16;2;6;3188;67;67;2;1;0;7;11;3188;1;4621;10;2;
/org.eclipse.help.ui/src/org/eclipse/help/internal/ui/util/TString.java;2;0;4;1;1;1;1;3;96;1;3;1420;98;98;1;0;0;3;4;1420;0;4439;4;2;
/org.eclipse.scripting/src/org/eclipse/scripting/internal/uirenderer/XGRXmlParser.java;1;0;1;1;0;0;0;1;0;0;1;1424;0;0;1;0;0;1;1;1424;0;1424;1;1;
/org.eclipse.swt.examples/Eclipse SWT Examples/common/org/eclipse/swt/examples/controlexample/ListTab.java;1;0;2;1;0;0;0;2;0;1;2;107;0;0;1;0;0;2;2;107;0;611;2;1;
/org.eclipse.jdt.ui.tests.refactoring/resources/ExtractMethodWorkSpace/ExtractMethodTests/locals_in/A_test563.java;1;1;3;1;2;2;2;1;26;0;1;1236;26;26;1;0;0;1;3;1236;0;4419;3;1;
/org.eclipse.jdt.ui/core refactoring/org/eclipse/jdt/internal/core/refactoring/nls/changes/DeleteFileChange.java;2;0;3;1;0;0;0;3;4;2;2;1922;4;4;2;1;0;3;3;1922;1;1939;2;2;
/org.eclipse.jdt.debug.ui/ui/org/eclipse/jdt/internal/debug/ui/actions/OpenOnDeclaringTypeAction.java;1;0;1;1;0;0;0;1;0;0;1;2384;0;0;1;0;0;1;1;2384;0;2384;1;1;
/org.eclipse.swt.examples.paint/src/org/eclipse/swt/examples/paint/PolyLineTool.java;4;0;6;2;1;1;1;5;93;3;3;513;103;103;3;2;0;5;6;609;2;4705;4;4;
/org.eclipse.swt/Eclipse SWT Custom Widgets/common/org/eclipse/swt/custom/ScrolledComposite.java;3;2;15;1;4;3;4;11;168;2;10;106;760;760;2;1;1;11;15;2876;2;4701;13;3;
/org.eclipse.vcm.ui/src/org/eclipse/vcm/internal/ui/VCMEditionSelectionDialog.java;5;0;16;3;0;0;0;16;651;3;11;1;986;986;3;5;0;16;16;295;5;1288;11;5;
/org.eclipse.jdt.ui.tests.refactoring/resources/RenameType/testFail00/in/A.java;1;0;1;1;0;0;0;1;0;0;1;49;0;0;1;0;0;1;1;49;0;49;1;1;
/org.eclipse.team.cvs.ui/src/org/eclipse/team/internal/ccvs/ui/IPromptCondition.java;1;0;2;1;1;1;1;1;0;0;1;3760;0;0;1;0;0;1;2;3760;0;4256;2;1;
/org.eclipse.jdt.core/model/org/eclipse/jdt/core/ClasspathVariableInitializer.java;1;0;4;1;0;0;0;4;17;1;4;3026;38;38;1;0;0;4;4;3026;0;3877;4;1;
/org.eclipse.jdt.debug/jdi interfaces/com/sun/jdi/event/ClassPrepareEvent.java;2;0;2;1;0;0;0;2;11;1;2;2704;11;11;1;0;0;2;2;2704;0;3040;2;2;
/org.eclipse.pde.ui/src/org/eclipse/pde/internal/editor/PDEFormPage.java;2;0;8;1;0;0;0;8;10;1;8;1434;39;39;1;0;0;8;8;1434;0;3579;8;2;
/org.eclipse.pde.ui/Eclipse PDE UI/org/eclipse/pde/internal/base/model/plugin/IPluginParent.java;2;0;5;2;0;0;0;5;12;3;3;267;12;12;3;2;0;5;5;324;2;1434;3;2;
/org.eclipse.team.ui/src/org/eclipse/team/ui/ISharedImages.java;3;2;6;2;3;2;3;3;42;1;3;1978;56;56;2;0;1;3;6;4632;1;4632;5;3;
/org.eclipse.team.ui/src/org/eclipse/team/internal/ui/target/MappingSelectionPage.java;4;4;18;2;18;11;18;0;144;0;0;4164;326;326;4;0;7;0;18;4164;7;4636;11;4;
/org.eclipse.swt.tests/JUnit Tests/org/eclipse/swt/tests/junit/Test_org_eclipse_swt_events_MouseTrackListener.java;2;0;2;1;1;1;1;1;6;0;1;1792;6;6;1;0;0;1;2;1792;0;4706;2;2;
/org.eclipse.jdt.launching.j9/j9/org/eclipse/jdt/internal/launching/j9/J9VMInstallType.java;2;1;4;1;2;2;2;2;9;1;2;3314;17;17;1;0;0;2;4;3314;0;4347;4;2;
/org.eclipse.pde.core/src/org/eclipse/pde/internal/core/PluginProject.java;1;0;2;1;0;0;0;2;0;1;2;3591;0;0;1;0;0;2;2;3591;0;3631;2;1;
/org.eclipse.scripting.tests/Eclipse Scripting Tests/org/eclipse/scripting/tests/ScriptTestToolkit.java;2;0;2;1;0;0;0;2;0;1;2;1186;0;0;1;0;0;2;2;1186;0;1862;2;2;
/org.eclipse.jdt.ui.tests.refactoring/resources/PullUp/test0/out/A.java;1;0;1;1;0;0;0;1;0;0;1;2406;0;0;1;0;0;1;1;2406;0;2406;1;1;
/org.eclipse.ui/Eclipse UI/org/eclipse/ui/internal/WorkbenchEditorsAction.java;3;1;6;1;2;2;2;4;17;2;3;1745;33;33;2;1;0;4;6;3212;1;4608;5;3;
/org.eclipse.help/src/org/eclipse/help/internal/search/SearchResultCollector.java;1;0;2;1;2;1;2;0;0;0;0;4000;0;0;2;0;1;0;2;4000;1;4000;1;1;
/org.eclipse.pde.ui/src/org/eclipse/pde/internal/wizards/project/PluginSelectionDialog.java;2;0;6;1;0;0;0;6;186;2;5;1434;189;189;2;1;0;6;6;3035;1;3579;5;2;
/org.eclipse.jdt.core/model/org/eclipse/jdt/core/jdom/IDOMMethod.java;2;0;6;1;2;1;2;4;318;1;4;455;354;354;2;0;1;4;6;4058;1;4058;5;2;
/org.eclipse.jdt.ui.tests.refactoring/resources/RenameNonPrivateField/test13/in/A.java;1;0;1;1;0;0;0;1;0;0;1;951;0;0;1;0;0;1;1;951;0;951;1;1;
/org.eclipse.jdt.ui/ui/org/eclipse/jdt/internal/ui/text/javadoc/HTMLPageBuffer.java;1;0;2;1;0;0;0;2;0;1;2;15;0;0;1;0;0;2;2;15;0;28;2;1;
/org.eclipse.jdt.ui.tests.refactoring/resources/SelectionAnalyzerWorkSpace/SelectionAnalyzerTests/validSelection/A_test254.java;1;0;1;1;0;0;0;1;0;0;1;1368;0;0;1;0;0;1;1;1368;0;1368;1;1;
/org.eclipse.update/src/org/eclipse/update/internal/ui/UMApplication.java;1;0;1;1;0;0;0;1;0;0;1;1424;0;0;1;0;0;1;1;1424;0;1424;1;1;
/org.eclipse.ui/Eclipse UI/org/eclipse/ui/internal/PartPlaceholder.java;2;0;2;1;0;0;0;2;5;1;2;257;5;5;1;0;0;2;2;257;0;457;2;2;
/org.eclipse.help.ui/src/org/eclipse/help/internal/ui/util/WorkbenchResources.java;2;0;5;1;1;1;1;4;80;1;4;1420;104;104;1;0;0;4;5;1420;0;4439;5;2;
/org.eclipse.jdt.ui/core refactoring/org/eclipse/jdt/internal/corext/refactoring/rename/RefactoringScopeFactory.java;2;0;5;1;0;0;0;5;37;1;5;1939;52;52;1;0;0;5;5;1939;0;3203;5;2;
/org.eclipse.scripting/Eclipse Scripting/org/eclipse/scripting/internal/IXGRElementUIChecked.java;1;0;3;1;0;0;0;3;4;1;3;133;4;4;1;0;0;3;3;133;0;1424;3;1;
/org.eclipse.jdt.ui/ui debug/org/eclipse/jdt/internal/debug/ui/ToggleStepFilterAction.java;2;0;2;1;0;0;0;2;0;1;2;1192;0;0;1;0;0;2;2;1192;0;1916;2;2;
/org.eclipse.update.ui/src/org/eclipse/update/internal/ui/forms/UpdateForm.java;1;0;2;1;0;0;0;2;0;1;2;3662;0;0;1;0;0;2;2;3662;0;3768;2;1;
/org.eclipse.ui/Eclipse UI/org/eclipse/ui/internal/PageLayout.java;4;3;14;2;5;3;5;9;187;1;9;257;429;429;3;0;2;9;14;4446;2;4446;12;4;
/org.eclipse.core.tests.runtime/src/org/eclipse/core/tests/internal/plugins/PluginResolveTest_29.java;3;0;3;1;0;0;0;3;110;1;3;1794;120;120;1;0;0;3;3;1794;0;3476;3;3;
/org.eclipse.pde.ui/src/org/eclipse/pde/internal/wizards/StatusWizardPage.java;1;0;2;1;0;0;0;2;0;1;2;2522;0;0;1;0;0;2;2;2522;0;3579;2;1;
/org.eclipse.update.tests.core/src/org/eclipse/update/tests/regularInstall/TestInstallURLSIteXML.java;1;1;22;1;6;6;6;16;213;2;14;2667;378;378;2;2;0;16;22;3025;2;4380;20;1;
/org.eclipse.jdt.ui.tests.refactoring/resources/ExtractMethodWorkSpace/ExtractMethodTests/validSelection/A_test254.java;2;1;3;1;2;2;2;1;4;0;1;195;4;4;1;0;0;1;3;195;0;4419;3;2;
/org.eclipse.ant.core/src/org/eclipse/ant/internal/core/old/CreateProject.java;1;0;1;1;0;0;0;1;0;0;1;3270;0;0;1;0;0;1;1;3270;0;3270;1;1;
/org.eclipse.jdt.ui.tests.refactoring/resources/ExtractMethodWorkSpace/ExtractMethodTests/try_in/A_test457.java;2;1;3;1;2;2;2;1;8;0;1;511;8;8;1;0;0;1;3;511;0;4419;3;2;
/org.eclipse.jdt.debug.ui/ui/org/eclipse/jdt/internal/debug/ui/JDIContentAssistPreference.java;3;0;5;1;0;0;0;5;51;2;4;1933;75;75;2;1;0;5;5;1933;1;3634;4;3;
/org.eclipse.ui/Eclipse UI Standard Components/org/eclipse/ui/views/tasklist/TaskListTestStub.java;2;0;2;1;0;0;0;2;0;1;2;1034;0;0;1;0;0;2;2;1034;0;1302;2;2;
/org.eclipse.jdt.ui.tests.refactoring/resources/RenameMethodInInterface/testFail13/in/A.java;1;0;1;1;0;0;0;1;0;0;1;49;0;0;1;0;0;1;1;49;0;49;1;1;
/org.eclipse.ui/Eclipse UI/org/eclipse/ui/WorkbenchException.java;2;0;2;1;0;0;0;2;5;1;2;257;5;5;1;0;0;2;2;257;0;457;2;2;
/org.eclipse.swt/Eclipse SWT/motif/org/eclipse/swt/widgets/Shell.java;10;1;31;1;9;9;9;22;667;2;21;106;1853;1853;2;1;0;22;31;894;1;4701;30;10;
/org.eclipse.pde.ui/src/org/eclipse/pde/internal/editor/ModifiedTextCellEditor.java;2;0;3;1;0;0;0;3;1;1;3;1434;1;1;1;0;0;3;3;1434;0;2998;3;2;
/org.eclipse.jdt.ui.tests.refactoring/resources/RenameVariables/canRename/A_test4_out.java;1;0;2;1;0;0;0;2;0;1;2;724;0;0;1;0;0;2;2;724;0;1665;2;1;
/org.eclipse.jdt.ui/core refactoring/org/eclipse/jdt/internal/core/refactoring/Resources.java;2;0;3;1;0;0;0;3;5;1;3;15;5;5;1;0;0;3;3;15;0;716;3;2;
/org.eclipse.jdt.ui/ui/org/eclipse/jdt/internal/ui/javaeditor/CompilationUnitAnnotationModelEvent.java;2;0;3;1;1;1;1;2;15;1;2;3627;17;17;1;0;0;2;3;3627;0;4138;3;2;
/org.eclipse.jdt.ui/ui/org/eclipse/jdt/internal/ui/actions/AbstractOpenJavaElementAction.java;4;1;5;1;2;2;2;3;18;1;3;1787;32;32;1;0;0;3;5;1787;0;4430;5;4;
/org.eclipse.jdt.core/compiler/org/eclipse/jdt/internal/compiler/ast/EmptyStatement.java;2;0;5;1;1;1;1;4;16;1;4;1291;37;37;1;0;0;4;5;1291;0;4062;5;2;
/org.eclipse.debug.ui/ui/org/eclipse/debug/internal/ui/DebugPerspectiveFactory.java;2;0;10;1;1;1;1;9;4;2;8;1795;16;16;2;1;0;9;10;2346;1;4083;9;2;
/org.eclipse.swt/Eclipse SWT/motif/org/eclipse/swt/widgets/FontDialog.java;8;1;21;1;4;4;4;17;1270;2;15;106;2058;2058;2;2;0;17;21;957;2;4701;19;8;
/org.eclipse.ui.tests/Eclipse UI Tests/RunSessionRestoreTest.java;1;0;2;1;0;0;0;2;0;1;2;1066;0;0;1;0;0;2;2;1066;0;1407;2;1;
/org.eclipse.jdt.core/compiler/org/eclipse/jdt/internal/compiler/parser/RecoveredBlock.java;2;0;13;1;1;1;1;12;515;4;9;455;649;649;4;3;0;12;13;1039;3;4062;10;2;
/org.eclipse.swt/Eclipse SWT/photon/org/eclipse/swt/internal/photon/PhCursorInfo_t.java;2;0;3;1;0;0;0;3;6;1;3;106;6;6;1;0;0;3;3;106;0;2069;3;2;
/org.eclipse.jdt.ui.tests.refactoring/resources/MoveMembers/test21/in/A.java;1;0;1;1;0;0;0;1;0;0;1;2738;0;0;1;0;0;1;1;2738;0;2738;1;1;
/org.eclipse.swt/Eclipse SWT/emulated/treetable/org/eclipse/swt/widgets/TreeRoots.java;4;1;4;1;2;2;2;2;6;1;2;1028;11;11;1;0;0;2;4;1028;0;4701;4;4;
/org.eclipse.ui.examples.propertysheet/Eclipse UI Examples PropertySheet/org/eclipse/ui/examples/propertysheet/StreetAddress.java;2;0;2;1;0;0;0;2;20;1;2;931;20;20;1;0;0;2;2;931;0;946;2;2;
/org.eclipse.jdt.ui/core refactoring/org/eclipse/jdt/internal/core/refactoring/base/Change.java;4;0;9;1;0;0;0;9;3;1;9;408;15;15;1;0;0;9;9;408;0;1939;9;4;
/org.eclipse.team.tests.cvs.core/src/org/eclipse/team/tests/ccvs/core/compatible/ReferenceClient.java;2;0;4;1;0;0;0;4;34;1;4;2536;39;39;1;0;0;4;4;2536;0;3089;4;2;
/org.eclipse.jdt.core/model/org/eclipse/jdt/core/jdom/DOMException.java;2;0;5;1;2;1;2;3;27;1;3;455;55;55;2;0;1;3;5;4058;1;4058;4;2;
/org.eclipse.swt.examples.paint/src/org/eclipse/swt/examples/paint/TextFigure.java;3;0;4;2;1;1;1;3;93;2;2;586;99;99;2;1;0;3;4;609;1;4705;3;3;
/org.eclipse.swt.examples.paint/org/eclipse/swt/examples/paint/FigureDrawContext.java;2;0;2;1;1;1;1;1;0;0;1;615;0;0;1;0;0;1;2;615;0;4024;2;2;
/org.eclipse.pde.ui/src/org/eclipse/pde/internal/preferences/TargetPlatformPreferencePage.java;1;0;9;1;0;0;0;9;212;1;9;2750;383;383;1;0;0;9;9;2750;0;3579;9;1;
/org.eclipse.ui/Eclipse UI Text Editor/org/eclipse/ui/texteditor/ResourceAction.java;6;0;7;1;0;0;0;7;56;1;7;257;77;77;1;0;0;7;7;257;0;3068;7;6;
/org.eclipse.jdt.core/compiler/org/eclipse/jdt/internal/compiler/ast/QualifiedSuperReference.java;2;1;12;1;2;2;2;10;73;4;7;455;183;183;4;3;0;10;12;1039;3;4421;9;2;
/org.eclipse.ui/Eclipse UI Text Editor/org/eclipse/ui/editors/text/StorageDocumentProvider.java;4;1;13;1;5;5;5;8;124;1;8;257;476;476;1;0;0;8;13;257;0;4838;13;4;
/org.eclipse.swt/Eclipse SWT/motif/org/eclipse/swt/internal/motif/XColor.java;2;0;3;1;0;0;0;3;4;1;3;106;4;4;1;0;0;3;3;106;0;2069;3;2;
/org.eclipse.swt/Eclipse SWT Drag and Drop/win32/org/eclipse/swt/dnd/DropTarget.java;3;2;9;1;7;6;7;2;85;1;2;106;190;190;2;0;1;2;9;4120;1;4824;8;3;
/org.eclipse.update.tests.core/src/org/eclipse/update/tests/nestedfeatures/TestGetFeature.java;1;0;2;1;2;1;2;0;0;0;0;3974;0;0;2;0;1;0;2;3974;1;3974;1;1;
/org.eclipse.core.tests.harness/src/org/eclipse/core/tests/harness/LoggingPerformanceTestResult.java;3;0;4;1;1;1;1;3;254;1;3;1794;277;277;1;0;0;3;4;1794;0;4516;4;3;
/org.eclipse.pde.ui/src/org/eclipse/pde/internal/editor/manifest/UnknownElementPropertySource.java;2;0;5;1;0;0;0;5;3;1;5;1434;6;6;1;0;0;5;5;1434;0;3579;5;2;
/org.eclipse.jdt.ui.tests.refactoring/resources/RenameMethodInInterface/testFail21/in/A.java;1;0;1;1;0;0;0;1;0;0;1;49;0;0;1;0;0;1;1;49;0;49;1;1;
/org.eclipse.jdt.launching/launching/org/eclipse/jdt/internal/launching/JavaClasspathVariablesInitializer.java;2;1;4;1;2;2;2;2;34;1;2;3474;51;51;1;0;0;2;4;3474;0;4383;4;2;
/org.eclipse.update.ui/src/org/eclipse/update/internal/ui/manager/SiteBookmarkPropertyPage.java;1;0;6;1;0;0;0;6;7;1;6;1612;16;16;1;0;0;6;6;1612;0;3537;6;1;
/org.eclipse.ui/Eclipse UI/org/eclipse/ui/dialogs/WizardExportResourcesPage.java;5;1;14;1;3;3;3;11;186;1;11;257;321;321;1;0;0;11;14;257;0;4359;14;5;
/org.eclipse.jdt.ui.tests.refactoring/resources/RenameMethodInInterface/test11/out/A.java;1;0;1;1;0;0;0;1;0;0;1;49;0;0;1;0;0;1;1;49;0;49;1;1;
/org.eclipse.jdt.ui/core refactoring/org/eclipse/jdt/internal/corext/refactoring/AbstractRefactoringASTAnalyzer.java;2;0;5;1;0;0;0;5;114;1;5;1939;118;118;1;0;0;5;5;1939;0;3826;5;2;
/org.eclipse.update.core/src/org/eclipse/update/internal/core/ISiteContentConsumer.java;2;1;3;1;2;2;2;1;32;0;1;3018;36;36;1;0;0;1;3;3018;0;4207;3;2;
/org.eclipse.jdt.ui/ui refactoring/org/eclipse/jdt/internal/ui/refactoring/actions/PullUpActionDelegate.java;1;0;3;1;0;0;0;3;3;1;3;2406;3;3;1;0;0;3;3;2406;0;3754;3;1;
/org.eclipse.update.ui.forms/src/org/eclipse/update/ui/forms/SelectableFormLabel.java;1;0;3;1;0;0;0;3;2;1;3;1980;2;2;1;0;0;3;3;1980;0;2474;3;1;
/org.eclipse.team.core/src/org/eclipse/team/internal/core/target/TargetManager.java;2;1;2;1;2;2;2;0;2;0;0;4636;2;2;1;0;0;0;2;4636;0;4707;2;2;
/org.eclipse.jdt.ui.tests.refactoring/resources/SelectionAnalyzerWorkSpace/SelectionAnalyzerTests/validSelection/A_test181_.java;1;0;1;1;0;0;0;1;0;0;1;2139;0;0;1;0;0;1;1;2139;0;2139;1;1;
/org.eclipse.update.ui/src/org/eclipse/update/internal/ui/forms/ActivitySection.java;2;0;4;1;1;1;1;3;14;1;3;3662;21;21;1;0;0;3;4;3662;0;4361;4;2;
/org.eclipse.ui/Eclipse UI Standard Components/org/eclipse/ui/views/tasklist/ITaskListHelpContextIds.java;3;0;5;1;1;1;1;4;18;1;4;620;35;35;1;0;0;4;5;620;0;4608;5;3;
/org.eclipse.jdt.ui.tests.refactoring/resources/RenameMethodInInterface/testFail43/in/A.java;1;0;1;1;0;0;0;1;0;0;1;49;0;0;1;0;0;1;1;49;0;49;1;1;
/org.eclipse.jdt.debug.ui/ui/org/eclipse/jdt/internal/debug/ui/snippeteditor/RunInPackageAction.java;3;0;6;1;0;0;0;6;22;1;6;1915;29;29;1;0;0;6;6;1915;0;3330;6;3;
/org.eclipse.scripting/src/org/eclipse/scripting/internal/views/ScriptUIEditorDoubleClickSelector.java;1;0;1;1;0;0;0;1;0;0;1;1424;0;0;1;0;0;1;1;1424;0;1424;1;1;
/org.eclipse.jdt.ui.tests/JUnit/junit/tests/NoTestCases.java;2;0;2;1;0;0;0;2;0;1;2;49;0;0;1;0;0;2;2;49;0;1186;2;2;
/org.eclipse.jdt.ui.tests.refactoring/resources/SefWorkSpace/SefTests/object_out/TestSetterInInitialization.java;1;0;1;1;0;0;0;1;0;0;1;2876;0;0;1;0;0;1;1;2876;0;2876;1;1;
/org.eclipse.ui/Eclipse UI/org/eclipse/ui/internal/dialogs/WizardStep.java;1;0;6;1;0;0;0;6;31;3;4;3187;60;60;3;2;0;6;6;3187;2;3488;4;1;
/org.eclipse.jdt.ui.tests.refactoring/resources/ExtractTemp/canExtract/A_test17_out.java;1;0;1;1;0;0;0;1;0;0;1;2481;0;0;1;0;0;1;1;2481;0;2481;1;1;
/org.eclipse.jdt.ui.tests.refactoring/resources/SelectionAnalyzerWorkSpace/SelectionAnalyzerTests/validSelection/A_test200.java;1;0;1;1;0;0;0;1;0;0;1;1368;0;0;1;0;0;1;1;1368;0;1368;1;1;
/org.eclipse.jdt.ui.tests.refactoring/resources/RenameVirtualMethodInClass/testFail9/in/A.java;1;0;1;1;0;0;0;1;0;0;1;49;0;0;1;0;0;1;1;49;0;49;1;1;
/org.eclipse.swt/Eclipse SWT/motif/org/eclipse/swt/widgets/Sash.java;8;1;16;1;5;5;5;11;139;2;10;106;494;494;2;1;0;11;16;3191;1;4701;15;8;
/org.eclipse.pde.core/src/org/eclipse/pde/internal/core/feature/IdentifiableObject.java;1;0;2;1;1;1;1;1;7;0;1;3591;7;7;1;0;0;1;2;3591;0;3994;2;1;
/org.eclipse.pde.ui/src/org/eclipse/pde/internal/preferences/TracingPropertySource.java;2;0;3;1;0;0;0;3;4;1;3;1434;4;4;1;0;0;3;3;1434;0;3579;3;2;
/org.eclipse.jdt.ui.tests.refactoring/resources/InlineTemp/canInline/A_test1_out.java;1;0;1;1;0;0;0;1;0;0;1;2015;0;0;1;0;0;1;1;2015;0;2015;1;1;
/org.eclipse.jdt.ui.tests.refactoring/resources/ExtractTemp/cannotExtract/A_testFail5.java;1;0;1;1;0;0;0;1;0;0;1;2481;0;0;1;0;0;1;1;2481;0;2481;1;1;
/org.eclipse.pde.core/src/org/eclipse/pde/internal/core/ischema/IDocumentSection.java;1;0;1;1;0;0;0;1;0;0;1;3591;0;0;1;0;0;1;1;3591;0;3591;1;1;
/org.eclipse.jdt.ui/ui/org/eclipse/jdt/internal/ui/jarpackager/ManifestProvider.java;1;0;3;1;0;0;0;3;31;1;3;2131;38;38;1;0;0;3;3;2131;0;3739;3;1;
/org.eclipse.team.cvs.ui/src/org/eclipse/team/internal/ccvs/ui/model/ModuleVersion.java;2;0;5;1;0;0;0;5;20;1;5;2126;31;31;1;0;0;5;5;2126;0;2393;5;2;
/org.eclipse.core.target/src/org/eclipse/core/internal/target/webdav/DavResourceManager.java;2;0;7;1;1;1;1;6;1312;1;6;12;1538;1538;1;0;0;6;7;12;0;4196;7;2;
/org.eclipse.pde.core/src/org/eclipse/pde/internal/core/feature/FeatureObject.java;1;0;2;1;1;1;1;1;16;0;1;3591;16;16;1;0;0;1;2;3591;0;3994;2;1;
/org.eclipse.core.boot/src/org/eclipse/core/internal/boot/update/IManifestAttributes.java;4;0;5;1;0;0;0;5;7;1;5;12;12;12;1;0;0;5;5;12;0;2726;5;4;
/org.eclipse.pde.ui/src/org/eclipse/pde/internal/ui/editor/manifest/ExtensionsForm.java;1;0;1;1;0;0;0;1;0;0;1;3579;0;0;1;0;0;1;1;3579;0;3579;1;1;
/org.eclipse.team.core/src/org/eclipse/team/internal/core/streams/TimeoutInputStream.java;1;0;1;1;1;1;1;0;0;0;0;4169;0;0;1;0;0;0;1;4169;0;4169;1;1;
/org.eclipse.swt/Eclipse SWT PI/win32/org/eclipse/swt/internal/win32/LOGBRUSH.java;2;0;2;1;1;1;1;1;6;0;1;2069;6;6;1;0;0;1;2;2069;0;4701;2;2;
/org.eclipse.jdt.core/model/org/eclipse/jdt/internal/core/builder/IDelta.java;1;0;3;1;0;0;0;3;44;1;3;455;44;44;1;0;0;3;3;455;0;2808;3;1;
/org.eclipse.pde.ui/src/org/eclipse/pde/internal/ui/wizards/imports/PluginImportWizardDetailedPage.java;1;2;6;1;3;2;3;3;201;1;3;3579;235;235;2;0;1;3;6;4001;1;4001;5;1;
/org.eclipse.debug.core/core/org/eclipse/debug/internal/core/LaunchManager.java;4;1;71;2;13;13;13;58;354;3;48;187;3484;3484;3;10;0;58;71;1725;10;4608;61;4;
/org.eclipse.jdt.ui/core refactoring/org/eclipse/jdt/core/refactoring/packages/RenamePackageASTAnalyzer.java;1;0;5;1;0;0;0;5;108;2;4;25;123;123;2;1;0;5;5;25;1;408;4;1;
/org.eclipse.update.core/src/org/eclipse/update/internal/model/ConfigurationPolicyModel.java;1;2;12;1;6;4;6;6;75;2;5;3027;205;205;2;1;2;6;12;3628;3;4408;9;1;
/org.eclipse.help/webapps/examples/WEB-INF/classes/examples/FooTagExtraInfo.java;1;0;2;1;0;0;0;2;0;1;2;1882;0;0;1;0;0;2;2;1882;0;1930;2;1;
/org.eclipse.update.ui/src/org/eclipse/update/internal/ui/search/MyComputerSearchDialog.java;2;1;2;1;2;2;2;0;2;0;0;4100;2;2;1;0;0;0;2;4100;0;4610;2;2;
/org.eclipse.jdt.ui.tests.refactoring/resources/RenameNonPrivateField/test0/in/A.java;1;0;1;1;0;0;0;1;0;0;1;49;0;0;1;0;0;1;1;49;0;49;1;1;
/org.eclipse.jdt.ui/ui/org/eclipse/jdt/internal/ui/launcher/SocketUtil.java;2;0;2;1;0;0;0;2;0;1;2;1290;0;0;1;0;0;2;2;1290;0;1916;2;2;
/org.eclipse.pde.ui/Eclipse PDE UI/org/eclipse/pde/internal/editor/PropertiesAction.java;2;0;5;2;0;0;0;5;12;3;3;267;12;12;3;2;0;5;5;324;2;1434;3;2;
/org.eclipse.team.cvs.ssh/src/org/eclipse/team/internal/ccvs/ssh/Policy.java;1;0;1;1;0;0;0;1;0;0;1;2963;0;0;1;0;0;1;1;2963;0;2963;1;1;
/org.eclipse.jdt.ui/ui/org/eclipse/jdt/internal/ui/preferences/WorkInProgressPreferencePage.java;5;2;23;2;7;6;7;16;37;2;15;1921;272;272;2;1;1;16;23;2599;2;4213;21;5;
/org.eclipse.jdt.ui/ui/org/eclipse/jdt/internal/ui/text/java/hover/JavaHoverMessages.java;1;0;1;1;0;0;0;1;0;0;1;770;0;0;1;0;0;1;1;770;0;770;1;1;
/org.eclipse.jdt.ui.tests.refactoring/resources/RenameType/test2/out/B.java;1;0;1;1;0;0;0;1;0;0;1;522;0;0;1;0;0;1;1;522;0;522;1;1;
/org.eclipse.team.cvs.core/src/org/eclipse/team/internal/ccvs/core/client/Tag.java;2;0;9;2;0;0;0;9;62;2;8;2572;122;122;2;1;0;9;9;3089;1;3610;8;2;
/org.eclipse.ui/Eclipse UI/org/eclipse/ui/internal/ViewPluginAction.java;3;0;5;1;0;0;0;5;34;1;5;257;45;45;1;0;0;5;5;257;0;2235;5;3;
/org.eclipse.jdt.ui.tests/ui/com/ibm/jdt/ui/tests/AddUnimplementedMethodsTest.java;1;0;3;1;0;0;0;3;4;1;3;255;4;4;1;0;0;3;3;255;0;522;3;1;
/org.eclipse.jdt.ui.tests.refactoring/resources/InlineTemp/canInline/A_test19_out.java;1;0;1;1;0;0;0;1;0;0;1;3356;0;0;1;0;0;1;1;3356;0;3356;1;1;
/org.eclipse.jdt.ui.tests.refactoring/resources/ExtractMethodWorkSpace/ExtractMethodTests/invalidSelection/A_test104.java;2;1;3;1;2;2;2;1;0;0;1;49;0;0;1;0;0;1;3;49;0;4419;3;2;
/org.eclipse.ui/Eclipse JFace/org/eclipse/jface/preference/FileFieldEditor.java;2;0;2;1;0;0;0;2;5;1;2;257;5;5;1;0;0;2;2;257;0;457;2;2;
/org.eclipse.core.tests.runtime/src/org/eclipse/core/tests/internal/plugins/RegressionResolveTest_6.java;3;0;3;1;0;0;0;3;132;1;3;1794;142;142;1;0;0;3;3;1794;0;3476;3;3;
/org.eclipse.pde.ui/src/org/eclipse/pde/internal/elements/IPDEElement.java;2;0;2;1;0;0;0;2;0;1;2;1434;0;0;1;0;0;2;2;1434;0;3579;2;2;
/org.eclipse.pde.ui/src/org/eclipse/pde/internal/builders/ManifestParser.java;2;0;2;1;0;0;0;2;0;1;2;1434;0;0;1;0;0;2;2;1434;0;3579;2;2;
/org.eclipse.jdt.ui.tests.refactoring/resources/DeleteSourceReference/A_testField3_in.java;1;0;2;1;0;0;0;2;0;1;2;2003;0;0;1;0;0;2;2;2003;0;2857;2;1;
/org.eclipse.jdt.ui/core refactoring/org/eclipse/jdt/internal/core/refactoring/CompositeChange.java;3;0;11;1;0;0;0;11;55;1;11;15;176;176;1;0;0;11;11;15;0;1939;11;3;
/org.eclipse.pde.build/src/org/eclipse/pde/internal/build/antwrappers/CVSPass.java;2;0;2;1;0;0;0;2;0;1;2;2859;0;0;1;0;0;2;2;2859;0;2900;2;2;
/org.eclipse.team.cvs.core/src/org/eclipse/team/internal/ccvs/core/commands/Update.java;3;0;7;1;0;0;0;7;178;1;7;1978;356;356;1;0;0;7;7;1978;0;2607;7;3;
/org.eclipse.jdt.ui.tests.refactoring/resources/RenameParameters/canRename/A_test1_out.java;1;0;1;1;0;0;0;1;0;0;1;233;0;0;1;0;0;1;1;233;0;233;1;1;
/org.eclipse.swt.examples.paint/org/eclipse/swt/examples/paint/RoundedRectangleFigure.java;4;0;5;2;1;1;1;4;66;2;3;586;77;77;2;1;0;4;5;609;1;4024;4;4;
/org.eclipse.pde.ui/Eclipse PDE UI/org/eclipse/pde/internal/editor/build/BuildSourcePage.java;2;0;5;2;0;0;0;5;12;3;3;267;12;12;3;2;0;5;5;324;2;1434;3;2;
/org.eclipse.jdt.ui.tests.refactoring/resources/RenameType/test25/out/B.java;1;0;1;1;0;0;0;1;0;0;1;522;0;0;1;0;0;1;1;522;0;522;1;1;
/org.eclipse.ui/Eclipse UI/org/eclipse/ui/internal/model/WorkbenchMarker.java;2;0;2;1;0;0;0;2;8;1;2;257;8;8;1;0;0;2;2;257;0;457;2;2;
/org.eclipse.team.examples.filesystem/src/org/eclipse/team/examples/filesystem/ui/FileSystemMainPage.java;1;0;1;1;1;1;1;0;0;0;0;4674;0;0;1;0;0;0;1;4674;0;4674;1;1;
/org.eclipse.ui/Eclipse UI/org/eclipse/ui/IEditorLauncher.java;2;0;2;1;0;0;0;2;5;1;2;257;5;5;1;0;0;2;2;257;0;457;2;2;
/org.eclipse.jdt.ui/core extension/org/eclipse/jdt/internal/corext/template/Templates.java;1;0;1;1;0;0;0;1;0;0;1;2784;0;0;1;0;0;1;1;2784;0;2784;1;1;
/org.eclipse.jdt.ui.tests.refactoring/resources/RenameType/testFail95/in/A.java;1;0;1;1;0;0;0;1;0;0;1;49;0;0;1;0;0;1;1;49;0;49;1;1;
/org.eclipse.pde.ui/Eclipse PDE UI/org/eclipse/pde/internal/editor/manifest/ExtensionPointPropertySource.java;2;0;5;2;0;0;0;5;12;3;3;267;12;12;3;2;0;5;5;324;2;1434;3;2;
/org.eclipse.jdt.ui.tests.refactoring/resources/ExtractMethodWorkSpace/ExtractMethodTests/invalidSelection/A_test094.java;2;1;3;1;2;2;2;1;0;0;1;49;0;0;1;0;0;1;3;49;0;4419;3;2;
/org.eclipse.pde.ui/src/org/eclipse/pde/internal/ui/editor/manifest/DetailChildrenSection.java;1;0;4;1;1;1;1;3;6;2;2;3579;10;10;2;1;0;3;4;3579;1;4573;3;1;
/org.eclipse.jdt.ui/core refactoring/org/eclipse/jdt/internal/core/refactoring/sef/SelfEncapsulateFieldRefactoring.java;2;0;8;1;0;0;0;8;136;2;7;1453;344;344;2;1;0;8;8;1937;1;1937;7;2;
/org.eclipse.jdt.ui.tests/JUnit/junit/tests/TestListenerTest.java;2;0;2;1;0;0;0;2;0;1;2;49;0;0;1;0;0;2;2;49;0;1186;2;2;
/org.eclipse.jdt.ui/ui/org/eclipse/jdt/internal/ui/compare/JavaStructureDiffViewerCreator.java;1;0;1;1;0;0;0;1;0;0;1;2717;0;0;1;0;0;1;1;2717;0;2717;1;1;
/org.eclipse.update.core/src/org/eclipse/update/configuration/ILocalSite.java;2;1;10;2;7;7;7;3;163;1;3;3018;345;345;1;0;0;3;10;3018;0;4687;10;2;
/org.eclipse.jdt.debug/eval/org/eclipse/jdt/debug/eval/IAstEvaluationEngine.java;2;0;5;1;1;1;1;4;59;1;4;3555;83;83;1;0;0;4;5;3555;0;4423;5;2;
/org.eclipse.jdt.ui/core extension/org/eclipse/jdt/internal/corext/template/java/JavaContextType.java;2;0;5;1;1;1;1;4;169;2;3;2784;185;185;2;1;0;4;5;2928;1;4186;4;2;
/org.eclipse.core.tests.runtime/src/org/eclipse/core/tests/internal/plugins/BadPluginsTest.java;4;0;12;1;1;1;1;11;742;1;11;1794;1155;1155;1;0;0;11;12;1794;0;4449;12;4;
/org.eclipse.jdt.ui.tests.refactoring/resources/RenameTemp/canRename/A_test23_in.java;1;0;1;1;0;0;0;1;0;0;1;1625;0;0;1;0;0;1;1;1625;0;1625;1;1;
/org.eclipse.swt.tests/JUnit Tests/org/eclipse/swt/tests/junit/Test_org_eclipse_swt_widgets_TabFolder.java;2;0;2;1;1;1;1;1;6;0;1;1792;6;6;1;0;0;1;2;1792;0;4706;2;2;
/org.eclipse.jdt.ui.tests.refactoring/resources/PasteSourceReference/Copy of test0/out/A.java;1;0;2;1;0;0;0;2;0;1;2;2003;0;0;1;0;0;2;2;2003;0;2156;2;1;
/org.eclipse.jdt.ui/ui/org/eclipse/jdt/internal/ui/text/link/LinkedPositionListener.java;1;0;2;1;0;0;0;2;18;1;2;1720;18;18;1;0;0;2;2;1720;0;1734;2;1;
/org.eclipse.jdt.core/compiler/org/eclipse/jdt/internal/compiler/ast/MethodDeclaration.java;2;1;15;1;2;2;2;13;160;4;10;455;449;449;4;3;0;13;15;1039;3;4421;12;2;
/org.eclipse.jdt.ui.tests/JUnit/junit/tests/NotPublicTestCase.java;2;0;2;1;0;0;0;2;0;1;2;49;0;0;1;0;0;2;2;49;0;1186;2;2;
/org.eclipse.ui/Eclipse UI/org/eclipse/ui/internal/dialogs/WorkbenchPreferencePage.java;9;2;43;2;9;8;9;34;847;2;28;257;2344;2344;2;6;1;34;43;2987;7;4451;36;9;
/org.eclipse.jdt.ui/ui/org/eclipse/jdt/internal/ui/text/correction/SimilarElementsRequestor.java;2;0;6;1;0;0;0;6;83;2;5;3531;171;171;2;1;0;6;6;3719;1;3759;5;2;
/org.eclipse.debug.core/core/org/eclipse/debug/core/model/IPersistableSourceLocator.java;2;1;4;1;2;2;2;2;8;1;2;3185;12;12;1;0;0;2;4;3185;0;4651;4;2;
/org.eclipse.search/search/org/eclipse/search/internal/ui/ShowSearchAction.java;2;0;5;1;0;0;0;5;31;1;5;15;43;43;1;0;0;5;5;15;0;687;5;2;
/org.eclipse.help/src/org/eclipse/help/internal/util/Logger.java;2;0;4;1;0;0;0;4;27;1;4;1420;54;54;1;0;0;4;4;1420;0;3609;4;2;
/org.eclipse.jdt.ui/core refactoring/org/eclipse/jdt/internal/corext/refactoring/JavaModelUtility.java;3;0;3;1;0;0;0;3;2;1;3;1939;2;2;1;0;0;3;3;1939;0;2137;3;3;
/org.eclipse.ui/Eclipse UI/org/eclipse/ui/IObjectActionDelegate.java;2;0;2;1;0;0;0;2;5;1;2;257;5;5;1;0;0;2;2;257;0;457;2;2;
/org.eclipse.ui/Eclipse JFace Text/org/eclipse/jface/text/IDocumentPartitioningListener.java;2;0;2;1;0;0;0;2;5;1;2;257;5;5;1;0;0;2;2;257;0;457;2;2;
/org.eclipse.jdt.junit/Eclipse JUnit/org/eclipse/jdt/junit/internal/FailureRunView.java;2;0;2;1;0;0;0;2;0;1;2;1531;0;0;1;0;0;2;2;1531;0;2007;2;2;
/org.eclipse.swt/Eclipse SWT Drag and Drop/emulated/org/eclipse/swt/dnd/DropTarget.java;2;1;5;1;4;4;4;1;94;0;1;3126;108;108;1;0;0;1;5;3126;0;4824;5;2;
/org.eclipse.debug.ui/ui/org/eclipse/debug/internal/ui/views/breakpoints/BreakpointsView.java;2;1;3;1;3;3;3;0;278;0;0;3975;291;291;1;0;0;0;3;3975;0;4423;3;2;
/org.eclipse.pde.junit/src/org/eclipse/pde/internal/junit/launcher/JUnitLaunchConfigurationTab.java;1;0;2;1;0;0;0;2;0;1;2;3171;0;0;1;0;0;2;2;3171;0;3184;2;1;
/org.eclipse.jdt.ui/ui/org/eclipse/jdt/internal/ui/wizards/buildpaths/VariableSelectionBlock.java;3;0;22;1;0;0;0;22;107;2;19;190;412;412;2;3;0;22;22;218;3;3680;19;3;
/org.eclipse.core.tests.runtime/src/org/eclipse/core/tests/internal/plugins/ConflictResolveTest_7.java;3;0;3;1;0;0;0;3;158;1;3;1794;168;168;1;0;0;3;3;1794;0;3476;3;3;
/org.eclipse.swt/Eclipse SWT OLE Win32/win32/org/eclipse/swt/internal/ole/win32/IPersistStorage.java;2;0;3;1;0;0;0;3;5;1;3;106;5;5;1;0;0;3;3;106;0;2069;3;2;
/org.eclipse.jdt.core/compiler/org/eclipse/jdt/internal/compiler/ast/SingleTypeReference.java;2;1;4;1;2;2;2;2;104;1;2;455;119;119;1;0;0;2;4;455;0;4421;4;2;
/org.eclipse.swt/Eclipse SWT PI/gtk/org/eclipse/swt/internal/gtk/GtkStyleClass.java;2;0;3;1;0;0;0;3;6;1;3;2107;6;6;1;0;0;3;3;2107;0;3633;3;2;
/org.eclipse.core.resources/src/org/eclipse/core/resources/IResourceChangeEvent.java;3;0;7;1;1;1;1;6;374;1;6;12;424;424;1;0;0;6;7;12;0;4214;7;3;
/org.eclipse.swt.tests/JUnit Tests/org/eclipse/swt/tests/junit/Test_org_eclipse_swt_events_TypedEvent.java;2;0;2;1;1;1;1;1;6;0;1;1792;6;6;1;0;0;1;2;1792;0;4706;2;2;
/org.eclipse.swt/Eclipse SWT Custom Widgets/common/org/eclipse/swt/custom/TextChangingEvent.java;3;1;4;1;2;2;2;2;41;1;2;175;89;89;1;0;0;2;4;175;0;4701;4;3;
/org.eclipse.jdt.debug/eval/org/eclipse/jdt/internal/debug/eval/ast/EvaluationVariable.java;1;0;3;1;0;0;0;3;192;1;3;3329;192;192;1;0;0;3;3;3329;0;3421;3;1;
/org.eclipse.ui.examples.propertysheet/Eclipse UI Examples PropertySheet/org/eclipse/ui/examples/propertysheet/IUserConstants.java;2;0;2;1;0;0;0;2;10;1;2;931;10;10;1;0;0;2;2;931;0;946;2;2;
/org.eclipse.jdt.ui.tests.refactoring/resources/ExtractMethodWorkSpace/ExtractMethodTests/locals_in/A_test555.java;1;1;3;1;2;2;2;1;28;0;1;1236;28;28;1;0;0;1;3;1236;0;4419;3;1;
/org.eclipse.jdt.ui.tests.refactoring/resources/SefWorkSpace/SefTests/object_out/TestFinalField.java;1;0;1;1;1;1;1;0;0;0;0;4403;0;0;1;0;0;0;1;4403;0;4403;1;1;
/org.eclipse.ui/Eclipse UI Text Editor/org/eclipse/ui/texteditor/ContentAssistAction.java;1;1;2;1;2;2;2;0;34;0;0;4468;34;34;1;0;0;0;2;4468;0;4838;2;1;
/org.eclipse.swt.tests/JUnit Tests/org/eclipse/swt/tests/junit/Test_org_eclipse_swt_events_ControlListener.java;2;0;2;1;1;1;1;1;6;0;1;1792;6;6;1;0;0;1;2;1792;0;4706;2;2;
/org.eclipse.ui/Eclipse UI/org/eclipse/ui/internal/SwitchToPageMenu.java;3;0;3;1;0;0;0;3;7;1;3;257;7;7;1;0;0;3;3;257;0;3067;3;3;
/org.eclipse.jdt.ui/core refactoring/org/eclipse/jdt/internal/corext/refactoring/nls/changes/CreateTextFileChange.java;2;1;4;1;2;2;2;2;4;1;2;1939;12;12;1;0;0;2;4;1939;0;4598;4;2;
/org.eclipse.jdt.core/search/org/eclipse/jdt/internal/core/search/matching/OrPathCombiner.java;2;0;4;1;1;1;1;3;208;1;3;455;262;262;1;0;0;3;4;455;0;4063;4;2;
/org.eclipse.help.ui/Eclipse Help UI/org/eclipse/help/internal/ui/TreeContentProvider.java;2;0;3;1;0;0;0;3;7;1;3;136;7;7;1;0;0;3;3;136;0;1420;3;2;
/org.eclipse.swt.examples/org/eclipse/swt/examples/javaviewer/JavaLineStyler.java;4;0;4;1;1;1;1;3;367;1;3;513;413;413;1;0;0;3;4;513;0;4024;4;4;
/org.eclipse.core.tests.runtime/src/org/eclipse/core/tests/plugintests/ApiTest.java;3;0;3;1;0;0;0;3;620;1;3;1794;630;630;1;0;0;3;3;1794;0;3476;3;3;
/org.eclipse.jdt.junit/src/org/eclipse/jdt/internal/junit/util/PixelConverter.java;1;0;1;1;1;1;1;0;0;0;0;4161;0;0;1;0;0;0;1;4161;0;4161;1;1;
/org.eclipse.core.tests.resources/src/org/eclipse/core/tests/internal/watson/ElementTreeSerializationTest.java;3;0;3;1;1;1;1;2;516;1;2;1794;533;533;1;0;0;2;3;1794;0;4516;3;3;
/org.eclipse.swt/Eclipse SWT/win32/org/eclipse/swt/widgets/Button.java;9;3;26;1;8;5;8;18;27;1;18;106;212;212;3;0;3;18;26;4557;3;4701;23;9;
/org.eclipse.team.cvs.core/src/org/eclipse/team/internal/ccvs/core/client/ValidRequestsHandler.java;1;0;3;1;0;0;0;3;37;1;3;2572;39;39;1;0;0;3;3;2572;0;2791;3;1;
/org.eclipse.jdt.ui/ui/org/eclipse/jdt/internal/ui/text/HTML2TextReader.java;3;1;9;2;2;2;2;7;139;2;5;1384;282;282;2;2;0;7;9;1482;2;4706;7;3;
/org.eclipse.scripting/Eclipse Scripting/org/eclipse/scripting/internal/datamodels/XGRStringDataModel.java;2;0;4;1;0;0;0;4;48;1;4;133;54;54;1;0;0;4;4;133;0;1424;4;2;
/org.eclipse.swt/Eclipse SWT/photon/org/eclipse/swt/internal/photon/PtTreeItem_t.java;2;0;3;1;0;0;0;3;6;1;3;106;6;6;1;0;0;3;3;106;0;2069;3;2;
/org.eclipse.swt/Eclipse SWT Custom Widgets/common/org/eclipse/swt/custom/PrintRenderer.java;2;0;3;1;1;1;1;2;270;1;2;3105;278;278;1;0;0;2;3;3105;0;4701;3;2;
/org.eclipse.jdt.debug/eval/org/eclipse/jdt/debug/eval/ICompiledExpression.java;1;0;3;1;1;1;1;2;12;1;2;3555;13;13;1;0;0;2;3;3555;0;4423;3;1;
/org.eclipse.jdt.ui.tests.refactoring/resources/MoveCU/testFail1/in/p1/A.java;2;0;2;1;0;0;0;2;0;1;2;49;0;0;1;0;0;2;2;49;0;2769;2;2;
/org.eclipse.help/Eclipse Help/org/eclipse/help/internal/contributions/xml/HelpTopicRef.java;2;0;5;1;0;0;0;5;25;1;5;135;53;53;1;0;0;5;5;135;0;1420;5;2;
/org.eclipse.jdt.ui.tests.refactoring/resources/RenameType/testFail94/in/A.java;1;0;1;1;0;0;0;1;0;0;1;49;0;0;1;0;0;1;1;49;0;49;1;1;
/org.eclipse.jdt.core/search/org/eclipse/jdt/internal/core/search/IIndexSearchRequestor.java;2;0;4;1;1;1;1;3;167;1;3;455;187;187;1;0;0;3;4;455;0;4063;4;2;
/org.eclipse.pde.ui/src/org/eclipse/pde/model/IModelChangedEvent.java;1;0;2;1;0;0;0;2;0;1;2;3039;0;0;1;0;0;2;2;3039;0;3579;2;1;
/org.eclipse.jdt.debug/eval/org/eclipse/jdt/debug/eval/model/IObject.java;2;0;2;1;0;0;0;2;0;1;2;3421;0;0;1;0;0;2;2;3421;0;3555;2;2;
/org.eclipse.ui/Eclipse UI/org/eclipse/ui/internal/PartListenerList.java;3;0;3;1;1;1;1;2;16;1;2;257;21;21;1;0;0;2;3;257;0;4363;3;3;
/org.eclipse.jdt.core/model/org/eclipse/jdt/internal/core/newbuilder/AbstractImageBuilder.java;2;0;33;1;0;0;0;33;168;3;27;1764;678;678;3;6;0;33;33;2065;6;2979;27;2;
/org.eclipse.pde.ui/src/org/eclipse/pde/internal/wizards/WizardElement.java;2;0;4;1;0;0;0;4;55;1;4;1434;63;63;1;0;0;4;4;1434;0;3579;4;2;
/org.eclipse.jdt.ui.tests.refactoring/resources/MoveMembers/testFail8/in/A.java;1;0;1;1;0;0;0;1;0;0;1;2738;0;0;1;0;0;1;1;2738;0;2738;1;1;
/org.eclipse.ui/Eclipse UI/org/eclipse/ui/internal/dialogs/PropertyPageContributorManager.java;5;0;11;1;0;0;0;11;43;2;9;257;149;149;2;2;0;11;11;1885;2;2300;9;5;
/org.eclipse.team.cvs.ui/src/org/eclipse/team/internal/ccvs/ui/actions/CopyRepositoryNameAction.java;2;0;5;1;1;1;1;4;2;1;4;3012;7;7;1;0;0;4;5;3012;0;4021;5;2;
/org.eclipse.jdt.ui.tests.refactoring/resources/RenameTemp/canRename/A_test13_out.java;1;0;2;1;0;0;0;2;2;1;2;1625;2;2;1;0;0;2;2;1625;0;1652;2;1;
/org.eclipse.swt/Eclipse SWT/common_j2me/org/eclipse/swt/internal/EventObjectCompatibility.java;2;0;2;1;0;0;0;2;0;1;2;1438;0;0;1;0;0;2;2;1438;0;1561;2;2;
/org.eclipse.ui/Eclipse UI/org/eclipse/ui/IMarkerHelpRegistry.java;1;0;2;1;0;0;0;2;12;1;2;2497;12;12;1;0;0;2;2;2497;0;2895;2;1;
/org.eclipse.help.ui/src/org/eclipse/help/internal/ui/HTMLHelpViewer.java;2;0;7;1;0;0;0;7;88;1;7;1420;118;118;1;0;0;7;7;1420;0;3030;7;2;
/org.eclipse.jdt.ui/ui/org/eclipse/jdt/internal/ui/compare/JavaCompareWithEditionAction.java;3;1;13;1;2;2;2;11;165;2;9;77;369;369;2;2;0;11;13;2133;2;4450;11;3;
/org.eclipse.jdt.core/compiler/org/eclipse/jdt/internal/compiler/ast/SwitchStatement.java;2;1;17;1;2;2;2;15;458;4;12;455;1195;1195;4;3;0;15;17;1039;3;4421;14;2;
/org.eclipse.jdt.ui.tests.refactoring/resources/ExtractMethodWorkSpace/ExtractMethodTests/locals_out/A_test523.java;1;1;4;1;2;2;2;2;48;1;2;2684;50;50;1;0;0;2;4;2684;0;4419;4;1;
/org.eclipse.ui/Eclipse UI/org/eclipse/ui/internal/dialogs/WorkbenchWizardSelectionPage.java;2;0;2;1;0;0;0;2;9;1;2;257;9;9;1;0;0;2;2;257;0;457;2;2;
/org.eclipse.jdt.ui.tests.refactoring/resources/SurroundWithWorkSpace/SurroundWithTests/trycatch_in/TestNoException.java;1;0;1;1;0;0;0;1;0;0;1;2327;0;0;1;0;0;1;1;2327;0;2327;1;1;
/org.eclipse.swt/Eclipse SWT/photon/org/eclipse/swt/graphics/Font.java;4;1;7;1;3;3;3;4;104;1;4;106;152;152;1;0;0;4;7;106;0;4701;7;4;
/org.eclipse.update.core/src/org/eclipse/update/internal/core/ConfigurationActivity.java;2;0;11;1;1;1;1;10;78;2;9;2098;209;209;2;1;0;10;11;3027;1;3914;10;2;
/org.eclipse.core.boot/src/org/eclipse/core/internal/boot/EclipseURLHandlerFactoryProxy.java;1;0;2;1;0;0;0;2;0;1;2;12;0;0;1;0;0;2;2;12;0;23;2;1;
/org.eclipse.ui/Eclipse JFace/org/eclipse/jface/util/IOpenEventListener.java;1;0;1;1;0;0;0;1;0;0;1;3576;0;0;1;0;0;1;1;3576;0;3576;1;1;
/org.eclipse.jdt.ui.tests.refactoring/resources/SelectionAnalyzerWorkSpace/SelectionAnalyzerTests/invalidSelection/A_test190.java;2;0;2;1;0;0;0;2;0;1;2;1368;0;0;1;0;0;2;2;1368;0;2139;2;2;
/org.eclipse.pde.ui/templates/helloWorld/java/$className$.java;1;0;1;1;1;1;1;0;0;0;0;4435;0;0;1;0;0;0;1;4435;0;4435;1;1;
/org.eclipse.pde.ui/src/org/eclipse/pde/internal/wizards/WizardNode.java;2;0;3;1;0;0;0;3;2;1;3;1434;2;2;1;0;0;3;3;1434;0;3579;3;2;
/org.eclipse.jdt.ui.tests.refactoring/resources/SelectionAnalyzerWorkSpace/SelectionAnalyzerTests/invalidSelection/A_test143.java;2;0;2;1;0;0;0;2;0;1;2;1368;0;0;1;0;0;2;2;1368;0;2139;2;2;
/org.eclipse.pde.ui/Eclipse PDE UI/org/eclipse/pde/internal/editor/schema/ElementSection.java;2;0;8;2;0;0;0;8;12;3;6;267;28;28;3;2;0;8;8;324;2;1434;6;2;
/org.eclipse.pde.runtime/src/org/eclipse/pde/internal/runtime/logview/LogViewContentProvider.java;2;0;2;1;0;0;0;2;47;1;2;1434;47;47;1;0;0;2;2;1434;0;3877;2;2;
/org.eclipse.jdt.debug/eval/org/eclipse/jdt/internal/debug/eval/ast/engine/UnaryPlusOperator.java;1;0;3;1;0;0;0;3;3;1;3;3329;3;3;1;0;0;3;3;3329;0;3421;3;1;
/org.eclipse.help.ui/src/org/eclipse/help/internal/ui/NavigationViewer.java;2;0;10;2;0;0;0;10;318;2;8;1420;449;449;2;2;0;10;10;1675;2;3030;8;2;
/org.eclipse.ui/Eclipse UI/org/eclipse/ui/internal/dialogs/EmptyPreferencePage.java;3;0;3;1;0;0;0;3;5;1;3;257;6;6;1;0;0;3;3;257;0;620;3;3;
/org.eclipse.swt.examples/org/eclipse/swt/examples/controlexample/ToolBarTab.java;5;1;7;1;3;3;3;4;445;1;4;513;808;808;1;0;0;4;7;513;0;4024;7;5;
/org.eclipse.ui/Eclipse JFace Text/org/eclipse/jface/text/DefaultAutoIndentStrategy.java;3;0;3;1;0;0;0;3;47;1;3;257;52;52;1;0;0;3;3;257;0;1066;3;3;
/org.eclipse.pde.ui/Eclipse PDE UI/org/eclipse/pde/internal/editor/component/ComponentEditorContributor.java;2;0;5;2;0;0;0;5;12;3;3;267;12;12;3;2;0;5;5;324;2;1434;3;2;
/org.eclipse.jdt.ui.tests.refactoring/resources/MoveMembers/test12/out/A.java;1;0;1;1;0;0;0;1;0;0;1;2738;0;0;1;0;0;1;1;2738;0;2738;1;1;
/org.eclipse.pde.ui/src/org/eclipse/pde/internal/ui/view/PluginsViewAdapterFactory.java;1;0;1;1;0;0;0;1;0;0;1;3579;0;0;1;0;0;1;1;3579;0;3579;1;1;
/org.eclipse.vcm.core.cvs/src/org/eclipse/vcm/internal/core/ccvs/utils/HackFinder.java;3;0;3;1;0;0;0;3;6;1;3;0;6;6;1;0;0;3;3;0;0;413;3;3;
/org.eclipse.jdt.debug/eval/org/eclipse/jdt/debug/eval/model/IRuntimeContext.java;2;0;2;1;0;0;0;2;0;1;2;3421;0;0;1;0;0;2;2;3421;0;3555;2;2;
/org.eclipse.scripting/src/org/eclipse/scripting/internal/IXGRDataNode.java;1;0;1;1;0;0;0;1;0;0;1;1424;0;0;1;0;0;1;1;1424;0;1424;1;1;
/org.eclipse.swt/Eclipse SWT/win32/org/eclipse/swt/widgets/Slider.java;9;2;14;1;4;3;4;10;35;1;10;106;140;140;2;0;1;10;14;4557;1;4701;13;9;
/org.eclipse.swt.examples/org/eclipse/swt/examples/addressbook/AddressBook.java;6;0;7;1;1;1;1;6;908;1;6;513;1040;1040;1;0;0;6;7;513;0;4024;7;6;
/org.eclipse.team.cvs.ui/src/org/eclipse/team/internal/ccvs/ui/ResourcePropertiesPage.java;3;0;5;1;0;0;0;5;190;1;5;1978;224;224;1;0;0;5;5;1978;0;3644;5;3;
/org.eclipse.core.resources/src/org/eclipse/core/internal/localstore/CopyVisitor.java;3;0;13;1;1;1;1;12;288;3;10;12;357;357;3;2;0;12;13;327;2;4214;11;3;
/org.eclipse.jdt.ui.tests.refactoring/resources/RenameMethodInInterface/test44/in/A.java;1;0;1;1;0;0;0;1;0;0;1;49;0;0;1;0;0;1;1;49;0;49;1;1;
/org.eclipse.team.cvs.core/src/org/eclipse/team/internal/ccvs/core/syncinfo/ResourceSyncInfo.java;2;0;15;1;0;0;0;15;345;1;15;2690;553;553;1;0;0;15;15;2690;0;3628;15;2;
/org.eclipse.ui.tests/UI Test Utils/org/eclipse/ui/tests/util/FileUtil.java;1;0;1;1;0;0;0;1;0;0;1;2785;0;0;1;0;0;1;1;2785;0;2785;1;1;
/org.eclipse.jdt.ui.tests.refactoring/resources/RenameMethodInInterface/testFail4/in/A.java;1;0;1;1;0;0;0;1;0;0;1;49;0;0;1;0;0;1;1;49;0;49;1;1;
/org.eclipse.help.ui/Eclipse Help UI/org/eclipse/help/internal/ui/search/SearchPage.java;3;0;5;1;0;0;0;5;7;1;5;136;18;18;1;0;0;5;5;136;0;1055;5;3;
/org.eclipse.swt/Eclipse SWT Drag and Drop/common/org/eclipse/swt/dnd/DragUnderEffect.java;2;0;3;1;1;1;1;2;10;1;2;106;16;16;1;0;0;2;3;106;0;4701;3;2;
/org.eclipse.jdt.core/codeassist/org/eclipse/jdt/internal/codeassist/complete/CompletionOnSingleTypeReference.java;3;1;11;1;2;2;2;9;52;4;6;455;100;100;4;3;0;9;11;1039;3;4062;8;3;
/org.eclipse.swt.examples/Eclipse SWT Examples/common/org/eclipse/swt/examples/controlexample/SliderTab.java;1;0;2;1;0;0;0;2;0;1;2;107;0;0;1;0;0;2;2;107;0;611;2;1;
/org.eclipse.ui/Eclipse JFace/org/eclipse/jface/resource/ImageRegistry.java;2;0;2;1;0;0;0;2;5;1;2;257;5;5;1;0;0;2;2;257;0;457;2;2;
/org.eclipse.jdt.ui/core refactoring/org/eclipse/jdt/internal/corext/refactoring/structure/MoveMembersRefactoring.java;2;1;20;2;3;3;3;17;199;3;11;2737;477;477;3;6;0;17;20;3694;6;4424;14;2;
/org.eclipse.team.core/src/org/eclipse/team/internal/core/DefaultFileModificationValidator.java;1;0;2;1;1;1;1;1;1;0;1;3762;1;1;1;0;0;1;2;3762;0;4123;2;1;
/org.eclipse.update.core/src/org/eclipse/update/core/INonPluginEntry.java;2;0;6;1;0;0;0;6;150;3;4;2419;265;265;3;2;0;6;6;3570;2;3570;4;2;
/org.eclipse.jdt.ui.tests.refactoring/resources/DeleteSourceReference/A_testField0_out.java;1;0;2;1;0;0;0;2;0;1;2;2003;0;0;1;0;0;2;2;2003;0;2857;2;1;
/org.eclipse.jdt.core/model/org/eclipse/jdt/internal/core/CreatePackageFragmentOperation.java;3;1;12;1;2;2;2;10;177;4;7;455;257;257;4;3;0;10;12;1039;3;4063;9;3;
/org.eclipse.team.ui/src/org/eclipse/team/internal/ui/target/SyncAction.java;2;1;2;1;2;2;2;0;4;0;0;4215;4;4;1;0;0;0;2;4215;0;4636;2;2;
/org.eclipse.jdt.debug.ui/ui/org/eclipse/jdt/internal/debug/ui/launcher/ProcessPropertyPage.java;2;0;4;1;1;1;1;3;2;1;3;1915;6;6;1;0;0;3;4;1915;0;4423;4;2;
/org.eclipse.swt/Eclipse SWT/motif/org/eclipse/swt/internal/motif/XSetWindowAttributes.java;2;0;3;1;0;0;0;3;4;1;3;106;4;4;1;0;0;3;3;106;0;2069;3;2;
/org.eclipse.pde.ui/src/org/eclipse/pde/internal/ui/ischema/ISchemaAttributeProvider.java;1;0;2;1;0;0;0;2;0;1;2;3579;0;0;1;0;0;2;2;3579;0;3591;2;1;
/org.eclipse.debug.ui/ui/org/eclipse/debug/internal/ui/actions/ResumeActionDelegate.java;3;1;10;1;3;3;3;7;46;1;7;2382;124;124;1;0;0;7;10;2382;0;4423;10;3;
/org.eclipse.ui.examples.javaeditor/Eclipse Java Editor Example/org/eclipse/ui/examples/javaeditor/JavaActionContributor.java;1;0;1;1;0;0;0;1;0;0;1;1067;0;0;1;0;0;1;1;1067;0;1067;1;1;
/org.eclipse.pde.ui/src/org/eclipse/pde/ui/IPluginStructureData.java;1;0;2;1;1;1;1;1;42;0;1;3579;42;42;1;0;0;1;2;3579;0;4752;2;1;
/org.eclipse.swt/Eclipse SWT PI/win32/org/eclipse/swt/internal/win32/SCROLLINFO.java;2;0;2;1;1;1;1;1;6;0;1;2069;6;6;1;0;0;1;2;2069;0;4701;2;2;
/org.eclipse.jdt.core/model/org/eclipse/jdt/core/ICompletionRequestor.java;3;2;13;1;7;6;7;6;340;1;6;1803;880;880;2;0;1;6;13;4058;1;4451;12;3;
/org.eclipse.swt/Eclipse SWT Drag and Drop/gtk1x/org/eclipse/swt/dnd/Clipboard.java;2;0;3;1;0;0;0;3;1;1;3;2107;1;1;1;0;0;3;3;2107;0;3127;3;2;
/org.eclipse.pde.ui/src/org/eclipse/pde/internal/editor/component/SynchronizeVersionsWizard.java;2;0;2;1;0;0;0;2;0;1;2;1434;0;0;1;0;0;2;2;1434;0;2951;2;2;
/org.eclipse.jdt.ui/ui refactoring/org/eclipse/jdt/internal/ui/refactoring/actions/RenameInputDialog.java;1;0;2;1;0;0;0;2;3;1;2;3307;3;3;1;0;0;2;2;3307;0;3568;2;1;
/org.eclipse.jdt.ui.tests.refactoring/resources/RenameType/testFail32/in/B.java;1;0;1;1;0;0;0;1;0;0;1;49;0;0;1;0;0;1;1;49;0;49;1;1;
/org.eclipse.jdt.debug/model/org/eclipse/jdt/internal/debug/core/model/JDIFieldVariable.java;3;0;7;2;0;0;0;7;13;3;5;2517;49;49;3;2;0;7;7;2517;2;3576;5;3;
/org.eclipse.help/Eclipse Help/org/eclipse/help/internal/contributions/InfoSet.java;2;0;3;1;0;0;0;3;7;1;3;135;7;7;1;0;0;3;3;135;0;1420;3;2;
/org.eclipse.jdt.core/model/org/eclipse/jdt/internal/core/util/HackFinder.java;1;0;4;1;0;0;0;4;22;1;4;455;27;27;1;0;0;4;4;455;0;2811;4;1;
/org.eclipse.jdt.core/model/org/eclipse/jdt/internal/core/newbuilder/NameEnvironment.java;1;0;11;1;0;0;0;11;258;2;9;1764;309;309;2;2;0;11;11;1926;2;2979;9;1;
/org.eclipse.jdt.ui/ui/org/eclipse/jdt/internal/ui/reorg/CopyResourcesToClipboardAction.java;3;1;14;2;4;4;4;10;42;2;9;3167;124;124;2;1;0;10;14;3826;1;4426;13;3;
/org.eclipse.team.tests.cvs.core/src/org/eclipse/team/tests/ccvs/ui/logformatter/PrintTextSummaryVisitor.java;1;0;1;1;0;0;0;1;0;0;1;3452;0;0;1;0;0;1;1;3452;0;3452;1;1;
/org.eclipse.jdt.ui/core refactoring/org/eclipse/jdt/internal/corext/refactoring/util/CodeAnalyzer2.java;1;0;4;1;0;0;0;4;14;1;4;3106;17;17;1;0;0;4;4;3106;0;3209;4;1;
/org.eclipse.jdt.debug/eval/org/eclipse/jdt/internal/debug/eval/model/EvaluationPrimitiveType.java;2;0;4;1;0;0;0;4;8;1;4;3421;9;9;1;0;0;4;4;3421;0;3645;4;2;
/org.eclipse.vcm.core.cvs.ssh/src/org/eclipse/vcm/internal/core/ccvs/ssh/Packet.java;2;0;3;1;0;0;0;3;4;1;3;111;8;8;1;0;0;3;3;111;0;298;3;2;
/org.eclipse.jdt.ui.tests.refactoring/resources/RenameParameters/canRename/A_test16_in.java;1;0;1;1;0;0;0;1;0;0;1;233;0;0;1;0;0;1;1;233;0;233;1;1;
/org.eclipse.jdt.debug.ui/ui/org/eclipse/jdt/internal/debug/ui/actions/JavaBreakpointsPreferenceStore.java;1;0;2;1;1;1;1;1;0;0;1;3508;0;0;1;0;0;1;2;3508;0;4410;2;1;
/org.eclipse.compare/compare/org/eclipse/compare/IContentChangeNotifier.java;1;0;2;1;0;0;0;2;5;1;2;14;5;5;1;0;0;2;2;14;0;329;2;1;
/org.eclipse.core.tests.resources/src/org/eclipse/core/tests/internal/localstore/MoveTest.java;3;0;7;1;1;1;1;6;1410;1;6;1794;1473;1473;1;0;0;6;7;1794;0;4516;7;3;
/org.eclipse.jdt.ui.tests.refactoring/resources/InlineTemp/canInline/A_test2_in.java;1;0;1;1;0;0;0;1;0;0;1;2015;0;0;1;0;0;1;1;2015;0;2015;1;1;
/org.eclipse.ui/Eclipse UI/org/eclipse/ui/internal/ToggleEditorsVisibilityAction.java;4;0;4;1;0;0;0;4;22;1;4;257;26;26;1;0;0;4;4;257;0;3029;4;4;
/org.eclipse.debug.ui/ui/org/eclipse/debug/internal/ui/preferences/DebugActionGroupsManager.java;3;2;4;2;4;3;4;0;18;0;0;3975;19;19;2;0;1;0;4;4207;1;4423;3;3;
/org.eclipse.scripting/src/org/eclipse/scripting/internal/datamodels/XGRStringDataModel.java;1;0;1;1;0;0;0;1;0;0;1;1424;0;0;1;0;0;1;1;1424;0;1424;1;1;
/org.eclipse.jdt.core/model/org/eclipse/jdt/internal/core/util/CharArrayOps.java;3;1;5;1;2;2;2;3;251;1;3;455;301;301;1;0;0;3;5;455;0;4422;5;3;
/org.eclipse.jdt.ui/ui/org/eclipse/jdt/ui/actions/FindDeclarationsInWorkingSetAction.java;3;1;3;1;3;3;3;0;18;0;0;4141;22;22;1;0;0;0;3;4141;0;4770;3;3;
/org.eclipse.pde.ui/src/org/eclipse/pde/internal/builders/SchemaTransformer.java;2;0;5;1;0;0;0;5;30;1;5;1434;36;36;1;0;0;5;5;1434;0;3579;5;2;
/org.eclipse.jdt.ui.tests.refactoring/resources/RenameTemp/canRename/A_test11_out.java;1;0;2;1;0;0;0;2;2;1;2;1625;2;2;1;0;0;2;2;1625;0;1652;2;1;
/org.eclipse.jdt.core/search/org/eclipse/jdt/internal/core/search/matching/FieldReferencePattern.java;3;0;27;1;1;1;1;26;1506;4;20;455;3335;3335;4;6;0;26;27;1039;6;4063;21;3;
/org.eclipse.jdt.core/compiler/org/eclipse/jdt/internal/compiler/ast/BranchStatement.java;2;1;6;1;2;2;2;4;74;1;4;455;96;96;1;0;0;4;6;455;0;4421;6;2;
/org.eclipse.jdt.ui/ui refactoring/org/eclipse/jdt/internal/ui/refactoring/ReorgInputPage2.java;1;0;1;1;0;0;0;1;0;0;1;1108;0;0;1;0;0;1;1;1108;0;1108;1;1;
/org.eclipse.webdav/src/client/org/eclipse/webdav/internal/authentication/ParserException.java;3;0;5;1;1;1;1;4;56;1;4;12;106;106;1;0;0;4;5;12;0;4211;5;3;
/org.eclipse.core.runtime/src/org/eclipse/core/internal/plugins/ConfigurationProperty.java;3;0;4;1;1;1;1;3;32;1;3;12;54;54;1;0;0;3;4;12;0;4213;4;3;
/org.eclipse.team.cvs.ssh/src/org/eclipse/team/internal/ccvs/ssh/Client.java;3;1;9;1;2;2;2;7;1289;1;7;1978;1405;1405;1;0;0;7;9;1978;0;4169;9;3;
/org.eclipse.team.tests.cvs.core/src/org/eclipse/team/tests/ccvs/core/CVSClientException.java;1;0;2;1;0;0;0;2;15;0;1;3086;15;15;2;1;0;2;2;3086;1;3086;1;1;
/org.eclipse.jdt.ui/core refactoring/org/eclipse/jdt/internal/corext/refactoring/util/GenericVisitor.java;3;0;7;1;0;0;0;7;38;1;7;1939;71;71;1;0;0;7;7;1939;0;3357;7;3;
/org.eclipse.ui.tests/Eclipse UI Tests/org/eclipse/ui/tests/adaptable/AdaptableDecoratorTestCase.java;1;1;3;1;2;2;2;1;6;0;1;2863;9;9;1;0;0;1;3;2863;0;4007;3;1;
/org.eclipse.jdt.ui.tests.refactoring/resources/RenameType/testFail47/in/A.java;1;0;1;1;0;0;0;1;0;0;1;49;0;0;1;0;0;1;1;49;0;49;1;1;
/org.eclipse.jdt.debug/eval/org/eclipse/jdt/internal/debug/eval/ast/EvaluationArrayVariable.java;1;0;3;1;0;0;0;3;2;1;3;3329;2;2;1;0;0;3;3;3329;0;3421;3;1;
/org.eclipse.debug.ui/ui/org/eclipse/debug/ui/IDebugUIEventFilter.java;2;0;3;1;0;0;0;3;5;1;3;187;5;5;1;0;0;3;3;187;0;3492;3;2;
/org.eclipse.scripting/Eclipse Scripting/org/eclipse/scripting/ScriptRunner.java;2;0;4;1;0;0;0;4;7;1;4;133;9;9;1;0;0;4;4;133;0;1424;4;2;
/org.eclipse.swt/Eclipse SWT/win32/org/eclipse/swt/widgets/List.java;10;2;16;1;4;3;4;12;129;1;12;106;319;319;2;0;1;12;16;4557;1;4701;15;10;
/org.eclipse.jdt.ui/core refactoring/org/eclipse/jdt/internal/corext/refactoring/structure/ParameterOffsetFinder.java;1;0;3;1;0;0;0;3;206;1;3;2630;220;220;1;0;0;3;3;2630;0;3082;3;1;
/org.eclipse.swt/Eclipse SWT/win32/org/eclipse/swt/internal/win32/MEASUREITEMSTRUCT.java;2;0;3;1;0;0;0;3;5;1;3;106;5;5;1;0;0;3;3;106;0;2069;3;2;
/org.eclipse.jdt.ui/ui/org/eclipse/jdt/internal/ui/jarpackager/JavaElementContentProvider.java;2;0;10;1;0;0;0;10;45;2;8;320;91;91;2;2;0;10;10;343;2;902;8;2;
/org.eclipse.jdt.ui.tests.refactoring/resources/SelectionAnalyzerWorkSpace/SelectionAnalyzerTests/validSelection/A_test263.java;1;0;1;1;0;0;0;1;0;0;1;1368;0;0;1;0;0;1;1;1368;0;1368;1;1;
/org.eclipse.ui/Eclipse UI Tool Script/org/eclipse/toolscript/core/internal/ToolScript.java;1;2;12;1;12;7;12;0;79;0;0;3920;248;248;2;0;5;0;12;3953;5;4083;7;1;
/org.eclipse.jdt.core/batch/org/eclipse/jdt/internal/compiler/batch/CompilationUnit.java;2;0;14;1;1;1;1;13;131;4;10;455;295;295;4;3;0;13;14;1039;3;4061;11;2;
/org.eclipse.ant.ui/src/org/eclipse/ant/internal/ui/AntLaunchDialog.java;2;0;4;2;0;0;0;4;47;3;2;276;47;47;3;2;0;4;4;296;2;296;2;2;
/org.eclipse.pde.ui/src/org/eclipse/pde/internal/wizards/project/NewProjectWizard.java;2;0;5;1;0;0;0;5;8;2;4;1434;13;13;2;1;0;5;5;3035;1;3579;4;2;
/org.eclipse.jdt.core/codeassist/org/eclipse/jdt/internal/codeassist/complete/CompletionParser.java;3;2;35;2;4;3;4;31;2083;5;24;455;2697;2697;5;7;1;31;35;1034;8;4062;27;3;
/org.eclipse.ui/Eclipse UI/org/eclipse/ui/part/IPageSite.java;1;0;2;1;0;0;0;2;34;1;2;1779;34;34;1;0;0;2;2;1779;0;3633;2;1;
/org.eclipse.jdt.debug/jdi/org/eclipse/jdi/internal/CharTypeImpl.java;2;0;4;1;0;0;0;4;13;1;4;187;27;27;1;0;0;4;4;187;0;3670;4;2;
/org.eclipse.vcm.core.cvs/src/org/eclipse/vcm/internal/core/ccvs/StateId.java;3;0;3;1;0;0;0;3;5;1;3;0;7;7;1;0;0;3;3;0;0;1499;3;3;
/org.eclipse.swt/Eclipse SWT/photon/org/eclipse/swt/widgets/Caret.java;6;1;11;1;4;4;4;7;252;2;6;106;380;380;2;1;0;7;11;2064;1;4701;10;6;
/org.eclipse.jdt.ui.tests.refactoring/resources/MoveMembers/test22/out/A.java;1;0;1;1;0;0;0;1;0;0;1;2738;0;0;1;0;0;1;1;2738;0;2738;1;1;
/org.eclipse.jdt.debug.tests/testprograms/TestIO.java;2;0;2;1;1;1;1;1;11;0;1;3719;11;11;1;0;0;1;2;3719;0;4571;2;2;
/org.eclipse.jdt.debug/eval/org/eclipse/jdt/internal/debug/eval/model/IType.java;2;0;2;1;0;0;0;2;0;1;2;3555;0;0;1;0;0;2;2;3555;0;3645;2;2;
/org.eclipse.swt.tests/JUnit Tests/org/eclipse/swt/tests/junit/Test_org_eclipse_swt_widgets_FontDialog.java;2;0;2;1;1;1;1;1;6;0;1;1792;6;6;1;0;0;1;2;1792;0;4706;2;2;
/org.eclipse.team.ui/src/org/eclipse/team/internal/ui/target/TargetProjectAction.java;3;1;4;1;4;4;4;0;10;0;0;4155;14;14;1;0;0;0;4;4155;0;4636;4;3;
/org.eclipse.team.core/src/org/eclipse/team/core/internal/FileModificationValidator.java;3;0;9;2;0;0;0;9;90;2;7;2155;179;179;2;2;0;9;9;2155;2;3514;7;3;
/org.eclipse.swt/Eclipse SWT/win32/org/eclipse/swt/internal/win32/BROWSEINFO.java;2;0;3;1;0;0;0;3;5;1;3;106;5;5;1;0;0;3;3;106;0;2069;3;2;
/org.eclipse.pde.build/src/org/eclipse/pde/core/internal/ant/Condition.java;1;0;2;1;0;0;0;2;0;1;2;3128;0;0;1;0;0;2;2;3128;0;3194;2;1;
/org.eclipse.ui/Eclipse UI/org/eclipse/ui/IResourceContributorProvider.java;1;0;2;1;0;0;0;2;0;1;2;2082;0;0;1;0;0;2;2;2082;0;2099;2;1;
/org.eclipse.jdt.ui/ui/org/eclipse/jdt/internal/ui/text/correction/CUCorrectionProposal.java;4;2;12;1;4;3;4;8;43;1;8;3306;127;127;2;0;1;8;12;4451;1;4621;11;4;
/org.eclipse.ui/Eclipse JFace/org/eclipse/jface/viewers/IInputSelectionProvider.java;2;0;2;1;0;0;0;2;5;1;2;257;5;5;1;0;0;2;2;257;0;457;2;2;
/org.eclipse.jdt.junit/Eclipse JUnit/org/eclipse/jdt/internal/junit/ui/RemoteTestRunnerClient.java;2;0;5;1;0;0;0;5;154;1;5;2007;194;194;1;0;0;5;5;2007;0;3313;5;2;
/org.eclipse.pde.ui/Eclipse PDE UI/org/eclipse/pde/internal/editor/component/ReferencePropertySource.java;2;0;5;2;0;0;0;5;12;3;3;267;12;12;3;2;0;5;5;324;2;1434;3;2;
/org.eclipse.core.resources/src_ant/org/eclipse/core/resources/ant/Policy.java;2;0;4;1;1;1;1;3;51;1;3;3509;70;70;1;0;0;3;4;3509;0;4214;4;2;
/org.eclipse.jdt.ui/core refactoring/org/eclipse/jdt/core/refactoring/fields/SafeDeletePrivateFieldRefactoring.java;1;0;2;1;0;0;0;2;0;1;2;15;0;0;1;0;0;2;2;15;0;47;2;1;
/org.eclipse.swt.examples/src/org/eclipse/swt/examples/controlexample/ButtonTab.java;5;1;7;1;3;3;3;4;307;1;4;513;576;576;1;0;0;4;7;513;0;4705;7;5;
/org.eclipse.swt/Eclipse SWT/photon/org/eclipse/swt/internal/photon/PhRect_t.java;2;0;3;1;0;0;0;3;6;1;3;106;6;6;1;0;0;3;3;106;0;2069;3;2;
/org.eclipse.swt.examples.controls/org/eclipse/swt/examples/controls/TableTab.java;2;0;3;1;0;0;0;3;172;1;3;513;172;172;1;0;0;3;3;513;0;970;3;2;
/org.eclipse.pde.ui/src/org/eclipse/pde/internal/core/builders/FeatureConsistencyChecker.java;1;0;3;1;0;0;0;3;2;1;3;3579;2;2;1;0;0;3;3;3579;0;3607;3;1;
/org.eclipse.core.tests.runtime/src/org/eclipse/core/tests/internal/plugins/PluginResolveTest_19.java;3;0;3;1;0;0;0;3;110;1;3;1794;120;120;1;0;0;3;3;1794;0;3476;3;3;
/org.eclipse.update.ui.forms/src/org/eclipse/update/ui/forms/FormLabel.java;1;0;2;1;0;0;0;2;0;1;2;1980;0;0;1;0;0;2;2;1980;0;2474;2;1;
/org.eclipse.core.resources/src/org/eclipse/core/internal/resources/MarkerAttributeMap.java;2;0;6;1;1;1;1;5;84;1;5;1018;139;139;1;0;0;5;6;1018;0;4213;6;2;
/org.eclipse.pde.core/src/org/eclipse/pde/internal/core/builders/DependencyLoopFinder.java;1;0;3;1;0;0;0;3;11;1;3;3591;11;11;1;0;0;3;3;3591;0;3631;3;1;
/org.eclipse.jdt.ui/ui/org/eclipse/jdt/internal/ui/jarpackager/JarManifestWizardPage.java;6;1;46;2;4;4;4;42;218;3;33;239;1067;1067;3;9;0;42;46;410;9;4627;37;6;
/org.eclipse.update.core/src/org/eclipse/update/internal/core/SiteFileNonPluginContentConsumer.java;2;1;7;1;2;2;2;5;54;1;5;2551;97;97;1;0;0;5;7;2551;0;4747;7;2;
/org.eclipse.ui/Eclipse JFace Text/org/eclipse/jface/text/reconciler/DirtyRegionQueue.java;3;0;3;1;0;0;0;3;5;1;3;257;10;10;1;0;0;3;3;257;0;1066;3;3;
/org.eclipse.jdt.ui/ui refactoring/org/eclipse/jdt/internal/ui/refactoring/RefactoringWizard.java;4;1;33;1;4;4;4;29;83;4;24;15;493;493;4;5;0;29;33;144;5;4598;28;4;
/org.eclipse.pde.core/src/org/eclipse/pde/internal/core/ischema/ISchemaDescriptor.java;1;0;2;1;0;0;0;2;8;1;2;3591;8;8;1;0;0;2;2;3591;0;3607;2;1;
/org.eclipse.team.cvs.ui/src/org/eclipse/team/internal/ccvs/ui/AvoidableMessageDialog.java;2;0;3;1;1;1;1;2;63;1;2;3653;65;65;1;0;0;2;3;3653;0;3957;3;2;
/org.eclipse.update.core/src/org/eclipse/update/examples/buildzip/BuildZipContentProvider.java;1;0;1;1;0;0;0;1;0;0;1;2472;0;0;1;0;0;1;1;2472;0;2472;1;1;
/org.eclipse.update.core/src/org/eclipse/update/internal/core/DefaultSiteParser.java;1;0;17;1;0;0;0;17;253;3;11;1531;722;722;3;6;0;17;17;1577;6;1791;11;1;
/org.eclipse.jdt.ui/core extension/org/eclipse/jdt/internal/corext/textmanipulation/MultiTextEdit.java;1;0;4;1;0;0;0;4;49;1;4;2137;55;55;1;0;0;4;4;2137;0;2512;4;1;
/org.eclipse.jdt.ui.tests.refactoring/resources/RenameVariables/canRename/A_test29_out.java;1;0;2;1;0;0;0;2;0;1;2;724;0;0;1;0;0;2;2;724;0;1665;2;1;
/org.eclipse.swt/Eclipse SWT/win32/org/eclipse/swt/internal/win32/CREATESTRUCT.java;2;0;3;1;0;0;0;3;5;1;3;106;5;5;1;0;0;3;3;106;0;2069;3;2;
/org.eclipse.swt/Eclipse SWT/win32/org/eclipse/swt/widgets/Decorations.java;7;2;44;2;8;7;8;36;231;2;30;106;1225;1225;2;6;1;36;44;1699;7;4701;37;7;
/org.eclipse.pde.ui/src/org/eclipse/pde/internal/core/ifeature/IFeatureURLElement.java;1;0;2;1;0;0;0;2;0;1;2;3591;0;0;1;0;0;2;2;3591;0;3607;2;1;
/org.eclipse.jdt.ui.tests.refactoring/resources/RenameParameters/cannotRename/A_testFail19.java;1;0;1;1;0;0;0;1;0;0;1;233;0;0;1;0;0;1;1;233;0;233;1;1;
/org.eclipse.swt/Eclipse SWT Accessibility/common/org/eclipse/swt/accessibility/AccessibleControlEvent.java;2;0;6;1;1;1;1;5;51;2;4;2781;67;67;2;1;0;5;6;3007;1;4701;5;2;
/org.eclipse.core.target/src/org/eclipse/core/internal/target/filesystem/PushTargetVisitor.java;1;0;3;1;0;0;0;3;6;1;3;12;6;6;1;0;0;3;3;12;0;713;3;1;
/org.eclipse.jdt.ui.tests.refactoring/resources/MoveMembers/testFail18/in/A.java;1;0;1;1;0;0;0;1;0;0;1;2738;0;0;1;0;0;1;1;2738;0;2738;1;1;
/org.eclipse.ui/Eclipse UI/org/eclipse/ui/internal/EditorSite.java;5;0;11;2;0;0;0;11;23;2;10;257;74;74;2;1;0;11;11;3052;1;3631;10;5;
/org.eclipse.swt/Eclipse SWT/gtk/org/eclipse/swt/widgets/FileDialog.java;4;1;16;1;5;5;5;11;247;3;8;2107;754;754;3;3;0;11;16;3780;3;4701;13;4;
/org.eclipse.jdt.ui.tests.refactoring/test cases/org/eclipse/jdt/ui/tests/refactoring/AbstractSelectionTestCase.java;2;0;7;2;0;0;0;7;50;2;6;1896;102;102;2;1;0;7;7;2583;1;3811;6;2;
/org.eclipse.jdt.debug/model/org/eclipse/jdt/debug/core/IJavaTargetPatternBreakpoint.java;2;0;3;1;0;0;0;3;24;1;3;3488;38;38;1;0;0;3;3;3488;0;3573;3;2;
/org.eclipse.jdt.ui/ui/org/eclipse/jdt/internal/ui/actions/CheckedTreeSelectionDialog.java;2;1;2;1;2;2;2;0;4;0;0;4465;4;4;1;0;0;0;2;4465;0;4643;2;2;
/org.eclipse.jdt.ui/ui/org/eclipse/jdt/ui/actions/JdtActionConstants.java;4;1;8;1;7;7;7;1;207;0;1;3716;346;346;1;0;0;1;8;3716;0;4770;8;4;
/org.eclipse.jdt.ui/core refactoring/org/eclipse/jdt/internal/core/refactoring/nls/NLSHolder.java;2;0;2;1;0;0;0;2;0;1;2;1922;0;0;1;0;0;2;2;1922;0;1939;2;2;
/org.eclipse.jdt.ui/ui refactoring/org/eclipse/jdt/internal/ui/refactoring/nls/search/NLSGroupByKeyComputer.java;2;0;3;1;0;0;0;3;4;2;2;3527;6;6;2;1;0;3;3;3527;1;3568;2;2;
/org.eclipse.team.cvs.core/src/org/eclipse/team/internal/ccvs/core/syncinfo/CacheData.java;1;0;2;1;0;0;0;2;0;1;2;2690;0;0;1;0;0;2;2;2690;0;3125;2;1;
/org.eclipse.jdt.ui.tests.refactoring/resources/ExtractTemp/cannotExtract/A_testFail0.java;1;0;1;1;0;0;0;1;0;0;1;2481;0;0;1;0;0;1;1;2481;0;2481;1;1;
/org.eclipse.pde.ui/src/org/eclipse/pde/internal/editor/manifest/FragmentManifestEditor.java;2;0;5;1;0;0;0;5;3;1;5;1434;7;7;1;0;0;5;5;1434;0;3579;5;2;
/org.eclipse.pde.ui/Eclipse PDE UI/org/eclipse/pde/internal/model/WorkspaceResourceHelper.java;2;0;6;2;0;0;0;6;207;3;4;267;220;220;3;2;0;6;6;324;2;1434;4;2;
/org.eclipse.jdt.ui/ui/org/eclipse/jdt/internal/ui/reorg/StructuredSelectionUtil.java;1;0;3;1;0;0;0;3;32;1;3;3167;35;35;1;0;0;3;3;3167;0;3739;3;1;
/org.eclipse.pde.ui/src/org/eclipse/pde/internal/ui/wizards/project/PluginClassCodeGenerator.java;1;0;1;1;0;0;0;1;0;0;1;3579;0;0;1;0;0;1;1;3579;0;3579;1;1;
/org.eclipse.jdt.core/compiler/org/eclipse/jdt/internal/compiler/ast/FloatLiteral.java;2;0;4;1;1;1;1;3;126;1;3;455;142;142;1;0;0;3;4;455;0;4062;4;2;
/org.eclipse.jdt.ui.tests.refactoring/resources/ExtractMethodWorkSpace/ExtractMethodTests/validSelection/A_test311.java;2;1;3;1;2;2;2;1;12;0;1;195;12;12;1;0;0;1;3;195;0;4419;3;2;
/org.eclipse.swt/Eclipse SWT/gtk1x/org/eclipse/swt/widgets/FontDialog.java;4;0;6;1;1;1;1;5;6;1;5;2107;15;15;1;0;0;5;6;2107;0;4701;6;4;
/org.eclipse.jdt.ui/ui/org/eclipse/jdt/internal/ui/actions/AddWatchpointAction.java;3;0;5;1;0;0;0;5;42;1;5;965;56;56;1;0;0;5;5;965;0;2217;5;3;
/org.eclipse.jdt.ui/ui/org/eclipse/jdt/ui/JavaElementLabelProvider.java;5;0;23;1;1;1;1;22;118;3;19;15;369;369;3;3;0;22;23;2581;3;4810;20;5;
/org.eclipse.vcm.ui.cvs/src/org/eclipse/vcm/internal/ui/ccvs/CVSPreferencesPage.java;1;0;6;1;0;0;0;6;149;1;6;977;274;274;1;0;0;6;6;977;0;1578;6;1;
/org.eclipse.jdt.debug.ui/ui/org/eclipse/jdt/internal/debug/ui/actions/BreakpointHitCountAction.java;2;1;13;1;2;2;2;11;105;2;9;1915;208;208;2;2;0;11;13;2720;2;4552;11;2;
/org.eclipse.jdt.debug/eval/org/eclipse/jdt/internal/debug/eval/ast/instructions/CompoundInstruction.java;1;0;2;1;0;0;0;2;3;1;2;3421;3;3;1;0;0;2;2;3421;0;3505;2;1;
/org.eclipse.jdt.ui.tests.refactoring/resources/RenameType/testFail79/in/A.java;1;0;1;1;0;0;0;1;0;0;1;49;0;0;1;0;0;1;1;49;0;49;1;1;
/org.eclipse.core.resources/src/org/eclipse/core/internal/indexing/ObjectID.java;3;0;5;1;1;1;1;4;100;1;4;12;155;155;1;0;0;4;5;12;0;4214;5;3;
/org.eclipse.jdt.ui.tests.refactoring/resources/RenameTemp/canRename/A_test36_out.java;1;0;2;1;0;0;0;2;2;1;2;2876;2;2;1;0;0;2;2;2876;0;3086;2;1;
/org.eclipse.core.boot/src/org/eclipse/core/internal/boot/update/LogStringReader.java;2;0;3;1;0;0;0;3;4;1;3;12;4;4;1;0;0;3;3;12;0;2726;3;2;
/org.eclipse.jdt.core/model/org/eclipse/jdt/internal/core/ImportContainer.java;3;1;11;1;2;2;2;9;129;4;6;455;211;211;4;3;0;9;11;1039;3;4322;8;3;
/org.eclipse.ui/Eclipse UI/org/eclipse/ui/internal/dialogs/RemoveCapabilityWizard.java;1;0;1;1;0;0;0;1;0;0;1;3506;0;0;1;0;0;1;1;3506;0;3506;1;1;
/org.eclipse.vcm.ui/src/org/eclipse/vcm/internal/ui/merge/MergeAction.java;2;0;4;1;0;0;0;4;12;1;4;1;24;24;1;0;0;4;4;1;0;370;4;2;
/org.eclipse.ui/Eclipse UI Text Editor/org/eclipse/ui/texteditor/SelectRulerAction.java;1;1;3;1;2;2;2;1;12;0;1;3592;17;17;1;0;0;1;3;3592;0;4838;3;1;
/org.eclipse.swt/Eclipse SWT PI/gtk1x/org/eclipse/swt/internal/gtk/GtkDialog.java;2;0;2;1;1;1;1;1;3;0;1;2107;3;3;1;0;0;1;2;2107;0;4701;2;2;
/org.eclipse.ui/Eclipse UI/org/eclipse/ui/internal/registry/ActionSetCategory.java;2;0;2;1;0;0;0;2;16;1;2;257;16;16;1;0;0;2;2;257;0;457;2;2;
/org.eclipse.jdt.ui/ui/org/eclipse/jdt/internal/ui/util/StringMatcher.java;3;0;6;1;0;0;0;6;260;1;6;15;401;401;1;0;0;6;6;15;0;2935;6;3;
/org.eclipse.core.tests.runtime/src/org/eclipse/core/tests/runtime/StatusTest.java;3;0;3;1;0;0;0;3;362;1;3;1794;372;372;1;0;0;3;3;1794;0;3476;3;3;
/org.eclipse.scripting/src/org/eclipse/scripting/internal/uirenderer/XGRElementUISwtGroupBox.java;1;0;1;1;0;0;0;1;0;0;1;1424;0;0;1;0;0;1;1;1424;0;1424;1;1;
/org.eclipse.update.ui/src/org/eclipse/update/internal/ui/model/MyComputer.java;2;1;9;1;2;2;2;7;61;2;6;2797;136;136;2;1;0;7;9;3532;1;4028;8;2;
/org.eclipse.ui/Eclipse UI/org/eclipse/ui/internal/TextActionHandler.java;5;0;9;1;0;0;0;9;141;2;7;257;199;199;2;2;0;9;9;1436;2;3105;7;5;
/org.eclipse.swt.examples/src/org/eclipse/swt/examples/explorer/TableView.java;1;0;1;1;0;0;0;1;0;0;1;547;0;0;1;0;0;1;1;547;0;547;1;1;
/org.eclipse.debug.ui/ui/org/eclipse/debug/internal/ui/views/variables/VariablesView.java;3;1;7;1;7;7;7;0;1738;0;0;3975;1765;1765;1;0;0;0;7;3975;0;4708;7;3;
/org.eclipse.swt/Eclipse SWT/gtk1x/org/eclipse/swt/widgets/Combo.java;5;0;6;2;1;1;1;5;254;2;3;2107;276;276;2;2;0;5;6;2107;2;4701;4;5;
/org.eclipse.ui/Eclipse JFace Text/org/eclipse/jface/text/formatter/ContentFormatter.java;3;0;4;1;0;0;0;4;504;1;4;257;935;935;1;0;0;4;4;257;0;1066;4;3;
/org.eclipse.swt/Eclipse SWT OLE Win32/win32/org/eclipse/swt/internal/ole/win32/IOleInPlaceObject.java;2;0;3;1;0;0;0;3;5;1;3;106;5;5;1;0;0;3;3;106;0;2069;3;2;
/org.eclipse.jdt.ui.tests.refactoring/resources/PullUpMethods/testFail9/in/A.java;1;0;2;1;0;0;0;2;0;1;2;2156;0;0;1;0;0;2;2;2156;0;2406;2;1;
/org.eclipse.pde.ui/src/org/eclipse/pde/internal/wizards/imports/UpdateBuildpathWizard.java;1;0;4;1;0;0;0;4;2;1;4;2650;4;4;1;0;0;4;4;2650;0;3579;4;1;
/org.eclipse.jdt.ui/ui refactoring/org/eclipse/jdt/internal/ui/refactoring/PullUpMethodsWizard.java;1;0;2;1;0;0;0;2;0;1;2;2270;0;0;1;0;0;2;2;2270;0;2406;2;1;
/org.eclipse.swt/Eclipse SWT Drag and Drop/common/org/eclipse/swt/dnd/DropTargetListener.java;4;1;8;1;2;2;2;6;278;1;6;106;345;345;1;0;0;6;8;106;0;4824;8;4;
/org.eclipse.jdt.ui/core extension/org/eclipse/jdt/internal/corext/codegeneration/CodeGenerationMessages.java;2;0;2;1;0;0;0;2;0;1;2;2016;0;0;1;0;0;2;2;2016;0;2137;2;2;
/org.eclipse.core.runtime/src/org/eclipse/core/internal/runtime/URLTool.java;4;0;5;2;2;1;2;3;964;1;3;12;1082;1082;2;0;1;3;5;4213;1;4213;4;4;
/org.eclipse.jdt.core/compiler/org/eclipse/jdt/internal/compiler/ast/DoubleLiteral.java;2;0;4;1;1;1;1;3;118;1;3;455;134;134;1;0;0;3;4;455;0;4062;4;2;
/org.eclipse.update.ui/src/org/eclipse/update/ui/internal/model/SiteCategory.java;1;0;6;1;0;0;0;6;57;1;6;1630;77;77;1;0;0;6;6;1630;0;2797;6;1;
/org.eclipse.ui/src-workbench/org/eclipse/ui/internal/SystemSummaryActionDelegate.java;1;0;2;1;2;1;2;0;0;0;0;4386;0;0;2;0;1;0;2;4386;1;4386;1;1;
/org.eclipse.swt.tests/JUnit Tests/org/eclipse/swt/tests/junit/Test_org_eclipse_swt_widgets_TableColumn.java;2;0;2;1;1;1;1;1;6;0;1;1792;6;6;1;0;0;1;2;1792;0;4706;2;2;
/org.eclipse.jdt.ui/core refactoring/org/eclipse/jdt/internal/core/refactoring/changes/MoveCompilationUnitChange.java;2;0;2;1;0;0;0;2;0;1;2;1342;0;0;1;0;0;2;2;1342;0;1939;2;2;
/org.eclipse.scripting/Eclipse Scripting/org/eclipse/scripting/internal/uirenderer/XGR.java;2;0;4;1;0;0;0;4;77;1;4;133;81;81;1;0;0;4;4;133;0;1424;4;2;
/org.eclipse.jdt.ui.tests.refactoring/resources/RenameMethodInInterface/testFail44/in/A.java;1;0;1;1;0;0;0;1;0;0;1;1258;0;0;1;0;0;1;1;1258;0;1258;1;1;
/org.eclipse.jdt.core/model/org/eclipse/jdt/core/util/IInnerClassesAttribute.java;2;2;6;1;5;4;5;1;20;0;1;3629;42;42;2;0;1;1;6;4058;1;4573;5;2;
/org.eclipse.swt/Eclipse SWT/win32/org/eclipse/swt/widgets/ToolBar.java;10;2;33;2;7;6;7;26;88;2;23;106;671;671;2;3;1;26;33;1696;4;4708;29;10;
/org.eclipse.jdt.debug.tests/tests/org/eclipse/jdt/debug/tests/eval/LongAssignmentOperatorsTests.java;2;2;3;2;3;2;3;0;18;0;0;4447;20;20;2;0;1;0;3;4447;1;4571;2;2;
/org.eclipse.jdt.ui.tests/JUnit/junit/tests/ExtensionTest.java;2;0;2;1;0;0;0;2;0;1;2;49;0;0;1;0;0;2;2;49;0;1186;2;2;
/org.eclipse.jdt.ui.tests.refactoring/resources/RenamePrivateField/testFail1/in/A.java;1;0;1;1;0;0;0;1;0;0;1;49;0;0;1;0;0;1;1;49;0;49;1;1;
/org.eclipse.scripting/Eclipse Scripting/org/eclipse/scripting/internal/ScriptReaderLineInputStream.java;2;0;6;1;0;0;0;6;10;1;6;133;26;26;1;0;0;6;6;133;0;1424;6;2;
/org.eclipse.jdt.core/model/org/eclipse/jdt/internal/core/util/LocalVariableAttribute.java;2;1;5;1;3;3;3;2;19;0;1;3629;41;41;2;1;0;2;5;3629;1;4422;4;2;
/org.eclipse.jdt.ui.tests.refactoring/test cases/AllAllTests.java;2;0;2;1;0;0;0;2;0;1;2;2062;0;0;1;0;0;2;2;2062;0;2279;2;2;
/org.eclipse.swt.examples.controls/org/eclipse/swt/examples/controls/ButtonTab.java;2;0;3;1;0;0;0;3;181;1;3;513;181;181;1;0;0;3;3;513;0;970;3;2;
/org.eclipse.core.tests.runtime/src/org/eclipse/core/tests/internal/plugin/a/Dummy.java;3;0;3;1;0;0;0;3;16;1;3;1794;26;26;1;0;0;3;3;1794;0;3476;3;3;
/org.eclipse.jdt.core/codeassist/org/eclipse/jdt/internal/codeassist/complete/CompletionOnQualifiedTypeReference.java;3;0;10;1;1;1;1;9;75;4;6;455;147;147;4;3;0;9;10;1039;3;4062;7;3;
/org.eclipse.jdt.core/compiler/org/eclipse/jdt/internal/compiler/ast/AllocationExpression.java;2;1;15;1;2;2;2;13;392;4;10;455;955;955;4;3;0;13;15;1039;3;4418;12;2;
/org.eclipse.jdt.ui.tests.refactoring/resources/RenameVirtualMethodInClass/testFail36/in/A.java;1;0;1;1;0;0;0;1;0;0;1;49;0;0;1;0;0;1;1;49;0;49;1;1;
/org.eclipse.update.ui.forms/src/org/eclipse/update/ui/forms/ScrollableSectionForm.java;1;0;2;1;0;0;0;2;0;1;2;1542;0;0;1;0;0;2;2;1542;0;2474;2;1;
/org.eclipse.scripting/Eclipse Scripting/org/eclipse/scripting/IStringData.java;1;0;3;1;0;0;0;3;7;1;3;133;7;7;1;0;0;3;3;133;0;1424;3;1;
/org.eclipse.jdt.ui/ui/org/eclipse/jdt/internal/ui/javadocexport/JavadocLinkDialogLabelProvider.java;3;1;6;1;3;3;3;3;6;1;3;3717;18;18;1;0;0;3;6;3717;0;4621;6;3;
/org.eclipse.update/Eclipse Update/org/eclipse/update/internal/core/UMSessionManager.java;1;0;3;1;0;0;0;3;4;1;3;108;4;4;1;0;0;3;3;108;0;1424;3;1;
/org.eclipse.update.ui/src/org/eclipse/update/ui/internal/model/MyComputer.java;1;0;2;1;0;0;0;2;0;1;2;2651;0;0;1;0;0;2;2;2651;0;2797;2;1;
/org.eclipse.scripting/src/org/eclipse/scripting/internal/views/ScriptUIEditorEnvironment.java;1;0;1;1;0;0;0;1;0;0;1;1424;0;0;1;0;0;1;1;1424;0;1424;1;1;
/org.eclipse.jdt.ui/nls/org/eclipse/jdt/internal/ui/nls/search/NLSSearchResultLabelProvider.java;1;0;2;1;0;0;0;2;0;1;2;1880;0;0;1;0;0;2;2;1880;0;1913;2;1;
/org.eclipse.swt/Eclipse SWT/gtk/org/eclipse/swt/widgets/Canvas.java;4;1;14;1;4;4;4;10;207;2;8;2107;526;526;2;2;0;10;14;3574;2;4701;12;4;
/org.eclipse.jdt.debug/model/org/eclipse/jdt/internal/debug/core/ThreadEvaluationContext.java;2;0;16;1;0;0;0;16;344;1;16;187;528;528;1;0;0;16;16;187;0;2381;16;2;
/org.eclipse.pde.ui/src/org/eclipse/pde/internal/ui/preferences/TargetEnvironmentPreferencePage.java;1;0;2;1;1;1;1;1;56;0;1;3579;56;56;1;0;0;1;2;3579;0;4221;2;1;
/org.eclipse.core.tests.runtime/src/org/eclipse/core/tests/internal/plugins/SoftPrereqTest_18.java;3;0;3;1;0;0;0;3;94;1;3;1794;104;104;1;0;0;3;3;1794;0;3476;3;3;
/org.eclipse.team.cvs.ui/src/org/eclipse/team/internal/ccvs/ui/CVSFolderPropertiesPage.java;2;0;3;1;1;1;1;2;2;1;2;3679;4;4;1;0;0;2;3;3679;0;4829;3;2;
/org.eclipse.jdt.junit/Eclipse JUnit/org/eclipse/jdt/junit/util/CallHistory.java;2;0;2;1;0;0;0;2;0;1;2;1511;0;0;1;0;0;2;2;1511;0;1996;2;2;
/org.eclipse.jdt.debug/eval/org/eclipse/jdt/internal/debug/eval/ast/engine/UnsignedRightShiftAssignmentOperator.java;1;0;2;1;0;0;0;2;0;1;2;3329;0;0;1;0;0;2;2;3329;0;3421;2;1;
/org.eclipse.core.tests.runtime/src/org/eclipse/core/tests/internal/plugin/a/ExtensionIndirectReferenceToPlugin.java;3;0;3;1;0;0;0;3;22;1;3;1794;32;32;1;0;0;3;3;1794;0;3476;3;3;
/org.eclipse.scripting/Eclipse Scripting/org/eclipse/scripting/internal/ScriptReaderFileSystemFile.java;2;0;4;1;0;0;0;4;4;1;4;133;7;7;1;0;0;4;4;133;0;1424;4;2;
/org.eclipse.jdt.core/compiler/org/eclipse/jdt/internal/compiler/flow/FlowContext.java;2;0;14;1;1;1;1;13;725;4;10;455;1523;1523;4;3;0;13;14;1039;3;4062;11;2;
/org.eclipse.pde.ui/src/org/eclipse/pde/internal/model/build/BuildEntry.java;2;0;5;1;0;0;0;5;4;1;5;1434;11;11;1;0;0;5;5;1434;0;3579;5;2;
/org.eclipse.jdt.ui/core refactoring/org/eclipse/jdt/internal/corext/refactoring/reorg/ICopyQueries.java;1;0;1;1;1;1;1;0;0;0;0;4212;0;0;1;0;0;0;1;4212;0;4212;1;1;
/org.eclipse.team.cvs.ui/src/org/eclipse/team/internal/ccvs/ui/CVSCompareEditorInput.java;3;1;21;3;2;2;2;19;712;2;16;2312;1316;1316;2;3;0;19;21;2312;3;4751;18;3;
/org.eclipse.swt/Eclipse SWT PI/gtk1x/org/eclipse/swt/internal/gtk/GtkCListRow.java;2;0;2;1;1;1;1;1;3;0;1;2107;3;3;1;0;0;1;2;2107;0;4701;2;2;
/org.eclipse.jdt.ui.tests.refactoring/resources/InlineTemp/cannotInline/A_testFail0.java;1;0;1;1;0;0;0;1;0;0;1;2015;0;0;1;0;0;1;1;2015;0;2015;1;1;
/org.eclipse.debug.ui/ui/org/eclipse/debug/ui/ILaunchWizard.java;2;0;4;1;0;0;0;4;5;1;4;187;6;6;1;0;0;4;4;187;0;3634;4;2;
/org.eclipse.jdt.ui.tests.refactoring/resources/RenameType/test8/out/A.java;1;0;2;1;0;0;0;2;0;1;2;49;0;0;1;0;0;2;2;49;0;522;2;1;
/org.eclipse.jdt.ui.tests.refactoring/resources/PullUpMethods/testFail7/in/B.java;1;0;2;1;0;0;0;2;0;1;2;2156;0;0;1;0;0;2;2;2156;0;2406;2;1;
/org.eclipse.swt/Eclipse SWT Drag and Drop/common/org/eclipse/swt/dnd/DND.java;2;1;7;1;3;3;3;4;142;1;4;106;171;171;1;0;0;4;7;106;0;4824;7;2;
/org.eclipse.ui/Eclipse UI Tool Script/org/eclipse/toolscript/core/internal/ToolScriptPlugin.java;1;1;4;1;4;4;4;0;33;0;0;3920;42;42;1;0;0;0;4;3920;0;4087;4;1;
/org.eclipse.jdt.ui.tests.refactoring/resources/SelectionAnalyzerWorkSpace/SelectionAnalyzerTests/validSelection/A_test309.java;1;0;1;1;0;0;0;1;0;0;1;1368;0;0;1;0;0;1;1;1368;0;1368;1;1;
/org.eclipse.jdt.ui.tests.refactoring/resources/MoveMembers/test23/in/A.java;1;0;1;1;0;0;0;1;0;0;1;2928;0;0;1;0;0;1;1;2928;0;2928;1;1;
/org.eclipse.jdt.core/codeassist/org/eclipse/jdt/internal/codeassist/complete/CompletionOnFieldType.java;2;0;4;1;1;1;1;3;37;1;3;455;57;57;1;0;0;3;4;455;0;4062;4;2;
/org.eclipse.ui.examples.javaeditor/Java Editor Example/org/eclipse/ui/examples/javaeditor/JavaDocumentProvider.java;1;0;2;1;0;0;0;2;0;0;1;1066;0;0;2;1;0;2;2;1066;1;1066;1;1;
/org.eclipse.debug.ui/ui/org/eclipse/debug/ui/IValueDetailListener.java;3;0;5;1;0;0;0;5;14;1;5;1805;26;26;1;0;0;5;5;1805;0;3492;5;3;
/org.eclipse.search/search/org/eclipse/search/internal/core/text/ITextSearchResultCollector.java;1;0;2;1;0;0;0;2;9;1;2;15;9;9;1;0;0;2;2;15;0;343;2;1;
/org.eclipse.jdt.debug/jdi/org/eclipse/jdi/internal/request/VMDeathRequestImpl.java;2;0;3;1;0;0;0;3;6;1;3;1801;8;8;1;0;0;3;3;1801;0;3670;3;2;
/org.eclipse.jdt.core/model/org/eclipse/jdt/internal/core/builder/impl/WorkQueue.java;1;0;10;1;0;0;0;10;163;4;6;455;217;217;4;4;0;10;10;1039;4;2808;6;1;
/org.eclipse.ui/Eclipse UI Standard Components/org/eclipse/ui/wizards/datatransfer/ResourceTreeAndListGroup.java;2;0;2;1;0;0;0;2;0;1;2;257;0;0;1;0;0;2;2;257;0;457;2;2;
/org.eclipse.core.resources/src/org/eclipse/core/internal/localstore/CoreFileSystemLibraryLinux.java;2;0;2;1;0;0;0;2;0;1;2;12;0;0;1;0;0;2;2;12;0;49;2;2;
/org.eclipse.ui/Eclipse UI/org/eclipse/ui/dialogs/MarkerResolutionSelectionDialog.java;1;1;4;1;2;2;2;2;31;1;2;2497;49;49;1;0;0;2;4;2497;0;4625;4;1;
/org.eclipse.jdt.ui.tests.refactoring/resources/RenameType/testFail71/in/A.java;1;0;1;1;0;0;0;1;0;0;1;49;0;0;1;0;0;1;1;49;0;49;1;1;
/org.eclipse.swt/Eclipse SWT AWT/win32/org/eclipse/swt/internal/awt/win32/SWT_AWT.java;2;1;6;1;3;3;3;3;61;1;3;106;114;114;1;0;0;3;6;106;0;4701;6;2;
/org.eclipse.jdt.core/model/org/eclipse/jdt/internal/core/JavaModel.java;3;3;40;2;12;9;12;28;1050;4;23;455;1646;1646;4;5;3;28;40;1039;8;4454;32;3;
/org.eclipse.jdt.core/codeassist/org/eclipse/jdt/internal/codeassist/select/SelectionOnSuperReference.java;2;0;9;1;1;1;1;8;35;4;5;455;73;73;4;3;0;8;9;1039;3;4062;6;2;
/org.eclipse.scripting/Eclipse Scripting/org/eclipse/scripting/internal/uirenderer/XGRElementUISwtButton.java;2;0;6;1;0;0;0;6;28;1;6;133;55;55;1;0;0;6;6;133;0;1424;6;2;
/org.eclipse.jdt.ui.tests.refactoring/resources/ExtractMethodWorkSpace/ExtractMethodTests/testing/F.java;1;1;3;1;2;2;2;1;18;0;1;2155;18;18;1;0;0;1;3;2155;0;4419;3;1;
/org.eclipse.update.ui/src/org/eclipse/update/ui/model/SiteBookmark.java;1;0;3;1;0;0;0;3;10;1;3;1460;10;10;1;0;0;3;3;1460;0;1526;3;1;
/org.eclipse.jdt.junit/src/org/eclipse/jdt/junit/wizards/Messages.java;2;0;4;1;0;0;0;4;6;2;3;3247;6;6;2;1;0;4;4;3396;1;3527;3;2;
/org.eclipse.jdt.core/eval/org/eclipse/jdt/internal/eval/CodeSnippetSingleNameReference.java;2;1;13;1;3;3;3;10;1050;2;9;455;1179;1179;2;1;0;10;13;2546;1;4062;12;2;
/org.eclipse.ui/Eclipse UI Standard Components/org/eclipse/ui/views/navigator/SortAndFilterActionFactory.java;2;0;4;1;1;1;1;3;6;1;3;1830;11;11;1;0;0;3;4;1830;0;4067;4;2;
/org.eclipse.swt/Eclipse SWT PI/win32/org/eclipse/swt/internal/ole/win32/OLECMD.java;2;0;2;1;1;1;1;1;6;0;1;2069;6;6;1;0;0;1;2;2069;0;4701;2;2;
/org.eclipse.swt/Eclipse SWT PI/win32/org/eclipse/swt/internal/win32/ACCEL.java;2;0;3;1;1;1;1;2;6;1;2;2069;8;8;1;0;0;2;3;2069;0;4701;3;2;
/org.eclipse.jdt.ui.tests.refactoring/resources/RenameMethodInInterface/test40/in/A.java;1;0;1;1;0;0;0;1;0;0;1;49;0;0;1;0;0;1;1;49;0;49;1;1;
/org.eclipse.jdt.ui.tests.refactoring/resources/ExtractMethodWorkSpace/ExtractMethodTests/expression_out/A_test609.java;1;1;3;1;2;2;2;1;0;0;1;1236;0;0;1;0;0;1;3;1236;0;4419;3;1;
/org.eclipse.jdt.ui/ui/org/eclipse/jdt/internal/ui/actions/OpenHierarchyAction.java;2;0;5;1;1;1;1;4;4;1;4;2546;8;8;1;0;0;4;5;2546;0;4454;5;2;
/org.eclipse.jdt.core/dom/org/eclipse/jdt/core/dom/VariableDeclaration.java;2;1;5;1;2;2;2;3;37;1;3;2669;65;65;1;0;0;3;5;2669;0;4453;5;2;
/org.eclipse.pde.ui/src/org/eclipse/pde/internal/component/FragmentListPage.java;2;0;3;1;0;0;0;3;2;1;3;1434;2;2;1;0;0;3;3;1434;0;2951;3;2;
/org.eclipse.team.tests.cvs.core/src/org/eclipse/team/tests/ccvs/core/provider/SyncElementTest.java;2;1;32;2;3;3;3;29;72;2;26;2536;415;415;2;3;0;29;32;2806;3;4544;29;2;
/org.eclipse.vcm.core.cvs.ssh/src/org/eclipse/vcm/internal/core/ccvs/ssh/Client.java;5;0;10;1;0;0;0;10;176;2;9;111;639;639;2;1;0;10;10;239;1;1640;9;5;
/org.eclipse.pde.ui/src/org/eclipse/pde/internal/editor/text/PDETagScanner.java;2;0;2;1;0;0;0;2;0;1;2;1434;0;0;1;0;0;2;2;1434;0;3579;2;2;
/org.eclipse.ui/Eclipse JFace Text/org/eclipse/jface/text/source/IVerticalRulerExtension.java;1;1;3;1;3;3;3;0;27;0;0;4038;32;32;1;0;0;0;3;4038;0;4838;3;1;
/org.eclipse.jdt.core/model/org/eclipse/jdt/internal/core/JavaElement.java;3;2;41;1;10;8;10;31;1083;4;26;455;1489;1489;4;5;2;31;41;1039;7;4521;34;3;
/org.eclipse.jdt.core/compiler/org/eclipse/jdt/internal/compiler/lookup/ProblemReasons.java;2;0;4;1;1;1;1;3;15;1;3;455;23;23;1;0;0;3;4;455;0;4062;4;2;
/org.eclipse.jdt.ui.tests.refactoring/resources/ExtractMethodWorkSpace/ExtractMethodTests/return_in/A_test708.java;1;1;3;1;2;2;2;1;18;0;1;887;18;18;1;0;0;1;3;887;0;4419;3;1;
/org.eclipse.jdt.debug/model/org/eclipse/jdt/internal/debug/core/JDIThisVariable.java;4;0;10;1;0;0;0;10;19;2;9;187;67;67;2;1;0;10;10;2010;1;2517;9;4;
/org.eclipse.swt/Eclipse SWT Custom Widgets/common/org/eclipse/swt/custom/LineBackgroundEvent.java;2;0;3;1;1;1;1;2;6;1;2;106;11;11;1;0;0;2;3;106;0;4701;3;2;
/org.eclipse.pde.ui/src/org/eclipse/pde/internal/model/plugin/PluginReference.java;1;0;2;1;0;0;0;2;0;1;2;3136;0;0;1;0;0;2;2;3136;0;3579;2;1;
/org.eclipse.jdt.ui/ui/org/eclipse/jdt/internal/ui/text/template/TemplateContentProvider.java;2;0;5;1;1;1;1;4;8;1;4;1469;21;21;1;0;0;4;5;1469;0;4401;5;2;
/org.eclipse.vcm.core/src/org/eclipse/vcm/internal/core/adapter/IReleaseListener.java;2;0;2;1;0;0;0;2;4;1;2;0;4;4;1;0;0;2;2;0;0;297;2;2;
/org.eclipse.jdt.debug.ui/ui/org/eclipse/jdt/debug/ui/launchConfigurations/JavaMainTab.java;2;1;5;1;5;5;5;0;12;0;0;4098;32;32;1;0;0;0;5;4098;0;4382;5;2;
/org.eclipse.jdt.ui.tests.refactoring/resources/RenameNonPrivateField/testFail0/in/A.java;1;0;1;1;0;0;0;1;0;0;1;49;0;0;1;0;0;1;1;49;0;49;1;1;
/org.eclipse.pde.ui/src/org/eclipse/pde/internal/parts/CheckboxTablePart.java;1;0;3;1;0;0;0;3;5;1;3;2981;5;5;1;0;0;3;3;2981;0;3579;3;1;
/org.eclipse.jdt.core/model/org/eclipse/jdt/core/util/DecodingFlag.java;1;0;3;1;0;0;0;3;27;2;2;3629;27;27;2;1;0;3;3;3629;1;3644;2;1;
/org.eclipse.jdt.ui.tests.refactoring/resources/ExtractTemp/canExtract/A_test8_in.java;1;0;1;1;0;0;0;1;0;0;1;2481;0;0;1;0;0;1;1;2481;0;2481;1;1;
/org.eclipse.jdt.core/codeassist/org/eclipse/jdt/internal/codeassist/complete/CompletionNodeFound.java;2;0;3;1;1;1;1;2;28;1;2;455;50;50;1;0;0;2;3;455;0;4062;3;2;
/org.eclipse.jdt.core/search/org/eclipse/jdt/core/search/IJavaSearchScope.java;3;2;9;1;4;3;4;5;104;1;5;455;142;142;2;0;1;5;9;4058;1;4422;8;3;
/org.eclipse.jdt.debug.ui/ui/org/eclipse/jdt/internal/debug/ui/launcher/ConnectTab.java;1;0;2;1;0;0;0;2;0;1;2;2556;0;0;1;0;0;2;2;2556;0;2586;2;1;
/org.eclipse.update.core/src/org/eclipse/update/core/JarEntryContentReference.java;2;0;4;1;0;0;0;4;102;1;4;2472;186;186;1;0;0;4;4;2472;0;3532;4;2;
/org.eclipse.ant.ui/src/org/eclipse/ant/internal/ui/AntPropertyChangeListener.java;3;0;4;1;0;0;0;4;72;1;4;677;89;89;1;0;0;4;4;677;0;3606;4;3;
/org.eclipse.ui/Eclipse UI/org/eclipse/ui/help/ViewContextComputer.java;3;0;4;1;0;0;0;4;11;1;4;257;17;17;1;0;0;4;4;257;0;3156;4;3;
/org.eclipse.jdt.debug/jdi interfaces/com/sun/jdi/PrimitiveValue.java;2;0;2;1;0;0;0;2;6;1;2;2704;6;6;1;0;0;2;2;2704;0;3033;2;2;
/org.eclipse.update.ui/src/org/eclipse/update/internal/ui/model/ISiteWrapper.java;1;0;2;1;0;0;0;2;0;1;2;2797;0;0;1;0;0;2;2;2797;0;2834;2;1;
/org.eclipse.core.boot/src/org/eclipse/core/internal/boot/update/LogEntry.java;3;0;4;2;0;0;0;4;14;2;3;12;14;14;2;1;0;4;4;323;1;2726;3;3;
/org.eclipse.jdt.ui.tests.refactoring/resources/RenameVariables/canRename/A_test0_out.java;1;0;2;1;0;0;0;2;0;1;2;724;0;0;1;0;0;2;2;724;0;1665;2;1;
/org.eclipse.jdt.ui.tests.refactoring/resources/PullUp/test2/out/A.java;1;0;1;1;0;0;0;1;0;0;1;2406;0;0;1;0;0;1;1;2406;0;2406;1;1;
/org.eclipse.jdt.ui/core refactoring/org/eclipse/jdt/internal/core/refactoring/rename/RenameTempRefactoring.java;2;0;8;1;0;0;0;8;25;2;5;1665;70;70;2;3;0;8;8;1665;3;1937;5;2;
/org.eclipse.jdt.ui.tests.refactoring/resources/AbstractField/can/A_test1_out.java;1;0;1;1;0;0;0;1;0;0;1;751;0;0;1;0;0;1;1;751;0;751;1;1;
/org.eclipse.core.runtime/src/org/eclipse/core/internal/plugins/PluginClassLoader.java;4;2;15;1;4;3;4;11;406;2;10;12;668;668;2;1;1;11;15;71;2;4212;13;4;
/org.eclipse.help.ui/Eclipse Help UI/org/eclipse/help/internal/ui/InfopopText.java;2;0;3;1;0;0;0;3;6;1;3;136;6;6;1;0;0;3;3;136;0;313;3;2;
/org.eclipse.jdt.junit/src/org/eclipse/jdt/internal/junit/ui/EnableStackFilterAction.java;2;1;5;1;3;3;3;2;23;1;2;3171;43;43;1;0;0;2;5;3171;0;4634;5;2;
/org.eclipse.swt/Eclipse SWT/common/org/eclipse/swt/internal/image/JPEGComment.java;2;0;3;1;1;1;1;2;6;1;2;106;10;10;1;0;0;2;3;106;0;4701;3;2;
/org.eclipse.swt/Eclipse SWT/win32/org/eclipse/swt/internal/win32/OS.java;8;0;19;2;0;0;0;19;5523;2;16;106;5881;5881;2;3;0;19;19;1086;3;2069;16;8;
/org.eclipse.ant.ui/src/org/eclipse/ant/internal/ui/RunAntActionDelegate.java;4;0;14;2;0;0;0;14;140;3;9;14;529;529;3;5;0;14;14;296;5;3606;9;4;
/org.eclipse.swt.tests/JUnit Tests/org/eclipse/swt/tests/junit/Test_org_eclipse_swt_custom_CTabItem.java;2;0;2;1;1;1;1;1;6;0;1;1792;6;6;1;0;0;1;2;1792;0;4706;2;2;
/org.eclipse.jdt.ui.tests.refactoring/resources/RenameType/test24/in/A.java;1;0;1;1;0;0;0;1;0;0;1;49;0;0;1;0;0;1;1;49;0;49;1;1;
/org.eclipse.vcm.core/src/org/eclipse/vcm/internal/core/ServerEvent.java;1;0;1;1;0;0;0;1;0;0;1;1033;0;0;1;0;0;1;1;1033;0;1033;1;1;
/org.eclipse.jdt.debug.tests/tests/org/eclipse/jdt/debug/tests/eval/TypeHierarchy_21_3.java;2;1;3;1;3;3;3;0;13;0;0;4447;15;15;1;0;0;0;3;4447;0;4571;3;2;
/org.eclipse.jdt.ui/ui/org/eclipse/jdt/internal/ui/wizards/JavaCapabilityWizard.java;2;0;5;1;1;1;1;4;8;1;4;3419;17;17;1;0;0;4;5;3419;0;4450;5;2;
/org.eclipse.jdt.ui.tests.refactoring/resources/RenameType/test5/out/B.java;1;0;1;1;0;0;0;1;0;0;1;522;0;0;1;0;0;1;1;522;0;522;1;1;
/org.eclipse.swt/Eclipse SWT/common/org/eclipse/swt/graphics/Rectangle.java;5;2;9;2;5;4;5;4;11;1;4;106;37;37;2;0;1;4;9;4279;1;4701;8;5;
/org.eclipse.jdt.core/compiler/org/eclipse/jdt/internal/compiler/lookup/Scope.java;4;1;33;1;3;3;3;30;12402;4;23;455;19818;19818;4;7;0;30;33;1039;7;4619;26;4;
/org.eclipse.team.cvs.ui/src/org/eclipse/team/internal/ccvs/ui/sync/ForceCommitSyncAction.java;3;2;17;2;8;6;8;9;91;1;9;3157;282;282;2;0;2;9;17;4005;2;4551;15;3;
/org.eclipse.ui.externaltools/External Tools/org/eclipse/ui/externaltools/internal/ui/ConfigurationDialog.java;1;2;6;1;6;5;6;0;44;0;0;4090;82;82;2;0;1;0;6;4188;1;4605;5;1;
/org.eclipse.update.tests.core/src/org/eclipse/update/tests/types/TestFeatureType.java;2;0;11;1;1;1;1;10;65;1;10;2251;171;171;1;0;0;10;11;2251;0;3903;11;2;
/org.eclipse.swt.examples/org/eclipse/swt/examples/addressbook/DataEntryDialog.java;3;0;3;1;1;1;1;2;157;1;2;513;157;157;1;0;0;2;3;513;0;4024;3;3;
/org.eclipse.jdt.junit/src/org/eclipse/jdt/internal/junit/wizards/UpdateTestSuite.java;2;1;5;1;3;3;3;2;16;1;2;3527;22;22;1;0;0;2;5;3527;0;4232;5;2;
/org.eclipse.pde.ui/src/org/eclipse/pde/model/plugin/IPluginModel.java;1;0;2;1;0;0;0;2;0;1;2;3039;0;0;1;0;0;2;2;3039;0;3579;2;1;
/org.eclipse.scripting/Eclipse Scripting/org/eclipse/scripting/internal/views/ScriptDevelopmentPreferencePageWorkbenchNew.java;2;0;4;1;0;0;0;4;8;1;4;133;15;15;1;0;0;4;4;133;0;1424;4;2;
/org.eclipse.jdt.core/dom/org/eclipse/jdt/core/dom/BooleanLiteral.java;2;0;4;1;0;0;0;4;9;1;4;2669;18;18;1;0;0;4;4;2669;0;3637;4;2;
/org.eclipse.jdt.ui.tests.refactoring/resources/RenameType/test57/out/B.java;1;0;1;1;0;0;0;1;0;0;1;1547;0;0;1;0;0;1;1;1547;0;1547;1;1;
/org.eclipse.jdt.ui.tests.refactoring/resources/SelectionAnalyzerWorkSpace/SelectionAnalyzerTests/invalidSelection/A_test141.java;2;0;2;1;0;0;0;2;0;1;2;1368;0;0;1;0;0;2;2;1368;0;2139;2;2;
/org.eclipse.swt/Eclipse SWT/common/org/eclipse/swt/internal/image/PngHuffmanTable.java;2;0;3;1;1;1;1;2;6;1;2;106;12;12;1;0;0;2;3;106;0;4701;3;2;
/org.eclipse.ui.tests/Eclipse UI Tests/org/eclipse/ui/tests/api/SessionRestoreTest.java;2;0;7;1;0;0;0;7;91;1;7;1008;105;105;1;0;0;7;7;1008;0;2785;7;2;
/org.eclipse.swt.examples/src/org/eclipse/swt/examples/controlexample/ScrollableTab.java;4;0;5;1;1;1;1;4;72;1;4;513;135;135;1;0;0;4;5;513;0;4705;5;4;
/org.eclipse.jdt.core/codeassist/org/eclipse/jdt/internal/codeassist/complete/InvalidCursorLocation.java;2;1;11;1;2;2;2;9;48;4;6;455;127;127;4;3;0;9;11;1039;3;4421;8;2;
/org.eclipse.ui/Eclipse UI/org/eclipse/ui/part/MessagePage.java;5;0;5;1;0;0;0;5;26;1;5;257;37;37;1;0;0;5;5;257;0;3699;5;5;
/org.eclipse.ui/Eclipse UI Standard Components/org/eclipse/ui/views/tasklist/TaskListContextComputer.java;1;0;2;1;0;0;0;2;0;1;2;2497;0;0;1;0;0;2;2;2497;0;3029;2;1;
/org.eclipse.jdt.debug.ui/ui/org/eclipse/jdt/internal/debug/ui/actions/JavaBreakpointPropertiesRulerActionDelegate.java;1;0;1;1;0;0;0;1;0;0;1;3573;0;0;1;0;0;1;1;3573;0;3573;1;1;
/org.eclipse.ui/Eclipse UI/org/eclipse/ui/internal/ViewerActionBuilder.java;2;0;2;1;0;0;0;2;22;1;2;257;22;22;1;0;0;2;2;257;0;457;2;2;
/org.eclipse.jdt.debug.ui/ui/org/eclipse/jdt/internal/debug/ui/actions/AddBreakpointAction.java;2;1;20;2;2;2;2;18;124;2;15;2023;529;529;2;3;0;18;20;2776;3;3935;17;2;
/org.eclipse.debug.core/core/org/eclipse/debug/internal/core/LaunchConfiguration.java;4;1;28;2;2;2;2;26;115;2;23;1819;474;474;2;3;0;26;28;2366;3;4536;25;4;
/org.eclipse.pde.core/src/org/eclipse/pde/internal/core/CoreSettings.java;1;0;3;1;0;0;0;3;4;2;2;3607;6;6;2;1;0;3;3;3607;1;3618;2;1;
/org.eclipse.jdt.core/model/org/eclipse/jdt/internal/core/CreateFieldOperation.java;2;1;11;1;2;2;2;9;129;4;6;455;178;178;4;3;0;9;11;1039;3;4063;8;2;
/org.eclipse.jdt.ui.tests.refactoring/resources/DeleteSourceReference/test8/in/A.java;1;0;1;1;0;0;0;1;0;0;1;2857;0;0;1;0;0;1;1;2857;0;2857;1;1;
/org.eclipse.jdt.ui.tests.refactoring/resources/SurroundWithWorkSpace/SurroundWithTests/trycatch_in/TestSuperCall.java;1;0;1;1;1;1;1;0;0;0;0;4424;0;0;1;0;0;0;1;4424;0;4424;1;1;
/org.eclipse.jdt.ui.tests.refactoring/resources/MoveCU/testFail6/in/p1/C.java;2;0;2;1;0;0;0;2;0;1;2;49;0;0;1;0;0;2;2;49;0;2769;2;2;
/org.eclipse.pde.ui/Eclipse PDE UI/org/eclipse/pde/internal/base/model/IIdentifiable.java;2;0;5;2;0;0;0;5;12;3;3;267;12;12;3;2;0;5;5;324;2;1434;3;2;
/org.eclipse.pde.ui/src/org/eclipse/pde/model/IIdentifiable.java;1;0;2;1;0;0;0;2;0;1;2;3039;0;0;1;0;0;2;2;3039;0;3579;2;1;
/org.eclipse.help.ui/src/org/eclipse/help/ui/browser/IBrowser.java;2;0;4;1;0;0;0;4;10;1;4;2429;13;13;1;0;0;4;4;2429;0;3609;4;2;
/org.eclipse.jdt.ui.tests.refactoring/resources/PullUp/testFail10/in/B.java;1;0;1;1;0;0;0;1;0;0;1;2406;0;0;1;0;0;1;1;2406;0;2406;1;1;
/org.eclipse.core.tests.resources/src/org/eclipse/core/tests/resources/regression/NLTest.java;3;0;4;1;1;1;1;3;238;1;3;1794;266;266;1;0;0;3;4;1794;0;4516;4;3;
/org.eclipse.vcm.ui/src/org/eclipse/vcm/internal/ui/actions/ToggleNavigatorVersionLabels.java;2;0;8;1;0;0;0;8;14;3;5;273;33;33;3;3;0;8;8;273;3;1669;5;2;
/org.eclipse.update/src/org/eclipse/update/internal/ui/KeyStores.java;1;0;1;1;0;0;0;1;0;0;1;1424;0;0;1;0;0;1;1;1424;0;1424;1;1;
/org.eclipse.debug.core/core/org/eclipse/debug/core/model/LineBreakpoint.java;3;0;3;1;0;0;0;3;5;1;3;1139;7;7;1;0;0;3;3;1139;0;1756;3;3;
/org.eclipse.core.tests.resources/src/org/eclipse/core/tests/resources/session/TestMultiSnap.java;2;0;3;1;0;0;0;3;128;1;3;2390;138;138;1;0;0;3;3;2390;0;3475;3;2;
/org.eclipse.scripting/Eclipse Scripting/org/eclipse/scripting/internal/views/ScriptDevelopmentWizardPageIconName.java;2;0;5;1;0;0;0;5;37;1;5;133;69;69;1;0;0;5;5;133;0;1424;5;2;
/org.eclipse.jdt.ui/core refactoring/org/eclipse/jdt/internal/corext/refactoring/base/IRefactoring.java;1;0;2;1;1;1;1;1;2;0;1;1939;2;2;1;0;0;1;2;1939;0;4400;2;1;
/org.eclipse.core.tests.runtime/src/org/eclipse/core/tests/internal/plugins/AllPluginRuntimeTests.java;2;0;2;1;0;0;0;2;0;1;2;1794;0;0;1;0;0;2;2;1794;0;3291;2;2;
/org.eclipse.jdt.ui.tests.refactoring/resources/StructureSelectionAction/A_test5.java;1;0;1;1;0;0;0;1;0;0;1;2139;0;0;1;0;0;1;1;2139;0;2139;1;1;
/org.eclipse.ui.tests/Eclipse JFace Tests/org/eclipse/jface/tests/viewers/interactive/DeleteChildrenAction.java;1;0;1;1;0;0;0;1;0;0;1;1488;0;0;1;0;0;1;1;1488;0;1488;1;1;
/org.eclipse.swt/Eclipse SWT/photon/org/eclipse/swt/widgets/TreeRoots.java;2;0;4;1;0;0;0;4;19;1;4;106;21;21;1;0;0;4;4;106;0;1028;4;2;
/org.eclipse.pde.ui/Eclipse PDE UI/org/eclipse/pde/internal/editor/component/ComponentReferencePage.java;2;0;5;2;0;0;0;5;12;3;3;267;12;12;3;2;0;5;5;324;2;1434;3;2;
/org.eclipse.swt/Eclipse SWT/win32/org/eclipse/swt/internal/win32/CHOOSEFONT.java;2;0;4;1;0;0;0;4;5;1;4;106;8;8;1;0;0;4;4;106;0;2069;4;2;
/org.eclipse.team.cvs.ui/src/org/eclipse/team/internal/ccvs/ui/wizards/KSubstWizardSummaryPage.java;3;1;7;1;4;4;4;3;193;1;3;3251;232;232;1;0;0;3;7;3251;0;4626;7;3;
/org.eclipse.jdt.ui.tests.refactoring/resources/RenameVariables/cannotRename/A_testFail14.java;1;0;2;1;0;0;0;2;0;1;2;724;0;0;1;0;0;2;2;724;0;1665;2;1;
/org.eclipse.jdt.ui.tests/JUnit/junit/tests/InheritedTestCase.java;2;0;2;1;0;0;0;2;0;1;2;49;0;0;1;0;0;2;2;49;0;1186;2;2;
/org.eclipse.swt/Eclipse SWT/gtk1x/org/eclipse/swt/widgets/Canvas.java;2;0;2;1;1;1;1;1;6;0;1;2107;6;6;1;0;0;1;2;2107;0;4701;2;2;
/org.eclipse.jdt.ui/core refactoring/org/eclipse/jdt/core/refactoring/IRefactoring.java;1;0;4;1;0;0;0;4;5;1;4;15;7;7;1;0;0;4;4;15;0;408;4;1;
/org.eclipse.ui/Eclipse UI/org/eclipse/ui/internal/ToggleFastViewAction.java;1;0;1;1;0;0;0;1;0;0;1;3287;0;0;1;0;0;1;1;3287;0;3287;1;1;
/org.eclipse.ui/Eclipse UI/org/eclipse/ui/actions/WorkspaceAction.java;4;0;7;1;1;1;1;6;14;1;6;257;51;51;1;0;0;6;7;257;0;4283;7;4;
/org.eclipse.jdt.ui/ui/org/eclipse/jdt/internal/ui/wizards/buildpaths/VariableBlock.java;4;1;33;1;3;3;3;30;136;3;24;159;548;548;3;6;0;30;33;218;6;4426;27;4;
/org.eclipse.update.core/src/org/eclipse/update/core/JarContentReference.java;2;2;21;2;7;6;7;14;263;4;9;2445;684;684;4;5;1;14;21;2757;6;4448;15;2;
/org.eclipse.jdt.core/model/org/eclipse/jdt/internal/core/builder/impl/AbstractNode.java;1;0;11;1;0;0;0;11;163;4;7;455;291;291;4;4;0;11;11;1039;4;2808;7;1;
/org.eclipse.jdt.debug/jdi interfaces/com/sun/jdi/connect/VMStartException.java;2;0;2;1;0;0;0;2;7;1;2;2704;7;7;1;0;0;2;2;2704;0;3033;2;2;
/org.eclipse.jdt.ui.tests.refactoring/resources/PullUp/testFieldMethod0/out/A.java;1;0;1;1;0;0;0;1;0;0;1;2406;0;0;1;0;0;1;1;2406;0;2406;1;1;
/org.eclipse.jdt.ui/ui/org/eclipse/jdt/internal/ui/text/template/TemplateMessages.java;1;0;2;1;0;0;0;2;0;1;2;1469;0;0;1;0;0;2;2;1469;0;2784;2;1;
/org.eclipse.jdt.ui.tests.refactoring/resources/SelectionAnalyzerWorkSpace/SelectionAnalyzerTests/invalidSelection/A_test073.java;1;0;1;1;0;0;0;1;0;0;1;1368;0;0;1;0;0;1;1;1368;0;1368;1;1;
/org.eclipse.debug.ui/ui/org/eclipse/debug/internal/ui/ComboFieldEditor.java;3;0;3;1;1;1;1;2;3;1;2;3686;3;3;1;0;0;2;3;3686;0;3975;3;3;
/org.eclipse.jdt.ui.tests.refactoring/resources/InlineTemp/canInline/A_test8_in.java;1;0;2;1;0;0;0;2;2;1;2;2051;2;2;1;0;0;2;2;2051;0;3048;2;1;
/org.eclipse.jdt.ui.tests.refactoring/resources/ExtractMethodWorkSpace/ExtractMethodTests/expression_out/A_test610.java;1;1;3;1;2;2;2;1;0;0;1;1236;0;0;1;0;0;1;3;1236;0;4419;3;1;
/org.eclipse.update.ui/src/org/eclipse/update/internal/ui/model/ISiteAdapter.java;1;0;1;1;0;0;0;1;0;0;1;2834;0;0;1;0;0;1;1;2834;0;2834;1;1;
/org.eclipse.debug.ui/ui/org/eclipse/debug/internal/ui/RunAction.java;2;0;5;1;0;0;0;5;15;1;5;187;26;26;1;0;0;5;5;187;0;2205;5;2;
/org.eclipse.jdt.ui.tests.refactoring/resources/RenamePrivateField/test4/out/A.java;1;0;1;1;0;0;0;1;0;0;1;2804;0;0;1;0;0;1;1;2804;0;2804;1;1;
/org.eclipse.help/src/org/eclipse/help/internal/contributions/Topic.java;2;0;2;1;0;0;0;2;0;1;2;1420;0;0;1;0;0;2;2;1420;0;1675;2;2;
/org.eclipse.jdt.core/compiler/org/eclipse/jdt/internal/compiler/DefaultErrorHandlingPolicies.java;2;1;5;1;2;2;2;3;126;1;3;455;156;156;1;0;0;3;5;455;0;4421;5;2;
/org.eclipse.pde.core/src/org/eclipse/pde/core/plugin/IPluginObject.java;1;0;4;1;2;1;2;2;78;1;2;3591;83;83;2;0;1;2;4;4751;1;4751;3;1;
/org.eclipse.pde.ui/Eclipse PDE UI/org/eclipse/pde/internal/base/schema/ISchemaType.java;2;0;5;2;0;0;0;5;12;3;3;267;12;12;3;2;0;5;5;324;2;1434;3;2;
/org.eclipse.jdt.ui.tests.refactoring/resources/RenameMethodInInterface/testFail22/in/A.java;1;0;1;1;0;0;0;1;0;0;1;49;0;0;1;0;0;1;1;49;0;49;1;1;
/org.eclipse.ui/Eclipse UI/org/eclipse/ui/part/FileEditorInput.java;2;0;2;1;0;0;0;2;5;1;2;257;5;5;1;0;0;2;2;257;0;457;2;2;
/org.eclipse.team.ftp/src/org/eclipse/team/internal/ftp/target/FTPResourceState.java;3;4;18;2;18;12;18;0;81;0;0;4241;342;342;4;0;6;0;18;4299;6;4573;12;3;
/org.eclipse.jdt.ui/core refactoring/org/eclipse/jdt/core/refactoring/tagging/IPreactivatedRefactoring.java;1;0;2;1;0;0;0;2;0;1;2;391;0;0;1;0;0;2;2;391;0;408;2;1;
/org.eclipse.scripting/Eclipse Scripting/org/eclipse/scripting/ScriptAdapterWorkbenchAction.java;2;0;5;1;0;0;0;5;16;1;5;133;26;26;1;0;0;5;5;133;0;1424;5;2;
/org.eclipse.help/src/org/eclipse/help/internal/search/DefaultAnalyzer.java;2;0;3;2;0;0;0;3;38;2;2;3701;38;38;2;1;0;3;3;3743;1;3743;2;2;
/org.eclipse.team.ui/src/org/eclipse/team/internal/ui/ASCIIPreferencePage.java;1;0;3;1;0;0;0;3;2;1;3;1978;2;2;1;0;0;3;3;1978;0;2797;3;1;
/org.eclipse.jdt.core/compiler/org/eclipse/jdt/internal/compiler/impl/BooleanConstant.java;2;0;10;1;1;1;1;9;49;4;6;455;107;107;4;3;0;9;10;1039;3;4062;7;2;
/org.eclipse.jdt.ui.tests.refactoring/resources/SelectionAnalyzerWorkSpace/SelectionAnalyzerTests/validSelection/A_test093_.java;1;0;1;1;0;0;0;1;0;0;1;2139;0;0;1;0;0;1;1;2139;0;2139;1;1;
/org.eclipse.jdt.ui.tests.refactoring/resources/RenamePrivateField/test3/out/A.java;1;0;1;1;0;0;0;1;0;0;1;1547;0;0;1;0;0;1;1;1547;0;1547;1;1;
/org.eclipse.swt/Eclipse SWT/emulated/treetable/org/eclipse/swt/widgets/TableColumn.java;4;2;11;1;6;5;6;5;56;1;5;1028;107;107;2;0;1;5;11;4557;1;4701;10;4;
/org.eclipse.search/search/org/eclipse/search/internal/ui/ShowSearchesAction.java;2;0;3;1;0;0;0;3;14;1;3;78;23;23;1;0;0;3;3;78;0;687;3;2;
/org.eclipse.vcm.core.cvs/src/org/eclipse/vcm/internal/core/ccvs/ICVSRepositoryLocation.java;1;0;3;1;0;0;0;3;65;1;3;1191;108;108;1;0;0;3;3;1191;0;1568;3;1;
/org.eclipse.jdt.ui.tests.refactoring/resources/ExtractMethodWorkSpace/ExtractMethodTests/validSelection/A_test242.java;2;0;2;1;0;0;0;2;0;1;2;49;0;0;1;0;0;2;2;49;0;3106;2;2;
/org.eclipse.vcm.core.cvs/src/org/eclipse/vcm/internal/core/ccvs/client/PServerConnection.java;1;0;2;1;0;0;0;2;20;1;2;1791;20;20;1;0;0;2;2;1791;0;1798;2;1;
/org.eclipse.vcm.core.cvs/src/org/eclipse/vcm/internal/core/ccvs/CVSRepositoryLocation.java;1;0;7;1;0;0;0;7;347;1;7;1191;592;592;1;0;0;7;7;1191;0;1722;7;1;
/org.eclipse.jdt.debug/eval/org/eclipse/jdt/internal/debug/eval/model/RuntimeContext.java;2;0;3;1;0;0;0;3;7;1;3;3421;7;7;1;0;0;3;3;3421;0;3645;3;2;
/org.eclipse.jdt.debug.tests/testprograms/HitCountLooper.java;3;1;3;1;2;2;2;1;29;0;1;3719;40;40;1;0;0;1;3;3719;0;4571;3;3;
/org.eclipse.team.cvs.core/src/org/eclipse/team/internal/ccvs/core/resources/RemoteModule.java;2;1;13;1;2;2;2;11;113;1;11;2707;258;258;1;0;0;11;13;2707;0;4569;13;2;
/org.eclipse.jdt.ui/core refactoring/org/eclipse/jdt/internal/corext/refactoring/code/flow/BlockFlowInfo.java;1;0;1;1;0;0;0;1;0;0;1;1939;0;0;1;0;0;1;1;1939;0;1939;1;1;
/org.eclipse.core.tests.resources/src/org/eclipse/core/tests/internal/builders/SnowBuilder.java;1;0;3;1;1;1;1;2;5;1;2;3400;6;6;1;0;0;2;3;3400;0;4516;3;1;
/org.eclipse.jdt.ui.tests/nls/org/eclipse/jdt/ui/nls/tests/CellEditorTester.java;1;0;3;1;0;0;0;3;2;1;3;1754;2;2;1;0;0;3;3;1754;0;1939;3;1;
/org.eclipse.pde.ui/Eclipse PDE UI/org/eclipse/pde/internal/editor/schema/IRestrictionPage.java;2;0;5;2;0;0;0;5;12;3;3;267;12;12;3;2;0;5;5;324;2;1434;3;2;
/org.eclipse.core.resources/src/org/eclipse/core/resources/IResourceDeltaVisitor.java;1;0;4;1;1;1;1;3;100;1;3;12;121;121;1;0;0;3;4;12;0;4214;4;1;
/org.eclipse.team.ui/src/org/eclipse/team/internal/ui/TeamPreferencePage.java;2;1;2;1;2;2;2;0;4;0;0;4146;5;5;1;0;0;0;2;4146;0;4455;2;2;
/org.eclipse.jdt.core/compiler/org/eclipse/jdt/internal/compiler/ast/ConditionalExpression.java;2;0;18;1;1;1;1;17;599;4;13;455;1212;1212;4;4;0;17;18;1039;4;4062;14;2;
/org.eclipse.core.resources/src/org/eclipse/core/internal/indexing/PageCache.java;3;0;3;1;0;0;0;3;5;1;3;12;5;5;1;0;0;3;3;12;0;448;3;3;
/org.eclipse.webdav/src/interface/org/eclipse/webdav/dom/HrefSet.java;3;0;5;1;1;1;1;4;410;1;4;12;486;486;1;0;0;4;5;12;0;4211;5;3;
/org.eclipse.jdt.core/compiler/org/eclipse/jdt/internal/compiler/parser/RecoveredElement.java;2;0;13;1;1;1;1;12;603;4;9;455;663;663;4;3;0;12;13;1039;3;4062;10;2;
/org.eclipse.ui/Eclipse UI/org/eclipse/ui/internal/NewWizardMenu.java;2;0;2;1;0;0;0;2;0;1;2;257;0;0;1;0;0;2;2;257;0;457;2;2;
/org.eclipse.jdt.ui/core refactoring/org/eclipse/jdt/internal/core/refactoring/changes/DeleteFromClasspathChange.java;2;0;6;1;0;0;0;6;16;1;6;1108;29;29;1;0;0;6;6;1108;0;1939;6;2;
/org.eclipse.update.ui/src/org/eclipse/update/internal/ui/views/HistoryView.java;1;0;2;1;0;0;0;2;0;1;2;3537;0;0;1;0;0;2;2;3537;0;3653;2;1;
/org.eclipse.jdt.ui/ui/org/eclipse/jdt/internal/ui/text/java/ExperimentalPreference.java;1;0;2;1;1;1;1;1;0;0;1;1938;0;0;1;0;0;1;2;1938;0;4185;2;1;
/org.eclipse.team.ui/src/org/eclipse/team/internal/ui/actions/CheckOutAction.java;2;1;2;1;2;2;2;0;0;0;0;4020;0;0;1;0;0;0;2;4020;0;4155;2;2;
/org.eclipse.vcm.ui.cvs/src/org/eclipse/vcm/internal/ui/ccvs/FilterStreamWizard.java;3;0;4;1;0;0;0;4;136;1;4;1057;222;222;1;0;0;4;4;1057;0;1578;4;3;
/org.eclipse.ui/Eclipse JFace/org/eclipse/jface/viewers/TreeViewer.java;3;1;5;1;2;2;2;3;6;1;3;257;21;21;1;0;0;3;5;257;0;4195;5;3;
/org.eclipse.debug.ui/ui/org/eclipse/debug/internal/ui/actions/SuspendActionDelegate.java;3;1;8;1;2;2;2;6;47;1;6;2382;122;122;1;0;0;6;8;2382;0;4423;8;3;
/org.eclipse.ui.tests/Eclipse UI Tests/org/eclipse/ui/tests/UiTestSuite.java;4;0;8;1;0;0;0;8;10;1;8;803;28;28;1;0;0;8;8;803;0;3633;8;4;
/org.eclipse.jdt.ui.tests.refactoring/resources/RenameTemp/canRename/A_test6_in.java;1;0;2;1;0;0;0;2;2;1;2;1625;2;2;1;0;0;2;2;1625;0;1652;2;1;
/org.eclipse.team.cvs.core/src/org/eclipse/team/internal/ccvs/core/client/StickyHandler.java;2;0;6;1;0;0;0;6;66;1;6;2572;82;82;1;0;0;6;6;2572;0;3610;6;2;
/org.eclipse.team.cvs.core/src/org/eclipse/team/internal/ccvs/core/util/InfiniteSubProgressMonitor.java;2;0;2;1;1;1;1;1;0;0;1;2791;0;0;1;0;0;1;2;2791;0;4406;2;2;
/org.eclipse.help.ui/src/org/eclipse/help/ui/internal/util/HelpWorkbenchException.java;1;0;1;1;1;1;1;0;0;0;0;4439;0;0;1;0;0;0;1;4439;0;4439;1;1;
/org.eclipse.core.tests.resources/src/org/eclipse/core/tests/internal/watson/ElementTreeIteratorTest.java;3;0;3;1;1;1;1;2;130;1;2;1794;150;150;1;0;0;2;3;1794;0;4516;3;3;
/org.eclipse.swt/Eclipse SWT Drag and Drop/gtk1x/org/eclipse/swt/dnd/TreeDragUnderEffect.java;2;0;2;1;0;0;0;2;0;1;2;2107;0;0;1;0;0;2;2;2107;0;3127;2;2;
/org.eclipse.team.tests.cvs.core/src/org/eclipse/team/tests/ccvs/ui/logformatter/PrintCSVSummaryVisitor.java;1;0;1;1;0;0;0;1;0;0;1;3452;0;0;1;0;0;1;1;3452;0;3452;1;1;
/org.eclipse.jdt.ui.tests.refactoring/resources/ExtractMethodWorkSpace/ExtractMethodTests/invalidSelection/A_test101.java;2;1;3;1;2;2;2;1;0;0;1;49;0;0;1;0;0;1;3;49;0;4419;3;2;
/org.eclipse.ui/Eclipse UI/org/eclipse/ui/internal/dialogs/PerspContentProvider.java;2;0;2;1;0;0;0;2;4;1;2;257;4;4;1;0;0;2;2;257;0;457;2;2;
/org.eclipse.jdt.ui.tests.refactoring/resources/ExtractMethodWorkSpace/ExtractMethodTests/validSelection/A_test234.java;2;1;3;1;2;2;2;1;0;0;1;49;0;0;1;0;0;1;3;49;0;4419;3;2;
/org.eclipse.ui/Eclipse JFace/org/eclipse/jface/viewers/TableViewerImpl.java;4;0;5;1;0;0;0;5;26;1;5;257;56;56;1;0;0;5;5;257;0;3358;5;4;
/org.eclipse.pde.core/src/org/eclipse/pde/internal/core/plugin/PluginAttribute.java;1;0;2;1;0;0;0;2;2;1;2;3591;2;2;1;0;0;2;2;3591;0;3607;2;1;
/org.eclipse.debug.core/core/org/eclipse/debug/internal/core/LaunchConfigurationType.java;3;0;7;1;1;1;1;6;15;1;6;1819;40;40;1;0;0;6;7;1819;0;3894;7;3;
/org.eclipse.swt/Eclipse SWT Drag and Drop/photon/org/eclipse/swt/dnd/ByteArrayTransfer.java;3;2;9;1;5;4;5;4;115;1;4;106;181;181;2;0;1;4;9;4824;1;4824;8;3;
/org.eclipse.swt/Eclipse SWT/carbon/org/eclipse/swt/widgets/Caret.java;4;1;5;1;5;5;5;0;22;0;0;4147;50;50;1;0;0;0;5;4147;0;4701;5;4;
/org.eclipse.scripting/src/org/eclipse/scripting/internal/IXGRElementScriptElement.java;1;0;1;1;0;0;0;1;0;0;1;1424;0;0;1;0;0;1;1;1424;0;1424;1;1;
/org.eclipse.jdt.core/model/org/eclipse/jdt/internal/core/builder/impl/StateSnap.java;1;0;10;1;0;0;0;10;95;4;6;455;131;131;4;4;0;10;10;1039;4;2808;6;1;
/org.eclipse.jdt.ui.tests.refactoring/resources/StructureSelectionAction/A_test17.java;1;0;1;1;0;0;0;1;0;0;1;2139;0;0;1;0;0;1;1;2139;0;2139;1;1;
/org.eclipse.ui/Eclipse UI/org/eclipse/ui/internal/ConfigurationInfo.java;3;0;7;1;1;1;1;6;60;1;6;1113;153;153;1;0;0;6;7;1113;0;4030;7;3;
/org.eclipse.jdt.ui/ui/org/eclipse/jdt/internal/ui/wizards/IStatusChangeListener.java;1;0;1;1;0;0;0;1;0;0;1;1275;0;0;1;0;0;1;1;1275;0;1275;1;1;
/org.eclipse.ui/Eclipse UI Standard Components/org/eclipse/ui/wizards/datatransfer/SelectFilesOperation.java;2;0;2;1;0;0;0;2;9;1;2;257;9;9;1;0;0;2;2;257;0;457;2;2;
/org.eclipse.ui/Eclipse JFace/org/eclipse/jface/util/IPropertyChangeListener.java;2;0;2;1;0;0;0;2;5;1;2;257;5;5;1;0;0;2;2;257;0;457;2;2;
/org.eclipse.pde.ui/src/org/eclipse/pde/internal/component/BuildConsoleViewer.java;2;0;2;1;0;0;0;2;0;1;2;1434;0;0;1;0;0;2;2;1434;0;2951;2;2;
/org.eclipse.scripting/src/org/eclipse/scripting/internal/IXGRElementEventGeneratorOnBlur.java;1;0;1;1;0;0;0;1;0;0;1;1424;0;0;1;0;0;1;1;1424;0;1424;1;1;
/org.eclipse.jdt.ui.tests.refactoring/resources/AbstractField/can/A_test4_in.java;1;0;1;1;0;0;0;1;0;0;1;751;0;0;1;0;0;1;1;751;0;751;1;1;
/org.eclipse.debug.core/core/org/eclipse/debug/core/IBreakpointManager.java;4;0;16;1;1;1;1;15;192;3;13;187;363;363;3;2;0;15;16;1725;2;4648;14;4;
/org.eclipse.jdt.ui.tests.refactoring/resources/PasteSourceReference/test0/in/B.java;1;0;1;1;0;0;0;1;0;0;1;2003;0;0;1;0;0;1;1;2003;0;2003;1;1;
/org.eclipse.jdt.ui.tests.refactoring/resources/SefWorkSpace/SefTests/object_in/TestSimpleRead.java;1;0;1;1;0;0;0;1;0;0;1;2155;0;0;1;0;0;1;1;2155;0;2155;1;1;
/org.eclipse.jdt.core/model/org/eclipse/jdt/internal/core/PackageDeclaration.java;3;0;10;1;1;1;1;9;58;4;6;455;115;115;4;3;0;9;10;1039;3;4063;7;3;
/org.eclipse.pde.ui/src/org/eclipse/pde/internal/component/ComponentData.java;2;0;2;1;0;0;0;2;0;1;2;1434;0;0;1;0;0;2;2;1434;0;2951;2;2;
/org.eclipse.core.runtime/src/org/eclipse/core/internal/runtime/CipherInputStream.java;3;0;4;1;1;1;1;3;172;1;3;12;193;193;1;0;0;3;4;12;0;4213;4;3;
/org.eclipse.swt/Eclipse SWT/common/org/eclipse/swt/internal/image/PngLzBlockReader.java;2;0;3;1;1;1;1;2;18;1;2;106;24;24;1;0;0;2;3;106;0;4701;3;2;
/org.eclipse.jdt.ui.tests.refactoring/resources/RenameMethodInInterface/test36/in/A.java;1;0;1;1;0;0;0;1;0;0;1;49;0;0;1;0;0;1;1;49;0;49;1;1;
/org.eclipse.jdt.junit/Eclipse JUnit/org/eclipse/jdt/junit/util/UITestCase.java;2;0;2;1;0;0;0;2;0;1;2;1511;0;0;1;0;0;2;2;1511;0;1996;2;2;
/org.eclipse.swt.tests/JUnit Tests/org/eclipse/swt/tests/junit/Test_org_eclipse_swt_custom_StackLayout.java;2;0;2;1;1;1;1;1;6;0;1;1792;6;6;1;0;0;1;2;1792;0;4706;2;2;
/org.eclipse.team.cvs.ui/src/org/eclipse/team/internal/ccvs/ui/actions/CompareRemoteResourcesAction.java;2;1;7;1;3;3;3;4;14;2;3;2392;31;31;2;1;0;4;7;2392;1;4021;6;2;
/org.eclipse.ui/Eclipse UI Standard Components/org/eclipse/ui/views/navigator/ActionFactory.java;2;0;3;1;1;1;1;2;3;1;2;1830;3;3;1;0;0;2;3;1830;0;4067;3;2;
/org.eclipse.jdt.ui.tests.refactoring/resources/RenameMethodInInterface/test3/out/A.java;1;0;1;1;0;0;0;1;0;0;1;49;0;0;1;0;0;1;1;49;0;49;1;1;
/org.eclipse.pde.ui/src/org/eclipse/pde/internal/ui/editor/manifest/ExtensionsPropertySheet.java;1;0;3;1;1;1;1;2;477;0;1;3579;479;479;2;1;0;2;3;3579;1;3974;2;1;
/org.eclipse.jdt.ui.tests.refactoring/resources/ExtractMethodWorkSpace/ExtractMethodTests/return_in/A_test712.java;1;1;3;1;2;2;2;1;14;0;1;887;14;14;1;0;0;1;3;887;0;4419;3;1;
/org.eclipse.jdt.ui/core extension/org/eclipse/jdt/internal/corext/codemanipulation/AddJavaDocStubOperation.java;4;1;8;1;3;3;3;5;27;2;4;2137;65;65;2;1;0;5;8;2232;1;4646;7;4;
/org.eclipse.pde.ui/src/org/eclipse/pde/IProjectProvider.java;1;0;2;1;0;0;0;2;0;1;2;3039;0;0;1;0;0;2;2;3039;0;3579;2;1;
/org.eclipse.jdt.debug.ui/ui/org/eclipse/jdt/internal/debug/ui/launcher/IAddVMDialogRequestor.java;1;0;1;1;0;0;0;1;0;0;1;2254;0;0;1;0;0;1;1;2254;0;2254;1;1;
/org.eclipse.pde.ui/src/org/eclipse/pde/internal/editor/manifest/AttributeClassCodeGenerator.java;1;0;2;1;0;0;0;2;0;1;2;2978;0;0;1;0;0;2;2;2978;0;3240;2;1;
/org.eclipse.help.ui/src/org/eclipse/help/ui/internal/browser/win32/IEBrowserAdapter.java;2;2;13;1;5;4;5;8;230;1;8;2429;528;528;2;0;1;8;13;4004;1;4427;12;2;
/org.eclipse.team.tests.cvs.core/src/org/eclipse/team/tests/ccvs/core/cvsresources/EclipseSynchronizerTest.java;1;0;5;1;0;0;0;5;78;1;5;3287;87;87;1;0;0;5;5;3287;0;3610;5;1;
/org.eclipse.core.resources/src/org/eclipse/core/internal/resources/OS.java;2;0;5;1;1;1;1;4;104;1;4;1700;192;192;1;0;0;4;5;1700;0;4213;5;2;
/org.eclipse.team.cvs.core/src/org/eclipse/team/internal/ccvs/core/util/EntryFileDateFormat.java;2;0;4;1;0;0;0;4;13;1;4;2570;17;17;1;0;0;4;4;2570;0;3398;4;2;
/org.eclipse.jdt.ui/ui/org/eclipse/jdt/internal/ui/text/correction/NoCorrectionProposal.java;4;0;10;1;1;1;1;9;48;2;8;3306;123;123;2;1;0;9;10;3589;1;4451;9;4;
/org.eclipse.help.ui/src/org/eclipse/help/ui/internal/search/SearchUIConstants.java;2;0;5;1;0;0;0;5;17;2;4;2429;23;23;2;1;0;5;5;3027;1;3074;4;2;
/org.eclipse.jdt.ui/nls/org/eclipse/jdt/internal/ui/nls/search/NLSSearchResultCollector.java;1;0;2;1;0;0;0;2;0;1;2;1880;0;0;1;0;0;2;2;1880;0;1913;2;1;
/org.eclipse.swt.tests/JUnit Tests/org/eclipse/swt/tests/junit/Test_org_eclipse_swt_widgets_Layout.java;2;0;2;1;1;1;1;1;6;0;1;1792;6;6;1;0;0;1;2;1792;0;4706;2;2;
/org.eclipse.ui.tests/Eclipse UI Tests/org/eclipse/ui/tests/api/IViewActionDelegateTest.java;2;0;8;1;0;0;0;8;31;2;7;1081;61;61;2;1;0;8;8;1454;1;2785;7;2;
/org.eclipse.jdt.core/model/org/eclipse/jdt/internal/core/JarPackageFragmentRoot.java;3;1;28;1;7;7;7;21;138;4;17;455;562;562;4;4;0;21;28;1039;4;4447;24;3;
/org.eclipse.team.ui/src/org/eclipse/team/internal/ui/IHelpContextIds.java;2;2;6;1;6;5;6;0;27;0;0;4160;47;47;2;0;1;0;6;4636;1;4636;5;2;
/org.eclipse.vcm.ui/src/org/eclipse/vcm/internal/ui/syncdialog/SyncCompareInput.java;2;0;6;2;0;0;0;6;46;5;2;1;46;46;5;4;0;6;6;1;4;68;2;2;
/org.eclipse.help/src/org/eclipse/help/internal/remote/StandaloneFacade.java;1;0;2;1;0;0;0;2;0;1;2;1420;0;0;1;0;0;2;2;1420;0;1502;2;1;
/org.eclipse.jdt.ui.tests.refactoring/resources/ExtractTemp/canExtract/A_test15_in.java;1;0;1;1;0;0;0;1;0;0;1;2481;0;0;1;0;0;1;1;2481;0;2481;1;1;
/org.eclipse.team.examples.filesystem/src/org/eclipse/team/examples/filesystem/ui/PutAction.java;1;0;1;1;1;1;1;0;0;0;0;4674;0;0;1;0;0;0;1;4674;0;4674;1;1;
/org.eclipse.jdt.ui/ui/org/eclipse/jdt/internal/ui/dnd/JdtTreeViewerDropAdapter.java;2;0;3;1;0;0;0;3;7;1;3;15;7;7;1;0;0;3;3;15;0;1848;3;2;
/org.eclipse.swt/Eclipse SWT PI/win32/org/eclipse/swt/internal/ole/win32/IStorage.java;2;0;2;1;1;1;1;1;6;0;1;2069;6;6;1;0;0;1;2;2069;0;4701;2;2;
/org.eclipse.jdt.debug.tests/tests/org/eclipse/jdt/debug/tests/eval/TestsNestedTypes.java;2;1;3;1;3;3;3;0;12;0;0;4447;14;14;1;0;0;0;3;4447;0;4571;3;2;
/org.eclipse.jdt.core/dom/org/eclipse/jdt/core/dom/Name.java;2;0;2;1;0;0;0;2;2;1;2;2669;2;2;1;0;0;2;2;2669;0;2702;2;2;
/org.eclipse.webdav/src/client/org/eclipse/webdav/client/CollectionHandle.java;4;1;8;1;3;3;3;5;650;1;5;12;1287;1287;1;0;0;5;8;12;0;4473;8;4;
/org.eclipse.jdt.core/model/org/eclipse/jdt/internal/core/builder/impl/MethodImplSWH.java;1;0;3;1;0;0;0;3;220;1;3;455;220;220;1;0;0;3;3;455;0;2808;3;1;
/org.eclipse.jdt.ui/core refactoring/org/eclipse/jdt/internal/core/refactoring/changes/CopyResourceChange.java;2;0;4;1;0;0;0;4;37;1;4;1108;39;39;1;0;0;4;4;1108;0;1939;4;2;
/org.eclipse.jdt.ui/core refactoring/org/eclipse/jdt/internal/corext/refactoring/code/flow/SwitchFlowInfo.java;1;0;2;1;0;0;0;2;7;1;2;1939;7;7;1;0;0;2;2;1939;0;2684;2;1;
/org.eclipse.team.cvs.ui/src/org/eclipse/team/internal/ccvs/ui/merge/TagElement.java;2;0;2;1;0;0;0;2;2;1;2;2641;2;2;1;0;0;2;2;2641;0;3610;2;2;
/org.eclipse.jdt.ui/core refactoring/org/eclipse/jdt/core/refactoring/code/ExceptionAnalyzer.java;1;0;6;1;0;0;0;6;20;2;5;25;34;34;2;1;0;6;6;25;1;408;5;1;
/org.eclipse.pde.ui/src/org/eclipse/pde/internal/feature/BuildPluginAction.java;1;0;10;1;0;0;0;10;49;2;9;2951;86;86;2;1;0;10;10;3102;1;3579;9;1;
/org.eclipse.pde.ui/src/org/eclipse/pde/internal/view/ShowInWorkspaceAction.java;1;0;2;1;0;0;0;2;0;1;2;3446;0;0;1;0;0;2;2;3446;0;3579;2;1;
/org.eclipse.jdt.ui/core extension/org/eclipse/jdt/internal/corext/codemanipulation/TextRange.java;1;0;2;1;0;0;0;2;0;0;1;2133;0;0;2;1;0;2;2;2133;1;2133;1;1;
/org.eclipse.jdt.debug/eval/org/eclipse/jdt/debug/eval/ast/model/IVirtualMachine.java;1;0;2;1;0;0;0;2;0;1;2;3329;0;0;1;0;0;2;2;3329;0;3421;2;1;
/org.eclipse.jdt.ui/ui/org/eclipse/jdt/ui/wizards/IClasspathContainerPage.java;2;1;2;1;2;2;2;0;45;0;0;4117;45;45;1;0;0;0;2;4117;0;4823;2;2;
/org.eclipse.jdt.core/search/org/eclipse/jdt/internal/core/index/impl/MemoryCheckThread.java;1;0;4;1;1;1;1;3;8;1;3;455;13;13;1;0;0;3;4;455;0;3893;4;1;
/org.eclipse.jdt.ui.tests.refactoring/resources/ExtractMethodWorkSpace/ExtractMethodTests/invalidSelection/A_test191.java;1;1;3;1;2;2;2;1;30;0;1;1851;30;30;1;0;0;1;3;1851;0;4419;3;1;
/org.eclipse.swt/Eclipse SWT PI/motif/org/eclipse/swt/internal/motif/XtWidgetGeometry.java;2;0;2;1;1;1;1;1;6;0;1;2069;6;6;1;0;0;1;2;2069;0;4701;2;2;
/org.eclipse.help/Eclipse Help/org/eclipse/help/internal/search/ISearchEngine.java;2;0;3;1;0;0;0;3;4;1;3;135;4;4;1;0;0;3;3;135;0;1188;3;2;
/org.eclipse.jdt.ui.tests.refactoring/resources/ExtractTemp/canExtract/A_test13_in.java;1;0;1;1;0;0;0;1;0;0;1;2481;0;0;1;0;0;1;1;2481;0;2481;1;1;
/org.eclipse.jdt.core/compiler/org/eclipse/jdt/internal/compiler/ast/NullLiteral.java;2;0;4;1;1;1;1;3;76;1;3;455;92;92;1;0;0;3;4;455;0;4062;4;2;
/org.eclipse.scripting/src/org/eclipse/scripting/internal/views/ScriptUIEditorLayout.java;1;0;1;1;0;0;0;1;0;0;1;1424;0;0;1;0;0;1;1;1424;0;1424;1;1;
/org.eclipse.jdt.debug.ui/ui/org/eclipse/jdt/internal/debug/ui/snippeteditor/JavaSnippetCompletionProcessor.java;3;0;8;1;0;0;0;8;63;1;8;1915;164;164;1;0;0;8;8;1915;0;3643;8;3;
/org.eclipse.ui/Eclipse UI/org/eclipse/ui/internal/ActionDescriptor.java;6;1;13;1;3;3;3;10;73;1;10;257;195;195;1;0;0;10;13;257;0;4629;13;6;
/org.eclipse.team.ui/src/org/eclipse/team/internal/ui/IgnorePreferencePage.java;3;2;13;2;6;4;6;7;6;2;6;2865;40;40;2;1;2;7;13;2865;3;4365;10;3;
/org.eclipse.pde.ui/src/org/eclipse/pde/internal/PDEPlugin.java;2;0;27;1;0;0;0;27;483;2;24;1434;1095;1095;2;3;0;27;27;2767;3;3579;24;2;
/org.eclipse.jdt.ui.tests.refactoring/resources/PullUpMethods/test10/out/A.java;1;0;3;1;0;0;0;3;2;1;3;2212;2;2;1;0;0;3;3;2212;0;2406;3;1;
/org.eclipse.jdt.ui/core refactoring/org/eclipse/jdt/internal/corext/refactoring/rename/RenameMethodInInterfaceRefactoring.java;2;1;8;1;3;3;3;5;31;1;5;1939;76;76;1;0;0;5;8;1939;0;4401;8;2;
/org.eclipse.ui/Eclipse UI Tool Script/org/eclipse/toolscript/core/internal/IPreferenceConstants.java;1;1;3;1;3;3;3;0;6;0;0;4022;6;6;1;0;0;0;3;4022;0;4087;3;1;
/org.eclipse.jdt.ui.tests.refactoring/resources/RenameTemp/cannotRename/A_testFail5.java;1;0;2;1;0;0;0;2;2;1;2;1625;2;2;1;0;0;2;2;1625;0;1652;2;1;
/org.eclipse.ui/Eclipse UI/org/eclipse/ui/internal/registry/FileEditorMapping.java;3;0;4;1;0;0;0;4;27;1;4;257;47;47;1;0;0;4;4;257;0;3377;4;3;
/org.eclipse.pde.ui/Eclipse PDE UI/org/eclipse/pde/internal/wizards/project/ConvertedProjectWizard.java;2;0;6;2;0;0;0;6;12;3;4;267;14;14;3;2;0;6;6;324;2;1434;4;2;
/org.eclipse.ui.tests/Eclipse JFace Tests/org/eclipse/jface/tests/viewers/TestElement.java;1;0;1;1;0;0;0;1;0;0;1;1488;0;0;1;0;0;1;1;1488;0;1488;1;1;
/org.eclipse.jdt.ui/core refactoring/org/eclipse/jdt/internal/core/refactoring/packages/RenameSourceFolderChange.java;1;0;1;1;0;0;0;1;0;0;1;988;0;0;1;0;0;1;1;988;0;988;1;1;
/org.eclipse.swt.tests/JUnit Tests/org/eclipse/swt/tests/junit/Test_org_eclipse_swt_graphics_ImageData.java;2;0;2;1;1;1;1;1;6;0;1;1792;6;6;1;0;0;1;2;1792;0;4706;2;2;
/org.eclipse.ui/Eclipse UI/org/eclipse/ui/internal/model/WorkbenchRootResource.java;2;0;2;1;0;0;0;2;7;1;2;257;7;7;1;0;0;2;2;257;0;457;2;2;
/org.eclipse.core.target/src/org/eclipse/core/internal/target/URLHelper.java;1;0;5;1;1;1;1;4;222;1;4;12;297;297;1;0;0;4;5;12;0;4196;5;1;
/org.eclipse.jdt.ui.tests.refactoring/resources/RenameType/test42/out/A.java;1;0;2;1;0;0;0;2;0;1;2;49;0;0;1;0;0;2;2;49;0;522;2;1;
/org.eclipse.team.core/src/org/eclipse/team/internal/core/Policy.java;2;0;2;1;1;1;1;1;26;0;1;3762;26;26;1;0;0;1;2;3762;0;4169;2;2;
/org.eclipse.core.resources/src/org/eclipse/core/internal/watson/ElementTreeDelta.java;1;0;4;1;1;1;1;3;352;1;3;12;373;373;1;0;0;3;4;12;0;4214;4;1;
/org.eclipse.jdt.ui.tests.refactoring/resources/RenameVirtualMethodInClass/test18/out/A.java;1;0;1;1;0;0;0;1;0;0;1;49;0;0;1;0;0;1;1;49;0;49;1;1;
/org.eclipse.core.resources/src/org/eclipse/core/internal/indexing/Insertable.java;2;0;4;1;1;1;1;3;28;1;3;12;48;48;1;0;0;3;4;12;0;4214;4;2;
/org.eclipse.ui/Eclipse UI/org/eclipse/ui/internal/ActiveEditorAction.java;3;0;3;1;0;0;0;3;41;1;3;257;46;46;1;0;0;3;3;257;0;2640;3;3;
/org.eclipse.pde.core/src/org/eclipse/pde/internal/core/builders/ISchemaTransformer.java;1;0;2;1;0;0;0;2;0;1;2;3591;0;0;1;0;0;2;2;3591;0;3631;2;1;
/org.eclipse.ui/Eclipse UI/org/eclipse/ui/internal/SaveAllOperation.java;3;0;3;1;0;0;0;3;4;1;3;257;4;4;1;0;0;3;3;257;0;3070;3;3;
/org.eclipse.ui/src-workbench/org/eclipse/ui/internal/SystemSummaryDocumentProvider.java;1;0;2;1;2;1;2;0;0;0;0;4386;0;0;2;0;1;0;2;4386;1;4386;1;1;
/org.eclipse.jdt.debug/jdi interfaces/com/sun/jdi/request/ThreadDeathRequest.java;2;0;2;1;0;0;0;2;8;1;2;2704;8;8;1;0;0;2;2;2704;0;3040;2;2;
/org.eclipse.jdt.ui/core extension/org/eclipse/jdt/internal/corext/javadoc/JavaDocLocations.java;3;0;11;2;1;1;1;10;232;2;8;2636;384;384;2;2;0;10;11;3247;2;4161;9;3;
/org.eclipse.jdt.ui.tests.refactoring/resources/ExtractMethodWorkSpace/ExtractMethodTests/validSelection_in/A_test364.java;1;1;3;1;2;2;2;1;24;0;1;2622;24;24;1;0;0;1;3;2622;0;4419;3;1;
/org.eclipse.jdt.ui.tests.refactoring/resources/ExtractMethodWorkSpace/ExtractMethodTests/invalidSelection/A_test062.java;2;1;3;1;2;2;2;1;0;0;1;49;0;0;1;0;0;1;3;49;0;4419;3;2;
/org.eclipse.debug.ui/ui/org/eclipse/debug/internal/ui/views/breakpoints/BreakpointsSorter.java;2;1;2;1;2;2;2;0;13;0;0;3975;13;13;1;0;0;0;2;3975;0;4208;2;2;
/org.eclipse.jdt.ui.tests.refactoring/resources/MoveMembers/testFail0/in/A.java;1;0;1;1;0;0;0;1;0;0;1;2738;0;0;1;0;0;1;1;2738;0;2738;1;1;
/org.eclipse.core.boot/src/org/eclipse/core/internal/boot/DelegatingURLClassLoader.java;5;1;23;2;2;2;2;21;1646;3;16;12;2814;2814;3;5;0;21;23;23;5;4214;18;5;
/org.eclipse.jdt.ui.tests.refactoring/test cases/org/eclipse/jdt/ui/tests/refactoring/ReorgTests.java;2;0;8;1;1;1;1;7;336;1;7;1896;432;432;1;0;0;7;8;1896;0;4212;8;2;
/org.eclipse.ui/Eclipse UI/org/eclipse/ui/internal/model/WorkbenchWorkspace.java;2;0;2;1;0;0;0;2;8;1;2;257;8;8;1;0;0;2;2;257;0;457;2;2;
/org.eclipse.jdt.ui.tests.refactoring/resources/RenameType/test0/out/B.java;1;0;1;1;0;0;0;1;0;0;1;522;0;0;1;0;0;1;1;522;0;522;1;1;
/org.eclipse.core.boot/src/org/eclipse/core/boot/IPlatformRunnable.java;3;0;5;1;1;1;1;4;54;1;4;12;85;85;1;0;0;4;5;12;0;4214;5;3;
/org.eclipse.pde.ui/src/org/eclipse/pde/internal/ui/ExternalModelManager.java;1;0;3;1;0;0;0;3;39;2;2;3579;39;39;2;1;0;3;3;3579;1;3607;2;1;
/org.eclipse.pde.ui/templates/editor/java/XMLTagScanner.java;1;0;2;1;1;1;1;1;4;0;1;3812;4;4;1;0;0;1;2;3812;0;4318;2;1;
/org.eclipse.ui.tests/Eclipse JFace Tests/org/eclipse/jface/tests/viewers/interactive/SetSorterAction.java;1;0;1;1;0;0;0;1;0;0;1;1488;0;0;1;0;0;1;1;1488;0;1488;1;1;
/org.eclipse.vcm.ui/src/org/eclipse/vcm/internal/ui/HistoryFilter.java;2;0;2;1;0;0;0;2;66;1;2;1056;66;66;1;0;0;2;2;1056;0;1418;2;2;
/org.eclipse.swt.examples.launcher/src/org/eclipse/swt/examples/launcher/ApplicationRunner.java;1;0;1;1;0;0;0;1;0;0;1;480;0;0;1;0;0;1;1;480;0;480;1;1;
/org.eclipse.pde.ui/Eclipse PDE UI/org/eclipse/pde/internal/editor/jars/JarsEditorContributor.java;2;0;5;2;0;0;0;5;12;3;3;267;12;12;3;2;0;5;5;324;2;1434;3;2;
/org.eclipse.pde.core/src/org/eclipse/pde/internal/core/WorkspaceModelManager.java;1;1;9;1;6;6;6;3;150;1;3;3591;433;433;1;0;0;3;9;3591;0;4591;9;1;
/org.eclipse.pde.ui/src/org/eclipse/pde/internal/schema/SchemaSimpleType.java;2;0;4;1;0;0;0;4;3;1;4;1434;4;4;1;0;0;4;4;1434;0;3579;4;2;
/org.eclipse.pde.ui/src/org/eclipse/pde/internal/ui/wizards/templates/TemplateField.java;1;0;3;1;0;0;0;3;7;1;3;3579;7;7;1;0;0;3;3;3579;0;3840;3;1;
/org.eclipse.update.ui/src/org/eclipse/update/internal/ui/search/NewPluginEntryDialog.java;2;1;2;1;2;2;2;0;2;0;0;4460;2;2;1;0;0;0;2;4460;0;4610;2;2;
/org.eclipse.pde.ui/Eclipse PDE UI/org/eclipse/pde/internal/editor/manifest/RuntimeForm.java;3;0;7;2;0;0;0;7;12;3;5;267;15;15;3;2;0;7;7;324;2;1434;5;3;
/org.eclipse.jdt.ui.tests.refactoring/test cases/org/eclipse/jdt/ui/tests/refactoring/RenameSourceFolderChangeTests.java;2;0;5;1;0;0;0;5;65;1;5;1896;79;79;1;0;0;5;5;1896;0;3357;5;2;
/org.eclipse.ui/Eclipse UI/org/eclipse/ui/dialogs/SelectionDialog.java;5;0;5;1;0;0;0;5;18;1;5;257;50;50;1;0;0;5;5;257;0;3487;5;5;
/org.eclipse.vcm.core/src/org/eclipse/vcm/internal/core/IgnoreInfo.java;1;0;1;1;0;0;0;1;0;0;1;373;0;0;1;0;0;1;1;373;0;373;1;1;
/org.eclipse.swt/Eclipse SWT Drag and Drop/motif/org/eclipse/swt/dnd/TextTransfer.java;3;1;9;1;7;7;7;2;91;1;2;106;214;214;1;0;0;2;9;106;0;4824;9;3;
/org.eclipse.scripting/Eclipse Scripting/org/eclipse/scripting/internal/ScriptObjectDescriptor.java;2;0;4;1;0;0;0;4;4;1;4;133;6;6;1;0;0;4;4;133;0;1424;4;2;
/org.eclipse.jdt.debug/eval/org/eclipse/jdt/debug/eval/EvaluationManager.java;2;0;10;1;0;0;0;10;191;1;10;1675;297;297;1;0;0;10;10;1675;0;3852;10;2;
/org.eclipse.swt/Eclipse SWT OLE Win32/win32/org/eclipse/swt/ole/win32/Variant.java;2;0;5;1;1;1;1;4;95;1;4;106;118;118;1;0;0;4;5;106;0;4701;5;2;
/org.eclipse.team.cvs.ui/src/org/eclipse/team/internal/ccvs/ui/wizards/BranchWizardVersionPage.java;2;0;2;1;0;0;0;2;0;1;2;3191;0;0;1;0;0;2;2;3191;0;3473;2;2;
/org.eclipse.jdt.ui/ui/org/eclipse/jdt/internal/ui/text/java/ExperimentalProposal.java;4;0;8;2;1;1;1;7;73;2;5;1921;128;128;2;2;0;7;8;1921;2;4401;6;4;
/org.eclipse.jdt.ui/core refactoring/org/eclipse/jdt/internal/core/refactoring/ASTEndVisitAdapter.java;2;0;3;1;0;0;0;3;5;1;3;15;5;5;1;0;0;3;3;15;0;1939;3;2;
/org.eclipse.jdt.ui.tests.refactoring/resources/ReorderParameters/canReorder/A_test5_in.java;1;0;3;1;0;0;0;3;0;1;3;724;0;0;1;0;0;3;3;724;0;2270;3;1;
/org.eclipse.jdt.ui/ui/org/eclipse/jdt/internal/ui/text/javadoc/JavaDocCompletionEvaluator.java;2;0;5;2;0;0;0;5;45;2;3;3643;52;52;2;2;0;5;5;3643;2;3791;3;2;
/org.eclipse.swt.examples.paint/src/org/eclipse/swt/examples/paint/AirbrushTool.java;3;0;4;2;1;1;1;3;114;2;2;513;120;120;2;1;0;3;4;609;1;4705;3;3;
/org.eclipse.jdt.debug/eval/org/eclipse/jdt/internal/debug/eval/ast/instructions/Instruction.java;3;1;7;1;2;2;2;5;84;1;5;3421;123;123;1;0;0;5;7;3421;0;4423;7;3;
/org.eclipse.ui.examples.javaeditor/Eclipse Java Editor Example/org/eclipse/ui/examples/javaeditor/javadoc/JavaDocScanner.java;1;0;1;1;0;0;0;1;0;0;1;1067;0;0;1;0;0;1;1;1067;0;1067;1;1;
/org.eclipse.swt/Eclipse SWT/motif/org/eclipse/swt/widgets/Combo.java;9;1;18;1;3;3;3;15;1097;2;14;106;2367;2367;2;1;0;15;18;3529;1;4701;17;9;
/org.eclipse.update.core/src/org/eclipse/update/core/IArchiveEntry.java;2;0;3;1;0;0;0;3;31;1;3;2476;31;31;1;0;0;3;3;2476;0;2981;3;2;
/org.eclipse.jdt.ui/core extension/org/eclipse/jdt/internal/corext/codemanipulation/TryCatchBlock.java;1;1;4;1;2;2;2;2;22;0;1;3870;29;29;2;1;0;2;4;3870;1;4543;3;1;
/org.eclipse.core.resources/src/org/eclipse/core/internal/resources/WorkspaceDescription.java;2;0;6;1;2;1;2;4;284;1;4;12;315;315;2;0;1;4;6;4209;1;4209;5;2;
/org.eclipse.team.core/src/org/eclipse/team/core/internal/FileModificationValidatorManager.java;3;0;4;1;0;0;0;4;14;2;3;3514;18;18;2;1;0;4;4;3514;1;3762;3;3;
/org.eclipse.jdt.ui.tests.refactoring/resources/SefWorkSpace/SefTests/base_out/TestPostfixInt.java;1;0;1;1;0;0;0;1;0;0;1;2876;0;0;1;0;0;1;1;2876;0;2876;1;1;
/org.eclipse.jdt.ui.tests.refactoring/resources/RenameNonPrivateField/test8/in/A.java;1;0;1;1;0;0;0;1;0;0;1;49;0;0;1;0;0;1;1;49;0;49;1;1;
/org.eclipse.ui/Eclipse UI Standard Components/org/eclipse/ui/views/properties/ComboBoxPropertyDescriptor.java;2;0;2;1;0;0;0;2;5;1;2;257;5;5;1;0;0;2;2;257;0;457;2;2;
/org.eclipse.ui/Eclipse UI/org/eclipse/ui/dialogs/SelectionStatusDialog.java;1;0;2;1;0;0;0;2;4;1;2;3733;4;4;1;0;0;2;2;3733;0;3740;2;1;
/org.eclipse.swt.tests/JUnit Tests/org/eclipse/swt/tests/junit/Test_org_eclipse_swt_dnd_DropTarget.java;2;0;2;1;1;1;1;1;6;0;1;1792;6;6;1;0;0;1;2;1792;0;4706;2;2;
/org.eclipse.ui/Eclipse UI/org/eclipse/ui/internal/LabelDecoratorAction.java;2;0;3;1;1;1;1;2;44;1;2;2007;53;53;1;0;0;2;3;2007;0;3955;3;2;
/org.eclipse.vcm.core.cvs.ext/src/org/eclipse/vcm/internal/core/ccvs/ext/EXTPlugin.java;1;0;2;1;0;0;0;2;2;1;2;1205;2;2;1;0;0;2;2;1205;0;1212;2;1;
/org.eclipse.pde.ui/Eclipse PDE UI/org/eclipse/pde/internal/editor/manifest/JavaAttributeValue.java;2;0;6;2;0;0;0;6;12;3;4;267;20;20;3;2;0;6;6;324;2;1434;4;2;
/org.eclipse.jdt.ui/ui refactoring/org/eclipse/jdt/internal/ui/refactoring/RefactoringPreferences.java;4;0;8;1;0;0;0;8;35;1;8;15;78;78;1;0;0;8;8;15;0;2007;8;4;
/org.eclipse.jdt.debug/jdi interfaces/com/sun/jdi/request/DuplicateRequestException.java;2;0;2;1;0;0;0;2;7;1;2;2704;7;7;1;0;0;2;2;2704;0;3040;2;2;
/org.eclipse.pde.ui/templates/propertyPages/java/$className$.java;1;0;1;1;0;0;0;1;0;0;1;3812;0;0;1;0;0;1;1;3812;0;3812;1;1;
/org.eclipse.jdt.ui.tests.refactoring/resources/RenameType/test45/out/B.java;2;0;2;1;0;0;0;2;2;1;2;522;2;2;1;0;0;2;2;522;0;1258;2;2;
/org.eclipse.jdt.debug.ui/ui/org/eclipse/jdt/internal/debug/ui/JavaDebugWorkInProgressPreferencePage.java;2;0;7;1;0;0;0;7;81;2;6;3329;153;153;2;1;0;7;7;3329;1;3635;6;2;
/org.eclipse.vcm.core.cvs/src/org/eclipse/vcm/internal/core/ccvs/CVSResourceTree.java;3;0;3;1;0;0;0;3;5;1;3;0;6;6;1;0;0;3;3;0;0;413;3;3;
/org.eclipse.update/Eclipse Update/org/eclipse/update/internal/ui/UMWizardPageLaunchHistoryComplete.java;2;0;4;1;0;0;0;4;178;1;4;108;182;182;1;0;0;4;4;108;0;1424;4;2;
/org.eclipse.jdt.ui.tests.refactoring/resources/MoveCU/testFail7/in/p/A.java;2;0;2;1;0;0;0;2;0;1;2;49;0;0;1;0;0;2;2;49;0;2769;2;2;
/org.eclipse.update.ui.forms/src/org/eclipse/update/ui/forms/internal/ScrollableSectionForm.java;1;0;5;1;1;1;1;4;163;1;4;2470;193;193;1;0;0;4;5;2470;0;4370;5;1;
/org.eclipse.swt.examples.launcher/org/eclipse/swt/examples/launcher/LaunchDelegate.java;3;0;3;1;0;0;0;3;9;1;3;513;9;9;1;0;0;3;3;513;0;3690;3;3;
/org.eclipse.help/src/org/eclipse/help/internal/contributions1_0/Action.java;1;0;2;1;0;0;0;2;0;1;2;1675;0;0;1;0;0;2;2;1675;0;2217;2;1;
/org.eclipse.jdt.core/model/org/eclipse/jdt/internal/core/jdom/DOMCompilationUnit.java;2;0;11;1;1;1;1;10;315;4;6;455;430;430;4;4;0;10;11;1039;4;4063;7;2;
/org.eclipse.jdt.core/model/org/eclipse/jdt/core/IBufferFactory.java;3;2;8;2;4;2;4;4;14;1;4;1757;34;34;2;0;2;4;8;4058;2;4421;6;3;
/org.eclipse.team.cvs.ui/src/org/eclipse/team/internal/ccvs/ui/wizards/BranchWizardMethodPage.java;3;0;3;1;0;0;0;3;22;1;3;3191;22;22;1;0;0;3;3;3191;0;3473;3;3;
/org.eclipse.jdt.ui/ui/org/eclipse/jdt/internal/ui/text/template/TemplateProposal.java;5;1;20;1;3;3;3;17;355;3;14;1469;1126;1126;3;3;0;17;20;1617;3;4568;17;5;
/org.eclipse.jdt.ui.tests.refactoring/resources/RenameType/test2/out/A.java;1;0;2;1;0;0;0;2;0;1;2;49;0;0;1;0;0;2;2;49;0;522;2;1;
/org.eclipse.jdt.ui/ui/org/eclipse/jdt/internal/ui/reorg/ReorgDestinationAction.java;6;2;34;1;7;6;7;27;78;2;26;1258;458;458;2;1;1;27;34;3568;2;4621;32;6;
/org.eclipse.swt/Eclipse SWT/common/org/eclipse/swt/events/KeyEvent.java;2;0;3;1;1;1;1;2;6;1;2;106;10;10;1;0;0;2;3;106;0;4701;3;2;
/org.eclipse.jdt.ui.tests.refactoring/resources/RenameType/testFail52/in/A.java;1;0;1;1;0;0;0;1;0;0;1;49;0;0;1;0;0;1;1;49;0;49;1;1;
/org.eclipse.jdt.ui.tests.refactoring/resources/RenameMethodInInterface/test22/out/A.java;1;0;1;1;0;0;0;1;0;0;1;49;0;0;1;0;0;1;1;49;0;49;1;1;
/org.eclipse.ui/Eclipse UI/org/eclipse/ui/internal/PartSite.java;5;0;6;1;1;1;1;5;13;1;5;257;37;37;1;0;0;5;6;257;0;4365;6;5;
/org.eclipse.jdt.ui/ui/org/eclipse/jdt/internal/ui/javadocexport/JavadocExportMessages.java;1;0;1;1;0;0;0;1;0;0;1;3589;0;0;1;0;0;1;1;3589;0;3589;1;1;
/org.eclipse.pde.build/src/org/eclipse/pde/internal/build/Fetch.java;3;0;7;1;0;0;0;7;176;1;7;1312;403;403;1;0;0;7;7;1312;0;3089;7;3;
/org.eclipse.swt/Eclipse SWT Custom Widgets/common_j2se/org/eclipse/swt/custom/ExtendedModifyEvent.java;1;0;1;1;0;0;0;1;0;0;1;1378;0;0;1;0;0;1;1;1378;0;1378;1;1;
/org.eclipse.ui/Eclipse JFace/org/eclipse/jface/viewers/IOpenListener.java;1;0;1;1;0;0;0;1;0;0;1;3576;0;0;1;0;0;1;1;3576;0;3576;1;1;
/org.eclipse.jdt.ui.tests.refactoring/resources/RenameVariables/canRename/A_test23_in.java;1;0;2;1;0;0;0;2;0;1;2;724;0;0;1;0;0;2;2;724;0;1665;2;1;
/org.eclipse.pde.runtime/src/org/eclipse/pde/internal/runtime/logview/LogSessionPropertyPage.java;1;1;2;1;2;2;2;0;5;0;0;4089;5;5;1;0;0;0;2;4089;0;4386;2;1;
/org.eclipse.jdt.launching/launching/org/eclipse/jdt/internal/launching/Standard11xVMType.java;2;0;1;2;1;1;1;0;2;0;0;4572;2;2;1;0;0;0;1;4572;0;4572;1;2;
/org.eclipse.core.target/src/org/eclipse/core/internal/target/webdav/StoredProperty.java;1;0;5;1;1;1;1;4;74;1;4;12;110;110;1;0;0;4;5;12;0;4196;5;1;
/org.eclipse.swt/Eclipse SWT PI/win32/org/eclipse/swt/internal/ole/win32/FUNCDESC1.java;2;0;2;1;1;1;1;1;6;0;1;2069;6;6;1;0;0;1;2;2069;0;4701;2;2;
/org.eclipse.jdt.ui.tests/refactoring/org/eclipse/jdt/refactoring/tests/RenamePrivateMethodTests.java;4;0;13;1;0;0;0;13;34;1;13;49;120;120;1;0;0;13;13;49;0;1896;13;4;
/org.eclipse.jdt.core/compiler/org/eclipse/jdt/internal/compiler/env/IGenericField.java;2;0;4;1;1;1;1;3;20;1;3;455;40;40;1;0;0;3;4;455;0;4062;4;2;
/org.eclipse.compare/compare/org/eclipse/compare/internal/patch/PreviewPatchPage.java;1;1;8;1;3;3;3;5;82;1;5;2876;201;201;1;0;0;5;8;2876;0;4451;8;1;
/org.eclipse.jdt.ui.tests/JUnit/junit/swingui/AboutDialog.java;2;0;2;1;0;0;0;2;0;1;2;49;0;0;1;0;0;2;2;49;0;1186;2;2;
/org.eclipse.update.core/src/org/eclipse/update/core/Utilities.java;2;3;23;1;14;11;14;9;256;2;8;3027;519;519;3;1;3;9;23;4452;4;4452;19;2;
/org.eclipse.jdt.ui.tests.refactoring/resources/RenameType/testFail69/in/A.java;1;0;1;1;0;0;0;1;0;0;1;49;0;0;1;0;0;1;1;49;0;49;1;1;
/org.eclipse.ui/Eclipse UI/org/eclipse/ui/internal/RemoveWorkingSetAction.java;1;0;1;1;0;0;0;1;0;0;1;3287;0;0;1;0;0;1;1;3287;0;3287;1;1;
/org.eclipse.help/Eclipse Help/org/eclipse/help/internal/remote/StandaloneFacade.java;2;0;3;1;0;0;0;3;7;1;3;135;7;7;1;0;0;3;3;135;0;1420;3;2;
/org.eclipse.jdt.core/model/org/eclipse/jdt/internal/core/builder/ReferenceCollection.java;3;0;3;2;2;1;2;1;21;0;1;2979;21;21;2;0;1;1;3;4063;1;4063;2;3;
/org.eclipse.jdt.ui.tests.refactoring/resources/RenameType/test6/in/A.java;1;0;1;1;0;0;0;1;0;0;1;49;0;0;1;0;0;1;1;49;0;49;1;1;
/org.eclipse.jdt.ui.tests.refactoring/resources/ExtractMethodWorkSpace/ExtractMethodTests/T9815.java;1;1;3;1;2;2;2;1;0;0;1;3168;0;0;1;0;0;1;3;3168;0;4419;3;1;
/org.eclipse.jdt.debug/jdi/org/eclipse/jdi/internal/connect/ConnectMessages.java;1;0;2;1;1;1;1;1;11;0;1;3677;11;11;1;0;0;1;2;3677;0;4567;2;1;
/org.eclipse.swt/Eclipse SWT PI/photon/org/eclipse/swt/internal/photon/PhPoint_t.java;2;0;2;1;1;1;1;1;6;0;1;2069;6;6;1;0;0;1;2;2069;0;4701;2;2;
/org.eclipse.core.runtime/src/org/eclipse/core/internal/runtime/PlatformURLResourceConnection.java;1;0;3;1;0;0;0;3;7;1;3;242;7;7;1;0;0;3;3;242;0;558;3;1;
/org.eclipse.jdt.ui.tests.refactoring/resources/MoveMembers/test20/in/A.java;1;0;1;1;0;0;0;1;0;0;1;2738;0;0;1;0;0;1;1;2738;0;2738;1;1;
/org.eclipse.swt/Eclipse SWT Custom Widgets/common/org/eclipse/swt/custom/LineStyleEvent.java;2;0;3;1;1;1;1;2;7;1;2;106;13;13;1;0;0;2;3;106;0;4701;3;2;
/org.eclipse.jdt.ui.tests.refactoring/resources/ExtractMethodWorkSpace/ExtractMethodTests/validSelection/A_test283.java;2;1;3;1;2;2;2;1;2;0;1;95;2;2;1;0;0;1;3;95;0;4419;3;2;
/org.eclipse.jdt.ui.tests.refactoring/resources/RenameTemp/cannotRename/A_testFail3.java;1;0;2;1;0;0;0;2;2;1;2;1625;2;2;1;0;0;2;2;1625;0;1652;2;1;
/org.eclipse.swt/Eclipse SWT PI/win32/org/eclipse/swt/internal/win32/DOCINFO.java;2;0;2;1;1;1;1;1;6;0;1;2069;6;6;1;0;0;1;2;2069;0;4701;2;2;
/org.eclipse.update/Eclipse Update/org/eclipse/update/internal/core/UMSessionManagerEntry.java;2;0;4;2;0;0;0;4;10;2;3;108;10;10;2;1;0;4;4;323;1;1424;3;2;
/org.eclipse.jdt.ui.tests.refactoring/resources/DeleteSourceReference/test10/out/A.java;1;0;1;1;0;0;0;1;0;0;1;2857;0;0;1;0;0;1;1;2857;0;2857;1;1;
/org.eclipse.pde.ui/src/org/eclipse/pde/internal/preferences/TargetEnvironmentPreferencePage.java;1;0;4;1;0;0;0;4;30;1;4;3103;38;38;1;0;0;4;4;3103;0;3579;4;1;
/org.eclipse.ui/Eclipse UI/org/eclipse/ui/actions/CopyProjectOperation.java;1;0;2;1;2;1;2;0;14;0;0;4208;14;14;2;0;1;0;2;4208;1;4208;1;1;
/org.eclipse.pde.runtime/src/org/eclipse/pde/internal/runtime/logview/LogView.java;2;2;9;1;4;3;4;5;312;2;4;1434;431;431;2;1;1;5;9;3684;2;4733;7;2;
/org.eclipse.pde.ui/src/org/eclipse/pde/internal/ui/editor/feature/IncludeFeaturesWizardPage.java;1;1;2;1;2;2;2;0;10;0;0;3982;10;10;1;0;0;0;2;3982;0;4435;2;1;
/org.eclipse.ant.core/src/org/eclipse/ant/internal/core/old/XercesRegexpMatcher.java;1;0;1;1;0;0;0;1;0;0;1;3270;0;0;1;0;0;1;1;3270;0;3270;1;1;
/org.eclipse.debug.ui/ui/org/eclipse/debug/internal/ui/ConsoleTerminateActionDelegate.java;2;0;2;1;0;0;0;2;0;1;2;2349;0;0;1;0;0;2;2;2349;0;2382;2;2;
/org.eclipse.team.tests.cvs.core/src/org/eclipse/team/tests/ccvs/ui/CVSUITestCase.java;3;1;12;1;3;3;3;9;104;1;9;2977;332;332;1;0;0;9;12;2977;0;4260;12;3;
/org.eclipse.swt.tests/JUnit Tests/org/eclipse/swt/tests/junit/Test_org_eclipse_swt_graphics_ImageLoaderEvent.java;2;0;2;1;1;1;1;1;6;0;1;1792;6;6;1;0;0;1;2;1792;0;4706;2;2;
/org.eclipse.jdt.core/compiler/org/eclipse/jdt/internal/compiler/IProblemFactory.java;2;0;7;1;1;1;1;6;34;3;4;455;72;72;3;2;0;6;7;3080;2;4062;5;2;
/org.eclipse.jdt.ui/ui/org/eclipse/jdt/internal/ui/actions/OpenImportDeclarationAction.java;4;1;13;2;2;2;2;11;36;2;9;15;127;127;2;2;0;11;13;411;2;3967;11;4;
/org.eclipse.help.ui/Eclipse Help UI/org/eclipse/help/internal/ui/util/TString.java;2;0;3;1;0;0;0;3;7;1;3;136;7;7;1;0;0;3;3;136;0;1420;3;2;
/org.eclipse.ui/Eclipse UI/org/eclipse/ui/internal/FolderLayout.java;4;0;5;1;1;1;1;4;56;1;4;257;69;69;1;0;0;4;5;257;0;4082;5;4;
/org.eclipse.swt.examples/org/eclipse/swt/examples/explorer/IconCache.java;1;0;1;1;0;0;0;1;0;0;1;553;0;0;1;0;0;1;1;553;0;553;1;1;
/org.eclipse.jdt.debug.ui/ui/org/eclipse/jdt/internal/debug/ui/JavaWatchpointPropertySource.java;2;0;3;1;0;0;0;3;12;1;3;1915;12;12;1;0;0;3;3;1915;0;2794;3;2;
/org.eclipse.jdt.ui.tests.refactoring/resources/SelectionAnalyzerWorkSpace/SelectionAnalyzerTests/validSelection/A_test048_.java;1;0;1;1;0;0;0;1;0;0;1;2139;0;0;1;0;0;1;1;2139;0;2139;1;1;
/org.eclipse.vcm.core/src/org/eclipse/vcm/internal/core/adapter/ICatchupListener.java;2;0;2;1;0;0;0;2;4;1;2;0;4;4;1;0;0;2;2;0;0;297;2;2;
/org.eclipse.pde.ui/Eclipse PDE UI/org/eclipse/pde/internal/editor/manifest/DetailExtensionPointSection.java;2;0;7;2;0;0;0;7;12;3;5;267;14;14;3;2;0;7;7;324;2;1434;5;2;
/org.eclipse.team.cvs.core/src/org/eclipse/team/internal/ccvs/core/resources/LocalResource.java;2;0;15;1;0;0;0;15;66;3;12;2156;181;181;3;3;0;15;15;2864;3;3089;12;2;
/org.eclipse.ui/Eclipse UI/org/eclipse/ui/internal/dialogs/WelcomeParser.java;2;0;2;1;0;0;0;2;12;1;2;457;12;12;1;0;0;2;2;457;0;620;2;2;
/org.eclipse.jdt.core/model/org/eclipse/jdt/internal/core/MoveElementsOperation.java;2;0;9;1;1;1;1;8;44;4;5;455;76;76;4;3;0;8;9;1039;3;4063;6;2;
/org.eclipse.jdt.ui/ui refactoring/org/eclipse/jdt/internal/ui/refactoring/nls/NLSImages.java;2;0;3;1;0;0;0;3;10;1;3;1922;10;10;1;0;0;3;3;1922;0;3847;3;2;
/org.eclipse.ui.tests/Eclipse JFace Tests/org/eclipse/jface/tests/viewers/TestModelChange.java;1;0;1;1;0;0;0;1;0;0;1;1488;0;0;1;0;0;1;1;1488;0;1488;1;1;
/org.eclipse.debug.ui/ui/org/eclipse/debug/internal/ui/LaunchWizardProjectSelectionPage.java;4;0;13;1;0;0;0;13;54;1;13;187;214;214;1;0;0;13;13;187;0;3634;13;4;
/org.eclipse.jdt.ui/core codemanipulation/org/eclipse/jdt/internal/core/codemanipulation/AddMemberEdit2.java;2;0;2;1;0;0;0;2;0;1;2;1929;0;0;1;0;0;2;2;1929;0;1937;2;2;
/org.eclipse.swt/Eclipse SWT OLE Win32/win32/org/eclipse/swt/internal/ole/win32/OLECMD.java;2;0;3;1;0;0;0;3;5;1;3;106;5;5;1;0;0;3;3;106;0;2069;3;2;
/org.eclipse.jdt.ui.tests.refactoring/resources/RenameParameters/cannotRename/A_testFail20.java;1;0;1;1;0;0;0;1;0;0;1;233;0;0;1;0;0;1;1;233;0;233;1;1;
/org.eclipse.jdt.ui.tests.refactoring/resources/RenameNonPrivateField/testFail9/in/A.java;1;0;1;1;0;0;0;1;0;0;1;49;0;0;1;0;0;1;1;49;0;49;1;1;
/org.eclipse.swt/Eclipse SWT/motif/org/eclipse/swt/internal/motif/XmDropProcCallback.java;2;0;3;1;0;0;0;3;4;1;3;106;4;4;1;0;0;3;3;106;0;2069;3;2;
/org.eclipse.pde.ui/Eclipse PDE UI/org/eclipse/pde/internal/model/WorkspacePluginModelBase.java;2;0;7;2;0;0;0;7;12;3;5;267;24;24;3;2;0;7;7;324;2;1434;5;2;
/org.eclipse.jdt.ui/core refactoring/org/eclipse/jdt/internal/corext/refactoring/reorg/SourceReferenceSourceRangeComputer.java;2;1;12;1;4;4;4;8;76;1;8;2212;215;215;1;0;0;8;12;2212;0;4424;12;2;
/org.eclipse.update.ui/src/org/eclipse/update/internal/ui/manager/SelectedFeatureListSection.java;1;0;2;1;0;0;0;2;0;0;1;1457;0;0;2;1;0;2;2;1457;1;1457;1;1;
/org.eclipse.help/src/org/eclipse/help/internal/protocols/links/LinksURLConnection.java;1;0;2;1;0;0;0;2;0;1;2;2572;0;0;1;0;0;2;2;2572;0;2694;2;1;
/org.eclipse.ui/Eclipse UI/org/eclipse/ui/part/MultiPageEditor.java;3;0;3;1;0;0;0;3;5;1;3;257;9;9;1;0;0;3;3;257;0;3504;3;3;
/org.eclipse.scripting/Eclipse Scripting/org/eclipse/scripting/internal/datamodels/XGRXmlElementsAndAttributesDataNode.java;2;0;4;1;0;0;0;4;9;1;4;133;13;13;1;0;0;4;4;133;0;1424;4;2;
/org.eclipse.ui/Eclipse UI Tool Script/org/eclipse/toolscript/ui/internal/AntTreeContentProvider.java;1;1;2;1;2;2;2;0;0;0;0;4065;0;0;1;0;0;0;2;4065;0;4087;2;1;
/org.eclipse.pde.ui/Eclipse PDE UI/org/eclipse/pde/internal/forms/FormSection.java;2;0;10;2;0;0;0;10;134;3;8;267;191;191;3;2;0;10;10;324;2;1434;8;2;
/org.eclipse.swt/Eclipse SWT/common/org/eclipse/swt/layout/GridData.java;3;1;7;1;2;2;2;5;35;2;4;106;56;56;2;1;0;5;7;2881;1;4701;6;3;
/org.eclipse.ant.core/src/org/eclipse/ant/core/IncrementalBuild.java;5;0;8;2;0;0;0;8;280;2;7;14;484;484;2;1;0;8;8;493;1;3489;7;5;
/org.eclipse.compare/compare/org/eclipse/compare/structuremergeviewer/DiffElement.java;1;0;2;1;0;0;0;2;5;1;2;14;5;5;1;0;0;2;2;14;0;329;2;1;
/org.eclipse.jdt.ui.tests.refactoring/resources/ExtractTemp/canExtract/A_test37_in.java;1;1;2;1;2;2;2;0;14;0;0;3995;14;14;1;0;0;0;2;3995;0;4002;2;1;
/org.eclipse.help/Eclipse Help/org/eclipse/help/internal/contributions/xml/HelpTopic.java;2;0;3;1;0;0;0;3;7;1;3;135;7;7;1;0;0;3;3;135;0;1420;3;2;
/org.eclipse.swt/Eclipse SWT/gtk/org/eclipse/swt/widgets/Caret.java;5;1;14;1;4;4;4;10;490;2;8;2107;867;867;2;2;0;10;14;3419;2;4701;12;5;
/org.eclipse.pde.ui/src/org/eclipse/pde/internal/ui/editor/PDEChildFormPage.java;1;0;1;1;0;0;0;1;0;0;1;3579;0;0;1;0;0;1;1;3579;0;3579;1;1;
/org.eclipse.team.cvs.core/src/org/eclipse/team/internal/ccvs/core/client/AbstractMessageCommand.java;2;0;5;2;0;0;0;5;31;2;4;2572;39;39;2;1;0;5;5;3089;1;3610;4;2;
/org.eclipse.swt/Eclipse SWT Custom Widgets/common/org/eclipse/swt/custom/ControlEditor.java;3;0;7;1;1;1;1;6;41;3;4;106;54;54;3;2;0;6;7;3051;2;4701;5;3;
/org.eclipse.jdt.ui/ui/org/eclipse/jdt/internal/ui/browsing/PackagesView.java;4;1;16;1;7;7;7;9;22;1;9;2878;130;130;1;0;0;9;16;2878;0;4643;16;4;
/org.eclipse.scripting/src/org/eclipse/scripting/internal/ScriptReaderString.java;1;0;1;1;0;0;0;1;0;0;1;1424;0;0;1;0;0;1;1;1424;0;1424;1;1;
/org.eclipse.swt/Eclipse SWT/win32/org/eclipse/swt/internal/win32/REBARBANDINFO.java;2;0;3;1;0;0;0;3;5;1;3;106;5;5;1;0;0;3;3;106;0;2069;3;2;
/org.eclipse.ant.core/src_ant/org/eclipse/ant/internal/core/ant/InternalAntRunner.java;1;2;19;1;12;9;12;7;705;2;4;3489;1041;1041;2;3;3;7;19;3489;6;4631;13;1;
/org.eclipse.swt/Eclipse SWT PI/win32/org/eclipse/swt/internal/win32/NONCLIENTMETRICS.java;2;0;2;1;1;1;1;1;6;0;1;2207;6;6;1;0;0;1;2;2207;0;4701;2;2;
/org.eclipse.jdt.ui/ui/org/eclipse/jdt/internal/ui/text/template/TemplateEditorPopup.java;1;0;4;1;0;0;0;4;45;1;4;1587;55;55;1;0;0;4;4;1587;0;1655;4;1;
/org.eclipse.jdt.junit/Eclipse JUnit/org/eclipse/jdt/junit/internal/util/FocusTestPass.java;2;0;2;1;0;0;0;2;0;1;2;1511;0;0;1;0;0;2;2;1511;0;1996;2;2;
/org.eclipse.jdt.ui/core refactoring/org/eclipse/jdt/internal/corext/refactoring/rename/RenameFieldRefactoring.java;3;1;25;2;2;2;2;23;218;3;18;1939;807;807;3;5;0;23;25;2133;5;4402;20;3;
/org.eclipse.ui.tests/Eclipse UI Tests/org/eclipse/ui/tests/api/MockPropertyListener.java;3;0;6;1;0;0;0;6;4;1;6;1059;11;11;1;0;0;6;6;1059;0;2785;6;3;
/org.eclipse.jdt.ui/core extension/org/eclipse/jdt/internal/corext/codemanipulation/TextEditNode.java;2;0;3;2;0;0;0;3;8;0;1;2133;8;8;3;2;0;3;3;2133;2;2133;1;2;
/org.eclipse.update/src/org/eclipse/update/internal/ui/UMWizard.java;1;0;1;1;0;0;0;1;0;0;1;1424;0;0;1;0;0;1;1;1424;0;1424;1;1;
/org.eclipse.jdt.ui/ui/org/eclipse/jdt/internal/ui/snippeteditor/JavaSnippetEditor.java;8;0;34;2;0;0;0;34;229;2;29;15;1410;1410;2;5;0;34;34;25;5;1916;29;8;
/org.eclipse.team.cvs.ui/src/org/eclipse/team/internal/ccvs/ui/actions/TagInRepositoryAction.java;3;1;7;1;4;4;4;3;153;1;3;3470;168;168;1;0;0;3;7;3470;0;4403;7;3;
/org.eclipse.jdt.ui.tests.refactoring/resources/ExtractMethodWorkSpace/ExtractMethodTests/locals_out/A_test525.java;1;1;4;1;2;2;2;2;70;1;2;2684;72;72;1;0;0;2;4;2684;0;4419;4;1;
/org.eclipse.core.tests.runtime/src/org/eclipse/core/tests/internal/plugins/FragmentResolveTest_6.java;3;0;4;1;0;0;0;4;1610;1;4;1819;1629;1629;1;0;0;4;4;1819;0;3476;4;3;
/org.eclipse.swt/Eclipse SWT OLE Win32/win32/org/eclipse/swt/internal/ole/win32/DROPFILES.java;2;0;3;1;0;0;0;3;5;1;3;106;5;5;1;0;0;3;3;106;0;1831;3;2;
/org.eclipse.jdt.ui/ui/org/eclipse/jdt/internal/ui/compare/JavaHistoryAction.java;3;1;18;1;4;4;4;14;167;2;13;15;391;391;2;1;0;14;18;2153;1;4621;17;3;
/org.eclipse.pde.ui/Eclipse PDE UI/org/eclipse/pde/internal/model/component/ComponentObject.java;2;0;6;2;0;0;0;6;30;3;4;267;42;42;3;2;0;6;6;324;2;1434;4;2;
/org.eclipse.swt/Eclipse SWT/photon/org/eclipse/swt/graphics/Color.java;3;1;6;1;3;3;3;3;132;1;3;106;159;159;1;0;0;3;6;106;0;4701;6;3;
/org.eclipse.jdt.ui/core refactoring/org/eclipse/jdt/internal/core/refactoring/changes/CompilationUnitChange.java;1;0;3;1;0;0;0;3;4;2;2;1800;4;4;2;1;0;3;3;1937;1;1937;2;1;
/org.eclipse.swt/Eclipse SWT Drag and Drop/gtk1x/org/eclipse/swt/dnd/DropTarget.java;2;0;2;1;0;0;0;2;0;1;2;2107;0;0;1;0;0;2;2;2107;0;3127;2;2;
/org.eclipse.jdt.ui.tests.refactoring/resources/SelectionAnalyzerWorkSpace/SelectionAnalyzerTests/invalidSelection/A_test050.java;1;0;1;1;0;0;0;1;0;0;1;1368;0;0;1;0;0;1;1;1368;0;1368;1;1;
/org.eclipse.pde.ui/Eclipse PDE UI/org/eclipse/pde/internal/base/model/component/IComponentReference.java;2;0;5;2;0;0;0;5;12;3;3;267;12;12;3;2;0;5;5;324;2;1434;3;2;
/org.eclipse.vcm.ui/src/org/eclipse/vcm/internal/ui/VCMLabelDecorator.java;2;0;6;1;0;0;0;6;4;2;4;397;10;10;2;2;0;6;6;397;2;531;4;2;
/org.eclipse.swt/Eclipse SWT PI/win32/org/eclipse/swt/internal/ole/win32/CONTROLINFO.java;2;0;2;1;1;1;1;1;6;0;1;2069;6;6;1;0;0;1;2;2069;0;4701;2;2;
/org.eclipse.jdt.ui/ui/org/eclipse/jdt/ui/jarpackager/IJarDescriptionReader.java;2;0;3;1;1;1;1;2;11;0;1;3529;15;15;2;1;0;2;3;3529;1;4811;2;2;
/org.eclipse.jdt.ui.tests/test plugin/org/eclipse/jdt/testplugin/AbstractCUTestCase.java;1;0;3;1;0;0;0;3;40;1;3;1236;40;40;1;0;0;3;3;1236;0;2216;3;1;
/org.eclipse.team.ui/src/org/eclipse/team/internal/ui/target/UploadAction.java;3;2;4;2;4;3;4;0;60;0;0;4435;98;98;2;0;1;0;4;4636;1;4636;3;3;
/org.eclipse.pde.ui/src/org/eclipse/pde/internal/feature/BuildPluginWizard.java;1;0;3;1;0;0;0;3;2;1;3;2951;2;2;1;0;0;3;3;2951;0;3113;3;1;
/org.eclipse.jdt.ui.tests.refactoring/resources/RenameType/test54/in/A.java;1;0;1;1;0;0;0;1;0;0;1;1284;0;0;1;0;0;1;1;1284;0;1284;1;1;
/org.eclipse.scripting/Eclipse Scripting/org/eclipse/scripting/internal/ScriptReporter.java;2;0;5;1;0;0;0;5;696;1;5;133;731;731;1;0;0;5;5;133;0;1424;5;2;
/org.eclipse.jdt.ui.tests.refactoring/resources/SelectionAnalyzerWorkSpace/SelectionAnalyzerTests/validSelection/A_test242.java;1;0;1;1;0;0;0;1;0;0;1;1368;0;0;1;0;0;1;1;1368;0;1368;1;1;
/org.eclipse.jdt.ui.tests.refactoring/resources/PullUpMethods/testTemplate/in/A.java;1;0;2;1;0;0;0;2;0;1;2;2156;0;0;1;0;0;2;2;2156;0;2406;2;1;
/org.eclipse.swt.tests/JUnit Tests/org/eclipse/swt/tests/junit/AllWidgetTests.java;2;0;2;1;1;1;1;1;6;0;1;1792;6;6;1;0;0;1;2;1792;0;4706;2;2;
/org.eclipse.pde.ui/Eclipse PDE UI/org/eclipse/pde/internal/base/model/IModelProviderListener.java;2;0;5;2;0;0;0;5;12;3;3;267;12;12;3;2;0;5;5;324;2;1434;3;2;
/org.eclipse.swt/Eclipse SWT/win32/org/eclipse/swt/widgets/Menu.java;8;4;22;2;8;4;8;14;100;2;13;106;457;457;4;1;4;14;22;4550;5;4701;17;8;
/org.eclipse.jdt.ui.tests.refactoring/resources/RenameMethodInInterface/testFail15/in/A.java;1;0;1;1;0;0;0;1;0;0;1;49;0;0;1;0;0;1;1;49;0;49;1;1;
/org.eclipse.jdt.ui/ui/org/eclipse/jdt/internal/ui/typehierarchy/HistoryListAction.java;2;0;12;1;1;1;1;11;106;2;10;1589;227;227;2;1;0;11;12;1589;1;4630;11;2;
/org.eclipse.jdt.debug.ui/ui/org/eclipse/jdt/internal/debug/ui/display/DisplayViewContentAssistant.java;2;0;2;1;0;0;0;2;0;1;2;2342;0;0;1;0;0;2;2;2342;0;2575;2;2;
/org.eclipse.jdt.ui/core refactoring/org/eclipse/jdt/internal/core/refactoring/base/RefactoringStatusEntry.java;3;0;7;1;0;0;0;7;106;2;6;408;191;191;2;1;0;7;7;1927;1;1939;6;3;
/org.eclipse.pde.ui/src/org/eclipse/pde/internal/ui/editor/manifest/NullToolBarManager.java;1;0;2;1;1;1;1;1;23;0;1;3579;23;23;1;0;0;1;2;3579;0;4572;2;1;
/org.eclipse.vcm.ui/src/org/eclipse/vcm/internal/ui/VersionDialog.java;4;0;10;2;0;0;0;10;34;2;9;1;124;124;2;1;0;10;10;295;1;1228;9;4;
/org.eclipse.jdt.debug/jdi/org/eclipse/jdi/internal/StackFrameImpl.java;2;0;5;1;0;0;0;5;38;1;5;187;70;70;1;0;0;5;5;187;0;3678;5;2;
/org.eclipse.jdt.ui/core refactoring/org/eclipse/jdt/internal/core/nls/model/NLSElement.java;1;0;2;1;0;0;0;2;0;1;2;1913;0;0;1;0;0;2;2;1913;0;1922;2;1;
/org.eclipse.jdt.ui.tests.refactoring/resources/ExtractTemp/canExtract/A_test5_in.java;1;0;1;1;0;0;0;1;0;0;1;2481;0;0;1;0;0;1;1;2481;0;2481;1;1;
/org.eclipse.compare/compare/org/eclipse/compare/internal/ExceptionHandler.java;1;0;1;1;0;0;0;1;0;0;1;2876;0;0;1;0;0;1;1;2876;0;2876;1;1;
/org.eclipse.swt/Eclipse SWT PI/gtk1x/org/eclipse/swt/internal/gtk/GtkWidget.java;2;0;2;1;1;1;1;1;3;0;1;2107;3;3;1;0;0;1;2;2107;0;4701;2;2;
/org.eclipse.ui.externaltools/External Tools/org/eclipse/ui/externaltools/internal/core/AntFileRunner.java;2;2;8;1;8;7;8;0;20;0;0;4090;55;55;2;0;1;0;8;4367;1;4768;7;2;
/org.eclipse.jdt.ui.tests.refactoring/resources/RenamePrivateMethod/test15/in/A.java;1;0;1;1;0;0;0;1;0;0;1;49;0;0;1;0;0;1;1;49;0;49;1;1;
/org.eclipse.core.resources/src/org/eclipse/core/internal/indexing/Index.java;2;0;4;1;1;1;1;3;306;1;3;12;326;326;1;0;0;3;4;12;0;4214;4;2;
/org.eclipse.jdt.ui/core refactoring/org/eclipse/jdt/internal/core/refactoring/text/ITextRegion.java;2;0;3;1;0;0;0;3;2;1;3;408;2;2;1;0;0;3;3;408;0;1939;3;2;
/org.eclipse.ui/Eclipse UI/org/eclipse/ui/internal/AboutInfo.java;1;1;8;1;8;8;8;0;75;0;0;3980;168;168;1;0;0;0;8;3980;0;4423;8;1;
/org.eclipse.team.cvs.core/src/org/eclipse/team/internal/ccvs/core/commands/CommandDispatcher.java;3;0;4;1;0;0;0;4;222;1;4;1978;236;236;1;0;0;4;4;1978;0;2607;4;3;
/org.eclipse.jdt.ui.tests.refactoring/resources/RenameType/testFail16/in/A.java;1;0;1;1;0;0;0;1;0;0;1;49;0;0;1;0;0;1;1;49;0;49;1;1;
/org.eclipse.team.cvs.core/src/org/eclipse/team/internal/ccvs/core/resources/api/ICVSFolder.java;2;0;2;1;0;0;0;2;0;1;2;1978;0;0;1;0;0;2;2;1978;0;2156;2;2;
/org.eclipse.jdt.ui/ui refactoring/org/eclipse/jdt/internal/ui/refactoring/EditorSavingWizardPage.java;1;0;2;1;0;0;0;2;0;1;2;15;0;0;1;0;0;2;2;15;0;171;2;1;
/org.eclipse.vcm.core.cvs/src/org/eclipse/vcm/internal/core/ccvs/requests/Log.java;3;0;3;1;0;0;0;3;13;1;3;0;15;15;1;0;0;3;3;0;0;1098;3;3;
/org.eclipse.ui/Eclipse JFace Text/org/eclipse/jface/text/rules/BufferedRuleBasedScanner.java;4;0;4;1;0;0;0;4;58;1;4;257;87;87;1;0;0;4;4;257;0;3880;4;4;
/org.eclipse.update.tests.core/src/org/eclipse/update/tests/configurations/AllConfigurationsTests.java;2;1;6;1;2;2;2;4;8;1;4;2180;18;18;1;0;0;4;6;2180;0;4324;6;2;
/org.eclipse.team.cvs.ui/src/org/eclipse/team/internal/ccvs/ui/model/RemoteFileElement.java;3;0;6;1;0;0;0;6;92;1;6;1978;103;103;1;0;0;6;6;1978;0;3644;6;3;
/org.eclipse.vcm.ui/src/org/eclipse/vcm/internal/ui/actions/ResourceEditionAction.java;2;0;2;1;0;0;0;2;5;1;2;1;5;5;1;0;0;2;2;1;0;298;2;2;
/org.eclipse.jdt.ui.tests.refactoring/resources/SefWorkSpace/SefTests/object_in/TestSetterAsReceiver.java;1;0;1;1;0;0;0;1;0;0;1;2876;0;0;1;0;0;1;1;2876;0;2876;1;1;
/org.eclipse.pde.ui/src/org/eclipse/pde/internal/wizards/templates/ViewTemplate.java;1;0;10;1;0;0;0;10;139;2;8;3278;236;236;2;2;0;10;10;3425;2;3579;8;1;
/org.eclipse.jdt.ui/ui refactoring/org/eclipse/jdt/internal/ui/refactoring/actions/UndoManagerAction.java;1;1;6;1;3;3;3;3;99;1;3;1345;129;129;1;0;0;3;6;1345;0;4379;6;1;
/org.eclipse.swt/Eclipse SWT/common_j2se/org/eclipse/swt/internal/Compatibility.java;4;1;9;1;2;2;2;7;88;2;6;1485;322;322;2;1;0;7;9;1499;1;4701;8;4;
/org.eclipse.update.ui/src/org/eclipse/update/internal/ui/manager/SiteForm.java;2;0;17;1;0;0;0;17;217;1;17;1570;364;364;1;0;0;17;17;1570;0;3662;17;2;
/org.eclipse.pde.ui/src/org/eclipse/pde/internal/wizards/templates/GenericTemplateSection.java;1;0;6;1;0;0;0;6;53;2;5;3278;66;66;2;1;0;6;6;3415;1;3579;5;1;
/org.eclipse.pde.ui/src/org/eclipse/pde/internal/model/plugin/PluginExtension.java;1;0;2;1;0;0;0;2;0;1;2;3136;0;0;1;0;0;2;2;3136;0;3579;2;1;
/org.eclipse.jdt.debug/model/org/eclipse/jdt/internal/debug/core/model/JDIPrimitiveValue.java;2;0;2;2;0;0;0;2;3;0;1;2517;3;3;2;1;0;2;2;2517;1;2517;1;2;
/org.eclipse.jdt.ui.tests.refactoring/resources/PullUpMethods/test8/in/A.java;1;0;3;1;0;0;0;3;2;1;3;2156;2;2;1;0;0;3;3;2156;0;2406;3;1;
/org.eclipse.compare/compare/org/eclipse/compare/internal/PatchParser.java;1;0;2;1;0;0;0;2;0;1;2;1258;0;0;1;0;0;2;2;1258;0;1314;2;1;
/org.eclipse.jdt.ui/core refactoring/org/eclipse/jdt/internal/core/refactoring/cus/CopyCompilationUnitChange.java;1;0;2;1;0;0;0;2;0;1;2;1257;0;0;1;0;0;2;2;1257;0;1342;2;1;
/org.eclipse.pde.ui/src/org/eclipse/pde/internal/editor/component/ComponentSourcePage.java;2;0;2;1;0;0;0;2;0;1;2;1434;0;0;1;0;0;2;2;1434;0;2951;2;2;
/org.eclipse.jdt.ui.tests.refactoring/resources/SelectionAnalyzerWorkSpace/SelectionAnalyzerTests/validSelection/A_test282.java;1;0;1;1;0;0;0;1;0;0;1;1368;0;0;1;0;0;1;1;1368;0;1368;1;1;
/org.eclipse.ui.tests/Eclipse UI Tests/org/eclipse/ui/tests/dialogs/UIWizardsAuto.java;3;0;5;1;0;0;0;5;27;1;5;1113;40;40;1;0;0;5;5;1113;0;2785;5;3;
/org.eclipse.jdt.ui.tests.refactoring/resources/MoveCU/testFail3/in/p/A.java;2;0;2;1;0;0;0;2;0;1;2;49;0;0;1;0;0;2;2;49;0;2769;2;2;
/org.eclipse.team.tests.cvs.core/src/org/eclipse/team/tests/ccvs/core/provider/AllTests.java;2;0;7;1;0;0;0;7;8;1;7;2536;14;14;1;0;0;7;7;2536;0;3250;7;2;
/org.eclipse.jdt.ui.tests.refactoring/resources/RenameVariables/canRename/A_test21_in.java;1;0;2;1;0;0;0;2;0;1;2;724;0;0;1;0;0;2;2;724;0;1665;2;1;
/org.eclipse.help.ui/Eclipse Help UI/org/eclipse/help/internal/ui/util/HelpWorkbenchException.java;2;0;3;1;0;0;0;3;7;1;3;136;7;7;1;0;0;3;3;136;0;1420;3;2;
/org.eclipse.vcm.core.cvs/src/org/eclipse/vcm/internal/core/ccvs/SyncInfoEntryIterator.java;2;0;5;1;0;0;0;5;28;1;5;0;60;60;1;0;0;5;5;0;0;392;5;2;
/org.eclipse.jdt.ui.tests.refactoring/resources/RenameType/testFail91/in/A.java;1;0;1;1;0;0;0;1;0;0;1;49;0;0;1;0;0;1;1;49;0;49;1;1;
/org.eclipse.jdt.ui.tests.refactoring/resources/RenameVariables/canRename/A_test13_out.java;1;0;2;1;0;0;0;2;0;1;2;724;0;0;1;0;0;2;2;724;0;1665;2;1;
/org.eclipse.update.core/src/org/eclipse/update/internal/core/FeatureExecutableContentProvider.java;2;0;17;1;1;1;1;16;261;2;15;2438;868;868;2;1;0;16;17;2790;1;4329;16;2;
/org.eclipse.swt.examples/src/org/eclipse/swt/examples/controlexample/ToolBarTab.java;5;1;7;1;3;3;3;4;445;1;4;513;814;814;1;0;0;4;7;513;0;4705;7;5;
/org.eclipse.scripting/Eclipse Scripting/org/eclipse/scripting/internal/IXGRElementContainer.java;1;0;3;1;0;0;0;3;4;1;3;133;4;4;1;0;0;3;3;133;0;1424;3;1;
/org.eclipse.jdt.core/dom/org/eclipse/jdt/core/dom/VariableBinding.java;3;0;9;1;0;0;0;9;7;2;8;2669;24;24;2;1;0;9;9;2755;1;3720;8;3;
/org.eclipse.jdt.core/model/org/eclipse/jdt/internal/core/util/ILRUCacheable.java;3;1;4;1;2;2;2;2;15;1;2;455;41;41;1;0;0;2;4;455;0;4422;4;3;
/org.eclipse.jdt.ui/ui/org/eclipse/jdt/internal/ui/browsing/JavaBrowsingContentProvider.java;2;1;9;1;9;9;9;0;38;0;0;4020;80;80;1;0;0;0;9;4020;0;4627;9;2;
/org.eclipse.core.tests.runtime/src/org/eclipse/core/tests/internal/plugins/SoftPrereqTest_12.java;3;0;3;1;0;0;0;3;106;1;3;1794;116;116;1;0;0;3;3;1794;0;3476;3;3;
/org.eclipse.jdt.ui.tests.refactoring/resources/RenameType/test26/out/B.java;1;0;1;1;0;0;0;1;0;0;1;522;0;0;1;0;0;1;1;522;0;522;1;1;
/org.eclipse.jdt.ui/ui/org/eclipse/jdt/internal/ui/JavaUIStatus.java;2;0;2;1;1;1;1;1;47;0;1;2770;47;47;1;0;0;1;2;2770;0;4621;2;2;
/org.eclipse.jdt.ui/ui/org/eclipse/jdt/ui/actions/AddGetterSetterAction.java;4;2;21;2;16;13;16;5;511;1;5;3533;840;840;2;0;3;5;21;4116;3;4770;18;4;
/org.eclipse.jdt.launching/launching/org/eclipse/jdt/launching/IVMInstallChangedListener.java;2;1;5;1;5;5;5;0;55;0;0;4097;90;90;1;0;0;0;5;4097;0;4224;5;2;
/org.eclipse.jdt.ui/core extension/org/eclipse/jdt/internal/corext/template/TemplateContext.java;1;0;1;1;0;0;0;1;0;0;1;2784;0;0;1;0;0;1;1;2784;0;2784;1;1;
/org.eclipse.swt.examples/org/eclipse/swt/examples/fileviewer/UpdateWorker.java;2;0;3;2;0;0;0;3;1;2;2;554;1;1;2;1;0;3;3;609;1;609;2;2;
/org.eclipse.ant.ui/src/org/eclipse/ant/internal/ui/AntLaunchDropDownAction.java;3;0;4;1;0;0;0;4;248;1;4;677;277;277;1;0;0;4;4;677;0;3606;4;3;
/org.eclipse.pde.ui/src/org/eclipse/pde/internal/ui/wizards/templates/PopupMenuNewWizard.java;1;0;3;1;0;0;0;3;8;1;3;3812;9;9;1;0;0;3;3;3812;0;3870;3;1;
/org.eclipse.help/webapps/examples/WEB-INF/classes/cal/TableBean.java;1;0;2;1;0;0;0;2;0;1;2;1882;0;0;1;0;0;2;2;1882;0;1930;2;1;
/org.eclipse.swt/Eclipse SWT Custom Widgets/common/org/eclipse/swt/custom/VerifyKeyListener.java;4;0;6;1;1;1;1;5;7;1;5;106;23;23;1;0;0;5;6;106;0;4701;6;4;
/org.eclipse.debug.ui/ui/org/eclipse/debug/internal/ui/LaunchSelectionAction.java;4;0;12;1;0;0;0;12;44;1;12;187;153;153;1;0;0;12;12;187;0;2382;12;4;
/org.eclipse.team.cvs.core/src/org/eclipse/team/internal/ccvs/core/syncinfo/ResourceSyncInfoMap.java;2;0;3;1;0;0;0;3;2;1;3;3123;2;2;1;0;0;3;3;3123;0;3398;3;2;
/org.eclipse.jdt.ui/core refactoring/org/eclipse/jdt/internal/core/refactoring/AbstractRenameChange.java;3;0;6;1;0;0;0;6;10;2;5;470;18;18;2;1;0;6;6;988;1;1800;5;3;
/org.eclipse.team.ui/src/org/eclipse/team/internal/ui/ProjectSetExportWizard.java;1;1;8;1;5;5;5;3;226;2;2;3728;276;276;2;1;0;3;8;3812;1;4668;7;1;
/org.eclipse.scripting/src/org/eclipse/scripting/internal/uirenderer/XGRElementUISwtScriptPreferenceDialog.java;1;0;1;1;0;0;0;1;0;0;1;1424;0;0;1;0;0;1;1;1424;0;1424;1;1;
/org.eclipse.ui/Eclipse JFace Text/org/eclipse/jface/text/information/IInformationPresenter.java;2;0;2;1;1;1;1;1;16;0;1;1435;16;16;1;0;0;1;2;1435;0;4838;2;2;
/org.eclipse.team.cvs.ui/src/org/eclipse/team/internal/ccvs/ui/merge/OverrideUpdateMergeAction.java;2;2;4;2;3;2;3;1;8;0;1;3288;14;14;2;0;1;1;4;4005;1;4455;3;2;
/org.eclipse.update.core/src/org/eclipse/update/internal/core/URLEntry.java;1;0;1;1;0;0;0;1;0;0;1;2419;0;0;1;0;0;1;1;2419;0;2419;1;1;
/org.eclipse.debug.core/core/org/eclipse/debug/core/ILaunchConfigurationWorkingCopy.java;3;0;9;1;1;1;1;8;31;1;8;1819;86;86;1;0;0;8;9;1819;0;4650;9;3;
/org.eclipse.jdt.ui.tests.refactoring/resources/RenameMethodInInterface/testFail27/in/A.java;1;0;1;1;0;0;0;1;0;0;1;49;0;0;1;0;0;1;1;49;0;49;1;1;
/org.eclipse.swt.examples/Eclipse SWT Examples/common/org/eclipse/swt/examples/controlexample/Images.java;1;0;2;1;0;0;0;2;0;1;2;107;0;0;1;0;0;2;2;107;0;611;2;1;
/org.eclipse.pde.ui/src/org/eclipse/pde/internal/base/schema/ISchemaRestriction.java;2;0;2;1;0;0;0;2;0;1;2;1434;0;0;1;0;0;2;2;1434;0;3579;2;2;
/org.eclipse.scripting/src/org/eclipse/scripting/internal/IXGRElementEventGeneratorOnReset.java;1;0;1;1;0;0;0;1;0;0;1;1424;0;0;1;0;0;1;1;1424;0;1424;1;1;
/org.eclipse.jdt.ui.tests.refactoring/resources/MoveMembers/test11/in/B.java;1;0;1;1;0;0;0;1;0;0;1;2738;0;0;1;0;0;1;1;2738;0;2738;1;1;
/org.eclipse.jdt.ui/core refactoring/org/eclipse/jdt/internal/core/refactoring/text/AddMemberChange.java;1;0;3;1;0;0;0;3;5;1;3;1453;5;5;1;0;0;3;3;1453;0;1800;3;1;
/org.eclipse.jdt.ui/core refactoring/org/eclipse/jdt/internal/core/refactoring/reorg/MoveRefactoring.java;2;0;6;1;0;0;0;6;43;1;6;1258;58;58;1;0;0;6;6;1258;0;1939;6;2;
/org.eclipse.pde.ui/src/org/eclipse/pde/internal/editor/manifest/ManifestSourceOutlinePage.java;2;0;2;1;0;0;0;2;0;1;2;1434;0;0;1;0;0;2;2;1434;0;3579;2;2;
/org.eclipse.team.ui/src/org/eclipse/team/internal/ui/target/LocalTargetSyncElement.java;2;2;3;2;3;2;3;0;10;0;0;4215;10;10;2;0;1;0;3;4245;1;4245;2;2;
/org.eclipse.jdt.ui.tests.refactoring/resources/RenameVariables/cannotRename/A_testFail16.java;1;0;2;1;0;0;0;2;0;1;2;724;0;0;1;0;0;2;2;724;0;1665;2;1;
/org.eclipse.ui.tests/Eclipse UI Tests/org/eclipse/ui/tests/SelectionProviderView.java;1;0;1;1;0;0;0;1;0;0;1;2008;0;0;1;0;0;1;1;2008;0;2008;1;1;
/org.eclipse.swt.examples.paint/src/org/eclipse/swt/examples/paint/PaintRenderer.java;2;0;2;1;0;0;0;2;0;1;2;391;0;0;1;0;0;2;2;391;0;611;2;2;
/org.eclipse.swt/Eclipse SWT/gtk/org/eclipse/swt/widgets/Scrollable.java;5;2;15;1;9;8;9;6;91;1;6;2107;240;240;2;0;1;6;15;4364;1;4701;14;5;
/org.eclipse.swt/Eclipse SWT/common/org/eclipse/swt/internal/image/WinBMPFileFormat.java;2;0;3;1;1;1;1;2;7;1;2;106;13;13;1;0;0;2;3;106;0;4701;3;2;
/org.eclipse.help/Eclipse Help/org/eclipse/help/internal/server/HelpServer.java;4;0;9;1;0;0;0;9;15;2;8;135;40;40;2;1;0;9;9;694;1;1420;8;4;
/org.eclipse.ui/Eclipse UI/org/eclipse/ui/internal/XMLMemento.java;4;0;6;1;0;0;0;6;579;2;5;257;685;685;2;1;0;6;6;3871;1;3871;5;4;
/org.eclipse.debug.ui/ui/org/eclipse/debug/internal/ui/views/launch/LaunchView.java;4;2;14;2;14;13;14;0;1724;0;0;3975;2026;2026;2;0;1;0;14;4400;1;4709;13;4;
/org.eclipse.pde.ui/src/org/eclipse/pde/internal/ui/wizards/extension/PointSelectionPage.java;1;0;2;1;0;0;0;2;9;1;2;3579;9;9;1;0;0;2;2;3579;0;3607;2;1;
/org.eclipse.ui.examples.readmetool/Eclipse UI Examples Readme Tool/org/eclipse/ui/examples/readmetool/MarkElement.java;1;0;1;1;0;0;0;1;0;0;1;932;0;0;1;0;0;1;1;932;0;932;1;1;
/org.eclipse.jdt.debug/eval/org/eclipse/jdt/internal/debug/eval/ast/instructions/AndAssignmentOperator.java;2;0;5;1;1;1;1;4;4;1;4;3421;11;11;1;0;0;4;5;3421;0;3955;5;2;
/org.eclipse.help/webapps/examples/jsp/plugin/applet/Clock2.java;1;0;2;1;0;0;0;2;0;1;2;1882;0;0;1;0;0;2;2;1882;0;1930;2;1;
/org.eclipse.jdt.ui.tests.refactoring/resources/RenameType/testFail93/in/A.java;1;0;1;1;0;0;0;1;0;0;1;49;0;0;1;0;0;1;1;49;0;49;1;1;
/org.eclipse.pde.core/src/org/eclipse/pde/internal/core/ExternalModelManager.java;1;0;6;1;1;1;1;5;146;1;5;3591;176;176;1;0;0;5;6;3591;0;3975;6;1;
/org.eclipse.vcm.ui/src/org/eclipse/vcm/internal/ui/HistorySorter.java;4;0;6;2;0;0;0;6;24;2;4;1;58;58;2;2;0;6;6;1;2;1171;4;4;
/org.eclipse.jdt.ui/core extension/org/eclipse/jdt/internal/corext/textmanipulation/TextRange.java;2;0;10;1;0;0;0;10;34;2;9;2137;87;87;2;1;0;10;10;2619;1;3825;9;2;
/org.eclipse.jdt.ui/core refactoring/org/eclipse/jdt/internal/corext/refactoring/structure/ReorderRenameParameterWrapperRefactoring.java;1;0;2;1;0;0;0;2;0;1;2;2630;0;0;1;0;0;2;2;2630;0;2820;2;1;
/org.eclipse.jdt.ui/ui/org/eclipse/jdt/ui/JavaElementImageDescriptor.java;2;1;6;1;4;4;4;2;24;1;2;2701;82;82;1;0;0;2;6;2701;0;4810;6;2;
/org.eclipse.update.examples/Eclipse Update Examples/org/eclipse/update/examples/ExamplesPlugin.java;1;0;2;1;0;0;0;2;0;1;2;474;0;0;1;0;0;2;2;474;0;1424;2;1;
/org.eclipse.help/src/org/eclipse/help/internal/topics/TopicsNavigationManager.java;2;0;4;1;0;0;0;4;180;1;4;1675;184;184;1;0;0;4;4;1675;0;1857;4;2;
/org.eclipse.ui/Eclipse UI/org/eclipse/ui/internal/WindowPartSelectionTracker.java;2;0;2;1;1;1;1;1;13;0;1;2999;13;13;1;0;0;1;2;2999;0;4195;2;2;
/org.eclipse.core.tests.resources/src/org/eclipse/core/tests/resources/session/TestBug20127.java;1;0;1;1;1;1;1;0;0;0;0;4692;0;0;1;0;0;0;1;4692;0;4692;1;1;
/org.eclipse.ui.tests/Eclipse UI Tests/org/eclipse/ui/tests/FileUtil.java;2;0;2;1;0;0;0;2;0;1;2;1003;0;0;1;0;0;2;2;1003;0;1073;2;2;
/org.eclipse.vcm.ui/src/org/eclipse/vcm/internal/ui/wizards/NewRepositoryWizard.java;2;0;2;1;0;0;0;2;0;1;2;1;0;0;1;0;0;2;2;1;0;31;2;2;
/org.eclipse.core.tests.resources/src/org/eclipse/core/tests/resources/ResourceDeltaVerifier.java;3;0;6;1;0;0;0;6;1464;1;6;1794;1526;1526;1;0;0;6;6;1794;0;3875;6;3;
/org.eclipse.jdt.ui.tests.refactoring/resources/SelectionAnalyzerWorkSpace/SelectionAnalyzerTests/invalidSelection/A_test122.java;2;0;2;1;0;0;0;2;0;1;2;1368;0;0;1;0;0;2;2;1368;0;2139;2;2;
/org.eclipse.pde.ui/src/org/eclipse/pde/internal/ui/wizards/NewWizard.java;1;0;1;1;0;0;0;1;0;0;1;3579;0;0;1;0;0;1;1;3579;0;3579;1;1;
/org.eclipse.update.ui/src/org/eclipse/update/internal/ui/manager/FeatureListSection.java;1;0;2;1;0;0;0;2;0;0;1;1457;0;0;2;1;0;2;2;1457;1;1457;1;1;
/org.eclipse.debug.ui/ui/org/eclipse/debug/internal/ui/actions/ConsoleTerminateActionDelegate.java;2;0;8;1;1;1;1;7;42;1;7;2382;111;111;1;0;0;7;8;2382;0;3975;8;2;
/org.eclipse.pde.ui/Eclipse PDE UI/org/eclipse/pde/internal/editor/component/ComponentForm.java;3;0;7;2;0;0;0;7;12;3;5;267;16;16;3;2;0;7;7;324;2;1434;5;3;
/org.eclipse.swt/Eclipse SWT PI/gtk/org/eclipse/swt/internal/gtk/GtkObject.java;1;0;2;1;0;0;0;2;0;1;2;2107;0;0;1;0;0;2;2;2107;0;3209;2;1;
/org.eclipse.pde.ui/Eclipse PDE UI/org/eclipse/pde/internal/editor/schema/DocSection.java;2;0;9;2;0;0;0;9;12;3;7;267;28;28;3;2;0;9;9;324;2;1434;7;2;
/org.eclipse.swt.examples/src/org/eclipse/swt/examples/helloworld/HelloWorld5.java;4;0;5;1;1;1;1;4;43;1;4;513;99;99;1;0;0;4;5;513;0;4705;5;4;
/org.eclipse.swt.tests/JUnit Tests/org/eclipse/swt/tests/junit/Test_org_eclipse_swt_program_Program.java;2;0;2;1;1;1;1;1;6;0;1;1792;6;6;1;0;0;1;2;1792;0;4706;2;2;
/org.eclipse.ui.tests/Eclipse UI Tests/org/eclipse/ui/tests/api/IPageServiceTest.java;3;0;8;1;0;0;0;8;102;2;7;882;152;152;2;1;0;8;8;882;1;3068;7;3;
/org.eclipse.core.resources/src/org/eclipse/core/resources/IContainer.java;2;0;11;1;1;1;1;10;672;2;9;12;1153;1153;2;1;0;10;11;3122;1;4214;10;2;
/org.eclipse.jdt.junit/Eclipse JUnit/org/eclipse/jdt/junit/internal/LauncherUtil.java;3;0;4;1;0;0;0;4;311;1;4;1511;335;335;1;0;0;4;4;1511;0;1996;4;3;
/org.eclipse.ui/Eclipse JFace Text/org/eclipse/jface/text/rules/IToken.java;3;0;3;1;0;0;0;3;30;1;3;257;35;35;1;0;0;3;3;257;0;1066;3;3;
/org.eclipse.ui/Eclipse UI/org/eclipse/ui/internal/registry/AcceleratorSet.java;2;0;5;1;0;0;0;5;23;1;5;3055;78;78;1;0;0;5;5;3055;0;3450;5;2;
/org.eclipse.swt/Eclipse SWT PI/win32/org/eclipse/swt/internal/ole/win32/IProvideClassInfo2.java;2;0;2;1;1;1;1;1;6;0;1;2069;6;6;1;0;0;1;2;2069;0;4701;2;2;
/org.eclipse.swt/Eclipse SWT PI/win32/org/eclipse/swt/internal/win32/NMCUSTOMDRAW.java;1;0;2;1;1;1;1;1;6;0;1;3122;6;6;1;0;0;1;2;3122;0;4701;2;1;
/org.eclipse.debug.core/core/org/eclipse/debug/internal/core/Launcher.java;3;0;6;1;0;0;0;6;20;1;6;187;57;57;1;0;0;6;6;187;0;3634;6;3;
/org.eclipse.jdt.core/model/org/eclipse/jdt/internal/core/builder/impl/ProblemDetailImpl.java;1;0;10;1;0;0;0;10;373;4;6;455;391;391;4;4;0;10;10;1039;4;2808;6;1;
/org.eclipse.jdt.ui.tests.refactoring/resources/SelectionAnalyzerWorkSpace/SelectionAnalyzerTests/validSelection/A_test270.java;1;0;1;1;0;0;0;1;0;0;1;1368;0;0;1;0;0;1;1;1368;0;1368;1;1;
/org.eclipse.help/src/org/eclipse/help/internal/toc/TocBuilder.java;2;0;3;1;0;0;0;3;19;1;3;1857;21;21;1;0;0;3;3;1857;0;3609;3;2;
/org.eclipse.vcm.core/src/org/eclipse/vcm/internal/core/Util.java;4;0;7;2;0;0;0;7;32;2;6;0;71;71;2;1;0;7;7;292;1;1567;6;4;
/org.eclipse.core.runtime/src/org/eclipse/core/internal/runtime/EclipseURLPluginHandlerFactory.java;1;0;2;1;0;0;0;2;0;1;2;12;0;0;1;0;0;2;2;12;0;23;2;1;
/org.eclipse.help/src/org/eclipse/help/IAppServer.java;3;0;7;1;0;0;0;7;17;1;7;2314;37;37;1;0;0;7;7;2314;0;3609;7;3;
/org.eclipse.core.resources/src/org/eclipse/core/internal/resources/MarkerReader_2.java;2;0;7;1;1;1;1;6;272;1;6;158;336;336;1;0;0;6;7;158;0;4213;7;2;
/org.eclipse.help/src/org/eclipse/help/AppServer.java;2;0;4;1;0;0;0;4;12;1;4;2913;29;29;1;0;0;4;4;2913;0;3530;4;2;
/org.eclipse.jdt.ui.tests.refactoring/resources/ExtractMethodWorkSpace/ExtractMethodTests/invalidSelection/A_test102.java;2;1;3;1;2;2;2;1;0;0;1;49;0;0;1;0;0;1;3;49;0;4419;3;2;
/org.eclipse.team.cvs.ui/src/org/eclipse/team/internal/ccvs/ui/CVSAbstractResolutionGenerator.java;2;1;6;1;2;2;2;4;20;2;3;3402;42;42;2;1;0;4;6;3402;1;4187;5;2;
/org.eclipse.jdt.core/compiler/org/eclipse/jdt/internal/compiler/env/ISourceMethod.java;2;0;5;1;1;1;1;4;104;1;4;455;129;129;1;0;0;4;5;455;0;4062;5;2;
/org.eclipse.pde.ui/src/org/eclipse/pde/internal/ui/wizards/project/ConvertJavaToPDEProjectAction.java;1;0;4;1;0;0;0;4;31;2;3;3579;54;54;2;1;0;4;4;3629;1;3629;3;1;
/org.eclipse.core.tests.runtime/src/org/eclipse/core/tests/internal/runtimetests/SampleJPB.java;1;0;2;1;0;0;0;2;10;1;2;3611;10;10;1;0;0;2;2;3611;0;3678;2;1;
/org.eclipse.help.ui/Eclipse Help UI/org/eclipse/help/internal/ui/IHyperlinkListener.java;2;0;3;1;0;0;0;3;7;1;3;136;7;7;1;0;0;3;3;136;0;1420;3;2;
/org.eclipse.ui/Eclipse UI/org/eclipse/ui/internal/WWinKeyBindingService.java;4;1;19;2;4;4;4;15;104;3;9;3177;398;398;3;6;0;15;19;3209;6;4725;13;4;
/org.eclipse.pde.ui/src/org/eclipse/pde/internal/core/ifeature/IFeatureEntry.java;1;0;2;1;0;0;0;2;0;1;2;3591;0;0;1;0;0;2;2;3591;0;3607;2;1;
/org.eclipse.swt/Eclipse SWT/gtk1x/org/eclipse/swt/widgets/Decorations.java;3;0;3;1;1;1;1;2;36;1;2;2107;42;42;1;0;0;2;3;2107;0;4701;3;3;
/org.eclipse.ui/Eclipse JFace Text/org/eclipse/jface/text/rules/RuleBasedPartitionScanner.java;1;0;3;1;1;1;1;2;41;1;2;3812;62;62;1;0;0;2;3;3812;0;4838;3;1;
/org.eclipse.jdt.core/search/org/eclipse/jdt/internal/core/search/indexing/BinaryIndexer.java;3;0;17;1;1;1;1;16;1162;4;13;455;1695;1695;4;3;0;16;17;1039;3;4063;14;3;
/org.eclipse.jdt.ui.tests.refactoring/resources/ExtractMethodWorkSpace/ExtractMethodTests/validSelection/A_test281.java;2;1;3;1;2;2;2;1;0;0;1;49;0;0;1;0;0;1;3;49;0;4419;3;2;
/org.eclipse.jdt.core/model/org/eclipse/jdt/core/IProblemRequestor.java;2;1;8;1;2;2;2;6;32;2;4;3114;83;83;2;2;0;6;8;3373;2;4061;6;2;
/org.eclipse.jdt.ui/ui refactoring/org/eclipse/jdt/internal/ui/refactoring/changes/DocumentTextBufferChangeCreator.java;2;0;5;1;0;0;0;5;6;1;5;15;14;14;1;0;0;5;5;15;0;2216;5;2;
/org.eclipse.jdt.ui/nls/org/eclipse/jdt/internal/ui/nls/FindStringsAction.java;1;0;5;1;0;0;0;5;78;2;3;1880;115;115;2;2;0;5;5;1880;2;1909;3;1;
/org.eclipse.jdt.debug/model/org/eclipse/jdt/internal/debug/core/RunToLineBreakpoint.java;1;0;1;1;0;0;0;1;0;0;1;831;0;0;1;0;0;1;1;831;0;831;1;1;
/org.eclipse.jdt.ui.tests.refactoring/resources/MoveMembers/test8/out/B.java;1;0;1;1;0;0;0;1;0;0;1;2738;0;0;1;0;0;1;1;2738;0;2738;1;1;
/org.eclipse.swt/Eclipse SWT/gtk1x/org/eclipse/swt/widgets/Tracker.java;3;0;3;1;1;1;1;2;6;1;2;2107;12;12;1;0;0;2;3;2107;0;4701;3;3;
/org.eclipse.jdt.ui.tests.refactoring/resources/ExtractMethodWorkSpace/ExtractMethodTests/return_out/A_test712.java;1;1;3;1;2;2;2;1;20;0;1;887;20;20;1;0;0;1;3;887;0;4419;3;1;
/org.eclipse.jdt.ui/core extension/org/eclipse/jdt/internal/corext/codegeneration/AddGetterSetterOperation.java;2;0;3;1;0;0;0;3;21;1;3;2016;21;21;1;0;0;3;3;2016;0;2137;3;2;
/org.eclipse.swt.examples.controls/src/org/eclipse/swt/examples/controls/ComboTab.java;2;0;2;1;0;0;0;2;0;1;2;391;0;0;1;0;0;2;2;391;0;611;2;2;
/org.eclipse.swt/Eclipse SWT Drag and Drop/emulated/org/eclipse/swt/dnd/TreeDragUnderEffect.java;2;1;3;1;2;2;2;1;6;0;1;3126;8;8;1;0;0;1;3;3126;0;4701;3;2;
/org.eclipse.jdt.ui/ui/org/eclipse/jdt/internal/ui/search/FindAction.java;1;0;2;1;2;1;2;0;0;0;0;4140;0;0;2;0;1;0;2;4140;1;4140;1;1;
/org.eclipse.jdt.debug/eval/org/eclipse/jdt/debug/eval/IEvaluationListener.java;2;0;6;1;1;1;1;5;14;1;5;1675;36;36;1;0;0;5;6;1675;0;4423;6;2;
/org.eclipse.ui/Eclipse UI Standard Components/org/eclipse/ui/views/properties/IPropertySheetEntryListener.java;2;0;2;1;0;0;0;2;5;1;2;257;5;5;1;0;0;2;2;257;0;457;2;2;
/org.eclipse.swt/Eclipse SWT/gtk/org/eclipse/swt/widgets/Control.java;5;3;72;2;29;18;29;43;2195;5;28;2107;4784;4784;5;15;11;43;72;3487;26;4701;46;5;
/org.eclipse.jdt.ui.tests/ui/org/eclipse/jdt/ui/wizards/examples/DialogFieldExample.java;2;0;2;1;0;0;0;2;0;1;2;522;0;0;1;0;0;2;2;522;0;1186;2;2;
/org.eclipse.jdt.launching/launching/org/eclipse/jdt/launching/SocketUtil.java;1;0;1;1;0;0;0;1;0;0;1;3132;0;0;1;0;0;1;1;3132;0;3132;1;1;
/org.eclipse.jdt.core/dom/org/eclipse/jdt/core/dom/BodyDeclaration.java;2;0;3;1;1;1;1;2;2;1;2;2669;4;4;1;0;0;2;3;2669;0;3942;3;2;
/org.eclipse.jdt.junit/src/org/eclipse/jdt/internal/junit/launcher/JUnitTabGroup.java;1;1;4;1;3;3;3;1;21;0;1;3466;31;31;1;0;0;1;4;3466;0;4453;4;1;
/org.eclipse.debug.ui/ui/org/eclipse/debug/internal/ui/actions/OpenDebugConfigurations.java;2;0;4;1;1;1;1;3;11;1;3;3152;22;22;1;0;0;3;4;3152;0;4004;4;2;
/org.eclipse.swt.examples/Eclipse SWT Examples/common/org/eclipse/swt/examples/imageexample/ImageAnalyzer.java;1;0;2;1;0;0;0;2;0;1;2;107;0;0;1;0;0;2;2;107;0;611;2;1;
/org.eclipse.pde.core/src/org/eclipse/pde/internal/core/SourceLocationManager.java;1;0;2;1;2;1;2;0;303;0;0;4409;303;303;2;0;1;0;2;4409;1;4409;1;1;
/org.eclipse.jdt.core/model/org/eclipse/jdt/internal/core/util/IDumpable.java;3;1;3;1;2;2;2;1;16;0;1;455;30;30;1;0;0;1;3;455;0;4422;3;3;
/org.eclipse.ui/Eclipse JFace/org/eclipse/jface/action/ContributionItem.java;3;0;4;1;0;0;0;4;50;1;4;257;78;78;1;0;0;4;4;257;0;3447;4;3;
/org.eclipse.core.tests.runtime/src/org/eclipse/core/tests/internal/runtimetests/SampleKPB.java;1;0;2;1;0;0;0;2;10;1;2;3611;10;10;1;0;0;2;2;3611;0;3678;2;1;
/org.eclipse.team.core/src/org/eclipse/team/core/IRepositoryMappingListener.java;1;0;1;1;1;1;1;0;0;0;0;4663;0;0;1;0;0;0;1;4663;0;4663;1;1;
/org.eclipse.help.ui/src/org/eclipse/help/ui/internal/search/CheckboxLabelProvider.java;2;0;2;1;0;0;0;2;0;1;2;2429;0;0;1;0;0;2;2;2429;0;3074;2;2;
/org.eclipse.help/src/org/eclipse/help/internal/search/ProcessedQuery.java;2;0;3;1;0;0;0;3;10;1;3;2429;10;10;1;0;0;3;3;2429;0;3186;3;2;
/org.eclipse.pde.ui/src/org/eclipse/pde/ui/templates/NewPluginTemplateWizard.java;1;0;2;1;1;1;1;1;56;0;1;3840;56;56;1;0;0;1;2;3840;0;4752;2;1;
/org.eclipse.update.ui/src/org/eclipse/update/internal/ui/parts/DefaultContentProvider.java;1;0;1;1;0;0;0;1;0;0;1;1460;0;0;1;0;0;1;1;1460;0;1460;1;1;
/org.eclipse.vcm.tests.core.cvs.ssh/src/org/eclipse/vcm/tests/core/ccvs/ssh/ClientTestSimple.java;1;0;1;1;0;0;0;1;0;0;1;1688;0;0;1;0;0;1;1;1688;0;1688;1;1;
/org.eclipse.jdt.ui.tests.refactoring/resources/MoveCU/test/out/p1/A.java;2;0;2;1;0;0;0;2;0;1;2;49;0;0;1;0;0;2;2;49;0;2769;2;2;
/org.eclipse.jdt.ui.tests.refactoring/resources/ExtractMethodWorkSpace/ExtractMethodTests/invalidSelection/A_test161.java;2;1;4;1;2;2;2;2;2;1;2;296;2;2;1;0;0;2;4;296;0;4419;4;2;
/org.eclipse.pde.ui/Eclipse PDE UI/org/eclipse/pde/internal/editor/schema/CompositorPropertySource.java;2;0;5;2;0;0;0;5;12;3;3;267;12;12;3;2;0;5;5;324;2;1434;3;2;
/org.eclipse.jdt.ui/ui/org/eclipse/jdt/ui/actions/FindReferencesInHierarchyAction.java;2;1;2;1;2;2;2;0;9;0;0;4141;9;9;1;0;0;0;2;4141;0;4770;2;2;
/org.eclipse.team.core/src/org/eclipse/team/core/DefaultMoveDeleteHook.java;2;0;3;1;0;0;0;3;14;1;3;3211;14;14;1;0;0;3;3;3211;0;3268;3;2;
/org.eclipse.jdt.core/model/org/eclipse/jdt/internal/core/builder/NotPresentException.java;1;0;4;1;0;0;0;4;23;1;4;455;29;29;1;0;0;4;4;455;0;2808;4;1;
/org.eclipse.jdt.ui/ui/org/eclipse/jdt/internal/ui/wizards/dialogfields/IDialogFieldListener.java;2;0;3;1;0;0;0;3;9;1;3;15;15;15;1;0;0;3;3;15;0;1342;3;2;
/org.eclipse.jdt.ui/ui/org/eclipse/jdt/internal/ui/wizards/SuperInterfaceSelectionDialog.java;6;1;15;2;3;3;3;12;18;2;11;15;112;112;2;1;0;12;15;1258;1;4630;14;6;
/org.eclipse.jdt.ui/ui/org/eclipse/jdt/internal/ui/javaeditor/DeleteISourceManipulationsAction.java;3;0;4;1;1;1;1;3;24;1;3;15;37;37;1;0;0;3;4;15;0;4400;4;3;
/org.eclipse.jdt.ui.tests.refactoring/resources/RenamePackage/test5/in/r/A.java;1;0;1;1;0;0;0;1;0;0;1;1274;0;0;1;0;0;1;1;1274;0;1274;1;1;
/org.eclipse.swt.examples/Eclipse SWT Examples/common/org/eclipse/swt/examples/javaviewer/JavaViewer.java;1;0;2;1;0;0;0;2;0;1;2;107;0;0;1;0;0;2;2;107;0;611;2;1;
/org.eclipse.jdt.ui.tests.refactoring/resources/RenamePrivateField/testFail4/in/A.java;1;0;1;1;0;0;0;1;0;0;1;49;0;0;1;0;0;1;1;49;0;49;1;1;
/org.eclipse.pde.ui/Eclipse PDE UI/org/eclipse/pde/internal/editor/schema/DescriptionSection.java;2;0;7;2;0;0;0;7;12;3;5;267;21;21;3;2;0;7;7;324;2;1434;5;2;
/org.eclipse.scripting/src/org/eclipse/scripting/internal/views/ScriptUIEditorXmlParser.java;1;0;1;1;0;0;0;1;0;0;1;1424;0;0;1;0;0;1;1;1424;0;1424;1;1;
/org.eclipse.pde.ui/src/org/eclipse/pde/internal/ui/editor/feature/NewFeatureRequireWizardPage.java;1;0;1;1;1;1;1;0;0;0;0;4262;0;0;1;0;0;0;1;4262;0;4262;1;1;
/org.eclipse.team.cvs.ui/src/org/eclipse/team/internal/ccvs/ui/wizards/BranchWizardBranchPage.java;2;0;2;1;0;0;0;2;0;1;2;3191;0;0;1;0;0;2;2;3191;0;3473;2;2;
/org.eclipse.pde.core/src/org/eclipse/pde/internal/core/feature/FeatureInstallHandler.java;1;0;2;1;1;1;1;1;56;0;1;3591;56;56;1;0;0;1;2;3591;0;3994;2;1;
/org.eclipse.swt/Eclipse SWT PI/win32/org/eclipse/swt/internal/win32/REBARBANDINFO.java;3;0;4;1;1;1;1;3;6;1;3;2069;9;9;1;0;0;3;4;2069;0;4701;4;3;
/org.eclipse.jdt.ui/ui refactoring/org/eclipse/jdt/internal/ui/refactoring/MoveCompilationUnitWizardPage.java;3;0;8;1;0;0;0;8;88;1;8;142;111;111;1;0;0;8;8;142;0;1258;8;3;
/org.eclipse.jdt.ui.tests.refactoring/resources/SelectionAnalyzerWorkSpace/SelectionAnalyzerTests/validSelection/A_test095_.java;1;0;1;1;0;0;0;1;0;0;1;2139;0;0;1;0;0;1;1;2139;0;2139;1;1;
/org.eclipse.ui/Eclipse UI/org/eclipse/ui/internal/ObjectFilterTest.java;1;0;1;1;0;0;0;1;0;0;1;2022;0;0;1;0;0;1;1;2022;0;2022;1;1;
/org.eclipse.ui/Eclipse JFace/org/eclipse/jface/action/SubContributionManager.java;5;1;7;1;3;3;3;4;19;1;4;257;81;81;1;0;0;4;7;257;0;4428;7;5;
/org.eclipse.debug.core/core/org/eclipse/debug/core/IDebugEventListener.java;2;0;6;1;0;0;0;6;5;1;6;187;15;15;1;0;0;6;6;187;0;3635;6;2;
/org.eclipse.ui/Eclipse UI/org/eclipse/ui/IWorkbenchWindowPulldownDelegate.java;2;0;2;1;0;0;0;2;5;1;2;257;5;5;1;0;0;2;2;257;0;457;2;2;
/org.eclipse.ui/Eclipse UI Standard Components/org/eclipse/ui/views/contentoutline/ContentOutline.java;5;0;7;1;0;0;0;7;51;1;7;257;76;76;1;0;0;7;7;257;0;3029;7;5;
/org.eclipse.jdt.ui.tests.refactoring/resources/MoveMembers/test6/in/A.java;1;0;1;1;0;0;0;1;0;0;1;2738;0;0;1;0;0;1;1;2738;0;2738;1;1;
/org.eclipse.jdt.junit/src/org/eclipse/jdt/internal/junit/wizards/Messages.java;2;0;2;1;0;0;0;2;0;1;2;3527;0;0;1;0;0;2;2;3527;0;3659;2;2;
/org.eclipse.pde.ui/src/org/eclipse/pde/internal/util/ImageOverlayIcon.java;1;0;2;1;0;0;0;2;0;1;2;2847;0;0;1;0;0;2;2;2847;0;3579;2;1;
/org.eclipse.team.ftp/src/org/eclipse/team/internal/ftp/client/FTPServerLocation.java;1;0;1;1;1;1;1;0;0;0;0;4285;0;0;1;0;0;0;1;4285;0;4285;1;1;
/org.eclipse.swt.tests/JUnit Tests/org/eclipse/swt/tests/junit/Test_org_eclipse_swt_custom_TableTreeItem.java;2;0;2;1;1;1;1;1;6;0;1;1792;6;6;1;0;0;1;2;1792;0;4706;2;2;
/org.eclipse.team.cvs.core/src/org/eclipse/team/internal/ccvs/core/ICVSFile.java;2;0;11;1;1;1;1;10;96;2;9;3012;188;188;2;1;0;10;11;3577;1;3921;10;2;
/org.eclipse.jdt.ui/ui/org/eclipse/jdt/ui/wizards/NewContainerWizardPage.java;4;1;9;1;3;3;3;6;125;1;6;3089;156;156;1;0;0;6;9;3089;0;4823;9;4;
/org.eclipse.team.ui/src/org/eclipse/team/internal/ui/target/TargetWizardPage.java;2;1;2;1;2;2;2;0;9;0;0;4155;9;9;1;0;0;0;2;4155;0;4164;2;2;
/org.eclipse.swt/Eclipse SWT PI/gtk/org/eclipse/swt/internal/gtk/GtkDialog.java;1;0;2;1;0;0;0;2;0;1;2;2107;0;0;1;0;0;2;2;2107;0;3209;2;1;
/org.eclipse.jdt.ui.tests.refactoring/resources/RenameMethodInInterface/testFail10/in/A.java;1;0;1;1;0;0;0;1;0;0;1;49;0;0;1;0;0;1;1;49;0;49;1;1;
/org.eclipse.core.runtime/src/org/eclipse/core/runtime/IAdapterManager.java;3;0;4;1;1;1;1;3;214;1;3;12;235;235;1;0;0;3;4;12;0;4214;4;3;
/org.eclipse.jdt.ui.tests.refactoring/resources/RenameTemp/cannotRename/A_testFail16.java;1;0;2;1;0;0;0;2;2;1;2;1625;2;2;1;0;0;2;2;1625;0;1652;2;1;
/org.eclipse.jdt.ui.tests.refactoring/resources/ExtractMethodWorkSpace/ExtractMethodTests/locals_in/A_test508.java;2;1;4;1;2;2;2;2;24;1;2;95;48;48;1;0;0;2;4;95;0;4419;4;2;
/org.eclipse.jdt.ui.tests/JUnit/junit/ui/ProgressBar.java;2;0;2;1;0;0;0;2;0;1;2;49;0;0;1;0;0;2;2;49;0;1186;2;2;
/org.eclipse.jdt.junit/Eclipse JUnit/org/eclipse/jdt/internal/junit/ui/OpenEditorAction.java;2;0;2;1;0;0;0;2;0;1;2;2399;0;0;1;0;0;2;2;2399;0;3313;2;2;
/org.eclipse.swt/Eclipse SWT/motif/org/eclipse/swt/graphics/FontMetrics.java;3;1;4;1;2;2;2;2;73;1;2;106;83;83;1;0;0;2;4;106;0;4701;4;3;
/org.eclipse.jdt.core/model/org/eclipse/jdt/internal/core/newbuilder/ClasspathMultiDirectory.java;1;0;10;1;0;0;0;10;95;1;10;1764;120;120;1;0;0;10;10;1764;0;2979;10;1;
/org.eclipse.jdt.ui/ui/org/eclipse/jdt/internal/ui/reorg/RefactoringSupportFactory.java;4;0;25;2;0;0;0;25;154;2;21;132;994;994;2;4;0;25;25;343;4;2804;21;4;
/org.eclipse.jdt.ui/ui/org/eclipse/jdt/internal/ui/dialogs/CheckedTreeSelectionDialog.java;4;0;8;1;1;1;1;7;6;2;6;2232;20;20;2;1;0;7;8;2826;1;4015;7;4;
/org.eclipse.team.ui/src/org/eclipse/team/ui/actions/ToggleNavigatorDecorations.java;2;0;3;1;0;0;0;3;115;1;3;1978;115;115;1;0;0;3;3;1978;0;2061;3;2;
/org.eclipse.jdt.core/model/org/eclipse/jdt/internal/core/SingleTypeRequestor.java;2;0;3;1;1;1;1;2;116;1;2;455;138;138;1;0;0;2;3;455;0;4063;3;2;
/org.eclipse.ui/Eclipse UI/org/eclipse/ui/part/DrillFrame.java;2;0;2;1;0;0;0;2;5;1;2;257;5;5;1;0;0;2;2;257;0;457;2;2;
/org.eclipse.jdt.ui/ui debug/org/eclipse/jdt/internal/debug/ui/display/EvaluateAction.java;5;0;17;1;0;0;0;17;131;3;14;345;505;505;3;3;0;17;17;471;3;1916;14;5;
/org.eclipse.pde.ui/Eclipse PDE UI/org/eclipse/pde/internal/editor/jars/PluginJarsEditor.java;2;0;7;2;0;0;0;7;20;3;5;267;34;34;3;2;0;7;7;324;2;1434;5;2;
/org.eclipse.jdt.ui.tests.refactoring/resources/PullUpMethods/test12/out/A.java;1;0;2;1;0;0;0;2;0;1;2;2212;0;0;1;0;0;2;2;2212;0;2406;2;1;
/org.eclipse.ant.core/src/org/eclipse/ant/core/EclipseFileUtils.java;2;0;3;1;0;0;0;3;154;1;3;1986;154;154;1;0;0;3;3;1986;0;3489;3;2;
/org.eclipse.jdt.core/dom/org/eclipse/jdt/core/dom/ASTNode.java;3;2;20;2;10;7;10;10;440;1;10;2669;760;760;2;0;3;10;20;3942;3;4452;17;3;
/org.eclipse.jdt.junit/Eclipse JUnit/org/eclipse/jdt/internal/junit/ui/IRunViewContext.java;1;0;2;1;0;0;0;2;0;1;2;2007;0;0;1;0;0;2;2;2007;0;2028;2;1;
/org.eclipse.jdt.ui/core extension/org/eclipse/jdt/internal/corext/codemanipulation/PositionUpdater.java;1;0;3;1;0;0;0;3;228;1;3;1937;228;228;1;0;0;3;3;1937;0;2133;3;1;
/org.eclipse.swt/Eclipse SWT PI/win32/org/eclipse/swt/internal/ole/win32/ISpecifyPropertyPages.java;2;0;2;1;1;1;1;1;6;0;1;2069;6;6;1;0;0;1;2;2069;0;4701;2;2;
/org.eclipse.update/Eclipse Update/org/eclipse/update/internal/ui/JarVerificationService.java;2;0;4;1;0;0;0;4;238;1;4;108;242;242;1;0;0;4;4;108;0;1424;4;2;
/org.eclipse.jdt.core/compiler/org/eclipse/jdt/internal/compiler/SourceElementParser.java;3;1;43;2;4;4;4;39;1727;4;31;455;2799;2799;4;8;0;39;43;1039;8;4421;35;3;
/org.eclipse.jdt.ui.tests.refactoring/resources/SelectionAnalyzerWorkSpace/SelectionAnalyzerTests/invalidSelection/A_test095.java;2;0;2;1;0;0;0;2;0;1;2;1368;0;0;1;0;0;2;2;1368;0;2139;2;2;
/org.eclipse.swt/Eclipse SWT Custom Widgets/common_j2se/org/eclipse/swt/custom/CCombo.java;1;0;1;1;0;0;0;1;0;0;1;1378;0;0;1;0;0;1;1;1378;0;1378;1;1;
/org.eclipse.jdt.ui.tests.refactoring/resources/RenamePrivateMethod/test18/out/A.java;1;0;1;1;0;0;0;1;0;0;1;49;0;0;1;0;0;1;1;49;0;49;1;1;
/org.eclipse.jdt.ui/ui/org/eclipse/jdt/ui/actions/SelfEncapsulateFieldAction.java;2;1;8;1;4;4;4;4;14;2;3;3716;55;55;2;1;0;4;8;3716;1;4770;7;2;
/org.eclipse.swt.tests/JUnit Tests/org/eclipse/swt/tests/junit/Test_org_eclipse_swt_widgets_Caret.java;2;0;2;1;1;1;1;1;6;0;1;1792;6;6;1;0;0;1;2;1792;0;4706;2;2;
/org.eclipse.core.resources/src/org/eclipse/core/internal/resources/TestingSupport.java;1;0;2;1;0;0;0;2;2;1;2;3363;2;2;1;0;0;2;2;3363;0;3528;2;1;
/org.eclipse.ui.tests/Eclipse UI Tests/org/eclipse/ui/tests/navigator/AbstractNavigatorTest.java;2;0;2;1;0;0;0;2;2;1;2;2290;2;2;1;0;0;2;2;2290;0;2785;2;2;
/org.eclipse.help/Eclipse Help/org/eclipse/help/internal/HelpPlugin.java;2;0;4;1;0;0;0;4;65;1;4;135;72;72;1;0;0;4;4;135;0;1420;4;2;
/org.eclipse.debug.core/core/org/eclipse/debug/core/ILaunchListener.java;2;0;6;2;0;0;0;6;33;2;5;187;48;48;2;1;0;6;6;2390;1;3460;5;2;
/org.eclipse.jdt.ui.tests.refactoring/resources/RenameType/testFail41/in/A.java;1;0;1;1;0;0;0;1;0;0;1;49;0;0;1;0;0;1;1;49;0;49;1;1;
/org.eclipse.jdt.ui.tests.refactoring/resources/RenameMethodInInterface/testFail11/in/A.java;1;0;1;1;0;0;0;1;0;0;1;49;0;0;1;0;0;1;1;49;0;49;1;1;
/org.eclipse.ant.core/src/org/eclipse/ant/core/toolscripts/ToolScript.java;1;0;3;1;0;0;0;3;14;1;3;2919;14;14;1;0;0;3;3;2919;0;2979;3;1;
/org.eclipse.jdt.ui/core refactoring/org/eclipse/jdt/internal/core/refactoring/PrettySignature.java;3;0;4;1;0;0;0;4;5;1;4;15;9;9;1;0;0;4;4;15;0;1939;4;3;
/org.eclipse.ui/Eclipse JFace Text/org/eclipse/jface/text/contentassist/IContextInformationExtension.java;1;0;2;1;1;1;1;1;28;0;1;2878;28;28;1;0;0;1;2;2878;0;4838;2;1;
/org.eclipse.swt/Eclipse SWT/win32/org/eclipse/swt/graphics/Font.java;3;1;4;1;2;2;2;2;20;1;2;106;28;28;1;0;0;2;4;106;0;4701;4;3;
/org.eclipse.search/search/org/eclipse/search/internal/ui/text/TextSearchPage.java;2;1;36;1;6;6;6;30;172;2;27;15;840;840;2;3;0;30;36;1000;3;4422;33;2;
/org.eclipse.jdt.ui.tests.refactoring/resources/ExtractMethodWorkSpace/ExtractMethodTests/invalidSelection/A_test110.java;2;1;3;1;2;2;2;1;0;0;1;49;0;0;1;0;0;1;3;49;0;4419;3;2;
/org.eclipse.jdt.ui.tests.refactoring/resources/ExtractTemp/cannotExtract/A_testFail1.java;1;0;1;1;0;0;0;1;0;0;1;2481;0;0;1;0;0;1;1;2481;0;2481;1;1;
/org.eclipse.jdt.debug.tests/tests/org/eclipse/jdt/debug/tests/eval/NestedTypeFieldValue_109.java;2;1;3;1;3;3;3;0;12;0;0;4447;14;14;1;0;0;0;3;4447;0;4571;3;2;
/org.eclipse.core.target/src/org/eclipse/core/internal/target/Sorter.java;1;0;4;1;1;1;1;3;112;1;3;12;133;133;1;0;0;3;4;12;0;4196;4;1;
/org.eclipse.jdt.debug/jdi/org/eclipse/jdi/internal/jdwp/JdwpThreadGroupID.java;2;0;3;1;0;0;0;3;5;1;3;187;8;8;1;0;0;3;3;187;0;3040;3;2;
/org.eclipse.ui/Eclipse UI/org/eclipse/ui/internal/CloseAllPerspectivesAction.java;1;0;2;1;0;0;0;2;4;1;2;3103;4;4;1;0;0;2;2;3103;0;3122;2;1;
/org.eclipse.jdt.ui.tests.refactoring/resources/InlineTemp/cannotInline/A_testFail12.java;1;0;1;1;1;1;1;0;0;0;0;4620;0;0;1;0;0;0;1;4620;0;4620;1;1;
/org.eclipse.team.cvs.core/src/org/eclipse/team/internal/ccvs/core/ILogEntry.java;3;0;8;1;0;0;0;8;111;2;7;1978;335;335;2;1;0;8;8;2049;1;3610;7;3;
/org.eclipse.jdt.ui/core refactoring/org/eclipse/jdt/core/refactoring/methods/SafeDeleteMethodRefactoring.java;1;0;3;1;0;0;0;3;6;1;3;15;6;6;1;0;0;3;3;15;0;47;3;1;
/org.eclipse.jdt.core/model/org/eclipse/jdt/internal/core/SourceMethod.java;3;0;12;1;1;1;1;11;371;4;8;455;505;505;4;3;0;11;12;1039;3;4063;9;3;
/org.eclipse.update.tests.core/src/org/eclipse/update/tests/api/MyURLEntry.java;2;0;2;1;0;0;0;2;25;1;2;2462;25;25;1;0;0;2;2;2462;0;2583;2;2;
/org.eclipse.jdt.core/model/org/eclipse/jdt/internal/core/builder/IMethod.java;1;0;4;1;0;0;0;4;23;1;4;455;24;24;1;0;0;4;4;455;0;2808;4;1;
/org.eclipse.update.core/src/org/eclipse/update/internal/core/obsolete/DefaultSite.java;1;0;1;1;0;0;0;1;0;0;1;2465;0;0;1;0;0;1;1;2465;0;2465;1;1;
/org.eclipse.swt/Eclipse SWT/common/org/eclipse/swt/events/SelectionEvent.java;3;2;5;1;3;2;3;2;23;1;2;106;40;40;2;0;1;2;5;4554;1;4701;4;3;
/org.eclipse.jdt.core/model/org/eclipse/jdt/core/IPackageFragment.java;2;1;13;1;3;3;3;10;235;4;6;455;471;471;4;4;0;10;13;1039;4;4421;9;2;
/org.eclipse.update.core/src/org/eclipse/update/core/model/ConfigurationPolicyModel.java;1;0;3;1;0;0;0;3;27;1;3;2764;27;27;1;0;0;3;3;2764;0;3027;3;1;
/org.eclipse.jdt.ui.tests.refactoring/resources/ReorderParameters/canReorder/A_test3_out.java;1;0;3;1;0;0;0;3;0;1;3;724;0;0;1;0;0;3;3;724;0;2270;3;1;
/org.eclipse.team.cvs.ui/src/org/eclipse/team/internal/ccvs/ui/actions/SetKeywordSubstitutionAction.java;2;1;9;2;2;2;2;7;22;3;5;3206;54;54;3;2;0;7;9;3206;2;4021;7;2;
/org.eclipse.jdt.ui/ui/org/eclipse/jdt/internal/ui/packageview/BuildGroup.java;4;1;9;1;2;2;2;7;100;1;7;15;213;213;1;0;0;7;9;15;0;4137;9;4;
/org.eclipse.vcm.ui/src/org/eclipse/vcm/internal/ui/VersionLabelDialog.java;4;0;6;2;0;0;0;6;13;2;5;1;24;24;2;1;0;6;6;295;1;1686;5;4;
/org.eclipse.jdt.ui.tests.refactoring/resources/RenameMethodInInterface/testFail32/in/A.java;1;0;1;1;0;0;0;1;0;0;1;49;0;0;1;0;0;1;1;49;0;49;1;1;
/org.eclipse.ui/Eclipse JFace Text/org/eclipse/jface/text/DocumentAdapter.java;5;1;10;1;4;4;4;6;248;1;6;257;540;540;1;0;0;6;10;257;0;4838;10;5;
/org.eclipse.jdt.ui.tests.refactoring/resources/SelectionAnalyzerWorkSpace/SelectionAnalyzerTests/invalidSelection/A_test085.java;1;0;1;1;0;0;0;1;0;0;1;1368;0;0;1;0;0;1;1;1368;0;1368;1;1;
/org.eclipse.pde.ui/src/org/eclipse/pde/internal/ui/wizards/extension/NewSchemaFileMainPage.java;1;0;2;1;0;0;0;2;2;1;2;3579;2;2;1;0;0;2;2;3579;0;3591;2;1;
/org.eclipse.core.tests.runtime/src/org/eclipse/core/tests/internal/plugins/TestClass.java;3;0;3;1;0;0;0;3;10;1;3;1794;18;18;1;0;0;3;3;1794;0;3476;3;3;
/org.eclipse.swt/Eclipse SWT/common/org/eclipse/swt/events/ModifyListener.java;4;0;5;1;1;1;1;4;6;1;4;106;18;18;1;0;0;4;5;106;0;4701;5;4;
/org.eclipse.jdt.ui/core refactoring/org/eclipse/jdt/internal/corext/refactoring/RefactoringCoreMessages.java;1;0;1;1;0;0;0;1;0;0;1;1939;0;0;1;0;0;1;1;1939;0;1939;1;1;
/org.eclipse.core.runtime/src/org/eclipse/core/internal/runtime/PlatformURLFragmentConnection.java;3;0;7;2;1;1;1;6;124;2;4;23;229;229;2;2;0;6;7;23;2;4213;5;3;
/org.eclipse.jdt.ui.tests.refactoring/resources/RenameType/testFail37/in/A.java;1;0;1;1;0;0;0;1;0;0;1;49;0;0;1;0;0;1;1;49;0;49;1;1;
/org.eclipse.core.resources/src/org/eclipse/core/internal/resources/MarkerWriter.java;2;0;4;1;1;1;1;3;376;1;3;158;403;403;1;0;0;3;4;158;0;4213;4;2;
/org.eclipse.pde.ui/src/org/eclipse/pde/internal/ui/model/ifeature/IFeatureData.java;1;0;2;1;0;0;0;2;0;1;2;3579;0;0;1;0;0;2;2;3579;0;3591;2;1;
/org.eclipse.pde.ui/Eclipse PDE UI/org/eclipse/pde/internal/base/schema/IMetaElement.java;2;0;5;2;0;0;0;5;12;3;3;267;12;12;3;2;0;5;5;324;2;1434;3;2;
/org.eclipse.jdt.ui/ui refactoring/org/eclipse/jdt/internal/ui/refactoring/nls/search/LineReader.java;3;0;3;1;1;1;1;2;7;1;2;1922;11;11;1;0;0;2;3;1922;0;4602;3;3;
/org.eclipse.core.tests.resources/src/org/eclipse/core/tests/internal/localstore/HistoryStoreTest.java;3;1;6;1;2;2;2;4;2604;1;4;1794;2962;2962;1;0;0;4;6;1794;0;4516;6;3;
/org.eclipse.jdt.ui.tests.refactoring/resources/RenameType/testIllegalTypeName9/in/A.java;1;0;1;1;0;0;0;1;0;0;1;2101;0;0;1;0;0;1;1;2101;0;2101;1;1;
/org.eclipse.swt.examples.controls/src/org/eclipse/swt/examples/controls/LabelTab.java;2;0;2;1;0;0;0;2;0;1;2;391;0;0;1;0;0;2;2;391;0;611;2;2;
/org.eclipse.pde.ui/src/org/eclipse/pde/internal/model/AbstractModel.java;2;0;7;1;0;0;0;7;19;1;7;1434;60;60;1;0;0;7;7;1434;0;3579;7;2;
/org.eclipse.swt/Eclipse SWT PI/win32/org/eclipse/swt/internal/win32/PAINTSTRUCT.java;2;0;2;1;1;1;1;1;6;0;1;2069;6;6;1;0;0;1;2;2069;0;4701;2;2;
/org.eclipse.jdt.ui.tests.refactoring/resources/ExtractMethodWorkSpace/ExtractMethodTests/invalidSelection/A_test108.java;2;1;3;1;2;2;2;1;0;0;1;49;0;0;1;0;0;1;3;49;0;4419;3;2;
/org.eclipse.jdt.junit/Eclipse JUnit/org/eclipse/jdt/internal/junit/ui/Launcher.java;1;0;2;1;0;0;0;2;0;1;2;2007;0;0;1;0;0;2;2;2007;0;2143;2;1;
/org.eclipse.help.ui/src/org/eclipse/help/ui/internal/search/HelpSearchSorter.java;1;0;3;1;1;1;1;2;5;1;2;3030;7;7;1;0;0;2;3;3030;0;4439;3;1;
/org.eclipse.jdt.ui/ui/org/eclipse/jdt/internal/ui/packageview/FilterWorkingSetAction.java;2;0;6;1;0;0;0;6;25;1;6;1693;40;40;1;0;0;6;6;1693;0;3678;6;2;
/org.eclipse.help/src/org/eclipse/help/internal/navigation1_0/InfosetsMap.java;2;0;3;1;0;0;0;3;25;1;3;1675;25;25;1;0;0;3;3;1675;0;2217;3;2;
/org.eclipse.core.resources/src/org/eclipse/core/internal/indexing/IndexAnchorFactory.java;3;0;3;1;0;0;0;3;5;1;3;12;5;5;1;0;0;3;3;12;0;448;3;3;
/org.eclipse.ui/Eclipse UI/org/eclipse/ui/internal/model/WorkspaceFactory.java;2;0;2;1;0;0;0;2;7;1;2;257;7;7;1;0;0;2;2;257;0;457;2;2;
/org.eclipse.jdt.ui/core refactoring/org/eclipse/jdt/internal/core/refactoring/base/ITextChange.java;2;0;3;1;0;0;0;3;22;1;3;408;22;22;1;0;0;3;3;408;0;1939;3;2;
/org.eclipse.help/src/org/eclipse/help/internal/search/SearchFacade.java;2;0;2;1;0;0;0;2;0;1;2;2318;0;0;1;0;0;2;2;2318;0;2325;2;2;
/org.eclipse.compare/compare/org/eclipse/compare/rangedifferencer/DifferencesIterator.java;1;0;2;1;0;0;0;2;5;1;2;14;5;5;1;0;0;2;2;14;0;329;2;1;
/org.eclipse.jdt.ui/core refactoring/org/eclipse/jdt/internal/core/refactoring/changes/RenameCompilationUnitChange.java;2;0;3;1;0;0;0;3;4;1;3;1342;4;4;1;0;0;3;3;1342;0;1939;3;2;
/org.eclipse.jdt.ui.tests.refactoring/resources/RenameTemp/canRename/A_test42_in.java;1;0;1;1;0;0;0;1;0;0;1;3322;0;0;1;0;0;1;1;3322;0;3322;1;1;
/org.eclipse.ui.tests/Eclipse UI Tests/org/eclipse/ui/tests/api/IWorkbenchPartSiteTest.java;2;0;4;1;0;0;0;4;5;1;4;1097;9;9;1;0;0;4;4;1097;0;2785;4;2;
/org.eclipse.jdt.ui/ui/org/eclipse/jdt/internal/ui/javaeditor/OpenOnSelectionAction.java;4;0;14;1;1;1;1;13;325;1;13;15;586;586;1;0;0;13;14;15;0;3968;14;4;
/org.eclipse.scripting/Eclipse Scripting/org/eclipse/scripting/internal/uirenderer/XGRXmlElement.java;2;0;4;1;0;0;0;4;48;1;4;133;55;55;1;0;0;4;4;133;0;1424;4;2;
/org.eclipse.jdt.ui/ui/org/eclipse/jdt/ui/actions/OpenProjectAction.java;2;1;4;1;4;4;4;0;89;0;0;4019;96;96;1;0;0;0;4;4019;0;4770;4;2;
/org.eclipse.jdt.ui.tests.refactoring/resources/RenameParameters/canRename/A_test20_in.java;2;0;2;1;0;0;0;2;4;1;2;233;4;4;1;0;0;2;2;233;0;952;2;2;
/org.eclipse.jdt.ui.tests.refactoring/resources/RenameVirtualMethodInClass/test27/in/A.java;1;0;1;1;0;0;0;1;0;0;1;49;0;0;1;0;0;1;1;49;0;49;1;1;
/org.eclipse.swt/Eclipse SWT/win32/org/eclipse/swt/internal/win32/TVHITTESTINFO.java;2;0;3;1;0;0;0;3;5;1;3;106;5;5;1;0;0;3;3;106;0;2069;3;2;
/org.eclipse.core.resources/src/org/eclipse/core/internal/events/BuilderPersistentInfo.java;2;0;4;1;1;1;1;3;70;1;3;182;95;95;1;0;0;3;4;182;0;4214;4;2;
/org.eclipse.vcm.core/src/org/eclipse/vcm/internal/core/ResourceEditionTree.java;4;0;5;1;0;0;0;5;69;2;4;56;91;91;2;1;0;5;5;56;1;297;4;4;
/org.eclipse.jdt.ui.tests.refactoring/resources/ExtractMethodWorkSpace/ExtractMethodTests/selection/A_test3.java;2;1;3;1;2;2;2;1;0;0;1;49;0;0;1;0;0;1;3;49;0;4419;3;2;
/org.eclipse.update.core/src/org/eclipse/update/internal/model/InstallChangeParser.java;2;1;6;1;6;6;6;0;79;0;0;3901;167;167;1;0;0;0;6;3901;0;4231;6;2;
/org.eclipse.swt.examples.controls/org/eclipse/swt/examples/controls/ControlView.java;3;0;5;2;1;1;1;4;99;2;3;513;163;163;2;1;0;4;5;609;1;4024;4;3;
/org.eclipse.jdt.ui/core refactoring/org/eclipse/jdt/internal/corext/refactoring/changes/CompilationUnitReorgChange.java;2;0;2;1;1;1;1;1;14;0;1;1939;14;14;1;0;0;1;2;1939;0;4212;2;2;
/org.eclipse.swt/Eclipse SWT PI/win32/org/eclipse/swt/internal/win32/TEXTMETRIC.java;2;0;2;1;1;1;1;1;6;0;1;2069;6;6;1;0;0;1;2;2069;0;4701;2;2;
/org.eclipse.vcm.core.cvs/src/org/eclipse/vcm/internal/core/ccvs/client/AbstractStaticHandler.java;1;0;1;1;0;0;0;1;0;0;1;1372;0;0;1;0;0;1;1;1372;0;1372;1;1;
/org.eclipse.scripting/Eclipse Scripting/org/eclipse/scripting/ScriptAdapterEventHandler.java;1;0;3;1;0;0;0;3;7;1;3;133;7;7;1;0;0;3;3;133;0;1424;3;1;
/org.eclipse.swt/Eclipse SWT/common/org/eclipse/swt/events/ArmListener.java;4;0;5;1;1;1;1;4;6;1;4;106;18;18;1;0;0;4;5;106;0;4701;5;4;
/org.eclipse.jdt.ui/ui/org/eclipse/jdt/internal/ui/launcher/JDK12PreferencePage.java;1;0;3;1;0;0;0;3;27;1;3;15;27;27;1;0;0;3;3;15;0;218;3;1;
/org.eclipse.core.tests.runtime/src/org/eclipse/core/tests/internal/plugins/RegressionResolveTest_4.java;3;0;3;1;0;0;0;3;132;1;3;1794;142;142;1;0;0;3;3;1794;0;3476;3;3;
/org.eclipse.jdt.ui.tests.refactoring/resources/ExtractMethodWorkSpace/ExtractMethodTests/return_out/A_test700.java;1;1;3;1;2;2;2;1;16;0;1;887;16;16;1;0;0;1;3;887;0;4419;3;1;
/org.eclipse.jdt.ui.tests.refactoring/resources/RenameVirtualMethodInClass/test33/out/A.java;1;0;1;1;0;0;0;1;0;0;1;1297;0;0;1;0;0;1;1;1297;0;1297;1;1;
/org.eclipse.help/Eclipse Help/org/eclipse/help/internal/remote/ServletFacade.java;4;0;14;2;0;0;0;14;80;2;12;135;326;326;2;2;0;14;14;693;2;1420;12;4;
/org.eclipse.swt.examples.paint/src/org/eclipse/swt/examples/paint/PaintPlugin.java;3;0;3;1;1;1;1;2;78;1;2;513;84;84;1;0;0;2;3;513;0;4705;3;3;
/org.eclipse.swt/Eclipse SWT PI/win32/org/eclipse/swt/internal/win32/DROPFILES.java;2;0;2;1;1;1;1;1;6;0;1;2069;6;6;1;0;0;1;2;2069;0;4701;2;2;
/org.eclipse.jdt.ui.tests.refactoring/resources/RenameMethodInInterface/test1/in/A.java;1;0;1;1;0;0;0;1;0;0;1;49;0;0;1;0;0;1;1;49;0;49;1;1;
/org.eclipse.jdt.debug/jdi/org/eclipse/jdi/internal/request/RequestMessages.java;1;0;1;1;0;0;0;1;0;0;1;3677;0;0;1;0;0;1;1;3677;0;3677;1;1;
/org.eclipse.help.tests/src/org/eclipse/help/tests/launching/DisplayHelpResource_IHrefResource_toc.java;1;0;1;1;1;1;1;0;0;0;0;4045;0;0;1;0;0;0;1;4045;0;4045;1;1;
/org.eclipse.team.tests.cvs.core/src/org/eclipse/team/tests/ccvs/ui/logformatter/LogEntry.java;1;0;3;1;0;0;0;3;7;1;3;2977;13;13;1;0;0;3;3;2977;0;3452;3;1;
/org.eclipse.jdt.core/codeassist/org/eclipse/jdt/internal/codeassist/impl/Engine.java;2;1;16;1;4;4;4;12;1146;4;9;455;2103;2103;4;3;0;12;16;1039;3;4619;13;2;
/org.eclipse.core.runtime/src/org/eclipse/core/runtime/model/ExtensionPointModel.java;3;0;5;1;1;1;1;4;270;1;4;12;314;314;1;0;0;4;5;12;0;4214;5;3;
/org.eclipse.jdt.ui/core refactoring/org/eclipse/jdt/internal/core/refactoring/changes/TextChange.java;1;0;3;1;0;0;0;3;8;2;2;1800;8;8;2;1;0;3;3;1937;1;1937;2;1;
/org.eclipse.swt/Eclipse SWT/motif/org/eclipse/swt/internal/motif/XmTextVerifyCallbackStruct.java;2;0;3;1;0;0;0;3;4;1;3;106;4;4;1;0;0;3;3;106;0;2069;3;2;
/org.eclipse.core.runtime/src/org/eclipse/core/runtime/IPluginPrerequisite.java;4;0;8;1;1;1;1;7;220;1;7;12;313;313;1;0;0;7;8;12;0;4214;8;4;
/org.eclipse.swt/Eclipse SWT PI/gtk/org/eclipse/swt/internal/gtk/GdkDragContext.java;1;0;1;1;0;0;0;1;0;0;1;3605;0;0;1;0;0;1;1;3605;0;3605;1;1;
/org.eclipse.jdt.ui/core refactoring/org/eclipse/jdt/internal/core/refactoring/util/ASTParentTrackingAdapter.java;1;0;2;1;0;0;0;2;0;1;2;1453;0;0;1;0;0;2;2;1453;0;1939;2;1;
/org.eclipse.jdt.ui.tests.refactoring/resources/RenameType/test28/in/A.java;1;0;1;1;0;0;0;1;0;0;1;49;0;0;1;0;0;1;1;49;0;49;1;1;
/org.eclipse.ui/Eclipse JFace Text/org/eclipse/jface/text/DefaultTextDoubleClickStrategy.java;4;0;5;1;1;1;1;4;212;1;4;257;308;308;1;0;0;4;5;257;0;4838;5;4;
/org.eclipse.pde.ui/src/org/eclipse/pde/internal/wizards/templates/ViewNewWizard.java;1;0;3;1;0;0;0;3;12;1;3;3278;12;12;1;0;0;3;3;3278;0;3579;3;1;
/org.eclipse.jdt.debug/eval/org/eclipse/jdt/internal/debug/eval/ast/EvaluationThread.java;1;0;3;1;0;0;0;3;116;1;3;3329;116;116;1;0;0;3;3;3329;0;3421;3;1;
/org.eclipse.jdt.ui.tests.refactoring/resources/RenameTemp/cannotRename/A_testFail7.java;1;0;2;1;0;0;0;2;2;1;2;1625;2;2;1;0;0;2;2;1625;0;1652;2;1;
/org.eclipse.update.ui.forms/src/org/eclipse/update/ui/forms/internal/IForm.java;1;0;2;1;0;0;0;2;2;1;2;2470;2;2;1;0;0;2;2;2470;0;2851;2;1;
/org.eclipse.swt.examples/org/eclipse/swt/examples/layoutexample/FillLayoutTab.java;2;0;3;1;1;1;1;2;39;1;2;3420;39;39;1;0;0;2;3;3420;0;4024;3;2;
/org.eclipse.jdt.ui.tests.refactoring/resources/ExtractTemp/canExtract/A_test22_out.java;1;0;1;1;0;0;0;1;0;0;1;2498;0;0;1;0;0;1;1;2498;0;2498;1;1;
/org.eclipse.jdt.core/search/org/eclipse/jdt/internal/core/search/matching/DeclarationOfReferencedMethodsPattern.java;3;1;6;1;2;2;2;4;41;1;4;1944;71;71;1;0;0;4;6;1944;0;4421;6;3;
/org.eclipse.core.tests.runtime/src/org/eclipse/core/tests/internal/plugin/d/PluginClass.java;3;0;3;1;0;0;0;3;34;1;3;1794;44;44;1;0;0;3;3;1794;0;3476;3;3;
/org.eclipse.jdt.ui.tests.refactoring/resources/PullUpMethods/test16/in/A.java;1;0;2;1;0;0;0;2;0;1;2;2286;0;0;1;0;0;2;2;2286;0;2406;2;1;
/org.eclipse.core.tests.runtime/src/org/eclipse/core/tests/internal/plugins/LoaderTest.java;4;0;5;1;0;0;0;5;852;1;5;1794;925;925;1;0;0;5;5;1794;0;3717;5;4;
/org.eclipse.ui.tests/Eclipse JFace Tests/org/eclipse/jface/tests/viewers/interactive/TestTable.java;1;0;1;1;0;0;0;1;0;0;1;1488;0;0;1;0;0;1;1;1488;0;1488;1;1;
/org.eclipse.team.tests.cvs.core/src/org/eclipse/team/tests/ccvs/core/provider/ImportTest.java;2;0;4;1;0;0;0;4;51;1;4;2536;88;88;1;0;0;4;4;2536;0;3610;4;2;
/org.eclipse.pde.core/src/org/eclipse/pde/core/ModelChangedEvent.java;1;0;3;1;2;1;2;1;64;0;1;3591;64;64;2;0;1;1;3;4751;1;4751;2;1;
/org.eclipse.help/src/org/eclipse/help/internal/contributors/xml/ContributorFactory.java;2;0;2;1;0;0;0;2;0;1;2;1420;0;0;1;0;0;2;2;1420;0;1675;2;2;
/org.eclipse.vcm.ui/src/org/eclipse/vcm/internal/ui/wizards/NewTeamStreamMainPage.java;4;0;8;2;0;0;0;8;55;2;7;1;107;107;2;1;0;8;8;295;1;1156;7;4;
/org.eclipse.ui/Eclipse JFace Text/org/eclipse/jface/text/ITextDoubleClickStrategy.java;2;0;2;1;0;0;0;2;5;1;2;257;5;5;1;0;0;2;2;257;0;457;2;2;
/org.eclipse.scripting/Eclipse Scripting/org/eclipse/scripting/internal/uirenderer/XGRElementUISwtGroupBox.java;2;0;6;1;0;0;0;6;12;1;6;133;22;22;1;0;0;6;6;133;0;1424;6;2;
/org.eclipse.jdt.debug/model/org/eclipse/jdt/internal/debug/core/JDIDebugPlugin.java;4;1;33;2;4;4;4;29;188;2;26;187;906;906;2;3;0;29;33;1139;3;4551;30;4;
/org.eclipse.jdt.debug.tests/tests/org/eclipse/jdt/debug/tests/eval/NestedTypeFieldValue_203.java;2;1;3;1;3;3;3;0;12;0;0;4447;14;14;1;0;0;0;3;4447;0;4571;3;2;
/org.eclipse.ant.core/src/org/eclipse/ant/internal/core/old/CopyProject.java;1;0;1;1;0;0;0;1;0;0;1;3270;0;0;1;0;0;1;1;3270;0;3270;1;1;
/org.eclipse.core.boot/src/org/eclipse/core/internal/boot/EclipseURLHandler.java;1;0;2;1;0;0;0;2;0;1;2;12;0;0;1;0;0;2;2;12;0;23;2;1;
/org.eclipse.jdt.core/search/org/eclipse/jdt/internal/core/search/indexing/AddJarFileToIndex.java;3;2;33;1;10;8;10;23;292;4;19;455;914;914;4;4;2;23;33;1039;6;4660;27;3;
/org.eclipse.swt.tests/JUnit Tests/org/eclipse/swt/tests/junit/Test_org_eclipse_swt_events_ControlEvent.java;2;0;2;1;1;1;1;1;6;0;1;1792;6;6;1;0;0;1;2;1792;0;4706;2;2;
/org.eclipse.jdt.ui.tests.refactoring/resources/RenameParameters/canRename/A_test18_in.java;1;0;1;1;0;0;0;1;0;0;1;233;0;0;1;0;0;1;1;233;0;233;1;1;
/org.eclipse.ui.tests/Eclipse UI Tests/org/eclipse/ui/tests/adaptable/AdaptableResourceWrapper.java;1;0;1;1;0;0;0;1;0;0;1;2863;0;0;1;0;0;1;1;2863;0;2863;1;1;
/org.eclipse.jdt.debug.tests/tests/org/eclipse/jdt/debug/tests/eval/NestedTypeFieldValue_470.java;2;1;3;1;3;3;3;0;12;0;0;4447;14;14;1;0;0;0;3;4447;0;4571;3;2;
/org.eclipse.pde.ui/Eclipse PDE UI/org/eclipse/pde/internal/TracingOptionsManager.java;2;0;5;2;0;0;0;5;12;3;3;267;12;12;3;2;0;5;5;324;2;1434;3;2;
/org.eclipse.team.cvs.ui/src/org/eclipse/team/internal/ccvs/ui/wizards/SetKeywordSubstitutionWizard.java;2;0;3;2;0;0;0;3;4;2;2;3206;4;4;2;1;0;3;3;3206;1;3251;2;2;
/org.eclipse.swt.examples.paint/src/org/eclipse/swt/examples/paint/DragPaintSession.java;3;0;4;2;1;1;1;3;137;2;2;586;143;143;2;1;0;3;4;609;1;4705;3;3;
/org.eclipse.scripting/src/org/eclipse/scripting/internal/uirenderer/XGRPresentationModel.java;1;0;1;1;0;0;0;1;0;0;1;1424;0;0;1;0;0;1;1;1424;0;1424;1;1;
/org.eclipse.team.cvs.ui/src/org/eclipse/team/internal/ccvs/ui/Console.java;3;1;15;1;4;4;4;11;429;1;11;1978;562;562;1;0;0;11;15;1978;0;4707;15;3;
/org.eclipse.jdt.ui/core refactoring/org/eclipse/jdt/internal/core/refactoring/rename/RenameTempASTAnalyzer.java;2;0;4;1;0;0;0;4;4;2;3;1665;4;4;2;1;0;4;4;1910;1;1939;3;2;
/org.eclipse.jdt.ui/ui refactoring/org/eclipse/jdt/internal/ui/nls/NLSImages.java;1;0;2;1;0;0;0;2;0;1;2;1913;0;0;1;0;0;2;2;1913;0;1922;2;1;
/org.eclipse.pde.ui/Eclipse PDE UI/org/eclipse/pde/internal/PDEPluginImages.java;2;0;10;2;0;0;0;10;229;3;7;267;264;264;3;3;0;10;10;324;3;1434;7;2;
/org.eclipse.help/Eclipse Help/org/eclipse/help/internal/contributors/ContextContributor.java;3;0;4;1;0;0;0;4;7;1;4;135;8;8;1;0;0;4;4;135;0;1420;4;3;
/org.eclipse.ui.tests/Eclipse UI Tests/org/eclipse/ui/tests/api/SessionCreateTest.java;3;0;8;1;0;0;0;8;93;1;8;1008;107;107;1;0;0;8;8;1008;0;2785;8;3;
/org.eclipse.jdt.ui.tests.refactoring/resources/RenameType/test0/in/A.java;1;0;1;1;0;0;0;1;0;0;1;49;0;0;1;0;0;1;1;49;0;49;1;1;
/org.eclipse.team.tests.cvs.core/src/org/eclipse/team/tests/ccvs/ui/EmptyPerspective.java;1;0;1;1;0;0;0;1;0;0;1;2977;0;0;1;0;0;1;1;2977;0;2977;1;1;
/org.eclipse.jdt.ui/ui/org/eclipse/jdt/internal/ui/wizards/NewSnippetCreationWizard.java;2;0;6;1;0;0;0;6;23;2;5;15;30;30;2;1;0;6;6;432;1;1342;5;2;
/org.eclipse.jdt.debug/eval/org/eclipse/jdt/internal/debug/eval/ast/instructions/PushString.java;2;0;3;1;0;0;0;3;2;1;3;3421;4;4;1;0;0;3;3;3421;0;3677;3;2;
/org.eclipse.pde.ui/src/org/eclipse/pde/internal/wizards/templates/MultiPageEditorTemplate.java;1;0;4;1;0;0;0;4;2;2;3;3442;3;3;2;1;0;4;4;3442;1;3579;3;1;
/org.eclipse.jdt.core/model/org/eclipse/jdt/internal/core/JavaElementRequestor.java;2;0;4;1;1;1;1;3;342;1;3;455;414;414;1;0;0;3;4;455;0;4063;4;2;
/org.eclipse.jdt.ui.tests.refactoring/resources/RenameTemp/canRename/A_test38_in.java;1;0;1;1;0;0;0;1;0;0;1;3226;0;0;1;0;0;1;1;3226;0;3226;1;1;
/org.eclipse.jdt.ui.tests.refactoring/resources/RenameMethodInInterface/test42/in/A.java;1;0;1;1;0;0;0;1;0;0;1;49;0;0;1;0;0;1;1;49;0;49;1;1;
/org.eclipse.help/Eclipse Help/org/eclipse/help/internal/contributors/xml/XMLViewContributorCreator.java;2;0;3;1;0;0;0;3;7;1;3;135;7;7;1;0;0;3;3;135;0;1420;3;2;
/org.eclipse.pde.ui/src/org/eclipse/pde/internal/wizards/extension/PointSelectionPage.java;2;0;9;1;0;0;0;9;69;3;7;1434;93;93;3;2;0;9;9;3035;2;3579;7;2;
/org.eclipse.jdt.ui.tests/ui/com/ibm/jdt/ui/tests/TypeHierarchyTest.java;1;0;3;1;0;0;0;3;4;1;3;255;4;4;1;0;0;3;3;255;0;522;3;1;
/org.eclipse.debug.ui/ui/org/eclipse/debug/internal/ui/actions/AbstractRemoveAction.java;1;0;2;1;0;0;0;2;0;1;2;2382;0;0;1;0;0;2;2;2382;0;2935;2;1;
/org.eclipse.swt/Eclipse SWT/gtk/org/eclipse/swt/graphics/FontData.java;4;1;8;1;3;3;3;5;338;1;5;2107;391;391;1;0;0;5;8;2107;0;4701;8;4;
/org.eclipse.swt/Eclipse SWT/common/org/eclipse/swt/widgets/Synchronizer.java;4;0;5;1;1;1;1;4;16;1;4;106;31;31;1;0;0;4;5;106;0;4701;5;4;
/org.eclipse.vcm.core/src/org/eclipse/vcm/internal/core/base/IVersionHistory.java;3;0;3;1;0;0;0;3;15;1;3;0;20;20;1;0;0;3;3;0;0;297;3;3;
/org.eclipse.swt/Eclipse SWT/win32/org/eclipse/swt/internal/win32/RECT.java;2;0;3;1;0;0;0;3;5;1;3;106;5;5;1;0;0;3;3;106;0;2069;3;2;
/org.eclipse.jdt.ui.tests.refactoring/resources/SelectionAnalyzerWorkSpace/SelectionAnalyzerTests/validSelection/A_test303.java;1;0;1;1;0;0;0;1;0;0;1;1368;0;0;1;0;0;1;1;1368;0;1368;1;1;
/org.eclipse.team.tests.cvs.core/src/org/eclipse/team/tests/ccvs/core/provider/ModuleTest.java;2;0;8;1;0;0;0;8;85;1;8;2707;194;194;1;0;0;8;8;2707;0;3610;8;2;
/org.eclipse.pde.ui/Eclipse PDE UI/org/eclipse/pde/internal/base/model/plugin/IPluginExtension.java;2;0;5;2;0;0;0;5;12;3;3;267;12;12;3;2;0;5;5;324;2;1434;3;2;
/org.eclipse.jdt.ui.tests.refactoring/resources/RenamePrivateField/test5/out/A.java;1;0;1;1;0;0;0;1;0;0;1;2931;0;0;1;0;0;1;1;2931;0;2931;1;1;
/org.eclipse.swt/Eclipse SWT/photon/org/eclipse/swt/graphics/FontData.java;7;1;11;1;2;2;2;9;168;1;9;106;305;305;1;0;0;9;11;106;0;4701;11;7;
/org.eclipse.swt/Eclipse SWT OLE Win32/win32/org/eclipse/swt/internal/ole/win32/STATSTG.java;2;0;3;1;0;0;0;3;5;1;3;106;5;5;1;0;0;3;3;106;0;2069;3;2;
/org.eclipse.scripting/Eclipse Scripting/org/eclipse/scripting/internal/views/ScriptUIEditorLabelProvider.java;2;0;5;1;0;0;0;5;14;1;5;133;25;25;1;0;0;5;5;133;0;1424;5;2;
/org.eclipse.ui/Eclipse UI/org/eclipse/ui/internal/ActionSetMenuManager.java;4;0;4;1;1;1;1;3;26;1;3;457;64;64;1;0;0;3;4;457;0;4688;4;4;
/org.eclipse.help.ui/src/org/eclipse/help/ui/internal/util/WorkbenchResources.java;1;0;1;1;1;1;1;0;0;0;0;4439;0;0;1;0;0;0;1;4439;0;4439;1;1;
/org.eclipse.team.cvs.ui/src/org/eclipse/team/internal/ccvs/ui/actions/NewRepositoryAction.java;1;0;1;1;1;1;1;0;0;0;0;4144;0;0;1;0;0;0;1;4144;0;4144;1;1;
/org.eclipse.jdt.core/model/org/eclipse/jdt/core/IWorkingCopy.java;3;2;24;1;6;5;6;18;524;3;13;455;1146;1146;3;5;1;18;24;3373;6;4657;18;3;
/org.eclipse.jdt.ui/ui refactoring/org/eclipse/jdt/internal/ui/nls/ExternalizeAction.java;1;0;2;1;0;0;0;2;0;1;2;1913;0;0;1;0;0;2;2;1913;0;1922;2;1;
/org.eclipse.pde.junit/src/org/eclipse/pde/internal/junit/launcher/JUnitPluginLaunchShortcut.java;1;1;2;1;2;2;2;0;3;0;0;4451;3;3;1;0;0;0;2;4451;0;4498;2;1;
/org.eclipse.update.ui/src/org/eclipse/update/internal/ui/model/IConfiguredSiteAdapter.java;1;0;1;1;0;0;0;1;0;0;1;2994;0;0;1;0;0;1;1;2994;0;2994;1;1;
/org.eclipse.debug.ui/ui/org/eclipse/debug/internal/ui/ControlAction.java;3;0;9;1;0;0;0;9;14;1;9;187;55;55;1;0;0;9;9;187;0;2382;9;3;
/org.eclipse.debug.ui/ui/org/eclipse/debug/internal/ui/actions/ShowQualifiedAction.java;1;0;2;1;0;0;0;2;0;1;2;2382;0;0;1;0;0;2;2;2382;0;2398;2;1;
/org.eclipse.jdt.ui.tests.refactoring/resources/SurroundWithWorkSpace/SurroundWithTests/trycatch_in/TestRuntimeException1.java;1;0;1;1;0;0;0;1;0;0;1;3719;0;0;1;0;0;1;1;3719;0;3719;1;1;
/org.eclipse.jdt.ui.tests.refactoring/resources/MoveCU/testFail2/in/p1/C.java;2;0;2;1;0;0;0;2;0;1;2;49;0;0;1;0;0;2;2;49;0;2769;2;2;
/org.eclipse.jdt.ui.tests.refactoring/resources/RenameMethodInInterface/test26/in/A.java;1;0;1;1;0;0;0;1;0;0;1;49;0;0;1;0;0;1;1;49;0;49;1;1;
/org.eclipse.scripting/src/org/eclipse/scripting/ScriptAdapterWorkbenchResourceEditor.java;1;0;1;1;0;0;0;1;0;0;1;1424;0;0;1;0;0;1;1;1424;0;1424;1;1;
/org.eclipse.pde.ui/src/org/eclipse/pde/internal/base/model/component/IComponentFragment.java;2;0;2;1;0;0;0;2;0;1;2;1434;0;0;1;0;0;2;2;1434;0;2951;2;2;
/org.eclipse.swt/Eclipse SWT PI/win32/org/eclipse/swt/internal/ole/win32/IConnectionPoint.java;2;0;2;1;1;1;1;1;6;0;1;2069;6;6;1;0;0;1;2;2069;0;4701;2;2;
/org.eclipse.scripting/src/org/eclipse/scripting/internal/views/ScriptUIEditorTreeContentProvider.java;1;0;1;1;0;0;0;1;0;0;1;1424;0;0;1;0;0;1;1;1424;0;1424;1;1;
/org.eclipse.pde.ui/src/org/eclipse/pde/internal/ui/util/Sorter.java;1;0;1;1;0;0;0;1;0;0;1;3579;0;0;1;0;0;1;1;3579;0;3579;1;1;
/org.eclipse.swt.tests/JUnit Tests/org/eclipse/swt/tests/junit/Test_org_eclipse_swt_events_ArmListener.java;2;0;2;1;1;1;1;1;6;0;1;1792;6;6;1;0;0;1;2;1792;0;4706;2;2;
/org.eclipse.debug.ui/ui/org/eclipse/debug/internal/ui/actions/RelaunchLastAction.java;4;2;10;1;6;5;6;4;73;1;4;2382;191;191;2;0;1;4;10;4062;1;4433;9;4;
/org.eclipse.jdt.ui/ui/org/eclipse/jdt/internal/ui/text/java/hover/JavaInformationProvider.java;2;0;2;1;0;0;0;2;18;1;2;2006;18;18;1;0;0;2;2;2006;0;3350;2;2;
/org.eclipse.ui/Eclipse UI/org/eclipse/ui/internal/dialogs/ResourceInfoPage.java;7;1;13;1;2;2;2;11;45;1;11;257;196;196;1;0;0;11;13;257;0;4429;13;7;
/org.eclipse.jdt.ui/ui/org/eclipse/jdt/ui/actions/ActionMessages.java;1;0;2;1;0;0;0;2;0;1;2;3533;0;0;1;0;0;2;2;3533;0;3571;2;1;
/org.eclipse.jdt.ui.tests.refactoring/resources/ExtractMethodWorkSpace/ExtractMethodTests/locals_in/A_test537.java;1;1;3;1;2;2;2;1;6;0;1;922;6;6;1;0;0;1;3;922;0;4419;3;1;
/org.eclipse.ui/Eclipse UI Standard Components/org/eclipse/ui/views/internal/navigator/ActionContributionFactory.java;1;0;2;1;0;0;0;2;0;1;2;1757;0;0;1;0;0;2;2;1757;0;1830;2;1;
/org.eclipse.update.ui/src/org/eclipse/update/internal/ui/manager/ActivitySection.java;2;0;12;1;0;0;0;12;69;2;11;2107;201;201;2;1;0;12;12;2172;1;3662;11;2;
/org.eclipse.jdt.ui.tests.refactoring/resources/SelectionAnalyzerWorkSpace/SelectionAnalyzerTests/validSelection/A_test203.java;1;0;1;1;0;0;0;1;0;0;1;1368;0;0;1;0;0;1;1;1368;0;1368;1;1;
/org.eclipse.pde.ui/src/org/eclipse/pde/model/plugin/IPluginExtension.java;1;0;2;1;0;0;0;2;0;1;2;3039;0;0;1;0;0;2;2;3039;0;3579;2;1;
/org.eclipse.swt/Eclipse SWT Custom Widgets/common/org/eclipse/swt/custom/AbstractRenderer.java;1;0;1;1;0;0;0;1;0;0;1;3105;0;0;1;0;0;1;1;3105;0;3105;1;1;
/org.eclipse.jdt.core/model/org/eclipse/jdt/core/IPackageFragmentRoot.java;3;1;14;1;2;2;2;12;242;4;8;455;581;581;4;4;0;12;14;1039;4;4421;10;3;
/org.eclipse.ui.examples.readmetool/Eclipse UI Examples Readme Tool/org/eclipse/ui/examples/readmetool/IReadmeFileParser.java;1;0;1;1;0;0;0;1;0;0;1;932;0;0;1;0;0;1;1;932;0;932;1;1;
/org.eclipse.jdt.ui.tests.refactoring/resources/RenameVariables/canRename/A_test10_in.java;1;0;2;1;0;0;0;2;0;1;2;724;0;0;1;0;0;2;2;724;0;1665;2;1;
/org.eclipse.ui/Eclipse UI/org/eclipse/ui/IWorkbenchPartDescriptor.java;1;0;2;1;2;1;2;0;37;0;0;4063;37;37;2;0;1;0;2;4063;1;4063;1;1;
/org.eclipse.jdt.ui/core refactoring/org/eclipse/jdt/internal/corext/refactoring/code/AstNodeMatcher.java;1;0;3;1;0;0;0;3;2;1;3;2480;2;2;1;0;0;3;3;2480;0;3210;3;1;
/org.eclipse.team.ui/src/org/eclipse/team/internal/ui/DetailsDialogWithProjects.java;2;1;3;1;3;3;3;0;4;0;0;4423;7;7;1;0;0;0;3;4423;0;4636;3;2;
/org.eclipse.jdt.ui.tests.refactoring/resources/RenameVirtualMethodInClass/testFail3/in/A.java;1;0;1;1;0;0;0;1;0;0;1;49;0;0;1;0;0;1;1;49;0;49;1;1;
/org.eclipse.ui/Eclipse UI/org/eclipse/ui/part/MultiPageEditorSite.java;5;1;9;1;2;2;2;7;21;1;7;257;55;55;1;0;0;7;9;257;0;4085;9;5;
/org.eclipse.swt.tests/JUnit Tests/org/eclipse/swt/tests/junit/Test_org_eclipse_swt_custom_SashForm.java;2;0;2;1;1;1;1;1;6;0;1;1792;6;6;1;0;0;1;2;1792;0;4706;2;2;
/org.eclipse.swt/Eclipse SWT/gtk1x/org/eclipse/swt/graphics/Image.java;5;1;5;1;2;2;2;3;12;1;3;2107;32;32;1;0;0;3;5;2107;0;4701;5;5;
/org.eclipse.jdt.ui/ui refactoring/org/eclipse/jdt/internal/ui/refactoring/NewPreviewWizardPage.java;1;0;5;1;0;0;0;5;14;1;5;1800;33;33;1;0;0;5;5;1800;0;2148;5;1;
/org.eclipse.jdt.ui.tests.refactoring/resources/ExtractMethodWorkSpace/ExtractMethodTests/validSelection/A_test200.java;2;1;3;1;2;2;2;1;0;0;1;49;0;0;1;0;0;1;3;49;0;4419;3;2;
/org.eclipse.jdt.core/search/org/eclipse/jdt/internal/core/index/impl/IndexOutput.java;2;0;2;1;1;1;1;1;14;0;1;455;14;14;1;0;0;1;2;455;0;4063;2;2;
/org.eclipse.jdt.ui/ui/org/eclipse/jdt/internal/ui/wizards/OpenSnippetWizardAction.java;4;1;5;1;2;2;2;3;6;1;3;436;12;12;1;0;0;3;5;436;0;4630;5;4;
/org.eclipse.jdt.core/eval/org/eclipse/jdt/internal/eval/CodeSnippetCompiler.java;2;0;11;1;1;1;1;10;32;4;7;455;76;76;4;3;0;10;11;1039;3;4062;8;2;
/org.eclipse.ui.tests/Eclipse UI Tests/org/eclipse/ui/tests/api/MockEditorActionBarContributor.java;2;0;6;1;1;1;1;5;31;2;4;1454;73;73;2;1;0;5;6;1454;1;4208;5;2;
/org.eclipse.swt/Eclipse SWT/common/org/eclipse/swt/SWTError.java;5;0;6;1;1;1;1;5;34;1;5;106;89;89;1;0;0;5;6;106;0;4701;6;5;
/org.eclipse.jdt.ui/ui/org/eclipse/jdt/ui/actions/OpenAction.java;2;2;19;2;13;10;13;6;120;2;5;3533;296;296;2;1;3;6;19;3641;4;4770;15;2;
/org.eclipse.team.ui/src/org/eclipse/team/internal/ui/actions/TeamAction.java;3;1;6;1;6;6;6;0;33;0;0;4020;48;48;1;0;0;0;6;4020;0;4636;6;3;
/org.eclipse.ui.externaltools/External Tools/org/eclipse/ui/externaltools/internal/core/ProgramRunner.java;2;1;7;1;7;7;7;0;30;0;0;4090;72;72;1;0;0;0;7;4090;0;4462;7;2;
/org.eclipse.pde.ui/Eclipse PDE UI/org/eclipse/pde/internal/forms/HyperlinkHandler.java;2;0;5;2;0;0;0;5;12;3;3;267;12;12;3;2;0;5;5;324;2;1434;3;2;
/org.eclipse.jdt.launching/launching/org/eclipse/jdt/launching/VMRunnerResult.java;2;0;3;1;0;0;0;3;7;1;3;2022;7;7;1;0;0;3;3;2022;0;3511;3;2;
/org.eclipse.jdt.ui/ui/org/eclipse/jdt/internal/ui/wizards/swt/MGridLayout.java;3;0;6;1;0;0;0;6;50;2;5;15;64;64;2;1;0;6;6;3084;1;3084;5;3;
/org.eclipse.jdt.ui/core refactoring/org/eclipse/jdt/internal/core/refactoring/base/IUndoManagerListener.java;2;0;2;1;0;0;0;2;0;1;2;408;0;0;1;0;0;2;2;408;0;1939;2;2;
/org.eclipse.jdt.debug.tests/tests/org/eclipse/jdt/debug/tests/eval/TestsNestedTypes2.java;2;2;4;2;4;3;4;0;12;0;0;4447;18;18;2;0;1;0;4;4568;1;4568;3;2;
/org.eclipse.update.core/src/org/eclipse/update/internal/security/JarVerificationResult.java;2;1;15;1;3;3;3;12;165;1;12;3122;524;524;1;0;0;12;15;3122;0;4626;15;2;
/org.eclipse.jdt.ui/core extension/org/eclipse/jdt/internal/corext/codemanipulation/SwapTextEdit.java;1;0;2;1;0;0;0;2;0;0;1;2133;0;0;2;1;0;2;2;2133;1;2133;1;1;
/org.eclipse.jdt.ui/ui refactoring/org/eclipse/jdt/internal/ui/refactoring/nls/search/NLSSearchMessages.java;2;0;2;1;0;0;0;2;4;1;2;1922;4;4;1;0;0;2;2;1922;0;3530;2;2;
/org.eclipse.jdt.ui.tests.refactoring/resources/RenamePrivateMethod/test14/out/A.java;1;0;1;1;0;0;0;1;0;0;1;49;0;0;1;0;0;1;1;49;0;49;1;1;
/org.eclipse.team.ftp/src/org/eclipse/team/internal/ftp/target/FTPTargetProvider.java;4;4;22;3;22;14;22;0;167;0;0;4241;524;524;4;0;8;0;22;4249;8;4636;14;4;
/org.eclipse.jdt.ui/ui refactoring/org/eclipse/jdt/internal/ui/refactoring/nls/search/ExceptionHandler.java;2;0;2;1;0;0;0;2;0;1;2;1922;0;0;1;0;0;2;2;1922;0;2155;2;2;
/org.eclipse.swt/Eclipse SWT/gtk1x/org/eclipse/swt/widgets/Scrollable.java;2;0;2;1;1;1;1;1;6;0;1;2107;6;6;1;0;0;1;2;2107;0;4701;2;2;
/org.eclipse.webdav/src/interface/org/eclipse/webdav/dom/PropertyBehavior.java;3;0;5;1;1;1;1;4;484;1;4;12;594;594;1;0;0;4;5;12;0;4211;5;3;
/org.eclipse.jdt.debug.tests/testprograms/MultiThreadedLoop.java;2;1;2;1;2;2;2;0;11;0;0;4307;11;11;1;0;0;0;2;4307;0;4571;2;2;
/org.eclipse.pde.ui/src/org/eclipse/pde/internal/editor/feature/FeatureEditorContributor.java;1;0;3;1;0;0;0;3;4;1;3;2951;4;4;1;0;0;3;3;2951;0;3579;3;1;
/org.eclipse.swt/Eclipse SWT PI/motif/org/eclipse/swt/internal/motif/KDE.java;2;0;2;1;1;1;1;1;6;0;1;2069;6;6;1;0;0;1;2;2069;0;4701;2;2;
/org.eclipse.jdt.ui/core codemanipulation/org/eclipse/jdt/internal/core/codemanipulation/TextRegion.java;1;0;2;1;0;0;0;2;0;1;2;1800;0;0;1;0;0;2;2;1800;0;1937;2;1;
/org.eclipse.jdt.core/codeassist/org/eclipse/jdt/internal/codeassist/select/SelectionNodeFound.java;2;1;4;1;2;2;2;2;14;1;2;455;32;32;1;0;0;2;4;455;0;4421;4;2;
/org.eclipse.swt.tests/JUnit Tests/org/eclipse/swt/tests/junit/Test_org_eclipse_swt_widgets_Listener.java;2;0;2;1;1;1;1;1;6;0;1;1792;6;6;1;0;0;1;2;1792;0;4706;2;2;
/org.eclipse.team.core/src/org/eclipse/team/core/target/IRemoteTargetResource.java;2;2;6;1;6;5;6;0;52;0;0;4168;100;100;2;0;1;0;6;4209;1;4636;5;2;
/org.eclipse.jdt.ui.tests.refactoring/resources/ExtractMethodWorkSpace/ExtractMethodTests/validSelection/A_test353.java;2;1;3;1;2;2;2;1;12;0;1;254;12;12;1;0;0;1;3;254;0;4419;3;2;
/org.eclipse.team.core/src/org/eclipse/team/core/FileModificationValidator.java;1;0;1;1;0;0;0;1;0;0;1;3193;0;0;1;0;0;1;1;3193;0;3193;1;1;
/org.eclipse.jdt.ui.tests.refactoring/resources/RenameType/testFail18/in/A.java;1;0;1;1;0;0;0;1;0;0;1;49;0;0;1;0;0;1;1;49;0;49;1;1;
/org.eclipse.debug.ui/ui/org/eclipse/debug/internal/ui/actions/OpenLaunchConfigurationsAction.java;3;1;10;1;2;2;2;8;84;1;8;3152;205;205;1;0;0;8;10;3152;0;4423;10;3;
/org.eclipse.update.core/src/org/eclipse/core/internal/boot/PlatformConfiguration.java;1;0;7;1;0;0;0;7;564;2;6;1993;1858;1858;2;1;0;7;7;2017;1;2315;6;1;
/org.eclipse.ui/Eclipse UI/org/eclipse/ui/internal/SwitchToPerspMenu.java;3;0;4;1;0;0;0;4;7;1;4;257;13;13;1;0;0;4;4;257;0;3050;4;3;
/org.eclipse.update.ui/src/org/eclipse/update/internal/ui/pages/MainPage.java;1;0;2;1;0;0;0;2;3;1;2;3537;3;3;1;0;0;2;2;3537;0;3662;2;1;
/org.eclipse.team.ftp/src/org/eclipse/team/internal/ftp/target/FTPRemoteSyncElement.java;3;1;4;1;4;4;4;0;68;0;0;4555;75;75;1;0;0;0;4;4555;0;4668;4;3;
/org.eclipse.ui/Eclipse JFace Text/org/eclipse/jface/text/source/IVerticalRulerColumn.java;1;1;2;1;2;2;2;0;23;0;0;4038;23;23;1;0;0;0;2;4038;0;4838;2;1;
/org.eclipse.help.tests/src/org/eclipse/help/tests/base/TestGeneratedModel.java;1;0;2;1;0;0;0;2;0;1;2;1642;0;0;1;0;0;2;2;1642;0;1805;2;1;
/org.eclipse.pde.ui/src/org/eclipse/pde/internal/wizards/project/ConvertedProjectWizard.java;2;0;4;1;0;0;0;4;11;1;4;1434;13;13;1;0;0;4;4;1434;0;3579;4;2;
/org.eclipse.vcm.tests.core/src/org/eclipse/vcm/tests/core/VCMTestSetup.java;1;0;1;1;0;0;0;1;0;0;1;1688;0;0;1;0;0;1;1;1688;0;1688;1;1;
/org.eclipse.swt/Eclipse SWT/win32/org/eclipse/swt/internal/win32/LOGBRUSH.java;2;0;3;1;0;0;0;3;5;1;3;106;5;5;1;0;0;3;3;106;0;2069;3;2;
/org.eclipse.jdt.ui.tests.refactoring/resources/MoveMembers/test9/out/B.java;1;0;1;1;0;0;0;1;0;0;1;2738;0;0;1;0;0;1;1;2738;0;2738;1;1;
/org.eclipse.team.webdav/src/org/eclipse/team/internal/webdav/DavState.java;1;1;2;1;2;2;2;0;0;0;0;4023;0;0;1;0;0;0;2;4023;0;4073;2;1;
/org.eclipse.jdt.ui.tests.refactoring/resources/StructureSelectionAction/A_test13.java;1;0;1;1;0;0;0;1;0;0;1;2139;0;0;1;0;0;1;1;2139;0;2139;1;1;
/org.eclipse.core.boot/src/org/eclipse/core/internal/boot/update/PluginEntryDescriptorModel.java;2;0;3;1;0;0;0;3;7;1;3;12;7;7;1;0;0;3;3;12;0;2726;3;2;
/org.eclipse.help/src/org/eclipse/help/IHelpTopic.java;2;0;4;1;0;0;0;4;16;1;4;1420;24;24;1;0;0;4;4;1420;0;3048;4;2;
/org.eclipse.ui/Eclipse UI Standard Components/org/eclipse/ui/views/tasklist/TaskListMarker.java;2;0;3;1;0;0;0;3;229;1;3;949;229;229;1;0;0;3;3;949;0;1516;3;2;
/org.eclipse.scripting/Eclipse Scripting/org/eclipse/scripting/internal/uirenderer/XGRElementUISwtHorizontalRule.java;2;0;5;1;0;0;0;5;35;1;5;133;52;52;1;0;0;5;5;133;0;1424;5;2;
/org.eclipse.jdt.ui.tests.refactoring/resources/RenameParameters/canRename/A_test17_in.java;1;0;1;1;0;0;0;1;0;0;1;233;0;0;1;0;0;1;1;233;0;233;1;1;
/org.eclipse.jdt.debug/jdi interfaces/com/sun/jdi/InvocationException.java;2;0;2;1;0;0;0;2;15;1;2;2704;15;15;1;0;0;2;2;2704;0;3033;2;2;
/org.eclipse.jdt.ui.tests.refactoring/resources/PullUp/testFail12/in/B.java;1;0;1;1;0;0;0;1;0;0;1;2406;0;0;1;0;0;1;1;2406;0;2406;1;1;
/org.eclipse.pde.ui/src/org/eclipse/pde/internal/base/schema/ISchema.java;2;0;4;1;0;0;0;4;8;1;4;1434;9;9;1;0;0;4;4;1434;0;3579;4;2;
/org.eclipse.vcm.core.cvs/src/org/eclipse/vcm/internal/core/ccvs/requests/IStatusListener.java;2;0;2;1;0;0;0;2;9;1;2;0;9;9;1;0;0;2;2;0;0;298;2;2;
/org.eclipse.core.tests.runtime/src/org/eclipse/core/tests/internal/runtimetests/SampleHFB.java;1;0;2;1;0;0;0;2;10;1;2;3611;10;10;1;0;0;2;2;3611;0;3678;2;1;
/org.eclipse.team.cvs.ui/src/org/eclipse/team/internal/ccvs/ui/actions/AddAction.java;2;1;10;1;2;2;2;8;154;1;8;1978;220;220;1;0;0;8;10;1978;0;4021;10;2;
/org.eclipse.debug.core/core/org/eclipse/debug/core/model/IValueModification.java;3;0;6;1;0;0;0;6;24;1;6;187;48;48;1;0;0;6;6;187;0;3474;6;3;
/org.eclipse.pde.ui/src/org/eclipse/pde/internal/FeatureProject.java;1;0;2;1;0;0;0;2;0;1;2;3078;0;0;1;0;0;2;2;3078;0;3579;2;1;
/org.eclipse.jdt.ui.tests.refactoring/resources/ReorgTests/B.java;1;0;1;1;0;0;0;1;0;0;1;1301;0;0;1;0;0;1;1;1301;0;1301;1;1;
/org.eclipse.update.core/src/org/eclipse/update/core/IContentReference.java;1;0;1;1;0;0;0;1;0;0;1;2434;0;0;1;0;0;1;1;2434;0;2434;1;1;
/org.eclipse.pde.ui/src/org/eclipse/pde/internal/base/model/feature/IFeatureEntry.java;1;0;2;1;0;0;0;2;0;1;2;3477;0;0;1;0;0;2;2;3477;0;3579;2;1;
/org.eclipse.jdt.debug/model/org/eclipse/jdt/internal/debug/core/model/JDIDebugTarget.java;3;1;41;2;7;7;7;34;295;4;21;2517;1136;1136;4;13;0;34;41;2662;13;4738;28;3;
/org.eclipse.jdt.ui.tests.refactoring/resources/RenameVirtualMethodInClass/test18/out/C.java;1;0;1;1;0;0;0;1;0;0;1;49;0;0;1;0;0;1;1;49;0;49;1;1;
/org.eclipse.jdt.debug/eval/org/eclipse/jdt/internal/debug/eval/ast/engine/PushFloat.java;1;0;3;1;0;0;0;3;56;1;3;3329;56;56;1;0;0;3;3;3329;0;3421;3;1;
/org.eclipse.jdt.debug/eval/org/eclipse/jdt/internal/debug/eval/ast/engine/BinaryOperator.java;1;0;3;1;0;0;0;3;5;1;3;3329;5;5;1;0;0;3;3;3329;0;3421;3;1;
/org.eclipse.webdav/src/client/org/eclipse/webdav/http/client/RequestInputStream.java;3;0;5;1;1;1;1;4;344;1;4;12;383;383;1;0;0;4;5;12;0;4211;5;3;
/org.eclipse.pde.ui/Eclipse PDE UI/org/eclipse/pde/internal/editor/component/URLElementPropertySource.java;2;0;5;2;0;0;0;5;12;3;3;267;12;12;3;2;0;5;5;324;2;1434;3;2;
/org.eclipse.team.cvs.ui/src/org/eclipse/team/internal/ccvs/ui/model/RemoteModule.java;3;0;12;2;0;0;0;12;43;2;11;2126;168;168;2;1;0;12;12;2289;1;3791;11;3;
/org.eclipse.jdt.ui.tests.refactoring/resources/StructureSelectionAction/A_test3.java;1;0;2;1;0;0;0;2;2;1;2;2139;2;2;1;0;0;2;2;2139;0;3020;2;1;
/org.eclipse.jdt.ui/core extension/org/eclipse/jdt/internal/corext/codemanipulation/CodeGenerationMessages.java;1;0;1;1;0;0;0;1;0;0;1;2137;0;0;1;0;0;1;1;2137;0;2137;1;1;
/org.eclipse.jdt.ui.tests.refactoring/resources/RenameMethodInInterface/test41/out/A.java;1;0;1;1;0;0;0;1;0;0;1;49;0;0;1;0;0;1;1;49;0;49;1;1;
/org.eclipse.swt.examples/org/eclipse/swt/examples/explorer/FileViewer.java;1;0;1;1;0;0;0;1;0;0;1;513;0;0;1;0;0;1;1;513;0;513;1;1;
/org.eclipse.jdt.ui.tests.refactoring/resources/RenameType/testIllegalTypeName1/in/A.java;1;0;1;1;0;0;0;1;0;0;1;49;0;0;1;0;0;1;1;49;0;49;1;1;
/org.eclipse.jdt.core/antadapter/org/eclipse/jdt/core/JDTCompilerAdapter.java;1;1;3;1;3;3;3;0;33;0;0;4125;37;37;1;0;0;0;3;4125;0;4385;3;1;
/org.eclipse.team.ui/src/org/eclipse/team/internal/ui/sync/CatchupReleaseViewer.java;3;1;13;1;10;10;10;3;218;2;2;2054;461;461;2;1;0;3;13;2231;1;4707;12;3;
/org.eclipse.jdt.ui.tests.refactoring/resources/ExtractMethodWorkSpace/ExtractMethodTests/invalidSelection/A_test181.java;1;1;3;1;2;2;2;1;0;0;1;922;0;0;1;0;0;1;3;922;0;4419;3;1;
/org.eclipse.jdt.ui.tests.refactoring/resources/ExtractMethodWorkSpace/ExtractMethodTests/invalidSelection/A_test150.java;2;1;3;1;2;2;2;1;12;0;1;254;12;12;1;0;0;1;3;254;0;4419;3;2;
/org.eclipse.swt/Eclipse SWT Custom Widgets/common_j2se/org/eclipse/swt/custom/StyledText.java;1;0;1;1;0;0;0;1;0;0;1;1378;0;0;1;0;0;1;1;1378;0;1378;1;1;
/org.eclipse.jdt.junit/src/org/eclipse/jdt/internal/junit/wizards/WizardMessages.java;1;0;1;1;0;0;0;1;0;0;1;3659;0;0;1;0;0;1;1;3659;0;3659;1;1;
/org.eclipse.swt/Eclipse SWT PI/motif/org/eclipse/swt/internal/motif/OS.java;6;0;19;1;1;1;1;18;771;3;15;2069;1608;1608;3;3;0;18;19;2568;3;4701;16;6;
/org.eclipse.jdt.debug.ui/ui/org/eclipse/jdt/internal/debug/ui/actions/ExceptionAction.java;2;0;5;1;0;0;0;5;44;2;4;1915;65;65;2;1;0;5;5;2312;1;2844;4;2;
/org.eclipse.jdt.ui.tests.refactoring/resources/RenameType/test46/out/C.java;1;0;1;1;0;0;0;1;0;0;1;49;0;0;1;0;0;1;1;49;0;49;1;1;
/org.eclipse.jdt.ui.tests.refactoring/resources/RenamePackage/test1/out/p1/A.java;1;0;1;1;0;0;0;1;0;0;1;49;0;0;1;0;0;1;1;49;0;49;1;1;
/org.eclipse.jdt.ui.tests.refactoring/resources/StructureSelectionAction/A_test28.java;1;0;1;1;0;0;0;1;0;0;1;3353;0;0;1;0;0;1;1;3353;0;3353;1;1;
/org.eclipse.update.ui.forms/src/org/eclipse/update/ui/forms/internal/engine/HyperlinkAction.java;1;0;2;1;0;0;0;2;4;1;2;2746;4;4;1;0;0;2;2;2746;0;2814;2;1;
/org.eclipse.jdt.junit/src/org/eclipse/jdt/internal/junit/runner/ITestRunListener.java;1;0;1;1;0;0;0;1;0;0;1;3171;0;0;1;0;0;1;1;3171;0;3171;1;1;
/org.eclipse.help/src/org/eclipse/help/internal/contributions/xml/HelpContribution.java;2;0;3;1;0;0;0;3;38;1;3;1420;38;38;1;0;0;3;3;1420;0;1675;3;2;
/org.eclipse.help/src/org/eclipse/help/ITopic.java;2;0;5;1;1;1;1;4;6;1;4;1804;14;14;1;0;0;4;5;1804;0;3938;5;2;
/org.eclipse.update/Eclipse Update/org/eclipse/update/internal/core/UpdateManager.java;3;0;8;1;0;0;0;8;27;1;8;108;68;68;1;0;0;8;8;108;0;1424;8;3;
/org.eclipse.ant.core/src/org/eclipse/ant/core/CommaPatternSet.java;5;0;9;2;0;0;0;9;858;2;8;14;2205;2205;2;1;0;9;9;493;1;3489;8;5;
/org.eclipse.vcm.ui.cvs/src/org/eclipse/vcm/internal/ui/ccvs/UserValidationDialog.java;4;0;6;1;0;0;0;6;13;1;6;1;37;37;1;0;0;6;6;1;0;353;6;4;
/org.eclipse.pde.ui/src/org/eclipse/pde/internal/ui/wizards/templates/HelpTemplate.java;1;1;2;1;2;2;2;0;7;0;0;3902;7;7;1;0;0;0;2;3902;0;4316;2;1;
/org.eclipse.jdt.junit/Eclipse JUnit/org/eclipse/jdt/internal/junit/ui/JUnitLaunchWizard.java;2;0;4;1;0;0;0;4;7;1;4;2143;14;14;1;0;0;4;4;2143;0;3313;4;2;
/org.eclipse.jdt.ui.tests.refactoring/resources/SefWorkSpace/SefTests/object_in/TestNestedRead.java;1;0;1;1;0;0;0;1;0;0;1;2155;0;0;1;0;0;1;1;2155;0;2155;1;1;
/org.eclipse.update.core/src/org/eclipse/update/core/IInstallConfiguration.java;3;0;19;1;0;0;0;19;75;2;18;1423;298;298;2;1;0;19;19;2032;1;3018;18;3;
/org.eclipse.ui.examples.readmetool/Eclipse UI Examples Readme Tool/org/eclipse/ui/examples/readmetool/ReadmeEditor.java;2;0;4;1;1;1;1;3;120;1;3;932;144;144;1;0;0;3;4;932;0;4454;4;2;
/org.eclipse.vcm.ui/src/org/eclipse/vcm/internal/ui/HistoryView.java;4;0;19;3;0;0;0;19;110;2;17;2;244;244;2;2;0;19;19;19;2;1637;17;4;
/org.eclipse.jdt.core/model/org/eclipse/jdt/internal/core/builder/State.java;3;2;11;2;7;6;7;4;67;1;4;2979;211;211;2;0;1;4;11;4063;1;4421;10;3;
/org.eclipse.pde.ui/src/org/eclipse/pde/internal/ui/editor/feature/FeatureOutlinePage.java;1;0;4;1;1;1;1;3;24;2;2;3579;29;29;2;1;0;3;4;3579;1;3982;3;1;
/org.eclipse.ui/Eclipse JFace/org/eclipse/jface/viewers/ColorCellEditor.java;2;0;2;1;0;0;0;2;5;1;2;257;5;5;1;0;0;2;2;257;0;457;2;2;
/org.eclipse.pde.ui/Eclipse PDE UI/org/eclipse/pde/internal/schema/MappedSchemaDescriptor.java;2;0;5;2;0;0;0;5;12;3;3;267;12;12;3;2;0;5;5;324;2;1434;3;2;
/org.eclipse.jdt.debug/eval/org/eclipse/jdt/debug/eval/model/IValue.java;2;0;3;1;0;0;0;3;68;2;2;3421;68;68;2;1;0;3;3;3552;1;3552;2;2;
/org.eclipse.jdt.ui.tests.refactoring/resources/RenameType/testFail25/in/B.java;1;0;1;1;0;0;0;1;0;0;1;49;0;0;1;0;0;1;1;49;0;49;1;1;
/org.eclipse.pde.ui/src/org/eclipse/pde/internal/editor/PDEFormSection.java;2;0;6;1;0;0;0;6;10;1;6;1434;14;14;1;0;0;6;6;1434;0;3579;6;2;
/org.eclipse.ui/Eclipse JFace Text/org/eclipse/jface/text/reconciler/DirtyRegion.java;3;0;4;1;0;0;0;4;23;1;4;257;32;32;1;0;0;4;4;257;0;1066;4;3;
/org.eclipse.ui/Eclipse JFace/org/eclipse/jface/viewers/StructuredViewer.java;4;2;20;1;5;4;5;15;96;2;13;257;371;371;2;2;1;15;20;2222;3;4626;17;4;
/org.eclipse.team.examples.filesystem/src/org/eclipse/team/examples/filesystem/ui/ReplaceAction.java;1;0;1;1;1;1;1;0;0;0;0;4727;0;0;1;0;0;0;1;4727;0;4727;1;1;
/org.eclipse.jdt.ui/ui/org/eclipse/jdt/internal/ui/workingsets/ClearWorkingSetAction.java;2;1;3;1;3;3;3;0;7;0;0;3897;9;9;1;0;0;0;3;3897;0;4630;3;2;
/org.eclipse.help/src/org/eclipse/help/internal/topics/TopicsNavigationModel.java;2;0;2;1;0;0;0;2;0;1;2;1675;0;0;1;0;0;2;2;1675;0;1804;2;2;
/org.eclipse.pde.ui/src/org/eclipse/pde/model/IModel.java;1;0;2;1;0;0;0;2;0;1;2;3039;0;0;1;0;0;2;2;3039;0;3579;2;1;
/org.eclipse.jdt.core/dom/org/eclipse/jdt/core/dom/Initializer.java;2;1;6;1;2;2;2;4;14;1;4;2669;40;40;1;0;0;4;6;2669;0;4453;6;2;
/org.eclipse.jdt.ui.tests.refactoring/resources/ExtractMethodWorkSpace/ExtractMethodTests/validSelection/A_test246.java;2;1;3;1;2;2;2;1;0;0;1;49;0;0;1;0;0;1;3;49;0;4419;3;2;
/org.eclipse.pde.core/src/org/eclipse/pde/internal/core/ifeature/IFeatureImport.java;1;0;1;1;0;0;0;1;0;0;1;3591;0;0;1;0;0;1;1;3591;0;3591;1;1;
/org.eclipse.core.resources/src/org/eclipse/core/internal/indexing/AbstractPagePolicy.java;2;0;3;1;1;1;1;2;34;1;2;448;49;49;1;0;0;2;3;448;0;4214;3;2;
/org.eclipse.jdt.core/model/org/eclipse/jdt/internal/core/builder/ClasspathDirectory.java;3;0;8;2;2;1;2;6;87;1;6;2979;125;125;2;0;1;6;8;4063;1;4063;7;3;
/org.eclipse.jdt.ui/ui refactoring/org/eclipse/jdt/internal/ui/nls/search/NLSSearchResultCollector.java;1;0;2;1;0;0;0;2;0;1;2;1913;0;0;1;0;0;2;2;1913;0;1922;2;1;
/org.eclipse.jdt.debug/model/org/eclipse/jdt/internal/debug/core/JDINullValue.java;2;0;3;1;0;0;0;3;7;1;3;1700;7;7;1;0;0;3;3;1700;0;2517;3;2;
/org.eclipse.update.ui/src/org/eclipse/update/internal/transform/AbstractTransform.java;1;0;2;1;0;0;0;2;0;1;2;1526;0;0;1;0;0;2;2;1526;0;1596;2;1;
/org.eclipse.jdt.ui/ui/org/eclipse/jdt/internal/ui/preferences/JavaBrowsingPreferencePage.java;2;0;2;2;2;1;2;0;41;0;0;4182;41;41;2;0;1;0;2;4182;1;4182;1;2;
/org.eclipse.swt/Eclipse SWT/gtk/org/eclipse/swt/widgets/ScrollBar.java;6;2;18;2;11;8;11;7;120;1;7;2107;359;359;2;0;3;7;18;4059;3;4701;15;6;
/org.eclipse.core.resources/src/org/eclipse/core/internal/indexing/ObjectStorePSPolicy.java;2;0;2;1;0;0;0;2;0;1;2;370;0;0;1;0;0;2;2;370;0;448;2;2;
/org.eclipse.ui/Eclipse JFace Text/org/eclipse/jface/text/contentassist/ContextInformationValidator.java;3;0;3;1;0;0;0;3;5;1;3;257;9;9;1;0;0;3;3;257;0;1066;3;3;
/org.eclipse.pde.ui/src/org/eclipse/pde/internal/editor/schema/AttributePropertySource.java;2;0;2;1;0;0;0;2;0;1;2;1434;0;0;1;0;0;2;2;1434;0;3579;2;2;
/org.eclipse.jdt.ui.tests.refactoring/resources/RenameVariables/canRename/A_test15_in.java;1;0;2;1;0;0;0;2;0;1;2;724;0;0;1;0;0;2;2;724;0;1665;2;1;
/org.eclipse.swt.tests/JUnit Tests/org/eclipse/swt/tests/junit/Test_org_eclipse_swt_graphics_Region.java;2;0;3;1;1;1;1;2;15;1;2;1792;21;21;1;0;0;2;3;1792;0;4706;3;2;
/org.eclipse.jdt.ui/core refactoring/org/eclipse/jdt/internal/core/refactoring/code/LocalVariableAnalyzer.java;3;0;7;1;0;0;0;7;277;1;7;408;391;391;1;0;0;7;7;408;0;1236;7;3;
/org.eclipse.jdt.ui.tests.refactoring/resources/ExtractTemp/canExtract/A_test15_out.java;1;0;1;1;0;0;0;1;0;0;1;2481;0;0;1;0;0;1;1;2481;0;2481;1;1;
/org.eclipse.pde.build/src/org/eclipse/pde/internal/build/ScriptGeneratorApplication.java;1;0;1;1;0;0;0;1;0;0;1;2896;0;0;1;0;0;1;1;2896;0;2896;1;1;
/org.eclipse.webdav/src/kernel/org/eclipse/webdav/internal/kernel/ConditionFactor.java;3;0;6;1;1;1;1;5;204;1;5;12;381;381;1;0;0;5;6;12;0;4211;6;3;
/org.eclipse.jdt.ui.tests.refactoring/resources/PullUpMethods/test0/in/A.java;1;0;2;1;0;0;0;2;0;1;2;2156;0;0;1;0;0;2;2;2156;0;2406;2;1;
/org.eclipse.jdt.ui.tests.refactoring/resources/MoveMembers/testFail15/in/B.java;1;0;1;1;0;0;0;1;0;0;1;2738;0;0;1;0;0;1;1;2738;0;2738;1;1;
/org.eclipse.jdt.ui/core refactoring/org/eclipse/jdt/core/refactoring/Refactoring.java;1;0;6;1;0;0;0;6;7;1;6;15;15;15;1;0;0;6;6;15;0;408;6;1;
/org.eclipse.jdt.ui.tests.refactoring/resources/MoveMembers/test5/out/B.java;1;0;1;1;0;0;0;1;0;0;1;2738;0;0;1;0;0;1;1;2738;0;2738;1;1;
/org.eclipse.update.core/src/org/eclipse/update/internal/security/JarVerification.java;1;0;2;1;0;0;0;2;0;1;2;3205;0;0;1;0;0;2;2;3205;0;3255;2;1;
/org.eclipse.vcm.core.cvs/src/org/eclipse/vcm/internal/core/ccvs/CVSPlugin.java;6;0;16;2;0;0;0;16;171;2;14;0;365;365;2;2;0;16;16;292;2;1640;14;6;
/org.eclipse.ui.externaltools/External Tools/org/eclipse/ui/externaltools/internal/ui/AntTargetContentProvider.java;1;1;3;1;3;3;3;0;11;0;0;4090;13;13;1;0;0;0;3;4090;0;4188;3;1;
/org.eclipse.team.cvs.ui/src/org/eclipse/team/internal/ccvs/ui/actions/NewCVSAnonEclipseConnection.java;2;1;2;1;2;2;2;0;8;0;0;3960;8;8;1;0;0;0;2;3960;0;3973;2;2;
/org.eclipse.update/src/org/eclipse/update/internal/ui/JarVerificationService.java;1;0;1;1;0;0;0;1;0;0;1;1424;0;0;1;0;0;1;1;1424;0;1424;1;1;
/org.eclipse.jdt.debug/eval/org/eclipse/jdt/internal/debug/eval/ast/instructions/Constructor.java;3;0;5;1;0;0;0;5;12;1;5;3421;20;20;1;0;0;5;5;3421;0;3677;5;3;
/org.eclipse.scripting/Eclipse Scripting/org/eclipse/scripting/internal/uirenderer/XGRPresentationModel.java;2;0;4;1;0;0;0;4;18;1;4;133;22;22;1;0;0;4;4;133;0;1424;4;2;
/org.eclipse.jdt.debug/eval/org/eclipse/jdt/debug/eval/ast/model/IThread.java;1;0;2;1;0;0;0;2;0;1;2;3329;0;0;1;0;0;2;2;3329;0;3421;2;1;
/org.eclipse.core.resources/src/org/eclipse/core/internal/indexing/LogReader.java;4;1;8;1;2;2;2;6;198;1;6;12;340;340;1;0;0;6;8;12;0;4632;8;4;
/org.eclipse.team.tests.core/src/org/eclipse/team/tests/core/TargetTestSetup.java;1;1;2;1;2;2;2;0;17;0;0;4326;17;17;1;0;0;0;2;4326;0;4636;2;1;
/org.eclipse.jdt.ui.tests.refactoring/resources/PullUpMethods/test10/in/A.java;1;0;3;1;0;0;0;3;2;1;3;2212;2;2;1;0;0;3;3;2212;0;2406;3;1;
/org.eclipse.jdt.core/model/org/eclipse/jdt/internal/core/IncrementalReconciler.java;1;0;2;1;0;0;0;2;0;1;2;455;0;0;1;0;0;2;2;455;0;632;2;1;
/org.eclipse.jdt.ui.tests.refactoring/resources/RenameTemp/canRename/A_test14_in.java;1;0;2;1;0;0;0;2;2;1;2;1625;2;2;1;0;0;2;2;1625;0;1652;2;1;
/org.eclipse.jdt.ui.tests.refactoring/resources/RenameParameters/cannotRename/A_testFail18.java;1;0;1;1;0;0;0;1;0;0;1;233;0;0;1;0;0;1;1;233;0;233;1;1;
/org.eclipse.ant.ui/src/org/eclipse/ant/ui/internal/toolscripts/GlobalToolScriptAction.java;1;0;2;1;0;0;0;2;0;1;2;2919;0;0;1;0;0;2;2;2919;0;2933;2;1;
/org.eclipse.search/search/org/eclipse/search/internal/ui/CopyToClipboardAction.java;1;1;4;1;2;2;2;2;28;1;2;1670;40;40;1;0;0;2;4;1670;0;4364;4;1;
/org.eclipse.jdt.ui.tests.refactoring/resources/StructureSelectionAction/A_test27.java;1;0;1;1;0;0;0;1;0;0;1;3353;0;0;1;0;0;1;1;3353;0;3353;1;1;
/org.eclipse.jdt.ui.tests.refactoring/resources/InlineTemp/canInline/A_test5_in.java;1;0;2;1;1;1;1;1;12;0;1;2015;12;12;1;0;0;1;2;2015;0;4419;2;1;
/org.eclipse.team.ui/src/org/eclipse/team/ui/IConfigurationWizard.java;1;0;2;1;0;0;0;2;60;1;2;1978;60;60;1;0;0;2;2;1978;0;3102;2;1;
/org.eclipse.pde.core/src/org/eclipse/pde/internal/core/plugin/XMLErrorHandler.java;1;0;1;1;0;0;0;1;0;0;1;3591;0;0;1;0;0;1;1;3591;0;3591;1;1;
/org.eclipse.core.tests.runtime/src/org/eclipse/core/tests/internal/runtime/AuthorizationDatabaseTest.java;3;0;4;1;0;0;0;4;246;1;4;1794;324;324;1;0;0;4;4;1794;0;3476;4;3;
/org.eclipse.jdt.ui.tests.refactoring/resources/RenameVirtualMethodInClass/testFail34/in/A.java;1;0;1;1;0;0;0;1;0;0;1;49;0;0;1;0;0;1;1;49;0;49;1;1;
/org.eclipse.jdt.ui.tests.refactoring/resources/ExtractMethodWorkSpace/ExtractMethodTests/expression_out/A_test608.java;2;1;4;1;2;2;2;2;4;1;2;376;4;4;1;0;0;2;4;376;0;4419;4;2;
/org.eclipse.debug.ui/ui/org/eclipse/debug/ui/ISourcePresentation.java;2;0;3;1;0;0;0;3;7;1;3;2775;9;9;1;0;0;3;3;2775;0;3492;3;2;
/org.eclipse.core.resources/src/org/eclipse/core/resources/ISaveContext.java;1;0;4;1;1;1;1;3;368;1;3;12;388;388;1;0;0;3;4;12;0;4214;4;1;
/org.eclipse.jdt.debug/jdi interfaces/com/sun/jdi/InternalException.java;2;0;2;1;0;0;0;2;11;1;2;2704;11;11;1;0;0;2;2;2704;0;3033;2;2;
/org.eclipse.debug.ui/ui/org/eclipse/debug/internal/ui/actions/DisableBreakpointsAction.java;1;0;2;1;0;0;0;2;3;1;2;2736;3;3;1;0;0;2;2;2736;0;3838;2;1;
/org.eclipse.update.core/src/org/eclipse/update/core/IFeatureFactory.java;2;0;8;1;0;0;0;8;46;2;7;2251;82;82;2;1;0;8;8;2976;1;3571;7;2;
/org.eclipse.update.core/src/org/eclipse/update/core/ISite.java;3;1;32;1;2;2;2;30;261;2;24;1423;638;638;2;6;0;30;32;1423;6;4408;26;3;
/org.eclipse.jdt.ui.tests/JUnit/junit/framework/TestCase.java;2;0;2;1;0;0;0;2;0;1;2;49;0;0;1;0;0;2;2;49;0;1186;2;2;
/org.eclipse.team.tests.cvs.core/src/org/eclipse/team/tests/ccvs/core/AllTeamAndCVSTests.java;1;0;1;1;0;0;0;1;0;0;1;3306;0;0;1;0;0;1;1;3306;0;3306;1;1;
/org.eclipse.pde.ui/src/org/eclipse/pde/internal/ui/wizards/templates/IVariableProvider.java;1;0;2;1;0;0;0;2;0;1;2;3579;0;0;1;0;0;2;2;3579;0;3819;2;1;
/org.eclipse.update.core/src/org/eclipse/update/core/AbstractFeature.java;1;0;11;1;0;0;0;11;586;3;7;1451;1356;1356;3;4;0;11;11;1638;4;1638;7;1;
/org.eclipse.swt/Eclipse SWT/common/org/eclipse/swt/internal/image/PngTrnsChunk.java;2;0;3;1;1;1;1;2;10;1;2;106;16;16;1;0;0;2;3;106;0;4701;3;2;
/org.eclipse.vcm.core.cvs/src/org/eclipse/vcm/internal/core/ccvs/client/CVSServerException.java;2;0;2;1;0;0;0;2;6;1;2;0;6;6;1;0;0;2;2;0;0;298;2;2;
/org.eclipse.jdt.ui.tests/test plugin/org/eclipse/jdt/testplugin/JavaElementDecorator.java;1;0;1;1;0;0;0;1;0;0;1;3202;0;0;1;0;0;1;1;3202;0;3202;1;1;
/org.eclipse.pde.core/src/org/eclipse/pde/core/build/IBuildEntry.java;1;0;4;1;2;1;2;2;78;1;2;3591;79;79;2;0;1;2;4;4751;1;4751;3;1;
/org.eclipse.jdt.ui.tests.refactoring/resources/RenameType/test15/in/A.java;1;0;1;1;0;0;0;1;0;0;1;49;0;0;1;0;0;1;1;49;0;49;1;1;
/org.eclipse.jdt.core/model/org/eclipse/jdt/internal/core/builder/IDependencyGraph.java;1;0;3;1;0;0;0;3;9;1;3;455;9;9;1;0;0;3;3;455;0;2808;3;1;
/org.eclipse.swt.tests/JUnit Tests/org/eclipse/swt/tests/junit/Test_org_eclipse_swt_events_DisposeListener.java;2;0;2;1;1;1;1;1;6;0;1;1792;6;6;1;0;0;1;2;1792;0;4706;2;2;
/org.eclipse.webdav/src/kernel/org/eclipse/webdav/internal/kernel/WebDAVPropertyNames.java;2;0;5;1;1;1;1;4;152;1;4;12;326;326;1;0;0;4;5;12;0;4211;5;2;
/org.eclipse.jdt.ui.tests.refactoring/resources/MoveMembers/test13/in/A.java;1;0;1;1;0;0;0;1;0;0;1;2738;0;0;1;0;0;1;1;2738;0;2738;1;1;
/org.eclipse.scripting/src/org/eclipse/scripting/internal/ScriptReaderWorkbenchFile.java;1;0;1;1;0;0;0;1;0;0;1;1424;0;0;1;0;0;1;1;1424;0;1424;1;1;
/org.eclipse.swt/Eclipse SWT/carbon/org/eclipse/swt/graphics/DeviceData.java;3;1;3;1;3;3;3;0;6;0;0;4147;8;8;1;0;0;0;3;4147;0;4701;3;3;
/org.eclipse.ui.externaltools/External Tools/org/eclipse/ui/externaltools/internal/core/ToolMessages.java;1;0;1;1;1;1;1;0;0;0;0;4090;0;0;1;0;0;0;1;4090;0;4090;1;1;
/org.eclipse.scripting.tests/src/org/eclipse/scripting/tests/ScriptTestToolkit.java;1;0;1;1;0;0;0;1;0;0;1;1862;0;0;1;0;0;1;1;1862;0;1862;1;1;
/org.eclipse.jdt.ui/ui/org/eclipse/jdt/internal/ui/text/javadoc/JavaDocTextReader.java;2;0;6;1;0;0;0;6;41;1;6;15;91;91;1;0;0;6;6;15;0;1670;6;2;
/org.eclipse.jdt.ui/ui/org/eclipse/jdt/internal/ui/reorg/ProjectNamingPolicy.java;3;0;6;1;0;0;0;6;19;1;6;46;34;34;1;0;0;6;6;46;0;1258;6;3;
/org.eclipse.jdt.ui.tests.refactoring/resources/ExtractMethodWorkSpace/ExtractMethodTests/invalidSelection/A_test143.java;1;1;3;1;2;2;2;1;20;0;1;887;20;20;1;0;0;1;3;887;0;4419;3;1;
/org.eclipse.jdt.ui/ui/org/eclipse/jdt/internal/ui/JavaHierarchyPerspectiveFactory.java;5;0;7;1;1;1;1;6;15;1;6;329;35;35;1;0;0;6;7;329;0;4085;7;5;
/org.eclipse.ui/Eclipse UI/org/eclipse/ui/actions/RefreshAction.java;5;0;7;1;0;0;0;7;36;1;7;257;98;98;1;0;0;7;7;257;0;3570;7;5;
/org.eclipse.jdt.ui.tests.refactoring/resources/RenameStaticMethod/test6/out/A.java;2;0;3;1;0;0;0;3;4;1;3;49;6;6;1;0;0;3;3;49;0;2248;3;2;
/org.eclipse.jdt.ui/core refactoring/org/eclipse/jdt/internal/core/refactoring/methods/MethodRefactoring.java;2;0;5;1;0;0;0;5;14;1;5;408;30;30;1;0;0;5;5;408;0;1342;5;2;
/org.eclipse.update.ui/src/org/eclipse/update/internal/ui/model/NamedModelObject.java;1;0;3;1;0;0;0;3;15;1;3;3517;17;17;1;0;0;3;3;3517;0;3740;3;1;
/org.eclipse.debug.ui/ui/org/eclipse/debug/internal/ui/DebugWithAction.java;1;0;2;1;0;0;0;2;0;1;2;2254;0;0;1;0;0;2;2;2254;0;2382;2;1;
/org.eclipse.jdt.ui/core refactoring/org/eclipse/jdt/internal/core/refactoring/projects/RenameJavaProjectChange.java;1;0;3;1;0;0;0;3;45;1;3;1108;45;45;1;0;0;3;3;1108;0;1342;3;1;
/org.eclipse.jdt.debug/jdi/org/eclipse/jdi/internal/TypeComponentImpl.java;2;0;3;1;0;0;0;3;13;1;3;187;25;25;1;0;0;3;3;187;0;3041;3;2;
/org.eclipse.swt.examples/org/eclipse/swt/examples/fileviewer/ComboView.java;2;0;3;2;0;0;0;3;88;2;2;554;88;88;2;1;0;3;3;609;1;609;2;2;
/org.eclipse.ui/Eclipse UI Text Editor/org/eclipse/ui/editors/text/TextEditorPreferencePage.java;6;0;10;1;1;1;1;9;51;1;9;257;151;151;1;0;0;9;10;257;0;4838;10;6;
/org.eclipse.core.tests.resources/src/org/eclipse/core/tests/internal/resources/WaterNature.java;1;0;1;1;0;0;0;1;0;0;1;3075;0;0;1;0;0;1;1;3075;0;3075;1;1;
/org.eclipse.update.core/src/org/eclipse/update/internal/core/DefaultPackagedFeature.java;1;0;16;1;0;0;0;16;312;2;13;1451;1275;1275;2;3;0;16;16;1451;3;1791;13;1;
/org.eclipse.jdt.ui.tests.refactoring/resources/RenameNonPrivateField/test3/out/A.java;1;0;1;1;0;0;0;1;0;0;1;49;0;0;1;0;0;1;1;49;0;49;1;1;
/org.eclipse.scripting/Eclipse Scripting/org/eclipse/scripting/internal/uirenderer/XGRElementUISwtWizard.java;2;0;4;1;0;0;0;4;32;1;4;133;54;54;1;0;0;4;4;133;0;1424;4;2;
/org.eclipse.core.tests.runtime/src/org/eclipse/core/tests/internal/plugins/PluginResolveTest_16.java;3;0;3;1;0;0;0;3;110;1;3;1794;120;120;1;0;0;3;3;1794;0;3476;3;3;
/org.eclipse.jdt.debug.ui/ui/org/eclipse/jdt/internal/debug/ui/actions/EnableDisableBreakpointRulerAction.java;1;0;3;1;0;0;0;3;132;2;2;3572;138;138;2;1;0;3;3;3572;1;3676;2;1;
/org.eclipse.jdt.ui.tests.refactoring/resources/RenameParameters/canRename/A_test6_out.java;1;0;1;1;0;0;0;1;0;0;1;233;0;0;1;0;0;1;1;233;0;233;1;1;
/org.eclipse.jdt.ui.tests.refactoring/resources/MultiMove/test2/in/p2/C.java;1;0;1;1;0;0;0;1;0;0;1;1157;0;0;1;0;0;1;1;1157;0;1157;1;1;
/org.eclipse.pde.ui/src/org/eclipse/pde/internal/wizards/templates/TemplateEditorInput.java;1;0;3;1;0;0;0;3;10;1;3;3240;10;10;1;0;0;3;3;3240;0;3579;3;1;
/org.eclipse.jdt.debug.ui/ui/org/eclipse/jdt/internal/debug/ui/launcher/JavaSourceLookupTab.java;1;1;5;1;5;5;5;0;14;0;0;3927;24;24;1;0;0;0;5;3927;0;4098;5;1;
/org.eclipse.jdt.debug/model/org/eclipse/jdt/debug/core/IJavaObject.java;3;0;11;1;0;0;0;11;23;2;9;1675;74;74;2;2;0;11;11;3104;2;3774;9;3;
/org.eclipse.update.ui/src/org/eclipse/update/internal/ui/forms/DetailsForm.java;3;2;22;2;18;14;18;4;166;1;4;3662;423;423;2;0;4;4;22;4047;4;4714;18;3;
/org.eclipse.jdt.ui.tests.refactoring/resources/PasteSourceReference/test1/in/A.java;1;0;1;1;0;0;0;1;0;0;1;2064;0;0;1;0;0;1;1;2064;0;2064;1;1;
/org.eclipse.jdt.ui/core refactoring/org/eclipse/jdt/internal/core/refactoring/cus/CompilationUnitReorgChange.java;1;0;2;1;0;0;0;2;0;1;2;1257;0;0;1;0;0;2;2;1257;0;1342;2;1;
/org.eclipse.ui.tests/Eclipse UI Tests/org/eclipse/ui/tests/api/IPerspectiveRegistryTest.java;3;0;7;1;1;1;1;6;15;1;6;881;41;41;1;0;0;6;7;881;0;4471;7;3;
/org.eclipse.jdt.core/model/org/eclipse/jdt/internal/core/RenameElementsOperation.java;2;0;9;1;1;1;1;8;115;4;5;455;150;150;4;3;0;8;9;1039;3;4063;6;2;
/org.eclipse.ui/Eclipse UI/org/eclipse/ui/IFileEditorMapping.java;3;0;3;1;0;0;0;3;7;1;3;257;12;12;1;0;0;3;3;257;0;3377;3;3;
/org.eclipse.jdt.ui.tests.refactoring/resources/ExtractMethodWorkSpace/ExtractMethodTests/expression_in/A_test619.java;1;1;3;1;2;2;2;1;14;0;1;2634;14;14;1;0;0;1;3;2634;0;4419;3;1;
/org.eclipse.jdt.ui/ui/org/eclipse/jdt/internal/ui/viewsupport/ProblemMarkerManager.java;3;1;10;1;5;5;5;5;73;1;5;1241;167;167;1;0;0;5;10;1241;0;4621;10;3;
/org.eclipse.jdt.core/search/org/eclipse/jdt/internal/core/search/matching/MatchSet.java;3;1;26;1;2;2;2;24;948;4;18;455;2319;2319;4;6;0;24;26;1039;6;4419;20;3;
/org.eclipse.swt/Eclipse SWT/motif/org/eclipse/swt/widgets/AbstractTreeItem.java;2;0;4;1;0;0;0;4;23;1;4;106;31;31;1;0;0;4;4;106;0;1028;4;2;
/org.eclipse.jdt.ui/core refactoring/org/eclipse/jdt/internal/corext/refactoring/nls/NLSElement.java;1;0;2;1;0;0;0;2;2;1;2;1939;2;2;1;0;0;2;2;1939;0;2137;2;1;
/org.eclipse.jdt.ui.tests.refactoring/resources/MoveMembers/testFail20/in/A.java;1;0;1;1;0;0;0;1;0;0;1;2928;0;0;1;0;0;1;1;2928;0;2928;1;1;
/org.eclipse.help.ui/src/org/eclipse/help/ui/internal/browser/win32/WebBrowser.java;2;0;2;1;1;1;1;1;0;0;1;3030;0;0;1;0;0;1;2;3030;0;4427;2;2;
/org.eclipse.jdt.junit/src/org/eclipse/jdt/internal/junit/util/ExceptionHandler.java;2;0;3;1;0;0;0;3;4;1;3;3247;6;6;1;0;0;3;3;3247;0;3659;3;2;
/org.eclipse.swt/Eclipse SWT PI/win32/org/eclipse/swt/internal/win32/OS.java;5;1;39;3;5;5;5;34;57;3;29;2069;244;244;3;5;0;34;39;3005;5;4701;34;5;
/org.eclipse.jdt.ui/core extension/org/eclipse/jdt/internal/corext/textmanipulation/TextEdit.java;2;0;5;1;0;0;0;5;5;1;5;2137;14;14;1;0;0;5;5;2137;0;3870;5;2;
/org.eclipse.debug.ui/ui/org/eclipse/debug/internal/ui/actions/ActionMessages.java;1;0;1;1;0;0;0;1;0;0;1;2382;0;0;1;0;0;1;1;2382;0;2382;1;1;
/org.eclipse.jdt.ui.tests.refactoring/resources/ExtractTemp/canExtract/A_test14_out.java;1;0;1;1;0;0;0;1;0;0;1;2481;0;0;1;0;0;1;1;2481;0;2481;1;1;
/org.eclipse.jdt.core/model/org/eclipse/jdt/core/jdom/IDOMField.java;2;0;4;1;1;1;1;3;106;1;3;455;135;135;1;0;0;3;4;455;0;4061;4;2;
/org.eclipse.jdt.debug/eval/org/eclipse/jdt/debug/eval/model/IPrimitiveType.java;2;0;3;1;0;0;0;3;4;1;3;3421;4;4;1;0;0;3;3;3421;0;3555;3;2;
/org.eclipse.jdt.ui.tests.refactoring/resources/ExtractMethodWorkSpace/ExtractMethodTests/locals_in/A_test535.java;1;1;3;1;2;2;2;1;14;0;1;922;14;14;1;0;0;1;3;922;0;4419;3;1;
/org.eclipse.ui/Eclipse UI/org/eclipse/ui/dialogs/ElementFilter.java;1;0;2;1;0;0;0;2;0;0;1;3225;0;0;2;1;0;2;2;3225;1;3225;1;1;
/org.eclipse.jdt.ui.tests.refactoring/resources/SelectionAnalyzerWorkSpace/SelectionAnalyzerTests/validSelection/A_test300.java;1;0;1;1;0;0;0;1;0;0;1;1368;0;0;1;0;0;1;1;1368;0;1368;1;1;
/org.eclipse.pde.ui/Eclipse PDE UI/org/eclipse/pde/internal/base/model/ModelProviderEvent.java;2;0;5;2;0;0;0;5;12;3;3;267;12;12;3;2;0;5;5;324;2;1434;3;2;
/org.eclipse.jdt.ui.tests/refactoring/org/eclipse/jdt/refactoring/tests/MultiMoveTests.java;2;0;4;1;0;0;0;4;36;1;4;1258;47;47;1;0;0;4;4;1258;0;1896;4;2;
/org.eclipse.jdt.core/compiler/org/eclipse/jdt/internal/compiler/ast/ThisReference.java;2;0;11;1;1;1;1;10;120;4;7;455;176;176;4;3;0;10;11;1039;3;4062;8;2;
/org.eclipse.vcm.core.cvs/src/org/eclipse/vcm/internal/core/ccvs/utils/FileUtil.java;4;0;4;1;0;0;0;4;13;1;4;0;16;16;1;0;0;4;4;0;0;423;4;4;
/org.eclipse.ui/Eclipse JFace Text/org/eclipse/jface/text/formatter/IFormattingStrategy.java;3;0;3;1;0;0;0;3;21;1;3;257;26;26;1;0;0;3;3;257;0;1066;3;3;
/org.eclipse.jdt.debug.ui/ui/org/eclipse/jdt/internal/debug/ui/snippeteditor/SelectImportsAction.java;1;0;2;1;0;0;0;2;19;1;2;3330;19;19;1;0;0;2;2;3330;0;3355;2;1;
/org.eclipse.jdt.ui/ui/org/eclipse/jdt/internal/ui/search/LRUWorkingSetList.java;1;0;4;1;0;0;0;4;9;1;4;1801;11;11;1;0;0;4;4;1801;0;3760;4;1;
/org.eclipse.pde.ui/src/org/eclipse/pde/internal/editor/manifest/DetailExtensionSection.java;2;0;24;1;0;0;0;24;628;4;18;1434;1629;1629;4;6;0;24;24;3134;6;3579;18;2;
/org.eclipse.jdt.ui/core refactoring/org/eclipse/jdt/internal/corext/refactoring/sef/EncapsulateReadAccess.java;1;0;5;1;0;0;0;5;14;2;4;1939;23;23;2;1;0;5;5;2133;1;3150;4;1;
/org.eclipse.jdt.ui/ui/org/eclipse/jdt/internal/ui/util/Utilities.java;2;0;4;1;0;0;0;4;5;1;4;15;7;7;1;0;0;4;4;15;0;1310;4;2;
/org.eclipse.jdt.debug.ui/ui/org/eclipse/jdt/internal/debug/ui/launcher/SourceLookupBlock.java;4;2;20;2;11;9;11;9;693;3;7;1915;1165;1165;3;2;2;9;20;2378;4;4528;16;4;
/org.eclipse.jdt.ui/ui refactoring/org/eclipse/jdt/internal/ui/refactoring/nls/ExternalizeAction.java;3;0;8;2;0;0;0;8;9;2;6;1922;30;30;2;2;0;8;8;1922;2;3565;6;3;
/org.eclipse.ui/Eclipse JFace/org/eclipse/jface/resource/MissingImageDescriptor.java;2;0;2;1;0;0;0;2;5;1;2;257;5;5;1;0;0;2;2;257;0;457;2;2;
/org.eclipse.ui/Eclipse UI Text Editor/org/eclipse/ui/texteditor/StatusTextEditor.java;1;1;3;1;3;3;3;0;20;0;0;4138;40;40;1;0;0;0;3;4138;0;4838;3;1;
/org.eclipse.jdt.core/model/org/eclipse/jdt/core/ISourceManipulation.java;2;0;3;1;1;1;1;2;195;1;2;455;210;210;1;0;0;2;3;455;0;4061;3;2;
/org.eclipse.jdt.ui.tests.refactoring/resources/ExtractMethodWorkSpace/ExtractMethodTests/return_in/A_test704.java;1;1;3;1;2;2;2;1;14;0;1;887;14;14;1;0;0;1;3;887;0;4419;3;1;
/org.eclipse.pde.ui/src/org/eclipse/pde/PluginReference.java;1;0;2;1;0;0;0;2;0;1;2;3240;0;0;1;0;0;2;2;3240;0;3278;2;1;
/org.eclipse.jdt.ui.tests.refactoring/resources/RenameTemp/cannotRename/A_testFail24.java;1;0;1;1;0;0;0;1;0;0;1;2481;0;0;1;0;0;1;1;2481;0;2481;1;1;
/org.eclipse.jdt.debug/eval/org/eclipse/jdt/internal/debug/eval/ast/engine/ASTEvaluationEngine.java;3;1;22;1;2;2;2;20;194;2;16;3421;659;659;2;4;0;20;22;3469;4;4423;18;3;
/org.eclipse.ui/Eclipse UI Standard Components/org/eclipse/ui/views/tasklist/TaskPropertiesDialog.java;2;1;8;1;3;3;3;5;111;2;4;3148;145;145;2;1;0;5;8;3170;1;4436;7;2;
/org.eclipse.jdt.ui.tests.refactoring/resources/SelectionAnalyzerWorkSpace/SelectionAnalyzerTests/validSelection/A_testx.java;1;0;2;1;0;0;0;2;0;1;2;1368;0;0;1;0;0;2;2;1368;0;2155;2;1;
/org.eclipse.vcm.core/src/org/eclipse/vcm/internal/core/Policy.java;2;0;2;1;0;0;0;2;5;1;2;0;5;5;1;0;0;2;2;0;0;297;2;2;
/org.eclipse.pde.ui/src/org/eclipse/pde/internal/core/IModelProviderEvent.java;1;0;2;1;0;0;0;2;0;1;2;3579;0;0;1;0;0;2;2;3579;0;3607;2;1;
/org.eclipse.debug.core/core/org/eclipse/debug/core/model/IStreamsProxy.java;3;0;6;1;1;1;1;5;8;1;5;187;21;21;1;0;0;5;6;187;0;4652;6;3;
/org.eclipse.jdt.ui.tests.refactoring/resources/ReorderParameters/canReorder/A_test19_in.java;1;0;1;1;0;0;0;1;0;0;1;2406;0;0;1;0;0;1;1;2406;0;2406;1;1;
/org.eclipse.jdt.core/search/org/eclipse/jdt/internal/core/index/impl/BlocksIndexOutput.java;2;0;9;1;1;1;1;8;83;4;5;455;119;119;4;3;0;8;9;1039;3;4063;6;2;
/org.eclipse.jdt.ui/ui/org/eclipse/jdt/internal/ui/javaeditor/BasicEditorActionContributor.java;5;2;17;2;7;6;7;10;84;1;10;15;328;328;2;0;1;10;17;4208;1;4598;16;5;
/org.eclipse.jdt.ui/core refactoring/org/eclipse/jdt/internal/corext/refactoring/code/flow/FlowAnalyzer.java;2;0;11;1;0;0;0;11;1095;1;11;1939;1312;1312;1;0;0;11;11;1939;0;3826;11;2;
/org.eclipse.update.core/src/org/eclipse/update/internal/core/Assert.java;1;0;3;1;0;0;0;3;4;1;3;1643;6;6;1;0;0;3;3;1643;0;1710;3;1;
/org.eclipse.vcm.core/src/org/eclipse/vcm/internal/core/base/IRepositoryLocation.java;2;0;2;1;0;0;0;2;5;1;2;0;5;5;1;0;0;2;2;0;0;297;2;2;
/org.eclipse.ui.tests/Eclipse UI Tests/RunSessionCreateTest.java;1;0;2;1;0;0;0;2;0;1;2;1066;0;0;1;0;0;2;2;1066;0;1407;2;1;
/org.eclipse.jdt.ui/ui/org/eclipse/jdt/internal/ui/packageview/PackagesMessages.java;1;0;1;1;0;0;0;1;0;0;1;719;0;0;1;0;0;1;1;719;0;719;1;1;
/org.eclipse.jdt.core/search/org/eclipse/jdt/internal/core/index/IEntryResult.java;2;0;4;1;1;1;1;3;21;1;3;455;30;30;1;0;0;3;4;455;0;4063;4;2;
/org.eclipse.ui/Eclipse UI/org/eclipse/ui/internal/ProductInfo.java;5;1;15;1;2;2;2;13;192;1;13;257;840;840;1;0;0;13;15;257;0;4210;15;5;
/org.eclipse.jdt.ui/core refactoring/org/eclipse/jdt/internal/core/refactoring/nls/NLSScanner.java;2;0;3;1;0;0;0;3;4;2;2;1922;4;4;2;1;0;3;3;1922;1;1939;2;2;
/org.eclipse.vcm.ui/src/org/eclipse/vcm/internal/ui/sync/SyncView.java;5;0;31;2;0;0;0;31;126;3;21;62;552;552;3;10;0;31;31;295;10;1659;21;5;
/org.eclipse.jdt.ui/ui refactoring/org/eclipse/jdt/internal/ui/refactoring/ChangeElementTreeViewer.java;1;0;6;1;0;0;0;6;94;1;6;1800;108;108;1;0;0;6;6;1800;0;2874;6;1;
/org.eclipse.pde.ui/Eclipse PDE UI/org/eclipse/pde/internal/base/model/plugin/IFragmentModel.java;2;0;5;2;0;0;0;5;12;3;3;267;12;12;3;2;0;5;5;324;2;1434;3;2;
/org.eclipse.ui.tests/Eclipse UI Tests/org/eclipse/ui/tests/api/MockAction.java;2;0;6;2;0;0;0;6;61;2;5;1041;73;73;2;1;0;6;6;1080;1;1500;5;2;
/org.eclipse.compare/compare/org/eclipse/compare/internal/StatusLineContributionItem.java;1;0;3;1;0;0;0;3;6;1;3;2415;6;6;1;0;0;3;3;2415;0;2704;3;1;
/org.eclipse.pde.ui/src/org/eclipse/pde/internal/base/model/component/IComponentObject.java;2;0;2;1;0;0;0;2;0;1;2;1434;0;0;1;0;0;2;2;1434;0;2951;2;2;
/org.eclipse.pde.ui/src/org/eclipse/pde/internal/wizards/templates/ITemplateSection.java;1;0;5;1;0;0;0;5;17;1;5;3278;28;28;1;0;0;5;5;3278;0;3579;5;1;
/org.eclipse.pde.core/src/org/eclipse/pde/internal/core/builders/DependencyLoop.java;1;0;2;1;0;0;0;2;0;1;2;3591;0;0;1;0;0;2;2;3591;0;3631;2;1;
/org.eclipse.core.resources/src/org/eclipse/core/internal/resources/SyncInfoSnapReader.java;2;0;6;1;1;1;1;5;96;1;5;158;140;140;1;0;0;5;6;158;0;4213;6;2;
/org.eclipse.pde.core/src/org/eclipse/pde/internal/core/feature/FeatureChild.java;1;1;3;1;3;3;3;0;7;0;0;3982;12;12;1;0;0;0;3;3982;0;4547;3;1;
/org.eclipse.pde.ui/src/org/eclipse/pde/internal/model/feature/FeatureImport.java;1;0;3;1;0;0;0;3;2;1;3;2952;2;2;1;0;0;3;3;2952;0;3579;3;1;
/org.eclipse.pde.ui/Eclipse PDE UI/org/eclipse/pde/internal/component/BuildPluginWizardPage.java;2;0;4;1;0;0;0;4;40;3;2;512;40;40;3;2;0;4;4;512;2;1434;2;2;
/org.eclipse.jdt.core/dom/org/eclipse/jdt/core/dom/InfixExpression.java;2;2;11;1;4;3;4;7;60;1;7;2669;124;124;2;0;1;7;11;4452;1;4452;10;2;
/org.eclipse.help/src/org/eclipse/help/internal/protocols/links/LinksURL.java;1;0;2;1;0;0;0;2;0;1;2;2572;0;0;1;0;0;2;2;2572;0;2694;2;1;
/org.eclipse.jdt.debug.ui/ui/org/eclipse/jdt/internal/debug/ui/launcher/StackFrameAction.java;2;0;2;1;0;0;0;2;0;1;2;1915;0;0;1;0;0;2;2;1915;0;2384;2;2;
/org.eclipse.jdt.junit/src/org/eclipse/jdt/internal/junit/wizards/NewTestCaseCreationWizard.java;2;1;4;1;2;2;2;2;18;1;2;3527;22;22;1;0;0;2;4;3527;0;4254;4;2;
/org.eclipse.ui/Eclipse JFace Text/org/eclipse/jface/text/information/IInformationProvider.java;2;0;2;1;1;1;1;1;24;0;1;1435;24;24;1;0;0;1;2;1435;0;4838;2;2;
/org.eclipse.update.ui/src/org/eclipse/update/internal/ui/manager/PopularSitesSection.java;1;0;2;1;0;0;0;2;0;1;2;1428;0;0;1;0;0;2;2;1428;0;1596;2;1;
/org.eclipse.update.ui/src/org/eclipse/update/internal/ui/manager/DiscoveryFolderPage.java;1;0;2;1;0;0;0;2;0;1;2;3517;0;0;1;0;0;2;2;3517;0;3537;2;1;
/org.eclipse.pde.ui/Eclipse PDE UI/org/eclipse/pde/internal/base/model/component/IComponentURL.java;2;0;5;2;0;0;0;5;12;3;3;267;12;12;3;2;0;5;5;324;2;1434;3;2;
/org.eclipse.debug.ui/ui/org/eclipse/debug/internal/ui/VariablesView.java;4;0;31;2;0;0;0;31;419;5;19;187;1110;1110;5;12;0;31;31;2307;12;2342;19;4;
/org.eclipse.jdt.ui.tests.refactoring/resources/ExtractMethodWorkSpace/ExtractMethodTests/invalidSelection/A_test083.java;2;1;3;1;2;2;2;1;0;0;1;49;0;0;1;0;0;1;3;49;0;4419;3;2;
/org.eclipse.jdt.ui.tests.refactoring/resources/RenameParameters/canRename/A_test21_in.java;2;0;2;1;0;0;0;2;3;1;2;233;3;3;1;0;0;2;2;233;0;952;2;2;
/org.eclipse.swt.examples/org/eclipse/swt/examples/layoutexample/GridLayoutTab.java;2;1;5;1;2;2;2;3;198;1;3;3420;208;208;1;0;0;3;5;3420;0;4024;5;2;
/org.eclipse.jdt.ui/ui/org/eclipse/jdt/internal/ui/wizards/NewClassCreationWizardPage.java;3;0;25;1;0;0;0;25;190;3;23;15;472;472;3;2;0;25;25;3084;2;3084;23;3;
/org.eclipse.jdt.ui/ui refactoring/org/eclipse/jdt/internal/ui/refactoring/changes/AbortChangeExceptionHandler.java;2;0;4;1;0;0;0;4;6;1;4;157;10;10;1;0;0;4;4;157;0;1939;4;2;
/org.eclipse.webdav/src/client/org/eclipse/webdav/http/client/Request.java;3;0;5;1;1;1;1;4;326;1;4;12;362;362;1;0;0;4;5;12;0;4211;5;3;
/org.eclipse.team.cvs.ui/src/org/eclipse/team/internal/ccvs/ui/CVSDecorator.java;4;1;39;2;9;9;9;30;354;4;23;1978;1630;1630;4;7;0;30;39;3206;7;4632;32;4;
/org.eclipse.jdt.ui/core refactoring/org/eclipse/jdt/internal/core/refactoring/rename/TextMatchFinder.java;2;0;6;1;0;0;0;6;49;2;4;1547;55;55;2;2;0;6;6;1877;2;1937;4;2;
/org.eclipse.pde.ui/src/org/eclipse/pde/model/plugin/IPluginAttribute.java;1;0;2;1;0;0;0;2;0;1;2;3039;0;0;1;0;0;2;2;3039;0;3579;2;1;
/org.eclipse.debug.ui/ui/org/eclipse/debug/internal/ui/actions/EnableDisableBreakpointAction.java;1;0;2;1;0;0;0;2;0;1;2;2382;0;0;1;0;0;2;2;2382;0;2736;2;1;
/org.eclipse.jdt.core/compiler/org/eclipse/jdt/internal/compiler/util/HashtableOfType.java;2;0;10;1;1;1;1;9;163;4;5;455;213;213;4;4;0;9;10;1039;4;4062;6;2;
/org.eclipse.team.tests.cvs.core/src/org/eclipse/team/tests/ccvs/core/cvsresources/SynchronizerTest.java;2;0;3;1;0;0;0;3;99;1;3;2536;99;99;1;0;0;3;3;2536;0;3089;3;2;
/org.eclipse.scripting/Eclipse Scripting/org/eclipse/scripting/internal/uirenderer/ScriptPreferencePage.java;2;0;4;1;0;0;0;4;13;1;4;133;23;23;1;0;0;4;4;133;0;1424;4;2;
/org.eclipse.pde.ui/src/org/eclipse/pde/internal/ui/preferences/RuntimeTracingPreferencePage.java;1;0;3;1;0;0;0;3;9;1;3;3579;9;9;1;0;0;3;3;3579;0;3634;3;1;
/org.eclipse.ui/Eclipse UI Standard Components/org/eclipse/ui/views/internal/framelist/TreeViewerFrameSource.java;3;0;4;1;0;0;0;4;4;1;4;257;8;8;1;0;0;4;4;257;0;3816;4;3;
/org.eclipse.jdt.junit/Eclipse JUnit/org/eclipse/jdt/junit/util/FileUtil.java;2;0;2;1;0;0;0;2;0;1;2;1511;0;0;1;0;0;2;2;1511;0;1996;2;2;
/org.eclipse.jdt.ui.tests.refactoring/resources/RenameVariables/canRename/A_test5_out.java;1;0;2;1;0;0;0;2;0;1;2;724;0;0;1;0;0;2;2;724;0;1665;2;1;
/org.eclipse.jdt.ui/core extension/org/eclipse/jdt/internal/corext/javadoc/JavaDocVMInstallListener.java;1;0;1;1;1;1;1;0;0;0;0;4187;0;0;1;0;0;0;1;4187;0;4187;1;1;
/org.eclipse.team.cvs.core/src/org/eclipse/team/internal/ccvs/core/streams/SizeConstrainedInputStream.java;2;1;4;1;2;2;2;2;6;1;2;3574;10;10;1;0;0;2;4;3574;0;4169;4;2;
/org.eclipse.swt/Eclipse SWT PI/gtk1x/org/eclipse/swt/internal/gtk/OS.java;4;0;16;2;1;1;1;15;31;3;11;2107;93;93;3;4;0;15;16;2154;4;4701;12;4;
/org.eclipse.swt/Eclipse SWT Drag and Drop/win32/org/eclipse/swt/dnd/DragSource.java;3;1;8;1;5;5;5;3;114;1;3;106;242;242;1;0;0;3;8;106;0;4824;8;3;
/org.eclipse.swt/Eclipse SWT/common/org/eclipse/swt/internal/image/JPEGStartOfImage.java;2;0;3;1;1;1;1;2;6;1;2;106;10;10;1;0;0;2;3;106;0;4701;3;2;
/org.eclipse.update.tests.core/src/org/eclipse/update/tests/uivalues/AllCoreUITests.java;1;0;3;1;0;0;0;3;4;2;2;1686;4;4;2;1;0;3;3;2589;1;2589;2;1;
/org.eclipse.team.tests.cvs.core/src/org/eclipse/team/tests/ccvs/ui/logformatter/PrintSummaryMain.java;1;0;1;1;0;0;0;1;0;0;1;3452;0;0;1;0;0;1;1;3452;0;3452;1;1;
/org.eclipse.jdt.ui/ui/org/eclipse/jdt/internal/ui/filters/FilterMessages.java;1;0;1;1;1;1;1;0;0;0;0;4211;0;0;1;0;0;0;1;4211;0;4211;1;1;
/org.eclipse.compare/compare/org/eclipse/compare/internal/ZipStructureCreator.java;2;0;5;1;0;0;0;5;20;1;5;14;34;34;1;0;0;5;5;14;0;1254;5;2;
/org.eclipse.jdt.ui/ui refactoring/org/eclipse/jdt/internal/ui/refactoring/actions/ModifyParamatersAction.java;1;0;2;1;0;0;0;2;0;1;2;3793;0;0;1;0;0;2;2;3793;0;3807;2;1;
/org.eclipse.pde.ui/src/org/eclipse/pde/internal/ui/wizards/templates/GenericTemplateWizardPage.java;1;0;2;1;0;0;0;2;0;1;2;3579;0;0;1;0;0;2;2;3579;0;3819;2;1;
/org.eclipse.ui.externaltools/External Tools/org/eclipse/ui/externaltools/internal/core/IRunnerContext.java;1;0;1;1;1;1;1;0;0;0;0;4090;0;0;1;0;0;0;1;4090;0;4090;1;1;
/org.eclipse.update.core/src/org/eclipse/update/core/model/ConfigurationActivityModel.java;1;0;4;1;0;0;0;4;18;1;4;2764;21;21;1;0;0;4;4;2764;0;3027;4;1;
/org.eclipse.swt/Eclipse SWT OLE Win32/win32/org/eclipse/swt/internal/ole/win32/IStorage.java;2;0;3;1;0;0;0;3;5;1;3;106;5;5;1;0;0;3;3;106;0;2069;3;2;
/org.eclipse.jdt.junit/Eclipse JUnit/org/eclipse/jdt/internal/junit/runner/RemoteTestRunner.java;2;0;6;1;0;0;0;6;491;2;5;2007;520;520;2;1;0;6;6;2399;1;3205;5;2;
/org.eclipse.jdt.ui.tests.refactoring/resources/ExtractMethodWorkSpace/ExtractMethodTests/expression_in/A.java;1;1;3;1;2;2;2;1;24;0;1;1236;24;24;1;0;0;1;3;1236;0;4419;3;1;
/org.eclipse.search/search/org/eclipse/search/internal/workingsets/WorkingSetDialog.java;1;0;13;1;0;0;0;13;115;1;13;1494;394;394;1;0;0;13;13;1494;0;3849;13;1;
/org.eclipse.ui/Eclipse UI Text Editor/org/eclipse/ui/texteditor/ITextEditorActionDefinitionIds.java;1;1;8;1;5;5;5;3;252;1;3;3250;434;434;1;0;0;3;8;3250;0;4853;8;1;
/org.eclipse.team.core/src/org/eclipse/team/internal/core/streams/ProgressMonitorInputStream.java;1;0;1;1;1;1;1;0;0;0;0;4169;0;0;1;0;0;0;1;4169;0;4169;1;1;
/org.eclipse.core.tests.runtime/src/org/eclipse/core/tests/plugintests/LibraryLookupTests.java;1;0;7;1;1;1;1;6;98;3;3;3605;255;255;3;3;0;6;7;3605;3;4191;4;1;
/org.eclipse.jdt.ui/ui refactoring/org/eclipse/jdt/internal/ui/refactoring/RefactoringStatusContentProvider.java;2;0;2;1;0;0;0;2;2;1;2;1406;2;2;1;0;0;2;2;1406;0;1939;2;2;
/org.eclipse.swt/Eclipse SWT/gtk1x/org/eclipse/swt/widgets/Scale.java;4;0;4;1;1;1;1;3;9;1;3;2107;17;17;1;0;0;3;4;2107;0;4701;4;4;
/org.eclipse.swt/Eclipse SWT/win32/org/eclipse/swt/widgets/TabItem.java;7;2;11;1;3;2;3;8;70;1;8;106;165;165;2;0;1;8;11;4557;1;4701;10;7;
/org.eclipse.jdt.ui/ui/org/eclipse/jdt/ui/IWorkingCopyProvider.java;2;1;4;1;4;4;4;0;24;0;0;4212;28;28;1;0;0;0;4;4212;0;4852;4;2;
/org.eclipse.ui/Eclipse JFace/org/eclipse/jface/dialogs/DialogSettings.java;4;0;6;1;0;0;0;6;34;1;6;257;63;63;1;0;0;6;6;257;0;3607;6;4;
/org.eclipse.jdt.ui.tests.refactoring/resources/PullUpMethods/testFail5/in/A.java;1;0;2;1;0;0;0;2;0;1;2;2156;0;0;1;0;0;2;2;2156;0;2406;2;1;
/org.eclipse.ui/Eclipse UI/org/eclipse/ui/actions/TextActionHandler.java;2;0;2;1;1;1;1;1;30;0;1;3105;30;30;1;0;0;1;2;3105;0;4608;2;2;
/org.eclipse.jdt.ui.tests.refactoring/resources/ExtractMethodWorkSpace/ExtractMethodTests/return_in/A_test721.java;1;1;3;1;2;2;2;1;30;0;1;1851;30;30;1;0;0;1;3;1851;0;4419;3;1;
/org.eclipse.pde.ui/src/org/eclipse/pde/ui/templates/AbstractNewPluginTemplateWizard.java;1;1;4;1;2;2;2;2;146;1;2;3840;194;194;1;0;0;2;4;3840;0;4752;4;1;
/org.eclipse.jdt.debug/eval/org/eclipse/jdt/internal/debug/eval/ast/engine/InstanceOfOperator.java;1;0;2;1;0;0;0;2;0;1;2;3329;0;0;1;0;0;2;2;3329;0;3421;2;1;
/org.eclipse.debug.ui/ui/org/eclipse/debug/internal/ui/DebugActionGroupsActionContentProvider.java;3;0;6;1;1;1;1;5;14;1;5;3257;28;28;1;0;0;5;6;3257;0;3975;6;3;
/org.eclipse.update.ui/src/org/eclipse/update/internal/ui/pages/SitePage.java;1;0;2;1;0;0;0;2;3;1;2;3537;3;3;1;0;0;2;2;3537;0;3662;2;1;
/org.eclipse.pde.ui/src/org/eclipse/pde/internal/ui/feature/BuildPluginAction.java;1;1;6;1;4;4;4;2;49;1;2;3579;105;105;1;0;0;2;6;3579;0;4825;6;1;
/org.eclipse.swt/Eclipse SWT Custom Widgets/common_j2se/org/eclipse/swt/custom/CTabFolderEvent.java;1;0;1;1;0;0;0;1;0;0;1;1378;0;0;1;0;0;1;1;1378;0;1378;1;1;
/org.eclipse.jdt.ui.tests.refactoring/resources/RenameVariables/cannotRename/A_testFail7.java;1;0;2;1;0;0;0;2;0;1;2;724;0;0;1;0;0;2;2;724;0;1665;2;1;
/org.eclipse.ui.examples.propertysheet/Eclipse UI Examples PropertySheet/org/eclipse/ui/examples/propertysheet/PropertySheetPlugin.java;1;0;1;1;0;0;0;1;0;0;1;931;0;0;1;0;0;1;1;931;0;931;1;1;
/org.eclipse.jdt.debug/model/org/eclipse/jdt/internal/debug/core/model/JDIClassObjectValue.java;2;0;2;2;0;0;0;2;5;0;1;2517;5;5;2;1;0;2;2;2517;1;2517;1;2;
/org.eclipse.jdt.ui/core extension/org/eclipse/jdt/internal/corext/textmanipulation/TextBufferFactory.java;1;0;4;1;1;1;1;3;14;1;3;2137;18;18;1;0;0;3;4;2137;0;4602;4;1;
/org.eclipse.scripting/src/org/eclipse/scripting/ScriptAdapterWorkbenchResourceImportWizard.java;1;0;1;1;0;0;0;1;0;0;1;1424;0;0;1;0;0;1;1;1424;0;1424;1;1;
/org.eclipse.debug.ui/ui/org/eclipse/debug/internal/ui/actions/ChangeVariableValueAction.java;1;1;7;1;2;2;2;5;10;1;5;2382;34;34;1;0;0;5;7;2382;0;4409;7;1;
/org.eclipse.jdt.ui/ui/org/eclipse/jdt/internal/ui/text/java/JavaCompletionProcessor.java;5;2;39;2;6;5;6;33;235;2;27;15;932;932;2;6;1;33;39;1605;7;4632;32;5;
/org.eclipse.ui/Eclipse UI/org/eclipse/ui/IDecoratorManager.java;2;4;7;2;7;4;7;0;65;0;0;3955;90;90;4;0;3;0;7;3955;3;4188;4;2;
/org.eclipse.jdt.ui/ui/org/eclipse/jdt/internal/ui/reorg/NewJdtMoveAction.java;1;0;2;1;0;0;0;2;0;1;2;3758;0;0;1;0;0;2;2;3758;0;3807;2;1;
/org.eclipse.pde.ui/src/org/eclipse/pde/internal/PDEPluginEvent.java;1;0;2;1;0;0;0;2;0;1;2;2470;0;0;1;0;0;2;2;2470;0;2650;2;1;
/org.eclipse.compare/compare/org/eclipse/patch/Hunk.java;1;0;3;1;0;0;0;3;26;1;3;1419;26;26;1;0;0;3;3;1419;0;1516;3;1;
/org.eclipse.ui.examples.readmetool/Eclipse UI Examples Readme Tool/org/eclipse/ui/examples/readmetool/ReadmeEditorActionBarContributor.java;3;0;6;1;1;1;1;5;48;1;5;932;118;118;1;0;0;5;6;932;0;4207;6;3;
/org.eclipse.jdt.ui/ui/org/eclipse/jdt/internal/ui/snippeteditor/SnippetFileDocumentProvider.java;2;0;3;1;0;0;0;3;5;1;3;15;5;5;1;0;0;3;3;15;0;1916;3;2;
/org.eclipse.jdt.debug/model/org/eclipse/jdt/internal/debug/core/model/JDIStackFrame.java;3;1;27;2;3;3;3;24;64;3;20;2517;369;369;3;4;0;24;27;2517;4;4455;23;3;
/org.eclipse.pde.core/src/org/eclipse/pde/internal/core/schema/DocumentSection.java;1;0;2;1;0;0;0;2;5;1;2;3591;5;5;1;0;0;2;2;3591;0;3607;2;1;
/org.eclipse.pde.ui/src/org/eclipse/pde/internal/ui/model/ifeature/IFeatureEntry.java;1;0;3;1;0;0;0;3;3;2;2;3579;3;3;2;1;0;3;3;3579;1;3591;2;1;
/org.eclipse.scripting/Eclipse Scripting/org/eclipse/scripting/internal/views/ScriptUIPreviewEditorPreviewPanel.java;2;0;4;1;0;0;0;4;38;1;4;133;62;62;1;0;0;4;4;133;0;1424;4;2;
/org.eclipse.jdt.ui/ui refactoring/org/eclipse/jdt/internal/ui/refactoring/actions/structureselection/StructureSelectionAnalyzer.java;2;0;5;1;0;0;0;5;49;1;5;2273;87;87;1;0;0;5;5;2273;0;3188;5;2;
/org.eclipse.pde.ui/src/org/eclipse/pde/internal/preferences/ExternalPluginsBlock.java;2;0;19;1;0;0;0;19;507;2;18;1434;782;782;2;1;0;19;19;3035;1;3579;18;2;
/org.eclipse.team.cvs.core/src/org/eclipse/team/internal/ccvs/core/client/ModTimeHandler.java;2;0;5;1;0;0;0;5;45;1;5;2572;59;59;1;0;0;5;5;2572;0;3398;5;2;
/org.eclipse.vcm.ui.cvs/src/org/eclipse/vcm/internal/ui/ccvs/GenerateDiffFileAction.java;1;0;3;1;0;0;0;3;17;2;2;1549;17;17;2;1;0;3;3;1556;1;1556;2;1;
/org.eclipse.jdt.ui.tests.refactoring/resources/ExtractMethodWorkSpace/ExtractMethodTests/validSelection/A_test287.java;2;1;3;1;2;2;2;1;8;0;1;195;8;8;1;0;0;1;3;195;0;4419;3;2;
/org.eclipse.ui/Eclipse UI/org/eclipse/ui/IPerspectiveDescriptor.java;2;0;2;1;0;0;0;2;5;1;2;257;5;5;1;0;0;2;2;257;0;457;2;2;
/org.eclipse.ui/Eclipse UI Standard Components/org/eclipse/ui/views/framelist/TreeFrame.java;1;0;1;1;0;0;0;1;0;0;1;3498;0;0;1;0;0;1;1;3498;0;3498;1;1;
/org.eclipse.ui.externaltools/External Tools/org/eclipse/ui/externaltools/internal/ui/BuildCanceledException.java;1;1;2;1;2;2;2;0;0;0;0;4090;0;0;1;0;0;0;2;4090;0;4384;2;1;
/org.eclipse.jdt.debug/eval/org/eclipse/jdt/internal/debug/eval/ast/engine/PostfixPlusPlusOperator.java;1;0;3;1;0;0;0;3;2;1;3;3329;2;2;1;0;0;3;3;3329;0;3421;3;1;
/org.eclipse.webdav/src/kernel/org/eclipse/webdav/internal/kernel/DAV4JException.java;2;0;3;1;0;0;0;3;5;1;3;12;5;5;1;0;0;3;3;12;0;1874;3;2;
/org.eclipse.jdt.core/dom/org/eclipse/jdt/core/dom/WhileStatement.java;2;1;6;1;2;2;2;4;18;1;4;2669;52;52;1;0;0;4;6;2669;0;4453;6;2;
/org.eclipse.jdt.ui.tests.refactoring/resources/SafeDeleteType/testFail10/in/A.java;1;0;1;1;0;0;0;1;0;0;1;49;0;0;1;0;0;1;1;49;0;49;1;1;
/org.eclipse.swt.examples/src/org/eclipse/swt/examples/layoutexample/RowLayoutTab.java;3;1;6;1;3;3;3;3;141;1;3;3420;164;164;1;0;0;3;6;3420;0;4705;6;3;
/org.eclipse.vcm.ui/src/org/eclipse/vcm/internal/ui/GenericVCMEvent.java;1;0;2;1;0;0;0;2;51;1;2;1057;51;51;1;0;0;2;2;1057;0;1240;2;1;
/org.eclipse.jdt.ui.tests.refactoring/resources/RenameVirtualMethodInClass/test17/out/A.java;1;0;1;1;0;0;0;1;0;0;1;49;0;0;1;0;0;1;1;49;0;49;1;1;
/org.eclipse.jdt.ui/ui/org/eclipse/jdt/internal/ui/actions/OpenExternalJavadocAction.java;3;0;13;1;1;1;1;12;98;2;10;2636;324;324;2;2;0;12;13;2636;2;3967;11;3;
/org.eclipse.team.tests.cvs.core/src/org/eclipse/team/tests/ccvs/core/cvsresources/AllTestsCVSResource.java;1;0;2;1;0;0;0;2;0;1;2;3250;0;0;1;0;0;2;2;3250;0;3287;2;1;
/org.eclipse.swt/Eclipse SWT PI/motif/org/eclipse/swt/internal/motif/XGCValues.java;2;0;2;1;1;1;1;1;6;0;1;2069;6;6;1;0;0;1;2;2069;0;4701;2;2;
/org.eclipse.ui/Eclipse UI/org/eclipse/ui/IPersistableAction.java;1;0;1;1;0;0;0;1;0;0;1;833;0;0;1;0;0;1;1;833;0;833;1;1;
/org.eclipse.swt.examples.paint/org/eclipse/swt/examples/paint/LineTool.java;4;0;5;2;1;1;1;4;62;2;3;513;64;64;2;1;0;4;5;609;1;4024;4;4;
/org.eclipse.jdt.ui.tests.refactoring/resources/MoveMembers/testFail6/in/A.java;1;0;1;1;0;0;0;1;0;0;1;2738;0;0;1;0;0;1;1;2738;0;2738;1;1;
/org.eclipse.core.tests.resources/src/org/eclipse/core/tests/internal/watson/TreeFlatteningTest.java;3;0;4;1;1;1;1;3;186;1;3;1794;214;214;1;0;0;3;4;1794;0;4516;4;3;
/org.eclipse.swt.examples.launcher/org/eclipse/swt/examples/launcher/ApplicationRunner.java;4;0;5;1;0;0;0;5;183;1;5;513;202;202;1;0;0;5;5;513;0;3690;5;4;
/org.eclipse.jdt.ui.tests/test plugin/org/eclipse/jdt/testplugin/JavaProjectHelper.java;2;0;9;1;1;1;1;8;27;2;7;1189;104;104;2;1;0;8;9;2180;1;4213;8;2;
/org.eclipse.jdt.ui/ui/org/eclipse/jdt/ui/text/IJavaColorConstants.java;3;0;7;1;2;1;2;5;22;1;5;15;72;72;2;0;1;5;7;4810;1;4810;6;3;
/org.eclipse.jdt.junit/src/org/eclipse/jdt/internal/junit/ui/IJUnitHelpContextIds.java;1;0;1;1;1;1;1;0;0;0;0;4634;0;0;1;0;0;0;1;4634;0;4634;1;1;
/org.eclipse.jdt.ui/core refactoring/org/eclipse/jdt/internal/core/refactoring/code/ReturnAnalyzer.java;1;0;3;1;0;0;0;3;17;1;3;887;17;17;1;0;0;3;3;887;0;1851;3;1;
/org.eclipse.scripting/Eclipse Scripting/org/eclipse/scripting/internal/uirenderer/ScriptDefaultContributionNode.java;2;0;4;1;0;0;0;4;11;1;4;133;13;13;1;0;0;4;4;133;0;1424;4;2;
/org.eclipse.ui/Eclipse UI/org/eclipse/ui/internal/dialogs/PropertyDialog.java;3;0;4;1;0;0;0;4;13;1;4;257;28;28;1;0;0;4;4;257;0;2771;4;3;
/org.eclipse.jdt.core/model/org/eclipse/jdt/internal/core/CreateTypeOperation.java;2;2;12;1;3;2;3;9;136;4;6;455;190;190;4;3;1;9;12;1039;4;4063;8;2;
/org.eclipse.swt/Eclipse SWT PI/gtk1x/org/eclipse/swt/internal/gtk/GtkBox.java;2;0;2;1;1;1;1;1;3;0;1;2107;3;3;1;0;0;1;2;2107;0;4701;2;2;
/org.eclipse.jdt.ui.tests.refactoring/resources/SafeDeleteType/testFail7/in/A.java;1;0;1;1;0;0;0;1;0;0;1;49;0;0;1;0;0;1;1;49;0;49;1;1;
/org.eclipse.jdt.debug/jdi interfaces/com/sun/jdi/VoidValue.java;2;0;2;1;0;0;0;2;6;1;2;2704;6;6;1;0;0;2;2;2704;0;3033;2;2;
/org.eclipse.pde.ui/src/org/eclipse/pde/internal/builders/PluginErrorReporter.java;2;0;4;1;0;0;0;4;12;1;4;1434;15;15;1;0;0;4;4;1434;0;3579;4;2;
/org.eclipse.jdt.debug/eval/org/eclipse/jdt/internal/debug/eval/ast/engine/XorAssignmentOperator.java;1;0;2;1;0;0;0;2;0;1;2;3329;0;0;1;0;0;2;2;3329;0;3421;2;1;
/org.eclipse.pde.ui/src/org/eclipse/pde/internal/editor/feature/FeaturePropertySource.java;1;0;2;1;0;0;0;2;0;1;2;2951;0;0;1;0;0;2;2;2951;0;3579;2;1;
/org.eclipse.jdt.debug/jdi interfaces/com/sun/jdi/BooleanValue.java;2;0;2;1;0;0;0;2;6;1;2;2704;6;6;1;0;0;2;2;2704;0;3033;2;2;
/org.eclipse.ant.ui/src/org/eclipse/ant/ui/internal/toolscripts/AntBuilderPropertyPage.java;1;0;3;1;0;0;0;3;4;2;2;2919;4;4;2;1;0;3;3;2919;1;2933;2;1;
/org.eclipse.swt/Eclipse SWT PI/gtk1x/org/eclipse/swt/internal/gtk/GtkCList.java;2;0;2;1;1;1;1;1;3;0;1;2107;3;3;1;0;0;1;2;2107;0;4701;2;2;
/org.eclipse.tomcat/src/org/eclipse/tomcat/internal/LocalConnectionTest.java;1;0;1;1;0;0;0;1;0;0;1;3297;0;0;1;0;0;1;1;3297;0;3297;1;1;
/org.eclipse.core.target/src/org/eclipse/core/internal/target/webdav/PushPullTargetVisitor.java;2;0;5;1;0;0;0;5;12;1;5;12;20;20;1;0;0;5;5;12;0;744;5;2;
/org.eclipse.jdt.ui.tests.refactoring/resources/ExtractMethodWorkSpace/ExtractMethodTests/locals_in/A_test525.java;1;1;3;1;2;2;2;1;58;0;1;2684;58;58;1;0;0;1;3;2684;0;4419;3;1;
/org.eclipse.core.tests.resources/src/org/eclipse/core/tests/internal/watson/TestUtil.java;3;0;4;1;1;1;1;3;802;1;3;1794;829;829;1;0;0;3;4;1794;0;4516;4;3;
/org.eclipse.jdt.ui.tests.refactoring/resources/ExtractTemp/canExtract/A_test12_out.java;1;0;1;1;0;0;0;1;0;0;1;2481;0;0;1;0;0;1;1;2481;0;2481;1;1;
/org.eclipse.team.cvs.ui/src/org/eclipse/team/internal/ccvs/ui/WorkbenchUserAuthenticator.java;3;0;9;1;1;1;1;8;327;1;8;1978;563;563;1;0;0;8;9;1978;0;4122;9;3;
/org.eclipse.help.ui/src/org/eclipse/help/ui/internal/IHelpUIConstants.java;1;0;1;1;1;1;1;0;0;0;0;4439;0;0;1;0;0;0;1;4439;0;4439;1;1;
/org.eclipse.vcm.core.cvs/src/org/eclipse/vcm/internal/core/ccvs/utils/PathUtil.java;2;0;2;1;0;0;0;2;5;1;2;0;5;5;1;0;0;2;2;0;0;298;2;2;
/org.eclipse.core.tests.runtime/src/org/eclipse/core/tests/internal/plugin/b/PluginClass.java;3;0;3;1;0;0;0;3;34;1;3;1794;44;44;1;0;0;3;3;1794;0;3476;3;3;
/org.eclipse.jdt.debug/jdi/org/eclipse/jdi/internal/connect/TransportImpl.java;2;0;3;1;0;0;0;3;12;1;3;187;22;22;1;0;0;3;3;187;0;3040;3;2;
/org.eclipse.jdt.debug.tests/test programs/EvaluationTests.java;1;0;2;1;0;0;0;2;0;1;2;3701;0;0;1;0;0;2;2;3701;0;3719;2;1;
/org.eclipse.update.core/src/org/eclipse/update/configuration/IInstallConfiguration.java;2;1;7;1;2;2;2;5;133;2;4;3018;246;246;2;1;0;5;7;3664;1;4687;6;2;
/org.eclipse.scripting/src/org/eclipse/scripting/internal/views/ScriptDevelopmentWizardPageScriptName.java;1;0;1;1;0;0;0;1;0;0;1;1424;0;0;1;0;0;1;1;1424;0;1424;1;1;
/org.eclipse.core.runtime/src/org/eclipse/core/runtime/ISafeRunnable.java;3;0;4;1;1;1;1;3;84;1;3;12;104;104;1;0;0;3;4;12;0;4214;4;3;
/org.eclipse.ui/Eclipse UI/org/eclipse/ui/PlatformUI.java;2;0;2;1;0;0;0;2;7;1;2;257;7;7;1;0;0;2;2;257;0;457;2;2;
/org.eclipse.jdt.ui/core refactoring/org/eclipse/jdt/internal/core/refactoring/code/ImportAnalyzer.java;1;0;2;1;0;0;0;2;0;1;2;1927;0;0;1;0;0;2;2;1927;0;1939;2;1;
/org.eclipse.ui.tests/Eclipse JFace Tests/org/eclipse/jface/tests/viewers/interactive/WorldChangedAction.java;1;0;1;1;0;0;0;1;0;0;1;1488;0;0;1;0;0;1;1;1488;0;1488;1;1;
/org.eclipse.swt.examples/Eclipse SWT Examples/common/org/eclipse/swt/examples/addressbook/AddressBook.java;1;0;2;1;0;0;0;2;0;1;2;107;0;0;1;0;0;2;2;107;0;611;2;1;
/org.eclipse.vcm.ui/src/org/eclipse/vcm/internal/ui/actions/NewTeamStreamAction.java;3;0;4;1;0;0;0;4;14;1;4;112;22;22;1;0;0;4;4;112;0;1156;4;3;
/org.eclipse.jdt.ui.tests.refactoring/resources/ExtractTemp/canExtract/A_test28_in.java;1;0;1;1;0;0;0;1;0;0;1;3121;0;0;1;0;0;1;1;3121;0;3121;1;1;
/org.eclipse.swt/Eclipse SWT PI/win32/org/eclipse/swt/internal/win32/TCHAR.java;2;0;2;1;1;1;1;1;6;0;1;2069;6;6;1;0;0;1;2;2069;0;4701;2;2;
/org.eclipse.ui/Eclipse UI/org/eclipse/ui/internal/EditActionSetsAction.java;4;0;4;1;0;0;0;4;10;1;4;257;18;18;1;0;0;4;4;257;0;3029;4;4;
/org.eclipse.update.tests.core/src/org/eclipse/update/tests/parser/TestCategories.java;1;0;10;1;0;0;0;10;92;2;7;1655;120;120;2;3;0;10;10;1655;3;3570;7;1;
/org.eclipse.jdt.ui/core refactoring/org/eclipse/jdt/internal/corext/refactoring/base/ChangeContext.java;2;1;4;1;2;2;2;2;3;1;2;1939;8;8;1;0;0;2;4;1939;0;4427;4;2;
/org.eclipse.pde.ui/src/org/eclipse/pde/internal/model/ExternalFragmentModel.java;2;0;3;1;0;0;0;3;2;1;3;1434;2;2;1;0;0;3;3;1434;0;3136;3;2;
/org.eclipse.jdt.ui.tests.refactoring/resources/ExtractMethodWorkSpace/ExtractMethodTests/semicolon_in/A_testx.java;2;0;2;1;0;0;0;2;0;1;2;49;0;0;1;0;0;2;2;49;0;2155;2;2;
/org.eclipse.jdt.core/model/org/eclipse/jdt/internal/core/builder/AdditionalTypeCollection.java;2;0;2;1;1;1;1;1;15;0;1;2979;15;15;1;0;0;1;2;2979;0;4063;2;2;
/org.eclipse.vcm.core/src/org/eclipse/vcm/internal/core/base/IServerEvent.java;1;0;1;1;0;0;0;1;0;0;1;951;0;0;1;0;0;1;1;951;0;951;1;1;
/org.eclipse.team.tests.core/src/org/eclipse/team/tests/core/StreamTests.java;1;0;1;1;1;1;1;0;0;0;0;4169;0;0;1;0;0;0;1;4169;0;4169;1;1;
/org.eclipse.help.tests/src/org/eclipse/help/tests/base/AllHelpBaseTests.java;1;0;4;1;0;0;0;4;4;1;4;1805;6;6;1;0;0;4;4;1805;0;1882;4;1;
/org.eclipse.jdt.ui.tests.refactoring/resources/SelectionAnalyzerWorkSpace/SelectionAnalyzerTests/invalidSelection/A_test094.java;2;0;2;1;0;0;0;2;0;1;2;1368;0;0;1;0;0;2;2;1368;0;2139;2;2;
/org.eclipse.webdav/src/kernel/org/eclipse/webdav/internal/kernel/utils/AssertionFailedException.java;1;0;4;1;1;1;1;3;52;1;3;12;72;72;1;0;0;3;4;12;0;4211;4;1;
/org.eclipse.debug.ui/ui/org/eclipse/debug/internal/ui/actions/AbstractRemoveAllAction.java;1;0;2;1;0;0;0;2;0;1;2;2382;0;0;1;0;0;2;2;2382;0;2919;2;1;
/org.eclipse.vcm.ui.cvs/src/org/eclipse/vcm/internal/ui/ccvs/SelfHostDiffAction.java;4;0;4;2;0;0;0;4;19;2;3;1;19;19;2;1;0;4;4;296;1;1549;3;4;
/org.eclipse.jdt.ui/ui/org/eclipse/jdt/internal/ui/viewsupport/IOverlayDescriptorFactory.java;2;0;3;1;0;0;0;3;8;1;3;15;8;8;1;0;0;3;3;15;0;1310;3;2;
/org.eclipse.pde.ui/src/org/eclipse/pde/model/plugin/IMatchRules.java;1;0;2;1;0;0;0;2;0;1;2;3039;0;0;1;0;0;2;2;3039;0;3579;2;1;
/org.eclipse.swt/Eclipse SWT PI/photon/org/eclipse/swt/internal/photon/PtContainerCallback_t.java;2;0;2;1;1;1;1;1;6;0;1;2069;6;6;1;0;0;1;2;2069;0;4701;2;2;
/org.eclipse.team.cvs.core/src/org/eclipse/team/internal/ccvs/core/response/IResponseHandler.java;3;0;3;1;0;0;0;3;4;1;3;1978;4;4;1;0;0;3;3;1978;0;2607;3;3;
/org.eclipse.pde.ui/src/org/eclipse/pde/internal/editor/PDEEditorContributor.java;2;0;9;1;0;0;0;9;295;2;8;1434;356;356;2;1;0;9;9;3136;1;3579;8;2;
/org.eclipse.swt/Eclipse SWT/win32/org/eclipse/swt/widgets/TreeItem.java;7;2;11;2;3;2;3;8;139;2;7;106;403;403;2;1;1;8;11;3152;2;4701;9;7;
/org.eclipse.team.cvs.core/src/org/eclipse/team/internal/ccvs/core/Policy.java;3;1;12;1;2;2;2;10;194;1;10;1978;430;430;1;0;0;10;12;1978;0;4406;12;3;
/org.eclipse.jdt.core/model/org/eclipse/jdt/internal/core/builder/IConstructor.java;1;0;4;1;0;0;0;4;26;1;4;455;27;27;1;0;0;4;4;455;0;2808;4;1;
/org.eclipse.jdt.ui.tests.refactoring/resources/RenameTemp/canRename/A_test30_in.java;1;0;2;1;0;0;0;2;2;1;2;1625;2;2;1;0;0;2;2;1625;0;1652;2;1;
/org.eclipse.jdt.debug/jdi/org/eclipse/jdi/internal/LongTypeImpl.java;2;0;4;1;0;0;0;4;13;1;4;187;27;27;1;0;0;4;4;187;0;3670;4;2;
/org.eclipse.jdt.debug.ui/ui/org/eclipse/jdt/internal/debug/ui/snippeteditor/ISnippetStateChangedListener.java;1;0;1;1;0;0;0;1;0;0;1;1915;0;0;1;0;0;1;1;1915;0;1915;1;1;
/org.eclipse.ui.tests/Eclipse UI Tests/org/eclipse/ui/tests/api/CallHistory.java;2;0;3;1;0;0;0;3;39;1;3;1007;39;39;1;0;0;3;3;1007;0;1073;3;2;
/org.eclipse.jdt.ui.tests.refactoring/resources/ExtractMethodWorkSpace/ExtractMethodTests/locals_out/A_test510.java;2;1;4;1;2;2;2;2;15;1;2;216;19;19;1;0;0;2;4;216;0;4419;4;2;
/org.eclipse.pde.ui/src/org/eclipse/pde/internal/editor/PDEMultiPageContentOutline.java;2;0;3;1;0;0;0;3;2;1;3;1434;2;2;1;0;0;3;3;1434;0;3579;3;2;
/org.eclipse.swt/Eclipse SWT/win32/org/eclipse/swt/internal/win32/DIBSECTION.java;2;0;3;1;0;0;0;3;5;1;3;106;5;5;1;0;0;3;3;106;0;2069;3;2;
/org.eclipse.ui.tests/Eclipse JFace Tests/org/eclipse/jface/tests/viewers/CheckboxTableViewerTest.java;1;0;1;1;0;0;0;1;0;0;1;1488;0;0;1;0;0;1;1;1488;0;1488;1;1;
/org.eclipse.swt/Eclipse SWT Drag and Drop/emulated/org/eclipse/swt/dnd/TransferData.java;2;1;4;1;3;3;3;1;27;0;1;3126;36;36;1;0;0;1;4;3126;0;4701;4;2;
/org.eclipse.debug.ui/ui/org/eclipse/debug/internal/ui/views/console/ConsoleOutputTextStore.java;1;1;2;1;2;2;2;0;124;0;0;3975;124;124;1;0;0;0;2;3975;0;4003;2;1;
/org.eclipse.core.runtime/src/org/eclipse/core/internal/runtime/PlatformURLPluginConnection.java;4;0;7;1;1;1;1;6;164;1;6;23;298;298;1;0;0;6;7;23;0;4213;7;4;
/org.eclipse.jdt.ui/ui/org/eclipse/jdt/ui/jarpackager/IJarExportRunnable.java;2;1;5;1;3;3;3;2;36;1;2;3529;47;47;1;0;0;2;5;3529;0;4852;5;2;
/org.eclipse.pde.ui/src/org/eclipse/pde/internal/editor/jars/JarsForm.java;2;0;3;1;0;0;0;3;10;1;3;1434;10;10;1;0;0;3;3;1434;0;2650;3;2;
/org.eclipse.scripting/Eclipse Scripting/org/eclipse/scripting/internal/uirenderer/XGRXmlParser.java;2;0;4;1;0;0;0;4;47;1;4;133;63;63;1;0;0;4;4;133;0;1424;4;2;
/org.eclipse.jdt.core/compiler/org/eclipse/jdt/internal/compiler/flow/LabelFlowContext.java;2;0;11;1;1;1;1;10;57;4;7;455;154;154;4;3;0;10;11;1039;3;4062;8;2;
/org.eclipse.jdt.ui/ui/org/eclipse/jdt/internal/ui/wizards/TypePage.java;5;0;59;2;0;0;0;59;734;4;46;15;2253;2253;4;13;0;59;59;390;13;3084;46;5;
/org.eclipse.jdt.ui.tests.refactoring/resources/RenameTemp/cannotRename/A_testFail9.java;1;0;2;1;0;0;0;2;2;1;2;1625;2;2;1;0;0;2;2;1625;0;1652;2;1;
/org.eclipse.team.core/src/org/eclipse/team/internal/core/FileModificationValidatorManager.java;1;0;2;1;1;1;1;1;1;0;1;3762;1;1;1;0;0;1;2;3762;0;4123;2;1;
/org.eclipse.jdt.debug.tests/tests/org/eclipse/jdt/debug/tests/eval/TypeHierarchy_21_5.java;2;1;3;1;3;3;3;0;13;0;0;4447;15;15;1;0;0;0;3;4447;0;4571;3;2;
/org.eclipse.jdt.ui.tests.refactoring/resources/MoveMembers/testFail24/in/A.java;1;0;1;1;0;0;0;1;0;0;1;2928;0;0;1;0;0;1;1;2928;0;2928;1;1;
/org.eclipse.jdt.ui/ui/org/eclipse/jdt/internal/ui/dnd/TransferDragSourceListener.java;1;0;2;1;0;0;0;2;7;1;2;15;7;7;1;0;0;2;2;15;0;327;2;1;
/org.eclipse.ui/Eclipse UI/org/eclipse/ui/internal/AboutPluginsAction.java;1;0;1;1;0;0;0;1;0;0;1;1039;0;0;1;0;0;1;1;1039;0;1039;1;1;
/org.eclipse.jdt.ui.tests.refactoring/resources/ExtractMethodWorkSpace/ExtractMethodTests/nested_in/A_test650.java;2;1;3;1;2;2;2;1;10;0;1;354;10;10;1;0;0;1;3;354;0;4419;3;2;
/org.eclipse.jdt.ui/core refactoring/org/eclipse/jdt/internal/corext/refactoring/RefactoringSearchEngine.java;3;0;4;1;1;1;1;3;97;1;3;1939;145;145;1;0;0;3;4;1939;0;4137;4;3;
/org.eclipse.jdt.ui.tests.refactoring/resources/SelectionAnalyzerWorkSpace/SelectionAnalyzerTests/invalidSelection/A_test022.java;1;0;1;1;0;0;0;1;0;0;1;1368;0;0;1;0;0;1;1;1368;0;1368;1;1;
/org.eclipse.pde.ui/src/org/eclipse/pde/internal/model/IModelUndoManager.java;1;0;2;1;0;0;0;2;0;1;2;3140;0;0;1;0;0;2;2;3140;0;3579;2;1;
/org.eclipse.jdt.ui.tests.refactoring/resources/ReorderParameters/cannotReorder/A_testFail0.java;1;0;3;1;0;0;0;3;6;1;3;729;6;6;1;0;0;3;3;729;0;2270;3;1;
/org.eclipse.core.resources/src/org/eclipse/core/internal/resources/MarkerSnapshotReader.java;2;0;5;1;1;1;1;4;74;1;4;158;103;103;1;0;0;4;5;158;0;4213;5;2;
/org.eclipse.jdt.debug/model/org/eclipse/jdt/debug/core/IJavaStackFrame.java;4;0;15;1;1;1;1;14;154;1;14;187;416;416;1;0;0;14;15;187;0;4423;15;4;
/org.eclipse.update.core/src/org/eclipse/update/internal/core/SiteURLFactory.java;2;1;17;1;3;3;3;14;64;2;11;2251;237;237;2;3;0;14;17;2661;3;4453;14;2;
/org.eclipse.pde.ui/src/org/eclipse/pde/internal/ui/launcher/WorkbenchLauncherWizardAdvancedPage.java;1;0;4;1;0;0;0;4;10;1;4;3579;19;19;1;0;0;4;4;3579;0;3634;4;1;
/org.eclipse.pde.ui/src/org/eclipse/pde/internal/ui/preferences/SourceLocationDialog.java;1;1;2;1;2;2;2;0;17;0;0;4409;17;17;1;0;0;0;2;4409;0;4637;2;1;
/org.eclipse.jdt.ui.tests.refactoring/resources/ExtractMethodWorkSpace/ExtractMethodTests/return_in/A_test709.java;1;1;3;1;2;2;2;1;20;0;1;887;20;20;1;0;0;1;3;887;0;4419;3;1;
/org.eclipse.core.resources/src/org/eclipse/core/resources/WorkspaceLock.java;3;0;8;1;1;1;1;7;166;1;7;12;258;258;1;0;0;7;8;12;0;4214;8;3;
/org.eclipse.jdt.ui.tests.refactoring/resources/DeleteSourceReferenceEdit/A_test4_in.java;1;0;1;1;0;0;0;1;0;0;1;2857;0;0;1;0;0;1;1;2857;0;2857;1;1;
/org.eclipse.update/Eclipse Update/org/eclipse/update/internal/ui/UMWizardPersistentProperties.java;2;0;5;1;0;0;0;5;263;1;5;108;273;273;1;0;0;5;5;108;0;1424;5;2;
/org.eclipse.ui/Eclipse UI/org/eclipse/ui/IWorkbench.java;8;2;25;2;4;3;4;21;110;2;17;257;557;557;2;4;1;21;25;2247;5;4167;20;8;
/org.eclipse.pde.ui/src/org/eclipse/pde/core/plugin/IPluginAttribute.java;1;0;3;1;0;0;0;3;1;2;2;3579;1;1;2;1;0;3;3;3579;1;3607;2;1;
/org.eclipse.jdt.debug/jdi/org/eclipse/jdi/internal/request/ExceptionRequestImpl.java;3;0;5;1;0;0;0;5;15;1;5;187;35;35;1;0;0;5;5;187;0;3670;5;3;
/org.eclipse.ui/Eclipse UI/org/eclipse/ui/ICapabilityInstallWizard.java;1;0;1;1;0;0;0;1;0;0;1;3506;0;0;1;0;0;1;1;3506;0;3506;1;1;
/org.eclipse.swt.examples/org/eclipse/swt/examples/fileviewer/TreeScrollDropListener.java;2;0;3;2;0;0;0;3;1;2;2;554;1;1;2;1;0;3;3;609;1;609;2;2;
/org.eclipse.pde.ui/Eclipse PDE UI/org/eclipse/pde/internal/schema/SchemaAttribute.java;2;0;7;2;0;0;0;7;44;3;5;267;57;57;3;2;0;7;7;324;2;1434;5;2;
/org.eclipse.jdt.ui.tests.refactoring/resources/ExtractMethodWorkSpace/ExtractMethodTests/invalidSelection/A_test090.java;2;1;3;1;2;2;2;1;0;0;1;49;0;0;1;0;0;1;3;49;0;4419;3;2;
/org.eclipse.jdt.ui/core refactoring/org/eclipse/jdt/internal/core/refactoring/ListenerList.java;2;0;4;1;0;0;0;4;5;1;4;15;9;9;1;0;0;4;4;15;0;1939;4;2;
/org.eclipse.swt/Eclipse SWT Drag and Drop/carbon/org/eclipse/swt/dnd/TreeDragUnderEffect.java;4;1;4;1;4;4;4;0;234;0;0;4147;242;242;1;0;0;0;4;4147;0;4701;4;4;
/org.eclipse.jdt.ui.tests.refactoring/resources/ExtractMethodWorkSpace/ExtractMethodTests/branch_out/A_test750.java;1;1;4;1;2;2;2;2;34;1;2;1851;35;35;1;0;0;2;4;1851;0;4419;4;1;
/org.eclipse.jdt.ui.tests.refactoring/resources/ExtractTemp/canExtract/A_test38_in.java;1;0;1;1;1;1;1;0;0;0;0;4363;0;0;1;0;0;0;1;4363;0;4363;1;1;
/org.eclipse.ui/Eclipse JFace Text/org/eclipse/jface/text/source/SourceViewer.java;5;1;17;1;8;8;8;9;276;1;9;257;471;471;1;0;0;9;17;257;0;4853;17;5;
/org.eclipse.swt/Eclipse SWT Custom Widgets/common_j2se/org/eclipse/swt/custom/CTabFolderListener.java;1;0;1;1;0;0;0;1;0;0;1;1378;0;0;1;0;0;1;1;1378;0;1378;1;1;
/org.eclipse.ui/Eclipse UI/org/eclipse/ui/internal/WWinActionBars.java;3;0;3;1;0;0;0;3;10;1;3;257;12;12;1;0;0;3;3;257;0;3484;3;3;
/org.eclipse.ui/Eclipse UI/org/eclipse/ui/internal/MessageLine.java;1;0;1;1;0;0;0;1;0;0;1;3733;0;0;1;0;0;1;1;3733;0;3733;1;1;
/org.eclipse.search/search/org/eclipse/search/internal/core/text/AmountOfWorkCalculator.java;2;0;3;1;1;1;1;2;13;1;2;15;22;22;1;0;0;2;3;15;0;4034;3;2;
/org.eclipse.team.cvs.ui/src/org/eclipse/team/internal/ccvs/ui/RepositorySorter.java;3;0;7;2;0;0;0;7;21;1;7;1997;61;61;1;0;0;7;7;1997;0;3610;7;3;
/org.eclipse.ui/Eclipse UI/org/eclipse/ui/internal/dialogs/InstallCapabilityStep.java;1;0;10;1;0;0;0;10;17;3;8;3187;79;79;3;2;0;10;10;3187;2;3506;8;1;
/org.eclipse.pde.ui/Eclipse PDE UI/org/eclipse/pde/internal/editor/schema/ICloneablePropertySource.java;2;0;5;2;0;0;0;5;12;3;3;267;12;12;3;2;0;5;5;324;2;1434;3;2;
/org.eclipse.swt/Eclipse SWT/win32/org/eclipse/swt/widgets/MenuItem.java;9;2;26;1;8;6;8;18;93;2;16;106;533;533;2;2;2;18;26;861;4;4701;22;9;
/org.eclipse.jdt.ui.tests.refactoring/resources/RenameType/testFail04/in/A.java;1;0;1;1;0;0;0;1;0;0;1;49;0;0;1;0;0;1;1;49;0;49;1;1;
/org.eclipse.scripting/Eclipse Scripting/org/eclipse/scripting/internal/views/ScriptUIEditorButtonPalette.java;2;0;5;1;0;0;0;5;37;1;5;133;57;57;1;0;0;5;5;133;0;1424;5;2;
/org.eclipse.jdt.ui/ui/org/eclipse/jdt/internal/ui/dnd/LocalSelectionTransfer.java;3;0;7;1;1;1;1;6;15;1;6;15;55;55;1;0;0;6;7;15;0;4602;7;3;
/org.eclipse.jdt.ui.tests.refactoring/resources/ExtractMethodWorkSpace/ExtractMethodTests/locals_in/A_test533.java;1;1;3;1;2;2;2;1;16;0;1;922;16;16;1;0;0;1;3;922;0;4419;3;1;
/org.eclipse.ant.ui/src/org/eclipse/ant/internal/ui/AntAction.java;3;0;6;1;1;1;1;5;170;1;5;677;213;213;1;0;0;5;6;677;0;4126;6;3;
/org.eclipse.swt/Eclipse SWT/carbon/org/eclipse/swt/widgets/Decorations.java;3;1;4;1;4;4;4;0;61;0;0;4147;78;78;1;0;0;0;4;4147;0;4701;4;3;
/org.eclipse.swt.tests/JUnit Tests/org/eclipse/swt/tests/junit/Test_org_eclipse_swt_custom_PopupList.java;2;0;2;1;1;1;1;1;6;0;1;1792;6;6;1;0;0;1;2;1792;0;4706;2;2;
/org.eclipse.team.cvs.core/src/org/eclipse/team/internal/ccvs/core/streams/TimeoutInputStream.java;2;1;4;1;2;2;2;2;273;1;2;3574;507;507;1;0;0;2;4;3574;0;4169;4;2;
/org.eclipse.debug.ui/ui/org/eclipse/debug/internal/ui/DebugPerspective.java;3;0;6;1;0;0;0;6;19;1;6;187;38;38;1;0;0;6;6;187;0;1795;6;3;
/org.eclipse.ui/Eclipse UI/org/eclipse/ui/internal/ObjectActionContributorReader.java;2;0;2;1;0;0;0;2;9;1;2;257;9;9;1;0;0;2;2;257;0;457;2;2;
/org.eclipse.jdt.ui.tests.refactoring/resources/SefWorkSpace/SefTests/object_in/TestSetterInAssignment.java;1;0;1;1;0;0;0;1;0;0;1;2876;0;0;1;0;0;1;1;2876;0;2876;1;1;
/org.eclipse.core.tests.resources/src/org/eclipse/core/tests/internal/indexing/TestPagePolicy.java;3;0;4;1;1;1;1;3;4;1;3;1794;8;8;1;0;0;3;4;1794;0;4516;4;3;
/org.eclipse.pde.ui/src/org/eclipse/pde/internal/ui/wizards/templates/ViewTemplate.java;1;1;7;1;3;3;3;4;62;1;4;3579;167;167;1;0;0;4;7;3579;0;4316;7;1;
/org.eclipse.update.ui/src/org/eclipse/update/internal/ui/preferences/MainPreferencePage.java;2;1;6;1;5;5;5;1;55;0;1;3572;101;101;1;0;0;1;6;3572;0;4610;6;2;
/org.eclipse.pde.ui/src/org/eclipse/pde/internal/ui/editor/TreeSection.java;1;0;1;1;0;0;0;1;0;0;1;3579;0;0;1;0;0;1;1;3579;0;3579;1;1;
/org.eclipse.core.resources/src/org/eclipse/core/internal/dtree/IDataFlattener.java;1;0;4;1;1;1;1;3;68;1;3;12;96;96;1;0;0;3;4;12;0;4214;4;1;
/org.eclipse.team.cvs.ui/src/org/eclipse/team/internal/ccvs/ui/ConsolePreferencesPage.java;3;0;3;1;1;1;1;2;2;1;2;3452;4;4;1;0;0;2;3;3452;0;4829;3;3;
/org.eclipse.ui/Eclipse UI/org/eclipse/ui/actions/AddBookmarkAction.java;5;0;7;1;0;0;0;7;35;1;7;257;96;96;1;0;0;7;7;257;0;3029;7;5;
/org.eclipse.update.core/src/org/eclipse/update/internal/core/ConfiguredSite.java;2;4;57;2;29;18;29;28;710;4;21;2995;3222;3222;4;7;11;28;57;3589;18;4462;39;2;
/org.eclipse.help.webapp/src/org/eclipse/help/internal/proxy/protocol/search/Handler.java;1;0;1;1;0;0;0;1;0;0;1;3454;0;0;1;0;0;1;1;3454;0;3454;1;1;
/org.eclipse.core.tests.resources/src/org/eclipse/core/tests/resources/regression/AllTests.java;3;0;4;1;1;1;1;3;66;1;3;1794;77;77;1;0;0;3;4;1794;0;4516;4;3;
/org.eclipse.help.ui/src/org/eclipse/help/internal/ui/TreeContentProvider.java;2;0;6;1;0;0;0;6;21;1;6;1420;47;47;1;0;0;6;6;1420;0;3030;6;2;
/org.eclipse.jdt.ui.tests.refactoring/resources/PullUpMethods/test3/in/A.java;1;0;2;1;0;0;0;2;0;1;2;2156;0;0;1;0;0;2;2;2156;0;2406;2;1;
/org.eclipse.jdt.core/model/org/eclipse/jdt/internal/core/util/ExceptionTableEntry.java;2;1;4;1;3;3;3;1;18;0;1;3629;50;50;1;0;0;1;4;3629;0;4422;4;2;
/org.eclipse.core.runtime/src/org/eclipse/core/internal/runtime/RuntimeStats.java;3;0;3;1;0;0;0;3;6;1;3;12;6;6;1;0;0;3;3;12;0;1392;3;3;
/org.eclipse.pde.ui/src/org/eclipse/pde/internal/wizards/templates/TemplateField.java;1;0;2;1;0;0;0;2;0;1;2;3415;0;0;1;0;0;2;2;3415;0;3579;2;1;
/org.eclipse.ui/Eclipse UI/org/eclipse/ui/actions/PerspectiveMenu.java;7;0;12;1;0;0;0;12;485;2;11;257;652;652;2;1;0;12;12;1727;1;3724;11;7;
/org.eclipse.swt/Eclipse SWT/win32/org/eclipse/swt/graphics/DeviceData.java;2;0;3;1;1;1;1;2;6;1;2;106;12;12;1;0;0;2;3;106;0;4701;3;2;
/org.eclipse.ui/Eclipse UI Standard Components/org/eclipse/ui/wizards/datatransfer/PopulateElementOperation.java;2;0;2;1;0;0;0;2;6;1;2;257;6;6;1;0;0;2;2;257;0;457;2;2;
/org.eclipse.team.webdav/src/org/eclipse/team/internal/webdav/core/TeamWebDavPlugin.java;2;1;4;1;4;4;4;0;20;0;0;4315;29;29;1;0;0;0;4;4315;0;4639;4;2;
/org.eclipse.swt/Eclipse SWT PI/common_j2me/org/eclipse/swt/internal/Library.java;3;1;32;1;12;12;12;20;6;1;20;2069;66;66;1;0;0;20;32;2069;0;4701;32;3;
/org.eclipse.jdt.ui.tests.refactoring/resources/RenameType/testFail62/in/A.java;1;0;1;1;0;0;0;1;0;0;1;49;0;0;1;0;0;1;1;49;0;49;1;1;
/org.eclipse.ui/Eclipse UI Tool Script/org/eclipse/toolscript/ui/internal/BuildCanceledException.java;1;1;2;1;2;2;2;0;0;0;0;4065;0;0;1;0;0;0;2;4065;0;4087;2;1;
/org.eclipse.jdt.debug.tests/test plugin/org/eclipse/jdt/debug/testplugin/DebugElementKindEventDetailWaiter.java;2;2;3;1;3;2;3;0;12;0;0;4286;12;12;2;0;1;0;3;4296;1;4296;2;2;
/org.eclipse.team.cvs.ui/src/org/eclipse/team/internal/ccvs/ui/actions/CompareWithBaseAction.java;2;0;4;1;1;1;1;3;10;1;3;3591;18;18;1;0;0;3;4;3591;0;3921;4;2;
/org.eclipse.jdt.ui/core refactoring/org/eclipse/jdt/internal/core/refactoring/rename/RenameJavaProjectRefactoring.java;2;0;7;2;0;0;0;7;44;2;6;1342;113;113;2;1;0;7;7;1938;1;1938;6;2;
/org.eclipse.jdt.core/model/org/eclipse/jdt/internal/core/util/LookupTable.java;1;0;10;1;0;0;0;10;288;4;7;455;518;518;4;3;0;10;10;1039;3;2811;7;1;
/org.eclipse.jdt.ui/ui/org/eclipse/jdt/internal/ui/search/ElementSearchAction.java;2;1;19;1;2;2;2;17;224;2;15;15;548;548;2;2;0;17;19;3318;2;4123;17;2;
/org.eclipse.team.cvs.core/src/org/eclipse/team/internal/ccvs/core/resources/ManagedResource.java;3;0;4;1;0;0;0;4;554;1;4;1978;664;664;1;0;0;4;4;1978;0;2156;4;3;
/org.eclipse.scripting/Eclipse Scripting/org/eclipse/scripting/internal/IXGRElementNamed.java;1;0;3;1;0;0;0;3;4;1;3;133;4;4;1;0;0;3;3;133;0;1424;3;1;
/org.eclipse.team.core/src/org/eclipse/team/internal/core/NullSubProgressMonitor.java;1;0;1;1;1;1;1;0;0;0;0;4424;0;0;1;0;0;0;1;4424;0;4424;1;1;
/org.eclipse.jdt.debug/jdi/org/eclipse/jdi/internal/ShortTypeImpl.java;2;0;4;1;0;0;0;4;13;1;4;187;27;27;1;0;0;4;4;187;0;3670;4;2;
/org.eclipse.jdt.ui.tests.refactoring/resources/RenamePackage/testFail11/in/q/A.java;1;0;1;1;0;0;0;1;0;0;1;1258;0;0;1;0;0;1;1;1258;0;1258;1;1;
/org.eclipse.ui.tests/Eclipse UI Tests/org/eclipse/ui/tests/dialogs/UIPreferences.java;3;0;4;1;0;0;0;4;17;1;4;1113;21;21;1;0;0;4;4;1113;0;2785;4;3;
/org.eclipse.update.core/src/org/eclipse/update/core/Import.java;2;0;6;1;1;1;1;5;43;1;5;2462;91;91;1;0;0;5;6;2462;0;4554;6;2;
/org.eclipse.jdt.ui.tests.refactoring/resources/RenameVirtualMethodInClass/testFail12/in/A.java;1;0;1;1;0;0;0;1;0;0;1;49;0;0;1;0;0;1;1;49;0;49;1;1;
/org.eclipse.pde.ui/src/org/eclipse/pde/core/plugin/IPluginExtensionPoint.java;1;0;3;1;0;0;0;3;3;2;2;3579;3;3;2;1;0;3;3;3579;1;3607;2;1;
/org.eclipse.ui/Eclipse UI/org/eclipse/ui/internal/dialogs/NewWizardCollectionSorter.java;4;0;4;1;0;0;0;4;7;1;4;257;16;16;1;0;0;4;4;257;0;1897;4;4;
/org.eclipse.jdt.ui.tests.refactoring/resources/RenamePackage/testFail10/in/r/p1/A.java;1;0;1;1;0;0;0;1;0;0;1;1258;0;0;1;0;0;1;1;1258;0;1258;1;1;
/org.eclipse.debug.core/core/org/eclipse/debug/internal/core/StreamsProxy.java;3;0;7;1;0;0;0;7;38;1;7;187;111;111;1;0;0;7;7;187;0;3793;7;3;
/org.eclipse.ui/Eclipse UI/org/eclipse/ui/internal/dialogs/RemoveCapabilitiesStep.java;1;0;3;1;0;0;0;3;13;1;3;3249;13;13;1;0;0;3;3;3249;0;3506;3;1;
/org.eclipse.ui/Eclipse UI/org/eclipse/ui/IWorkbenchPreferencePage.java;2;0;2;1;0;0;0;2;5;1;2;257;5;5;1;0;0;2;2;257;0;457;2;2;
/org.eclipse.update.core/src/org/eclipse/update/internal/core/Site.java;2;0;17;1;0;0;0;17;362;2;16;1791;847;847;2;1;0;17;17;2329;1;2583;16;2;
/org.eclipse.swt/Eclipse SWT/common/org/eclipse/swt/internal/image/LZWCodec.java;2;0;3;1;1;1;1;2;7;1;2;106;13;13;1;0;0;2;3;106;0;4701;3;2;
/org.eclipse.jdt.ui.tests.refactoring/resources/ExtractMethodWorkSpace/ExtractMethodTests/locals_out/A_test530.java;1;1;4;1;2;2;2;2;28;1;2;922;33;33;1;0;0;2;4;922;0;4419;4;1;
/org.eclipse.jdt.ui/ui/org/eclipse/jdt/ui/actions/FindReadReferencesAction.java;3;1;3;1;3;3;3;0;9;0;0;4141;13;13;1;0;0;0;3;4141;0;4770;3;3;
/org.eclipse.jdt.core/model/org/eclipse/jdt/internal/core/SourceField.java;3;0;11;1;1;1;1;10;103;4;7;455;181;181;4;3;0;10;11;1039;3;4063;8;3;
/org.eclipse.jdt.ui/core refactoring/org/eclipse/jdt/internal/corext/refactoring/code/flow/ForFlowInfo.java;1;0;1;1;0;0;0;1;0;0;1;1939;0;0;1;0;0;1;1;1939;0;1939;1;1;
/org.eclipse.vcm.ui/src/org/eclipse/vcm/internal/ui/actions/AddToWorkspaceAction.java;3;0;3;1;0;0;0;3;25;1;3;1;30;30;1;0;0;3;3;1;0;490;3;3;
/org.eclipse.pde.ui/src/org/eclipse/pde/internal/ui/wizards/WizardNode.java;1;0;1;1;0;0;0;1;0;0;1;3579;0;0;1;0;0;1;1;3579;0;3579;1;1;
/org.eclipse.vcm.core.cvs.ssh/src/org/eclipse/vcm/internal/core/ccvs/ssh/ClientPacket.java;2;0;4;1;0;0;0;4;5;1;4;111;13;13;1;0;0;4;4;111;0;298;4;2;
/org.eclipse.jdt.ui/ui debug/org/eclipse/jdt/internal/debug/ui/JDIAttachLauncherWizard.java;2;0;4;1;0;0;0;4;30;1;4;15;38;38;1;0;0;4;4;15;0;1916;4;2;
/org.eclipse.jdt.ui.tests.refactoring/resources/RenameType/testFail5/in/C.java;1;0;1;1;0;0;0;1;0;0;1;49;0;0;1;0;0;1;1;49;0;49;1;1;
/org.eclipse.jdt.ui.tests.refactoring/resources/RenameMethodInInterface/test18/out/A.java;1;0;1;1;0;0;0;1;0;0;1;49;0;0;1;0;0;1;1;49;0;49;1;1;
/org.eclipse.jdt.ui/core refactoring/org/eclipse/jdt/internal/core/refactoring/util/IParentProvider.java;1;0;2;1;0;0;0;2;0;1;2;1462;0;0;1;0;0;2;2;1462;0;1939;2;1;
/org.eclipse.ui/Eclipse JFace/org/eclipse/jface/viewers/CellEditor.java;2;0;2;1;0;0;0;2;221;1;2;257;221;221;1;0;0;2;2;257;0;457;2;2;
/org.eclipse.pde.ui/src/org/eclipse/pde/internal/editor/text/TagRule.java;2;0;2;1;0;0;0;2;0;1;2;1434;0;0;1;0;0;2;2;1434;0;3579;2;2;
/org.eclipse.vcm.core.cvs.ssh/src/org/eclipse/vcm/internal/core/ccvs/ssh/Cipher.java;2;0;2;1;0;0;0;2;4;1;2;111;4;4;1;0;0;2;2;111;0;298;2;2;
/org.eclipse.ui.examples.propertysheet/Eclipse UI Examples PropertySheet/org/eclipse/ui/examples/propertysheet/PopupMenuActionDelegate.java;1;0;1;1;0;0;0;1;0;0;1;1779;0;0;1;0;0;1;1;1779;0;1779;1;1;
/org.eclipse.pde.ui/src/org/eclipse/pde/internal/base/model/plugin/IPluginReference.java;1;0;2;1;0;0;0;2;0;1;2;2951;0;0;1;0;0;2;2;2951;0;3039;2;1;
/org.eclipse.ui/Eclipse UI Standard Components/org/eclipse/ui/views/properties/IResourcePropertyConstants.java;4;0;4;1;0;0;0;4;20;1;4;257;37;37;1;0;0;4;4;257;0;3607;4;4;
/org.eclipse.core.resources/src/org/eclipse/core/internal/dtree/DataDeltaNode.java;2;0;6;1;1;1;1;5;232;2;4;12;450;450;2;1;0;5;6;1241;1;4214;5;2;
/org.eclipse.jdt.debug.ui/ui/org/eclipse/jdt/internal/debug/ui/launcher/StandardVMCommandTab.java;1;0;1;1;1;1;1;0;0;0;0;4214;0;0;1;0;0;0;1;4214;0;4214;1;1;
/org.eclipse.update.ui.forms/src/org/eclipse/update/ui/forms/internal/IFormPage.java;1;0;1;1;0;0;0;1;0;0;1;2470;0;0;1;0;0;1;1;2470;0;2470;1;1;
/org.eclipse.core.tests.resources/src/org/eclipse/core/tests/resources/usecase/IWorkspaceRunnableUseCaseTest.java;3;0;3;1;0;0;0;3;198;1;3;1794;206;206;1;0;0;3;3;1794;0;3420;3;3;
/org.eclipse.scripting/Eclipse Scripting/org/eclipse/scripting/internal/uirenderer/XGRElementUISwtImage.java;2;0;5;1;0;0;0;5;22;1;5;133;35;35;1;0;0;5;5;133;0;1424;5;2;
/org.eclipse.scripting/Eclipse Scripting/org/eclipse/scripting/internal/IXGRElementUILayoutTableElement.java;1;0;3;1;0;0;0;3;4;1;3;133;4;4;1;0;0;3;3;133;0;1424;3;1;
/org.eclipse.pde.runtime/src/org/eclipse/pde/internal/runtime/registry/ExtensionPropertySource.java;1;0;1;1;0;0;0;1;0;0;1;1434;0;0;1;0;0;1;1;1434;0;1434;1;1;
/org.eclipse.jdt.ui.tests.refactoring/resources/ExtractTemp/cannotExtract/A_testFail3.java;1;0;1;1;0;0;0;1;0;0;1;2481;0;0;1;0;0;1;1;2481;0;2481;1;1;
/org.eclipse.pde.ui/src/org/eclipse/pde/internal/ui/wizards/project/ConvertedProjectsPage.java;1;0;6;1;1;1;1;5;9;3;3;3579;21;21;3;2;0;5;6;3629;2;4435;4;1;
/org.eclipse.jdt.ui.tests.refactoring/resources/RenameParameters/cannotRename/a.java;1;0;1;1;0;0;0;1;0;0;1;233;0;0;1;0;0;1;1;233;0;233;1;1;
/org.eclipse.jdt.ui.tests.refactoring/resources/ReorderParameters/canReorder/A_test14_out.java;1;0;1;1;0;0;0;1;0;0;1;2270;0;0;1;0;0;1;1;2270;0;2270;1;1;
/org.eclipse.swt/Eclipse SWT/win32/org/eclipse/swt/widgets/Scrollable.java;6;2;13;1;4;3;4;9;63;1;9;106;167;167;2;0;1;9;13;4557;1;4701;12;6;
/org.eclipse.webdav/src/kernel/org/eclipse/webdav/internal/kernel/Status.java;2;0;5;1;1;1;1;4;424;1;4;12;858;858;1;0;0;4;5;12;0;4211;5;2;
/org.eclipse.ui.tests/Eclipse UI Tests/org/eclipse/ui/tests/zoom/ZoomTestCase.java;1;0;2;1;1;1;1;1;3;0;1;3633;3;3;1;0;0;1;2;3633;0;3976;2;1;
/org.eclipse.ui/Eclipse UI/org/eclipse/ui/internal/EditorHistoryItem.java;3;0;5;1;2;1;2;3;95;1;3;257;108;108;2;0;1;3;5;4083;1;4083;4;3;
/org.eclipse.ui.tests/Eclipse UI Tests/org/eclipse/ui/tests/api/IEditorLauncherTest.java;1;0;1;1;0;0;0;1;0;0;1;983;0;0;1;0;0;1;1;983;0;983;1;1;
/org.eclipse.jdt.ui/core refactoring/org/eclipse/jdt/internal/corext/refactoring/base/ICompositeChange.java;1;0;1;1;0;0;0;1;0;0;1;1939;0;0;1;0;0;1;1;1939;0;1939;1;1;
/org.eclipse.scripting/Eclipse Scripting/org/eclipse/scripting/internal/datamodels/XGRXmlDataModel.java;2;0;6;1;0;0;0;6;44;1;6;133;52;52;1;0;0;6;6;133;0;1424;6;2;
/org.eclipse.swt.examples/src/org/eclipse/swt/examples/fileviewer/TreeView.java;2;0;3;2;0;0;0;3;1;2;2;554;1;1;2;1;0;3;3;609;1;609;2;2;
/org.eclipse.jdt.ui.tests.refactoring/resources/RenameMethodInInterface/test34/out/A.java;1;0;1;1;0;0;0;1;0;0;1;49;0;0;1;0;0;1;1;49;0;49;1;1;
/org.eclipse.update.tests.core/src/org/eclipse/update/tests/nestedfeatures/AllRegularInstallTests.java;1;0;2;1;2;1;2;0;0;0;0;3974;0;0;2;0;1;0;2;3974;1;3974;1;1;
/org.eclipse.jdt.ui/core refactoring/org/eclipse/jdt/internal/core/refactoring/rename/RefactoringScopeFactory.java;2;0;3;1;0;0;0;3;47;2;2;1922;47;47;2;1;0;3;3;1922;1;1939;2;2;
/org.eclipse.swt.tests/JUnit Tests/org/eclipse/swt/tests/junit/Test_org_eclipse_swt_events_ModifyListener.java;2;0;2;1;1;1;1;1;6;0;1;1792;6;6;1;0;0;1;2;1792;0;4706;2;2;
/org.eclipse.ui/Eclipse UI Standard Components/org/eclipse/ui/views/tasklist/MarkerTypesModel.java;4;0;5;1;2;1;2;3;19;1;3;257;38;38;2;0;1;3;5;4268;1;4268;4;4;
/org.eclipse.pde.build/src/org/eclipse/pde/internal/build/Echo.java;3;0;5;1;0;0;0;5;26;1;5;1366;31;31;1;0;0;5;5;1366;0;3089;5;3;
/org.eclipse.debug.ui/ui/org/eclipse/debug/internal/ui/BreakpointsView.java;3;0;19;2;0;0;0;19;202;3;16;187;609;609;3;3;0;19;19;2307;3;2307;16;3;
/org.eclipse.update.ui/src/org/eclipse/update/internal/ui/forms/ExtensionRootForm.java;2;2;3;2;3;2;3;0;3;0;0;4244;3;3;2;0;1;0;3;4606;1;4606;2;2;
/org.eclipse.ui/Eclipse UI/org/eclipse/ui/IEditorInput.java;2;0;2;1;0;0;0;2;5;1;2;257;5;5;1;0;0;2;2;257;0;457;2;2;
/org.eclipse.ui/Eclipse JFace Text/org/eclipse/jface/text/TypedRegion.java;3;0;3;1;0;0;0;3;19;1;3;257;24;24;1;0;0;3;3;257;0;1066;3;3;
/org.eclipse.help.tests/src/org/eclipse/help/tests/livehelp/TestAction.java;1;1;2;1;2;2;2;0;2;0;0;3928;2;2;1;0;0;0;2;3928;0;4439;2;1;
/org.eclipse.core.tests.runtime/src/org/eclipse/core/tests/internal/runtimetests/SampleCPB.java;1;0;3;1;0;0;0;3;10;2;2;3605;13;13;2;1;0;3;3;3605;1;3678;2;1;
/org.eclipse.update.tests.core/src/org/eclipse/update/tests/regularRemove/AllRegularRemoveTests.java;1;0;4;1;0;0;0;4;8;2;3;2330;11;11;2;1;0;4;4;2589;1;2589;3;1;
/org.eclipse.help/src/org/eclipse/help/internal/contributors/xml1_0/XMLTopicContributorCreator.java;1;0;2;1;0;0;0;2;0;1;2;1675;0;0;1;0;0;2;2;1675;0;2217;2;1;
/org.eclipse.pde.ui/src/org/eclipse/pde/core/ModelChangedEvent.java;1;0;3;1;0;0;0;3;2;2;2;3579;2;2;2;1;0;3;3;3579;1;3607;2;1;
/org.eclipse.jdt.ui.tests.refactoring/resources/ExtractMethodWorkSpace/ExtractMethodTests/locals_out/A_test509.java;2;1;4;1;2;2;2;2;33;1;2;195;61;61;1;0;0;2;4;195;0;4419;4;2;
/org.eclipse.pde.junit/src/org/eclipse/pde/internal/junit/ui/UITestApplication.java;1;0;1;1;0;0;0;1;0;0;1;3171;0;0;1;0;0;1;1;3171;0;3171;1;1;
/org.eclipse.jdt.ui/core refactoring/org/eclipse/jdt/core/refactoring/cus/MoveCompilationUnitRefactoring.java;1;0;10;1;0;0;0;10;73;2;8;15;132;132;2;2;0;10;10;106;2;408;8;1;
/org.eclipse.jdt.ui/ui refactoring/org/eclipse/jdt/internal/ui/refactoring/ChangeElementLabelProvider.java;2;0;6;1;0;0;0;6;86;2;5;1800;98;98;2;1;0;6;6;2874;1;3567;5;2;
/org.eclipse.jdt.ui/ui/org/eclipse/jdt/internal/ui/filters/AbstractFilter.java;1;0;1;1;1;1;1;0;0;0;0;4211;0;0;1;0;0;0;1;4211;0;4211;1;1;
/org.eclipse.ui/Eclipse JFace/org/eclipse/jface/wizard/ProgressMonitorPart.java;3;0;4;1;0;0;0;4;78;1;4;257;85;85;1;0;0;4;4;257;0;2325;4;3;
/org.eclipse.jdt.launching/launching/org/eclipse/jdt/internal/launching/RuntimeClasspathEntryListComparator.java;1;0;1;1;1;1;1;0;0;0;0;4215;0;0;1;0;0;0;1;4215;0;4215;1;1;
/org.eclipse.jdt.ui/ui/org/eclipse/jdt/internal/ui/search/ParentNameSorter.java;1;0;1;1;0;0;0;1;0;0;1;1272;0;0;1;0;0;1;1;1272;0;1272;1;1;
/org.eclipse.jdt.core/model/org/eclipse/jdt/internal/core/CreateTypeMemberOperation.java;3;1;11;1;2;2;2;9;205;4;6;455;297;297;4;3;0;9;11;1039;3;4424;8;3;
/org.eclipse.jdt.debug.tests/tests/org/eclipse/jdt/debug/tests/eval/IntAssignmentOperatorsTests.java;2;2;3;2;3;2;3;0;18;0;0;4447;20;20;2;0;1;0;3;4447;1;4571;2;2;
/org.eclipse.jdt.ui.tests.refactoring/resources/ExtractTemp/canExtract/A_test26_out.java;1;0;1;1;0;0;0;1;0;0;1;2913;0;0;1;0;0;1;1;2913;0;2913;1;1;
/org.eclipse.swt/Eclipse SWT Drag and Drop/carbon/org/eclipse/swt/dnd/ByteArrayTransfer.java;4;2;7;1;7;6;7;0;91;0;0;4147;165;165;2;0;1;0;7;4824;1;4824;6;4;
/org.eclipse.jdt.ui/core refactoring/org/eclipse/jdt/internal/corext/refactoring/rename/RenameTypeASTAnalyzer.java;2;0;5;1;0;0;0;5;20;1;5;1939;55;55;1;0;0;5;5;1939;0;3412;5;2;
/org.eclipse.swt.tests/JUnit Tests/org/eclipse/swt/tests/junit/Test_org_eclipse_swt_custom_CCombo.java;2;0;2;1;1;1;1;1;6;0;1;1792;6;6;1;0;0;1;2;1792;0;4706;2;2;
/org.eclipse.jdt.ui.tests.refactoring/resources/RenameType/test56/in/A.java;1;0;1;1;0;0;0;1;0;0;1;1547;0;0;1;0;0;1;1;1547;0;1547;1;1;
/org.eclipse.jdt.ui/core refactoring/org/eclipse/jdt/internal/core/refactoring/util/GenericVisitor.java;1;0;3;1;0;0;0;3;2;1;3;1453;2;2;1;0;0;3;3;1453;0;1939;3;1;
/org.eclipse.jdt.ui/core refactoring/org/eclipse/jdt/internal/core/refactoring/resources/RenameResourceRefactoring.java;1;0;6;1;0;0;0;6;117;2;5;990;152;152;2;1;0;6;6;1338;1;1338;5;1;
/org.eclipse.jdt.debug.tests/testprograms/EvalTypeTests.java;2;1;2;1;2;2;2;0;150;0;0;4447;150;150;1;0;0;0;2;4447;0;4571;2;2;
/org.eclipse.jdt.ui.tests.refactoring/resources/ReorderParameters/canReorder/A_test20_in.java;1;0;1;1;1;1;1;0;0;0;0;4400;0;0;1;0;0;0;1;4400;0;4400;1;1;
/org.eclipse.team.cvs.core/src/org/eclipse/team/internal/ccvs/core/ICVSResource.java;2;0;5;1;1;1;1;4;139;1;4;3012;148;148;1;0;0;4;5;3012;0;4111;5;2;
/org.eclipse.jdt.ui.tests.refactoring/resources/SelectionAnalyzerWorkSpace/SelectionAnalyzerTests/validSelection/A_test352.java;1;0;1;1;0;0;0;1;0;0;1;1368;0;0;1;0;0;1;1;1368;0;1368;1;1;
/org.eclipse.debug.ui/ui/org/eclipse/debug/internal/ui/launchConfigurations/LaunchConfigurationTabImageDescriptor.java;2;1;3;1;3;3;3;0;2;0;0;4349;4;4;1;0;0;0;3;4349;0;4423;3;2;
/org.eclipse.update/Eclipse Update/org/eclipse/update/internal/core/UpdateManagerPlugin.java;1;0;3;1;0;0;0;3;6;1;3;108;6;6;1;0;0;3;3;108;0;1424;3;1;
/org.eclipse.jdt.ui/core extension/org/eclipse/jdt/internal/corext/codemanipulation/IUndoTextEdits.java;1;0;2;1;0;0;0;2;0;1;2;1937;0;0;1;0;0;2;2;1937;0;2133;2;1;
/org.eclipse.jdt.ui.tests.refactoring/resources/ReorderParameters/canReorder/A_test6_out.java;1;0;3;1;0;0;0;3;0;1;3;724;0;0;1;0;0;3;3;724;0;2270;3;1;
/org.eclipse.ui/Eclipse JFace/org/eclipse/jface/viewers/ICheckable.java;3;0;3;1;0;0;0;3;5;1;3;257;9;9;1;0;0;3;3;257;0;2034;3;3;
/org.eclipse.jdt.ui.tests.refactoring/resources/ExtractTemp/canExtract/A_test23_out.java;1;0;1;1;0;0;0;1;0;0;1;2498;0;0;1;0;0;1;1;2498;0;2498;1;1;
/org.eclipse.ui/Eclipse UI/org/eclipse/ui/internal/dialogs/WelcomeEditorInput.java;3;1;4;1;2;2;2;2;25;1;2;457;34;34;1;0;0;2;4;457;0;4407;4;3;
/org.eclipse.jdt.ui/core refactoring/org/eclipse/jdt/internal/core/refactoring/nls/changes/Messages.java;1;0;2;1;0;0;0;2;2;0;1;1922;2;2;2;1;0;2;2;1922;1;1922;1;1;
/org.eclipse.jdt.debug/model/org/eclipse/jdt/internal/debug/core/model/JDIThread.java;3;2;53;3;10;9;10;43;153;3;27;2517;1181;1181;3;16;1;43;53;2517;17;4766;36;3;
/org.eclipse.core.boot/src/org/eclipse/core/internal/boot/update/IFragmentEntryDescriptor.java;2;0;3;1;0;0;0;3;4;1;3;12;4;4;1;0;0;3;3;12;0;2726;3;2;
/org.eclipse.debug.ui/ui/org/eclipse/debug/internal/ui/launchConfigurations/LaunchConfigurationLabelDecorator.java;1;0;3;1;0;0;0;3;2;1;3;2760;2;2;1;0;0;3;3;2760;0;2895;3;1;
/org.eclipse.compare/compare/org/eclipse/patch/PatchedResource.java;1;0;2;1;0;0;0;2;0;1;2;1419;0;0;1;0;0;2;2;1419;0;1516;2;1;
/org.eclipse.pde.ui/src/org/eclipse/pde/internal/schema/SchemaCompositor.java;2;0;4;1;0;0;0;4;3;1;4;1434;4;4;1;0;0;4;4;1434;0;3579;4;2;
/org.eclipse.jdt.ui.tests.refactoring/resources/RenamePrivateMethod/test12/out/A.java;1;0;1;1;0;0;0;1;0;0;1;49;0;0;1;0;0;1;1;49;0;49;1;1;
/org.eclipse.pde.ui/src/org/eclipse/pde/internal/editor/PropertiesAction.java;2;0;3;1;0;0;0;3;3;1;3;1434;3;3;1;0;0;3;3;1434;0;3579;3;2;
/org.eclipse.swt.examples/src/org/eclipse/swt/examples/controlexample/ListTab.java;5;1;6;1;3;3;3;3;106;1;3;513;233;233;1;0;0;3;6;513;0;4705;6;5;
/org.eclipse.pde.ui/src/org/eclipse/pde/internal/ui/parts/WizardCheckboxTablePart.java;1;0;1;1;0;0;0;1;0;0;1;3579;0;0;1;0;0;1;1;3579;0;3579;1;1;
/org.eclipse.pde.ui/src/org/eclipse/pde/internal/base/model/plugin/IPluginParent.java;2;0;2;1;0;0;0;2;0;1;2;1434;0;0;1;0;0;2;2;1434;0;3039;2;2;
/org.eclipse.pde.ui/src/org/eclipse/pde/core/plugin/IPluginBase.java;1;0;3;1;0;0;0;3;5;2;2;3579;5;5;2;1;0;3;3;3579;1;3607;2;1;
/org.eclipse.ui/Eclipse UI Standard Components/org/eclipse/ui/wizards/datatransfer/ZipFileExportOperation.java;3;0;6;1;0;0;0;6;47;1;6;257;107;107;1;0;0;6;6;257;0;3569;6;3;
/org.eclipse.jdt.ui.tests.refactoring/resources/ExtractMethodWorkSpace/ExtractMethodTests/invalidSelection/A_test011.java;2;1;3;1;2;2;2;1;0;0;1;49;0;0;1;0;0;1;3;49;0;4419;3;2;
/org.eclipse.team.ui/src/org/eclipse/team/ui/actions/GetAction.java;2;0;7;1;1;1;1;6;19;1;6;2434;42;42;1;0;0;6;7;2434;0;4020;7;2;
/org.eclipse.pde.core/src/org/eclipse/pde/internal/core/feature/AbstractFeatureModel.java;1;0;1;1;0;0;0;1;0;0;1;3591;0;0;1;0;0;1;1;3591;0;3591;1;1;
/org.eclipse.team.cvs.core/src/org/eclipse/team/internal/ccvs/core/connection/PServerConnectionMethod.java;3;0;3;1;0;0;0;3;2;1;3;1978;4;4;1;0;0;3;3;1978;0;3610;3;3;
/org.eclipse.jdt.ui.tests.refactoring/resources/MoveMembers/test8/out/A.java;1;0;1;1;0;0;0;1;0;0;1;2738;0;0;1;0;0;1;1;2738;0;2738;1;1;
/org.eclipse.core.resources/src/org/eclipse/core/internal/events/ResourceDeltaInfo.java;3;0;7;1;1;1;1;6;100;1;6;12;150;150;1;0;0;6;7;12;0;4214;7;3;
/org.eclipse.jdt.ui/ui/org/eclipse/jdt/internal/ui/wizards/NewSnippetFileCreationPage.java;2;0;6;1;0;0;0;6;29;1;6;15;75;75;1;0;0;6;6;15;0;1342;6;2;
/org.eclipse.team.cvs.core/src/org/eclipse/team/internal/ccvs/core/client/CopyHandler.java;2;0;7;1;0;0;0;7;55;1;7;2572;71;71;1;0;0;7;7;2572;0;3610;7;2;
/org.eclipse.scripting/Eclipse Scripting/org/eclipse/scripting/internal/views/ScriptUIEditorColorProvider.java;2;0;4;1;0;0;0;4;15;1;4;133;23;23;1;0;0;4;4;133;0;1424;4;2;
/org.eclipse.jdt.debug.tests/tests/org/eclipse/jdt/debug/tests/eval/TestsNumberLiteral.java;2;0;2;2;2;1;2;0;6;0;0;4568;6;6;2;0;1;0;2;4568;1;4568;1;2;
/org.eclipse.core.tests.resources/src/org/eclipse/core/tests/internal/indexing/BasicIndexedStoreTest.java;3;0;4;1;1;1;1;3;1956;1;3;1794;1984;1984;1;0;0;3;4;1794;0;4516;4;3;
/org.eclipse.jdt.ui/core refactoring/org/eclipse/jdt/internal/core/refactoring/rename/RenameMethodASTAnalyzer.java;2;0;5;1;0;0;0;5;6;2;4;1342;9;9;2;1;0;5;5;1910;1;1939;4;2;
/org.eclipse.team.ui/src/org/eclipse/team/internal/ui/Policy.java;2;0;5;1;2;1;2;3;240;1;3;1978;254;254;2;0;1;3;5;4401;1;4401;4;2;
/org.eclipse.pde.ui/src/org/eclipse/pde/model/plugin/IFragment.java;1;0;2;1;0;0;0;2;0;1;2;3039;0;0;1;0;0;2;2;3039;0;3579;2;1;
/org.eclipse.jdt.junit/src/org/eclipse/jdt/internal/junit/util/CheckedTableSelectionDialog.java;2;1;7;1;4;4;4;3;8;1;3;3247;21;21;1;0;0;3;7;3247;0;4077;7;2;
/org.eclipse.ui/Eclipse UI/org/eclipse/ui/IPerspectiveListener.java;2;0;2;1;0;0;0;2;5;1;2;257;5;5;1;0;0;2;2;257;0;457;2;2;
/org.eclipse.jdt.core/model/org/eclipse/jdt/internal/core/util/ICacheEnumeration.java;3;1;3;1;2;2;2;1;14;0;1;455;28;28;1;0;0;1;3;455;0;4422;3;3;
/org.eclipse.jdt.ui.tests.refactoring/resources/PullUp/test5/in/B.java;1;0;1;1;0;0;0;1;0;0;1;2406;0;0;1;0;0;1;1;2406;0;2406;1;1;
/org.eclipse.update.examples/src/org/eclipse/update/examples/buildzip/BuildZipConverter.java;2;0;7;1;1;1;1;6;23;2;5;2859;63;63;2;1;0;6;7;2859;1;4401;6;2;
/org.eclipse.scripting/Eclipse Scripting/org/eclipse/scripting/internal/uirenderer/XGRPresentationModelAttribute.java;2;0;4;1;0;0;0;4;11;1;4;133;18;18;1;0;0;4;4;133;0;1424;4;2;
/org.eclipse.jdt.debug/jdi/org/eclipse/jdi/internal/VoidValueImpl.java;2;0;4;1;0;0;0;4;18;1;4;187;34;34;1;0;0;4;4;187;0;3670;4;2;
/org.eclipse.jdt.ui/core refactoring/org/eclipse/jdt/internal/corext/refactoring/code/LocalTypeAnalyzer.java;1;0;4;1;1;1;1;3;191;1;3;1939;193;193;1;0;0;3;4;1939;0;3909;4;1;
/org.eclipse.jdt.ui/core extension/org/eclipse/jdt/internal/corext/javadoc/JavaDocAccess.java;1;0;2;1;0;0;0;2;44;1;2;2495;44;44;1;0;0;2;2;2495;0;3437;2;1;
/org.eclipse.update.ui/src/org/eclipse/update/internal/ui/pages/DiscoveryFolderPage.java;1;0;2;1;0;0;0;2;3;1;2;3537;3;3;1;0;0;2;2;3537;0;3662;2;1;
/org.eclipse.swt/Eclipse SWT PI/win32/org/eclipse/swt/internal/ole/win32/IOleLink.java;2;0;2;1;1;1;1;1;6;0;1;2069;6;6;1;0;0;1;2;2069;0;4701;2;2;
/org.eclipse.jdt.core/model/org/eclipse/jdt/core/util/IConstantPoolConstant.java;2;2;5;1;4;3;4;1;20;0;1;3629;36;36;2;0;1;1;5;4058;1;4573;4;2;
/org.eclipse.pde.ui/src/org/eclipse/pde/internal/ui/editor/build/TokenSection.java;1;0;3;1;1;1;1;2;310;0;1;3579;343;343;2;1;0;2;3;3579;1;4435;2;1;
/org.eclipse.jdt.ui.tests.refactoring/resources/InlineTemp/canInline/A_test10_in.java;1;0;2;1;0;0;0;2;2;1;2;2751;2;2;1;0;0;2;2;2751;0;3048;2;1;
/org.eclipse.swt/Eclipse SWT Drag and Drop/gtk/org/eclipse/swt/dnd/DropTarget.java;3;1;7;1;5;5;5;2;97;1;2;2107;206;206;1;0;0;2;7;2107;0;4824;7;3;
/org.eclipse.jdt.core/model/org/eclipse/jdt/internal/core/builder/impl/ClassOrInterfaceHandleImpl.java;1;0;3;1;0;0;0;3;860;1;3;455;860;860;1;0;0;3;3;455;0;2808;3;1;
/org.eclipse.team.ftp/src/org/eclipse/team/internal/ftp/client/GetFileWorker.java;1;1;3;1;3;3;3;0;4;0;0;4169;4;4;1;0;0;0;3;4169;0;4573;3;1;
/org.eclipse.compare/compare/org/eclipse/compare/internal/CompareEditor.java;2;0;11;1;0;0;0;11;54;1;11;14;155;155;1;0;0;11;11;14;0;2704;11;2;
/org.eclipse.jdt.ui.tests.refactoring/resources/RenameMethodInInterface/test47/in/A.java;1;0;1;1;0;0;0;1;0;0;1;1297;0;0;1;0;0;1;1;1297;0;1297;1;1;
/org.eclipse.pde.core/src/org/eclipse/pde/internal/core/plugin/ExternalFragmentModel.java;1;0;1;1;0;0;0;1;0;0;1;3591;0;0;1;0;0;1;1;3591;0;3591;1;1;
/org.eclipse.ui/Eclipse JFace/org/eclipse/jface/action/IAction.java;4;0;9;1;0;0;0;9;25;2;8;257;85;85;2;1;0;9;9;1436;1;3128;8;4;
/org.eclipse.jdt.ui.tests.refactoring/resources/MoveMembers/test21/in/B.java;1;0;1;1;0;0;0;1;0;0;1;2738;0;0;1;0;0;1;1;2738;0;2738;1;1;
/org.eclipse.swt/Eclipse SWT Drag and Drop/win32/org/eclipse/swt/dnd/Clipboard.java;2;1;11;1;5;5;5;6;80;3;4;106;260;260;3;2;0;6;11;3048;2;4824;9;2;
/org.eclipse.jdt.ui/core refactoring/org/eclipse/jdt/internal/corext/refactoring/util/Selection.java;2;0;4;1;0;0;0;4;14;1;4;1939;21;21;1;0;0;4;4;1939;0;3413;4;2;
/org.eclipse.ui/Eclipse JFace Text/org/eclipse/jface/text/SequentialRewriteTextStore.java;2;1;3;1;3;3;3;0;238;0;0;4423;276;276;1;0;0;0;3;4423;0;4838;3;2;
/org.eclipse.scripting/src/org/eclipse/scripting/internal/views/ScriptDevelopmentPreferencePageWorkbenchNew.java;1;0;1;1;0;0;0;1;0;0;1;1424;0;0;1;0;0;1;1;1424;0;1424;1;1;
/org.eclipse.jdt.ui.tests.refactoring/resources/ExtractMethodWorkSpace/ExtractMethodTests/locals_out/A_test521.java;1;1;4;1;2;2;2;2;36;1;2;1851;39;39;1;0;0;2;4;1851;0;4419;4;1;
/org.eclipse.jdt.ui.tests.refactoring/resources/RenameMethodInInterface/test45/in/A.java;1;0;1;1;0;0;0;1;0;0;1;548;0;0;1;0;0;1;1;548;0;548;1;1;
/org.eclipse.swt/Eclipse SWT/win32/org/eclipse/swt/widgets/TableItem.java;8;2;18;2;5;4;5;13;137;2;12;106;443;443;2;1;1;13;18;3152;2;4701;16;8;
/org.eclipse.jdt.core/compiler/org/eclipse/jdt/internal/compiler/lookup/ArrayBinding.java;2;0;11;1;1;1;1;10;247;4;7;455;311;311;4;3;0;10;11;1039;3;4062;8;2;
/org.eclipse.core.tests.runtime/src/org/eclipse/core/tests/internal/plugins/SoftPrereqTest_9.java;3;0;3;1;0;0;0;3;166;1;3;1794;176;176;1;0;0;3;3;1794;0;3476;3;3;
/org.eclipse.jdt.ui.tests.refactoring/resources/RenameType/testFail56/in/A.java;1;0;1;1;0;0;0;1;0;0;1;49;0;0;1;0;0;1;1;49;0;49;1;1;
/org.eclipse.pde.ui/src/org/eclipse/pde/internal/ui/wizards/templates/LabelField.java;1;0;3;1;0;0;0;3;3;1;3;3579;3;3;1;0;0;3;3;3579;0;3840;3;1;
/org.eclipse.jdt.ui.tests.refactoring/resources/PullUp/test19/in/A.java;1;0;2;1;2;1;2;0;3;0;0;4450;3;3;2;0;1;0;2;4450;1;4450;1;1;
/org.eclipse.jdt.ui.tests.refactoring/resources/PullUpMethods/test16/out/A.java;1;0;2;1;0;0;0;2;0;1;2;2286;0;0;1;0;0;2;2;2286;0;2406;2;1;
/org.eclipse.team.cvs.core/src/org/eclipse/team/internal/ccvs/core/client/listeners/DiffListener.java;2;0;7;1;1;1;1;6;43;1;6;2572;70;70;1;0;0;6;7;2572;0;4400;7;2;
/org.eclipse.ui/Eclipse UI Text Editor/org/eclipse/ui/texteditor/AbstractTextEditor.java;7;3;42;1;15;12;15;27;2191;2;26;257;5844;5844;3;1;3;27;42;4423;4;4838;38;7;
/org.eclipse.pde.ui/src/org/eclipse/pde/internal/base/schema/ISchemaAttribute.java;2;0;2;1;0;0;0;2;0;1;2;1434;0;0;1;0;0;2;2;1434;0;3579;2;2;
/org.eclipse.update.ui.forms/src/org/eclipse/update/ui/forms/WrapGridLayout.java;1;0;2;1;0;0;0;2;0;0;1;1537;0;0;2;1;0;2;2;1537;1;1537;1;1;
/org.eclipse.jdt.ui.tests.refactoring/resources/RenameVariables/canRename/A_test31_in.java;1;0;2;1;0;0;0;2;0;1;2;724;0;0;1;0;0;2;2;724;0;1665;2;1;
/org.eclipse.ui/Eclipse UI/org/eclipse/ui/internal/misc/ProjectCapabilitySelectionGroup.java;1;0;13;1;0;0;0;13;515;3;9;3154;905;905;3;4;0;13;13;3186;4;3529;9;1;
/org.eclipse.pde.ui/src/org/eclipse/pde/internal/ui/editor/manifest/JavaAttributeWizardPage.java;1;0;2;1;0;0;0;2;2;1;2;3579;2;2;1;0;0;2;2;3579;0;3591;2;1;
/org.eclipse.update.core/src/org/eclipse/update/core/Assert.java;1;0;2;1;0;0;0;2;0;1;2;1451;0;0;1;0;0;2;2;1451;0;1643;2;1;
/org.eclipse.jdt.debug/jdi interfaces/com/sun/jdi/connect/IllegalConnectorArgumentsException.java;2;0;2;1;0;0;0;2;16;1;2;2704;16;16;1;0;0;2;2;2704;0;3033;2;2;
/org.eclipse.swt.tests/JUnit Tests/org/eclipse/swt/tests/junit/Test_org_eclipse_swt_SWT.java;2;0;2;1;1;1;1;1;6;0;1;1792;6;6;1;0;0;1;2;1792;0;4706;2;2;
/org.eclipse.pde.ui/Eclipse PDE UI/org/eclipse/pde/internal/editor/IPDEEditorPage.java;2;0;5;2;0;0;0;5;12;3;3;267;12;12;3;2;0;5;5;324;2;1434;3;2;
/org.eclipse.help.ui/src/org/eclipse/help/internal/ui/RelatedTopicsView.java;1;0;3;1;0;0;0;3;8;1;3;1675;8;8;1;0;0;3;3;1675;0;3030;3;1;
/org.eclipse.pde.ui/src/org/eclipse/pde/internal/core/feature/FeatureURL.java;1;0;4;1;0;0;0;4;142;2;3;3579;144;144;2;1;0;4;4;3579;1;3607;3;1;
/org.eclipse.help/src/org/eclipse/help/internal/context/XMLContextContributor.java;2;0;3;1;0;0;0;3;2;1;3;1675;2;2;1;0;0;3;3;1675;0;2217;3;2;
/org.eclipse.pde.ui/src/org/eclipse/pde/internal/model/ModelDataTransfer.java;1;0;3;1;0;0;0;3;2;2;2;3136;2;2;2;1;0;3;3;3136;1;3579;2;1;
/org.eclipse.jdt.debug/jdi interfaces/com/sun/jdi/CharValue.java;2;0;2;1;0;0;0;2;6;1;2;2704;6;6;1;0;0;2;2;2704;0;3033;2;2;
/org.eclipse.team.cvs.ui/src/org/eclipse/team/internal/ccvs/ui/sync/CVSCatchupReleaseViewer.java;3;2;47;2;12;10;12;35;542;2;31;2231;1653;1653;2;4;2;35;47;2231;6;4628;41;3;
/org.eclipse.pde.ui/Eclipse PDE UI/org/eclipse/pde/internal/wizards/project/DefaultCodeGenerationPage.java;3;0;12;2;0;0;0;12;32;2;11;267;126;126;2;1;0;12;12;324;1;1434;11;3;
/org.eclipse.core.resources/src_ant/org/eclipse/core/resources/ant/RefreshLocalTask.java;2;1;6;1;4;4;4;2;20;1;2;3509;63;63;1;0;0;2;6;3509;0;4633;6;2;
/org.eclipse.ui/Eclipse UI/org/eclipse/ui/internal/registry/ViewDescriptor.java;4;0;5;1;1;1;1;4;33;1;4;257;84;84;1;0;0;4;5;257;0;4082;5;4;
/org.eclipse.jdt.ui.tests.refactoring/resources/RenameParameters/canRename/A_test28_out.java;1;0;1;1;0;0;0;1;0;0;1;233;0;0;1;0;0;1;1;233;0;233;1;1;
/org.eclipse.swt/Eclipse SWT Drag and Drop/carbon/org/eclipse/swt/dnd/DropTarget.java;4;1;6;1;6;6;6;0;512;0;0;4147;622;622;1;0;0;0;6;4147;0;4824;6;4;
/org.eclipse.debug.ui/ui/org/eclipse/debug/internal/ui/actions/OpenRunConfigurations.java;2;0;4;1;1;1;1;3;11;1;3;3152;22;22;1;0;0;3;4;3152;0;4004;4;2;
/org.eclipse.jdt.launching.j9/j9/org/eclipse/jdt/internal/launching/j9/JavaVMRunner.java;3;1;6;1;3;3;3;3;9;1;3;3314;16;16;1;0;0;3;6;3314;0;4423;6;3;
/org.eclipse.jdt.ui.tests.refactoring/resources/MoveMembers/testFail24/in/B.java;1;0;1;1;0;0;0;1;0;0;1;2928;0;0;1;0;0;1;1;2928;0;2928;1;1;
/org.eclipse.pde.ui/src/org/eclipse/pde/internal/editor/build/BuildOutlinePage.java;2;0;4;1;0;0;0;4;9;2;3;1434;9;9;2;1;0;4;4;3035;1;3579;3;2;
/org.eclipse.pde.ui/src/org/eclipse/pde/internal/ui/editor/feature/PortabilityChoiceCellEditor.java;1;0;2;1;0;0;0;2;2;1;2;3579;2;2;1;0;0;2;2;3579;0;3591;2;1;
/org.eclipse.swt/Eclipse SWT/motif/org/eclipse/swt/widgets/Text.java;10;1;21;1;7;7;7;14;1308;1;14;106;3118;3118;1;0;0;14;21;106;0;4701;21;10;
/org.eclipse.jdt.junit/src/org/eclipse/jdt/junit/wizards/NewTestCaseCreationWizard.java;2;0;9;1;0;0;0;9;17;3;6;3247;38;38;3;3;0;9;9;3394;3;3527;6;2;
/org.eclipse.update.ui/src/org/eclipse/update/internal/ui/manager/UpdateSearchContribution.java;1;0;3;1;0;0;0;3;76;1;3;1942;76;76;1;0;0;3;3;1942;0;3662;3;1;
/org.eclipse.jdt.ui.tests.refactoring/resources/RenamePrivateField/testFail5/in/A.java;1;0;1;1;0;0;0;1;0;0;1;49;0;0;1;0;0;1;1;49;0;49;1;1;
/org.eclipse.jdt.core/search/org/eclipse/jdt/internal/core/search/processing/IJob.java;3;0;7;1;1;1;1;6;33;1;6;455;86;86;1;0;0;6;7;455;0;4063;7;3;
/org.eclipse.pde.junit/Pde JUnit/org/eclipse/pde/internal/junit/ui/UITestApplication.java;2;0;2;1;0;0;0;2;0;1;2;2399;0;0;1;0;0;2;2;2399;0;3205;2;2;
/org.eclipse.ui/Eclipse UI/org/eclipse/ui/internal/CoolItemToolBarManager.java;1;1;3;1;3;3;3;0;15;0;0;3894;26;26;1;0;0;0;3;3894;0;4404;3;1;
/org.eclipse.jdt.ui.tests.refactoring/resources/RenameType/testFail68/in/A.java;1;0;1;1;0;0;0;1;0;0;1;49;0;0;1;0;0;1;1;49;0;49;1;1;
/org.eclipse.ui/Eclipse UI Text Editor/org/eclipse/ui/texteditor/ITextEditorActionConstants.java;4;1;13;1;4;4;4;9;99;1;9;257;227;227;1;0;0;9;13;257;0;4838;13;4;
/org.eclipse.jdt.ui/ui/org/eclipse/jdt/internal/ui/packageview/SelectionTransferDropAdapter.java;6;1;28;2;5;5;5;23;202;2;19;15;885;885;2;4;0;23;28;2212;4;4212;24;6;
/org.eclipse.jdt.core/compiler/org/eclipse/jdt/internal/compiler/ast/Statement.java;2;1;17;1;2;2;2;15;98;4;11;455;318;318;4;4;0;15;17;1039;4;4421;13;2;
/org.eclipse.jdt.ui.tests.refactoring/resources/RenameParameters/cannotRename/A_testFail15.java;1;0;1;1;0;0;0;1;0;0;1;233;0;0;1;0;0;1;1;233;0;233;1;1;
/org.eclipse.ui/Eclipse UI/org/eclipse/ui/internal/dialogs/FakeWizardActionSet.java;2;0;2;1;0;0;0;2;4;1;2;257;4;4;1;0;0;2;2;257;0;457;2;2;
/org.eclipse.jdt.core/dom/org/eclipse/jdt/core/dom/ArrayAccess.java;2;1;6;1;2;2;2;4;18;1;4;2669;50;50;1;0;0;4;6;2669;0;4453;6;2;
/org.eclipse.jdt.ui.tests.refactoring/resources/RenameType/test38/out/B.java;1;0;1;1;0;0;0;1;0;0;1;49;0;0;1;0;0;1;1;49;0;49;1;1;
/org.eclipse.help.tests/src/org/eclipse/help/tests/base/TestTocs.java;2;1;10;1;3;3;3;7;99;1;7;1857;237;237;1;0;0;7;10;1857;0;4704;10;2;
/org.eclipse.ui.tests/Eclipse UI Tests/org/eclipse/ui/tests/api/MockViewPart.java;2;0;5;2;0;0;0;5;64;2;4;993;69;69;2;1;0;5;5;1002;1;1098;4;2;
/org.eclipse.swt/Eclipse SWT PI/gtk1x/org/eclipse/swt/internal/gtk/GdkGCValues.java;2;0;2;1;1;1;1;1;3;0;1;2107;3;3;1;0;0;1;2;2107;0;4701;2;2;
/org.eclipse.search/search/org/eclipse/search/internal/ui/text/ReplaceDialog.java;1;1;4;1;4;4;4;0;68;0;0;4147;99;99;1;0;0;0;4;4147;0;4763;4;1;
/org.eclipse.pde.ui/Eclipse PDE UI/org/eclipse/pde/internal/editor/manifest/ResourceAttributeDescriptor.java;2;0;5;2;0;0;0;5;12;3;3;267;12;12;3;2;0;5;5;324;2;1434;3;2;
/org.eclipse.jdt.ui.tests.refactoring/resources/RenameType/test16/out/A.java;1;0;2;1;0;0;0;2;0;1;2;49;0;0;1;0;0;2;2;49;0;522;2;1;
/org.eclipse.swt/Eclipse SWT/common/org/eclipse/swt/layout/FormAttachment.java;3;0;6;2;1;1;1;5;261;2;4;2880;414;414;2;1;0;5;6;2880;1;4701;5;3;
/org.eclipse.ui/Eclipse UI/org/eclipse/ui/part/MultiPageEditorPart.java;3;0;5;1;1;1;1;4;26;1;4;257;60;60;1;0;0;4;5;257;0;4629;5;3;
/org.eclipse.pde.ui/src/org/eclipse/pde/internal/core/IPluginModelListener.java;1;0;2;1;0;0;0;2;0;1;2;3445;0;0;1;0;0;2;2;3445;0;3607;2;1;
/org.eclipse.pde.ui/src/org/eclipse/pde/internal/editor/manifest/RuntimeForm.java;2;0;3;1;0;0;0;3;8;1;3;1434;8;8;1;0;0;3;3;1434;0;3579;3;2;
/org.eclipse.pde.ui/src/org/eclipse/pde/internal/ui/editor/PDEMultiPagePropertySheet.java;1;0;1;1;0;0;0;1;0;0;1;3579;0;0;1;0;0;1;1;3579;0;3579;1;1;
/org.eclipse.team.cvs.core/src/org/eclipse/team/internal/ccvs/core/commands/AddStructureVisitor.java;3;0;4;1;0;0;0;4;184;1;4;1978;368;368;1;0;0;4;4;1978;0;2607;4;3;
/org.eclipse.jdt.ui/ui/org/eclipse/jdt/internal/ui/text/template/Templates.java;1;0;2;1;0;0;0;2;0;1;2;1786;0;0;1;0;0;2;2;1786;0;2784;2;1;
/org.eclipse.core.tests.runtime/src/org/eclipse/core/tests/plugintests/AllTests.java;3;0;3;1;0;0;0;3;34;1;3;1794;44;44;1;0;0;3;3;1794;0;3476;3;3;
/org.eclipse.jdt.ui/ui/org/eclipse/jdt/internal/ui/reorg/IRefactoringAction.java;2;0;2;1;0;0;0;2;0;1;2;1338;0;0;1;0;0;2;2;1338;0;1345;2;2;
/org.eclipse.team.cvs.core/src/org/eclipse/team/internal/ccvs/core/response/Removed.java;3;0;4;1;0;0;0;4;14;1;4;1978;20;20;1;0;0;4;4;1978;0;2607;4;3;
/org.eclipse.jdt.ui/nls/org/eclipse/jdt/internal/ui/nls/model/NLSScanner.java;1;0;3;1;0;0;0;3;4;2;2;1880;4;4;2;1;0;3;3;1880;1;1913;2;1;
/org.eclipse.jdt.debug/eval/org/eclipse/jdt/debug/eval/IClassFileEvaluationEngine.java;2;0;8;1;1;1;1;7;45;1;7;2049;87;87;1;0;0;7;8;2049;0;4423;8;2;
/org.eclipse.scripting/Eclipse Scripting/org/eclipse/scripting/internal/IXGRElementUISizable.java;2;0;4;1;0;0;0;4;6;1;4;133;10;10;1;0;0;4;4;133;0;1424;4;2;
/org.eclipse.update.core/src/org/eclipse/update/core/model/SiteModelFactory.java;2;0;11;1;0;0;0;11;114;2;10;2409;294;294;2;1;0;11;11;3027;1;3796;10;2;
/org.eclipse.pde.ui/src/org/eclipse/pde/internal/editor/component/BuildComponentAction.java;2;0;2;1;0;0;0;2;0;1;2;1434;0;0;1;0;0;2;2;1434;0;2951;2;2;
/org.eclipse.jdt.ui/ui/org/eclipse/jdt/internal/ui/jarpackager/JarPackageReader.java;2;0;16;1;0;0;0;16;205;2;15;239;696;696;2;1;0;16;16;431;1;3791;15;2;
/org.eclipse.jdt.core/search/org/eclipse/jdt/internal/core/search/processing/IJobConstants.java;1;0;4;1;0;0;0;4;7;1;4;455;9;9;1;0;0;4;4;455;0;1651;4;1;
/org.eclipse.pde.core/src/org/eclipse/pde/internal/core/ischema/IMetaAttribute.java;1;0;1;1;0;0;0;1;0;0;1;3591;0;0;1;0;0;1;1;3591;0;3591;1;1;
/org.eclipse.jdt.ui/ui/org/eclipse/jdt/internal/ui/viewsupport/JavaElementDescriptorFactory.java;3;0;9;1;0;0;0;9;29;2;8;15;74;74;2;1;0;9;9;1004;1;1310;8;3;
/org.eclipse.ui/Eclipse UI/org/eclipse/ui/internal/dialogs/EmptyPropertyPage.java;3;0;3;1;0;0;0;3;5;1;3;257;6;6;1;0;0;3;3;257;0;620;3;3;
/org.eclipse.update.ui/src/org/eclipse/update/internal/ui/views/UpdatesView.java;2;2;23;1;17;14;17;6;333;5;2;3572;993;993;5;4;3;6;23;3653;7;4610;16;2;
/org.eclipse.ui/Eclipse UI Text Editor/org/eclipse/ui/texteditor/MarkRegionTarget.java;1;1;2;1;2;2;2;0;12;0;0;4209;22;22;1;0;0;0;2;4209;0;4838;2;1;
/org.eclipse.jdt.ui/ui/org/eclipse/jdt/internal/ui/search/JavaSearchScopeFactory.java;1;0;6;1;0;0;0;6;53;1;6;1722;117;117;1;0;0;6;6;1722;0;3824;6;1;
/org.eclipse.jdt.debug.ui/ui/org/eclipse/jdt/internal/debug/ui/launcher/OpenOnReceivingTypeAction.java;2;0;2;1;0;0;0;2;0;1;2;1915;0;0;1;0;0;2;2;1915;0;2384;2;2;
/org.eclipse.jdt.ui/ui/org/eclipse/jdt/internal/ui/actions/OpenSuperImplementationAction.java;2;0;9;1;1;1;1;8;38;1;8;1683;72;72;1;0;0;8;9;1683;0;3967;9;2;
/org.eclipse.jdt.ui/ui/org/eclipse/jdt/internal/ui/dialogs/TwoArrayQuickSort.java;2;0;2;1;0;0;0;2;0;1;2;1199;0;0;1;0;0;2;2;1199;0;1254;2;2;
/org.eclipse.pde.ui/src/org/eclipse/pde/model/IModelChangeProvider.java;1;0;2;1;0;0;0;2;0;1;2;3039;0;0;1;0;0;2;2;3039;0;3579;2;1;
/org.eclipse.team.cvs.core/src/org/eclipse/team/internal/ccvs/core/commands/ImportStructureVisitor.java;3;0;4;1;0;0;0;4;278;1;4;1978;556;556;1;0;0;4;4;1978;0;2607;4;3;
/org.eclipse.jdt.debug.tests/tests/org/eclipse/jdt/debug/tests/eval/XfixOperatorsTests.java;2;1;3;1;3;3;3;0;18;0;0;4447;20;20;1;0;0;0;3;4447;0;4571;3;2;
/org.eclipse.vcm.tests.core/src/org/eclipse/vcm/tests/core/adapter/IRepositoryAdapterTest.java;1;0;1;1;0;0;0;1;0;0;1;1688;0;0;1;0;0;1;1;1688;0;1688;1;1;
/org.eclipse.pde.core/src/org/eclipse/pde/internal/core/feature/FeatureURL.java;1;0;2;1;1;1;1;1;12;0;1;3591;12;12;1;0;0;1;2;3591;0;3994;2;1;
/org.eclipse.jdt.ui.tests.refactoring/resources/PullUp/test9/out/A.java;1;0;1;1;0;0;0;1;0;0;1;2406;0;0;1;0;0;1;1;2406;0;2406;1;1;
/org.eclipse.pde.ui/src/org/eclipse/pde/internal/editor/component/URLElementPropertySource.java;2;0;2;1;0;0;0;2;0;1;2;1434;0;0;1;0;0;2;2;1434;0;2951;2;2;
/org.eclipse.pde.ui/src/org/eclipse/pde/internal/base/model/plugin/IJars.java;2;0;2;1;0;0;0;2;0;1;2;1434;0;0;1;0;0;2;2;1434;0;2691;2;2;
/org.eclipse.jdt.core/model/org/eclipse/jdt/internal/core/util/IProgressListener.java;1;0;4;1;0;0;0;4;42;1;4;455;64;64;1;0;0;4;4;455;0;2811;4;1;
/org.eclipse.jdt.ui/core refactoring/org/eclipse/jdt/internal/corext/refactoring/surround/ExceptionAnalyzer.java;1;1;6;1;2;2;2;4;52;1;4;2327;99;99;1;0;0;4;6;2327;0;4422;6;1;
/org.eclipse.debug.ui/ui/org/eclipse/debug/internal/ui/actions/LaunchSelectionAction.java;2;0;4;1;0;0;0;4;4;1;4;2382;6;6;1;0;0;4;4;2382;0;3634;4;2;
/org.eclipse.jdt.ui.tests.refactoring/resources/PullUpMethods/testFail13/in/A.java;1;0;2;1;0;0;0;2;0;1;2;2286;0;0;1;0;0;2;2;2286;0;2406;2;1;
/org.eclipse.jdt.ui.tests.refactoring/resources/ExtractMethodWorkSpace/ExtractMethodTests/validSelection/A_test307.java;2;1;3;1;2;2;2;1;0;0;1;49;0;0;1;0;0;1;3;49;0;4419;3;2;
/org.eclipse.ui/Eclipse UI Text Editor/org/eclipse/ui/texteditor/BasicTextEditorActionContributor.java;5;2;13;2;5;4;5;8;76;1;8;257;387;387;2;0;1;8;13;4423;1;4838;12;5;
/org.eclipse.ui/Eclipse UI/org/eclipse/ui/INewWizard.java;2;0;2;1;0;0;0;2;5;1;2;257;5;5;1;0;0;2;2;257;0;457;2;2;
/org.eclipse.jdt.ui/ui/org/eclipse/jdt/internal/ui/launcher/OpenOnReceivingTypeAction.java;2;0;4;1;0;0;0;4;5;1;4;15;9;9;1;0;0;4;4;15;0;1916;4;2;
/org.eclipse.jdt.ui.tests.refactoring/resources/ExtractMethodWorkSpace/ExtractMethodTests/locals_in/A_test518.java;2;1;4;1;2;2;2;2;4;1;2;511;4;4;1;0;0;2;4;511;0;4419;4;2;
/org.eclipse.pde.ui/src/org/eclipse/pde/internal/ui/wizards/templates/PropertyPageNewWizard.java;1;0;3;1;0;0;0;3;8;1;3;3812;9;9;1;0;0;3;3;3812;0;3870;3;1;
/org.eclipse.jdt.ui.tests.refactoring/resources/RenameType/test11/out/A.java;1;0;2;1;0;0;0;2;0;1;2;49;0;0;1;0;0;2;2;49;0;522;2;1;
/org.eclipse.debug.ui/ui/org/eclipse/debug/internal/ui/DebugPluginImages.java;3;3;28;1;7;5;7;21;148;1;21;187;409;409;3;0;2;21;28;4001;2;4349;26;3;
/org.eclipse.jdt.ui.tests.refactoring/resources/RenameTemp/canRename/A_out.java;1;0;1;1;0;0;0;1;0;0;1;1625;0;0;1;0;0;1;1;1625;0;1625;1;1;
/org.eclipse.ui/Eclipse UI/org/eclipse/ui/internal/misc/Workbook.java;2;0;2;1;0;0;0;2;5;1;2;257;5;5;1;0;0;2;2;257;0;457;2;2;
/org.eclipse.core.tests.runtime/src/org/eclipse/core/tests/internal/plugins/ActivationTest_IndirectRef.java;4;0;4;1;0;0;0;4;164;1;4;1794;194;194;1;0;0;4;4;1794;0;3476;4;4;
/org.eclipse.jdt.core/ant/org/eclipse/jdt/core/ant/Jdtcom.java;1;0;13;1;0;0;0;13;94;4;8;676;135;135;4;5;0;13;13;1039;5;3285;8;1;
/org.eclipse.jdt.core/search/org/eclipse/jdt/internal/core/index/impl/WordEntryHashedArray.java;2;1;3;1;2;2;2;1;17;0;1;3836;31;31;1;0;0;1;3;3836;0;4063;3;2;
/org.eclipse.jdt.ui/ui/org/eclipse/jdt/internal/ui/text/java/ResultCollector.java;7;1;43;2;5;5;5;38;388;3;30;15;1294;1294;3;8;0;38;43;1619;8;4632;35;7;
/org.eclipse.jdt.ui/ui/org/eclipse/jdt/ui/actions/MoveAction.java;2;1;4;1;4;4;4;0;34;0;0;3970;47;47;1;0;0;0;4;3970;0;4770;4;2;
/org.eclipse.help/src/org/eclipse/help/internal/server/CSSEmbedProcessor.java;2;0;2;1;0;0;0;2;0;1;2;1420;0;0;1;0;0;2;2;1420;0;1675;2;2;
/org.eclipse.jdt.debug/eval/org/eclipse/jdt/internal/debug/eval/ast/instructions/MinusAssignmentOperator.java;2;0;5;1;1;1;1;4;4;1;4;3421;10;10;1;0;0;4;5;3421;0;3955;5;2;
/org.eclipse.debug.ui/ui/org/eclipse/debug/internal/ui/actions/LaunchDropDownAction.java;4;2;27;2;11;10;11;16;108;4;12;2382;571;571;4;4;1;16;27;3152;5;4693;22;4;
/org.eclipse.pde.ui/src/org/eclipse/pde/ui/templates/BooleanOption.java;1;0;2;1;1;1;1;1;42;0;1;3840;42;42;1;0;0;1;2;3840;0;4752;2;1;
/org.eclipse.jdt.core/dom/org/eclipse/jdt/core/dom/DoStatement.java;2;1;6;1;2;2;2;4;18;1;4;2669;52;52;1;0;0;4;6;2669;0;4453;6;2;
/org.eclipse.jdt.ui/ui/org/eclipse/jdt/internal/ui/ResourceLocator.java;2;0;3;1;1;1;1;2;23;1;2;15;31;31;1;0;0;2;3;15;0;4400;3;2;
/org.eclipse.ui.externaltools/External Tools/org/eclipse/ui/externaltools/internal/core/ExternalToolsRunner.java;1;2;4;1;4;3;4;0;6;0;0;4090;9;9;2;0;1;0;4;4382;1;4382;3;1;
/org.eclipse.swt/Eclipse SWT/gtk1x/org/eclipse/swt/widgets/FileDialog.java;4;0;4;1;1;1;1;3;131;1;3;2107;138;138;1;0;0;3;4;2107;0;4701;4;4;
/org.eclipse.ant.core/src/org/eclipse/ant/core/AntNotificationManager.java;2;0;2;1;0;0;0;2;0;1;2;2938;0;0;1;0;0;2;2;2938;0;3489;2;2;
/org.eclipse.jdt.ui.tests.refactoring/resources/StructureSelectionAction/A_test20.java;1;0;1;1;0;0;0;1;0;0;1;2139;0;0;1;0;0;1;1;2139;0;2139;1;1;
/org.eclipse.core.runtime/src/org/eclipse/core/internal/runtime/SafeFileOutputStream.java;4;0;6;1;1;1;1;5;232;1;5;12;272;272;1;0;0;5;6;12;0;4213;6;4;
/org.eclipse.jdt.ui.tests.refactoring/resources/ExtractMethodWorkSpace/ExtractMethodTests/return_in/A_test710.java;1;1;3;1;2;2;2;1;22;0;1;887;22;22;1;0;0;1;3;887;0;4419;3;1;
/org.eclipse.jdt.ui/ui refactoring/org/eclipse/jdt/internal/ui/refactoring/ModifyParametersInputPage.java;2;2;11;2;4;3;4;7;268;4;4;2820;435;435;4;3;1;7;11;2928;4;4722;7;2;
/org.eclipse.help.tests/src/org/eclipse/help/tests/base/TestHelpUrls.java;1;0;4;1;0;0;0;4;16;1;4;1865;22;22;1;0;0;4;4;1865;0;2862;4;1;
/org.eclipse.jdt.core/search/org/eclipse/jdt/internal/core/search/HierarchyScope.java;3;1;19;1;2;2;2;17;223;4;14;455;688;688;4;3;0;17;19;1039;3;4063;16;3;
/org.eclipse.core.runtime/src/org/eclipse/core/runtime/Platform.java;3;1;10;1;3;3;3;7;794;1;7;12;856;856;1;0;0;7;10;12;0;4409;10;3;
/org.eclipse.jdt.core/model/org/eclipse/jdt/core/CorrectionEngine.java;4;2;23;2;8;5;8;15;43;4;10;2675;248;248;4;5;3;15;23;3081;8;4832;15;4;
/org.eclipse.jdt.ui/core refactoring/org/eclipse/jdt/internal/corext/refactoring/base/Refactoring.java;2;0;4;2;0;0;0;4;56;2;3;1939;69;69;2;1;0;4;4;1939;1;3699;3;2;
/org.eclipse.vcm.tests.core/src/org/eclipse/vcm/tests/core/adapter/AllTests.java;1;0;1;1;0;0;0;1;0;0;1;1688;0;0;1;0;0;1;1;1688;0;1688;1;1;
/org.eclipse.core.resources/src/org/eclipse/core/internal/resources/IModelObjectConstants.java;2;0;5;1;2;1;2;3;72;1;3;12;150;150;2;0;1;3;5;4209;1;4209;4;2;
/org.eclipse.jdt.ui/ui/org/eclipse/jdt/internal/ui/reorg/JdtCopyAction.java;2;0;5;1;1;1;1;4;38;1;4;3222;53;53;1;0;0;4;5;3222;0;4212;5;2;
/org.eclipse.scripting/Eclipse Scripting/org/eclipse/scripting/ScriptAdapterWorkbenchResourceEditorContent.java;2;0;5;1;0;0;0;5;20;1;5;133;40;40;1;0;0;5;5;133;0;1424;5;2;
/org.eclipse.ui/Eclipse JFace/org/eclipse/jface/action/ToolBarManager.java;5;0;6;1;1;1;1;5;38;1;5;257;97;97;1;0;0;5;6;257;0;3901;6;5;
/org.eclipse.jdt.ui.tests.refactoring/resources/RenameVirtualMethodInClass/testFail13/in/A.java;1;0;1;1;0;0;0;1;0;0;1;49;0;0;1;0;0;1;1;49;0;49;1;1;
/org.eclipse.ui/Eclipse UI/org/eclipse/ui/internal/registry/WorkingSetDescriptor.java;1;1;6;1;3;3;3;3;99;1;3;3400;206;206;1;0;0;3;6;3400;0;4675;6;1;
/org.eclipse.swt/Eclipse SWT OLE Win32/win32/org/eclipse/swt/internal/ole/win32/IFont.java;2;0;3;1;0;0;0;3;9;1;3;106;9;9;1;0;0;3;3;106;0;2069;3;2;
/org.eclipse.pde.ui/src/org/eclipse/pde/internal/ui/editor/manifest/ManifestEditor.java;1;1;9;1;2;2;2;7;114;2;6;3579;198;198;2;1;0;7;9;3579;1;4545;8;1;
/org.eclipse.scripting/Eclipse Scripting/org/eclipse/scripting/internal/uirenderer/ScriptPreferenceNode.java;2;0;5;1;0;0;0;5;18;1;5;133;28;28;1;0;0;5;5;133;0;1424;5;2;
/org.eclipse.help/Eclipse Help/org/eclipse/help/internal/contributors/ContextManager.java;3;0;4;1;0;0;0;4;8;1;4;135;15;15;1;0;0;4;4;135;0;1420;4;3;
/org.eclipse.help/webapps/examples/WEB-INF/classes/dates/JspCalendar.java;1;0;2;1;0;0;0;2;0;1;2;1882;0;0;1;0;0;2;2;1882;0;1930;2;1;
/org.eclipse.jdt.debug/model/org/eclipse/jdt/internal/debug/core/JDIFieldVariable.java;4;0;13;1;0;0;0;13;47;2;12;187;204;204;2;1;0;13;13;1471;1;2517;12;4;
/org.eclipse.jdt.ui.tests.refactoring/resources/ExtractMethodWorkSpace/ExtractMethodTests/return_out/A_test720.java;1;1;3;1;2;2;2;1;38;0;1;1368;38;38;1;0;0;1;3;1368;0;4419;3;1;
/org.eclipse.ui.tests/Eclipse UI Tests/org/eclipse/ui/tests/api/IEditorRegistryTest.java;3;0;9;1;0;0;0;9;285;1;9;983;341;341;1;0;0;9;9;983;0;2785;9;3;
/org.eclipse.core.boot/src/org/eclipse/core/internal/boot/update/UMRegistryManager.java;5;0;8;1;0;0;0;8;87;1;8;12;236;236;1;0;0;8;8;12;0;2726;8;5;
/org.eclipse.pde.ui/src/org/eclipse/pde/internal/core/builders/DependencyLoop.java;1;0;2;1;0;0;0;2;0;1;2;3579;0;0;1;0;0;2;2;3579;0;3607;2;1;
/org.eclipse.swt/Eclipse SWT/gtk/org/eclipse/swt/widgets/UtilFuncs.java;2;0;4;1;0;0;0;4;103;1;4;2107;129;129;1;0;0;4;4;2107;0;3330;4;2;
/org.eclipse.swt/Eclipse SWT/carbon/org/eclipse/swt/graphics/GC.java;4;1;5;1;5;5;5;0;42;0;0;4147;79;79;1;0;0;0;5;4147;0;4701;5;4;
/org.eclipse.jdt.ui.tests.refactoring/resources/SurroundWithWorkSpace/SurroundWithTests/trycatch_out/TestMultiLine.java;1;0;2;1;0;0;0;2;2;1;2;2327;2;2;1;0;0;2;2;2327;0;3870;2;1;
/org.eclipse.debug.core/core/org/eclipse/debug/core/model/ISourceLocator.java;3;0;6;1;0;0;0;6;17;1;6;187;28;28;1;0;0;6;6;187;0;3474;6;3;
/org.eclipse.help.ui/src/org/eclipse/help/ui/internal/browser/aix/NetscapeFactory.java;2;0;4;1;1;1;1;3;20;1;3;2429;24;24;1;0;0;3;4;2429;0;4439;4;2;
/org.eclipse.jdt.ui.tests.refactoring/resources/ExtractMethodWorkSpace/ExtractMethodTests/expression_out/A_test601.java;2;1;4;1;2;2;2;2;22;1;2;239;23;23;1;0;0;2;4;239;0;4419;4;2;
/org.eclipse.ui/Eclipse UI/org/eclipse/ui/internal/dialogs/ActionSetSelectionDialog.java;7;1;13;2;2;2;2;11;17;2;10;257;89;89;2;1;0;11;13;1097;1;4151;12;7;
/org.eclipse.jdt.core/compiler/org/eclipse/jdt/internal/compiler/lookup/MethodScope.java;2;1;16;1;3;3;3;13;609;4;10;455;1446;1446;4;3;0;13;16;1039;3;4421;13;2;
/org.eclipse.jdt.ui.tests.refactoring/resources/RenamePackage/test4/in/p/A.java;2;0;2;1;0;0;0;2;0;1;2;91;0;0;1;0;0;2;2;91;0;1258;2;2;
/org.eclipse.swt.tests/JUnit Tests/org/eclipse/swt/tests/junit/Test_org_eclipse_swt_widgets_Scrollable.java;2;0;2;1;1;1;1;1;6;0;1;1792;6;6;1;0;0;1;2;1792;0;4706;2;2;
/org.eclipse.jdt.ui.tests.refactoring/resources/ExtractMethodWorkSpace/ExtractMethodTests/validSelection/A_test304.java;2;1;3;1;2;2;2;1;0;0;1;49;0;0;1;0;0;1;3;49;0;4419;3;2;
/org.eclipse.team.ui/src/org/eclipse/team/internal/ui/ConfigurationWizardNode.java;2;0;3;1;0;0;0;3;130;1;3;1978;132;132;1;0;0;3;3;1978;0;3642;3;2;
/org.eclipse.jdt.ui/core refactoring/org/eclipse/jdt/internal/corext/refactoring/base/Change.java;2;1;3;1;2;2;2;1;2;0;1;1939;4;4;1;0;0;1;3;1939;0;4427;3;2;
/org.eclipse.webdav/src/kernel/org/eclipse/webdav/internal/kernel/Policy.java;3;0;8;1;1;1;1;7;178;1;7;399;252;252;1;0;0;7;8;399;0;4211;8;3;
/org.eclipse.pde.ui/src/org/eclipse/pde/internal/util/ChoicePropertyDescriptor.java;1;0;2;1;0;0;0;2;0;1;2;3113;0;0;1;0;0;2;2;3113;0;3579;2;1;
/org.eclipse.webdav/src/interface/org/eclipse/webdav/dom/PropFind.java;3;0;5;1;1;1;1;4;408;1;4;12;500;500;1;0;0;4;5;12;0;4211;5;3;
/org.eclipse.jdt.ui.tests.refactoring/resources/RenameNonPrivateField/test4/out/A.java;1;0;1;1;0;0;0;1;0;0;1;49;0;0;1;0;0;1;1;49;0;49;1;1;
/org.eclipse.swt/Eclipse SWT/motif/org/eclipse/swt/internal/motif/CDE.java;2;0;2;1;0;0;0;2;0;1;2;650;0;0;1;0;0;2;2;650;0;2069;2;2;
/org.eclipse.ui/Eclipse UI Standard Components/org/eclipse/ui/views/internal/framelist/TreeFrame.java;3;0;4;1;0;0;0;4;4;1;4;257;8;8;1;0;0;4;4;257;0;3816;4;3;
/org.eclipse.team.ftp/src/org/eclipse/team/internal/ftp/client/FTPClient.java;2;3;14;1;14;11;14;0;181;0;0;4169;392;392;3;0;3;0;14;4285;3;4731;11;2;
/org.eclipse.jdt.ui/ui refactoring/org/eclipse/jdt/internal/ui/refactoring/actions/structureselection/StructureSelectionAction.java;2;0;14;2;0;0;0;14;79;2;11;2273;190;190;2;3;0;14;14;2527;3;3188;11;2;
/org.eclipse.jdt.ui/core extension/org/eclipse/jdt/internal/corext/codemanipulation/NopTextEdit.java;1;0;2;1;0;0;0;2;0;0;1;2133;0;0;2;1;0;2;2;2133;1;2133;1;1;
/org.eclipse.jdt.ui/ui/org/eclipse/jdt/internal/ui/viewsupport/SelectionProviderMediator.java;3;0;5;1;0;0;0;5;12;1;5;15;19;19;1;0;0;5;5;15;0;1464;5;3;
/org.eclipse.jdt.junit/src/org/eclipse/jdt/internal/junit/ui/JavaBrowsingMessages.java;1;0;1;1;1;1;1;0;0;0;0;4254;0;0;1;0;0;0;1;4254;0;4254;1;1;
/org.eclipse.scripting/Eclipse Scripting/org/eclipse/scripting/internal/IXGRDataModel.java;1;0;3;1;0;0;0;3;4;1;3;133;4;4;1;0;0;3;3;133;0;1424;3;1;
/org.eclipse.jdt.ui/ui/org/eclipse/jdt/internal/ui/packageview/ShowInNavigatorAction.java;4;0;8;1;1;1;1;7;24;1;7;204;47;47;1;0;0;7;8;204;0;4450;8;4;
/org.eclipse.pde.build/src/org/eclipse/pde/internal/build/ant/ConditionTask.java;1;0;5;1;1;1;1;4;10;2;3;3194;16;16;2;1;0;4;5;3571;1;4273;4;1;
/org.eclipse.jdt.ui.tests.refactoring/resources/ExtractMethodWorkSpace/ExtractMethodTests/locals_out/A_test501.java;2;1;4;1;2;2;2;2;24;1;2;80;26;26;1;0;0;2;4;80;0;4419;4;2;
/org.eclipse.debug.ui/ui/org/eclipse/debug/internal/ui/actions/DebugDropDownAction.java;4;1;9;1;3;3;3;6;13;1;6;2382;43;43;1;0;0;6;9;2382;0;4068;9;4;
/org.eclipse.debug.ui/ui/org/eclipse/debug/internal/ui/views/AbstractDebugEventHandler.java;3;0;10;1;1;1;1;9;62;1;9;2344;124;124;1;0;0;9;10;2344;0;3975;10;3;
/org.eclipse.swt/Eclipse SWT Custom Widgets/common/org/eclipse/swt/custom/CTabFolderAdapter.java;2;0;3;1;1;1;1;2;6;1;2;106;12;12;1;0;0;2;3;106;0;4701;3;2;
/org.eclipse.swt.examples.paint/org/eclipse/swt/examples/paint/DragInteractivePaintSession.java;1;0;1;1;0;0;0;1;0;0;1;513;0;0;1;0;0;1;1;513;0;513;1;1;
/org.eclipse.jdt.ui.tests.refactoring/resources/DeleteSourceReference/A_testField1_in.java;1;0;2;1;0;0;0;2;0;1;2;2003;0;0;1;0;0;2;2;2003;0;2857;2;1;
/org.eclipse.vcm.ui/src/org/eclipse/vcm/internal/ui/model/TeamStreamElement.java;4;0;4;1;0;0;0;4;36;1;4;1;62;62;1;0;0;4;4;1;0;1436;4;4;
/org.eclipse.pde.ui/src/org/eclipse/pde/internal/model/feature/FeatureInfo.java;1;0;4;1;0;0;0;4;49;2;3;2951;55;55;2;1;0;4;4;2951;1;3579;3;1;
/org.eclipse.core.boot/src/org/eclipse/core/internal/boot/update/UMEclipseTree.java;4;0;9;2;0;0;0;9;32;2;7;12;89;89;2;2;0;9;9;258;2;2726;7;4;
/org.eclipse.scripting.examples/Eclipse Scripting Examples/org/eclipse/scripting/examples/ExcaliburWorkbenchNewWizardAdapter.java;1;0;3;1;0;0;0;3;4;1;3;134;4;4;1;0;0;3;3;134;0;1424;3;1;
/org.eclipse.jdt.ui.tests.refactoring/resources/MoveMembers/testFail6/in/B.java;1;0;1;1;0;0;0;1;0;0;1;2738;0;0;1;0;0;1;1;2738;0;2738;1;1;
/org.eclipse.update.ui/src/org/eclipse/update/internal/ui/pages/InstallableSitePage.java;1;0;2;1;0;0;0;2;3;1;2;3537;3;3;1;0;0;2;2;3537;0;3662;2;1;
/org.eclipse.jdt.core/model/org/eclipse/jdt/internal/core/NonVoidMethodRequestor.java;2;0;9;1;1;1;1;8;28;4;5;455;64;64;4;3;0;8;9;1039;3;4063;6;2;
/org.eclipse.compare/compare/org/eclipse/compare/internal/ListContentProvider.java;1;0;1;1;0;0;0;1;0;0;1;2876;0;0;1;0;0;1;1;2876;0;2876;1;1;
/org.eclipse.scripting/src/org/eclipse/scripting/internal/uirenderer/ScriptPreferenceNode.java;1;0;1;1;0;0;0;1;0;0;1;1424;0;0;1;0;0;1;1;1424;0;1424;1;1;
/org.eclipse.scripting/Eclipse Scripting/org/eclipse/scripting/internal/views/ScriptUIPreviewEditorContent.java;2;0;4;1;0;0;0;4;19;1;4;133;35;35;1;0;0;4;4;133;0;1424;4;2;
/org.eclipse.ui/Eclipse UI/org/eclipse/ui/internal/CoolItemMultiToolBarManager.java;1;1;2;1;2;2;2;0;6;0;0;4453;6;6;1;0;0;0;2;4453;0;4569;2;1;
/org.eclipse.jdt.ui.tests/refactoring/org/eclipse/jdt/refactoring/tests/CopyPackageChangeTest.java;2;0;3;1;0;0;0;3;4;1;3;1258;4;4;1;0;0;3;3;1258;0;1896;3;2;
/org.eclipse.jdt.ui.tests.refactoring/resources/SurroundWithWorkSpace/SurroundWithTests/trycatch_in/TestOneLine.java;1;0;1;1;0;0;0;1;0;0;1;2327;0;0;1;0;0;1;1;2327;0;2327;1;1;
/org.eclipse.jdt.ui/core extension/org/eclipse/jdt/internal/corext/dom/Bindings.java;3;0;9;1;1;1;1;8;178;2;7;2915;307;307;2;1;0;8;9;3737;1;4383;8;3;
/org.eclipse.core.runtime/src/org/eclipse/core/internal/plugins/ConfigurationElement.java;3;2;7;1;3;2;3;4;312;1;4;12;360;360;2;0;1;4;7;4212;1;4855;6;3;
/org.eclipse.ui/Eclipse UI/org/eclipse/ui/internal/dialogs/WizardNewProjectCapabilityPage.java;2;0;6;1;1;1;1;5;25;1;5;3186;55;55;1;0;0;5;6;3186;0;3975;6;2;
/org.eclipse.jdt.junit/src/org/eclipse/jdt/internal/junit/ui/JavaModelUtil.java;1;0;2;1;1;1;1;1;0;0;1;3171;0;0;1;0;0;1;2;3171;0;4232;2;1;
/org.eclipse.pde.ui/Eclipse PDE UI/org/eclipse/pde/internal/base/model/component/IComponentModelFactory.java;2;0;5;2;0;0;0;5;12;3;3;267;12;12;3;2;0;5;5;324;2;1434;3;2;
/org.eclipse.swt.examples/Eclipse SWT Examples/common/org/eclipse/swt/examples/helloworld/HelloWorld1.java;1;0;2;1;0;0;0;2;0;1;2;107;0;0;1;0;0;2;2;107;0;611;2;1;
/org.eclipse.jdt.core/model/org/eclipse/jdt/internal/core/builder/IState.java;1;0;3;1;0;0;0;3;71;1;3;455;71;71;1;0;0;3;3;455;0;2808;3;1;
/org.eclipse.jdt.core/dom/org/eclipse/jdt/core/dom/PostfixExpression.java;2;2;7;1;3;2;3;4;13;1;4;2669;41;41;2;0;1;4;7;4452;1;4452;6;2;
/org.eclipse.swt/Eclipse SWT/common/org/eclipse/swt/layout/FormLayout.java;3;1;8;2;2;2;2;6;174;2;4;2880;262;262;2;2;0;6;8;2880;2;4701;6;3;
/org.eclipse.jdt.launching/launching/org/eclipse/jdt/launching/ExecutionArguments.java;3;1;9;1;4;4;4;5;167;1;5;2022;277;277;1;0;0;5;9;2022;0;4610;9;3;
/org.eclipse.team.cvs.ui/src/org/eclipse/team/internal/ccvs/ui/merge/GetMergeAction.java;1;0;2;1;0;0;0;2;0;1;2;2673;0;0;1;0;0;2;2;2673;0;2828;2;1;
/org.eclipse.update.ui/src/org/eclipse/update/internal/ui/wizards/TargetPage.java;3;2;30;2;13;10;13;17;178;2;16;1843;848;848;2;1;3;17;30;3584;4;4610;26;3;
/org.eclipse.jdt.ui.tests.refactoring/resources/ExtractMethodWorkSpace/ExtractMethodTests/semicolon_in/A_test406.java;2;1;4;1;2;2;2;2;8;1;2;178;14;14;1;0;0;2;4;178;0;4419;4;2;
/org.eclipse.ui.examples.javaeditor/Eclipse Java Editor Example/org/eclipse/ui/examples/javaeditor/JavaAnnotationHover.java;1;0;1;1;0;0;0;1;0;0;1;1067;0;0;1;0;0;1;1;1067;0;1067;1;1;
/org.eclipse.scripting/Eclipse Scripting/org/eclipse/scripting/internal/uirenderer/IScriptPreferenceNode.java;2;0;4;1;0;0;0;4;14;1;4;133;21;21;1;0;0;4;4;133;0;1424;4;2;
/org.eclipse.pde.ui/src/org/eclipse/pde/internal/base/schema/ISchemaObject.java;2;0;3;1;0;0;0;3;1;1;3;1434;1;1;1;0;0;3;3;1434;0;3579;3;2;
/org.eclipse.debug.core/core/org/eclipse/debug/core/model/IStep.java;3;0;6;1;1;1;1;5;24;1;5;187;50;50;1;0;0;5;6;187;0;4652;6;3;
/org.eclipse.swt.examples/src/org/eclipse/swt/examples/controlexample/ShellTab.java;5;1;7;1;3;3;3;4;380;1;4;513;686;686;1;0;0;4;7;513;0;4705;7;5;
/org.eclipse.pde.ui/Eclipse PDE UI/org/eclipse/pde/internal/editor/SelectionProvider.java;2;0;5;2;0;0;0;5;12;3;3;267;12;12;3;2;0;5;5;324;2;1434;3;2;
/org.eclipse.jdt.debug.tests/testprograms/StaticVariablesTests.java;2;0;2;1;1;1;1;1;11;0;1;3719;11;11;1;0;0;1;2;3719;0;4571;2;2;
/org.eclipse.pde.ui/src/org/eclipse/pde/internal/ui/feature/FeatureSpecPage.java;1;0;1;1;0;0;0;1;0;0;1;3579;0;0;1;0;0;1;1;3579;0;3579;1;1;
/org.eclipse.jdt.ui.tests/JUnit/junit/extensions/RepeatedTest.java;2;0;2;1;0;0;0;2;0;1;2;49;0;0;1;0;0;2;2;49;0;1186;2;2;
/org.eclipse.swt/Eclipse SWT/photon/org/eclipse/swt/graphics/GCData.java;3;1;5;1;2;2;2;3;12;1;3;106;26;26;1;0;0;3;5;106;0;4701;5;3;
/org.eclipse.swt/Eclipse SWT OLE Win32/win32/org/eclipse/swt/internal/ole/win32/DISPPARAMS.java;2;0;3;1;0;0;0;3;5;1;3;106;5;5;1;0;0;3;3;106;0;2069;3;2;
/org.eclipse.ui/Eclipse UI/org/eclipse/ui/internal/registry/RegistryReader.java;2;0;2;1;0;0;0;2;17;1;2;257;17;17;1;0;0;2;2;257;0;457;2;2;
/org.eclipse.jdt.ui.tests.refactoring/resources/ExtractMethodWorkSpace/ExtractMethodTests/locals_out/A_test536.java;1;1;5;1;2;2;2;3;32;1;3;922;41;41;1;0;0;3;5;922;0;4419;5;1;
/org.eclipse.jdt.ui.tests.refactoring/resources/RenamePackage/test4/out/p/A.java;2;0;2;1;0;0;0;2;0;1;2;91;0;0;1;0;0;2;2;91;0;1258;2;2;
/org.eclipse.team.cvs.core/src/org/eclipse/team/internal/ccvs/core/util/Assert.java;2;0;2;1;0;0;0;2;194;1;2;1978;194;194;1;0;0;2;2;1978;0;2791;2;2;
/org.eclipse.help/src/org/eclipse/help/internal/remote/ServletFacade.java;1;0;2;1;0;0;0;2;0;1;2;1420;0;0;1;0;0;2;2;1420;0;1502;2;1;
/org.eclipse.ui.tests/Eclipse UI Tests/org/eclipse/ui/tests/api/IWorkbenchPageTest.java;5;0;19;1;0;0;0;19;802;2;18;881;1551;1551;2;1;0;19;19;1039;1;3378;18;5;
/org.eclipse.jdt.debug.ui/ui/org/eclipse/jdt/internal/debug/ui/JavaConditionalBreakpointListener.java;2;0;4;1;0;0;0;4;78;1;4;3329;123;123;1;0;0;4;4;3329;0;3558;4;2;
/org.eclipse.webdav/src/interface/org/eclipse/webdav/dom/ElementEditor.java;4;0;6;1;1;1;1;5;3814;1;5;12;3943;3943;1;0;0;5;6;12;0;4211;6;4;
/org.eclipse.jdt.ui/ui/org/eclipse/jdt/internal/ui/util/TypeInfoRequestor.java;2;0;4;1;0;0;0;4;33;2;3;1258;33;33;2;1;0;4;4;2820;1;3069;3;2;
/org.eclipse.help/src/org/eclipse/help/internal/toc/HrefUtil.java;2;0;7;1;1;1;1;6;29;1;6;1857;41;41;1;0;0;6;7;1857;0;4529;7;2;
/org.eclipse.jdt.core/model/org/eclipse/jdt/internal/core/IncrementalDeterministicRequestor.java;1;0;2;1;0;0;0;2;0;1;2;455;0;0;1;0;0;2;2;455;0;632;2;1;
/org.eclipse.core.tests.resources/src/org/eclipse/core/tests/resources/regression/IWorkspaceTest.java;3;0;6;2;1;1;1;5;398;2;4;1794;573;573;2;1;0;5;6;3251;1;4516;5;3;
/org.eclipse.jdt.ui.tests.refactoring/resources/RenameParameters/canRename/A_test34_in.java;1;0;1;1;0;0;0;1;0;0;1;2751;0;0;1;0;0;1;1;2751;0;2751;1;1;
/org.eclipse.jdt.debug.ui/ui/org/eclipse/jdt/internal/debug/ui/launcher/RuntimeClasspathAdvancedDialog.java;2;2;6;2;6;4;6;0;85;0;0;4188;119;119;2;0;2;0;6;4188;2;4386;4;2;
/org.eclipse.swt.tests/JUnit Tests/org/eclipse/swt/tests/junit/Test_org_eclipse_swt_layout_RowLayout.java;2;0;2;1;1;1;1;1;6;0;1;1792;6;6;1;0;0;1;2;1792;0;4706;2;2;
/org.eclipse.jdt.core/model/org/eclipse/jdt/internal/core/builder/impl/SourceEntry.java;1;0;10;1;0;0;0;10;130;4;6;455;238;238;4;4;0;10;10;1039;4;2808;6;1;
/org.eclipse.help/src/org/eclipse/help/internal/contributions/xml/HelpInfoView.java;2;0;2;1;0;0;0;2;0;1;2;1420;0;0;1;0;0;2;2;1420;0;1675;2;2;
/org.eclipse.jdt.ui.tests.refactoring/resources/ExtractMethodWorkSpace/ExtractMethodTests/locals_in/A_test520.java;1;1;3;1;2;2;2;1;0;0;1;922;0;0;1;0;0;1;3;922;0;4419;3;1;
/org.eclipse.jdt.ui/ui/org/eclipse/jdt/internal/ui/wizards/dialogfields/StringButtonStatusDialogField.java;2;0;5;1;0;0;0;5;40;1;5;15;56;56;1;0;0;5;5;15;0;3084;5;2;
/org.eclipse.jdt.ui.tests.refactoring/resources/SelectionAnalyzerWorkSpace/SelectionAnalyzerTests/invalidSelection/A_test115.java;1;0;1;1;0;0;0;1;0;0;1;1368;0;0;1;0;0;1;1;1368;0;1368;1;1;
/org.eclipse.jdt.ui/core refactoring/org/eclipse/jdt/core/refactoring/methods/RenameStaticMethodRefactoring.java;1;0;6;1;0;0;0;6;10;1;6;15;23;23;1;0;0;6;6;15;0;408;6;1;
/org.eclipse.jdt.ui/ui debug/org/eclipse/jdt/internal/debug/ui/JavaApplicationWizard.java;3;0;5;1;0;0;0;5;24;1;5;15;44;44;1;0;0;5;5;15;0;1916;5;3;
/org.eclipse.jdt.core/codeassist/org/eclipse/jdt/internal/codeassist/select/SelectionOnQualifiedAllocationExpression.java;2;0;11;1;1;1;1;10;73;4;7;455;158;158;4;3;0;10;11;1039;3;4062;8;2;
/org.eclipse.pde.core/src/org/eclipse/pde/internal/core/plugin/ImportObject.java;1;0;3;1;1;1;1;2;7;1;2;3591;12;12;1;0;0;2;3;3591;0;4552;3;1;
/org.eclipse.pde.ui/src/org/eclipse/pde/internal/editor/feature/URLSection.java;1;0;6;1;0;0;0;6;358;2;5;2951;373;373;2;1;0;6;6;2951;1;3579;5;1;
/org.eclipse.ant.core/src/org/eclipse/ant/internal/core/IAntCoreConstants.java;1;0;5;1;1;1;1;4;25;2;3;3490;48;48;2;1;0;4;5;3575;1;4273;4;1;
/org.eclipse.jdt.debug/eval/org/eclipse/jdt/internal/debug/eval/ast/engine/SendMessage.java;1;0;3;1;0;0;0;3;130;1;3;3329;130;130;1;0;0;3;3;3329;0;3421;3;1;
/org.eclipse.jdt.ui.tests.refactoring/resources/PasteSourceReference/test0/in/A.java;1;0;1;1;0;0;0;1;0;0;1;2003;0;0;1;0;0;1;1;2003;0;2003;1;1;
/org.eclipse.jdt.ui.tests.refactoring/resources/RenamePrivateMethod/testFail0/in/A.java;1;0;1;1;0;0;0;1;0;0;1;49;0;0;1;0;0;1;1;49;0;49;1;1;
/org.eclipse.ui/Eclipse UI/org/eclipse/ui/internal/PluginActionSetReader.java;2;0;2;1;0;0;0;2;5;1;2;257;5;5;1;0;0;2;2;257;0;457;2;2;
/org.eclipse.ui/Eclipse UI/org/eclipse/ui/model/IWorkbenchAdapter.java;2;0;2;1;0;0;0;2;5;1;2;257;5;5;1;0;0;2;2;257;0;457;2;2;
/org.eclipse.jdt.core/compiler/org/eclipse/jdt/core/compiler/ITerminalSymbols.java;1;0;4;1;0;0;0;4;285;2;3;3349;295;295;2;1;0;4;4;3373;1;3423;3;1;
/org.eclipse.pde.ui/src/org/eclipse/pde/internal/ui/editor/manifest/ResourceAttributeDescriptor.java;1;0;1;1;0;0;0;1;0;0;1;3579;0;0;1;0;0;1;1;3579;0;3579;1;1;
/org.eclipse.swt/Eclipse SWT/gtk1x/org/eclipse/swt/graphics/Pixbuffer.java;2;0;2;1;1;1;1;1;6;0;1;2107;6;6;1;0;0;1;2;2107;0;4701;2;2;
/org.eclipse.swt/Eclipse SWT/common/org/eclipse/swt/graphics/ImageLoader.java;5;0;7;1;1;1;1;6;9;1;6;106;30;30;1;0;0;6;7;106;0;4701;7;5;
/org.eclipse.team.cvs.core/src/org/eclipse/team/internal/ccvs/core/client/ResponseHandler.java;2;0;7;1;0;0;0;7;73;1;7;2572;130;130;1;0;0;7;7;2572;0;3739;7;2;
/org.eclipse.update.core/src/org/eclipse/update/internal/model/ConfiguredSiteModel.java;2;1;5;1;3;3;3;2;21;1;2;3027;38;38;1;0;0;2;5;3027;0;4260;5;2;
/org.eclipse.jdt.core/model/org/eclipse/jdt/core/IPackageDeclaration.java;2;1;6;1;3;3;3;3;20;1;3;455;57;57;1;0;0;3;6;455;0;4421;6;2;
/org.eclipse.pde.ui/src/org/eclipse/pde/internal/model/PluginAttribute.java;2;0;6;1;0;0;0;6;7;1;6;1434;21;21;1;0;0;6;6;1434;0;3136;6;2;
/org.eclipse.pde.ui/Eclipse PDE UI/org/eclipse/pde/internal/schema/ChoiceRestriction.java;2;0;6;2;0;0;0;6;12;3;4;267;13;13;3;2;0;6;6;324;2;1434;4;2;
/org.eclipse.core.resources/src/org/eclipse/core/internal/resources/ResourceStatus.java;2;0;6;1;1;1;1;5;152;1;5;12;207;207;1;0;0;5;6;12;0;4213;6;2;
/org.eclipse.jdt.debug/eval/org/eclipse/jdt/internal/debug/eval/ast/instructions/PushLong.java;2;0;3;1;0;0;0;3;2;1;3;3421;4;4;1;0;0;3;3;3421;0;3677;3;2;
/org.eclipse.pde.ui/src/org/eclipse/pde/internal/ui/ischema/ISchemaDescriptor.java;1;0;2;1;0;0;0;2;0;1;2;3579;0;0;1;0;0;2;2;3579;0;3591;2;1;
/org.eclipse.jdt.ui.tests.refactoring/resources/MoveMembers/testFail18/in/B.java;1;0;1;1;0;0;0;1;0;0;1;2738;0;0;1;0;0;1;1;2738;0;2738;1;1;
/org.eclipse.jdt.ui.tests.refactoring/resources/RenameType/test49/out/A.java;1;0;2;1;0;0;0;2;0;1;2;49;0;0;1;0;0;2;2;49;0;522;2;1;
/org.eclipse.swt/Eclipse SWT Custom Widgets/common/org/eclipse/swt/custom/WrappedContent.java;3;0;5;1;1;1;1;4;30;1;4;2502;48;48;1;0;0;4;5;2502;0;4701;5;3;
/org.eclipse.jdt.ui/ui/org/eclipse/jdt/internal/ui/javaeditor/ClassFileMarkerAnnotationModel.java;3;0;6;1;0;0;0;6;57;1;6;15;116;116;1;0;0;6;6;15;0;2862;6;3;
/org.eclipse.jdt.core/compiler/org/eclipse/jdt/internal/compiler/ast/IntLiteral.java;2;0;4;1;1;1;1;3;291;1;3;455;307;307;1;0;0;3;4;455;0;4062;4;2;
/org.eclipse.jdt.ui/ui refactoring/org/eclipse/jdt/internal/ui/refactoring/actions/PerformRefactoringUtil.java;1;0;1;1;0;0;0;1;0;0;1;2297;0;0;1;0;0;1;1;2297;0;2297;1;1;
/org.eclipse.help/src/org/eclipse/help/internal/search/Analyzer_en.java;1;0;2;1;0;0;0;2;41;1;2;3213;41;41;1;0;0;2;2;3213;0;3416;2;1;
/org.eclipse.jdt.ui.tests/ui/org/eclipse/jdt/ui/tests/core/JavaModelUtilTest.java;1;0;8;1;0;0;0;8;183;2;7;1363;236;236;2;1;0;8;8;1363;1;2805;7;1;
/org.eclipse.update/Eclipse Update/org/eclipse/update/internal/core/URLHandler.java;2;0;5;2;0;0;0;5;8;2;4;108;14;14;2;1;0;5;5;323;1;1424;4;2;
/org.eclipse.search/search/org/eclipse/search/internal/ui/util/HackFinder.java;1;0;2;1;0;0;0;2;10;1;2;15;10;10;1;0;0;2;2;15;0;343;2;1;
/org.eclipse.help/Eclipse Help/org/eclipse/help/internal/contributors/ContributorCreator.java;2;0;3;1;0;0;0;3;7;1;3;135;7;7;1;0;0;3;3;135;0;1420;3;2;
/org.eclipse.swt/Eclipse SWT/motif/org/eclipse/swt/widgets/Display.java;11;2;53;3;8;7;8;45;1089;3;34;106;3287;3287;3;11;1;45;53;2058;12;4701;41;11;
/org.eclipse.jdt.core/model/org/eclipse/jdt/internal/core/builder/IReportCard.java;1;0;3;1;0;0;0;3;86;1;3;455;86;86;1;0;0;3;3;455;0;2808;3;1;
/org.eclipse.compare/compare/org/eclipse/compare/internal/patch/PatchMessages.java;1;0;1;1;0;0;0;1;0;0;1;2876;0;0;1;0;0;1;1;2876;0;2876;1;1;
/org.eclipse.help/src/org/eclipse/help/internal/search/WordTokenStream.java;1;0;1;1;0;0;0;1;0;0;1;3701;0;0;1;0;0;1;1;3701;0;3701;1;1;
/org.eclipse.jdt.ui/ui/org/eclipse/jdt/ui/ProblemsLabelDecorator.java;3;1;8;1;8;8;8;0;57;0;0;4018;151;151;1;0;0;0;8;4018;0;4810;8;3;
/org.eclipse.jdt.ui.tests.refactoring/resources/RenameVariables/canRename/A_test16_out.java;1;0;2;1;0;0;0;2;0;1;2;724;0;0;1;0;0;2;2;724;0;1665;2;1;
/org.eclipse.jdt.ui.tests.refactoring/resources/RenameTemp/canRename/A_test38_out.java;1;0;1;1;0;0;0;1;0;0;1;3226;0;0;1;0;0;1;1;3226;0;3226;1;1;
/org.eclipse.jdt.ui/core refactoring/org/eclipse/jdt/internal/corext/refactoring/code/StatementAnalyzer.java;2;0;5;1;0;0;0;5;77;1;5;1939;86;86;1;0;0;5;5;1939;0;2481;5;2;
/org.eclipse.vcm.tests.core/src/org/eclipse/vcm/tests/core/SniffTests.java;1;0;1;1;0;0;0;1;0;0;1;1688;0;0;1;0;0;1;1;1688;0;1688;1;1;
/org.eclipse.pde.ui/src/org/eclipse/pde/internal/ui/OpenPDEPerspectiveAction.java;1;0;1;1;1;1;1;0;0;0;0;4612;0;0;1;0;0;0;1;4612;0;4612;1;1;
/org.eclipse.jdt.ui.tests.refactoring/resources/RenameType/testFail48/in/A.java;1;0;1;1;0;0;0;1;0;0;1;49;0;0;1;0;0;1;1;49;0;49;1;1;
/org.eclipse.team.tests.cvs.core/src/org/eclipse/team/tests/ccvs/core/CVSTestSetup.java;3;0;15;2;2;1;2;13;87;2;12;2536;222;222;2;1;1;13;15;2977;2;4568;13;3;
/org.eclipse.swt/Eclipse SWT Drag and Drop/gtk/org/eclipse/swt/dnd/Clipboard.java;3;2;12;1;9;6;9;3;340;1;3;2107;698;698;2;0;3;3;12;4016;3;4824;9;3;
/org.eclipse.pde.ui/src/org/eclipse/pde/internal/model/component/ComponentObject.java;2;0;3;1;0;0;0;3;2;1;3;1434;2;2;1;0;0;3;3;1434;0;2951;3;2;
/org.eclipse.swt/Eclipse SWT/motif/org/eclipse/swt/graphics/Image.java;8;1;22;1;4;4;4;18;371;1;18;106;864;864;1;0;0;18;22;106;0;4701;22;8;
/org.eclipse.jdt.ui/ui/org/eclipse/jdt/internal/ui/launcher/DebugOverlayDescriptorFactory.java;2;0;4;1;0;0;0;4;21;1;4;15;27;27;1;0;0;4;4;15;0;1310;4;2;
/org.eclipse.jdt.debug/eval/org/eclipse/jdt/debug/eval/ast/model/IArray.java;1;0;2;1;0;0;0;2;0;1;2;3329;0;0;1;0;0;2;2;3329;0;3421;2;1;
/org.eclipse.vcm.tests.core/src/org/eclipse/vcm/tests/core/TestsUserAuthenticator.java;1;0;1;1;0;0;0;1;0;0;1;1700;0;0;1;0;0;1;1;1700;0;1700;1;1;
/org.eclipse.ui/Eclipse UI/org/eclipse/ui/internal/dialogs/NewWizardNewPage.java;5;0;6;1;0;0;0;6;14;1;6;257;37;37;1;0;0;6;6;257;0;3720;6;5;
/org.eclipse.jdt.core/compiler/org/eclipse/jdt/internal/compiler/parser/SourceFieldDeclaration.java;2;0;3;1;1;1;1;2;19;1;2;455;34;34;1;0;0;2;3;455;0;4062;3;2;
/org.eclipse.jdt.ui.tests.refactoring/resources/MoveMembers/testFail5/in/B.java;1;0;1;1;0;0;0;1;0;0;1;2738;0;0;1;0;0;1;1;2738;0;2738;1;1;
/org.eclipse.pde.ui/src/org/eclipse/pde/internal/ui/editor/manifest/UnknownElementPropertySource.java;1;0;2;1;0;0;0;2;30;0;1;3579;30;30;2;1;0;2;2;3579;1;3579;1;1;
/org.eclipse.ant.ui/src/org/eclipse/ant/internal/ui/AntTreeContentProvider.java;3;0;3;1;0;0;0;3;126;1;3;981;144;144;1;0;0;3;3;981;0;3606;3;3;
/org.eclipse.jdt.core/dom/org/eclipse/jdt/core/dom/NaiveASTFlattener.java;3;0;4;1;0;0;0;4;286;1;4;3158;304;304;1;0;0;4;4;3158;0;3832;4;3;
/org.eclipse.swt/Eclipse SWT Drag and Drop/gtk/org/eclipse/swt/dnd/DragSource.java;3;1;7;1;5;5;5;2;113;1;2;2107;211;211;1;0;0;2;7;2107;0;4824;7;3;
/org.eclipse.compare/compare/org/eclipse/compare/internal/AddFromHistoryAction.java;1;0;2;1;1;1;1;1;30;0;1;3571;30;30;1;0;0;1;2;3571;0;4210;2;1;
/org.eclipse.compare/compare/org/eclipse/patch/InputPatchPage.java;1;0;4;1;0;0;0;4;36;1;4;1419;40;40;1;0;0;4;4;1419;0;1516;4;1;
/org.eclipse.swt.examples/src/org/eclipse/swt/examples/fileviewer/TableView.java;2;0;3;2;0;0;0;3;1;2;2;554;1;1;2;1;0;3;3;609;1;609;2;2;
/org.eclipse.jdt.ui.tests.refactoring/resources/RenameParameters/canRename/A_test19_in.java;1;0;1;1;0;0;0;1;0;0;1;233;0;0;1;0;0;1;1;233;0;233;1;1;
/org.eclipse.jdt.ui.tests.refactoring/resources/ExtractMethodWorkSpace/ExtractMethodTests/locals_out/A_test535.java;1;1;5;1;2;2;2;3;20;1;3;922;27;27;1;0;0;3;5;922;0;4419;5;1;
/org.eclipse.ui/Eclipse UI/org/eclipse/ui/internal/BaseSaveAction.java;2;0;2;1;0;0;0;2;5;1;2;257;5;5;1;0;0;2;2;257;0;457;2;2;
/org.eclipse.jdt.ui.tests.refactoring/resources/SelectionAnalyzerWorkSpace/SelectionAnalyzerTests/invalidSelection/A_test153.java;1;0;1;1;0;0;0;1;0;0;1;1368;0;0;1;0;0;1;1;1368;0;1368;1;1;
/org.eclipse.pde.core/src/org/eclipse/pde/internal/core/plugin/WorkspacePluginModel.java;1;0;1;1;0;0;0;1;0;0;1;3591;0;0;1;0;0;1;1;3591;0;3591;1;1;
/org.eclipse.jdt.core/search/org/eclipse/jdt/internal/core/index/impl/Int.java;2;0;4;1;1;1;1;3;15;1;3;455;23;23;1;0;0;3;4;455;0;4063;4;2;
/org.eclipse.jdt.debug/jdi interfaces/com/sun/jdi/InvalidStackFrameException.java;2;0;2;1;0;0;0;2;7;1;2;2704;7;7;1;0;0;2;2;2704;0;3033;2;2;
/org.eclipse.webdav/src/interface/org/eclipse/webdav/dom/SupportedLock.java;3;0;5;1;1;1;1;4;204;1;4;12;254;254;1;0;0;4;5;12;0;4211;5;3;
/org.eclipse.jdt.debug/jdi interfaces/com/sun/jdi/Value.java;2;0;2;1;0;0;0;2;8;1;2;2704;8;8;1;0;0;2;2;2704;0;3033;2;2;
/org.eclipse.swt/Eclipse SWT/gtk/org/eclipse/swt/graphics/GC.java;6;1;22;2;7;7;7;15;2558;2;11;2107;4726;4726;2;4;0;15;22;2365;4;4701;18;6;
/org.eclipse.jdt.ui.tests.refactoring/resources/SelectionAnalyzerWorkSpace/SelectionAnalyzerTests/validSelection/A_test306.java;1;0;1;1;0;0;0;1;0;0;1;1368;0;0;1;0;0;1;1;1368;0;1368;1;1;
/org.eclipse.jdt.ui.tests.refactoring/resources/ExtractTemp/canExtract/A_test2_out.java;1;0;1;1;0;0;0;1;0;0;1;2481;0;0;1;0;0;1;1;2481;0;2481;1;1;
/org.eclipse.jdt.ui/ui/org/eclipse/jdt/internal/ui/jarpackager/JarPackageActionDelegate.java;2;0;7;1;0;0;0;7;47;1;7;349;170;170;1;0;0;7;7;349;0;3529;7;2;
/org.eclipse.ui/Eclipse UI/org/eclipse/ui/internal/registry/IViewDescriptor.java;4;0;5;1;1;1;1;4;17;1;4;257;30;30;1;0;0;4;5;257;0;4082;5;4;
/org.eclipse.jdt.ui/core refactoring/org/eclipse/jdt/internal/corext/refactoring/code/flow/InOutFlowAnalyzer.java;1;0;5;1;0;0;0;5;103;1;5;1939;165;165;1;0;0;5;5;1939;0;3106;5;1;
/org.eclipse.webdav/src/kernel/org/eclipse/webdav/internal/kernel/utils/NestedHashtable.java;1;0;4;1;1;1;1;3;226;1;3;12;248;248;1;0;0;3;4;12;0;4211;4;1;
/org.eclipse.ui.win32/src/org/eclipse/ui/internal/editorsupport/win32/OleEditor.java;3;2;7;1;7;6;7;0;54;0;0;3952;119;119;2;0;1;0;7;4360;1;4640;6;3;
/org.eclipse.jdt.ui/ui/org/eclipse/jdt/internal/ui/typehierarchy/HistoryAction.java;5;0;15;2;1;1;1;14;91;2;12;328;291;291;2;2;0;14;15;1226;2;4630;13;5;
/org.eclipse.jdt.ui.tests.refactoring/resources/MoveMembers/testFail8/in/B.java;1;0;1;1;0;0;0;1;0;0;1;2738;0;0;1;0;0;1;1;2738;0;2738;1;1;
/org.eclipse.team.core/src/org/eclipse/team/core/internal/IgnoreInfo.java;1;0;2;1;0;0;0;2;0;1;2;2864;0;0;1;0;0;2;2;2864;0;3213;2;1;
/org.eclipse.search/search/org/eclipse/search/internal/ui/SorterDescriptor.java;2;0;6;1;1;1;1;5;20;1;5;15;42;42;1;0;0;5;6;15;0;4619;6;2;
/org.eclipse.swt.examples.ole.win32/src/org/eclipse/swt/examples/ole/win32/OleWebBrowser.java;3;0;3;1;1;1;1;2;251;1;2;513;257;257;1;0;0;2;3;513;0;4705;3;3;
/org.eclipse.jdt.ui/ui/org/eclipse/jdt/internal/ui/workingsets/WorkingSetFilterActionGroup.java;3;1;10;1;10;10;10;0;8;0;0;3897;47;47;1;0;0;0;10;3897;0;4541;10;3;
/org.eclipse.vcm.ui/src/org/eclipse/vcm/internal/ui/sync/ToolTipMessageDialog.java;2;0;5;1;0;0;0;5;4;1;5;100;12;12;1;0;0;5;5;100;0;1159;5;2;
/org.eclipse.jdt.ui/core extension/org/eclipse/jdt/internal/corext/codemanipulation/TextPosition.java;1;0;3;1;0;0;0;3;98;1;3;1937;98;98;1;0;0;3;3;1937;0;2133;3;1;
/org.eclipse.jdt.ui/ui/org/eclipse/jdt/internal/ui/preferences/JavaBasePreferencePage.java;9;5;41;2;12;8;12;29;413;4;22;15;1228;1228;5;7;4;29;41;4181;11;4643;30;9;
/org.eclipse.jdt.junit/Eclipse JUnit/org/eclipse/jdt/junit/internal/ITestRunListener.java;2;0;2;1;0;0;0;2;0;1;2;1531;0;0;1;0;0;2;2;1531;0;2007;2;2;
/org.eclipse.jdt.core/compiler/org/eclipse/jdt/internal/compiler/ast/LocalTypeDeclaration.java;2;1;5;1;2;2;2;3;77;1;3;455;97;97;1;0;0;3;5;455;0;4421;5;2;
/org.eclipse.swt/Eclipse SWT Drag and Drop/emulated/org/eclipse/swt/dnd/TableDragUnderEffect.java;2;1;3;1;2;2;2;1;6;0;1;3126;8;8;1;0;0;1;3;3126;0;4701;3;2;
/org.eclipse.pde.ui/src/org/eclipse/pde/internal/editor/schema/SchemaDocPage.java;2;0;4;1;0;0;0;4;4;1;4;1434;6;6;1;0;0;4;4;1434;0;3579;4;2;
/org.eclipse.jdt.ui/ui/org/eclipse/jdt/internal/ui/compare/JavaCompareAction.java;1;0;2;1;0;0;0;2;117;1;2;3210;117;117;1;0;0;2;2;3210;0;3223;2;1;
/org.eclipse.search/search/org/eclipse/search/ui/IActionGroupFactory.java;1;1;2;1;2;2;2;0;1;0;0;4161;1;1;1;0;0;0;2;4161;0;4619;2;1;
/org.eclipse.ui/Eclipse JFace/org/eclipse/jface/wizard/WizardSelectionPage.java;2;0;2;1;0;0;0;2;5;1;2;257;5;5;1;0;0;2;2;257;0;457;2;2;
/org.eclipse.jdt.ui.tests.refactoring/resources/RenamePackage/testFail3/in/p/A.java;2;0;2;1;0;0;0;2;0;1;2;49;0;0;1;0;0;2;2;49;0;1258;2;2;
/org.eclipse.jdt.ui.tests.refactoring/resources/ExtractMethodWorkSpace/ExtractMethodTests/validSelection_out/A_test361.java;1;1;3;1;2;2;2;1;22;0;1;2621;22;22;1;0;0;1;3;2621;0;4419;3;1;
/org.eclipse.pde.ui/src/org/eclipse/pde/internal/base/model/plugin/IPluginExtensionPoint.java;2;0;2;1;0;0;0;2;0;1;2;1434;0;0;1;0;0;2;2;1434;0;3039;2;2;
/org.eclipse.core.resources/src/org/eclipse/core/internal/resources/SavedState.java;3;0;4;1;1;1;1;3;122;1;3;182;147;147;1;0;0;3;4;182;0;4213;4;3;
/org.eclipse.pde.ui/src/org/eclipse/pde/internal/ui/wizards/imports/BinaryProjectFilter.java;1;0;1;1;1;1;1;0;0;0;0;4345;0;0;1;0;0;0;1;4345;0;4345;1;1;
/org.eclipse.jdt.ui/ui/org/eclipse/jdt/internal/ui/dialogs/OpenTypeSelectionDialog.java;5;1;11;1;2;2;2;9;61;3;7;329;175;175;3;2;0;9;11;1256;2;4381;9;5;
/org.eclipse.jdt.ui/core refactoring/org/eclipse/jdt/internal/core/refactoring/JavaStatusEntry.java;1;0;2;1;0;0;0;2;0;0;1;1927;0;0;2;1;0;2;2;1927;1;1927;1;1;
/org.eclipse.swt/Eclipse SWT/carbon/org/eclipse/swt/widgets/Label.java;3;1;4;1;4;4;4;0;40;0;0;4147;56;56;1;0;0;0;4;4147;0;4701;4;3;
/org.eclipse.team.ftp/src/org/eclipse/team/internal/ftp/client/Constants.java;2;1;4;1;4;4;4;0;2;0;0;4169;5;5;1;0;0;0;4;4169;0;4731;4;2;
/org.eclipse.help/src/org/eclipse/help/IHelp.java;2;1;15;1;3;3;3;12;89;1;12;1420;395;395;1;0;0;12;15;1420;0;4452;15;2;
/org.eclipse.jdt.core/search/org/eclipse/jdt/internal/core/search/IInfoConstants.java;2;0;3;1;1;1;1;2;15;1;2;455;20;20;1;0;0;2;3;455;0;4063;3;2;
/org.eclipse.scripting/Eclipse Scripting/org/eclipse/scripting/internal/uirenderer/XGRElementUISwtShell.java;2;0;4;1;0;0;0;4;20;1;4;133;24;24;1;0;0;4;4;133;0;1424;4;2;
/org.eclipse.jdt.ui/ui/org/eclipse/jdt/internal/ui/launcher/StringChoiceFieldEditor.java;3;0;4;1;0;0;0;4;5;1;4;15;7;7;1;0;0;4;4;15;0;1607;4;3;
/org.eclipse.scripting/src/org/eclipse/scripting/internal/datamodels/XGRXmlSaxHandler.java;1;0;1;1;0;0;0;1;0;0;1;1424;0;0;1;0;0;1;1;1424;0;1424;1;1;
/org.eclipse.pde.ui/src/org/eclipse/pde/internal/util/SharedLabelProvider.java;1;0;6;1;0;0;0;6;97;3;4;3031;124;124;3;2;0;6;6;3031;2;3579;4;1;
/org.eclipse.scripting/src/org/eclipse/scripting/internal/views/ScriptDevelopmentPreferencePageWorkbenchPopupMenu.java;1;0;1;1;0;0;0;1;0;0;1;1424;0;0;1;0;0;1;1;1424;0;1424;1;1;
/org.eclipse.pde.ui/Eclipse PDE UI/org/eclipse/pde/internal/model/Fragment.java;2;0;8;2;0;0;0;8;12;3;6;267;32;32;3;2;0;8;8;324;2;1434;6;2;
/org.eclipse.help.tests/src/org/eclipse/help/tests/launching/DisplayHelpResource_topicHref.java;1;0;1;1;1;1;1;0;0;0;0;4042;0;0;1;0;0;0;1;4042;0;4042;1;1;
/org.eclipse.pde.ui/src/org/eclipse/pde/internal/ui/editor/manifest/ManifestRuntimePage.java;1;0;1;1;0;0;0;1;0;0;1;3579;0;0;1;0;0;1;1;3579;0;3579;1;1;
/org.eclipse.jdt.debug/jdi/org/eclipse/jdi/internal/FloatValueImpl.java;2;0;4;1;0;0;0;4;19;1;4;187;37;37;1;0;0;4;4;187;0;3670;4;2;
/org.eclipse.jdt.ui/core refactoring/org/eclipse/jdt/internal/corext/refactoring/code/flow/IfFlowInfo.java;1;0;1;1;0;0;0;1;0;0;1;1939;0;0;1;0;0;1;1;1939;0;1939;1;1;
/org.eclipse.pde.ui/src/org/eclipse/pde/internal/editor/FormOutlinePage.java;2;0;6;1;0;0;0;6;12;2;5;1434;16;16;2;1;0;6;6;3035;1;3579;5;2;
/org.eclipse.jdt.core/search/org/eclipse/jdt/internal/core/index/impl/InMemoryIndex.java;3;1;9;1;4;4;4;5;99;1;5;455;278;278;1;0;0;5;9;455;0;4063;9;3;
/org.eclipse.team.cvs.ssh/src/org/eclipse/team/internal/ccvs/ssh/Packet.java;1;0;2;1;0;0;0;2;28;1;2;1978;28;28;1;0;0;2;2;1978;0;3102;2;1;
/org.eclipse.jdt.junit/Eclipse JUnit/org/eclipse/jdt/junit/internal/TestRunnerUI.java;2;0;2;1;0;0;0;2;0;1;2;1531;0;0;1;0;0;2;2;1531;0;2007;2;2;
/org.eclipse.scripting/src/org/eclipse/scripting/internal/views/ScriptUIEditorColorProvider.java;1;0;1;1;0;0;0;1;0;0;1;1424;0;0;1;0;0;1;1;1424;0;1424;1;1;
/org.eclipse.swt/Eclipse SWT/gtk/org/eclipse/swt/graphics/DefaultGtkStyle.java;1;0;2;1;0;0;0;2;0;1;2;2107;0;0;1;0;0;2;2;2107;0;3209;2;1;
/org.eclipse.team.core/src/org/eclipse/team/core/sync/Assert.java;2;0;3;1;1;1;1;2;100;1;2;3193;100;100;1;0;0;2;3;3193;0;4019;3;2;
/org.eclipse.swt.examples/src/org/eclipse/swt/examples/explorer/Images.java;1;0;1;1;0;0;0;1;0;0;1;513;0;0;1;0;0;1;1;513;0;513;1;1;
/org.eclipse.jdt.ui/ui refactoring/org/eclipse/jdt/internal/ui/refactoring/RenameInputWizardPage.java;4;0;16;1;1;1;1;15;14;1;15;193;108;108;1;0;0;15;16;193;0;4141;16;4;
/org.eclipse.update.ui/src/org/eclipse/update/internal/ui/wizards/ReviewPage.java;3;0;13;1;1;1;1;12;74;1;12;1570;204;204;1;0;0;12;13;1570;0;4610;13;3;
/org.eclipse.swt.examples/src/org/eclipse/swt/examples/controlexample/ComboTab.java;5;1;7;1;3;3;3;4;166;1;4;513;338;338;1;0;0;4;7;513;0;4705;7;5;
/org.eclipse.ui/Eclipse JFace/org/eclipse/jface/operation/IRunnableContext.java;2;0;2;1;0;0;0;2;5;1;2;257;5;5;1;0;0;2;2;257;0;457;2;2;
/org.eclipse.jdt.ui.tests.refactoring/resources/RenameVirtualMethodInClass/test21/in/A.java;1;0;1;1;0;0;0;1;0;0;1;49;0;0;1;0;0;1;1;49;0;49;1;1;
/org.eclipse.jdt.core/compiler/org/eclipse/jdt/internal/compiler/codegen/ResetStateForCodeGenerationVisitor.java;1;0;2;1;1;1;1;1;10;0;1;2419;10;10;1;0;0;1;2;2419;0;4062;2;1;
/org.eclipse.scripting/Eclipse Scripting/org/eclipse/scripting/internal/ScriptRunnerExtended.java;2;0;4;1;0;0;0;4;4;1;4;133;7;7;1;0;0;4;4;133;0;1424;4;2;
/org.eclipse.vcm.ui/src/org/eclipse/vcm/internal/ui/actions/CompareWithAction.java;3;0;12;2;0;0;0;12;42;3;10;1;185;185;3;2;0;12;12;295;2;1288;10;3;
/org.eclipse.pde.ui/src/org/eclipse/pde/internal/CoreUtility.java;2;0;2;1;0;0;0;2;0;1;2;1434;0;0;1;0;0;2;2;1434;0;2691;2;2;
/org.eclipse.jdt.debug.tests/tests/org/eclipse/jdt/debug/tests/eval/NestedTypeFieldValue_241.java;2;1;3;1;3;3;3;0;12;0;0;4447;14;14;1;0;0;0;3;4447;0;4571;3;2;
/org.eclipse.core.resources/src/org/eclipse/core/internal/localstore/Copy of CoreFileSystemLibrary.java;2;0;2;2;0;0;0;2;0;0;1;49;0;0;2;1;0;2;2;49;1;49;1;2;
/org.eclipse.debug.ui/ui/org/eclipse/debug/ui/RunAction.java;2;0;3;1;0;0;0;3;2;1;3;2205;2;2;1;0;0;3;3;2205;0;2397;3;2;
/org.eclipse.swt.examples.paint/src/org/eclipse/swt/examples/paint/MetaStatelessXORHelper.java;1;0;1;1;0;0;0;1;0;0;1;512;0;0;1;0;0;1;1;512;0;512;1;1;
/org.eclipse.jdt.core/dom/org/eclipse/jdt/core/dom/NullLiteral.java;2;0;4;1;0;0;0;4;10;1;4;2669;19;19;1;0;0;4;4;2669;0;3637;4;2;
/org.eclipse.ui.tests/Eclipse UI Tests/org/eclipse/ui/tests/api/ApiTestSuite.java;2;0;19;2;0;0;0;19;40;3;13;803;117;117;3;6;0;19;19;1452;6;2029;13;2;
/org.eclipse.update/src/org/eclipse/update/internal/ui/UMWizardPageComplete.java;1;0;1;1;0;0;0;1;0;0;1;1424;0;0;1;0;0;1;1;1424;0;1424;1;1;
/org.eclipse.update.tests.core/src/org/eclipse/update/tests/regularRemove/TestRemove.java;2;0;13;1;1;1;1;12;170;2;11;2330;293;293;2;1;0;12;13;3695;1;4060;12;2;
/org.eclipse.scripting/src/org/eclipse/scripting/internal/uirenderer/XGR.java;1;0;1;1;0;0;0;1;0;0;1;1424;0;0;1;0;0;1;1;1424;0;1424;1;1;
/org.eclipse.pde.ui/src/org/eclipse/pde/internal/base/model/ISourceObject.java;1;0;2;1;0;0;0;2;0;1;2;2730;0;0;1;0;0;2;2;2730;0;3039;2;1;
/org.eclipse.jdt.ui/ui/org/eclipse/jdt/internal/ui/dialogs/StatusUtil.java;3;0;7;1;1;1;1;6;24;1;6;1272;56;56;1;0;0;6;7;1272;0;3954;7;3;
/org.eclipse.swt/Eclipse SWT Custom Widgets/common/org/eclipse/swt/custom/StackLayout.java;2;0;4;1;1;1;1;3;39;1;3;106;49;49;1;0;0;3;4;106;0;4701;4;2;
/org.eclipse.swt/Eclipse SWT/win32/org/eclipse/swt/internal/win32/TCHAR.java;2;0;3;1;0;0;0;3;109;1;3;1379;109;109;1;0;0;3;3;1379;0;2069;3;2;
/org.eclipse.pde.core/src/org/eclipse/pde/internal/core/plugin/Fragment.java;1;0;1;1;0;0;0;1;0;0;1;3591;0;0;1;0;0;1;1;3591;0;3591;1;1;
/org.eclipse.compare/compare/org/eclipse/compare/CompareEditorInput.java;3;3;29;1;9;7;9;20;131;2;19;14;622;622;3;1;2;20;29;4564;3;4820;26;3;
/org.eclipse.jdt.ui/ui/org/eclipse/jdt/internal/ui/launcher/SourceLookupBlock.java;2;0;2;1;0;0;0;2;0;1;2;1739;0;0;1;0;0;2;2;1739;0;1916;2;2;
/org.eclipse.ui/Eclipse UI/org/eclipse/ui/dialogs/WizardImportPage.java;3;0;3;1;0;0;0;3;20;1;3;257;21;21;1;0;0;3;3;257;0;2738;3;3;
/org.eclipse.swt.examples.launcher/src/org/eclipse/swt/examples/launcher/ProgramLaunchDelegate.java;2;0;2;1;0;0;0;2;0;1;2;391;0;0;1;0;0;2;2;391;0;611;2;2;
/org.eclipse.jdt.ui.tests.refactoring/resources/RenameMethodInInterface/test1/out/A.java;1;0;1;1;0;0;0;1;0;0;1;49;0;0;1;0;0;1;1;49;0;49;1;1;
/org.eclipse.update.ui/src/org/eclipse/update/internal/ui/wizards/NewWizard.java;1;0;1;1;0;0;0;1;0;0;1;3653;0;0;1;0;0;1;1;3653;0;3653;1;1;
/org.eclipse.ui/Eclipse UI/org/eclipse/ui/IViewPart.java;3;0;3;1;0;0;0;3;6;1;3;257;10;10;1;0;0;3;3;257;0;1686;3;3;
/org.eclipse.help.ui/src/org/eclipse/help/internal/ui/ShowHelp.java;2;0;2;1;0;0;0;2;0;1;2;1420;0;0;1;0;0;2;2;1420;0;1675;2;2;
/org.eclipse.jdt.junit/Eclipse JUnit/org/eclipse/jdt/internal/junit/ui/IJUnitLauncherDelegate.java;2;0;2;1;0;0;0;2;0;1;2;2653;0;0;1;0;0;2;2;2653;0;3313;2;2;
/org.eclipse.pde.ui/src/org/eclipse/pde/internal/model/plugin/PluginBase.java;1;0;2;1;0;0;0;2;0;1;2;3136;0;0;1;0;0;2;2;3136;0;3579;2;1;
/org.eclipse.pde.ui/src/org/eclipse/pde/internal/ui/editor/schema/NewReferenceAction.java;1;0;2;1;0;0;0;2;2;1;2;3579;2;2;1;0;0;2;2;3579;0;3591;2;1;
/org.eclipse.jdt.ui.tests.refactoring/resources/RenameVirtualMethodInClass/test28/in/A.java;1;0;1;1;0;0;0;1;0;0;1;49;0;0;1;0;0;1;1;49;0;49;1;1;
/org.eclipse.jdt.core/model/org/eclipse/jdt/internal/core/jdom/CompilationUnit.java;2;1;12;1;2;2;2;10;69;4;6;455;184;184;4;4;0;10;12;1039;4;4063;8;2;
/org.eclipse.update.core/src/org/eclipse/update/core/model/SiteLocalParser.java;1;0;5;1;0;0;0;5;9;1;5;2764;22;22;1;0;0;5;5;2764;0;3027;5;1;
/org.eclipse.pde.ui/src/org/eclipse/pde/internal/model/feature/FeatureURLElement.java;1;0;2;1;0;0;0;2;0;1;2;2951;0;0;1;0;0;2;2;2951;0;3579;2;1;
/org.eclipse.pde.ui/Eclipse PDE UI/org/eclipse/pde/internal/model/XMLErrorHandler.java;2;0;5;2;0;0;0;5;12;3;3;267;12;12;3;2;0;5;5;324;2;1434;3;2;
/org.eclipse.help/Eclipse Help/org/eclipse/help/internal/navigation/InfosetBuilder.java;3;0;12;2;0;0;0;12;590;3;9;135;699;699;3;3;0;12;12;295;3;1420;9;3;
/org.eclipse.update.core/src/org/eclipse/update/core/model/PluginEntryModel.java;2;0;5;1;1;1;1;4;98;1;4;2409;202;202;1;0;0;4;5;2409;0;4091;5;2;
/org.eclipse.pde.ui/Eclipse PDE UI/org/eclipse/pde/internal/base/model/IEditable.java;2;0;5;2;0;0;0;5;12;3;3;267;12;12;3;2;0;5;5;324;2;1434;3;2;
/org.eclipse.jdt.debug/jdi interfaces/com/sun/jdi/InvalidTypeException.java;2;0;2;1;0;0;0;2;7;1;2;2704;7;7;1;0;0;2;2;2704;0;3033;2;2;
/org.eclipse.pde.ui/src/org/eclipse/pde/internal/schema/DocumentSection.java;2;0;2;1;0;0;0;2;0;1;2;1434;0;0;1;0;0;2;2;1434;0;3579;2;2;
/org.eclipse.jdt.ui.tests.refactoring/resources/RenameMethodInInterface/test38/in/A.java;1;0;1;1;0;0;0;1;0;0;1;49;0;0;1;0;0;1;1;49;0;49;1;1;
/org.eclipse.jdt.ui/ui/org/eclipse/jdt/internal/ui/text/JavaWordDetector.java;1;0;2;1;0;0;0;2;5;1;2;15;5;5;1;0;0;2;2;15;0;326;2;1;
/org.eclipse.team.cvs.ui/src/org/eclipse/team/internal/ccvs/ui/CVSCompareRevisionsInput.java;3;1;15;2;2;2;2;13;55;1;13;2377;252;252;1;0;0;13;15;2377;0;4428;15;3;
/org.eclipse.update.core/src/org/eclipse/update/examples/buildzip/BuildZipFeatureParser.java;1;0;1;1;0;0;0;1;0;0;1;2472;0;0;1;0;0;1;1;2472;0;2472;1;1;
/org.eclipse.swt.examples.paint/src/org/eclipse/swt/examples/paint/MetaLine.java;1;0;1;1;0;0;0;1;0;0;1;512;0;0;1;0;0;1;1;512;0;512;1;1;
/org.eclipse.jdt.core/dom/org/eclipse/jdt/core/dom/SimpleName.java;3;1;17;2;3;3;3;14;139;2;11;2669;276;276;2;3;0;14;17;2773;3;4452;14;3;
/org.eclipse.swt.examples.controls/src/org/eclipse/swt/examples/controls/ListTab.java;2;0;2;1;0;0;0;2;0;1;2;391;0;0;1;0;0;2;2;391;0;611;2;2;
/org.eclipse.vcm.core.cvs/src/org/eclipse/vcm/internal/core/ccvs/requests/RTagErrorHandler.java;2;0;3;1;0;0;0;3;6;1;3;0;10;10;1;0;0;3;3;0;0;298;3;2;
/org.eclipse.core.tests.runtime/src/org/eclipse/core/tests/runtime/AutomatedTests.java;4;0;5;1;0;0;0;5;44;1;5;1794;58;58;1;0;0;5;5;1794;0;3476;5;4;
/org.eclipse.jdt.debug/jdi/org/eclipse/jdi/internal/event/EventMessages.java;1;0;1;1;0;0;0;1;12;0;1;3677;12;12;1;0;0;1;1;3677;0;3677;1;1;
/org.eclipse.jdt.ui/ui/org/eclipse/jdt/internal/ui/launcher/J9PreferencePage.java;1;0;3;1;0;0;0;3;25;1;3;15;25;25;1;0;0;3;3;15;0;218;3;1;
/org.eclipse.pde.ui/src/org/eclipse/pde/internal/parts/EditableTablePart.java;1;0;2;1;0;0;0;2;0;1;2;2998;0;0;1;0;0;2;2;2998;0;3579;2;1;
/org.eclipse.jdt.ui.tests/ui/org/eclipse/jdt/ui/tests/dialogs/DialogsTest.java;4;0;16;1;0;0;0;16;48;2;15;1208;224;224;2;1;0;16;16;2180;1;3849;15;4;
/org.eclipse.jdt.core/model/org/eclipse/jdt/internal/core/SourceTypeElementInfo.java;3;0;5;1;1;1;1;4;439;1;4;455;613;613;1;0;0;4;5;455;0;4063;5;3;
/org.eclipse.jdt.debug.ui/ui/org/eclipse/jdt/internal/debug/ui/display/DisplayViewAction.java;1;0;2;1;0;0;0;2;7;1;2;1915;7;7;1;0;0;2;2;1915;0;2342;2;1;
/org.eclipse.ui/Eclipse UI Standard Components/org/eclipse/ui/views/tasklist/MarkerUtil.java;5;0;10;1;1;1;1;9;113;1;9;257;228;228;1;0;0;9;10;257;0;4269;10;5;
/org.eclipse.jdt.ui/nls/org/eclipse/jdt/internal/ui/nls/model/NLSHolder.java;1;0;2;1;0;0;0;2;0;1;2;1880;0;0;1;0;0;2;2;1880;0;1913;2;1;
/org.eclipse.swt.examples.controls/src/org/eclipse/swt/examples/controls/ControlView.java;3;0;5;2;1;1;1;4;99;2;3;513;171;171;2;1;0;4;5;609;1;4705;4;3;
/org.eclipse.pde.ui/src/org/eclipse/pde/internal/forms/SectionChangeManager.java;2;0;2;1;0;0;0;2;0;1;2;1434;0;0;1;0;0;2;2;1434;0;2470;2;2;
/org.eclipse.swt.examples.paint/org/eclipse/swt/examples/paint/SolidEllipseFigure.java;3;0;4;2;1;1;1;3;54;2;2;586;54;54;2;1;0;3;4;609;1;4024;3;3;
/org.eclipse.jdt.ui.tests.refactoring/resources/DeleteSourceReferenceEdit/A_testField0_in.java;1;0;1;1;0;0;0;1;0;0;1;2857;0;0;1;0;0;1;1;2857;0;2857;1;1;
/org.eclipse.jdt.ui.tests.refactoring/resources/RenamePrivateMethod/test13/out/A.java;1;0;1;1;0;0;0;1;0;0;1;49;0;0;1;0;0;1;1;49;0;49;1;1;
/org.eclipse.team.ui/src/org/eclipse/team/internal/ui/sync/SyncView.java;2;1;12;1;9;9;9;3;129;2;2;2054;281;281;2;1;0;3;12;2231;1;4829;11;2;
/org.eclipse.core.resources/src/org/eclipse/core/internal/resources/ProjectDescriptionChangeListener.java;1;0;3;1;0;0;0;3;9;1;3;3236;9;9;1;0;0;3;3;3236;0;3360;3;1;
/org.eclipse.help/Eclipse Help/org/eclipse/help/internal/contributions/Visitor.java;2;0;3;1;0;0;0;3;7;1;3;135;7;7;1;0;0;3;3;135;0;1420;3;2;
/org.eclipse.team.core/src/org/eclipse/team/internal/core/target/ITeamStatusConstants.java;2;2;5;1;5;4;5;0;69;0;0;4010;97;97;2;0;1;0;5;4245;1;4245;4;2;
/org.eclipse.jdt.ui/ui/org/eclipse/jdt/internal/ui/jarpackager/JarPackageWizardPage.java;5;2;33;2;3;2;3;30;239;3;25;239;998;998;3;5;1;30;33;410;6;4466;27;5;
/org.eclipse.swt/Eclipse SWT/common/org/eclipse/swt/events/ShellEvent.java;2;0;3;1;1;1;1;2;6;1;2;106;10;10;1;0;0;2;3;106;0;4701;3;2;
/org.eclipse.debug.core/core/org/eclipse/debug/core/model/ILauncherDelegate.java;3;0;8;1;0;0;0;8;31;2;7;187;60;60;2;1;0;8;8;963;1;3634;7;3;
/org.eclipse.pde.runtime/Eclipse PDE Runtime/org/eclipse/pde/internal/runtime/registry/IPluginFolder.java;2;0;3;1;0;0;0;3;4;1;3;267;4;4;1;0;0;3;3;267;0;1434;3;2;
/org.eclipse.core.tests.runtime/src/org/eclipse/core/tests/internal/runtimetests/SampleNFR.java;1;0;2;1;0;0;0;2;10;1;2;3611;10;10;1;0;0;2;2;3611;0;3678;2;1;
/org.eclipse.debug.core/core/org/eclipse/debug/core/model/IRegisterGroup.java;2;0;4;1;0;0;0;4;12;1;4;1950;19;19;1;0;0;4;4;1950;0;3474;4;2;
/org.eclipse.jdt.ui.tests.refactoring/resources/InlineTemp/canInline/A_test2_out.java;1;0;1;1;0;0;0;1;0;0;1;2015;0;0;1;0;0;1;1;2015;0;2015;1;1;
/org.eclipse.core.resources/src/org/eclipse/core/internal/indexing/UserDefinedObjectFactory.java;3;0;4;1;0;0;0;4;8;1;4;12;11;11;1;0;0;4;4;12;0;448;4;3;
/org.eclipse.debug.ui/ui/org/eclipse/debug/internal/ui/actions/StepActionDelegate.java;1;0;8;1;1;1;1;7;22;1;7;2382;71;71;1;0;0;7;8;2382;0;4087;8;1;
/org.eclipse.webdav/src/client/org/eclipse/webdav/http/client/ContentType.java;3;0;5;1;1;1;1;4;324;1;4;12;364;364;1;0;0;4;5;12;0;4211;5;3;
/org.eclipse.jdt.ui.tests.refactoring/resources/RenamePackage/test4/in/r/p1/A.java;1;0;1;1;0;0;0;1;0;0;1;1258;0;0;1;0;0;1;1;1258;0;1258;1;1;
/org.eclipse.pde.runtime/Eclipse PDE Runtime/org/eclipse/pde/internal/runtime/logview/StatusAdapter.java;2;0;4;1;0;0;0;4;33;1;4;267;37;37;1;0;0;4;4;267;0;1434;4;2;
/org.eclipse.core.tests.resources/src/org/eclipse/core/tests/resources/session/WorkspaceSerializationTest.java;2;0;7;1;0;0;0;7;790;2;6;2289;953;953;2;1;0;7;7;2289;1;3475;6;2;
/org.eclipse.vcm.ui.cvs/src/org/eclipse/vcm/internal/ui/ccvs/ModuleTableLabelProvider.java;2;0;2;1;0;0;0;2;57;1;2;1008;57;57;1;0;0;2;2;1008;0;1277;2;2;
/org.eclipse.ui.tests/Eclipse UI Tests/org/eclipse/ui/tests/dialogs/UIDialogsAuto.java;3;0;5;1;0;0;0;5;39;1;5;1113;54;54;1;0;0;5;5;1113;0;2785;5;3;
/org.eclipse.swt.examples/org/eclipse/swt/examples/helloworld/HelloWorld2.java;4;0;5;1;1;1;1;4;33;1;4;513;76;76;1;0;0;4;5;513;0;4024;5;4;
/org.eclipse.help.ui/src/org/eclipse/help/ui/internal/ContextHelpDialog.java;1;1;2;1;2;2;2;0;3;0;0;4439;3;3;1;0;0;0;2;4439;0;4452;2;1;
/org.eclipse.compare/compare/org/eclipse/compare/internal/MergeSourceViewer.java;2;0;14;1;0;0;0;14;199;1;14;14;456;456;1;0;0;14;14;14;0;3572;14;2;
/org.eclipse.jdt.ui/ui/org/eclipse/jdt/internal/ui/IRuntimeDefaultPreferences.java;1;0;3;1;0;0;0;3;9;1;3;15;9;9;1;0;0;3;3;15;0;416;3;1;
/org.eclipse.swt/Eclipse SWT/common/org/eclipse/swt/widgets/RunnableLock.java;3;0;4;1;1;1;1;3;6;1;3;106;13;13;1;0;0;3;4;106;0;4701;4;3;
/org.eclipse.jdt.ui/ui/org/eclipse/jdt/internal/ui/browsing/JavaBrowsingPerspectiveFactory.java;4;3;10;3;6;4;6;4;82;1;4;2878;170;170;3;0;2;4;10;4182;2;4626;8;4;
/org.eclipse.jdt.core/eval/org/eclipse/jdt/internal/eval/VariablesEvaluator.java;2;0;16;1;1;1;1;15;561;4;10;455;985;985;4;5;0;15;16;1039;5;4062;11;2;
/org.eclipse.pde.ui/src/org/eclipse/pde/internal/core/feature/FeatureInfo.java;1;0;3;1;0;0;0;3;2;1;3;3579;2;2;1;0;0;3;3;3579;0;3607;3;1;
/org.eclipse.team.cvs.ui/src/org/eclipse/team/internal/ccvs/ui/ResourceEditionNode.java;2;0;5;1;0;0;0;5;318;1;5;2312;421;421;1;0;0;5;5;2312;0;3791;5;2;
/org.eclipse.vcm.ui/src/org/eclipse/vcm/internal/ui/model/RepositoryContentProvider.java;2;0;2;1;0;0;0;2;5;1;2;1;5;5;1;0;0;2;2;1;0;298;2;2;
/org.eclipse.jdt.debug.ui/ui/org/eclipse/jdt/internal/debug/ui/SourceAttachmentWizardPage.java;2;0;4;1;0;0;0;4;123;1;4;1915;125;125;1;0;0;4;4;1915;0;2355;4;2;
/org.eclipse.ui/Eclipse UI/org/eclipse/ui/internal/misc/OverlayIcon.java;1;0;1;1;0;0;0;1;0;0;1;620;0;0;1;0;0;1;1;620;0;620;1;1;
/org.eclipse.vcm.core.cvs/src/org/eclipse/vcm/internal/core/ccvs/requests/IUpdateMessageListener.java;2;0;3;1;0;0;0;3;9;1;3;0;12;12;1;0;0;3;3;0;0;1240;3;2;
/org.eclipse.core.tests.runtime/src/org/eclipse/core/tests/internal/plugins/PluginResolveTest_33.java;3;0;3;1;0;0;0;3;86;1;3;1794;96;96;1;0;0;3;3;1794;0;3476;3;3;
/org.eclipse.jdt.ui.tests.refactoring/resources/RenamePackage/testFail11/in/q/p1/A.java;1;0;1;1;0;0;0;1;0;0;1;1258;0;0;1;0;0;1;1;1258;0;1258;1;1;
/org.eclipse.jdt.ui.tests.refactoring/resources/ExtractMethodWorkSpace/ExtractMethodTests/try_out/A_test457.java;2;1;4;1;2;2;2;2;8;1;2;511;10;10;1;0;0;2;4;511;0;4419;4;2;
/org.eclipse.jdt.ui.tests.refactoring/resources/RenamePrivateField/testFail3/in/A.java;1;0;1;1;0;0;0;1;0;0;1;49;0;0;1;0;0;1;1;49;0;49;1;1;
/org.eclipse.jdt.ui.tests.refactoring/resources/ExtractMethodWorkSpace/ExtractMethodTests/semicolon_out/A_test406.java;1;1;3;1;2;2;2;1;6;0;1;1236;6;6;1;0;0;1;3;1236;0;4419;3;1;
/org.eclipse.core.runtime/src/org/eclipse/core/internal/plugins/ExtensionPoint.java;3;0;7;1;2;1;2;5;144;1;5;12;177;177;2;0;1;5;7;4212;1;4212;6;3;
/org.eclipse.ui/Eclipse JFace Text/org/eclipse/jface/text/ITextOperationTarget.java;3;0;4;1;0;0;0;4;28;1;4;257;34;34;1;0;0;4;4;257;0;1098;4;3;
/org.eclipse.help/webapps/examples/WEB-INF/classes/colors/ColorGameBean.java;1;0;2;1;0;0;0;2;0;1;2;1882;0;0;1;0;0;2;2;1882;0;1930;2;1;
/org.eclipse.team.cvs.ui/src/org/eclipse/team/internal/ccvs/ui/SimpleContentProvider.java;1;0;1;1;0;0;0;1;0;0;1;2374;0;0;1;0;0;1;1;2374;0;2374;1;1;
/org.eclipse.pde.ui/Eclipse PDE UI/org/eclipse/pde/internal/editor/FormOutlinePage.java;2;0;5;2;0;0;0;5;12;3;3;267;12;12;3;2;0;5;5;324;2;1434;3;2;
/org.eclipse.ui.externaltools/External Tools/org/eclipse/ui/externaltools/internal/ui/ClasspathPage.java;1;0;1;1;1;1;1;0;0;0;0;4123;0;0;1;0;0;0;1;4123;0;4123;1;1;
/org.eclipse.swt.examples/src/org/eclipse/swt/examples/javaviewer/JavaLineStyler.java;4;0;4;1;1;1;1;3;367;1;3;513;419;419;1;0;0;3;4;513;0;4705;4;4;
/org.eclipse.compare/compare/org/eclipse/compare/ITypedElement.java;2;0;4;1;1;1;1;3;17;1;3;14;28;28;1;0;0;3;4;14;0;4820;4;2;
/org.eclipse.webdav/src/kernel/org/eclipse/webdav/internal/kernel/DocumentMarshalerImpl.java;2;0;3;1;0;0;0;3;6;1;3;12;6;6;1;0;0;3;3;12;0;1874;3;2;
/org.eclipse.scripting/Eclipse Scripting/org/eclipse/scripting/internal/uirenderer/XGRElementUISwtTextField.java;2;0;5;1;0;0;0;5;12;1;5;133;32;32;1;0;0;5;5;133;0;1424;5;2;
/org.eclipse.jdt.ui.tests.refactoring/resources/RenameType/test45/in/A.java;1;0;1;1;0;0;0;1;0;0;1;49;0;0;1;0;0;1;1;49;0;49;1;1;
/org.eclipse.core.boot/src/org/eclipse/core/internal/boot/update/BaseURLHandler.java;2;0;4;1;0;0;0;4;18;1;4;12;25;25;1;0;0;4;4;12;0;2726;4;2;
/org.eclipse.jdt.ui/core refactoring/org/eclipse/jdt/internal/corext/refactoring/changes/ResourceReorgChange.java;2;0;3;1;1;1;1;2;26;1;2;1939;31;31;1;0;0;2;3;1939;0;4212;3;2;
/org.eclipse.pde.build/src/org/eclipse/pde/internal/build/Policy.java;3;0;9;1;1;1;1;8;221;2;6;349;293;293;2;2;0;8;9;349;2;4363;7;3;
/org.eclipse.jdt.launching/launching/org/eclipse/jdt/internal/launching/RuntimeClasspathEntryResolver.java;1;1;5;1;5;5;5;0;13;0;0;4087;36;36;1;0;0;0;5;4087;0;4210;5;1;
/org.eclipse.pde.ui/src/org/eclipse/pde/internal/ui/editor/IModelUndoManager.java;1;0;1;1;0;0;0;1;0;0;1;3583;0;0;1;0;0;1;1;3583;0;3583;1;1;
/org.eclipse.jdt.debug.ui/ui/org/eclipse/jdt/internal/debug/ui/actions/ObjectFilter.java;1;0;1;1;1;1;1;0;0;0;0;3905;0;0;1;0;0;0;1;3905;0;3905;1;1;
/org.eclipse.jdt.ui.tests.refactoring/resources/RenameType/test19/out/A.java;1;0;2;1;0;0;0;2;0;1;2;49;0;0;1;0;0;2;2;49;0;522;2;1;
/org.eclipse.swt/Eclipse SWT/win32/org/eclipse/swt/graphics/FontData.java;8;0;14;2;1;1;1;13;165;2;12;106;379;379;2;1;0;13;14;1674;1;4701;13;8;
/org.eclipse.swt/Eclipse SWT/photon/org/eclipse/swt/widgets/TableItem.java;2;0;5;1;0;0;0;5;288;1;5;106;445;445;1;0;0;5;5;106;0;1028;5;2;
/org.eclipse.update.core/src/org/eclipse/update/internal/model/ConfigurationActivityModel.java;1;0;1;1;0;0;0;1;0;0;1;3027;0;0;1;0;0;1;1;3027;0;3027;1;1;
/org.eclipse.jdt.debug/model/org/eclipse/jdt/debug/core/IJavaHotCodeReplaceListener.java;3;0;6;1;1;1;1;5;36;1;5;1801;58;58;1;0;0;5;6;1801;0;4567;6;3;
/org.eclipse.pde.ui/src/org/eclipse/pde/internal/ui/util/ChoicePropertyDescriptor.java;1;0;1;1;0;0;0;1;0;0;1;3579;0;0;1;0;0;1;1;3579;0;3579;1;1;
/org.eclipse.jdt.debug.tests/tests/org/eclipse/jdt/debug/tests/core/ThreadFilterBreakpointsTests.java;2;3;7;1;7;4;7;0;88;0;0;4293;117;117;3;0;3;0;7;4307;3;4571;4;2;
/org.eclipse.vcm.core.cvs/src/org/eclipse/vcm/internal/core/ccvs/client/ErrorMessageHandler.java;2;0;2;1;0;0;0;2;6;1;2;0;6;6;1;0;0;2;2;0;0;298;2;2;
/org.eclipse.jdt.debug/jdi/org/eclipse/jdi/internal/ClassTypeImpl.java;3;0;6;1;0;0;0;6;43;1;6;187;124;124;1;0;0;6;6;187;0;3838;6;3;
/org.eclipse.pde.ui/src/org/eclipse/pde/internal/wizards/templates/TemplateForm.java;1;0;4;1;0;0;0;4;85;2;3;3240;95;95;2;1;0;4;4;3240;1;3365;3;1;
/org.eclipse.jdt.ui/ui/org/eclipse/jdt/ui/wizards/NewClassWizardPage.java;3;1;5;1;3;3;3;2;65;1;2;3089;107;107;1;0;0;2;5;3089;0;4823;5;3;
/org.eclipse.ui.externaltools/Ant Builder/org/eclipse/ui/externaltools/internal/ui/ant/AntBuildLogger.java;1;1;3;1;3;3;3;0;43;0;0;4124;63;63;1;0;0;0;3;4124;0;4367;3;1;
/org.eclipse.jdt.debug/eval/org/eclipse/jdt/internal/debug/eval/LocalEvaluationEngine.java;3;0;39;2;1;1;1;38;406;3;32;1675;1598;1598;3;6;0;38;39;3555;6;4423;33;3;
/org.eclipse.jdt.ui.tests.refactoring/resources/MoveMembers/test15/in/A.java;1;0;1;1;0;0;0;1;0;0;1;2738;0;0;1;0;0;1;1;2738;0;2738;1;1;
/org.eclipse.jdt.ui.tests.refactoring/resources/ExtractMethodWorkSpace/ExtractMethodTests/validSelection/A_testx.java;2;0;2;1;0;0;0;2;0;1;2;49;0;0;1;0;0;2;2;49;0;2155;2;2;
/org.eclipse.swt.examples/org/eclipse/swt/examples/controlexample/TreeTab.java;5;1;6;1;3;3;3;3;191;1;3;513;378;378;1;0;0;3;6;513;0;4024;6;5;
/org.eclipse.pde.ui/src/org/eclipse/pde/internal/ui/ischema/ISchemaElement.java;1;0;2;1;0;0;0;2;0;1;2;3579;0;0;1;0;0;2;2;3579;0;3591;2;1;
/org.eclipse.jdt.ui.tests.refactoring/resources/RenameType/testWrongArg2/in/A.java;1;0;1;1;0;0;0;1;0;0;1;49;0;0;1;0;0;1;1;49;0;49;1;1;
/org.eclipse.jdt.debug.ui/ui/org/eclipse/jdt/internal/debug/ui/JavaModelListener.java;3;1;8;1;3;3;3;5;54;2;4;3329;128;128;2;1;0;5;8;3362;1;4423;7;3;
/org.eclipse.jdt.ui.tests.refactoring/resources/ExtractMethodWorkSpace/ExtractMethodTests/branch_in/A_test755.java;1;1;3;1;2;2;2;1;26;0;1;1851;26;26;1;0;0;1;3;1851;0;4419;3;1;
/org.eclipse.jdt.ui.tests.refactoring/resources/DeleteSourceReferenceEdit/A_testField0_out.java;1;0;1;1;0;0;0;1;0;0;1;2857;0;0;1;0;0;1;1;2857;0;2857;1;1;
/org.eclipse.update.ui.forms/src/org/eclipse/update/ui/forms/internal/WebForm.java;1;2;8;1;5;4;5;3;329;1;3;2470;358;358;2;0;1;3;8;4217;1;4583;7;1;
/org.eclipse.swt.tests/JUnit Tests/org/eclipse/swt/tests/junit/Test_org_eclipse_swt_custom_CLabel.java;2;0;2;1;1;1;1;1;6;0;1;1792;6;6;1;0;0;1;2;1792;0;4706;2;2;
/org.eclipse.pde.ui/src/org/eclipse/pde/internal/editor/feature/InfoFormPage.java;1;0;2;1;0;0;0;2;0;1;2;2951;0;0;1;0;0;2;2;2951;0;3579;2;1;
/org.eclipse.pde.build/src/plugin/org/eclipse/pde/internal/core/IXMLConstants.java;1;0;1;1;0;0;0;1;0;0;1;3475;0;0;1;0;0;1;1;3475;0;3475;1;1;
/org.eclipse.vcm.core.cvs/src/org/eclipse/vcm/internal/core/ccvs/client/CVSCommunicationException.java;4;0;4;1;0;0;0;4;9;1;4;0;19;19;1;0;0;4;4;0;0;1568;4;4;
/org.eclipse.swt.examples.paint/src/org/eclipse/swt/examples/paint/MetaEllipse.java;1;0;1;1;0;0;0;1;0;0;1;512;0;0;1;0;0;1;1;512;0;512;1;1;
/org.eclipse.jdt.ui.tests.refactoring/resources/RenameVirtualMethodInClass/test25/out/A.java;1;0;1;1;0;0;0;1;0;0;1;49;0;0;1;0;0;1;1;49;0;49;1;1;
/org.eclipse.swt/Eclipse SWT/gtk/org/eclipse/swt/widgets/Combo.java;6;4;30;2;15;10;15;15;1056;2;12;2107;1922;1922;4;3;5;15;30;3957;8;4701;22;6;
/org.eclipse.swt.examples.paint/src/org/eclipse/swt/examples/paint/ContainerFigure.java;3;0;4;2;1;1;1;3;149;2;2;566;155;155;2;1;0;3;4;609;1;4705;3;3;
/org.eclipse.pde.core/src/org/eclipse/pde/internal/core/PluginModelManager.java;1;1;5;1;3;3;3;2;18;1;2;3591;30;30;1;0;0;2;5;3591;0;4753;5;1;
/org.eclipse.jdt.ui.tests.refactoring/resources/SurroundWithWorkSpace/SurroundWithTests/trycatch_out/TestInitializer.java;1;0;1;1;1;1;1;0;0;0;0;4000;0;0;1;0;0;0;1;4000;0;4000;1;1;
/org.eclipse.jdt.ui.tests.refactoring/resources/RenamePackage/testFail9/in/p1/A.java;1;0;1;1;0;0;0;1;0;0;1;49;0;0;1;0;0;1;1;49;0;49;1;1;
/org.eclipse.jdt.ui/ui refactoring/org/eclipse/jdt/internal/ui/refactoring/PreviewWizardPage.java;5;0;19;2;0;0;0;19;397;2;16;15;769;769;2;3;0;19;19;415;3;3567;16;5;
/org.eclipse.team.tests.cvs.core/src/org/eclipse/team/tests/ccvs/core/cvsresources/ResourceSyncInfoTest.java;2;0;4;1;0;0;0;4;129;1;4;2536;141;141;1;0;0;4;4;2536;0;3398;4;2;
/org.eclipse.help.ui/src/org/eclipse/help/internal/ui/util/RuntimeErrorDialog.java;2;0;4;1;1;1;1;3;19;1;3;1420;21;21;1;0;0;3;4;1420;0;4439;4;2;
/org.eclipse.ui.tests/Eclipse UI Tests/org/eclipse/ui/tests/internal/PopupMenuExpressionTest.java;2;0;3;1;0;0;0;3;2;1;3;2033;4;4;1;0;0;3;3;2033;0;2785;3;2;
/org.eclipse.swt.examples.controls/src/org/eclipse/swt/examples/controls/Tab.java;2;0;2;1;0;0;0;2;0;1;2;391;0;0;1;0;0;2;2;391;0;611;2;2;
/org.eclipse.swt/Eclipse SWT/gtk/org/eclipse/swt/widgets/TreeItem.java;5;1;17;2;5;5;5;12;220;3;9;2107;1005;1005;3;3;0;12;17;2275;3;4701;14;5;
/org.eclipse.jdt.core/search/org/eclipse/jdt/internal/core/search/indexing/IndexBinaryFolder.java;3;2;15;1;6;5;6;9;179;1;9;1379;260;260;2;0;1;9;15;4190;1;4525;14;3;
/org.eclipse.ui.tests/Eclipse UI Tests/org/eclipse/ui/tests/api/IWorkbenchWindowActionDelegateTest.java;2;0;9;1;0;0;0;9;37;2;7;1080;101;101;2;2;0;9;9;1080;2;2785;7;2;
/org.eclipse.jdt.ui/core extension/org/eclipse/jdt/internal/corext/codegeneration/AddImportsOperation.java;2;0;2;1;0;0;0;2;0;1;2;2016;0;0;1;0;0;2;2;2016;0;2137;2;2;
/org.eclipse.jdt.ui/ui/org/eclipse/jdt/internal/ui/preferences/ZipContentProvider.java;4;0;5;2;0;0;0;5;17;2;4;15;22;22;2;1;0;5;5;752;1;1258;4;4;
/org.eclipse.ui/Eclipse UI/org/eclipse/ui/internal/misc/StatusUtil.java;4;0;4;1;1;1;1;3;54;1;3;257;68;68;1;0;0;3;4;257;0;4283;4;4;
/org.eclipse.pde.ui/src/org/eclipse/pde/internal/ui/wizards/project/OpenProjectWizardAction.java;1;0;2;1;1;1;1;1;3;0;1;3579;3;3;1;0;0;1;2;3579;0;4567;2;1;
/org.eclipse.jdt.debug/eval/org/eclipse/jdt/internal/debug/eval/ast/instructions/InstructionSequence.java;2;0;8;1;1;1;1;7;21;2;6;3421;63;63;2;1;0;7;8;3832;1;4423;7;2;
/org.eclipse.team.cvs.core/src/org/eclipse/team/internal/ccvs/core/client/CheckedInHandler.java;2;0;7;1;0;0;0;7;75;1;7;2572;116;116;1;0;0;7;7;2572;0;3610;7;2;
/org.eclipse.debug.ui/ui/org/eclipse/debug/internal/ui/views/expression/ExpressionView.java;2;1;4;1;4;4;4;0;250;0;0;3975;260;260;1;0;0;0;4;3975;0;4327;4;2;
/org.eclipse.jdt.ui/ui/org/eclipse/jdt/internal/ui/filters/CustomFiltersDialog.java;1;2;5;1;5;3;5;0;30;0;0;4211;40;40;2;0;2;0;5;4211;2;4400;3;1;
/org.eclipse.jdt.ui/core refactoring/org/eclipse/jdt/internal/corext/refactoring/util/ResourceManager.java;2;0;3;1;1;1;1;2;2;1;2;1939;2;2;1;0;0;2;3;1939;0;4137;3;2;
/org.eclipse.jdt.ui.tests.refactoring/resources/RenameType/testIllegalTypeName8/in/A.java;1;0;1;1;0;0;0;1;0;0;1;49;0;0;1;0;0;1;1;49;0;49;1;1;
/org.eclipse.jdt.ui/core refactoring/org/eclipse/jdt/internal/corext/refactoring/util/MultiLocalDeclaration.java;1;0;2;1;0;0;0;2;0;1;2;2327;0;0;1;0;0;2;2;2327;0;2481;2;1;
/org.eclipse.ui/Eclipse JFace Text/org/eclipse/jface/text/contentassist/IContextInformationValidator.java;3;0;3;1;0;0;0;3;5;1;3;257;8;8;1;0;0;3;3;257;0;1066;3;3;
/org.eclipse.jdt.ui/ui/org/eclipse/jdt/internal/ui/text/template/EditBox.java;1;0;4;1;0;0;0;4;30;1;4;1587;37;37;1;0;0;4;4;1587;0;1655;4;1;
/org.eclipse.jdt.ui.tests.refactoring/resources/SelectionAnalyzerWorkSpace/SelectionAnalyzerTests/invalidSelection/A_test015.java;1;0;1;1;0;0;0;1;0;0;1;1368;0;0;1;0;0;1;1;1368;0;1368;1;1;
/org.eclipse.ui/Eclipse UI Standard Components/org/eclipse/ui/views/internal/framelist/IFrameSource.java;3;0;4;1;0;0;0;4;4;1;4;257;7;7;1;0;0;4;4;257;0;3816;4;3;
/org.eclipse.jdt.debug/jdi/org/eclipse/jdi/internal/event/AccessWatchpointEventImpl.java;2;0;4;1;0;0;0;4;16;1;4;187;30;30;1;0;0;4;4;187;0;3670;4;2;
/org.eclipse.team.ui/src/org/eclipse/team/internal/ui/target/GetAsProjectAction.java;2;1;3;1;3;3;3;0;8;0;0;4256;12;12;1;0;0;0;3;4256;0;4636;3;2;
/org.eclipse.compare/compare/org/eclipse/compare/internal/patch/PatchWizard.java;1;1;4;1;2;2;2;2;27;1;2;2876;56;56;1;0;0;2;4;2876;0;4419;4;1;
/org.eclipse.vcm.ui/src/org/eclipse/vcm/internal/ui/SharingDialog.java;4;0;9;2;0;0;0;9;28;2;7;1;97;97;2;2;0;9;9;1;2;1160;7;4;
/org.eclipse.ui/Eclipse UI/org/eclipse/ui/dialogs/WizardNewProjectCreationPage.java;6;3;16;1;4;2;4;12;104;1;12;257;271;271;3;0;2;12;16;4082;2;4567;14;6;
/org.eclipse.pde.ui/Eclipse PDE UI/org/eclipse/pde/internal/wizards/WizardListSelectionPage.java;2;0;5;2;0;0;0;5;12;3;3;267;12;12;3;2;0;5;5;324;2;1434;3;2;
/org.eclipse.swt/Eclipse SWT/gtk1x/org/eclipse/swt/widgets/MenuItem.java;4;0;4;1;1;1;1;3;18;1;3;2107;29;29;1;0;0;3;4;2107;0;4701;4;4;
/org.eclipse.team.core/src/org/eclipse/team/core/sync/IRemoteResource.java;3;1;4;2;2;2;2;2;10;1;2;2019;21;21;1;0;0;2;4;2019;0;4707;4;3;
/org.eclipse.jdt.ui.tests.refactoring/resources/DeleteSourceReference/test10/in/A.java;1;0;1;1;0;0;0;1;0;0;1;2857;0;0;1;0;0;1;1;2857;0;2857;1;1;
/org.eclipse.jdt.ui.tests.refactoring/resources/InlineTemp/canInline/A_test4_in.java;1;0;1;1;0;0;0;1;0;0;1;2015;0;0;1;0;0;1;1;2015;0;2015;1;1;
/org.eclipse.jdt.ui.tests.refactoring/resources/RenameTemp/cannotRename/A_testFail27.java;1;0;1;1;0;0;0;1;0;0;1;3322;0;0;1;0;0;1;1;3322;0;3322;1;1;
/org.eclipse.jdt.ui.tests.refactoring/resources/SafeDeleteType/testFail18/in/A.java;1;0;1;1;0;0;0;1;0;0;1;49;0;0;1;0;0;1;1;49;0;49;1;1;
/org.eclipse.search/search/org/eclipse/search/internal/ui/util/ListDialog.java;2;0;3;1;1;1;1;2;39;1;2;15;48;48;1;0;0;2;3;15;0;4147;3;2;
/org.eclipse.team.cvs.core/src/org/eclipse/team/internal/ccvs/core/resources/RemoteManagedResource.java;2;0;2;1;0;0;0;2;0;1;2;1978;0;0;1;0;0;2;2;1978;0;2036;2;2;
/org.eclipse.jdt.core/search/org/eclipse/jdt/internal/core/search/AbstractSearchScope.java;3;0;6;1;1;1;1;5;48;1;5;455;145;145;1;0;0;5;6;455;0;4063;6;3;
/org.eclipse.pde.ui/src/org/eclipse/pde/internal/launcher/ICurrentLaunchListener.java;1;0;2;1;0;0;0;2;0;1;2;2903;0;0;1;0;0;2;2;2903;0;3348;2;1;
/org.eclipse.ant.core/src/org/eclipse/ant/core/IAntCoreConstants.java;1;0;3;1;0;0;0;3;20;2;2;3270;20;20;2;1;0;3;3;3489;1;3489;2;1;
/org.eclipse.jdt.junit/Eclipse JUnit/org/eclipse/jdt/junit/internal/util/FailureDialog.java;2;0;2;1;0;0;0;2;0;1;2;1511;0;0;1;0;0;2;2;1511;0;1996;2;2;
/org.eclipse.team.tests.cvs.core/src/org/eclipse/team/tests/ccvs/ui/logformatter/GroupEntry.java;1;0;1;1;0;0;0;1;0;0;1;2977;0;0;1;0;0;1;1;2977;0;2977;1;1;
/org.eclipse.help/src/org/eclipse/help/internal/protocols/HelpURLConnection.java;2;0;3;1;0;0;0;3;2;1;3;2694;3;3;1;0;0;3;3;2694;0;3609;3;2;
/org.eclipse.debug.ui/ui/org/eclipse/debug/internal/ui/views/DebugPageSelectionProvider.java;2;0;4;1;0;0;0;4;19;3;2;2325;19;19;3;2;0;4;4;2325;2;3186;2;2;
/org.eclipse.ui/Eclipse UI Tool Script/org/eclipse/toolscript/core/internal/IToolScriptContext.java;1;1;4;1;4;4;4;0;7;0;0;3976;13;13;1;0;0;0;4;3976;0;4087;4;1;
/org.eclipse.jdt.junit/src/org/eclipse/jdt/internal/junit/ui/JUnitPreferencePage.java;2;1;7;1;3;3;3;4;152;1;4;3171;219;219;1;0;0;4;7;3171;0;4634;7;2;
/org.eclipse.pde.ui/src/org/eclipse/pde/internal/schema/SchemaType.java;2;0;2;1;0;0;0;2;0;1;2;1434;0;0;1;0;0;2;2;1434;0;3579;2;2;
/org.eclipse.jdt.ui.tests.refactoring/resources/ExtractMethodWorkSpace/ExtractMethodTests/locals_in/A_test561.java;1;1;3;1;2;2;2;1;24;0;1;1236;24;24;1;0;0;1;3;1236;0;4419;3;1;
/org.eclipse.jdt.core/model/org/eclipse/jdt/internal/core/JarEntryFile.java;3;1;12;1;2;2;2;10;81;4;7;455;137;137;4;3;0;10;12;1039;3;4161;9;3;
/org.eclipse.team.core/src/org/eclipse/team/core/target/Site.java;3;1;7;1;7;7;7;0;89;0;0;4132;120;120;1;0;0;0;7;4132;0;4636;7;3;
/org.eclipse.pde.ui/Eclipse PDE UI/org/eclipse/pde/internal/editor/schema/SchemaEditor.java;2;0;7;2;0;0;0;7;14;3;5;267;28;28;3;2;0;7;7;324;2;1434;5;2;
/org.eclipse.jdt.ui.tests.refactoring/resources/ExtractMethodWorkSpace/ExtractMethodTests/handTests/Comments.java;2;1;3;1;2;2;2;1;6;0;1;376;6;6;1;0;0;1;3;376;0;4419;3;2;
/org.eclipse.ui/Eclipse UI/org/eclipse/ui/internal/dialogs/WorkingSetTypePage.java;1;1;5;1;3;3;3;2;112;0;1;3576;159;159;2;1;0;2;5;3576;1;4193;4;1;
/org.eclipse.scripting/Eclipse Scripting/org/eclipse/scripting/internal/views/ScriptDevelopmentWizardPageResourceType.java;2;0;4;1;0;0;0;4;30;1;4;133;45;45;1;0;0;4;4;133;0;1424;4;2;
/org.eclipse.ui.examples.readmetool/Eclipse UI Examples Readme Tool/org/eclipse/ui/examples/readmetool/SectionsDialog.java;3;0;3;1;0;0;0;3;2;1;3;932;4;4;1;0;0;3;3;932;0;3029;3;3;
/org.eclipse.core.boot/src/org/eclipse/core/internal/boot/update/UMFactory.java;2;0;3;1;0;0;0;3;8;1;3;12;8;8;1;0;0;3;3;12;0;2726;3;2;
/org.eclipse.jdt.ui/ui/org/eclipse/jdt/internal/ui/typehierarchy/MethodsViewerFilterAction.java;2;0;8;1;0;0;0;8;52;1;8;15;143;143;1;0;0;8;8;15;0;3123;8;2;
/org.eclipse.jdt.ui/ui/org/eclipse/jdt/internal/ui/workingsets/WorkingSetFilter.java;1;0;3;1;0;0;0;3;8;2;2;3834;10;10;2;1;0;3;3;3834;1;3847;2;1;
/org.eclipse.jdt.ui.tests.refactoring/resources/SelectionAnalyzerWorkSpace/SelectionAnalyzerTests/validSelection/A_test302.java;1;0;1;1;0;0;0;1;0;0;1;1368;0;0;1;0;0;1;1;1368;0;1368;1;1;
/org.eclipse.core.runtime/src/org/eclipse/core/runtime/model/ConfigurationPropertyModel.java;3;0;4;1;1;1;1;3;90;1;3;12;110;110;1;0;0;3;4;12;0;4214;4;3;
/org.eclipse.jdt.debug.ui/ui/org/eclipse/jdt/internal/debug/ui/snippeteditor/ScrapbookLauncher.java;3;2;24;2;9;8;9;15;131;2;13;2992;472;472;2;2;1;15;24;3492;3;4477;21;3;
/org.eclipse.vcm.core.cvs/src/org/eclipse/vcm/internal/core/ccvs/requests/RTag.java;3;0;3;1;0;0;0;3;13;1;3;0;17;17;1;0;0;3;3;0;0;1098;3;3;
/org.eclipse.ui/Eclipse UI/org/eclipse/ui/internal/SharedImages.java;2;0;2;1;0;0;0;2;5;1;2;257;5;5;1;0;0;2;2;257;0;457;2;2;
/org.eclipse.core.boot/src/org/eclipse/core/internal/boot/update/BootUpdateManager.java;4;0;15;2;0;0;0;15;335;3;11;12;537;537;3;4;0;15;15;323;4;2726;11;4;
/org.eclipse.pde.ui/src/org/eclipse/pde/internal/parts/FormBrowser.java;1;0;3;1;0;0;0;3;10;1;3;3278;10;10;1;0;0;3;3;3278;0;3579;3;1;
/org.eclipse.jdt.core/model/org/eclipse/jdt/internal/core/jdom/NullProblemFactory.java;1;0;3;1;0;0;0;3;53;1;3;455;53;53;1;0;0;3;3;455;0;2849;3;1;
/org.eclipse.ui/Eclipse UI/org/eclipse/ui/IEditorActionBarContributor.java;3;0;4;1;1;1;1;3;31;1;3;257;38;38;1;0;0;3;4;257;0;4195;4;3;
/org.eclipse.swt.examples.paint/org/eclipse/swt/examples/paint/PolyLineTool.java;4;0;6;2;1;1;1;5;93;3;3;513;97;97;3;2;0;5;6;609;2;4024;4;4;
/org.eclipse.debug.ui/ui/org/eclipse/debug/ui/IDebugModelPresentation.java;3;1;17;2;2;2;2;15;38;3;11;187;156;156;3;4;0;15;17;187;4;4652;13;3;
/org.eclipse.ui/Eclipse UI/org/eclipse/ui/internal/SelectionService.java;5;0;6;1;0;0;0;6;54;1;6;257;120;120;1;0;0;6;6;257;0;2999;6;5;
/org.eclipse.jdt.ui/ui/org/eclipse/jdt/internal/ui/viewsupport/JavaElementImageProvider.java;4;3;22;1;13;9;13;9;117;2;8;1707;670;670;3;1;4;9;22;4035;5;4641;17;4;
/org.eclipse.jdt.ui/core refactoring/org/eclipse/jdt/internal/core/refactoring/code/Selection.java;2;0;3;1;0;0;0;3;2;1;3;408;2;2;1;0;0;3;3;408;0;1236;3;2;
/org.eclipse.jdt.core/model/org/eclipse/jdt/internal/core/builder/IType.java;1;0;4;1;0;0;0;4;104;1;4;455;149;149;1;0;0;4;4;455;0;2808;4;1;
/org.eclipse.swt/Eclipse SWT PI/motif/org/eclipse/swt/internal/motif/XButtonEvent.java;2;0;2;1;1;1;1;1;6;0;1;2069;6;6;1;0;0;1;2;2069;0;4701;2;2;
/org.eclipse.update.core/src/org/eclipse/update/internal/core/FeatureExecutableFactory.java;2;1;18;1;3;3;3;15;113;2;14;2251;336;336;2;1;0;15;18;2791;1;4421;17;2;
/org.eclipse.pde.ui/src/org/eclipse/pde/internal/ui/editor/feature/PreviewAction.java;1;1;2;1;2;2;2;0;7;0;0;3962;7;7;1;0;0;0;2;3962;0;3974;2;1;
/org.eclipse.jdt.ui/ui/org/eclipse/jdt/internal/ui/viewsupport/JavaOverlayDescriptor.java;3;0;5;1;0;0;0;5;8;1;5;15;16;16;1;0;0;5;5;15;0;1310;5;3;
/org.eclipse.jdt.ui/ui refactoring/org/eclipse/jdt/internal/ui/refactoring/RefactoringStatusEntryLabelProvider.java;2;0;3;1;0;0;0;3;6;1;3;1406;8;8;1;0;0;3;3;1406;0;2501;3;2;
/org.eclipse.jdt.core/compiler/org/eclipse/jdt/internal/compiler/ast/Argument.java;2;1;18;1;2;2;2;16;125;4;12;455;333;333;4;4;0;16;18;1039;4;4418;14;2;
/org.eclipse.jdt.ui/core refactoring/org/eclipse/jdt/internal/core/refactoring/methods/ParameterOffsetFinder.java;2;0;3;1;0;0;0;3;36;1;3;408;36;36;1;0;0;3;3;408;0;1342;3;2;
/org.eclipse.search/search/org/eclipse/search/internal/ui/SearchResultContentProvider.java;1;0;2;1;0;0;0;2;9;1;2;15;9;9;1;0;0;2;2;15;0;343;2;1;
/org.eclipse.debug.ui/ui/org/eclipse/debug/internal/ui/launchConfigurations/DebugHistoryPreferenceTab.java;3;1;6;2;2;2;2;4;24;3;2;3132;33;33;3;2;0;4;6;3132;2;4207;4;3;
/org.eclipse.jdt.ui/ui/org/eclipse/jdt/internal/ui/preferences/ZipLabelProvider.java;2;0;4;1;0;0;0;4;5;1;4;15;7;7;1;0;0;4;4;15;0;1258;4;2;
/org.eclipse.update/Eclipse Update/org/eclipse/update/internal/ui/UMApplication.java;2;0;4;1;0;0;0;4;28;1;4;108;32;32;1;0;0;4;4;108;0;1424;4;2;
/org.eclipse.ui.tests/Eclipse UI Tests/org/eclipse/ui/tests/api/MockActionDelegate.java;2;0;7;1;0;0;0;7;20;1;7;1080;39;39;1;0;0;7;7;1080;0;2785;7;2;
/org.eclipse.team.ui/src/org/eclipse/team/internal/ui/target/TargetSyncAction.java;3;2;5;1;5;4;5;0;37;0;0;4215;56;56;2;0;1;0;5;4244;1;4636;4;3;
/org.eclipse.vcm.ui.cvs/src/org/eclipse/vcm/internal/ui/ccvs/ModuleContentProvider.java;1;0;2;1;0;0;0;2;36;0;1;1385;36;36;2;1;0;2;2;1385;1;1385;1;1;
/org.eclipse.jdt.core/model/org/eclipse/jdt/internal/core/hierarchy/HierarchyBinaryType.java;3;1;15;1;4;4;4;11;390;4;7;455;629;629;4;4;0;11;15;1039;4;4404;11;3;
/org.eclipse.jdt.core/model/org/eclipse/jdt/internal/core/jdom/SiblingEnumeration.java;2;0;3;1;1;1;1;2;50;1;2;455;68;68;1;0;0;2;3;455;0;4063;3;2;
/org.eclipse.pde.ui/src/org/eclipse/pde/internal/builders/ISchemaTransformer.java;2;0;2;1;0;0;0;2;0;1;2;1434;0;0;1;0;0;2;2;1434;0;3579;2;2;
/org.eclipse.jdt.core/model/org/eclipse/jdt/core/BufferChangedEvent.java;3;1;4;1;2;2;2;2;101;1;2;455;117;117;1;0;0;2;4;455;0;4422;4;3;
/org.eclipse.team.ftp/src/org/eclipse/team/internal/ftp/client/ControlConnection.java;1;1;2;1;2;2;2;0;8;0;0;4169;8;8;1;0;0;0;2;4169;0;4241;2;1;
/org.eclipse.jdt.ui.tests.refactoring/resources/PullUpMethods/test5/in/A.java;1;0;2;1;0;0;0;2;0;1;2;2156;0;0;1;0;0;2;2;2156;0;2406;2;1;
/org.eclipse.pde.build/src/org/eclipse/pde/internal/build/tasks/BuildManifestTask.java;1;0;4;1;0;0;0;4;221;1;4;3038;223;223;1;0;0;4;4;3038;0;3509;4;1;
/org.eclipse.jdt.ui/ui/org/eclipse/jdt/internal/ui/search/ImplementorsSearchGroup.java;1;3;9;1;5;3;5;4;33;1;4;1707;106;106;3;0;2;4;9;4140;2;4140;7;1;
/org.eclipse.jdt.ui/core extension/org/eclipse/jdt/internal/corext/codemanipulation/UndoMemento.java;1;0;2;1;0;0;0;2;0;0;1;2133;0;0;2;1;0;2;2;2133;1;2133;1;1;
/org.eclipse.jdt.ui.tests/ui/org/eclipse/jdt/ui/tests/core/AddUnimplementedMethodsTest.java;3;0;11;1;1;1;1;10;62;1;10;1189;132;132;1;0;0;10;11;1189;0;4682;11;3;
/org.eclipse.jdt.ui/ui/org/eclipse/jdt/internal/ui/preferences/JavaDebugPreferencePage.java;5;0;16;2;0;0;0;16;511;2;14;965;1114;1114;2;2;0;16;16;1319;2;2010;14;5;
/org.eclipse.core.tests.resources/src/org/eclipse/core/tests/resources/regression/PR_1G1N9GZ_1Test.java;3;0;4;1;0;0;0;4;5;1;4;1794;9;9;1;0;0;4;4;1794;0;3287;4;3;
/org.eclipse.ui/Eclipse UI/org/eclipse/ui/internal/PlaceholderFolderLayout.java;1;0;1;1;0;0;0;1;0;0;1;3528;0;0;1;0;0;1;1;3528;0;3528;1;1;
/org.eclipse.jdt.debug/eval/org/eclipse/jdt/internal/debug/eval/ast/instructions/TwiddleOperator.java;3;0;6;1;0;0;0;6;5;1;6;3421;17;17;1;0;0;6;6;3421;0;3677;6;3;
/org.eclipse.jdt.core/compiler/org/eclipse/jdt/internal/compiler/classfmt/ClassFileReader.java;4;1;28;1;5;5;5;23;1314;4;16;455;4626;4626;4;7;0;23;28;1039;7;4428;21;4;
/org.eclipse.pde.ui/src/org/eclipse/pde/internal/ui/elements/ElementList.java;1;0;1;1;0;0;0;1;0;0;1;3579;0;0;1;0;0;1;1;3579;0;3579;1;1;
/org.eclipse.jdt.ui/ui/org/eclipse/jdt/internal/ui/search/FindHierarchyDeclarationsAction.java;4;0;8;3;0;0;0;8;23;2;7;15;44;44;2;1;0;8;8;1707;1;1707;7;4;
/org.eclipse.jdt.ui/core extension/org/eclipse/jdt/internal/corext/textmanipulation/NopTextEdit.java;2;0;3;1;0;0;0;3;2;1;3;2137;4;4;1;0;0;3;3;2137;0;2769;3;2;
/org.eclipse.jdt.ui/ui/org/eclipse/jdt/internal/ui/javaeditor/JavaMarkerAnnotation.java;5;1;15;1;5;5;5;10;86;1;10;15;224;224;1;0;0;10;15;15;0;4621;15;5;
/org.eclipse.jdt.core/model/org/eclipse/jdt/internal/core/builder/IBuildListener.java;1;0;2;1;0;0;0;2;0;1;2;455;0;0;1;0;0;2;2;455;0;2808;2;1;
/org.eclipse.update.ui/src/org/eclipse/update/internal/ui/parts/MultiPageEditor.java;1;0;2;1;0;0;0;2;0;1;2;1428;0;0;1;0;0;2;2;1428;0;1477;2;1;
/org.eclipse.jdt.debug/eval/org/eclipse/jdt/internal/debug/eval/ast/engine/IRuntimeContext.java;1;0;1;1;0;0;0;1;0;0;1;3645;0;0;1;0;0;1;1;3645;0;3645;1;1;
/org.eclipse.jdt.ui/ui/org/eclipse/jdt/internal/ui/javaeditor/AnnotationErrorTickManager.java;1;0;3;1;0;0;0;3;2;1;3;1035;2;2;1;0;0;3;3;1035;0;1256;3;1;
/org.eclipse.jdt.ui.tests.refactoring/resources/RenameVariables/canRename/A_test9_out.java;1;0;2;1;0;0;0;2;0;1;2;724;0;0;1;0;0;2;2;724;0;1665;2;1;
/org.eclipse.ui/Eclipse JFace/org/eclipse/jface/preference/PreferencePage.java;6;2;13;1;3;2;3;10;16;1;10;257;67;67;2;0;1;10;13;3955;1;4145;12;6;
/org.eclipse.swt/Eclipse SWT OLE Win32/win32/org/eclipse/swt/internal/ole/win32/LICINFO.java;2;0;3;1;0;0;0;3;5;1;3;106;5;5;1;0;0;3;3;106;0;2069;3;2;
/org.eclipse.jdt.debug/eval/org/eclipse/jdt/internal/debug/eval/ast/engine/LeftShiftAssignmentOperator.java;1;0;2;1;0;0;0;2;0;1;2;3329;0;0;1;0;0;2;2;3329;0;3421;2;1;
/org.eclipse.jdt.ui.tests.refactoring/resources/SelectionAnalyzerWorkSpace/SelectionAnalyzerTests/invalidSelection/A_test120.java;1;0;1;1;0;0;0;1;0;0;1;1368;0;0;1;0;0;1;1;1368;0;1368;1;1;
/org.eclipse.ui/Eclipse JFace Text/org/eclipse/jface/text/rules/RuleBasedDamagerRepairer.java;4;0;8;1;1;1;1;7;175;1;7;257;404;404;1;0;0;7;8;257;0;4838;8;4;
/org.eclipse.ui/Eclipse UI/org/eclipse/ui/IViewActionDelegate.java;2;0;2;1;0;0;0;2;5;1;2;257;5;5;1;0;0;2;2;257;0;457;2;2;
/org.eclipse.compare/compare/org/eclipse/compare/internal/Splitter.java;2;0;3;1;0;0;0;3;5;1;3;14;7;7;1;0;0;3;3;14;0;761;3;2;
/org.eclipse.pde.ui/Eclipse PDE UI/org/eclipse/pde/internal/editor/manifest/PluginSpecSection.java;2;0;8;2;0;0;0;8;63;3;6;267;85;85;3;2;0;8;8;324;2;1434;6;2;
/org.eclipse.jdt.debug/jdi interfaces/com/sun/jdi/request/StepRequest.java;2;0;2;1;0;0;0;2;12;1;2;2704;12;12;1;0;0;2;2;2704;0;3040;2;2;
/org.eclipse.scripting/src/org/eclipse/scripting/internal/uirenderer/XGRElementUISwtLayoutTable.java;1;0;1;1;0;0;0;1;0;0;1;1424;0;0;1;0;0;1;1;1424;0;1424;1;1;
/org.eclipse.jdt.ui.tests.refactoring/resources/ExtractMethodWorkSpace/ExtractMethodTests/expression_out/B.java;1;1;3;1;2;2;2;1;0;0;1;3741;0;0;1;0;0;1;3;3741;0;4419;3;1;
/org.eclipse.pde.ui/Eclipse PDE UI/org/eclipse/pde/internal/model/jars/JarsModelFactory.java;2;0;5;2;0;0;0;5;12;3;3;267;12;12;3;2;0;5;5;324;2;1434;3;2;
/org.eclipse.jdt.debug/eval/org/eclipse/jdt/debug/eval/IEvaluationEngine.java;2;0;14;1;1;1;1;13;136;1;13;1675;378;378;1;0;0;13;14;1675;0;3896;14;2;
/org.eclipse.pde.ui/src/org/eclipse/pde/internal/ExternalModelManager.java;2;0;21;1;0;0;0;21;498;2;19;1434;914;914;2;2;0;21;21;2650;2;3579;19;2;
/org.eclipse.jdt.core/compiler/org/eclipse/jdt/internal/compiler/ast/ExplicitConstructorCall.java;2;1;16;1;2;2;2;14;455;4;11;455;1028;1028;4;3;0;14;16;1039;3;4421;13;2;
/org.eclipse.jdt.ui.tests.refactoring/resources/ExtractTemp/canExtract/A_test35_out.java;1;0;1;1;0;0;0;1;0;0;1;3264;0;0;1;0;0;1;1;3264;0;3264;1;1;
/org.eclipse.core.tests.resources/src/org/eclipse/core/tests/resources/MarkerSetTest.java;3;0;4;1;1;1;1;3;294;1;3;1794;331;331;1;0;0;3;4;1794;0;4516;4;3;
/org.eclipse.jdt.ui.tests.refactoring/resources/RenameTemp/canRename/A_test7_in.java;1;0;2;1;0;0;0;2;2;1;2;1625;2;2;1;0;0;2;2;1625;0;1652;2;1;
/org.eclipse.jdt.debug/model/org/eclipse/jdt/debug/core/IJavaDebugConstants.java;3;0;6;1;0;0;0;6;36;1;6;187;81;81;1;0;0;6;6;187;0;1270;6;3;
/org.eclipse.core.target/src/org/eclipse/core/internal/target/AssertionFailedException.java;1;0;4;1;1;1;1;3;54;1;3;12;75;75;1;0;0;3;4;12;0;4196;4;1;
/org.eclipse.jdt.ui.tests.refactoring/resources/PullUp/test12/in/A.java;1;0;1;1;0;0;0;1;0;0;1;2406;0;0;1;0;0;1;1;2406;0;2406;1;1;
/org.eclipse.pde.runtime/Eclipse PDE Runtime/org/eclipse/pde/internal/runtime/registry/PropertiesAction.java;2;0;3;1;0;0;0;3;4;1;3;267;4;4;1;0;0;3;3;267;0;1434;3;2;
/org.eclipse.debug.ui/ui/org/eclipse/debug/internal/ui/views/LaunchViewer.java;3;0;5;1;1;1;1;4;15;1;4;2307;31;31;1;0;0;4;5;2307;0;3975;5;3;
/org.eclipse.swt/Eclipse SWT OLE Win32/win32/org/eclipse/swt/ole/win32/OleParameterDescription.java;2;0;3;1;1;1;1;2;6;1;2;106;12;12;1;0;0;2;3;106;0;4701;3;2;
/org.eclipse.jdt.debug.ui/ui/org/eclipse/jdt/internal/debug/ui/launcher/ComboFieldEditor.java;1;0;2;1;2;1;2;0;27;0;0;4065;27;27;2;0;1;0;2;4065;1;4065;1;1;
/org.eclipse.webdav/src/interface/org/eclipse/webdav/IContextFactory.java;2;0;4;1;1;1;1;3;88;1;3;1635;147;147;1;0;0;3;4;1635;0;4211;4;2;
/org.eclipse.compare/compare/org/eclipse/compare/internal/Pane.java;2;0;4;1;0;0;0;4;5;1;4;14;7;7;1;0;0;4;4;14;0;1802;4;2;
/org.eclipse.team.cvs.core/src/org/eclipse/team/internal/ccvs/core/util/SyncFileWriter.java;2;0;14;1;1;1;1;13;393;2;12;3030;1162;1162;2;1;0;13;14;3417;1;4021;13;2;
/org.eclipse.swt/Eclipse SWT/motif/org/eclipse/swt/internal/motif/XWindowAttributes.java;2;0;3;1;0;0;0;3;4;1;3;106;4;4;1;0;0;3;3;106;0;2069;3;2;
/org.eclipse.swt/Eclipse SWT OLE Win32/win32/org/eclipse/swt/internal/ole/win32/CONTROLINFO.java;2;0;3;1;0;0;0;3;5;1;3;106;5;5;1;0;0;3;3;106;0;2069;3;2;
/org.eclipse.jdt.ui/ui refactoring/org/eclipse/jdt/internal/ui/refactoring/changes/DocumentTextBufferChange.java;2;0;9;1;0;0;0;9;23;1;9;15;44;44;1;0;0;9;9;15;0;2216;9;2;
/org.eclipse.jdt.ui.tests.refactoring/resources/SafeDeleteType/testFail13/in/A.java;1;0;1;1;0;0;0;1;0;0;1;49;0;0;1;0;0;1;1;49;0;49;1;1;
/org.eclipse.ui/Eclipse JFace/org/eclipse/jface/action/AbstractGroupMarker.java;2;0;2;1;0;0;0;2;5;1;2;257;5;5;1;0;0;2;2;257;0;457;2;2;
/org.eclipse.jdt.ui.tests.refactoring/resources/RenameVariables/canRename/A_test14_in.java;1;0;2;1;0;0;0;2;0;1;2;724;0;0;1;0;0;2;2;724;0;1665;2;1;
/org.eclipse.ui/Eclipse UI Tool Script/org/eclipse/toolscript/ui/internal/AntBuildLogger.java;1;1;2;1;2;2;2;0;0;0;0;4065;0;0;1;0;0;0;2;4065;0;4087;2;1;
/org.eclipse.jdt.ui/ui refactoring/org/eclipse/jdt/internal/ui/refactoring/RenameParametersWizard.java;3;0;15;1;0;0;0;15;30;2;14;233;98;98;2;1;0;15;15;1339;1;2630;14;3;
/org.eclipse.jdt.ui.tests.refactoring/resources/DeleteSourceReference/test4/out/A.java;1;0;1;1;0;0;0;1;0;0;1;2857;0;0;1;0;0;1;1;2857;0;2857;1;1;
/org.eclipse.ui/Eclipse UI/org/eclipse/ui/actions/MoveResourceAction.java;7;0;7;1;1;1;1;6;264;1;6;257;334;334;1;0;0;6;7;257;0;4265;7;7;
/org.eclipse.jdt.ui.tests.refactoring/resources/PullUp/test1/out/A.java;1;0;1;1;0;0;0;1;0;0;1;2406;0;0;1;0;0;1;1;2406;0;2406;1;1;
/org.eclipse.jdt.ui/core refactoring/org/eclipse/jdt/internal/core/refactoring/tagging/IReferenceUpdatingRefactoring.java;2;0;2;1;0;0;0;2;0;1;2;1665;0;0;1;0;0;2;2;1665;0;1939;2;2;
/org.eclipse.update.core/src/org/eclipse/update/internal/core/PluginEntry.java;2;0;7;1;0;0;0;7;79;2;6;1451;214;214;2;1;0;7;7;1451;1;2583;6;2;
/org.eclipse.ui/Eclipse UI Standard Components/org/eclipse/ui/views/bookmarkexplorer/IBookmarkHelpContextIds.java;3;0;3;1;0;0;0;3;10;1;3;620;11;11;1;0;0;3;3;620;0;2989;3;3;
/org.eclipse.jdt.ui.tests.refactoring/resources/ExtractMethodWorkSpace/ExtractMethodTests/invalidSelection/A_test014.java;2;1;3;1;2;2;2;1;0;0;1;49;0;0;1;0;0;1;3;49;0;4419;3;2;
/org.eclipse.swt.examples.controls/src/org/eclipse/swt/examples/controls/RangeTab.java;2;0;2;1;0;0;0;2;0;1;2;391;0;0;1;0;0;2;2;391;0;611;2;2;
/org.eclipse.debug.core/core/org/eclipse/debug/internal/core/OutputStreamMonitor.java;3;0;14;2;1;1;1;13;178;2;12;728;446;446;2;1;0;13;14;3359;1;4292;13;3;
/org.eclipse.jdt.ui/core refactoring/org/eclipse/jdt/internal/corext/refactoring/changes/CopyPackageChange.java;2;0;3;1;1;1;1;2;15;1;2;1939;18;18;1;0;0;2;3;1939;0;4212;3;2;
/org.eclipse.jdt.debug/jdi/org/eclipse/jdi/internal/jdwp/JdwpInterfaceID.java;2;0;3;1;0;0;0;3;12;1;3;187;13;13;1;0;0;3;3;187;0;3040;3;2;
/org.eclipse.swt/Eclipse SWT/gtk/org/eclipse/swt/widgets/Slider.java;6;1;12;1;5;5;5;7;78;1;7;2107;203;203;1;0;0;7;12;2107;0;4701;12;6;
/org.eclipse.jdt.core/search/org/eclipse/jdt/internal/core/index/impl/FileListBlock.java;2;0;4;1;1;1;1;3;62;1;3;455;86;86;1;0;0;3;4;455;0;4063;4;2;
/org.eclipse.ui/Eclipse JFace Text/org/eclipse/jface/text/reconciler/AbstractReconciler.java;2;1;6;1;4;4;4;2;380;1;2;1226;532;532;1;0;0;2;6;1226;0;4838;6;2;
/org.eclipse.jdt.core/model/org/eclipse/jdt/internal/core/jdom/DOMPackage.java;2;0;12;1;1;1;1;11;233;4;8;455;331;331;4;3;0;11;12;1039;3;4063;9;2;
/org.eclipse.debug.ui/ui/org/eclipse/debug/internal/ui/actions/DisconnectActionDelegate.java;2;1;9;1;3;3;3;6;44;1;6;2382;75;75;1;0;0;6;9;2382;0;4163;9;2;
/org.eclipse.jdt.ui.tests.refactoring/resources/ExtractMethodWorkSpace/ExtractMethodTests/invalidSelection/A_test107.java;2;1;3;1;2;2;2;1;0;0;1;49;0;0;1;0;0;1;3;49;0;4419;3;2;
/org.eclipse.jdt.ui.tests.refactoring/resources/RenameType/test9/out/B.java;1;0;1;1;0;0;0;1;0;0;1;522;0;0;1;0;0;1;1;522;0;522;1;1;
/org.eclipse.jdt.ui.tests.refactoring/resources/MoveCU/testFail6/in/p/A.java;2;0;2;1;0;0;0;2;0;1;2;49;0;0;1;0;0;2;2;49;0;2769;2;2;
/org.eclipse.swt.examples.launcher/src/org/eclipse/swt/examples/launcher/LauncherView.java;5;0;7;2;1;1;1;6;234;2;5;513;372;372;2;1;0;6;7;609;1;4705;6;5;
/org.eclipse.jdt.ui.tests.refactoring/resources/templates/test/out/A.java;1;0;1;1;0;0;0;1;0;0;1;49;0;0;1;0;0;1;1;49;0;49;1;1;
/org.eclipse.pde.ui/Eclipse PDE UI/org/eclipse/pde/internal/editor/PDEChildFormPage.java;2;0;5;2;0;0;0;5;12;3;3;267;12;12;3;2;0;5;5;324;2;1434;3;2;
/org.eclipse.jdt.core/search/org/eclipse/jdt/internal/core/search/indexing/IIndexConstants.java;3;1;12;1;2;2;2;10;156;4;7;455;324;324;4;3;0;10;12;1039;3;4357;9;3;
/org.eclipse.ui/Eclipse UI/org/eclipse/ui/internal/ShortcutBarPartDragDrop.java;1;0;1;1;0;0;0;1;0;0;1;3837;0;0;1;0;0;1;1;3837;0;3837;1;1;
/org.eclipse.jdt.ui.tests.refactoring/resources/RenameMethodInInterface/test34/in/A.java;1;0;1;1;0;0;0;1;0;0;1;49;0;0;1;0;0;1;1;49;0;49;1;1;
/org.eclipse.jdt.debug/jdi/org/eclipse/jdi/internal/request/ClassPrepareRequestImpl.java;2;0;4;1;0;0;0;4;12;1;4;187;26;26;1;0;0;4;4;187;0;3670;4;2;
/org.eclipse.jdt.ui/core refactoring/org/eclipse/jdt/internal/corext/refactoring/tagging/IReferenceUpdatingRefactoring.java;1;0;1;1;0;0;0;1;0;0;1;1939;0;0;1;0;0;1;1;1939;0;1939;1;1;
/org.eclipse.team.core/src/org/eclipse/team/internal/core/target/RemoteTargetSyncElement.java;2;1;3;1;3;3;3;0;204;0;0;4555;207;207;1;0;0;0;3;4555;0;4636;3;2;
/org.eclipse.ui/Eclipse UI/org/eclipse/ui/part/PageSite.java;1;0;1;1;0;0;0;1;0;0;1;1779;0;0;1;0;0;1;1;1779;0;1779;1;1;
/org.eclipse.ui/Eclipse UI/org/eclipse/ui/IStorageEditorInput.java;2;0;2;1;0;0;0;2;7;1;2;257;7;7;1;0;0;2;2;257;0;457;2;2;
/org.eclipse.jdt.ui/core refactoring/org/eclipse/jdt/core/refactoring/code/CommentAnalyzer.java;1;0;2;1;0;0;0;2;0;1;2;376;0;0;1;0;0;2;2;376;0;408;2;1;
/org.eclipse.pde.core/src/org/eclipse/pde/internal/core/schema/AbstractSchemaDescriptor.java;1;0;2;1;0;0;0;2;19;1;2;3591;19;19;1;0;0;2;2;3591;0;3607;2;1;
/org.eclipse.help/src/CookieExample.java;1;0;2;1;0;0;0;2;0;1;2;1882;0;0;1;0;0;2;2;1882;0;1930;2;1;
/org.eclipse.ui/Eclipse JFace/org/eclipse/jface/preference/IPreferenceStore.java;4;0;4;1;1;1;1;3;5;1;3;257;11;11;1;0;0;3;4;257;0;4022;4;4;
/org.eclipse.help/src/org/eclipse/help/internal/contributions/xml/HelpContext.java;2;0;2;1;0;0;0;2;0;1;2;1420;0;0;1;0;0;2;2;1420;0;1675;2;2;
/org.eclipse.jdt.ui.tests.refactoring/resources/RenameType/test37/out/B.java;1;0;1;1;0;0;0;1;0;0;1;49;0;0;1;0;0;1;1;49;0;49;1;1;
/org.eclipse.jdt.ui.tests.refactoring/resources/ExtractMethodWorkSpace/ExtractMethodTests/locals_in/A_test528.java;1;0;1;1;1;1;1;0;0;0;0;4424;0;0;1;0;0;0;1;4424;0;4424;1;1;
/org.eclipse.ui/Eclipse UI Standard Components/org/eclipse/ui/views/internal/framelist/FrameList.java;3;0;4;1;0;0;0;4;6;1;4;257;9;9;1;0;0;4;4;257;0;3816;4;3;
/org.eclipse.ui/Eclipse UI/org/eclipse/ui/internal/ActionSetContributionItem.java;2;0;2;1;0;0;0;2;4;1;2;457;4;4;1;0;0;2;2;457;0;620;2;2;
/org.eclipse.jdt.ui.tests.refactoring/resources/PullUp/test4/in/A.java;1;0;1;1;0;0;0;1;0;0;1;2406;0;0;1;0;0;1;1;2406;0;2406;1;1;
/org.eclipse.jdt.ui.tests.refactoring/resources/RenameTemp/cannotRename/A_testFail1.java;1;0;2;1;0;0;0;2;1;1;2;1625;1;1;1;0;0;2;2;1625;0;1652;2;1;
/org.eclipse.help/src/org/eclipse/help/internal/contributors/xml/HelpContextManager.java;2;0;3;1;0;0;0;3;53;1;3;1420;53;53;1;0;0;3;3;1420;0;1675;3;2;
/org.eclipse.ui/Eclipse UI Text Editor/org/eclipse/ui/editors/text/FileDocumentProvider.java;4;1;15;1;7;7;7;8;208;1;8;257;913;913;1;0;0;8;15;257;0;4838;15;4;
/org.eclipse.pde.ui/src/org/eclipse/pde/internal/editor/text/PDEPartitionScanner.java;2;0;2;1;0;0;0;2;0;1;2;1434;0;0;1;0;0;2;2;1434;0;3579;2;2;
/org.eclipse.jdt.ui.tests.refactoring/resources/SelectionAnalyzerWorkSpace/SelectionAnalyzerTests/validSelection/A_test252.java;1;0;1;1;0;0;0;1;0;0;1;1368;0;0;1;0;0;1;1;1368;0;1368;1;1;
/org.eclipse.core.resources/src/org/eclipse/core/internal/resources/DelayedSnapshotRunnable.java;2;2;3;1;3;2;3;0;4;0;0;4127;4;4;2;0;1;0;3;4209;1;4209;2;2;
/org.eclipse.jdt.debug/jdi/org/eclipse/jdi/internal/request/RequestID.java;2;0;4;1;0;0;0;4;12;1;4;187;23;23;1;0;0;4;4;187;0;3670;4;2;
/org.eclipse.jdt.debug/model/org/eclipse/jdt/internal/debug/core/breakpoints/JavaWatchpoint.java;3;0;16;2;1;1;1;15;143;2;13;2517;365;365;2;2;0;15;16;2517;2;4547;14;3;
/org.eclipse.jdt.core/model/org/eclipse/jdt/internal/core/builder/ProblemFactory.java;3;0;3;2;2;1;2;1;21;0;1;2979;21;21;2;0;1;1;3;4063;1;4063;2;3;
/org.eclipse.team.cvs.ui/src/org/eclipse/team/internal/ccvs/ui/model/RemoteProject.java;2;0;3;1;0;0;0;3;9;1;3;2055;13;13;1;0;0;3;3;2055;0;2126;3;2;
/org.eclipse.jdt.core/model/org/eclipse/jdt/core/jdom/IDOMImport.java;2;0;4;1;1;1;1;3;44;1;3;455;72;72;1;0;0;3;4;455;0;4061;4;2;
/org.eclipse.vcm.core.cvs/src/org/eclipse/vcm/internal/core/ccvs/client/CVSFileException.java;3;0;3;1;0;0;0;3;9;1;3;0;12;12;1;0;0;3;3;0;0;298;3;3;
/org.eclipse.swt/Eclipse SWT/carbon/org/eclipse/swt/graphics/Cursor.java;3;1;4;1;4;4;4;0;46;0;0;4147;57;57;1;0;0;0;4;4147;0;4701;4;3;
/org.eclipse.help/webapps/examples/WEB-INF/classes/cal/JspCalendar.java;1;0;2;1;0;0;0;2;0;1;2;1882;0;0;1;0;0;2;2;1882;0;1930;2;1;
/org.eclipse.jdt.ui.tests.refactoring/resources/ExtractMethodWorkSpace/ExtractMethodTests/E.java;1;1;3;1;2;2;2;1;24;0;1;2638;24;24;1;0;0;1;3;2638;0;4419;3;1;
/org.eclipse.ui/Eclipse JFace Text/org/eclipse/jface/text/rules/EndOfLineRule.java;3;0;3;1;0;0;0;3;5;1;3;257;8;8;1;0;0;3;3;257;0;1066;3;3;
/org.eclipse.jdt.core/search/org/eclipse/jdt/internal/core/index/impl/Index.java;4;1;17;1;3;3;3;14;173;4;11;455;341;341;4;3;0;14;17;1039;3;4525;14;4;
/org.eclipse.jdt.ui.tests.refactoring/resources/SelectionAnalyzerWorkSpace/SelectionAnalyzerTests/validSelection/A_test094_.java;1;0;1;1;0;0;0;1;0;0;1;2139;0;0;1;0;0;1;1;2139;0;2139;1;1;
/org.eclipse.team.cvs.core/src/org/eclipse/team/internal/ccvs/core/client/listeners/ModuleExpansion.java;1;0;3;1;0;0;0;3;2;1;3;2702;4;4;1;0;0;3;3;2702;0;2893;3;1;
/org.eclipse.jdt.ui/ui/org/eclipse/jdt/internal/ui/compare/JavaStructureCreator.java;4;2;25;2;4;3;4;21;228;2;19;15;788;788;2;2;1;21;25;1955;3;4621;22;4;
/org.eclipse.ui/Eclipse UI/org/eclipse/ui/internal/CyclePerspectiveAction.java;4;1;5;2;2;2;2;3;16;2;2;3747;31;31;2;1;0;3;5;3747;1;4730;4;4;
/org.eclipse.update.ui/src/org/eclipse/update/internal/ui/model/PendingChange.java;1;0;3;1;0;0;0;3;10;1;3;2797;20;20;1;0;0;3;3;2797;0;2943;3;1;
/org.eclipse.update.core/src/org/eclipse/update/core/UpdateManagerPlugin.java;1;0;5;1;0;0;0;5;12;1;5;1531;24;24;1;0;0;5;5;1531;0;1643;5;1;
/org.eclipse.update.core/src/org/eclipse/update/internal/core/SiteReconciler.java;2;2;22;1;22;17;22;0;371;0;0;3901;1399;1399;2;0;5;0;22;3901;5;4617;17;2;
/org.eclipse.jdt.ui.tests.refactoring/resources/ExtractMethodWorkSpace/ExtractMethodTests/invalidSelection/A_test140.java;2;1;6;1;2;2;2;4;38;1;4;216;67;67;1;0;0;4;6;216;0;4419;6;2;
/org.eclipse.swt/Eclipse SWT PI/photon/org/eclipse/swt/internal/photon/PhArea_t.java;2;0;2;1;1;1;1;1;6;0;1;2069;6;6;1;0;0;1;2;2069;0;4701;2;2;
/org.eclipse.ui/Eclipse UI Standard Components/org/eclipse/ui/views/tasklist/TaskAction.java;4;0;4;1;1;1;1;3;9;1;3;257;13;13;1;0;0;3;4;257;0;4269;4;4;
/org.eclipse.swt/Eclipse SWT PI/photon/org/eclipse/swt/internal/photon/PhImage_t.java;2;0;2;1;1;1;1;1;6;0;1;2069;6;6;1;0;0;1;2;2069;0;4701;2;2;
/org.eclipse.jdt.ui/core refactoring/org/eclipse/jdt/internal/core/refactoring/changes/RenamePackageChange.java;2;0;3;1;0;0;0;3;10;1;3;1342;10;10;1;0;0;3;3;1342;0;1939;3;2;
/org.eclipse.pde.ui/Eclipse PDE UI/org/eclipse/pde/internal/base/model/component/IComponentModel.java;2;0;5;2;0;0;0;5;12;3;3;267;12;12;3;2;0;5;5;324;2;1434;3;2;
/org.eclipse.jdt.ui.tests.refactoring/resources/PullUp/test4/out/A.java;1;0;1;1;0;0;0;1;0;0;1;2406;0;0;1;0;0;1;1;2406;0;2406;1;1;
/org.eclipse.jdt.debug/jdi/org/eclipse/jdi/internal/AccessibleImpl.java;2;0;4;1;0;0;0;4;14;1;4;187;28;28;1;0;0;4;4;187;0;3670;4;2;
/org.eclipse.jdt.ui.tests.refactoring/resources/RenameMethodInInterface/test19/out/A.java;1;0;1;1;0;0;0;1;0;0;1;49;0;0;1;0;0;1;1;49;0;49;1;1;
/org.eclipse.ui/Eclipse UI/org/eclipse/ui/actions/OpenResourceAction.java;5;0;5;1;0;0;0;5;160;1;5;257;182;182;1;0;0;5;5;257;0;3571;5;5;
/org.eclipse.update.ui/src/org/eclipse/update/internal/ui/parts/WebBrowser.java;2;0;8;1;1;1;1;7;13;1;7;1477;30;30;1;0;0;7;8;1477;0;4127;8;2;
/org.eclipse.jdt.ui/ui/org/eclipse/jdt/ui/actions/OpenExternalJavadocAction.java;3;2;12;2;6;5;6;6;59;2;4;3533;193;193;2;2;1;6;12;3623;3;4770;9;3;
/org.eclipse.pde.core/src/org/eclipse/pde/internal/core/feature/FeatureFactory.java;1;0;2;1;1;1;1;1;7;0;1;3591;7;7;1;0;0;1;2;3591;0;3982;2;1;
/org.eclipse.team.cvs.ui/src/org/eclipse/team/internal/ccvs/ui/actions/BranchAction.java;3;2;16;2;4;3;4;12;173;2;11;2290;365;365;2;1;1;12;16;3676;2;4125;14;3;
/org.eclipse.jdt.ui/ui/org/eclipse/jdt/internal/ui/wizards/dialogfields/SelectionButtonDialogFieldGroup.java;2;0;6;1;0;0;0;6;54;1;6;15;92;92;1;0;0;6;6;15;0;3084;6;2;
/org.eclipse.pde.runtime/src/org/eclipse/pde/internal/runtime/PDERuntimePlugin.java;2;0;2;1;1;1;1;1;73;0;1;1434;73;73;1;0;0;1;2;1434;0;4425;2;2;
/org.eclipse.swt.examples/org/eclipse/swt/examples/controlexample/Tab.java;5;2;9;1;5;4;5;4;647;1;4;513;1331;1331;2;0;1;4;9;3914;1;4024;8;5;
/org.eclipse.vcm.core/src/org/eclipse/vcm/internal/core/base/IChangeSet.java;2;0;2;1;0;0;0;2;4;1;2;0;4;4;1;0;0;2;2;0;0;297;2;2;
/org.eclipse.help/src/org/eclipse/help/internal/contributors/Contributor.java;2;0;2;1;0;0;0;2;0;1;2;1420;0;0;1;0;0;2;2;1420;0;1675;2;2;
/org.eclipse.jdt.debug/eval/org/eclipse/jdt/internal/debug/eval/ast/engine/BinaryEvaluationSourceGenerator.java;1;0;2;1;0;0;0;2;0;1;2;3421;0;0;1;0;0;2;2;3421;0;3447;2;1;
/org.eclipse.jdt.debug.ui/ui/org/eclipse/jdt/internal/debug/ui/actions/ManageBreakpointActionDelegate.java;1;1;10;1;10;10;10;0;84;0;0;3935;268;268;1;0;0;0;10;3935;0;4692;10;1;
/org.eclipse.team.cvs.core/src/org/eclipse/team/internal/ccvs/core/client/UpdatedHandler.java;2;0;17;2;0;0;0;17;104;2;15;2572;278;278;2;2;0;17;17;2791;2;3739;15;2;
/org.eclipse.jdt.ui/ui/org/eclipse/jdt/internal/ui/javaeditor/ClassFileEditorInputFactory.java;2;0;4;1;0;0;0;4;5;1;4;15;11;11;1;0;0;4;4;15;0;1685;4;2;
/org.eclipse.jdt.ui.tests.refactoring/resources/RenameStaticMethod/testFail1/in/A.java;1;0;1;1;0;0;0;1;0;0;1;49;0;0;1;0;0;1;1;49;0;49;1;1;
/org.eclipse.jdt.core/model/org/eclipse/jdt/internal/core/builder/impl/BuildMonitorImpl.java;1;0;3;1;0;0;0;3;13;1;3;455;13;13;1;0;0;3;3;455;0;2808;3;1;
/org.eclipse.jdt.ui/ui/org/eclipse/jdt/ui/actions/SurroundWithTryCatchAction.java;2;2;8;1;8;7;8;0;28;0;0;3970;99;99;2;0;1;0;8;4422;1;4770;7;2;
/org.eclipse.jdt.ui.tests.refactoring/resources/RenameVariables/cannotRename/A_testFail6.java;1;0;2;1;0;0;0;2;0;1;2;724;0;0;1;0;0;2;2;724;0;1665;2;1;
/org.eclipse.update.ui.forms/src/org/eclipse/update/ui/forms/internal/IFormTextListener.java;1;0;1;1;0;0;0;1;0;0;1;2470;0;0;1;0;0;1;1;2470;0;2470;1;1;
/org.eclipse.swt/Eclipse SWT/carbon/org/eclipse/swt/graphics/Font.java;3;1;4;1;4;4;4;0;6;0;0;4147;15;15;1;0;0;0;4;4147;0;4701;4;3;
/org.eclipse.jdt.ui.tests/test plugin/org/eclipse/jdt/testplugin/TestWorkbench.java;2;0;5;1;1;1;1;4;29;2;2;1186;55;55;2;2;0;4;5;1186;2;4682;3;2;
/org.eclipse.swt/Eclipse SWT/photon/org/eclipse/swt/widgets/ColorDialog.java;4;1;9;1;3;3;3;6;90;2;5;106;111;111;2;1;0;6;9;2064;1;4701;8;4;
/org.eclipse.jdt.ui.tests.refactoring/resources/MoveMembers/testFail1/in/A.java;1;0;1;1;0;0;0;1;0;0;1;2738;0;0;1;0;0;1;1;2738;0;2738;1;1;
/org.eclipse.pde.ui/src/org/eclipse/pde/internal/editor/PDEMultiPageXMLEditor.java;2;0;3;1;0;0;0;3;4;1;3;1434;4;4;1;0;0;3;3;1434;0;3579;3;2;
/org.eclipse.pde.ui/Eclipse PDE UI/org/eclipse/pde/internal/model/NLResourceHelper.java;2;0;5;2;0;0;0;5;12;3;3;267;12;12;3;2;0;5;5;324;2;1434;3;2;
/org.eclipse.team.ui/src/org/eclipse/team/internal/ui/DetailsDialog.java;2;1;3;1;3;3;3;0;67;0;0;4284;75;75;1;0;0;0;3;4284;0;4569;3;2;
/org.eclipse.help.ui/src/org/eclipse/help/ui/internal/browser/BrowserDescriptor.java;1;0;2;1;0;0;0;2;2;1;2;2429;2;2;1;0;0;2;2;2429;0;3609;2;1;
/org.eclipse.swt/Eclipse SWT/win32/org/eclipse/swt/graphics/FontMetrics.java;4;1;5;1;2;2;2;3;13;1;3;106;26;26;1;0;0;3;5;106;0;4701;5;4;
/org.eclipse.swt/Eclipse SWT PI/carbon/org/eclipse/swt/internal/carbon/MacControlEvent.java;2;1;2;1;2;2;2;0;6;0;0;4147;6;6;1;0;0;0;2;4147;0;4701;2;2;
/org.eclipse.ui/Eclipse UI Standard Components/org/eclipse/ui/views/navigator/ResourceNavigator.java;8;2;46;3;8;6;8;38;1549;3;29;257;3230;3230;3;9;2;38;46;3491;11;4425;35;8;
/org.eclipse.ui/Eclipse UI/org/eclipse/ui/internal/SetPagePerspectiveAction.java;2;1;5;1;2;2;2;3;19;1;3;3050;30;30;1;0;0;3;5;3050;0;4382;5;2;
/org.eclipse.jdt.ui.tests.refactoring/resources/ExtractMethodWorkSpace/ExtractMethodTests/locals_in/A_test543.java;1;1;3;1;2;2;2;1;2;0;1;922;2;2;1;0;0;1;3;922;0;4419;3;1;
/org.eclipse.ui/Eclipse UI Standard Components/org/eclipse/ui/views/properties/CategoriesAction.java;4;0;4;1;0;0;0;4;5;1;4;257;9;9;1;0;0;4;4;257;0;3029;4;4;
/org.eclipse.jdt.ui.tests.refactoring/resources/ExtractTemp/canExtract/A_test9_in.java;1;0;1;1;0;0;0;1;0;0;1;2481;0;0;1;0;0;1;1;2481;0;2481;1;1;
/org.eclipse.core.resources/src/org/eclipse/core/internal/events/ResourceChangeEvent.java;2;0;5;1;1;1;1;4;156;1;4;12;212;212;1;0;0;4;5;12;0;4214;5;2;
/org.eclipse.ui/Eclipse JFace Text/org/eclipse/jface/text/TextUtilities.java;3;0;5;1;0;0;0;5;58;1;5;257;82;82;1;0;0;5;5;257;0;1320;5;3;
/org.eclipse.jdt.ui/ui/org/eclipse/jdt/internal/ui/snippeteditor/SnippetOpenOnSelectionAction.java;5;0;7;2;0;0;0;7;54;2;6;15;95;95;2;1;0;7;7;759;1;1916;6;5;
/org.eclipse.ui/Eclipse UI/org/eclipse/ui/dialogs/IWorkingSetSelectionDialog.java;1;0;1;1;0;0;0;1;0;0;1;3494;0;0;1;0;0;1;1;3494;0;3494;1;1;
/org.eclipse.jdt.ui/ui/org/eclipse/jdt/internal/ui/wizards/buildpaths/CPListElement.java;3;1;13;1;2;2;2;11;55;1;11;15;236;236;1;0;0;11;13;15;0;4162;13;3;
/org.eclipse.help/src/org/eclipse/help/standalone/Help.java;2;0;3;1;1;1;1;2;24;1;2;3270;31;31;1;0;0;2;3;3270;0;4426;3;2;
/org.eclipse.pde.ui/src/org/eclipse/pde/internal/ui/editor/SubActionBars.java;1;0;1;1;0;0;0;1;0;0;1;3579;0;0;1;0;0;1;1;3579;0;3579;1;1;
/org.eclipse.pde.build/src/org/eclipse/pde/internal/build/BuildAntScript.java;1;0;8;1;1;1;1;7;17;3;4;3128;23;23;3;3;0;7;8;3190;3;4082;5;1;
/org.eclipse.jdt.debug.ui/ui/org/eclipse/jdt/internal/debug/ui/launcher/IEntriesChangedListener.java;1;0;1;1;1;1;1;0;0;0;0;4197;0;0;1;0;0;0;1;4197;0;4197;1;1;
/org.eclipse.jdt.ui/ui/org/eclipse/jdt/internal/ui/util/JavaModelUtility.java;2;0;14;1;0;0;0;14;70;2;13;15;382;382;2;1;0;14;14;432;1;1228;13;2;
/org.eclipse.pde.core/src/org/eclipse/pde/internal/core/ifeature/IFeatureInfo.java;1;0;1;1;0;0;0;1;0;0;1;3591;0;0;1;0;0;1;1;3591;0;3591;1;1;
/org.eclipse.jdt.junit/src/org/eclipse/jdt/junit/wizards/SelectionButtonGroup.java;2;0;3;1;0;0;0;3;4;1;3;3247;4;4;1;0;0;3;3;3247;0;3394;3;2;
/org.eclipse.jdt.ui.tests.refactoring/resources/ExtractMethodWorkSpace/ExtractMethodTests/return_in/A_test715.java;1;1;3;1;2;2;2;1;30;0;1;923;30;30;1;0;0;1;3;923;0;4419;3;1;
/org.eclipse.team.cvs.core/src/org/eclipse/team/internal/ccvs/core/client/listeners/ModuleDefinitionsListener.java;2;0;8;1;1;1;1;7;76;2;6;2702;107;107;2;1;0;7;8;2702;1;4368;7;2;
/org.eclipse.pde.ui/src/org/eclipse/pde/internal/editor/manifest/ManifestEditor.java;2;0;16;1;0;0;0;16;460;2;15;1434;566;566;2;1;0;16;16;2921;1;3579;15;2;
/org.eclipse.jdt.core/model/org/eclipse/jdt/internal/core/newbuilder/CompilationUnit.java;1;0;3;1;0;0;0;3;6;1;3;1764;6;6;1;0;0;3;3;1764;0;1947;3;1;
/org.eclipse.swt.tests/JUnit Tests/org/eclipse/swt/tests/junit/Test_org_eclipse_swt_custom_TableTree.java;2;0;2;1;1;1;1;1;6;0;1;1792;6;6;1;0;0;1;2;1792;0;4706;2;2;
/org.eclipse.jdt.core/dom/org/eclipse/jdt/core/dom/SwitchCase.java;2;1;7;1;2;2;2;5;9;1;5;2669;37;37;1;0;0;5;7;2669;0;4453;7;2;
/org.eclipse.update/src/org/eclipse/update/internal/ui/UMWizardProductComponentRevert.java;1;0;1;1;0;0;0;1;0;0;1;1424;0;0;1;0;0;1;1;1424;0;1424;1;1;
/org.eclipse.jdt.ui/core refactoring/org/eclipse/jdt/internal/core/refactoring/text/SimpleTextChange.java;4;0;7;1;0;0;0;7;33;1;7;408;94;94;1;0;0;7;7;408;0;1939;7;4;
/org.eclipse.pde.ui/Eclipse PDE UI/org/eclipse/pde/internal/component/ComponentData.java;2;0;5;2;0;0;0;5;12;3;3;267;12;12;3;2;0;5;5;324;2;1434;3;2;
/org.eclipse.vcm.core.cvs/src/org/eclipse/vcm/internal/core/ccvs/CVSStatus.java;4;0;4;1;0;0;0;4;10;1;4;0;22;22;1;0;0;4;4;0;0;413;4;4;
/org.eclipse.pde.ui/src/org/eclipse/pde/internal/ui/preferences/SourcePreferencePage.java;1;2;6;1;6;4;6;0;97;0;0;4228;199;199;2;0;2;0;6;4228;2;4567;4;1;
/org.eclipse.jdt.ui/ui/org/eclipse/jdt/internal/ui/packageview/JavaElementPatternFilter.java;3;0;7;1;1;1;1;6;10;1;6;37;24;24;1;0;0;6;7;37;0;4211;7;3;
/org.eclipse.jdt.ui/ui/org/eclipse/jdt/ui/actions/FindStringsToExternalizeAction.java;2;1;13;2;4;4;4;9;202;3;6;3533;398;398;3;3;0;9;13;3639;3;4770;10;2;
/org.eclipse.pde.ui/src/org/eclipse/pde/internal/ui/editor/feature/FeatureSourcePage.java;1;0;1;1;0;0;0;1;0;0;1;3579;0;0;1;0;0;1;1;3579;0;3579;1;1;
/org.eclipse.jdt.ui/core refactoring/org/eclipse/jdt/internal/core/nls/changes/DeleteFileChange.java;1;0;2;1;0;0;0;2;0;1;2;1913;0;0;1;0;0;2;2;1913;0;1922;2;1;
/org.eclipse.jdt.ui.tests.refactoring/resources/ExtractMethodWorkSpace/ExtractMethodTests/validSelection/A_test273.java;2;1;3;1;2;2;2;1;0;0;1;49;0;0;1;0;0;1;3;49;0;4419;3;2;
/org.eclipse.ui/Eclipse UI Tool Script/org/eclipse/toolscript/core/internal/ToolScriptRegistry.java;1;1;3;1;3;3;3;0;14;0;0;3920;14;14;1;0;0;0;3;3920;0;4087;3;1;
/org.eclipse.jdt.ui.tests.refactoring/resources/RenameMethodInInterface/test38/out/A.java;1;0;1;1;0;0;0;1;0;0;1;49;0;0;1;0;0;1;1;49;0;49;1;1;
/org.eclipse.pde.build/src/plugin/org/eclipse/pde/internal/core/Policy.java;1;0;1;1;0;0;0;1;0;0;1;3475;0;0;1;0;0;1;1;3475;0;3475;1;1;
/org.eclipse.jdt.ui/core refactoring/org/eclipse/jdt/internal/core/nls/model/NLSLine.java;1;0;2;1;0;0;0;2;0;1;2;1913;0;0;1;0;0;2;2;1913;0;1922;2;1;
/org.eclipse.jdt.debug.ui/ui/org/eclipse/jdt/internal/debug/ui/launcher/VMConnectTimeoutStatusHandler.java;2;0;2;1;0;0;0;2;2;1;2;3122;2;2;1;0;0;2;2;3122;0;3676;2;2;
/org.eclipse.team.core/src/org/eclipse/team/core/internal/TeamManager.java;2;0;6;2;0;0;0;6;550;2;5;1978;744;744;2;1;0;6;6;2864;1;3213;5;2;
/org.eclipse.vcm.core.cvs/src/org/eclipse/vcm/internal/core/ccvs/requests/ModuleNames.java;2;0;2;1;0;0;0;2;45;1;2;1008;45;45;1;0;0;2;2;1008;0;1277;2;2;
/org.eclipse.swt.examples/org/eclipse/swt/examples/fileviewer/IconCache.java;4;0;5;1;1;1;1;4;149;1;4;554;183;183;1;0;0;4;5;554;0;4024;5;4;
/org.eclipse.jdt.ui/core refactoring/org/eclipse/jdt/internal/core/refactoring/rename/RenameMethodInInterfaceRefactoring.java;2;0;4;2;0;0;0;4;132;2;3;1342;158;158;2;1;0;4;4;1938;1;1938;3;2;
/org.eclipse.core.resources/src_ant/org/eclipse/core/resources/ant/ConvertPath.java;2;1;4;1;2;2;2;2;18;1;2;3509;39;39;1;0;0;2;4;3509;0;4633;4;2;
/org.eclipse.jdt.ui.tests.refactoring/resources/InlineTemp/canInline/A_test7_out.java;1;0;1;1;0;0;0;1;0;0;1;2051;0;0;1;0;0;1;1;2051;0;2051;1;1;
/org.eclipse.team.ui/src/org/eclipse/team/internal/ui/sync/SyncCompareInput.java;3;2;12;2;7;5;7;5;232;3;2;2054;485;485;3;3;2;5;12;2054;5;4628;7;3;
/org.eclipse.jdt.ui.tests.refactoring/resources/ExtractMethodWorkSpace/ExtractMethodTests/locals_in/A_test515.java;2;1;4;1;2;2;2;2;8;1;2;369;12;12;1;0;0;2;4;369;0;4419;4;2;
/org.eclipse.jdt.ui/ui/org/eclipse/jdt/internal/ui/wizards/buildpaths/ProjectsWorkbookPage.java;3;0;13;1;1;1;1;12;32;1;12;15;117;117;1;0;0;12;13;15;0;4083;13;3;
/org.eclipse.jdt.ui/ui refactoring/org/eclipse/jdt/internal/ui/refactoring/DeleteInputPage.java;1;0;1;1;0;0;0;1;0;0;1;1108;0;0;1;0;0;1;1;1108;0;1108;1;1;
/org.eclipse.jdt.ui/ui/org/eclipse/jdt/internal/ui/search/FindDeclarationsAction.java;2;2;14;1;4;3;4;10;35;1;10;15;163;163;2;0;1;10;14;4140;1;4140;13;2;
/org.eclipse.jdt.ui.tests.refactoring/resources/RenameMethodInInterface/test6/in/A.java;1;0;1;1;0;0;0;1;0;0;1;49;0;0;1;0;0;1;1;49;0;49;1;1;
/org.eclipse.jdt.ui.tests.refactoring/resources/SefWorkSpace/SefTests/invalid/TestPostfixExpression.java;1;0;1;1;0;0;0;1;0;0;1;2876;0;0;1;0;0;1;1;2876;0;2876;1;1;
/org.eclipse.vcm.ui.cvs/src/org/eclipse/vcm/internal/ui/ccvs/ICVSHelpContextIds.java;1;0;5;1;0;0;0;5;25;1;5;977;31;31;1;0;0;5;5;977;0;1436;5;1;
/org.eclipse.jdt.ui/ui/org/eclipse/jdt/internal/ui/util/JdtPortingFinder.java;1;0;3;1;0;0;0;3;8;1;3;15;8;8;1;0;0;3;3;15;0;437;3;1;
/org.eclipse.update.core/src/org/eclipse/update/configuration/IInstallConfigurationChangedListener.java;2;0;3;1;1;1;1;2;19;1;2;3018;37;37;1;0;0;2;3;3018;0;4687;3;2;
/org.eclipse.team.cvs.ui/src/org/eclipse/team/internal/ccvs/ui/model/CVSRepositoryLocationPropertySource.java;2;0;3;1;0;0;0;3;18;1;3;3053;24;24;1;0;0;3;3;3053;0;3644;3;2;
/org.eclipse.jdt.ui.tests.refactoring/resources/RenameType/test10/in/A.java;1;0;1;1;0;0;0;1;0;0;1;49;0;0;1;0;0;1;1;49;0;49;1;1;
/org.eclipse.swt/Eclipse SWT PI/gtk/org/eclipse/swt/internal/gtk/GtkAllocation.java;3;0;4;1;2;1;2;2;10;1;2;2107;17;17;2;0;1;2;4;4701;1;4701;3;3;
/org.eclipse.debug.ui/ui/org/eclipse/debug/internal/ui/RemoveTerminatedAction.java;3;0;10;2;0;0;0;10;90;2;9;187;191;191;2;1;0;10;10;346;1;2382;9;3;
/org.eclipse.update.ui/src/org/eclipse/update/internal/ui/pages/SearchPage.java;1;0;2;1;0;0;0;2;3;1;2;3553;3;3;1;0;0;2;2;3553;0;3662;2;1;
/org.eclipse.jdt.debug.tests/tests/org/eclipse/jdt/debug/tests/eval/NestedTypeFieldValue_728.java;2;1;3;1;3;3;3;0;12;0;0;4447;14;14;1;0;0;0;3;4447;0;4571;3;2;
/org.eclipse.swt.examples/org/eclipse/swt/examples/explorer/TreeView.java;1;0;1;1;0;0;0;1;0;0;1;547;0;0;1;0;0;1;1;547;0;547;1;1;
/org.eclipse.help/src/org/eclipse/help/internal/search/ProgressDirstributor.java;1;0;2;1;2;1;2;0;0;0;0;4000;0;0;2;0;1;0;2;4000;1;4000;1;1;
/org.eclipse.jdt.ui.tests.refactoring/resources/ExtractMethodWorkSpace/ExtractMethodTests/return_out/A_test716.java;1;1;3;1;2;2;2;1;26;0;1;1236;26;26;1;0;0;1;3;1236;0;4419;3;1;
/org.eclipse.core.resources/src/org/eclipse/core/internal/resources/Synchronizer.java;3;1;11;1;3;3;3;8;472;1;8;12;684;684;1;0;0;8;11;12;0;4552;11;3;
/org.eclipse.pde.core/src/org/eclipse/pde/internal/core/ischema/IMetaElement.java;1;0;2;1;0;0;0;2;3;1;2;3591;3;3;1;0;0;2;2;3591;0;3607;2;1;
/org.eclipse.debug.core/core/org/eclipse/debug/core/IDebugEventFilter.java;1;0;3;1;0;0;0;3;16;1;3;2391;22;22;1;0;0;3;3;2391;0;3460;3;1;
/org.eclipse.vcm.core.cvs/src/org/eclipse/vcm/internal/core/ccvs/StickyTag.java;1;0;1;1;0;0;0;1;0;0;1;663;0;0;1;0;0;1;1;663;0;663;1;1;
/org.eclipse.update.ui.forms/src/org/eclipse/update/ui/forms/FormButton.java;1;0;2;1;0;0;0;2;0;1;2;1423;0;0;1;0;0;2;2;1423;0;2474;2;1;
/org.eclipse.jdt.ui/ui/org/eclipse/jdt/internal/ui/preferences/EditTemplateDialog.java;5;1;25;2;6;6;6;19;146;2;13;1601;799;799;2;6;0;19;25;1601;6;4700;19;5;
/org.eclipse.help.ui/src/org/eclipse/help/internal/ui/win32/HelpControlSite.java;2;0;3;1;0;0;0;3;8;1;3;1420;8;8;1;0;0;3;3;1420;0;3030;3;2;
/org.eclipse.jdt.ui.tests.refactoring/resources/PullUp/test4/in/B.java;1;0;1;1;0;0;0;1;0;0;1;2406;0;0;1;0;0;1;1;2406;0;2406;1;1;
/org.eclipse.ui/Eclipse JFace/org/eclipse/jface/viewers/SelectionChangedEvent.java;2;0;2;1;0;0;0;2;5;1;2;257;5;5;1;0;0;2;2;257;0;457;2;2;
/org.eclipse.ant.core/src/org/eclipse/ant/core/AntRunnerListener.java;2;0;4;2;0;0;0;4;6;2;3;360;8;8;2;1;0;4;4;493;1;981;3;2;
/org.eclipse.ui/Eclipse UI Tool Script/org/eclipse/toolscript/core/internal/ToolUtil.java;1;2;3;1;3;2;3;0;168;0;0;4066;168;168;2;0;1;0;3;4083;1;4083;2;1;
/org.eclipse.pde.ui/src/org/eclipse/pde/ui/IBasePluginWizard.java;1;0;2;1;1;1;1;1;6;0;1;3579;6;6;1;0;0;1;2;3579;0;4752;2;1;
/org.eclipse.jdt.debug/model/org/eclipse/jdt/internal/debug/core/model/JDIVariable.java;3;0;6;2;0;0;0;6;38;3;4;2517;86;86;3;2;0;6;6;2517;2;3576;4;3;
/org.eclipse.pde.ui/src/org/eclipse/pde/internal/ui/parts/CheckboxTablePart.java;1;0;2;1;1;1;1;1;7;0;1;3579;7;7;1;0;0;1;2;3579;0;4345;2;1;
/org.eclipse.jdt.ui/core refactoring/org/eclipse/jdt/internal/core/refactoring/changes/RenameJavaProjectChange.java;2;0;3;1;0;0;0;3;8;1;3;1342;8;8;1;0;0;3;3;1342;0;1939;3;2;
/org.eclipse.swt.examples.paint/src/org/eclipse/swt/examples/paint/DragInteractivePaintSession.java;2;0;2;1;0;0;0;2;0;1;2;391;0;0;1;0;0;2;2;391;0;611;2;2;
/org.eclipse.vcm.ui/src/org/eclipse/vcm/internal/ui/sync/IVCMNode.java;2;0;7;1;0;0;0;7;51;1;7;48;95;95;1;0;0;7;7;48;0;350;7;2;
/org.eclipse.jdt.ui.tests.refactoring/resources/RenamePackage/test2/in/fred/A.java;2;0;2;1;0;0;0;2;4;1;2;49;4;4;1;0;0;2;2;49;0;1258;2;2;
/org.eclipse.jdt.ui/core extension/org/eclipse/jdt/internal/corext/codemanipulation/MemberEdit.java;4;1;18;2;2;2;2;16;71;2;13;1955;240;240;2;3;0;16;18;1955;3;4000;15;4;
/org.eclipse.update.core/src/org/eclipse/update/core/IVerifier.java;2;0;7;2;1;1;1;6;41;2;4;3255;73;73;2;2;0;6;7;3574;2;4008;5;2;
/org.eclipse.jdt.ui.tests.refactoring/resources/ExtractMethodWorkSpace/ExtractMethodTests/return_in/A_test714.java;1;1;3;1;2;2;2;1;16;0;1;923;16;16;1;0;0;1;3;923;0;4419;3;1;
/org.eclipse.vcm.tests.core.cvs/src/org/eclipse/vcm/tests/core/cvs/PruningTest.java;1;0;1;1;0;0;0;1;0;0;1;1688;0;0;1;0;0;1;1;1688;0;1688;1;1;
/org.eclipse.jdt.ui/ui/org/eclipse/jdt/internal/ui/dialogs/StatusDialog.java;5;0;18;1;1;1;1;17;43;3;15;15;131;131;3;2;0;17;18;571;2;4018;16;5;
/org.eclipse.jdt.ui/core refactoring/org/eclipse/jdt/internal/corext/refactoring/base/IReorgExceptionHandler.java;1;0;1;1;1;1;1;0;0;0;0;3947;0;0;1;0;0;0;1;3947;0;3947;1;1;
/org.eclipse.jdt.ui.tests.refactoring/resources/MoveMembers/test10/out/A.java;1;0;1;1;0;0;0;1;0;0;1;2738;0;0;1;0;0;1;1;2738;0;2738;1;1;
/org.eclipse.swt/Eclipse SWT PI/win32/org/eclipse/swt/internal/ole/win32/LICINFO.java;2;0;2;1;1;1;1;1;6;0;1;2069;6;6;1;0;0;1;2;2069;0;4701;2;2;
/org.eclipse.core.runtime/src/org/eclipse/core/internal/plugins/Extension.java;3;0;7;1;2;1;2;5;98;1;5;12;129;129;2;0;1;5;7;4212;1;4212;6;3;
/org.eclipse.ui/Eclipse UI/org/eclipse/ui/internal/dialogs/ProjectCapabilityPropertyPage.java;1;0;8;1;0;0;0;8;87;1;8;3238;128;128;1;0;0;8;8;3238;0;3576;8;1;
/org.eclipse.debug.core/core/org/eclipse/debug/core/IStreamListener.java;2;0;4;1;0;0;0;4;6;1;4;187;15;15;1;0;0;4;4;187;0;3460;4;2;
/org.eclipse.jdt.ui.tests.refactoring/resources/ReorderParameters/canReorder/A_test18_out.java;1;0;1;1;0;0;0;1;0;0;1;2296;0;0;1;0;0;1;1;2296;0;2296;1;1;
/org.eclipse.swt.tests/JUnit Tests/org/eclipse/swt/tests/junit/SwtJunit.java;3;2;4;1;3;2;3;1;6;0;1;1792;10;10;2;0;1;1;4;4429;1;4706;3;3;
/org.eclipse.pde.ui/src/org/eclipse/pde/internal/ui/editor/schema/DocSection.java;1;2;10;1;6;5;6;4;472;2;3;3579;599;599;2;1;1;4;10;3579;2;4573;8;1;
/org.eclipse.vcm.core/src/org/eclipse/vcm/internal/core/adapter/IRepositoryAdapter.java;4;0;8;2;0;0;0;8;11;2;7;0;41;41;2;1;0;8;8;194;1;983;7;4;
/org.eclipse.help/src/org/eclipse/help/internal/contributors/xml/XMLActionContributor.java;2;0;2;1;0;0;0;2;0;1;2;1420;0;0;1;0;0;2;2;1420;0;1675;2;2;
/org.eclipse.swt.examples/src/org/eclipse/swt/examples/explorer/TreeView.java;1;0;1;1;0;0;0;1;0;0;1;547;0;0;1;0;0;1;1;547;0;547;1;1;
/org.eclipse.jdt.ui.tests.refactoring/resources/RenamePackage/test4/in/p/p1/A.java;2;0;2;1;0;0;0;2;0;1;2;91;0;0;1;0;0;2;2;91;0;1258;2;2;
/org.eclipse.jdt.debug.ui/ui/org/eclipse/jdt/internal/debug/ui/JavaExceptionBreakpointPropertySource.java;2;0;3;1;0;0;0;3;12;1;3;1915;12;12;1;0;0;3;3;1915;0;2794;3;2;
/org.eclipse.ui/Eclipse UI/org/eclipse/ui/internal/dialogs/FakeViewActionSet.java;2;0;2;1;0;0;0;2;4;1;2;257;4;4;1;0;0;2;2;257;0;457;2;2;
/org.eclipse.core.runtime/src/org/eclipse/core/internal/plugins/RegistryCacheReader.java;5;3;28;2;7;5;7;21;2922;2;18;12;5422;5422;3;3;2;21;28;4212;5;4726;23;5;
/org.eclipse.pde.ui/src/org/eclipse/pde/internal/core/builders/SchemaTransformer.java;1;0;3;1;0;0;0;3;2;1;3;3579;2;2;1;0;0;3;3;3579;0;3607;3;1;
/org.eclipse.jdt.ui.tests.refactoring/resources/RenameMethodInInterface/test28/out/A.java;1;0;1;1;0;0;0;1;0;0;1;49;0;0;1;0;0;1;1;49;0;49;1;1;
/org.eclipse.jdt.ui/ui/org/eclipse/jdt/ui/actions/FindReferencesInWorkingSetAction.java;2;1;2;1;2;2;2;0;18;0;0;4141;18;18;1;0;0;0;2;4141;0;4770;2;2;
/org.eclipse.core.tests.runtime/src/org/eclipse/core/tests/internal/plugin/a/ConfigurableExtension.java;3;0;3;1;0;0;0;3;32;1;3;1794;42;42;1;0;0;3;3;1794;0;3476;3;3;
/org.eclipse.ui.tests/Eclipse JFace Tests/org/eclipse/jface/tests/viewers/StructuredViewerTest.java;1;0;2;1;1;1;1;1;15;0;1;1488;15;15;1;0;0;1;2;1488;0;4146;2;1;
/org.eclipse.pde.runtime/src/org/eclipse/pde/internal/runtime/registry/ConfigurationElementAdapter.java;1;0;1;1;0;0;0;1;0;0;1;1434;0;0;1;0;0;1;1;1434;0;1434;1;1;
/org.eclipse.ui/Eclipse UI/org/eclipse/ui/internal/DecoratorManager.java;3;2;31;2;5;4;5;26;273;3;18;1932;1299;1299;3;8;1;26;31;2197;9;4626;22;3;
/org.eclipse.jdt.ui.tests.refactoring/resources/ExtractTemp/canExtract/A_test33_in.java;1;0;1;1;0;0;0;1;0;0;1;3226;0;0;1;0;0;1;1;3226;0;3226;1;1;
/org.eclipse.jdt.ui.tests/test plugin/org/eclipse/jdt/testplugin/JavaTestProject.java;3;0;6;1;0;0;0;6;38;1;6;49;72;72;1;0;0;6;6;49;0;1228;6;3;
/org.eclipse.jdt.ui.tests.refactoring/resources/RenameMethodInInterface/test27/in/A.java;1;0;1;1;0;0;0;1;0;0;1;49;0;0;1;0;0;1;1;49;0;49;1;1;
/org.eclipse.scripting/Eclipse Scripting/org/eclipse/scripting/internal/uirenderer/XGRElementUISwtTextArea.java;2;0;5;1;0;0;0;5;12;1;5;133;33;33;1;0;0;5;5;133;0;1424;5;2;
/org.eclipse.update.core/src/org/eclipse/update/core/SiteContentConsumer.java;2;0;3;1;0;0;0;3;40;1;3;2465;40;40;1;0;0;3;3;2465;0;3018;3;2;
/org.eclipse.jdt.junit/Eclipse JUnit/org/eclipse/jdt/internal/junit/ui/JUnitLaunchWizardPage.java;2;0;4;1;0;0;0;4;44;1;4;2143;46;46;1;0;0;4;4;2143;0;3313;4;2;
/org.eclipse.jdt.ui.tests.refactoring/resources/RenameVirtualMethodInClass/testFail5/in/A.java;1;0;1;1;0;0;0;1;0;0;1;49;0;0;1;0;0;1;1;49;0;49;1;1;
/org.eclipse.jdt.ui.tests.refactoring/resources/RenameNonPrivateField/test7/out/A.java;1;0;1;1;0;0;0;1;0;0;1;49;0;0;1;0;0;1;1;49;0;49;1;1;
/org.eclipse.ui/Eclipse JFace Text/org/eclipse/jface/text/contentassist/IContentAssistant.java;3;0;3;1;0;0;0;3;38;1;3;257;43;43;1;0;0;3;3;257;0;1066;3;3;
/org.eclipse.pde.ui/Eclipse PDE UI/org/eclipse/pde/internal/editor/PDEFormPage.java;2;0;7;2;0;0;0;7;12;3;5;267;17;17;3;2;0;7;7;324;2;1434;5;2;
/org.eclipse.update.ui/src/org/eclipse/update/internal/ui/search/ISearchCategory.java;1;0;3;1;0;0;0;3;23;1;3;3553;25;25;1;0;0;3;3;3553;0;3660;3;1;
/org.eclipse.swt.examples/org/eclipse/swt/examples/texteditor/TextEditor.java;5;0;6;1;1;1;1;5;355;1;5;540;437;437;1;0;0;5;6;540;0;4024;6;5;
/org.eclipse.jdt.ui.tests.refactoring/resources/ExtractMethodWorkSpace/ExtractMethodTests/locals_out/A_test542.java;1;1;4;1;2;2;2;2;4;1;2;922;6;6;1;0;0;2;4;922;0;4419;4;1;
/org.eclipse.search/search/org/eclipse/search/internal/ui/SearchAgainAction.java;2;0;3;1;0;0;0;3;9;1;3;78;13;13;1;0;0;3;3;78;0;687;3;2;
/org.eclipse.jdt.ui/core refactoring/org/eclipse/jdt/internal/corext/refactoring/util/CommentAnalyzer.java;2;1;7;1;2;2;2;5;14;1;5;3106;36;36;1;0;0;5;7;3106;0;4000;7;2;
/org.eclipse.jdt.core/model/org/eclipse/jdt/core/IJavaModel.java;2;2;9;1;7;6;7;2;319;1;2;455;439;439;2;0;1;2;9;4453;1;4453;8;2;
/org.eclipse.jdt.ui.tests.refactoring/resources/MoveMembers/test14/in/B.java;1;0;1;1;0;0;0;1;0;0;1;2738;0;0;1;0;0;1;1;2738;0;2738;1;1;
/org.eclipse.swt/Eclipse SWT Custom Widgets/common/org/eclipse/swt/custom/CTabFolder.java;7;2;53;2;15;13;15;38;499;3;32;106;3676;3676;3;6;2;38;53;2876;8;4701;45;7;
/org.eclipse.vcm.core/src/org/eclipse/vcm/internal/core/Assert.java;4;0;4;2;0;0;0;4;26;2;3;0;34;34;2;1;0;4;4;292;1;292;3;4;
/org.eclipse.jdt.ui.tests.refactoring/resources/ExtractMethodWorkSpace/ExtractMethodTests/expression_in/A_test618.java;1;1;3;1;2;2;2;1;16;0;1;1368;16;16;1;0;0;1;3;1368;0;4419;3;1;
/org.eclipse.update.ui.forms/src/org/eclipse/update/ui/forms/internal/FormWidgetFactory.java;1;1;14;1;6;6;6;8;588;1;8;2470;698;698;1;0;0;8;14;2470;0;4690;14;1;
/org.eclipse.jdt.debug.ui/ui/org/eclipse/jdt/internal/debug/ui/JavaDebugPreferencePage.java;3;2;42;1;11;9;11;31;676;2;30;2009;1775;1775;2;1;2;31;42;2762;3;4551;39;3;
/org.eclipse.update.core/src/org/eclipse/update/internal/core/FeatureExecutable.java;2;0;8;1;0;0;0;8;23;1;8;1791;41;41;1;0;0;8;8;1791;0;2583;8;2;
/org.eclipse.ui/Eclipse UI Text Editor/org/eclipse/ui/texteditor/EditorMessages.java;1;0;1;1;0;0;0;1;0;0;1;1066;0;0;1;0;0;1;1;1066;0;1066;1;1;
/org.eclipse.swt.tests/JUnit Tests/org/eclipse/swt/tests/junit/Test_org_eclipse_swt_events_HelpListener.java;2;0;2;1;1;1;1;1;6;0;1;1792;6;6;1;0;0;1;2;1792;0;4706;2;2;
/org.eclipse.swt/Eclipse SWT Drag and Drop/emulated/org/eclipse/swt/dnd/ByteArrayTransfer.java;2;2;6;1;5;4;5;1;91;0;1;3126;121;121;2;0;1;1;6;4824;1;4824;5;2;
/org.eclipse.scripting/src/org/eclipse/scripting/internal/views/ScriptUIEditorXmlElement.java;1;0;1;1;0;0;0;1;0;0;1;1424;0;0;1;0;0;1;1;1424;0;1424;1;1;
/org.eclipse.vcm.core.cvs/src/org/eclipse/vcm/internal/core/ccvs/client/ClearStaticHandler.java;1;0;1;1;0;0;0;1;0;0;1;1372;0;0;1;0;0;1;1;1372;0;1372;1;1;
/org.eclipse.jdt.junit/Eclipse JUnit/org/eclipse/jdt/internal/junit/ui/CopyTraceAction.java;2;0;4;1;0;0;0;4;12;2;3;2399;14;14;2;1;0;4;4;2399;1;3313;3;2;
/org.eclipse.team.cvs.core/src/org/eclipse/team/internal/ccvs/core/client/RemoveEntryHandler.java;2;0;6;1;0;0;0;6;55;1;6;2572;74;74;1;0;0;6;6;2572;0;3610;6;2;
/org.eclipse.pde.ui/src/org/eclipse/pde/internal/model/component/ComponentPlugin.java;2;0;2;1;0;0;0;2;0;1;2;1434;0;0;1;0;0;2;2;1434;0;2951;2;2;
/org.eclipse.jdt.ui/ui/org/eclipse/jdt/internal/ui/codemanipulation/AddJavaDocStubOperation.java;1;0;5;1;0;0;0;5;14;1;5;1359;20;20;1;0;0;5;5;1359;0;2016;5;1;
/org.eclipse.pde.ui/src/org/eclipse/pde/internal/wizards/NewWizard.java;2;0;3;1;0;0;0;3;3;1;3;1434;3;3;1;0;0;3;3;1434;0;3579;3;2;
/org.eclipse.jdt.core/model/org/eclipse/jdt/internal/core/Buffer.java;3;4;30;1;8;5;8;22;1223;4;16;455;2288;2288;4;6;3;22;30;1039;9;4569;21;3;
/org.eclipse.jdt.launching/launching/org/eclipse/jdt/launching/StandardSourcePathProvider.java;1;2;3;1;3;2;3;0;6;0;0;4168;6;6;2;0;1;0;3;4211;1;4211;2;1;
/org.eclipse.jdt.ui/ui/org/eclipse/jdt/internal/ui/jarexporter/WizardJarFileExportPage1.java;1;0;2;1;0;0;0;2;0;1;2;15;0;0;1;0;0;2;2;15;0;239;2;1;
/org.eclipse.jdt.ui/core refactoring/org/eclipse/jdt/internal/core/refactoring/nls/NLSElement.java;2;0;3;1;0;0;0;3;2;2;2;1922;2;2;2;1;0;3;3;1937;1;1937;2;2;
/org.eclipse.ant.core/src/org/eclipse/ant/core/ConvertPath.java;3;0;3;1;0;0;0;3;334;1;3;896;334;334;1;0;0;3;3;896;0;3489;3;3;
/org.eclipse.jdt.ui.tests.refactoring/resources/RenameType/testFail28/in/A.java;1;0;1;1;0;0;0;1;0;0;1;49;0;0;1;0;0;1;1;49;0;49;1;1;
/org.eclipse.ui/Eclipse JFace/org/eclipse/jface/viewers/ITreeContentProvider.java;2;0;2;1;0;0;0;2;5;1;2;257;5;5;1;0;0;2;2;257;0;457;2;2;
/org.eclipse.update.ui/src/org/eclipse/update/internal/ui/manager/MainForm.java;1;0;17;1;0;0;0;17;188;2;14;1428;522;522;2;3;0;17;17;1457;3;3662;14;1;
/org.eclipse.jdt.junit/Eclipse JUnit/org/eclipse/jdt/junit/internal/MessageIds.java;2;0;2;1;0;0;0;2;0;1;2;1531;0;0;1;0;0;2;2;1531;0;2007;2;2;
/org.eclipse.jdt.core/model/org/eclipse/jdt/core/util/ByteCodeVisitorAdapter.java;2;1;4;1;3;3;3;1;18;0;1;3629;34;34;1;0;0;1;4;3629;0;4836;4;2;
/org.eclipse.update.core/src/org/eclipse/update/core/model/InstallHandlerModel.java;2;0;3;1;0;0;0;3;126;1;3;2409;126;126;1;0;0;3;3;2409;0;2981;3;2;
/org.eclipse.swt.examples/src/org/eclipse/swt/examples/addressbook/AddressBook.java;5;1;8;1;2;2;2;6;908;1;6;513;1179;1179;1;0;0;6;8;513;0;4705;8;5;
/org.eclipse.ui/Eclipse JFace/org/eclipse/jface/dialogs/TitleAreaDialog.java;5;1;16;1;2;2;2;14;160;2;12;257;437;437;2;2;0;14;16;2426;2;4380;14;5;
/org.eclipse.jdt.ui.tests.refactoring/resources/ExtractMethodWorkSpace/ExtractMethodTests/T4165.java;1;1;3;1;2;2;2;1;0;0;1;3168;0;0;1;0;0;1;3;3168;0;4419;3;1;
/org.eclipse.swt/Eclipse SWT/gtk/org/eclipse/swt/widgets/Widget.java;5;2;28;2;10;9;10;18;165;2;16;2107;579;579;2;2;1;18;28;2807;3;4701;25;5;
/org.eclipse.jdt.ui/ui refactoring/org/eclipse/jdt/internal/ui/refactoring/changes/ChangeExceptionHandler.java;4;0;7;1;0;0;0;7;9;1;7;157;29;29;1;0;0;7;7;157;0;2684;7;4;
/org.eclipse.scripting/Eclipse Scripting/org/eclipse/scripting/internal/views/ScriptUIEditorContentOutlinePage.java;2;0;4;1;0;0;0;4;20;1;4;133;36;36;1;0;0;4;4;133;0;1424;4;2;
/org.eclipse.core.resources/src/org/eclipse/core/internal/localstore/SafeFileInputStream.java;2;0;5;1;1;1;1;4;76;1;4;12;99;99;1;0;0;4;5;12;0;4214;5;2;
/org.eclipse.jdt.core/compiler/org/eclipse/jdt/internal/compiler/util/CharOperation.java;2;1;16;1;3;3;3;13;1109;4;9;455;1292;1292;4;4;0;13;16;1039;4;4444;12;2;
/org.eclipse.jdt.core/model/org/eclipse/jdt/internal/core/JarPackageFragmentInfo.java;2;0;5;1;1;1;1;4;41;1;4;455;69;69;1;0;0;4;5;455;0;4063;5;2;
/org.eclipse.pde.ui/src/org/eclipse/pde/internal/ui/editor/text/ColorManager.java;1;0;2;1;1;1;1;1;61;0;1;3579;61;61;1;0;0;1;2;3579;0;4588;2;1;
/org.eclipse.core.tests.resources/src/org/eclipse/core/tests/resources/MarkersChangeListener.java;3;0;4;1;1;1;1;3;212;1;3;1794;237;237;1;0;0;3;4;1794;0;4516;4;3;
/org.eclipse.team.ftp/src/org/eclipse/team/internal/ftp/client/ListFilesWorker.java;1;1;4;1;4;4;4;0;5;0;0;4169;9;9;1;0;0;0;4;4169;0;4573;4;1;
/org.eclipse.jdt.debug/eval/org/eclipse/jdt/internal/debug/eval/ast/engine/PushArrayType.java;1;0;3;1;0;0;0;3;2;1;3;3329;2;2;1;0;0;3;3;3329;0;3421;3;1;
/org.eclipse.jdt.ui.tests.refactoring/resources/DeleteSourceReference/test12/out/A.java;1;0;1;1;0;0;0;1;0;0;1;2857;0;0;1;0;0;1;1;2857;0;2857;1;1;
/org.eclipse.update.ui/src/org/eclipse/update/internal/ui/manager/SnapshotPage.java;1;0;3;1;0;0;0;3;2;1;3;2107;2;2;1;0;0;3;3;2107;0;2827;3;1;
/org.eclipse.swt/Eclipse SWT PI/photon/org/eclipse/swt/internal/photon/PgVideoModeInfo_t.java;2;0;2;1;1;1;1;1;6;0;1;2069;6;6;1;0;0;1;2;2069;0;4701;2;2;
/org.eclipse.scripting/src/org/eclipse/scripting/internal/views/ScriptConsoleViewer.java;1;0;1;1;0;0;0;1;0;0;1;1424;0;0;1;0;0;1;1;1424;0;1424;1;1;
/org.eclipse.swt/Eclipse SWT/photon/org/eclipse/swt/widgets/Composite.java;6;2;25;1;8;7;8;17;145;1;17;106;978;978;2;0;1;17;25;4464;1;4701;24;6;
/org.eclipse.jdt.ui/core refactoring/org/eclipse/jdt/internal/core/refactoring/fields/RenameFieldASTAnalyzer.java;2;0;3;1;0;0;0;3;4;1;3;408;4;4;1;0;0;3;3;408;0;1342;3;2;
/org.eclipse.jdt.ui.tests.refactoring/resources/DeleteSourceReferenceEdit/A_testField3_out.java;1;0;1;1;0;0;0;1;0;0;1;2857;0;0;1;0;0;1;1;2857;0;2857;1;1;
/org.eclipse.pde.core/src/org/eclipse/pde/internal/core/plugin/PluginImport.java;1;0;2;1;1;1;1;1;3;0;1;3591;3;3;1;0;0;1;2;3591;0;4552;2;1;
/org.eclipse.update.ui/src/org/eclipse/update/internal/ui/search/MyComputerSearchSettings.java;1;0;2;1;0;0;0;2;16;1;2;3537;16;16;1;0;0;2;2;3537;0;3662;2;1;
/org.eclipse.swt.tests/JUnit Tests/org/eclipse/swt/tests/junit/Test_org_eclipse_swt_widgets_FileDialog.java;2;0;2;1;1;1;1;1;6;0;1;1792;6;6;1;0;0;1;2;1792;0;4706;2;2;
/org.eclipse.core.resources/src/org/eclipse/core/internal/utils/Policy.java;3;2;13;2;3;2;3;10;308;1;10;12;439;439;2;0;1;10;13;4209;1;4268;12;3;
/org.eclipse.swt/Eclipse SWT OLE Win32/win32/org/eclipse/swt/internal/ole/win32/IDataObject.java;2;0;3;1;0;0;0;3;9;1;3;106;9;9;1;0;0;3;3;106;0;2069;3;2;
/org.eclipse.jdt.ui/ui/org/eclipse/jdt/ui/actions/FindWriteReferencesAction.java;3;1;3;1;3;3;3;0;9;0;0;4141;13;13;1;0;0;0;3;4141;0;4770;3;3;
/org.eclipse.jdt.ui.tests.refactoring/resources/RenameType/testFail21/in/C.java;1;0;1;1;0;0;0;1;0;0;1;49;0;0;1;0;0;1;1;49;0;49;1;1;
/org.eclipse.pde.ui/src/org/eclipse/pde/internal/editor/schema/SchemaAdapterFactory.java;2;0;2;1;0;0;0;2;0;1;2;1434;0;0;1;0;0;2;2;1434;0;3579;2;2;
/org.eclipse.swt.examples/org/eclipse/swt/examples/controlexample/AlignableTab.java;3;0;4;1;1;1;1;3;106;1;3;513;179;179;1;0;0;3;4;513;0;4024;4;3;
/org.eclipse.jdt.ui.tests/JUnit/junit/ui/Logo.java;2;0;2;1;0;0;0;2;0;1;2;49;0;0;1;0;0;2;2;49;0;1186;2;2;
/org.eclipse.swt/Eclipse SWT Custom Widgets/common/org/eclipse/swt/custom/BusyIndicator.java;3;1;5;1;2;2;2;3;52;1;3;106;106;106;1;0;0;3;5;106;0;4701;5;3;
/org.eclipse.jdt.ui.tests.refactoring/resources/ExtractMethodWorkSpace/ExtractMethodTests/errors_out/A_test801.java;1;0;2;1;0;0;0;2;0;1;2;3124;0;0;1;0;0;2;2;3124;0;3736;2;1;
/org.eclipse.jdt.debug.ui/ui/org/eclipse/jdt/internal/debug/ui/launcher/ListContentProvider.java;2;0;2;1;0;0;0;2;4;1;2;1915;4;4;1;0;0;2;2;1915;0;3385;2;2;
/org.eclipse.jdt.debug.ui/ui/org/eclipse/jdt/internal/debug/ui/BreakpointUtils.java;3;0;12;1;0;0;0;12;17;2;11;2558;73;73;2;1;0;12;12;3362;1;3833;11;3;
/org.eclipse.webdav/src/kernel/org/eclipse/webdav/internal/kernel/utils/ExcludingEnumeration.java;1;0;4;1;1;1;1;3;94;1;3;12;114;114;1;0;0;3;4;12;0;4211;4;1;
/org.eclipse.debug.core/core/org/eclipse/debug/core/IBreakpoint.java;2;0;5;1;0;0;0;5;119;1;5;831;205;205;1;0;0;5;5;831;0;1139;5;2;
/org.eclipse.jdt.debug.tests/tests/org/eclipse/jdt/debug/tests/eval/TypeHierarchy_57_2.java;2;1;3;1;3;3;3;0;13;0;0;4447;15;15;1;0;0;0;3;4447;0;4571;3;2;
/org.eclipse.jdt.ui.tests.refactoring/resources/ExtractMethodWorkSpace/ExtractMethodTests/BBB.java;1;1;3;1;2;2;2;1;92;0;1;2915;92;92;1;0;0;1;3;2915;0;4419;3;1;
/org.eclipse.jdt.ui/core refactoring/org/eclipse/jdt/internal/corext/refactoring/base/Context.java;1;0;1;1;1;1;1;0;0;0;0;4014;0;0;1;0;0;0;1;4014;0;4014;1;1;
/org.eclipse.jdt.ui.tests.refactoring/resources/SefWorkSpace/SefTests/object_out/TestArrayRead.java;1;0;1;1;0;0;0;1;0;0;1;2617;0;0;1;0;0;1;1;2617;0;2617;1;1;
/org.eclipse.pde.ui/src/org/eclipse/pde/core/IWritable.java;1;0;2;1;0;0;0;2;0;1;2;3579;0;0;1;0;0;2;2;3579;0;3607;2;1;
/org.eclipse.jdt.ui/ui/org/eclipse/jdt/internal/ui/wizards/dialogfields/CheckedListDialogField.java;2;0;11;1;0;0;0;11;125;1;11;15;230;230;1;0;0;11;11;15;0;2045;11;2;
/org.eclipse.pde.ui/src/org/eclipse/pde/internal/ui/editor/schema/DocForm.java;1;0;1;1;0;0;0;1;0;0;1;3579;0;0;1;0;0;1;1;3579;0;3579;1;1;
/org.eclipse.swt/Eclipse SWT/win32/org/eclipse/swt/internal/win32/WINDOWPOS.java;2;0;3;1;0;0;0;3;5;1;3;106;5;5;1;0;0;3;3;106;0;2069;3;2;
/org.eclipse.jdt.ui.tests/ui/org/eclipse/jdt/ui/tests/core/AllTypesCacheTest.java;1;0;2;1;0;0;0;2;7;1;2;2805;7;7;1;0;0;2;2;2805;0;2820;2;1;
/org.eclipse.jdt.ui/ui/org/eclipse/jdt/ui/actions/BuildActionGroup.java;1;1;9;1;7;7;7;2;21;1;2;3716;75;75;1;0;0;2;9;3716;0;4770;9;1;
/org.eclipse.pde.ui/Eclipse PDE UI/org/eclipse/pde/internal/base/model/build/IBuild.java;2;0;5;2;0;0;0;5;12;3;3;267;12;12;3;2;0;5;5;324;2;1434;3;2;
/org.eclipse.jdt.ui/ui/org/eclipse/jdt/internal/ui/typehierarchy/EnableMemberFilterAction.java;3;0;9;1;1;1;1;8;21;1;8;15;77;77;1;0;0;8;9;15;0;4182;9;3;
/org.eclipse.jdt.ui.tests.refactoring/resources/ExtractMethodWorkSpace/ExtractMethodTests/expression_in/A_test614.java;1;1;3;1;2;2;2;1;0;0;1;1236;0;0;1;0;0;1;3;1236;0;4419;3;1;
/org.eclipse.ui/Eclipse UI Tool Script/org/eclipse/toolscript/ui/internal/IHelpContextIds.java;1;1;3;1;2;2;2;1;1;0;1;3766;1;1;1;0;0;1;3;3766;0;4087;3;1;
/org.eclipse.jdt.debug/model/org/eclipse/jdt/internal/debug/core/model/JDIThisVariable.java;2;0;3;2;0;0;0;3;5;0;1;2517;5;5;3;2;0;3;3;2517;2;2517;1;2;
/org.eclipse.ui.tests/Eclipse UI Tests/org/eclipse/ui/tests/api/IEditorActionBarContributorTest.java;2;0;3;1;0;0;0;3;2;1;3;1454;4;4;1;0;0;3;3;1454;0;2785;3;2;
/org.eclipse.scripting/src/org/eclipse/scripting/internal/datamodels/XGRXmlElementsAndAttributesDataModel.java;1;0;1;1;0;0;0;1;0;0;1;1424;0;0;1;0;0;1;1;1424;0;1424;1;1;
/org.eclipse.jdt.core/compiler/org/eclipse/jdt/internal/compiler/ast/AssertStatement.java;2;0;17;1;1;1;1;16;142;4;11;793;238;238;4;5;0;16;17;1039;5;4062;12;2;
/org.eclipse.webdav/src/kernel/org/eclipse/webdav/internal/kernel/IDocumentFactory.java;2;0;4;1;1;1;1;3;24;1;3;1635;52;52;1;0;0;3;4;1635;0;4211;4;2;
/org.eclipse.jdt.ui.tests.refactoring/resources/ExtractMethodWorkSpace/ExtractMethodTests/validSelection/A_test230.java;2;1;3;1;2;2;2;1;0;0;1;49;0;0;1;0;0;1;3;49;0;4419;3;2;
/org.eclipse.swt/Eclipse SWT/common/org/eclipse/swt/layout/FillLayout.java;4;1;7;2;3;3;3;4;33;2;3;106;58;58;2;1;0;4;7;2880;1;4701;6;4;
/org.eclipse.jdt.core/compiler/org/eclipse/jdt/internal/compiler/parser/RecoveredImport.java;2;0;11;1;1;1;1;10;78;4;7;455;119;119;4;3;0;10;11;1039;3;4062;8;2;
/org.eclipse.core.boot/src/org/eclipse/core/internal/boot/EclipseURLConfigurationConnection.java;1;0;2;1;0;0;0;2;0;1;2;12;0;0;1;0;0;2;2;12;0;23;2;1;
/org.eclipse.ui/Eclipse UI/org/eclipse/ui/internal/WorkbenchMessages.java;2;0;3;1;0;0;0;3;16;1;3;457;18;18;1;0;0;3;3;457;0;3822;3;2;
/org.eclipse.update/Eclipse Update/org/eclipse/update/internal/ui/UMWizardProductComponentURLInstall.java;2;0;4;1;0;0;0;4;130;1;4;108;136;136;1;0;0;4;4;108;0;1424;4;2;
/org.eclipse.jdt.ui.tests.refactoring/resources/ExtractMethodWorkSpace/ExtractMethodTests/semicolon_in/A_test409.java;1;1;3;1;2;2;2;1;4;0;1;1236;4;4;1;0;0;1;3;1236;0;4419;3;1;
/org.eclipse.webdav/src/kernel/org/eclipse/webdav/internal/kernel/utils/Assert.java;2;0;5;1;1;1;1;4;154;1;4;12;190;190;1;0;0;4;5;12;0;4211;5;2;
/org.eclipse.update.tests.core/src/org/eclipse/update/tests/api/CopyOfTestSiteManagerAPI.java;1;0;2;1;0;0;0;2;0;1;2;1674;0;0;1;0;0;2;2;1674;0;1724;2;1;
/org.eclipse.jdt.ui.tests.refactoring/resources/RenameTemp/canRename/A_test33_in.java;1;0;3;1;0;0;0;3;4;1;3;1625;6;6;1;0;0;3;3;1625;0;2481;3;1;
/org.eclipse.update.core/src/org/eclipse/update/internal/core/BaseSiteLocalFactory.java;1;0;7;1;0;0;0;7;36;1;7;2773;81;81;1;0;0;7;7;2773;0;3589;7;1;
/org.eclipse.jdt.ui/core refactoring/org/eclipse/jdt/internal/corext/refactoring/code/TempNameUtil2.java;2;0;3;1;0;0;0;3;2;1;3;3048;2;2;1;0;0;3;3;3048;0;3210;3;2;
/org.eclipse.jdt.ui/ui/org/eclipse/jdt/internal/ui/preferences/CodeGenerationPreferencePage.java;3;0;12;2;2;1;2;10;46;3;8;2007;114;114;3;2;1;10;12;2016;3;4181;9;3;
/org.eclipse.jdt.ui.tests.refactoring/resources/RenameType/testFail19/in/A.java;1;0;1;1;0;0;0;1;0;0;1;49;0;0;1;0;0;1;1;49;0;49;1;1;
/org.eclipse.swt/Eclipse SWT PI/photon/org/eclipse/swt/internal/photon/PhEvent_t.java;2;0;2;1;1;1;1;1;6;0;1;2069;6;6;1;0;0;1;2;2069;0;4701;2;2;
/org.eclipse.jdt.ui.tests.refactoring/test cases/org/eclipse/jdt/ui/tests/actions/AllTests.java;1;0;7;1;0;0;0;7;5;2;6;2017;17;17;2;1;0;7;7;2857;1;3502;6;1;
/org.eclipse.jdt.junit/Eclipse JUnit/org/eclipse/jdt/internal/junit/launcher/NameValuePairDialog.java;2;0;2;1;0;0;0;2;0;1;2;2861;0;0;1;0;0;2;2;2861;0;3068;2;2;
/org.eclipse.jdt.ui/ui/org/eclipse/jdt/internal/ui/search/ElementNameSorter.java;1;0;1;1;0;0;0;1;0;0;1;1272;0;0;1;0;0;1;1;1272;0;1272;1;1;
/org.eclipse.team.core/src/org/eclipse/team/internal/core/target/StreamUtil.java;3;2;5;1;5;4;5;0;52;0;0;4010;64;64;2;0;1;0;5;4245;1;4340;4;3;
/org.eclipse.swt.examples/Eclipse SWT Examples/common/org/eclipse/swt/examples/controlexample/ButtonTab.java;1;0;2;1;0;0;0;2;0;1;2;107;0;0;1;0;0;2;2;107;0;611;2;1;
/org.eclipse.pde.ui/src/org/eclipse/pde/internal/PluginProject.java;2;0;2;1;0;0;0;2;0;1;2;1434;0;0;1;0;0;2;2;1434;0;3579;2;2;
/org.eclipse.swt/Eclipse SWT/motif/org/eclipse/swt/widgets/CoolItem.java;5;0;14;2;0;0;0;14;304;1;14;106;763;763;1;0;0;14;14;106;0;1989;14;5;
/org.eclipse.jdt.ui/core refactoring/org/eclipse/jdt/internal/core/nls/model/Utils.java;1;0;2;1;0;0;0;2;0;1;2;1913;0;0;1;0;0;2;2;1913;0;1922;2;1;
/org.eclipse.core.tests.resources/src/org/eclipse/core/tests/resources/usecase/SnapshotTest.java;3;0;5;1;0;0;0;5;114;1;5;1794;158;158;1;0;0;5;5;1794;0;3420;5;3;
/org.eclipse.swt/Eclipse SWT PI/win32/org/eclipse/swt/internal/ole/win32/IStream.java;2;0;2;1;1;1;1;1;6;0;1;2069;6;6;1;0;0;1;2;2069;0;4701;2;2;
/org.eclipse.jdt.core/model/org/eclipse/jdt/internal/core/SetClasspathOperation.java;4;2;46;2;6;5;6;40;427;4;32;455;2493;2493;4;8;1;40;46;1039;9;4283;37;4;
/org.eclipse.pde.ui/src/org/eclipse/pde/core/IModel.java;1;0;2;1;0;0;0;2;0;1;2;3579;0;0;1;0;0;2;2;3579;0;3607;2;1;
/org.eclipse.jdt.ui.tests.refactoring/resources/RenameVirtualMethodInClass/testFail14/in/A.java;1;0;1;1;0;0;0;1;0;0;1;49;0;0;1;0;0;1;1;49;0;49;1;1;
/org.eclipse.ui/Eclipse UI/org/eclipse/ui/model/WorkbenchLabelProvider.java;3;0;4;1;1;1;1;3;21;1;3;257;42;42;1;0;0;3;4;257;0;4006;4;3;
/org.eclipse.jdt.core/model/org/eclipse/jdt/internal/core/CompilationUnitVisitor.java;2;1;19;1;5;5;5;14;1668;4;10;455;2626;2626;4;4;0;14;19;1039;4;4382;15;2;
/org.eclipse.jdt.debug.tests/tests/org/eclipse/jdt/debug/tests/eval/FloatOperatorsTests.java;2;2;3;2;3;2;3;0;17;0;0;4447;19;19;2;0;1;0;3;4447;1;4571;2;2;
/org.eclipse.team.cvs.ui/src/org/eclipse/team/internal/ccvs/ui/wizards/KSubstWizardSelectionPage.java;3;1;5;1;2;2;2;3;16;1;3;3251;32;32;1;0;0;3;5;3251;0;4455;5;3;
/org.eclipse.vcm.core.cvs/src/org/eclipse/vcm/internal/core/ccvs/requests/ErrorMessageFileOutputHandler.java;3;0;4;1;0;0;0;4;34;1;4;0;50;50;1;0;0;4;4;0;0;1549;4;3;
/org.eclipse.jdt.ui.tests.refactoring/resources/RenameParameters/canRename/A_test33_out.java;1;0;1;1;0;0;0;1;0;0;1;1288;0;0;1;0;0;1;1;1288;0;1288;1;1;
/org.eclipse.jdt.core/model/org/eclipse/jdt/core/jdom/DOMFactory.java;2;0;12;1;1;1;1;11;277;4;7;455;388;388;4;4;0;11;12;1039;4;4061;8;2;
/org.eclipse.update.core/src/org/eclipse/core/internal/boot/InternalBootLoader2.java;1;0;5;1;0;0;0;5;18;2;4;2017;35;35;2;1;0;5;5;2017;1;2315;4;1;
/org.eclipse.update.core/src/org/eclipse/update/configuration/ILocalSystemInfoListener.java;1;1;4;1;2;2;2;2;16;1;2;3067;31;31;1;0;0;2;4;3067;0;4687;4;1;
/org.eclipse.jdt.core/dom/org/eclipse/jdt/core/dom/ConstructorInvocation.java;2;0;5;1;0;0;0;5;15;1;5;2669;33;33;1;0;0;5;5;2669;0;3637;5;2;
/org.eclipse.debug.ui/ui/org/eclipse/debug/internal/ui/views/VariablesViewContentProvider.java;3;0;11;2;1;1;1;10;40;3;6;2344;149;149;3;4;0;10;11;3360;4;3975;7;3;
/org.eclipse.jdt.ui/ui/org/eclipse/jdt/internal/ui/wizards/NewSnippetFileCreationWizardPage.java;1;0;3;1;0;0;0;3;2;1;3;1342;2;2;1;0;0;3;3;1342;0;3089;3;1;
/org.eclipse.jdt.ui/ui/org/eclipse/jdt/internal/ui/viewsupport/OverrideImageProvider.java;2;0;5;1;0;0;0;5;11;1;5;2583;20;20;1;0;0;5;5;2583;0;3068;5;2;
/org.eclipse.ui/Eclipse JFace/org/eclipse/jface/preference/JFacePreferences.java;2;0;4;2;0;0;0;4;10;2;3;3633;12;12;2;1;0;4;4;3641;1;3832;3;2;
/org.eclipse.jdt.ui.tests.refactoring/resources/RenameType/testFail33/in/A.java;1;0;1;1;0;0;0;1;0;0;1;49;0;0;1;0;0;1;1;49;0;49;1;1;
/org.eclipse.jdt.ui/core refactoring/org/eclipse/jdt/internal/corext/refactoring/code/flow/LocalFlowInfo.java;1;0;2;1;0;0;0;2;18;1;2;1939;18;18;1;0;0;2;2;1939;0;3106;2;1;
/org.eclipse.jdt.ui/ui refactoring/org/eclipse/jdt/internal/ui/refactoring/PullUpMethodTreeViewer.java;1;0;2;1;0;0;0;2;0;1;2;2270;0;0;1;0;0;2;2;2270;0;2406;2;1;
/org.eclipse.jdt.ui.tests.refactoring/resources/RenameType/test29/out/B.java;1;0;1;1;0;0;0;1;0;0;1;49;0;0;1;0;0;1;1;49;0;49;1;1;
/org.eclipse.jdt.ui/core refactoring/org/eclipse/jdt/internal/core/refactoring/methods/RenameMethodInInterfaceRefactoring.java;2;0;7;1;0;0;0;7;330;1;7;408;381;381;1;0;0;7;7;408;0;1342;7;2;
/org.eclipse.pde.ui/src/org/eclipse/pde/internal/wizards/extension/NewSchemaFileWizard.java;2;0;4;1;0;0;0;4;7;1;4;1434;9;9;1;0;0;4;4;1434;0;3579;4;2;
/org.eclipse.pde.ui/src/org/eclipse/pde/internal/preferences/RuntimeTracingPreferencePage.java;2;0;2;1;0;0;0;2;0;1;2;1434;0;0;1;0;0;2;2;1434;0;3579;2;2;
/org.eclipse.jdt.debug.tests/tests/org/eclipse/jdt/debug/tests/core/WatchpointTests.java;3;2;6;1;5;4;5;1;65;0;1;3701;144;144;2;0;1;1;6;4310;1;4571;5;3;
/org.eclipse.pde.build/src/org/eclipse/pde/internal/build/ant/AntScript.java;1;1;11;1;6;6;6;5;208;2;4;3194;265;265;2;1;0;5;11;3571;1;4572;10;1;
/org.eclipse.jdt.debug.tests/tests/org/eclipse/jdt/debug/tests/core/StepFilterTests.java;2;1;2;1;2;2;2;0;24;0;0;4510;24;24;1;0;0;0;2;4510;0;4571;2;2;
/org.eclipse.jdt.ui.tests.refactoring/resources/ExtractMethodWorkSpace/ExtractMethodTests/validSelection/A_test280.java;2;1;3;1;2;2;2;1;0;0;1;49;0;0;1;0;0;1;3;49;0;4419;3;2;
/org.eclipse.jdt.core/model/org/eclipse/jdt/core/JavaModelException.java;3;1;12;1;3;3;3;9;183;4;6;455;276;276;4;3;0;9;12;1039;3;4421;9;3;
/org.eclipse.jdt.debug.ui/ui/org/eclipse/jdt/internal/debug/ui/launcher/JDK12Launcher.java;2;0;6;1;0;0;0;6;6;1;6;1915;15;15;1;0;0;6;6;1915;0;2388;6;2;
/org.eclipse.ui/Eclipse UI/org/eclipse/ui/internal/AbstractPartSelectionTracker.java;3;1;3;1;2;2;2;1;52;0;1;2999;58;58;1;0;0;1;3;2999;0;4363;3;3;
/org.eclipse.debug.ui/ui/org/eclipse/debug/internal/ui/actions/OpenBreakpointMarkerAction.java;2;0;8;1;1;1;1;7;23;1;7;2382;47;47;1;0;0;7;8;2382;0;4409;8;2;
/org.eclipse.ui/Eclipse UI Text Editor/org/eclipse/ui/texteditor/IWorkbenchActionDefinitionIds.java;1;1;4;1;2;2;2;2;101;1;2;3355;135;135;1;0;0;2;4;3355;0;4838;4;1;
/org.eclipse.jdt.ui.tests.refactoring/resources/RenameVirtualMethodInClass/test25/in/A.java;1;0;1;1;0;0;0;1;0;0;1;49;0;0;1;0;0;1;1;49;0;49;1;1;
/org.eclipse.help.ui/Eclipse Help UI/org/eclipse/help/internal/ui/util/WorkbenchResources.java;3;0;6;1;0;0;0;6;7;1;6;136;14;14;1;0;0;6;6;136;0;1420;6;3;
/org.eclipse.jdt.core/formatter/org/eclipse/jdt/internal/formatter/CodeFormatter.java;2;2;32;1;6;5;6;26;23046;4;22;455;43970;43970;4;4;1;26;32;1039;5;4307;27;2;
/org.eclipse.jdt.core/compiler/org/eclipse/jdt/internal/compiler/util/SimpleNameVector.java;2;0;12;1;1;1;1;11;127;4;7;455;279;279;4;4;0;11;12;1039;4;4062;8;2;
/org.eclipse.pde.ui/templates/editor/java/$contributorClass$.java;1;1;3;1;2;2;2;1;5;0;1;3812;5;5;1;0;0;1;3;3812;0;4370;3;1;
/org.eclipse.jdt.ui/core refactoring/org/eclipse/jdt/internal/corext/refactoring/changes/PackageReorgChange.java;2;0;2;1;1;1;1;1;11;0;1;1939;11;11;1;0;0;1;2;1939;0;4212;2;2;
/org.eclipse.jdt.ui/core refactoring/org/eclipse/jdt/internal/corext/refactoring/rename/RenameSourceFolderRefactoring.java;2;0;7;1;0;0;0;7;38;1;7;1939;105;105;1;0;0;7;7;1939;0;3678;7;2;
/org.eclipse.update.core/src/org/eclipse/update/internal/model/DefaultPluginParser.java;1;0;3;1;1;1;1;2;14;0;1;3027;21;21;2;1;0;2;3;3027;1;4091;2;1;
/org.eclipse.core.resources/src/org/eclipse/core/internal/resources/Container.java;2;0;13;1;1;1;1;12;482;2;10;12;708;708;2;2;0;12;13;3122;2;4213;11;2;
/org.eclipse.jdt.ui.tests.refactoring/resources/DeleteSourceReference/test13/out/A.java;1;0;1;1;0;0;0;1;0;0;1;2859;0;0;1;0;0;1;1;2859;0;2859;1;1;
/org.eclipse.swt/Eclipse SWT/win32/org/eclipse/swt/internal/win32/NMLISTVIEW.java;2;0;3;1;0;0;0;3;5;1;3;106;5;5;1;0;0;3;3;106;0;2069;3;2;
/org.eclipse.compare/compare/org/eclipse/compare/CompareViewerPane.java;1;0;2;1;1;1;1;1;52;0;1;1802;52;52;1;0;0;1;2;1802;0;4820;2;1;
/org.eclipse.ui/Eclipse UI/org/eclipse/ui/internal/ClonePerspectiveAction.java;3;0;3;1;0;0;0;3;2;1;3;2271;2;2;1;0;0;3;3;2271;0;3049;3;3;
/org.eclipse.jdt.ui.tests.refactoring/resources/RenameStaticMethod/test2/out/A.java;1;0;1;1;0;0;0;1;0;0;1;49;0;0;1;0;0;1;1;49;0;49;1;1;
/org.eclipse.ui/Eclipse UI/org/eclipse/ui/actions/RenameResourceAction.java;7;0;18;2;1;1;1;17;57;2;15;257;314;314;2;2;0;17;18;2588;2;4728;16;7;
/org.eclipse.core.resources/src/org/eclipse/core/internal/indexing/IndexedStoreException.java;4;1;8;1;3;3;3;5;300;1;5;12;593;593;1;0;0;5;8;12;0;4632;8;4;
/org.eclipse.jdt.ui/core refactoring/org/eclipse/jdt/internal/core/refactoring/code/flow/BranchFlowInfo.java;1;0;2;1;0;0;0;2;0;1;2;1236;0;0;1;0;0;2;2;1236;0;1939;2;1;
/org.eclipse.jdt.core/compiler/org/eclipse/jdt/internal/compiler/lookup/SyntheticFieldBinding.java;2;0;3;1;1;1;1;2;16;1;2;455;31;31;1;0;0;2;3;455;0;4062;3;2;
/org.eclipse.jdt.core/codeassist/org/eclipse/jdt/internal/codeassist/impl/AssistOptions.java;2;0;7;1;1;1;1;6;76;2;5;1105;210;210;2;1;0;6;7;1939;1;4062;6;2;
/org.eclipse.jdt.debug.ui/ui/org/eclipse/jdt/internal/debug/ui/IPreferencesConstants.java;2;0;3;1;0;0;0;3;2;1;3;1915;2;2;1;0;0;3;3;1915;0;2353;3;2;
/org.eclipse.pde.ui/src/org/eclipse/pde/internal/forms/renamed/IFormWorkbook.java;1;0;2;1;0;0;0;2;0;1;2;2470;0;0;1;0;0;2;2;2470;0;2691;2;1;
/org.eclipse.debug.ui/ui/org/eclipse/debug/internal/ui/DebugView.java;3;0;25;2;0;0;0;25;150;3;19;187;581;581;3;6;0;25;25;2307;6;2307;19;3;
/org.eclipse.swt.examples.paint/src/org/eclipse/swt/examples/paint/EllipseTool.java;4;0;5;2;1;1;1;4;81;2;3;513;89;89;2;1;0;4;5;609;1;4705;4;4;
/org.eclipse.pde.runtime/Eclipse PDE Runtime/org/eclipse/pde/internal/runtime/registry/ExtensionAdapter.java;2;0;3;1;0;0;0;3;4;1;3;267;4;4;1;0;0;3;3;267;0;1434;3;2;
/org.eclipse.jdt.ui/core extension/org/eclipse/jdt/internal/corext/codemanipulation/AddUnimplementedConstructorsOperation.java;1;0;2;1;0;0;0;2;29;1;2;2157;29;29;1;0;0;2;2;2157;0;2232;2;1;
/org.eclipse.jdt.ui.tests.refactoring/resources/ExtractMethodWorkSpace/ExtractMethodTests/locals_out/A_test505.java;2;1;4;1;2;2;2;2;14;1;2;80;14;14;1;0;0;2;4;80;0;4419;4;2;
/org.eclipse.jdt.ui.tests.refactoring/resources/MoveCU/test1/in/p1/C.java;2;0;2;1;0;0;0;2;0;1;2;49;0;0;1;0;0;2;2;49;0;2769;2;2;
/org.eclipse.search/search/org/eclipse/search/internal/ui/text/TextSearchOperation.java;2;1;11;1;2;2;2;9;17;1;9;15;61;61;1;0;0;9;11;15;0;4147;11;2;
/org.eclipse.debug.core/core/org/eclipse/debug/core/model/IStreamMonitor.java;3;0;5;1;1;1;1;4;10;1;4;187;26;26;1;0;0;4;5;187;0;4652;5;3;
/org.eclipse.jdt.ui.tests.refactoring/resources/ExtractMethodWorkSpace/ExtractMethodTests/return_out/A_test717.java;1;1;3;1;2;2;2;1;30;0;1;1236;30;30;1;0;0;1;3;1236;0;4419;3;1;
/org.eclipse.team.core/src/org/eclipse/team/core/Team.java;3;2;12;1;7;6;7;5;30;1;5;3458;144;144;2;0;1;5;12;4004;1;4708;11;3;
/org.eclipse.update.core/src/org/eclipse/update/core/Verifier.java;1;0;1;1;1;1;1;0;0;0;0;4008;0;0;1;0;0;0;1;4008;0;4008;1;1;
/org.eclipse.swt/Eclipse SWT PI/win32/org/eclipse/swt/internal/win32/GRADIENT_RECT.java;2;0;2;1;1;1;1;1;6;0;1;2069;6;6;1;0;0;1;2;2069;0;4701;2;2;
/org.eclipse.jdt.core/compiler/org/eclipse/jdt/internal/compiler/flow/InitializationFlowContext.java;2;0;6;1;1;1;1;5;83;1;5;455;212;212;1;0;0;5;6;455;0;4062;6;2;
/org.eclipse.jdt.ui.tests.refactoring/resources/ExtractMethodWorkSpace/ExtractMethodTests/locals_in/A_test554.java;1;1;3;1;2;2;2;1;24;0;1;1236;24;24;1;0;0;1;3;1236;0;4419;3;1;
/org.eclipse.jdt.ui/ui/org/eclipse/jdt/internal/ui/util/ExceptionHandler.java;4;0;12;1;0;0;0;12;201;3;9;15;249;249;3;3;0;12;12;1312;3;1755;9;4;
/org.eclipse.jdt.debug/model/org/eclipse/jdt/internal/debug/core/breakpoints/JavaRunToLineBreakpoint.java;3;0;3;2;0;0;0;3;2;2;2;2517;2;2;2;1;0;3;3;2517;1;2558;2;3;
/org.eclipse.webdav/src/interface/org/eclipse/webdav/ContextFactory.java;3;0;3;1;0;0;0;3;12;1;3;12;12;12;1;0;0;3;3;12;0;1874;3;3;
/org.eclipse.pde.ui/src/org/eclipse/pde/internal/core/schema/EditableSchema.java;1;0;4;1;0;0;0;4;7;2;3;3579;9;9;2;1;0;4;4;3579;1;3607;3;1;
/org.eclipse.ui/Eclipse UI/org/eclipse/ui/internal/UISynchronizer.java;3;0;3;1;0;0;0;3;5;1;3;257;6;6;1;0;0;3;3;257;0;941;3;3;
/org.eclipse.jdt.debug/eval/org/eclipse/jdt/internal/debug/eval/ast/engine/PushDouble.java;1;0;3;1;0;0;0;3;56;1;3;3329;56;56;1;0;0;3;3;3329;0;3421;3;1;
/org.eclipse.jdt.ui.tests.refactoring/resources/PasteSourceReference/test2/out/A.java;1;0;1;1;0;0;0;1;0;0;1;2859;0;0;1;0;0;1;1;2859;0;2859;1;1;
/org.eclipse.jdt.ui/core refactoring/org/eclipse/jdt/internal/corext/refactoring/base/ITextChange.java;1;0;1;1;0;0;0;1;0;0;1;1939;0;0;1;0;0;1;1;1939;0;1939;1;1;
/org.eclipse.update.core/src/org/eclipse/update/internal/core/DefaultInstallHandler.java;2;0;7;1;2;1;2;5;26;3;3;3398;66;66;3;2;1;5;7;3398;3;4385;4;2;
/org.eclipse.pde.ui/src/org/eclipse/pde/internal/editor/feature/DataSection.java;1;0;2;1;0;0;0;2;0;1;2;3477;0;0;1;0;0;2;2;3477;0;3579;2;1;
/org.eclipse.jdt.debug/jdi interfaces/com/sun/jdi/connect/Transport.java;2;0;2;1;0;0;0;2;4;1;2;2704;4;4;1;0;0;2;2;2704;0;3033;2;2;
/org.eclipse.ant.core/src/org/eclipse/ant/internal/core/AntClassLoader.java;1;0;6;1;1;1;1;5;62;2;4;3365;90;90;2;1;0;5;6;3489;1;4142;5;1;
/org.eclipse.jdt.ui/ui/org/eclipse/jdt/internal/ui/typehierarchy/TypeHierarchyTransferDropAdapter.java;3;1;7;1;3;3;3;4;126;1;4;949;403;403;1;0;0;4;7;949;0;4080;7;3;
/org.eclipse.jdt.core/compiler/org/eclipse/jdt/internal/compiler/parser/RecoveredInitializer.java;2;1;15;1;2;2;2;13;400;4;10;455;502;502;4;3;0;13;15;1039;3;4493;12;2;
/org.eclipse.jdt.ui/ui/org/eclipse/jdt/internal/ui/search/JavaSearchPage.java;5;2;51;2;6;5;6;45;179;2;41;15;1049;1049;2;4;1;45;51;49;5;4360;46;5;
/org.eclipse.update.core/src/org/eclipse/update/core/URLEntry.java;2;0;6;1;0;0;0;6;46;1;6;2462;91;91;1;0;0;6;6;2462;0;3575;6;2;
/org.eclipse.vcm.core.cvs/src/org/eclipse/vcm/internal/core/ccvs/CVSServerEvent.java;1;0;1;1;0;0;0;1;0;0;1;951;0;0;1;0;0;1;1;951;0;951;1;1;
/org.eclipse.ui/Eclipse UI Standard Components/org/eclipse/ui/views/contentoutline/IContentOutlinePage.java;3;0;4;1;0;0;0;4;10;1;4;257;23;23;1;0;0;4;4;257;0;2530;4;3;
/org.eclipse.jdt.core/model/org/eclipse/jdt/internal/core/newbuilder/AdditionalTypeCollection.java;1;0;5;1;0;0;0;5;6;1;5;1886;10;10;1;0;0;5;5;1886;0;2979;5;1;
/org.eclipse.pde.ui/src/org/eclipse/pde/internal/core/ischema/ISchemaAttributeProvider.java;1;0;2;1;0;0;0;2;0;1;2;3591;0;0;1;0;0;2;2;3591;0;3607;2;1;
/org.eclipse.webdav/src/kernel/org/eclipse/webdav/internal/kernel/ServerException.java;1;0;4;1;1;1;1;3;82;1;3;12;102;102;1;0;0;3;4;12;0;4211;4;1;
/org.eclipse.jdt.core/search/org/eclipse/jdt/internal/core/search/matching/MatchingOpenable.java;3;1;15;2;2;2;2;13;160;3;11;1906;382;382;3;2;0;13;15;3084;2;4424;13;3;
/org.eclipse.ui/Eclipse UI Text Editor/org/eclipse/ui/texteditor/TextUtilities.java;2;0;2;1;0;0;0;2;60;1;2;620;60;60;1;0;0;2;2;620;0;1066;2;2;
/org.eclipse.jdt.ui.tests.refactoring/resources/InlineTemp/canInline/A_test14_out.java;1;0;1;1;0;0;0;1;0;0;1;3048;0;0;1;0;0;1;1;3048;0;3048;1;1;
/org.eclipse.pde.ui/src/org/eclipse/pde/internal/view/CopyToClipboardAction.java;1;0;2;1;0;0;0;2;0;1;2;3446;0;0;1;0;0;2;2;3446;0;3579;2;1;
/org.eclipse.jdt.ui.tests.refactoring/resources/ExtractMethodWorkSpace/ExtractMethodTests/expression_out/A_test605.java;2;1;4;1;2;2;2;2;24;1;2;239;25;25;1;0;0;2;4;239;0;4419;4;2;
/org.eclipse.jdt.ui.tests.refactoring/resources/RenamePrivateMethod/test27/out/A.java;1;0;1;1;0;0;0;1;0;0;1;1274;0;0;1;0;0;1;1;1274;0;1274;1;1;
/org.eclipse.ui/Eclipse UI/org/eclipse/ui/actions/DeleteResourceAction.java;7;1;19;1;4;4;4;15;147;2;14;257;623;623;2;1;0;15;19;1636;1;4625;18;7;
/org.eclipse.pde.ui/src/org/eclipse/pde/internal/editor/schema/TypeRestrictionDialog.java;2;0;2;1;0;0;0;2;0;1;2;1434;0;0;1;0;0;2;2;1434;0;3579;2;2;
/org.eclipse.jdt.ui/ui/org/eclipse/jdt/internal/ui/viewsupport/IErrorTickManager.java;1;0;2;1;0;0;0;2;0;1;2;1035;0;0;1;0;0;2;2;1035;0;1256;2;1;
/org.eclipse.jdt.ui.tests.refactoring/test cases/org/eclipse/jdt/ui/tests/all/AllAllTests.java;2;0;2;1;0;0;0;2;1;1;2;2279;1;1;1;0;0;2;2;2279;0;3246;2;2;
/org.eclipse.team.tests.core/src/org/eclipse/team/tests/core/TargetProviderTests.java;3;2;9;2;9;8;9;0;329;0;0;4128;541;541;2;0;1;0;9;4128;1;4636;8;3;
/org.eclipse.team.cvs.core/src/org/eclipse/team/internal/ccvs/core/commands/AbstractStructureVisitor.java;3;0;10;1;0;0;0;10;284;1;10;1978;905;905;1;0;0;10;10;1978;0;2607;10;3;
/org.eclipse.ui/Eclipse JFace/org/eclipse/jface/dialogs/IDialogSettings.java;2;0;2;1;0;0;0;2;5;1;2;257;5;5;1;0;0;2;2;257;0;457;2;2;
/org.eclipse.update.ui/src/org/eclipse/update/internal/ui/forms/LocalSiteForm.java;2;1;5;1;2;2;2;3;188;1;3;3662;194;194;1;0;0;3;5;3662;0;4610;5;2;
/org.eclipse.jdt.ui.tests.refactoring/resources/RenameVirtualMethodInClass/testFail0/in/A.java;1;0;1;1;0;0;0;1;0;0;1;49;0;0;1;0;0;1;1;49;0;49;1;1;
/org.eclipse.webdav/src/kernel/org/eclipse/webdav/internal/kernel/LocatorFactory.java;2;0;4;1;1;1;1;3;60;1;3;1635;101;101;1;0;0;3;4;1635;0;4211;4;2;
/org.eclipse.debug.ui/ui/org/eclipse/debug/internal/ui/BasicContentProvider.java;3;0;10;1;0;0;0;10;20;1;10;187;68;68;1;0;0;10;10;187;0;2348;10;3;
/org.eclipse.swt.examples/Eclipse SWT Examples/common/org/eclipse/swt/examples/explorer/ShellContents.java;1;0;1;1;0;0;0;1;0;0;1;480;0;0;1;0;0;1;1;480;0;480;1;1;
/org.eclipse.swt/Eclipse SWT PI/gtk1x/org/eclipse/swt/internal/gtk/GDKPIXBUF.java;2;0;3;1;1;1;1;2;3;1;2;2107;5;5;1;0;0;2;3;2107;0;4701;3;2;
/org.eclipse.swt/Eclipse SWT PI/win32/org/eclipse/swt/internal/ole/win32/IClassFactory2.java;2;0;2;1;1;1;1;1;6;0;1;2069;6;6;1;0;0;1;2;2069;0;4701;2;2;
/org.eclipse.swt/Eclipse SWT Custom Widgets/common/org/eclipse/swt/custom/TextChangeListener.java;5;1;7;1;2;2;2;5;47;1;5;175;107;107;1;0;0;5;7;175;0;4701;7;5;
/org.eclipse.swt.examples/org/eclipse/swt/examples/controlexample/ShellTab.java;5;1;7;1;3;3;3;4;380;1;4;513;680;680;1;0;0;4;7;513;0;4024;7;5;
/org.eclipse.compare/compare/org/eclipse/compare/IStreamContentAccessor.java;1;0;2;1;0;0;0;2;5;1;2;14;5;5;1;0;0;2;2;14;0;329;2;1;
/org.eclipse.jdt.ui/ui/org/eclipse/jdt/internal/ui/search/ReferencesSearchGroup.java;1;3;9;1;5;3;5;4;35;1;4;1707;114;114;3;0;2;4;9;4140;2;4140;7;1;
/org.eclipse.jdt.ui/ui/org/eclipse/jdt/internal/ui/typehierarchy/TypeHierarchyContentProvider.java;6;1;23;1;6;6;6;17;88;2;16;15;375;375;2;1;0;17;23;2462;1;4621;22;6;
/org.eclipse.jdt.debug/eval/org/eclipse/jdt/internal/debug/eval/ast/instructions/PostfixMinusMinusOperator.java;3;0;6;1;0;0;0;6;20;1;6;3421;32;32;1;0;0;6;6;3421;0;3677;6;3;
/org.eclipse.core.boot/src/org/eclipse/core/internal/boot/update/ComponentDescriptorModel.java;5;0;7;1;0;0;0;7;38;1;7;12;80;80;1;0;0;7;7;12;0;2726;7;5;
/org.eclipse.swt.tests/JUnit Tests/org/eclipse/swt/tests/junit/Test_org_eclipse_swt_custom_CTabFolderEvent.java;2;0;2;1;1;1;1;1;6;0;1;1792;6;6;1;0;0;1;2;1792;0;4706;2;2;
/org.eclipse.jdt.ui.tests.refactoring/resources/PullUp/test16/out/A.java;1;0;1;1;0;0;0;1;0;0;1;2406;0;0;1;0;0;1;1;2406;0;2406;1;1;
/org.eclipse.search/search/org/eclipse/search/internal/ui/RemoveMatchAction.java;2;0;7;1;1;1;1;6;10;1;6;92;45;45;1;0;0;6;7;92;0;4619;7;2;
/org.eclipse.jdt.ui/core refactoring/org/eclipse/jdt/core/refactoring/cus/CompilationUnitRefactoring.java;1;0;4;1;0;0;0;4;6;1;4;130;8;8;1;0;0;4;4;130;0;408;4;1;
/org.eclipse.jdt.ui/ui/org/eclipse/jdt/internal/ui/reorg/ReorgAction.java;5;0;18;1;0;0;0;18;199;1;18;15;418;418;1;0;0;18;18;15;0;3739;18;5;
/org.eclipse.update.ui/src/org/eclipse/update/internal/ui/wizards/InstallWizardDialog.java;1;0;1;1;0;0;0;1;0;0;1;1943;0;0;1;0;0;1;1;1943;0;1943;1;1;
/org.eclipse.jdt.core/model/org/eclipse/jdt/internal/core/builder/IProblemReporter.java;1;0;3;1;0;0;0;3;114;1;3;455;114;114;1;0;0;3;3;455;0;2808;3;1;
/org.eclipse.debug.ui/ui/org/eclipse/debug/internal/ui/LaunchesView.java;3;0;18;2;0;0;0;18;257;3;15;187;651;651;3;3;0;18;18;2307;3;2307;15;3;
/org.eclipse.pde.ui/Eclipse PDE UI/org/eclipse/pde/internal/wizards/project/PluginCodeGeneratorWizard.java;2;0;5;2;0;0;0;5;12;3;3;267;12;12;3;2;0;5;5;324;2;1434;3;2;
/org.eclipse.jdt.ui.tests.refactoring/resources/RenameType/test35/out/B.java;1;0;1;1;0;0;0;1;0;0;1;49;0;0;1;0;0;1;1;49;0;49;1;1;
/org.eclipse.jdt.debug/model/org/eclipse/jdt/internal/debug/core/StringMatcher.java;1;0;2;1;0;0;0;2;4;1;2;2449;4;4;1;0;0;2;2;2449;0;2934;2;1;
/org.eclipse.jdt.ui.tests.refactoring/resources/PasteSourceReference/test1/out/A.java;1;0;1;1;0;0;0;1;0;0;1;2064;0;0;1;0;0;1;1;2064;0;2064;1;1;
/org.eclipse.update.ui.forms/src/org/eclipse/update/ui/forms/internal/FormButton.java;1;0;2;1;0;0;0;2;10;1;2;2470;10;10;1;0;0;2;2;2470;0;3159;2;1;
/org.eclipse.swt/Eclipse SWT PI/gtk1x/org/eclipse/swt/internal/gtk/GtkCTree.java;2;0;2;1;1;1;1;1;3;0;1;2107;3;3;1;0;0;1;2;2107;0;4701;2;2;
/org.eclipse.jdt.ui.tests/ui/org/eclipse/jdt/ui/tests/core/TypeHierarchyTest.java;3;0;8;1;1;1;1;7;66;1;7;1189;104;104;1;0;0;7;8;1189;0;4682;8;3;
/org.eclipse.debug.ui/ui/org/eclipse/debug/internal/ui/RemoveAllExpressionsAction.java;2;0;2;1;0;0;0;2;0;1;2;2347;0;0;1;0;0;2;2;2347;0;2382;2;2;
/org.eclipse.jdt.core/search/org/eclipse/jdt/internal/core/index/impl/ObjectVector.java;2;0;11;1;1;1;1;10;99;4;7;455;187;187;4;3;0;10;11;1039;3;3938;8;2;
/org.eclipse.pde.ui/src/org/eclipse/pde/internal/ui/wizards/templates/StringOption.java;1;0;3;1;0;0;0;3;3;1;3;3579;3;3;1;0;0;3;3;3579;0;3840;3;1;
/org.eclipse.jdt.ui.tests.refactoring/resources/SelectionAnalyzerWorkSpace/SelectionAnalyzerTests/invalidSelection/A_test040.java;1;0;1;1;0;0;0;1;0;0;1;1368;0;0;1;0;0;1;1;1368;0;1368;1;1;
/org.eclipse.pde.ui/src/org/eclipse/pde/internal/ui/wizards/templates/TemplateOption.java;1;0;3;1;0;0;0;3;3;1;3;3579;3;3;1;0;0;3;3;3579;0;3840;3;1;
/org.eclipse.debug.ui/ui/org/eclipse/debug/internal/ui/views/breakpoints/BreakpointsViewContentProvider.java;2;1;2;1;2;2;2;0;50;0;0;3975;50;50;1;0;0;0;2;3975;0;4208;2;2;
/org.eclipse.jdt.core/model/org/eclipse/jdt/internal/core/util/Dumper.java;3;1;11;1;2;2;2;9;520;4;6;455;860;860;4;3;0;9;11;1039;3;4422;8;3;
/org.eclipse.ui/Eclipse JFace Text/org/eclipse/jface/text/rules/Token.java;4;0;5;1;1;1;1;4;76;1;4;257;162;162;1;0;0;4;5;257;0;4838;5;4;
/org.eclipse.jdt.ui/core refactoring/org/eclipse/jdt/internal/core/refactoring/rename/RippleMethodFinder.java;2;0;2;2;0;0;0;2;0;0;1;1938;0;0;2;1;0;2;2;1938;1;1938;1;2;
/org.eclipse.jdt.ui.tests.refactoring/resources/RenamePackage/testFail9/in/p/A.java;2;0;2;1;0;0;0;2;0;1;2;49;0;0;1;0;0;2;2;49;0;1258;2;2;
/org.eclipse.webdav/src/interface/org/eclipse/webdav/dom/Mkworkspace.java;3;0;5;1;1;1;1;4;116;1;4;12;154;154;1;0;0;4;5;12;0;4211;5;3;
/org.eclipse.swt/Eclipse SWT/motif/org/eclipse/swt/widgets/TableColumn.java;2;0;5;1;0;0;0;5;328;1;5;106;726;726;1;0;0;5;5;106;0;1028;5;2;
/org.eclipse.help/Eclipse Help/org/eclipse/help/internal/navigation/NavigationModel.java;4;0;11;1;0;0;0;11;56;1;11;135;133;133;1;0;0;11;11;135;0;1420;11;4;
/org.eclipse.debug.ui/ui/org/eclipse/debug/internal/ui/DebugUIUtils.java;3;0;7;1;0;0;0;7;13;1;7;187;31;31;1;0;0;7;7;187;0;1561;7;3;
/org.eclipse.update/Eclipse Update/org/eclipse/update/internal/core/UMSessionManagerOperation.java;2;0;11;2;0;0;0;11;127;2;10;108;368;368;2;1;0;11;11;324;1;1424;10;2;
/org.eclipse.update/Eclipse Update/org/eclipse/update/internal/ui/UMApplicationUserInterface.java;2;0;4;1;0;0;0;4;439;1;4;108;443;443;1;0;0;4;4;108;0;1424;4;2;
/org.eclipse.vcm.ui/src/org/eclipse/vcm/internal/ui/sync/UpdateAction.java;1;0;2;1;0;0;0;2;72;1;2;1455;72;72;1;0;0;2;2;1455;0;1515;2;1;
/org.eclipse.jdt.debug.ui/ui/org/eclipse/jdt/internal/debug/ui/snippeteditor/SnippetEditorActionContributor.java;2;2;11;1;7;6;7;4;28;1;4;1915;118;118;2;0;1;4;11;4431;1;4551;10;2;
/org.eclipse.swt/Eclipse SWT/common/org/eclipse/swt/internal/image/JPEGAppn.java;2;0;3;1;1;1;1;2;6;1;2;106;10;10;1;0;0;2;3;106;0;4701;3;2;
/org.eclipse.ui/Eclipse JFace Text/org/eclipse/jface/text/IFindReplaceTarget.java;4;0;4;1;1;1;1;3;5;1;3;257;12;12;1;0;0;3;4;257;0;4853;4;4;
/org.eclipse.pde.ui/src/org/eclipse/pde/internal/ui/editor/feature/PortabilitySection.java;1;1;6;1;2;2;2;4;67;2;3;3579;114;114;2;1;0;4;6;3579;1;4695;5;1;
/org.eclipse.update.core/src/org/eclipse/update/internal/security/KeystoreHandle.java;1;0;1;1;0;0;0;1;0;0;1;3169;0;0;1;0;0;1;1;3169;0;3169;1;1;
/org.eclipse.pde.ui/src/org/eclipse/pde/internal/core/schema/SchemaRegistry.java;1;0;4;1;0;0;0;4;17;2;3;3579;19;19;2;1;0;4;4;3579;1;3607;3;1;
/org.eclipse.jdt.ui/ui refactoring/org/eclipse/jdt/internal/ui/refactoring/actions/MoveMembersAction.java;3;2;9;2;7;6;7;2;138;0;1;3832;164;164;2;1;1;2;9;3832;2;4630;7;3;
/org.eclipse.jdt.ui.tests.refactoring/resources/PullUp/testFieldFail0/in/A.java;1;0;1;1;0;0;0;1;0;0;1;2406;0;0;1;0;0;1;1;2406;0;2406;1;1;
/org.eclipse.jdt.ui.tests.refactoring/resources/MoveMembers/test13/out/B.java;1;0;2;1;0;0;0;2;3;1;2;2738;3;3;1;0;0;2;2;2738;0;3188;2;1;
/org.eclipse.jdt.core/compiler/org/eclipse/jdt/internal/compiler/util/HashtableOfInt.java;2;0;11;1;1;1;1;10;151;4;6;455;217;217;4;4;0;10;11;1039;4;4062;7;2;
/org.eclipse.jdt.ui.tests.refactoring/resources/RenameVirtualMethodInClass/testFail37/in/A.java;1;0;1;1;0;0;0;1;0;0;1;49;0;0;1;0;0;1;1;49;0;49;1;1;
/org.eclipse.pde.ui/Eclipse PDE UI/org/eclipse/pde/internal/elements/DefaultContentProvider.java;2;0;5;2;0;0;0;5;12;3;3;267;12;12;3;2;0;5;5;324;2;1434;3;2;
/org.eclipse.update.ui/src/org/eclipse/update/internal/ui/parts/IBrowserListener.java;1;0;3;1;1;1;1;2;4;1;2;1562;4;4;1;0;0;2;3;1562;0;4127;3;1;
/org.eclipse.swt/Eclipse SWT PI/win32/org/eclipse/swt/internal/win32/WINDOWPLACEMENT.java;2;0;2;1;1;1;1;1;6;0;1;2069;6;6;1;0;0;1;2;2069;0;4701;2;2;
/org.eclipse.core.tests.runtime/src/org/eclipse/core/tests/internal/plugins/PluginResolveTest_10.java;3;0;3;1;0;0;0;3;156;1;3;1794;166;166;1;0;0;3;3;1794;0;3476;3;3;
/org.eclipse.ui/Eclipse JFace/org/eclipse/jface/util/PropertyChangeEvent.java;4;1;4;1;2;2;2;2;5;1;2;257;10;10;1;0;0;2;4;257;0;4807;4;4;
/org.eclipse.debug.ui/ui/org/eclipse/debug/internal/ui/views/DebugSelectionProvider.java;1;0;2;1;0;0;0;2;0;0;1;2324;0;0;2;1;0;2;2;2324;1;2324;1;1;
/org.eclipse.jdt.ui/core refactoring/org/eclipse/jdt/internal/corext/refactoring/rename/MethodChecks.java;1;1;7;1;2;2;2;5;117;2;4;2270;156;156;2;1;0;5;7;3185;1;4189;6;1;
/org.eclipse.swt.tests/JUnit Tests/org/eclipse/swt/tests/junit/Test_org_eclipse_swt_widgets_Item.java;2;0;2;1;1;1;1;1;6;0;1;1792;6;6;1;0;0;1;2;1792;0;4706;2;2;
/org.eclipse.jdt.ui.tests.refactoring/resources/RenamePackage/testFail6/in/r/A.java;1;0;1;1;0;0;0;1;0;0;1;1258;0;0;1;0;0;1;1;1258;0;1258;1;1;
/org.eclipse.jdt.ui.tests.refactoring/resources/MoveCU/test/out/p1/C.java;2;0;2;1;0;0;0;2;0;1;2;49;0;0;1;0;0;2;2;49;0;2769;2;2;
/org.eclipse.jdt.ui/ui/org/eclipse/jdt/internal/ui/viewsupport/ErrorTickImageProvider.java;2;0;4;1;0;0;0;4;15;2;3;2581;25;25;2;1;0;4;4;2581;1;3068;3;2;
/org.eclipse.update/Eclipse Update/org/eclipse/update/internal/ui/Main.java;1;0;3;1;0;0;0;3;7;1;3;108;7;7;1;0;0;3;3;108;0;1424;3;1;
/org.eclipse.pde.ui/src/org/eclipse/pde/internal/editor/manifest/DetailChildrenSection.java;2;0;15;1;0;0;0;15;538;3;12;1434;714;714;3;3;0;15;15;3136;3;3579;12;2;
/org.eclipse.jdt.ui.tests.refactoring/resources/RenameMethodInInterface/test31/in/A.java;1;0;1;1;0;0;0;1;0;0;1;49;0;0;1;0;0;1;1;49;0;49;1;1;
/org.eclipse.help/Eclipse Help/org/eclipse/help/internal/contributors/xml/XMLContextContributor.java;3;0;7;1;0;0;0;7;7;1;7;135;16;16;1;0;0;7;7;135;0;1420;7;3;
/org.eclipse.swt/Eclipse SWT/photon/org/eclipse/swt/widgets/ProgressBar.java;6;1;11;1;4;4;4;7;109;1;7;106;182;182;1;0;0;7;11;106;0;4701;11;6;
/org.eclipse.ui/Eclipse UI/org/eclipse/ui/internal/dialogs/FakeAction.java;2;0;2;1;0;0;0;2;4;1;2;257;4;4;1;0;0;2;2;257;0;457;2;2;
/org.eclipse.jdt.core/model/org/eclipse/jdt/internal/core/JavaModelManager.java;5;3;104;3;23;16;23;81;2556;4;60;455;7663;7663;4;21;7;81;104;1039;28;4665;76;5;
/org.eclipse.jdt.debug.tests/tests/org/eclipse/jdt/debug/tests/eval/CharOperatorsTests.java;2;2;3;2;3;2;3;0;17;0;0;4447;19;19;2;0;1;0;3;4447;1;4571;2;2;
/org.eclipse.jdt.ui/ui/org/eclipse/jdt/internal/ui/text/correction/InsertCorrectionProposal.java;2;0;3;1;0;0;0;3;7;1;3;3531;11;11;1;0;0;3;3;3531;0;3763;3;2;
/org.eclipse.jdt.ui/core refactoring/org/eclipse/jdt/internal/corext/refactoring/breakers/ResourcesManagerImpl.java;2;0;3;1;1;1;1;2;2;1;2;1939;2;2;1;0;0;2;3;1939;0;4137;3;2;
/org.eclipse.jdt.debug/jdi/org/eclipse/jdi/TimeoutException.java;1;0;2;1;0;0;0;2;11;1;2;187;11;11;1;0;0;2;2;187;0;366;2;1;
/org.eclipse.swt/Eclipse SWT Custom Widgets/common/org/eclipse/swt/custom/CTabFolderEvent.java;2;0;3;1;1;1;1;2;6;1;2;106;12;12;1;0;0;2;3;106;0;4701;3;2;
/org.eclipse.help/src/org/eclipse/help/standalone/Eclipse.java;1;0;3;1;1;1;1;2;196;1;2;3270;198;198;1;0;0;2;3;3270;0;4427;3;1;
/org.eclipse.pde.ui/src/org/eclipse/pde/internal/launcher/ILauncherSettings.java;1;0;5;1;0;0;0;5;3;1;5;2868;6;6;1;0;0;5;5;2868;0;3579;5;1;
/org.eclipse.scripting/Eclipse Scripting/org/eclipse/scripting/internal/IXGRElementEventGeneratorOnUnload.java;1;0;3;1;0;0;0;3;4;1;3;133;4;4;1;0;0;3;3;133;0;1424;3;1;
/org.eclipse.swt/Eclipse SWT/win32/org/eclipse/swt/internal/win32/SCROLLINFO.java;2;0;3;1;0;0;0;3;5;1;3;106;5;5;1;0;0;3;3;106;0;2069;3;2;
/org.eclipse.jdt.ui/ui/org/eclipse/jdt/internal/ui/actions/OpenHierarchyPerspective.java;1;0;3;1;0;0;0;3;9;2;2;329;9;9;2;1;0;3;3;329;1;344;2;1;
/org.eclipse.pde.ui/Eclipse PDE UI/org/eclipse/pde/internal/wizards/project/WizardIdProjectCreationPage.java;2;0;3;1;0;0;0;3;5;1;3;482;5;5;1;0;0;3;3;482;0;1434;3;2;
/org.eclipse.vcm.core.cvs/src/org/eclipse/vcm/internal/core/ccvs/IModuleExpansion.java;2;0;2;1;0;0;0;2;30;1;2;1008;30;30;1;0;0;2;2;1008;0;1277;2;2;
/org.eclipse.jdt.ui/ui/org/eclipse/jdt/internal/ui/wizards/dialogfields/IStringButtonAdapter.java;2;0;3;1;0;0;0;3;9;1;3;15;12;12;1;0;0;3;3;15;0;1342;3;2;
/org.eclipse.jdt.ui.tests.refactoring/resources/RenameType/testFail21/in/A.java;1;0;1;1;0;0;0;1;0;0;1;49;0;0;1;0;0;1;1;49;0;49;1;1;
/org.eclipse.swt.tests/JUnit Tests/org/eclipse/swt/tests/junit/Test_org_eclipse_swt_layout_GridData.java;2;0;2;1;1;1;1;1;6;0;1;1792;6;6;1;0;0;1;2;1792;0;4706;2;2;
/org.eclipse.swt.examples.paint/org/eclipse/swt/examples/paint/MetaSolidRectangle.java;1;0;1;1;0;0;0;1;0;0;1;513;0;0;1;0;0;1;1;513;0;513;1;1;
/org.eclipse.help/Eclipse Help/org/eclipse/help/IContext.java;2;0;4;1;0;0;0;4;8;1;4;135;15;15;1;0;0;4;4;135;0;1420;4;2;
/org.eclipse.help.tests/src/org/eclipse/help/tests/browsers/TestWin32IE.java;1;0;1;1;0;0;0;1;0;0;1;2737;0;0;1;0;0;1;1;2737;0;2737;1;1;
/org.eclipse.ui.tests/Eclipse JFace Tests/org/eclipse/jface/tests/viewers/interactive/TestBrowserAction.java;1;0;1;1;0;0;0;1;0;0;1;1488;0;0;1;0;0;1;1;1488;0;1488;1;1;
/org.eclipse.jdt.ui.tests.refactoring/resources/ExtractMethodWorkSpace/ExtractMethodTests/return_out/A_test714.java;1;1;3;1;2;2;2;1;22;0;1;923;22;22;1;0;0;1;3;923;0;4419;3;1;
/org.eclipse.swt/Eclipse SWT PI/gtk/org/eclipse/swt/internal/gtk/GtkBin.java;1;0;2;1;0;0;0;2;0;1;2;2107;0;0;1;0;0;2;2;2107;0;3209;2;1;
/org.eclipse.pde.ui/src/org/eclipse/pde/internal/editor/feature/InfoForm.java;1;0;6;1;0;0;0;6;18;2;5;2951;25;25;2;1;0;6;6;2951;1;3579;5;1;
/org.eclipse.debug.ui/ui/org/eclipse/debug/internal/ui/actions/ClearOutputAction.java;2;0;3;1;1;1;1;2;2;1;2;2382;4;4;1;0;0;2;3;2382;0;3975;3;2;
/org.eclipse.ui/Eclipse JFace Text/org/eclipse/jface/text/contentassist/ICompletionProposalExtension.java;2;0;3;1;1;1;1;2;29;1;2;1516;45;45;1;0;0;2;3;1516;0;4838;3;2;
/org.eclipse.team.ui/src/org/eclipse/team/internal/ui/target/SiteElement.java;3;2;12;1;12;8;12;0;55;0;0;4164;120;120;2;0;4;0;12;4164;4;4636;8;3;
/org.eclipse.jdt.debug.tests/tests/org/eclipse/jdt/debug/tests/eval/QualifiedFieldValueTests.java;2;1;3;1;3;3;3;0;17;0;0;4447;19;19;1;0;0;0;3;4447;0;4571;3;2;
/org.eclipse.ui/Eclipse UI Standard Components/org/eclipse/ui/views/properties/ICellEditorActivationListener.java;1;0;1;1;0;0;0;1;0;0;1;457;0;0;1;0;0;1;1;457;0;457;1;1;
/org.eclipse.ui/Eclipse UI Text Editor/org/eclipse/ui/texteditor/RevertToSavedAction.java;3;0;3;1;0;0;0;3;5;1;3;257;7;7;1;0;0;3;3;257;0;1066;3;3;
/org.eclipse.jdt.ui/ui/org/eclipse/jdt/internal/ui/browsing/PatchedOpenInNewWindowAction.java;1;0;1;1;0;0;0;1;0;0;1;3622;0;0;1;0;0;1;1;3622;0;3622;1;1;
/org.eclipse.ui/Eclipse UI Text Editor/org/eclipse/ui/texteditor/IMarkerUpdater.java;3;0;4;1;0;0;0;4;20;1;4;257;30;30;1;0;0;4;4;257;0;1320;4;3;
/org.eclipse.jdt.core/compiler/org/eclipse/jdt/internal/compiler/flow/LoopingFlowContext.java;2;0;11;1;1;1;1;10;186;4;7;455;419;419;4;3;0;10;11;1039;3;4062;8;2;
/org.eclipse.pde.ui/src/org/eclipse/pde/internal/wizards/templates/MultiPageEditorNewWizard.java;1;0;2;1;0;0;0;2;0;1;2;3442;0;0;1;0;0;2;2;3442;0;3579;2;1;
/org.eclipse.jdt.ui/ui refactoring/org/eclipse/jdt/internal/ui/refactoring/RefactoringResources.java;2;0;3;1;0;0;0;3;6;1;3;15;6;6;1;0;0;3;3;15;0;717;3;2;
/org.eclipse.jdt.ui.tests.refactoring/resources/RenameMethodInInterface/test0/in/A.java;1;0;1;1;0;0;0;1;0;0;1;49;0;0;1;0;0;1;1;49;0;49;1;1;
/org.eclipse.jdt.ui.tests.refactoring/resources/ExtractTemp/canExtract/A_test34_out.java;1;0;1;1;0;0;0;1;0;0;1;3227;0;0;1;0;0;1;1;3227;0;3227;1;1;
/org.eclipse.jdt.core/model/org/eclipse/jdt/internal/core/ClasspathEntry.java;2;1;16;1;3;3;3;13;321;4;8;455;909;909;4;5;0;13;16;1039;5;4063;11;2;
/org.eclipse.swt/Eclipse SWT/gtk/org/eclipse/swt/widgets/Scale.java;6;1;11;1;5;5;5;6;38;1;6;2107;131;131;1;0;0;6;11;2107;0;4701;11;6;
/org.eclipse.jdt.debug/eval/org/eclipse/jdt/debug/eval/ast/model/IObject.java;1;0;2;1;0;0;0;2;0;1;2;3329;0;0;1;0;0;2;2;3329;0;3421;2;1;
/org.eclipse.scripting/src/org/eclipse/scripting/ScriptAdapterWorkbenchAction.java;1;0;1;1;0;0;0;1;0;0;1;1424;0;0;1;0;0;1;1;1424;0;1424;1;1;
/org.eclipse.update.ui.forms/src/org/eclipse/update/ui/forms/internal/engine/IBulletParagraph.java;1;0;1;1;0;0;0;1;0;0;1;3245;0;0;1;0;0;1;1;3245;0;3245;1;1;
/org.eclipse.jdt.ui.tests.refactoring/resources/DeleteSourceReference/A_test2_in.java;1;0;2;1;0;0;0;2;0;1;2;2003;0;0;1;0;0;2;2;2003;0;2857;2;1;
/org.eclipse.jdt.core/dom/org/eclipse/jdt/core/dom/CompilationUnitResolver.java;3;1;15;1;4;4;4;11;41;2;10;2669;138;138;2;1;0;11;15;3084;1;4421;14;3;
/org.eclipse.jdt.ui.tests.refactoring/resources/SelectionAnalyzerWorkSpace/SelectionAnalyzerTests/invalidSelection/A_test096.java;2;0;2;1;0;0;0;2;0;1;2;1368;0;0;1;0;0;2;2;1368;0;2139;2;2;
/org.eclipse.debug.ui/ui/org/eclipse/debug/internal/ui/ProcessesContentProvider.java;3;0;5;1;0;0;0;5;12;1;5;187;25;25;1;0;0;5;5;187;0;2312;5;3;
/org.eclipse.jdt.debug/eval/org/eclipse/jdt/internal/debug/eval/model/EvaluationObject.java;2;0;3;1;0;0;0;3;4;1;3;3421;4;4;1;0;0;3;3;3421;0;3645;3;2;
/org.eclipse.jdt.ui/ui/org/eclipse/jdt/internal/ui/JavaUIErrorStatus.java;2;0;2;1;0;0;0;2;0;1;2;1786;0;0;1;0;0;2;2;1786;0;2770;2;2;
/org.eclipse.update.core/src/org/eclipse/update/internal/core/DefaultCategory.java;1;0;5;1;0;0;0;5;59;2;4;1577;71;71;2;1;0;5;5;1577;1;1791;4;1;
/org.eclipse.pde.ui/src/org/eclipse/pde/internal/pluginsview/PluginsView.java;1;0;2;1;0;0;0;2;0;1;2;2650;0;0;1;0;0;2;2;2650;0;2978;2;1;
/org.eclipse.update.ui.forms/src/org/eclipse/update/ui/forms/internal/engine/ImageSegment.java;1;0;3;1;0;0;0;3;27;2;2;2745;31;31;2;1;0;3;3;2745;1;3245;2;1;
/org.eclipse.ui.tests/Eclipse JFace Tests/org/eclipse/jface/tests/viewers/interactive/TestBrowser.java;1;0;1;1;0;0;0;1;0;0;1;1488;0;0;1;0;0;1;1;1488;0;1488;1;1;
/org.eclipse.jdt.debug.tests/test programs/InstanceVariablesTests.java;1;0;2;1;0;0;0;2;0;1;2;3701;0;0;1;0;0;2;2;3701;0;3719;2;1;
/org.eclipse.update.tests.core/src/org/eclipse/update/tests/implementation/SiteFTPFactory.java;2;0;7;1;0;0;0;7;41;1;7;2291;92;92;1;0;0;7;7;2291;0;3570;7;2;
/org.eclipse.team.cvs.core/src/org/eclipse/team/internal/ccvs/core/CVSProviderPlugin.java;3;1;39;2;2;2;2;37;339;2;33;1978;1496;1496;2;4;0;37;39;2049;4;4632;35;3;
/org.eclipse.update.ui/src/org/eclipse/update/internal/ui/parts/ConfigurationInfo.java;1;0;1;1;1;1;1;0;0;0;0;4108;0;0;1;0;0;0;1;4108;0;4108;1;1;
/org.eclipse.help/Eclipse Help/org/eclipse/help/internal/contributors/Contributor.java;3;0;4;1;0;0;0;4;7;1;4;135;8;8;1;0;0;4;4;135;0;1420;4;3;
/org.eclipse.jdt.ui.tests.refactoring/resources/MoveMembers/testFail0/in/B.java;1;0;1;1;0;0;0;1;0;0;1;2738;0;0;1;0;0;1;1;2738;0;2738;1;1;
/org.eclipse.vcm.ui/src/org/eclipse/vcm/internal/ui/syncdialog/IRepositoryDeltaCollector.java;2;0;2;1;0;0;0;2;0;1;2;1;0;0;1;0;0;2;2;1;0;68;2;2;
/org.eclipse.swt/Eclipse SWT PI/gtk1x/org/eclipse/swt/internal/gtk/GdkEventMotion.java;2;0;2;1;1;1;1;1;3;0;1;2107;3;3;1;0;0;1;2;2107;0;4701;2;2;
/org.eclipse.scripting/Eclipse Scripting/org/eclipse/scripting/internal/uirenderer/ScriptWizard.java;2;0;5;1;0;0;0;5;53;1;5;133;75;75;1;0;0;5;5;133;0;1424;5;2;
/org.eclipse.pde.ui/src/org/eclipse/pde/internal/ui/elements/DefaultElement.java;1;0;1;1;0;0;0;1;0;0;1;3579;0;0;1;0;0;1;1;3579;0;3579;1;1;
/org.eclipse.ui/Eclipse JFace Text/org/eclipse/jface/text/source/VerticalRuler.java;6;2;15;2;9;7;9;6;189;1;6;257;424;424;2;0;2;6;15;4038;2;4838;13;6;
/org.eclipse.pde.ui/Eclipse PDE UI/org/eclipse/pde/internal/model/PluginObject.java;2;0;7;2;0;0;0;7;35;3;5;267;76;76;3;2;0;7;7;324;2;1434;5;2;
/org.eclipse.pde.ui/src/org/eclipse/pde/model/plugin/IFragmentModel.java;1;0;2;1;0;0;0;2;0;1;2;3039;0;0;1;0;0;2;2;3039;0;3579;2;1;
/org.eclipse.pde.ui/Eclipse PDE UI/org/eclipse/pde/internal/model/PluginAttribute.java;2;0;6;2;0;0;0;6;15;3;4;267;27;27;3;2;0;6;6;324;2;1434;4;2;
/org.eclipse.swt/Eclipse SWT PI/gtk/org/eclipse/swt/internal/gtk/GdkRectangle.java;3;0;5;2;2;1;2;3;10;2;2;2107;17;17;2;1;1;3;5;3252;2;4701;3;3;
/org.eclipse.jdt.ui.tests.refactoring/resources/RenameVariables/canRename/A_test22_out.java;1;0;2;1;0;0;0;2;0;1;2;724;0;0;1;0;0;2;2;724;0;1665;2;1;
/org.eclipse.swt/Eclipse SWT PI/win32/org/eclipse/swt/internal/ole/win32/IEnum.java;2;0;2;1;1;1;1;1;6;0;1;2069;6;6;1;0;0;1;2;2069;0;4701;2;2;
/org.eclipse.jdt.ui.tests.refactoring/resources/StructureSelectionAction/A_test11.java;1;0;1;1;0;0;0;1;0;0;1;2139;0;0;1;0;0;1;1;2139;0;2139;1;1;
/org.eclipse.jdt.core/compiler/org/eclipse/jdt/internal/compiler/ast/UnaryExpression.java;2;0;16;1;1;1;1;15;472;4;12;455;1035;1035;4;3;0;15;16;1039;3;4062;13;2;
/org.eclipse.jdt.ui.tests.refactoring/resources/ExtractTemp/canExtract/A_test0_in.java;1;0;1;1;0;0;0;1;0;0;1;2481;0;0;1;0;0;1;1;2481;0;2481;1;1;
/org.eclipse.pde.runtime/src/org/eclipse/pde/internal/runtime/registry/ExtensionPointAdapter.java;1;0;1;1;0;0;0;1;0;0;1;1434;0;0;1;0;0;1;1;1434;0;1434;1;1;
/org.eclipse.vcm.tests.core/src/org/eclipse/vcm/tests/core/base/IMergeManagerTest.java;1;0;1;1;0;0;0;1;0;0;1;1688;0;0;1;0;0;1;1;1688;0;1688;1;1;
/org.eclipse.swt/Eclipse SWT OLE Win32/win32/org/eclipse/swt/internal/ole/win32/IStream.java;2;0;3;1;0;0;0;3;5;1;3;106;5;5;1;0;0;3;3;106;0;2069;3;2;
/org.eclipse.pde.ui/src/org/eclipse/pde/internal/editor/schema/GrammarSection.java;2;0;7;1;0;0;0;7;465;2;6;1434;473;473;2;1;0;7;7;3035;1;3579;6;2;
/org.eclipse.jdt.ui.tests/refactoring/org/eclipse/jdt/refactoring/tests/AllChangeTests.java;3;0;4;1;0;0;0;4;11;1;4;1114;17;17;1;0;0;4;4;1114;0;1896;4;3;
/org.eclipse.swt/Eclipse SWT Drag and Drop/common/org/eclipse/swt/dnd/DragSourceEvent.java;2;1;4;1;2;2;2;2;58;1;2;106;69;69;1;0;0;2;4;106;0;4824;4;2;
/org.eclipse.vcm.ui/src/org/eclipse/vcm/internal/ui/actions/CompareEditionsAction.java;3;0;4;2;0;0;0;4;22;2;3;1;31;31;2;1;0;4;4;297;1;1238;3;3;
/org.eclipse.jdt.ui/ui/org/eclipse/jdt/ui/StandardJavaElementContentProvider.java;2;1;3;1;3;3;3;0;119;0;0;4212;139;139;1;0;0;0;3;4212;0;4810;3;2;
/org.eclipse.ant.core/src/org/eclipse/ant/core/MoveProject.java;3;0;3;1;0;0;0;3;552;1;3;896;552;552;1;0;0;3;3;896;0;3489;3;3;
/org.eclipse.jdt.debug.tests/tests/org/eclipse/jdt/debug/tests/eval/TypeHierarchy_57_1.java;2;1;3;1;3;3;3;0;13;0;0;4447;15;15;1;0;0;0;3;4447;0;4571;3;2;
/org.eclipse.jdt.core/compiler/org/eclipse/jdt/internal/compiler/env/ICompilationUnit.java;2;0;5;1;1;1;1;4;26;1;4;455;57;57;1;0;0;4;5;455;0;4062;5;2;
/org.eclipse.help/src/org/eclipse/help/internal/topics/NavigationBuilder.java;2;0;4;1;0;0;0;4;78;1;4;1675;88;88;1;0;0;4;4;1675;0;1857;4;2;
/org.eclipse.vcm.ui/src/org/eclipse/vcm/internal/ui/VCMPropertyPage.java;5;0;11;2;0;0;0;11;47;2;10;1;145;145;2;1;0;11;11;295;1;1349;10;5;
/org.eclipse.jdt.ui/ui refactoring/org/eclipse/jdt/internal/ui/refactoring/PerformChangeOperation.java;3;0;7;1;0;0;0;7;37;1;7;15;55;55;1;0;0;7;7;15;0;1939;7;3;
/org.eclipse.jdt.debug.tests/testprograms/IBreakpoints.java;2;0;2;1;1;1;1;1;13;0;1;3719;13;13;1;0;0;1;2;3719;0;4571;2;2;
/org.eclipse.team.core/src/org/eclipse/team/internal/core/simpleAccess/SimpleAccessOperations.java;2;0;2;1;1;1;1;1;4;0;1;3762;4;4;1;0;0;1;2;3762;0;4006;2;2;
/org.eclipse.core.tests.runtime/src/org/eclipse/core/tests/internal/plugins/BasicFragmentTest.java;3;0;3;1;0;0;0;3;550;1;3;1794;560;560;1;0;0;3;3;1794;0;3476;3;3;
/org.eclipse.jdt.ui.tests.refactoring/resources/RenameVirtualMethodInClass/test26/in/A.java;1;0;1;1;0;0;0;1;0;0;1;49;0;0;1;0;0;1;1;49;0;49;1;1;
/org.eclipse.ui/Eclipse UI/org/eclipse/ui/internal/dialogs/WizardProjectConfigurePage.java;1;0;3;1;0;0;0;3;91;1;3;3186;91;91;1;0;0;3;3;3186;0;3211;3;1;
/org.eclipse.jdt.ui/ui/org/eclipse/jdt/internal/ui/launcher/AddExceptionDialog.java;7;0;22;1;0;0;0;22;86;2;20;235;241;241;2;2;0;22;22;235;2;1916;20;7;
/org.eclipse.team.ftp/src/org/eclipse/team/internal/ftp/client/FTPServerException.java;1;1;3;1;3;3;3;0;15;0;0;4169;18;18;1;0;0;0;3;4169;0;4381;3;1;
/org.eclipse.jdt.core/dom/org/eclipse/jdt/core/dom/ThisExpression.java;2;1;6;1;2;2;2;4;9;1;4;2669;29;29;1;0;0;4;6;2669;0;4453;6;2;
/org.eclipse.jdt.ui/ui/org/eclipse/jdt/internal/ui/launcher/EditVMDialog.java;2;0;10;1;0;0;0;10;18;2;8;218;41;41;2;2;0;10;10;218;2;1416;8;2;
/org.eclipse.jdt.ui.tests.refactoring/resources/ExtractMethodWorkSpace/ExtractMethodTests/validSelection_in/A_test365.java;1;1;3;1;2;2;2;1;0;0;1;3736;0;0;1;0;0;1;3;3736;0;4419;3;1;
/org.eclipse.jdt.ui/core extension/org/eclipse/jdt/internal/corext/template/java/JavaFormatter.java;3;0;5;1;1;1;1;4;16;1;4;2784;40;40;1;0;0;4;5;2784;0;4186;5;3;
/org.eclipse.swt/Eclipse SWT PI/motif/org/eclipse/swt/internal/motif/XCharStruct.java;2;0;2;1;1;1;1;1;6;0;1;2069;6;6;1;0;0;1;2;2069;0;4701;2;2;
/org.eclipse.pde.ui/src/org/eclipse/pde/internal/base/schema/ISchemaSimpleType.java;2;0;3;1;0;0;0;3;3;1;3;1434;3;3;1;0;0;3;3;1434;0;3579;3;2;
/org.eclipse.team.cvs.core/src/org/eclipse/team/internal/ccvs/core/resources/ManagedFile.java;3;0;4;1;0;0;0;4;773;1;4;1978;787;787;1;0;0;4;4;1978;0;2156;4;3;
/org.eclipse.jdt.ui.tests.refactoring/resources/PullUp/testFail4/in/A.java;1;0;1;1;0;0;0;1;0;0;1;2406;0;0;1;0;0;1;1;2406;0;2406;1;1;
/org.eclipse.ui/Eclipse JFace Text/org/eclipse/jface/text/contentassist/ICompletionProposal.java;4;0;4;1;0;0;0;4;31;1;4;257;39;39;1;0;0;4;4;257;0;3592;4;4;
/org.eclipse.help/Eclipse Help/org/eclipse/help/internal/util/HelpProperties.java;3;0;5;2;0;0;0;5;53;2;4;966;76;76;2;1;0;5;5;1051;1;1420;4;3;
/org.eclipse.jdt.ui/ui debug/org/eclipse/jdt/internal/debug/ui/JavaWatchpointPropertySource.java;2;0;2;1;0;0;0;2;0;1;2;1330;0;0;1;0;0;2;2;1330;0;1916;2;2;
/org.eclipse.ui.tests/Eclipse JFace Tests/org/eclipse/jface/tests/viewers/interactive/ChangeChildLabelAction.java;1;0;1;1;0;0;0;1;0;0;1;1488;0;0;1;0;0;1;1;1488;0;1488;1;1;
/org.eclipse.ui.tests/Eclipse UI Tests/org/eclipse/ui/tests/api/EmptyPerspective.java;2;0;3;1;0;0;0;3;1;1;3;883;1;1;1;0;0;3;3;883;0;1407;3;2;
/org.eclipse.jdt.core/compiler/org/eclipse/jdt/internal/compiler/lookup/ProblemMethodBinding.java;2;0;4;1;1;1;1;3;59;1;3;455;79;79;1;0;0;3;4;455;0;4062;4;2;
/org.eclipse.jdt.ui/ui refactoring/org/eclipse/jdt/internal/ui/refactoring/code/ExtractMethodWizard.java;3;1;18;1;2;2;2;16;41;1;16;15;139;139;1;0;0;16;18;15;0;4621;18;3;
/org.eclipse.help.ui/Eclipse Help UI/org/eclipse/help/internal/ui/util/StreamConsumer.java;2;0;3;1;0;0;0;3;7;1;3;136;7;7;1;0;0;3;3;136;0;1420;3;2;
/org.eclipse.jdt.ui.tests.refactoring/resources/RenameMethodInInterface/testFail1/in/A.java;1;0;1;1;0;0;0;1;0;0;1;49;0;0;1;0;0;1;1;49;0;49;1;1;
/org.eclipse.swt/Eclipse SWT PI/gtk1x/org/eclipse/swt/internal/gtk/GtkText.java;2;0;2;1;1;1;1;1;3;0;1;2107;3;3;1;0;0;1;2;2107;0;4701;2;2;
/org.eclipse.jdt.ui/core refactoring/org/eclipse/jdt/internal/corext/refactoring/rename/RenameResourceRefactoring.java;2;0;5;1;0;0;0;5;32;1;5;1939;60;60;1;0;0;5;5;1939;0;3678;5;2;
/org.eclipse.jdt.ui.tests.refactoring/resources/MultiMove/test0/in/p1/A.java;1;0;1;1;0;0;0;1;0;0;1;1157;0;0;1;0;0;1;1;1157;0;1157;1;1;
/org.eclipse.pde.ui/src/org/eclipse/pde/internal/core/ifeature/IFeatureData.java;1;0;2;1;0;0;0;2;0;1;2;3591;0;0;1;0;0;2;2;3591;0;3607;2;1;
/org.eclipse.jdt.debug/model/org/eclipse/jdt/debug/core/IJavaMethodBreakpoint.java;1;0;3;1;0;0;0;3;40;1;3;2646;42;42;1;0;0;3;3;2646;0;3571;3;1;
/org.eclipse.jdt.debug.ui/ui/org/eclipse/jdt/internal/debug/ui/display/DisplayView.java;2;1;27;1;6;6;6;21;4;2;19;1915;54;54;2;2;0;21;27;1944;2;4630;25;2;
/org.eclipse.swt.examples/org/eclipse/swt/examples/helloworld/HelloWorld4.java;4;0;5;1;1;1;1;4;35;1;4;513;73;73;1;0;0;4;5;513;0;4024;5;4;
/org.eclipse.pde.ui/src/org/eclipse/pde/internal/editor/jars/JarsSourcePage.java;2;0;2;1;0;0;0;2;0;1;2;1434;0;0;1;0;0;2;2;1434;0;2650;2;2;
/org.eclipse.core.tests.runtime/src/org/eclipse/core/tests/internal/runtimetests/SampleMFB.java;1;0;2;1;0;0;0;2;10;1;2;3611;10;10;1;0;0;2;2;3611;0;3678;2;1;
/org.eclipse.jdt.ui.tests.refactoring/resources/RenameParameters/canRename/A_test12_out.java;1;0;1;1;0;0;0;1;0;0;1;233;0;0;1;0;0;1;1;233;0;233;1;1;
/org.eclipse.core.tests.resources/src/org/eclipse/core/tests/resources/session/Test1G1N9GZ.java;2;0;4;1;0;0;0;4;152;1;4;2291;177;177;1;0;0;4;4;2291;0;3475;4;2;
/org.eclipse.swt/Eclipse SWT/gtk1x/org/eclipse/swt/widgets/ScrollBar.java;4;0;5;1;1;1;1;4;120;1;4;2107;137;137;1;0;0;4;5;2107;0;4701;5;4;
/org.eclipse.vcm.core.cvs.ext/src/org/eclipse/vcm/internal/core/ccvs/ext/EXTServerConnection.java;2;0;4;1;0;0;0;4;30;1;4;1205;43;43;1;0;0;4;4;1205;0;1592;4;2;
/org.eclipse.jdt.ui.tests.refactoring/resources/RenameType/test28/out/A.java;1;0;2;1;0;0;0;2;0;1;2;49;0;0;1;0;0;2;2;49;0;522;2;1;
/org.eclipse.jdt.core/dom/org/eclipse/jdt/core/dom/ConditionalExpression.java;2;1;6;1;2;2;2;4;27;1;4;2669;66;66;1;0;0;4;6;2669;0;4453;6;2;
/org.eclipse.swt.examples/org/eclipse/swt/examples/controlexample/ControlExample.java;4;0;8;1;1;1;1;7;238;1;7;513;339;339;1;0;0;7;8;513;0;4024;8;4;
/org.eclipse.swt/Eclipse SWT Custom Widgets/common_j2se/org/eclipse/swt/custom/CTabFolder.java;1;0;1;1;0;0;0;1;0;0;1;1378;0;0;1;0;0;1;1;1378;0;1378;1;1;
/org.eclipse.jdt.ui.tests.refactoring/resources/RenameMethodInInterface/testFail34/in/A.java;1;0;1;1;0;0;0;1;0;0;1;49;0;0;1;0;0;1;1;49;0;49;1;1;
/org.eclipse.jdt.debug.ui/ui/org/eclipse/jdt/internal/debug/ui/actions/EnableDisableBreakpointAction.java;2;0;4;1;0;0;0;4;60;1;4;2215;63;63;1;0;0;4;4;2215;0;2776;4;2;
/org.eclipse.update/Eclipse Update/org/eclipse/update/internal/ui/AuthorizationDatabase.java;2;0;5;1;0;0;0;5;139;1;5;108;283;283;1;0;0;5;5;108;0;1424;5;2;
/org.eclipse.jdt.debug/jdi/org/eclipse/jdi/internal/event/EventImpl.java;2;0;6;1;0;0;0;6;25;1;6;187;47;47;1;0;0;6;6;187;0;3677;6;2;
/org.eclipse.jdt.core/model/org/eclipse/jdt/internal/core/JavaModelStatus.java;2;1;14;1;2;2;2;12;563;4;9;455;1899;1899;4;3;0;12;14;1039;3;4063;11;2;
/org.eclipse.jdt.debug.tests/testprograms/MultiThreadedList.java;2;1;2;1;2;2;2;0;11;0;0;4313;11;11;1;0;0;0;2;4313;0;4571;2;2;
/org.eclipse.jdt.debug/eval/org/eclipse/jdt/internal/debug/eval/ast/instructions/PushStaticFieldVariable.java;2;0;3;1;0;0;0;3;7;1;3;3645;11;11;1;0;0;3;3;3645;0;3833;3;2;
/org.eclipse.pde.ui/src/org/eclipse/pde/internal/base/model/component/IComponentModelFactory.java;2;0;2;1;0;0;0;2;0;1;2;1434;0;0;1;0;0;2;2;1434;0;2951;2;2;
/org.eclipse.pde.ui/src/org/eclipse/pde/internal/preferences/PDEBasePreferencePage.java;2;0;4;1;0;0;0;4;8;1;4;1434;16;16;1;0;0;4;4;1434;0;2750;4;2;
/org.eclipse.jdt.debug/model/org/eclipse/jdt/debug/core/IEvaluationRunnable.java;2;0;4;1;0;0;0;4;5;2;3;2720;7;7;2;1;0;4;4;3552;1;3552;3;2;
/org.eclipse.jdt.ui.tests.refactoring/resources/RenameType/testFail35/in/A.java;1;0;1;1;0;0;0;1;0;0;1;49;0;0;1;0;0;1;1;49;0;49;1;1;
/org.eclipse.ui/Eclipse JFace/org/eclipse/jface/viewers/CombinedLabel.java;2;0;5;1;1;1;1;4;57;2;3;3420;61;61;2;1;0;4;5;3473;1;4006;4;2;
/org.eclipse.team.cvs.core/src/org/eclipse/team/internal/ccvs/core/response/custom/UpdateErrorHandler.java;3;0;9;1;0;0;0;9;286;2;8;1978;539;539;2;1;0;9;9;2288;1;2607;8;3;
/org.eclipse.help.ui/src/org/eclipse/help/internal/ui/InfocenterAction.java;2;0;2;1;0;0;0;2;0;1;2;2768;0;0;1;0;0;2;2;2768;0;3762;2;2;
/org.eclipse.ui/Eclipse UI Tool Script/org/eclipse/toolscript/core/internal/AntUtil.java;1;1;3;1;3;3;3;0;20;0;0;4022;20;20;1;0;0;0;3;4022;0;4087;3;1;
/org.eclipse.jdt.junit/Eclipse JUnit/org/eclipse/jdt/internal/junit/oldlauncher/IJUnitLauncherDelegate.java;2;0;2;1;0;0;0;2;0;1;2;2861;0;0;1;0;0;2;2;2861;0;3205;2;2;
/org.eclipse.debug.ui/ui/org/eclipse/debug/ui/BreakpointPropertySource.java;2;0;3;1;0;0;0;3;18;1;3;1326;18;18;1;0;0;3;3;1326;0;2794;3;2;
/org.eclipse.jdt.ui/core extension/org/eclipse/jdt/internal/corext/textmanipulation/TextBuffer.java;1;0;7;1;0;0;0;7;97;2;6;2137;155;155;2;1;0;7;7;3870;1;3870;6;1;
/org.eclipse.pde.runtime/Eclipse PDE Runtime/org/eclipse/pde/internal/runtime/registry/RegistryPropertySourceFactory.java;2;0;3;1;0;0;0;3;4;1;3;267;4;4;1;0;0;3;3;267;0;1434;3;2;
/org.eclipse.debug.core/core/org/eclipse/debug/core/IExceptionBreakpoint.java;1;0;1;1;0;0;0;1;0;0;1;831;0;0;1;0;0;1;1;831;0;831;1;1;
/org.eclipse.swt.examples.launcher/src/org/eclipse/swt/examples/launcher/LauncherPlugin.java;4;0;5;1;1;1;1;4;413;1;4;513;475;475;1;0;0;4;5;513;0;4705;5;4;
/org.eclipse.swt/Eclipse SWT/win32/org/eclipse/swt/internal/win32/ICONINFO.java;2;0;3;1;0;0;0;3;5;1;3;106;5;5;1;0;0;3;3;106;0;2069;3;2;
/org.eclipse.update/Eclipse Update/org/eclipse/update/internal/ui/UserValidationDialog.java;2;0;5;1;0;0;0;5;240;1;5;108;259;259;1;0;0;5;5;108;0;1424;5;2;
/org.eclipse.team.tests.cvs.core/src/org/eclipse/team/tests/ccvs/ui/logformatter/ILogEntryVisitor.java;1;0;1;1;0;0;0;1;0;0;1;2977;0;0;1;0;0;1;1;2977;0;2977;1;1;
/org.eclipse.jdt.core/model/org/eclipse/jdt/internal/core/builder/impl/OrderedSet.java;1;0;12;1;0;0;0;12;445;4;8;455;511;511;4;4;0;12;12;1039;4;2808;8;1;
/org.eclipse.core.tests.runtime/src/org/eclipse/core/tests/internal/runtimetests/SampleE.java;1;0;3;1;0;0;0;3;10;2;2;3605;13;13;2;1;0;3;3;3605;1;3678;2;1;
/org.eclipse.scripting/Eclipse Scripting/org/eclipse/scripting/internal/IXGRElementCaption.java;1;0;3;1;0;0;0;3;4;1;3;133;4;4;1;0;0;3;3;133;0;1424;3;1;
/org.eclipse.jdt.ui/ui/org/eclipse/jdt/internal/ui/viewsupport/ErrorTickAdornmentProvider.java;2;1;6;1;3;3;3;3;17;1;3;3068;36;36;1;0;0;3;6;3068;0;4018;6;2;
/org.eclipse.jdt.ui.tests.refactoring/resources/ExtractMethodWorkSpace/ExtractMethodTests/locals_out/A_test556.java;1;1;4;1;2;2;2;2;38;1;2;1236;40;40;1;0;0;2;4;1236;0;4419;4;1;
/org.eclipse.ui.examples.propertysheet/Eclipse UI Examples PropertySheet/org/eclipse/ui/examples/propertysheet/Birthday.java;2;0;2;1;0;0;0;2;22;1;2;931;22;22;1;0;0;2;2;931;0;946;2;2;
/org.eclipse.team.ui/src/org/eclipse/team/internal/ui/target/SiteViewSorter.java;3;1;3;1;3;3;3;0;10;0;0;4164;12;12;1;0;0;0;3;4164;0;4636;3;3;
/org.eclipse.debug.core/core/org/eclipse/debug/core/model/IProcess.java;3;1;8;1;2;2;2;6;16;1;6;187;68;68;1;0;0;6;8;187;0;4651;8;3;
/org.eclipse.core.resources/src/org/eclipse/core/internal/indexing/IObjectFactory.java;3;0;3;1;0;0;0;3;5;1;3;12;5;5;1;0;0;3;3;12;0;448;3;3;
/org.eclipse.pde.ui/src/org/eclipse/pde/internal/base/model/component/IComponentReference.java;2;0;2;1;0;0;0;2;0;1;2;1434;0;0;1;0;0;2;2;1434;0;2951;2;2;
/org.eclipse.help/src/org/eclipse/help/internal/contributors/xml1_0/XMLActionContributor.java;1;0;2;1;0;0;0;2;0;1;2;1675;0;0;1;0;0;2;2;1675;0;2217;2;1;
/org.eclipse.pde.ui/src/org/eclipse/pde/internal/ui/editor/IOpenablePropertySource.java;1;0;1;1;0;0;0;1;0;0;1;3579;0;0;1;0;0;1;1;3579;0;3579;1;1;
/org.eclipse.team.cvs.core/src/org/eclipse/team/internal/ccvs/core/syncinfo/MutableResourceSyncInfo.java;1;0;6;1;0;0;0;6;103;1;6;3388;139;139;1;0;0;6;6;3388;0;3610;6;1;
/org.eclipse.swt.examples/org/eclipse/swt/examples/controlexample/CoolBarTab.java;3;1;11;1;3;3;3;8;162;2;7;1759;323;323;2;1;0;8;11;3455;1;4024;10;3;
/org.eclipse.pde.ui/src/org/eclipse/pde/internal/model/plugin/PluginAttribute.java;1;0;2;1;0;0;0;2;0;1;2;3136;0;0;1;0;0;2;2;3136;0;3579;2;1;
/org.eclipse.ui/Eclipse JFace/org/eclipse/jface/viewers/ContainerCheckedTreeViewer.java;1;0;2;1;0;0;0;2;0;1;2;3733;0;0;1;0;0;2;2;3733;0;3740;2;1;
/org.eclipse.jdt.ui.tests.refactoring/resources/SelectionAnalyzerWorkSpace/SelectionAnalyzerTests/validSelection/A_test148_.java;1;0;1;1;0;0;0;1;0;0;1;2139;0;0;1;0;0;1;1;2139;0;2139;1;1;
/org.eclipse.jdt.ui.tests.refactoring/resources/ExtractMethodWorkSpace/ExtractMethodTests/validSelection/A_test261.java;2;1;3;1;2;2;2;1;0;0;1;49;0;0;1;0;0;1;3;49;0;4419;3;2;
/org.eclipse.ui/Eclipse UI/org/eclipse/ui/internal/ShowViewAction.java;5;0;7;1;1;1;1;6;7;1;6;257;26;26;1;0;0;6;7;257;0;4429;7;5;
/org.eclipse.jdt.ui.tests.refactoring/resources/MoveMembers/test7/in/B.java;1;0;1;1;0;0;0;1;0;0;1;2738;0;0;1;0;0;1;1;2738;0;2738;1;1;
/org.eclipse.jdt.core/model/org/eclipse/jdt/internal/core/builder/impl/AbstractMethodCollaboratorIndictment.java;1;0;9;1;0;0;0;9;39;4;6;455;57;57;4;3;0;9;9;1039;3;2808;6;1;
/org.eclipse.update.ui/src/org/eclipse/update/internal/ui/search/UpdatesQuery.java;1;0;2;1;0;0;0;2;0;1;2;3537;0;0;1;0;0;2;2;3537;0;3553;2;1;
/org.eclipse.team.tests.cvs.core/src/org/eclipse/team/tests/ccvs/core/compatible/ModuleTest.java;2;0;3;1;0;0;0;3;247;1;3;2536;486;486;1;0;0;3;3;2536;0;3089;3;2;
/org.eclipse.scripting/src/org/eclipse/scripting/internal/datamodels/XGRBaseDataNode.java;1;0;1;1;0;0;0;1;0;0;1;1424;0;0;1;0;0;1;1;1424;0;1424;1;1;
/org.eclipse.help/Eclipse Help/org/eclipse/help/internal/server/OutputProcessor.java;2;0;3;1;0;0;0;3;7;1;3;135;7;7;1;0;0;3;3;135;0;1420;3;2;
/org.eclipse.swt.examples.paint/src/org/eclipse/swt/examples/paint/SegmentedInteractivePaintSession.java;2;0;2;1;0;0;0;2;0;1;2;391;0;0;1;0;0;2;2;391;0;611;2;2;
/org.eclipse.pde.ui/Eclipse PDE UI/org/eclipse/pde/internal/editor/SubActionBars.java;2;0;5;2;0;0;0;5;12;3;3;267;12;12;3;2;0;5;5;324;2;1434;3;2;
/org.eclipse.update.examples/src/org/eclipse/update/examples/buildzip/BuildZipFeatureContentProvider.java;2;0;10;2;1;1;1;9;24;2;7;2762;60;60;2;2;0;9;10;2790;2;4401;8;2;
/org.eclipse.webdav/src/interface/org/eclipse/webdav/dom/QualifiedNameImpl.java;3;0;6;1;1;1;1;5;186;1;5;12;225;225;1;0;0;5;6;12;0;4211;6;3;
/org.eclipse.jdt.ui.tests.refactoring/resources/SelectionAnalyzerWorkSpace/SelectionAnalyzerTests/validSelection/A_test090_.java;1;0;1;1;0;0;0;1;0;0;1;2139;0;0;1;0;0;1;1;2139;0;2139;1;1;
/org.eclipse.jdt.ui.tests.refactoring/resources/ExtractMethodWorkSpace/ExtractMethodTests/branch_in/A_test751.java;1;1;3;1;2;2;2;1;26;0;1;1851;26;26;1;0;0;1;3;1851;0;4419;3;1;
/org.eclipse.pde.ui/Eclipse PDE UI/org/eclipse/pde/internal/builders/SchemaTransformer.java;3;0;8;2;0;0;0;8;89;3;6;267;106;106;3;2;0;8;8;324;2;1434;6;3;
/org.eclipse.update.ui/src/org/eclipse/update/ui/internal/parts/IUpdateFormPage.java;1;0;2;1;0;0;0;2;0;0;1;1426;0;0;2;1;0;2;2;1426;1;1426;1;1;
/org.eclipse.swt.examples.paint/org/eclipse/swt/examples/paint/StatelessXORFigureHelper.java;2;0;3;2;0;0;0;3;24;2;2;566;24;24;2;1;0;3;3;609;1;609;2;2;
/org.eclipse.jdt.ui/ui/org/eclipse/jdt/internal/ui/text/SingleTokenJavaScanner.java;1;0;1;1;0;0;0;1;0;0;1;1864;0;0;1;0;0;1;1;1864;0;1864;1;1;
/org.eclipse.ui/Eclipse UI/org/eclipse/ui/IWorkingSet.java;1;0;5;1;1;1;1;4;71;1;4;3287;112;112;1;0;0;4;5;3287;0;4193;5;1;
/org.eclipse.core.resources/src/org/eclipse/core/internal/indexing/ObjectStorePolicy.java;2;0;2;1;0;0;0;2;0;1;2;370;0;0;1;0;0;2;2;370;0;448;2;2;
/org.eclipse.ui/Eclipse UI Standard Components/org/eclipse/ui/views/properties/IPropertySource.java;3;0;4;1;0;0;0;4;6;1;4;257;13;13;1;0;0;4;4;257;0;2589;4;3;
/org.eclipse.help.ui/src/org/eclipse/help/internal/ui/ElementLabelProvider.java;2;0;8;1;0;0;0;8;43;1;8;1420;79;79;1;0;0;8;8;1420;0;3875;8;2;
/org.eclipse.ui/Eclipse JFace/org/eclipse/ui/internal/HistoryAction.java;1;0;1;1;0;0;0;1;0;0;1;941;0;0;1;0;0;1;1;941;0;941;1;1;
/org.eclipse.jdt.ui.tests.refactoring/resources/PullUpMethods/test5/out/A.java;1;0;3;1;0;0;0;3;1;1;3;2156;1;1;1;0;0;3;3;2156;0;2406;3;1;
/org.eclipse.jdt.ui.tests.refactoring/resources/ExtractMethodWorkSpace/ExtractMethodTests/expression_out/A_test614.java;1;1;3;1;2;2;2;1;0;0;1;1236;0;0;1;0;0;1;3;1236;0;4419;3;1;
/org.eclipse.team.cvs.core/src/org/eclipse/team/internal/ccvs/core/util/PrepareForReplaceVisitor.java;2;2;10;1;5;4;5;5;33;1;5;3455;75;75;2;0;1;5;10;3914;1;4569;9;2;
/org.eclipse.update/src/org/eclipse/update/internal/ui/JarVerificationResult.java;1;0;1;1;0;0;0;1;0;0;1;1424;0;0;1;0;0;1;1;1424;0;1424;1;1;
/org.eclipse.update.ui/src/org/eclipse/update/internal/ui/model/MyComputerSearchSettings.java;1;0;2;1;0;0;0;2;0;1;2;2797;0;0;1;0;0;2;2;2797;0;3537;2;1;
/org.eclipse.jdt.debug.ui/ui/org/eclipse/jdt/internal/debug/ui/launcher/OpenOnDeclaringTypeAction.java;2;0;2;1;0;0;0;2;0;1;2;1915;0;0;1;0;0;2;2;1915;0;2384;2;2;
/org.eclipse.scripting/Eclipse Scripting/org/eclipse/scripting/internal/uirenderer/XGRElementUISwtTableHeading.java;2;0;4;1;0;0;0;4;15;1;4;133;19;19;1;0;0;4;4;133;0;1424;4;2;
/org.eclipse.scripting/Eclipse Scripting/org/eclipse/scripting/internal/ScriptReaderWorkbenchFile.java;2;0;4;1;0;0;0;4;11;1;4;133;15;15;1;0;0;4;4;133;0;1424;4;2;
/org.eclipse.core.tests.runtime/src/org/eclipse/core/tests/internal/plugin/d/api/ApiClass.java;3;0;3;1;0;0;0;3;10;1;3;1794;20;20;1;0;0;3;3;1794;0;3476;3;3;
/org.eclipse.swt/Eclipse SWT OLE Win32/win32/org/eclipse/swt/internal/ole/win32/IClassFactory2.java;2;0;3;1;0;0;0;3;5;1;3;106;5;5;1;0;0;3;3;106;0;2069;3;2;
/org.eclipse.jdt.ui/ui/org/eclipse/jdt/internal/ui/wizards/buildpaths/LibrariesWorkbookPage.java;5;1;48;1;8;8;8;40;264;2;35;15;1560;1560;2;5;0;40;48;49;5;4631;43;5;
/org.eclipse.swt/Eclipse SWT Program/carbon/org/eclipse/swt/program/Program.java;3;1;4;1;4;4;4;0;22;0;0;4170;30;30;1;0;0;0;4;4170;0;4701;4;3;
/org.eclipse.jdt.ui/ui/org/eclipse/jdt/internal/ui/search/FindImplementorsInWorkingSetAction.java;1;2;10;1;4;3;4;6;55;1;6;1707;145;145;2;0;1;6;10;4140;1;4140;9;1;
/org.eclipse.pde.ui/Eclipse PDE UI/org/eclipse/pde/internal/builders/ManifestParser.java;2;0;5;2;0;0;0;5;12;3;3;267;12;12;3;2;0;5;5;324;2;1434;3;2;
/org.eclipse.ui/Eclipse UI/org/eclipse/ui/internal/dialogs/WelcomeEditorInputFactory.java;2;0;2;1;1;1;1;1;22;0;1;457;22;22;1;0;0;1;2;457;0;4407;2;2;
/org.eclipse.jdt.ui.tests.refactoring/resources/ExtractMethodWorkSpace/ExtractMethodTests/validSelection_in/A_test363.java;1;1;3;1;2;2;2;1;14;0;1;2621;14;14;1;0;0;1;3;2621;0;4419;3;1;
/org.eclipse.jdt.ui.tests.refactoring/resources/SelectionAnalyzerWorkSpace/SelectionAnalyzerTests/selection/A_test4.java;1;0;1;1;0;0;0;1;0;0;1;1368;0;0;1;0;0;1;1;1368;0;1368;1;1;
/org.eclipse.swt/Eclipse SWT/motif/org/eclipse/swt/widgets/MessageBox.java;9;1;15;1;5;5;5;10;83;1;10;106;312;312;1;0;0;10;15;106;0;4701;15;9;
/org.eclipse.jdt.ui.tests.refactoring/resources/RenameVariables/cannotRename/A_testFail3.java;1;0;2;1;0;0;0;2;0;1;2;724;0;0;1;0;0;2;2;724;0;1665;2;1;
/org.eclipse.pde.ui/src/org/eclipse/pde/internal/ui/ischema/ISchemaObjectReference.java;1;0;2;1;0;0;0;2;0;1;2;3579;0;0;1;0;0;2;2;3579;0;3591;2;1;
/org.eclipse.team.cvs.ui/src/org/eclipse/team/internal/ccvs/ui/actions/ShowHistoryAction.java;3;1;11;1;2;2;2;9;18;1;9;1991;59;59;1;0;0;9;11;1991;0;4123;11;3;
/org.eclipse.jdt.ui.tests.refactoring/resources/ExtractMethodWorkSpace/ExtractMethodTests/locals_in/A_test524.java;1;1;3;1;2;2;2;1;38;0;1;2684;38;38;1;0;0;1;3;2684;0;4419;3;1;
/org.eclipse.jdt.ui/ui debug/org/eclipse/jdt/internal/debug/ui/ShowStaticFieldsAction.java;2;0;5;1;0;0;0;5;16;1;5;15;31;31;1;0;0;5;5;15;0;1916;5;2;
/org.eclipse.core.resources/src/org/eclipse/core/internal/resources/RootInfo.java;2;0;5;1;1;1;1;4;78;1;4;12;101;101;1;0;0;4;5;12;0;4213;5;2;
/org.eclipse.jdt.ui/ui refactoring/org/eclipse/jdt/internal/ui/refactoring/ExtractInterfaceWizard.java;1;0;2;1;0;0;0;2;0;1;2;15;0;0;1;0;0;2;2;15;0;47;2;1;
/org.eclipse.jdt.core/eval/org/eclipse/jdt/internal/eval/CodeSnippetParser.java;2;1;26;2;2;2;2;24;1291;4;18;455;1561;1561;4;6;0;24;26;1039;6;4062;20;2;
/org.eclipse.pde.ui/src/org/eclipse/pde/internal/editor/schema/NewElementAction.java;2;0;2;1;0;0;0;2;0;1;2;1434;0;0;1;0;0;2;2;1434;0;3579;2;2;
/org.eclipse.pde.ui/Eclipse PDE UI/org/eclipse/pde/internal/preferences/ExternalPluginsWizard.java;2;0;5;2;0;0;0;5;12;3;3;267;12;12;3;2;0;5;5;324;2;1434;3;2;
/org.eclipse.jdt.ui.tests.refactoring/resources/PullUp/test15/in/A.java;1;0;1;1;0;0;0;1;0;0;1;2406;0;0;1;0;0;1;1;2406;0;2406;1;1;
/org.eclipse.webdav/src/interface/org/eclipse/webdav/internal/utils/URLEncoder.java;3;0;5;1;1;1;1;4;328;1;4;12;369;369;1;0;0;4;5;12;0;4211;5;3;
/org.eclipse.jdt.core/search/org/eclipse/jdt/internal/core/search/matching/ConstructorDeclarationPattern.java;2;0;12;1;1;1;1;11;1056;4;7;455;2087;2087;4;4;0;11;12;1039;4;4063;8;2;
/org.eclipse.jdt.ui/core refactoring/org/eclipse/jdt/internal/corext/refactoring/rename/TextMatchFinder.java;2;0;4;1;0;0;0;4;15;1;4;1939;28;28;1;0;0;4;4;1939;0;3678;4;2;
/org.eclipse.jdt.ui/ui/org/eclipse/jdt/internal/ui/text/link/LinkedPositionUI.java;4;2;16;2;3;2;3;13;127;2;12;1720;465;465;2;1;1;13;16;1720;2;4568;14;4;
/org.eclipse.ui.externaltools/External Tools/org/eclipse/ui/externaltools/internal/core/ToolUtil.java;1;2;7;1;7;6;7;0;46;0;0;4090;95;95;2;0;1;0;7;4188;1;4768;6;1;
/org.eclipse.jdt.ui.tests.refactoring/resources/RenameType/test49/in/A.java;1;0;1;1;0;0;0;1;0;0;1;49;0;0;1;0;0;1;1;49;0;49;1;1;
/org.eclipse.scripting/src/org/eclipse/scripting/ScriptAdapterWorkbenchResourceEditorContent.java;1;0;1;1;0;0;0;1;0;0;1;1424;0;0;1;0;0;1;1;1424;0;1424;1;1;
/org.eclipse.jdt.ui.tests.refactoring/resources/RenameStaticMethod/testFail8/in/A.java;1;0;1;1;0;0;0;1;0;0;1;49;0;0;1;0;0;1;1;49;0;49;1;1;
/org.eclipse.jdt.ui.tests.refactoring/resources/RenameType/testFail45/in/A.java;1;0;1;1;0;0;0;1;0;0;1;49;0;0;1;0;0;1;1;49;0;49;1;1;
/org.eclipse.help/Eclipse Help/org/eclipse/help/internal/util/SequenceGenerator.java;2;0;3;1;0;0;0;3;7;1;3;135;7;7;1;0;0;3;3;135;0;1420;3;2;
/org.eclipse.jdt.ui/core refactoring/org/eclipse/jdt/core/refactoring/methods/RenameVirtualMethodRefactoring.java;1;0;7;1;0;0;0;7;33;2;6;15;68;68;2;1;0;7;7;391;1;408;6;1;
/org.eclipse.pde.ui/src/org/eclipse/pde/internal/ui/editor/manifest/ManifestSourceOutlinePage.java;1;0;1;1;0;0;0;1;0;0;1;3579;0;0;1;0;0;1;1;3579;0;3579;1;1;
/org.eclipse.team.cvs.ui/src/org/eclipse/team/internal/ccvs/ui/IRepositoryListener.java;3;0;7;2;0;0;0;7;15;1;7;2009;44;44;1;0;0;7;7;2009;0;3610;7;3;
/org.eclipse.update.tests.core/src/org/eclipse/update/tests/core/boot/TestPlatCfgDefault.java;1;0;2;1;0;0;0;2;9;1;2;2082;9;9;1;0;0;2;2;2082;0;2315;2;1;
/org.eclipse.vcm.core/src/org/eclipse/vcm/internal/core/EmptyVersionHistory.java;3;0;3;1;0;0;0;3;6;1;3;0;11;11;1;0;0;3;3;0;0;297;3;3;
/org.eclipse.core.runtime/src/org/eclipse/core/runtime/ILibrary.java;3;0;6;1;1;1;1;5;170;1;5;12;260;260;1;0;0;5;6;12;0;4214;6;3;
/org.eclipse.update.core/src/org/eclipse/update/core/IFeatureContentProvider.java;2;0;11;2;1;1;1;10;266;2;9;2434;468;468;2;1;0;10;11;2786;1;4060;10;2;
/org.eclipse.jdt.debug/jdi interfaces/com/sun/jdi/ObjectCollectedException.java;2;0;2;1;0;0;0;2;7;1;2;2704;7;7;1;0;0;2;2;2704;0;3033;2;2;
/org.eclipse.jdt.junit/src/org/eclipse/jdt/junit/wizards/NewTestSuiteCreationWizardPage.java;2;0;10;1;0;0;0;10;253;4;7;3247;304;304;4;3;0;10;10;3392;3;3527;7;2;
/org.eclipse.jdt.debug/eval/org/eclipse/jdt/internal/debug/eval/ast/JavaObjectRuntimeContext.java;1;0;2;1;0;0;0;2;0;1;2;3386;0;0;1;0;0;2;2;3386;0;3421;2;1;
/org.eclipse.jdt.ui.tests.refactoring/resources/RenameParameters/cannotRename/A_testFail1.java;1;0;1;1;0;0;0;1;0;0;1;233;0;0;1;0;0;1;1;233;0;233;1;1;
/org.eclipse.jdt.core/compiler/org/eclipse/jdt/internal/compiler/ast/DefaultCase.java;2;0;13;1;1;1;1;12;110;4;9;455;259;259;4;3;0;12;13;1039;3;4062;10;2;
/org.eclipse.jdt.ui/ui/org/eclipse/jdt/internal/ui/text/java/hover/JavaTextHover.java;4;0;11;1;1;1;1;10;220;1;10;15;357;357;1;0;0;10;11;15;0;4186;11;4;
/org.eclipse.core.tests.runtime/src/org/eclipse/core/tests/internal/runtime/CipherTest.java;3;0;3;1;0;0;0;3;90;1;3;1794;100;100;1;0;0;3;3;1794;0;3476;3;3;
/org.eclipse.jdt.ui.tests.refactoring/resources/RenameTemp/canRename/A_test39_in.java;1;0;1;1;0;0;0;1;0;0;1;3229;0;0;1;0;0;1;1;3229;0;3229;1;1;
/org.eclipse.scripting/src/org/eclipse/scripting/internal/views/ScriptUIEditorXmlAttribute.java;1;0;1;1;0;0;0;1;0;0;1;1424;0;0;1;0;0;1;1;1424;0;1424;1;1;
/org.eclipse.core.resources/src/org/eclipse/core/internal/localstore/ILocalStoreConstants.java;2;0;4;1;1;1;1;3;50;1;3;12;69;69;1;0;0;3;4;12;0;4214;4;2;
/org.eclipse.jdt.ui/core refactoring/org/eclipse/jdt/internal/corext/refactoring/NullChange.java;1;0;1;1;0;0;0;1;0;0;1;1939;0;0;1;0;0;1;1;1939;0;1939;1;1;
/org.eclipse.jdt.debug.tests/tests/org/eclipse/jdt/debug/tests/eval/TypeHierarchy_21_1.java;2;1;3;1;3;3;3;0;13;0;0;4447;15;15;1;0;0;0;3;4447;0;4571;3;2;
/org.eclipse.jdt.ui/ui/org/eclipse/jdt/internal/ui/reorg/ICopySupport.java;2;0;4;1;0;0;0;4;10;1;4;15;15;15;1;0;0;4;4;15;0;1258;4;2;
/org.eclipse.ant.ui/src/org/eclipse/ant/internal/ui/toolscripts/GlobalToolScriptAction.java;1;0;2;1;0;0;0;2;0;1;2;2933;0;0;1;0;0;2;2;2933;0;2979;2;1;
/org.eclipse.swt/Eclipse SWT/win32/org/eclipse/swt/internal/win32/TOOLINFO.java;2;0;3;1;0;0;0;3;5;1;3;106;5;5;1;0;0;3;3;106;0;2069;3;2;
/org.eclipse.update.ui/src/org/eclipse/update/internal/ui/parts/PixelConverter.java;1;0;1;1;0;0;0;1;0;0;1;3584;0;0;1;0;0;1;1;3584;0;3584;1;1;
/org.eclipse.jdt.ui/ui/org/eclipse/jdt/internal/ui/text/LineBreakingReader.java;3;0;6;1;0;0;0;6;53;2;5;295;64;64;2;1;0;6;6;1482;1;1482;5;3;
/org.eclipse.jdt.ui.tests.refactoring/resources/RenamePrivateField/testFail2/in/A.java;1;0;1;1;0;0;0;1;0;0;1;49;0;0;1;0;0;1;1;49;0;49;1;1;
/org.eclipse.jdt.ui/ui/org/eclipse/jdt/internal/ui/text/javadoc/JavaDocMessages.java;1;0;1;1;0;0;0;1;0;0;1;770;0;0;1;0;0;1;1;770;0;770;1;1;
/org.eclipse.jdt.ui/ui/org/eclipse/jdt/internal/ui/javaeditor/JavaOutlineErrorTickUpdater.java;3;0;6;1;1;1;1;5;36;1;5;1241;78;78;1;0;0;5;6;1241;0;4138;6;3;
/org.eclipse.debug.ui/ui/org/eclipse/debug/internal/ui/views/ConsoleDocument.java;4;0;16;2;1;1;1;15;135;2;13;2338;365;365;2;2;0;15;16;2914;2;3975;14;4;
/org.eclipse.swt/Eclipse SWT PI/motif/org/eclipse/swt/internal/motif/XMotionEvent.java;2;0;2;1;1;1;1;1;6;0;1;2069;6;6;1;0;0;1;2;2069;0;4701;2;2;
/org.eclipse.jdt.ui/ui/org/eclipse/jdt/internal/ui/javaeditor/ExternalClassFileEditorInput.java;2;0;3;1;0;0;0;3;16;1;3;1685;26;26;1;0;0;3;3;1685;0;3568;3;2;
/org.eclipse.swt/Eclipse SWT/motif/org/eclipse/swt/widgets/ProgressBar.java;7;1;12;1;4;4;4;8;223;1;8;106;580;580;1;0;0;8;12;106;0;4701;12;7;
/org.eclipse.ui/Eclipse UI/org/eclipse/ui/internal/OpenNewWindowAction.java;5;0;8;1;1;1;1;7;125;1;7;257;144;144;1;0;0;7;8;257;0;4429;8;5;
/org.eclipse.pde.ui/src/org/eclipse/pde/internal/ui/editor/manifest/ImportListSection.java;1;1;7;1;2;2;2;5;48;2;4;3579;86;86;2;1;0;5;7;3579;1;4567;6;1;
/org.eclipse.jdt.ui.tests.refactoring/resources/MoveMembers/test22/in/B.java;1;0;1;1;0;0;0;1;0;0;1;2738;0;0;1;0;0;1;1;2738;0;2738;1;1;
/org.eclipse.swt/Eclipse SWT PI/gtk/org/eclipse/swt/internal/gtk/GtkCheckMenuItem.java;1;0;2;1;0;0;0;2;0;1;2;2107;0;0;1;0;0;2;2;2107;0;3209;2;1;
/org.eclipse.debug.ui/ui/org/eclipse/debug/internal/ui/actions/StepOverActionDelegate.java;2;0;4;1;1;1;1;3;37;1;3;2382;47;47;1;0;0;3;4;2382;0;4163;4;2;
/org.eclipse.jdt.core/search/org/eclipse/jdt/internal/core/index/IndexFactory.java;2;1;4;1;2;2;2;2;20;1;2;455;30;30;1;0;0;2;4;455;0;4525;4;2;
/org.eclipse.help.ui/src/org/eclipse/help/internal/ui/DefaultHelp.java;2;1;37;2;2;2;2;35;248;3;30;1420;1760;1760;3;5;0;35;37;3049;5;4439;32;2;
/org.eclipse.pde.core/src/org/eclipse/pde/internal/core/schema/ExternalSchemaDescriptor.java;1;0;2;1;0;0;0;2;12;1;2;3591;12;12;1;0;0;2;2;3591;0;3607;2;1;
/org.eclipse.update.tests.core/src/org/eclipse/update/tests/parser/TestFeatureParse.java;2;0;17;1;1;1;1;16;59;2;14;1577;158;158;2;2;0;16;17;1577;2;4208;15;2;
/org.eclipse.update.ui.forms/src/org/eclipse/update/ui/forms/internal/engine/Paragraph.java;1;0;7;1;1;1;1;6;66;2;5;2745;147;147;2;1;0;6;7;2745;1;4365;6;1;
/org.eclipse.pde.ui/src/org/eclipse/pde/ui/IProjectProvider.java;1;0;2;1;1;1;1;1;24;0;1;3579;24;24;1;0;0;1;2;3579;0;4752;2;1;
/org.eclipse.ui/Eclipse UI/org/eclipse/ui/internal/AboutParser.java;1;1;2;1;2;2;2;0;0;0;0;4030;0;0;1;0;0;0;2;4030;0;4150;2;1;
/org.eclipse.jdt.ui.tests.refactoring/resources/MoveCU/test/in/p1/C.java;2;0;2;1;0;0;0;2;0;1;2;49;0;0;1;0;0;2;2;49;0;2769;2;2;
/org.eclipse.scripting/Eclipse Scripting/org/eclipse/scripting/internal/views/ScriptUIPreviewEditor.java;2;0;4;1;0;0;0;4;93;1;4;133;108;108;1;0;0;4;4;133;0;1424;4;2;
/org.eclipse.jdt.debug/jdi interfaces/com/sun/jdi/request/WatchpointRequest.java;2;0;2;1;0;0;0;2;15;1;2;2704;15;15;1;0;0;2;2;2704;0;3040;2;2;
/org.eclipse.core.tests.resources/src/org/eclipse/core/tests/resources/TestPerformer.java;3;0;5;2;0;0;0;5;230;1;5;1794;266;266;1;0;0;5;5;1794;0;3875;5;3;
/org.eclipse.swt/Eclipse SWT PI/gtk/org/eclipse/swt/internal/gtk/GdkFont.java;1;0;2;1;0;0;0;2;0;1;2;2107;0;0;1;0;0;2;2;2107;0;3869;2;1;
/org.eclipse.jdt.debug.tests/tests/org/eclipse/jdt/debug/tests/eval/NumericTypesCastTests.java;2;1;3;1;3;3;3;0;18;0;0;4447;20;20;1;0;0;0;3;4447;0;4571;3;2;
/org.eclipse.jdt.ui.tests.refactoring/resources/DeleteSourceReference/test5/in/A.java;1;0;1;1;0;0;0;1;0;0;1;2857;0;0;1;0;0;1;1;2857;0;2857;1;1;
/org.eclipse.swt/Eclipse SWT/common/org/eclipse/swt/widgets/TypedListener.java;4;0;5;1;1;1;1;4;8;1;4;106;26;26;1;0;0;4;5;106;0;4701;5;4;
/org.eclipse.jdt.core/search/org/eclipse/jdt/internal/core/index/impl/BlocksIndexInput.java;3;2;13;1;3;2;3;10;378;4;7;455;703;703;4;3;1;10;13;1039;4;4063;9;3;
/org.eclipse.jdt.ui.tests.refactoring/resources/RenameStaticMethod/test1/in/A.java;2;0;2;1;0;0;0;2;1;1;2;49;1;1;1;0;0;2;2;49;0;1297;2;2;
/org.eclipse.jdt.debug.ui/ui/org/eclipse/jdt/internal/debug/ui/launcher/JDK12DebugLauncher.java;2;0;9;2;0;0;0;9;46;2;7;1915;62;62;2;2;0;9;9;1915;2;2388;7;2;
/org.eclipse.jdt.ui.tests/refactoring/org/eclipse/jdt/refactoring/tests/infra/FileDocumentManager.java;2;0;4;1;0;0;0;4;10;1;4;49;15;15;1;0;0;4;4;49;0;1896;4;2;
/org.eclipse.swt.examples.paint/org/eclipse/swt/examples/paint/SimplePaintSession.java;1;0;1;1;0;0;0;1;0;0;1;513;0;0;1;0;0;1;1;513;0;513;1;1;
/org.eclipse.webdav/src/interface/org/eclipse/webdav/dom/Owner.java;2;0;4;1;1;1;1;3;74;1;3;12;104;104;1;0;0;3;4;12;0;4211;4;2;
/org.eclipse.swt/Eclipse SWT PI/win32/org/eclipse/swt/internal/win32/NMLVCUSTOMDRAW.java;1;0;2;1;1;1;1;1;6;0;1;3122;6;6;1;0;0;1;2;3122;0;4701;2;1;
/org.eclipse.ui/Eclipse JFace/org/eclipse/jface/preference/FontPreferencePage.java;1;0;1;1;0;0;0;1;0;0;1;955;0;0;1;0;0;1;1;955;0;955;1;1;
/org.eclipse.ant.ui/src/org/eclipse/ant/internal/ui/CustomizeAntContentProvider.java;1;0;2;1;0;0;0;2;45;0;1;3489;45;45;2;1;0;2;2;3489;1;3489;1;1;
/org.eclipse.update.ui/src/org/eclipse/update/internal/ui/manager/RemovePage.java;1;0;2;1;0;0;0;2;0;0;1;1457;0;0;2;1;0;2;2;1457;1;1457;1;1;
/org.eclipse.jdt.ui.tests.refactoring/resources/MoveMembers/testFail14/in/B.java;1;0;1;1;0;0;0;1;0;0;1;2738;0;0;1;0;0;1;1;2738;0;2738;1;1;
/org.eclipse.ui/Eclipse UI Standard Components/org/eclipse/ui/views/tasklist/FiltersAction.java;4;1;5;1;2;2;2;3;15;1;3;257;28;28;1;0;0;3;5;257;0;4608;5;4;
/org.eclipse.jdt.ui.tests/ui/org/eclipse/jdt/ui/tests/text/JavaDoc2HTMLTextReaderTester.java;1;0;1;1;1;1;1;0;7;0;0;4643;7;7;1;0;0;0;1;4643;0;4643;1;1;
/org.eclipse.help/Eclipse Help/org/eclipse/help/internal/util/ContextResources.java;2;0;4;1;0;0;0;4;16;1;4;374;17;17;1;0;0;4;4;374;0;1085;4;2;
/org.eclipse.help.webapp/src/org/eclipse/help/servlet/HighlightFilter.java;2;1;12;1;3;3;3;9;74;1;9;2410;204;204;1;0;0;9;12;2410;0;4428;12;2;
/org.eclipse.pde.ui/src/org/eclipse/pde/internal/base/model/component/IComponentPlugin.java;2;0;2;1;0;0;0;2;0;1;2;1434;0;0;1;0;0;2;2;1434;0;2951;2;2;
/org.eclipse.ui/Eclipse UI/org/eclipse/ui/IWorkingSetDialog.java;1;0;1;1;0;0;0;1;0;0;1;3400;0;0;1;0;0;1;1;3400;0;3400;1;1;
/org.eclipse.webdav/src/interface/org/eclipse/webdav/dom/Conflict.java;2;0;4;1;1;1;1;3;110;1;3;12;140;140;1;0;0;3;4;12;0;4211;4;2;
/org.eclipse.pde.ui/src/org/eclipse/pde/internal/ui/ischema/ISchemaEnumeration.java;1;0;2;1;0;0;0;2;0;1;2;3579;0;0;1;0;0;2;2;3579;0;3591;2;1;
/org.eclipse.jdt.junit/Eclipse JUnit/org/eclipse/jdt/junit/internal/HierarchyRunView.java;2;0;2;1;0;0;0;2;0;1;2;1531;0;0;1;0;0;2;2;1531;0;2007;2;2;
/org.eclipse.compare/compare/org/eclipse/compare/structuremergeviewer/IDiffContainer.java;1;0;2;1;0;0;0;2;5;1;2;14;5;5;1;0;0;2;2;14;0;329;2;1;
/org.eclipse.jdt.debug/jdi interfaces/com/sun/jdi/ClassNotLoadedException.java;2;0;2;1;0;0;0;2;7;1;2;2704;7;7;1;0;0;2;2;2704;0;3033;2;2;
/org.eclipse.debug.ui/ui/org/eclipse/debug/internal/ui/preferences/LaunchHistoryPreferenceTab.java;3;1;7;1;7;7;7;0;18;0;0;3975;57;57;1;0;0;0;7;3975;0;4426;7;3;
/org.eclipse.ui/Eclipse UI/org/eclipse/ui/internal/misc/UIHackFinder.java;2;0;2;1;0;0;0;2;5;1;2;257;5;5;1;0;0;2;2;257;0;457;2;2;
/org.eclipse.jdt.debug/jdi interfaces/com/sun/jdi/request/VMDeathRequest.java;1;0;1;1;0;0;0;1;0;0;1;2704;0;0;1;0;0;1;1;2704;0;2704;1;1;
/org.eclipse.team.cvs.ui/src/org/eclipse/team/internal/ccvs/ui/merge/ProjectElement.java;3;2;8;1;4;3;4;4;47;1;4;2763;133;133;2;0;1;4;8;4426;1;4426;7;3;
/org.eclipse.jdt.ui/core refactoring/org/eclipse/jdt/internal/core/refactoring/rename/RenameFieldASTAnalyzer.java;2;0;5;1;0;0;0;5;6;2;4;1342;9;9;2;1;0;5;5;1910;1;1939;4;2;
/org.eclipse.jdt.debug/model/org/eclipse/jdt/internal/debug/core/model/JDIType.java;3;0;7;2;1;1;1;6;6;3;4;2517;19;19;3;2;0;6;7;2517;2;4063;5;3;
/org.eclipse.jdt.ui.tests.refactoring/resources/RenameTemp/canRename/A_test36_in.java;1;0;2;1;0;0;0;2;2;1;2;2876;2;2;1;0;0;2;2;2876;0;3086;2;1;
/org.eclipse.vcm.ui/src/org/eclipse/vcm/internal/ui/HistoryDialog.java;2;0;2;2;0;0;0;2;0;0;1;1;0;0;2;1;0;2;2;1;1;1;1;2;
/org.eclipse.compare/compare/org/eclipse/compare/patch/PatchedResource.java;1;0;4;1;0;0;0;4;23;1;4;1516;45;45;1;0;0;4;4;1516;0;2876;4;1;
/org.eclipse.jdt.ui/ui/org/eclipse/jdt/internal/ui/text/correction/CorrectionMessages.java;1;0;1;1;0;0;0;1;0;0;1;3528;0;0;1;0;0;1;1;3528;0;3528;1;1;
/org.eclipse.pde.ui/src/org/eclipse/pde/internal/ui/editor/text/PDEWhitespaceDetector.java;1;0;2;1;1;1;1;1;2;0;1;3579;2;2;1;0;0;1;2;3579;0;4381;2;1;
/org.eclipse.pde.ui/src/org/eclipse/pde/internal/base/IProjectProvider.java;2;0;3;1;0;0;0;3;19;1;3;1434;19;19;1;0;0;3;3;1434;0;3039;3;2;
/org.eclipse.swt.examples/org/eclipse/swt/examples/fileviewer/TableView.java;2;0;3;2;0;0;0;3;1;2;2;554;1;1;2;1;0;3;3;609;1;609;2;2;
/org.eclipse.swt/Eclipse SWT/common/org/eclipse/swt/events/KeyListener.java;4;0;5;1;1;1;1;4;6;1;4;106;18;18;1;0;0;4;5;106;0;4701;5;4;
/org.eclipse.pde.ui/src/org/eclipse/pde/internal/core/build/Build.java;1;0;3;1;0;0;0;3;13;2;2;3579;13;13;2;1;0;3;3;3579;1;3607;2;1;
/org.eclipse.swt/Eclipse SWT PI/gtk1x/org/eclipse/swt/internal/gtk/GtkMenuItem.java;2;0;2;1;1;1;1;1;3;0;1;2107;3;3;1;0;0;1;2;2107;0;4701;2;2;
/org.eclipse.jdt.debug.ui/ui/org/eclipse/jdt/internal/debug/ui/JavaDebugOptionsManager.java;4;1;35;2;6;6;6;29;397;2;25;2762;1310;1310;2;4;0;29;35;2762;4;4435;31;4;
/org.eclipse.help/src/org/eclipse/help/internal/contributions/xml/HelpInfoSet.java;2;0;2;1;0;0;0;2;0;1;2;1420;0;0;1;0;0;2;2;1420;0;1675;2;2;
/org.eclipse.vcm.core.cvs/src/org/eclipse/vcm/internal/core/ccvs/client/UnsupportedHandler.java;3;0;3;1;0;0;0;3;6;1;3;0;10;10;1;0;0;3;3;0;0;298;3;3;
/org.eclipse.jdt.ui.tests.refactoring/resources/ExtractMethodWorkSpace/ExtractMethodTests/return_out/A_test711.java;1;1;3;1;2;2;2;1;30;0;1;887;30;30;1;0;0;1;3;887;0;4419;3;1;
/org.eclipse.jdt.core/model/org/eclipse/jdt/core/jdom/IDOMCompilationUnit.java;2;0;4;1;1;1;1;3;82;1;3;455;111;111;1;0;0;3;4;455;0;4061;4;2;
/org.eclipse.team.cvs.core/src/org/eclipse/team/internal/ccvs/core/client/Remove.java;2;0;8;2;0;0;0;8;32;2;7;2572;49;49;2;1;0;8;8;3089;1;3610;7;2;
/org.eclipse.swt.tests/JUnit Tests/org/eclipse/swt/tests/junit/Test_org_eclipse_swt_custom_ControlEditor.java;2;0;2;1;1;1;1;1;6;0;1;1792;6;6;1;0;0;1;2;1792;0;4706;2;2;
/org.eclipse.pde.ui/Eclipse PDE UI/org/eclipse/pde/internal/editor/schema/NewCompositorAction.java;2;0;5;2;0;0;0;5;12;3;3;267;12;12;3;2;0;5;5;324;2;1434;3;2;
/org.eclipse.pde.ui/src/org/eclipse/pde/internal/editor/feature/PortabilitySection.java;1;0;6;1;0;0;0;6;34;1;6;2953;48;48;1;0;0;6;6;2953;0;3579;6;1;
/org.eclipse.jdt.ui/core extension/org/eclipse/jdt/internal/corext/codemanipulation/NameProposer.java;4;2;11;1;4;3;4;7;34;1;7;2876;157;157;2;0;1;7;11;4116;1;4402;10;4;
/org.eclipse.jdt.core/codeassist/org/eclipse/jdt/internal/codeassist/select/SelectionOnQualifiedNameReference.java;2;0;10;1;1;1;1;9;68;4;6;455;157;157;4;3;0;9;10;1039;3;4062;7;2;
/org.eclipse.core.resources/src/org/eclipse/core/internal/localstore/UnifiedTreeNode.java;3;0;8;1;1;1;1;7;210;1;7;12;280;280;1;0;0;7;8;12;0;4214;8;3;
/org.eclipse.jdt.ui/ui/org/eclipse/jdt/internal/ui/compare/JavaContentViewerCreator.java;1;0;2;1;0;0;0;2;5;1;2;15;5;5;1;0;0;2;2;15;0;329;2;1;
/org.eclipse.help.ui/Eclipse Help UI/org/eclipse/help/internal/ui/util/RuntimeErrorDialog.java;2;0;5;1;0;0;0;5;15;2;4;136;23;23;2;1;0;5;5;238;1;1420;4;2;
/org.eclipse.swt.examples.paint/src/org/eclipse/swt/examples/paint/SolidRoundedRectangleFigure.java;3;0;4;2;1;1;1;3;55;2;2;586;61;61;2;1;0;3;4;609;1;4705;3;3;
/org.eclipse.core.tests.resources/src/org/eclipse/core/tests/internal/builders/BuildDeltaVerificationTest.java;3;0;3;1;0;0;0;3;836;1;3;1794;844;844;1;0;0;3;3;1794;0;3420;3;3;
/org.eclipse.jdt.core/compiler/org/eclipse/jdt/internal/compiler/flow/ConditionalFlowInfo.java;2;0;10;1;1;1;1;9;224;4;6;455;264;264;4;3;0;9;10;1039;3;4062;7;2;
/org.eclipse.jdt.debug/eval/org/eclipse/jdt/internal/debug/eval/ast/engine/PushLong.java;1;0;3;1;0;0;0;3;56;1;3;3329;56;56;1;0;0;3;3;3329;0;3421;3;1;
/org.eclipse.pde.ui/src/org/eclipse/pde/internal/ui/launcher/TracingLauncherTab.java;1;1;9;1;4;4;4;5;55;2;4;3579;93;93;2;1;0;5;9;3579;1;4636;8;1;
/org.eclipse.jdt.ui/ui/org/eclipse/jdt/internal/ui/browsing/JavaElementTypeComparator.java;1;0;2;1;1;1;1;1;2;0;1;2878;2;2;1;0;0;1;2;2878;0;4449;2;1;
/org.eclipse.jdt.ui.tests.refactoring/resources/ExtractMethodWorkSpace/ExtractMethodTests/invalidSelection/A_test042.java;2;1;3;1;2;2;2;1;0;0;1;49;0;0;1;0;0;1;3;49;0;4419;3;2;
/org.eclipse.swt/Eclipse SWT/common/org/eclipse/swt/graphics/Point.java;3;0;4;1;1;1;1;3;6;1;3;106;14;14;1;0;0;3;4;106;0;4701;4;3;
/org.eclipse.pde.ui/src/org/eclipse/pde/internal/wizards/templates/DefaultPluginTemplateWizard.java;1;0;3;1;0;0;0;3;5;1;3;3240;5;5;1;0;0;3;3;3240;0;3579;3;1;
/org.eclipse.core.tests.runtime/src/org/eclipse/core/tests/internal/plugins/SoftPrereqTest_19.java;3;0;3;1;0;0;0;3;94;1;3;1794;104;104;1;0;0;3;3;1794;0;3476;3;3;
/org.eclipse.pde.build/src/org/eclipse/pde/internal/build/BuildManifestTask.java;2;0;4;1;0;0;0;4;32;1;4;1915;64;64;1;0;0;4;4;1915;0;3089;4;2;
/org.eclipse.jdt.ui/ui/org/eclipse/jdt/internal/ui/actions/OpenJavaElementAction.java;7;1;14;1;2;2;2;12;112;2;11;15;227;227;2;1;0;12;14;675;1;3967;13;7;
/org.eclipse.swt.examples.paint/org/eclipse/swt/examples/paint/PaintRenderer.java;1;0;1;1;0;0;0;1;0;0;1;513;0;0;1;0;0;1;1;513;0;513;1;1;
/org.eclipse.ui/Eclipse UI/org/eclipse/ui/internal/dialogs/CreateProjectStep.java;2;0;5;1;1;1;1;4;19;2;3;3187;39;39;2;1;0;4;5;3187;1;4082;4;2;
/org.eclipse.scripting/Eclipse Scripting/org/eclipse/scripting/IScriptAdapter.java;1;0;3;1;0;0;0;3;7;1;3;133;7;7;1;0;0;3;3;133;0;1424;3;1;
/org.eclipse.jdt.core/model/org/eclipse/jdt/internal/core/builder/impl/TypeStructureEntry.java;1;0;10;1;0;0;0;10;63;4;6;455;99;99;4;4;0;10;10;1039;4;2808;6;1;
/org.eclipse.pde.junit/Pde JUnit/org/eclipse/pde/internal/junit/ui/JUnitPdePreferencePage.java;1;0;2;1;0;0;0;2;0;1;2;2399;0;0;1;0;0;2;2;2399;0;2654;2;1;
/org.eclipse.ui/Eclipse JFace/org/eclipse/jface/dialogs/MessageDialog.java;4;0;6;1;0;0;0;6;5;1;6;257;13;13;1;0;0;6;6;257;0;3148;6;4;
/org.eclipse.jdt.ui/ui/org/eclipse/jdt/internal/ui/actions/GroupContext.java;4;1;6;1;3;3;3;3;16;1;3;15;24;24;1;0;0;3;6;15;0;4161;6;4;
/org.eclipse.ui.externaltools/External Tools/org/eclipse/ui/externaltools/internal/ui/AntPageContentProvider.java;1;0;1;1;1;1;1;0;0;0;0;4123;0;0;1;0;0;0;1;4123;0;4123;1;1;
/org.eclipse.ui/Eclipse JFace Text/org/eclipse/jface/text/IDocumentExtension.java;1;1;5;1;4;4;4;1;67;0;1;1739;87;87;1;0;0;1;5;1739;0;4853;5;1;
/org.eclipse.search/search/org/eclipse/search/ui/IWorkingSet.java;1;0;4;1;1;1;1;3;2;1;3;1434;3;3;1;0;0;3;4;1434;0;3896;4;1;
/org.eclipse.pde.ui/src/org/eclipse/pde/internal/core/feature/FeatureData.java;1;0;3;1;0;0;0;3;2;1;3;3579;2;2;1;0;0;3;3;3579;0;3607;3;1;
/org.eclipse.pde.build/src/org/eclipse/pde/internal/build/PluginBuildScriptGenerator.java;5;1;12;1;2;2;2;10;50;2;9;245;110;110;2;1;0;10;12;3571;1;4273;11;5;
/org.eclipse.pde.ui/src/org/eclipse/pde/internal/ui/SourceLocation.java;1;1;3;1;3;3;3;0;23;0;0;4228;23;23;1;0;0;0;3;4228;0;4408;3;1;
/org.eclipse.jdt.ui/core refactoring/org/eclipse/jdt/internal/core/refactoring/rename/RenameCompilationUnitRefactoring.java;2;0;7;1;0;0;0;7;70;1;7;1342;103;103;1;0;0;7;7;1342;0;1939;7;2;
/org.eclipse.swt/Eclipse SWT/motif/org/eclipse/swt/internal/motif/KDE.java;3;0;4;1;0;0;0;4;80;1;4;106;86;86;1;0;0;4;4;106;0;2069;4;3;
/org.eclipse.jdt.ui/core refactoring/org/eclipse/jdt/internal/core/refactoring/util/Binding2JavaModel.java;1;0;2;1;0;0;0;2;0;0;1;1927;0;0;2;1;0;2;2;1927;1;1927;1;1;
/org.eclipse.ant.core/src/org/eclipse/ant/core/CreateProject.java;3;0;3;1;0;0;0;3;440;1;3;896;440;440;1;0;0;3;3;896;0;3489;3;3;
/org.eclipse.team.tests.core/src/org/eclipse/team/tests/ftp/FTPApplication.java;1;0;1;1;1;1;1;0;0;0;0;4212;0;0;1;0;0;0;1;4212;0;4212;1;1;
/org.eclipse.core.resources/src/org/eclipse/core/internal/utils/UniversalUniqueIdentifier.java;3;1;6;1;2;2;2;4;848;1;4;12;897;897;1;0;0;4;6;12;0;4214;6;3;
/org.eclipse.jdt.ui/core refactoring/org/eclipse/jdt/core/refactoring/methods/RenameMethodInInterfaceRefactoring.java;1;0;5;1;0;0;0;5;31;1;5;15;48;48;1;0;0;5;5;15;0;408;5;1;
/org.eclipse.jdt.ui/nls/org/eclipse/jdt/internal/nls/changes/CreateFileChange.java;1;0;3;1;0;0;0;3;4;2;2;1880;4;4;2;1;0;3;3;1880;1;1913;2;1;
/org.eclipse.jdt.ui/ui refactoring/org/eclipse/jdt/internal/ui/refactoring/sef/SelfEncapsulateFieldWizard.java;2;0;7;1;1;1;1;6;31;1;6;1453;47;47;1;0;0;6;7;1453;0;4630;7;2;
/org.eclipse.jdt.debug/jdi/org/eclipse/jdi/internal/connect/SocketAttachingConnectorImpl.java;2;0;7;1;1;1;1;6;21;1;6;187;76;76;1;0;0;6;7;187;0;4423;7;2;
/org.eclipse.swt/Eclipse SWT/emulated/bidi/org/eclipse/swt/internal/BidiUtil.java;4;0;11;2;1;1;1;10;35;2;7;1360;79;79;2;3;0;10;11;1360;3;4701;8;4;
/org.eclipse.help/src/org/eclipse/help/internal/search/ISearchIndex.java;2;0;2;1;0;0;0;2;0;1;2;2318;0;0;1;0;0;2;2;2318;0;2325;2;2;
/org.eclipse.jdt.core/compiler/org/eclipse/jdt/internal/compiler/impl/ByteConstant.java;2;0;11;1;1;1;1;10;90;4;6;455;150;150;4;4;0;10;11;1039;4;4062;7;2;
/org.eclipse.swt/Eclipse SWT/win32/org/eclipse/swt/internal/win32/LVITEM.java;2;0;3;1;0;0;0;3;5;1;3;106;5;5;1;0;0;3;3;106;0;2069;3;2;
/org.eclipse.jdt.core/model/org/eclipse/jdt/internal/core/builder/MemoryBinaryBroker.java;1;0;3;1;0;0;0;3;80;1;3;455;80;80;1;0;0;3;3;455;0;2808;3;1;
/org.eclipse.jdt.ui.tests.refactoring/resources/RenameParameters/cannotRename/A_testFail13.java;1;0;1;1;0;0;0;1;0;0;1;233;0;0;1;0;0;1;1;233;0;233;1;1;
/org.eclipse.jdt.core/compiler/org/eclipse/jdt/internal/compiler/lookup/TypeIds.java;2;0;10;1;1;1;1;9;18;4;6;455;48;48;4;3;0;9;10;1039;3;4062;7;2;
/org.eclipse.jdt.debug/eval/org/eclipse/jdt/internal/debug/eval/ast/instructions/SimpleInstruction.java;2;0;5;1;1;1;1;4;4;1;4;3421;11;11;1;0;0;4;5;3421;0;4423;5;2;
/org.eclipse.swt/Eclipse SWT/carbon/org/eclipse/swt/widgets/Tracker.java;4;2;6;2;6;5;6;0;30;0;0;4147;71;71;2;0;1;0;6;4701;1;4701;5;4;
/org.eclipse.ui/Eclipse UI/org/eclipse/ui/actions/CreateProjectAction.java;1;0;7;1;0;0;0;7;32;2;6;3186;53;53;2;1;0;7;7;3269;1;3573;6;1;
/org.eclipse.jdt.ui.tests.refactoring/resources/SelectionAnalyzerWorkSpace/SelectionAnalyzerTests/validSelection/A_test307.java;1;0;1;1;0;0;0;1;0;0;1;1368;0;0;1;0;0;1;1;1368;0;1368;1;1;
/org.eclipse.scripting/src/org/eclipse/scripting/internal/IXGRElementEventGeneratorOnFocus.java;1;0;1;1;0;0;0;1;0;0;1;1424;0;0;1;0;0;1;1;1424;0;1424;1;1;
/org.eclipse.swt/Eclipse SWT PI/motif/org/eclipse/swt/internal/motif/GNOME.java;2;0;2;1;1;1;1;1;6;0;1;2069;6;6;1;0;0;1;2;2069;0;4701;2;2;
/org.eclipse.team.cvs.core/src/org/eclipse/team/internal/ccvs/core/commands/FileNameMatcher.java;3;0;4;1;0;0;0;4;183;1;4;1978;215;215;1;0;0;4;4;1978;0;2607;4;3;
/org.eclipse.pde.ui/src/org/eclipse/pde/internal/forms/Form.java;2;0;2;1;0;0;0;2;0;1;2;1434;0;0;1;0;0;2;2;1434;0;2470;2;2;
/org.eclipse.update.ui/src/org/eclipse/update/internal/ui/forms/PropertyWebForm.java;1;0;2;1;1;1;1;1;70;0;1;3662;70;70;1;0;0;1;2;3662;0;4361;2;1;
/org.eclipse.pde.core/src/org/eclipse/pde/internal/core/ifeature/IFeatureModel.java;1;0;1;1;0;0;0;1;0;0;1;3591;0;0;1;0;0;1;1;3591;0;3591;1;1;
/org.eclipse.update.core/src/org/eclipse/update/core/IArchiveReference.java;2;0;5;1;0;0;0;5;36;2;3;2981;44;44;2;2;0;5;5;3512;2;3571;3;2;
/org.eclipse.jdt.junit/Eclipse JUnit/org/eclipse/jdt/junit/internal/JUnitPlugin.java;2;0;2;1;0;0;0;2;0;1;2;1531;0;0;1;0;0;2;2;1531;0;2007;2;2;
/org.eclipse.jdt.core/compiler/org/eclipse/jdt/internal/compiler/parser/RecoveredUnit.java;2;0;14;1;1;1;1;13;321;4;10;455;453;453;4;3;0;13;14;1039;3;4062;11;2;
/org.eclipse.update.ui/src/org/eclipse/update/internal/ui/parts/UpdateWebForm.java;1;0;7;1;0;0;0;7;14;1;7;1542;44;44;1;0;0;7;7;1542;0;3662;7;1;
/org.eclipse.jdt.ui.tests.refactoring/resources/ExtractMethodWorkSpace/ExtractMethodTests/invalidSelection/A_test106.java;2;1;3;1;2;2;2;1;0;0;1;49;0;0;1;0;0;1;3;49;0;4419;3;2;
/org.eclipse.jdt.core/search/org/eclipse/jdt/core/search/SearchEngine.java;3;2;33;2;5;3;5;28;1062;4;24;455;1640;1640;4;4;2;28;33;1039;6;4450;27;3;
/org.eclipse.compare/compare/org/eclipse/compare/internal/ColorEditor.java;1;0;1;1;0;0;0;1;0;0;1;3572;0;0;1;0;0;1;1;3572;0;3572;1;1;
/org.eclipse.update.ui/src/org/eclipse/update/internal/ui/model/ConfiguredFeatureAdapter.java;2;1;5;1;3;3;3;2;47;1;2;2834;71;71;1;0;0;2;5;2834;0;4438;5;2;
/org.eclipse.jdt.core/compiler/org/eclipse/jdt/internal/compiler/lookup/BaseTypes.java;2;0;11;1;1;1;1;10;120;4;6;455;257;257;4;4;0;10;11;1039;4;4062;7;2;
/org.eclipse.swt/Eclipse SWT Accessibility/win32/org/eclipse/swt/accessibility/Accessible.java;2;2;21;1;10;9;10;11;701;2;7;2781;2030;2030;2;4;1;11;21;3007;5;4701;16;2;
/org.eclipse.jdt.ui.tests.refactoring/resources/SelectionAnalyzerWorkSpace/SelectionAnalyzerTests/invalidSelection/A_test091.java;2;0;2;1;0;0;0;2;0;1;2;1368;0;0;1;0;0;2;2;1368;0;2139;2;2;
/org.eclipse.help/src/org/eclipse/help/internal/server/HelpURLFactory.java;3;0;6;2;0;0;0;6;20;2;5;1420;36;36;2;1;0;6;6;2319;1;3095;5;3;
/org.eclipse.core.boot/src/org/eclipse/core/internal/boot/update/VersionIdentifier.java;3;0;5;2;0;0;0;5;48;2;4;12;74;74;2;1;0;5;5;323;1;2726;4;3;
/org.eclipse.jdt.ui/ui/org/eclipse/jdt/internal/ui/wizards/NewElementWizard.java;3;0;10;1;0;0;0;10;103;2;9;15;175;175;2;1;0;10;10;144;1;3088;9;3;
/org.eclipse.swt/Eclipse SWT PI/gtk1x/org/eclipse/swt/internal/gtk/GtkObject.java;2;0;2;1;1;1;1;1;3;0;1;2107;3;3;1;0;0;1;2;2107;0;4701;2;2;
/org.eclipse.core.tests.runtime/src/org/eclipse/core/tests/internal/plugins/PluginResolveTest_13.java;3;0;3;1;0;0;0;3;114;1;3;1794;124;124;1;0;0;3;3;1794;0;3476;3;3;
/org.eclipse.swt.examples/org/eclipse/swt/examples/controlexample/SliderTab.java;6;1;7;1;3;3;3;4;401;1;4;513;692;692;1;0;0;4;7;513;0;4024;7;6;
/org.eclipse.jdt.ui.tests.refactoring/resources/MoveMembers/testFail17/in/B.java;1;0;1;1;0;0;0;1;0;0;1;2738;0;0;1;0;0;1;1;2738;0;2738;1;1;
/org.eclipse.swt/Eclipse SWT/emulated/coolbar/org/eclipse/swt/widgets/CoolItem.java;3;2;24;2;14;11;14;10;288;3;8;1947;1140;1140;3;2;3;10;24;1989;5;4701;19;3;
/org.eclipse.jdt.ui/ui refactoring/org/eclipse/jdt/internal/ui/nls/search/PrettySignature.java;1;0;2;1;0;0;0;2;0;1;2;1913;0;0;1;0;0;2;2;1913;0;1922;2;1;
/org.eclipse.jdt.ui/ui/org/eclipse/jdt/internal/ui/actions/OpenActionUtil.java;1;2;6;1;4;3;4;2;55;1;2;3533;99;99;2;0;1;2;6;4078;1;4116;5;1;
/org.eclipse.jdt.ui.tests.refactoring/resources/ExtractMethodWorkSpace/ExtractMethodTests/return_out/A_test704.java;1;1;3;1;2;2;2;1;20;0;1;887;20;20;1;0;0;1;3;887;0;4419;3;1;
/org.eclipse.jdt.core/model/org/eclipse/jdt/internal/core/builder/impl/ArrayTypeHandleImplSWH.java;1;0;3;1;0;0;0;3;130;1;3;455;130;130;1;0;0;3;3;455;0;2808;3;1;
/org.eclipse.jdt.ui/core extension/org/eclipse/jdt/internal/corext/codegeneration/IImportsStructure.java;2;0;2;1;0;0;0;2;0;1;2;2016;0;0;1;0;0;2;2;2016;0;2137;2;2;
/org.eclipse.pde.ui/src/org/eclipse/pde/internal/ui/editor/schema/SchemaSourceOutlinePage.java;1;0;1;1;0;0;0;1;0;0;1;3579;0;0;1;0;0;1;1;3579;0;3579;1;1;
/org.eclipse.core.runtime/src/org/eclipse/core/runtime/Status.java;3;0;4;1;1;1;1;3;384;1;3;12;423;423;1;0;0;3;4;12;0;4214;4;3;
/org.eclipse.jdt.debug/eval/org/eclipse/jdt/internal/debug/eval/ast/engine/MultiplyOperator.java;1;0;2;1;0;0;0;2;0;1;2;3329;0;0;1;0;0;2;2;3329;0;3421;2;1;
/org.eclipse.jdt.ui.tests.refactoring/resources/RenameTemp/cannotRename/A_testFail18.java;1;0;2;1;0;0;0;2;2;1;2;1625;2;2;1;0;0;2;2;1625;0;1652;2;1;
/org.eclipse.team.cvs.ui/src/org/eclipse/team/internal/ccvs/ui/actions/AddToWorkspaceAction.java;3;1;24;2;5;5;5;19;194;3;15;1978;720;720;3;4;0;19;24;3123;4;4256;20;3;
/org.eclipse.pde.ui/src/org/eclipse/pde/internal/editor/TreeSection.java;1;0;4;1;0;0;0;4;4;1;4;3023;7;7;1;0;0;4;4;3023;0;3579;4;1;
/org.eclipse.jdt.ui.tests.refactoring/resources/SefWorkSpace/SefTests/object_out/TestNestedRead.java;1;0;1;1;0;0;0;1;0;0;1;2155;0;0;1;0;0;1;1;2155;0;2155;1;1;
/org.eclipse.ui/Eclipse JFace Text/org/eclipse/jface/text/source/JFaceTextMessages.java;1;1;2;1;2;2;2;0;38;0;0;4138;38;38;1;0;0;0;2;4138;0;4838;2;1;
/org.eclipse.compare/compare/org/eclipse/compare/structuremergeviewer/IStructureCreator.java;2;0;4;1;1;1;1;3;22;1;3;14;41;41;1;0;0;3;4;14;0;4820;4;2;
/org.eclipse.jdt.core/model/org/eclipse/jdt/internal/core/builder/impl/IndictmentSet.java;1;0;10;1;0;0;0;10;212;4;7;455;376;376;4;3;0;10;10;1039;3;2808;7;1;
/org.eclipse.jdt.debug/eval/org/eclipse/jdt/internal/debug/eval/ast/instructions/XorOperator.java;3;0;6;1;0;0;0;6;34;1;6;3421;46;46;1;0;0;6;6;3421;0;3677;6;3;
/org.eclipse.jdt.ui/ui/org/eclipse/jdt/internal/ui/dialogs/TwoPaneElementSelector.java;8;0;23;1;1;1;1;22;376;3;19;15;775;775;3;3;0;22;23;1256;3;4015;20;8;
/org.eclipse.jdt.ui.tests.refactoring/resources/RenameParameters/canRename/A_test11_in.java;1;0;1;1;0;0;0;1;0;0;1;233;0;0;1;0;0;1;1;233;0;233;1;1;
/org.eclipse.jdt.core/compiler/org/eclipse/jdt/internal/compiler/lookup/SyntheticArgumentBinding.java;2;0;4;1;1;1;1;3;36;1;3;455;62;62;1;0;0;3;4;455;0;4062;4;2;
/org.eclipse.search/search/org/eclipse/search/internal/core/text/TextSearchVisitor.java;3;2;16;1;9;8;9;7;87;1;7;15;187;187;2;0;1;7;16;4139;1;4619;15;3;
/org.eclipse.ui/Eclipse UI/org/eclipse/ui/internal/NewWizardDropDownAction.java;4;0;4;1;0;0;0;4;70;1;4;257;78;78;1;0;0;4;4;257;0;3840;4;4;
/org.eclipse.pde.core/src/org/eclipse/pde/internal/core/ifeature/IFeatureModelFactory.java;1;0;2;1;1;1;1;1;6;0;1;3591;6;6;1;0;0;1;2;3591;0;3982;2;1;
/org.eclipse.swt.tests/JUnit Tests/org/eclipse/swt/tests/junit/Test_org_eclipse_swt_widgets_TypedListener.java;2;0;2;1;1;1;1;1;6;0;1;1792;6;6;1;0;0;1;2;1792;0;4706;2;2;
/org.eclipse.jdt.core/model/org/eclipse/jdt/internal/core/LRUCacheEnumerator.java;2;0;3;1;1;1;1;2;46;1;2;455;60;60;1;0;0;2;3;455;0;4063;3;2;
/org.eclipse.jdt.ui.tests.refactoring/resources/ExtractMethodWorkSpace/ExtractMethodTests/T11337_1.java;1;1;3;1;2;2;2;1;0;0;1;3220;0;0;1;0;0;1;3;3220;0;4419;3;1;
/org.eclipse.jdt.ui/core extension/org/eclipse/jdt/internal/corext/codemanipulation/ImportsStructure.java;4;2;16;2;6;5;6;10;312;2;9;2137;582;582;2;1;1;10;16;2137;2;4426;14;4;
/org.eclipse.jdt.core/ant/org/eclipse/jdt/internal/core/ant/AntPrintWriter.java;1;0;9;1;0;0;0;9;8;4;6;676;13;13;4;3;0;9;9;1039;3;3526;6;1;
/org.eclipse.update.ui.forms/src/org/eclipse/update/ui/forms/internal/SelectableFormLabel.java;1;0;3;1;1;1;1;2;12;1;2;2470;16;16;1;0;0;2;3;2470;0;4365;3;1;
/org.eclipse.team.cvs.core/src/org/eclipse/team/internal/ccvs/core/commands/Tag.java;3;0;5;1;0;0;0;5;116;1;5;1978;143;143;1;0;0;5;5;1978;0;2607;5;3;
/org.eclipse.jdt.ui.tests.refactoring/resources/ExtractMethodWorkSpace/ExtractMethodTests/errors_in/A_test800.java;1;0;2;1;0;0;0;2;0;1;2;3124;0;0;1;0;0;2;2;3124;0;3736;2;1;
/org.eclipse.vcm.core.cvs/src/org/eclipse/vcm/internal/core/ccvs/requests/IHistoryListener.java;4;0;4;1;0;0;0;4;10;1;4;0;23;23;1;0;0;4;4;0;0;1002;4;4;
/org.eclipse.vcm.core/src/org/eclipse/vcm/internal/core/RepositoryLocation.java;3;0;3;1;0;0;0;3;7;1;3;0;13;13;1;0;0;3;3;0;0;297;3;3;
/org.eclipse.jdt.ui/ui/org/eclipse/jdt/internal/ui/reorg/ReorgSupportFactory.java;3;0;6;1;0;0;0;6;20;1;6;15;33;33;1;0;0;6;6;15;0;1258;6;3;
/org.eclipse.jdt.debug.ui/ui/org/eclipse/jdt/internal/debug/ui/JavaApplicationWizardPage.java;2;0;4;1;0;0;0;4;36;1;4;1915;39;39;1;0;0;4;4;1915;0;3634;4;2;
/org.eclipse.jdt.junit/Eclipse JUnit/org/eclipse/jdt/internal/junit/ui/FailureRunView.java;2;0;7;1;0;0;0;7;147;1;7;2007;170;170;1;0;0;7;7;2007;0;3313;7;2;
/org.eclipse.jdt.ui/core extension/org/eclipse/jdt/internal/corext/codemanipulation/GetterSetterUtil.java;2;0;2;1;0;0;0;2;2;1;2;2931;2;2;1;0;0;2;2;2931;0;3466;2;2;
/org.eclipse.jdt.ui/ui/org/eclipse/jdt/internal/ui/actions/JavaUIAction.java;5;0;9;1;0;0;0;9;14;2;8;15;44;44;2;1;0;9;9;675;1;2546;8;5;
/org.eclipse.jdt.ui.tests.refactoring/resources/PasteSourceReference/Copy of test0/in/B.java;1;0;2;1;0;0;0;2;0;1;2;2003;0;0;1;0;0;2;2;2003;0;2156;2;1;
/org.eclipse.jdt.ui/ui/org/eclipse/jdt/internal/ui/codemanipulation/IRequestQuery.java;1;0;3;1;0;0;0;3;2;1;3;1173;2;2;1;0;0;3;3;1173;0;2016;3;1;
/org.eclipse.jdt.ui.tests.refactoring/resources/SelectionAnalyzerWorkSpace/SelectionAnalyzerTests/validSelection/A_test141_.java;1;0;1;1;0;0;0;1;0;0;1;2139;0;0;1;0;0;1;1;2139;0;2139;1;1;
/org.eclipse.jdt.debug/jdi/org/eclipse/jdi/internal/spy/TcpipSpy.java;2;0;5;1;0;0;0;5;23;1;5;187;52;52;1;0;0;5;5;187;0;3678;5;2;
/org.eclipse.jdt.ui.tests.refactoring/resources/SelectionAnalyzerWorkSpace/SelectionAnalyzerTests/validSelection/A_test310.java;1;0;1;1;0;0;0;1;0;0;1;1368;0;0;1;0;0;1;1;1368;0;1368;1;1;
/org.eclipse.swt/Eclipse SWT/gtk/org/eclipse/swt/internal/Converter.java;2;1;4;1;3;3;3;1;58;0;1;2107;115;115;1;0;0;1;4;2107;0;4701;4;2;
/org.eclipse.jdt.ui/core refactoring/org/eclipse/jdt/internal/core/refactoring/code/flow/ThrowFlowInfo.java;1;0;2;1;0;0;0;2;0;1;2;1236;0;0;1;0;0;2;2;1236;0;1939;2;1;
/org.eclipse.ui/Eclipse JFace Text/org/eclipse/jface/text/AbstractLineTracker.java;4;0;6;1;0;0;0;6;322;1;6;257;340;340;1;0;0;6;6;257;0;3812;6;4;
/org.eclipse.update.ui/src/org/eclipse/update/internal/ui/model/SiteCategory.java;2;0;5;1;1;1;1;4;22;1;4;2797;33;33;1;0;0;4;5;2797;0;4071;5;2;
/org.eclipse.pde.ui/src/org/eclipse/pde/internal/forms/FormWidgetFactory.java;2;0;2;1;0;0;0;2;0;1;2;1434;0;0;1;0;0;2;2;1434;0;2470;2;2;
/org.eclipse.core.resources/src/org/eclipse/core/internal/resources/MarkerInfo.java;2;0;6;1;1;1;1;5;218;1;5;12;272;272;1;0;0;5;6;12;0;4213;6;2;
/org.eclipse.jdt.debug.ui/ui/org/eclipse/jdt/internal/debug/ui/JavaDebugImages.java;5;3;21;2;7;5;7;14;35;2;12;1915;176;176;3;2;2;14;21;4193;4;4526;17;5;
/org.eclipse.jdt.ui.tests.refactoring/resources/ExtractMethodWorkSpace/ExtractMethodTests/invalidSelection/A_test142.java;1;1;3;1;2;2;2;1;26;0;1;887;26;26;1;0;0;1;3;887;0;4419;3;1;
/org.eclipse.pde.ui/Eclipse PDE UI/org/eclipse/pde/internal/base/model/plugin/IPluginModel.java;2;0;5;2;0;0;0;5;12;3;3;267;12;12;3;2;0;5;5;324;2;1434;3;2;
/org.eclipse.jdt.ui/ui refactoring/org/eclipse/jdt/internal/ui/refactoring/MoveMembersWizard.java;1;0;3;1;0;0;0;3;4;1;3;2737;6;6;1;0;0;3;3;2737;0;3567;3;1;
/org.eclipse.team.tests.core/src/org/eclipse/team/tests/ftp/FTPTestSetup.java;1;1;2;1;2;2;2;0;36;0;0;4169;69;69;1;0;0;0;2;4169;0;4186;2;1;
/org.eclipse.swt.tests/JUnit Tests/org/eclipse/swt/tests/junit/Test_org_eclipse_swt_dnd_DragSourceEvent.java;2;0;2;1;1;1;1;1;6;0;1;1792;6;6;1;0;0;1;2;1792;0;4706;2;2;
/org.eclipse.jdt.ui.tests.refactoring/resources/ExtractMethodWorkSpace/ExtractMethodTests/validSelection/A_test251.java;2;1;4;1;2;2;2;2;2;1;2;49;2;2;1;0;0;2;4;49;0;4419;4;2;
/org.eclipse.ui/Eclipse UI/org/eclipse/ui/internal/misc/WorkbookPage.java;2;0;2;1;0;0;0;2;5;1;2;257;5;5;1;0;0;2;2;257;0;457;2;2;
/org.eclipse.ui/Eclipse UI/org/eclipse/ui/internal/dialogs/ActionSetDialogInput.java;5;0;6;1;0;0;0;6;30;1;6;257;83;83;1;0;0;6;6;257;0;3560;6;5;
/org.eclipse.jdt.ui.tests.refactoring/resources/SelectionAnalyzerWorkSpace/SelectionAnalyzerTests/validSelection/A_test311.java;1;0;1;1;0;0;0;1;0;0;1;1368;0;0;1;0;0;1;1;1368;0;1368;1;1;
/org.eclipse.core.runtime/src/org/eclipse/core/runtime/IProgressMonitor.java;3;0;4;1;1;1;1;3;230;1;3;12;251;251;1;0;0;3;4;12;0;4214;4;3;
/org.eclipse.jdt.ui/nls/org/eclipse/jdt/internal/ui/nls/Messages.java;1;0;2;1;0;0;0;2;0;1;2;1880;0;0;1;0;0;2;2;1880;0;1913;2;1;
/org.eclipse.jdt.ui/ui/org/eclipse/jdt/internal/ui/text/JavaWhitespaceDetector.java;1;0;2;1;0;0;0;2;5;1;2;15;5;5;1;0;0;2;2;15;0;326;2;1;
/org.eclipse.jdt.debug.tests/test programs/IBreakpoints.java;1;0;2;1;0;0;0;2;0;1;2;3701;0;0;1;0;0;2;2;3701;0;3719;2;1;
/org.eclipse.jdt.debug/model/org/eclipse/jdt/internal/debug/core/JDTDebugUtils.java;1;0;2;1;0;0;0;2;0;1;2;1806;0;0;1;0;0;2;2;1806;0;1962;2;1;
/org.eclipse.pde.ui/src/org/eclipse/pde/internal/ui/elements/DefaultContentProvider.java;1;0;1;1;0;0;0;1;0;0;1;3579;0;0;1;0;0;1;1;3579;0;3579;1;1;
/org.eclipse.vcm.ui/src/org/eclipse/vcm/internal/ui/actions/OpenRepositoriesViewAction.java;1;0;1;1;0;0;0;1;0;0;1;419;0;0;1;0;0;1;1;419;0;419;1;1;
/org.eclipse.jdt.debug.tests/tests/org/eclipse/jdt/debug/tests/eval/NestedTypeFieldValue_144.java;2;1;3;1;3;3;3;0;12;0;0;4447;14;14;1;0;0;0;3;4447;0;4571;3;2;
/org.eclipse.jdt.debug/model/org/eclipse/jdt/internal/debug/core/JDIArrayType.java;2;0;3;1;0;0;0;3;29;1;3;1758;29;29;1;0;0;3;3;1758;0;2517;3;2;
/org.eclipse.jdt.ui/core refactoring/org/eclipse/jdt/internal/corext/refactoring/util/MethodBlock.java;1;0;2;1;0;0;0;2;0;1;2;3845;0;0;1;0;0;2;2;3845;0;3872;2;1;
/org.eclipse.jdt.core/eval/org/eclipse/jdt/internal/eval/CodeSnippetReturnStatement.java;2;0;17;1;1;1;1;16;203;4;12;455;371;371;4;4;0;16;17;1039;4;4062;13;2;
/org.eclipse.jdt.ui.tests.refactoring/resources/ExtractMethodWorkSpace/ExtractMethodTests/locals_in/A_test556.java;1;1;3;1;2;2;2;1;28;0;1;1236;28;28;1;0;0;1;3;1236;0;4419;3;1;
/org.eclipse.jdt.ui/ui/org/eclipse/jdt/internal/ui/actions/ShowInPackageViewAction.java;5;0;20;2;1;1;1;19;212;2;16;15;489;489;2;3;0;19;20;436;3;3967;17;5;
/org.eclipse.ant.ui/src/org/eclipse/ant/internal/ui/AntPreferencesPage.java;3;0;5;1;0;0;0;5;14;1;5;677;24;24;1;0;0;5;5;677;0;3606;5;3;
/org.eclipse.team.tests.cvs.core/src/org/eclipse/team/tests/ccvs/ui/benchmark/CommandTests.java;2;0;3;1;0;0;0;3;221;1;3;3452;223;223;1;0;0;3;3;3452;0;3873;3;2;
/org.eclipse.swt.tests/JUnit Tests/org/eclipse/swt/tests/junit/Test_org_eclipse_swt_graphics_Cursor.java;2;0;2;1;1;1;1;1;6;0;1;1792;6;6;1;0;0;1;2;1792;0;4706;2;2;
/org.eclipse.jdt.ui/ui/org/eclipse/jdt/internal/ui/text/ContentAssistPreference.java;4;0;5;1;1;1;1;4;26;1;4;1926;46;46;1;0;0;4;5;1926;0;4185;5;4;
/org.eclipse.jdt.ui/ui/org/eclipse/jdt/internal/ui/viewsupport/JavaElementSorter.java;1;0;10;1;0;0;0;10;78;2;9;1559;218;218;2;1;0;10;10;2588;1;3120;9;1;
/org.eclipse.swt.examples/org/eclipse/swt/examples/helloworld/HelloWorld1.java;4;0;5;1;1;1;1;4;26;1;4;513;64;64;1;0;0;4;5;513;0;4024;5;4;
/org.eclipse.ui.examples.javaeditor/Java Editor Example/org/eclipse/ui/examples/javaeditor/JavaEditorMessages.java;1;0;2;1;0;0;0;2;0;0;1;1066;0;0;2;1;0;2;2;1066;1;1066;1;1;
/org.eclipse.jdt.ui.tests.refactoring/resources/PullUpMethods/testFail10/in/A.java;1;0;2;1;0;0;0;2;0;1;2;2156;0;0;1;0;0;2;2;2156;0;2406;2;1;
/org.eclipse.jdt.ui/ui/org/eclipse/jdt/internal/ui/dialogs/MultiTypeSelectionDialog.java;6;1;19;2;4;4;4;15;46;3;11;15;155;155;3;4;0;15;19;1313;4;4630;15;6;
/org.eclipse.update.core/src/org/eclipse/update/internal/core/InternalSiteManager.java;3;1;57;1;8;8;8;49;340;3;44;1428;2648;2648;3;5;0;49;57;1638;5;4214;52;3;
/org.eclipse.swt.examples/src/org/eclipse/swt/examples/fileviewer/FileViewer.java;5;0;13;2;1;1;1;12;1593;2;9;554;2638;2638;2;3;0;12;13;609;3;4705;10;5;
/org.eclipse.jdt.ui.tests.refactoring/test cases/org/eclipse/jdt/ui/tests/nls/NLSElementTester.java;1;0;1;1;0;0;0;1;0;0;1;2015;0;0;1;0;0;1;1;2015;0;2015;1;1;
/org.eclipse.team.tests.cvs.core/src/org/eclipse/team/tests/ccvs/core/cvsresources/LocalFileTest.java;2;0;6;1;0;0;0;6;72;1;6;2536;87;87;1;0;0;6;6;2536;0;3089;6;2;
/org.eclipse.jdt.ui.tests.refactoring/resources/PasteSourceReference/test2/out/B.java;1;0;2;1;0;0;0;2;1;0;1;2859;1;1;2;1;0;2;2;2859;1;2859;1;1;
/org.eclipse.swt.examples/org/eclipse/swt/examples/layoutexample/RowLayoutTab.java;2;1;5;1;2;2;2;3;141;1;3;3420;149;149;1;0;0;3;5;3420;0;4024;5;2;
/org.eclipse.help/src/org/eclipse/help/internal/server/HelpServer.java;1;0;2;1;0;0;0;2;0;1;2;1420;0;0;1;0;0;2;2;1420;0;3095;2;1;
/org.eclipse.jdt.ui/ui/org/eclipse/jdt/internal/ui/wizards/NewSourceFolderCreationWizard.java;2;1;5;1;2;2;2;3;14;2;2;1342;18;18;2;1;0;3;5;3088;1;4621;4;2;
/org.eclipse.jdt.ui.tests.refactoring/resources/DeleteSourceReference/test7/in/A.java;1;0;1;1;0;0;0;1;0;0;1;2857;0;0;1;0;0;1;1;2857;0;2857;1;1;
/org.eclipse.jdt.ui/ui/org/eclipse/jdt/internal/ui/launcher/JavaApplicationLauncherDelegate.java;2;0;10;2;0;0;0;10;40;2;8;1313;103;103;2;2;0;10;10;1313;2;1916;8;2;
/org.eclipse.jdt.junit/src/org/eclipse/jdt/internal/junit/wizards/JUnitWizard.java;2;0;2;1;0;0;0;2;4;1;2;3527;4;4;1;0;0;2;2;3527;0;3659;2;2;
/org.eclipse.jdt.ui/ui/org/eclipse/jdt/internal/ui/dialogs/FilteredList.java;4;0;17;2;1;1;1;16;167;3;13;1298;690;690;3;3;0;16;17;1298;3;4018;14;4;
/org.eclipse.swt/Eclipse SWT Custom Widgets/common_j2se/org/eclipse/swt/custom/SashForm.java;1;0;1;1;0;0;0;1;0;0;1;1378;0;0;1;0;0;1;1;1378;0;1378;1;1;
/org.eclipse.ui/Eclipse UI/org/eclipse/ui/internal/dialogs/EditorsPreferencePage.java;2;1;3;1;3;3;3;0;2;0;0;4405;4;4;1;0;0;0;3;4405;0;4626;3;2;
/org.eclipse.help/src/org/eclipse/help/internal/util/ResourceLocator.java;1;0;2;1;0;0;0;2;65;1;2;1420;65;65;1;0;0;2;2;1420;0;3379;2;1;
/org.eclipse.ui/Eclipse UI/org/eclipse/ui/internal/GlobalBuildAction.java;5;0;7;1;0;0;0;7;31;1;7;257;63;63;1;0;0;7;7;257;0;3235;7;5;
/org.eclipse.swt/Eclipse SWT/carbon/org/eclipse/swt/widgets/MenuItem.java;5;1;6;1;6;6;6;0;42;0;0;4147;63;63;1;0;0;0;6;4147;0;4701;6;5;
/org.eclipse.jdt.ui/ui/org/eclipse/jdt/internal/ui/jarpackager/JarFileExportOperation.java;3;1;51;1;2;2;2;49;311;4;41;239;1158;1158;4;8;0;49;51;431;8;4019;43;3;
/org.eclipse.jdt.ui.tests.refactoring/resources/RenameParameters/canRename/A_test25_in.java;1;0;1;1;0;0;0;1;0;0;1;233;0;0;1;0;0;1;1;233;0;233;1;1;
/org.eclipse.jdt.ui.tests.refactoring/resources/MoveMembers/test19/in/A.java;1;0;1;1;0;0;0;1;0;0;1;2738;0;0;1;0;0;1;1;2738;0;2738;1;1;
/org.eclipse.jdt.ui.tests.refactoring/resources/SafeDeleteType/testFail2/in/A.java;1;0;1;1;0;0;0;1;0;0;1;49;0;0;1;0;0;1;1;49;0;49;1;1;
/org.eclipse.swt.examples/src/org/eclipse/swt/examples/fileviewer/TreeExpandDropListener.java;2;0;3;2;0;0;0;3;84;2;2;554;84;84;2;1;0;3;3;609;1;609;2;2;
/org.eclipse.ui/Eclipse UI/org/eclipse/ui/IReusableEditor.java;1;0;2;1;0;0;0;2;22;1;2;855;22;22;1;0;0;2;2;855;0;1388;2;1;
/org.eclipse.pde.ui/src/org/eclipse/pde/internal/editor/component/URLSection.java;2;0;4;1;0;0;0;4;4;1;4;1434;6;6;1;0;0;4;4;1434;0;2951;4;2;
/org.eclipse.update.core/src/org/eclipse/update/internal/core/UpdateManagerReconciler.java;2;2;8;1;5;3;5;3;151;1;3;3454;229;229;2;0;2;3;8;4018;2;4104;6;2;
/org.eclipse.vcm.core/src/org/eclipse/vcm/internal/core/adapter/IServerEventListener.java;1;0;1;1;0;0;0;1;0;0;1;951;0;0;1;0;0;1;1;951;0;951;1;1;
/org.eclipse.jdt.debug/jdi/org/eclipse/jdi/internal/ObjectReferenceImpl.java;3;0;7;1;0;0;0;7;41;1;7;187;138;138;1;0;0;7;7;187;0;3838;7;3;
/org.eclipse.scripting/Eclipse Scripting/org/eclipse/scripting/internal/IXGRParentComposite.java;1;0;3;1;0;0;0;3;4;1;3;133;4;4;1;0;0;3;3;133;0;1424;3;1;
/org.eclipse.pde.ui/src/org/eclipse/pde/internal/ui/editor/manifest/ExtensionPointForm.java;1;0;1;1;0;0;0;1;0;0;1;3579;0;0;1;0;0;1;1;3579;0;3579;1;1;
/org.eclipse.jdt.ui.tests.refactoring/resources/ExtractMethodWorkSpace/ExtractMethodTests/locals_out/A_test507.java;2;1;5;1;2;2;2;3;30;1;3;80;54;54;1;0;0;3;5;80;0;4419;5;2;
/org.eclipse.jdt.ui.tests/JUnit/junit/framework/TestListener.java;2;0;2;1;0;0;0;2;0;1;2;49;0;0;1;0;0;2;2;49;0;1186;2;2;
/org.eclipse.jdt.core/model/org/eclipse/jdt/core/util/ISourceAttribute.java;2;2;6;1;5;4;5;1;21;0;1;3629;41;41;2;0;1;1;6;4058;1;4573;5;2;
/org.eclipse.jdt.core/model/org/eclipse/jdt/internal/core/builder/MissingClassFileException.java;2;1;2;1;2;2;2;0;15;0;0;4007;15;15;1;0;0;0;2;4007;0;4063;2;2;
/org.eclipse.jdt.ui.tests.refactoring/resources/PullUpMethods/test14/out/A.java;1;0;3;1;0;0;0;3;2;1;3;2286;2;2;1;0;0;3;3;2286;0;2406;3;1;
/org.eclipse.vcm.ui/src/org/eclipse/vcm/internal/ui/sync/SyncAction.java;4;0;14;2;0;0;0;14;39;2;9;48;143;143;2;5;0;14;14;62;5;1211;9;4;
/org.eclipse.search/search/org/eclipse/search/ui/ISearchPage.java;2;0;3;1;0;0;0;3;9;1;3;15;11;11;1;0;0;3;3;15;0;1434;3;2;
/org.eclipse.jdt.junit/src/org/eclipse/jdt/internal/junit/util/TestSearchEngine.java;3;0;5;1;0;0;0;5;13;1;5;3171;27;27;1;0;0;5;5;3171;0;3659;5;3;
/org.eclipse.jdt.ui.tests/refactoring/org/eclipse/jdt/refactoring/tests/SelectionAnalyzerTestSetup.java;1;0;2;1;0;0;0;2;0;1;2;1368;0;0;1;0;0;2;2;1368;0;1896;2;1;
/org.eclipse.jdt.ui.tests.refactoring/resources/SelectionAnalyzerWorkSpace/SelectionAnalyzerTests/validSelection/A_test244.java;1;0;1;1;0;0;0;1;0;0;1;1368;0;0;1;0;0;1;1;1368;0;1368;1;1;
/org.eclipse.jdt.ui.tests.refactoring/resources/MoveCU/test1/out/p1/A.java;2;0;3;1;0;0;0;3;1;1;3;49;1;1;1;0;0;3;3;49;0;2769;3;2;
/org.eclipse.jdt.ui.tests.refactoring/resources/RenameVirtualMethodInClass/test11/in/A.java;1;0;1;1;0;0;0;1;0;0;1;49;0;0;1;0;0;1;1;49;0;49;1;1;
/org.eclipse.jdt.ui/core refactoring/org/eclipse/jdt/internal/corext/refactoring/changes/RenameResourceChange.java;1;0;1;1;0;0;0;1;0;0;1;1939;0;0;1;0;0;1;1;1939;0;1939;1;1;
/org.eclipse.scripting/src/org/eclipse/scripting/StringDataSingle.java;1;0;1;1;0;0;0;1;0;0;1;1424;0;0;1;0;0;1;1;1424;0;1424;1;1;
/org.eclipse.team.core/src/org/eclipse/team/internal/core/streams/CRLFtoLFInputStream.java;1;0;1;1;1;1;1;0;0;0;0;4169;0;0;1;0;0;0;1;4169;0;4169;1;1;
/org.eclipse.compare/compare/org/eclipse/compare/internal/ReplaceWithPreviousEditionAction.java;1;0;1;1;0;0;0;1;0;0;1;2415;0;0;1;0;0;1;1;2415;0;2415;1;1;
/org.eclipse.jdt.ui.tests.refactoring/resources/SafeDeleteType/testFail8/in/A.java;1;0;1;1;0;0;0;1;0;0;1;49;0;0;1;0;0;1;1;49;0;49;1;1;
/org.eclipse.jdt.ui/ui debug/org/eclipse/jdt/internal/debug/ui/display/DisplayView.java;5;0;22;1;0;0;0;22;122;3;17;345;194;194;3;5;0;22;22;1814;5;1916;17;5;
/org.eclipse.update.core/src/org/eclipse/update/configuration/ILocalSiteChangedListener.java;2;0;3;1;1;1;1;2;21;1;2;3018;42;42;1;0;0;2;3;3018;0;4687;3;2;
/org.eclipse.jdt.ui/ui/org/eclipse/jdt/internal/ui/util/JavaModelUtil.java;2;0;10;1;0;0;0;10;340;1;10;1228;525;525;1;0;0;10;10;1228;0;2016;10;2;
/org.eclipse.jdt.core/model/org/eclipse/jdt/internal/core/HandleFactory.java;3;1;12;1;2;2;2;10;130;1;10;455;283;283;1;0;0;10;12;455;0;4381;12;3;
/org.eclipse.jdt.ui/ui/org/eclipse/jdt/internal/ui/text/correction/JavaCorrectionProcessor.java;4;2;31;2;8;7;8;23;74;3;16;3306;476;476;3;7;1;23;31;3306;8;4621;23;4;
/org.eclipse.jdt.core/compiler/org/eclipse/jdt/internal/compiler/ast/MemberTypeDeclaration.java;2;0;4;1;1;1;1;3;77;1;3;455;96;96;1;0;0;3;4;455;0;4062;4;2;
/org.eclipse.jdt.ui/ui/org/eclipse/jdt/internal/ui/search/FindDeclarationsInHierarchyAction.java;1;2;7;1;4;3;4;3;31;1;3;1707;64;64;2;0;1;3;7;4140;1;4140;6;1;
/org.eclipse.core.runtime/src/org/eclipse/core/internal/plugins/RegistryLoader.java;4;2;22;2;3;2;3;19;464;3;16;12;817;817;3;3;1;19;22;2702;4;4212;18;4;
/org.eclipse.vcm.core/src/org/eclipse/vcm/internal/core/FileVersionStorage.java;4;0;4;2;0;0;0;4;14;2;3;0;18;18;2;1;0;4;4;292;1;292;3;4;
/org.eclipse.jdt.ui.tests.refactoring/resources/ExtractMethodWorkSpace/ExtractMethodTests/locals_out/A_test569.java;1;1;2;1;2;2;2;0;0;0;0;4383;0;0;1;0;0;0;2;4383;0;4419;2;1;
/org.eclipse.vcm.core.cvs/src/org/eclipse/vcm/internal/core/ccvs/requests/HistoryMessageHandler.java;1;0;1;1;0;0;0;1;0;0;1;1721;0;0;1;0;0;1;1;1721;0;1721;1;1;
/org.eclipse.team.ui/src/org/eclipse/team/internal/ui/target/TargetSyncCompareInput.java;4;1;6;1;6;6;6;0;27;0;0;4215;67;67;1;0;0;0;6;4215;0;4636;6;4;
/org.eclipse.jdt.ui/ui/org/eclipse/jdt/internal/ui/viewsupport/ImageImageDescriptor.java;1;0;1;1;1;1;1;0;0;0;0;4018;0;0;1;0;0;0;1;4018;0;4018;1;1;
/org.eclipse.core.tests.runtime/src/org/eclipse/core/tests/runtime/OperationCanceledExceptionTest.java;3;0;3;1;0;0;0;3;60;1;3;1794;70;70;1;0;0;3;3;1794;0;3476;3;3;
/org.eclipse.jdt.ui/core extension/org/eclipse/jdt/internal/corext/template/java/CompilationUnitContextType.java;2;0;4;1;1;1;1;3;16;1;3;2932;36;36;1;0;0;3;4;2932;0;4186;4;2;
/org.eclipse.update/src/org/eclipse/update/internal/core/UpdateManager.java;1;0;1;1;0;0;0;1;0;0;1;1424;0;0;1;0;0;1;1;1424;0;1424;1;1;
/org.eclipse.jdt.ui/ui/org/eclipse/jdt/internal/ui/launcher/JavaApplicationLauncher.java;5;0;17;2;0;0;0;17;123;2;13;15;368;368;2;4;0;17;17;218;4;1310;13;5;
/org.eclipse.jdt.core/compiler/org/eclipse/jdt/internal/compiler/env/IGenericType.java;2;0;4;1;1;1;1;3;28;1;3;455;48;48;1;0;0;3;4;455;0;4062;4;2;
/org.eclipse.pde.ui/src/org/eclipse/pde/internal/editor/feature/InfoSection.java;1;0;8;1;0;0;0;8;524;3;5;2951;564;564;3;3;0;8;8;2951;3;3579;5;1;
/org.eclipse.ui/Eclipse UI/org/eclipse/ui/part/IPageBookViewPage.java;1;0;3;1;0;0;0;3;54;2;2;1816;61;61;2;1;0;3;3;1816;1;1863;2;1;
/org.eclipse.jdt.ui.tests.refactoring/resources/RenamePackage/test3/in/fred/A.java;2;0;2;1;0;0;0;2;4;1;2;91;4;4;1;0;0;2;2;91;0;1258;2;2;
/org.eclipse.pde.ui/src/org/eclipse/pde/internal/editor/manifest/ManifestPropertySheet.java;2;0;3;1;0;0;0;3;1;1;3;1434;1;1;1;0;0;3;3;1434;0;3579;3;2;
/org.eclipse.team.ui/src/org/eclipse/team/internal/ui/actions/UndoCheckOutAction.java;2;1;2;1;2;2;2;0;0;0;0;4020;0;0;1;0;0;0;2;4020;0;4155;2;2;
/org.eclipse.jdt.ui.tests.refactoring/resources/ExtractMethodWorkSpace/ExtractMethodTests/locals_in/A_test565.java;1;1;3;1;2;2;2;1;0;0;1;3220;0;0;1;0;0;1;3;3220;0;4419;3;1;
/org.eclipse.jdt.ui.tests.refactoring/resources/MoveMembers/test17/in/A.java;1;0;1;1;0;0;0;1;0;0;1;2738;0;0;1;0;0;1;1;2738;0;2738;1;1;
/org.eclipse.swt/Eclipse SWT PI/win32/org/eclipse/swt/internal/win32/TVITEM.java;2;0;2;1;1;1;1;1;6;0;1;2069;6;6;1;0;0;1;2;2069;0;4701;2;2;
/org.eclipse.update.core/src/org/eclipse/update/internal/core/ConfigurationPolicy.java;2;2;60;2;9;8;9;51;251;5;33;2032;2241;2241;5;18;1;51;60;2180;19;4688;41;2;
/org.eclipse.jdt.debug.tests/test programs/ThrowsNPE.java;1;0;2;1;0;0;0;2;0;1;2;3701;0;0;1;0;0;2;2;3701;0;3719;2;1;
/org.eclipse.jdt.launching/launching/org/eclipse/jdt/launching/sourcelookup/LocalFileStorage.java;2;0;4;1;1;1;1;3;6;1;3;2372;9;9;1;0;0;3;4;2372;0;4198;4;2;
/org.eclipse.jdt.ui.tests.refactoring/resources/ReorderParameters/canReorder/A_test4_in.java;1;0;3;1;0;0;0;3;0;1;3;724;0;0;1;0;0;3;3;724;0;2270;3;1;
/org.eclipse.jdt.ui/core refactoring/org/eclipse/jdt/internal/core/refactoring/methods/RenamePrivateMethodRefactoring.java;2;0;7;1;0;0;0;7;96;1;7;408;173;173;1;0;0;7;7;408;0;1342;7;2;
/org.eclipse.jdt.ui/core refactoring/org/eclipse/jdt/internal/corext/refactoring/base/UndoManagerAdapter.java;1;0;2;1;1;1;1;1;16;0;1;1939;16;16;1;0;0;1;2;1939;0;4094;2;1;
/org.eclipse.jdt.ui.tests.refactoring/resources/ExtractMethodWorkSpace/ExtractMethodTests/invalidSelection/A_test122.java;2;1;4;1;2;2;2;2;14;1;2;65;16;16;1;0;0;2;4;65;0;4419;4;2;
/org.eclipse.jdt.ui.tests.refactoring/resources/RenameType/testFail8/in/B.java;1;0;1;1;0;0;0;1;0;0;1;49;0;0;1;0;0;1;1;49;0;49;1;1;
/org.eclipse.ui/Eclipse UI/org/eclipse/ui/internal/model/AdaptableList.java;3;0;3;1;0;0;0;3;12;1;3;257;17;17;1;0;0;3;3;257;0;2618;3;3;
/org.eclipse.debug.ui/ui/org/eclipse/debug/internal/ui/actions/ListenerActionDelegate.java;1;0;3;1;0;0;0;3;78;1;3;2740;78;78;1;0;0;3;3;2740;0;2919;3;1;
/org.eclipse.swt/Eclipse SWT/motif/org/eclipse/swt/widgets/ToolBar.java;8;1;18;1;4;4;4;14;292;2;13;106;784;784;2;1;0;14;18;1833;1;4701;17;8;
/org.eclipse.jdt.ui.tests.refactoring/resources/RenameVirtualMethodInClass/test30/in/A.java;1;0;1;1;0;0;0;1;0;0;1;49;0;0;1;0;0;1;1;49;0;49;1;1;
/org.eclipse.jdt.ui.tests/refactoring/org/eclipse/jdt/refactoring/tests/ReorgTests.java;2;0;5;1;0;0;0;5;8;2;4;1300;11;11;2;1;0;5;5;1300;1;1896;4;2;
/org.eclipse.update/Eclipse Update/org/eclipse/update/internal/ui/UMWizardPageURLInstall.java;2;0;4;1;0;0;0;4;658;1;4;108;666;666;1;0;0;4;4;108;0;1424;4;2;
/org.eclipse.team.cvs.ui/src/org/eclipse/team/internal/ccvs/ui/model/CVSModelElement.java;1;0;3;1;0;0;0;3;61;1;3;1978;67;67;1;0;0;3;3;1978;0;3644;3;1;
/org.eclipse.jdt.ui/core refactoring/org/eclipse/jdt/internal/corext/refactoring/base/IUndoManagerListener.java;1;0;2;1;1;1;1;1;17;0;1;1939;17;17;1;0;0;1;2;1939;0;4094;2;1;
/org.eclipse.jdt.ui/core refactoring/org/eclipse/jdt/internal/core/refactoring/AstNodeData.java;2;0;4;1;0;0;0;4;5;1;4;238;9;9;1;0;0;4;4;238;0;1939;4;2;
/org.eclipse.ui.tests/Eclipse JFace Tests/org/eclipse/jface/tests/viewers/interactive/ChangeLabelAction.java;1;0;1;1;0;0;0;1;0;0;1;1488;0;0;1;0;0;1;1;1488;0;1488;1;1;
/org.eclipse.jdt.ui/ui/org/eclipse/jdt/internal/ui/util/TypeRefRequestor.java;2;0;3;1;0;0;0;3;4;1;3;15;4;4;1;0;0;3;3;15;0;1258;3;2;
/org.eclipse.jdt.ui.tests/nls/org/eclipse/jdt/ui/nls/tests/NLSElementTester.java;1;0;4;1;0;0;0;4;2;1;4;1754;4;4;1;0;0;4;4;1754;0;1939;4;1;
/org.eclipse.team.cvs.ui/src/org/eclipse/team/internal/ccvs/ui/wizards/KSubstChangeSet.java;1;0;2;1;0;0;0;2;0;1;2;3251;0;0;1;0;0;2;2;3251;0;3313;2;1;
/org.eclipse.pde.ui/src/org/eclipse/pde/internal/base/model/plugin/IPluginBase.java;2;0;5;1;0;0;0;5;255;1;5;1434;267;267;1;0;0;5;5;1434;0;3039;5;2;
/org.eclipse.jdt.core/codeassist/org/eclipse/jdt/internal/codeassist/select/SelectionOnMessageSend.java;3;0;14;1;1;1;1;13;60;4;10;455;272;272;4;3;0;13;14;1039;3;4062;11;3;
/org.eclipse.team.cvs.core/src/org/eclipse/team/internal/ccvs/core/client/AddStructureVisitor.java;2;0;6;2;0;0;0;6;83;2;5;2572;147;147;2;1;0;6;6;3089;1;3610;5;2;
/org.eclipse.core.resources/src/org/eclipse/core/internal/localstore/SafeFileOutputStream.java;2;0;6;1;1;1;1;5;236;1;5;12;270;270;1;0;0;5;6;12;0;4214;6;2;
/org.eclipse.pde.ui/templates/editor/java/ColorManager.java;1;0;2;1;1;1;1;1;4;0;1;3812;4;4;1;0;0;1;2;3812;0;4316;2;1;
/org.eclipse.jdt.ui.tests.refactoring/resources/PullUpMethods/testFail12/in/B.java;1;0;2;1;0;0;0;2;0;1;2;2212;0;0;1;0;0;2;2;2212;0;2406;2;1;
/org.eclipse.jdt.ui/ui/org/eclipse/jdt/internal/ui/ResourceAdapterFactory.java;1;0;2;1;0;0;0;2;8;1;2;15;8;8;1;0;0;2;2;15;0;329;2;1;
/org.eclipse.pde.ui/src/org/eclipse/pde/internal/core/plugin/ExternalFragmentModel.java;1;0;2;1;0;0;0;2;0;1;2;3579;0;0;1;0;0;2;2;3579;0;3607;2;1;
/org.eclipse.scripting/src/org/eclipse/scripting/internal/IXGRElementUIListener.java;1;0;1;1;0;0;0;1;0;0;1;1424;0;0;1;0;0;1;1;1424;0;1424;1;1;
/org.eclipse.jdt.debug/jdi/org/eclipse/jdi/internal/BooleanValueImpl.java;2;0;4;1;0;0;0;4;19;1;4;187;37;37;1;0;0;4;4;187;0;3670;4;2;
/org.eclipse.core.runtime/src/org/eclipse/core/runtime/model/PluginPrerequisiteModel.java;4;0;8;1;1;1;1;7;378;2;6;12;478;478;2;1;0;7;8;1657;1;4214;7;4;
/org.eclipse.core.resources/src/org/eclipse/core/internal/localstore/UnifiedTree.java;3;0;10;1;1;1;1;9;678;2;8;12;905;905;2;1;0;9;10;3419;1;4214;9;3;
/org.eclipse.swt.examples/Eclipse SWT Examples/common/org/eclipse/swt/examples/explorer/UpdateWorker.java;1;0;1;1;0;0;0;1;0;0;1;480;0;0;1;0;0;1;1;480;0;480;1;1;
/org.eclipse.update.core/src/org/eclipse/update/core/Messages.java;1;0;2;1;0;0;0;2;0;1;2;2963;0;0;1;0;0;2;2;2963;0;2976;2;1;
/org.eclipse.jdt.ui.tests.refactoring/resources/RenameType/testFail23/in/Bogus.java;1;0;1;1;0;0;0;1;0;0;1;49;0;0;1;0;0;1;1;49;0;49;1;1;
/org.eclipse.swt/Eclipse SWT/carbon/org/eclipse/swt/widgets/Control.java;6;1;7;1;7;7;7;0;109;0;0;4147;186;186;1;0;0;0;7;4147;0;4701;7;6;
/org.eclipse.jdt.ui.tests.refactoring/resources/SurroundWithWorkSpace/SurroundWithTests/trycatch_out/TestThrowInCatch.java;1;0;2;1;0;0;0;2;2;1;2;2684;2;2;1;0;0;2;2;2684;0;3870;2;1;
/org.eclipse.vcm.core.cvs/src/org/eclipse/vcm/internal/core/ccvs/client/WorkingCopyFileUpdater.java;2;0;2;1;0;0;0;2;11;1;2;0;11;11;1;0;0;2;2;0;0;298;2;2;
/org.eclipse.jdt.ui/ui/org/eclipse/jdt/internal/ui/dialogs/MultiMainTypeSelectionDialog.java;8;1;14;1;2;2;2;12;83;3;10;15;225;225;3;2;0;12;14;1256;2;4630;12;8;
/org.eclipse.swt/Eclipse SWT PI/win32/org/eclipse/swt/internal/ole/win32/IEnumFORMATETC.java;2;0;2;1;1;1;1;1;6;0;1;2069;6;6;1;0;0;1;2;2069;0;4701;2;2;
/org.eclipse.vcm.ui.cvs/src/org/eclipse/vcm/internal/ui/ccvs/GenerateDiffFileWizard.java;1;0;3;1;0;0;0;3;195;2;2;1549;195;195;2;1;0;3;3;1556;1;1556;2;1;
/org.eclipse.core.tests.runtime/src/org/eclipse/core/tests/internal/plugins/PluginResolveTest_3.java;4;0;4;1;0;0;0;4;112;1;4;1794;127;127;1;0;0;4;4;1794;0;3476;4;4;
/org.eclipse.jdt.ui/ui/org/eclipse/jdt/internal/ui/javaeditor/BreakpointLocationVerifier.java;3;0;8;1;0;0;0;8;135;2;6;1916;254;254;2;2;0;8;8;2448;2;3568;6;3;
/org.eclipse.core.tests.resources/src/org/eclipse/core/tests/internal/indexing/IntegratedIndexedStoreTest.java;3;0;3;1;1;1;1;2;24;1;2;1794;34;34;1;0;0;2;3;1794;0;4516;3;3;
/org.eclipse.pde.ui/src/org/eclipse/pde/internal/ui/editor/feature/OpenReferenceAction.java;1;1;4;1;2;2;2;2;22;1;2;3579;34;34;1;0;0;2;4;3579;0;4067;4;1;
/org.eclipse.pde.ui/src/org/eclipse/pde/internal/core/plugin/PluginExtensionPoint.java;1;0;3;1;0;0;0;3;10;2;2;3579;10;10;2;1;0;3;3;3579;1;3607;2;1;
/org.eclipse.vcm.core.cvs/src/org/eclipse/vcm/internal/core/ccvs/requests/Commit.java;3;0;4;1;0;0;0;4;13;1;4;0;29;29;1;0;0;4;4;0;0;1098;4;3;
/org.eclipse.help/Eclipse Help/org/eclipse/help/internal/util/PersistentMap.java;3;0;7;2;0;0;0;7;64;2;6;135;90;90;2;1;0;7;7;830;1;966;6;3;
/org.eclipse.swt.examples.launcher/src/org/eclipse/swt/examples/launcher/URLHelper.java;1;0;1;1;0;0;0;1;0;0;1;480;0;0;1;0;0;1;1;480;0;480;1;1;
/org.eclipse.jdt.core/model/org/eclipse/jdt/internal/core/builder/impl/MethodImpl.java;1;0;10;1;0;0;0;10;61;4;6;455;97;97;4;4;0;10;10;1039;4;2808;6;1;
/org.eclipse.ui/Eclipse UI Standard Components/org/eclipse/ui/views/navigator/ResourceNavigatorRenameAction.java;4;0;9;1;0;0;0;9;84;1;9;257;278;278;1;0;0;9;9;257;0;3354;9;4;
/org.eclipse.update/src/org/eclipse/update/internal/ui/UMWizardURLNamePairComparator.java;1;0;1;1;0;0;0;1;0;0;1;1424;0;0;1;0;0;1;1;1424;0;1424;1;1;
/org.eclipse.debug.ui/ui/org/eclipse/debug/internal/ui/actions/ToggleFilterAction.java;1;0;3;1;1;1;1;2;14;1;2;2382;28;28;1;0;0;2;3;2382;0;4026;3;1;
/org.eclipse.core.tests.runtime/src/org/eclipse/core/tests/internal/plugins/SoftPrereqTest_4.java;3;0;3;1;0;0;0;3;88;1;3;1794;98;98;1;0;0;3;3;1794;0;3476;3;3;
/org.eclipse.jdt.ui.tests.refactoring/resources/ExtractMethodWorkSpace/ExtractMethodTests/invalidSelection/A_test082.java;2;1;3;1;2;2;2;1;0;0;1;49;0;0;1;0;0;1;3;49;0;4419;3;2;
/org.eclipse.pde.ui/src/org/eclipse/pde/internal/preferences/RuntimeOption.java;2;0;2;1;0;0;0;2;0;1;2;1434;0;0;1;0;0;2;2;1434;0;3579;2;2;
/org.eclipse.ui/Eclipse JFace Text/org/eclipse/jface/text/Line.java;3;0;3;1;0;0;0;3;35;1;3;257;40;40;1;0;0;3;3;257;0;1066;3;3;
/org.eclipse.jdt.ui.tests.refactoring/resources/MoveMembers/test17/in/B.java;1;0;1;1;0;0;0;1;0;0;1;2738;0;0;1;0;0;1;1;2738;0;2738;1;1;
/org.eclipse.pde.ui/src/org/eclipse/pde/internal/editor/SystemFileEditorInputFactory.java;1;0;2;1;0;0;0;2;0;1;2;3446;0;0;1;0;0;2;2;3446;0;3579;2;1;
/org.eclipse.jdt.ui.tests.refactoring/resources/RenameType/testFail76/in/A.java;1;0;1;1;0;0;0;1;0;0;1;49;0;0;1;0;0;1;1;49;0;49;1;1;
/org.eclipse.team.cvs.core/src/org/eclipse/team/internal/ccvs/core/resources/EclipseFolder.java;2;1;15;2;2;2;2;13;275;2;12;3004;487;487;2;1;0;13;15;3398;1;4111;14;2;
/org.eclipse.pde.ui/src/org/eclipse/pde/internal/model/feature/IdentifiableObject.java;1;0;2;1;0;0;0;2;0;1;2;3468;0;0;1;0;0;2;2;3468;0;3579;2;1;
/org.eclipse.jdt.ui/ui/org/eclipse/jdt/internal/ui/jarpackager/OpenJarPackageWizardActionDelegate.java;2;0;11;1;1;1;1;10;53;2;9;349;128;128;2;1;0;10;11;414;1;4568;10;2;
/org.eclipse.swt.examples.paint/src/org/eclipse/swt/examples/paint/MetaRectangle.java;1;0;1;1;0;0;0;1;0;0;1;512;0;0;1;0;0;1;1;512;0;512;1;1;
/org.eclipse.jdt.ui.tests.refactoring/resources/SelectionAnalyzerWorkSpace/SelectionAnalyzerTests/validSelection/A_test272.java;1;0;1;1;0;0;0;1;0;0;1;1368;0;0;1;0;0;1;1;1368;0;1368;1;1;
/org.eclipse.jdt.ui.tests.refactoring/resources/RenameParameters/canRename/A_test31_out.java;1;0;1;1;0;0;0;1;0;0;1;233;0;0;1;0;0;1;1;233;0;233;1;1;
/org.eclipse.jdt.ui.tests.refactoring/test cases/org/eclipse/jdt/ui/tests/refactoring/InlineTempTests.java;2;2;21;1;6;5;6;15;45;3;11;2015;196;196;3;4;1;15;21;2751;5;4620;16;2;
/org.eclipse.jdt.core/compiler/org/eclipse/jdt/internal/compiler/util/ObjectVector.java;2;0;16;1;1;1;1;15;161;4;10;455;365;365;4;5;0;15;16;1039;5;4062;11;2;
/org.eclipse.jdt.debug/eval/org/eclipse/jdt/internal/debug/eval/ast/engine/Interpreter.java;2;0;8;1;1;1;1;7;16;1;7;3329;67;67;1;0;0;7;8;3329;0;3915;8;2;
/org.eclipse.pde.ui/src/org/eclipse/pde/internal/ui/editor/manifest/JavaAttributeWizard.java;1;0;2;1;0;0;0;2;2;1;2;3579;2;2;1;0;0;2;2;3579;0;3591;2;1;
/org.eclipse.jdt.debug/jdi/org/eclipse/jdi/internal/event/WatchpointEventImpl.java;2;0;3;1;0;0;0;3;24;1;3;187;36;36;1;0;0;3;3;187;0;2155;3;2;
/org.eclipse.pde.ui/src/org/eclipse/pde/internal/editor/schema/TypeRestrictionCellEditor.java;2;0;3;1;0;0;0;3;3;1;3;1434;3;3;1;0;0;3;3;1434;0;3579;3;2;
/org.eclipse.core.tests.runtime/src/org/eclipse/core/tests/internal/runtimetests/SampleOFB.java;1;0;2;1;0;0;0;2;10;1;2;3611;10;10;1;0;0;2;2;3611;0;3678;2;1;
/org.eclipse.jdt.debug/eval/org/eclipse/jdt/internal/debug/eval/ast/engine/LeftShiftOperator.java;1;0;3;1;0;0;0;3;2;1;3;3329;2;2;1;0;0;3;3;3329;0;3421;3;1;
/org.eclipse.jdt.ui.tests.refactoring/resources/SefWorkSpace/SefTests/bb.java;1;0;1;1;0;0;0;1;0;0;1;2876;0;0;1;0;0;1;1;2876;0;2876;1;1;
/org.eclipse.team.cvs.core/src/org/eclipse/team/internal/ccvs/core/response/custom/LogListener.java;3;0;4;1;0;0;0;4;79;1;4;1978;157;157;1;0;0;4;4;1978;0;2607;4;3;
/org.eclipse.jdt.ui/core refactoring/org/eclipse/jdt/internal/core/refactoring/code/ExpressionAnalyzer.java;1;0;2;1;0;0;0;2;0;1;2;1236;0;0;1;0;0;2;2;1236;0;1939;2;1;
/org.eclipse.jdt.core/compiler/org/eclipse/jdt/internal/compiler/ast/TrueLiteral.java;2;0;4;1;1;1;1;3;108;1;3;455;134;134;1;0;0;3;4;455;0;4062;4;2;
/org.eclipse.help/Eclipse Help/org/eclipse/help/internal/contributions/xml/HelpInfoSet.java;2;0;3;1;0;0;0;3;7;1;3;135;7;7;1;0;0;3;3;135;0;1420;3;2;
/org.eclipse.swt/Eclipse SWT/motif/org/eclipse/swt/internal/motif/XImage.java;2;0;3;1;0;0;0;3;4;1;3;106;4;4;1;0;0;3;3;106;0;2069;3;2;
/org.eclipse.swt/Eclipse SWT/photon/org/eclipse/swt/widgets/Tree.java;2;0;5;1;0;0;0;5;637;1;5;106;1072;1072;1;0;0;5;5;106;0;1028;5;2;
/org.eclipse.ui/Eclipse UI Standard Components/org/eclipse/ui/views/navigator/RefactorActionContributionFactory.java;1;0;2;1;0;0;0;2;0;1;2;1726;0;0;1;0;0;2;2;1726;0;1757;2;1;
/org.eclipse.ant.ui/src/org/eclipse/ant/internal/ui/CustomizeAntLabelProvider.java;1;0;3;1;0;0;0;3;103;2;2;3489;107;107;2;1;0;3;3;3489;1;3506;2;1;
/org.eclipse.team.cvs.core/src/org/eclipse/team/internal/ccvs/core/util/ProjectDescriptionContentHandler.java;2;0;3;1;0;0;0;3;320;1;3;1978;350;350;1;0;0;3;3;1978;0;2791;3;2;
/org.eclipse.swt/Eclipse SWT/win32/org/eclipse/swt/internal/win32/LRESULT.java;2;0;3;1;0;0;0;3;5;1;3;106;5;5;1;0;0;3;3;106;0;2069;3;2;
/org.eclipse.jdt.ui.tests.refactoring/resources/RenameType/testWrongArg3/in/A.java;1;0;1;1;0;0;0;1;0;0;1;49;0;0;1;0;0;1;1;49;0;49;1;1;
/org.eclipse.debug.ui/ui/org/eclipse/debug/internal/ui/actions/EnableBreakpointsAction.java;2;0;7;2;1;1;1;6;50;2;5;2736;110;110;2;1;0;6;7;3833;1;4409;6;2;
/org.eclipse.ui/Eclipse UI/org/eclipse/ui/internal/PlatformUIPreferenceListener.java;1;0;3;1;3;1;3;0;53;0;0;4626;53;53;3;0;2;0;3;4626;2;4626;1;1;
/org.eclipse.jdt.core/model/org/eclipse/jdt/internal/core/jdom/DOMType.java;2;0;14;1;1;1;1;13;1138;4;10;455;1597;1597;4;3;0;13;14;1039;3;4063;11;2;
/org.eclipse.jdt.ui.tests.refactoring/resources/ReorderParameters/canReorder/A_test6_in.java;1;0;3;1;0;0;0;3;0;1;3;724;0;0;1;0;0;3;3;724;0;2270;3;1;
/org.eclipse.vcm.ui/src/org/eclipse/vcm/internal/ui/sync/CatchupReleaseViewer.java;7;0;29;2;0;0;0;29;213;3;22;48;948;948;3;7;0;29;29;312;7;1642;22;7;
/org.eclipse.jdt.ui.tests.refactoring/resources/RenamePrivateMethod/test0/in/A.java;1;0;1;1;0;0;0;1;0;0;1;49;0;0;1;0;0;1;1;49;0;49;1;1;
/org.eclipse.jdt.ui.tests.refactoring/resources/DeleteSourceReference/A_test1_out.java;1;0;2;1;0;0;0;2;0;1;2;2003;0;0;1;0;0;2;2;2003;0;2857;2;1;
/org.eclipse.team.tests.cvs.core/src/org/eclipse/team/tests/ccvs/core/cvsresources/BatchedTestSetup.java;1;0;1;1;0;0;0;1;0;0;1;3287;0;0;1;0;0;1;1;3287;0;3287;1;1;
/org.eclipse.ui/Eclipse UI/org/eclipse/ui/internal/WelcomePageSelectionDialog.java;1;1;4;1;4;4;4;0;9;0;0;4407;22;22;1;0;0;0;4;4407;0;4687;4;1;
/org.eclipse.jdt.ui/ui/org/eclipse/jdt/internal/ui/actions/ShowTypeHierarchyAction.java;5;0;12;2;1;1;1;11;107;2;10;15;316;316;2;1;0;11;12;740;1;3967;11;5;
/org.eclipse.jdt.ui/ui/org/eclipse/jdt/internal/ui/codemanipulation/ImportsStructure.java;3;0;23;1;0;0;0;23;371;2;21;15;1006;1006;2;2;0;23;23;568;2;2016;21;3;
/org.eclipse.jdt.ui.tests.refactoring/resources/RenameType/test44/out/B.java;1;0;1;1;0;0;0;1;0;0;1;522;0;0;1;0;0;1;1;522;0;522;1;1;
/org.eclipse.jdt.ui.tests.refactoring/resources/ExtractMethodWorkSpace/ExtractMethodTests/locals_out/A_test532.java;1;1;4;1;2;2;2;2;24;1;2;922;27;27;1;0;0;2;4;922;0;4419;4;1;
/org.eclipse.scripting/Eclipse Scripting/org/eclipse/scripting/internal/ScriptDescriptor.java;1;0;3;1;0;0;0;3;4;1;3;133;4;4;1;0;0;3;3;133;0;1424;3;1;
/org.eclipse.pde.ui/Eclipse PDE UI/org/eclipse/pde/internal/wizards/project/ProjectStructurePage.java;3;0;9;2;0;0;0;9;25;3;7;267;66;66;3;2;0;9;9;324;2;1434;7;3;
/org.eclipse.ui/Eclipse UI/org/eclipse/ui/internal/model/WorkbenchResource.java;4;1;5;1;2;2;2;3;95;1;3;257;137;137;1;0;0;3;5;257;0;4435;5;4;
/org.eclipse.core.tests.harness/src/org/eclipse/core/tests/harness/CorePerformanceTest.java;3;0;3;1;1;1;1;2;248;1;2;1794;265;265;1;0;0;2;3;1794;0;4516;3;3;
/org.eclipse.pde.ui/src/org/eclipse/pde/internal/wizards/extension/NewExtensionTemplateWizard.java;1;0;3;1;0;0;0;3;4;1;3;3278;4;4;1;0;0;3;3;3278;0;3579;3;1;
/org.eclipse.jdt.ui/ui/org/eclipse/jdt/internal/ui/typehierarchy/ShowInheriredMembersAction.java;1;0;4;1;0;0;0;4;3;2;3;15;5;5;2;1;0;4;4;236;1;236;3;1;
/org.eclipse.jdt.ui.tests.refactoring/resources/MoveMembers/testFail7/in/A.java;1;0;1;1;0;0;0;1;0;0;1;2738;0;0;1;0;0;1;1;2738;0;2738;1;1;
/org.eclipse.jdt.junit/src/org/eclipse/jdt/internal/junit/ui/FilterPatternsDialog.java;2;0;2;1;0;0;0;2;4;1;2;3171;4;4;1;0;0;2;2;3171;0;3659;2;2;
/org.eclipse.jdt.core/model/org/eclipse/jdt/internal/core/DeleteResourceElementsOperation.java;3;1;13;1;2;2;2;11;182;4;8;455;260;260;4;3;0;11;13;1039;3;4568;10;3;
/org.eclipse.jdt.junit/src/org/eclipse/jdt/junit/wizards/NewTestCaseCreationWizardPage2.java;2;0;8;1;0;0;0;8;40;2;6;3247;82;82;2;2;0;8;8;3371;2;3527;6;2;
/org.eclipse.core.tests.resources/src/org/eclipse/core/tests/internal/localstore/DeleteTest.java;3;0;6;1;1;1;1;5;824;2;4;1794;1220;1220;2;1;0;5;6;3415;1;4516;5;3;
/org.eclipse.ui/Eclipse UI Text Editor/org/eclipse/ui/texteditor/SelectMarkerRulerAction.java;2;1;10;1;5;5;5;5;251;1;5;1226;356;356;1;0;0;5;10;1226;0;4853;10;2;
/org.eclipse.ui.tests/Eclipse UI Tests/org/eclipse/ui/tests/internal/InternalTestSuite.java;1;0;2;1;0;0;0;2;2;1;2;1500;2;2;1;0;0;2;2;1500;0;2033;2;1;
/org.eclipse.swt/Eclipse SWT/gtk1x/org/eclipse/swt/graphics/FontMetrics.java;2;0;2;1;1;1;1;1;6;0;1;2107;6;6;1;0;0;1;2;2107;0;4701;2;2;
/org.eclipse.jdt.ui/ui/org/eclipse/jdt/internal/ui/reorg/IRefactoringRenameSupport.java;2;0;4;1;0;0;0;4;9;1;4;132;21;21;1;0;0;4;4;132;0;1406;4;2;
/org.eclipse.swt/Eclipse SWT/gtk1x/org/eclipse/swt/widgets/ToolItem.java;4;0;4;1;1;1;1;3;46;1;3;2107;59;59;1;0;0;3;4;2107;0;4701;4;4;
/org.eclipse.jdt.ui/core refactoring/org/eclipse/jdt/internal/core/refactoring/changes/Utils.java;2;0;2;1;0;0;0;2;0;1;2;1257;0;0;1;0;0;2;2;1257;0;1939;2;2;
/org.eclipse.jdt.ui.tests.refactoring/resources/RenameType/test18/out/B.java;1;0;1;1;0;0;0;1;0;0;1;522;0;0;1;0;0;1;1;522;0;522;1;1;
/org.eclipse.jdt.ui.tests.refactoring/resources/RenameType/testFail7/in/A.java;1;0;2;1;0;0;0;2;1;1;2;49;1;1;1;0;0;2;2;49;0;570;2;1;
/org.eclipse.jdt.ui.tests.refactoring/resources/ExtractTemp/canExtract/A_test2_in.java;1;0;1;1;0;0;0;1;0;0;1;2481;0;0;1;0;0;1;1;2481;0;2481;1;1;
/org.eclipse.jdt.debug/model/org/eclipse/jdt/internal/debug/core/model/JDIArrayPartitionValue.java;3;0;4;2;0;0;0;4;7;3;2;2517;13;13;3;2;0;4;4;2517;2;3360;2;3;
/org.eclipse.ui.externaltools/External Tools/org/eclipse/ui/externaltools/internal/ui/ant/AntBuildLogger.java;1;2;3;1;3;2;3;0;25;0;0;4090;25;25;2;0;1;0;3;4123;1;4123;2;1;
/org.eclipse.jdt.core/codeassist/org/eclipse/jdt/internal/codeassist/select/SelectionOnPackageReference.java;2;0;9;1;1;1;1;8;36;4;5;455;100;100;4;3;0;8;9;1039;3;4062;6;2;
/org.eclipse.jdt.ui.tests.refactoring/resources/ExtractMethodWorkSpace/ExtractMethodTests/locals_in/A_test534.java;1;1;3;1;2;2;2;1;22;0;1;922;22;22;1;0;0;1;3;922;0;4419;3;1;
/org.eclipse.jdt.core/compiler/org/eclipse/jdt/internal/compiler/ast/SingleNameReference.java;2;1;14;1;2;2;2;12;1249;2;10;455;1380;1380;2;2;0;12;14;2546;2;4062;12;2;
/org.eclipse.jdt.ui.tests.refactoring/resources/RenameTemp/canRename/A_test14_out.java;1;0;2;1;0;0;0;2;2;1;2;1625;2;2;1;0;0;2;2;1625;0;1652;2;1;
/org.eclipse.core.tests.runtime/src/org/eclipse/core/tests/runtime/AllTests.java;4;0;7;1;1;1;1;6;64;1;6;1794;90;90;1;0;0;6;7;1794;0;4772;7;4;
/org.eclipse.pde.ui/Eclipse PDE UI/org/eclipse/pde/internal/wizards/project/PluginSelectionDialog.java;2;0;5;2;0;0;0;5;12;3;3;267;12;12;3;2;0;5;5;324;2;1434;3;2;
/org.eclipse.jdt.ui/core refactoring/org/eclipse/jdt/internal/core/refactoring/text/ChangeVisibilityChange.java;1;0;4;1;0;0;0;4;5;1;4;1453;7;7;1;0;0;4;4;1453;0;1800;4;1;
/org.eclipse.update.ui/src/org/eclipse/update/internal/ui/manager/RemoveForm.java;1;0;2;1;0;0;0;2;0;0;1;1457;0;0;2;1;0;2;2;1457;1;1457;1;1;
/org.eclipse.jdt.ui.tests.refactoring/resources/PullUpMethods/test6/in/A.java;1;0;3;1;0;0;0;3;2;1;3;2156;2;2;1;0;0;3;3;2156;0;2406;3;1;
/org.eclipse.scripting/Eclipse Scripting/org/eclipse/scripting/internal/uirenderer/XGRElementUISwtTable.java;2;0;6;1;0;0;0;6;54;1;6;133;81;81;1;0;0;6;6;133;0;1424;6;2;
/org.eclipse.jdt.debug/eval/org/eclipse/jdt/internal/debug/eval/ast/instructions/RemainderOperator.java;3;0;7;1;0;0;0;7;45;1;7;3421;71;71;1;0;0;7;7;3421;0;3833;7;3;
/org.eclipse.jdt.core/model/org/eclipse/jdt/internal/core/jdom/DOMMember.java;2;0;10;1;1;1;1;9;602;4;6;455;645;645;4;3;0;9;10;1039;3;4063;7;2;
/org.eclipse.jdt.ui.tests.refactoring/resources/PullUp/test17/in/A.java;1;0;1;1;0;0;0;1;0;0;1;2406;0;0;1;0;0;1;1;2406;0;2406;1;1;
/org.eclipse.pde.ui/Eclipse PDE UI/org/eclipse/pde/internal/editor/manifest/JavaAttributeDescriptor.java;2;0;5;2;0;0;0;5;12;3;3;267;12;12;3;2;0;5;5;324;2;1434;3;2;
/org.eclipse.jdt.ui/ui/org/eclipse/jdt/ui/wizards/JavaCapabilityConfigurationPage.java;3;1;7;1;6;6;6;1;63;0;1;3870;161;161;1;0;0;1;7;3870;0;4823;7;3;
/org.eclipse.ui/Eclipse JFace/org/eclipse/jface/action/StatusLineManager.java;4;0;6;1;1;1;1;5;31;1;5;257;72;72;1;0;0;5;6;257;0;4606;6;4;
/org.eclipse.swt.tests/JUnit Tests/org/eclipse/swt/tests/junit/Test_org_eclipse_swt_events_ArmEvent.java;2;0;2;1;1;1;1;1;6;0;1;1792;6;6;1;0;0;1;2;1792;0;4706;2;2;
/org.eclipse.ant.core/src/plugin/org/eclipse/ant/internal/core/Task.java;1;0;1;1;0;0;0;1;0;0;1;3475;0;0;1;0;0;1;1;3475;0;3475;1;1;
/org.eclipse.pde.ui/src/org/eclipse/pde/IBasePluginWizard.java;1;0;2;1;0;0;0;2;0;1;2;3039;0;0;1;0;0;2;2;3039;0;3579;2;1;
/org.eclipse.jdt.ui.tests.refactoring/resources/RenameType/test25/out/A.java;1;0;2;1;0;0;0;2;0;1;2;49;0;0;1;0;0;2;2;49;0;522;2;1;
/org.eclipse.pde.ui/src/org/eclipse/pde/internal/core/schema/SchemaEnumeration.java;1;0;3;1;0;0;0;3;2;1;3;3579;2;2;1;0;0;3;3;3579;0;3607;3;1;
/org.eclipse.help/src/org/eclipse/help/internal/contributors/ActionContributor.java;2;0;2;1;0;0;0;2;0;1;2;1420;0;0;1;0;0;2;2;1420;0;1675;2;2;
/org.eclipse.help/Eclipse Help/org/eclipse/help/internal/util/PluginVersionInfo.java;3;0;5;1;0;0;0;5;59;1;5;135;70;70;1;0;0;5;5;135;0;1420;5;3;
/org.eclipse.team.ui/src/org/eclipse/team/ui/sync/UnchangedTeamContainer.java;2;0;6;1;1;1;1;5;9;1;5;2233;34;34;1;0;0;5;6;2233;0;4005;6;2;
/org.eclipse.swt/Eclipse SWT/gtk/org/eclipse/swt/widgets/Table.java;6;3;39;2;22;19;22;17;673;3;14;2107;1676;1676;3;3;3;17;39;3471;6;4701;33;6;
/org.eclipse.swt/Eclipse SWT/win32/org/eclipse/swt/internal/win32/NMHEADER.java;2;0;3;1;0;0;0;3;5;1;3;106;5;5;1;0;0;3;3;106;0;2069;3;2;
/org.eclipse.swt/Eclipse SWT OLE Win32/win32/org/eclipse/swt/internal/ole/win32/OLECMDTEXT.java;2;0;3;1;0;0;0;3;5;1;3;106;5;5;1;0;0;3;3;106;0;2069;3;2;
/org.eclipse.ui/Eclipse UI/org/eclipse/ui/help/IContextComputer.java;3;0;3;1;0;0;0;3;5;1;3;257;7;7;1;0;0;3;3;257;0;3066;3;3;
/org.eclipse.scripting/Eclipse Scripting/org/eclipse/scripting/internal/views/ScriptUIEditorWordDetector.java;1;0;3;1;0;0;0;3;7;1;3;133;7;7;1;0;0;3;3;133;0;1424;3;1;
/org.eclipse.help/src/org/eclipse/help/internal/search/SearchIndex.java;3;3;16;2;6;3;6;10;186;1;10;2318;433;433;3;0;3;10;16;4000;3;4123;13;3;
/org.eclipse.jdt.ui.tests/refactoring/org/eclipse/jdt/refactoring/tests/RenameTypeTests.java;4;0;22;1;0;0;0;22;119;2;21;49;370;370;2;1;0;22;22;1342;1;1896;21;4;
/org.eclipse.ui.tests/Eclipse UI Tests/org/eclipse/ui/tests/internal/ActionSetExpressionTest.java;2;0;3;1;0;0;0;3;2;1;3;2033;4;4;1;0;0;3;3;2033;0;2785;3;2;
/org.eclipse.help/webapps/examples/WEB-INF/classes/filters/RequestDumperFilter.java;1;0;2;1;0;0;0;2;0;1;2;1882;0;0;1;0;0;2;2;1882;0;1930;2;1;
/org.eclipse.jdt.core/model/org/eclipse/jdt/internal/core/builder/BinaryBrokerKey.java;1;0;3;1;0;0;0;3;11;1;3;455;11;11;1;0;0;3;3;455;0;2808;3;1;
/org.eclipse.jdt.ui/core refactoring/org/eclipse/jdt/internal/corext/refactoring/reorg/ReorgUtils.java;1;0;1;1;0;0;0;1;0;0;1;1939;0;0;1;0;0;1;1;1939;0;1939;1;1;
/org.eclipse.jdt.ui.tests.refactoring/resources/MoveCU/testFail1/in/p/A.java;2;0;2;1;0;0;0;2;0;1;2;49;0;0;1;0;0;2;2;49;0;2769;2;2;
/org.eclipse.team.cvs.ui/src/org/eclipse/team/internal/ccvs/ui/wizards/SharingWizardFinishPage.java;2;0;3;1;1;1;1;2;4;1;2;2724;6;6;1;0;0;2;3;2724;0;4455;3;2;
/org.eclipse.compare/compare/org/eclipse/compare/structuremergeviewer/DiffTreeViewer.java;3;2;28;1;6;5;6;22;242;2;21;14;730;730;2;1;1;22;28;2459;2;4820;26;3;
/org.eclipse.jdt.ui/core refactoring/org/eclipse/jdt/internal/core/refactoring/nls/changes/NLSChangesMessages.java;2;0;2;1;0;0;0;2;0;1;2;1923;0;0;1;0;0;2;2;1923;0;1939;2;2;
/org.eclipse.team.cvs.core/src/org/eclipse/team/ccvs/core/ICVSTag.java;2;0;3;1;0;0;0;3;1;1;3;2051;1;1;1;0;0;3;3;2051;0;2156;3;2;
/org.eclipse.jdt.ui.tests.refactoring/test cases/org/eclipse/jdt/ui/tests/refactoring/RenameStaticMethodTests.java;2;0;5;1;0;0;0;5;58;1;5;1896;76;76;1;0;0;5;5;1896;0;3326;5;2;
/org.eclipse.jdt.ui.tests.refactoring/resources/ExtractMethodWorkSpace/ExtractMethodTests/semicolon_out/A_test409.java;1;1;3;1;2;2;2;1;4;0;1;2327;4;4;1;0;0;1;3;2327;0;4419;3;1;
/org.eclipse.jdt.ui/core refactoring/org/eclipse/jdt/internal/corext/refactoring/structure/ReorderParameterMoveFinder.java;2;0;5;1;0;0;0;5;76;1;5;2270;85;85;1;0;0;5;5;2270;0;3188;5;2;
/org.eclipse.jdt.ui/core extension/org/eclipse/jdt/internal/corext/template/java/GlobalVariables.java;2;0;2;1;0;0;0;2;16;1;2;2784;16;16;1;0;0;2;2;2784;0;3683;2;2;
/org.eclipse.jdt.ui.tests.refactoring/resources/SelectionAnalyzerWorkSpace/SelectionAnalyzerTests/validSelection/A_test235.java;1;0;1;1;0;0;0;1;0;0;1;1368;0;0;1;0;0;1;1;1368;0;1368;1;1;
/org.eclipse.swt.examples.paint/org/eclipse/swt/examples/paint/PaintSession.java;3;0;3;1;1;1;1;2;52;1;2;513;52;52;1;0;0;2;3;513;0;4024;3;3;
/org.eclipse.pde.ui/Eclipse PDE UI/org/eclipse/pde/internal/preferences/RuntimeTracingPreferencePage.java;2;0;5;2;0;0;0;5;75;3;3;267;75;75;3;2;0;5;5;324;2;1434;3;2;
/org.eclipse.swt.examples/Eclipse SWT Examples/common/org/eclipse/swt/examples/hoverhelp/HoverHelp.java;1;0;1;1;0;0;0;1;0;0;1;499;0;0;1;0;0;1;1;499;0;499;1;1;
/org.eclipse.jdt.core/model/org/eclipse/jdt/internal/core/CreateTypeHierarchyOperation.java;3;1;4;1;2;2;2;2;133;1;2;455;186;186;1;0;0;2;4;455;0;4139;4;3;
/org.eclipse.search/search/org/eclipse/search/internal/ui/ResourcePathSorter.java;2;0;4;1;0;0;0;4;9;1;4;15;13;13;1;0;0;4;4;15;0;1117;4;2;
/org.eclipse.help/src/org/eclipse/help/internal/contributions1_0/Insert.java;1;0;2;1;0;0;0;2;0;1;2;1675;0;0;1;0;0;2;2;1675;0;2217;2;1;
/org.eclipse.jdt.ui.tests.refactoring/resources/RenameVirtualMethodInClass/test2/out/A.java;1;0;1;1;0;0;0;1;0;0;1;49;0;0;1;0;0;1;1;49;0;49;1;1;
/org.eclipse.jdt.debug/jdi/org/eclipse/jdi/internal/jdwp/JdwpMethodID.java;2;0;3;1;0;0;0;3;12;1;3;187;13;13;1;0;0;3;3;187;0;3040;3;2;
/org.eclipse.update.ui/src/org/eclipse/update/internal/ui/manager/BaseTreeView.java;1;0;8;1;0;0;0;8;199;2;7;1460;240;240;2;1;0;8;8;2174;1;3537;7;1;
/org.eclipse.jdt.core/compiler/org/eclipse/jdt/internal/compiler/ast/SynchronizedStatement.java;2;1;16;1;2;2;2;14;253;4;10;455;602;602;4;4;0;14;16;1039;4;4421;12;2;
/org.eclipse.jdt.ui.tests.refactoring/resources/ExtractMethodWorkSpace/ExtractMethodTests/invalidSelection/A_test113.java;2;1;3;1;2;2;2;1;0;0;1;49;0;0;1;0;0;1;3;49;0;4419;3;2;
/org.eclipse.jdt.debug/eval/org/eclipse/jdt/internal/debug/eval/ast/engine/BinaryBasedSourceGenerator.java;3;0;9;1;1;1;1;8;94;1;8;3447;243;243;1;0;0;8;9;3447;0;4423;9;3;
/org.eclipse.ui/Eclipse UI/org/eclipse/ui/internal/NewConfigurationInfo.java;1;1;4;1;4;4;4;0;24;0;0;3980;40;40;1;0;0;0;4;3980;0;4449;4;1;
/org.eclipse.ui/Eclipse UI/org/eclipse/ui/part/MultiEditorInput.java;2;0;2;1;0;0;0;2;4;1;2;3128;4;4;1;0;0;2;2;3128;0;3607;2;2;
/org.eclipse.swt/Eclipse SWT/photon/org/eclipse/swt/widgets/ToolItem.java;9;1;23;1;9;9;9;14;345;2;12;106;825;825;2;2;0;14;23;617;2;4701;21;9;
/org.eclipse.scripting/src/org/eclipse/scripting/internal/uirenderer/XGRFontManager.java;1;0;1;1;0;0;0;1;0;0;1;1424;0;0;1;0;0;1;1;1424;0;1424;1;1;
/org.eclipse.ui/Eclipse UI/org/eclipse/ui/dialogs/ProjectLocationMoveDialog.java;3;0;5;1;1;1;1;4;5;1;4;1143;13;13;1;0;0;4;5;1143;0;3918;5;3;
/org.eclipse.debug.ui/ui/org/eclipse/debug/internal/ui/LaunchWizard.java;3;0;18;2;0;0;0;18;143;3;13;187;390;390;3;5;0;18;18;290;5;3634;13;3;
/org.eclipse.pde.ui/src/org/eclipse/pde/internal/editor/SystemFileStorage.java;1;0;2;1;0;0;0;2;0;1;2;3446;0;0;1;0;0;2;2;3446;0;3579;2;1;
/org.eclipse.jdt.ui/core refactoring/org/eclipse/jdt/internal/core/refactoring/util/IParentTracker.java;1;0;3;1;0;0;0;3;2;1;3;1453;2;2;1;0;0;3;3;1453;0;1939;3;1;
/org.eclipse.update.core/src/org/eclipse/update/internal/core/Feature.java;2;0;17;1;0;0;0;17;487;2;16;1791;802;802;2;1;0;17;17;2004;1;2583;16;2;
/org.eclipse.jdt.ui/core refactoring/org/eclipse/jdt/internal/core/refactoring/changes/CopyPackageChange.java;2;0;3;1;0;0;0;3;18;1;3;1108;18;18;1;0;0;3;3;1108;0;1939;3;2;
/org.eclipse.ui.externaltools/External Tools/org/eclipse/ui/externaltools/internal/ui/AntPreferencePage.java;2;1;3;1;3;3;3;0;3;0;0;4123;5;5;1;0;0;0;3;4123;0;4463;3;2;
/org.eclipse.pde.build/src/plugin/org/eclipse/pde/internal/core/BuildAntScript.java;1;0;1;1;0;0;0;1;0;0;1;3475;0;0;1;0;0;1;1;3475;0;3475;1;1;
/org.eclipse.jdt.ui/core refactoring/org/eclipse/jdt/internal/corext/refactoring/util/NewStatementAnalyzer.java;1;0;7;1;0;0;0;7;10;1;7;2327;23;23;1;0;0;7;7;2327;0;3209;7;1;
/org.eclipse.core.runtime/src/org/eclipse/core/runtime/Preferences.java;3;1;7;1;4;4;4;3;104;1;3;3506;225;225;1;0;0;3;7;3506;0;4807;7;3;
/org.eclipse.help/src/org/eclipse/help/internal/server/HelpHttpResponse.java;1;0;2;1;0;0;0;2;0;1;2;1420;0;0;1;0;0;2;2;1420;0;3095;2;1;
/org.eclipse.core.runtime/src/org/eclipse/core/internal/runtime/PlatformURLPluginHandlerFactory.java;4;0;8;2;2;1;2;6;98;1;6;23;130;130;2;0;1;6;8;4213;1;4213;7;4;
/org.eclipse.pde.ui/src/org/eclipse/pde/model/build/IBuildModel.java;1;0;2;1;0;0;0;2;0;1;2;3039;0;0;1;0;0;2;2;3039;0;3579;2;1;
/org.eclipse.scripting/Eclipse Scripting/org/eclipse/scripting/internal/uirenderer/XGRXmlAttribute.java;2;0;4;1;0;0;0;4;8;1;4;133;15;15;1;0;0;4;4;133;0;1424;4;2;
/org.eclipse.pde.ui/src/org/eclipse/pde/internal/base/model/IEditable.java;2;0;3;1;0;0;0;3;8;1;3;1434;8;8;1;0;0;3;3;1434;0;3039;3;2;
/org.eclipse.vcm.ui/src/org/eclipse/vcm/internal/ui/svrevents/ServerEventsView.java;1;0;1;1;0;0;0;1;0;0;1;951;0;0;1;0;0;1;1;951;0;951;1;1;
/org.eclipse.ui/Eclipse UI/org/eclipse/ui/internal/PerspectiveComboBox.java;2;0;4;1;0;0;0;4;22;2;3;1828;22;22;2;1;0;4;4;2271;1;3050;3;2;
/org.eclipse.vcm.tests.core.cvs.ssh/src/org/eclipse/vcm/tests/core/ccvs/ssh/ClientCvsServerTest.java;1;0;1;1;0;0;0;1;0;0;1;1688;0;0;1;0;0;1;1;1688;0;1688;1;1;
/org.eclipse.jdt.ui.tests.refactoring/resources/SelectionAnalyzerWorkSpace/SelectionAnalyzerTests/invalidSelection/A_test100.java;2;0;3;1;0;0;0;3;0;1;3;1368;0;0;1;0;0;3;3;1368;0;2327;3;2;
/org.eclipse.jdt.ui.tests.refactoring/resources/SurroundWithWorkSpace/SurroundWithTests/trycatch_in/TestRuntimeException2.java;1;0;1;1;0;0;0;1;0;0;1;3719;0;0;1;0;0;1;1;3719;0;3719;1;1;
/org.eclipse.jdt.ui/ui refactoring/org/eclipse/jdt/internal/ui/refactoring/nls/OrderedMap.java;1;0;1;1;0;0;0;1;0;0;1;1922;0;0;1;0;0;1;1;1922;0;1922;1;1;
/org.eclipse.ui/Eclipse UI/org/eclipse/ui/ICapabilityWizard.java;1;0;3;1;0;0;0;3;18;1;3;3227;31;31;1;0;0;3;3;3227;0;3506;3;1;
/org.eclipse.jdt.ui/ui/org/eclipse/jdt/internal/ui/javaeditor/JavaSelectMarkerRulerAction.java;1;1;2;1;2;2;2;0;8;0;0;4466;8;8;1;0;0;0;2;4466;0;4699;2;1;
/org.eclipse.ant.ui/src/org/eclipse/ant/internal/ui/TargetsListContentProvider.java;4;0;7;1;0;0;0;7;98;1;7;300;181;181;1;0;0;7;7;300;0;3606;7;4;
/org.eclipse.jdt.ui.tests.refactoring/resources/PullUpMethods/test11/in/A.java;1;0;3;1;0;0;0;3;2;1;3;2212;2;2;1;0;0;3;3;2212;0;2406;3;1;
/org.eclipse.swt.examples/org/eclipse/swt/examples/texteditor/ColorTextEditor.java;1;0;1;1;0;0;0;1;0;0;1;513;0;0;1;0;0;1;1;513;0;513;1;1;
/org.eclipse.swt/Eclipse SWT PI/motif/org/eclipse/swt/internal/motif/XInputEvent.java;2;0;2;1;1;1;1;1;6;0;1;2069;6;6;1;0;0;1;2;2069;0;4701;2;2;
/org.eclipse.update.tests.core/src/org/eclipse/update/tests/nestedfeatures/AllNestedTests.java;1;0;1;1;1;1;1;0;0;0;0;3977;0;0;1;0;0;0;1;3977;0;3977;1;1;
/org.eclipse.pde.ui/Eclipse PDE UI/org/eclipse/pde/internal/editor/component/BuildComponentAction.java;2;0;5;2;0;0;0;5;12;3;3;267;12;12;3;2;0;5;5;324;2;1434;3;2;
/org.eclipse.jdt.ui.tests.refactoring/resources/SelectionAnalyzerWorkSpace/SelectionAnalyzerTests/invalidSelection/A_test052.java;1;0;1;1;0;0;0;1;0;0;1;1368;0;0;1;0;0;1;1;1368;0;1368;1;1;
/org.eclipse.jdt.ui.tests.refactoring/resources/RenameMethodInInterface/test32/out/A.java;1;0;1;1;0;0;0;1;0;0;1;49;0;0;1;0;0;1;1;49;0;49;1;1;
/org.eclipse.compare/compare/org/eclipse/patch/Diff.java;1;0;4;1;0;0;0;4;43;1;4;1419;50;50;1;0;0;4;4;1419;0;1516;4;1;
/org.eclipse.swt/Eclipse SWT/photon/org/eclipse/swt/widgets/AbstractTreeItem.java;2;0;4;1;0;0;0;4;23;1;4;106;33;33;1;0;0;4;4;106;0;1028;4;2;
/org.eclipse.jdt.ui.tests.refactoring/resources/SelectionAnalyzerWorkSpace/SelectionAnalyzerTests/invalidSelection/A_test081.java;1;0;1;1;0;0;0;1;0;0;1;1368;0;0;1;0;0;1;1;1368;0;1368;1;1;
/org.eclipse.jdt.ui/ui/org/eclipse/jdt/internal/ui/typehierarchy/FocusOnSelectionAction.java;2;0;6;1;0;0;0;6;31;1;6;436;64;64;1;0;0;6;6;436;0;3050;6;2;
/org.eclipse.help/src/org/eclipse/help/internal/contributors/xml1_0/XMLContributor.java;1;0;2;1;0;0;0;2;0;1;2;1675;0;0;1;0;0;2;2;1675;0;2217;2;1;
/org.eclipse.jdt.core/model/org/eclipse/jdt/internal/core/newbuilder/IncompleteClassPathException.java;1;0;2;1;0;0;0;2;0;1;2;2276;0;0;1;0;0;2;2;2276;0;2979;2;1;
/org.eclipse.pde.ui/src/org/eclipse/pde/ui/IPluginContentWizard.java;1;0;3;1;1;1;1;2;13;1;2;3579;16;16;1;0;0;2;3;3579;0;4752;3;1;
/org.eclipse.jdt.ui.tests.refactoring/resources/ExtractMethodWorkSpace/ExtractMethodTests/return_out/A_test709.java;1;1;3;1;2;2;2;1;26;0;1;887;26;26;1;0;0;1;3;887;0;4419;3;1;
/org.eclipse.jdt.core/codeassist/org/eclipse/jdt/internal/codeassist/complete/CompletionOnMemberAccess.java;2;0;10;1;1;1;1;9;36;4;6;455;122;122;4;3;0;9;10;1039;3;4062;7;2;
/org.eclipse.jdt.ui.tests.refactoring/resources/InlineTemp/cannotInline/A_testFail10.java;1;0;1;1;1;1;1;0;0;0;0;4357;0;0;1;0;0;0;1;4357;0;4357;1;1;
/org.eclipse.swt/Eclipse SWT Drag and Drop/gtk/org/eclipse/swt/dnd/TableDragUnderEffect.java;2;0;2;1;0;0;0;2;0;1;2;2107;0;0;1;0;0;2;2;2107;0;3127;2;2;
/org.eclipse.jdt.ui/ui refactoring/org/eclipse/jdt/internal/ui/refactoring/undo/UndoRefactoringAction.java;3;0;8;1;0;0;0;8;13;1;8;15;47;47;1;0;0;8;8;15;0;1360;8;3;
/org.eclipse.pde.core/src/org/eclipse/pde/internal/core/plugin/PluginModelFactory.java;1;0;1;1;0;0;0;1;0;0;1;3591;0;0;1;0;0;1;1;3591;0;3591;1;1;
/org.eclipse.pde.ui/src/org/eclipse/pde/internal/ui/editor/manifest/JavaAttributeDescriptor.java;1;0;1;1;0;0;0;1;0;0;1;3579;0;0;1;0;0;1;1;3579;0;3579;1;1;
/org.eclipse.jdt.ui/ui/org/eclipse/jdt/internal/ui/compare/JavaNode.java;2;0;7;1;0;0;0;7;113;1;7;15;324;324;1;0;0;7;7;15;0;2681;7;2;
/org.eclipse.jdt.ui/ui/org/eclipse/jdt/internal/ui/reorg/ContainerFilter.java;2;0;3;1;0;0;0;3;5;1;3;15;5;5;1;0;0;3;3;15;0;1258;3;2;
/org.eclipse.jdt.ui.tests.refactoring/resources/CopyPackageChange/A.java;1;0;1;1;0;0;0;1;0;0;1;1157;0;0;1;0;0;1;1;1157;0;1157;1;1;
/org.eclipse.jdt.launching.j9/j9/org/eclipse/jdt/internal/launching/j9/J9LauncherMessages.java;1;0;1;1;0;0;0;1;0;0;1;3314;0;0;1;0;0;1;1;3314;0;3314;1;1;
/org.eclipse.jdt.junit/Eclipse JUnit/org/eclipse/jdt/internal/junit/launcher/JUnitMainTab.java;2;0;5;2;0;0;0;5;305;2;4;2861;316;316;2;1;0;5;5;3068;1;3068;4;2;
/org.eclipse.pde.ui/Eclipse PDE UI/org/eclipse/pde/internal/ArraySorter.java;2;0;5;2;0;0;0;5;12;3;3;267;12;12;3;2;0;5;5;324;2;1434;3;2;
/org.eclipse.ui/Eclipse UI/org/eclipse/ui/internal/dialogs/AboutPluginsDialog.java;4;2;15;1;7;6;7;8;462;1;8;1039;743;743;2;0;1;8;15;4210;1;4637;14;4;
/org.eclipse.help/src/org/eclipse/help/internal/contributors/xml1_0/ContributorFactory.java;1;0;2;1;0;0;0;2;0;1;2;1675;0;0;1;0;0;2;2;1675;0;2217;2;1;
/org.eclipse.ant.ui/src/org/eclipse/ant/internal/ui/IAntPreferenceConstants.java;3;0;3;1;0;0;0;3;74;1;3;677;89;89;1;0;0;3;3;677;0;3606;3;3;
/org.eclipse.pde.ui/src/org/eclipse/pde/internal/wizards/templates/GenericTemplateWizardPage.java;1;0;3;1;0;0;0;3;12;1;3;3278;12;12;1;0;0;3;3;3278;0;3579;3;1;
/org.eclipse.core.runtime/src/org/eclipse/core/internal/runtime/SafeFileInputStream.java;3;0;5;1;1;1;1;4;78;1;4;12;104;104;1;0;0;4;5;12;0;4213;5;3;
/org.eclipse.jdt.ui.tests.refactoring/resources/RenameMethodInInterface/test11/in/A.java;1;0;1;1;0;0;0;1;0;0;1;49;0;0;1;0;0;1;1;49;0;49;1;1;
/org.eclipse.jdt.ui.tests/JUnit/junit/tests/WasRun.java;2;0;2;1;0;0;0;2;0;1;2;49;0;0;1;0;0;2;2;49;0;1186;2;2;
/org.eclipse.team.ui/src/org/eclipse/team/internal/ui/UIConstants.java;3;2;12;2;8;7;8;4;57;1;4;1978;143;143;2;0;1;4;12;4146;1;4707;11;3;
/org.eclipse.ui.examples.readmetool/Eclipse UI Examples Readme Tool/org/eclipse/ui/examples/readmetool/ReadmeContentOutlineDragListener.java;2;0;2;1;0;0;0;2;4;1;2;932;4;4;1;0;0;2;2;932;0;945;2;2;
/org.eclipse.jdt.ui/ui/org/eclipse/jdt/internal/ui/typehierarchy/HierarchyLabelProvider.java;3;2;14;1;6;5;6;8;166;2;6;1705;507;507;2;2;1;8;14;1705;3;4401;11;3;
/org.eclipse.ui/Eclipse JFace Text/org/eclipse/jface/text/presentation/IPresentationDamager.java;3;0;3;1;0;0;0;3;15;1;3;257;20;20;1;0;0;3;3;257;0;1066;3;3;
/org.eclipse.ui/Eclipse JFace/org/eclipse/jface/viewers/ColumnPixelData.java;2;0;2;1;0;0;0;2;5;1;2;257;5;5;1;0;0;2;2;257;0;457;2;2;
/org.eclipse.pde.core/src/org/eclipse/pde/internal/core/plugin/IdentifiablePluginObject.java;1;0;1;1;0;0;0;1;0;0;1;3591;0;0;1;0;0;1;1;3591;0;3591;1;1;
/org.eclipse.team.ui/src/org/eclipse/team/internal/ui/target/TargetAction.java;3;1;6;1;6;6;6;0;28;0;0;4256;60;60;1;0;0;0;6;4256;0;4636;6;3;
/org.eclipse.jdt.ui.tests.refactoring/resources/PullUp/test13/in/A.java;1;0;1;1;0;0;0;1;0;0;1;2406;0;0;1;0;0;1;1;2406;0;2406;1;1;
/org.eclipse.jdt.core/model/org/eclipse/jdt/core/jdom/IDOMPackage.java;2;0;4;1;1;1;1;3;30;1;3;455;59;59;1;0;0;3;4;455;0;4061;4;2;
/org.eclipse.jdt.ui.tests.refactoring/resources/RenameTemp/canRename/A_test11_in.java;1;0;2;1;0;0;0;2;2;1;2;1625;2;2;1;0;0;2;2;1625;0;1652;2;1;
/org.eclipse.help/src/org/eclipse/help/internal/contributors/xml1_0/XMLActionContributorCreator.java;1;0;2;1;0;0;0;2;0;1;2;1675;0;0;1;0;0;2;2;1675;0;2217;2;1;
/org.eclipse.jdt.debug.tests/tests/org/eclipse/jdt/debug/tests/eval/CharAssignmentOperatorsTests.java;2;2;3;2;3;2;3;0;18;0;0;4447;20;20;2;0;1;0;3;4447;1;4571;2;2;
/org.eclipse.search/search/org/eclipse/search/internal/ui/SearchResultView.java;2;1;21;1;6;6;6;15;60;1;15;15;302;302;1;0;0;15;21;15;0;4762;21;2;
/org.eclipse.ui/Eclipse UI/org/eclipse/ui/internal/WorkbenchPlugin.java;9;2;59;3;13;9;13;46;724;4;40;257;1118;1118;4;6;4;46;59;3570;10;4626;49;9;
/org.eclipse.jdt.ui/core refactoring/org/eclipse/jdt/core/refactoring/code/LocalTypeAnalyzer.java;1;0;5;1;0;0;0;5;5;1;5;15;13;13;1;0;0;5;5;15;0;408;5;1;
/org.eclipse.swt.examples/src/org/eclipse/swt/examples/controlexample/TextTab.java;5;2;9;1;5;4;5;4;159;1;4;513;455;455;2;0;1;4;9;3914;1;4705;8;5;
/org.eclipse.swt/Eclipse SWT PI/gtk/org/eclipse/swt/internal/gtk/GtkStyle.java;2;0;5;1;2;1;2;3;22;1;3;2107;34;34;2;0;1;3;5;4701;1;4701;4;2;
/org.eclipse.scripting/Eclipse Scripting/org/eclipse/scripting/StringDataSingle.java;1;0;3;1;0;0;0;3;7;1;3;133;7;7;1;0;0;3;3;133;0;1424;3;1;
/org.eclipse.jdt.debug/jdi interfaces/com/sun/jdi/connect/ListeningConnector.java;2;0;2;1;0;0;0;2;17;1;2;2704;17;17;1;0;0;2;2;2704;0;3033;2;2;
/org.eclipse.scripting/Eclipse Scripting/org/eclipse/scripting/internal/uirenderer/IScriptContributionNode.java;2;0;4;1;0;0;0;4;7;1;4;133;11;11;1;0;0;4;4;133;0;1424;4;2;
/org.eclipse.jdt.ui.tests.refactoring/resources/RenameVariables/canRename/A_test16_in.java;1;0;2;1;0;0;0;2;0;1;2;724;0;0;1;0;0;2;2;724;0;1665;2;1;
/org.eclipse.jdt.ui/nls/org/eclipse/jdt/internal/ui/nls/model/NLSLine.java;1;0;2;1;0;0;0;2;0;1;2;1880;0;0;1;0;0;2;2;1880;0;1913;2;1;
/org.eclipse.ui/Eclipse UI/org/eclipse/ui/internal/dialogs/ImportWizard.java;4;0;4;1;0;0;0;4;9;1;4;257;17;17;1;0;0;4;4;257;0;3029;4;4;
/org.eclipse.jdt.core/model/org/eclipse/jdt/internal/core/builder/impl/Indictment.java;1;0;3;1;0;0;0;3;64;1;3;455;64;64;1;0;0;3;3;455;0;2808;3;1;
/org.eclipse.jdt.ui.tests/JUnit/junit/samples/money/MoneyTest.java;2;0;2;1;0;0;0;2;0;1;2;49;0;0;1;0;0;2;2;49;0;1186;2;2;
/org.eclipse.update.ui/src/org/eclipse/update/internal/ui/parts/IWebBrowser.java;1;0;2;1;1;1;1;1;0;0;1;3662;0;0;1;0;0;1;2;3662;0;4127;2;1;
/org.eclipse.swt/Eclipse SWT/photon/org/eclipse/swt/internal/BidiUtil.java;1;0;2;1;0;0;0;2;0;1;2;1349;0;0;1;0;0;2;2;1349;0;1360;2;1;
/org.eclipse.jdt.debug/jdi/org/eclipse/jdi/internal/ThreadGroupReferenceImpl.java;2;0;4;1;0;0;0;4;23;1;4;187;45;45;1;0;0;4;4;187;0;3670;4;2;
/org.eclipse.pde.core/src/org/eclipse/pde/internal/core/schema/SchemaRegistry.java;1;0;4;1;2;1;2;2;21;1;2;3591;39;39;2;0;1;2;4;4650;1;4650;3;1;
/org.eclipse.pde.ui/src/org/eclipse/pde/internal/editor/jars/JarsOutlinePage.java;2;0;2;1;0;0;0;2;0;1;2;1434;0;0;1;0;0;2;2;1434;0;2650;2;2;
/org.eclipse.swt/Eclipse SWT/gtk/org/eclipse/swt/widgets/TabItem.java;4;2;14;1;8;7;8;6;30;1;6;2107;144;144;2;0;1;6;14;3975;1;4701;13;4;
/org.eclipse.debug.ui/ui/org/eclipse/debug/internal/ui/ChangeVariableValueAction.java;4;0;10;1;0;0;0;10;45;1;10;187;122;122;1;0;0;10;10;187;0;2382;10;4;
/org.eclipse.jdt.core/search/org/eclipse/jdt/core/search/ITypeNameRequestor.java;3;2;7;2;4;3;4;3;68;1;3;455;127;127;2;0;1;3;7;4421;1;4450;6;3;
/org.eclipse.jdt.debug.tests/testprograms/MethodEntryRunner.java;2;0;2;1;1;1;1;1;11;0;1;3719;11;11;1;0;0;1;2;3719;0;4571;2;2;
/org.eclipse.pde.ui/src/org/eclipse/pde/internal/wizards/templates/ControlStack.java;1;0;2;1;0;0;0;2;0;1;2;3442;0;0;1;0;0;2;2;3442;0;3579;2;1;
/org.eclipse.pde.ui/Eclipse PDE UI/org/eclipse/pde/internal/editor/PDEMultiPageEditor.java;2;0;11;2;0;0;0;11;29;3;8;267;71;71;3;3;0;11;11;324;3;1434;8;2;
/org.eclipse.swt.tests/JUnit Tests/org/eclipse/swt/tests/junit/Test_org_eclipse_swt_events_VerifyEvent.java;2;0;2;1;1;1;1;1;6;0;1;1792;6;6;1;0;0;1;2;1792;0;4706;2;2;
/org.eclipse.jdt.ui.tests.refactoring/resources/ExtractMethodWorkSpace/ExtractMethodTests/branch_out/A_test753.java;1;1;4;1;2;2;2;2;34;1;2;1851;35;35;1;0;0;2;4;1851;0;4419;4;1;
/org.eclipse.scripting/src/org/eclipse/scripting/internal/datamodels/XGRIncompatibleDataModelException.java;1;0;1;1;0;0;0;1;0;0;1;1424;0;0;1;0;0;1;1;1424;0;1424;1;1;
/org.eclipse.pde.ui/src/org/eclipse/pde/internal/ui/parts/TablePart.java;1;0;1;1;0;0;0;1;0;0;1;3579;0;0;1;0;0;1;1;3579;0;3579;1;1;
/org.eclipse.jdt.core/model/org/eclipse/jdt/core/util/IExceptionTableEntry.java;2;1;7;1;5;5;5;2;19;0;1;3629;56;56;2;1;0;2;7;3629;1;4573;6;2;
/org.eclipse.jdt.debug.ui/ui/org/eclipse/jdt/internal/debug/ui/snippeteditor/ScrapbookMain.java;2;0;2;1;0;0;0;2;2;1;2;1915;2;2;1;0;0;2;2;1915;0;3783;2;2;
/org.eclipse.ui/Eclipse UI Standard Components/org/eclipse/ui/views/navigator/IResourceTreeNavigatorPart.java;2;0;2;1;1;1;1;1;0;0;1;1831;0;0;1;0;0;1;2;1831;0;4067;2;2;
/org.eclipse.pde.ui/src/org/eclipse/pde/internal/model/build/ExternalBuildModel.java;2;0;3;1;0;0;0;3;21;1;3;1434;21;21;1;0;0;3;3;1434;0;3579;3;2;
/org.eclipse.jdt.ui.tests.refactoring/resources/RenameVariables/canRename/A_test24_in.java;1;0;2;1;0;0;0;2;0;1;2;724;0;0;1;0;0;2;2;724;0;1665;2;1;
/org.eclipse.jdt.ui/ui/org/eclipse/jdt/internal/ui/util/RowLayouter.java;2;0;4;1;0;0;0;4;12;1;4;15;21;21;1;0;0;4;4;15;0;1310;4;2;
/org.eclipse.webdav/src/interface/org/eclipse/webdav/dom/QualifiedName.java;2;0;4;1;1;1;1;3;68;1;3;12;95;95;1;0;0;3;4;12;0;4211;4;2;
/org.eclipse.jdt.ui/ui/org/eclipse/jdt/internal/ui/reorg/CopyQueries.java;2;1;3;1;3;3;3;0;34;0;0;4212;42;42;1;0;0;0;3;4212;0;4426;3;2;
/org.eclipse.ui.examples.javaeditor/Eclipse Java Editor Example/org/eclipse/ui/examples/javaeditor/JavaEditorMessages.java;1;0;1;1;0;0;0;1;0;0;1;1067;0;0;1;0;0;1;1;1067;0;1067;1;1;
/org.eclipse.vcm.core.cvs/src/org/eclipse/vcm/internal/core/ccvs/requests/ModuleNamesMessageHandler.java;1;0;1;1;0;0;0;1;0;0;1;1721;0;0;1;0;0;1;1;1721;0;1721;1;1;
/org.eclipse.jdt.ui.tests.refactoring/resources/ExtractMethodWorkSpace/ExtractMethodTests/validSelection/A_test284.java;2;1;3;1;2;2;2;1;8;0;1;158;8;8;1;0;0;1;3;158;0;4419;3;2;
/org.eclipse.swt/Eclipse SWT/emulated/treetable/org/eclipse/swt/widgets/AbstractTreeItem.java;4;1;4;1;2;2;2;2;6;1;2;1028;11;11;1;0;0;2;4;1028;0;4701;4;4;
/org.eclipse.jdt.ui.tests.refactoring/resources/RenameVariables/cannotRename/A_testFail20.java;1;0;2;1;0;0;0;2;0;1;2;724;0;0;1;0;0;2;2;724;0;1665;2;1;
/org.eclipse.pde.build/src/org/eclipse/pde/internal/build/FetchScriptGenerator.java;1;1;14;1;3;3;3;11;328;2;9;2977;501;501;2;2;0;11;14;3089;2;4273;12;1;
/org.eclipse.ui/Eclipse UI/org/eclipse/ui/internal/registry/IActionSetDescriptor.java;2;0;2;1;0;0;0;2;16;1;2;257;16;16;1;0;0;2;2;257;0;457;2;2;
/org.eclipse.swt/Eclipse SWT/photon/org/eclipse/swt/widgets/TabFolder.java;5;1;14;1;6;6;6;8;204;2;7;106;545;545;2;1;0;8;14;2064;1;4727;13;5;
/org.eclipse.pde.core/src/org/eclipse/pde/internal/core/build/ExternalBuildModel.java;1;0;1;1;0;0;0;1;0;0;1;3591;0;0;1;0;0;1;1;3591;0;3591;1;1;
/org.eclipse.pde.ui/Eclipse PDE UI/org/eclipse/pde/internal/schema/ExtensionPointSchemaDescriptor.java;2;0;5;2;0;0;0;5;12;3;3;267;12;12;3;2;0;5;5;324;2;1434;3;2;
/org.eclipse.compare/compare/org/eclipse/patch/CompareWithPatchAction.java;1;0;2;1;0;0;0;2;0;1;2;1419;0;0;1;0;0;2;2;1419;0;1516;2;1;
/org.eclipse.update.core/src/org/eclipse/update/configuration/IVolume.java;1;1;2;1;2;2;2;0;30;0;0;3971;30;30;1;0;0;0;2;3971;0;4687;2;1;
/org.eclipse.pde.ui/src/org/eclipse/pde/internal/ui/editor/schema/SchemaContentProvider.java;1;0;1;1;0;0;0;1;0;0;1;3579;0;0;1;0;0;1;1;3579;0;3579;1;1;
/org.eclipse.jdt.ui/core refactoring/org/eclipse/jdt/internal/corext/refactoring/util/TextBufferChangeManager.java;1;0;2;1;0;0;0;2;0;1;2;1939;0;0;1;0;0;2;2;1939;0;2216;2;1;
/org.eclipse.jdt.ui.tests.refactoring/resources/RenameStaticMethod/testFail7/in/A.java;1;0;1;1;0;0;0;1;0;0;1;49;0;0;1;0;0;1;1;49;0;49;1;1;
/org.eclipse.jdt.ui/ui/org/eclipse/jdt/ui/actions/CCPActionGroup.java;2;1;12;2;6;6;6;6;60;2;5;3716;180;180;2;1;0;6;12;3826;1;4770;11;2;
/org.eclipse.pde.ui/src/org/eclipse/pde/internal/editor/component/DescriptionSection.java;2;0;3;1;0;0;0;3;12;1;3;1434;12;12;1;0;0;3;3;1434;0;2951;3;2;
/org.eclipse.swt/Eclipse SWT OLE Win32/win32/org/eclipse/swt/internal/ole/win32/IOleWindow.java;2;0;3;1;0;0;0;3;9;1;3;106;9;9;1;0;0;3;3;106;0;2069;3;2;
/org.eclipse.jdt.debug.tests/tests/org/eclipse/jdt/debug/tests/core/LaunchConfigurationTests.java;2;1;3;1;2;2;2;1;16;0;1;3701;29;29;1;0;0;1;3;3701;0;4328;3;2;
/org.eclipse.scripting/src/org/eclipse/scripting/ScriptAdapterWorkbenchPreferencePage.java;1;0;1;1;0;0;0;1;0;0;1;1424;0;0;1;0;0;1;1;1424;0;1424;1;1;
/org.eclipse.jdt.core/model/org/eclipse/jdt/internal/core/builder/impl/ProjectBinaryOutput.java;1;0;14;1;0;0;0;14;404;4;10;455;481;481;4;4;0;14;14;1039;4;2808;10;1;
/org.eclipse.core.resources/src/org/eclipse/core/resources/IFileModificationValidator.java;2;1;6;1;2;2;2;4;126;1;4;2089;188;188;1;0;0;4;6;2089;0;4632;6;2;
/org.eclipse.jdt.ui.tests.refactoring/resources/PullUpMethods/test9/out/A.java;1;0;3;1;0;0;0;3;4;1;3;2212;4;4;1;0;0;3;3;2212;0;2406;3;1;
/org.eclipse.team.cvs.core/src/org/eclipse/team/internal/ccvs/core/syncinfo/SimpleCache.java;1;0;2;1;0;0;0;2;0;1;2;2690;0;0;1;0;0;2;2;2690;0;3125;2;1;
/org.eclipse.pde.ui/src/org/eclipse/pde/internal/editor/manifest/IDependencyGraphNode.java;2;0;2;1;0;0;0;2;0;1;2;1434;0;0;1;0;0;2;2;1434;0;3050;2;2;
/org.eclipse.jdt.ui/core refactoring/org/eclipse/jdt/internal/core/refactoring/base/JavaSourceContext.java;1;0;2;1;0;0;0;2;0;1;2;1930;0;0;1;0;0;2;2;1930;0;1939;2;1;
/org.eclipse.team.ui/src/org/eclipse/team/internal/ui/target/SiteExplorerViewLabelProvider.java;2;2;7;1;7;6;7;0;44;0;0;4213;79;79;2;0;1;0;7;4245;1;4550;6;2;
/org.eclipse.update.ui/src/org/eclipse/update/internal/ui/wizards/BannerPage.java;1;1;3;1;2;2;2;1;48;0;1;3584;50;50;1;0;0;1;3;3584;0;4297;3;1;
/org.eclipse.ui.examples.javaeditor/Java Editor Example/org/eclipse/ui/examples/javaeditor/util/JavaWordDetector.java;1;0;2;1;0;0;0;2;0;0;1;1066;0;0;2;1;0;2;2;1066;1;1066;1;1;
/org.eclipse.jdt.ui.tests.refactoring/resources/RenameType/test26/in/A.java;1;0;1;1;0;0;0;1;0;0;1;49;0;0;1;0;0;1;1;49;0;49;1;1;
/org.eclipse.swt/Eclipse SWT PI/win32/org/eclipse/swt/internal/win32/SHELLEXECUTEINFO.java;2;0;2;1;1;1;1;1;6;0;1;2069;6;6;1;0;0;1;2;2069;0;4701;2;2;
/org.eclipse.ui/Eclipse UI Tool Script/org/eclipse/toolscript/core/internal/ToolScriptRunner.java;1;2;5;1;5;4;5;0;10;0;0;3920;16;16;2;0;1;0;5;4060;1;4087;4;1;
/org.eclipse.ui/Eclipse JFace Text/org/eclipse/jface/text/contentassist/JFaceTextMessages.java;1;0;1;1;0;0;0;1;0;0;1;1066;0;0;1;0;0;1;1;1066;0;1066;1;1;
/org.eclipse.jdt.ui.tests.refactoring/resources/ExtractTemp/canExtract/A_test29_in.java;1;0;1;1;0;0;0;1;0;0;1;3210;0;0;1;0;0;1;1;3210;0;3210;1;1;
/org.eclipse.update.ui/src/org/eclipse/update/internal/ui/manager/CategoryPage.java;1;0;3;1;0;0;0;3;2;1;3;2172;2;2;1;0;0;3;3;2172;0;3537;3;1;
/org.eclipse.jdt.debug/eval/org/eclipse/jdt/internal/debug/eval/ast/instructions/OrAssignmentOperator.java;2;0;5;1;1;1;1;4;4;1;4;3421;10;10;1;0;0;4;5;3421;0;3955;5;2;
/org.eclipse.jdt.debug.ui/ui/org/eclipse/jdt/internal/debug/ui/actions/AbstractBreakpointRulerAction.java;4;2;8;2;4;3;4;4;80;1;4;3573;156;156;2;0;1;4;8;3934;1;4423;7;4;
/org.eclipse.help/Eclipse Help/org/eclipse/help/internal/util/BelongsToPluginsFileFilter.java;2;0;3;1;0;0;0;3;7;1;3;135;7;7;1;0;0;3;3;135;0;890;3;2;
/org.eclipse.swt.examples.paint/org/eclipse/swt/examples/paint/PaintView.java;3;0;5;2;1;1;1;4;548;3;2;513;548;548;3;2;0;4;5;609;2;4024;3;3;
/org.eclipse.update.core/src/org/eclipse/update/core/model/SiteCategoryModel.java;2;0;4;1;0;0;0;4;159;1;4;2409;160;160;1;0;0;4;4;2409;0;3027;4;2;
/org.eclipse.help/src/org/eclipse/help/internal/search/ProgressDistributor.java;1;1;2;1;2;2;2;0;26;0;0;4002;26;26;1;0;0;0;2;4002;0;4025;2;1;
/org.eclipse.team.ui/src/org/eclipse/team/ui/actions/DeleteAction.java;2;0;9;1;1;1;1;8;146;1;8;1978;238;238;1;0;0;8;9;1978;0;4020;9;2;
/org.eclipse.help/src/org/eclipse/help/internal/server/TocURL.java;2;0;3;1;0;0;0;3;13;1;3;1865;13;13;1;0;0;3;3;1865;0;3095;3;2;
/org.eclipse.vcm.core.cvs/src/org/eclipse/vcm/internal/core/ccvs/client/ICVSContext.java;2;0;2;1;0;0;0;2;6;1;2;0;6;6;1;0;0;2;2;0;0;298;2;2;
/org.eclipse.swt.examples.controls/src/org/eclipse/swt/examples/controls/TableTab.java;2;0;2;1;0;0;0;2;0;1;2;391;0;0;1;0;0;2;2;391;0;611;2;2;
/org.eclipse.jdt.debug.ui/ui/org/eclipse/jdt/internal/debug/ui/snippeteditor/ScrapbookLauncherDelegate.java;2;0;7;2;0;0;0;7;41;2;6;1915;65;65;2;1;0;7;7;2571;1;3055;6;2;
/org.eclipse.ui.tests/Eclipse UI Tests/org/eclipse/ui/tests/propertysheet/SelectionProviderView.java;2;0;2;1;0;0;0;2;0;1;2;1396;0;0;1;0;0;2;2;1396;0;2008;2;2;
/org.eclipse.debug.ui/ui/org/eclipse/debug/internal/ui/IDebugHelpContextIds.java;3;2;12;1;3;2;3;9;76;1;9;392;141;141;2;0;1;9;12;4122;1;4382;11;3;
/org.eclipse.jdt.ui.tests.refactoring/test cases/org/eclipse/jdt/ui/tests/refactoring/MultiMoveTests.java;2;0;7;1;0;0;0;7;28;2;6;1896;68;68;2;1;0;7;7;3286;1;3326;6;2;
/org.eclipse.team.ui/src/org/eclipse/team/internal/ui/TeamUIPlugin.java;3;2;8;1;8;7;8;0;81;0;0;4123;168;168;2;0;1;0;8;4187;1;4362;7;3;
/org.eclipse.jdt.debug.tests/test plugin/org/eclipse/jdt/debug/testplugin/Main.java;2;0;2;1;1;1;1;1;27;0;1;3701;27;27;1;0;0;1;2;3701;0;4328;2;2;
/org.eclipse.swt.examples.launcher/org/eclipse/swt/examples/launcher/LauncherView.java;5;0;7;2;1;1;1;6;234;2;5;513;366;366;2;1;0;6;7;609;1;4024;6;5;
/org.eclipse.pde.build/src/org/eclipse/pde/internal/build/Utils.java;1;1;12;1;3;3;3;9;145;2;8;3018;316;316;2;1;0;9;12;3571;1;4273;11;1;
/org.eclipse.ui/Eclipse JFace/org/eclipse/jface/action/IMenuCreator.java;2;0;2;1;0;0;0;2;5;1;2;257;5;5;1;0;0;2;2;257;0;457;2;2;
/org.eclipse.scripting/src/org/eclipse/scripting/internal/IXGRElementUIDataPresentationElement.java;1;0;1;1;0;0;0;1;0;0;1;1424;0;0;1;0;0;1;1;1424;0;1424;1;1;
/org.eclipse.swt/Eclipse SWT/motif/org/eclipse/swt/widgets/ToolItem.java;9;2;36;2;7;6;7;29;860;2;27;106;2217;2217;2;2;1;29;36;847;3;4701;33;9;
/org.eclipse.jdt.ui.tests.refactoring/resources/RenameTemp/canRename/A_test37_in.java;1;0;1;1;0;0;0;1;0;0;1;3086;0;0;1;0;0;1;1;3086;0;3086;1;1;
/org.eclipse.core.tests.resources/src/org/eclipse/core/tests/internal/resources/EarthNature.java;1;0;1;1;0;0;0;1;0;0;1;3075;0;0;1;0;0;1;1;3075;0;3075;1;1;
/org.eclipse.swt.examples/src/org/eclipse/swt/examples/controlexample/ProgressBarTab.java;5;1;8;1;4;4;4;4;169;1;4;513;347;347;1;0;0;4;8;513;0;4705;8;5;
/org.eclipse.jdt.ui.tests/refactoring/org/eclipse/jdt/refactoring/tests/RenameTempTests.java;2;0;3;1;0;0;0;3;4;1;3;1665;4;4;1;0;0;3;3;1665;0;1896;3;2;
/org.eclipse.scripting/Eclipse Scripting/org/eclipse/scripting/internal/uirenderer/XGRElementUISwtScriptPreferenceDialog.java;2;0;4;1;0;0;0;4;26;1;4;133;30;30;1;0;0;4;4;133;0;1424;4;2;
/org.eclipse.scripting/Eclipse Scripting/org/eclipse/scripting/internal/uirenderer/XGRElementUISwtWizardBuildTime.java;2;0;4;1;0;0;0;4;31;1;4;133;51;51;1;0;0;4;4;133;0;1424;4;2;
/org.eclipse.swt.examples/org/eclipse/swt/examples/controlexample/ComboTab.java;5;1;7;1;3;3;3;4;166;1;4;513;332;332;1;0;0;4;7;513;0;4024;7;5;
/org.eclipse.jdt.ui.tests.refactoring/resources/RenameTemp/canRename/A_test23_out.java;1;0;1;1;0;0;0;1;0;0;1;1625;0;0;1;0;0;1;1;1625;0;1625;1;1;
/org.eclipse.jdt.ui/ui/org/eclipse/jdt/internal/ui/javaeditor/IPositionManager.java;1;0;1;1;0;0;0;1;0;0;1;3087;0;0;1;0;0;1;1;3087;0;3087;1;1;
/org.eclipse.ui/Eclipse UI Standard Components/org/eclipse/ui/views/properties/PropertySheetAction.java;2;0;2;1;0;0;0;2;5;1;2;257;5;5;1;0;0;2;2;257;0;457;2;2;
/org.eclipse.jdt.launching/launching/org/eclipse/jdt/internal/launching/SocketUtil.java;1;0;2;1;0;0;0;2;0;1;2;3122;0;0;1;0;0;2;2;3122;0;3132;2;1;
/org.eclipse.update.tests.core/src/org/eclipse/update/tests/parser/AllParserTests.java;1;0;7;1;0;0;0;7;5;2;6;1581;13;13;2;1;0;7;7;2589;1;3018;6;1;
/org.eclipse.pde.ui/src/org/eclipse/pde/internal/editor/build/VariableSelectionDialog.java;2;0;3;1;0;0;0;3;2;1;3;1434;2;2;1;0;0;3;3;1434;0;3579;3;2;
/org.eclipse.webdav/src/kernel/org/eclipse/webdav/internal/kernel/DAVRuntimeException.java;2;0;4;1;1;1;1;3;208;1;3;1681;329;329;1;0;0;3;4;1681;0;4211;4;2;
/org.eclipse.jdt.launching/launching/org/eclipse/jdt/internal/launching/JavaLocalApplicationLaunchConfigurationDelegate.java;3;2;24;2;7;6;7;17;629;2;13;3055;994;994;2;4;1;17;24;3122;5;4572;19;3;
/org.eclipse.ui/Eclipse UI/org/eclipse/ui/internal/LayoutPart.java;5;0;8;1;0;0;0;8;35;1;8;257;83;83;1;0;0;8;8;257;0;3104;8;5;
/org.eclipse.jdt.ui.tests.refactoring/resources/RenameVirtualMethodInClass/testFail20/in/A.java;1;0;1;1;0;0;0;1;0;0;1;49;0;0;1;0;0;1;1;49;0;49;1;1;
/org.eclipse.ui/Eclipse UI/org/eclipse/ui/ISharedImages.java;3;0;3;1;0;0;0;3;24;1;3;257;29;29;1;0;0;3;3;257;0;721;3;3;
/org.eclipse.update.core/src/org/eclipse/update/core/model/FeatureModel.java;2;1;15;1;2;2;2;13;541;4;10;2409;1064;1064;4;3;0;13;15;3533;3;4448;12;2;
/org.eclipse.jdt.ui/core refactoring/org/eclipse/jdt/internal/core/refactoring/reorg/DeleteRefactoring.java;2;0;7;1;0;0;0;7;41;1;7;1258;81;81;1;0;0;7;7;1258;0;1939;7;2;
/org.eclipse.jdt.core/codeassist/org/eclipse/jdt/internal/codeassist/select/SelectionOnFieldReference.java;2;0;11;1;1;1;1;10;39;4;7;455;109;109;4;3;0;10;11;1039;3;4062;8;2;
/org.eclipse.jdt.core/dom/org/eclipse/jdt/core/dom/DefaultBindingResolver.java;3;2;38;1;6;5;6;32;466;3;25;2669;1435;1435;3;7;1;32;38;3026;8;4421;30;3;
/org.eclipse.core.resources/src/org/eclipse/core/internal/dtree/DeltaDataTree.java;3;0;10;1;1;1;1;9;1782;1;9;12;2921;2921;1;0;0;9;10;12;0;4214;10;3;
/org.eclipse.jdt.ui.tests.refactoring/resources/DeleteSourceReference/A_test3_in.java;1;0;2;1;0;0;0;2;0;1;2;2003;0;0;1;0;0;2;2;2003;0;2857;2;1;
/org.eclipse.jdt.ui.tests.refactoring/resources/ExtractMethodWorkSpace/ExtractMethodTests/expression_in/A_test611.java;1;1;4;1;2;2;2;2;2;1;2;1236;2;2;1;0;0;2;4;1236;0;4419;4;1;
/org.eclipse.jdt.ui/core refactoring/org/eclipse/jdt/core/refactoring/text/AbstractTextBufferChange.java;1;0;5;1;0;0;0;5;50;1;5;15;58;58;1;0;0;5;5;15;0;408;5;1;
/org.eclipse.ui/Eclipse JFace Text/org/eclipse/jface/text/rules/PatternRule.java;4;0;5;1;1;1;1;4;65;1;4;257;171;171;1;0;0;4;5;257;0;4838;5;4;
/org.eclipse.pde.core/src/org/eclipse/pde/internal/core/feature/WorkspaceFeatureModel.java;1;0;4;1;1;1;1;3;4;1;3;3591;7;7;1;0;0;3;4;3591;0;4711;4;1;
/org.eclipse.jdt.ui/ui/org/eclipse/jdt/internal/ui/wizards/TypedElementSelectionValidator.java;4;1;6;2;2;2;2;4;9;2;3;1254;22;22;2;1;0;4;6;1254;1;4401;5;4;
/org.eclipse.jdt.ui.tests.refactoring/resources/RenameVirtualMethodInClass/testFail4/in/A.java;1;0;1;1;0;0;0;1;0;0;1;49;0;0;1;0;0;1;1;49;0;49;1;1;
/org.eclipse.jdt.ui.tests.refactoring/resources/RenameVirtualMethodInClass/test24/in/A.java;1;0;1;1;0;0;0;1;0;0;1;49;0;0;1;0;0;1;1;49;0;49;1;1;
/org.eclipse.pde.core/src/org/eclipse/pde/internal/core/ischema/ISchemaAttribute.java;1;0;1;1;0;0;0;1;0;0;1;3591;0;0;1;0;0;1;1;3591;0;3591;1;1;
/org.eclipse.pde.ui/src/org/eclipse/pde/internal/editor/manifest/ManifestRuntimePage.java;2;0;4;1;0;0;0;4;4;1;4;1434;6;6;1;0;0;4;4;1434;0;3579;4;2;
/org.eclipse.scripting/src/org/eclipse/scripting/internal/views/ScriptUIPreviewEditorPreviewPanel.java;1;0;1;1;0;0;0;1;0;0;1;1424;0;0;1;0;0;1;1;1424;0;1424;1;1;
/org.eclipse.swt/Eclipse SWT Drag and Drop/photon/org/eclipse/swt/dnd/TableDragUnderEffect.java;3;1;5;1;2;2;2;3;6;1;3;106;20;20;1;0;0;3;5;106;0;4701;5;3;
/org.eclipse.ui.tests/Eclipse UI Tests/org/eclipse/ui/tests/api/IActionFilterTest.java;2;0;7;1;0;0;0;7;83;2;5;1403;271;271;2;2;0;7;7;1403;2;2785;5;2;
/org.eclipse.help/src/org/eclipse/help/internal/context/IContextContributionNode.java;2;0;3;1;0;0;0;3;6;1;3;2217;6;6;1;0;0;3;3;2217;0;2829;3;2;
/org.eclipse.help/src/org/eclipse/help/internal/context/IContextContributor.java;1;0;2;1;0;0;0;2;0;1;2;1675;0;0;1;0;0;2;2;1675;0;2217;2;1;
/org.eclipse.swt/Eclipse SWT PI/gtk/org/eclipse/swt/internal/gtk/GtkFrame.java;1;0;2;1;0;0;0;2;0;1;2;2107;0;0;1;0;0;2;2;2107;0;3209;2;1;
/org.eclipse.core.runtime/src/org/eclipse/core/internal/runtime/CipherOutputStream.java;3;0;4;1;1;1;1;3;86;1;3;12;107;107;1;0;0;3;4;12;0;4213;4;3;
/org.eclipse.vcm.core/src/org/eclipse/vcm/internal/core/base/IFileEdition.java;2;0;2;1;0;0;0;2;6;1;2;0;6;6;1;0;0;2;2;0;0;297;2;2;
/org.eclipse.pde.ui/Eclipse PDE UI/org/eclipse/pde/internal/base/model/IModelProvider.java;2;0;5;2;0;0;0;5;12;3;3;267;12;12;3;2;0;5;5;324;2;1434;3;2;
/org.eclipse.swt/Eclipse SWT/common_j2me/org/eclipse/swt/internal/EventObjectCompatability.java;1;0;1;1;0;0;0;1;0;0;1;1378;0;0;1;0;0;1;1;1378;0;1378;1;1;
/org.eclipse.jdt.ui.tests/refactoring/experiments/ASTMatcher.java;1;0;1;1;0;0;0;1;2;0;1;1679;2;2;1;0;0;1;1;1679;0;1679;1;1;
/org.eclipse.ui/Eclipse JFace Text/org/eclipse/jface/text/IEventConsumer.java;2;0;2;1;0;0;0;2;5;1;2;257;5;5;1;0;0;2;2;257;0;457;2;2;
/org.eclipse.pde.ui/src/org/eclipse/pde/internal/ui/editor/build/BuildSourceOutlinePage.java;1;0;1;1;0;0;0;1;0;0;1;3579;0;0;1;0;0;1;1;3579;0;3579;1;1;
/org.eclipse.ui/Eclipse UI/org/eclipse/ui/internal/EditorHistory.java;4;0;7;1;1;1;1;6;213;1;6;257;332;332;1;0;0;6;7;257;0;4692;7;4;
/org.eclipse.ui/Eclipse UI/org/eclipse/ui/part/PageBook.java;2;0;2;1;0;0;0;2;5;1;2;257;5;5;1;0;0;2;2;257;0;457;2;2;
/org.eclipse.swt/Eclipse SWT/win32/org/eclipse/swt/internal/win32/DRAWITEMSTRUCT.java;2;0;3;1;0;0;0;3;5;1;3;106;5;5;1;0;0;3;3;106;0;2069;3;2;
/org.eclipse.team.ui/src/org/eclipse/team/ui/TeamImages.java;3;1;7;1;7;7;7;0;26;0;0;4123;56;56;1;0;0;0;7;4123;0;4707;7;3;
/org.eclipse.update.ui/src/org/eclipse/update/internal/ui/pages/UpdateFormPage.java;1;0;2;1;1;1;1;1;44;0;1;3662;44;44;1;0;0;1;2;3662;0;4606;2;1;
/org.eclipse.jdt.ui.tests/refactoring/org/eclipse/jdt/refactoring/tests/PathTransformationTests.java;4;0;7;1;0;0;0;7;37;1;7;49;68;68;1;0;0;7;7;49;0;1896;7;4;
/org.eclipse.jdt.junit/Eclipse JUnit/org/eclipse/jdt/internal/junit/ui/TabFolderLayout.java;2;0;3;1;0;0;0;3;4;1;3;2007;4;4;1;0;0;3;3;2007;0;3313;3;2;
/org.eclipse.compare/compare/org/eclipse/compare/internal/DiffImage.java;1;0;5;1;0;0;0;5;51;1;5;14;64;64;1;0;0;5;5;14;0;489;5;1;
/org.eclipse.pde.ui/src/org/eclipse/pde/internal/base/model/build/IBuild.java;2;0;2;1;0;0;0;2;0;1;2;1434;0;0;1;0;0;2;2;1434;0;3039;2;2;
/org.eclipse.pde.ui/src/org/eclipse/pde/IExtensionWizard.java;1;0;2;1;0;0;0;2;0;1;2;3039;0;0;1;0;0;2;2;3039;0;3579;2;1;
/org.eclipse.jdt.ui.tests.refactoring/resources/RenameType/test29/in/C.java;1;0;1;1;0;0;0;1;0;0;1;49;0;0;1;0;0;1;1;49;0;49;1;1;
/org.eclipse.jdt.ui/core refactoring/org/eclipse/jdt/internal/core/refactoring/nls/changes/CreateFileChange.java;2;0;3;1;0;0;0;3;4;2;2;1922;4;4;2;1;0;3;3;1922;1;1939;2;2;
/org.eclipse.vcm.core.cvs/src/org/eclipse/vcm/internal/core/ccvs/CVSResource.java;6;0;14;2;0;0;0;14;25;2;12;0;103;103;2;2;0;14;14;17;2;1584;12;6;
/org.eclipse.jdt.ui.tests.refactoring/resources/RenameMethodInInterface/test35/in/A.java;1;0;1;1;0;0;0;1;0;0;1;49;0;0;1;0;0;1;1;49;0;49;1;1;
/org.eclipse.core.tests.resources/src/org/eclipse/core/tests/resources/MarkerAttributeChangeListener.java;3;0;4;1;1;1;1;3;130;1;3;1794;150;150;1;0;0;3;4;1794;0;4516;4;3;
/org.eclipse.jdt.ui/core refactoring/org/eclipse/jdt/internal/corext/refactoring/code/flow/WhileFlowInfo.java;1;0;1;1;0;0;0;1;0;0;1;1939;0;0;1;0;0;1;1;1939;0;1939;1;1;
/org.eclipse.jdt.debug.tests/tests/org/eclipse/jdt/debug/tests/eval/IntOperatorsTests.java;2;2;3;2;3;2;3;0;17;0;0;4447;19;19;2;0;1;0;3;4447;1;4571;2;2;
/org.eclipse.swt/Eclipse SWT/photon/org/eclipse/swt/internal/photon/PgDisplaySettings_t.java;2;0;2;1;0;0;0;2;0;1;2;621;0;0;1;0;0;2;2;621;0;2069;2;2;
/org.eclipse.jdt.ui/core refactoring/org/eclipse/jdt/internal/core/refactoring/rename/RenameMethodRefactoring.java;2;0;11;2;0;0;0;11;169;3;9;1342;215;215;3;2;0;11;11;1937;2;1937;9;2;
/org.eclipse.jdt.ui.tests.refactoring/resources/RenamePrivateMethod/test2/out/A.java;1;0;1;1;0;0;0;1;0;0;1;49;0;0;1;0;0;1;1;49;0;49;1;1;
/org.eclipse.jdt.ui.tests.refactoring/test cases/org/eclipse/jdt/ui/tests/refactoring/SurroundWithTestSetup.java;2;0;3;1;1;1;1;2;2;1;2;2327;3;3;1;0;0;2;3;2327;0;4081;3;2;
/org.eclipse.scripting/Eclipse Scripting/org/eclipse/scripting/internal/ScriptReaderString.java;1;0;3;1;0;0;0;3;4;1;3;133;4;4;1;0;0;3;3;133;0;1424;3;1;
/org.eclipse.swt.tests/JUnit Tests/org/eclipse/swt/tests/junit/Test_org_eclipse_swt_widgets_Scale.java;2;0;2;1;1;1;1;1;6;0;1;1792;6;6;1;0;0;1;2;1792;0;4706;2;2;
/org.eclipse.jdt.junit/src/org/eclipse/jdt/internal/junit/runner/RemoteTestRunner.java;4;1;8;1;2;2;2;6;53;1;6;3171;87;87;1;0;0;6;8;3171;0;4742;8;4;
/org.eclipse.jdt.core/model/org/eclipse/jdt/internal/core/util/DiskCacheEntry.java;1;0;4;1;0;0;0;4;13;1;4;455;23;23;1;0;0;4;4;455;0;2811;4;1;
/org.eclipse.core.resources/src/org/eclipse/core/internal/resources/Marker.java;2;0;10;1;1;1;1;9;564;1;9;12;704;704;1;0;0;9;10;12;0;4213;10;2;
/org.eclipse.swt/Eclipse SWT Drag and Drop/gtk1x/org/eclipse/swt/dnd/FileTransfer.java;2;0;2;1;0;0;0;2;0;1;2;2107;0;0;1;0;0;2;2;2107;0;3127;2;2;
/org.eclipse.team.cvs.core/src/org/eclipse/team/internal/ccvs/core/CVSTag.java;3;0;11;1;0;0;0;11;152;1;11;2156;246;246;1;0;0;11;11;2156;0;3746;11;3;
/org.eclipse.webdav/src/client/org/eclipse/webdav/client/ResourceHandle.java;3;0;5;1;1;1;1;4;250;1;4;12;433;433;1;0;0;4;5;12;0;4211;5;3;
/org.eclipse.ui/Eclipse UI/org/eclipse/ui/internal/dialogs/EditorSelectionDialog.java;5;0;9;1;0;0;0;9;41;1;9;257;136;136;1;0;0;9;9;257;0;3029;9;5;
/org.eclipse.pde.ui/src/org/eclipse/pde/internal/ui/editor/manifest/PluginSpecSection.java;1;0;3;1;1;1;1;2;28;0;1;3579;29;29;2;1;0;2;3;3579;1;4428;2;1;
/org.eclipse.swt.examples/Eclipse SWT Examples/common/org/eclipse/swt/examples/controlexample/SashTab.java;1;0;2;1;0;0;0;2;0;1;2;107;0;0;1;0;0;2;2;107;0;611;2;1;
/org.eclipse.team.cvs.core/src/org/eclipse/team/internal/ccvs/core/streams/PollingOutputStream.java;2;1;5;1;2;2;2;3;22;1;3;3574;42;42;1;0;0;3;5;3574;0;4169;5;2;
/org.eclipse.update.core/src/org/eclipse/update/internal/core/InvalidSiteTypeException.java;2;0;3;1;0;0;0;3;1;1;3;2251;1;1;1;0;0;3;3;2251;0;2583;3;2;
/org.eclipse.jdt.debug/model/org/eclipse/jdt/internal/debug/core/LineBreakpoint.java;1;0;1;1;0;0;0;1;0;0;1;831;0;0;1;0;0;1;1;831;0;831;1;1;
/org.eclipse.vcm.ui/src/org/eclipse/vcm/internal/ui/DetailsDialog.java;2;0;3;1;0;0;0;3;12;1;3;377;14;14;1;0;0;3;3;377;0;1628;3;2;
/org.eclipse.team.cvs.core/src/org/eclipse/team/internal/ccvs/core/streams/LFtoCRLFInputStream.java;2;0;2;1;1;1;1;1;0;0;1;3574;0;0;1;0;0;1;2;3574;0;4169;2;2;
/org.eclipse.jdt.ui.tests.refactoring/resources/MoveMembers/test5/in/B.java;1;0;1;1;0;0;0;1;0;0;1;2738;0;0;1;0;0;1;1;2738;0;2738;1;1;
/org.eclipse.jdt.ui.tests.refactoring/resources/DeleteSourceReference/A_test0_out.java;1;0;2;1;0;0;0;2;0;1;2;2003;0;0;1;0;0;2;2;2003;0;2857;2;1;
/org.eclipse.jdt.ui.tests.refactoring/resources/ExtractMethodWorkSpace/ExtractMethodTests/locals_out/A_test558.java;1;1;4;1;2;2;2;2;34;1;2;1236;36;36;1;0;0;2;4;1236;0;4419;4;1;
/org.eclipse.jdt.debug/jdi interfaces/com/sun/jdi/ArrayReference.java;2;0;2;1;0;0;0;2;18;1;2;2704;18;18;1;0;0;2;2;2704;0;3033;2;2;
/org.eclipse.swt/Eclipse SWT Drag and Drop/motif/org/eclipse/swt/dnd/TransferData.java;3;1;5;1;3;3;3;2;39;1;2;106;75;75;1;0;0;2;5;106;0;4701;5;3;
/org.eclipse.help/src/org/eclipse/help/internal/protocols/help/Handler.java;2;0;3;1;0;0;0;3;11;1;3;1420;11;11;1;0;0;3;3;1420;0;2694;3;2;
/org.eclipse.jdt.debug/model/org/eclipse/jdt/internal/debug/core/JavaHotCodeReplaceManager.java;3;0;23;1;0;0;0;23;239;2;21;187;779;779;2;2;0;23;23;1801;2;2517;21;3;
/org.eclipse.pde.ui/src/org/eclipse/pde/internal/ui/wizards/templates/TemplateEditorInput.java;1;0;1;1;0;0;0;1;0;0;1;3579;0;0;1;0;0;1;1;3579;0;3579;1;1;
/org.eclipse.ui.tests/UI Test Utils/org/eclipse/ui/tests/util/ArrayUtil.java;1;0;1;1;0;0;0;1;0;0;1;2785;0;0;1;0;0;1;1;2785;0;2785;1;1;
/org.eclipse.pde.ui/src/org/eclipse/pde/model/build/IBuildModelFactory.java;1;0;2;1;0;0;0;2;0;1;2;3039;0;0;1;0;0;2;2;3039;0;3579;2;1;
/org.eclipse.jdt.ui/ui/org/eclipse/jdt/internal/ui/JavaPerspectiveFactory.java;5;0;16;1;1;1;1;15;30;1;15;15;99;99;1;0;0;15;16;15;0;4036;16;5;
/org.eclipse.jdt.ui/ui/org/eclipse/jdt/internal/ui/wizards/NewProjectCreationWizard.java;4;0;16;1;1;1;1;15;111;2;14;15;364;364;2;1;0;15;16;144;1;4076;15;4;
/org.eclipse.update.ui.forms/src/org/eclipse/update/ui/forms/internal/HyperlinkHandler.java;1;1;5;1;2;2;2;3;309;1;3;2470;453;453;1;0;0;3;5;2470;0;4217;5;1;
/org.eclipse.team.ui/src/org/eclipse/team/internal/ui/target/SiteExplorerView.java;4;2;20;2;20;14;20;0;409;0;0;4164;940;940;2;0;6;0;20;4164;6;4636;14;4;
/org.eclipse.update.tests.core/src/org/eclipse/update/tests/parser/TestSiteGeneration.java;2;0;9;2;0;0;0;9;32;2;8;1948;79;79;2;1;0;9;9;2583;1;3018;8;2;
/org.eclipse.jdt.ui.tests.refactoring/resources/MoveMembers/testFail19/in/A.java;1;0;1;1;0;0;0;1;0;0;1;2928;0;0;1;0;0;1;1;2928;0;2928;1;1;
/org.eclipse.jdt.ui.tests.refactoring/resources/StructureSelectionAction/A_test14.java;1;0;1;1;0;0;0;1;0;0;1;2139;0;0;1;0;0;1;1;2139;0;2139;1;1;
/org.eclipse.jdt.debug/jdi interfaces/com/sun/jdi/ReferenceType.java;2;0;2;1;0;0;0;2;49;1;2;2704;49;49;1;0;0;2;2;2704;0;3033;2;2;
/org.eclipse.jdt.ui.tests/refactoring/org/eclipse/jdt/refactoring/tests/ExtractMethodTests.java;4;0;29;1;0;0;0;29;336;2;23;49;975;975;2;6;0;29;29;237;6;1896;23;4;
/org.eclipse.update.ui.forms/src/org/eclipse/update/ui/forms/internal/HyperlinkAdapter.java;1;0;1;1;0;0;0;1;0;0;1;2470;0;0;1;0;0;1;1;2470;0;2470;1;1;
/org.eclipse.swt/Eclipse SWT Drag and Drop/common/org/eclipse/swt/dnd/DropTargetAdapter.java;2;1;4;1;2;2;2;2;47;1;2;106;59;59;1;0;0;2;4;106;0;4824;4;2;
/org.eclipse.pde.ui/src/org/eclipse/pde/internal/ui/util/OverlayIcon.java;1;0;1;1;0;0;0;1;0;0;1;3579;0;0;1;0;0;1;1;3579;0;3579;1;1;
/org.eclipse.pde.build/src/antlib/org/eclipse/pde/internal/core/JDTCompilerAdapter.java;1;0;1;1;0;0;0;1;0;0;1;3475;0;0;1;0;0;1;1;3475;0;3475;1;1;
/org.eclipse.compare/compare/org/eclipse/compare/IModificationDate.java;2;0;3;1;0;0;0;3;5;1;3;14;8;8;1;0;0;3;3;14;0;1802;3;2;
/org.eclipse.jdt.ui.tests.refactoring/resources/RenameParameters/canRename/A_test26_in.java;1;0;1;1;0;0;0;1;0;0;1;233;0;0;1;0;0;1;1;233;0;233;1;1;
/org.eclipse.swt.examples.paint/org/eclipse/swt/examples/paint/MetaEllipse.java;1;0;1;1;0;0;0;1;0;0;1;513;0;0;1;0;0;1;1;513;0;513;1;1;
/org.eclipse.jdt.ui.tests.refactoring/resources/RenameType/testFail74/in/A.java;1;0;1;1;0;0;0;1;0;0;1;49;0;0;1;0;0;1;1;49;0;49;1;1;
/org.eclipse.swt.examples/Eclipse SWT Examples/common/org/eclipse/swt/examples/hover/HoverHelpExample.java;1;0;2;1;0;0;0;2;0;1;2;107;0;0;1;0;0;2;2;107;0;611;2;1;
/org.eclipse.scripting/Eclipse Scripting/org/eclipse/scripting/internal/views/ScriptUIEditorActionManager.java;2;0;4;1;0;0;0;4;31;1;4;133;45;45;1;0;0;4;4;133;0;1424;4;2;
/org.eclipse.pde.ui/Eclipse PDE UI/org/eclipse/pde/internal/editor/text/PDEScanner.java;2;0;5;2;0;0;0;5;12;3;3;267;12;12;3;2;0;5;5;324;2;1434;3;2;
/org.eclipse.update.tests.core/src/org/eclipse/update/tests/core/boot/TestPlatCfgAPI.java;2;0;4;1;0;0;0;4;51;1;4;2082;78;78;1;0;0;4;4;2082;0;3107;4;2;
/org.eclipse.core.tests.resources/src/org/eclipse/core/tests/internal/indexing/StandAloneIndexedStoreTest.java;3;0;4;1;1;1;1;3;32;1;3;1794;54;54;1;0;0;3;4;1794;0;4516;4;3;
/org.eclipse.swt/Eclipse SWT Drag and Drop/common/org/eclipse/swt/dnd/DropTargetEvent.java;2;1;7;1;2;2;2;5;87;1;5;106;130;130;1;0;0;5;7;106;0;4824;7;2;
/org.eclipse.vcm.core.cvs/src/org/eclipse/vcm/internal/core/ccvs/client/SetStaticHandler.java;1;0;1;1;0;0;0;1;0;0;1;1372;0;0;1;0;0;1;1;1372;0;1372;1;1;
/org.eclipse.swt.examples/Eclipse SWT Examples/common/org/eclipse/swt/examples/explorer/TreeScrollDropListener.java;1;0;1;1;0;0;0;1;0;0;1;480;0;0;1;0;0;1;1;480;0;480;1;1;
/org.eclipse.team.cvs.core/src/org/eclipse/team/internal/ccvs/core/syncinfo/ReentrantLock.java;2;0;2;1;0;0;0;2;12;1;2;3703;12;12;1;0;0;2;2;3703;0;3739;2;2;
/org.eclipse.help/src/org/eclipse/help/internal/contributors/ContributorCreator.java;2;0;2;1;0;0;0;2;0;1;2;1420;0;0;1;0;0;2;2;1420;0;1675;2;2;
/org.eclipse.jdt.ui.tests.refactoring/resources/ExtractMethodWorkSpace/ExtractMethodTests/try_in/A_test454.java;2;1;3;1;2;2;2;1;10;0;1;511;10;10;1;0;0;1;3;511;0;4419;3;2;
/org.eclipse.swt.examples.launcher/src/org/eclipse/swt/examples/launcher/ViewLaunchDelegate.java;2;0;2;1;0;0;0;2;0;1;2;391;0;0;1;0;0;2;2;391;0;611;2;2;
/org.eclipse.jdt.debug/model/org/eclipse/jdt/debug/core/IJavaType.java;1;0;4;1;0;0;0;4;51;1;4;1623;67;67;1;0;0;4;4;1623;0;3573;4;1;
/org.eclipse.jdt.ui/ui/org/eclipse/jdt/internal/ui/reorg/CUOrFileReorgSupport.java;3;0;7;1;0;0;0;7;19;1;7;15;50;50;1;0;0;7;7;15;0;1258;7;3;
/org.eclipse.team.cvs.ui/src/org/eclipse/team/internal/ccvs/ui/wizards/ModuleSelectionPage.java;2;1;4;1;2;2;2;2;6;1;2;2577;14;14;1;0;0;2;4;2577;0;4626;4;2;
/org.eclipse.help.webapp/src/org/eclipse/help/servlet/Tocs.java;3;0;9;1;0;0;0;9;146;1;9;2409;328;328;1;0;0;9;9;2409;0;3449;9;3;
/org.eclipse.team.core/src/org/eclipse/team/core/target/ITargetRunnable.java;2;1;2;1;2;2;2;0;0;0;0;4385;0;0;1;0;0;0;2;4385;0;4636;2;2;
/org.eclipse.ui/Eclipse UI Standard Components/org/eclipse/ui/views/tasklist/TaskList.java;7;2;38;2;4;3;4;34;175;2;31;257;1124;1124;2;3;1;34;38;2830;4;4385;34;7;
/org.eclipse.vcm.ui.cvs/src/org/eclipse/vcm/internal/ui/ccvs/FilterStreamAction.java;2;0;4;1;0;0;0;4;120;1;4;1044;228;228;1;0;0;4;4;1044;0;1436;4;2;
/org.eclipse.jdt.ui.tests/JUnit/junit/tests/ThreadTest.java;2;0;2;1;0;0;0;2;0;1;2;49;0;0;1;0;0;2;2;49;0;1186;2;2;
/org.eclipse.pde.core/src/org/eclipse/pde/internal/core/plugin/WorkspaceFragmentModel.java;1;0;1;1;0;0;0;1;0;0;1;3591;0;0;1;0;0;1;1;3591;0;3591;1;1;
/org.eclipse.core.runtime/src/org/eclipse/core/internal/plugins/FragmentDescriptor.java;3;0;6;1;2;1;2;4;20;1;4;44;34;34;2;0;1;4;6;4212;1;4212;5;3;
/org.eclipse.jdt.core/model/org/eclipse/jdt/internal/core/builder/impl/PackageMap.java;1;0;10;1;0;0;0;10;48;4;6;455;105;105;4;4;0;10;10;1039;4;2808;6;1;
/org.eclipse.jdt.ui/core refactoring/org/eclipse/jdt/internal/corext/refactoring/nls/NLSRefactoring.java;3;1;22;1;6;6;6;16;35;2;14;1939;221;221;2;2;0;16;22;2133;2;4598;20;3;
/org.eclipse.scripting/Eclipse Scripting/org/eclipse/scripting/internal/ScriptConstants.java;1;0;3;1;0;0;0;3;4;1;3;133;4;4;1;0;0;3;3;133;0;1424;3;1;
/org.eclipse.jdt.ui/core refactoring/org/eclipse/jdt/core/refactoring/methods/RenamePrivateMethodRefactoring.java;1;0;7;1;0;0;0;7;17;2;6;15;48;48;2;1;0;7;7;25;1;408;6;1;
/org.eclipse.scripting/Eclipse Scripting/org/eclipse/scripting/internal/views/ScriptDevelopmentWizard.java;2;0;4;1;0;0;0;4;28;1;4;133;51;51;1;0;0;4;4;133;0;1424;4;2;
/org.eclipse.scripting/Eclipse Scripting/org/eclipse/scripting/internal/views/ScriptDevelopmentWizardPageFileName.java;2;0;6;1;0;0;0;6;47;1;6;133;106;106;1;0;0;6;6;133;0;1424;6;2;
/org.eclipse.swt.examples.paint/src/org/eclipse/swt/examples/paint/RoundedRectangleFigure.java;4;0;5;2;1;1;1;4;66;2;3;586;83;83;2;1;0;4;5;609;1;4705;4;4;
/org.eclipse.jdt.debug/jdi/org/eclipse/jdi/internal/event/VMStartEventImpl.java;2;0;4;1;0;0;0;4;18;1;4;187;32;32;1;0;0;4;4;187;0;3670;4;2;
/org.eclipse.jdt.debug.ui/ui/org/eclipse/jdt/internal/debug/ui/actions/ToggleStepFilterAction.java;2;0;5;1;1;1;1;4;94;1;4;1915;108;108;1;0;0;4;5;1915;0;4371;5;2;
/org.eclipse.update.ui/src/org/eclipse/update/internal/ui/forms/UIProblemHandler.java;2;0;2;1;0;0;0;2;8;1;2;3662;8;8;1;0;0;2;2;3662;0;3682;2;2;
/org.eclipse.pde.ui/Eclipse PDE UI/org/eclipse/pde/internal/PDEPerspective.java;2;0;7;2;0;0;0;7;12;3;5;267;17;17;3;2;0;7;7;324;2;1434;5;2;
/org.eclipse.jdt.ui/core codemanipulation/org/eclipse/jdt/internal/core/codemanipulation/TextBufferEditor.java;1;0;3;1;0;0;0;3;4;1;3;1800;4;4;1;0;0;3;3;1800;0;1937;3;1;
/org.eclipse.ui/Eclipse UI Tool Script/org/eclipse/toolscript/ui/internal/AntAction.java;1;1;3;1;3;3;3;0;2;0;0;4022;2;2;1;0;0;0;3;4022;0;4087;3;1;
/org.eclipse.ui/Eclipse JFace/org/eclipse/jface/dialogs/DialogPage.java;3;0;6;1;0;0;0;6;41;1;6;257;128;128;1;0;0;6;6;257;0;3680;6;3;
/org.eclipse.jdt.ui.tests.refactoring/resources/PasteSourceReference/test2/in/A.java;1;0;1;1;0;0;0;1;0;0;1;2859;0;0;1;0;0;1;1;2859;0;2859;1;1;
/org.eclipse.pde.ui/src/org/eclipse/pde/model/build/IBuildEntry.java;1;0;2;1;0;0;0;2;0;1;2;3039;0;0;1;0;0;2;2;3039;0;3579;2;1;
/org.eclipse.jdt.ui.tests.refactoring/resources/ExtractMethodWorkSpace/ExtractMethodTests/invalidSelection/A_test045.java;2;1;3;1;2;2;2;1;0;0;1;49;0;0;1;0;0;1;3;49;0;4419;3;2;
/org.eclipse.pde.build/src/org/eclipse/pde/internal/build/FragmentBuildScriptGenerator.java;5;1;14;1;2;2;2;12;50;2;11;245;116;116;2;1;0;12;14;3571;1;4273;13;5;
/org.eclipse.pde.ui/src/org/eclipse/pde/internal/base/model/feature/IFeatureData.java;1;0;3;1;0;0;0;3;70;1;3;3468;70;70;1;0;0;3;3;3468;0;3579;3;1;
/org.eclipse.jdt.ui/ui/org/eclipse/jdt/internal/ui/dialogs/MultiElementListSelectionDialog.java;6;0;22;2;1;1;1;21;220;2;18;15;561;561;2;3;0;21;22;1267;3;4376;19;6;
/org.eclipse.swt/Eclipse SWT Custom Widgets/common_j2se/org/eclipse/swt/custom/StyledTextBidi.java;1;0;1;1;0;0;0;1;0;0;1;1378;0;0;1;0;0;1;1;1378;0;1378;1;1;
/org.eclipse.jdt.ui/ui/org/eclipse/jdt/internal/ui/preferences/ColorEditor.java;1;0;1;1;0;0;0;1;0;0;1;1864;0;0;1;0;0;1;1;1864;0;1864;1;1;
/org.eclipse.swt/Eclipse SWT/gtk1x/org/eclipse/swt/widgets/Widget.java;4;0;6;1;1;1;1;5;34;2;4;2107;76;76;2;1;0;5;6;2807;1;4701;5;4;
/org.eclipse.jdt.ui/ui/org/eclipse/jdt/internal/ui/packageview/FrameList.java;1;0;3;1;0;0;0;3;4;1;3;213;4;4;1;0;0;3;3;213;0;390;3;1;
/org.eclipse.jdt.ui.tests.refactoring/resources/RenameType/test27/in/A.java;1;0;1;1;0;0;0;1;0;0;1;49;0;0;1;0;0;1;1;49;0;49;1;1;
/org.eclipse.pde.ui/src/org/eclipse/pde/internal/ui/editor/PropertiesAction.java;1;0;1;1;0;0;0;1;0;0;1;3579;0;0;1;0;0;1;1;3579;0;3579;1;1;
/org.eclipse.pde.ui/src/org/eclipse/pde/internal/ui/editor/manifest/ExtensionElementPropertySource.java;1;0;4;1;1;1;1;3;10;2;2;3579;14;14;2;1;0;3;4;3579;1;4167;3;1;
/org.eclipse.update/src/org/eclipse/update/internal/ui/UMWizardPageLocations.java;1;0;1;1;0;0;0;1;0;0;1;1424;0;0;1;0;0;1;1;1424;0;1424;1;1;
/org.eclipse.ui/Eclipse JFace Text/org/eclipse/jface/text/DefaultUndoManager.java;5;1;10;1;3;3;3;7;193;1;7;257;355;355;1;0;0;7;10;257;0;4838;10;5;
/org.eclipse.swt.examples/Eclipse SWT Examples/common/org/eclipse/swt/examples/controlexample/LabelTab.java;1;0;2;1;0;0;0;2;0;1;2;107;0;0;1;0;0;2;2;107;0;611;2;1;
/org.eclipse.pde.ui/src/org/eclipse/pde/internal/model/PluginReference.java;1;0;3;1;0;0;0;3;2;1;3;2477;2;2;1;0;0;3;3;2477;0;3136;3;1;
/org.eclipse.help/src/org/eclipse/help/internal/HelpSystem.java;3;0;17;2;0;0;0;17;151;2;16;1420;412;412;2;1;0;17;17;1683;1;3793;16;3;
/org.eclipse.jdt.ui.tests.refactoring/resources/ExtractMethodWorkSpace/ExtractMethodTests/return_in/A_test701.java;1;1;3;1;2;2;2;1;8;0;1;887;8;8;1;0;0;1;3;887;0;4419;3;1;
/org.eclipse.jdt.ui/core refactoring/org/eclipse/jdt/core/refactoring/IChange.java;1;0;4;1;0;0;0;4;5;1;4;15;9;9;1;0;0;4;4;15;0;408;4;1;
/org.eclipse.pde.ui/Eclipse PDE UI/org/eclipse/pde/internal/wizards/project/ConvertJavaToPDEProjectAction.java;2;0;6;2;0;0;0;6;12;3;4;267;17;17;3;2;0;6;6;324;2;1434;4;2;
/org.eclipse.help.tests/src/org/eclipse/help/tests/base/AllNavigationTests.java;1;0;2;1;0;0;0;2;0;1;2;1642;0;0;1;0;0;2;2;1642;0;1805;2;1;
/org.eclipse.jdt.ui/core refactoring/org/eclipse/jdt/internal/core/nls/model/NLSScanner.java;1;0;2;1;0;0;0;2;0;1;2;1913;0;0;1;0;0;2;2;1913;0;1922;2;1;
/org.eclipse.jdt.ui.tests.refactoring/resources/RenamePackage/test5/out/p1/A.java;1;0;1;1;0;0;0;1;0;0;1;1274;0;0;1;0;0;1;1;1274;0;1274;1;1;
/org.eclipse.pde.ui/src/org/eclipse/pde/core/plugin/IPluginModelBase.java;1;0;3;1;0;0;0;3;9;2;2;3579;9;9;2;1;0;3;3;3579;1;3607;2;1;
/org.eclipse.pde.ui/src/org/eclipse/pde/internal/core/schema/SchemaType.java;1;0;3;1;0;0;0;3;2;1;3;3579;2;2;1;0;0;3;3;3579;0;3607;3;1;
/org.eclipse.jdt.debug/eval/org/eclipse/jdt/internal/debug/eval/ast/engine/RuntimeContext.java;1;0;1;1;0;0;0;1;0;0;1;3645;0;0;1;0;0;1;1;3645;0;3645;1;1;
/org.eclipse.jdt.ui.tests.refactoring/resources/ExtractMethodWorkSpace/ExtractMethodTests/invalidSelection/A_test190.java;1;1;3;1;2;2;2;1;34;0;1;1236;34;34;1;0;0;1;3;1236;0;4419;3;1;
/org.eclipse.pde.core/src/org/eclipse/pde/internal/core/plugin/PluginParent.java;1;0;2;1;0;0;0;2;8;1;2;3591;8;8;1;0;0;2;2;3591;0;3687;2;1;
/org.eclipse.jdt.ui.tests.refactoring/resources/MoveMembers/test3/in/B.java;1;0;1;1;0;0;0;1;0;0;1;2738;0;0;1;0;0;1;1;2738;0;2738;1;1;
/org.eclipse.jdt.core/compiler/org/eclipse/jdt/internal/compiler/classfmt/MethodInfo.java;2;1;17;1;3;3;3;14;379;4;10;455;821;821;4;4;0;14;17;1039;4;4062;13;2;
/org.eclipse.jdt.core/eval/org/eclipse/jdt/internal/eval/CodeSnippetEnvironment.java;2;1;6;1;2;2;2;4;107;1;4;455;143;143;1;0;0;4;6;455;0;4062;6;2;
/org.eclipse.pde.ui/src/org/eclipse/pde/internal/core/AbstractModel.java;1;0;3;1;0;0;0;3;16;2;2;3579;16;16;2;1;0;3;3;3579;1;3607;2;1;
/org.eclipse.jdt.debug/eval/org/eclipse/jdt/internal/debug/eval/ast/engine/GreaterOperator.java;1;0;2;1;0;0;0;2;0;1;2;3329;0;0;1;0;0;2;2;3329;0;3421;2;1;
/org.eclipse.ui/Eclipse UI Standard Components/org/eclipse/ui/views/navigator/IResourceNavigatorPart.java;3;0;7;1;1;1;1;6;86;2;5;1726;122;122;2;1;0;6;7;1830;1;4067;6;3;
/org.eclipse.scripting/Eclipse Scripting/org/eclipse/scripting/internal/views/ScriptDevelopmentPreferencePageWorkbenchExport.java;2;0;4;1;0;0;0;4;8;1;4;133;15;15;1;0;0;4;4;133;0;1424;4;2;
/org.eclipse.pde.build/src/plugin/org/eclipse/pde/internal/core/AbstractScriptGenerator.java;1;0;1;1;0;0;0;1;0;0;1;3475;0;0;1;0;0;1;1;3475;0;3475;1;1;
/org.eclipse.ui/Eclipse UI/org/eclipse/ui/internal/PinEditorAction.java;2;0;9;1;0;0;0;9;250;2;8;1388;307;307;2;1;0;9;9;3051;1;3471;8;2;
/org.eclipse.core.resources/src/org/eclipse/core/resources/IWorkspaceRunnable.java;2;0;5;1;1;1;1;4;74;1;4;12;101;101;1;0;0;4;5;12;0;4214;5;2;
/org.eclipse.pde.ui/Eclipse PDE UI/org/eclipse/pde/internal/model/PluginExtensionPoint.java;2;0;7;2;0;0;0;7;12;3;5;267;18;18;3;2;0;7;7;324;2;1434;5;2;
/org.eclipse.swt.examples.paint/org/eclipse/swt/examples/paint/PaintSurface.java;4;0;8;2;1;1;1;7;69;5;3;513;71;71;5;4;0;7;8;609;4;4024;4;4;
/org.eclipse.jdt.debug.ui/ui/org/eclipse/jdt/internal/debug/ui/actions/JavaBreakpointPreferenceStore.java;1;0;1;1;1;1;1;0;0;0;0;4410;0;0;1;0;0;0;1;4410;0;4410;1;1;
/org.eclipse.jdt.core/eval/org/eclipse/jdt/internal/eval/CodeSnippetToCuMapper.java;4;2;26;2;5;4;5;21;609;4;16;455;1059;1059;4;5;1;21;26;1039;6;4545;20;4;
/org.eclipse.jdt.ui/core refactoring/org/eclipse/jdt/internal/core/refactoring/reorg/ReorgRefactoring.java;2;0;6;1;0;0;0;6;92;1;6;1258;119;119;1;0;0;6;6;1258;0;1939;6;2;
/org.eclipse.team.cvs.core/src/org/eclipse/team/internal/ccvs/core/response/DefaultHandler.java;3;0;3;1;0;0;0;3;4;1;3;1978;4;4;1;0;0;3;3;1978;0;2607;3;3;
/org.eclipse.jdt.ui/ui/org/eclipse/jdt/internal/ui/viewsupport/OverrideAdornmentProvider.java;2;0;4;1;1;1;1;3;25;1;3;3068;46;46;1;0;0;3;4;3068;0;4018;4;2;
/org.eclipse.pde.ui/Eclipse PDE UI/org/eclipse/pde/internal/preferences/ExternalPluginsEditor.java;2;0;7;2;0;0;0;7;12;3;5;267;16;16;3;2;0;7;7;324;2;1434;5;2;
/org.eclipse.jdt.ui.tests.refactoring/resources/RenameType/testFail85/in/A.java;1;0;1;1;0;0;0;1;0;0;1;49;0;0;1;0;0;1;1;49;0;49;1;1;
/org.eclipse.jdt.ui.tests/JUnit/junit/util/ReloadingTestSuiteLoader.java;2;0;2;1;0;0;0;2;0;1;2;49;0;0;1;0;0;2;2;49;0;1186;2;2;
/org.eclipse.jdt.ui/ui/org/eclipse/jdt/internal/ui/reorg/MoveAction.java;5;0;27;2;0;0;0;27;277;3;24;15;901;901;3;3;0;27;27;1338;3;3222;24;5;
/org.eclipse.jdt.debug/jdi/org/eclipse/jdi/internal/DoubleTypeImpl.java;2;0;4;1;0;0;0;4;13;1;4;187;27;27;1;0;0;4;4;187;0;3670;4;2;
/org.eclipse.jdt.ui.tests/JUnit/junit/tests/SuiteTest.java;2;0;2;1;0;0;0;2;0;1;2;49;0;0;1;0;0;2;2;49;0;1186;2;2;
/org.eclipse.pde.ui/src/org/eclipse/pde/internal/ui/wizards/templates/MultiPageEditorTemplate.java;1;1;6;1;2;2;2;4;83;1;4;3579;136;136;1;0;0;4;6;3579;0;4316;6;1;
/org.eclipse.jdt.ui/ui/org/eclipse/jdt/ui/actions/AddUnimplementedConstructorsAction.java;3;1;12;1;7;7;7;5;86;1;5;3533;165;165;1;0;0;5;12;3533;0;4770;12;3;
/org.eclipse.pde.ui/Eclipse PDE UI/org/eclipse/pde/internal/editor/PDESourcePage.java;2;0;6;2;0;0;0;6;12;3;4;267;22;22;3;2;0;6;6;324;2;1434;4;2;
/org.eclipse.ui/Eclipse UI/org/eclipse/ui/internal/NextPageAction.java;4;0;4;1;0;0;0;4;6;1;4;257;8;8;1;0;0;4;4;257;0;1890;4;4;
/org.eclipse.help.ui/src/org/eclipse/help/internal/ui/PrintTopicTreeAction.java;2;0;5;2;0;0;0;5;18;2;4;1675;32;32;2;1;0;5;5;1675;1;3030;4;2;
/org.eclipse.ui.externaltools/External Tools/org/eclipse/ui/externaltools/internal/core/AntUtil.java;2;1;7;1;7;7;7;0;73;0;0;4090;254;254;1;0;0;0;7;4090;0;4730;7;2;
/org.eclipse.jdt.debug.tests/tests/org/eclipse/jdt/debug/tests/eval/LongOperatorsTests.java;2;2;3;2;3;2;3;0;17;0;0;4447;19;19;2;0;1;0;3;4447;1;4571;2;2;
/org.eclipse.team.tests.cvs.core/src/org/eclipse/team/tests/ccvs/ui/logformatter/PrintAverageMain.java;1;0;3;1;0;0;0;3;12;1;3;2977;12;12;1;0;0;3;3;2977;0;3452;3;1;
/org.eclipse.pde.ui/Eclipse PDE UI/org/eclipse/pde/internal/model/build/BuildModel.java;2;0;5;2;0;0;0;5;12;3;3;267;12;12;3;2;0;5;5;324;2;1434;3;2;
/org.eclipse.ui/Eclipse JFace/org/eclipse/jface/wizard/WizardDialog.java;6;1;17;1;3;3;3;14;28;2;12;257;93;93;2;2;0;14;17;3233;2;4145;15;6;
/org.eclipse.debug.core/core/org/eclipse/debug/core/model/IDisconnect.java;3;0;4;1;0;0;0;4;7;1;4;187;17;17;1;0;0;4;4;187;0;3474;4;3;
/org.eclipse.jdt.ui/core refactoring/org/eclipse/jdt/internal/core/refactoring/code/flow/GenericConditionalFlowInfo.java;1;0;2;1;0;0;0;2;0;1;2;1236;0;0;1;0;0;2;2;1236;0;1939;2;1;
/org.eclipse.swt.tests/JUnit Tests/org/eclipse/swt/tests/junit/Test_org_eclipse_swt_widgets_Menu.java;2;0;3;1;1;1;1;2;16;1;2;1792;22;22;1;0;0;2;3;1792;0;4706;3;2;
/org.eclipse.swt/Eclipse SWT PI/win32/org/eclipse/swt/internal/ole/win32/IPersist.java;2;0;2;1;1;1;1;1;6;0;1;2069;6;6;1;0;0;1;2;2069;0;4701;2;2;
/org.eclipse.jdt.ui.tests.refactoring/resources/ExtractMethodWorkSpace/ExtractMethodTests/errors_in/A_test802.java;1;0;2;1;0;0;0;2;0;1;2;3124;0;0;1;0;0;2;2;3124;0;3736;2;1;
/org.eclipse.jdt.ui.tests.refactoring/resources/RenameType/test35/in/A.java;1;0;1;1;0;0;0;1;0;0;1;49;0;0;1;0;0;1;1;49;0;49;1;1;
/org.eclipse.jdt.core/search/org/eclipse/jdt/internal/core/search/indexing/AbstractIndexer.java;2;1;4;1;2;2;2;2;1269;1;2;455;1335;1335;1;0;0;2;4;455;0;4063;4;2;
/org.eclipse.jdt.ui/ui/org/eclipse/jdt/internal/ui/packageview/GotoPackageAction.java;7;1;19;1;5;5;5;14;35;2;13;283;182;182;2;1;0;14;19;324;1;4630;18;7;
/org.eclipse.team.cvs.core/src/org/eclipse/team/internal/ccvs/core/resources/CVSRemoteSyncElement.java;3;1;38;2;4;4;4;34;634;2;30;2156;1580;1580;2;4;0;34;38;2375;4;4111;34;3;
/org.eclipse.core.boot/src/org/eclipse/core/internal/boot/update/IdVersionPairModel.java;2;0;3;1;0;0;0;3;4;1;3;12;4;4;1;0;0;3;3;12;0;2726;3;2;
/org.eclipse.jdt.core/model/org/eclipse/jdt/internal/core/hierarchy/IHierarchyRequestor.java;2;0;2;1;1;1;1;1;17;0;1;2790;17;17;1;0;0;1;2;2790;0;4063;2;2;
/org.eclipse.team.cvs.core/src/org/eclipse/team/internal/ccvs/core/resources/RemoteFileRevision.java;2;0;2;1;0;0;0;2;0;1;2;1978;0;0;1;0;0;2;2;1978;0;2032;2;2;
/org.eclipse.jdt.ui.tests.refactoring/resources/ExtractMethodWorkSpace/ExtractMethodTests/locals_in/A_test526.java;1;1;3;1;2;2;2;1;58;0;1;2684;58;58;1;0;0;1;3;2684;0;4419;3;1;
/org.eclipse.ui/Eclipse JFace/org/eclipse/jface/action/IContributionItem.java;3;0;4;1;0;0;0;4;35;1;4;257;58;58;1;0;0;4;4;257;0;3447;4;3;
/org.eclipse.jdt.ui/ui debug/org/eclipse/jdt/internal/debug/ui/display/DisplayAction.java;7;0;17;1;0;0;0;17;46;2;16;345;214;214;2;1;0;17;17;345;1;1916;16;7;
/org.eclipse.jdt.ui/ui refactoring/org/eclipse/jdt/internal/ui/refactoring/actions/MoveActionDelegate.java;3;0;8;1;0;0;0;8;58;2;7;1358;86;86;2;1;0;8;8;1358;1;3758;7;3;
/org.eclipse.core.boot/src/org/eclipse/core/internal/boot/update/IdVersionPair.java;2;0;3;1;0;0;0;3;4;1;3;12;4;4;1;0;0;3;3;12;0;2726;3;2;
/org.eclipse.jdt.ui.tests.refactoring/resources/RenameType/test53/in/A.java;1;0;1;1;0;0;0;1;0;0;1;1274;0;0;1;0;0;1;1;1274;0;1274;1;1;
/org.eclipse.jdt.ui/ui/org/eclipse/jdt/internal/ui/viewsupport/ImageDescriptorRegistry.java;2;0;4;1;0;0;0;4;4;1;4;1310;7;7;1;0;0;4;4;1310;0;3644;4;2;
/org.eclipse.jdt.ui/ui/org/eclipse/jdt/internal/ui/search/WriteReferencesSearchGroup.java;1;3;9;1;5;3;5;4;35;1;4;1707;114;114;3;0;2;4;9;4140;2;4140;7;1;
/org.eclipse.pde.ui/src/org/eclipse/pde/internal/ui/wizards/templates/HelloWorldNewWizard.java;1;0;3;1;0;0;0;3;8;1;3;3579;9;9;1;0;0;3;3;3579;0;3870;3;1;
/org.eclipse.pde.ui/Eclipse PDE UI/org/eclipse/pde/internal/elements/ElementLabelProvider.java;2;0;5;2;0;0;0;5;12;3;3;267;12;12;3;2;0;5;5;324;2;1434;3;2;
/org.eclipse.jdt.core/codeassist/org/eclipse/jdt/internal/codeassist/complete/CompletionOnClassLiteralAccess.java;2;0;10;1;1;1;1;9;39;4;6;455;113;113;4;3;0;9;10;1039;3;4062;7;2;
/org.eclipse.swt/Eclipse SWT PI/win32/org/eclipse/swt/internal/ole/win32/OLECMDTEXT.java;2;0;2;1;1;1;1;1;6;0;1;2069;6;6;1;0;0;1;2;2069;0;4701;2;2;
/org.eclipse.debug.ui/ui/org/eclipse/debug/internal/ui/views/console/ConsoleDocumentManager.java;3;3;7;1;7;5;7;0;124;0;0;4021;140;140;3;0;2;0;7;4403;2;4608;5;3;
/org.eclipse.scripting/Eclipse Scripting/org/eclipse/scripting/internal/views/ScriptDevelopmentPreferencePageWorkbenchAction.java;2;0;5;1;0;0;0;5;21;1;5;133;30;30;1;0;0;5;5;133;0;1424;5;2;
/org.eclipse.jdt.ui/ui/org/eclipse/jdt/ui/jarpackager/IJarDescriptionWriter.java;2;1;4;1;2;2;2;2;9;0;1;3529;15;15;2;1;0;2;4;3529;1;4852;3;2;
/org.eclipse.jdt.core/model/org/eclipse/jdt/internal/core/builder/impl/ClassOrInterfaceHandleImplSWH.java;1;0;9;1;0;0;0;9;1143;4;6;455;1161;1161;4;3;0;9;9;1039;3;2808;6;1;
/org.eclipse.swt/Eclipse SWT/common/org/eclipse/swt/events/TraverseListener.java;4;0;5;1;1;1;1;4;6;1;4;106;20;20;1;0;0;4;5;106;0;4701;5;4;
/org.eclipse.jdt.ui/ui/org/eclipse/jdt/ui/actions/OrganizeImportsAction.java;2;1;11;1;9;9;9;2;38;1;2;3834;121;121;1;0;0;2;11;3834;0;4770;11;2;
/org.eclipse.jdt.ui/ui/org/eclipse/jdt/internal/ui/text/JavaColorManager.java;2;0;6;1;0;0;0;6;76;1;6;15;214;214;1;0;0;6;6;15;0;1864;6;2;
/org.eclipse.core.resources/src/org/eclipse/core/internal/resources/ProjectDescription.java;2;0;4;1;1;1;1;3;332;1;3;12;359;359;1;0;0;3;4;12;0;4213;4;2;
/org.eclipse.ui/Eclipse UI/org/eclipse/ui/internal/WorkbenchPage.java;10;3;104;3;32;19;32;72;535;4;56;257;3845;3845;4;16;13;72;104;3122;29;4629;75;10;
/org.eclipse.swt.examples/src/org/eclipse/swt/examples/fileviewer/FileDisplayInfo.java;2;0;3;2;0;0;0;3;1;2;2;554;1;1;2;1;0;3;3;609;1;609;2;2;
/org.eclipse.core.runtime/src/org/eclipse/core/runtime/ILog.java;3;0;4;1;1;1;1;3;94;1;3;12;114;114;1;0;0;3;4;12;0;4214;4;3;
/org.eclipse.jdt.ui/ui/org/eclipse/jdt/internal/ui/compare/JavaTextViewerCreator.java;1;0;2;1;0;0;0;2;5;1;2;15;5;5;1;0;0;2;2;15;0;329;2;1;
/org.eclipse.jdt.ui.tests.refactoring/resources/ExtractMethodWorkSpace/ExtractMethodTests/branch_in/A_test753.java;1;1;3;1;2;2;2;1;26;0;1;1851;26;26;1;0;0;1;3;1851;0;4419;3;1;
/org.eclipse.jdt.ui.tests.refactoring/resources/SelectionAnalyzerWorkSpace/SelectionAnalyzerTests/validSelection/A_test243.java;1;0;1;1;0;0;0;1;0;0;1;1368;0;0;1;0;0;1;1;1368;0;1368;1;1;
/org.eclipse.jdt.core/dom/org/eclipse/jdt/core/dom/ContinueStatement.java;2;1;6;1;2;2;2;4;9;1;4;2669;29;29;1;0;0;4;6;2669;0;4453;6;2;
/org.eclipse.pde.ui/src/org/eclipse/pde/internal/editor/manifest/ExtensionElementPropertySource.java;2;0;6;1;0;0;0;6;25;2;5;1434;30;30;2;1;0;6;6;3035;1;3579;5;2;
/org.eclipse.pde.ui/src/org/eclipse/pde/internal/core/schema/Schema.java;1;0;4;1;0;0;0;4;16;2;3;3579;18;18;2;1;0;4;4;3579;1;3607;3;1;
/org.eclipse.update/Eclipse Update/org/eclipse/update/internal/ui/UMWizardPageLocations.java;2;0;7;2;0;0;0;7;947;2;6;108;1082;1082;2;1;0;7;7;323;1;1424;6;2;
/org.eclipse.ui/Eclipse UI Standard Components/org/eclipse/ui/views/tasklist/DefaultTaskListResourceAdapter.java;1;0;1;1;0;0;0;1;0;0;1;2205;0;0;1;0;0;1;1;2205;0;2205;1;1;
/org.eclipse.jdt.ui.tests.refactoring/resources/RenameType/testWrongArg1/in/A.java;1;0;1;1;0;0;0;1;0;0;1;49;0;0;1;0;0;1;1;49;0;49;1;1;
/org.eclipse.team.webdav/src/org/eclipse/team/internal/webdav/ui/TargetWizardPage.java;1;1;2;1;2;2;2;0;0;0;0;4073;0;0;1;0;0;0;2;4073;0;4155;2;1;
/org.eclipse.ui/Eclipse UI Standard Components/org/eclipse/ui/views/framelist/TreeViewerFrameSource.java;1;0;1;1;0;0;0;1;0;0;1;3498;0;0;1;0;0;1;1;3498;0;3498;1;1;
/org.eclipse.pde.ui/Eclipse PDE UI/org/eclipse/pde/internal/editor/manifest/ManifestPropertySheet.java;2;0;5;2;0;0;0;5;12;3;3;267;12;12;3;2;0;5;5;324;2;1434;3;2;
/org.eclipse.swt/Eclipse SWT/photon/org/eclipse/swt/internal/photon/PhPointerEvent_t.java;2;0;3;1;0;0;0;3;6;1;3;106;6;6;1;0;0;3;3;106;0;2069;3;2;
/org.eclipse.swt/Eclipse SWT/common/org/eclipse/swt/layout/FormData.java;3;0;5;2;1;1;1;4;64;2;3;2880;138;138;2;1;0;4;5;2880;1;4701;4;3;
/org.eclipse.compare/compare/org/eclipse/compare/internal/CompareAction.java;3;0;7;1;1;1;1;6;16;1;6;14;48;48;1;0;0;6;7;14;0;4741;7;3;
/org.eclipse.jdt.ui.tests.refactoring/resources/RenameStaticMethod/test5/out/A.java;1;0;1;1;0;0;0;1;0;0;1;49;0;0;1;0;0;1;1;49;0;49;1;1;
/org.eclipse.pde.ui/src/org/eclipse/pde/internal/editor/feature/HandlerSection.java;1;0;5;1;0;0;0;5;24;1;5;2953;28;28;1;0;0;5;5;2953;0;3579;5;1;
/org.eclipse.scripting/Eclipse Scripting/org/eclipse/scripting/internal/uirenderer/XGRElementUISwtPreferencePage.java;2;0;4;1;0;0;0;4;40;1;4;133;44;44;1;0;0;4;4;133;0;1424;4;2;
/org.eclipse.core.boot/src/org/eclipse/core/internal/boot/update/IManifestDescriptor.java;2;0;3;1;0;0;0;3;7;1;3;12;7;7;1;0;0;3;3;12;0;2726;3;2;
/org.eclipse.debug.ui/ui/org/eclipse/debug/internal/ui/IDebugPreferenceConstants.java;4;1;18;1;2;2;2;16;10;1;16;187;96;96;1;0;0;16;18;187;0;3975;18;4;
/org.eclipse.team.ui/src/org/eclipse/team/internal/ui/ProjectSetImportWizard.java;1;1;6;1;3;3;3;3;125;2;2;3728;134;134;2;1;0;3;6;3812;1;4454;5;1;
/org.eclipse.ui/Eclipse JFace Text/org/eclipse/jface/text/IFindReplaceTargetExtension.java;1;1;4;1;2;2;2;2;48;1;2;3170;87;87;1;0;0;2;4;3170;0;4838;4;1;
/org.eclipse.jdt.ui.tests.refactoring/resources/ExtractMethodWorkSpace/ExtractMethodTests/branch_out/A_test754.java;1;1;4;1;2;2;2;2;34;1;2;1851;35;35;1;0;0;2;4;1851;0;4419;4;1;
/org.eclipse.jdt.ui/core refactoring/org/eclipse/jdt/internal/corext/refactoring/text/SimpleReplaceTextChange.java;1;0;2;1;0;0;0;2;0;1;2;1939;0;0;1;0;0;2;2;1939;0;2216;2;1;
/org.eclipse.pde.ui/src/org/eclipse/pde/internal/base/model/feature/IFeatureModel.java;1;0;4;1;0;0;0;4;2;1;4;2951;3;3;1;0;0;4;4;2951;0;3579;4;1;
/org.eclipse.ant.ui/src/org/eclipse/ant/internal/ui/toolscripts/RunToolScriptDialog.java;1;0;3;1;0;0;0;3;15;2;2;2933;15;15;2;1;0;3;3;2933;1;2979;2;1;
/org.eclipse.scripting/src/org/eclipse/scripting/internal/uirenderer/XGRPresentationModelException.java;1;0;1;1;0;0;0;1;0;0;1;1424;0;0;1;0;0;1;1;1424;0;1424;1;1;
/org.eclipse.team.cvs.ui/src/org/eclipse/team/internal/ccvs/ui/TagConfigurationDialog.java;3;1;13;1;6;6;6;7;669;1;7;3545;951;951;1;0;0;7;13;3545;0;4706;13;3;
/org.eclipse.jdt.core/compiler/org/eclipse/jdt/internal/compiler/ast/MessageSend.java;2;0;22;1;1;1;1;21;488;4;14;455;782;782;4;7;0;21;22;1039;7;4062;15;2;
/org.eclipse.ui/Eclipse UI Standard Components/org/eclipse/ui/views/navigator/ResourceNavigatorAction.java;4;0;6;1;1;1;1;5;97;1;5;257;111;111;1;0;0;5;6;257;0;4067;6;4;
/org.eclipse.update.ui/src/org/eclipse/update/ui/internal/model/MonitorAdapter.java;1;0;2;1;0;0;0;2;0;1;2;1919;0;0;1;0;0;2;2;1919;0;2797;2;1;
/org.eclipse.jdt.ui.tests.refactoring/resources/InlineTemp/cannotInline/A_testFail9.java;1;0;1;1;1;1;1;0;0;0;0;4357;0;0;1;0;0;0;1;4357;0;4357;1;1;
/org.eclipse.team.ftp/src/org/eclipse/team/internal/ftp/client/PassiveDataTransferManager.java;1;1;2;1;2;2;2;0;0;0;0;4169;0;0;1;0;0;0;2;4169;0;4573;2;1;
/org.eclipse.debug.ui/ui/org/eclipse/debug/internal/ui/DebugActionGroupsPreferencePage.java;2;0;6;1;1;1;1;5;6;2;4;3257;12;12;2;1;0;5;6;3330;1;3975;5;2;
/org.eclipse.jdt.ui.tests/ui/org/eclipse/jdt/ui/tests/dialogs/UIInteractiveSuite.java;1;0;3;1;0;0;0;3;5;1;3;1189;5;5;1;0;0;3;3;1189;0;2182;3;1;
/org.eclipse.scripting/src/org/eclipse/scripting/internal/uirenderer/XGRElementUISwtWizardPageBuildTime.java;1;0;1;1;0;0;0;1;0;0;1;1424;0;0;1;0;0;1;1;1424;0;1424;1;1;
/org.eclipse.swt.tests/JUnit Tests/org/eclipse/swt/tests/junit/Test_org_eclipse_swt_events_ControlAdapter.java;2;0;2;1;1;1;1;1;6;0;1;1792;6;6;1;0;0;1;2;1792;0;4706;2;2;
/org.eclipse.jdt.ui.tests.refactoring/resources/SurroundWithWorkSpace/SurroundWithTests/trycatch_in/TestWrappedLocal4.java;1;0;2;1;0;0;0;2;2;1;2;3209;2;2;1;0;0;2;2;3209;0;3870;2;1;
/org.eclipse.jdt.junit/src/org/eclipse/jdt/internal/junit/ui/RemoteTestRunnerClient.java;2;0;3;1;0;0;0;3;24;1;3;3171;26;26;1;0;0;3;3;3171;0;3659;3;2;
/org.eclipse.help.tests/src/org/eclipse/help/tests/AllHelpTests.java;2;0;6;1;0;0;0;6;6;1;6;1642;17;17;1;0;0;6;6;1642;0;2913;6;2;
/org.eclipse.vcm.core.cvs/src/org/eclipse/vcm/internal/core/ccvs/requests/Add.java;3;0;3;1;0;0;0;3;14;1;3;0;19;19;1;0;0;3;3;0;0;1098;3;3;
/org.eclipse.ui/Eclipse UI Text Editor/org/eclipse/ui/texteditor/AddTaskAction.java;1;1;2;1;2;2;2;0;16;0;0;4209;16;16;1;0;0;0;2;4209;0;4838;2;1;
/org.eclipse.debug.ui/ui/org/eclipse/debug/internal/ui/views/expression/ExpressionViewContentProvider.java;3;1;4;1;4;4;4;0;138;0;0;3975;157;157;1;0;0;0;4;3975;0;4708;4;3;
/org.eclipse.jdt.ui.tests/ui/org/eclipse/jdt/ui/tests/dialogs/WizardsTest.java;1;0;6;1;0;0;0;6;23;3;4;1208;33;33;3;2;0;6;6;2180;2;2180;4;1;
/org.eclipse.team.cvs.ui/src/org/eclipse/team/internal/ccvs/ui/CVSRemoveResolutionGenerator.java;3;0;9;2;1;1;1;8;267;2;6;3175;519;519;2;2;0;8;9;3402;2;4020;7;3;
/org.eclipse.ui/Eclipse UI Standard Components/org/eclipse/ui/views/navigator/WorkbenchStateActionContributionFactory.java;1;0;2;1;0;0;0;2;0;1;2;1726;0;0;1;0;0;2;2;1726;0;1757;2;1;
/org.eclipse.pde.ui/Eclipse PDE UI/org/eclipse/pde/internal/model/jars/JarsModel.java;2;0;5;2;0;0;0;5;12;3;3;267;12;12;3;2;0;5;5;324;2;1434;3;2;
/org.eclipse.help.ui/src/org/eclipse/help/ui/internal/browser/hpux/NetscapeBrowserAdapter.java;1;1;2;1;2;2;2;0;2;0;0;4209;2;2;1;0;0;0;2;4209;0;4439;2;1;
/org.eclipse.jdt.ui/core extension/org/eclipse/jdt/internal/corext/codemanipulation/CompositeCodeBlock.java;1;0;1;1;0;0;0;1;0;0;1;3870;0;0;1;0;0;1;1;3870;0;3870;1;1;
/org.eclipse.ui.examples.multipageeditor/Eclipse UI Examples MultiPageEditor/org/eclipse/ui/examples/multipageeditor/MessageUtil.java;1;0;1;1;0;0;0;1;2;0;1;932;2;2;1;0;0;1;1;932;0;932;1;1;
/org.eclipse.jdt.ui.tests.refactoring/resources/MoveMembers/test14/out/B.java;1;0;2;1;0;0;0;2;3;1;2;2738;3;3;1;0;0;2;2;2738;0;3188;2;1;
/org.eclipse.pde.ui/src/org/eclipse/pde/internal/base/model/build/IBuildModelFactory.java;2;0;2;1;0;0;0;2;0;1;2;1434;0;0;1;0;0;2;2;1434;0;3039;2;2;
/org.eclipse.swt/Eclipse SWT/win32/org/eclipse/swt/widgets/WidgetTable.java;2;0;3;1;1;1;1;2;6;1;2;106;10;10;1;0;0;2;3;106;0;4701;3;2;
/org.eclipse.jdt.ui.tests.refactoring/resources/RenameType/test13/out/B.java;1;0;1;1;0;0;0;1;0;0;1;522;0;0;1;0;0;1;1;522;0;522;1;1;
/org.eclipse.update.core/src/org/eclipse/update/core/IPluginEntry.java;3;0;12;1;0;0;0;12;152;2;11;1423;297;297;2;1;0;12;12;3571;1;3571;11;3;
/org.eclipse.core.tests.runtime/src/org/eclipse/core/tests/internal/plugins/PluginResolveTest_30.java;3;0;3;1;0;0;0;3;110;1;3;1794;120;120;1;0;0;3;3;1794;0;3476;3;3;
/org.eclipse.help/webapps/examples/WEB-INF/classes/compressionFilters/CompressionResponseStream.java;1;0;2;1;0;0;0;2;0;1;2;1882;0;0;1;0;0;2;2;1882;0;1930;2;1;
/org.eclipse.jdt.ui.tests.refactoring/test cases/org/eclipse/jdt/ui/tests/refactoring/infra/RefactoringTestPlugin.java;1;0;1;1;0;0;0;1;0;0;1;1896;0;0;1;0;0;1;1;1896;0;1896;1;1;
/org.eclipse.jdt.core/dom/org/eclipse/jdt/core/dom/SingleVariableDeclaration.java;2;1;7;1;2;2;2;5;33;1;5;2669;68;68;1;0;0;5;7;2669;0;4453;7;2;
/org.eclipse.ui.tests/Eclipse UI Tests/org/eclipse/ui/tests/dialogs/DataTransferMessagesCopy.java;1;0;1;1;0;0;0;1;0;0;1;1113;0;0;1;0;0;1;1;1113;0;1113;1;1;
/org.eclipse.update.core/src/org/eclipse/update/internal/core/obsolete/FeaturePackaged.java;1;0;1;1;0;0;0;1;0;0;1;2463;0;0;1;0;0;1;1;2463;0;2463;1;1;
/org.eclipse.compare/compare/org/eclipse/compare/rangedifferencer/RangeDifferencer.java;2;0;7;1;1;1;1;6;93;1;6;14;131;131;1;0;0;6;7;14;0;4820;7;2;
/org.eclipse.swt/Eclipse SWT/motif/org/eclipse/swt/internal/motif/XConfigureEvent.java;2;0;3;1;0;0;0;3;4;1;3;106;4;4;1;0;0;3;3;106;0;2069;3;2;
/org.eclipse.jdt.ui.tests.refactoring/resources/RenameTemp/canRename/A_test7_out.java;1;0;2;1;0;0;0;2;2;1;2;1625;2;2;1;0;0;2;2;1625;0;1652;2;1;
/org.eclipse.jdt.ui/ui/org/eclipse/jdt/internal/ui/search/ByPathSorter.java;1;0;3;1;0;0;0;3;32;2;2;1119;32;32;2;1;0;3;3;1267;1;1267;2;1;
/org.eclipse.jdt.ui.tests.refactoring/resources/RenamePackage/test3/out/r/r/B.java;1;0;1;1;0;0;0;1;0;0;1;1258;0;0;1;0;0;1;1;1258;0;1258;1;1;
/org.eclipse.ui/Eclipse UI/org/eclipse/ui/internal/ShortcutMenu.java;4;0;5;1;0;0;0;5;45;1;5;257;100;100;1;0;0;5;5;257;0;3125;5;4;
/org.eclipse.pde.core/src/org/eclipse/pde/internal/core/NLResourceHelper.java;1;0;1;1;0;0;0;1;0;0;1;3591;0;0;1;0;0;1;1;3591;0;3591;1;1;
/org.eclipse.pde.runtime/Eclipse PDE Runtime/org/eclipse/pde/internal/runtime/registry/ExtensionPointAdapter.java;2;0;3;1;0;0;0;3;4;1;3;267;4;4;1;0;0;3;3;267;0;1434;3;2;
/org.eclipse.pde.ui/src/org/eclipse/pde/internal/ui/wizards/extension/NewExtensionTemplateWizard.java;1;0;3;1;0;0;0;3;39;1;3;3579;43;43;1;0;0;3;3;3579;0;3840;3;1;
/org.eclipse.swt/Eclipse SWT PI/win32/org/eclipse/swt/internal/win32/HELPINFO.java;2;0;2;1;1;1;1;1;6;0;1;2069;6;6;1;0;0;1;2;2069;0;4701;2;2;
/org.eclipse.debug.ui/ui/org/eclipse/debug/internal/ui/DebugUIMessages.java;1;0;1;1;0;0;0;1;0;0;1;1561;0;0;1;0;0;1;1;1561;0;1561;1;1;
/org.eclipse.jdt.ui.tests.refactoring/resources/ExtractTemp/canExtract/A_test21_in.java;1;0;1;1;0;0;0;1;0;0;1;2498;0;0;1;0;0;1;1;2498;0;2498;1;1;
/org.eclipse.jdt.ui/ui/org/eclipse/jdt/internal/ui/util/TabFolderLayout.java;1;0;1;1;0;0;0;1;0;0;1;393;0;0;1;0;0;1;1;393;0;393;1;1;
/org.eclipse.update.ui/src/org/eclipse/update/internal/ui/views/SiteView.java;1;0;3;1;0;0;0;3;70;1;3;3537;70;70;1;0;0;3;3;3537;0;3561;3;1;
/org.eclipse.jdt.debug/jdi interfaces/com/sun/jdi/LocalVariable.java;2;0;2;1;0;0;0;2;10;1;2;2704;10;10;1;0;0;2;2;2704;0;3033;2;2;
/org.eclipse.ui/Eclipse JFace/org/eclipse/jface/dialogs/IInputValidator.java;3;0;3;1;1;1;1;2;10;1;2;257;15;15;1;0;0;2;3;257;0;4267;3;3;
/org.eclipse.jdt.ui.tests.refactoring/resources/RenameType/testFail38/in/A.java;1;0;1;1;0;0;0;1;0;0;1;49;0;0;1;0;0;1;1;49;0;49;1;1;
/org.eclipse.ui/Eclipse UI/org/eclipse/ui/part/CoolItemGroupMarker.java;1;0;1;1;1;1;1;0;0;0;0;4453;0;0;1;0;0;0;1;4453;0;4453;1;1;
/org.eclipse.compare/compare/org/eclipse/compare/internal/INavigatable.java;2;0;2;1;0;0;0;2;2;1;2;419;2;2;1;0;0;2;2;419;0;761;2;2;
/org.eclipse.vcm.ui/src/org/eclipse/vcm/internal/ui/sync/UnchangedVCMContainer.java;2;0;9;1;0;0;0;9;99;2;8;48;183;183;2;1;0;9;9;176;1;331;8;2;
/org.eclipse.jdt.core/search/org/eclipse/jdt/internal/core/search/Util.java;2;0;11;1;1;1;1;10;48;4;6;630;110;110;4;4;0;10;11;1039;4;4063;7;2;
/org.eclipse.swt.tests/JUnit Tests/org/eclipse/swt/tests/junit/Test_org_eclipse_swt_events_ShellListener.java;2;0;2;1;1;1;1;1;6;0;1;1792;6;6;1;0;0;1;2;1792;0;4706;2;2;
/org.eclipse.jdt.debug.ui/ui/org/eclipse/jdt/internal/debug/ui/actions/ManageWatchpointAction.java;3;1;17;2;2;2;2;15;167;2;14;2215;521;521;2;1;0;15;17;3570;1;4025;16;3;
/org.eclipse.pde.ui/Eclipse PDE UI/org/eclipse/pde/internal/model/build/BuildModelFactory.java;2;0;5;2;0;0;0;5;12;3;3;267;12;12;3;2;0;5;5;324;2;1434;3;2;
/org.eclipse.swt.examples/src/org/eclipse/swt/examples/addressbook/FindListener.java;3;0;3;1;1;1;1;2;12;1;2;513;18;18;1;0;0;2;3;513;0;4705;3;3;
/org.eclipse.jdt.ui.tests.refactoring/resources/MultiMove/test1/out/p2/B.java;1;0;2;1;0;0;0;2;3;1;2;1157;3;3;1;0;0;2;2;1157;0;2682;2;1;
/org.eclipse.swt/Eclipse SWT/photon/org/eclipse/swt/widgets/SelectableItem.java;2;0;4;1;0;0;0;4;24;1;4;106;38;38;1;0;0;4;4;106;0;1028;4;2;
/org.eclipse.ui.tests/Eclipse UI Tests/AbstractSniffTest.java;1;0;2;1;0;0;0;2;0;1;2;1041;0;0;1;0;0;2;2;1041;0;1407;2;1;
/org.eclipse.pde.ui/src/org/eclipse/pde/internal/ui/elements/IPDEElement.java;1;0;1;1;0;0;0;1;0;0;1;3579;0;0;1;0;0;1;1;3579;0;3579;1;1;
/org.eclipse.ui.externaltools/External Tools/org/eclipse/ui/externaltools/internal/ui/LogPropertyChangeListener.java;1;1;2;1;2;2;2;0;0;0;0;4123;0;0;1;0;0;0;2;4123;0;4145;2;1;
/org.eclipse.jdt.debug/eval/org/eclipse/jdt/internal/debug/eval/model/IArray.java;2;0;2;1;0;0;0;2;0;1;2;3555;0;0;1;0;0;2;2;3555;0;3645;2;2;
/org.eclipse.team.ftp/src/org/eclipse/team/internal/ftp/client/DataTransferWorker.java;1;3;5;1;5;3;5;0;12;0;0;4169;12;12;3;0;2;0;5;4285;2;4573;3;1;
/org.eclipse.swt/Eclipse SWT PI/gtk/org/eclipse/swt/internal/gtk/GtkWindow.java;1;0;2;1;0;0;0;2;0;1;2;2107;0;0;1;0;0;2;2;2107;0;3209;2;1;
/org.eclipse.swt/Eclipse SWT/win32/org/eclipse/swt/widgets/DirectoryDialog.java;7;2;10;1;3;2;3;7;34;1;7;106;79;79;2;0;1;7;10;4557;1;4701;9;7;
/org.eclipse.ui/Eclipse UI/org/eclipse/ui/ISelectionListener.java;3;0;3;1;0;0;0;3;10;1;3;257;15;15;1;0;0;3;3;257;0;2235;3;3;
/org.eclipse.jdt.debug/model/org/eclipse/jdt/debug/core/IJavaBreakpointListener.java;1;0;4;1;0;0;0;4;33;1;4;2816;57;57;1;0;0;4;4;2816;0;3558;4;1;
/org.eclipse.jdt.ui.tests.refactoring/resources/RenameTemp/canRename/A_test44_out.java;1;0;1;1;0;0;0;1;0;0;1;3353;0;0;1;0;0;1;1;3353;0;3353;1;1;
/org.eclipse.help.ui/src/org/eclipse/help/internal/ui/util/ErrorUtil.java;2;0;4;1;1;1;1;3;42;1;3;1675;44;44;1;0;0;3;4;1675;0;4439;4;2;
/org.eclipse.pde.ui/src/org/eclipse/pde/internal/ui/editor/manifest/PointUsageSection.java;1;0;3;1;1;1;1;2;33;1;2;3579;37;37;1;0;0;2;3;3579;0;4568;3;1;
/org.eclipse.update.ui/src/org/eclipse/update/internal/ui/model/IFeatureAdapter.java;1;1;3;1;2;2;2;1;4;0;1;2834;7;7;1;0;0;1;3;2834;0;4384;3;1;
/org.eclipse.jdt.ui.tests.refactoring/resources/PullUp/test8/in/A.java;1;0;1;1;0;0;0;1;0;0;1;2406;0;0;1;0;0;1;1;2406;0;2406;1;1;
/org.eclipse.ui/Eclipse UI Text Editor/org/eclipse/ui/texteditor/ConvertLineDelimitersAction.java;2;3;10;2;10;8;10;0;210;0;0;3915;459;459;3;0;2;0;10;4423;2;4838;8;2;
/org.eclipse.jdt.ui.tests.refactoring/resources/ExtractMethodWorkSpace/ExtractMethodTests/expression_out/A_test603.java;2;1;4;1;2;2;2;2;22;1;2;239;23;23;1;0;0;2;4;239;0;4419;4;2;
/org.eclipse.jdt.core/codeassist/org/eclipse/jdt/internal/codeassist/complete/CompletionOnClassReference.java;2;2;3;1;3;2;3;0;18;0;0;3890;22;22;2;0;1;0;3;3890;1;4062;2;2;
/org.eclipse.jdt.ui.tests.refactoring/resources/RefactoringScanner/B.java;1;0;1;1;0;0;0;1;0;0;1;1547;0;0;1;0;0;1;1;1547;0;1547;1;1;
/org.eclipse.swt/Eclipse SWT/win32/org/eclipse/swt/widgets/Display.java;9;1;31;2;5;5;5;26;187;3;20;106;1056;1056;3;6;0;26;31;2416;6;4701;25;9;
/org.eclipse.vcm.ui/src/org/eclipse/vcm/internal/ui/actions/VersionAction.java;5;0;15;2;0;0;0;15;324;3;13;1;705;705;3;2;0;15;15;293;2;1794;13;5;
/org.eclipse.pde.ui/src/org/eclipse/pde/internal/editor/manifest/ImportStatusSection.java;1;0;12;1;0;0;0;12;153;2;11;2477;268;268;2;1;0;12;12;3035;1;3579;11;1;
/org.eclipse.pde.ui/src/org/eclipse/pde/internal/ui/launcher/WorkbenchLauncherWizard.java;1;0;2;1;0;0;0;2;0;1;2;3579;0;0;1;0;0;2;2;3579;0;3634;2;1;
/org.eclipse.jdt.ui.tests.refactoring/resources/ExtractMethodWorkSpace/ExtractMethodTests/locals_out/A_test538.java;1;1;4;1;2;2;2;2;4;1;2;922;8;8;1;0;0;2;4;922;0;4419;4;1;
/org.eclipse.jdt.ui/nls/org/eclipse/jdt/internal/ui/nls/search/PrettySignature.java;1;0;2;1;0;0;0;2;0;1;2;1880;0;0;1;0;0;2;2;1880;0;1913;2;1;
/org.eclipse.jdt.ui/ui debug/org/eclipse/jdt/internal/debug/ui/display/DisplayCompletionProcessor.java;3;0;8;1;0;0;0;8;92;2;7;1364;153;153;2;1;0;8;8;1619;1;1916;7;3;
/org.eclipse.update.core/src/org/eclipse/update/core/ILocalSite.java;3;0;25;1;0;0;0;25;159;2;20;1423;378;378;2;5;0;25;25;1423;5;3018;20;3;
/org.eclipse.debug.ui/ui/org/eclipse/debug/internal/ui/TextViewerAction.java;3;0;3;1;0;0;0;3;2;1;3;1714;2;2;1;0;0;3;3;1714;0;2382;3;3;
/org.eclipse.pde.core/src/org/eclipse/pde/internal/core/ischema/ISchemaRepeatable.java;1;0;1;1;0;0;0;1;0;0;1;3591;0;0;1;0;0;1;1;3591;0;3591;1;1;
/org.eclipse.jdt.core/model/org/eclipse/jdt/internal/core/eval/GlobalVariableWrapper.java;2;0;3;1;1;1;1;2;60;1;2;455;77;77;1;0;0;2;3;455;0;4063;3;2;
/org.eclipse.debug.ui/ui/org/eclipse/debug/internal/ui/views/ConsoleView.java;3;1;23;1;3;3;3;20;113;2;18;2338;292;292;2;2;0;20;23;2349;2;3975;21;3;
/org.eclipse.ui.externaltools/External Tools/org/eclipse/ui/externaltools/internal/ui/LogConsolePreferencePage.java;1;1;3;1;3;3;3;0;9;0;0;4123;11;11;1;0;0;0;3;4123;0;4567;3;1;
/org.eclipse.pde.ui/src/org/eclipse/pde/internal/editor/manifest/ExtensionPointPropertySource.java;2;0;5;1;0;0;0;5;5;2;4;1434;6;6;2;1;0;5;5;3035;1;3579;4;2;
/org.eclipse.jdt.core/codeassist/org/eclipse/jdt/internal/codeassist/select/SelectionOnQualifiedSuperReference.java;2;0;9;1;1;1;1;8;43;4;5;455;100;100;4;3;0;8;9;1039;3;4062;6;2;
/org.eclipse.team.ftp/src/org/eclipse/team/internal/ftp/client/PassiveDataConnection.java;1;1;2;1;2;2;2;0;41;0;0;4535;41;41;1;0;0;0;2;4535;0;4573;2;1;
/org.eclipse.jdt.ui.tests.refactoring/resources/RenamePrivateMethod/testFail3/in/A.java;2;0;2;1;0;0;0;2;0;1;2;49;0;0;1;0;0;2;2;49;0;1258;2;2;
/org.eclipse.jdt.ui/core refactoring/org/eclipse/jdt/internal/corext/refactoring/code/OldCommentAnalyzer.java;2;0;3;1;0;0;0;3;10;1;3;3106;10;10;1;0;0;3;3;3106;0;3413;3;2;
/org.eclipse.jdt.ui.tests.refactoring/resources/RenameTemp/cannotRename/A_testFail10.java;1;0;2;1;0;0;0;2;2;1;2;1625;2;2;1;0;0;2;2;1625;0;1652;2;1;
/org.eclipse.jdt.ui/ui/org/eclipse/jdt/internal/ui/launcher/StandardVMType.java;4;0;10;1;0;0;0;10;32;2;8;218;111;111;2;2;0;10;10;218;2;1916;8;4;
/org.eclipse.jdt.ui.tests.refactoring/resources/InlineTemp/cannotInline/A_testFail1.java;1;0;1;1;0;0;0;1;0;0;1;2015;0;0;1;0;0;1;1;2015;0;2015;1;1;
/org.eclipse.jdt.ui.tests.refactoring/resources/ExtractMethodWorkSpace/ExtractMethodTests/return_in/A_test722.java;1;1;3;1;2;2;2;1;20;0;1;2580;20;20;1;0;0;1;3;2580;0;4419;3;1;
/org.eclipse.ui.tests/Eclipse UI Tests/org/eclipse/ui/tests/dialogs/TaskListTestStub.java;1;0;1;1;0;0;0;1;0;0;1;1274;0;0;1;0;0;1;1;1274;0;1274;1;1;
/org.eclipse.jdt.ui.tests.refactoring/resources/ExtractMethodWorkSpace/ExtractMethodTests/MyTest.java;1;1;3;1;2;2;2;1;0;0;1;3872;0;0;1;0;0;1;3;3872;0;4419;3;1;
/org.eclipse.swt/Eclipse SWT Accessibility/win32/org/eclipse/swt/accessibility/ACC.java;1;0;1;1;0;0;0;1;0;0;1;2781;0;0;1;0;0;1;1;2781;0;2781;1;1;
/org.eclipse.jdt.ui/ui refactoring/org/eclipse/jdt/internal/ui/refactoring/UserInputWizardPage.java;3;0;16;2;0;0;0;16;106;2;15;15;380;380;2;1;0;16;16;1939;1;3357;15;3;
/org.eclipse.jdt.ui.tests.refactoring/resources/RenameType/testFail58/in/A.java;1;0;1;1;0;0;0;1;0;0;1;49;0;0;1;0;0;1;1;49;0;49;1;1;
/org.eclipse.jdt.ui.tests.refactoring/resources/RenameVariables/cannotRename/A_testFail11.java;1;0;2;1;0;0;0;2;0;1;2;724;0;0;1;0;0;2;2;724;0;1665;2;1;
/org.eclipse.jdt.core/compiler/org/eclipse/jdt/internal/compiler/codegen/CodeStream.java;2;1;32;1;4;4;4;28;10382;4;21;455;11832;11832;4;7;0;28;32;1039;7;4421;25;2;
/org.eclipse.scripting/Eclipse Scripting/org/eclipse/scripting/internal/uirenderer/XGRPresentationModelElement.java;2;0;4;1;0;0;0;4;50;1;4;133;58;58;1;0;0;4;4;133;0;1424;4;2;
/org.eclipse.ant.ui/src/org/eclipse/ant/internal/ui/AntTreeLabelProvider.java;3;0;3;1;0;0;0;3;138;1;3;981;156;156;1;0;0;3;3;981;0;3606;3;3;
/org.eclipse.jdt.ui.tests.refactoring/resources/RenamePrivateField/test3/in/A.java;1;0;1;1;0;0;0;1;0;0;1;1547;0;0;1;0;0;1;1;1547;0;1547;1;1;
/org.eclipse.jdt.ui/ui debug/org/eclipse/jdt/internal/debug/ui/SourceAttachmentWizard.java;2;0;4;1;0;0;0;4;10;1;4;154;15;15;1;0;0;4;4;154;0;1916;4;2;
/org.eclipse.update.core/src/org/eclipse/update/core/model/ImportModel.java;1;0;3;1;0;0;0;3;97;1;3;2409;155;155;1;0;0;3;3;2409;0;3543;3;1;
/org.eclipse.jdt.ui.tests.refactoring/resources/SefWorkSpace/SefTests/base_in/TestPostfixInt.java;1;0;1;1;0;0;0;1;0;0;1;2876;0;0;1;0;0;1;1;2876;0;2876;1;1;
/org.eclipse.pde.ui/src/org/eclipse/pde/internal/base/schema/ISchemaComplexType.java;2;0;3;1;0;0;0;3;1;1;3;1434;1;1;1;0;0;3;3;1434;0;3579;3;2;
/org.eclipse.update.ui/src/org/eclipse/update/internal/transform/ITransform.java;1;0;2;1;0;0;0;2;0;1;2;1526;0;0;1;0;0;2;2;1526;0;1596;2;1;
/org.eclipse.core.runtime/src/org/eclipse/core/runtime/model/PluginModel.java;4;0;9;1;1;1;1;8;506;1;8;23;570;570;1;0;0;8;9;23;0;4214;9;4;
/org.eclipse.jdt.ui.tests.refactoring/resources/RenameTemp/canRename/A_test20_out.java;1;0;2;1;0;0;0;2;2;1;2;1625;2;2;1;0;0;2;2;1625;0;1652;2;1;
/org.eclipse.search/search/org/eclipse/search/internal/workingsets/WorkingSetWriter.java;1;0;4;1;0;0;0;4;4;1;4;1725;6;6;1;0;0;4;4;1725;0;3849;4;1;
/org.eclipse.core.runtime/src/org/eclipse/core/runtime/model/PluginModelObject.java;3;0;5;1;1;1;1;4;136;1;4;12;162;162;1;0;0;4;5;12;0;4214;5;3;
/org.eclipse.pde.ui/src/org/eclipse/pde/internal/wizards/imports/PluginImportWizardDetailedPage.java;1;0;16;1;0;0;0;16;506;3;13;2522;1111;1111;3;3;0;16;16;3035;3;3579;13;1;
/org.eclipse.jdt.debug.tests/tests/org/eclipse/jdt/debug/tests/eval/NestedTypeFieldValue_268.java;2;1;3;1;3;3;3;0;12;0;0;4447;14;14;1;0;0;0;3;4447;0;4571;3;2;
/org.eclipse.jdt.launching/launching/org/eclipse/jdt/internal/launching/LaunchingPlugin.java;3;3;19;2;11;9;11;8;86;2;7;2022;421;421;3;1;2;8;19;4163;3;4551;16;3;
/org.eclipse.jdt.ui.tests.refactoring/resources/RenameVirtualMethodInClass/test27/out/A.java;1;0;1;1;0;0;0;1;0;0;1;49;0;0;1;0;0;1;1;49;0;49;1;1;
/org.eclipse.pde.ui/src/org/eclipse/pde/internal/editor/ModifiedTextPropertyDescriptor.java;2;0;4;1;0;0;0;4;2;1;4;1434;3;3;1;0;0;4;4;1434;0;3579;4;2;
/org.eclipse.help/src/org/eclipse/help/internal/context/ContextContributor.java;2;0;3;1;0;0;0;3;122;1;3;2217;122;122;1;0;0;3;3;2217;0;2829;3;2;
/org.eclipse.jdt.ui.tests.refactoring/resources/SelectionAnalyzerWorkSpace/SelectionAnalyzerTests/validSelection/A_test351.java;1;0;1;1;0;0;0;1;0;0;1;1368;0;0;1;0;0;1;1;1368;0;1368;1;1;
/org.eclipse.help/src/org/eclipse/help/internal/context/XMLContextContributorCreator.java;1;0;2;1;0;0;0;2;0;1;2;1675;0;0;1;0;0;2;2;1675;0;2217;2;1;
/org.eclipse.help.ui/src/org/eclipse/help/ui/internal/browser/win32/IEFactory.java;2;0;4;1;1;1;1;3;2;1;3;2429;4;4;1;0;0;3;4;2429;0;4427;4;2;
/org.eclipse.jdt.ui/core refactoring/org/eclipse/jdt/internal/corext/refactoring/util/LocalTypeAnalyzer.java;1;0;2;1;0;0;0;2;0;1;2;2327;0;0;1;0;0;2;2;2327;0;3209;2;1;
/org.eclipse.jdt.core/model/org/eclipse/jdt/core/IClassFile.java;3;2;9;2;4;2;4;5;91;1;5;455;171;171;2;0;2;5;9;4058;2;4421;7;3;
/org.eclipse.core.target/src/org/eclipse/core/internal/target/ResourceHashtableSorter.java;1;0;4;1;1;1;1;3;102;1;3;12;123;123;1;0;0;3;4;12;0;4196;4;1;
/org.eclipse.pde.ui/src/org/eclipse/pde/internal/base/model/plugin/IFragmentModel.java;2;0;2;1;0;0;0;2;0;1;2;1434;0;0;1;0;0;2;2;1434;0;3039;2;2;
/org.eclipse.jdt.ui/ui/org/eclipse/jdt/internal/ui/javaeditor/structureselection/StructureSelectPreviousAction.java;2;1;7;2;2;2;2;5;9;2;4;3188;41;41;2;1;0;5;7;3188;1;4630;6;2;
/org.eclipse.jdt.ui/ui/org/eclipse/jdt/internal/ui/text/correction/UnresolvedElementsSubProcessor.java;3;2;20;2;4;3;4;16;89;3;11;3570;516;516;3;5;1;16;20;3737;6;4452;14;3;
/org.eclipse.jdt.debug/model/org/eclipse/jdt/internal/debug/core/breakpoints/JDIDebugBreakpointMessages.java;1;0;1;1;0;0;0;1;0;0;1;2521;0;0;1;0;0;1;1;2521;0;2521;1;1;
/org.eclipse.webdav/src/client/org/eclipse/webdav/http/client/Message.java;4;0;6;1;1;1;1;5;272;1;5;12;321;321;1;0;0;5;6;12;0;4211;6;4;
/org.eclipse.update.tests.core/src/org/eclipse/update/tests/model/FeatureMain.java;2;0;6;1;0;0;0;6;205;2;5;2420;250;250;2;1;0;6;6;2858;1;3433;5;2;
/org.eclipse.core.tests.runtime/src/org/eclipse/core/tests/internal/plugins/RegressionResolveTest_10.java;3;0;3;1;0;0;0;3;132;1;3;1794;142;142;1;0;0;3;3;1794;0;3476;3;3;
/org.eclipse.pde.ui/src/org/eclipse/pde/internal/core/plugin/PluginAttribute.java;1;0;4;1;0;0;0;4;14;2;3;3579;16;16;2;1;0;4;4;3579;1;3607;3;1;
/org.eclipse.team.examples.filesystem/src/org/eclipse/team/examples/filesystem/FileModificationValidator.java;1;0;1;1;1;1;1;0;0;0;0;4727;0;0;1;0;0;0;1;4727;0;4727;1;1;
/org.eclipse.core.resources/src/org/eclipse/core/resources/IProject.java;4;0;15;1;1;1;1;14;1264;1;14;12;1717;1717;1;0;0;14;15;12;0;4214;15;4;
/org.eclipse.swt/Eclipse SWT/common/org/eclipse/swt/events/PaintListener.java;4;0;5;1;1;1;1;4;6;1;4;106;18;18;1;0;0;4;5;106;0;4701;5;4;
/org.eclipse.swt/Eclipse SWT PI/win32/org/eclipse/swt/internal/ole/win32/IUnknown.java;2;0;2;1;1;1;1;1;6;0;1;2069;6;6;1;0;0;1;2;2069;0;4701;2;2;
/org.eclipse.jdt.ui/ui/org/eclipse/jdt/internal/ui/wizards/swt/MGridUtil.java;2;0;3;1;0;0;0;3;9;1;3;15;9;9;1;0;0;3;3;15;0;1342;3;2;
/org.eclipse.core.tests.runtime/src/org/eclipse/core/tests/internal/runtimetests/SampleNFB.java;1;0;2;1;0;0;0;2;10;1;2;3611;10;10;1;0;0;2;2;3611;0;3678;2;1;
/org.eclipse.jdt.ui/ui/org/eclipse/jdt/internal/ui/util/JdtHackFinder.java;1;0;3;1;0;0;0;3;9;1;3;15;9;9;1;0;0;3;3;15;0;438;3;1;
/org.eclipse.jdt.ui/core refactoring/org/eclipse/jdt/internal/core/refactoring/changes/UndoTextChange.java;1;0;3;1;0;0;0;3;6;2;2;1800;6;6;2;1;0;3;3;1937;1;1937;2;1;
/org.eclipse.jdt.debug.ui/ui/org/eclipse/jdt/internal/debug/ui/actions/AccessWatchpointToggleAction.java;2;0;3;1;0;0;0;3;22;1;3;1915;23;23;1;0;0;3;3;1915;0;2844;3;2;
/org.eclipse.jdt.core/model/org/eclipse/jdt/internal/core/util/CharArrayBuffer.java;3;1;5;1;2;2;2;3;270;1;3;455;320;320;1;0;0;3;5;455;0;4422;5;3;
/org.eclipse.jdt.ui/ui/org/eclipse/jdt/internal/ui/viewsupport/ListContentProvider.java;2;0;3;1;0;0;0;3;4;1;3;15;8;8;1;0;0;3;3;15;0;1199;3;2;
/org.eclipse.jdt.debug/jdi interfaces/com/sun/jdi/event/WatchpointEvent.java;2;0;2;1;0;0;0;2;17;1;2;2704;17;17;1;0;0;2;2;2704;0;3040;2;2;
/org.eclipse.ui.tests/Eclipse UI Tests/org/eclipse/ui/tests/internal/ExtendedTextSelection.java;1;0;1;1;0;0;0;1;0;0;1;2236;0;0;1;0;0;1;1;2236;0;2236;1;1;
/org.eclipse.jdt.core/compiler/org/eclipse/jdt/internal/compiler/ast/Block.java;2;1;15;1;2;2;2;13;216;4;10;455;609;609;4;3;0;13;15;1039;3;4421;12;2;
/org.eclipse.jdt.ui.tests.refactoring/resources/ExtractMethodWorkSpace/ExtractMethodTests/validSelection/A_test301.java;2;1;3;1;2;2;2;1;0;0;1;49;0;0;1;0;0;1;3;49;0;4419;3;2;
/org.eclipse.jdt.debug/jdi/org/eclipse/jdi/internal/LocalVariableImpl.java;2;0;5;1;0;0;0;5;16;1;5;187;38;38;1;0;0;5;5;187;0;3678;5;2;
/org.eclipse.scripting/src/org/eclipse/scripting/internal/IXGRElementUIGridElement.java;1;0;1;1;0;0;0;1;0;0;1;1424;0;0;1;0;0;1;1;1424;0;1424;1;1;
/org.eclipse.jdt.debug/jdi interfaces/com/sun/jdi/ClassNotPreparedException.java;2;0;2;1;0;0;0;2;7;1;2;2704;7;7;1;0;0;2;2;2704;0;3033;2;2;
/org.eclipse.jdt.ui/ui/org/eclipse/jdt/internal/ui/snippeteditor/InspectAction.java;4;0;6;1;0;0;0;6;24;1;6;15;41;41;1;0;0;6;6;15;0;1916;6;4;
/org.eclipse.debug.ui/ui/org/eclipse/debug/internal/ui/views/console/ConsoleView.java;3;1;5;1;5;5;5;0;773;0;0;3975;869;869;1;0;0;0;5;3975;0;4726;5;3;
/org.eclipse.team.cvs.core/src/org/eclipse/team/internal/ccvs/core/IUserAuthenticator.java;3;0;3;1;0;0;0;3;94;1;3;1978;98;98;1;0;0;3;3;1978;0;3610;3;3;
/org.eclipse.jdt.core/model/org/eclipse/jdt/internal/core/util/DefaultBytecodeVisitor.java;3;2;8;2;4;3;4;4;617;3;2;3629;759;759;3;2;1;4;8;3629;3;4421;5;3;
/org.eclipse.pde.ui/Eclipse PDE UI/org/eclipse/pde/internal/wizards/WizardElement.java;2;0;5;2;0;0;0;5;12;3;3;267;12;12;3;2;0;5;5;324;2;1434;3;2;
/org.eclipse.pde.ui/src/org/eclipse/pde/internal/wizards/templates/AbstractTemplateSection.java;1;0;10;1;0;0;0;10;157;2;9;3240;265;265;2;1;0;10;10;3425;1;3579;9;1;
/org.eclipse.jdt.ui.tests.refactoring/resources/RenameType/testFail84/in/A.java;1;0;1;1;0;0;0;1;0;0;1;49;0;0;1;0;0;1;1;49;0;49;1;1;
/org.eclipse.ui/Eclipse JFace/org/eclipse/jface/window/ApplicationWindow.java;5;1;8;1;3;3;3;5;60;2;4;257;209;209;2;1;0;5;8;1097;1;4550;7;5;
/org.eclipse.core.resources/src/org/eclipse/core/internal/properties/IndexedStoreWrapper.java;3;0;8;1;1;1;1;7;388;1;7;54;544;544;1;0;0;7;8;54;0;4214;8;3;
/org.eclipse.core.tests.resources/src/org/eclipse/core/tests/resources/IResourceTest.java;3;0;9;1;0;0;0;9;3068;2;8;1794;4060;4060;2;1;0;9;9;3415;1;3875;8;3;
/org.eclipse.update.core/src/org/eclipse/core/internal/boot/Policy.java;1;0;2;1;0;0;0;2;0;1;2;2067;0;0;1;0;0;2;2;2067;0;2315;2;1;
/org.eclipse.jdt.ui.tests.refactoring/resources/RenameType/test56/out/A.java;1;0;1;1;0;0;0;1;0;0;1;1547;0;0;1;0;0;1;1;1547;0;1547;1;1;
/org.eclipse.help.tests/src/org/eclipse/help/tests/HelpSystemTestCase.java;1;0;1;1;0;0;0;1;0;0;1;1642;0;0;1;0;0;1;1;1642;0;1642;1;1;
/org.eclipse.update.core/src/org/eclipse/update/internal/core/InstallConfiguration.java;2;3;93;2;22;17;22;71;316;4;51;1644;4230;4230;4;20;5;71;93;3589;25;4708;68;2;
/org.eclipse.jdt.core/compiler/org/eclipse/jdt/internal/compiler/ast/Break.java;2;1;13;1;2;2;2;11;136;4;8;455;301;301;4;3;0;11;13;1039;3;4421;10;2;
/org.eclipse.help/src/org/eclipse/help/internal/protocols/LiveHelpURLHandler.java;1;0;2;1;0;0;0;2;0;1;2;2694;0;0;1;0;0;2;2;2694;0;2773;2;1;
/org.eclipse.jdt.ui.tests.refactoring/resources/RenameVirtualMethodInClass/testFail18/in/A.java;1;0;1;1;0;0;0;1;0;0;1;49;0;0;1;0;0;1;1;49;0;49;1;1;
/org.eclipse.swt/Eclipse SWT Custom Widgets/common/org/eclipse/swt/custom/StyledTextRenderer.java;2;0;3;1;1;1;1;2;872;1;2;3142;879;879;1;0;0;2;3;3142;0;4701;3;2;
/org.eclipse.jdt.core/compiler/org/eclipse/jdt/internal/compiler/codegen/DoubleCache.java;2;1;12;1;2;2;2;10;245;4;6;455;357;357;4;4;0;10;12;1039;4;4062;8;2;
/org.eclipse.jdt.ui.tests.refactoring/resources/ExtractMethodWorkSpace/ExtractMethodTests/expression_out/A_test615.java;1;1;3;1;2;2;2;1;0;0;1;1236;0;0;1;0;0;1;3;1236;0;4419;3;1;
/org.eclipse.jdt.core/eval/org/eclipse/jdt/internal/eval/CodeSnippetTypeDeclaration.java;2;0;5;1;1;1;1;4;106;1;4;455;132;132;1;0;0;4;5;455;0;4062;5;2;
/org.eclipse.debug.ui/ui/org/eclipse/debug/internal/ui/ShowBreakpointsForModelAction.java;2;0;6;2;0;0;0;6;53;4;3;2317;53;53;4;3;0;6;6;2328;3;2382;3;2;
/org.eclipse.jdt.debug.tests/testprograms/LocalVariablesTests.java;2;0;2;1;1;1;1;1;11;0;1;3719;11;11;1;0;0;1;2;3719;0;4571;2;2;
/org.eclipse.jdt.core/model/org/eclipse/jdt/internal/core/builder/IBuildMonitor.java;1;0;3;1;0;0;0;3;10;1;3;455;10;10;1;0;0;3;3;455;0;2808;3;1;
/org.eclipse.jdt.ui.tests.refactoring/resources/ExtractMethodWorkSpace/ExtractMethodTests/semicolon_out/A_test410.java;1;1;3;1;2;2;2;1;4;0;1;1236;4;4;1;0;0;1;3;1236;0;4419;3;1;
/org.eclipse.swt/Eclipse SWT PI/motif/org/eclipse/swt/internal/motif/CDE.java;2;0;2;1;1;1;1;1;6;0;1;2069;6;6;1;0;0;1;2;2069;0;4701;2;2;
/org.eclipse.pde.ui/src/org/eclipse/pde/internal/base/model/feature/IFeatureInfo.java;1;0;3;1;0;0;0;3;3;2;2;2951;3;3;2;1;0;3;3;2951;1;3579;2;1;
/org.eclipse.swt/Eclipse SWT Accessibility/win32/org/eclipse/swt/accessibility/OSACC.java;1;0;3;1;0;0;0;3;4;2;2;3007;4;4;2;1;0;3;3;3007;1;3030;2;1;
/org.eclipse.help.ui/Eclipse Help UI Motif/org/eclipse/help/internal/ui/motif/BrowserFactory.java;2;0;3;1;0;0;0;3;7;1;3;136;7;7;1;0;0;3;3;136;0;1420;3;2;
/org.eclipse.jdt.core/dom/org/eclipse/jdt/core/dom/ASTErrorPropagator.java;1;0;2;1;0;0;0;2;11;1;2;2739;11;11;1;0;0;2;2;2739;0;2776;2;1;
/org.eclipse.jdt.core/compiler/org/eclipse/jdt/internal/compiler/ast/WhileStatement.java;2;0;14;1;1;1;1;13;345;4;10;455;790;790;4;3;0;13;14;1039;3;4062;11;2;
/org.eclipse.pde.ui/src/org/eclipse/pde/internal/ui/editor/build/BuildSourcePage.java;1;0;1;1;0;0;0;1;0;0;1;3579;0;0;1;0;0;1;1;3579;0;3579;1;1;
/org.eclipse.scripting/src/org/eclipse/scripting/internal/ScriptReporter.java;1;0;1;1;0;0;0;1;0;0;1;1424;0;0;1;0;0;1;1;1424;0;1424;1;1;
/org.eclipse.pde.ui/src/org/eclipse/pde/internal/editor/manifest/RequiresSection.java;2;0;10;1;0;0;0;10;300;1;10;1434;416;416;1;0;0;10;10;1434;0;3579;10;2;
/org.eclipse.help/src/org/eclipse/help/internal/context/ContextImpl.java;2;0;4;1;0;0;0;4;4;1;4;1675;7;7;1;0;0;4;4;1675;0;2829;4;2;
/org.eclipse.pde.ui/src/org/eclipse/pde/internal/base/model/IModel.java;2;0;5;1;0;0;0;5;26;1;5;1434;49;49;1;0;0;5;5;1434;0;3039;5;2;
/org.eclipse.jdt.core/eval/org/eclipse/jdt/internal/eval/EvaluationResult.java;2;0;13;1;1;1;1;12;363;4;7;455;584;584;4;5;0;12;13;1039;5;4062;8;2;
/org.eclipse.jdt.ui/ui refactoring/org/eclipse/jdt/internal/ui/nls/search/NLSSearchOperation.java;1;0;2;1;0;0;0;2;0;1;2;1913;0;0;1;0;0;2;2;1913;0;1922;2;1;
/org.eclipse.ui/Eclipse UI/org/eclipse/ui/part/EditorActionBarContributor.java;4;1;4;1;2;2;2;2;33;1;2;257;48;48;1;0;0;2;4;257;0;4453;4;4;
/org.eclipse.jdt.launching/launching/org/eclipse/jdt/launching/AbstractVMInstall.java;1;1;9;1;8;8;8;1;17;0;1;2022;84;84;1;0;0;1;9;2022;0;4651;9;1;
/org.eclipse.vcm.core.cvs/src/org/eclipse/vcm/internal/core/ccvs/requests/Diff.java;3;0;5;1;0;0;0;5;140;1;5;0;166;166;1;0;0;5;5;0;0;1627;5;3;
/org.eclipse.swt/Eclipse SWT PI/motif/org/eclipse/swt/internal/motif/XmTextVerifyCallbackStruct.java;2;0;2;1;1;1;1;1;6;0;1;2069;6;6;1;0;0;1;2;2069;0;4701;2;2;
/org.eclipse.vcm.ui.cvs/src/org/eclipse/vcm/internal/ui/ccvs/LoadModuleAliasAction.java;1;0;2;1;0;0;0;2;228;0;1;1385;228;228;2;1;0;2;2;1385;1;1385;1;1;
/org.eclipse.ant.core/src/org/eclipse/ant/internal/core/Type.java;1;0;4;1;0;0;0;4;66;2;3;3452;84;84;2;1;0;4;4;3489;1;3575;3;1;
/org.eclipse.jdt.ui/ui/org/eclipse/jdt/internal/ui/codemanipulation/StubUtility.java;4;0;31;1;0;0;0;31;178;2;29;15;919;919;2;2;0;31;31;326;2;2016;29;4;
/org.eclipse.swt/Eclipse SWT/common/org/eclipse/swt/internal/image/PngDecodingDataStream.java;2;0;3;1;1;1;1;2;14;1;2;106;20;20;1;0;0;2;3;106;0;4701;3;2;
/org.eclipse.swt/Eclipse SWT PI/photon/org/eclipse/swt/internal/photon/PhPointerEvent_t.java;2;0;2;1;1;1;1;1;6;0;1;2069;6;6;1;0;0;1;2;2069;0;4701;2;2;
/org.eclipse.swt.examples.paint/src/org/eclipse/swt/examples/paint/PaintViewAction.java;2;0;2;1;0;0;0;2;0;1;2;391;0;0;1;0;0;2;2;391;0;611;2;2;
/org.eclipse.team.cvs.ui/src/org/eclipse/team/internal/ccvs/ui/wizards/KSubstWizardSharedFilesPage.java;3;1;6;1;3;3;3;3;23;1;3;3251;47;47;1;0;0;3;6;3251;0;4626;6;3;
/org.eclipse.vcm.core/src/org/eclipse/vcm/internal/core/ResourceComparator.java;2;0;2;1;0;0;0;2;6;1;2;0;6;6;1;0;0;2;2;0;0;297;2;2;
/org.eclipse.jdt.ui/core refactoring/org/eclipse/jdt/core/refactoring/types/ExtractInterfaceRefactoring.java;1;0;2;1;0;0;0;2;0;1;2;15;0;0;1;0;0;2;2;15;0;47;2;1;
/org.eclipse.pde.ui/Eclipse PDE UI/org/eclipse/pde/internal/base/IPluginContentWizard.java;2;0;5;2;0;0;0;5;12;3;3;267;12;12;3;2;0;5;5;324;2;1434;3;2;
/org.eclipse.ui/Eclipse UI Standard Components/org/eclipse/ui/wizards/datatransfer/ZipFileExporter.java;2;0;2;1;0;0;0;2;23;1;2;257;23;23;1;0;0;2;2;257;0;457;2;2;
/org.eclipse.jdt.debug/jdi/org/eclipse/jdi/internal/spy/VerboseWriter.java;2;0;5;1;0;0;0;5;14;1;5;187;39;39;1;0;0;5;5;187;0;3678;5;2;
/org.eclipse.pde.ui/Eclipse PDE UI/org/eclipse/pde/internal/model/component/WorkspaceComponentModel.java;2;0;8;2;0;0;0;8;12;3;6;267;24;24;3;2;0;8;8;324;2;1434;6;2;
/org.eclipse.ui.examples.javaeditor/Java Editor Example/org/eclipse/ui/examples/javaeditor/JavaSourceViewerConfiguration.java;1;0;2;1;0;0;0;2;0;0;1;1066;0;0;2;1;0;2;2;1066;1;1066;1;1;
/org.eclipse.pde.ui/src/org/eclipse/pde/internal/base/model/plugin/IPluginAttribute.java;2;0;2;1;0;0;0;2;0;1;2;1434;0;0;1;0;0;2;2;1434;0;3039;2;2;
/org.eclipse.jdt.ui/ui/org/eclipse/jdt/internal/ui/PersistableJavaElementFactory.java;2;0;2;1;0;0;0;2;4;1;2;335;4;4;1;0;0;2;2;335;0;740;2;2;
/org.eclipse.jdt.ui.tests.refactoring/resources/RenameType/test7/out/B.java;1;0;1;1;0;0;0;1;0;0;1;522;0;0;1;0;0;1;1;522;0;522;1;1;
/org.eclipse.swt/Eclipse SWT/common/org/eclipse/swt/widgets/Dialog.java;5;2;9;1;3;2;3;6;39;1;6;106;83;83;2;0;1;6;9;4557;1;4701;8;5;
/org.eclipse.core.tests.resources/src/org/eclipse/core/tests/resources/session/TestClosedProjectLocation.java;1;0;1;1;0;0;0;1;0;0;1;3507;0;0;1;0;0;1;1;3507;0;3507;1;1;
/org.eclipse.jdt.ui/ui refactoring/org/eclipse/jdt/internal/ui/refactoring/actions/TextSelectionAction.java;2;0;8;1;0;0;0;8;111;2;7;2139;164;164;2;1;0;8;8;2270;1;3792;7;2;
/org.eclipse.jdt.ui.tests.refactoring/resources/RenameVariables/canRename/A_test20_in.java;1;0;2;1;0;0;0;2;0;1;2;724;0;0;1;0;0;2;2;724;0;1665;2;1;
/org.eclipse.jdt.junit/src/org/eclipse/jdt/internal/junit/launcher/JavaBrowsingMessages.java;1;0;1;1;1;1;1;0;0;0;0;4254;0;0;1;0;0;0;1;4254;0;4254;1;1;
/org.eclipse.team.cvs.core/src/org/eclipse/team/internal/ccvs/core/response/ResponseDispatcher.java;3;0;6;1;0;0;0;6;567;1;6;1978;1145;1145;1;0;0;6;6;1978;0;2607;6;3;
/org.eclipse.scripting/Eclipse Scripting/org/eclipse/scripting/ScriptAdapterWorkbenchNewWizard.java;2;0;4;1;0;0;0;4;13;1;4;133;22;22;1;0;0;4;4;133;0;1424;4;2;
/org.eclipse.vcm.tests.core/src/org/eclipse/vcm/tests/core/regression/Regressions.java;1;0;1;1;0;0;0;1;0;0;1;1688;0;0;1;0;0;1;1;1688;0;1688;1;1;
/org.eclipse.jdt.core/eval/org/eclipse/jdt/internal/eval/VariablesInfo.java;2;0;3;1;1;1;1;2;83;1;2;455;100;100;1;0;0;2;3;455;0;4062;3;2;
/org.eclipse.jdt.ui.tests.refactoring/resources/RenameType/test43/in/A.java;1;0;2;1;0;0;0;2;2;1;2;49;2;2;1;0;0;2;2;49;0;522;2;1;
/org.eclipse.help.tests/src/org/eclipse/help/tests/browsers/AllHelpBrowsersTests.java;1;0;2;1;0;0;0;2;2;1;2;2737;2;2;1;0;0;2;2;2737;0;2805;2;1;
/org.eclipse.jdt.ui/ui/org/eclipse/jdt/internal/ui/viewsupport/ImageDisposer.java;2;0;3;1;0;0;0;3;4;1;3;15;8;8;1;0;0;3;3;15;0;1256;3;2;
/org.eclipse.pde.ui/templates/newWizard/java/$wizardPageClassName$.java;1;0;1;1;0;0;0;1;0;0;1;3442;0;0;1;0;0;1;1;3442;0;3442;1;1;
/org.eclipse.ant.core/src/org/eclipse/ant/core/toolscripts/AntBuilder.java;1;0;3;1;0;0;0;3;2;1;3;2919;2;2;1;0;0;3;3;2919;0;2979;3;1;
/org.eclipse.swt/Eclipse SWT Drag and Drop/motif/org/eclipse/swt/dnd/RTFTransfer.java;3;1;8;1;6;6;6;2;76;1;2;106;205;205;1;0;0;2;8;106;0;4824;8;3;
/org.eclipse.vcm.core.cvs/src/org/eclipse/vcm/internal/core/ccvs/requests/ModuleExpansions.java;2;0;2;1;0;0;0;2;49;1;2;1008;49;49;1;0;0;2;2;1008;0;1277;2;2;
/org.eclipse.jdt.ui.tests.refactoring/resources/SelectionAnalyzerWorkSpace/SelectionAnalyzerTests/validSelection/A_test251.java;1;0;1;1;0;0;0;1;0;0;1;1368;0;0;1;0;0;1;1;1368;0;1368;1;1;
/org.eclipse.core.tests.runtime/src/org/eclipse/core/tests/internal/runtimetests/SampleHPR.java;1;0;2;1;0;0;0;2;10;1;2;3611;10;10;1;0;0;2;2;3611;0;3678;2;1;
/org.eclipse.jdt.ui.tests.refactoring/resources/ExtractMethodWorkSpace/ExtractMethodTests/return_out/A_test724.java;1;1;4;1;2;2;2;2;46;1;2;2684;48;48;1;0;0;2;4;2684;0;4419;4;1;
/org.eclipse.pde.ui/Eclipse PDE UI/org/eclipse/pde/internal/forms/FormButton.java;2;0;5;2;0;0;0;5;12;3;3;267;12;12;3;2;0;5;5;324;2;1434;3;2;
/org.eclipse.jdt.debug/eval/org/eclipse/jdt/internal/debug/eval/ast/engine/PushClassLiteralValue.java;1;0;2;1;0;0;0;2;0;1;2;3329;0;0;1;0;0;2;2;3329;0;3421;2;1;
/org.eclipse.jdt.ui.tests.refactoring/resources/RenameMethodInInterface/test24/out/A.java;1;0;1;1;0;0;0;1;0;0;1;49;0;0;1;0;0;1;1;49;0;49;1;1;
/org.eclipse.pde.ui/Eclipse PDE UI/org/eclipse/pde/internal/elements/TreeContentProvider.java;2;0;5;2;0;0;0;5;12;3;3;267;12;12;3;2;0;5;5;324;2;1434;3;2;
/org.eclipse.jdt.ui.tests.refactoring/resources/RenameTemp/canRename/A_test29_out.java;1;0;2;1;0;0;0;2;2;1;2;1625;2;2;1;0;0;2;2;1625;0;1652;2;1;
/org.eclipse.core.tests.resources/src/org/eclipse/core/tests/resources/usecase/Snapshot5Test.java;3;0;5;1;0;0;0;5;104;1;5;1794;137;137;1;0;0;5;5;1794;0;3420;5;3;
/org.eclipse.jdt.ui/ui/org/eclipse/jdt/internal/ui/text/javadoc/CompletionEvaluator.java;5;0;25;2;0;0;0;25;2812;2;21;15;3171;3171;2;4;0;25;25;25;4;3659;21;5;
/org.eclipse.core.tests.runtime/src/org/eclipse/core/tests/internal/plugin/a/ExtensionDirectCompilerReferenceToPluginClass.java;3;0;3;1;0;0;0;3;22;1;3;1794;32;32;1;0;0;3;3;1794;0;3476;3;3;
/org.eclipse.jdt.ui/core extension/org/eclipse/jdt/internal/corext/dom/CompilationUnitBuffer.java;2;1;7;1;2;2;2;5;50;2;4;3006;93;93;2;1;0;5;7;3481;1;4000;6;2;
/org.eclipse.vcm.core.cvs/src/org/eclipse/vcm/internal/core/ccvs/requests/ITagListener.java;2;0;2;1;0;0;0;2;6;1;2;0;6;6;1;0;0;2;2;0;0;298;2;2;
/org.eclipse.team.cvs.ui/src/org/eclipse/team/internal/ccvs/ui/sync/CVSSyncCompareUnsharedInput.java;1;0;1;1;1;1;1;0;0;0;0;4023;0;0;1;0;0;0;1;4023;0;4023;1;1;
/org.eclipse.jdt.ui/core refactoring/org/eclipse/jdt/internal/corext/refactoring/tagging/IMultiRenameRefactoring.java;1;0;1;1;0;0;0;1;0;0;1;1939;0;0;1;0;0;1;1;1939;0;1939;1;1;
/org.eclipse.update.core/src/org/eclipse/update/core/SiteContentProvider.java;2;0;8;1;0;0;0;8;80;2;7;2467;197;197;2;1;0;8;8;3027;1;3796;7;2;
/org.eclipse.swt/Eclipse SWT PI/motif/org/eclipse/swt/internal/motif/XWindowChanges.java;2;0;2;1;1;1;1;1;6;0;1;2069;6;6;1;0;0;1;2;2069;0;4701;2;2;
/org.eclipse.jdt.debug/eval/org/eclipse/jdt/internal/debug/eval/ast/engine/SimpleInstruction.java;1;0;3;1;0;0;0;3;2;1;3;3329;2;2;1;0;0;3;3;3329;0;3421;3;1;
/org.eclipse.pde.ui/Eclipse PDE UI/org/eclipse/pde/internal/editor/build/VariableSelectionDialog.java;2;0;5;2;0;0;0;5;12;3;3;267;12;12;3;2;0;5;5;324;2;1434;3;2;
/org.eclipse.jdt.debug.ui/ui/org/eclipse/jdt/internal/debug/ui/launcher/JavaJRETab.java;2;1;5;1;5;5;5;0;125;0;0;3939;236;236;1;0;0;0;5;3939;0;4098;5;2;
/org.eclipse.pde.ui/src/org/eclipse/pde/internal/model/plugin/WorkspacePluginModelBase.java;1;0;3;1;0;0;0;3;264;1;3;3136;264;264;1;0;0;3;3;3136;0;3579;3;1;
/org.eclipse.update.ui.win32/src/org/eclipse/update/internal/ui/win32/views/BrowserControlSite.java;1;0;1;1;1;1;1;0;0;0;0;4127;0;0;1;0;0;0;1;4127;0;4127;1;1;
/org.eclipse.jdt.junit/Eclipse JUnit/org/eclipse/jdt/junit/internal/BaseLauncher.java;2;0;2;1;0;0;0;2;0;1;2;1531;0;0;1;0;0;2;2;1531;0;2007;2;2;
/org.eclipse.pde.ui/src/org/eclipse/pde/core/plugin/IMatchRules.java;1;0;2;1;0;0;0;2;0;1;2;3579;0;0;1;0;0;2;2;3579;0;3607;2;1;
/org.eclipse.jdt.debug.ui/ui/org/eclipse/jdt/internal/debug/ui/JDIViewerConfiguration.java;2;0;4;1;0;0;0;4;3;1;4;1933;6;6;1;0;0;4;4;1933;0;3634;4;2;
/org.eclipse.team.core/src/org/eclipse/team/internal/core/DefaultMoveDeleteHook.java;1;0;1;1;0;0;0;1;0;0;1;3762;0;0;1;0;0;1;1;3762;0;3762;1;1;
/org.eclipse.jdt.debug/model/org/eclipse/jdt/internal/debug/core/JDIArrayValue.java;3;0;5;1;0;0;0;5;17;1;5;1758;27;27;1;0;0;5;5;1758;0;2517;5;3;
/org.eclipse.jdt.ui/nls/org/eclipse/jdt/internal/ui/nls/search/NLSSearchPage.java;1;0;2;1;0;0;0;2;0;1;2;1880;0;0;1;0;0;2;2;1880;0;1913;2;1;
/org.eclipse.pde.ui/Eclipse PDE UI/org/eclipse/pde/internal/editor/schema/GrammarSection.java;2;0;8;2;0;0;0;8;24;3;6;267;40;40;3;2;0;8;8;324;2;1434;6;2;
/org.eclipse.jdt.ui/ui debug/org/eclipse/jdt/internal/debug/ui/DebugUIUtils.java;2;0;4;1;0;0;0;4;8;1;4;15;10;10;1;0;0;4;4;15;0;1916;4;2;
/org.eclipse.jdt.ui/core extension/org/eclipse/jdt/internal/corext/util/SuperTypeHierarchyCache.java;1;0;1;1;0;0;0;1;0;0;1;3628;0;0;1;0;0;1;1;3628;0;3628;1;1;
/org.eclipse.jdt.ui.tests/ui/com/ibm/jdt/ui/wizards/examples/TabTest.java;1;0;3;1;0;0;0;3;4;1;3;255;4;4;1;0;0;3;3;255;0;522;3;1;
/org.eclipse.jdt.ui/ui/org/eclipse/jdt/ui/actions/SelectionDispatchAction.java;1;1;6;1;2;2;2;4;127;2;3;3533;186;186;2;1;0;4;6;3641;1;4770;5;1;
/org.eclipse.debug.ui/ui/org/eclipse/debug/internal/ui/RemoveAllFromInspectorAction.java;2;0;6;1;0;0;0;6;8;1;6;187;25;25;1;0;0;6;6;187;0;2348;6;2;
/org.eclipse.search/search/org/eclipse/search/internal/ui/SearchDialog.java;2;1;25;1;7;7;7;18;87;3;15;15;476;476;3;3;0;18;25;2629;3;4359;22;2;
/org.eclipse.debug.ui/ui/org/eclipse/debug/internal/ui/VariablesContentProvider.java;4;0;15;1;0;0;0;15;49;2;14;187;190;190;2;1;0;15;15;2343;1;2343;14;4;
/org.eclipse.swt.examples/src/org/eclipse/swt/examples/fileviewer/TreeDropFeedbackListener.java;2;0;7;1;0;0;0;7;8;4;4;613;10;10;4;3;0;7;7;641;3;1625;4;2;
/org.eclipse.jdt.ui.tests.refactoring/resources/RenameMethodInInterface/test18/in/A.java;1;0;1;1;0;0;0;1;0;0;1;49;0;0;1;0;0;1;1;49;0;49;1;1;
/org.eclipse.pde.ui/src/org/eclipse/pde/BuildPathUtil.java;1;0;6;1;0;0;0;6;121;1;6;3039;149;149;1;0;0;6;6;3039;0;3579;6;1;
/org.eclipse.core.tests.runtime/src/org/eclipse/core/tests/internal/plugins/SoftPrereqTest_1.java;3;0;3;1;0;0;0;3;110;1;3;1794;120;120;1;0;0;3;3;1794;0;3476;3;3;
/org.eclipse.pde.build/src/org/eclipse/pde/internal/build/tasks/BuildScriptGeneratorTask.java;1;0;7;1;0;0;0;7;203;2;6;3018;290;290;2;1;0;7;7;3104;1;3509;6;1;
/org.eclipse.jdt.debug/jdi/org/eclipse/jdi/VirtualMachine.java;1;0;2;1;0;0;0;2;11;1;2;187;11;11;1;0;0;2;2;187;0;366;2;1;
/org.eclipse.scripting/src/org/eclipse/scripting/IScriptPreferencePage.java;1;0;1;1;0;0;0;1;0;0;1;1424;0;0;1;0;0;1;1;1424;0;1424;1;1;
/org.eclipse.update.tests.core/src/org/eclipse/update/tests/types/AllTypesTests.java;1;0;2;1;0;0;0;2;1;1;2;2251;1;1;1;0;0;2;2;2251;0;2276;2;1;
/org.eclipse.jdt.core/compiler/org/eclipse/jdt/internal/compiler/env/IBinaryField.java;2;0;3;1;1;1;1;2;32;1;2;455;48;48;1;0;0;2;3;455;0;4062;3;2;
/org.eclipse.ui/Eclipse UI/org/eclipse/ui/IProjectActionFilter.java;3;0;3;1;0;0;0;3;5;1;3;257;9;9;1;0;0;3;3;257;0;721;3;3;
/org.eclipse.jdt.core/compiler/org/eclipse/jdt/internal/compiler/ast/InstanceOfExpression.java;2;1;15;1;2;2;2;13;368;4;10;455;778;778;4;3;0;13;15;1039;3;4421;12;2;
/org.eclipse.swt/Eclipse SWT PI/win32/org/eclipse/swt/internal/ole/win32/STGMEDIUM.java;2;0;2;1;1;1;1;1;6;0;1;2069;6;6;1;0;0;1;2;2069;0;4701;2;2;
/org.eclipse.jdt.debug.tests/test programs/ArgumentsTests.java;1;0;2;1;0;0;0;2;0;1;2;3701;0;0;1;0;0;2;2;3701;0;3719;2;1;
/org.eclipse.jdt.ui.tests/ui/org/eclipse/jdt/ui/tests/core/TypeRefTest.java;2;0;5;1;0;0;0;5;122;1;5;1189;142;142;1;0;0;5;5;1189;0;1379;5;2;
/org.eclipse.scripting/src/org/eclipse/scripting/internal/datamodels/XGRXmlDataModel.java;1;0;1;1;0;0;0;1;0;0;1;1424;0;0;1;0;0;1;1;1424;0;1424;1;1;
/org.eclipse.scripting/src/org/eclipse/scripting/internal/views/ScriptConsole.java;1;0;1;1;0;0;0;1;0;0;1;1424;0;0;1;0;0;1;1;1424;0;1424;1;1;
/org.eclipse.help.ui/Eclipse Help UI Win32/org/eclipse/help/internal/ui/win32/BrowserFactory.java;2;0;3;1;0;0;0;3;7;1;3;136;7;7;1;0;0;3;3;136;0;1420;3;2;
/org.eclipse.team.cvs.ui/src/org/eclipse/team/internal/ccvs/ui/wizards/ConfigurationWizardPostPage.java;1;0;2;1;0;0;0;2;0;1;2;2435;0;0;1;0;0;2;2;2435;0;2577;2;1;
/org.eclipse.update/Eclipse Update/org/eclipse/update/internal/core/UMLock.java;1;0;3;1;0;0;0;3;15;1;3;108;15;15;1;0;0;3;3;108;0;1424;3;1;
/org.eclipse.jdt.ui/ui/org/eclipse/jdt/internal/ui/actions/ActionMessages.java;1;0;1;1;0;0;0;1;0;0;1;3571;0;0;1;0;0;1;1;3571;0;3571;1;1;
/org.eclipse.update/src/org/eclipse/update/internal/ui/UMWizardPageURLInstallable.java;1;0;1;1;0;0;0;1;0;0;1;1424;0;0;1;0;0;1;1;1424;0;1424;1;1;
/org.eclipse.jdt.ui/ui refactoring/org/eclipse/jdt/internal/ui/refactoring/actions/PullUpMethodsActionDelegate.java;1;0;2;1;0;0;0;2;0;1;2;2270;0;0;1;0;0;2;2;2270;0;2406;2;1;
/org.eclipse.debug.core/core/org/eclipse/debug/core/ILaunchManager.java;3;1;33;1;5;5;5;28;84;3;24;187;668;668;3;4;0;28;33;1724;4;4650;29;3;
/org.eclipse.ui/Eclipse JFace/org/eclipse/jface/preference/PreferenceManager.java;2;0;2;1;0;0;0;2;5;1;2;257;5;5;1;0;0;2;2;257;0;457;2;2;
/org.eclipse.jdt.debug/eval/org/eclipse/jdt/internal/debug/eval/ast/instructions/PlusOperator.java;3;0;6;1;0;0;0;6;53;1;6;3421;66;66;1;0;0;6;6;3421;0;3677;6;3;
/org.eclipse.vcm.core/src/org/eclipse/vcm/internal/core/SyncInfo.java;3;0;3;1;0;0;0;3;6;1;3;0;12;12;1;0;0;3;3;0;0;297;3;3;
/org.eclipse.jdt.ui.tests.refactoring/resources/RenameMethodInInterface/testFail20/in/A.java;1;0;1;1;0;0;0;1;0;0;1;49;0;0;1;0;0;1;1;49;0;49;1;1;
/org.eclipse.jdt.debug.tests/tests/org/eclipse/jdt/debug/tests/eval/ShortOperatorsTests.java;2;1;3;1;3;3;3;0;17;0;0;4447;19;19;1;0;0;0;3;4447;0;4571;3;2;
/org.eclipse.core.runtime/src/org/eclipse/core/internal/runtime/Log.java;3;1;5;1;2;2;2;3;146;1;3;12;170;170;1;0;0;3;5;12;0;4753;5;3;
/org.eclipse.scripting/Eclipse Scripting/org/eclipse/scripting/internal/views/ScriptDevelopmentWizardPageScriptLanguage.java;2;0;4;1;0;0;0;4;17;1;4;133;29;29;1;0;0;4;4;133;0;1424;4;2;
/org.eclipse.help/src/org/eclipse/help/internal/navigation1_0/HelpNavigationManager.java;2;0;3;1;0;0;0;3;13;1;3;1675;13;13;1;0;0;3;3;1675;0;2217;3;2;
/org.eclipse.team.tests.core/src/org/eclipse/team/tests/core/SyncElementTest.java;1;2;6;1;6;5;6;0;54;0;0;4368;105;105;2;0;1;0;6;4368;1;4636;5;1;
/org.eclipse.core.runtime/src/org/eclipse/core/internal/runtime/PlatformLogReader.java;2;1;8;1;2;2;2;6;426;1;6;1817;1094;1094;1;0;0;6;8;1817;0;4127;8;2;
/org.eclipse.jdt.debug.ui/ui/org/eclipse/jdt/internal/debug/ui/JavaLocalApplicationLaunchConfigurationDelegate.java;3;0;19;2;0;0;0;19;166;2;15;2556;600;600;2;4;0;19;19;2688;4;3055;15;3;
/org.eclipse.jdt.ui/core refactoring/org/eclipse/jdt/internal/core/refactoring/packages/RenameSourceFolderRefactoring.java;1;0;1;1;0;0;0;1;0;0;1;988;0;0;1;0;0;1;1;988;0;988;1;1;
/org.eclipse.debug.ui/ui/org/eclipse/debug/internal/ui/LaunchDropDownAction.java;3;0;7;1;0;0;0;7;50;1;7;187;96;96;1;0;0;7;7;187;0;2382;7;3;
/org.eclipse.search/search/org/eclipse/search/internal/ui/util/FileLabelProvider.java;1;0;10;1;1;1;1;9;93;1;9;1117;170;170;1;0;0;9;10;1117;0;4078;10;1;
/org.eclipse.pde.core/src/org/eclipse/pde/core/IModelChangeProvider.java;1;0;3;1;2;1;2;1;40;0;1;3591;40;40;2;0;1;1;3;4751;1;4751;2;1;
/org.eclipse.pde.ui/src/org/eclipse/pde/internal/core/ischema/ISchemaObject.java;1;0;2;1;0;0;0;2;0;1;2;3591;0;0;1;0;0;2;2;3591;0;3607;2;1;
/org.eclipse.jdt.ui.tests.refactoring/resources/ExtractTemp/canExtract/A_test30_out.java;1;0;1;1;0;0;0;1;0;0;1;3210;0;0;1;0;0;1;1;3210;0;3210;1;1;
/org.eclipse.jdt.ui/ui/org/eclipse/jdt/internal/ui/text/template/ArgumentEvaluator.java;1;0;3;1;0;0;0;3;23;1;3;1469;23;23;1;0;0;3;3;1469;0;1618;3;1;
/org.eclipse.swt/Eclipse SWT Drag and Drop/motif/org/eclipse/swt/dnd/Transfer.java;4;1;9;1;6;6;6;3;75;1;3;106;251;251;1;0;0;3;9;106;0;4830;9;4;
/org.eclipse.jdt.core/compiler/org/eclipse/jdt/internal/compiler/ast/StringLiteral.java;2;0;11;1;1;1;1;10;176;4;7;455;399;399;4;3;0;10;11;1039;3;4062;8;2;
/org.eclipse.jdt.core/compiler/org/eclipse/jdt/internal/compiler/impl/Constant.java;2;0;13;1;1;1;1;12;3930;4;9;455;4373;4373;4;3;0;12;13;1039;3;4062;10;2;
/org.eclipse.team.cvs.core/src/org/eclipse/team/internal/ccvs/core/commands/ICommand.java;3;0;3;1;0;0;0;3;4;1;3;1978;4;4;1;0;0;3;3;1978;0;2607;3;3;
/org.eclipse.help.webapp/src/org/eclipse/help/internal/proxy/protocol/ProxyHandler.java;2;0;2;1;0;0;0;2;19;1;2;3454;19;19;1;0;0;2;2;3454;0;3484;2;2;
/org.eclipse.jdt.ui.tests.refactoring/resources/ExtractMethodWorkSpace/ExtractMethodTests/locals_in/A_test530.java;1;1;3;1;2;2;2;1;18;0;1;922;18;18;1;0;0;1;3;922;0;4419;3;1;
/org.eclipse.scripting/src/org/eclipse/scripting/internal/IXGRElementCaption.java;1;0;1;1;0;0;0;1;0;0;1;1424;0;0;1;0;0;1;1;1424;0;1424;1;1;
/org.eclipse.ui.externaltools/External Tools/org/eclipse/ui/externaltools/internal/ui/AntLaunchWizardPage.java;2;2;6;1;6;5;6;0;60;0;0;4090;71;71;2;0;1;0;6;4462;1;4462;5;2;
/org.eclipse.jdt.ui.tests.refactoring/resources/RenameMethodInInterface/test13/out/A.java;2;0;2;1;0;0;0;2;0;1;2;49;0;0;1;0;0;2;2;49;0;1258;2;2;
/org.eclipse.jdt.core/search/org/eclipse/jdt/internal/core/search/matching/SuperInterfaceReferencePattern.java;2;0;11;1;1;1;1;10;324;4;6;455;637;637;4;4;0;10;11;1039;4;4063;7;2;
/org.eclipse.jdt.core/search/org/eclipse/jdt/core/search/ISearchPattern.java;3;2;5;2;3;2;3;2;14;1;2;455;23;23;2;0;1;2;5;4421;1;4421;4;3;
/org.eclipse.pde.ui/Eclipse PDE UI/org/eclipse/pde/internal/editor/manifest/ManifestFormPage.java;2;0;5;2;0;0;0;5;12;3;3;267;12;12;3;2;0;5;5;324;2;1434;3;2;
/org.eclipse.help.ui/Eclipse Help UI/org/eclipse/help/internal/ui/IBrowser.java;3;0;4;1;0;0;0;4;7;1;4;136;9;9;1;0;0;4;4;136;0;1420;4;3;
/org.eclipse.scripting/src/org/eclipse/scripting/internal/uirenderer/XGRUILinkManager.java;1;0;1;1;0;0;0;1;0;0;1;1424;0;0;1;0;0;1;1;1424;0;1424;1;1;
/org.eclipse.help/src/org/eclipse/help/internal/server/TempURL.java;2;0;7;1;0;0;0;7;34;2;6;1420;39;39;2;1;0;7;7;1930;1;1930;6;2;
/org.eclipse.pde.ui/src/org/eclipse/pde/internal/launcher/AbstractLauncherTab.java;1;0;4;1;0;0;0;4;64;1;4;3093;87;87;1;0;0;4;4;3093;0;3579;4;1;
/org.eclipse.pde.ui/src/org/eclipse/pde/internal/core/schema/RepeatableSchemaObject.java;1;0;3;1;0;0;0;3;2;1;3;3579;2;2;1;0;0;3;3;3579;0;3607;3;1;
/org.eclipse.scripting/Eclipse Scripting/org/eclipse/scripting/internal/views/ScriptUIEditorCompletionProcessor.java;2;0;4;1;0;0;0;4;7;1;4;133;9;9;1;0;0;4;4;133;0;1424;4;2;
/org.eclipse.jdt.ui/ui/org/eclipse/jdt/internal/ui/actions/OpenTypeAction.java;7;1;18;1;3;3;3;15;53;1;15;15;274;274;1;0;0;15;18;15;0;4630;18;7;
/org.eclipse.jdt.debug.ui/ui/org/eclipse/jdt/internal/debug/ui/actions/AddExceptionDialog.java;3;0;14;2;0;0;0;14;4;2;11;2384;26;26;2;3;0;14;14;2517;3;3853;11;3;
/org.eclipse.core.tests.runtime/src/org/eclipse/core/tests/internal/plugins/RegressionResolveTest_3.java;3;0;3;1;0;0;0;3;132;1;3;1794;142;142;1;0;0;3;3;1794;0;3476;3;3;
/org.eclipse.core.tests.resources/src/org/eclipse/core/tests/internal/indexing/TestPage.java;3;0;4;1;1;1;1;3;78;1;3;1794;108;108;1;0;0;3;4;1794;0;4516;4;3;
/org.eclipse.jdt.ui.tests.refactoring/resources/ExtractMethodWorkSpace/ExtractMethodTests/validSelection/A_test274.java;2;1;3;1;2;2;2;1;4;0;1;195;4;4;1;0;0;1;3;195;0;4419;3;2;
/org.eclipse.webdav/src/kernel/org/eclipse/webdav/internal/kernel/utils/DateTime.java;1;0;4;1;1;1;1;3;218;1;3;12;254;254;1;0;0;3;4;12;0;4211;4;1;
/org.eclipse.swt/Eclipse SWT/motif/org/eclipse/swt/graphics/GCData.java;4;1;5;1;2;2;2;3;19;1;3;106;28;28;1;0;0;3;5;106;0;4701;5;4;
/org.eclipse.jdt.ui.tests.refactoring/resources/SurroundWithWorkSpace/SurroundWithTests/trycatch_in/TestSuperConstructorCall.java;1;0;1;1;0;0;0;1;0;0;1;3209;0;0;1;0;0;1;1;3209;0;3209;1;1;
/org.eclipse.jdt.ui/ui/org/eclipse/jdt/ui/actions/InlineTempAction.java;2;1;5;1;5;5;5;0;64;0;0;3970;70;70;1;0;0;0;5;3970;0;4770;5;2;
/org.eclipse.jdt.ui.tests.refactoring/resources/ExtractMethodWorkSpace/ExtractMethodTests/try_in/A_test459.java;1;1;3;1;2;2;2;1;0;0;1;923;0;0;1;0;0;1;3;923;0;4419;3;1;
/org.eclipse.pde.ui/Eclipse PDE UI/org/eclipse/pde/internal/component/BuildComponentJarAction.java;2;0;5;2;0;0;0;5;12;3;3;267;12;12;3;2;0;5;5;324;2;1434;3;2;
/org.eclipse.jdt.ui/ui/org/eclipse/jdt/ui/text/IColorManagerExtension.java;2;0;3;1;2;1;2;1;23;0;1;1864;23;23;2;0;1;1;3;4810;1;4810;2;2;
/org.eclipse.ui/Eclipse UI/org/eclipse/ui/internal/SelectWorkingSetAction.java;1;0;6;1;1;1;1;5;59;1;5;3287;81;81;1;0;0;5;6;3287;0;3940;6;1;
/org.eclipse.team.cvs.ui/src/org/eclipse/team/internal/ccvs/ui/actions/CompareWithVersionAction.java;1;0;3;1;0;0;0;3;20;2;2;2374;24;24;2;1;0;3;3;2374;1;2388;2;1;
/org.eclipse.swt/Eclipse SWT/photon/org/eclipse/swt/widgets/MessageBox.java;5;1;10;1;3;3;3;7;97;2;6;106;153;153;2;1;0;7;10;2064;1;4701;9;5;
/org.eclipse.vcm.core.cvs/src/org/eclipse/vcm/internal/core/ccvs/Util.java;2;0;3;1;0;0;0;3;5;1;3;0;8;8;1;0;0;3;3;0;0;398;3;2;
/org.eclipse.jdt.core/model/org/eclipse/jdt/internal/core/util/ClassFileReader.java;3;2;11;2;7;5;7;4;53;2;2;3629;173;173;2;2;2;4;11;3629;4;4492;7;3;
/org.eclipse.pde.ui/src/org/eclipse/pde/internal/ui/ischema/ISchemaRestriction.java;1;0;2;1;0;0;0;2;0;1;2;3579;0;0;1;0;0;2;2;3579;0;3591;2;1;
/org.eclipse.pde.build/src/org/eclipse/pde/internal/build/AbstractBuildScriptGenerator.java;1;2;32;1;16;13;16;16;429;3;12;2962;1634;1634;3;4;3;16;32;3190;7;4426;25;1;
/org.eclipse.pde.ui/src/org/eclipse/pde/internal/model/PluginImport.java;2;0;7;1;0;0;0;7;202;1;7;1434;304;304;1;0;0;7;7;1434;0;3136;7;2;
/org.eclipse.jdt.ui.tests.refactoring/resources/RenameType/test29/out/C.java;1;0;1;1;0;0;0;1;0;0;1;49;0;0;1;0;0;1;1;49;0;49;1;1;
/org.eclipse.jdt.ui/ui/org/eclipse/jdt/internal/ui/viewsupport/MemberFilter.java;2;1;6;1;3;3;3;3;43;1;3;3123;92;92;1;0;0;3;6;3123;0;4402;6;2;
/org.eclipse.pde.ui/src/org/eclipse/pde/model/plugin/IPluginLibrary.java;1;0;2;1;0;0;0;2;0;1;2;3039;0;0;1;0;0;2;2;3039;0;3579;2;1;
/org.eclipse.jdt.ui.tests.refactoring/resources/RenameParameters/canRename/A_test32_in.java;1;0;1;1;0;0;0;1;0;0;1;348;0;0;1;0;0;1;1;348;0;348;1;1;
/org.eclipse.jdt.ui.tests.refactoring/resources/SefWorkSpace/SefTests/object_in/TestSetterInExpression.java;1;0;1;1;0;0;0;1;0;0;1;2876;0;0;1;0;0;1;1;2876;0;2876;1;1;
/org.eclipse.scripting/Eclipse Scripting/org/eclipse/scripting/ScriptAdapterWorkbenchResourceEditor.java;2;0;5;1;0;0;0;5;17;1;5;133;42;42;1;0;0;5;5;133;0;1424;5;2;
/org.eclipse.jdt.ui/core refactoring/org/eclipse/jdt/internal/corext/refactoring/SourceRange.java;2;0;6;1;0;0;0;6;17;1;6;1939;31;31;1;0;0;6;6;1939;0;3188;6;2;
/org.eclipse.jdt.ui/core refactoring/org/eclipse/jdt/internal/corext/refactoring/structure/ReorderParametersRefactoring.java;1;0;11;1;1;1;1;10;32;2;9;2270;132;132;2;1;0;10;11;3185;1;4165;10;1;
/org.eclipse.pde/src/org/eclipse/pde/internal/builders/FeatureConsistencyChecker.java;1;0;3;1;1;1;1;2;196;1;2;3631;210;210;1;0;0;2;3;3631;0;3982;3;1;
/org.eclipse.jdt.junit/Eclipse JUnit/org/eclipse/jdt/junit/internal/SearchEngine.java;2;0;2;1;0;0;0;2;0;1;2;1531;0;0;1;0;0;2;2;1531;0;2007;2;2;
/org.eclipse.team.core/src/org/eclipse/team/core/IResourceStateChangeListener.java;3;0;3;1;0;0;0;3;78;1;3;1978;78;78;1;0;0;3;3;1978;0;3213;3;3;
/org.eclipse.help/src/org/eclipse/help/internal/contributions/Action.java;2;0;2;1;0;0;0;2;0;1;2;1420;0;0;1;0;0;2;2;1420;0;1675;2;2;
/org.eclipse.jdt.core/compiler/org/eclipse/jdt/internal/compiler/ast/OperatorIds.java;2;0;4;1;1;1;1;3;18;1;3;455;38;38;1;0;0;3;4;455;0;4062;4;2;
/org.eclipse.jdt.ui.tests.refactoring/resources/RenameVirtualMethodInClass/test33/in/A.java;1;0;1;1;0;0;0;1;0;0;1;1297;0;0;1;0;0;1;1;1297;0;1297;1;1;
/org.eclipse.jdt.ui/core extension/org/eclipse/jdt/internal/corext/codemanipulation/IOverrideMethodQuery.java;1;0;1;1;0;0;0;1;0;0;1;2246;0;0;1;0;0;1;1;2246;0;2246;1;1;
/org.eclipse.update.ui.forms/src/org/eclipse/update/ui/forms/internal/FormLabel.java;1;0;3;1;1;1;1;2;197;1;2;2470;202;202;1;0;0;2;3;2470;0;4365;3;1;
/org.eclipse.team.cvs.ui/src/org/eclipse/team/internal/ccvs/ui/actions/CompareWithRemoteAction.java;3;2;18;2;5;4;5;13;135;1;13;2312;481;481;2;0;1;13;18;3936;1;4428;17;3;
/org.eclipse.jdt.ui.tests.refactoring/resources/DeleteSourceReference/test16/in/A.java;1;0;1;1;1;1;1;0;0;0;0;4018;0;0;1;0;0;0;1;4018;0;4018;1;1;
/org.eclipse.scripting/src/org/eclipse/scripting/ScriptRunner.java;1;0;1;1;0;0;0;1;0;0;1;1424;0;0;1;0;0;1;1;1424;0;1424;1;1;
/org.eclipse.jdt.ui/core refactoring/org/eclipse/jdt/internal/core/refactoring/util/JavaElementMapper.java;1;0;3;1;0;0;0;3;31;1;3;1453;31;31;1;0;0;3;3;1453;0;1939;3;1;
/org.eclipse.swt.tests/JUnit Tests/org/eclipse/swt/tests/junit/Test_org_eclipse_swt_custom_ExtendedModifyEvent.java;2;0;2;1;1;1;1;1;6;0;1;1792;6;6;1;0;0;1;2;1792;0;4706;2;2;
/org.eclipse.core.resources/src/org/eclipse/core/resources/ISaveParticipant.java;2;0;5;1;1;1;1;4;328;1;4;12;374;374;1;0;0;4;5;12;0;4214;5;2;
/org.eclipse.core.runtime/src/org/eclipse/core/runtime/IPluginRegistry.java;3;0;4;1;1;1;1;3;314;1;3;12;335;335;1;0;0;3;4;12;0;4214;4;3;
/org.eclipse.jdt.ui.tests.refactoring/test cases/org/eclipse/jdt/ui/nls/tests/NLSScannerTester.java;1;0;2;1;0;0;0;2;0;1;2;1939;0;0;1;0;0;2;2;1939;0;2015;2;1;
/org.eclipse.jdt.ui.tests.refactoring/resources/RenameTemp/canRename/A_test22_out.java;1;0;2;1;0;0;0;2;2;1;2;1625;2;2;1;0;0;2;2;1625;0;1652;2;1;
/org.eclipse.help/webapps/examples/WEB-INF/classes/listeners/SessionListener.java;1;0;2;1;0;0;0;2;0;1;2;1882;0;0;1;0;0;2;2;1882;0;1930;2;1;
/org.eclipse.tomcat/src_jdt/org/eclipse/jdt/core/jasper/JdtJasperCompiler.java;2;0;8;2;0;0;0;8;26;3;5;2460;43;43;3;3;0;8;8;2585;3;3285;5;2;
/org.eclipse.jdt.debug.tests/testprograms/ArgumentsTests.java;2;0;2;1;1;1;1;1;11;0;1;3719;11;11;1;0;0;1;2;3719;0;4571;2;2;
/org.eclipse.help/src/org/eclipse/help/internal/toc/TocFileParser.java;1;0;3;1;0;0;0;3;38;1;3;1857;52;52;1;0;0;3;3;1857;0;3875;3;1;
/org.eclipse.jdt.ui/ui refactoring/org/eclipse/jdt/internal/ui/nls/MultiStateCellEditor.java;1;0;2;1;0;0;0;2;0;1;2;1913;0;0;1;0;0;2;2;1913;0;1922;2;1;
/org.eclipse.update.core/src/org/eclipse/update/core/model/NonPluginEntryModel.java;1;0;4;1;0;0;0;4;52;2;3;2409;85;85;2;1;0;4;4;3570;1;3570;3;1;
/org.eclipse.jdt.ui.tests.refactoring/resources/SelectionAnalyzerWorkSpace/SelectionAnalyzerTests/validSelection/A_test232.java;1;0;1;1;0;0;0;1;0;0;1;1368;0;0;1;0;0;1;1;1368;0;1368;1;1;
/org.eclipse.jdt.debug.ui/ui/org/eclipse/jdt/internal/debug/ui/JavaDebugAppearancePreferencePage.java;2;1;4;1;4;4;4;0;6;0;0;4020;9;9;1;0;0;0;4;4020;0;4409;4;2;
/org.eclipse.jdt.debug/jdi interfaces/com/sun/jdi/event/ThreadDeathEvent.java;2;0;2;1;0;0;0;2;8;1;2;2704;8;8;1;0;0;2;2;2704;0;3040;2;2;
/org.eclipse.pde.ui/src/org/eclipse/pde/core/plugin/IPluginElement.java;1;0;3;1;0;0;0;3;2;2;2;3579;2;2;2;1;0;3;3;3579;1;3607;2;1;
/org.eclipse.jdt.core/codeassist/org/eclipse/jdt/internal/codeassist/select/SelectionParser.java;3;1;23;1;3;3;3;20;980;4;16;455;1383;1383;4;4;0;20;23;1039;4;4362;19;3;
/org.eclipse.ui/Eclipse UI/org/eclipse/ui/internal/IWorkbenchGraphicConstants.java;6;1;11;1;3;3;3;8;294;1;8;257;333;333;1;0;0;8;11;257;0;4460;11;6;
/org.eclipse.jdt.ui.tests.refactoring/resources/DeleteSourceReference/test18/in/A.java;1;0;1;1;1;1;1;0;0;0;0;4383;0;0;1;0;0;0;1;4383;0;4383;1;1;
/org.eclipse.swt/Eclipse SWT/common/org/eclipse/swt/graphics/Drawable.java;2;0;3;1;1;1;1;2;6;1;2;106;12;12;1;0;0;2;3;106;0;4701;3;2;
/org.eclipse.pde.build/src/org/eclipse/pde/internal/build/ScriptBuilder.java;3;0;7;1;0;0;0;7;103;1;7;1312;174;174;1;0;0;7;7;1312;0;3089;7;3;
/org.eclipse.jdt.ui.tests.refactoring/resources/ReorderParameters/canReorder/A_test16_out.java;1;0;1;1;0;0;0;1;0;0;1;2296;0;0;1;0;0;1;1;2296;0;2296;1;1;
/org.eclipse.pde.ui/src/org/eclipse/pde/internal/pluginsview/ParentElement.java;1;0;2;1;0;0;0;2;0;1;2;2650;0;0;1;0;0;2;2;2650;0;2978;2;1;
/org.eclipse.jdt.ui.tests.refactoring/resources/RenamePrivateField/test4/in/A.java;1;0;1;1;0;0;0;1;0;0;1;2804;0;0;1;0;0;1;1;2804;0;2804;1;1;
/org.eclipse.jdt.ui.tests.refactoring/resources/ExtractMethodWorkSpace/ExtractMethodTests/semicolon_out/A_testx.java;2;0;2;1;0;0;0;2;0;1;2;49;0;0;1;0;0;2;2;49;0;2155;2;2;
/org.eclipse.help/Eclipse Help/org/eclipse/help/internal/contributors/xml/HelpContributionManager.java;3;0;7;1;0;0;0;7;7;1;7;135;23;23;1;0;0;7;7;135;0;1420;7;3;
/org.eclipse.jdt.ui/ui/org/eclipse/jdt/internal/ui/typehierarchy/ITypeHierarchyLifeCycleListener.java;2;0;4;1;0;0;0;4;9;1;4;15;19;19;1;0;0;4;4;15;0;1524;4;2;
/org.eclipse.jdt.ui.tests/JUnit/junit/tests/TestTest.java;2;0;2;1;0;0;0;2;0;1;2;49;0;0;1;0;0;2;2;49;0;1186;2;2;
/org.eclipse.vcm.core.cvs/src/org/eclipse/vcm/internal/core/ccvs/client/ResponseDetail.java;2;0;2;1;0;0;0;2;5;1;2;0;5;5;1;0;0;2;2;0;0;298;2;2;
/org.eclipse.help/Eclipse Help/org/eclipse/help/internal/navigation/HelpNavigationManager.java;4;0;13;1;0;0;0;13;84;1;13;135;299;299;1;0;0;13;13;135;0;1420;13;4;
/org.eclipse.pde.ui/src/org/eclipse/pde/internal/component/ComponentSpecPage.java;2;0;2;1;0;0;0;2;0;1;2;1434;0;0;1;0;0;2;2;1434;0;2951;2;2;
/org.eclipse.jdt.debug/jdi/org/eclipse/jdi/internal/request/ThreadStartRequestImpl.java;2;0;4;1;0;0;0;4;12;1;4;187;25;25;1;0;0;4;4;187;0;3670;4;2;
/org.eclipse.jdt.ui.tests.refactoring/resources/SafeDeleteType/testFail16/in/A.java;1;0;1;1;0;0;0;1;0;0;1;49;0;0;1;0;0;1;1;49;0;49;1;1;
/org.eclipse.ui.examples.javaeditor/Java Editor Example/org/eclipse/ui/examples/javaeditor/java/JavaAutoIndentStrategy.java;1;0;2;1;0;0;0;2;0;0;1;1066;0;0;2;1;0;2;2;1066;1;1066;1;1;
/org.eclipse.jdt.core/compiler/org/eclipse/jdt/internal/compiler/classfmt/ClassFileStruct.java;3;1;13;1;2;2;2;11;551;4;7;455;832;832;4;4;0;11;13;1039;4;4420;9;3;
/org.eclipse.core.resources/src/org/eclipse/core/internal/events/BuildCommand.java;1;0;5;1;1;1;1;4;138;1;4;12;171;171;1;0;0;4;5;12;0;4214;5;1;
/org.eclipse.jdt.ui.tests.refactoring/resources/MoveMembers/test19/out/A.java;1;0;1;1;0;0;0;1;0;0;1;2738;0;0;1;0;0;1;1;2738;0;2738;1;1;
/org.eclipse.jdt.ui.tests.refactoring/resources/ExtractMethodWorkSpace/ExtractMethodTests/try_out/A_test456.java;2;1;4;1;2;2;2;2;8;1;2;511;10;10;1;0;0;2;4;511;0;4419;4;2;
/org.eclipse.jdt.core/compiler/org/eclipse/jdt/internal/compiler/lookup/BaseTypeBinding.java;2;0;10;1;1;1;1;9;304;4;6;455;340;340;4;3;0;9;10;1039;3;4062;7;2;
/org.eclipse.swt.tests/JUnit Tests/org/eclipse/swt/tests/junit/Test_org_eclipse_swt_events_SelectionListener.java;2;0;2;1;1;1;1;1;6;0;1;1792;6;6;1;0;0;1;2;1792;0;4706;2;2;
/org.eclipse.team.ui/src/org/eclipse/team/internal/ui/target/InfiniteSubProgressMonitor.java;1;0;2;1;2;1;2;0;0;0;0;4401;0;0;2;0;1;0;2;4401;1;4401;1;1;
/org.eclipse.jdt.core/compiler/org/eclipse/jdt/internal/compiler/IProblem.java;1;0;6;1;0;0;0;6;477;2;5;455;611;611;2;1;0;6;6;3084;1;3084;5;1;
/org.eclipse.update/src/org/eclipse/update/internal/ui/UMWizardProductComponentNew.java;1;0;1;1;0;0;0;1;0;0;1;1424;0;0;1;0;0;1;1;1424;0;1424;1;1;
/org.eclipse.core.tests.runtime/src/org/eclipse/core/tests/internal/registrycache/CacheHelpers.java;4;0;8;1;1;1;1;7;732;2;5;1794;821;821;2;2;0;7;8;2680;2;4630;6;4;
/org.eclipse.core.tests.resources/src/org/eclipse/core/tests/internal/indexing/IntegratedObjectStoreTest.java;3;0;3;1;1;1;1;2;24;1;2;1794;34;34;1;0;0;2;3;1794;0;4516;3;3;
/org.eclipse.ui/Eclipse JFace Text/org/eclipse/jface/text/contentassist/CompletionProposalPopup.java;5;3;21;2;7;5;7;14;212;1;14;257;844;844;3;0;2;14;21;4454;2;4853;19;5;
/org.eclipse.jdt.debug/eval/org/eclipse/jdt/internal/debug/eval/ast/instructions/LeftShiftAssignmentOperator.java;2;0;5;1;1;1;1;4;4;1;4;3421;10;10;1;0;0;4;5;3421;0;3955;5;2;
/org.eclipse.jdt.junit/Eclipse JUnit/org/eclipse/jdt/junit/internal/SearchUtil.java;2;0;2;1;0;0;0;2;0;1;2;1531;0;0;1;0;0;2;2;1531;0;2007;2;2;
/org.eclipse.update.ui/src/org/eclipse/update/internal/ui/model/MyComputerDirectory.java;3;1;8;2;4;4;4;4;91;1;4;2797;222;222;1;0;0;4;8;2797;0;4197;8;3;
/org.eclipse.jdt.core/search/org/eclipse/jdt/internal/core/search/indexing/AddCompilationUnitToIndex.java;3;1;20;1;4;4;4;16;103;4;13;455;309;309;4;3;0;16;20;1039;3;4525;17;3;
/org.eclipse.core.boot/src/org/eclipse/core/internal/boot/update/AssertionFailedException.java;2;0;2;1;0;0;0;2;0;1;2;12;0;0;1;0;0;2;2;12;0;323;2;2;
/org.eclipse.jdt.ui/core refactoring/org/eclipse/jdt/core/refactoring/fields/FieldRefactoring.java;1;0;4;1;0;0;0;4;5;1;4;15;6;6;1;0;0;4;4;15;0;408;4;1;
/org.eclipse.scripting/Eclipse Scripting/org/eclipse/scripting/StringDataMultiple.java;1;0;3;1;0;0;0;3;7;1;3;133;7;7;1;0;0;3;3;133;0;1424;3;1;
/org.eclipse.jdt.core/model/org/eclipse/jdt/internal/core/SourceRefElement.java;3;0;14;1;1;1;1;13;380;4;9;455;498;498;4;4;0;13;14;1039;4;4063;10;3;
/org.eclipse.jdt.ui.tests.refactoring/resources/RenameVariables/canRename/A_test29_in.java;1;0;2;1;0;0;0;2;0;1;2;724;0;0;1;0;0;2;2;724;0;1665;2;1;
/org.eclipse.debug.ui/ui/org/eclipse/debug/internal/ui/actions/LaunchShortcutAction.java;2;1;3;1;3;3;3;0;16;0;0;4367;18;18;1;0;0;0;3;4367;0;4423;3;2;
/org.eclipse.ui/Eclipse UI/org/eclipse/ui/dialogs/IWorkingSetDialog.java;1;0;2;1;0;0;0;2;0;1;2;3494;0;0;1;0;0;2;2;3494;0;3576;2;1;
/org.eclipse.vcm.core.cvs/src/org/eclipse/vcm/internal/core/ccvs/requests/IModuleExpansionListener.java;2;0;2;1;0;0;0;2;13;1;2;1008;13;13;1;0;0;2;2;1008;0;1277;2;2;
/org.eclipse.jdt.debug.ui/ui/org/eclipse/jdt/internal/debug/ui/actions/AddJarAction.java;2;1;4;1;4;4;4;0;11;0;0;3905;17;17;1;0;0;0;4;3905;0;4423;4;2;
/org.eclipse.pde.ui/src/org/eclipse/pde/internal/core/plugin/XMLErrorHandler.java;1;0;2;1;0;0;0;2;0;1;2;3579;0;0;1;0;0;2;2;3579;0;3607;2;1;
/org.eclipse.ui/Eclipse UI/org/eclipse/ui/internal/AboutAction.java;4;1;6;1;3;3;3;3;27;1;3;257;46;46;1;0;0;3;6;257;0;4277;6;4;
/org.eclipse.jdt.ui.tests/refactoring/org/eclipse/jdt/refactoring/tests/ExtractMethodTestSetup.java;1;0;2;1;0;0;0;2;0;1;2;1236;0;0;1;0;0;2;2;1236;0;1896;2;1;
/org.eclipse.search/search/org/eclipse/search/internal/core/text/TextSearchScope.java;2;0;8;1;1;1;1;7;35;1;7;15;113;113;1;0;0;7;8;15;0;3998;8;2;
/org.eclipse.core.runtime/src/org/eclipse/core/runtime/model/ComponentModel.java;4;0;6;1;0;0;0;6;228;1;6;82;249;249;1;0;0;6;6;82;0;3719;6;4;
/org.eclipse.scripting/src/org/eclipse/scripting/internal/datamodels/XGRXmlElementsAndAttributesSaxHandler.java;1;0;1;1;0;0;0;1;0;0;1;1424;0;0;1;0;0;1;1;1424;0;1424;1;1;
/org.eclipse.team.core/src/org/eclipse/team/internal/core/streams/SizeConstrainedInputStream.java;1;0;1;1;1;1;1;0;0;0;0;4169;0;0;1;0;0;0;1;4169;0;4169;1;1;
/org.eclipse.jdt.ui.tests.refactoring/resources/SelectionAnalyzerWorkSpace/SelectionAnalyzerTests/validSelection/A_test100_.java;2;0;2;1;0;0;0;2;0;1;2;2139;0;0;1;0;0;2;2;2139;0;2327;2;2;
/org.eclipse.jdt.ui/ui/org/eclipse/jdt/internal/ui/launcher/VMSelector.java;4;0;10;1;0;0;0;10;41;2;8;218;144;144;2;2;0;10;10;218;2;1916;8;4;
/org.eclipse.swt.examples/org/eclipse/swt/examples/controlexample/TableTab.java;6;1;9;1;4;4;4;5;289;1;5;513;770;770;1;0;0;5;9;513;0;4024;9;6;
/org.eclipse.jdt.core/model/org/eclipse/jdt/internal/core/builder/impl/PackageImplSWH.java;1;0;10;1;0;0;0;10;296;4;6;455;314;314;4;4;0;10;10;1039;4;2808;6;1;
/org.eclipse.update.ui/src/org/eclipse/update/internal/ui/manager/IUpdateModes.java;1;0;2;1;0;0;0;2;0;0;1;1457;0;0;2;1;0;2;2;1457;1;1457;1;1;
/org.eclipse.jdt.debug.tests/test plugin/org/eclipse/jdt/debug/testplugin/JavaTestPlugin.java;2;0;2;1;1;1;1;1;16;0;1;3701;16;16;1;0;0;1;2;3701;0;4328;2;2;
/org.eclipse.pde.ui/Eclipse PDE UI/org/eclipse/pde/internal/editor/text/PDEPartitionScanner.java;2;0;5;2;0;0;0;5;12;3;3;267;12;12;3;2;0;5;5;324;2;1434;3;2;
/org.eclipse.core.resources/src/org/eclipse/core/internal/resources/SyncInfoReader_3.java;2;0;7;1;1;1;1;6;174;1;6;158;232;232;1;0;0;6;7;158;0;4213;7;2;
/org.eclipse.swt/Eclipse SWT/motif/org/eclipse/swt/widgets/FileDialog.java;8;2;17;2;7;6;7;10;145;1;10;106;535;535;2;0;1;10;17;4528;1;4701;16;8;
/org.eclipse.pde.ui/src/org/eclipse/pde/internal/model/WorkspaceResourceHelper.java;2;0;7;1;0;0;0;7;15;1;7;1434;25;25;1;0;0;7;7;1434;0;3579;7;2;
/org.eclipse.core.tests.runtime/src/org/eclipse/core/tests/internal/plugin/a/PluginClass.java;3;0;3;1;0;0;0;3;34;1;3;1794;44;44;1;0;0;3;3;1794;0;3476;3;3;
/org.eclipse.jdt.ui.tests.refactoring/resources/RenameVariables/canRename/A_test27_out.java;1;0;2;1;0;0;0;2;0;1;2;724;0;0;1;0;0;2;2;724;0;1665;2;1;
/org.eclipse.team.core/src/org/eclipse/team/core/internal/FileTypeRegistry.java;2;0;5;1;0;0;0;5;424;1;5;1978;529;529;1;0;0;5;5;1978;0;3458;5;2;
/org.eclipse.search/search/org/eclipse/search/ui/ISearchResultView.java;2;2;10;1;3;2;3;7;45;1;7;15;135;135;2;0;1;7;10;4160;1;4273;9;2;
/org.eclipse.jdt.core/model/org/eclipse/jdt/internal/core/builder/impl/BinaryOutput.java;1;0;3;1;0;0;0;3;99;1;3;455;99;99;1;0;0;3;3;455;0;2808;3;1;
/org.eclipse.swt/Eclipse SWT PI/gtk/org/eclipse/swt/internal/gtk/GtkFontSelectionDialog.java;1;0;2;1;0;0;0;2;0;1;2;2107;0;0;1;0;0;2;2;2107;0;3209;2;1;
/org.eclipse.jdt.ui/ui/org/eclipse/jdt/internal/ui/launcher/ExceptionSelectionDialog.java;1;0;3;1;0;0;0;3;7;1;3;15;7;7;1;0;0;3;3;15;0;295;3;1;
/org.eclipse.team.cvs.ssh/src/org/eclipse/team/internal/ccvs/ssh/Misc.java;2;0;4;1;0;0;0;4;898;1;4;1978;913;913;1;0;0;4;4;1978;0;3723;4;2;
/org.eclipse.pde.ui/src/org/eclipse/pde/internal/ui/ModelSynchronizer.java;1;0;3;1;0;0;0;3;10;1;3;3579;10;10;1;0;0;3;3;3579;0;3607;3;1;
/org.eclipse.jdt.debug.tests/tests/org/eclipse/jdt/debug/tests/eval/NestedTypeFieldValue_83.java;2;1;3;1;3;3;3;0;12;0;0;4447;14;14;1;0;0;0;3;4447;0;4571;3;2;
/org.eclipse.jdt.debug/jdi/org/eclipse/jdi/internal/event/BreakpointEventImpl.java;2;0;4;1;0;0;0;4;17;1;4;187;31;31;1;0;0;4;4;187;0;3670;4;2;
/org.eclipse.swt.examples.paint/src/org/eclipse/swt/examples/paint/SolidEllipseFigure.java;3;0;4;2;1;1;1;3;54;2;2;586;60;60;2;1;0;3;4;609;1;4705;3;3;
/org.eclipse.jdt.core/compiler/org/eclipse/jdt/internal/compiler/lookup/VariableBinding.java;2;0;10;1;1;1;1;9;38;4;6;455;115;115;4;3;0;9;10;1039;3;4062;7;2;
/org.eclipse.jdt.ui/ui/org/eclipse/jdt/internal/ui/jarpackager/JarOptionsPage.java;3;0;23;1;0;0;0;23;58;2;20;320;390;390;2;3;0;23;23;410;3;3529;20;3;
/org.eclipse.ui/Eclipse UI/org/eclipse/ui/internal/dialogs/MultiStepWizard.java;1;0;7;1;0;0;0;7;51;1;7;3211;127;127;1;0;0;7;7;3211;0;3487;7;1;
/org.eclipse.jdt.ui/ui/org/eclipse/jdt/internal/ui/preferences/MinMaxIntegerFieldEditor.java;4;0;5;2;0;0;0;5;9;1;5;74;11;11;1;0;0;5;5;74;0;1603;5;4;
/org.eclipse.update.core/src/org/eclipse/update/core/model/InstallAbortedException.java;1;0;2;1;2;1;2;0;6;0;0;4385;6;6;2;0;1;0;2;4385;1;4385;1;1;
/org.eclipse.swt/Eclipse SWT PI/win32/org/eclipse/swt/internal/win32/NMTOOLBAR.java;2;0;3;1;1;1;1;2;6;1;2;2069;9;9;1;0;0;2;3;2069;0;4701;3;2;
/org.eclipse.jdt.ui.tests.refactoring/resources/ExtractMethodWorkSpace/ExtractMethodTests/expression_out/A.java;1;1;3;1;2;2;2;1;24;0;1;1236;24;24;1;0;0;1;3;1236;0;4419;3;1;
/org.eclipse.jdt.ui/ui/org/eclipse/jdt/internal/ui/compare/JavaReplaceWithPreviousEditionAction.java;1;0;1;1;0;0;0;1;0;0;1;2415;0;0;1;0;0;1;1;2415;0;2415;1;1;
/org.eclipse.jdt.ui/core refactoring/org/eclipse/jdt/internal/core/refactoring/text/ITextBufferChange.java;2;0;3;1;0;0;0;3;2;1;3;408;2;2;1;0;0;3;3;408;0;1939;3;2;
/org.eclipse.jdt.debug.ui/ui/org/eclipse/jdt/internal/debug/ui/actions/EnableDisableBreakpointRulerActionDelegate.java;1;0;2;1;0;0;0;2;2;0;1;3572;2;2;2;1;0;2;2;3572;1;3572;1;1;
/org.eclipse.pde.ui/src/org/eclipse/pde/internal/ui/wizards/templates/MultiPageEditorNewWizard.java;1;0;3;1;0;0;0;3;9;1;3;3579;10;10;1;0;0;3;3;3579;0;3870;3;1;
/org.eclipse.ui/Eclipse JFace Text/org/eclipse/jface/text/ITextListener.java;2;0;2;1;0;0;0;2;5;1;2;257;5;5;1;0;0;2;2;257;0;457;2;2;
/org.eclipse.swt/Eclipse SWT PI/win32/org/eclipse/swt/internal/win32/TRIVERTEX.java;2;0;2;1;1;1;1;1;6;0;1;2069;6;6;1;0;0;1;2;2069;0;4701;2;2;
/org.eclipse.jdt.ui/core refactoring/org/eclipse/jdt/internal/corext/refactoring/sef/AccessAnalyzer.java;2;1;11;1;2;2;2;9;212;1;9;1939;294;294;1;0;0;9;11;1939;0;4403;11;2;
/org.eclipse.update.tests.core/src/org/eclipse/update/tests/regularInstall/TestExecutablePackagedInstall.java;2;1;17;1;3;3;3;14;38;1;14;1978;127;127;1;0;0;14;17;1978;0;4339;17;2;
/org.eclipse.tomcat/src/org/eclipse/tomcat/TomcatAppServer.java;2;0;4;1;0;0;0;4;10;1;4;2409;11;11;1;0;0;4;4;2409;0;3285;4;2;
/org.eclipse.jdt.ui/ui/org/eclipse/jdt/ui/jarpackager/IManifestProvider.java;2;0;3;1;1;1;1;2;4;1;2;3529;8;8;1;0;0;2;3;3529;0;4811;3;2;
/org.eclipse.jdt.ui.tests/examples/org/eclipse/jdt/ui/examples/TwoPaneElementSelectorExample.java;3;0;4;1;1;1;1;3;11;1;3;1186;28;28;1;0;0;3;4;1186;0;4682;4;3;
/org.eclipse.core.resources/src/org/eclipse/core/internal/resources/PlatformURLResourceConnection.java;3;0;3;1;1;1;1;2;150;1;2;558;186;186;1;0;0;2;3;558;0;4213;3;3;
/org.eclipse.pde.ui/src/org/eclipse/pde/internal/editor/feature/PortabilityChoice.java;1;0;2;1;0;0;0;2;0;1;2;2953;0;0;1;0;0;2;2;2953;0;3103;2;1;
/org.eclipse.ui/Eclipse UI/org/eclipse/ui/internal/CycleEditorAction.java;4;1;12;1;3;3;3;9;74;2;8;1693;166;166;2;1;0;9;12;3212;1;4730;11;4;
/org.eclipse.jdt.ui.tests.refactoring/test cases/org/eclipse/jdt/ui/tests/actions/StructureSelectionActionTests.java;2;0;13;1;1;1;1;12;109;2;10;2273;267;267;2;2;0;12;13;3168;2;4181;11;2;
/org.eclipse.jdt.ui.tests.refactoring/resources/ExtractMethodWorkSpace/ExtractMethodTests/validSelection/A_test253.java;2;1;3;1;2;2;2;1;0;0;1;49;0;0;1;0;0;1;3;49;0;4419;3;2;
/org.eclipse.pde.ui/src/org/eclipse/pde/internal/ui/elements/NamedElement.java;1;0;1;1;0;0;0;1;0;0;1;3579;0;0;1;0;0;1;1;3579;0;3579;1;1;
/org.eclipse.pde.ui/Eclipse PDE UI/org/eclipse/pde/internal/editor/build/BuildSourceOutlinePage.java;2;0;5;2;0;0;0;5;12;3;3;267;12;12;3;2;0;5;5;324;2;1434;3;2;
/org.eclipse.core.target/src/org/eclipse/core/internal/target/DeploymentException.java;1;0;5;1;1;1;1;4;138;1;4;12;186;186;1;0;0;4;5;12;0;4196;5;1;
/org.eclipse.jdt.debug.ui/ui/org/eclipse/jdt/internal/debug/ui/actions/AddFolderAction.java;1;1;3;1;3;3;3;0;14;0;0;3905;16;16;1;0;0;0;3;3905;0;4423;3;1;
/org.eclipse.jdt.ui.tests.refactoring/resources/SelectionAnalyzerWorkSpace/SelectionAnalyzerTests/validSelection/A_test285.java;1;0;1;1;0;0;0;1;0;0;1;1368;0;0;1;0;0;1;1;1368;0;1368;1;1;
/org.eclipse.pde.ui/src/org/eclipse/pde/internal/ui/editor/manifest/MatchSection.java;1;1;5;1;2;2;2;3;161;2;2;3579;299;299;2;1;0;3;5;3579;1;4592;4;1;
/org.eclipse.jdt.debug/eval/org/eclipse/jdt/internal/debug/eval/ast/instructions/PostfixPlusPlusOperator.java;3;0;6;1;0;0;0;6;20;1;6;3421;32;32;1;0;0;6;6;3421;0;3677;6;3;
/org.eclipse.help/src/org/eclipse/help/internal/util/PluginVersionInfo.java;2;0;4;1;1;1;1;3;46;1;3;1420;71;71;1;0;0;3;4;1420;0;3938;4;2;
/org.eclipse.jdt.debug.tests/test programs/org/eclipse/debug/tests/targets/Watchpoint.java;1;0;2;1;0;0;0;2;0;1;2;3701;0;0;1;0;0;2;2;3701;0;3719;2;1;
/org.eclipse.jdt.ui.tests.refactoring/resources/RenameParameters/cannotRename/A_testFail21.java;1;0;1;1;0;0;0;1;0;0;1;3480;0;0;1;0;0;1;1;3480;0;3480;1;1;
/org.eclipse.debug.ui/ui/org/eclipse/debug/internal/ui/actions/TextViewerAction.java;1;0;1;1;0;0;0;1;0;0;1;2382;0;0;1;0;0;1;1;2382;0;2382;1;1;
/org.eclipse.pde.ui/src/org/eclipse/pde/internal/ui/editor/schema/TypeRestrictionCellEditor.java;1;0;3;1;1;1;1;2;3;1;2;3579;5;5;1;0;0;2;3;3579;0;4567;3;1;
/org.eclipse.jdt.ui.tests.refactoring/resources/ExtractMethodWorkSpace/ExtractMethodTests/locals_out/A_test550.java;1;1;4;1;2;2;2;2;34;1;2;1236;37;37;1;0;0;2;4;1236;0;4419;4;1;
/org.eclipse.pde.ui/src/org/eclipse/pde/internal/ui/editor/manifest/PluginUndoManager.java;1;0;3;1;0;0;0;3;14;2;2;3579;16;16;2;1;0;3;3;3579;1;3687;2;1;
/org.eclipse.jdt.ui.tests.refactoring/resources/MoveMembers/testFail4/in/B.java;1;0;1;1;0;0;0;1;0;0;1;2738;0;0;1;0;0;1;1;2738;0;2738;1;1;
/org.eclipse.team.core/src/org/eclipse/team/core/ITeamProviderTests.java;3;0;3;1;0;0;0;3;50;1;3;1978;50;50;1;0;0;3;3;1978;0;3213;3;3;
/org.eclipse.jdt.ui.tests.refactoring/resources/ExtractMethodWorkSpace/ExtractMethodTests/Z.java;1;1;3;1;2;2;2;1;52;0;1;1851;52;52;1;0;0;1;3;1851;0;4419;3;1;
/org.eclipse.jdt.ui/ui/org/eclipse/jdt/internal/ui/typehierarchy/TypeHierarchyLifeCycle.java;5;1;27;1;8;8;8;19;102;2;18;15;414;414;2;1;0;19;27;3148;1;4621;26;5;
/org.eclipse.update.ui/src/org/eclipse/update/internal/ui/pages/DetailsPage.java;1;0;2;1;0;0;0;2;3;1;2;3537;3;3;1;0;0;2;2;3537;0;3662;2;1;
/org.eclipse.team.cvs.core/src/org/eclipse/team/internal/ccvs/core/resources/RemoteFolderTree.java;2;0;11;1;0;0;0;11;104;1;11;2053;319;319;1;0;0;11;11;2053;0;3812;11;2;
/org.eclipse.jdt.ui.tests.refactoring/resources/RenameTemp/canRename/A_test4_in.java;1;0;2;1;0;0;0;2;2;1;2;1625;2;2;1;0;0;2;2;1625;0;1652;2;1;
/org.eclipse.ui/Eclipse UI/org/eclipse/ui/internal/EditorToolBarManager.java;6;1;12;2;2;2;2;10;73;4;7;457;298;298;4;3;0;10;12;3447;3;4569;9;6;
/org.eclipse.jdt.ui.tests.refactoring/resources/SelectionAnalyzerWorkSpace/SelectionAnalyzerTests/validSelection/A_test301.java;1;0;1;1;0;0;0;1;0;0;1;1368;0;0;1;0;0;1;1;1368;0;1368;1;1;
/org.eclipse.scripting/src/org/eclipse/scripting/internal/IXGRElementUITableHeadingElement.java;1;0;1;1;0;0;0;1;0;0;1;1424;0;0;1;0;0;1;1;1424;0;1424;1;1;
/org.eclipse.jdt.ui.tests.refactoring/resources/RenameMethodInInterface/test30/in/A.java;1;0;1;1;0;0;0;1;0;0;1;49;0;0;1;0;0;1;1;49;0;49;1;1;
/org.eclipse.pde.ui/src/org/eclipse/pde/internal/launcher/WorkbenchLauncher.java;2;0;8;1;0;0;0;8;658;1;8;1434;740;740;1;0;0;8;8;1434;0;2750;8;2;
/org.eclipse.jdt.ui.tests.refactoring/resources/SelectionAnalyzerWorkSpace/SelectionAnalyzerTests/validSelection/A_test241.java;1;0;1;1;0;0;0;1;0;0;1;1368;0;0;1;0;0;1;1;1368;0;1368;1;1;
/org.eclipse.jdt.ui/ui/org/eclipse/jdt/ui/actions/OverrideMethodsAction.java;3;1;11;1;6;6;6;5;149;1;5;3533;219;219;1;0;0;5;11;3533;0;4770;11;3;
/org.eclipse.pde.ui/src/org/eclipse/pde/internal/ui/editor/feature/ReferencePropertySource.java;1;1;5;1;2;2;2;3;79;1;3;3579;107;107;1;0;0;3;5;3579;0;4430;5;1;
/org.eclipse.compare/compare/org/eclipse/compare/internal/patch/PatchCompareInput.java;2;0;3;1;1;1;1;2;21;1;2;2876;23;23;1;0;0;2;3;2876;0;4741;3;2;
/org.eclipse.ui/Eclipse UI Standard Components/org/eclipse/ui/views/navigator/NavigatorTestStub.java;2;0;2;1;0;0;0;2;0;1;2;1034;0;0;1;0;0;2;2;1034;0;1302;2;2;
/org.eclipse.jdt.ui.tests.refactoring/resources/RenameMethodInInterface/test19/in/A.java;1;0;1;1;0;0;0;1;0;0;1;49;0;0;1;0;0;1;1;49;0;49;1;1;
/org.eclipse.update.ui/src/org/eclipse/update/ui/internal/model/ISiteWrapper.java;1;0;2;1;0;0;0;2;0;1;2;1942;0;0;1;0;0;2;2;1942;0;2797;2;1;
/org.eclipse.debug.core/core/org/eclipse/debug/core/ILaunchConfiguration.java;4;1;24;1;2;2;2;22;40;2;21;1819;321;321;2;1;0;22;24;1884;1;4649;23;4;
/org.eclipse.jdt.ui.tests.refactoring/resources/RenameVirtualMethodInClass/testFail19/in/A.java;1;0;1;1;0;0;0;1;0;0;1;49;0;0;1;0;0;1;1;49;0;49;1;1;
/org.eclipse.swt/Eclipse SWT PI/win32/org/eclipse/swt/internal/win32/CHOOSEFONT.java;2;0;2;1;1;1;1;1;6;0;1;2069;6;6;1;0;0;1;2;2069;0;4701;2;2;
/org.eclipse.ui.examples.propertysheet/Eclipse UI Examples PropertySheet/org/eclipse/ui/examples/propertysheet/EmailAddress.java;2;0;2;1;0;0;0;2;16;1;2;931;16;16;1;0;0;2;2;931;0;946;2;2;
/org.eclipse.jdt.debug/eval/org/eclipse/jdt/internal/debug/eval/ast/engine/CompoundInstruction.java;1;0;3;1;0;0;0;3;2;1;3;3329;2;2;1;0;0;3;3;3329;0;3421;3;1;
/org.eclipse.jdt.ui/ui/org/eclipse/jdt/internal/ui/typehierarchy/ShowInheritedMembersAction.java;3;0;9;1;1;1;1;8;22;1;8;238;84;84;1;0;0;8;9;238;0;4182;9;3;
/org.eclipse.jdt.ui.tests.refactoring/resources/ExtractMethodWorkSpace/ExtractMethodTests/wiki_in/A_test2005.java;1;1;4;1;2;2;2;2;36;1;2;1236;40;40;1;0;0;2;4;1236;0;4419;4;1;
/org.eclipse.jdt.debug/eval/org/eclipse/jdt/internal/debug/eval/ast/instructions/PushNull.java;3;0;6;1;1;1;1;5;2;1;5;3421;9;9;1;0;0;5;6;3421;0;4423;6;3;
/org.eclipse.pde.ui/src/org/eclipse/pde/internal/ui/ischema/IMetaAttribute.java;1;0;2;1;0;0;0;2;0;1;2;3579;0;0;1;0;0;2;2;3579;0;3591;2;1;
/org.eclipse.update.core/src/org/eclipse/update/internal/core/UpdateManagerPlugin.java;2;2;33;2;13;11;13;20;147;2;17;1643;618;618;2;3;2;20;33;2791;5;4708;28;2;
/org.eclipse.help.webapp/src/org/eclipse/help/servlet/HeadFilterHelper.java;1;0;2;1;0;0;0;2;2;1;2;3472;2;2;1;0;0;2;2;3472;0;3609;2;1;
/org.eclipse.jdt.ui.tests.refactoring/resources/RenameType/test51/in/A.java;1;0;1;1;0;0;0;1;0;0;1;49;0;0;1;0;0;1;1;49;0;49;1;1;
/org.eclipse.core.runtime/src/org/eclipse/core/internal/plugins/RegistryWriter.java;4;0;12;2;3;1;3;9;702;2;8;12;1162;1162;3;1;2;9;12;4212;3;4212;9;4;
/org.eclipse.jdt.ui/core refactoring/org/eclipse/jdt/internal/core/refactoring/resources/RenameResourceChange.java;1;0;3;1;0;0;0;3;15;1;3;990;15;15;1;0;0;3;3;990;0;1342;3;1;
/org.eclipse.ui/Eclipse UI Text Editor/org/eclipse/ui/texteditor/IReadOnlyDependent.java;1;1;3;1;3;3;3;0;35;0;0;3956;37;37;1;0;0;0;3;3956;0;4838;3;1;
/org.eclipse.jdt.ui.tests.refactoring/resources/ExtractTemp/canExtract/A_test4_in.java;1;0;1;1;0;0;0;1;0;0;1;2481;0;0;1;0;0;1;1;2481;0;2481;1;1;
/org.eclipse.swt.examples/Eclipse SWT Examples/common/org/eclipse/swt/examples/explorer/Explorer.java;1;0;2;1;0;0;0;2;0;1;2;107;0;0;1;0;0;2;2;107;0;611;2;1;
/org.eclipse.jdt.debug.ui/ui/org/eclipse/jdt/internal/debug/ui/JavaWordFinder.java;1;0;1;1;0;0;0;1;0;0;1;2009;0;0;1;0;0;1;1;2009;0;2009;1;1;
/org.eclipse.core.resources/src/org/eclipse/core/internal/resources/XMLWriter.java;4;0;6;1;1;1;1;5;206;1;5;12;309;309;1;0;0;5;6;12;0;4213;6;4;
/org.eclipse.jdt.ui.tests.refactoring/resources/ExtractMethodWorkSpace/ExtractMethodTests/invalidSelection/A_test149.java;1;1;3;1;2;2;2;1;32;0;1;887;32;32;1;0;0;1;3;887;0;4419;3;1;
/org.eclipse.core.boot/src/org/eclipse/core/internal/boot/update/FragmentEntryDescriptor.java;2;0;3;1;0;0;0;3;7;1;3;12;7;7;1;0;0;3;3;12;0;2726;3;2;
/org.eclipse.jdt.ui/ui/org/eclipse/jdt/internal/ui/dialogs/OptionalMessageDialog.java;1;0;1;1;1;1;1;0;0;0;0;4423;0;0;1;0;0;0;1;4423;0;4423;1;1;
/org.eclipse.ui/Eclipse UI Text Editor/org/eclipse/ui/texteditor/RetargetTextEditorAction.java;4;1;8;1;3;3;3;5;41;1;5;257;128;128;1;0;0;5;8;257;0;4838;8;4;
/org.eclipse.pde.ui/src/org/eclipse/pde/internal/ui/editor/feature/SynchronizeVersionsAction.java;1;0;4;1;0;0;0;4;22;1;4;3579;30;30;1;0;0;4;4;3579;0;3793;4;1;
/org.eclipse.jdt.ui.tests.refactoring/resources/AbstractField/can/A_test3_in.java;1;0;1;1;0;0;0;1;0;0;1;751;0;0;1;0;0;1;1;751;0;751;1;1;
/org.eclipse.team.cvs.ui/src/org/eclipse/team/internal/ccvs/ui/ChangeListener.java;3;0;4;2;0;0;0;4;7;2;3;2864;13;13;2;1;0;4;4;2864;1;3701;3;3;
/org.eclipse.pde.ui/src/org/eclipse/pde/internal/base/model/plugin/IPluginModelBase.java;2;0;4;1;0;0;0;4;11;1;4;1434;19;19;1;0;0;4;4;1434;0;3039;4;2;
/org.eclipse.team.core/src/org/eclipse/team/internal/core/streams/TimeoutOutputStream.java;1;0;1;1;1;1;1;0;0;0;0;4169;0;0;1;0;0;0;1;4169;0;4169;1;1;
/org.eclipse.jdt.ui/ui/org/eclipse/jdt/internal/ui/dialogs/StringInputDialog.java;4;0;6;2;0;0;0;6;7;2;5;15;11;11;2;1;0;6;6;1272;1;1272;5;4;
/org.eclipse.help/src/org/eclipse/help/internal/server/AddressTest.java;1;0;2;1;0;0;0;2;0;1;2;1420;0;0;1;0;0;2;2;1420;0;3095;2;1;
/org.eclipse.ui/Eclipse JFace/org/eclipse/jface/wizard/Wizard.java;2;0;2;1;0;0;0;2;5;1;2;257;5;5;1;0;0;2;2;257;0;457;2;2;
/org.eclipse.jdt.ui.tests.refactoring/resources/PullUp/test6/in/A.java;1;0;1;1;0;0;0;1;0;0;1;2406;0;0;1;0;0;1;1;2406;0;2406;1;1;
/org.eclipse.jdt.core/dom/org/eclipse/jdt/core/dom/ForStatement.java;2;1;6;1;2;2;2;4;18;1;4;2669;54;54;1;0;0;4;6;2669;0;4453;6;2;
/org.eclipse.compare/compare/org/eclipse/compare/patch/PreviewPatchPage.java;1;0;10;1;0;0;0;10;294;1;10;1516;770;770;1;0;0;10;10;1516;0;2876;10;1;
/org.eclipse.swt/Eclipse SWT/motif/org/eclipse/swt/widgets/Slider.java;7;1;11;1;4;4;4;7;468;1;7;106;1044;1044;1;0;0;7;11;106;0;4701;11;7;
/org.eclipse.jdt.ui/ui debug/org/eclipse/jdt/internal/debug/ui/ToggleFilterAction.java;3;0;7;1;0;0;0;7;50;1;7;15;85;85;1;0;0;7;7;15;0;1916;7;3;
/org.eclipse.jdt.core/model/org/eclipse/jdt/core/IJavaElement.java;3;1;8;1;2;2;2;6;218;2;5;455;316;316;2;1;0;6;8;3565;1;4061;7;3;
/org.eclipse.jdt.ui.tests.refactoring/resources/ExtractMethodWorkSpace/ExtractMethodTests/validSelection/A_test300.java;2;1;3;1;2;2;2;1;0;0;1;49;0;0;1;0;0;1;3;49;0;4419;3;2;
/org.eclipse.jdt.ui.tests.refactoring/resources/ExtractMethodWorkSpace/ExtractMethodTests/semicolon_out/A_test405.java;2;0;4;1;0;0;0;4;6;1;4;80;9;9;1;0;0;4;4;80;0;3106;4;2;
/org.eclipse.jdt.ui.tests.refactoring/resources/ExtractMethodWorkSpace/ExtractMethodTests/semicolon_in/A_test408.java;1;0;2;1;0;0;0;2;0;1;2;1236;0;0;1;0;0;2;2;1236;0;3106;2;1;
/org.eclipse.swt/Eclipse SWT/win32/org/eclipse/swt/internal/win32/HELPINFO.java;2;0;3;1;0;0;0;3;5;1;3;106;5;5;1;0;0;3;3;106;0;2069;3;2;
/org.eclipse.pde.core/src/org/eclipse/pde/core/plugin/IPluginModelBase.java;1;0;4;1;2;1;2;2;80;1;2;3591;83;83;2;0;1;2;4;4751;1;4751;3;1;
/org.eclipse.swt/Eclipse SWT Drag and Drop/photon/org/eclipse/swt/dnd/RTFTransfer.java;4;1;11;1;4;4;4;7;66;2;5;106;165;165;2;2;0;7;11;699;2;4824;9;4;
/org.eclipse.pde.core/src/org/eclipse/pde/internal/core/ifeature/IFeatureObject.java;1;0;2;1;1;1;1;1;2;0;1;3591;2;2;1;0;0;1;2;3591;0;3994;2;1;
/org.eclipse.jdt.ui/ui/org/eclipse/jdt/internal/ui/workingsets/CheckWorkingSetAction.java;1;1;2;1;2;2;2;0;0;0;0;4040;0;0;1;0;0;0;2;4040;0;4384;2;1;
/org.eclipse.jdt.ui/core refactoring/org/eclipse/jdt/internal/core/refactoring/Assert.java;3;0;4;1;0;0;0;4;8;1;4;15;13;13;1;0;0;4;4;15;0;1939;4;3;
/org.eclipse.jdt.ui.tests.refactoring/test cases/org/eclipse/jdt/ui/tests/actions/FakeSelectionProvider.java;1;0;2;1;0;0;0;2;0;1;2;2003;0;0;1;0;0;2;2;2003;0;3739;2;1;
/org.eclipse.jdt.ui/core refactoring/org/eclipse/jdt/internal/core/refactoring/base/IChange.java;3;0;7;1;0;0;0;7;18;1;7;408;45;45;1;0;0;7;7;408;0;1939;7;3;
/org.eclipse.jdt.core/search/org/eclipse/jdt/internal/core/index/IIndexerOutput.java;2;0;3;1;1;1;1;2;16;1;2;455;18;18;1;0;0;2;3;455;0;4063;3;2;
/org.eclipse.update.ui.forms/src/org/eclipse/update/ui/forms/internal/HTMLTableLayout.java;2;0;3;1;0;0;0;3;4;1;3;2470;7;7;1;0;0;3;3;2470;0;3667;3;2;
/org.eclipse.swt/Eclipse SWT PI/win32/org/eclipse/swt/internal/ole/win32/IViewObject2.java;2;0;2;1;1;1;1;1;6;0;1;2069;6;6;1;0;0;1;2;2069;0;4701;2;2;
/org.eclipse.swt.examples/src/org/eclipse/swt/examples/explorer/UpdateWorker.java;1;0;1;1;0;0;0;1;0;0;1;513;0;0;1;0;0;1;1;513;0;513;1;1;
/org.eclipse.jdt.ui.tests.refactoring/resources/RenameParameters/canRename/A_test27_in.java;1;0;1;1;0;0;0;1;0;0;1;233;0;0;1;0;0;1;1;233;0;233;1;1;
/org.eclipse.jdt.ui.tests.refactoring/resources/RenameNonPrivateField/test12/in/A.java;1;0;1;1;0;0;0;1;0;0;1;951;0;0;1;0;0;1;1;951;0;951;1;1;
/org.eclipse.jdt.ui.tests.refactoring/resources/RenameMethodInInterface/testFail42/in/A.java;1;0;1;1;0;0;0;1;0;0;1;49;0;0;1;0;0;1;1;49;0;49;1;1;
/org.eclipse.ui/Eclipse JFace/org/eclipse/jface/viewers/ListViewer.java;3;0;6;1;1;1;1;5;21;1;5;257;44;44;1;0;0;5;6;257;0;4195;6;3;
/org.eclipse.jdt.ui.tests.refactoring/resources/SelectionAnalyzerWorkSpace/SelectionAnalyzerTests/validSelection/A_test350.java;1;0;1;1;0;0;0;1;0;0;1;1368;0;0;1;0;0;1;1;1368;0;1368;1;1;
/org.eclipse.team.cvs.core/src/org/eclipse/team/internal/ccvs/core/util/NullOutputStream.java;2;0;2;1;0;0;0;2;0;1;2;2306;0;0;1;0;0;2;2;2306;0;3399;2;2;
/org.eclipse.swt.tests/JUnit Tests/org/eclipse/swt/tests/junit/Test_org_eclipse_swt_dnd_DragSourceAdapter.java;2;0;2;1;1;1;1;1;6;0;1;1792;6;6;1;0;0;1;2;1792;0;4706;2;2;
/org.eclipse.core.tests.resources/src/org/eclipse/core/tests/internal/resources/SnowNature.java;1;0;2;1;0;0;0;2;59;1;2;3075;59;59;1;0;0;2;2;3075;0;3400;2;1;
/org.eclipse.vcm.ui.cvs/src/org/eclipse/vcm/internal/ui/ccvs/FilterRepositoryAction.java;1;0;3;1;0;0;0;3;107;1;3;1424;166;166;1;0;0;3;3;1424;0;1578;3;1;
/org.eclipse.jdt.ui.tests.refactoring/resources/RenameType/testFail5/in/A.java;1;0;1;1;0;0;0;1;0;0;1;49;0;0;1;0;0;1;1;49;0;49;1;1;
/org.eclipse.jdt.ui/ui/org/eclipse/jdt/internal/ui/util/TypeCache.java;2;0;6;1;0;0;0;6;2;2;5;1258;4;4;2;1;0;6;6;2819;1;3069;5;2;
/org.eclipse.swt/Eclipse SWT/common/org/eclipse/swt/internal/image/JPEGScanHeader.java;2;0;3;1;1;1;1;2;6;1;2;106;10;10;1;0;0;2;3;106;0;4701;3;2;
/org.eclipse.jdt.core/compiler/org/eclipse/jdt/internal/compiler/IAbstractSyntaxTreeVisitor.java;2;0;14;1;1;1;1;13;58;4;9;455;103;103;4;4;0;13;14;1039;4;4062;10;2;
/org.eclipse.pde.ui/src/org/eclipse/pde/NewPluginTemplateWizard.java;1;0;3;1;0;0;0;3;76;2;2;3240;76;76;2;1;0;3;3;3240;1;3278;2;1;
/org.eclipse.jdt.ui.tests.refactoring/resources/RenameType/testFail36/in/A.java;1;0;1;1;0;0;0;1;0;0;1;49;0;0;1;0;0;1;1;49;0;49;1;1;
/org.eclipse.jdt.core/compiler/org/eclipse/jdt/internal/compiler/problem/ProblemSeverities.java;2;0;5;1;1;1;1;4;15;1;4;455;24;24;1;0;0;4;5;455;0;4062;5;2;
/org.eclipse.jdt.ui.tests.refactoring/resources/SelectionAnalyzerWorkSpace/SelectionAnalyzerTests/validSelection/A_test092_.java;1;0;1;1;0;0;0;1;0;0;1;2139;0;0;1;0;0;1;1;2139;0;2139;1;1;
/org.eclipse.help/src/org/eclipse/help/internal/navigation1_0/XMLNavGenerator.java;2;0;3;1;0;0;0;3;2;1;3;1675;2;2;1;0;0;3;3;1675;0;2217;3;2;
/org.eclipse.jdt.ui.tests.refactoring/resources/RenameParameters/canRename/A_test24_in.java;1;0;1;1;0;0;0;1;0;0;1;233;0;0;1;0;0;1;1;233;0;233;1;1;
/org.eclipse.jdt.ui.tests.refactoring/resources/RenameStaticMethod/test0/out/A.java;1;0;1;1;0;0;0;1;0;0;1;49;0;0;1;0;0;1;1;49;0;49;1;1;
/org.eclipse.pde.ui/Eclipse PDE UI/org/eclipse/pde/internal/builders/PluginErrorReporter.java;2;0;6;2;0;0;0;6;12;3;4;267;21;21;3;2;0;6;6;324;2;1434;4;2;
/org.eclipse.team.core/src/org/eclipse/team/core/target/TargetProvider.java;3;2;20;2;20;15;20;0;54;0;0;4113;272;272;2;0;5;0;20;4128;5;4636;15;3;
/org.eclipse.team.cvs.core/src/org/eclipse/team/internal/ccvs/core/response/RemoveEntry.java;3;0;3;1;0;0;0;3;14;1;3;1978;14;14;1;0;0;3;3;1978;0;2607;3;3;
/org.eclipse.jdt.ui.tests.refactoring/resources/RenameVirtualMethodInClass/test13/in/A.java;1;0;1;1;0;0;0;1;0;0;1;49;0;0;1;0;0;1;1;49;0;49;1;1;
/org.eclipse.swt.examples/src/org/eclipse/swt/examples/explorer/TreeScrollDropListener.java;1;0;1;1;0;0;0;1;0;0;1;513;0;0;1;0;0;1;1;513;0;513;1;1;
/org.eclipse.swt/Eclipse SWT PI/motif/org/eclipse/swt/internal/motif/XmDropFinishCallback.java;2;0;2;1;1;1;1;1;6;0;1;2069;6;6;1;0;0;1;2;2069;0;4701;2;2;
/org.eclipse.jdt.launching/launching/org/eclipse/jdt/internal/launching/StandardClasspathProvider.java;1;1;2;1;2;2;2;0;0;0;0;4126;0;0;1;0;0;0;2;4126;0;4168;2;1;
/org.eclipse.jdt.ui.tests.refactoring/resources/RenameVirtualMethodInClass/test16/in/A.java;1;0;1;1;0;0;0;1;0;0;1;49;0;0;1;0;0;1;1;49;0;49;1;1;
/org.eclipse.jdt.core/eval/org/eclipse/jdt/internal/eval/CodeSnippetSuperReference.java;2;1;6;1;2;2;2;4;25;2;3;1028;33;33;2;1;0;4;6;1046;1;4062;5;2;
/org.eclipse.jdt.ui.tests.refactoring/test cases/org/eclipse/jdt/ui/tests/changes/AllTests.java;1;0;1;1;0;0;0;1;0;0;1;3246;0;0;1;0;0;1;1;3246;0;3246;1;1;
/org.eclipse.scripting/Eclipse Scripting/org/eclipse/scripting/IDefault.java;1;0;3;1;0;0;0;3;7;1;3;133;7;7;1;0;0;3;3;133;0;1424;3;1;
/org.eclipse.swt.examples.controls/src/org/eclipse/swt/examples/controls/TreeTab.java;2;0;2;1;0;0;0;2;0;1;2;391;0;0;1;0;0;2;2;391;0;611;2;2;
/org.eclipse.pde.ui/src/org/eclipse/pde/internal/schema/SchemaAttribute.java;2;0;3;1;0;0;0;3;20;1;3;1434;20;20;1;0;0;3;3;1434;0;3579;3;2;
/org.eclipse.jdt.ui/ui refactoring/org/eclipse/jdt/internal/ui/refactoring/changes/TextBuffer.java;2;0;6;1;0;0;0;6;41;1;6;15;55;55;1;0;0;6;6;15;0;2216;6;2;
/org.eclipse.ui/Eclipse UI/org/eclipse/ui/internal/SafeRunnableAdapter.java;4;0;5;1;1;1;1;4;25;1;4;257;41;41;1;0;0;4;5;257;0;4363;5;4;
/org.eclipse.ui.externaltools/External Tools/org/eclipse/ui/externaltools/internal/core/DefaultRunnerContext.java;1;3;13;1;13;10;13;0;124;0;0;4090;355;355;3;0;3;0;13;4384;3;4768;10;1;
/org.eclipse.jdt.debug/model/org/eclipse/jdt/debug/core/IJavaRunToLineBreakpoint.java;2;0;3;1;0;0;0;3;13;1;3;1035;13;13;1;0;0;3;3;1035;0;2558;3;2;
/org.eclipse.pde.ui/src/org/eclipse/pde/ui/templates/OptionTemplateWizardPage.java;1;0;4;1;1;1;1;3;47;1;3;3819;73;73;1;0;0;3;4;3819;0;4752;4;1;
/org.eclipse.pde.ui/src/org/eclipse/pde/internal/ui/editor/manifest/ManifestDependenciesPage.java;1;0;1;1;0;0;0;1;0;0;1;3579;0;0;1;0;0;1;1;3579;0;3579;1;1;
/org.eclipse.help/src/org/eclipse/help/internal/search/ISearchResultCollector.java;1;0;2;1;2;1;2;0;0;0;0;4000;0;0;2;0;1;0;2;4000;1;4000;1;1;
/org.eclipse.jdt.ui.tests.refactoring/resources/ExtractMethodWorkSpace/ExtractMethodTests/locals_in/A_test538.java;1;1;3;1;2;2;2;1;4;0;1;922;4;4;1;0;0;1;3;922;0;4419;3;1;
/org.eclipse.jdt.ui/ui/org/eclipse/jdt/ui/actions/RefactorActionGroup.java;3;4;18;2;10;6;10;8;288;3;5;3716;500;500;4;3;4;8;18;3966;7;4770;11;3;
/org.eclipse.jdt.ui.tests.refactoring/resources/PullUpMethods/test1/in/A.java;1;0;2;1;0;0;0;2;0;1;2;2156;0;0;1;0;0;2;2;2156;0;2406;2;1;
/org.eclipse.update/src/org/eclipse/update/internal/ui/AuthorizationDatabase.java;1;0;1;1;0;0;0;1;0;0;1;1424;0;0;1;0;0;1;1;1424;0;1424;1;1;
/org.eclipse.ui/Eclipse UI/org/eclipse/ui/internal/SelectionEnabler.java;5;1;11;1;2;2;2;9;69;2;8;257;228;228;2;1;0;9;11;2033;1;4191;10;5;
/org.eclipse.ui.tests/Eclipse UI Tests/org/eclipse/ui/tests/dialogs/ResourceMessagesCopy.java;1;0;1;1;0;0;0;1;0;0;1;1113;0;0;1;0;0;1;1;1113;0;1113;1;1;
/org.eclipse.jdt.debug.tests/test programs/DropTests.java;1;0;2;1;0;0;0;2;0;1;2;3701;0;0;1;0;0;2;2;3701;0;3719;2;1;
/org.eclipse.team.cvs.core/src/org/eclipse/team/internal/ccvs/core/client/listeners/TagListener.java;2;1;6;1;2;2;2;4;48;2;3;3089;60;60;2;1;0;4;6;3089;1;4368;5;2;
/org.eclipse.jdt.ui.tests.refactoring/resources/StructureSelectionAction/A_test26.java;1;0;1;1;0;0;0;1;0;0;1;3353;0;0;1;0;0;1;1;3353;0;3353;1;1;
/org.eclipse.pde.ui/src/org/eclipse/pde/internal/base/BuildPathUtil.java;2;0;9;1;0;0;0;9;318;1;9;1434;405;405;1;0;0;9;9;1434;0;3039;9;2;
/org.eclipse.swt.tests/JUnit Tests/org/eclipse/swt/tests/junit/Test_org_eclipse_swt_dnd_DropTargetAdapter.java;2;0;2;1;1;1;1;1;6;0;1;1792;6;6;1;0;0;1;2;1792;0;4706;2;2;
/org.eclipse.ui/Eclipse UI Standard Components/org/eclipse/ui/views/tasklist/TasksFilter.java;5;1;11;1;2;2;2;9;111;1;9;257;352;352;1;0;0;9;11;257;0;4268;11;5;
/org.eclipse.jdt.ui/core refactoring/org/eclipse/jdt/internal/core/refactoring/changes/PackageReorgChange.java;2;0;5;1;0;0;0;5;31;1;5;1108;39;39;1;0;0;5;5;1108;0;1939;5;2;
/org.eclipse.vcm.tests.core/src/org/eclipse/vcm/tests/core/usecase/AllTests.java;1;0;1;1;0;0;0;1;0;0;1;1688;0;0;1;0;0;1;1;1688;0;1688;1;1;
/org.eclipse.pde.core/src/org/eclipse/pde/internal/core/ifeature/IFeature.java;1;1;3;1;2;2;2;1;26;0;1;3591;45;45;1;0;0;1;3;3591;0;3994;3;1;
/org.eclipse.jdt.ui.tests.refactoring/resources/SafeDeleteType/testFail9/in/A.java;1;0;1;1;0;0;0;1;0;0;1;49;0;0;1;0;0;1;1;49;0;49;1;1;
/org.eclipse.jdt.core/codeassist/org/eclipse/jdt/internal/codeassist/SelectionEngine.java;3;1;37;2;4;4;4;33;839;4;25;455;2226;2226;4;8;0;33;37;1039;8;4165;29;3;
/org.eclipse.jdt.ui/ui/org/eclipse/jdt/internal/ui/snippeteditor/ImportAction.java;1;0;3;1;0;0;0;3;7;1;3;15;7;7;1;0;0;3;3;15;0;291;3;1;
/org.eclipse.swt/Eclipse SWT/win32/org/eclipse/swt/widgets/Sash.java;8;2;13;1;4;3;4;9;114;1;9;106;281;281;2;0;1;9;13;4557;1;4701;12;8;
/org.eclipse.pde.ui/src/org/eclipse/pde/internal/ui/wizards/templates/NewWizardTemplate.java;1;1;6;1;2;2;2;4;34;1;4;3579;88;88;1;0;0;4;6;3579;0;4316;6;1;
/org.eclipse.swt/Eclipse SWT/photon/org/eclipse/swt/widgets/Label.java;7;1;16;2;4;4;4;12;191;2;11;106;442;442;2;1;0;12;16;609;1;4701;15;7;
/org.eclipse.ui/Eclipse UI/org/eclipse/ui/internal/dialogs/RemoveCapabilityStep.java;1;0;1;1;0;0;0;1;0;0;1;3506;0;0;1;0;0;1;1;3506;0;3506;1;1;
/org.eclipse.jdt.debug.ui/ui/org/eclipse/jdt/internal/debug/ui/launcher/JavaLauncher.java;2;0;6;1;0;0;0;6;26;1;6;1915;66;66;1;0;0;6;6;1915;0;3122;6;2;
/org.eclipse.jdt.ui.tests.refactoring/resources/MoveMembers/testFail2/in/A.java;1;0;1;1;0;0;0;1;0;0;1;2738;0;0;1;0;0;1;1;2738;0;2738;1;1;
/org.eclipse.jdt.core/compiler/org/eclipse/jdt/internal/compiler/env/IGenericMethod.java;2;0;5;1;1;1;1;4;26;1;4;455;58;58;1;0;0;4;5;455;0;4062;5;2;
/org.eclipse.scripting/src/org/eclipse/scripting/ICancel.java;1;0;1;1;0;0;0;1;0;0;1;1424;0;0;1;0;0;1;1;1424;0;1424;1;1;
/org.eclipse.pde.ui/src/org/eclipse/pde/internal/ui/editor/PDEEditorContributor.java;1;2;6;1;4;3;4;2;38;0;1;3579;70;70;2;1;1;2;6;3579;2;4552;4;1;
/org.eclipse.jdt.ui/ui/org/eclipse/jdt/internal/ui/wizards/buildpaths/ClasspathContainerWizard.java;1;1;4;1;4;4;4;0;100;0;0;4117;166;166;1;0;0;0;4;4117;0;4193;4;1;
/org.eclipse.team.cvs.core/src/org/eclipse/team/internal/ccvs/core/response/custom/StatusErrorHandler.java;3;0;5;1;0;0;0;5;123;1;5;1978;135;135;1;0;0;5;5;1978;0;2607;5;3;
/org.eclipse.jdt.core/codeassist/org/eclipse/jdt/internal/codeassist/ISearchableNameEnvironment.java;2;1;6;1;2;2;2;4;55;1;4;455;123;123;1;0;0;4;6;455;0;4062;6;2;
/org.eclipse.jdt.ui/core extension/org/eclipse/jdt/internal/corext/textmanipulation/TextUtil.java;1;0;2;1;0;0;0;2;0;1;2;2216;0;0;1;0;0;2;2;2216;0;3811;2;1;
/org.eclipse.pde.runtime/src/org/eclipse/pde/internal/runtime/registry/RegistryBrowserLabelProvider.java;2;0;2;1;0;0;0;2;205;1;2;1434;205;205;1;0;0;2;2;1434;0;3702;2;2;
/org.eclipse.jdt.ui.tests/JUnit/junit/util/StandardTestSuiteLoader.java;2;0;2;1;0;0;0;2;0;1;2;49;0;0;1;0;0;2;2;49;0;1186;2;2;
/org.eclipse.ui.tests/Eclipse UI Tests/org/eclipse/ui/tests/dialogs/UIDialogs.java;3;0;5;1;0;0;0;5;39;1;5;1113;54;54;1;0;0;5;5;1113;0;2785;5;3;
/org.eclipse.swt/Eclipse SWT/common_j2se/org/eclipse/swt/internal/SWTEventObject.java;2;1;3;1;2;2;2;1;6;0;1;1561;11;11;1;0;0;1;3;1561;0;4701;3;2;
/org.eclipse.pde.ui/src/org/eclipse/pde/internal/ui/wizards/Category.java;1;0;1;1;0;0;0;1;0;0;1;3579;0;0;1;0;0;1;1;3579;0;3579;1;1;
/org.eclipse.jdt.core/dom/org/eclipse/jdt/core/dom/Type.java;2;0;2;1;0;0;0;2;2;1;2;2669;2;2;1;0;0;2;2;2669;0;2702;2;2;
/org.eclipse.core.resources/src/org/eclipse/core/internal/resources/LocalMetaArea.java;3;1;10;1;2;2;2;8;554;1;8;12;842;842;1;0;0;8;10;12;0;4213;10;3;
/org.eclipse.jdt.ui/core refactoring/org/eclipse/jdt/internal/core/refactoring/code/ExtractMethodAnalyzer.java;1;0;6;1;0;0;0;6;71;2;5;1236;130;130;2;1;0;6;6;1927;1;1939;5;1;
/org.eclipse.jdt.ui/core refactoring/org/eclipse/jdt/internal/core/refactoring/code/SelectionAnalyzer.java;1;0;3;1;0;0;0;3;2;1;3;1236;2;2;1;0;0;3;3;1236;0;1360;3;1;
/org.eclipse.jdt.junit/Eclipse JUnit/org/eclipse/jdt/internal/junit/ui/TestRunInfo.java;2;0;2;1;0;0;0;2;0;1;2;2399;0;0;1;0;0;2;2;2399;0;3313;2;2;
/org.eclipse.jdt.debug.tests/testprograms/EvaluationTests.java;2;0;2;1;1;1;1;1;11;0;1;3719;11;11;1;0;0;1;2;3719;0;4571;2;2;
/org.eclipse.pde.ui/src/org/eclipse/pde/internal/ui/model/ifeature/IFeatureInfo.java;1;0;2;1;0;0;0;2;0;1;2;3579;0;0;1;0;0;2;2;3579;0;3591;2;1;
/org.eclipse.jdt.core/search/org/eclipse/jdt/internal/core/search/matching/PackageReferencePattern.java;3;2;22;2;6;5;6;16;1680;4;12;455;3289;3289;4;4;1;16;22;1039;5;4419;17;3;
/org.eclipse.jdt.ui/core refactoring/org/eclipse/jdt/core/refactoring/methods/RenameParameterASTAnalyzer.java;1;0;7;1;0;0;0;7;10;2;5;233;27;27;2;2;0;7;7;233;2;408;5;1;
/org.eclipse.ant.core/src/plugin/org/eclipse/ant/core/AntRunner.java;1;0;1;1;0;0;0;1;0;0;1;3475;0;0;1;0;0;1;1;3475;0;3475;1;1;
/org.eclipse.pde.ui/templates/newWizard/java/$wizardClassName$.java;1;0;1;1;0;0;0;1;0;0;1;3442;0;0;1;0;0;1;1;3442;0;3442;1;1;
/org.eclipse.jdt.ui/ui/org/eclipse/jdt/internal/ui/reorg/DuplicateSourceReferenceAction.java;2;0;8;1;0;0;0;8;52;2;7;2003;85;85;2;1;0;8;8;2133;1;3739;7;2;
/org.eclipse.ui/Eclipse UI Standard Components/org/eclipse/ui/views/navigator/GotoResourceAction.java;5;0;8;1;1;1;1;7;9;1;7;257;32;32;1;0;0;7;8;257;0;4067;8;5;
/org.eclipse.jdt.core/model/org/eclipse/jdt/core/util/IExceptionAttribute.java;2;2;7;1;5;4;5;2;20;0;1;3629;50;50;2;1;1;2;7;3629;2;4573;5;2;
/org.eclipse.jdt.ui/core extension/org/eclipse/jdt/internal/corext/textmanipulation/SwapTextEdit.java;1;0;2;1;0;0;0;2;2;1;2;2137;2;2;1;0;0;2;2;2137;0;2512;2;1;
/org.eclipse.jdt.ui.tests.refactoring/resources/RenameType/test47/out/A.java;1;0;2;1;0;0;0;2;0;1;2;49;0;0;1;0;0;2;2;49;0;522;2;1;
/org.eclipse.ui/Eclipse JFace Text/org/eclipse/jface/text/contentassist/CompletionProposal.java;3;0;3;1;0;0;0;3;31;1;3;257;36;36;1;0;0;3;3;257;0;1066;3;3;
/org.eclipse.swt.tests/JUnit Tests/org/eclipse/swt/tests/junit/Test_org_eclipse_swt_widgets_Display.java;2;0;2;1;1;1;1;1;6;0;1;1792;6;6;1;0;0;1;2;1792;0;4706;2;2;
/org.eclipse.jdt.ui.tests.refactoring/resources/RenameStaticMethod/test7/out/A.java;1;0;1;1;0;0;0;1;0;0;1;49;0;0;1;0;0;1;1;49;0;49;1;1;
/org.eclipse.jdt.core/compiler/org/eclipse/jdt/internal/compiler/IDebugRequestor.java;2;0;2;1;1;1;1;1;10;0;1;1811;10;10;1;0;0;1;2;1811;0;4062;2;2;
/org.eclipse.ui/Eclipse UI/org/eclipse/ui/internal/SystemSummaryEditor.java;2;1;2;1;2;2;2;0;35;0;0;4387;35;35;1;0;0;0;2;4387;0;4751;2;2;
/org.eclipse.compare/compare/org/eclipse/compare/ZipFileStructureCreator.java;1;0;2;1;1;1;1;1;51;0;1;1254;51;51;1;0;0;1;2;1254;0;4820;2;1;
/org.eclipse.ant.core/src/org/eclipse/ant/core/EclipseProject.java;6;0;20;1;0;0;0;20;576;2;18;14;1056;1056;2;2;0;20;20;66;2;3489;18;6;
/org.eclipse.update.ui/src/org/eclipse/update/internal/ui/manager/UpdatesPage.java;1;0;5;1;0;0;0;5;11;1;5;1428;13;13;1;0;0;5;5;1428;0;3537;5;1;
/org.eclipse.jdt.debug.ui/ui/org/eclipse/jdt/internal/debug/ui/IJDIPreferencesConstants.java;3;0;11;1;1;1;1;10;87;1;10;2009;182;182;1;0;0;10;11;2009;0;4212;11;3;
/org.eclipse.help/src/org/eclipse/help/topics/ITopic.java;2;0;4;1;0;0;0;4;11;1;4;1675;12;12;1;0;0;4;4;1675;0;1804;4;2;
/org.eclipse.pde.ui/src/org/eclipse/pde/internal/core/build/BuildEntry.java;1;0;3;1;0;0;0;3;9;2;2;3579;9;9;2;1;0;3;3;3579;1;3607;2;1;
/org.eclipse.pde.ui/src/org/eclipse/pde/internal/wizards/WizardListSelectionPage.java;2;0;4;1;0;0;0;4;18;1;4;1434;20;20;1;0;0;4;4;1434;0;3579;4;2;
/org.eclipse.vcm.ui/src/org/eclipse/vcm/internal/ui/VCMResourceNode.java;2;0;4;1;0;0;0;4;38;1;4;1;60;60;1;0;0;4;4;1;0;531;4;2;
/org.eclipse.pde.ui/src/org/eclipse/pde/internal/core/ifeature/IFeaturePlugin.java;1;0;2;1;0;0;0;2;0;1;2;3591;0;0;1;0;0;2;2;3591;0;3607;2;1;
/org.eclipse.pde.ui/src/org/eclipse/pde/internal/editor/manifest/PointUsageSection.java;1;0;4;1;0;0;0;4;4;1;4;3050;5;5;1;0;0;4;4;3050;0;3579;4;1;
/org.eclipse.ui.examples.readmetool/Eclipse UI Examples Readme Tool/org/eclipse/ui/examples/readmetool/IReadmeConstants.java;3;0;5;1;0;0;0;5;48;1;5;932;63;63;1;0;0;5;5;932;0;3579;5;3;
/org.eclipse.jdt.ui.tests.refactoring/resources/SelectionAnalyzerWorkSpace/SelectionAnalyzerTests/validSelection/A_test140_.java;1;0;1;1;0;0;0;1;0;0;1;2139;0;0;1;0;0;1;1;2139;0;2139;1;1;
/org.eclipse.compare/compare/org/eclipse/compare/internal/CompareDialog.java;2;0;5;1;1;1;1;4;54;1;4;14;73;73;1;0;0;4;5;14;0;4188;5;2;
/org.eclipse.debug.ui/ui/org/eclipse/debug/internal/ui/actions/TerminateAndRemoveActionDelegate.java;3;1;9;1;2;2;2;7;43;1;7;2382;112;112;1;0;0;7;9;2382;0;4163;9;3;
/org.eclipse.ui/Eclipse JFace/org/eclipse/jface/operation/IRunnableWithProgress.java;2;0;2;1;0;0;0;2;5;1;2;257;5;5;1;0;0;2;2;257;0;457;2;2;
/org.eclipse.pde.ui/src/org/eclipse/pde/internal/ui/editor/schema/SchemaEditorContributor.java;1;0;2;1;1;1;1;1;15;0;1;3579;15;15;1;0;0;1;2;3579;0;3923;2;1;
/org.eclipse.jdt.ui/ui/org/eclipse/jdt/internal/ui/javaeditor/structureselection/StructureSelectEnclosingAction.java;2;1;6;2;2;2;2;4;7;2;3;3188;29;29;2;1;0;4;6;3188;1;4630;5;2;
/org.eclipse.webdav/src/client/org/eclipse/webdav/http/client/HttpConnection.java;4;1;7;1;2;2;2;5;3000;1;5;12;4603;4603;1;0;0;5;7;12;0;4626;7;4;
/org.eclipse.jdt.ui/ui/org/eclipse/jdt/internal/ui/search/SearchViewSiteAdapter.java;1;0;1;1;1;1;1;0;0;0;0;4165;0;0;1;0;0;0;1;4165;0;4165;1;1;
/org.eclipse.debug.ui/ui/org/eclipse/debug/internal/ui/views/ExpressionViewContentProvider.java;3;0;8;2;1;1;1;7;45;3;4;2345;91;91;3;3;0;7;8;3360;3;3975;5;3;
/org.eclipse.swt/Eclipse SWT/common/org/eclipse/swt/layout/RowData.java;4;0;6;2;1;1;1;5;29;3;3;106;40;40;3;2;0;5;6;2880;2;4701;4;4;
/org.eclipse.swt.tests/JUnit Tests/org/eclipse/swt/tests/junit/AllGraphicsTests.java;2;0;2;1;1;1;1;1;6;0;1;1792;6;6;1;0;0;1;2;1792;0;4706;2;2;
/org.eclipse.jdt.ui.tests.refactoring/resources/SafeDeleteType/testFail0/in/A.java;1;0;1;1;0;0;0;1;0;0;1;49;0;0;1;0;0;1;1;49;0;49;1;1;
/org.eclipse.ui/Eclipse JFace Text/org/eclipse/jface/text/source/AnnotationRulerColumn.java;2;2;7;2;7;6;7;0;35;0;0;4138;79;79;2;0;1;0;7;4455;1;4838;6;2;
/org.eclipse.debug.ui/ui/org/eclipse/debug/internal/ui/LaunchConfigurationTypePropertyPage.java;3;0;9;1;0;0;0;9;15;1;9;2538;44;44;1;0;0;9;9;2538;0;3741;9;3;
/org.eclipse.jdt.ui/ui/org/eclipse/jdt/internal/ui/util/ResourceDeltaSpy.java;3;0;4;1;0;0;0;4;8;1;4;15;14;14;1;0;0;4;4;15;0;1199;4;3;
/org.eclipse.debug.ui/ui/org/eclipse/debug/internal/ui/IInternalDebugUIConstants.java;3;2;13;1;3;2;3;10;78;1;10;187;147;147;2;0;1;10;13;4002;1;4349;12;3;
/org.eclipse.jdt.ui.tests.refactoring/resources/RenameType/testFail9/in/A.java;1;0;1;1;0;0;0;1;0;0;1;49;0;0;1;0;0;1;1;49;0;49;1;1;
/org.eclipse.vcm.ui/src/org/eclipse/vcm/internal/ui/HistoryFilterDialog.java;2;0;3;1;0;0;0;3;197;1;3;1131;248;248;1;0;0;3;3;1131;0;1568;3;2;
/org.eclipse.jdt.debug.ui/ui/org/eclipse/jdt/internal/debug/ui/launcher/JavaConnectTab.java;3;2;22;2;6;5;6;16;357;2;14;2586;863;863;2;2;1;16;22;3050;3;4098;19;3;
/org.eclipse.scripting/src/org/eclipse/scripting/internal/uirenderer/XGRNodePresentation.java;1;0;1;1;0;0;0;1;0;0;1;1424;0;0;1;0;0;1;1;1424;0;1424;1;1;
/org.eclipse.ant.core/src/org/eclipse/ant/internal/core/Policy.java;2;0;5;1;1;1;1;4;97;1;4;3439;164;164;1;0;0;4;5;3439;0;4363;5;2;
/org.eclipse.swt/Eclipse SWT/win32/org/eclipse/swt/internal/win32/WNDCLASSEX.java;2;0;3;1;0;0;0;3;5;1;3;106;5;5;1;0;0;3;3;106;0;1612;3;2;
/org.eclipse.jdt.debug/eval/org/eclipse/jdt/internal/debug/eval/ast/engine/NotOperator.java;1;0;2;1;0;0;0;2;0;1;2;3329;0;0;1;0;0;2;2;3329;0;3421;2;1;
/org.eclipse.jdt.ui.tests.refactoring/resources/ExtractMethodWorkSpace/ExtractMethodTests/error_out/A_test802.java;1;1;3;1;2;2;2;1;0;0;1;3150;0;0;1;0;0;1;3;3150;0;4419;3;1;
/org.eclipse.ui/Eclipse JFace Text/org/eclipse/jface/text/IUndoManager.java;3;0;3;1;0;0;0;3;52;1;3;257;57;57;1;0;0;3;3;257;0;1066;3;3;
/org.eclipse.update.core/src/org/eclipse/update/core/model/CategoryModel.java;2;0;2;1;0;0;0;2;127;1;2;3027;127;127;1;0;0;2;2;3027;0;3512;2;2;
/org.eclipse.jdt.debug.tests/tests/org/eclipse/jdt/debug/tests/eval/NestedTypeFieldValue_703.java;2;1;3;1;3;3;3;0;12;0;0;4447;14;14;1;0;0;0;3;4447;0;4571;3;2;
/org.eclipse.team.core/src/org/eclipse/team/internal/core/target/Symmetria.java;4;3;11;1;11;8;11;0;253;0;0;4010;523;523;3;0;3;0;11;4322;3;4339;8;4;
/org.eclipse.jdt.ui.tests.refactoring/resources/RenameType/test14/out/B.java;1;0;1;1;0;0;0;1;0;0;1;522;0;0;1;0;0;1;1;522;0;522;1;1;
/org.eclipse.jdt.ui.tests.refactoring/resources/ExtractMethodWorkSpace/ExtractMethodTests/invalidSelection/A_test031.java;2;1;3;1;2;2;2;1;0;0;1;49;0;0;1;0;0;1;3;49;0;4419;3;2;
/org.eclipse.jdt.ui/core refactoring/org/eclipse/jdt/internal/core/refactoring/code/flow/DoWhileFlowInfo.java;1;0;2;1;0;0;0;2;0;1;2;1236;0;0;1;0;0;2;2;1236;0;1939;2;1;
/org.eclipse.pde.ui/src/org/eclipse/pde/internal/editor/manifest/AlertSection.java;2;0;8;1;0;0;0;8;44;3;6;1434;61;61;3;2;0;8;8;2470;2;3579;6;2;
/org.eclipse.pde.ui/src/org/eclipse/pde/internal/editor/schema/EnumerationRestrictionPage.java;2;0;2;1;0;0;0;2;0;1;2;1434;0;0;1;0;0;2;2;1434;0;3579;2;2;
/org.eclipse.jdt.ui/ui/org/eclipse/jdt/internal/ui/dialogs/ProblemDialog.java;3;0;3;1;0;0;0;3;46;1;3;431;67;67;1;0;0;3;3;431;0;1256;3;3;
/org.eclipse.jdt.ui/core refactoring/org/eclipse/jdt/internal/core/refactoring/code/flow/SwitchFlowInfo.java;1;0;2;1;0;0;0;2;0;1;2;1236;0;0;1;0;0;2;2;1236;0;1939;2;1;
/org.eclipse.pde.ui/Eclipse PDE UI/org/eclipse/pde/internal/wizards/extension/NewExtensionWizard.java;2;0;5;2;0;0;0;5;12;3;3;267;12;12;3;2;0;5;5;324;2;1434;3;2;
/org.eclipse.ui/Eclipse JFace Text/org/eclipse/jface/text/DefaultInformationControl.java;2;1;8;1;2;2;2;6;37;1;6;1435;144;144;1;0;0;6;8;1435;0;4838;8;2;
/org.eclipse.swt/Eclipse SWT OLE Win32/win32/org/eclipse/swt/internal/ole/win32/IOleCommandTarget.java;2;0;3;1;0;0;0;3;9;1;3;106;9;9;1;0;0;3;3;106;0;2069;3;2;
/org.eclipse.pde.ui/Eclipse PDE UI/org/eclipse/pde/internal/editor/component/ComponentSpecSection.java;2;0;9;2;0;0;0;9;59;3;7;267;120;120;3;2;0;9;9;324;2;1434;7;2;
/org.eclipse.help/src/org/eclipse/help/internal/toc/Toc.java;2;0;6;1;0;0;0;6;57;1;6;1857;197;197;1;0;0;6;6;1857;0;3766;6;2;
/org.eclipse.jdt.ui.tests.refactoring/test cases/org/eclipse/jdt/ui/tests/actions/DeleteSourceReferenceEditTests.java;1;0;1;1;0;0;0;1;0;0;1;2857;0;0;1;0;0;1;1;2857;0;2857;1;1;
/org.eclipse.jdt.debug.ui/ui/org/eclipse/jdt/internal/debug/ui/actions/ManageBreakpointAction.java;1;0;3;1;1;1;1;2;1;1;2;2844;1;1;1;0;0;2;3;2844;0;3935;3;1;
/org.eclipse.jdt.ui.tests.refactoring/resources/ReorderParameters/canReorder/A_test12_out.java;1;0;3;1;0;0;0;3;0;1;3;724;0;0;1;0;0;3;3;724;0;2270;3;1;
/org.eclipse.swt/Eclipse SWT PI/gtk/org/eclipse/swt/internal/gtk/GdkColor.java;2;0;4;1;2;1;2;2;7;1;2;2107;9;9;2;0;1;2;4;4701;1;4701;3;2;
/org.eclipse.jdt.ui.tests.refactoring/resources/RenameVariables/cannotRename/A_testFail9.java;1;0;2;1;0;0;0;2;0;1;2;724;0;0;1;0;0;2;2;724;0;1665;2;1;
/org.eclipse.jdt.junit/Eclipse JUnit/org/eclipse/jdt/junit/internal/TestUIApplication.java;1;0;2;1;0;0;0;2;0;1;2;1530;0;0;1;0;0;2;2;1530;0;2007;2;1;
/org.eclipse.pde.ui/src/org/eclipse/pde/internal/ui/editor/schema/SchemaSpecSection.java;1;0;2;1;0;0;0;2;2;1;2;3579;2;2;1;0;0;2;2;3579;0;3591;2;1;
/org.eclipse.jdt.ui/ui/org/eclipse/jdt/internal/ui/codemanipulation/AddImportsOperation.java;2;0;12;1;0;0;0;12;18;1;12;15;85;85;1;0;0;12;12;15;0;2016;12;2;
/org.eclipse.vcm.tests.core.cvs/src/org/eclipse/vcm/tests/core/cvs/CVSROOTTest.java;1;0;1;1;0;0;0;1;0;0;1;1688;0;0;1;0;0;1;1;1688;0;1688;1;1;
/org.eclipse.vcm.ui/src/org/eclipse/vcm/internal/ui/model/RemoteProject.java;3;0;6;1;0;0;0;6;16;1;6;1;27;27;1;0;0;6;6;1;0;1273;6;3;
/org.eclipse.pde.ui/src/org/eclipse/pde/internal/model/jars/ExternalJarsModel.java;2;0;2;1;0;0;0;2;0;1;2;1434;0;0;1;0;0;2;2;1434;0;2650;2;2;
/org.eclipse.swt/Eclipse SWT Custom Widgets/common/org/eclipse/swt/custom/StyledTextEvent.java;3;0;4;1;1;1;1;3;9;1;3;106;17;17;1;0;0;3;4;106;0;4701;4;3;
/org.eclipse.swt.examples/Eclipse SWT Examples/common/org/eclipse/swt/examples/controlexample/ToolBarTab.java;1;0;2;1;0;0;0;2;0;1;2;107;0;0;1;0;0;2;2;107;0;611;2;1;
/org.eclipse.swt/Eclipse SWT PI/gtk1x/org/eclipse/swt/internal/gtk/GtkFileSelection.java;2;0;2;1;1;1;1;1;3;0;1;2107;3;3;1;0;0;1;2;2107;0;4701;2;2;
/org.eclipse.jdt.ui/ui/org/eclipse/jdt/internal/ui/wizards/buildpaths/CPListLabelProvider.java;3;1;17;1;3;3;3;14;77;2;12;15;290;290;2;2;0;14;17;128;2;4158;15;3;
/org.eclipse.jdt.debug.ui/ui/org/eclipse/jdt/internal/debug/ui/display/DetailsViewerConfiguration.java;1;0;1;1;0;0;0;1;0;0;1;3327;0;0;1;0;0;1;1;3327;0;3327;1;1;
/org.eclipse.search/search/org/eclipse/search/internal/ui/ShowNextResultAction.java;2;0;4;1;0;0;0;4;9;1;4;15;16;16;1;0;0;4;4;15;0;687;4;2;
/org.eclipse.team.cvs.core/src/org/eclipse/team/internal/ccvs/core/client/NewEntryHandler.java;3;0;6;2;0;0;0;6;5;2;5;2826;19;19;2;1;0;6;6;2826;1;3610;5;3;
/org.eclipse.jdt.ui/ui/org/eclipse/jdt/internal/ui/jarpackager/ContainerFilter.java;1;1;5;1;2;2;2;3;14;1;3;902;27;27;1;0;0;3;5;902;0;4627;5;1;
/org.eclipse.ui/Eclipse UI Standard Components/org/eclipse/ui/views/internal/framelist/ForwardAction.java;3;0;4;1;0;0;0;4;16;1;4;257;19;19;1;0;0;4;4;257;0;3816;4;3;
/org.eclipse.jdt.ui/ui/org/eclipse/jdt/internal/ui/reorg/NewReorgDestinationAction.java;1;0;2;1;0;0;0;2;0;1;2;3758;0;0;1;0;0;2;2;3758;0;3807;2;1;
/org.eclipse.jdt.ui.tests.refactoring/resources/RenameParameters/canRename/A_test12_in.java;1;0;1;1;0;0;0;1;0;0;1;233;0;0;1;0;0;1;1;233;0;233;1;1;
/org.eclipse.pde.ui/Eclipse PDE UI/org/eclipse/pde/internal/editor/text/IColorManager.java;2;0;5;2;0;0;0;5;12;3;3;267;12;12;3;2;0;5;5;324;2;1434;3;2;
/org.eclipse.jdt.core/dom/org/eclipse/jdt/core/dom/CatchClause.java;2;1;6;1;2;2;2;4;18;1;4;2669;50;50;1;0;0;4;6;2669;0;4453;6;2;
/org.eclipse.jdt.core/model/org/eclipse/jdt/internal/core/builder/SearchProgressEvent.java;1;0;4;1;0;0;0;4;32;1;4;455;44;44;1;0;0;4;4;455;0;2808;4;1;
/org.eclipse.core.boot/src/org/eclipse/core/internal/boot/EclipseURLConnection.java;1;0;2;1;0;0;0;2;0;1;2;12;0;0;1;0;0;2;2;12;0;23;2;1;
/org.eclipse.pde.ui/src/org/eclipse/pde/internal/ui/editor/schema/EnumerationRestrictionPage.java;1;0;2;1;0;0;0;2;2;1;2;3579;2;2;1;0;0;2;2;3579;0;3591;2;1;
/org.eclipse.pde.ui/Eclipse PDE UI/org/eclipse/pde/internal/base/model/IModel.java;2;0;5;2;0;0;0;5;12;3;3;267;12;12;3;2;0;5;5;324;2;1434;3;2;
/org.eclipse.jdt.ui.tests.refactoring/test cases/org/eclipse/jdt/ui/tests/refactoring/PullUpMethodsTests.java;1;0;4;1;0;0;0;4;21;1;4;2270;27;27;1;0;0;4;4;2270;0;2406;4;1;
/org.eclipse.pde.ui/src/org/eclipse/pde/internal/ui/launcher/BasicLauncherTab.java;1;2;11;1;6;5;6;5;90;2;4;3579;241;241;2;1;1;5;11;3579;2;4631;9;1;
/org.eclipse.swt/Eclipse SWT/motif/org/eclipse/swt/widgets/DirectoryDialog.java;9;2;15;2;6;5;6;9;194;1;9;106;459;459;2;0;1;9;15;4528;1;4701;14;9;
/org.eclipse.pde.runtime/Eclipse PDE Runtime/org/eclipse/pde/internal/runtime/registry/RegistryBrowserContentProvider.java;2;0;3;1;0;0;0;3;4;1;3;267;4;4;1;0;0;3;3;267;0;1434;3;2;
/org.eclipse.jdt.core/model/org/eclipse/jdt/core/util/JavaModelUtil.java;1;0;2;1;0;0;0;2;0;1;2;3522;0;0;1;0;0;2;2;3522;0;3565;2;1;
/org.eclipse.jdt.ui/ui/org/eclipse/jdt/internal/ui/javaeditor/PrintMarginPainter.java;1;0;3;1;0;0;0;3;25;1;3;3101;29;29;1;0;0;3;3;3101;0;3324;3;1;
/org.eclipse.core.tests.runtime/src/org/eclipse/core/tests/internal/plugins/FragmentResolveTest_9.java;3;0;4;1;0;0;0;4;194;1;4;1819;205;205;1;0;0;4;4;1819;0;3476;4;3;
/org.eclipse.jdt.ui.tests.refactoring/resources/SefWorkSpace/SefTests/object_out/TestCompoundWrite2.java;1;0;1;1;0;0;0;1;0;0;1;2876;0;0;1;0;0;1;1;2876;0;2876;1;1;
/org.eclipse.pde.ui/src/org/eclipse/pde/internal/base/schema/ISchemaAttributeProvider.java;2;0;2;1;0;0;0;2;0;1;2;1434;0;0;1;0;0;2;2;1434;0;3579;2;2;
/org.eclipse.pde.ui/Eclipse PDE UI/org/eclipse/pde/internal/model/PluginParent.java;2;0;5;2;0;0;0;5;12;3;3;267;12;12;3;2;0;5;5;324;2;1434;3;2;
/org.eclipse.ui/Eclipse UI Standard Components/org/eclipse/ui/views/internal/framelist/FrameListMessages.java;2;0;3;1;0;0;0;3;3;1;3;457;3;3;1;0;0;3;3;457;0;3816;3;2;
/org.eclipse.jdt.ui/core refactoring/org/eclipse/jdt/internal/corext/refactoring/changes/UndoTextChange.java;1;0;4;1;0;0;0;4;16;2;3;1939;18;18;2;1;0;4;4;2133;1;2512;3;1;
/org.eclipse.pde.ui/Eclipse PDE UI/org/eclipse/pde/internal/schema/SchemaObject.java;2;0;6;2;0;0;0;6;34;3;4;267;46;46;3;2;0;6;6;324;2;1434;4;2;
/org.eclipse.debug.ui/ui/org/eclipse/debug/internal/ui/SWTUtil.java;1;1;4;1;3;3;3;1;19;0;1;3266;24;24;1;0;0;1;4;3266;0;4426;4;1;
/org.eclipse.webdav/src/interface/org/eclipse/webdav/dom/Update.java;3;0;5;1;1;1;1;4;324;1;4;12;407;407;1;0;0;4;5;12;0;4211;5;3;
/org.eclipse.vcm.core.cvs/src/org/eclipse/vcm/internal/core/ccvs/ICVSStatus.java;3;0;3;1;0;0;0;3;9;1;3;0;15;15;1;0;0;3;3;0;0;298;3;3;
/org.eclipse.jdt.ui.tests.refactoring/resources/RenameVariables/canRename/A_test32_out.java;1;0;2;1;0;0;0;2;0;1;2;724;0;0;1;0;0;2;2;724;0;1665;2;1;
/org.eclipse.ui/Eclipse UI/org/eclipse/ui/internal/CloseAllPagesAction.java;5;0;5;1;0;0;0;5;15;1;5;257;19;19;1;0;0;5;5;257;0;3103;5;5;
/org.eclipse.pde.ui/src/org/eclipse/pde/internal/schema/Schema.java;2;0;8;1;0;0;0;8;45;1;8;1434;99;99;1;0;0;8;8;1434;0;3579;8;2;
/org.eclipse.update.ui/src/org/eclipse/update/internal/ui/views/BaseTreeView.java;2;0;4;1;1;1;1;3;2;1;3;3537;5;5;1;0;0;3;4;3537;0;4610;4;2;
/org.eclipse.pde.ui/src/org/eclipse/pde/internal/preferences/ExternalPluginsWizardPage.java;2;0;2;1;0;0;0;2;0;1;2;1434;0;0;1;0;0;2;2;1434;0;2750;2;2;
/org.eclipse.pde.runtime/src/org/eclipse/pde/internal/runtime/registry/RegistryBrowser.java;2;0;3;1;0;0;0;3;17;1;3;1434;21;21;1;0;0;3;3;1434;0;3702;3;2;
/org.eclipse.jdt.ui.tests.refactoring/resources/ExtractMethodWorkSpace/ExtractMethodTests/invalidSelection/A_test020.java;2;1;3;1;2;2;2;1;0;0;1;49;0;0;1;0;0;1;3;49;0;4419;3;2;
/org.eclipse.core.runtime/src/org/eclipse/core/runtime/IExtensionPoint.java;3;0;4;1;1;1;1;3;190;1;3;12;211;211;1;0;0;3;4;12;0;4214;4;3;
/org.eclipse.jdt.ui.tests.refactoring/test cases/org/eclipse/jdt/ui/tests/refactoring/ExtractMethodTestSetup.java;2;0;8;1;1;1;1;7;6;1;7;1896;27;27;1;0;0;7;8;1896;0;4081;8;2;
/org.eclipse.jdt.ui/ui/org/eclipse/jdt/internal/ui/javaeditor/DisplayAction.java;1;0;6;1;0;0;0;6;47;1;6;15;65;65;1;0;0;6;6;15;0;345;6;1;
/org.eclipse.ui/Eclipse UI/org/eclipse/ui/internal/dialogs/WorkbenchPreferenceNode.java;3;0;3;1;1;1;1;2;20;1;2;257;25;25;1;0;0;2;3;257;0;4429;3;3;
/org.eclipse.update.ui/src/org/eclipse/update/internal/ui/manager/SiteView.java;3;0;31;1;0;0;0;31;632;2;28;1460;1205;1205;2;3;0;31;31;1526;3;3537;28;3;
/org.eclipse.swt/Eclipse SWT OLE Win32/win32/org/eclipse/swt/internal/ole/win32/IDispatch.java;2;0;3;1;0;0;0;3;5;1;3;106;5;5;1;0;0;3;3;106;0;2069;3;2;
/org.eclipse.jdt.ui/ui refactoring/org/eclipse/jdt/internal/ui/refactoring/actions/RefactoringWizardFactory.java;1;0;2;1;0;0;0;2;0;1;2;1258;0;0;1;0;0;2;2;1258;0;1328;2;1;
/org.eclipse.team.examples.filesystem/src/org/eclipse/team/examples/filesystem/ui/FileSystemPropertiesPage.java;1;0;1;1;1;1;1;0;0;0;0;4674;0;0;1;0;0;0;1;4674;0;4674;1;1;
/org.eclipse.debug.ui/ui/org/eclipse/debug/internal/ui/StepActionDelegate.java;3;0;3;1;0;0;0;3;5;1;3;187;5;5;1;0;0;3;3;187;0;2382;3;3;
/org.eclipse.jdt.ui.tests/test plugin/org/eclipse/jdt/testplugin/ui/JavaTestUIApplication.java;2;0;4;1;0;0;0;4;6;1;4;49;10;10;1;0;0;4;4;49;0;1186;4;2;
/org.eclipse.jdt.ui.tests.refactoring/resources/MoveMembers/testFail12/in/A.java;1;0;1;1;0;0;0;1;0;0;1;2738;0;0;1;0;0;1;1;2738;0;2738;1;1;
/org.eclipse.swt/Eclipse SWT/motif/org/eclipse/swt/internal/BidiUtil.java;1;0;2;1;0;0;0;2;0;1;2;1349;0;0;1;0;0;2;2;1349;0;1360;2;1;
/org.eclipse.debug.core/core/org/eclipse/debug/internal/core/LaunchConfigurationInfo.java;4;1;14;1;3;3;3;11;232;1;11;1819;413;413;1;0;0;11;14;1819;0;4406;14;4;
/org.eclipse.jdt.ui.tests.refactoring/resources/ExtractMethodWorkSpace/ExtractMethodTests/locals_in/A_test516.java;2;1;4;1;2;2;2;2;16;1;2;369;16;16;1;0;0;2;4;369;0;4419;4;2;
/org.eclipse.jdt.ui.tests.refactoring/resources/ExtractMethodWorkSpace/ExtractMethodTests/invalidSelection/A_test051.java;2;1;3;1;2;2;2;1;0;0;1;49;0;0;1;0;0;1;3;49;0;4419;3;2;
/org.eclipse.vcm.ui/src/org/eclipse/vcm/internal/ui/actions/ViewFileAction.java;3;0;8;2;0;0;0;8;46;4;5;1;110;110;4;3;0;8;8;1;3;512;5;3;
/org.eclipse.pde.ui/Eclipse PDE UI/org/eclipse/pde/internal/preferences/TracingPropertySource.java;2;0;5;2;0;0;0;5;57;3;3;267;57;57;3;2;0;5;5;324;2;1434;3;2;
/org.eclipse.jdt.ui.tests.refactoring/resources/RenameType/test22/in/A.java;1;0;1;1;0;0;0;1;0;0;1;49;0;0;1;0;0;1;1;49;0;49;1;1;
/org.eclipse.core.tests.resources/src/org/eclipse/core/tests/internal/dtree/DeltaDataTreeTest.java;3;0;3;1;0;0;0;3;2024;1;3;1794;2035;2035;1;0;0;3;3;1794;0;3420;3;3;
/org.eclipse.jdt.ui/ui/org/eclipse/jdt/ui/actions/UnifiedSite.java;1;0;2;1;0;0;0;2;0;1;2;3533;0;0;1;0;0;2;2;3533;0;3826;2;1;
/org.eclipse.swt.tests/JUnit Tests/org/eclipse/swt/tests/junit/Test_org_eclipse_swt_SWTError.java;2;0;2;1;1;1;1;1;6;0;1;1792;6;6;1;0;0;1;2;1792;0;4706;2;2;
/org.eclipse.jdt.core/search/org/eclipse/jdt/internal/core/search/PatternSearchJob.java;3;1;16;1;2;2;2;14;207;4;11;455;582;582;4;3;0;14;16;1039;3;4063;13;3;
/org.eclipse.jdt.ui/core refactoring/org/eclipse/jdt/internal/core/refactoring/util/IParentTrackable.java;1;0;2;1;0;0;0;2;0;1;2;1453;0;0;1;0;0;2;2;1453;0;1462;2;1;
/org.eclipse.jdt.ui.tests.refactoring/test cases/org/eclipse/jdt/ui/tests/refactoring/RefactoringTest.java;2;0;9;1;1;1;1;8;29;1;8;1896;90;90;1;0;0;8;9;1896;0;4081;9;2;
/org.eclipse.update.ui.forms/src/org/eclipse/update/ui/forms/FormEntry.java;1;0;2;1;0;0;0;2;0;1;2;1542;0;0;1;0;0;2;2;1542;0;2474;2;1;
/org.eclipse.team.cvs.ui/src/org/eclipse/team/internal/ccvs/ui/wizards/UpdateWizard.java;3;0;6;1;0;0;0;6;6;1;6;3204;19;19;1;0;0;6;6;3204;0;3644;6;3;
/org.eclipse.jdt.core/codeassist/org/eclipse/jdt/internal/codeassist/select/SelectionOnQualifiedTypeReference.java;2;0;10;1;1;1;1;9;63;4;6;455;142;142;4;3;0;9;10;1039;3;4062;7;2;
/org.eclipse.jdt.ui.tests/JUnit/junit/textui/TestRunner.java;2;0;3;1;0;0;0;3;5;1;3;49;5;5;1;0;0;3;3;49;0;1186;3;2;
/org.eclipse.jdt.debug/jdi interfaces/com/sun/jdi/Method.java;2;0;2;1;0;0;0;2;24;1;2;2704;24;24;1;0;0;2;2;2704;0;3033;2;2;
/org.eclipse.jdt.ui.tests.refactoring/resources/RenameTemp/canRename/A_test41_in.java;1;0;1;1;0;0;0;1;0;0;1;3322;0;0;1;0;0;1;1;3322;0;3322;1;1;
/org.eclipse.core.tests.runtime/src/org/eclipse/core/tests/internal/plugins/ConflictResolveTest_3.java;3;0;3;1;0;0;0;3;134;1;3;1794;144;144;1;0;0;3;3;1794;0;3476;3;3;
/org.eclipse.jdt.ui/ui refactoring/org/eclipse/jdt/internal/ui/refactoring/PullUpWizard.java;2;1;8;1;4;4;4;4;14;1;4;2406;41;41;1;0;0;4;8;2406;0;4621;8;2;
/org.eclipse.pde.ui/src/org/eclipse/pde/internal/editor/component/ComponentForm.java;2;0;3;1;0;0;0;3;8;1;3;1434;8;8;1;0;0;3;3;1434;0;2951;3;2;
/org.eclipse.jdt.ui/core refactoring/org/eclipse/jdt/internal/core/refactoring/packages/RenamePackageASTAnalyzer.java;2;0;5;1;0;0;0;5;8;1;5;408;12;12;1;0;0;5;5;408;0;1342;5;2;
/org.eclipse.jdt.ui.tests.refactoring/resources/PasteSourceReference/test0/out/A.java;1;0;1;1;0;0;0;1;0;0;1;2003;0;0;1;0;0;1;1;2003;0;2003;1;1;
/org.eclipse.swt/Eclipse SWT PI/photon/org/eclipse/swt/internal/photon/PhRegion_t.java;2;0;2;1;1;1;1;1;6;0;1;2069;6;6;1;0;0;1;2;2069;0;4701;2;2;
/org.eclipse.jdt.debug/model/org/eclipse/jdt/internal/debug/core/model/JDIArrayType.java;2;0;3;2;0;0;0;3;15;0;1;2517;15;15;3;2;0;3;3;2517;2;2517;1;2;
/org.eclipse.jdt.ui.tests.refactoring/resources/RenameType/test28/out/B.java;1;0;1;1;0;0;0;1;0;0;1;522;0;0;1;0;0;1;1;522;0;522;1;1;
/org.eclipse.jdt.core/model/org/eclipse/jdt/internal/core/Openable.java;4;1;48;2;7;7;7;41;676;4;33;455;1529;1529;4;8;0;41;48;1039;8;4424;40;4;
/org.eclipse.swt/Eclipse SWT OLE Win32/win32/org/eclipse/swt/internal/ole/win32/IMoniker.java;2;0;3;1;0;0;0;3;5;1;3;106;5;5;1;0;0;3;3;106;0;2069;3;2;
/org.eclipse.jdt.ui/ui refactoring/org/eclipse/jdt/internal/ui/refactoring/ChangeElement.java;1;0;2;1;1;1;1;1;3;0;1;1800;3;3;1;0;0;1;2;1800;0;4447;2;1;
/org.eclipse.pde.ui/src/org/eclipse/pde/internal/editor/manifest/ImportListSection.java;1;0;20;1;0;0;0;20;493;2;17;2472;1240;1240;2;3;0;20;20;2472;3;3579;17;1;
/org.eclipse.core.boot/src/org/eclipse/core/internal/boot/PlatformURLConnection.java;6;0;13;1;1;1;1;12;908;2;11;23;1093;1093;2;1;0;12;13;39;1;4214;12;6;
/org.eclipse.ui/Eclipse UI Standard Components/org/eclipse/ui/views/properties/FilePropertySource.java;2;0;2;1;0;0;0;2;4;1;2;257;4;4;1;0;0;2;2;257;0;457;2;2;
/org.eclipse.jdt.debug/jdi/org/eclipse/jdi/internal/ReferenceTypeImpl.java;3;1;11;2;2;2;2;9;61;2;8;187;240;240;2;1;0;9;11;3528;1;4207;10;3;
/org.eclipse.debug.ui/ui/org/eclipse/debug/internal/ui/ClearOutputAction.java;3;0;7;1;0;0;0;7;7;1;7;187;23;23;1;0;0;7;7;187;0;2382;7;3;
/org.eclipse.core.boot/src/org/eclipse/core/internal/boot/EclipseURLComponentConnection.java;1;0;2;1;0;0;0;2;0;1;2;12;0;0;1;0;0;2;2;12;0;23;2;1;
/org.eclipse.scripting.tests/Eclipse Scripting Tests/org/eclipse/scripting/tests/ScriptTests.java;2;0;2;1;0;0;0;2;0;1;2;1186;0;0;1;0;0;2;2;1186;0;1862;2;2;
/org.eclipse.core.resources/src/org/eclipse/core/internal/indexing/PageStorePolicy.java;2;0;2;1;0;0;0;2;0;1;2;370;0;0;1;0;0;2;2;370;0;448;2;2;
/org.eclipse.webdav/src/kernel/org/eclipse/webdav/internal/kernel/Message.java;2;0;5;1;1;1;1;4;86;1;4;12;161;161;1;0;0;4;5;12;0;4211;5;2;
/org.eclipse.jdt.ui.tests.refactoring/resources/RenamePrivateMethod/testAnon0/in/A.java;1;0;1;1;0;0;0;1;0;0;1;49;0;0;1;0;0;1;1;49;0;49;1;1;
/org.eclipse.jdt.ui.tests.refactoring/resources/InlineTemp/canInline/A_test22_in.java;1;0;1;1;1;1;1;0;0;0;0;4419;0;0;1;0;0;0;1;4419;0;4419;1;1;
/org.eclipse.jdt.ui.tests.refactoring/resources/RenamePackage/test3/out/p/A.java;2;0;2;1;0;0;0;2;0;1;2;91;0;0;1;0;0;2;2;91;0;1258;2;2;
/org.eclipse.debug.ui/ui/org/eclipse/debug/internal/ui/launchConfigurations/LaunchConfigurationTypePropertyPage.java;2;0;3;1;1;1;1;2;9;1;2;3741;13;13;1;0;0;2;3;3741;0;3899;3;2;
/org.eclipse.update.ui.forms/src/org/eclipse/update/ui/forms/internal/engine/FormEngineLayout.java;2;0;5;1;0;0;0;5;95;2;4;2746;104;104;2;1;0;5;5;2746;1;3245;4;2;
/org.eclipse.pde.ui/Eclipse PDE UI/org/eclipse/pde/internal/editor/manifest/ManifestExtensionPointPage.java;2;0;5;2;0;0;0;5;12;3;3;267;12;12;3;2;0;5;5;324;2;1434;3;2;
/org.eclipse.swt/Eclipse SWT PI/win32/org/eclipse/swt/internal/win32/GCP_RESULTS.java;2;0;2;1;1;1;1;1;6;0;1;2069;6;6;1;0;0;1;2;2069;0;4701;2;2;
/org.eclipse.core.tests.resources/src/org/eclipse/core/tests/resources/usecase/Snapshot2Test.java;3;0;4;1;0;0;0;4;224;1;4;1794;251;251;1;0;0;4;4;1794;0;3420;4;3;
/org.eclipse.ui.tests/Eclipse UI Tests/org/eclipse/ui/tests/adaptable/TestNavigatorActionFactory.java;2;0;2;1;1;1;1;1;0;0;1;2863;0;0;1;0;0;1;2;2863;0;4068;2;2;
/org.eclipse.jdt.ui.tests.refactoring/resources/ExtractMethodWorkSpace/ExtractMethodTests/invalidSelection/A_test048.java;1;1;3;1;2;2;2;1;0;0;1;892;0;0;1;0;0;1;3;892;0;4419;3;1;
/org.eclipse.update.tests.core/src/org/eclipse/update/tests/regularInstall/TestInstall.java;2;1;43;1;2;2;2;41;204;2;37;1531;929;929;2;4;0;41;43;1577;4;4209;39;2;
/org.eclipse.debug.ui/ui/org/eclipse/debug/internal/ui/views/DebugUIViewsMessages.java;1;0;2;1;1;1;1;1;11;0;1;2328;11;11;1;0;0;1;2;2328;0;4567;2;1;
/org.eclipse.core.boot/src/org/eclipse/core/internal/boot/update/ComponentEntryDescriptor.java;4;0;6;2;0;0;0;6;24;1;6;12;62;62;1;0;0;6;6;12;0;2726;6;4;
/org.eclipse.jdt.ui/ui/org/eclipse/jdt/internal/ui/launcher/MainTypeSelectionDialog.java;3;0;5;1;0;0;0;5;13;1;5;1290;19;19;1;0;0;5;5;1290;0;1916;5;3;
/org.eclipse.pde.ui/src/org/eclipse/pde/internal/ui/editor/schema/NewAttributeAction.java;1;0;2;1;0;0;0;2;2;1;2;3579;2;2;1;0;0;2;2;3579;0;3591;2;1;
/org.eclipse.jdt.ui/ui/org/eclipse/jdt/internal/ui/viewsupport/OverrideIndicatorLabelDecorator.java;1;1;2;1;2;2;2;0;0;0;0;4018;0;0;1;0;0;0;2;4018;0;4044;2;1;
/org.eclipse.jdt.core/model/org/eclipse/jdt/internal/core/builder/SourceFile.java;3;2;9;2;5;3;5;4;48;1;4;2979;106;106;2;0;2;4;9;4063;2;4382;7;3;
/org.eclipse.jdt.debug/jdi interfaces/com/sun/jdi/request/BreakpointRequest.java;2;0;2;1;0;0;0;2;13;1;2;2704;13;13;1;0;0;2;2;2704;0;3040;2;2;
/org.eclipse.jdt.debug/eval/org/eclipse/jdt/debug/eval/ast/model/IRuntimeContext.java;1;0;2;1;0;0;0;2;0;1;2;3329;0;0;1;0;0;2;2;3329;0;3421;2;1;
/org.eclipse.webdav/src/client/org/eclipse/webdav/internal/authentication/AuthenticationInfo.java;3;0;5;1;1;1;1;4;234;1;4;12;272;272;1;0;0;4;5;12;0;4211;5;3;
/org.eclipse.jdt.ui/core refactoring/org/eclipse/jdt/internal/corext/refactoring/reorg/AddImportUtil.java;2;0;2;1;0;0;0;2;0;1;2;1939;0;0;1;0;0;2;2;1939;0;2212;2;2;
/org.eclipse.pde.ui/src/org/eclipse/pde/internal/ui/editor/text/PDEPartitionScanner.java;1;0;2;1;1;1;1;1;30;0;1;3579;30;30;1;0;0;1;2;3579;0;4316;2;1;
/org.eclipse.ui/Eclipse UI/org/eclipse/ui/internal/SystemSummaryEditorInputFactory.java;1;0;1;1;1;1;1;0;0;0;0;4387;0;0;1;0;0;0;1;4387;0;4387;1;1;
/org.eclipse.swt/Eclipse SWT PI/win32/org/eclipse/swt/internal/ole/win32/COM.java;3;1;10;1;2;2;2;8;132;2;7;2069;230;230;2;1;0;8;10;3030;1;4701;9;3;
/org.eclipse.jdt.core/compiler/org/eclipse/jdt/core/compiler/InvalidInputException.java;1;0;5;1;1;1;1;4;90;2;3;3349;96;96;2;1;0;4;5;3373;1;4421;4;1;
/org.eclipse.pde.build/src/plugin/org/eclipse/pde/internal/core/BuildScriptGeneratorApplication.java;1;0;1;1;0;0;0;1;0;0;1;3475;0;0;1;0;0;1;1;3475;0;3475;1;1;
/org.eclipse.ui/Eclipse UI/org/eclipse/ui/part/PluginTransfer.java;2;0;2;1;0;0;0;2;7;1;2;257;7;7;1;0;0;2;2;257;0;457;2;2;
/org.eclipse.pde.ui/src/org/eclipse/pde/internal/editor/component/PluginReference.java;2;0;2;1;0;0;0;2;0;1;2;1434;0;0;1;0;0;2;2;1434;0;2951;2;2;
/org.eclipse.ui/Eclipse UI/org/eclipse/ui/internal/dialogs/AboutDialog.java;5;2;24;2;14;12;14;10;181;2;9;257;884;884;2;1;2;10;24;1097;3;4637;21;5;
/org.eclipse.swt/Eclipse SWT/win32/org/eclipse/swt/widgets/Scale.java;6;2;9;1;4;3;4;5;28;1;5;106;61;61;2;0;1;5;9;4557;1;4701;8;6;
/org.eclipse.jdt.core/model/org/eclipse/jdt/internal/core/util/LineNumberAttribute.java;2;1;5;1;3;3;3;2;19;0;1;3629;41;41;2;1;0;2;5;3629;1;4422;4;2;
/org.eclipse.jdt.ui.tests.refactoring/resources/RenameNonPrivateField/testFail13/in/A.java;1;0;1;1;0;0;0;1;0;0;1;49;0;0;1;0;0;1;1;49;0;49;1;1;
/org.eclipse.jdt.ui.tests.refactoring/resources/RenameParameters/canRename/A_test7_out.java;1;0;1;1;0;0;0;1;0;0;1;233;0;0;1;0;0;1;1;233;0;233;1;1;
/org.eclipse.jdt.ui.tests.refactoring/resources/ExtractMethodWorkSpace/ExtractMethodTests/wiki_out/A_test2004.java;1;1;4;1;2;2;2;2;42;1;2;1236;44;44;1;0;0;2;4;1236;0;4419;4;1;
/org.eclipse.core.resources/src/org/eclipse/core/internal/utils/EmptyEnumeration.java;1;0;4;1;1;1;1;3;82;1;3;12;106;106;1;0;0;3;4;12;0;4214;4;1;
/org.eclipse.swt/Eclipse SWT OLE Win32/win32/org/eclipse/swt/internal/ole/win32/IOleControl.java;2;0;3;1;0;0;0;3;5;1;3;106;5;5;1;0;0;3;3;106;0;2069;3;2;
/org.eclipse.scripting/Eclipse Scripting/org/eclipse/scripting/internal/IXGRElementUITableElement.java;1;0;3;1;0;0;0;3;4;1;3;133;4;4;1;0;0;3;3;133;0;1424;3;1;
/org.eclipse.jdt.ui/ui/org/eclipse/jdt/internal/ui/util/SocketUtil.java;2;0;3;1;0;0;0;3;9;1;3;15;9;9;1;0;0;3;3;15;0;1290;3;2;
/org.eclipse.core.resources/src/org/eclipse/core/internal/events/DeltaFilter.java;1;0;4;1;1;1;1;3;58;1;3;12;79;79;1;0;0;3;4;12;0;4214;4;1;
/org.eclipse.pde.core/src/org/eclipse/pde/core/build/IBuildModelFactory.java;1;0;4;1;2;1;2;2;16;1;2;3591;18;18;2;0;1;2;4;4751;1;4751;3;1;
/org.eclipse.ui/Eclipse UI Text Editor/org/eclipse/ui/texteditor/TextEditorAction.java;3;0;3;1;0;0;0;3;5;1;3;257;10;10;1;0;0;3;3;257;0;1066;3;3;
/org.eclipse.jdt.ui.tests.refactoring/resources/RenameType/test57/in/A.java;1;0;1;1;0;0;0;1;0;0;1;1547;0;0;1;0;0;1;1;1547;0;1547;1;1;
/org.eclipse.jdt.ui/ui/org/eclipse/jdt/internal/ui/launcher/J9VM.java;1;0;3;1;0;0;0;3;4;2;2;218;4;4;2;1;0;3;3;218;1;323;2;1;
/org.eclipse.scripting/Eclipse Scripting/org/eclipse/scripting/internal/views/ScriptConsoleClearAction.java;2;0;4;1;0;0;0;4;5;1;4;133;9;9;1;0;0;4;4;133;0;1424;4;2;
/org.eclipse.ui/Eclipse JFace/org/eclipse/jface/viewers/CheckboxTreeViewer.java;3;0;4;1;0;0;0;4;19;1;4;257;30;30;1;0;0;4;4;257;0;1436;4;3;
/org.eclipse.swt/Eclipse SWT OLE Win32/win32/org/eclipse/swt/internal/ole/win32/COMObject.java;2;0;3;1;1;1;1;2;6;1;2;106;10;10;1;0;0;2;3;106;0;4701;3;2;
/org.eclipse.jdt.ui/ui/org/eclipse/jdt/internal/ui/launcher/JDK12Launcher.java;5;0;12;2;0;0;0;12;30;2;9;15;111;111;2;3;0;12;12;218;3;1916;9;5;
/org.eclipse.compare/compare/org/eclipse/compare/contentmergeviewer/ContentMergeViewer.java;2;0;24;1;1;1;1;23;114;2;21;14;593;593;2;2;0;23;24;347;2;4820;22;2;
/org.eclipse.team.cvs.core/src/org/eclipse/team/internal/ccvs/core/response/CheckedIn.java;3;0;6;1;0;0;0;6;25;1;6;1978;47;47;1;0;0;6;6;1978;0;2607;6;3;
/org.eclipse.ui/Eclipse JFace Text/org/eclipse/jface/text/rules/IRule.java;2;0;2;1;0;0;0;2;5;1;2;257;5;5;1;0;0;2;2;257;0;457;2;2;
/org.eclipse.swt/Eclipse SWT/motif/org/eclipse/swt/widgets/FontExtStyle.java;3;0;4;1;0;0;0;4;5;1;4;106;7;7;1;0;0;4;4;106;0;3006;4;3;
/org.eclipse.scripting/src/org/eclipse/scripting/internal/uirenderer/XGRElementUISwtWizardBuildTime.java;1;0;1;1;0;0;0;1;0;0;1;1424;0;0;1;0;0;1;1;1424;0;1424;1;1;
/org.eclipse.team.cvs.ui/src/org/eclipse/team/internal/ccvs/ui/actions/DiffAction.java;1;0;2;1;0;0;0;2;0;1;2;1978;0;0;1;0;0;2;2;1978;0;2389;2;1;
/org.eclipse.help/src/org/eclipse/help/internal/util/TableOfContentsGenerator.java;2;0;2;1;0;0;0;2;0;1;2;1420;0;0;1;0;0;2;2;1420;0;1675;2;2;
/org.eclipse.jdt.ui.tests.refactoring/resources/ExtractMethodWorkSpace/ExtractMethodTests/invalidSelection/A_test111.java;2;1;3;1;2;2;2;1;0;0;1;49;0;0;1;0;0;1;3;49;0;4419;3;2;
/org.eclipse.jdt.ui/core refactoring/org/eclipse/jdt/internal/corext/refactoring/nls/NLSScanner.java;2;0;8;1;1;1;1;7;13;1;7;1939;47;47;1;0;0;7;8;1939;0;3892;8;2;
/org.eclipse.ant.core/src/org/eclipse/ant/internal/core/old/EclipseCopy.java;1;0;1;1;0;0;0;1;0;0;1;3270;0;0;1;0;0;1;1;3270;0;3270;1;1;
/org.eclipse.pde.runtime/Eclipse PDE Runtime/org/eclipse/pde/internal/runtime/registry/ParentAdapter.java;2;0;3;1;0;0;0;3;4;1;3;267;4;4;1;0;0;3;3;267;0;1434;3;2;
/org.eclipse.ui/Eclipse JFace/org/eclipse/jface/viewers/ICheckStateListener.java;2;0;2;1;0;0;0;2;5;1;2;257;5;5;1;0;0;2;2;257;0;457;2;2;
/org.eclipse.team.cvs.core/src/org/eclipse/team/internal/ccvs/core/util/RemoteFolderTreeBuilder.java;3;0;34;2;0;0;0;34;192;3;27;2117;907;907;3;7;0;34;34;2249;7;3089;27;3;
/org.eclipse.ui/Eclipse UI/org/eclipse/ui/dialogs/PropertyDialogAction.java;5;0;7;1;2;1;2;5;50;1;5;257;80;80;2;0;1;5;7;4259;1;4259;6;5;
/org.eclipse.team.tests.cvs.core/src/org/eclipse/team/tests/ccvs/core/provider/CommandsTest.java;2;0;5;1;0;0;0;5;12;1;5;2536;21;21;1;0;0;5;5;2536;0;3089;5;2;
/org.eclipse.ui/Eclipse UI Standard Components/org/eclipse/ui/views/properties/PropertySheetEntry.java;3;0;4;1;1;1;1;3;9;1;3;257;20;20;1;0;0;3;4;257;0;4120;4;3;
/org.eclipse.pde.ui/src/org/eclipse/pde/internal/ui/launcher/TracingPropertySource.java;1;0;1;1;0;0;0;1;0;0;1;3579;0;0;1;0;0;1;1;3579;0;3579;1;1;
/org.eclipse.jdt.debug.ui/ui/org/eclipse/jdt/internal/debug/ui/actions/AddExceptionAction.java;2;0;6;1;1;1;1;5;17;1;5;2384;49;49;1;0;0;5;6;2384;0;4581;6;2;
/org.eclipse.jdt.debug.tests/tests/org/eclipse/jdt/debug/tests/eval/ByteOperatorsTests.java;2;2;3;2;3;2;3;0;17;0;0;4447;19;19;2;0;1;0;3;4447;1;4571;2;2;
/org.eclipse.pde.ui/src/org/eclipse/pde/internal/editor/jars/JarsSourceOutlinePage.java;2;0;2;1;0;0;0;2;0;1;2;1434;0;0;1;0;0;2;2;1434;0;2650;2;2;
/org.eclipse.swt/Eclipse SWT PI/photon/org/eclipse/swt/internal/photon/PhClipHeader.java;2;0;2;1;1;1;1;1;6;0;1;2069;6;6;1;0;0;1;2;2069;0;4701;2;2;
/org.eclipse.jdt.ui/core refactoring/org/eclipse/jdt/internal/corext/refactoring/util/ResourceUtil.java;1;0;4;1;0;0;0;4;33;1;4;3523;65;65;1;0;0;4;4;3523;0;3737;4;1;
/org.eclipse.ui.tests/Eclipse UI Tests/org/eclipse/ui/tests/internal/TextSelectionActionExpressionTest.java;2;0;2;1;0;0;0;2;2;1;2;2236;2;2;1;0;0;2;2;2236;0;2785;2;2;
/org.eclipse.vcm.tests.core/src/org/eclipse/vcm/tests/core/AllTests.java;1;0;1;1;0;0;0;1;0;0;1;1688;0;0;1;0;0;1;1;1688;0;1688;1;1;
/org.eclipse.swt/Eclipse SWT Drag and Drop/carbon/org/eclipse/swt/dnd/TableDragUnderEffect.java;4;1;4;1;4;4;4;0;83;0;0;4147;91;91;1;0;0;0;4;4147;0;4701;4;4;
/org.eclipse.pde.ui/Eclipse PDE UI/org/eclipse/pde/internal/component/ComponentJarWizardPage.java;2;0;11;2;0;0;0;11;28;3;8;267;76;76;3;3;0;11;11;324;3;1434;8;2;
/org.eclipse.jdt.ui/ui/org/eclipse/jdt/internal/ui/jarpackager/JarPackagerMessages.java;1;0;3;1;0;0;0;3;2;1;3;699;4;4;1;0;0;3;3;699;0;3529;3;1;
/org.eclipse.pde.ui/src/org/eclipse/pde/internal/base/model/plugin/IPluginImport.java;2;0;5;1;0;0;0;5;51;1;5;1434;116;116;1;0;0;5;5;1434;0;3039;5;2;
/org.eclipse.jdt.ui.tests.refactoring/resources/ExtractTemp/canExtract/A_test6_in.java;1;0;1;1;0;0;0;1;0;0;1;2481;0;0;1;0;0;1;1;2481;0;2481;1;1;
/org.eclipse.pde.ui/src/org/eclipse/pde/internal/ui/launcher/ILauncherSettings.java;1;0;1;1;0;0;0;1;0;0;1;3579;0;0;1;0;0;1;1;3579;0;3579;1;1;
/org.eclipse.pde.ui/src/org/eclipse/pde/internal/core/ModelEntry.java;1;0;5;1;0;0;0;5;18;2;3;3445;30;30;2;2;0;5;5;3445;2;3607;3;1;
/org.eclipse.jdt.debug/jdi interfaces/com/sun/jdi/request/EventRequestManager.java;3;0;3;1;0;0;0;3;61;1;3;2704;62;62;1;0;0;3;3;2704;0;3040;3;3;
/org.eclipse.ui/Eclipse JFace Text/org/eclipse/jface/text/internal/html/IBrowser.java;2;0;2;1;1;1;1;1;0;0;1;1435;0;0;1;0;0;1;2;1435;0;3915;2;2;
/org.eclipse.vcm.core.cvs/src/org/eclipse/vcm/internal/core/ccvs/requests/CheckedInErrorHandler.java;1;0;2;1;0;0;0;2;10;1;2;160;10;10;1;0;0;2;2;160;0;298;2;1;
/org.eclipse.swt/Eclipse SWT Custom Widgets/common_j2se/org/eclipse/swt/custom/TableTreeEditor.java;1;0;1;1;0;0;0;1;0;0;1;1378;0;0;1;0;0;1;1;1378;0;1378;1;1;
/org.eclipse.debug.ui/ui/org/eclipse/debug/internal/ui/actions/AbstractRemoveActionDelegate.java;1;0;6;1;0;0;0;6;19;1;6;2935;47;47;1;0;0;6;6;2935;0;3730;6;1;
/org.eclipse.jdt.debug/model/org/eclipse/jdt/internal/debug/core/StackFrameEvaluationContext.java;2;0;14;1;0;0;0;14;202;3;12;187;360;360;3;2;0;14;14;465;2;2381;12;2;
/org.eclipse.ui/Eclipse JFace/org/eclipse/jface/viewers/ISelection.java;2;0;2;1;0;0;0;2;5;1;2;257;5;5;1;0;0;2;2;257;0;457;2;2;
/org.eclipse.core.target/src/org/eclipse/core/internal/target/TargetInfo.java;1;1;6;1;2;2;2;4;648;1;4;12;786;786;1;0;0;4;6;12;0;4196;6;1;
/org.eclipse.jdt.ui/ui/org/eclipse/jdt/ui/JavaUI.java;10;2;42;2;12;9;12;30;206;3;26;15;692;692;3;4;3;30;42;322;7;4835;35;10;
/org.eclipse.debug.ui/ui/org/eclipse/debug/internal/ui/LaunchWizardNode.java;3;0;10;1;0;0;0;10;38;2;9;187;67;67;2;1;0;10;10;291;1;3634;9;3;
/org.eclipse.jdt.ui.tests.refactoring/resources/ExtractMethodWorkSpace/ExtractMethodTests/validSelection_out/A_test364.java;1;1;3;1;2;2;2;1;30;0;1;2622;30;30;1;0;0;1;3;2622;0;4419;3;1;
/org.eclipse.swt/Eclipse SWT PI/gtk1x/org/eclipse/swt/internal/gtk/GdkEventButton.java;2;0;2;1;1;1;1;1;3;0;1;2107;3;3;1;0;0;1;2;2107;0;4701;2;2;
/org.eclipse.swt/Eclipse SWT/win32/org/eclipse/swt/internal/win32/INITCOMMONCONTROLSEX.java;2;0;3;1;0;0;0;3;5;1;3;106;5;5;1;0;0;3;3;106;0;2069;3;2;
/org.eclipse.jdt.ui/ui/org/eclipse/jdt/internal/ui/browsing/MembersView.java;3;1;24;1;12;12;12;12;69;2;11;2878;347;347;2;1;0;12;24;3377;1;4626;23;3;
/org.eclipse.team.cvs.core/src/org/eclipse/team/internal/ccvs/core/resources/api/CVSProperties.java;3;0;3;1;0;0;0;3;152;1;3;1978;152;152;1;0;0;3;3;1978;0;2156;3;3;
/org.eclipse.scripting/Eclipse Scripting/org/eclipse/scripting/internal/views/ScriptUIEditorPropertySheetPage.java;2;0;4;1;0;0;0;4;8;1;4;133;13;13;1;0;0;4;4;133;0;1424;4;2;
/org.eclipse.compare/compare/org/eclipse/compare/internal/patch/CompareWithPatchAction.java;1;0;5;1;2;1;2;3;45;1;3;2876;54;54;2;0;1;3;5;4356;1;4356;4;1;
/org.eclipse.debug.ui/ui/org/eclipse/debug/internal/ui/BreakpointPropertiesAdapterFactory.java;3;0;5;1;0;0;0;5;31;1;5;1326;42;42;1;0;0;5;5;1326;0;2794;5;3;
/org.eclipse.jdt.ui.tests.refactoring/resources/SelectionAnalyzerWorkSpace/SelectionAnalyzerTests/validSelection/A_test149_.java;1;0;1;1;0;0;0;1;0;0;1;2139;0;0;1;0;0;1;1;2139;0;2139;1;1;
/org.eclipse.debug.ui/ui/org/eclipse/debug/internal/ui/launchConfigurations/TeamTab.java;2;0;4;1;0;0;0;4;296;1;4;2176;299;299;1;0;0;4;4;2176;0;2571;4;2;
/org.eclipse.pde.ui/Eclipse PDE UI/org/eclipse/pde/internal/editor/component/ComponentAdapterFactory.java;2;0;5;2;0;0;0;5;12;3;3;267;12;12;3;2;0;5;5;324;2;1434;3;2;
/org.eclipse.pde.ui/src/org/eclipse/pde/internal/ui/editor/manifest/NullMenuManager.java;1;0;2;1;1;1;1;1;46;0;1;3579;46;46;1;0;0;1;2;3579;0;4572;2;1;
/org.eclipse.jdt.ui/core refactoring/org/eclipse/jdt/internal/core/refactoring/reorg/CopyRefactoring.java;2;0;7;1;0;0;0;7;90;2;6;1258;120;120;2;1;0;7;7;1683;1;1939;6;2;
/org.eclipse.jdt.ui.tests.refactoring/resources/RenameType/test48/out/B.java;1;0;1;1;0;0;0;1;0;0;1;522;0;0;1;0;0;1;1;522;0;522;1;1;
/org.eclipse.jdt.ui/core refactoring/org/eclipse/jdt/internal/corext/refactoring/rename/RenameVirtualMethodRefactoring.java;2;1;9;1;2;2;2;7;70;1;7;1939;143;143;1;0;0;7;9;1939;0;4401;9;2;
/org.eclipse.jdt.ui.tests.refactoring/resources/SelectionAnalyzerWorkSpace/SelectionAnalyzerTests/validSelection/A_test304.java;1;0;1;1;0;0;0;1;0;0;1;1368;0;0;1;0;0;1;1;1368;0;1368;1;1;
/org.eclipse.jdt.ui.tests.refactoring/test cases/org/eclipse/jdt/ui/nls/tests/NLSRefactoringTester.java;1;0;2;1;0;0;0;2;0;1;2;1939;0;0;1;0;0;2;2;1939;0;2015;2;1;
/org.eclipse.jdt.ui.tests.refactoring/resources/RenameVirtualMethodInClass/test10/in/A.java;1;0;1;1;0;0;0;1;0;0;1;49;0;0;1;0;0;1;1;49;0;49;1;1;
/org.eclipse.debug.ui/ui/org/eclipse/debug/internal/ui/views/ExpressionView.java;3;0;15;1;1;1;1;14;66;3;12;2345;165;165;3;2;0;14;15;2345;2;3975;13;3;
/org.eclipse.jdt.debug/eval/org/eclipse/jdt/internal/debug/eval/ast/instructions/LessOperator.java;3;0;6;1;0;0;0;6;36;1;6;3421;48;48;1;0;0;6;6;3421;0;3677;6;3;
/org.eclipse.team.tests.core/src/org/eclipse/team/tests/core/RepositoryProviderBic.java;2;0;5;1;1;1;1;4;28;0;1;3271;38;38;4;3;0;4;5;3271;3;4545;2;2;
/org.eclipse.help/src/org/eclipse/help/internal/context/ContextProxy.java;1;0;3;1;0;0;0;3;8;1;3;2829;16;16;1;0;0;3;3;2829;0;3400;3;1;
/org.eclipse.jdt.core/search/org/eclipse/jdt/core/search/IJavaSearchResultCollector.java;3;2;9;2;6;4;6;3;74;1;3;455;102;102;2;0;2;3;9;4058;2;4573;7;3;
/org.eclipse.swt/Eclipse SWT/win32/org/eclipse/swt/internal/win32/TVITEM.java;2;0;3;1;0;0;0;3;5;1;3;106;5;5;1;0;0;3;3;106;0;2069;3;2;
/org.eclipse.jdt.ui.tests.refactoring/resources/SelectionAnalyzerWorkSpace/SelectionAnalyzerTests/invalidSelection/A_test102.java;1;0;1;1;0;0;0;1;0;0;1;1368;0;0;1;0;0;1;1;1368;0;1368;1;1;
/org.eclipse.debug.ui/ui/org/eclipse/debug/ui/ILaunchShortcut.java;1;0;1;1;1;1;1;0;0;0;0;4367;0;0;1;0;0;0;1;4367;0;4367;1;1;
/org.eclipse.core.tests.runtime/src/org/eclipse/core/tests/plugintests/SavePreferencesTests.java;1;0;1;1;1;1;1;0;0;0;0;4550;0;0;1;0;0;0;1;4550;0;4550;1;1;
/org.eclipse.swt/Eclipse SWT/common/org/eclipse/swt/graphics/RGB.java;3;0;4;1;1;1;1;3;6;1;3;106;14;14;1;0;0;3;4;106;0;4701;4;3;
/org.eclipse.jdt.ui/core refactoring/org/eclipse/jdt/internal/core/refactoring/AbstractJavaElementRenameChange.java;1;0;2;1;0;0;0;2;0;1;2;1800;0;0;1;0;0;2;2;1800;0;1939;2;1;
/org.eclipse.pde.ui/src/org/eclipse/pde/internal/forms/HyperlinkAdapter.java;2;0;2;1;0;0;0;2;0;1;2;1434;0;0;1;0;0;2;2;1434;0;2470;2;2;
/org.eclipse.core.resources/src/org/eclipse/core/internal/indexing/ObjectHeader.java;3;0;5;1;1;1;1;4;96;1;4;12;122;122;1;0;0;4;5;12;0;4214;5;3;
/org.eclipse.pde.build/src/antlib/org/eclipse/pde/internal/core/tasks/BuildScriptGeneratorTask.java;1;0;1;1;0;0;0;1;0;0;1;3475;0;0;1;0;0;1;1;3475;0;3475;1;1;
/org.eclipse.update.ui/src/org/eclipse/update/internal/ui/UpdateManagerAction.java;1;0;1;1;0;0;0;1;0;0;1;3662;0;0;1;0;0;1;1;3662;0;3662;1;1;
/org.eclipse.jdt.ui.tests.refactoring/resources/RenameMethodInInterface/testFail37/in/A.java;1;0;1;1;0;0;0;1;0;0;1;49;0;0;1;0;0;1;1;49;0;49;1;1;
/org.eclipse.update/src/org/eclipse/update/internal/ui/UMApplicationWindow.java;1;0;1;1;0;0;0;1;0;0;1;1424;0;0;1;0;0;1;1;1424;0;1424;1;1;
/org.eclipse.jdt.ui/ui/org/eclipse/jdt/ui/actions/ImplementorsSearchGroup.java;2;2;4;2;4;3;4;0;21;0;0;4146;29;29;2;0;1;0;4;4146;1;4770;3;2;
/org.eclipse.update.tests.core/src/org/eclipse/update/tests/api/TestPluginContainerAPI.java;2;0;13;1;1;1;1;12;24;2;11;1531;106;106;2;1;0;12;13;1638;1;3903;12;2;
/org.eclipse.help/Eclipse Help/org/eclipse/help/internal/server/HelpURLFactory.java;3;0;5;1;0;0;0;5;15;1;5;135;32;32;1;0;0;5;5;135;0;1420;5;3;
/org.eclipse.jdt.ui.tests.refactoring/resources/ExtractMethodWorkSpace/ExtractMethodTests/locals_in/A_test517.java;2;1;4;1;2;2;2;2;14;1;2;369;14;14;1;0;0;2;4;369;0;4419;4;2;
/org.eclipse.pde.runtime/Eclipse PDE Runtime/org/eclipse/pde/internal/runtime/registry/RegistryBrowser.java;2;0;3;1;0;0;0;3;4;1;3;267;4;4;1;0;0;3;3;267;0;1434;3;2;
/org.eclipse.jdt.ui/ui/org/eclipse/jdt/internal/ui/viewsupport/StorageLabelProvider.java;1;0;2;1;0;0;0;2;15;1;2;2321;15;15;1;0;0;2;2;2321;0;3846;2;1;
/org.eclipse.jdt.core/model/org/eclipse/jdt/internal/core/util/StringMatcher.java;1;0;9;1;0;0;0;9;127;4;6;455;163;163;4;3;0;9;9;1039;3;2032;6;1;
/org.eclipse.debug.core/core/org/eclipse/debug/core/IDebugConstants.java;3;0;7;1;0;0;0;7;36;1;7;187;92;92;1;0;0;7;7;187;0;1725;7;3;
/org.eclipse.jdt.core/codeassist/org/eclipse/jdt/internal/codeassist/complete/CompletionOnPackageReference.java;2;0;9;1;1;1;1;8;36;4;5;455;98;98;4;3;0;8;9;1039;3;4062;6;2;
/org.eclipse.jdt.debug.ui/ui/org/eclipse/jdt/internal/debug/ui/display/DisplayContentAssistPreference.java;1;0;2;1;0;0;0;2;0;0;1;1930;0;0;2;1;0;2;2;1930;1;1930;1;1;
/org.eclipse.help/Eclipse Help/org/eclipse/help/internal/util/URLCoder.java;1;0;3;1;0;0;0;3;4;1;3;809;4;4;1;0;0;3;3;809;0;1420;3;1;
/org.eclipse.jdt.core/compiler/org/eclipse/jdt/internal/compiler/codegen/Opcodes.java;2;0;3;1;1;1;1;2;15;1;2;455;20;20;1;0;0;2;3;455;0;4062;3;2;
/org.eclipse.core.tests.resources/src/org/eclipse/core/tests/internal/localstore/UnifiedTreeTest.java;3;0;4;1;1;1;1;3;432;1;3;1794;466;466;1;0;0;3;4;1794;0;4516;4;3;
/org.eclipse.core.tests.runtime/src/org/eclipse/core/tests/internal/plugins/PluginVersionTest.java;4;0;4;1;0;0;0;4;192;1;4;1794;207;207;1;0;0;4;4;1794;0;3476;4;4;
/org.eclipse.ui/Eclipse UI/org/eclipse/ui/internal/dialogs/WizardProjectReviewPage.java;1;0;4;1;0;0;0;4;356;3;2;3186;356;356;3;2;0;4;4;3186;2;3211;2;1;
/org.eclipse.pde.ui/Eclipse PDE UI/org/eclipse/pde/internal/base/IProjectProvider.java;2;0;6;2;0;0;0;6;12;3;4;267;21;21;3;2;0;6;6;324;2;1434;4;2;
/org.eclipse.ui.examples.readmetool/Eclipse UI Examples Readme Tool/org/eclipse/ui/examples/readmetool/PopupMenuActionDelegate.java;2;0;2;1;0;0;0;2;4;1;2;932;4;4;1;0;0;2;2;932;0;945;2;2;
/org.eclipse.pde.ui/Eclipse PDE UI/org/eclipse/pde/internal/editor/manifest/DependenciesForm.java;2;0;6;2;0;0;0;6;12;3;4;267;17;17;3;2;0;6;6;324;2;1434;4;2;
/org.eclipse.jdt.core/model/org/eclipse/jdt/internal/core/ClassFileWorkingCopy.java;3;1;17;1;4;4;4;13;42;3;9;3052;194;194;3;4;0;13;17;3373;4;4657;13;3;
/org.eclipse.debug.ui/ui/org/eclipse/debug/internal/ui/RemoveExpressionAction.java;2;0;2;1;0;0;0;2;0;1;2;2347;0;0;1;0;0;2;2;2347;0;2382;2;2;
/org.eclipse.pde.ui/src/org/eclipse/pde/internal/builders/DependencyLoop.java;1;0;3;1;0;0;0;3;2;1;3;2477;2;2;1;0;0;3;3;2477;0;3579;3;1;
/org.eclipse.jdt.ui.tests.refactoring/resources/ExtractMethodWorkSpace/ExtractMethodTests/expression_in/A_test615.java;1;1;3;1;2;2;2;1;0;0;1;1236;0;0;1;0;0;1;3;1236;0;4419;3;1;
/org.eclipse.scripting/Eclipse Scripting/org/eclipse/scripting/internal/IXGRElementUI.java;1;0;3;1;0;0;0;3;4;1;3;133;4;4;1;0;0;3;3;133;0;1424;3;1;
/org.eclipse.jdt.ui/core refactoring/org/eclipse/jdt/internal/core/refactoring/code/flow/ForFlowInfo.java;1;0;3;1;0;0;0;3;3;1;3;1236;3;3;1;0;0;3;3;1236;0;1939;3;1;
/org.eclipse.jdt.ui/core refactoring/org/eclipse/jdt/core/refactoring/text/SimpleReplaceTextChange.java;1;0;5;1;0;0;0;5;9;2;4;15;14;14;2;1;0;5;5;325;1;408;4;1;
/org.eclipse.jdt.ui.tests.refactoring/resources/RenameTemp/cannotRename/A_testFail23.java;1;0;2;1;0;0;0;2;2;1;2;1625;2;2;1;0;0;2;2;1625;0;1652;2;1;
/org.eclipse.team.cvs.ui/src/org/eclipse/team/internal/ccvs/ui/actions/CompareWithStreamAction.java;1;0;1;1;0;0;0;1;0;0;1;2312;0;0;1;0;0;1;1;2312;0;2312;1;1;
/org.eclipse.jdt.ui/core refactoring/org/eclipse/jdt/internal/core/refactoring/RefactoringSearchEngine.java;3;0;9;1;0;0;0;9;41;1;9;15;122;122;1;0;0;9;9;15;0;1939;9;3;
/org.eclipse.jdt.ui.tests.refactoring/resources/RenameType/testFail10/in/A.java;1;0;1;1;0;0;0;1;0;0;1;49;0;0;1;0;0;1;1;49;0;49;1;1;
/org.eclipse.team.cvs.ui/src/org/eclipse/team/internal/ccvs/ui/sync/GetSyncAction.java;1;0;2;1;0;0;0;2;0;1;2;2673;0;0;1;0;0;2;2;2673;0;2828;2;1;
/org.eclipse.core.runtime/src/org/eclipse/core/runtime/IConfigurationElement.java;3;0;4;1;1;1;1;3;406;1;3;12;426;426;1;0;0;3;4;12;0;4214;4;3;
/org.eclipse.update.ui.forms/src/org/eclipse/update/ui/forms/SectionChangeManager.java;1;0;2;1;0;0;0;2;0;1;2;1423;0;0;1;0;0;2;2;1423;0;2474;2;1;
/org.eclipse.scripting.examples/src/org/eclipse/scripting/examples/ExcaliburScriptRenderer.java;1;0;1;1;0;0;0;1;0;0;1;1424;0;0;1;0;0;1;1;1424;0;1424;1;1;
/org.eclipse.scripting/Eclipse Scripting/org/eclipse/scripting/internal/IXGRReader.java;1;0;3;1;0;0;0;3;4;1;3;133;4;4;1;0;0;3;3;133;0;1424;3;1;
/org.eclipse.pde.ui/src/org/eclipse/pde/internal/core/ischema/ISchemaDescriptor.java;1;0;2;1;0;0;0;2;0;1;2;3591;0;0;1;0;0;2;2;3591;0;3607;2;1;
/org.eclipse.ui/Eclipse UI/org/eclipse/ui/internal/dialogs/ViewSorter.java;3;0;3;1;0;0;0;3;23;1;3;257;27;27;1;0;0;3;3;257;0;1382;3;3;
/org.eclipse.jdt.ui.tests.refactoring/resources/SelectionAnalyzerWorkSpace/SelectionAnalyzerTests/validSelection/A_test121_.java;1;0;1;1;0;0;0;1;0;0;1;2139;0;0;1;0;0;1;1;2139;0;2139;1;1;
/org.eclipse.pde.ui/src/org/eclipse/pde/internal/wizards/extension/NewSchemaFileMainPage.java;2;0;4;1;0;0;0;4;2;1;4;1434;3;3;1;0;0;4;4;1434;0;3579;4;2;
/org.eclipse.jdt.ui/nls/org/eclipse/jdt/internal/ui/nls/ExternalizeAction.java;1;0;5;1;0;0;0;5;20;2;3;1880;40;40;2;2;0;5;5;1880;2;1908;3;1;
/org.eclipse.jdt.ui.tests.refactoring/resources/PullUp/test7/in/A.java;1;0;1;1;0;0;0;1;0;0;1;2406;0;0;1;0;0;1;1;2406;0;2406;1;1;
/org.eclipse.jdt.core/model/org/eclipse/jdt/internal/core/builder/impl/AbstractImageBuilder.java;1;0;4;1;0;0;0;4;306;1;4;455;308;308;1;0;0;4;4;455;0;2808;4;1;
/org.eclipse.jdt.ui/ui/org/eclipse/jdt/internal/ui/wizards/NewElementWizardPage.java;2;0;12;1;0;0;0;12;96;2;11;15;241;241;2;1;0;12;12;3088;1;3088;11;2;
/org.eclipse.jdt.ui.tests.refactoring/resources/ExtractMethodWorkSpace/ExtractMethodTests/semicolon_in/A_test403.java;2;1;3;1;2;2;2;1;0;0;1;49;0;0;1;0;0;1;3;49;0;4419;3;2;
/org.eclipse.ui/Eclipse JFace Text/org/eclipse/jface/text/rules/SingleLineRule.java;3;0;3;1;0;0;0;3;5;1;3;257;8;8;1;0;0;3;3;257;0;1066;3;3;
/org.eclipse.pde.core/src/org/eclipse/pde/internal/core/ischema/ISchemaElement.java;1;0;1;1;0;0;0;1;0;0;1;3591;0;0;1;0;0;1;1;3591;0;3591;1;1;
/org.eclipse.jdt.core/search/org/eclipse/jdt/internal/core/search/indexing/SourceIndexer.java;2;0;13;1;1;1;1;12;84;4;8;455;142;142;4;4;0;12;13;1039;4;4063;9;2;
/org.eclipse.jdt.ui.tests.refactoring/resources/ExtractMethodWorkSpace/ExtractMethodTests/invalidSelection/A_test131.java;2;1;4;1;2;2;2;2;24;1;2;80;27;27;1;0;0;2;4;80;0;4419;4;2;
/org.eclipse.jdt.ui/core refactoring/org/eclipse/jdt/internal/corext/refactoring/reorg/CopyRefactoring.java;3;1;10;1;4;4;4;6;128;1;6;1939;343;343;1;0;0;6;10;1939;0;4427;10;3;
/org.eclipse.team.cvs.core/src/org/eclipse/team/internal/ccvs/core/connection/ExtConnectionMethod.java;1;0;2;1;0;0;0;2;6;1;2;2956;6;6;1;0;0;2;2;2956;0;3610;2;1;
/org.eclipse.jdt.core/model/org/eclipse/jdt/internal/core/jdom/ILineStartFinder.java;2;1;5;1;2;2;2;3;15;1;3;455;40;40;1;0;0;3;5;455;0;4063;5;2;
/org.eclipse.scripting/src/org/eclipse/scripting/internal/uirenderer/XGRElementUISwtTree.java;1;0;1;1;0;0;0;1;0;0;1;1424;0;0;1;0;0;1;1;1424;0;1424;1;1;
/org.eclipse.jdt.debug/eval/org/eclipse/jdt/internal/debug/eval/ast/engine/UnaryMinusOperator.java;1;0;3;1;0;0;0;3;3;1;3;3329;3;3;1;0;0;3;3;3329;0;3421;3;1;
/org.eclipse.jdt.ui/ui/org/eclipse/jdt/internal/ui/text/JavaWordFinder.java;1;0;2;1;0;0;0;2;7;1;2;15;7;7;1;0;0;2;2;15;0;326;2;1;
/org.eclipse.jdt.ui/ui refactoring/org/eclipse/jdt/internal/ui/refactoring/ReorderParametersInputPage.java;1;0;4;1;0;0;0;4;323;2;3;2270;323;323;2;1;0;4;4;2630;1;2820;3;1;
/org.eclipse.jdt.core/codeassist/org/eclipse/jdt/internal/codeassist/select/SelectionOnArgumentName.java;2;0;2;1;1;1;1;1;22;0;1;3350;22;22;1;0;0;1;2;3350;0;4062;2;2;
/org.eclipse.update.ui/src/org/eclipse/update/internal/ui/manager/MyComputerPage.java;1;0;2;1;0;0;0;2;0;1;2;2651;0;0;1;0;0;2;2;2651;0;3537;2;1;
/org.eclipse.core.boot/src/org/eclipse/core/internal/boot/ResourceLoader.java;2;0;4;1;1;1;1;3;56;1;3;23;77;77;1;0;0;3;4;23;0;4214;4;2;
/org.eclipse.jdt.ui.tests.refactoring/resources/AbstractField/can/A_test2_in.java;1;0;1;1;0;0;0;1;0;0;1;751;0;0;1;0;0;1;1;751;0;751;1;1;
/org.eclipse.team.cvs.core/src/org/eclipse/team/ccvs/core/CVSRepositoryProviderType.java;1;0;3;1;0;0;0;3;31;1;3;3193;31;31;1;0;0;3;3;3193;0;3268;3;1;
/org.eclipse.jdt.core/compiler/org/eclipse/jdt/internal/compiler/lookup/SourceTypeBinding.java;4;1;24;2;2;2;2;22;1584;4;17;455;3849;3849;4;5;0;22;24;1039;5;4062;19;4;
/org.eclipse.jdt.ui.tests.refactoring/resources/RenameMethodInInterface/testFail8/in/A.java;1;0;1;1;0;0;0;1;0;0;1;49;0;0;1;0;0;1;1;49;0;49;1;1;
/org.eclipse.core.tests.resources.saveparticipant2/src/org/eclipse/core/tests/resources/saveparticipant2/SaveParticipant2Plugin.java;3;0;3;1;0;0;0;3;352;1;3;1794;362;362;1;0;0;3;3;1794;0;3475;3;3;
/org.eclipse.update.core/src/org/eclipse/update/core/IVerificationListener.java;2;0;3;1;0;0;0;3;59;1;3;3233;68;68;1;0;0;3;3;3233;0;3576;3;2;
/org.eclipse.swt/Eclipse SWT PI/win32/org/eclipse/swt/internal/win32/LOGFONT.java;2;0;2;1;1;1;1;1;6;0;1;2069;6;6;1;0;0;1;2;2069;0;4701;2;2;
/org.eclipse.jdt.debug.ui/ui/org/eclipse/jdt/internal/debug/ui/DropToFrameActionFilter.java;1;0;1;1;1;1;1;0;0;0;0;4552;0;0;1;0;0;0;1;4552;0;4552;1;1;
/org.eclipse.pde.ui/src/org/eclipse/pde/internal/ui/editor/build/VariableSection.java;1;0;3;1;1;1;1;2;34;0;1;3579;37;37;2;1;0;2;3;3579;1;4567;2;1;
/org.eclipse.debug.ui/ui/org/eclipse/debug/internal/ui/LauncherPropertyPage.java;3;0;15;1;0;0;0;15;29;2;14;187;93;93;2;1;0;15;15;3362;1;3634;14;3;
/org.eclipse.jdt.debug.ui/ui/org/eclipse/jdt/internal/debug/ui/snippeteditor/SnippetOpenHierarchyOnSelectionAction.java;2;0;4;1;3;1;3;1;139;0;1;1915;139;139;3;0;2;1;4;4431;2;4431;2;2;
/org.eclipse.jdt.debug.tests/tests/org/eclipse/jdt/debug/tests/core/HitCountBreakpointsTests.java;3;2;6;1;6;5;6;0;31;0;0;4286;60;60;2;0;1;0;6;4286;1;4571;5;3;
/org.eclipse.ui/Eclipse UI/org/eclipse/ui/internal/misc/Stopwatch.java;2;0;2;1;0;0;0;2;13;1;2;257;13;13;1;0;0;2;2;257;0;457;2;2;
/org.eclipse.pde.ui/src/org/eclipse/pde/internal/model/plugin/IdentifiablePluginObject.java;1;0;2;1;0;0;0;2;0;1;2;3136;0;0;1;0;0;2;2;3136;0;3579;2;1;
/org.eclipse.jdt.ui/ui/org/eclipse/jdt/internal/ui/wizards/ContainerPage.java;3;0;25;2;0;0;0;25;293;3;20;15;586;586;3;5;0;25;25;3084;5;3084;20;3;
/org.eclipse.jdt.ui/ui/org/eclipse/jdt/internal/ui/viewsupport/LibraryFilter.java;1;0;2;1;1;1;1;1;4;0;1;3484;4;4;1;0;0;1;2;3484;0;4211;2;1;
/org.eclipse.jdt.ui.tests.refactoring/resources/RenameMethodInInterface/test12/out/A.java;1;0;1;1;0;0;0;1;0;0;1;49;0;0;1;0;0;1;1;49;0;49;1;1;
/org.eclipse.pde.core/src/org/eclipse/pde/internal/core/builders/FeatureConsistencyChecker.java;1;0;3;1;0;0;0;3;36;1;3;3591;36;36;1;0;0;3;3;3591;0;3631;3;1;
/org.eclipse.jdt.core/model/org/eclipse/jdt/internal/core/CompilationUnitElementInfo.java;2;0;4;1;1;1;1;3;62;1;3;455;95;95;1;0;0;3;4;455;0;4063;4;2;
/org.eclipse.jdt.ui.tests.refactoring/resources/ExtractTemp/cannotExtract/A_testFail4.java;1;0;1;1;0;0;0;1;0;0;1;2481;0;0;1;0;0;1;1;2481;0;2481;1;1;
/org.eclipse.jdt.debug.tests/testprograms/DropTests.java;2;0;2;1;1;1;1;1;11;0;1;3719;11;11;1;0;0;1;2;3719;0;4571;2;2;
/org.eclipse.jdt.ui.tests.refactoring/resources/ExtractMethodWorkSpace/ExtractMethodTests/locals_out/A_test551.java;1;1;4;1;2;2;2;2;34;1;2;1236;37;37;1;0;0;2;4;1236;0;4419;4;1;
/org.eclipse.ui/Eclipse UI/org/eclipse/ui/internal/IInternalPerspectiveListener.java;2;0;2;1;0;0;0;2;31;1;2;2419;31;31;1;0;0;2;2;2419;0;3125;2;2;
/org.eclipse.debug.ui/ui/org/eclipse/debug/internal/ui/ShowTypesAction.java;3;0;10;1;0;0;0;10;24;1;10;187;77;77;1;0;0;10;10;187;0;2382;10;3;
/org.eclipse.swt.tests/JUnit Tests/org/eclipse/swt/tests/junit/Test_org_eclipse_swt_widgets_Synchronizer.java;2;0;2;1;1;1;1;1;6;0;1;1792;6;6;1;0;0;1;2;1792;0;4706;2;2;
/org.eclipse.pde.ui/Eclipse PDE UI/org/eclipse/pde/internal/base/model/plugin/IPluginExtensionPoint.java;2;0;5;2;0;0;0;5;12;3;3;267;12;12;3;2;0;5;5;324;2;1434;3;2;
/org.eclipse.jdt.debug/jdi/org/eclipse/jdi/internal/event/EventSetImpl.java;3;0;6;1;0;0;0;6;26;1;6;187;73;73;1;0;0;6;6;187;0;3677;6;3;
/org.eclipse.pde.ui/Eclipse PDE UI/org/eclipse/pde/internal/editor/build/BuildOutlinePage.java;2;0;5;2;0;0;0;5;12;3;3;267;12;12;3;2;0;5;5;324;2;1434;3;2;
/org.eclipse.help/Eclipse Help/org/eclipse/help/internal/util/ResourceLocator.java;2;0;2;1;0;0;0;2;0;1;2;1070;0;0;1;0;0;2;2;1070;0;1420;2;2;
/org.eclipse.jdt.ui/ui refactoring/org/eclipse/jdt/internal/ui/refactoring/ReorderParametersWizard.java;1;0;3;1;0;0;0;3;4;1;3;2270;4;4;1;0;0;3;3;2270;0;2820;3;1;
/org.eclipse.ui/Eclipse UI/org/eclipse/ui/internal/dialogs/WorkInProgressPreferencePage.java;6;1;22;3;6;6;6;16;230;4;10;3490;810;810;4;6;0;16;22;3570;6;4527;16;6;
/org.eclipse.jdt.ui/ui/org/eclipse/jdt/internal/ui/snippeteditor/StopAction.java;3;0;5;1;0;0;0;5;9;1;5;15;24;24;1;0;0;5;5;15;0;1916;5;3;
/org.eclipse.update.core/src/org/eclipse/update/internal/core/Policy.java;1;0;3;1;0;0;0;3;166;1;3;2963;174;174;1;0;0;3;3;2963;0;3808;3;1;
/org.eclipse.jdt.ui.tests.refactoring/resources/ReorderParameters/canReorder/A_test10_in.java;1;0;3;1;0;0;0;3;0;1;3;724;0;0;1;0;0;3;3;724;0;2270;3;1;
/org.eclipse.vcm.core.cvs/src/org/eclipse/vcm/internal/core/ccvs/requests/Tag.java;3;0;3;1;0;0;0;3;6;1;3;0;11;11;1;0;0;3;3;0;0;1098;3;3;
/org.eclipse.jdt.ui.tests.refactoring/resources/ExtractMethodWorkSpace/ExtractMethodTests/expression_out/A_test611.java;1;1;4;1;2;2;2;2;4;1;2;1236;4;4;1;0;0;2;4;1236;0;4419;4;1;
/org.eclipse.ui/Eclipse UI/org/eclipse/ui/internal/DetachedWindow.java;3;0;4;1;1;1;1;3;16;1;3;257;23;23;1;0;0;3;4;257;0;4069;4;3;
/org.eclipse.help/src/org/eclipse/help/internal/navigation/InfosetBuilder.java;2;0;3;1;0;0;0;3;6;1;3;1420;6;6;1;0;0;3;3;1420;0;1675;3;2;
/org.eclipse.jdt.ui.tests.refactoring/resources/ExtractMethodWorkSpace/ExtractMethodTests/locals_in/A_test568.java;1;1;2;1;2;2;2;0;0;0;0;4383;0;0;1;0;0;0;2;4383;0;4419;2;1;
/org.eclipse.ui/Eclipse UI Tool Script/org/eclipse/toolscript/ui/internal/AntPropertyChangeListener.java;1;1;2;1;2;2;2;0;0;0;0;4065;0;0;1;0;0;0;2;4065;0;4087;2;1;
/org.eclipse.scripting/src/org/eclipse/scripting/internal/uirenderer/ScriptDefaultContributionNode.java;1;0;1;1;0;0;0;1;0;0;1;1424;0;0;1;0;0;1;1;1424;0;1424;1;1;
/org.eclipse.jdt.ui.tests.refactoring/resources/DeleteSourceReferenceEdit/A_test3_out.java;1;0;1;1;0;0;0;1;0;0;1;2857;0;0;1;0;0;1;1;2857;0;2857;1;1;
/org.eclipse.pde.ui/Eclipse PDE UI/org/eclipse/pde/internal/model/ExternalPluginModel.java;2;0;5;2;0;0;0;5;12;3;3;267;12;12;3;2;0;5;5;324;2;1434;3;2;
/org.eclipse.vcm.ui/src/org/eclipse/vcm/internal/ui/sync/SyncCompareInput.java;6;0;45;2;0;0;0;45;397;4;29;48;1374;1374;4;16;0;45;45;325;16;1794;29;6;
/org.eclipse.swt/Eclipse SWT Custom Widgets/common_j2se/org/eclipse/swt/custom/StyledTextContent.java;1;0;1;1;0;0;0;1;0;0;1;1378;0;0;1;0;0;1;1;1378;0;1378;1;1;
/org.eclipse.swt/Eclipse SWT/carbon/org/eclipse/swt/widgets/ColorDialog.java;3;1;4;1;4;4;4;0;6;0;0;4147;14;14;1;0;0;0;4;4147;0;4701;4;3;
/org.eclipse.jdt.ui/ui/org/eclipse/jdt/internal/ui/viewsupport/ProblemTreeViewer.java;5;3;19;1;8;6;8;11;83;1;11;1035;486;486;3;0;2;11;19;3985;2;4629;17;5;
/org.eclipse.jdt.ui/ui/org/eclipse/jdt/internal/ui/javaeditor/AddClassFileMarkerAction.java;2;0;4;1;0;0;0;4;21;1;4;15;34;34;1;0;0;4;4;15;0;1685;4;2;
/org.eclipse.update.ui/src/org/eclipse/update/internal/ui/manager/HistoryForm.java;1;0;2;1;0;0;0;2;0;1;2;1428;0;0;1;0;0;2;2;1428;0;1460;2;1;
/org.eclipse.help.ui/src/org/eclipse/help/internal/ui/NestedPrintAction.java;2;0;2;1;0;0;0;2;0;1;2;1420;0;0;1;0;0;2;2;1420;0;1675;2;2;
/org.eclipse.core.resources/src/org/eclipse/core/internal/watson/ElementTreeIterator.java;1;0;4;1;1;1;1;3;218;1;3;12;245;245;1;0;0;3;4;12;0;4214;4;1;
/org.eclipse.swt.examples.paint/org/eclipse/swt/examples/paint/TextTool.java;3;0;4;2;1;1;1;3;140;2;2;587;140;140;2;1;0;3;4;609;1;4024;3;3;
/org.eclipse.ui/Eclipse UI/org/eclipse/ui/part/MultiEditor.java;3;0;4;2;0;0;0;4;3;2;3;3128;5;5;2;1;0;4;4;3310;1;3448;3;3;
/org.eclipse.ui/Eclipse UI/org/eclipse/ui/internal/dialogs/ContainerCheckedTreeViewer.java;1;0;1;1;0;0;0;1;0;0;1;3740;0;0;1;0;0;1;1;3740;0;3740;1;1;
/org.eclipse.ui/Eclipse UI/org/eclipse/ui/internal/registry/PerspectiveRegistryReader.java;3;0;3;1;0;0;0;3;9;1;3;257;10;10;1;0;0;3;3;257;0;620;3;3;
/org.eclipse.swt/Eclipse SWT Custom Widgets/common/org/eclipse/swt/custom/ExtendedModifyEvent.java;2;0;3;1;1;1;1;2;7;1;2;106;13;13;1;0;0;2;3;106;0;4701;3;2;
/org.eclipse.jdt.ui.tests.refactoring/resources/MoveMembers/test7/out/B.java;1;0;1;1;0;0;0;1;0;0;1;2738;0;0;1;0;0;1;1;2738;0;2738;1;1;
/org.eclipse.ui.tests/Eclipse JFace Tests/org/eclipse/jface/tests/viewers/TreeViewerTest.java;1;0;1;1;0;0;0;1;0;0;1;1488;0;0;1;0;0;1;1;1488;0;1488;1;1;
/org.eclipse.jdt.ui.tests.refactoring/resources/RenameTemp/canRename/A_test26_in.java;1;0;2;1;0;0;0;2;2;1;2;1625;2;2;1;0;0;2;2;1625;0;1652;2;1;
/org.eclipse.swt.tests/JUnit Tests/org/eclipse/swt/tests/junit/Test_org_eclipse_swt_widgets_DirectoryDialog.java;2;0;2;1;1;1;1;1;6;0;1;1792;6;6;1;0;0;1;2;1792;0;4706;2;2;
/org.eclipse.pde.ui/src/org/eclipse/pde/internal/elements/ListContentProvider.java;2;0;2;1;0;0;0;2;0;1;2;1434;0;0;1;0;0;2;2;1434;0;3579;2;2;
/org.eclipse.jdt.junit/Eclipse JUnit/org/eclipse/jdt/junit/util/DialogCheck.java;2;0;2;1;0;0;0;2;0;1;2;1511;0;0;1;0;0;2;2;1511;0;1996;2;2;
/org.eclipse.ui/src-workbench/org/eclipse/ui/internal/SystemSummaryEditorInput.java;1;0;2;1;2;1;2;0;0;0;0;4386;0;0;2;0;1;0;2;4386;1;4386;1;1;
/org.eclipse.pde.ui/Eclipse PDE UI/org/eclipse/pde/internal/forms/SectionChangeManager.java;2;0;5;2;0;0;0;5;12;3;3;267;12;12;3;2;0;5;5;324;2;1434;3;2;
/org.eclipse.jdt.ui/ui/org/eclipse/jdt/internal/ui/search/ShowTypeHierarchyAction.java;1;0;2;1;0;0;0;2;0;1;2;355;0;0;1;0;0;2;2;355;0;421;2;1;
/org.eclipse.jdt.core/compiler/org/eclipse/jdt/internal/compiler/codegen/ResetSateForCodeGenerationVisitor.java;2;0;2;1;0;0;0;2;0;1;2;1314;0;0;1;0;0;2;2;1314;0;2419;2;2;
/org.eclipse.jdt.ui.tests.refactoring/resources/ExtractTemp/canExtract/A_test24_in.java;1;0;1;1;0;0;0;1;0;0;1;2637;0;0;1;0;0;1;1;2637;0;2637;1;1;
/org.eclipse.core.resources/src/org/eclipse/core/internal/localstore/RefreshLocalVisitor.java;3;0;12;1;1;1;1;11;506;1;11;12;654;654;1;0;0;11;12;12;0;4214;12;3;
/org.eclipse.pde.ui/src/org/eclipse/pde/internal/ui/editor/manifest/ManifestTemplatePage.java;1;0;1;1;0;0;0;1;0;0;1;3579;0;0;1;0;0;1;1;3579;0;3579;1;1;
/org.eclipse.pde.ui/Eclipse PDE UI/org/eclipse/pde/internal/editor/schema/SchemaSourcePage.java;2;0;5;2;0;0;0;5;12;3;3;267;12;12;3;2;0;5;5;324;2;1434;3;2;
/org.eclipse.jdt.ui/core extension/org/eclipse/jdt/internal/corext/template/java/CompilationUnitContext.java;1;0;2;1;1;1;1;1;8;0;1;2932;8;8;1;0;0;1;2;2932;0;4186;2;1;
/org.eclipse.team.cvs.core/src/org/eclipse/team/internal/ccvs/core/IUserInfo.java;2;0;3;1;0;0;0;3;66;1;3;1978;68;68;1;0;0;3;3;1978;0;3610;3;2;
/org.eclipse.pde.ui/src/org/eclipse/pde/internal/ui/wizards/templates/ControlStack.java;1;0;2;1;0;0;0;2;2;1;2;3579;2;2;1;0;0;2;2;3579;0;3819;2;1;
/org.eclipse.debug.ui/ui/org/eclipse/debug/internal/ui/StepReturnActionDelegate.java;3;0;7;1;0;0;0;7;50;1;7;187;78;78;1;0;0;7;7;187;0;2382;7;3;
/org.eclipse.jdt.ui.tests.refactoring/resources/RenameType/test52/in/A.java;1;0;1;1;0;0;0;1;0;0;1;1258;0;0;1;0;0;1;1;1258;0;1258;1;1;
/org.eclipse.update.core/src/org/eclipse/update/core/model/InstallHandlerEntryModel.java;2;0;3;1;0;0;0;3;104;1;3;2981;108;108;1;0;0;3;3;2981;0;3568;3;2;
/org.eclipse.jdt.core/search/org/eclipse/jdt/internal/core/index/impl/Util.java;3;0;6;1;1;1;1;5;238;1;5;455;394;394;1;0;0;5;6;455;0;4063;6;3;
/org.eclipse.swt.examples/org/eclipse/swt/examples/explorer/ComboView.java;1;0;1;1;0;0;0;1;0;0;1;547;0;0;1;0;0;1;1;547;0;547;1;1;
/org.eclipse.update.ui/src/org/eclipse/update/internal/ui/pages/CategoryPage.java;1;0;2;1;0;0;0;2;3;1;2;3537;3;3;1;0;0;2;2;3537;0;3662;2;1;
/org.eclipse.ui.tests/Eclipse UI Tests/org/eclipse/ui/tests/api/IPerspectiveDescriptorTest.java;3;0;6;1;0;0;0;6;29;1;6;881;40;40;1;0;0;6;6;881;0;2785;6;3;
/org.eclipse.team.cvs.ui/src/org/eclipse/team/internal/ccvs/ui/RemoteFileStorage.java;3;0;4;1;0;0;0;4;82;1;4;1978;122;122;1;0;0;4;4;1978;0;3791;4;3;
/org.eclipse.update.tests.core/src/org/eclipse/update/tests/core/boot/PlatformConfigurationTestCase.java;2;0;2;1;0;0;0;2;5;1;2;2082;5;5;1;0;0;2;2;2082;0;2119;2;2;
/org.eclipse.ui/Eclipse UI/org/eclipse/ui/part/ResourceTransfer.java;3;0;4;1;0;0;0;4;35;1;4;257;46;46;1;0;0;4;4;257;0;2830;4;3;
/org.eclipse.help/src/org/eclipse/help/internal/util/HelpException.java;2;0;2;1;0;0;0;2;2;1;2;1420;2;2;1;0;0;2;2;1420;0;3609;2;2;
/org.eclipse.jdt.debug.ui/ui/org/eclipse/jdt/internal/debug/ui/launcher/JDKLauncher.java;2;0;5;2;0;0;0;5;154;2;4;2388;155;155;2;1;0;5;5;3089;1;3122;4;2;
/org.eclipse.update.ui/src/org/eclipse/update/internal/ui/model/ModelObject.java;1;0;3;1;0;0;0;3;12;1;3;2797;12;12;1;0;0;3;3;2797;0;3740;3;1;
/org.eclipse.scripting/Eclipse Scripting/org/eclipse/scripting/ScriptAdapterWorkbenchResourceExportWizard.java;2;0;4;1;0;0;0;4;13;1;4;133;22;22;1;0;0;4;4;133;0;1424;4;2;
/org.eclipse.scripting/Eclipse Scripting/org/eclipse/scripting/internal/views/ScriptUIEditorIntegerTransfer.java;2;0;4;1;0;0;0;4;16;1;4;133;21;21;1;0;0;4;4;133;0;1424;4;2;
/org.eclipse.help/src/org/eclipse/help/internal/search/AnalyzerDescriptor.java;2;1;3;1;3;3;3;0;97;0;0;3938;108;108;1;0;0;0;3;3938;0;4169;3;2;
/org.eclipse.jdt.debug.ui/ui/org/eclipse/jdt/internal/debug/ui/JavaApplicationWizard.java;2;0;5;1;0;0;0;5;17;1;5;1915;32;32;1;0;0;5;5;1915;0;3634;5;2;
/org.eclipse.help.ui/src/org/eclipse/help/ui/internal/util/ErrorUtil.java;1;0;1;1;1;1;1;0;0;0;0;4439;0;0;1;0;0;0;1;4439;0;4439;1;1;
/org.eclipse.pde.ui/Eclipse PDE UI/org/eclipse/pde/internal/editor/manifest/UnknownElementPropertySource.java;2;0;6;2;0;0;0;6;12;3;4;267;14;14;3;2;0;6;6;324;2;1434;4;2;
/org.eclipse.team.cvs.core/src/org/eclipse/team/internal/ccvs/core/resources/EclipsePhantomSynchronizer.java;2;1;3;1;3;3;3;0;450;0;0;3978;452;452;1;0;0;0;3;3978;0;4040;3;2;
/org.eclipse.team.cvs.core/src/org/eclipse/team/internal/ccvs/core/resources/RemoteFile.java;3;1;55;2;3;3;3;52;703;3;44;1978;3101;3101;3;8;0;52;55;2032;8;4769;47;3;
/org.eclipse.jdt.ui/core refactoring/org/eclipse/jdt/internal/core/refactoring/breakers/ResourcesManagerImpl.java;1;0;2;1;0;0;0;2;0;1;2;1800;0;0;1;0;0;2;2;1800;0;1939;2;1;
/org.eclipse.pde.core/src/org/eclipse/pde/core/plugin/IFragment.java;1;0;4;1;2;1;2;2;74;1;2;3591;76;76;2;0;1;2;4;4751;1;4751;3;1;
/org.eclipse.swt/Eclipse SWT PI/gtk1x/org/eclipse/swt/internal/gtk/GtkItem.java;2;0;2;1;1;1;1;1;3;0;1;2107;3;3;1;0;0;1;2;2107;0;4701;2;2;
/org.eclipse.jdt.ui.tests.refactoring/resources/SelectionAnalyzerWorkSpace/SelectionAnalyzerTests/validSelection/A_test273.java;1;0;1;1;0;0;0;1;0;0;1;1368;0;0;1;0;0;1;1;1368;0;1368;1;1;
/org.eclipse.jdt.ui.tests.refactoring/resources/ExtractMethodWorkSpace/ExtractMethodTests/invalidSelection/A_test120.java;2;1;4;1;2;2;2;2;4;1;2;65;4;4;1;0;0;2;4;65;0;4419;4;2;
/org.eclipse.jdt.debug/jdi interfaces/com/sun/jdi/FloatValue.java;2;0;2;1;0;0;0;2;6;1;2;2704;6;6;1;0;0;2;2;2704;0;3033;2;2;
/org.eclipse.swt/Eclipse SWT/gtk1x/org/eclipse/swt/widgets/UtilFuncs.java;3;0;3;1;1;1;1;2;26;1;2;2107;32;32;1;0;0;2;3;2107;0;4701;3;3;
/org.eclipse.pde.core/src/org/eclipse/pde/internal/core/ischema/ISchemaObject.java;1;0;1;1;0;0;0;1;0;0;1;3591;0;0;1;0;0;1;1;3591;0;3591;1;1;
/org.eclipse.jdt.ui.tests.refactoring/resources/RenameType/test7/in/A.java;1;0;1;1;0;0;0;1;0;0;1;49;0;0;1;0;0;1;1;49;0;49;1;1;
/org.eclipse.jdt.debug/jdi interfaces/com/sun/jdi/DoubleValue.java;2;0;2;1;0;0;0;2;6;1;2;2704;6;6;1;0;0;2;2;2704;0;3033;2;2;
/org.eclipse.jdt.ui.tests.refactoring/resources/SelectionAnalyzerWorkSpace/SelectionAnalyzerTests/validSelection/A_test281.java;1;0;1;1;0;0;0;1;0;0;1;1368;0;0;1;0;0;1;1;1368;0;1368;1;1;
/org.eclipse.pde.ui/src/org/eclipse/pde/internal/base/schema/IMetaAttribute.java;2;0;2;1;0;0;0;2;0;1;2;1434;0;0;1;0;0;2;2;1434;0;3579;2;2;
/org.eclipse.jdt.ui.tests.refactoring/resources/SefWorkSpace/SefTests/object_in/TestFinalField.java;1;0;1;1;1;1;1;0;0;0;0;4403;0;0;1;0;0;0;1;4403;0;4403;1;1;
/org.eclipse.pde.ui/src/org/eclipse/pde/internal/ui/TargetPlatform.java;1;1;6;1;4;4;4;2;46;1;2;3579;112;112;1;0;0;2;6;3579;0;4555;6;1;
/org.eclipse.pde.ui/src/org/eclipse/pde/internal/ui/elements/TreeContentProvider.java;1;0;1;1;0;0;0;1;0;0;1;3579;0;0;1;0;0;1;1;3579;0;3579;1;1;
/org.eclipse.jdt.ui.tests.refactoring/resources/ExtractMethodWorkSpace/ExtractMethodTests/locals_in/A_test509.java;2;1;4;1;2;2;2;2;27;1;2;195;47;47;1;0;0;2;4;195;0;4419;4;2;
/org.eclipse.swt/Eclipse SWT PI/gtk1x/org/eclipse/swt/internal/gtk/GtkAllocation.java;2;0;2;1;1;1;1;1;3;0;1;2107;3;3;1;0;0;1;2;2107;0;4701;2;2;
/org.eclipse.jdt.ui/ui/org/eclipse/jdt/internal/ui/text/java/JavaCompletionProposal.java;6;2;23;2;3;2;3;20;96;2;19;25;504;504;2;1;1;20;23;2098;2;4429;21;6;
/org.eclipse.help/src/org/eclipse/help/internal/contributors1_0/ActionContributor.java;1;0;2;1;0;0;0;2;0;1;2;1675;0;0;1;0;0;2;2;1675;0;2217;2;1;
/org.eclipse.jdt.ui.tests.refactoring/resources/DeleteSourceReferenceEdit/A_test4_out.java;1;0;1;1;0;0;0;1;0;0;1;2857;0;0;1;0;0;1;1;2857;0;2857;1;1;
/org.eclipse.swt/Eclipse SWT OLE Win32/win32/org/eclipse/swt/internal/ole/win32/OLEINPLACEFRAMEINFO.java;2;0;3;1;0;0;0;3;5;1;3;106;5;5;1;0;0;3;3;106;0;2069;3;2;
/org.eclipse.jdt.ui/core refactoring/org/eclipse/jdt/internal/corext/refactoring/base/RefactoringStatusEntry.java;3;1;6;1;4;4;4;2;50;1;2;1939;80;80;1;0;0;2;6;1939;0;4427;6;3;
/org.eclipse.swt/Eclipse SWT/motif/org/eclipse/swt/widgets/ToolDrawable.java;5;1;6;1;2;2;2;4;7;1;4;106;22;22;1;0;0;4;6;106;0;4701;6;5;
/org.eclipse.jdt.ui.tests.refactoring/resources/RenameType/test32/out/A.java;1;0;2;1;0;0;0;2;0;1;2;49;0;0;1;0;0;2;2;49;0;522;2;1;
/org.eclipse.jdt.ui/nls/org/eclipse/jdt/internal/ui/nls/ExternalizeWizardPage2.java;1;0;4;1;0;0;0;4;40;2;3;1880;41;41;2;1;0;4;4;1880;1;1913;3;1;
/org.eclipse.jdt.debug/eval/org/eclipse/jdt/internal/debug/eval/ast/instructions/Pop.java;2;0;4;1;0;0;0;4;4;1;4;3421;8;8;1;0;0;4;4;3421;0;3677;4;2;
/org.eclipse.jdt.ui.tests.refactoring/resources/RenameTemp/canRename/A_test25_out.java;1;0;2;1;0;0;0;2;2;1;2;1625;2;2;1;0;0;2;2;1625;0;1652;2;1;
/org.eclipse.jdt.ui.tests/ui/com/ibm/jdt/ui/wizards/examples/CheckBoxExample.java;1;0;3;1;0;0;0;3;4;1;3;255;4;4;1;0;0;3;3;255;0;522;3;1;
/org.eclipse.jdt.ui.tests.refactoring/resources/RenameType/testFail27/in/A.java;1;0;1;1;0;0;0;1;0;0;1;49;0;0;1;0;0;1;1;49;0;49;1;1;
/org.eclipse.jdt.ui.tests.refactoring/resources/PullUp/test14/in/A.java;1;0;1;1;0;0;0;1;0;0;1;2406;0;0;1;0;0;1;1;2406;0;2406;1;1;
/org.eclipse.core.tests.resources/src/org/eclipse/core/tests/internal/indexing/AllTests.java;3;0;3;1;1;1;1;2;46;1;2;1794;56;56;1;0;0;2;3;1794;0;4516;3;3;
/org.eclipse.jdt.ui.tests.refactoring/resources/MoveCU/test2/out/p1/A.java;2;0;2;1;0;0;0;2;0;1;2;49;0;0;1;0;0;2;2;49;0;2769;2;2;
/org.eclipse.help/src/org/eclipse/help/internal/contributions1_0/InfoSet.java;1;0;2;1;0;0;0;2;0;1;2;1675;0;0;1;0;0;2;2;1675;0;2217;2;1;
/org.eclipse.jdt.ui/core refactoring/org/eclipse/jdt/internal/corext/refactoring/rename/TempDeclarationFinder.java;1;0;5;1;0;0;0;5;107;1;5;2015;164;164;1;0;0;5;5;2015;0;3357;5;1;
/org.eclipse.pde.ui/src/org/eclipse/pde/model/ModelChangedEvent.java;1;0;2;1;0;0;0;2;0;1;2;3039;0;0;1;0;0;2;2;3039;0;3579;2;1;
/org.eclipse.swt/Eclipse SWT/gtk1x/org/eclipse/swt/internal/Converter.java;3;1;3;1;2;2;2;1;15;0;1;2107;21;21;1;0;0;1;3;2107;0;4701;3;3;
/org.eclipse.ui/Eclipse UI/org/eclipse/ui/internal/registry/ActionDefinitionRegistryReader.java;3;0;5;1;0;0;0;5;18;1;5;3055;45;45;1;0;0;5;5;3055;0;3607;5;3;
/org.eclipse.jdt.ui.tests.refactoring/resources/ExtractMethodWorkSpace/ExtractMethodTests/branch_out/A_test752.java;1;1;4;1;2;2;2;2;34;1;2;1851;35;35;1;0;0;2;4;1851;0;4419;4;1;
/org.eclipse.core.boot/src/org/eclipse/core/internal/boot/update/VersionComparator.java;2;0;3;1;0;0;0;3;7;1;3;12;7;7;1;0;0;3;3;12;0;2726;3;2;
/org.eclipse.jdt.debug/eval/org/eclipse/jdt/internal/debug/eval/model/IThread.java;2;0;2;1;0;0;0;2;0;1;2;3555;0;0;1;0;0;2;2;3555;0;3645;2;2;
/org.eclipse.jdt.junit/src/org/eclipse/jdt/internal/junit/oldlauncher/JUnitLaunchWizard.java;2;0;2;1;0;0;0;2;0;1;2;3171;0;0;1;0;0;2;2;3171;0;3638;2;2;
/org.eclipse.core.tests.resources/src/org/eclipse/core/tests/resources/session/FindDeletedMembersTest.java;1;0;1;1;0;0;0;1;0;0;1;3682;0;0;1;0;0;1;1;3682;0;3682;1;1;
/org.eclipse.vcm.ui/src/org/eclipse/vcm/internal/ui/sync/Repository.java;5;0;19;2;0;0;0;19;151;4;15;48;387;387;4;4;0;19;19;295;4;1515;15;5;
/org.eclipse.ui/Eclipse UI/org/eclipse/ui/internal/PerspectivePresentation.java;7;1;21;2;5;5;5;16;825;2;15;257;1353;1353;2;1;0;16;21;2248;1;4448;20;7;
/org.eclipse.team.cvs.core/src/org/eclipse/team/internal/ccvs/core/resources/ManagedFolder.java;3;0;6;1;0;0;0;6;1208;2;5;1978;1386;1386;2;1;0;6;6;2063;1;2156;5;3;
/org.eclipse.debug.ui/ui/org/eclipse/debug/internal/ui/actions/RemoveAllBreakpointsAction.java;3;0;6;1;1;1;1;5;64;1;5;2382;81;81;1;0;0;5;6;2382;0;4409;6;3;
/org.eclipse.webdav/src/interface/org/eclipse/webdav/dom/Namespaces.java;2;0;4;1;1;1;1;3;96;1;3;12;123;123;1;0;0;3;4;12;0;4211;4;2;
/org.eclipse.pde.ui/src/org/eclipse/pde/internal/editor/IPDEEditorPage.java;2;0;5;1;0;0;0;5;2;1;5;1434;6;6;1;0;0;5;5;1434;0;3579;5;2;
/org.eclipse.jdt.debug.tests/tests/org/eclipse/jdt/debug/tests/core/ConditionalBreakpointsTests.java;2;1;3;1;3;3;3;0;16;0;0;4286;20;20;1;0;0;0;3;4286;0;4571;3;2;
/org.eclipse.jdt.ui.tests.refactoring/resources/RenameParameters/canRename/A_test22_in.java;1;0;1;1;0;0;0;1;0;0;1;233;0;0;1;0;0;1;1;233;0;233;1;1;
/org.eclipse.core.tests.runtime/src/org/eclipse/core/tests/plugintests/PluginTests.java;3;0;3;1;0;0;0;3;4280;1;3;1794;4290;4290;1;0;0;3;3;1794;0;3476;3;3;
/org.eclipse.jdt.ui.tests.refactoring/resources/DeleteSourceReference/test17/out/A.java;1;0;1;1;1;1;1;0;0;0;0;4141;0;0;1;0;0;0;1;4141;0;4141;1;1;
/org.eclipse.scripting/Eclipse Scripting/org/eclipse/scripting/internal/views/ScriptUIEditorPartitionScanner.java;1;0;3;1;0;0;0;3;7;1;3;133;7;7;1;0;0;3;3;133;0;1424;3;1;
/org.eclipse.update.core/src/org/eclipse/update/core/model/ArchiveReferenceModel.java;1;0;3;1;0;0;0;3;97;1;3;2414;160;160;1;0;0;3;3;2414;0;3512;3;1;
/org.eclipse.update/Eclipse Update/org/eclipse/update/internal/ui/UMWizardPageLaunchHistory.java;2;0;5;1;0;0;0;5;452;1;5;108;475;475;1;0;0;5;5;108;0;1424;5;2;
/org.eclipse.update.ui.forms/src/org/eclipse/update/ui/forms/OldForm.java;1;0;2;1;0;0;0;2;0;1;2;1542;0;0;1;0;0;2;2;1542;0;1599;2;1;
/org.eclipse.swt/Eclipse SWT PI/gtk1x/org/eclipse/swt/internal/gtk/GtkContainer.java;2;0;2;1;1;1;1;1;3;0;1;2107;3;3;1;0;0;1;2;2107;0;4701;2;2;
/org.eclipse.swt.examples.launcher/org/eclipse/swt/examples/launcher/ItemTreeNode.java;3;0;3;1;1;1;1;2;73;1;2;513;73;73;1;0;0;2;3;513;0;4024;3;3;
/org.eclipse.core.resources/src/org/eclipse/core/internal/watson/IElementInfoFlattener.java;1;0;4;1;1;1;1;3;64;1;3;12;91;91;1;0;0;3;4;12;0;4214;4;1;
/org.eclipse.core.boot/src/org/eclipse/core/internal/boot/update/UMRegistry.java;3;0;5;2;0;0;0;5;103;2;4;12;128;128;2;1;0;5;5;324;1;2726;4;3;
/org.eclipse.swt.examples/src/org/eclipse/swt/examples/controlexample/SliderTab.java;6;1;8;1;4;4;4;4;401;1;4;513;717;717;1;0;0;4;8;513;0;4705;8;6;
/org.eclipse.core.tests.resources/src/org/eclipse/core/tests/internal/indexing/StandAloneTestEnvironment.java;3;0;4;1;1;1;1;3;116;1;3;1794;136;136;1;0;0;3;4;1794;0;4516;4;3;
/org.eclipse.jdt.debug/jdi interfaces/com/sun/jdi/request/AccessWatchpointRequest.java;2;0;2;1;0;0;0;2;6;1;2;2704;6;6;1;0;0;2;2;2704;0;3040;2;2;
/org.eclipse.ui/Eclipse UI/org/eclipse/ui/part/MarkerTransfer.java;3;0;3;1;0;0;0;3;18;1;3;257;25;25;1;0;0;3;3;257;0;2932;3;3;
/org.eclipse.webdav/src/kernel/org/eclipse/webdav/internal/kernel/utils/MergedEnumeration.java;1;0;4;1;1;1;1;3;72;1;3;12;92;92;1;0;0;3;4;12;0;4211;4;1;
/org.eclipse.webdav/src/kernel/org/eclipse/webdav/internal/kernel/Condition.java;3;0;6;1;1;1;1;5;504;1;5;12;960;960;1;0;0;5;6;12;0;4211;6;3;
/org.eclipse.pde.ui/src/org/eclipse/pde/internal/ui/editor/feature/FeatureEditor.java;1;1;9;1;5;5;5;4;80;2;3;3579;182;182;2;1;0;4;9;3579;1;4545;8;1;
/org.eclipse.scripting/Eclipse Scripting/org/eclipse/scripting/internal/uirenderer/XGRElementUISwtComboBox.java;2;0;6;1;0;0;0;6;49;1;6;133;76;76;1;0;0;6;6;133;0;1424;6;2;
/org.eclipse.jdt.junit/Eclipse JUnit/org/eclipse/jdt/junit/internal/BaseLauncherUtil.java;2;0;2;1;0;0;0;2;0;1;2;1531;0;0;1;0;0;2;2;1531;0;2007;2;2;
/org.eclipse.jdt.ui.tests.refactoring/resources/MoveMembers/test21/out/B.java;1;0;1;1;0;0;0;1;0;0;1;2738;0;0;1;0;0;1;1;2738;0;2738;1;1;
/org.eclipse.jdt.ui.tests/refactoring/org/eclipse/jdt/refactoring/tests/ReorderParametersTests.java;2;0;5;1;0;0;0;5;13;1;5;729;23;23;1;0;0;5;5;729;0;1342;5;2;
/org.eclipse.ui.examples.readmetool/Eclipse UI Examples Readme Tool/org/eclipse/ui/examples/readmetool/ReadmePlugin.java;2;0;2;1;0;0;0;2;2;1;2;932;2;2;1;0;0;2;2;932;0;945;2;2;
/org.eclipse.ui.tests/Eclipse UI Tests/org/eclipse/ui/tests/internal/ExtendedSourceViewer.java;1;0;1;1;0;0;0;1;0;0;1;2236;0;0;1;0;0;1;1;2236;0;2236;1;1;
/org.eclipse.jdt.ui.tests.refactoring/resources/StructureSelectionAction/A_test16.java;1;0;1;1;0;0;0;1;0;0;1;2139;0;0;1;0;0;1;1;2139;0;2139;1;1;
/org.eclipse.team.cvs.core/src/org/eclipse/team/internal/ccvs/core/syncinfo/FolderSyncInfo.java;3;0;9;2;1;1;1;8;18;2;7;2690;46;46;2;1;0;8;9;3811;1;4023;8;3;
/org.eclipse.jdt.ui.tests.refactoring/resources/RenameType/test32/in/A.java;1;0;1;1;0;0;0;1;0;0;1;49;0;0;1;0;0;1;1;49;0;49;1;1;
/org.eclipse.ui.tests/UI Test Utils/org/eclipse/ui/tests/util/CallHistory.java;1;0;1;1;0;0;0;1;0;0;1;2785;0;0;1;0;0;1;1;2785;0;2785;1;1;
/org.eclipse.compare/compare/org/eclipse/compare/internal/OverlayPreferenceStore.java;1;0;2;1;0;0;0;2;2;1;2;2974;2;2;1;0;0;2;2;2974;0;3053;2;1;
/org.eclipse.swt/Eclipse SWT/emulated/treetable/org/eclipse/swt/widgets/TreeItem.java;5;2;10;1;4;3;4;6;126;1;6;1028;341;341;2;0;1;6;10;4557;1;4701;9;5;
/org.eclipse.help/Eclipse Help/org/eclipse/help/internal/contributors/xml/HelpContributionManagerProxy.java;2;0;2;1;0;0;0;2;0;1;2;135;0;0;1;0;0;2;2;135;0;176;2;2;
/org.eclipse.swt.tests/JUnit Tests/org/eclipse/swt/tests/junit/Test_org_eclipse_swt_SWTException.java;2;0;2;1;1;1;1;1;6;0;1;1792;6;6;1;0;0;1;2;1792;0;4706;2;2;
/org.eclipse.jdt.ui.tests.refactoring/resources/ExtractMethodWorkSpace/ExtractMethodTests/error_in/A_test800.java;1;1;4;1;2;2;2;2;2;1;2;3150;2;2;1;0;0;2;4;3150;0;4419;4;1;
/org.eclipse.jdt.ui/ui refactoring/org/eclipse/jdt/internal/ui/refactoring/actions/RefactoringActionDelegate.java;2;0;9;1;0;0;0;9;38;1;9;1359;88;88;1;0;0;9;9;1359;0;3792;9;2;
/org.eclipse.jdt.ui/ui refactoring/org/eclipse/jdt/internal/ui/refactoring/IPreviewWizardPage.java;1;0;4;1;0;0;0;4;2;1;4;1800;6;6;1;0;0;4;4;1800;0;2874;4;1;
/org.eclipse.ui.tests/Eclipse UI Tests/org/eclipse/ui/tests/dialogs/NavigatorTestStub.java;1;0;1;1;0;0;0;1;0;0;1;1274;0;0;1;0;0;1;1;1274;0;1274;1;1;
/org.eclipse.swt/Eclipse SWT PI/win32/org/eclipse/swt/internal/ole/win32/VARDESC2.java;2;0;2;1;1;1;1;1;6;0;1;2069;6;6;1;0;0;1;2;2069;0;4701;2;2;
/org.eclipse.pde.ui/src/org/eclipse/pde/internal/ui/editor/feature/AdvancedForm.java;1;0;1;1;1;1;1;0;0;0;0;3982;0;0;1;0;0;0;1;3982;0;3982;1;1;
/org.eclipse.jdt.core/dom/org/eclipse/jdt/core/dom/ReturnStatement.java;2;1;6;1;2;2;2;4;9;1;4;2669;33;33;1;0;0;4;6;2669;0;4453;6;2;
/org.eclipse.jdt.ui/ui/org/eclipse/jdt/internal/ui/text/java/JavaParameterListValidator.java;1;0;3;1;0;0;0;3;189;1;3;1137;191;191;1;0;0;3;3;1137;0;1497;3;1;
/org.eclipse.pde.ui/src/org/eclipse/pde/internal/wizards/extension/NewExtensionRegistryReader.java;2;0;4;1;0;0;0;4;4;2;3;1434;4;4;2;1;0;4;4;3035;1;3579;3;2;
/org.eclipse.jdt.debug/eval/org/eclipse/jdt/internal/debug/eval/ast/instructions/PushArrayLength.java;1;0;1;1;0;0;0;1;0;0;1;3811;0;0;1;0;0;1;1;3811;0;3811;1;1;
/org.eclipse.jdt.ui.tests.refactoring/resources/SefWorkSpace/SefTests/object_out/TestSetterAsReceiver.java;1;0;1;1;0;0;0;1;0;0;1;2876;0;0;1;0;0;1;1;2876;0;2876;1;1;
/org.eclipse.team.core/src/org/eclipse/team/internal/core/streams/PollingOutputStream.java;1;0;1;1;1;1;1;0;0;0;0;4169;0;0;1;0;0;0;1;4169;0;4169;1;1;
/org.eclipse.jdt.ui.tests.refactoring/resources/RenameType/testFail83/in/A.java;1;0;1;1;0;0;0;1;0;0;1;49;0;0;1;0;0;1;1;49;0;49;1;1;
/org.eclipse.swt/Eclipse SWT/win32/org/eclipse/swt/internal/win32/FILETIME.java;2;0;3;1;0;0;0;3;12;1;3;1507;12;12;1;0;0;3;3;1507;0;2069;3;2;
/org.eclipse.vcm.core.cvs/src/org/eclipse/vcm/internal/core/ccvs/requests/StatusMessageHandler.java;3;0;3;1;0;0;0;3;6;1;3;0;12;12;1;0;0;3;3;0;0;298;3;3;
/org.eclipse.scripting/src/org/eclipse/scripting/internal/uirenderer/XGRElementUISwtRadioButton.java;1;0;1;1;0;0;0;1;0;0;1;1424;0;0;1;0;0;1;1;1424;0;1424;1;1;
/org.eclipse.pde.core/src/org/eclipse/pde/internal/core/IPluginModelListener.java;1;0;1;1;0;0;0;1;0;0;1;3591;0;0;1;0;0;1;1;3591;0;3591;1;1;
/org.eclipse.jdt.ui.tests.refactoring/resources/ExtractMethodWorkSpace/ExtractMethodTests/invalidSelection/A_test109.java;2;1;3;1;2;2;2;1;0;0;1;49;0;0;1;0;0;1;3;49;0;4419;3;2;
/org.eclipse.help/Eclipse Help/org/eclipse/help/internal/server/HelpContentManager.java;3;0;4;1;0;0;0;4;7;1;4;135;9;9;1;0;0;4;4;135;0;1420;4;3;
/org.eclipse.jdt.ui.tests.refactoring/resources/RenameVirtualMethodInClass/testAnon0/out/A.java;1;0;1;1;0;0;0;1;0;0;1;49;0;0;1;0;0;1;1;49;0;49;1;1;
/org.eclipse.pde.ui/src/org/eclipse/pde/internal/wizards/templates/HelloWorldTemplate.java;1;0;6;1;0;0;0;6;65;1;6;3240;135;135;1;0;0;6;6;3240;0;3579;6;1;
/org.eclipse.team.tests.cvs.core/src/org/eclipse/team/tests/ccvs/core/CommandLineCVSClient.java;2;1;6;1;2;2;2;4;106;2;3;3086;197;197;2;1;0;4;6;3086;1;4545;5;2;
/org.eclipse.jdt.ui.tests.refactoring/resources/ExtractMethodWorkSpace/ExtractMethodTests/locals_out/A_test528.java;1;0;1;1;1;1;1;0;0;0;0;4424;0;0;1;0;0;0;1;4424;0;4424;1;1;
/org.eclipse.jdt.ui.tests.refactoring/resources/RenameType/test23/out/B.java;1;0;1;1;0;0;0;1;0;0;1;522;0;0;1;0;0;1;1;522;0;522;1;1;
/org.eclipse.ui/Eclipse UI Standard Components/org/eclipse/ui/views/internal/navigator/WorkbenchStateActionContributionFactory.java;1;0;2;1;0;0;0;2;0;1;2;1757;0;0;1;0;0;2;2;1757;0;1830;2;1;
/org.eclipse.jdt.ui/ui refactoring/org/eclipse/jdt/internal/ui/refactoring/nls/search/Properties.java;1;0;1;1;0;0;0;1;0;0;1;1922;0;0;1;0;0;1;1;1922;0;1922;1;1;
/org.eclipse.ui/Eclipse UI Standard Components/org/eclipse/ui/views/navigator/SortViewAction.java;5;0;7;1;1;1;1;6;13;1;6;257;28;28;1;0;0;6;7;257;0;4067;7;5;
/org.eclipse.jdt.debug.ui/ui/org/eclipse/jdt/internal/debug/ui/Filter.java;1;0;1;1;0;0;0;1;0;0;1;3030;0;0;1;0;0;1;1;3030;0;3030;1;1;
/org.eclipse.jdt.ui.tests.refactoring/resources/RenameParameters/cannotRename/A_testFail8.java;1;0;1;1;0;0;0;1;0;0;1;233;0;0;1;0;0;1;1;233;0;233;1;1;
/org.eclipse.update.ui.forms/src/org/eclipse/update/ui/forms/internal/TableData.java;1;0;1;1;0;0;0;1;0;0;1;2470;0;0;1;0;0;1;1;2470;0;2470;1;1;
/org.eclipse.pde.ui/src/org/eclipse/pde/internal/ui/feature/PluginListPage.java;1;0;2;1;0;0;0;2;20;1;2;3579;20;20;1;0;0;2;2;3579;0;3607;2;1;
/org.eclipse.jdt.ui/ui refactoring/org/eclipse/jdt/internal/ui/refactoring/IErrorContextViewer.java;1;0;2;1;0;0;0;2;2;1;2;1927;2;2;1;0;0;2;2;1927;0;2512;2;1;
/org.eclipse.jdt.ui/ui refactoring/org/eclipse/jdt/internal/ui/refactoring/ExtractInterfaceWizardPage.java;1;0;2;1;0;0;0;2;0;1;2;15;0;0;1;0;0;2;2;15;0;47;2;1;
/org.eclipse.pde.ui/Eclipse PDE UI/org/eclipse/pde/internal/base/IExtensionWizard.java;2;0;5;2;0;0;0;5;12;3;3;267;12;12;3;2;0;5;5;324;2;1434;3;2;
/org.eclipse.jdt.debug/model/org/eclipse/jdt/internal/debug/core/model/JDIArrayEntryVariable.java;2;0;3;2;0;0;0;3;5;0;1;2517;5;5;3;2;0;3;3;2517;2;2517;1;2;
/org.eclipse.jdt.ui.tests.refactoring/resources/RenameVariables/canRename/A_test26_in.java;1;0;2;1;0;0;0;2;0;1;2;724;0;0;1;0;0;2;2;724;0;1665;2;1;
/org.eclipse.core.resources/src/org/eclipse/core/internal/utils/ArrayEnumeration.java;1;0;4;1;1;1;1;3;98;1;3;12;119;119;1;0;0;3;4;12;0;4214;4;1;
/org.eclipse.pde.ui/src/org/eclipse/pde/internal/ui/editor/manifest/FragmentManifestEditor.java;1;0;2;1;0;0;0;2;2;0;1;3579;2;2;2;1;0;2;2;3579;1;3579;1;1;
/org.eclipse.vcm.core/src/org/eclipse/vcm/internal/core/ProjectDescriptionWriter.java;2;0;3;1;0;0;0;3;26;1;3;0;31;31;1;0;0;3;3;0;0;1504;3;2;
/org.eclipse.vcm.core/src/org/eclipse/vcm/internal/core/base/ServerEvent.java;1;0;1;1;0;0;0;1;0;0;1;951;0;0;1;0;0;1;1;951;0;951;1;1;
/org.eclipse.jdt.ui/core refactoring/org/eclipse/jdt/internal/corext/refactoring/reorg/CreateCopyOfCompilationUnitChange.java;2;1;2;1;2;2;2;0;4;0;0;4212;4;4;1;0;0;0;2;4212;0;4427;2;2;
/org.eclipse.swt/Eclipse SWT/common/org/eclipse/swt/events/ControlAdapter.java;2;0;3;1;1;1;1;2;6;1;2;106;10;10;1;0;0;2;3;106;0;4701;3;2;
/org.eclipse.core.resources/src_ant/org/eclipse/core/resources/ant/EclipseFileUtils.java;2;1;4;1;2;2;2;2;15;1;2;3509;17;17;1;0;0;2;4;3509;0;4646;4;2;
/org.eclipse.team.cvs.ui/src/org/eclipse/team/internal/ccvs/ui/merge/BranchesElement.java;2;0;2;1;0;0;0;2;0;1;2;2763;0;0;1;0;0;2;2;2763;0;3577;2;2;
/org.eclipse.jdt.ui.tests.refactoring/resources/SelectionAnalyzerWorkSpace/SelectionAnalyzerTests/validSelection/A_test147_.java;1;0;1;1;0;0;0;1;0;0;1;2139;0;0;1;0;0;1;1;2139;0;2139;1;1;
/org.eclipse.jdt.junit/Eclipse JUnit/org/eclipse/jdt/internal/junit/ui/EnableStackFilterAction.java;2;0;2;1;0;0;0;2;0;1;2;2399;0;0;1;0;0;2;2;2399;0;3313;2;2;
/org.eclipse.pde.ui/src/org/eclipse/pde/internal/ui/editor/StorageDocumentProvider.java;1;1;2;1;2;2;2;0;1;0;0;4067;1;1;1;0;0;0;2;4067;0;4568;2;1;
/org.eclipse.update.ui/src/org/eclipse/update/internal/ui/model/CategorizedFeature.java;1;0;2;1;0;0;0;2;0;1;2;2797;0;0;1;0;0;2;2;2797;0;2834;2;1;
/org.eclipse.jdt.debug/model/org/eclipse/jdt/internal/debug/core/hcr/Differencer.java;2;0;2;1;0;0;0;2;18;1;2;2585;18;18;1;0;0;2;2;2585;0;2683;2;2;
/org.eclipse.jdt.core/model/org/eclipse/jdt/internal/core/JavaElementDeltaBuilder.java;3;1;12;1;2;2;2;10;750;4;7;455;835;835;4;3;0;10;12;1039;3;4322;9;3;
/org.eclipse.ui/Eclipse UI/org/eclipse/ui/internal/ResetPerspectiveAction.java;5;0;5;1;0;0;0;5;14;1;5;257;26;26;1;0;0;5;5;257;0;3122;5;5;
/org.eclipse.jdt.debug/eval/org/eclipse/jdt/internal/debug/eval/ast/engine/PlusAssignmentOperator.java;1;0;2;1;0;0;0;2;0;1;2;3329;0;0;1;0;0;2;2;3329;0;3421;2;1;
/org.eclipse.team.cvs.ui/src/org/eclipse/team/internal/ccvs/ui/actions/SyncAction.java;2;1;18;1;4;4;4;14;79;2;13;2054;203;203;2;1;0;14;18;2231;1;4143;17;2;
/org.eclipse.jdt.core/dom/org/eclipse/jdt/core/dom/TypeBinding.java;3;0;7;1;0;0;0;7;16;1;7;2669;33;33;1;0;0;7;7;2669;0;3747;7;3;
/org.eclipse.help/src/org/eclipse/help/internal/topics/TopicsFileParser.java;2;0;3;1;0;0;0;3;7;1;3;1675;7;7;1;0;0;3;3;1675;0;1857;3;2;
/org.eclipse.jdt.ui.tests.refactoring/resources/ExtractMethodWorkSpace/ExtractMethodTests/try_in/A_test453.java;2;1;3;1;2;2;2;1;22;0;1;65;22;22;1;0;0;1;3;65;0;4419;3;2;
/org.eclipse.jdt.ui.tests.refactoring/resources/ExtractTemp/canExtract/A_test1_in.java;1;0;1;1;0;0;0;1;0;0;1;2481;0;0;1;0;0;1;1;2481;0;2481;1;1;
/org.eclipse.pde.ui/src/org/eclipse/pde/internal/ui/editor/schema/GrammarSection.java;1;0;4;1;1;1;1;3;19;2;2;3579;28;28;2;1;0;3;4;3579;1;4695;3;1;
/org.eclipse.pde.ui/Eclipse PDE UI/org/eclipse/pde/internal/editor/manifest/ExtensionElementPropertySource.java;2;0;7;2;0;0;0;7;12;3;5;267;20;20;3;2;0;7;7;324;2;1434;5;2;
/org.eclipse.jdt.ui/core refactoring/org/eclipse/jdt/internal/core/refactoring/changes/ResourceReorgChange.java;2;0;4;1;0;0;0;4;66;1;4;1108;72;72;1;0;0;4;4;1108;0;1939;4;2;
/org.eclipse.swt.tests/JUnit Tests/org/eclipse/swt/tests/junit/Test_org_eclipse_swt_events_MouseAdapter.java;2;0;2;1;1;1;1;1;6;0;1;1792;6;6;1;0;0;1;2;1792;0;4706;2;2;
/org.eclipse.swt/Eclipse SWT/common_j2se/org/eclipse/swt/internal/SWTEventListener.java;2;0;2;1;1;1;1;1;6;0;1;1561;6;6;1;0;0;1;2;1561;0;4701;2;2;
/org.eclipse.jdt.ui.tests.refactoring/resources/RenameType/testFail23/in/A.java;1;0;1;1;0;0;0;1;0;0;1;49;0;0;1;0;0;1;1;49;0;49;1;1;
/org.eclipse.pde.runtime/Eclipse PDE Runtime/org/eclipse/pde/internal/runtime/registry/ConfigurationElementAdapter.java;2;0;3;1;0;0;0;3;4;1;3;267;4;4;1;0;0;3;3;267;0;1434;3;2;
/org.eclipse.ant.ui/src/org/eclipse/ant/internal/ui/TargetsListLabelProvider.java;5;0;8;1;0;0;0;8;42;2;7;300;52;52;2;1;0;8;8;326;1;3606;7;5;
/org.eclipse.jdt.junit/Eclipse JUnit/org/eclipse/jdt/internal/junit/ui/JUnitPreferencePage.java;2;0;3;1;0;0;0;3;26;1;3;2007;26;26;1;0;0;3;3;2007;0;3313;3;2;
/org.eclipse.swt/Eclipse SWT/motif/org/eclipse/swt/widgets/CoolBar.java;7;0;15;2;0;0;0;15;406;2;14;106;900;900;2;1;0;15;15;1761;1;1989;14;7;
/org.eclipse.jdt.ui.tests.refactoring/resources/RenameNonPrivateField/test14/in/A.java;1;0;1;1;0;0;0;1;0;0;1;1274;0;0;1;0;0;1;1;1274;0;1274;1;1;
/org.eclipse.pde.ui/src/org/eclipse/pde/internal/ui/editor/schema/ElementPropertySource.java;1;0;2;1;0;0;0;2;2;1;2;3579;2;2;1;0;0;2;2;3579;0;3591;2;1;
/org.eclipse.pde.ui/src/org/eclipse/pde/model/IModelUndoManager.java;1;0;2;1;0;0;0;2;0;1;2;3039;0;0;1;0;0;2;2;3039;0;3140;2;1;
/org.eclipse.jdt.ui.tests.refactoring/resources/ExtractTemp/cannotExtract/A_testFail21.java;1;0;1;1;1;1;1;0;0;0;0;4620;0;0;1;0;0;0;1;4620;0;4620;1;1;
/org.eclipse.jdt.debug.tests/test programs/StaticVariablesTests.java;1;0;2;1;0;0;0;2;0;1;2;3701;0;0;1;0;0;2;2;3701;0;3719;2;1;
/org.eclipse.jdt.core/compiler/org/eclipse/jdt/internal/compiler/parser/SourceMethodDeclaration.java;2;0;3;1;1;1;1;2;18;1;2;455;24;24;1;0;0;2;3;455;0;4062;3;2;
/org.eclipse.pde.ui/src/org/eclipse/pde/internal/schema/SchemaComplexType.java;2;0;4;1;0;0;0;4;3;1;4;1434;4;4;1;0;0;4;4;1434;0;3579;4;2;
/org.eclipse.help/src/org/eclipse/help/internal/search/PrebuiltIndex.java;3;0;7;1;1;1;1;6;7;1;6;2318;15;15;1;0;0;6;7;2318;0;4000;7;3;
/org.eclipse.webdav/src/kernel/org/eclipse/webdav/internal/kernel/WebDAVException.java;2;0;5;1;1;1;1;4;126;1;4;12;243;243;1;0;0;4;5;12;0;4211;5;2;
/org.eclipse.jdt.ui.tests.refactoring/resources/RenameTemp/cannotRename/A_testFail2.java;1;0;2;1;0;0;0;2;2;1;2;1625;2;2;1;0;0;2;2;1625;0;1652;2;1;
/org.eclipse.scripting/src/org/eclipse/scripting/internal/views/ScriptUIEditorAction.java;1;0;1;1;0;0;0;1;0;0;1;1424;0;0;1;0;0;1;1;1424;0;1424;1;1;
/org.eclipse.ui.examples.multipageeditor/Eclipse UI Examples MultiPageEditor/org/eclipse/ui/examples/multipageeditor/MultiPageContributor.java;1;0;1;1;0;0;0;1;0;0;1;928;0;0;1;0;0;1;1;928;0;928;1;1;
/org.eclipse.pde.ui/src/org/eclipse/pde/internal/ui/preferences/ExternalPluginsEditor.java;1;0;2;1;0;0;0;2;0;1;2;3579;0;0;1;0;0;2;2;3579;0;3618;2;1;
/org.eclipse.debug.ui/ui/org/eclipse/debug/internal/ui/actions/RemoveTerminatedAction.java;2;0;8;1;0;0;0;8;175;1;8;2382;207;207;1;0;0;8;8;2382;0;2919;8;2;
/org.eclipse.jdt.ui.tests.refactoring/resources/MoveMembers/test4/in/B.java;1;0;1;1;0;0;0;1;0;0;1;2738;0;0;1;0;0;1;1;2738;0;2738;1;1;
/org.eclipse.team.ui/src/org/eclipse/team/ui/TeamUIPlugin.java;2;1;8;1;3;3;3;5;365;1;5;1978;427;427;1;0;0;5;8;1978;0;4123;8;2;
/org.eclipse.jdt.core/model/org/eclipse/jdt/internal/core/ModelUpdater.java;2;1;4;1;2;2;2;2;16;1;2;3790;26;26;1;0;0;2;4;3790;0;4421;4;2;
/org.eclipse.core.tests.runtime/src/org/eclipse/core/tests/internal/plugins/PluginVersionTest_2.java;4;0;4;1;0;0;0;4;204;1;4;1794;219;219;1;0;0;4;4;1794;0;3476;4;4;
/org.eclipse.vcm.core.cvs/src/org/eclipse/vcm/internal/core/ccvs/utils/NullProgressMonitor.java;3;0;3;1;0;0;0;3;6;1;3;0;6;6;1;0;0;3;3;0;0;413;3;3;
/org.eclipse.help/Eclipse Help/org/eclipse/help/internal/navigation/InfosetsMap.java;4;0;11;1;0;0;0;11;120;2;10;176;182;182;2;1;0;11;11;992;1;1420;10;4;
/org.eclipse.jdt.ui/core refactoring/org/eclipse/jdt/internal/core/nls/changes/Messages.java;1;0;2;1;0;0;0;2;0;1;2;1913;0;0;1;0;0;2;2;1913;0;1922;2;1;
/org.eclipse.scripting/Eclipse Scripting/org/eclipse/scripting/internal/views/ScriptUIEditorModelException.java;2;0;4;1;0;0;0;4;9;1;4;133;16;16;1;0;0;4;4;133;0;1424;4;2;
/org.eclipse.swt/Eclipse SWT/motif/org/eclipse/swt/internal/motif/XAnyEvent.java;2;0;3;1;0;0;0;3;4;1;3;106;4;4;1;0;0;3;3;106;0;2069;3;2;
/org.eclipse.core.resources/src/org/eclipse/core/internal/indexing/IndexedStoreObjectPolicy.java;2;0;3;1;1;1;1;2;76;1;2;448;91;91;1;0;0;2;3;448;0;4214;3;2;
/org.eclipse.core.runtime/src/org/eclipse/core/internal/runtime/Policy.java;3;0;7;1;1;1;1;6;218;1;6;12;312;312;1;0;0;6;7;12;0;4213;7;3;
/org.eclipse.swt.tests/JUnit Tests/org/eclipse/swt/tests/junit/Test_org_eclipse_swt_graphics_Rectangle.java;2;1;3;1;2;2;2;1;6;0;1;1792;8;8;1;0;0;1;3;1792;0;4706;3;2;
/org.eclipse.help/src/org/eclipse/help/internal/protocols/SearchResults.java;1;0;2;1;2;1;2;0;0;0;0;4000;0;0;2;0;1;0;2;4000;1;4000;1;1;
/org.eclipse.jdt.core/model/org/eclipse/jdt/internal/core/builder/IDevelopmentContext.java;1;0;3;1;0;0;0;3;27;1;3;455;27;27;1;0;0;3;3;455;0;2808;3;1;
/org.eclipse.jdt.debug.tests/testprograms/org/eclipse/debug/tests/targets/Looper.java;2;0;2;1;1;1;1;1;11;0;1;3719;11;11;1;0;0;1;2;3719;0;4571;2;2;
/org.eclipse.jdt.ui.tests.refactoring/resources/MoveMembers/test6/in/B.java;1;0;1;1;0;0;0;1;0;0;1;2738;0;0;1;0;0;1;1;2738;0;2738;1;1;
/org.eclipse.ui/Eclipse JFace Text/org/eclipse/jface/text/Region.java;3;0;3;1;0;0;0;3;28;1;3;257;33;33;1;0;0;3;3;257;0;1066;3;3;
/org.eclipse.team.cvs.core/src/org/eclipse/team/internal/ccvs/core/CVSLocalSyncElement.java;1;0;4;1;0;0;0;4;21;3;2;2053;21;21;3;2;0;4;4;2053;2;2156;2;1;
/org.eclipse.core.resources/src/org/eclipse/core/internal/localstore/FileManager.java;1;0;1;1;0;0;0;1;0;0;1;653;0;0;1;0;0;1;1;653;0;653;1;1;
/org.eclipse.debug.ui/ui/org/eclipse/debug/internal/ui/actions/ControlAction.java;1;0;2;1;0;0;0;2;0;1;2;2382;0;0;1;0;0;2;2;2382;0;2850;2;1;
/org.eclipse.core.resources/src/org/eclipse/core/internal/properties/ResourceName.java;2;0;4;1;1;1;1;3;86;1;3;12;109;109;1;0;0;3;4;12;0;4214;4;2;
/org.eclipse.jdt.ui.tests.refactoring/resources/RenameType/test24/out/B.java;1;0;1;1;0;0;0;1;0;0;1;522;0;0;1;0;0;1;1;522;0;522;1;1;
/org.eclipse.jdt.ui/ui/org/eclipse/jdt/internal/ui/javadocexport/CreateJavadocActionDelegate.java;3;0;4;1;1;1;1;3;5;1;3;3070;9;9;1;0;0;3;4;3070;0;4404;4;3;
/org.eclipse.team.cvs.core/src/org/eclipse/team/internal/ccvs/core/response/custom/UpdateMessageHandler.java;3;0;5;1;0;0;0;5;106;2;4;1978;127;127;2;1;0;5;5;2271;1;2607;4;3;
/org.eclipse.pde.ui/src/org/eclipse/pde/internal/ui/model/ifeature/IFeatureModel.java;1;0;3;1;0;0;0;3;3;2;2;3579;3;3;2;1;0;3;3;3579;1;3591;2;1;
/org.eclipse.debug.core/core/org/eclipse/debug/core/IExpressionManager.java;2;0;5;1;1;1;1;4;10;2;3;2345;25;25;2;1;0;4;5;2345;1;4649;4;2;
/org.eclipse.pde.ui/Eclipse PDE UI/org/eclipse/pde/internal/editor/manifest/ManifestEditor.java;2;0;8;2;0;0;0;8;19;3;6;267;35;35;3;2;0;8;8;324;2;1434;6;2;
/org.eclipse.jdt.ui.tests.refactoring/resources/RenamePackage/test2/in/p/A.java;2;0;2;1;0;0;0;2;0;1;2;49;0;0;1;0;0;2;2;49;0;1258;2;2;
/org.eclipse.swt.tests/JUnit Tests/org/eclipse/swt/tests/junit/Test_org_eclipse_swt_dnd_TextTransfer.java;2;0;2;1;1;1;1;1;6;0;1;1792;6;6;1;0;0;1;2;1792;0;4706;2;2;
/org.eclipse.jdt.ui/ui/org/eclipse/jdt/internal/ui/reorg/SourceReferenceSourceRangeComputer.java;2;0;4;1;0;0;0;4;26;1;4;2003;30;30;1;0;0;4;4;2003;0;2212;4;2;
/org.eclipse.jdt.debug/jdi/org/eclipse/jdi/internal/LocationImpl.java;3;0;7;1;0;0;0;7;29;1;7;187;75;75;1;0;0;7;7;187;0;3678;7;3;
/org.eclipse.update.tests.core/src/org/eclipse/update/tests/api/TestSiteManagerAPI.java;2;1;23;1;3;3;3;20;25;2;19;1623;134;134;2;1;0;20;23;2008;1;4329;22;2;
/org.eclipse.jdt.core/compiler/org/eclipse/jdt/internal/compiler/ast/QualifiedTypeReference.java;2;1;11;1;2;2;2;9;91;4;6;455;126;126;4;3;0;9;11;1039;3;4421;8;2;
/org.eclipse.ui/Eclipse JFace/org/eclipse/jface/preference/ColorFieldEditor.java;3;0;3;1;0;0;0;3;5;1;3;257;8;8;1;0;0;3;3;257;0;620;3;3;
/org.eclipse.update/src/org/eclipse/update/internal/ui/UMWizardProductComponentURLInstall.java;1;0;1;1;0;0;0;1;0;0;1;1424;0;0;1;0;0;1;1;1424;0;1424;1;1;
/org.eclipse.jdt.ui.tests.refactoring/resources/RenameParameters/canRename/A_test9_out.java;1;0;1;1;0;0;0;1;0;0;1;233;0;0;1;0;0;1;1;233;0;233;1;1;
/org.eclipse.jdt.debug/model/org/eclipse/jdt/internal/debug/core/model/Timer.java;2;0;2;1;0;0;0;2;4;1;2;3557;4;4;1;0;0;2;2;3557;0;3667;2;2;
/org.eclipse.swt/Eclipse SWT/win32/org/eclipse/swt/widgets/TableColumn.java;8;2;11;1;4;3;4;7;63;1;7;106;163;163;2;0;1;7;11;4557;1;4701;10;8;
/org.eclipse.jdt.ui.tests.refactoring/resources/ExtractMethodWorkSpace/ExtractMethodTests/wiki_in/A_test2002.java;1;1;3;1;2;2;2;1;24;0;1;1236;24;24;1;0;0;1;3;1236;0;4419;3;1;
/org.eclipse.pde.ui/Eclipse PDE UI/org/eclipse/pde/internal/editor/manifest/DetailExtensionSection.java;2;0;8;2;0;0;0;8;28;3;6;267;42;42;3;2;0;8;8;324;2;1434;6;2;
/org.eclipse.swt/Eclipse SWT/gtk/org/eclipse/swt/widgets/Shell.java;6;4;52;3;21;16;21;31;319;4;22;2107;1643;1643;4;9;5;31;52;2359;14;4701;38;6;
/org.eclipse.pde.ui/src/org/eclipse/pde/internal/model/PluginParent.java;2;0;5;1;0;0;0;5;16;2;4;1434;22;22;2;1;0;5;5;3134;1;3134;4;2;
/org.eclipse.ui.examples.readmetool/Eclipse UI Examples Readme Tool/org/eclipse/ui/examples/readmetool/MarkElementProperties.java;2;0;2;1;0;0;0;2;12;1;2;932;12;12;1;0;0;2;2;932;0;945;2;2;
/org.eclipse.jdt.core/model/org/eclipse/jdt/internal/core/builder/impl/JavaBuilder.java;1;0;13;1;0;0;0;13;327;4;9;455;587;587;4;4;0;13;13;1039;4;2808;9;1;
/org.eclipse.pde.build/src_ant/org/eclipse/pde/internal/build/tasks/BuildScriptGeneratorTask.java;1;0;4;1;0;0;0;4;4;2;3;3509;6;6;2;1;0;4;4;3571;1;3672;3;1;
/org.eclipse.jdt.ui.tests.refactoring/resources/InlineTemp/canInline/A_test7_in.java;1;0;1;1;0;0;0;1;0;0;1;2051;0;0;1;0;0;1;1;2051;0;2051;1;1;
/org.eclipse.jdt.ui/ui/org/eclipse/jdt/internal/ui/search/JavaElementSearchAction.java;1;1;2;1;2;2;2;0;0;0;0;4123;0;0;1;0;0;0;2;4123;0;4140;2;1;
/org.eclipse.swt/Eclipse SWT/gtk1x/org/eclipse/swt/widgets/TabItem.java;2;0;2;1;1;1;1;1;6;0;1;2107;6;6;1;0;0;1;2;2107;0;4701;2;2;
/org.eclipse.jdt.ui/ui/org/eclipse/jdt/internal/ui/text/correction/CompletionRequestorAdapter.java;1;0;2;1;0;0;0;2;0;1;2;3306;0;0;1;0;0;2;2;3306;0;3435;2;1;
/org.eclipse.pde.ui/src/org/eclipse/pde/internal/schema/ExtensionPointSchemaDescriptor.java;2;0;2;1;0;0;0;2;0;1;2;1434;0;0;1;0;0;2;2;1434;0;2696;2;2;
/org.eclipse.jdt.core/model/org/eclipse/jdt/internal/core/CreateCompilationUnitOperation.java;3;2;15;1;4;3;4;11;119;4;8;455;328;328;4;3;1;11;15;1039;4;4424;11;3;
/org.eclipse.jdt.ui.tests.refactoring/resources/ExtractMethodWorkSpace/ExtractMethodTests/expression_in/A_test603.java;2;1;3;1;2;2;2;1;14;0;1;239;14;14;1;0;0;1;3;239;0;4419;3;2;
/org.eclipse.swt/Eclipse SWT PI/win32/org/eclipse/swt/internal/win32/DIBSECTION.java;2;0;2;1;1;1;1;1;6;0;1;2069;6;6;1;0;0;1;2;2069;0;4701;2;2;
/org.eclipse.jdt.ui.tests.refactoring/resources/SefWorkSpace/SefTests/object_in/TestCompoundWrite2.java;1;0;1;1;0;0;0;1;0;0;1;2876;0;0;1;0;0;1;1;2876;0;2876;1;1;
/org.eclipse.pde.ui/src/org/eclipse/pde/internal/ui/ischema/IDocumentSection.java;1;0;2;1;0;0;0;2;0;1;2;3579;0;0;1;0;0;2;2;3579;0;3591;2;1;
/org.eclipse.jdt.debug/eval/org/eclipse/jdt/internal/debug/eval/ast/instructions/PushClassLiteralValue.java;3;0;6;1;0;0;0;6;4;1;6;3421;13;13;1;0;0;6;6;3421;0;3677;6;3;
/org.eclipse.jdt.ui.tests.refactoring/resources/RenameTemp/cannotRename/A_testFail17.java;1;0;2;1;0;0;0;2;2;1;2;1625;2;2;1;0;0;2;2;1625;0;1652;2;1;
/org.eclipse.ant.ui/src/org/eclipse/ant/ui/internal/toolscripts/GlobalToolScriptWizard.java;1;0;2;1;0;0;0;2;0;1;2;2919;0;0;1;0;0;2;2;2919;0;2933;2;1;
/org.eclipse.jdt.core/model/org/eclipse/jdt/core/IJavaModelStatus.java;2;1;4;1;2;2;2;2;82;1;2;455;118;118;1;0;0;2;4;455;0;4061;4;2;
/org.eclipse.pde.ui/src/org/eclipse/pde/internal/model/plugin/AbstractPluginModelBase.java;1;0;6;1;0;0;0;6;234;1;6;3136;239;239;1;0;0;6;6;3136;0;3579;6;1;
/org.eclipse.jdt.ui.tests.refactoring/resources/ExtractTemp/canExtract/A_test23_in.java;1;0;1;1;0;0;0;1;0;0;1;2498;0;0;1;0;0;1;1;2498;0;2498;1;1;
/org.eclipse.ui/Eclipse UI Standard Components/org/eclipse/ui/views/navigator/DecoratorActionFactory.java;1;0;3;1;0;0;0;3;43;2;2;2007;43;43;2;1;0;3;3;2007;1;2029;2;1;
/org.eclipse.jdt.core/model/org/eclipse/jdt/internal/core/newbuilder/BatchImageBuilder.java;2;0;15;1;0;0;0;15;40;2;14;1764;110;110;2;1;0;15;15;2975;1;2975;14;2;
/org.eclipse.core.tests.resources/src/org/eclipse/core/tests/resources/usecase/IFileTest.java;3;0;4;1;0;0;0;4;436;1;4;1794;447;447;1;0;0;4;4;1794;0;3475;4;3;
/org.eclipse.pde.core/src/org/eclipse/pde/internal/core/schema/SchemaAttribute.java;1;0;2;1;0;0;0;2;5;1;2;3591;5;5;1;0;0;2;2;3591;0;3607;2;1;
/org.eclipse.jdt.debug/eval/org/eclipse/jdt/internal/debug/eval/model/EvaluationPrimitiveValue.java;2;0;3;1;0;0;0;3;1;1;3;3421;1;1;1;0;0;3;3;3421;0;3645;3;2;
/org.eclipse.swt.tests/JUnit Tests/org/eclipse/swt/tests/junit/Test_org_eclipse_swt_layout_FillLayout.java;2;0;2;1;1;1;1;1;6;0;1;1792;6;6;1;0;0;1;2;1792;0;4706;2;2;
/org.eclipse.pde.core/src/org/eclipse/pde/core/build/IBuildModel.java;1;0;3;1;2;1;2;1;32;0;1;3591;32;32;2;0;1;1;3;4751;1;4751;2;1;
/org.eclipse.jdt.debug/eval/org/eclipse/jdt/internal/debug/eval/ast/engine/EvaluationSourceGenerator.java;3;1;17;1;4;4;4;13;125;2;11;3421;317;317;2;2;0;13;17;3739;2;4423;15;3;
/org.eclipse.ui/Eclipse JFace Text/org/eclipse/jface/text/source/AnnotationColumn.java;1;1;3;1;3;3;3;0;338;0;0;4038;361;361;1;0;0;0;3;4038;0;4838;3;1;
/org.eclipse.webdav/src/client/org/eclipse/webdav/internal/authentication/Base64Encoder.java;3;0;5;1;1;1;1;4;146;1;4;12;273;273;1;0;0;4;5;12;0;4211;5;3;
/org.eclipse.jdt.ui.tests.refactoring/resources/ExtractTemp/cannotExtract/A_testFail9.java;1;0;1;1;0;0;0;1;0;0;1;2873;0;0;1;0;0;1;1;2873;0;2873;1;1;
/org.eclipse.swt/Eclipse SWT PI/motif/org/eclipse/swt/internal/motif/XRectangle.java;2;0;2;1;1;1;1;1;6;0;1;2069;6;6;1;0;0;1;2;2069;0;4701;2;2;
/org.eclipse.jdt.core/eval/org/eclipse/jdt/internal/eval/CodeSnippetEvaluator.java;2;2;10;1;3;2;3;7;328;2;6;455;375;375;2;1;1;7;10;3084;2;4062;8;2;
/org.eclipse.jdt.core/model/org/eclipse/jdt/internal/core/util/AnonymousFileSource.java;3;2;12;2;3;2;3;9;223;4;6;455;391;391;4;3;1;9;12;1039;4;4418;8;3;
/org.eclipse.jdt.core/compiler/org/eclipse/jdt/internal/compiler/Compiler.java;2;1;31;2;5;5;5;26;5004;4;21;455;8601;8601;4;5;0;26;31;1039;5;4165;26;2;
/org.eclipse.jdt.ui.tests.refactoring/resources/SelectionAnalyzerWorkSpace/SelectionAnalyzerTests/invalidSelection/A_test130.java;2;0;2;1;0;0;0;2;0;1;2;1368;0;0;1;0;0;2;2;1368;0;2139;2;2;
/org.eclipse.swt/Eclipse SWT Accessibility/common/org/eclipse/swt/accessibility/AccessibleListener.java;2;0;6;1;1;1;1;5;74;2;4;2781;164;164;2;1;0;5;6;3007;1;4701;5;2;
/org.eclipse.jdt.ui.tests.refactoring/resources/SurroundWithWorkSpace/SurroundWithTests/D.java;1;1;2;1;2;2;2;0;2;0;0;4000;2;2;1;0;0;0;2;4000;0;4014;2;1;
/org.eclipse.core.runtime/src/org/eclipse/core/internal/plugins/DefaultPlugin.java;3;0;4;1;1;1;1;3;38;1;3;12;60;60;1;0;0;3;4;12;0;4213;4;3;
/org.eclipse.jdt.ui/ui/org/eclipse/jdt/internal/ui/launcher/J9VMType.java;1;0;5;1;0;0;0;5;16;2;4;218;22;22;2;1;0;5;5;218;1;323;4;1;
/org.eclipse.ui.tests/Eclipse UI Tests/RunSessionTest1.java;1;0;2;1;0;0;0;2;0;1;2;1041;0;0;1;0;0;2;2;1041;0;1066;2;1;
/org.eclipse.jdt.ui.tests.refactoring/resources/InlineTemp/canInline/A_test1_in.java;1;0;1;1;0;0;0;1;0;0;1;2015;0;0;1;0;0;1;1;2015;0;2015;1;1;
/org.eclipse.jdt.ui.tests.refactoring/resources/SafeDeleteType/testFail6/in/A.java;1;0;1;1;0;0;0;1;0;0;1;49;0;0;1;0;0;1;1;49;0;49;1;1;
/org.eclipse.jdt.ui.tests.refactoring/resources/SelectionAnalyzerWorkSpace/SelectionAnalyzerTests/invalidSelection/A_test092.java;2;0;2;1;0;0;0;2;0;1;2;1368;0;0;1;0;0;2;2;1368;0;2139;2;2;
/org.eclipse.debug.ui/ui/org/eclipse/debug/internal/ui/actions/RemoveAllTerminatedAction.java;1;0;6;1;0;0;0;6;15;1;6;2919;35;35;1;0;0;6;6;2919;0;3747;6;1;
/org.eclipse.jdt.ui/core refactoring/org/eclipse/jdt/internal/core/refactoring/code/flow/IfFlowInfo.java;1;0;2;1;0;0;0;2;0;1;2;1236;0;0;1;0;0;2;2;1236;0;1939;2;1;
/org.eclipse.scripting/src/org/eclipse/scripting/ScriptAdapterWorkbenchNewWizard.java;1;0;1;1;0;0;0;1;0;0;1;1424;0;0;1;0;0;1;1;1424;0;1424;1;1;
/org.eclipse.jdt.debug.tests/test plugin/org/eclipse/jdt/debug/testplugin/DebugEventWaiter.java;2;0;2;1;1;1;1;1;11;0;1;3701;11;11;1;0;0;1;2;3701;0;4328;2;2;
/org.eclipse.vcm.core.cvs/src/org/eclipse/vcm/internal/core/ccvs/IStaticListener.java;1;0;1;1;0;0;0;1;0;0;1;1372;0;0;1;0;0;1;1;1372;0;1372;1;1;
/org.eclipse.pde.ui/Eclipse PDE UI/org/eclipse/pde/internal/ExternalModelManager.java;2;0;5;2;0;0;0;5;25;2;4;267;27;27;2;1;0;5;5;324;1;1434;4;2;
/org.eclipse.swt/Eclipse SWT/motif/java/util/EventListener.java;1;0;1;1;0;0;0;1;0;0;1;1378;0;0;1;0;0;1;1;1378;0;1378;1;1;
/org.eclipse.tomcat/src/org/eclipse/jdt/core/jasper/JdtJasperCompiler.java;2;0;2;1;0;0;0;2;0;1;2;2409;0;0;1;0;0;2;2;2409;0;2460;2;2;
/org.eclipse.core.runtime/src/org/eclipse/core/runtime/IExtension.java;3;0;4;1;1;1;1;3;154;1;3;12;175;175;1;0;0;3;4;12;0;4214;4;3;
/org.eclipse.jdt.debug/eval/org/eclipse/jdt/internal/debug/eval/EvaluationResult.java;3;0;5;1;0;0;0;5;71;1;5;1675;94;94;1;0;0;5;5;1675;0;3492;5;3;
/org.eclipse.jdt.ui/ui/org/eclipse/jdt/internal/ui/dialogs/TwoArrayQuickSorter.java;2;0;5;1;1;1;1;4;38;1;4;1238;65;65;1;0;0;4;5;1238;0;4018;5;2;
/org.eclipse.jdt.ui.tests.refactoring/resources/SelectionAnalyzerWorkSpace/SelectionAnalyzerTests/selection/A_test3.java;1;0;1;1;0;0;0;1;0;0;1;1368;0;0;1;0;0;1;1;1368;0;1368;1;1;
/org.eclipse.jdt.debug/eval/org/eclipse/jdt/internal/debug/eval/ast/engine/EngineEvaluationMessages.java;2;0;3;1;0;0;0;3;11;2;2;3676;11;11;2;1;0;3;3;3676;1;3764;2;2;
/org.eclipse.jdt.debug/jdi interfaces/com/sun/jdi/event/EventIterator.java;2;0;2;1;0;0;0;2;8;1;2;2704;8;8;1;0;0;2;2;2704;0;3040;2;2;
/org.eclipse.jdt.core/compiler/org/eclipse/jdt/internal/compiler/ast/CastExpression.java;2;1;14;1;2;2;2;12;443;4;9;455;920;920;4;3;0;12;14;1039;3;4421;11;2;
/org.eclipse.jdt.debug.ui/ui/org/eclipse/jdt/internal/debug/ui/JavaBreakpointPropertySource.java;2;0;4;1;0;0;0;4;20;1;4;1915;24;24;1;0;0;4;4;1915;0;2794;4;2;
/org.eclipse.team.cvs.core/src/org/eclipse/team/internal/ccvs/core/resources/CVSFolder.java;3;0;4;1;0;0;0;4;956;1;4;1978;996;996;1;0;0;4;4;1978;0;2156;4;3;
/org.eclipse.jdt.debug.tests/test plugin/org/eclipse/jdt/debug/testplugin/EmptyClasspathProvider.java;2;1;2;1;2;2;2;0;14;0;0;4127;14;14;1;0;0;0;2;4127;0;4328;2;2;
/org.eclipse.jdt.ui.tests.refactoring/resources/MoveMembers/testFail11/in/A.java;1;0;1;1;0;0;0;1;0;0;1;2738;0;0;1;0;0;1;1;2738;0;2738;1;1;
/org.eclipse.jdt.ui.tests/test plugin/org/eclipse/jdt/testplugin/ui/TestPluginUILauncher.java;2;0;3;1;0;0;0;3;4;1;3;49;4;4;1;0;0;3;3;49;0;1186;3;2;
/org.eclipse.ui.tests/Eclipse UI Tests/org/eclipse/ui/tests/api/EmptyEditorInput.java;2;0;2;1;0;0;0;2;0;1;2;983;0;0;1;0;0;2;2;983;0;1073;2;2;
/org.eclipse.jdt.ui.tests/JUnit/junit/swingui/TestTreeFrame.java;2;0;2;1;0;0;0;2;0;1;2;49;0;0;1;0;0;2;2;49;0;1186;2;2;
/org.eclipse.core.tests.resources/src/org/eclipse/core/tests/resources/usecase/ConcurrentOperation.java;3;0;3;1;0;0;0;3;294;1;3;1794;304;304;1;0;0;3;3;1794;0;3475;3;3;
/org.eclipse.swt.examples.paint/org/eclipse/swt/examples/paint/SolidRoundedRectangleFigure.java;3;0;4;2;1;1;1;3;55;2;2;586;55;55;2;1;0;3;4;609;1;4024;3;3;
/org.eclipse.help/src/org/eclipse/help/internal/protocols/LiveHelpURL.java;2;0;4;1;1;1;1;3;6;1;3;2694;12;12;1;0;0;3;4;2694;0;3928;4;2;
/org.eclipse.update.ui/src/org/eclipse/update/ui/internal/model/UpdateSearchSite.java;1;0;2;1;0;0;0;2;0;1;2;1942;0;0;1;0;0;2;2;1942;0;2797;2;1;
/org.eclipse.team.ui/src/org/eclipse/team/internal/ui/sync/ToolTipMessageDialog.java;1;0;2;1;0;0;0;2;0;1;2;2054;0;0;1;0;0;2;2;2054;0;2231;2;1;
/org.eclipse.jdt.debug/jdi/org/eclipse/jdi/internal/event/VMDeathEventImpl.java;2;0;4;1;0;0;0;4;16;1;4;187;30;30;1;0;0;4;4;187;0;3670;4;2;
/org.eclipse.team.cvs.core/src/org/eclipse/team/internal/ccvs/core/response/custom/CVSTag.java;3;0;3;1;0;0;0;3;91;1;3;1978;91;91;1;0;0;3;3;1978;0;2156;3;3;
/org.eclipse.jdt.ui/ui/org/eclipse/jdt/internal/ui/text/java/JavaCodeScanner.java;4;1;15;1;2;2;2;13;119;1;13;15;366;366;1;0;0;13;15;15;0;4137;15;4;
/org.eclipse.compare/compare/org/eclipse/compare/internal/CompareWithEditionAction.java;2;0;4;1;0;0;0;4;75;1;4;176;89;89;1;0;0;4;4;176;0;918;4;2;
/org.eclipse.update.ui.forms/src/org/eclipse/update/ui/forms/ScrollableForm.java;1;0;2;1;0;0;0;2;0;1;2;1423;0;0;1;0;0;2;2;1423;0;1542;2;1;
/org.eclipse.update.core/src/org/eclipse/update/core/model/SiteMapModel.java;2;0;5;1;0;0;0;5;211;1;5;2409;219;219;1;0;0;5;5;2409;0;3027;5;2;
/org.eclipse.jdt.debug/eval/org/eclipse/jdt/internal/debug/eval/ast/engine/UnaryOperator.java;1;0;2;1;0;0;0;2;0;1;2;3329;0;0;1;0;0;2;2;3329;0;3421;2;1;
/org.eclipse.jdt.core/model/org/eclipse/jdt/internal/core/builder/BuildNotifier.java;3;0;9;2;2;1;2;7;36;2;6;2979;66;66;2;1;1;7;9;3084;2;4063;7;3;
/org.eclipse.pde.ui/src/org/eclipse/pde/core/plugin/IPluginParent.java;1;0;2;1;0;0;0;2;0;1;2;3579;0;0;1;0;0;2;2;3579;0;3607;2;1;
/org.eclipse.jdt.debug.ui/ui/org/eclipse/jdt/internal/debug/ui/ITimeoutListener.java;1;0;2;1;0;0;0;2;0;1;2;1915;0;0;1;0;0;2;2;1915;0;3557;2;1;
/org.eclipse.swt/Eclipse SWT OLE Win32/win32/org/eclipse/swt/internal/ole/win32/IProvideClassInfo2.java;2;0;3;1;0;0;0;3;5;1;3;106;5;5;1;0;0;3;3;106;0;2069;3;2;
/org.eclipse.core.tests.runtime/src/org/eclipse/core/tests/internal/plugins/SoftPrereqTest_11.java;3;0;3;1;0;0;0;3;110;1;3;1794;120;120;1;0;0;3;3;1794;0;3476;3;3;
/org.eclipse.jdt.ui/core refactoring/org/eclipse/jdt/internal/corext/refactoring/text/ITextRegion.java;1;0;2;1;0;0;0;2;0;1;2;1939;0;0;1;0;0;2;2;1939;0;2216;2;1;
/org.eclipse.pde.ui/src/org/eclipse/pde/internal/NoPDENatureDialog.java;1;0;2;1;0;0;0;2;0;1;2;2750;0;0;1;0;0;2;2;2750;0;3579;2;1;
/org.eclipse.jdt.core/search/org/eclipse/jdt/internal/core/search/IndexSearchAdapter.java;2;0;4;1;1;1;1;3;150;1;3;455;170;170;1;0;0;3;4;455;0;4063;4;2;
/org.eclipse.jdt.ui.tests.refactoring/resources/RenameMethodInInterface/test7/out/A.java;1;0;1;1;0;0;0;1;0;0;1;49;0;0;1;0;0;1;1;49;0;49;1;1;
/org.eclipse.swt/Eclipse SWT/carbon/org/eclipse/swt/widgets/Widget.java;4;2;6;1;6;5;6;0;146;0;0;4147;230;230;2;0;1;0;6;4605;1;4701;5;4;
/org.eclipse.jdt.ui.tests.refactoring/resources/ExtractMethodWorkSpace/ExtractMethodTests/locals_in/A_test542.java;1;1;3;1;2;2;2;1;2;0;1;922;2;2;1;0;0;1;3;922;0;4419;3;1;
/org.eclipse.pde.ui/src/org/eclipse/pde/internal/ui/wizards/project/ProjectStructurePage.java;1;0;5;1;1;1;1;4;6;2;3;3579;14;14;2;1;0;4;5;3631;1;4316;4;1;
/org.eclipse.ui/Eclipse UI Standard Components/org/eclipse/ui/views/navigator/OpenActionFactory.java;5;0;9;2;1;1;1;8;26;2;6;1830;68;68;2;2;0;8;9;1830;2;4067;7;5;
/org.eclipse.debug.ui/ui/org/eclipse/debug/internal/ui/views/launch/LaunchViewEventHandler.java;4;1;8;1;8;8;8;0;1014;0;0;3975;1081;1081;1;0;0;0;8;3975;0;4625;8;4;
/org.eclipse.jdt.ui.tests.refactoring/resources/RenameType/test46/out/A.java;1;0;2;1;0;0;0;2;0;1;2;49;0;0;1;0;0;2;2;49;0;522;2;1;
/org.eclipse.core.tests.runtime/src/org/eclipse/core/tests/internal/plugins/PluginResolveTest_9.java;3;0;3;1;0;0;0;3;144;1;3;1794;154;154;1;0;0;3;3;1794;0;3476;3;3;
/org.eclipse.help/src/org/eclipse/help/internal/protocols/SearchURLConnection.java;2;0;2;1;0;0;0;2;2;1;2;2694;2;2;1;0;0;2;2;2694;0;3609;2;2;
/org.eclipse.compare/compare/org/eclipse/compare/structuremergeviewer/DocumentRangeNode.java;2;0;7;1;0;0;0;7;22;1;7;14;62;62;1;0;0;7;7;14;0;3170;7;2;
/org.eclipse.team.tests.cvs.core/src/org/eclipse/team/tests/ccvs/core/cvsresources/EclipseFolderTest.java;1;0;2;1;0;0;0;2;6;1;2;3323;6;6;1;0;0;2;2;3323;0;3610;2;1;
/org.eclipse.vcm.ui/src/org/eclipse/vcm/internal/ui/actions/AddVersionToStreamAction.java;4;0;5;2;0;0;0;5;11;2;4;1;13;13;2;1;0;5;5;297;1;1240;4;4;
/org.eclipse.jdt.ui.tests.refactoring/resources/SelectionAnalyzerWorkSpace/SelectionAnalyzerTests/invalidSelection/A_test012.java;1;0;1;1;0;0;0;1;0;0;1;1368;0;0;1;0;0;1;1;1368;0;1368;1;1;
/org.eclipse.scripting/src/org/eclipse/scripting/internal/views/ScriptDevelopmentPreferencePageWorkbenchAction.java;1;0;1;1;0;0;0;1;0;0;1;1424;0;0;1;0;0;1;1;1424;0;1424;1;1;
/org.eclipse.pde.ui/src/org/eclipse/pde/internal/core/build/BuildObject.java;1;0;3;1;0;0;0;3;10;2;2;3579;10;10;2;1;0;3;3;3579;1;3607;2;1;
/org.eclipse.core.resources/src/org/eclipse/core/internal/resources/SaveContext.java;2;0;4;1;1;1;1;3;230;1;3;12;251;251;1;0;0;3;4;12;0;4213;4;2;
/org.eclipse.jdt.ui.tests.refactoring/resources/RenameVirtualMethodInClass/testFail30/in/A.java;1;0;1;1;0;0;0;1;0;0;1;49;0;0;1;0;0;1;1;49;0;49;1;1;
/org.eclipse.help.ui/src/org/eclipse/help/internal/ui/IHelpUIConstants.java;2;1;8;1;2;2;2;6;42;1;6;1420;59;59;1;0;0;6;8;1420;0;4439;8;2;
/org.eclipse.pde.ui/src/org/eclipse/pde/internal/core/builders/ISchemaTransformer.java;1;0;2;1;0;0;0;2;0;1;2;3579;0;0;1;0;0;2;2;3579;0;3607;2;1;
/org.eclipse.jdt.debug.ui/ui/org/eclipse/jdt/internal/debug/ui/launcher/StandardVMType.java;2;0;5;1;0;0;0;5;2;1;5;1915;6;6;1;0;0;5;5;1915;0;3122;5;2;
/org.eclipse.ui/Eclipse UI Standard Components/org/eclipse/ui/views/bookmarkexplorer/RemoveBookmarkAction.java;4;0;4;1;0;0;0;4;11;1;4;257;15;15;1;0;0;4;4;257;0;3029;4;4;
/org.eclipse.core.tests.runtime/src/org/eclipse/core/tests/internal/plugins/SoftPrereqTest_3.java;3;0;3;1;0;0;0;3;174;1;3;1794;184;184;1;0;0;3;3;1794;0;3476;3;3;
/org.eclipse.pde/src/org/eclipse/pde/internal/builders/ISchemaTransformer.java;1;0;1;1;0;0;0;1;0;0;1;3631;0;0;1;0;0;1;1;3631;0;3631;1;1;
/org.eclipse.pde.ui/src/org/eclipse/pde/model/plugin/IPluginReference.java;1;0;2;1;0;0;0;2;0;1;2;3039;0;0;1;0;0;2;2;3039;0;3579;2;1;
/org.eclipse.jdt.ui.tests.refactoring/resources/RenamePackage/test1/in/r/A.java;1;0;1;1;0;0;0;1;0;0;1;1258;0;0;1;0;0;1;1;1258;0;1258;1;1;
/org.eclipse.swt/Eclipse SWT Program/photon/org/eclipse/swt/program/ProgramSupport.java;1;0;2;1;0;0;0;2;0;1;2;106;0;0;1;0;0;2;2;106;0;612;2;1;
/org.eclipse.jdt.ui.tests.refactoring/resources/PullUpMethods/test2/out/A.java;1;0;3;1;0;0;0;3;4;1;3;2156;4;4;1;0;0;3;3;2156;0;2406;3;1;
/org.eclipse.ant.ui/src_ant/org/eclipse/ant/internal/ui/ant/UIBuildLogger.java;1;0;3;1;0;0;0;3;172;2;2;3489;190;190;2;1;0;3;3;3489;1;3606;2;1;
/org.eclipse.jdt.ui.tests.refactoring/resources/RenameType/test25/in/A.java;1;0;1;1;0;0;0;1;0;0;1;49;0;0;1;0;0;1;1;49;0;49;1;1;
/org.eclipse.jdt.ui.tests.refactoring/resources/ExtractMethodWorkSpace/ExtractMethodTests/Wcf.java;1;1;3;1;2;2;2;1;26;0;1;2915;26;26;1;0;0;1;3;2915;0;4419;3;1;
/org.eclipse.pde.core/src/org/eclipse/pde/internal/core/feature/ExternalFeatureModel.java;1;0;1;1;1;1;1;0;0;0;0;4067;0;0;1;0;0;0;1;4067;0;4067;1;1;
/org.eclipse.compare/compare/org/eclipse/compare/CompareViewerSwitchingPane.java;2;1;11;1;3;3;3;8;100;1;8;1802;246;246;1;0;0;8;11;1802;0;4820;11;2;
/org.eclipse.jdt.ui/ui/org/eclipse/jdt/internal/ui/search/JavaSearchOperation.java;2;0;14;1;1;1;1;13;49;2;12;15;152;152;2;1;0;13;14;871;1;4137;13;2;
/org.eclipse.core.resources/src/org/eclipse/core/internal/resources/SyncInfoSnapReader_1.java;1;0;4;1;0;0;0;4;6;1;4;158;11;11;1;0;0;4;4;158;0;299;4;1;
/org.eclipse.jdt.ui/ui/org/eclipse/jdt/internal/ui/reorg/DestinationRenderer.java;3;0;4;1;0;0;0;4;5;1;4;15;7;7;1;0;0;4;4;15;0;1258;4;3;
/org.eclipse.scripting/Eclipse Scripting/org/eclipse/scripting/internal/uirenderer/XGRXmlParserException.java;2;0;4;1;0;0;0;4;10;1;4;133;17;17;1;0;0;4;4;133;0;1424;4;2;
/org.eclipse.pde.ui/Eclipse PDE UI/org/eclipse/pde/internal/editor/manifest/PluginAdapterFactory.java;2;0;5;2;0;0;0;5;12;3;3;267;12;12;3;2;0;5;5;324;2;1434;3;2;
/org.eclipse.jdt.ui.tests.refactoring/resources/RenameParameters/canRename/A_test15_in.java;1;0;1;1;0;0;0;1;0;0;1;233;0;0;1;0;0;1;1;233;0;233;1;1;
/org.eclipse.jdt.debug.ui/ui/org/eclipse/jdt/internal/debug/ui/launcher/MainMethodFinder.java;2;0;6;1;0;0;0;6;5;1;6;1915;14;14;1;0;0;6;6;1915;0;3738;6;2;
/org.eclipse.pde.ui/src/org/eclipse/pde/internal/ui/editor/feature/FeatureFormPage.java;1;0;1;1;0;0;0;1;0;0;1;3579;0;0;1;0;0;1;1;3579;0;3579;1;1;
/org.eclipse.jdt.core/model/org/eclipse/jdt/internal/core/INameLookup.java;1;0;3;1;0;0;0;3;214;1;3;455;214;214;1;0;0;3;3;455;0;1467;3;1;
/org.eclipse.core.tests.runtime/src/org/eclipse/core/tests/internal/plugins/PluginResolveTest_26.java;3;0;3;1;0;0;0;3;110;1;3;1794;120;120;1;0;0;3;3;1794;0;3476;3;3;
/org.eclipse.ui/Eclipse JFace Text/org/eclipse/jface/text/IMarkRegionTarget.java;1;1;2;1;2;2;2;0;10;0;0;4209;20;20;1;0;0;0;2;4209;0;4838;2;1;
/org.eclipse.jdt.ui.tests.refactoring/resources/RenameType/testFail24/in/A.java;1;0;1;1;0;0;0;1;0;0;1;49;0;0;1;0;0;1;1;49;0;49;1;1;
/org.eclipse.vcm.core/src/org/eclipse/vcm/internal/core/base/IVCMListener.java;3;0;3;1;0;0;0;3;5;1;3;0;9;9;1;0;0;3;3;0;0;297;3;3;
/org.eclipse.swt.examples.paint/src/org/eclipse/swt/examples/paint/FigureDrawContext.java;2;0;2;1;1;1;1;1;6;0;1;615;6;6;1;0;0;1;2;615;0;4705;2;2;
/org.eclipse.jdt.debug.ui/ui/org/eclipse/jdt/internal/debug/ui/PixelConverter.java;1;0;2;1;1;1;1;1;14;0;1;3816;14;14;1;0;0;1;2;3816;0;4567;2;1;
/org.eclipse.swt.examples.controls/org/eclipse/swt/examples/controls/TextTab.java;2;0;4;1;0;0;0;4;100;1;4;513;124;124;1;0;0;4;4;513;0;970;4;2;
/org.eclipse.pde.junit/Pde JUnit/org/eclipse/pde/internal/junit/ui/JUnitPdeLauncherDelegate.java;1;0;3;1;0;0;0;3;410;1;3;2399;410;410;1;0;0;3;3;2399;0;2861;3;1;
/org.eclipse.webdav/src/interface/org/eclipse/webdav/LocatorFactory.java;3;0;3;1;0;0;0;3;12;1;3;12;12;12;1;0;0;3;3;12;0;1874;3;3;
/org.eclipse.update.ui/src/org/eclipse/update/internal/ui/manager/DetailsForm.java;3;0;42;1;0;0;0;42;1200;4;35;1460;2811;2811;4;7;0;42;42;3654;7;3654;35;3;
/org.eclipse.ui/Eclipse UI/org/eclipse/ui/part/MultiPageSelectionProvider.java;2;0;2;1;0;0;0;2;5;1;2;257;5;5;1;0;0;2;2;257;0;457;2;2;
/org.eclipse.jdt.ui.tests.refactoring/resources/ExtractMethodWorkSpace/ExtractMethodTests/nested_in/A_test653.java;2;1;3;1;2;2;2;1;12;0;1;354;12;12;1;0;0;1;3;354;0;4419;3;2;
/org.eclipse.swt.examples.controls/org/eclipse/swt/examples/controls/ListTab.java;2;0;3;1;0;0;0;3;74;1;3;513;74;74;1;0;0;3;3;513;0;970;3;2;
/org.eclipse.update/Eclipse Update/org/eclipse/update/internal/ui/Installation.java;2;0;4;1;0;0;0;4;320;1;4;108;324;324;1;0;0;4;4;108;0;1424;4;2;
/org.eclipse.vcm.core.cvs/src/org/eclipse/vcm/internal/core/ccvs/client/CVSTag.java;1;0;2;1;0;0;0;2;36;0;1;1238;36;36;2;1;0;2;2;1238;1;1238;1;1;
/org.eclipse.pde.ui/Eclipse PDE UI/org/eclipse/pde/internal/base/model/component/IComponentObject.java;2;0;5;2;0;0;0;5;12;3;3;267;12;12;3;2;0;5;5;324;2;1434;3;2;
/org.eclipse.jdt.ui.tests.refactoring/resources/RenameType/test18/in/A.java;1;0;1;1;0;0;0;1;0;0;1;49;0;0;1;0;0;1;1;49;0;49;1;1;
/org.eclipse.swt/Eclipse SWT/gtk1x/org/eclipse/swt/graphics/Device.java;4;0;7;2;1;1;1;6;61;2;5;2107;154;154;2;1;0;6;7;2123;1;4701;6;4;
/org.eclipse.webdav/src/interface/org/eclipse/webdav/Policy.java;3;0;7;1;1;1;1;6;180;1;6;400;395;395;1;0;0;6;7;400;0;4211;7;3;
/org.eclipse.swt.examples.paint/src/org/eclipse/swt/examples/paint/PaintStatus.java;2;0;2;1;0;0;0;2;0;1;2;391;0;0;1;0;0;2;2;391;0;611;2;2;
/org.eclipse.team.core/src/org/eclipse/team/core/internal/Assert.java;3;0;3;1;0;0;0;3;200;1;3;1978;200;200;1;0;0;3;3;1978;0;3213;3;3;
/org.eclipse.swt/Eclipse SWT/motif/org/eclipse/swt/widgets/TreeItem.java;2;0;5;1;0;0;0;5;298;1;5;106;727;727;1;0;0;5;5;106;0;1028;5;2;
/org.eclipse.jdt.ui/ui/org/eclipse/jdt/internal/ui/viewsupport/JavaElementImageDescriptor.java;2;0;3;1;0;0;0;3;12;1;3;1310;12;12;1;0;0;3;3;1310;0;2701;3;2;
/org.eclipse.core.tests.resources/src/org/eclipse/core/tests/internal/builders/BuilderNatureTest.java;2;0;5;2;0;0;0;5;31;3;2;3400;34;34;3;3;0;5;5;3415;3;3415;2;2;
/org.eclipse.debug.ui/ui/org/eclipse/debug/internal/ui/actions/RemoveExpressionAction.java;1;0;4;1;0;0;0;4;51;1;4;2382;63;63;1;0;0;4;4;2382;0;3309;4;1;
/org.eclipse.pde.ui/src/org/eclipse/pde/internal/base/model/IModelChangedListener.java;2;0;2;1;0;0;0;2;0;1;2;1434;0;0;1;0;0;2;2;1434;0;3039;2;2;
/org.eclipse.jdt.junit/src/org/eclipse/jdt/internal/junit/wizards/NewTestCaseCreationWizardPage.java;2;1;6;1;4;4;4;2;70;1;2;3527;140;140;1;0;0;2;6;3527;0;4634;6;2;
/org.eclipse.jdt.ui.vcm/vcm/org/eclipse/jdt/ui/vcm/VCMLabelDecorator.java;1;0;2;1;0;0;0;2;0;1;2;419;0;0;1;0;0;2;2;419;0;435;2;1;
/org.eclipse.vcm.ui/src/org/eclipse/vcm/internal/ui/WorkbenchVCMPlugin.java;6;0;23;2;0;0;0;23;59;3;18;1;336;336;3;5;0;23;23;237;5;1637;18;6;
/org.eclipse.team.webdav/src/org/eclipse/team/internal/webdav/Authenticator.java;1;1;2;1;2;2;2;0;0;0;0;4023;0;0;1;0;0;0;2;4023;0;4073;2;1;
/org.eclipse.vcm.ui/src/org/eclipse/vcm/internal/ui/VersionInfo.java;2;0;2;1;0;0;0;2;5;1;2;1;5;5;1;0;0;2;2;1;0;298;2;2;
/org.eclipse.update.ui/src/org/eclipse/update/internal/ui/parts/OverlayIcon.java;1;0;1;1;0;0;0;1;0;0;1;1460;0;0;1;0;0;1;1;1460;0;1460;1;1;
/org.eclipse.debug.ui/ui/org/eclipse/debug/internal/ui/views/VariablesView.java;3;0;39;2;1;1;1;38;81;5;30;2344;557;557;5;8;0;38;39;2344;8;3975;31;3;
/org.eclipse.jdt.core/model/org/eclipse/jdt/internal/core/builder/impl/ConstructorImplSWH.java;1;0;4;1;0;0;0;4;186;1;4;455;187;187;1;0;0;4;4;455;0;2808;4;1;
/org.eclipse.help/Eclipse Help/org/eclipse/help/internal/server/SearchURL.java;3;0;6;1;0;0;0;6;7;2;5;135;18;18;2;1;0;6;6;694;1;1154;5;3;
/org.eclipse.vcm.ui/src/org/eclipse/vcm/internal/ui/actions/RemoveRepositoryAction.java;5;0;5;1;0;0;0;5;64;1;5;1;112;112;1;0;0;5;5;1;0;1628;5;5;
/org.eclipse.jdt.core/model/org/eclipse/jdt/internal/core/MultiOperation.java;3;0;5;1;1;1;1;4;563;1;4;455;611;611;1;0;0;4;5;455;0;4063;5;3;
/org.eclipse.jdt.debug.tests/tests/org/eclipse/jdt/debug/tests/eval/TypeHierarchy_135_1.java;2;1;3;1;3;3;3;0;13;0;0;4447;15;15;1;0;0;0;3;4447;0;4571;3;2;
/org.eclipse.vcm.ui/src/org/eclipse/vcm/internal/ui/actions/CompareWithVersionAction.java;3;0;9;1;0;0;0;9;20;2;8;1;74;74;2;1;0;9;9;370;1;1288;8;3;
/org.eclipse.jdt.ui.tests/JUnit/junit/tests/OneTestCase.java;2;0;2;1;0;0;0;2;0;1;2;49;0;0;1;0;0;2;2;49;0;1186;2;2;
/org.eclipse.jdt.core/model/org/eclipse/jdt/internal/core/builder/IImage.java;1;0;3;1;0;0;0;3;7;1;3;455;7;7;1;0;0;3;3;455;0;2808;3;1;
/org.eclipse.jdt.ui.tests/JUnit/junit/tests/TestTestCaseClassLoader.java;2;0;2;1;0;0;0;2;0;1;2;49;0;0;1;0;0;2;2;49;0;1186;2;2;
/org.eclipse.jdt.ui.tests.refactoring/resources/PullUp/test14/out/A.java;1;0;1;1;0;0;0;1;0;0;1;2406;0;0;1;0;0;1;1;2406;0;2406;1;1;
/org.eclipse.team.core/src/org/eclipse/team/core/internal/StringMatcher.java;1;0;2;1;0;0;0;2;0;1;2;3458;0;0;1;0;0;2;2;3458;0;3762;2;1;
/org.eclipse.jdt.ui.tests.refactoring/resources/DeleteSourceReference/test13/in/A.java;1;0;1;1;0;0;0;1;0;0;1;2859;0;0;1;0;0;1;1;2859;0;2859;1;1;
/org.eclipse.jdt.debug.ui/ui/org/eclipse/jdt/debug/ui/launchConfigurations/JavaSourceLookupTab.java;3;1;5;1;5;5;5;0;14;0;0;4098;24;24;1;0;0;0;5;4098;0;4382;5;3;
/org.eclipse.jdt.ui/core refactoring/org/eclipse/jdt/internal/core/refactoring/code/flow/InOutFlowAnalyzer.java;1;0;4;1;0;0;0;4;22;1;4;1236;32;32;1;0;0;4;4;1236;0;1939;4;1;
/org.eclipse.help/src/org/eclipse/help/internal/contributors/ContextManager.java;2;0;2;1;0;0;0;2;0;1;2;1420;0;0;1;0;0;2;2;1420;0;1675;2;2;
/org.eclipse.ui/Eclipse UI Text Editor/org/eclipse/ui/texteditor/TaskRulerAction.java;1;1;3;1;2;2;2;1;51;0;1;3592;60;60;1;0;0;1;3;3592;0;4838;3;1;
/org.eclipse.swt.examples.controls/src/org/eclipse/swt/examples/controls/ControlPlugin.java;3;0;4;1;1;1;1;3;128;1;3;513;240;240;1;0;0;3;4;513;0;4705;4;3;
/org.eclipse.help/Eclipse Help/org/eclipse/help/internal/contributors/xml/HelpContextManager.java;3;0;8;1;0;0;0;8;187;1;8;135;271;271;1;0;0;8;8;135;0;1420;8;3;
/org.eclipse.webdav/src/kernel/org/eclipse/webdav/internal/kernel/utils/SimpleRFC1123DateFormat.java;2;0;5;1;1;1;1;4;430;1;4;12;462;462;1;0;0;4;5;12;0;4211;5;2;
/org.eclipse.jdt.debug.ui/ui/org/eclipse/jdt/internal/debug/ui/actions/ActionDelegateHelper.java;1;2;8;1;8;6;8;0;37;0;0;4060;102;102;2;0;2;0;8;4082;2;4692;6;1;
/org.eclipse.jdt.core/model/org/eclipse/jdt/internal/core/ClassFile.java;4;1;45;2;6;6;6;39;816;4;30;455;1293;1293;4;9;0;39;45;1039;9;4424;36;4;
/org.eclipse.jdt.ui/ui/org/eclipse/jdt/ui/jarpackager/JarWriter.java;2;1;10;1;7;7;7;3;96;1;3;3529;142;142;1;0;0;3;10;3529;0;4811;10;2;
/org.eclipse.pde.core/src/org/eclipse/pde/internal/core/CoreArraySorter.java;1;0;1;1;0;0;0;1;0;0;1;3607;0;0;1;0;0;1;1;3607;0;3607;1;1;
/org.eclipse.jdt.ui.tests.refactoring/resources/RenameMethodInInterface/testFail16/in/A.java;1;0;1;1;0;0;0;1;0;0;1;49;0;0;1;0;0;1;1;49;0;49;1;1;
/org.eclipse.jdt.ui.tests.refactoring/resources/RenameType/testFail17/in/A.java;1;0;1;1;0;0;0;1;0;0;1;49;0;0;1;0;0;1;1;49;0;49;1;1;
/org.eclipse.scripting/Eclipse Scripting/org/eclipse/scripting/internal/IXGRElementUITableHeadingElement.java;1;0;3;1;0;0;0;3;4;1;3;133;4;4;1;0;0;3;3;133;0;1424;3;1;
/org.eclipse.jdt.ui.tests.refactoring/resources/ReorderParameters/canReorder/A_test14_in.java;1;0;1;1;0;0;0;1;0;0;1;2270;0;0;1;0;0;1;1;2270;0;2270;1;1;
/org.eclipse.jdt.ui/ui/org/eclipse/jdt/ui/PreferenceConstants.java;4;2;9;2;9;7;9;0;630;0;0;4186;736;736;2;0;2;0;9;4186;2;4823;7;4;
/org.eclipse.jdt.debug/jdi interfaces/com/sun/jdi/event/VMDeathEvent.java;2;0;2;1;0;0;0;2;6;1;2;2704;6;6;1;0;0;2;2;2704;0;3040;2;2;
/org.eclipse.ui/Eclipse UI/org/eclipse/ui/internal/WorkbenchActionBuilder.java;10;2;96;3;26;21;26;70;965;4;57;257;2973;2973;4;13;5;70;96;3574;18;4737;78;10;
/org.eclipse.jdt.ui.tests.refactoring/resources/RenameStaticMethod/test3/in/A.java;1;0;1;1;0;0;0;1;0;0;1;49;0;0;1;0;0;1;1;49;0;49;1;1;
/org.eclipse.swt/Eclipse SWT/photon/org/eclipse/swt/internal/photon/PtCallbackInfo_t.java;2;0;3;1;0;0;0;3;6;1;3;106;6;6;1;0;0;3;3;106;0;2069;3;2;
/org.eclipse.jdt.debug/eval/org/eclipse/jdt/debug/eval/ast/model/IPrimitiveType.java;1;0;2;1;0;0;0;2;0;1;2;3329;0;0;1;0;0;2;2;3329;0;3421;2;1;
/org.eclipse.pde.ui/src/org/eclipse/pde/internal/model/PluginModelFactory.java;2;0;3;1;0;0;0;3;2;1;3;1434;2;2;1;0;0;3;3;1434;0;3136;3;2;
/org.eclipse.ui.tests/UI Test Utils/org/eclipse/ui/tests/util/UITestCase.java;1;0;1;1;0;0;0;1;0;0;1;2785;0;0;1;0;0;1;1;2785;0;2785;1;1;
/org.eclipse.ui/Eclipse JFace/org/eclipse/jface/resource/FontRegistry.java;4;0;12;1;1;1;1;11;92;2;10;257;297;297;2;1;0;11;12;1344;1;3971;11;4;
/org.eclipse.core.boot/src/org/eclipse/core/internal/boot/InternalBootLoader.java;6;3;32;3;7;5;7;25;1790;2;23;12;3153;3153;3;2;2;25;32;4023;4;4692;28;6;
/org.eclipse.jdt.ui/core extension/org/eclipse/jdt/internal/corext/dom/ASTUtil.java;2;0;4;1;0;0;0;4;7;1;4;2876;11;11;1;0;0;4;4;2876;0;3106;4;2;
/org.eclipse.pde.ui/src/org/eclipse/pde/internal/ui/wizards/WizardElement.java;1;0;2;1;0;0;0;2;3;1;2;3579;3;3;1;0;0;2;2;3579;0;3819;2;1;
/org.eclipse.search/search/org/eclipse/search/internal/ui/SearchPluginImages.java;2;0;13;1;1;1;1;12;81;2;11;15;199;199;2;1;0;12;13;365;1;4619;12;2;
/org.eclipse.jdt.ui.tests.refactoring/resources/RenameType/testFail77/in/A.java;1;0;1;1;0;0;0;1;0;0;1;49;0;0;1;0;0;1;1;49;0;49;1;1;
/org.eclipse.team.ui/src/org/eclipse/team/internal/ui/ProjectSetContentHandler.java;1;0;2;1;0;0;0;2;87;1;2;3728;87;87;1;0;0;2;2;3728;0;3812;2;1;
/org.eclipse.webdav/src/kernel/org/eclipse/webdav/internal/kernel/IDocumentMarshaler.java;2;0;4;1;1;1;1;3;42;1;3;1635;84;84;1;0;0;3;4;1635;0;4211;4;2;
/org.eclipse.pde.ui/Eclipse PDE UI/org/eclipse/pde/internal/wizards/extension/NewSchemaFileMainPage.java;2;0;5;2;0;0;0;5;12;3;3;267;12;12;3;2;0;5;5;324;2;1434;3;2;
/org.eclipse.scripting/Eclipse Scripting/org/eclipse/scripting/internal/views/ScriptUIEditorXmlParser.java;2;0;5;1;0;0;0;5;57;1;5;133;74;74;1;0;0;5;5;133;0;1424;5;2;
/org.eclipse.pde.ui/src/org/eclipse/pde/internal/core/plugin/AttributeChangedEvent.java;1;0;2;1;0;0;0;2;0;1;2;3579;0;0;1;0;0;2;2;3579;0;3607;2;1;
/org.eclipse.help.webapp/src/org/eclipse/help/servlet/URLCoder.java;1;0;2;1;0;0;0;2;0;0;1;3489;0;0;2;1;0;2;2;3489;1;3489;1;1;
/org.eclipse.jdt.ui.tests.refactoring/resources/ExtractMethodWorkSpace/ExtractMethodTests/locals_out/A_test539.java;1;1;4;1;2;2;2;2;4;1;2;922;8;8;1;0;0;2;4;922;0;4419;4;1;
/org.eclipse.pde.core/src/org/eclipse/pde/internal/core/feature/FeaturePlugin.java;1;0;2;1;1;1;1;1;8;0;1;3591;8;8;1;0;0;1;2;3591;0;3994;2;1;
/org.eclipse.ui/Eclipse JFace/org/eclipse/jface/viewers/IDoubleClickListener.java;2;0;2;1;0;0;0;2;5;1;2;257;5;5;1;0;0;2;2;257;0;457;2;2;
/org.eclipse.update/src/org/eclipse/update/internal/core/IUMLock.java;1;0;1;1;0;0;0;1;0;0;1;1424;0;0;1;0;0;1;1;1424;0;1424;1;1;
/org.eclipse.team.core/src/org/eclipse/team/core/ITeamProvider.java;2;0;3;1;0;0;0;3;632;1;3;1978;632;632;1;0;0;3;3;1978;0;3213;3;2;
/org.eclipse.update/src/org/eclipse/update/internal/core/UpdateManagerStrings.java;1;0;1;1;0;0;0;1;0;0;1;1424;0;0;1;0;0;1;1;1424;0;1424;1;1;
/org.eclipse.swt/Eclipse SWT/carbon/org/eclipse/swt/widgets/Scale.java;3;1;4;1;4;4;4;0;17;0;0;4147;27;27;1;0;0;0;4;4147;0;4701;4;3;
/org.eclipse.jdt.ui/core refactoring/org/eclipse/jdt/internal/core/refactoring/code/LocalTypeAnalyzer.java;3;0;4;1;0;0;0;4;5;1;4;408;9;9;1;0;0;4;4;408;0;1939;4;3;
/org.eclipse.pde.ui/src/org/eclipse/pde/internal/util/Sorter.java;1;0;2;1;0;0;0;2;0;1;2;2691;0;0;1;0;0;2;2;2691;0;3579;2;1;
/org.eclipse.ui.tests/Eclipse UI Tests/org/eclipse/ui/tests/dialogs/UIWizards.java;3;0;5;1;0;0;0;5;27;1;5;1113;40;40;1;0;0;5;5;1113;0;2785;5;3;
/org.eclipse.jdt.debug/jdi/org/eclipse/jdi/internal/jdwp/JdwpPacket.java;2;0;4;1;0;0;0;4;12;1;4;187;23;23;1;0;0;4;4;187;0;3670;4;2;
/org.eclipse.jdt.ui.tests.refactoring/resources/MoveMembers/testFail20/in/B.java;1;0;1;1;0;0;0;1;0;0;1;2928;0;0;1;0;0;1;1;2928;0;2928;1;1;
/org.eclipse.vcm.ui.cvs/src/org/eclipse/vcm/internal/ui/ccvs/AutoCreateVersionAndStreamDefinitions.java;2;0;3;1;0;0;0;3;135;2;2;1238;137;137;2;1;0;3;3;1238;1;1794;2;2;
/org.eclipse.ui/Eclipse JFace Text/org/eclipse/jface/text/ITextViewer.java;4;1;7;1;2;2;2;5;408;1;5;257;456;456;1;0;0;5;7;257;0;4853;7;4;
/org.eclipse.team.cvs.core/src/org/eclipse/team/internal/ccvs/core/resources/CVSFile.java;3;0;3;1;0;0;0;3;393;1;3;1978;393;393;1;0;0;3;3;1978;0;2156;3;3;
/org.eclipse.core.resources/src/org/eclipse/core/internal/properties/StoreKey.java;3;0;6;1;1;1;1;5;308;1;5;12;383;383;1;0;0;5;6;12;0;4214;6;3;
/org.eclipse.swt.tests/JUnit Tests/org/eclipse/swt/tests/junit/Test_org_eclipse_swt_events_MenuEvent.java;2;0;2;1;1;1;1;1;6;0;1;1792;6;6;1;0;0;1;2;1792;0;4706;2;2;
/org.eclipse.jdt.ui.tests.refactoring/resources/PullUp/testFail13/in/A.java;1;0;1;1;0;0;0;1;0;0;1;2406;0;0;1;0;0;1;1;2406;0;2406;1;1;
/org.eclipse.jdt.launching/launching/org/eclipse/jdt/launching/sourcelookup/JavaProjectSourceLocation.java;1;2;7;1;4;3;4;3;136;2;2;2372;184;184;2;1;1;3;7;2372;2;4406;5;1;
/org.eclipse.core.boot/src/org/eclipse/core/internal/boot/update/ProductDescriptor.java;3;0;6;1;0;0;0;6;52;1;6;12;71;71;1;0;0;6;6;12;0;2726;6;3;
/org.eclipse.ui/Eclipse JFace Text/org/eclipse/jface/text/rules/ITokenScanner.java;1;0;2;1;1;1;1;1;22;0;1;3812;22;22;1;0;0;1;2;3812;0;4838;2;1;
/org.eclipse.jdt.ui/core refactoring/org/eclipse/jdt/internal/core/refactoring/rename/RenameResourceRefactoring.java;2;0;6;1;0;0;0;6;22;1;6;1342;44;44;1;0;0;6;6;1342;0;1939;6;2;
/org.eclipse.pde.ui/Eclipse PDE UI/org/eclipse/pde/internal/base/model/build/IBuildModel.java;2;0;5;2;0;0;0;5;12;3;3;267;12;12;3;2;0;5;5;324;2;1434;3;2;
/org.eclipse.jdt.ui/nls/org/eclipse/jdt/internal/ui/nls/search/LibraryFilter.java;1;0;2;1;0;0;0;2;0;1;2;1880;0;0;1;0;0;2;2;1880;0;1913;2;1;
/org.eclipse.ui.tests/Eclipse UI Tests/org/eclipse/ui/tests/api/SessionView.java;1;0;3;1;0;0;0;3;35;1;3;1008;36;36;1;0;0;3;3;1008;0;1058;3;1;
/org.eclipse.jdt.ui.tests.refactoring/resources/RenamePrivateMethod/test24/in/A.java;1;0;1;1;0;0;0;1;0;0;1;49;0;0;1;0;0;1;1;49;0;49;1;1;
/org.eclipse.debug.core/core/org/eclipse/debug/internal/core/Breakpoint.java;2;0;5;1;0;0;0;5;412;1;5;831;484;484;1;0;0;5;5;831;0;1139;5;2;
/org.eclipse.pde.ui/src/org/eclipse/pde/internal/base/model/feature/IFeatureURL.java;1;0;3;1;0;0;0;3;18;1;3;2951;18;18;1;0;0;3;3;2951;0;3579;3;1;
/org.eclipse.swt/Eclipse SWT Drag and Drop/gtk1x/org/eclipse/swt/dnd/ByteArrayTransfer.java;2;0;2;1;0;0;0;2;0;1;2;2107;0;0;1;0;0;2;2;2107;0;3127;2;2;
/org.eclipse.pde.ui/src/org/eclipse/pde/internal/editor/component/PluginSection.java;2;0;6;1;0;0;0;6;8;2;5;1434;13;13;2;1;0;6;6;2691;1;2951;5;2;
/org.eclipse.ui.externaltools/External Tools/org/eclipse/ui/externaltools/internal/ui/EditDialog.java;2;3;14;1;14;11;14;0;177;0;0;4090;494;494;3;0;3;0;14;4425;3;4729;11;2;
/org.eclipse.pde.build/src/org/eclipse/pde/internal/build/antwrappers/Mkdir.java;2;0;2;1;0;0;0;2;0;1;2;2859;0;0;1;0;0;2;2;2859;0;2900;2;2;
/org.eclipse.jdt.ui/core refactoring/org/eclipse/jdt/internal/core/refactoring/RefactoringASTAnalyzer.java;2;0;7;1;0;0;0;7;126;2;6;25;199;199;2;1;0;7;7;25;1;1910;6;2;
/org.eclipse.pde.ui/src/org/eclipse/pde/internal/ui/editor/manifest/TemplateForm.java;1;0;3;1;1;1;1;2;53;1;2;3579;59;59;1;0;0;2;3;3579;0;4449;3;1;
/org.eclipse.pde.ui/Eclipse PDE UI/org/eclipse/pde/internal/editor/build/TokenSection.java;2;0;8;2;0;0;0;8;12;3;6;267;22;22;3;2;0;8;8;324;2;1434;6;2;
/org.eclipse.jdt.ui/ui/org/eclipse/jdt/internal/ui/search/FindReadReferencesAction.java;1;2;6;1;4;3;4;2;30;1;2;1707;51;51;2;0;1;2;6;4140;1;4140;5;1;
/org.eclipse.jdt.ui/ui/org/eclipse/jdt/internal/ui/packageview/PackageExplorerActionGroup.java;4;3;21;2;17;14;17;4;110;2;3;3716;339;339;3;1;3;4;21;3894;4;4541;17;4;
/org.eclipse.jdt.ui/ui/org/eclipse/jdt/internal/ui/packageview/PackageViewerSorter.java;3;0;11;1;0;0;0;11;22;1;11;15;81;81;1;0;0;11;11;15;0;1559;11;3;
/org.eclipse.jdt.ui.tests.refactoring/resources/RenamePackage/test3/out/r/A.java;1;0;1;1;0;0;0;1;0;0;1;1258;0;0;1;0;0;1;1;1258;0;1258;1;1;
/org.eclipse.swt.examples.launcher/src/org/eclipse/swt/examples/launcher/LauncherApplication.java;1;0;1;1;0;0;0;1;0;0;1;480;0;0;1;0;0;1;1;480;0;480;1;1;
/org.eclipse.jdt.ui.tests.refactoring/resources/PullUp/test12/out/B.java;1;0;2;1;0;0;0;2;2;1;2;2406;2;2;1;0;0;2;2;2406;0;2738;2;1;
/org.eclipse.update.ui/src/org/eclipse/update/internal/ui/views/IEmbeddedWebBrowser.java;1;0;1;1;1;1;1;0;0;0;0;4127;0;0;1;0;0;0;1;4127;0;4127;1;1;
/org.eclipse.jdt.ui.tests.refactoring/resources/DeleteSourceReference/test15/in/A.java;1;0;1;1;0;0;0;1;0;0;1;3416;0;0;1;0;0;1;1;3416;0;3416;1;1;
/org.eclipse.jdt.ui.tests.refactoring/resources/RenameType/testFail54/in/A.java;1;0;1;1;0;0;0;1;0;0;1;49;0;0;1;0;0;1;1;49;0;49;1;1;
/org.eclipse.jdt.core/search/org/eclipse/jdt/internal/core/index/impl/HashtableOfObject.java;1;0;9;1;0;0;0;9;80;4;6;455;116;116;4;3;0;9;9;1039;3;3674;6;1;
/org.eclipse.jdt.ui/core refactoring/org/eclipse/jdt/internal/core/refactoring/util/ASTUtil.java;1;0;3;1;0;0;0;3;18;1;3;1453;18;18;1;0;0;3;3;1453;0;1939;3;1;
/org.eclipse.vcm.tests.core.cvs.ssh/src/org/eclipse/vcm/tests/core/ccvs/ssh/ClientTest.java;1;0;1;1;0;0;0;1;0;0;1;1688;0;0;1;0;0;1;1;1688;0;1688;1;1;
/org.eclipse.jdt.ui.tests.refactoring/resources/ExtractMethodWorkSpace/ExtractMethodTests/invalidSelection/A_test171.java;2;1;3;1;2;2;2;1;0;0;1;511;0;0;1;0;0;1;3;511;0;4419;3;2;
/org.eclipse.jdt.core/model/org/eclipse/jdt/internal/core/builder/impl/BuildNotifier.java;1;0;12;1;0;0;0;12;438;4;8;455;659;659;4;4;0;12;12;1039;4;2808;8;1;
/org.eclipse.jdt.ui.tests.refactoring/resources/RenameVirtualMethodInClass/testFail10/in/A.java;1;0;1;1;0;0;0;1;0;0;1;49;0;0;1;0;0;1;1;49;0;49;1;1;
/org.eclipse.core.tests.runtime/src/org/eclipse/core/tests/plugintests/CmdLinePreferencesTest.java;1;0;1;1;1;1;1;0;0;0;0;4006;0;0;1;0;0;0;1;4006;0;4006;1;1;
/org.eclipse.core.resources/src/org/eclipse/core/internal/localstore/DeleteVisitor.java;4;0;12;1;1;1;1;11;236;2;10;12;389;389;2;1;0;11;12;327;1;4214;11;4;
/org.eclipse.vcm.ui/src/org/eclipse/vcm/internal/ui/actions/RemoveStreamAction.java;1;0;2;1;0;0;0;2;2;1;2;402;2;2;1;0;0;2;2;402;0;438;2;1;
/org.eclipse.jdt.ui.tests.refactoring/resources/RenameStaticMethod/testFail0/in/A.java;1;0;1;1;0;0;0;1;0;0;1;49;0;0;1;0;0;1;1;49;0;49;1;1;
/org.eclipse.jdt.debug.ui/ui/org/eclipse/jdt/internal/debug/ui/snippeteditor/SnippetFileDocumentProvider.java;1;0;1;1;0;0;0;1;0;0;1;1915;0;0;1;0;0;1;1;1915;0;1915;1;1;
/org.eclipse.pde.ui/templates/editor/java/XMLScanner.java;1;0;2;1;1;1;1;1;4;0;1;3812;4;4;1;0;0;1;2;3812;0;4318;2;1;
/org.eclipse.pde.ui/src/org/eclipse/pde/internal/feature/FeatureProject.java;1;0;2;1;0;0;0;2;0;1;2;2951;0;0;1;0;0;2;2;2951;0;3078;2;1;
/org.eclipse.core.tests.runtime/src/org/eclipse/core/tests/internal/plugins/PluginResolveTest_27.java;3;0;3;1;0;0;0;3;110;1;3;1794;120;120;1;0;0;3;3;1794;0;3476;3;3;
/org.eclipse.jdt.ui/ui refactoring/org/eclipse/jdt/internal/ui/refactoring/undo/UndoManagerAction.java;4;0;9;1;0;0;0;9;65;1;9;15;108;108;1;0;0;9;9;15;0;1360;9;4;
/org.eclipse.pde.build/src/org/eclipse/pde/core/internal/ant/ConditionTask.java;1;0;2;1;0;0;0;2;0;1;2;3128;0;0;1;0;0;2;2;3128;0;3194;2;1;
/org.eclipse.debug.ui/ui/org/eclipse/debug/internal/ui/actions/ShowVariableDetailPaneAction.java;1;0;3;1;0;0;0;3;4;1;3;2382;4;4;1;0;0;3;3;2382;0;3536;3;1;
/org.eclipse.jdt.ui/core refactoring/org/eclipse/jdt/internal/corext/refactoring/base/IUndoManager.java;1;0;1;1;0;0;0;1;0;0;1;1939;0;0;1;0;0;1;1;1939;0;1939;1;1;
/org.eclipse.jdt.ui.tests.refactoring/resources/RenameParameters/cannotRename/A_testFail17.java;1;0;1;1;0;0;0;1;0;0;1;233;0;0;1;0;0;1;1;233;0;233;1;1;
/org.eclipse.ui.tests/Eclipse UI Tests/org/eclipse/ui/tests/api/PlatformUITest.java;2;0;3;1;0;0;0;3;4;1;3;803;6;6;1;0;0;3;3;803;0;1080;3;2;
/org.eclipse.core.tests.harness/src/org/eclipse/core/tests/harness/ExampleWorkspaceTest.java;3;0;4;1;1;1;1;3;260;1;3;1794;291;291;1;0;0;3;4;1794;0;4516;4;3;
/org.eclipse.pde.build/src/plugin/org/eclipse/pde/internal/core/FeatureBuildScriptGenerator.java;1;0;1;1;0;0;0;1;0;0;1;3475;0;0;1;0;0;1;1;3475;0;3475;1;1;
/org.eclipse.jdt.debug.ui/ui/org/eclipse/jdt/internal/debug/ui/display/DisplayViewerConfiguration.java;3;0;5;1;0;0;0;5;144;1;5;1915;192;192;1;0;0;5;5;1915;0;3634;5;3;
/org.eclipse.ui/Eclipse JFace/org/eclipse/jface/util/SafeRunnable.java;2;2;3;2;3;2;3;0;18;0;0;4363;22;22;2;0;1;0;3;4363;1;4434;2;2;
/org.eclipse.pde.core/src/org/eclipse/pde/internal/core/AbstractModel.java;1;0;1;1;0;0;0;1;0;0;1;3591;0;0;1;0;0;1;1;3591;0;3591;1;1;
/org.eclipse.jdt.ui/ui/org/eclipse/jdt/internal/ui/wizards/ContainerPackagePage.java;1;0;3;1;0;0;0;3;26;1;3;15;26;26;1;0;0;3;3;15;0;144;3;1;
/org.eclipse.update.core/src/org/eclipse/update/core/VersionedIdentifier.java;3;1;14;1;3;3;3;11;134;1;11;1423;289;289;1;0;0;11;14;1423;0;4365;14;3;
/org.eclipse.pde.build/src/org/eclipse/pde/core/internal/ant/AntScript.java;1;0;2;1;0;0;0;2;0;1;2;3128;0;0;1;0;0;2;2;3128;0;3194;2;1;
/org.eclipse.pde.core/src/org/eclipse/pde/internal/core/feature/FeatureData.java;1;1;3;1;2;2;2;1;24;0;1;3591;44;44;1;0;0;1;3;3591;0;4430;3;1;
/org.eclipse.scripting/Eclipse Scripting/org/eclipse/scripting/internal/uirenderer/XGRElementUISwtCompositePanel.java;2;0;4;1;0;0;0;4;13;1;4;133;17;17;1;0;0;4;4;133;0;1424;4;2;
/org.eclipse.jdt.core/model/org/eclipse/jdt/internal/core/newbuilder/BuildNotifier.java;1;0;9;1;0;0;0;9;51;2;8;1764;105;105;2;1;0;9;9;1816;1;2979;8;1;
/org.eclipse.update.ui/src/org/eclipse/update/internal/ui/manager/UpdatesForm.java;1;0;22;1;0;0;0;22;520;3;17;1428;1017;1017;3;5;0;22;22;1436;5;3561;17;1;
/org.eclipse.jdt.ui/ui/org/eclipse/jdt/internal/ui/text/template/TemplateEvaluator.java;2;0;9;1;0;0;0;9;91;1;9;1720;194;194;1;0;0;9;9;1720;0;2784;9;2;
/org.eclipse.pde.runtime/src/org/eclipse/pde/internal/runtime/registry/ParentAdapter.java;1;0;1;1;0;0;0;1;0;0;1;1434;0;0;1;0;0;1;1;1434;0;1434;1;1;
/org.eclipse.swt.examples.paint/src/org/eclipse/swt/examples/paint/Assert.java;2;0;2;1;0;0;0;2;0;1;2;391;0;0;1;0;0;2;2;391;0;611;2;2;
/org.eclipse.ant.core/src_ant/org/eclipse/ant/internal/core/ant/Policy.java;2;1;5;1;2;2;2;3;97;1;3;3489;178;178;1;0;0;3;5;3489;0;4436;5;2;
/org.eclipse.debug.ui/ui/org/eclipse/debug/internal/ui/preferences/DebugPreferencePage.java;2;2;7;1;7;6;7;0;260;0;0;3975;310;310;2;0;1;0;7;4164;1;4708;6;2;
/org.eclipse.jdt.core/eval/org/eclipse/jdt/internal/eval/CodeSnippetMessageSend.java;2;0;14;1;1;1;1;13;420;3;9;455;540;540;3;4;0;13;14;2565;4;4062;10;2;
/org.eclipse.ui/Eclipse UI/org/eclipse/ui/internal/dialogs/WizardNewProjectCreationPage.java;3;0;6;1;1;1;1;5;16;1;5;3186;47;47;1;0;0;5;6;3186;0;4082;6;3;
/org.eclipse.jdt.ui.tests.refactoring/resources/ExtractTemp/canExtract/A_test33_out.java;1;0;1;1;0;0;0;1;0;0;1;3226;0;0;1;0;0;1;1;3226;0;3226;1;1;
/org.eclipse.core.tests.runtime/src/org/eclipse/core/tests/internal/registrycache/SimpleCacheTests.java;4;0;6;1;1;1;1;5;2794;1;5;1794;3001;3001;1;0;0;5;6;1794;0;4630;6;4;
/org.eclipse.jdt.ui.tests.refactoring/resources/StructureSelectionAction/A_test4.java;1;0;1;1;0;0;0;1;0;0;1;2139;0;0;1;0;0;1;1;2139;0;2139;1;1;
/org.eclipse.jdt.ui.tests.refactoring/resources/ExtractMethodWorkSpace/ExtractMethodTests/validSelection/A_test252.java;2;1;3;1;2;2;2;1;0;0;1;49;0;0;1;0;0;1;3;49;0;4419;3;2;
/org.eclipse.swt.examples/org/eclipse/swt/examples/fileviewer/FileViewer.java;6;0;13;2;1;1;1;12;1593;2;9;554;2632;2632;2;3;0;12;13;609;3;4024;10;6;
/org.eclipse.pde.runtime/src/org/eclipse/pde/internal/runtime/logview/LogEntryPropertyPage.java;1;0;2;1;1;1;1;1;13;0;1;3877;13;13;1;0;0;1;2;3877;0;4089;2;1;
/org.eclipse.jdt.ui.tests.refactoring/resources/RenameVirtualMethodInClass/testFail8/in/A.java;1;0;1;1;0;0;0;1;0;0;1;49;0;0;1;0;0;1;1;49;0;49;1;1;
/org.eclipse.jdt.ui.tests.refactoring/resources/ExtractMethodWorkSpace/ExtractMethodTests/locals_out/A_test531.java;1;1;4;1;2;2;2;2;24;1;2;922;27;27;1;0;0;2;4;922;0;4419;4;1;
/org.eclipse.jdt.ui.tests.refactoring/resources/RenameVirtualMethodInClass/test16/out/A.java;1;0;1;1;0;0;0;1;0;0;1;49;0;0;1;0;0;1;1;49;0;49;1;1;
/org.eclipse.ui.tests/Eclipse JFace Tests/org/eclipse/jface/tests/viewers/interactive/ClearSelectionAction.java;1;0;1;1;0;0;0;1;0;0;1;1488;0;0;1;0;0;1;1;1488;0;1488;1;1;
/org.eclipse.jdt.ui.tests.refactoring/resources/PullUpMethods/testFail6/in/B.java;1;0;2;1;0;0;0;2;0;1;2;2156;0;0;1;0;0;2;2;2156;0;2406;2;1;
/org.eclipse.pde.ui/src/org/eclipse/pde/internal/forms/FormSection.java;2;0;2;1;0;0;0;2;0;1;2;1434;0;0;1;0;0;2;2;1434;0;2470;2;2;
/org.eclipse.pde.ui/src/org/eclipse/pde/internal/ui/wizards/project/ProjectCodeGeneratorsPage.java;1;0;6;1;1;1;1;5;13;2;4;3579;36;36;2;1;0;5;6;3631;1;4167;5;1;
/org.eclipse.update.core/src/org/eclipse/update/core/model/DefaultPluginParser.java;1;0;5;1;0;0;0;5;50;2;4;2764;52;52;2;1;0;5;5;2913;1;3027;4;1;
/org.eclipse.jdt.core/model/org/eclipse/jdt/internal/core/SourceMapper.java;4;3;38;2;8;6;8;30;5904;4;20;455;10478;10478;4;10;2;30;38;1039;12;4382;26;4;
/org.eclipse.ui/Eclipse UI Text Editor/org/eclipse/ui/texteditor/PropagatingFontFieldEditor.java;1;0;4;1;0;0;0;4;114;1;4;1155;118;118;1;0;0;4;4;1155;0;1516;4;1;
/org.eclipse.debug.ui/ui/org/eclipse/debug/internal/ui/preferences/DebugHistoryPreferenceTab.java;1;0;2;1;2;1;2;0;1;0;0;4207;1;1;2;0;1;0;2;4207;1;4207;1;1;
/org.eclipse.pde.ui/src/org/eclipse/pde/core/plugin/IPluginLibrary.java;1;0;2;1;0;0;0;2;0;1;2;3579;0;0;1;0;0;2;2;3579;0;3607;2;1;
/org.eclipse.jdt.ui.tests.refactoring/resources/MoveCU/testFail8/in/p/B.java;2;0;2;1;0;0;0;2;0;1;2;49;0;0;1;0;0;2;2;49;0;2769;2;2;
/org.eclipse.jdt.core/compiler/org/eclipse/jdt/internal/compiler/util/HashtableOfPackage.java;2;0;10;1;1;1;1;9;162;4;5;455;212;212;4;4;0;9;10;1039;4;4062;6;2;
/org.eclipse.jdt.ui/core refactoring/org/eclipse/jdt/internal/corext/refactoring/RenameResourceChange.java;2;0;2;1;0;0;0;2;0;1;2;1939;0;0;1;0;0;2;2;1939;0;2820;2;2;
/org.eclipse.team.ui/src/org/eclipse/team/internal/ui/ImportProjectSetMainPage.java;2;1;7;1;5;5;5;2;125;1;2;3728;148;148;1;0;0;2;7;3728;0;4708;7;2;
/org.eclipse.swt/Eclipse SWT OLE Win32/win32/org/eclipse/swt/internal/ole/win32/VARDESC2.java;2;0;3;1;0;0;0;3;6;1;3;106;6;6;1;0;0;3;3;106;0;2069;3;2;
/org.eclipse.ant.ui/src/org/eclipse/ant/internal/ui/TasksPage.java;1;0;3;1;0;0;0;3;66;1;3;3476;118;118;1;0;0;3;3;3476;0;3506;3;1;
/org.eclipse.jdt.ui.tests.refactoring/resources/ExtractTemp/canExtract/A_test5_out.java;1;0;1;1;0;0;0;1;0;0;1;2481;0;0;1;0;0;1;1;2481;0;2481;1;1;
/org.eclipse.compare/compare/org/eclipse/compare/internal/CompareNavigator.java;3;1;13;1;3;3;3;10;54;1;10;419;142;142;1;0;0;10;13;419;0;4699;13;3;
/org.eclipse.ui/Eclipse UI/org/eclipse/ui/actions/CreateFolderAction.java;5;0;5;1;0;0;0;5;14;1;5;257;23;23;1;0;0;5;5;257;0;3029;5;5;
/org.eclipse.pde.core/src/org/eclipse/pde/internal/core/builders/PluginErrorReporter.java;1;0;3;1;0;0;0;3;11;1;3;3591;11;11;1;0;0;3;3;3591;0;3631;3;1;
/org.eclipse.jdt.ui.tests/refactoring/experiments/TextRegion.java;1;0;2;1;0;0;0;2;0;1;2;729;0;0;1;0;0;2;2;729;0;1895;2;1;
/org.eclipse.core.resources/src/org/eclipse/core/resources/IFile.java;3;1;13;1;3;3;3;10;1236;1;10;12;1770;1770;1;0;0;10;13;12;0;4454;13;3;
/org.eclipse.swt.tests/JUnit Tests/org/eclipse/swt/tests/junit/AllTests.java;2;0;2;1;1;1;1;1;6;0;1;1792;6;6;1;0;0;1;2;1792;0;4706;2;2;
/org.eclipse.jdt.ui.tests.refactoring/resources/RenameVirtualMethodInClass/testFail35/in/A.java;1;0;1;1;0;0;0;1;0;0;1;49;0;0;1;0;0;1;1;49;0;49;1;1;
/org.eclipse.update.tests.core/src/org/eclipse/update/tests/configurations/TestBackward.java;1;1;8;1;2;2;2;6;8;1;6;2841;28;28;1;0;0;6;8;2841;0;4329;8;1;
/org.eclipse.pde.ui/Eclipse PDE UI/org/eclipse/pde/internal/wizards/project/PluginClassCodeGenerator.java;2;0;6;2;0;0;0;6;94;3;4;267;106;106;3;2;0;6;6;324;2;1434;4;2;
/org.eclipse.jdt.ui.tests.refactoring/resources/RenamePackage/testFail4/in/r/A.java;1;0;1;1;0;0;0;1;0;0;1;1258;0;0;1;0;0;1;1;1258;0;1258;1;1;
/org.eclipse.ui/Eclipse JFace Text/org/eclipse/jface/text/IHoverInfoPresenter.java;1;0;3;1;0;0;0;3;25;1;3;1226;25;25;1;0;0;3;3;1226;0;1435;3;1;
/org.eclipse.update.core/src/org/eclipse/update/core/ISiteFactory.java;2;0;13;2;0;0;0;13;61;3;10;2251;107;107;3;3;0;13;13;3570;3;3570;10;2;
/org.eclipse.debug.ui/ui/org/eclipse/debug/internal/ui/views/AbstractDebugView.java;1;0;2;1;0;0;0;2;20;0;1;2312;20;20;2;1;0;2;2;2312;1;2312;1;1;
/org.eclipse.update.core/src/org/eclipse/update/configuration/IConfiguredSiteChangedListener.java;2;0;5;1;1;1;1;4;33;2;3;3018;73;73;2;1;0;4;5;3664;1;4687;4;2;
/org.eclipse.ui/Eclipse UI/org/eclipse/ui/internal/misc/StringMatcher.java;1;0;1;1;0;0;0;1;0;0;1;3733;0;0;1;0;0;1;1;3733;0;3733;1;1;
/org.eclipse.jdt.ui.examples.projects/examples/org/eclipse/jdt/internal/ui/exampleprojects/ExampleProjectCreationWizard.java;3;0;4;1;1;1;1;3;132;1;3;534;195;195;1;0;0;3;4;534;0;4440;4;3;
/org.eclipse.jdt.ui.tests.refactoring/resources/MoveMembers/test9/in/A.java;1;0;1;1;0;0;0;1;0;0;1;2738;0;0;1;0;0;1;1;2738;0;2738;1;1;
/org.eclipse.jdt.ui/ui refactoring/org/eclipse/jdt/internal/ui/refactoring/actions/ExtractMethodAction.java;3;0;23;1;1;1;1;22;155;1;22;15;491;491;1;0;0;22;23;15;0;3970;23;3;
/org.eclipse.swt/Eclipse SWT/motif/org/eclipse/swt/widgets/Decorations.java;6;1;16;1;7;7;7;9;613;1;9;106;1306;1306;1;0;0;9;16;106;0;4701;16;6;
/org.eclipse.swt/Eclipse SWT PI/gtk1x/org/eclipse/swt/internal/gtk/GtkWindow.java;2;0;2;1;1;1;1;1;3;0;1;2107;3;3;1;0;0;1;2;2107;0;4701;2;2;
/org.eclipse.jdt.ui.tests.refactoring/resources/RenameMethodInInterface/testFail18/in/A.java;1;0;1;1;0;0;0;1;0;0;1;49;0;0;1;0;0;1;1;49;0;49;1;1;
/org.eclipse.jdt.debug.ui/ui/org/eclipse/jdt/internal/debug/ui/launcher/LauncherMessages.java;1;0;1;1;0;0;0;1;0;0;1;1915;0;0;1;0;0;1;1;1915;0;1915;1;1;
/org.eclipse.jdt.core/compiler/org/eclipse/jdt/internal/compiler/codegen/FieldNameAndTypeCache.java;2;1;11;1;2;2;2;9;294;4;6;455;397;397;4;3;0;9;11;1039;3;4062;8;2;
/org.eclipse.update.ui/src/org/eclipse/update/ui/internal/manager/UpdateManagerInputFactory.java;1;0;2;1;0;0;0;2;0;0;1;1426;0;0;2;1;0;2;2;1426;1;1426;1;1;
/org.eclipse.pde.ui/Eclipse PDE UI/org/eclipse/pde/internal/editor/jars/JarsPage.java;2;0;6;2;0;0;0;6;12;3;4;267;14;14;3;2;0;6;6;324;2;1434;4;2;
/org.eclipse.update.tests.core/src/org/eclipse/update/tests/regularInstall/Test1.java;1;0;3;1;0;0;0;3;39;1;3;1454;39;39;1;0;0;3;3;1454;0;1643;3;1;
/org.eclipse.core.tests.resources/src/org/eclipse/core/tests/resources/IProjectTest.java;3;0;10;2;1;1;1;9;4856;2;7;1794;7092;7092;2;2;0;9;10;3251;2;4516;8;3;
/org.eclipse.team.core/src/org/eclipse/team/core/sync/IRemoteSyncElement.java;3;1;6;2;3;3;3;3;25;1;3;2019;44;44;1;0;0;3;6;2019;0;4707;6;3;
/org.eclipse.pde.ui/Eclipse PDE UI/org/eclipse/pde/internal/component/ComponentProject.java;2;0;5;2;0;0;0;5;12;3;3;267;12;12;3;2;0;5;5;324;2;1434;3;2;
/org.eclipse.jdt.ui.tests.refactoring/resources/SelectionAnalyzerWorkSpace/SelectionAnalyzerTests/validSelection/A_test202.java;1;0;1;1;0;0;0;1;0;0;1;1368;0;0;1;0;0;1;1;1368;0;1368;1;1;
/org.eclipse.swt/Eclipse SWT/common_j2me/org/eclipse/swt/internal/Compatibility.java;3;1;6;1;2;2;2;4;105;1;4;1531;219;219;1;0;0;4;6;1531;0;4701;6;3;
/org.eclipse.help/Eclipse Help/org/eclipse/help/internal/server/HelpHttpConnection.java;2;0;3;1;0;0;0;3;7;1;3;135;7;7;1;0;0;3;3;135;0;1420;3;2;
/org.eclipse.swt/Eclipse SWT/common/org/eclipse/swt/events/FocusEvent.java;2;0;3;1;1;1;1;2;6;1;2;106;10;10;1;0;0;2;3;106;0;4701;3;2;
/org.eclipse.help/webapps/examples/WEB-INF/classes/compressionFilters/CompressionFilter.java;1;0;2;1;0;0;0;2;0;1;2;1882;0;0;1;0;0;2;2;1882;0;1930;2;1;
/org.eclipse.jdt.core/compiler/org/eclipse/jdt/internal/compiler/flow/ExceptionHandlingFlowContext.java;2;1;14;1;2;2;2;12;207;4;9;455;558;558;4;3;0;12;14;1039;3;4180;11;2;
/org.eclipse.jdt.ui/ui/org/eclipse/jdt/internal/ui/packageview/PackagesFrameSource.java;3;0;3;1;0;0;0;3;4;1;3;390;8;8;1;0;0;3;3;390;0;3571;3;3;
/org.eclipse.team.cvs.core/src/org/eclipse/team/internal/ccvs/core/client/Admin.java;2;0;4;1;0;0;0;4;16;1;4;2572;20;20;1;0;0;4;4;2572;0;3452;4;2;
/org.eclipse.jdt.core/model/org/eclipse/jdt/core/util/IConstantValueAttribute.java;2;2;6;1;5;4;5;1;20;0;1;3629;41;41;2;0;1;1;6;4058;1;4573;5;2;
/org.eclipse.ui/Eclipse UI Standard Components/org/eclipse/ui/views/tasklist/PurgeCompletedAction.java;5;0;5;1;1;1;1;4;14;1;4;257;29;29;1;0;0;4;5;257;0;4269;5;5;
/org.eclipse.vcm.ui/src/org/eclipse/vcm/internal/ui/merge/AfterStatePage.java;4;0;7;2;0;0;0;7;43;2;6;1;93;93;2;1;0;7;7;297;1;1398;6;4;
/org.eclipse.jdt.ui.tests.refactoring/resources/ReorderParameters/canReorder/A_test2_out.java;1;0;3;1;0;0;0;3;0;1;3;724;0;0;1;0;0;3;3;724;0;2270;3;1;
/org.eclipse.jdt.ui.tests.refactoring/test cases/org/eclipse/jdt/ui/tests/nls/OrderedMapTester.java;1;0;1;1;0;0;0;1;0;0;1;2015;0;0;1;0;0;1;1;2015;0;2015;1;1;
/org.eclipse.update.ui/src/org/eclipse/update/internal/ui/manager/UpdateManagerAction.java;1;0;7;1;0;0;0;7;23;1;7;1428;44;44;1;0;0;7;7;1428;0;3662;7;1;
/org.eclipse.jdt.ui.tests.refactoring/resources/ExtractMethodWorkSpace/ExtractMethodTests/expression_in/A_test607.java;2;1;3;1;2;2;2;1;12;0;1;239;12;12;1;0;0;1;3;239;0;4419;3;2;
/org.eclipse.pde.ui/src/org/eclipse/pde/internal/builders/ComponentConsistencyChecker.java;2;0;3;1;0;0;0;3;1;1;3;1434;1;1;1;0;0;3;3;1434;0;2951;3;2;
/org.eclipse.core.tests.resources/src/org/eclipse/core/tests/resources/TeamPrivateMemberTest.java;2;0;8;1;1;1;1;7;455;1;7;3345;992;992;1;0;0;7;8;3345;0;4516;8;2;
/org.eclipse.jdt.ui.tests.refactoring/resources/RenameVariables/cannotRename/A_testFail2.java;1;0;2;1;0;0;0;2;0;1;2;724;0;0;1;0;0;2;2;724;0;1665;2;1;
/org.eclipse.jdt.ui.tests.refactoring/resources/RenamePackage/test0/in/r/A.java;1;0;1;1;0;0;0;1;0;0;1;1258;0;0;1;0;0;1;1;1258;0;1258;1;1;
/org.eclipse.jdt.ui.tests.refactoring/resources/RenameTemp/canRename/A_test45_in.java;1;0;1;1;0;0;0;1;0;0;1;3356;0;0;1;0;0;1;1;3356;0;3356;1;1;
/org.eclipse.jdt.ui/ui/org/eclipse/jdt/internal/ui/jarpackager/JarPackageWriter.java;2;0;14;1;0;0;0;14;124;1;14;239;453;453;1;0;0;14;14;239;0;3791;14;2;
/org.eclipse.jdt.ui.tests.refactoring/resources/RenameMethodInInterface/test4/in/A.java;1;0;1;1;0;0;0;1;0;0;1;49;0;0;1;0;0;1;1;49;0;49;1;1;
/org.eclipse.jdt.ui.tests.refactoring/resources/PullUp/test7/out/A.java;1;0;1;1;0;0;0;1;0;0;1;2406;0;0;1;0;0;1;1;2406;0;2406;1;1;
/org.eclipse.jdt.core/codeassist/org/eclipse/jdt/internal/codeassist/ISelectionRequestor.java;3;0;9;1;1;1;1;8;224;2;7;455;545;545;2;1;0;8;9;3084;1;4062;8;3;
/org.eclipse.ui.examples.javaeditor/Eclipse Java Editor Example/org/eclipse/ui/examples/javaeditor/util/JavaWhitespaceDetector.java;1;0;1;1;0;0;0;1;0;0;1;1067;0;0;1;0;0;1;1;1067;0;1067;1;1;
/org.eclipse.pde.ui/src/org/eclipse/pde/internal/base/schema/ISchemaDescriptor.java;2;0;2;1;0;0;0;2;0;1;2;1434;0;0;1;0;0;2;2;1434;0;3579;2;2;
/org.eclipse.core.tests.runtime/src/org/eclipse/core/tests/internal/runtimetests/SampleNPB.java;1;0;2;1;0;0;0;2;10;1;2;3611;10;10;1;0;0;2;2;3611;0;3678;2;1;
/org.eclipse.update.ui/src/org/eclipse/update/ui/internal/manager/UpdateManagerAction.java;1;0;2;1;0;0;0;2;0;0;1;1426;0;0;2;1;0;2;2;1426;1;1426;1;1;
/org.eclipse.jdt.ui/core extension/org/eclipse/jdt/internal/corext/codemanipulation/TextBuffer.java;2;0;5;1;0;0;0;5;83;2;4;1937;151;151;2;1;0;5;5;2133;1;2133;4;2;
/org.eclipse.jdt.ui/ui/org/eclipse/jdt/internal/ui/reorg/IDeleteSupport.java;2;0;5;1;0;0;0;5;5;1;5;15;10;10;1;0;0;5;5;15;0;1258;5;2;
/org.eclipse.jdt.core/notes/howto/generate parser/UpdateParserFiles.java;1;0;1;1;0;0;0;1;0;0;1;3471;0;0;1;0;0;1;1;3471;0;3471;1;1;
/org.eclipse.jdt.debug.tests/tests/org/eclipse/jdt/debug/tests/core/SuspendVMBreakpointsTests.java;2;1;4;1;4;4;4;0;151;0;0;4307;170;170;1;0;0;0;4;4307;0;4571;4;2;
/org.eclipse.scripting/src/org/eclipse/scripting/IScriptAdapter.java;1;0;1;1;0;0;0;1;0;0;1;1424;0;0;1;0;0;1;1;1424;0;1424;1;1;
/org.eclipse.jdt.ui/ui refactoring/org/eclipse/jdt/internal/ui/refactoring/InlineTempWizard.java;2;0;4;1;0;0;0;4;2;1;4;2015;4;4;1;0;0;4;4;2015;0;2298;4;2;
/org.eclipse.debug.ui/ui/org/eclipse/debug/internal/ui/launchConfigurations/PerspectiveManager.java;4;1;31;2;2;2;2;29;151;3;21;2275;763;763;3;8;0;29;31;2309;8;4403;23;4;
/org.eclipse.ui/Eclipse UI Standard Components/org/eclipse/ui/views/framelist/Frame.java;1;0;1;1;0;0;0;1;0;0;1;3498;0;0;1;0;0;1;1;3498;0;3498;1;1;
/org.eclipse.core.target/src/org/eclipse/core/internal/target/ResourceMapping.java;1;0;4;1;1;1;1;3;108;1;3;12;135;135;1;0;0;3;4;12;0;4196;4;1;
/org.eclipse.jdt.core/model/org/eclipse/jdt/internal/core/lookup/ReferenceInfo.java;1;0;11;1;0;0;0;11;74;4;7;455;135;135;4;4;0;11;11;1039;4;2811;7;1;
/org.eclipse.team.ui/src/org/eclipse/team/ui/sync/CatchupReleaseViewer.java;2;2;11;1;5;4;5;6;133;1;6;2233;226;226;2;0;1;6;11;3937;1;4005;10;2;
/org.eclipse.jdt.debug.tests/test plugin/org/eclipse/jdt/debug/testplugin/JavaProjectHelper.java;2;0;3;1;1;1;1;2;12;1;2;3701;14;14;1;0;0;2;3;3701;0;4328;3;2;
/org.eclipse.ui/Eclipse UI Standard Components/org/eclipse/ui/wizards/datatransfer/WizardFileSystemImportPage1.java;3;0;3;1;0;0;0;3;72;1;3;257;73;73;1;0;0;3;3;257;0;2738;3;3;
/org.eclipse.jdt.ui.tests.refactoring/resources/SelectionAnalyzerWorkSpace/SelectionAnalyzerTests/validSelection/A_test245.java;1;0;1;1;0;0;0;1;0;0;1;1368;0;0;1;0;0;1;1;1368;0;1368;1;1;
/org.eclipse.jdt.debug/jdi interfaces/com/sun/jdi/VMMismatchException.java;2;0;2;1;0;0;0;2;4;1;2;2704;4;4;1;0;0;2;2;2704;0;3033;2;2;
/org.eclipse.ui/Eclipse UI Standard Components/org/eclipse/ui/wizards/datatransfer/FileSystemImportWizard.java;2;0;3;1;0;0;0;3;17;1;3;257;24;24;1;0;0;3;3;257;0;2568;3;2;
/org.eclipse.pde.ui/src/org/eclipse/pde/internal/ui/parts/SharedPartWithButtons.java;1;0;1;1;0;0;0;1;0;0;1;3579;0;0;1;0;0;1;1;3579;0;3579;1;1;
/org.eclipse.jdt.ui.tests.refactoring/resources/RenameTemp/canRename/A_test18_out.java;1;0;2;1;0;0;0;2;2;1;2;1625;2;2;1;0;0;2;2;1625;0;1652;2;1;
/org.eclipse.help/Eclipse Help/org/eclipse/help/internal/util/SearchableDocFileNameFilter.java;2;0;3;1;0;0;0;3;7;1;3;135;7;7;1;0;0;3;3;135;0;890;3;2;
/org.eclipse.update.ui/src/org/eclipse/update/ui/internal/model/UpdateModel.java;1;0;11;1;0;0;0;11;50;2;10;1526;134;134;2;1;0;11;11;1526;1;2797;10;1;
/org.eclipse.jdt.debug/model/org/eclipse/jdt/debug/core/IJavaModifiers.java;3;0;4;1;0;0;0;4;70;1;4;187;85;85;1;0;0;4;4;187;0;3571;4;3;
/org.eclipse.pde.ui/src/org/eclipse/pde/internal/wizards/imports/UpdateBuildpathWizardPage.java;1;0;8;1;0;0;0;8;102;1;8;2650;209;209;1;0;0;8;8;2650;0;3579;8;1;
/org.eclipse.jdt.ui/core refactoring/org/eclipse/jdt/internal/corext/refactoring/nls/NLSLine.java;2;0;2;1;1;1;1;1;4;0;1;1939;4;4;1;0;0;1;2;1939;0;3948;2;2;
/org.eclipse.swt/Eclipse SWT Drag and Drop/motif/org/eclipse/swt/dnd/DropTarget.java;3;1;9;1;5;5;5;4;197;1;4;106;709;709;1;0;0;4;9;106;0;4824;9;3;
/org.eclipse.swt/Eclipse SWT PI/win32/org/eclipse/swt/internal/win32/CHOOSECOLOR.java;2;0;2;1;1;1;1;1;6;0;1;2069;6;6;1;0;0;1;2;2069;0;4701;2;2;
/org.eclipse.ui.tests/Eclipse UI Tests/org/eclipse/ui/tests/zoom/OpenEditorTest.java;1;0;1;1;0;0;0;1;0;0;1;3633;0;0;1;0;0;1;1;3633;0;3633;1;1;
/org.eclipse.jdt.ui.tests.refactoring/resources/RenameVariables/cannotRename/A_testFail8.java;1;0;2;1;0;0;0;2;0;1;2;724;0;0;1;0;0;2;2;724;0;1665;2;1;
/org.eclipse.jdt.ui/ui/org/eclipse/jdt/internal/ui/viewsupport/MarkerErrorTickManager.java;1;0;2;1;0;0;0;2;0;1;2;1035;0;0;1;0;0;2;2;1035;0;1256;2;1;
/org.eclipse.jdt.ui/ui/org/eclipse/jdt/internal/ui/javaeditor/ProblemAnnotationIterator.java;1;0;2;1;1;1;1;1;16;0;1;3418;16;16;1;0;0;1;2;3418;0;4167;2;1;
/org.eclipse.jdt.junit/Eclipse JUnit/org/eclipse/jdt/junit/internal/util/VerifyDialog.java;2;0;2;1;0;0;0;2;0;1;2;1511;0;0;1;0;0;2;2;1511;0;1996;2;2;
/org.eclipse.jdt.ui.tests.refactoring/resources/ExtractMethodWorkSpace/ExtractMethodTests/locals_in/A_test562.java;1;1;3;1;2;2;2;1;26;0;1;1236;26;26;1;0;0;1;3;1236;0;4419;3;1;
/org.eclipse.pde.ui/src/org/eclipse/pde/internal/editor/component/ComponentAdapterFactory.java;2;0;2;1;0;0;0;2;0;1;2;1434;0;0;1;0;0;2;2;1434;0;2951;2;2;
/org.eclipse.debug.ui/ui/org/eclipse/debug/internal/ui/DebugDropDownAction.java;3;0;7;1;0;0;0;7;7;1;7;187;22;22;1;0;0;7;7;187;0;2382;7;3;
/org.eclipse.help/src/org/eclipse/help/internal/context/IContextManager.java;1;0;2;1;0;0;0;2;0;1;2;1675;0;0;1;0;0;2;2;1675;0;2217;2;1;
/org.eclipse.jdt.ui.tests/refactoring/experiments/ReorderParametersRefactoring.java;1;0;6;1;0;0;0;6;39;1;6;729;88;88;1;0;0;6;6;729;0;1895;6;1;
/org.eclipse.jdt.core/model/org/eclipse/jdt/internal/core/newbuilder/JavaBuilder.java;2;0;34;1;0;0;0;34;202;6;26;1764;657;657;6;8;0;34;34;1845;8;2979;26;2;
/org.eclipse.jdt.ui/ui/org/eclipse/jdt/internal/ui/snippeteditor/ScrapbookMain1.java;3;0;3;1;0;0;0;3;2;1;3;569;2;2;1;0;0;3;3;569;0;1916;3;3;
/org.eclipse.ui/Eclipse UI/org/eclipse/ui/help/WorkbenchHelp.java;4;0;8;1;1;1;1;7;211;1;7;257;322;322;1;0;0;7;8;257;0;4754;8;4;
/org.eclipse.jdt.core/search/org/eclipse/jdt/internal/core/search/matching/TypeReferencePattern.java;3;2;25;2;8;6;8;17;2556;4;13;455;5121;5121;4;4;2;17;25;1039;6;4444;19;3;
/org.eclipse.help/Eclipse Help/org/eclipse/help/internal/contributors/xml/XMLTopicContributor.java;3;0;4;2;0;0;0;4;35;2;3;135;35;35;2;1;0;4;4;323;1;1420;3;3;
/org.eclipse.jdt.debug/eval/org/eclipse/jdt/internal/debug/eval/model/EvaluationInterfaceType.java;2;0;3;1;0;0;0;3;5;1;3;3421;5;5;1;0;0;3;3;3421;0;3645;3;2;
/org.eclipse.jdt.ui/core refactoring/org/eclipse/jdt/internal/corext/refactoring/changes/RenameJavaProjectChange.java;2;0;5;1;1;1;1;4;113;1;4;1939;131;131;1;0;0;4;5;1939;0;4379;5;2;
/org.eclipse.swt/Eclipse SWT/carbon/org/eclipse/swt/graphics/Region.java;3;1;4;1;4;4;4;0;6;0;0;4147;14;14;1;0;0;0;4;4147;0;4701;4;3;
/org.eclipse.swt/Eclipse SWT Drag and Drop/gtk1x/org/eclipse/swt/dnd/TransferData.java;2;0;2;1;0;0;0;2;0;1;2;2107;0;0;1;0;0;2;2;2107;0;3127;2;2;
/org.eclipse.jdt.ui.tests.refactoring/resources/RenameType/test7/out/A.java;1;0;2;1;0;0;0;2;0;1;2;49;0;0;1;0;0;2;2;49;0;522;2;1;
/org.eclipse.jdt.ui.tests.refactoring/resources/ExtractMethodWorkSpace/ExtractMethodTests/validSelection/A_test250.java;2;1;3;1;2;2;2;1;0;0;1;49;0;0;1;0;0;1;3;49;0;4419;3;2;
/org.eclipse.debug.ui/ui/org/eclipse/debug/internal/ui/preferences/ComboFieldEditor.java;2;1;2;1;2;2;2;0;5;0;0;3975;5;5;1;0;0;0;2;3975;0;4065;2;2;
/org.eclipse.ui/Eclipse UI Tool Script/org/eclipse/toolscript/ui/internal/AntLaunchWizardPage.java;1;3;5;1;5;3;5;0;151;0;0;4024;151;151;3;0;2;0;5;4042;2;4087;3;1;
/org.eclipse.scripting/Eclipse Scripting/org/eclipse/scripting/internal/uirenderer/ScriptPreferenceViewer.java;2;0;4;1;0;0;0;4;31;1;4;133;62;62;1;0;0;4;4;133;0;1424;4;2;
/org.eclipse.jdt.ui/ui/org/eclipse/jdt/internal/ui/text/correction/CorrectionMarkerResolution.java;1;0;2;1;2;1;2;0;0;0;0;4161;0;0;2;0;1;0;2;4161;1;4161;1;1;
/org.eclipse.ant.ui/src/org/eclipse/ant/internal/ui/UIBuildListener.java;5;0;17;2;0;0;0;17;556;3;12;14;1128;1128;3;5;0;17;17;369;5;3490;12;5;
/org.eclipse.jdt.ui/core refactoring/org/eclipse/jdt/internal/corext/refactoring/rename/RenamePackageASTAnalyzer.java;2;0;4;1;0;0;0;4;33;1;4;1939;35;35;1;0;0;4;4;1939;0;3373;4;2;
/org.eclipse.pde.ui/src/org/eclipse/pde/internal/view/PluginsLabelProvider.java;1;0;3;1;0;0;0;3;2;2;2;3445;2;2;2;1;0;3;3;3445;1;3579;2;1;
/org.eclipse.jdt.ui.tests.refactoring/resources/ExtractTemp/canExtract/A_test11_out.java;1;0;1;1;0;0;0;1;0;0;1;2481;0;0;1;0;0;1;1;2481;0;2481;1;1;
/org.eclipse.jdt.ui/ui/org/eclipse/jdt/internal/ui/viewsupport/AbstractJavaElementContentProvider.java;2;0;3;1;0;0;0;3;32;1;3;902;32;32;1;0;0;3;3;902;0;1322;3;2;
/org.eclipse.jdt.ui/core extension/org/eclipse/jdt/internal/corext/codemanipulation/ImportEdit.java;3;0;11;1;1;1;1;10;27;1;10;2148;87;87;1;0;0;10;11;2148;0;3908;11;3;
/org.eclipse.pde.ui/src/org/eclipse/pde/internal/core/builders/DependencyLoopFinder.java;1;0;2;1;0;0;0;2;0;1;2;3579;0;0;1;0;0;2;2;3579;0;3607;2;1;
/org.eclipse.jdt.ui/core refactoring/org/eclipse/jdt/internal/core/refactoring/util/Bindings.java;1;0;2;1;0;0;0;2;0;0;1;1927;0;0;2;1;0;2;2;1927;1;1927;1;1;
/org.eclipse.update.core/src/org/eclipse/update/internal/core/SiteURLContentProvider.java;2;1;12;1;2;2;2;10;102;1;10;2501;170;170;1;0;0;10;12;2501;0;4104;12;2;
/org.eclipse.jdt.ui.tests.refactoring/resources/SurroundWithWorkSpace/SurroundWithTests/A.java;1;1;4;1;2;2;2;2;24;1;2;2684;49;49;1;0;0;2;4;2684;0;4014;4;1;
/org.eclipse.jdt.ui.tests.refactoring/resources/SelectionAnalyzerWorkSpace/SelectionAnalyzerTests/validSelection/A_test248.java;1;0;1;1;0;0;0;1;0;0;1;1368;0;0;1;0;0;1;1;1368;0;1368;1;1;
/org.eclipse.vcm.core.cvs/src/org/eclipse/vcm/internal/core/ccvs/DiffEntryIterator.java;2;0;5;1;0;0;0;5;32;1;5;0;65;65;1;0;0;5;5;0;0;1627;5;2;
/org.eclipse.jdt.ui/core refactoring/org/eclipse/jdt/core/refactoring/ChangeContext.java;1;0;3;1;0;0;0;3;5;1;3;157;5;5;1;0;0;3;3;157;0;408;3;1;
/org.eclipse.jdt.debug/eval/org/eclipse/jdt/internal/debug/eval/ast/instructions/PushChar.java;2;0;3;1;0;0;0;3;2;1;3;3421;4;4;1;0;0;3;3;3421;0;3677;3;2;
/org.eclipse.jdt.debug.ui/ui/org/eclipse/jdt/internal/debug/ui/launcher/SocketUtil.java;2;0;5;1;0;0;0;5;15;1;5;1915;24;24;1;0;0;5;5;1915;0;3156;5;2;
/org.eclipse.help.tests/src/org/eclipse/help/tests/launching/DisplayHelpResource_tocHref.java;1;0;2;1;2;1;2;0;15;0;0;4042;15;15;2;0;1;0;2;4042;1;4042;1;1;
/org.eclipse.update/src/org/eclipse/update/internal/ui/UMWizardPageURLInstalling.java;1;0;1;1;0;0;0;1;0;0;1;1424;0;0;1;0;0;1;1;1424;0;1424;1;1;
/org.eclipse.jdt.ui.tests.refactoring/test cases/org/eclipse/jdt/ui/tests/refactoring/infra/FileDocumentManager.java;1;0;2;1;0;0;0;2;0;1;2;1896;0;0;1;0;0;2;2;1896;0;2216;2;1;
/org.eclipse.jdt.ui/core refactoring/org/eclipse/jdt/internal/corext/refactoring/code/flow/FlowInfo.java;1;0;4;1;0;0;0;4;165;1;4;1939;325;325;1;0;0;4;4;1939;0;3106;4;1;
/org.eclipse.jdt.ui/ui refactoring/org/eclipse/jdt/internal/ui/refactoring/actions/CodeToolsMainMenu.java;3;0;5;1;0;0;0;5;6;1;5;15;14;14;1;0;0;5;5;15;0;1345;5;3;
/org.eclipse.ant.ui/src/org/eclipse/ant/internal/ui/AntLogDialog.java;2;0;3;2;0;0;0;3;63;2;2;350;63;63;2;1;0;3;3;357;1;357;2;2;
/org.eclipse.pde.ui/Eclipse PDE UI/org/eclipse/pde/internal/editor/schema/TypeRestrictionDescriptor.java;2;0;5;2;0;0;0;5;12;3;3;267;12;12;3;2;0;5;5;324;2;1434;3;2;
/org.eclipse.jdt.ui.tests.refactoring/test cases/org/eclipse/jdt/ui/nls/tests/AllTests.java;1;0;2;1;0;0;0;2;0;1;2;1939;0;0;1;0;0;2;2;1939;0;2015;2;1;
/org.eclipse.help/src/org/eclipse/help/internal/util/HelpPreferences.java;2;0;5;1;0;0;0;5;88;1;5;1420;98;98;1;0;0;5;5;1420;0;3762;5;2;
/org.eclipse.pde.core/src/org/eclipse/pde/internal/core/plugin/PluginLibrary.java;1;0;1;1;0;0;0;1;0;0;1;3591;0;0;1;0;0;1;1;3591;0;3591;1;1;
/org.eclipse.debug.ui/ui/org/eclipse/debug/internal/ui/RelaunchLastAction.java;3;0;9;1;0;0;0;9;29;2;8;187;63;63;2;1;0;9;9;1885;1;2382;8;3;
/org.eclipse.ui/Eclipse JFace Text/org/eclipse/jface/text/rules/IPredicateRule.java;1;0;2;1;1;1;1;1;36;0;1;3812;36;36;1;0;0;1;2;3812;0;4838;2;1;
/org.eclipse.jdt.core/model/org/eclipse/jdt/internal/core/builder/impl/JavaDevelopmentContextImpl.java;1;0;14;1;0;0;0;14;696;4;10;455;1026;1026;4;4;0;14;14;1039;4;2808;10;1;
/org.eclipse.jdt.core/search/org/eclipse/jdt/internal/core/index/impl/IndexedFileHashedArray.java;2;1;2;1;2;2;2;0;17;0;0;3938;17;17;1;0;0;0;2;3938;0;4063;2;2;
/org.eclipse.jdt.ui.tests.refactoring/resources/MoveMembers/test3/out/A.java;1;0;1;1;0;0;0;1;0;0;1;2738;0;0;1;0;0;1;1;2738;0;2738;1;1;
/org.eclipse.pde.ui/templates/helloWorld/java/SampleAction.java;1;0;4;1;1;1;1;3;4;1;3;3240;6;6;1;0;0;3;4;3240;0;4431;4;1;
/org.eclipse.ui/Eclipse UI/org/eclipse/ui/internal/registry/EditorDescriptor.java;3;0;4;1;0;0;0;4;13;1;4;257;17;17;1;0;0;4;4;257;0;3414;4;3;
/org.eclipse.swt.examples/Eclipse SWT Examples/common/org/eclipse/swt/examples/helloworld/HelloWorld4.java;1;0;2;1;0;0;0;2;0;1;2;107;0;0;1;0;0;2;2;107;0;611;2;1;
/org.eclipse.team.cvs.ui/src/org/eclipse/team/internal/ccvs/ui/CVSLocalCompareEditorInput.java;2;1;6;1;5;5;5;1;88;0;1;3794;126;126;1;0;0;1;6;3794;0;4633;6;2;
/org.eclipse.update.examples/src/org/eclipse/update/examples/buildzip/BuildZipContentProvider.java;2;0;6;1;0;0;0;6;229;1;6;2553;293;293;1;0;0;6;6;2553;0;2762;6;2;
/org.eclipse.jdt.ui.tests/refactoring/org/eclipse/jdt/refactoring/tests/RenamePackageTests.java;4;0;16;1;0;0;0;16;70;2;15;49;172;172;2;1;0;16;16;1342;1;1896;15;4;
/org.eclipse.help/src/org/eclipse/help/internal/contributors/ContextContributor.java;2;0;2;1;0;0;0;2;0;1;2;1420;0;0;1;0;0;2;2;1420;0;1675;2;2;
/org.eclipse.jdt.ui.tests.refactoring/resources/MoveCU/test0/out/p1/C.java;2;0;2;1;0;0;0;2;0;1;2;49;0;0;1;0;0;2;2;49;0;2769;2;2;
/org.eclipse.jdt.core/model/org/eclipse/jdt/internal/core/builder/MissingSourceFileException.java;2;0;2;1;1;1;1;1;15;0;1;3743;15;15;1;0;0;1;2;3743;0;4063;2;2;
/org.eclipse.jdt.core/model/org/eclipse/jdt/internal/core/CreateMethodOperation.java;2;1;11;1;2;2;2;9;148;4;6;455;198;198;4;3;0;9;11;1039;3;4063;8;2;
/org.eclipse.pde.ui/src/org/eclipse/pde/internal/ui/wizards/extension/NewExtensionPointWizard.java;1;0;1;1;0;0;0;1;0;0;1;3579;0;0;1;0;0;1;1;3579;0;3579;1;1;
/org.eclipse.jdt.ui.tests/examples/org/eclipse/jdt/ui/examples/MultiElementListSelectorExample.java;3;0;4;1;1;1;1;3;23;1;3;1186;48;48;1;0;0;3;4;1186;0;4682;4;3;
/org.eclipse.jdt.ui/ui/org/eclipse/jdt/internal/ui/util/BusyIndicatorRunnableContext.java;3;0;7;1;0;0;0;7;138;1;7;15;188;188;1;0;0;7;7;15;0;1310;7;3;
/org.eclipse.pde.ui/src/org/eclipse/pde/internal/ui/editor/text/IPDEColorConstants.java;1;0;2;1;1;1;1;1;7;0;1;3579;7;7;1;0;0;1;2;3579;0;4588;2;1;
/org.eclipse.team.cvs.core/src/org/eclipse/team/internal/ccvs/core/resources/api/IManagedResource.java;3;0;4;1;0;0;0;4;278;1;4;1978;280;280;1;0;0;4;4;1978;0;2156;4;3;
/org.eclipse.jdt.ui.tests/refactoring/org/eclipse/jdt/refactoring/tests/infra/TestExceptionHandler.java;2;0;4;1;0;0;0;4;5;1;4;158;7;7;1;0;0;4;4;158;0;1896;4;2;
/org.eclipse.jdt.core/compiler/org/eclipse/jdt/internal/compiler/ast/Case.java;2;0;15;1;1;1;1;14;141;4;11;455;370;370;4;3;0;14;15;1039;3;4062;12;2;
/org.eclipse.team.cvs.ssh/src/org/eclipse/team/internal/ccvs/ssh/SSHServerConnection.java;3;0;4;1;0;0;0;4;157;1;4;1978;165;165;1;0;0;4;4;1978;0;3610;4;3;
/org.eclipse.update.tests.core/src/org/eclipse/update/tests/configurations/TestRevert.java;2;1;21;1;5;5;5;16;22;2;14;2180;142;142;2;2;0;16;21;2180;2;4249;19;2;
/org.eclipse.help/Eclipse Help/org/eclipse/help/internal/util/Logger.java;4;0;5;1;0;0;0;5;7;1;5;135;18;18;1;0;0;5;5;135;0;1420;5;4;
/org.eclipse.swt/Eclipse SWT/win32/org/eclipse/swt/internal/win32/LVHITTESTINFO.java;2;0;3;1;0;0;0;3;5;1;3;106;5;5;1;0;0;3;3;106;0;2069;3;2;
/org.eclipse.debug.ui/ui/org/eclipse/debug/internal/ui/launchConfigurations/RunHistoryPreferenceTab.java;3;1;6;2;2;2;2;4;27;3;2;3132;36;36;3;2;0;4;6;3132;2;4207;4;3;
/org.eclipse.update.ui/src/org/eclipse/update/internal/ui/parts/IUpdateFormPage.java;1;0;9;1;0;0;0;9;5;1;9;1428;12;12;1;0;0;9;9;1428;0;3662;9;1;
/org.eclipse.jdt.ui.tests.refactoring/resources/PullUp/testFail12/in/A.java;1;0;1;1;0;0;0;1;0;0;1;2406;0;0;1;0;0;1;1;2406;0;2406;1;1;
/org.eclipse.jdt.ui.tests.refactoring/resources/PullUpMethods/test4/in/A.java;1;0;2;1;0;0;0;2;0;1;2;2156;0;0;1;0;0;2;2;2156;0;2406;2;1;
/org.eclipse.pde.ui/Eclipse PDE UI/org/eclipse/pde/internal/base/model/build/IBuildEntry.java;2;0;5;2;0;0;0;5;12;3;3;267;12;12;3;2;0;5;5;324;2;1434;3;2;
/org.eclipse.team.cvs.ui/src/org/eclipse/team/internal/ccvs/ui/TeamResourceDecorator.java;1;0;2;1;0;0;0;2;0;1;2;2484;0;0;1;0;0;2;2;2484;0;2690;2;1;
/org.eclipse.jdt.ui.tests.refactoring/resources/ExtractTemp/canExtract/A_test27_in.java;1;0;1;1;0;0;0;1;0;0;1;3105;0;0;1;0;0;1;1;3105;0;3105;1;1;
/org.eclipse.ui/Eclipse UI/org/eclipse/ui/dialogs/ElementTreeSelectionDialog.java;1;0;3;1;1;1;1;2;23;1;2;3733;29;29;1;0;0;2;3;3733;0;4451;3;1;
/org.eclipse.jdt.ui.tests.refactoring/resources/RenameVariables/canRename/A_test30_out.java;1;0;2;1;0;0;0;2;0;1;2;724;0;0;1;0;0;2;2;724;0;1665;2;1;
/org.eclipse.swt/Eclipse SWT/win32/org/eclipse/swt/internal/win32/LVCOLUMN.java;2;0;3;1;0;0;0;3;5;1;3;106;5;5;1;0;0;3;3;106;0;2069;3;2;
/org.eclipse.swt/Eclipse SWT/gtk1x/org/eclipse/swt/widgets/Sash.java;3;0;3;1;1;1;1;2;6;1;2;2107;8;8;1;0;0;2;3;2107;0;4701;3;3;
/org.eclipse.jdt.core/model/org/eclipse/jdt/internal/core/WorkingCopy.java;3;1;49;2;5;5;5;44;575;4;33;455;1330;1330;4;11;0;44;49;1039;11;4424;38;3;
/org.eclipse.update.core/src/org/eclipse/update/core/IProblemHandler.java;1;0;4;1;0;0;0;4;9;2;3;2216;11;11;2;1;0;4;4;2216;1;3018;3;1;
/org.eclipse.pde/src/org/eclipse/pde/internal/FeatureProject.java;1;0;1;1;0;0;0;1;0;0;1;3631;0;0;1;0;0;1;1;3631;0;3631;1;1;
/org.eclipse.jdt.debug/eval/org/eclipse/jdt/internal/debug/eval/ast/engine/PushString.java;1;0;3;1;0;0;0;3;56;1;3;3329;56;56;1;0;0;3;3;3329;0;3421;3;1;
/org.eclipse.jdt.ui/ui/org/eclipse/jdt/internal/ui/wizards/dialogfields/Separator.java;2;0;4;1;0;0;0;4;31;1;4;15;42;42;1;0;0;4;4;15;0;3084;4;2;
/org.eclipse.jdt.ui.tests/refactoring/org/eclipse/jdt/refactoring/tests/RenamePrivateFieldTests.java;4;0;14;1;0;0;0;14;24;1;14;49;117;117;1;0;0;14;14;49;0;1896;14;4;
/org.eclipse.webdav/src/kernel/org/eclipse/webdav/internal/kernel/ClientException.java;1;0;4;1;1;1;1;3;110;1;3;12;130;130;1;0;0;3;4;12;0;4211;4;1;
/org.eclipse.team.core/src/org/eclipse/team/internal/core/target/ResourceState.java;4;4;26;2;26;17;26;0;436;0;0;4010;1532;1532;4;0;9;0;26;4367;9;4636;17;4;
/org.eclipse.pde.ui/Eclipse PDE UI/org/eclipse/pde/internal/schema/SchemaType.java;2;0;5;2;0;0;0;5;12;3;3;267;12;12;3;2;0;5;5;324;2;1434;3;2;
/org.eclipse.pde.ui/src/org/eclipse/pde/internal/editor/manifest/ManifestFormPage.java;2;0;5;1;0;0;0;5;18;1;5;1434;26;26;1;0;0;5;5;1434;0;3579;5;2;
/org.eclipse.jdt.ui.tests.refactoring/resources/SefWorkSpace/SefTests/object_out/TestSimpleRead.java;1;0;1;1;0;0;0;1;0;0;1;2155;0;0;1;0;0;1;1;2155;0;2155;1;1;
/org.eclipse.ui.externaltools/External Tools/org/eclipse/ui/externaltools/internal/ui/AntTargetLabelProvider.java;1;1;3;1;3;3;3;0;7;0;0;4090;9;9;1;0;0;0;3;4090;0;4188;3;1;
/org.eclipse.jdt.ui.tests.refactoring/resources/ExtractMethodWorkSpace/ExtractMethodTests/invalidSelection/A_test071.java;2;1;3;1;2;2;2;1;0;0;1;49;0;0;1;0;0;1;3;49;0;4419;3;2;
/org.eclipse.ui.examples.javaeditor/Eclipse Java Editor Example/org/eclipse/ui/examples/javaeditor/JavaEditor.java;1;0;1;1;0;0;0;1;0;0;1;1067;0;0;1;0;0;1;1;1067;0;1067;1;1;
/org.eclipse.scripting/src/org/eclipse/scripting/ScriptAdapterWorkbenchResourceExportWizard.java;1;0;1;1;0;0;0;1;0;0;1;1424;0;0;1;0;0;1;1;1424;0;1424;1;1;
/org.eclipse.jdt.ui.tests.refactoring/resources/RenameType/testFail03/in/A.java;1;0;1;1;0;0;0;1;0;0;1;49;0;0;1;0;0;1;1;49;0;49;1;1;
/org.eclipse.pde.ui/Eclipse PDE UI/org/eclipse/pde/internal/schema/SchemaComplexType.java;2;0;5;2;0;0;0;5;12;3;3;267;12;12;3;2;0;5;5;324;2;1434;3;2;
/org.eclipse.jdt.ui.tests.refactoring/resources/DeleteSourceReference/A_testField3_out.java;1;0;2;1;0;0;0;2;0;1;2;2003;0;0;1;0;0;2;2;2003;0;2857;2;1;
/org.eclipse.jdt.debug/jdi/org/eclipse/jdi/internal/StringReferenceImpl.java;2;0;5;1;0;0;0;5;21;1;5;187;43;43;1;0;0;5;5;187;0;3678;5;2;
/org.eclipse.jdt.ui/core refactoring/org/eclipse/jdt/internal/core/refactoring/UndoManager.java;3;0;11;1;0;0;0;11;68;1;11;15;240;240;1;0;0;11;11;15;0;1939;11;3;
/org.eclipse.pde.runtime/Eclipse PDE Runtime/org/eclipse/pde/internal/runtime/registry/ConfigurationElementPropertySource.java;2;0;3;1;0;0;0;3;4;1;3;267;4;4;1;0;0;3;3;267;0;1434;3;2;
/org.eclipse.jdt.ui/ui/org/eclipse/jdt/internal/ui/filters/EmptyPackageFilter.java;1;0;1;1;1;1;1;0;0;0;0;4211;0;0;1;0;0;0;1;4211;0;4211;1;1;
/org.eclipse.team.examples.filesystem/src/org/eclipse/team/examples/filesystem/FileSystemProvider.java;1;1;2;1;2;2;2;0;9;0;0;4674;9;9;1;0;0;0;2;4674;0;4727;2;1;
/org.eclipse.jdt.ui/ui/org/eclipse/jdt/internal/ui/wizards/buildpaths/VariablePathDialogField.java;4;1;8;1;2;2;2;6;4;1;6;354;16;16;1;0;0;6;8;354;0;4630;8;4;
/org.eclipse.jdt.ui/ui/org/eclipse/jdt/internal/ui/launcher/VMLabelProvider.java;2;0;5;1;0;0;0;5;24;2;3;218;34;34;2;2;0;5;5;218;2;1916;3;2;
/org.eclipse.jdt.ui.tests.refactoring/resources/ExtractMethodWorkSpace/ExtractMethodTests/invalidSelection/A_test151.java;2;1;3;1;2;2;2;1;12;0;1;254;12;12;1;0;0;1;3;254;0;4419;3;2;
/org.eclipse.ui/Eclipse UI/org/eclipse/ui/internal/dialogs/MultiStepCapabilityWizard.java;1;0;2;1;0;0;0;2;6;1;2;3487;6;6;1;0;0;2;2;3487;0;3506;2;1;
/org.eclipse.jdt.launching/launching/org/eclipse/jdt/internal/launching/Standard11xVM.java;1;0;1;1;1;1;1;0;0;0;0;4572;0;0;1;0;0;0;1;4572;0;4572;1;1;
/org.eclipse.update.ui/src/org/eclipse/update/internal/ui/wizards/NewFolderWizardPage.java;2;1;3;1;2;2;2;1;7;0;1;3653;9;9;1;0;0;1;3;3653;0;4610;3;2;
/org.eclipse.jdt.ui.tests.refactoring/resources/RenameNonPrivateField/test6/in/A.java;2;0;3;1;0;0;0;3;6;1;3;49;8;8;1;0;0;3;3;49;0;1575;3;2;
/org.eclipse.team.cvs.ui/src/org/eclipse/team/internal/ccvs/ui/ConsoleDocument.java;2;0;3;1;1;1;1;2;50;1;2;3452;52;52;1;0;0;2;3;3452;0;4088;3;2;
/org.eclipse.jdt.ui/ui/org/eclipse/jdt/ui/wizards/NewElementWizardPage.java;2;0;3;1;1;1;1;2;36;1;2;3089;39;39;1;0;0;2;3;3089;0;4823;3;2;
/org.eclipse.jdt.ui/ui/org/eclipse/jdt/internal/ui/search/SearchMessages.java;1;0;4;1;0;0;0;4;17;1;4;689;34;34;1;0;0;4;4;689;0;3318;4;1;
/org.eclipse.jdt.ui.tests.refactoring/resources/ExtractMethodWorkSpace/ExtractMethodTests/validSelection/A_test235.java;2;1;3;1;2;2;2;1;0;0;1;49;0;0;1;0;0;1;3;49;0;4419;3;2;
/org.eclipse.jdt.ui.tests.refactoring/resources/RenameMethodInInterface/testFail39/in/A.java;1;0;1;1;0;0;0;1;0;0;1;49;0;0;1;0;0;1;1;49;0;49;1;1;
/org.eclipse.core.tests.runtime/src/org/eclipse/core/tests/internal/plugins/FragmentResolveTest_5.java;3;0;4;1;0;0;0;4;194;1;4;1819;205;205;1;0;0;4;4;1819;0;3476;4;3;
/org.eclipse.jdt.ui.tests.refactoring/resources/RenameTemp/canRename/A_test41_out.java;1;0;1;1;0;0;0;1;0;0;1;3322;0;0;1;0;0;1;1;3322;0;3322;1;1;
/org.eclipse.ui/Eclipse UI/org/eclipse/ui/internal/registry/PerspectiveDescriptor.java;6;0;8;1;1;1;1;7;18;2;6;257;47;47;2;1;0;7;8;1359;1;4573;7;6;
/org.eclipse.swt/Eclipse SWT/carbon/org/eclipse/swt/widgets/FileDialog.java;3;1;4;1;4;4;4;0;30;0;0;4147;42;42;1;0;0;0;4;4147;0;4701;4;3;
/org.eclipse.ant.core/src/org/eclipse/ant/core/AntScriptRunner.java;1;0;1;1;0;0;0;1;0;0;1;3441;0;0;1;0;0;1;1;3441;0;3441;1;1;
/org.eclipse.help/src/RequestParamExample.java;1;0;2;1;0;0;0;2;0;1;2;1882;0;0;1;0;0;2;2;1882;0;1930;2;1;
/org.eclipse.jdt.ui.tests.refactoring/resources/SelectionAnalyzerWorkSpace/SelectionAnalyzerTests/invalidSelection/A_test048.java;2;0;2;1;0;0;0;2;0;1;2;1368;0;0;1;0;0;2;2;1368;0;2139;2;2;
/org.eclipse.jdt.core/search/org/eclipse/jdt/internal/core/index/impl/GammaCompressedIndexBlock.java;2;0;3;1;1;1;1;2;68;1;2;455;84;84;1;0;0;2;3;455;0;4063;3;2;
/org.eclipse.help.ui/Eclipse Help UI Win32/org/eclipse/help/internal/ui/win32/NestedPrintDelegate.java;3;0;4;1;0;0;0;4;11;1;4;136;18;18;1;0;0;4;4;136;0;1420;4;3;
/org.eclipse.jdt.ui/ui/org/eclipse/jdt/internal/ui/preferences/CodeFormatterPreferencePage.java;6;1;37;1;5;5;5;32;692;2;29;28;2987;2987;2;3;0;32;37;95;3;4428;34;6;
/org.eclipse.jdt.ui.tests.refactoring/resources/RenameParameters/canRename/A_test4_out.java;1;0;1;1;0;0;0;1;0;0;1;233;0;0;1;0;0;1;1;233;0;233;1;1;
/org.eclipse.team.cvs.ui/src/org/eclipse/team/internal/ccvs/ui/TagAsVersionDialog.java;2;2;7;1;7;6;7;0;34;0;0;3957;56;56;2;0;1;0;7;3957;1;4455;6;2;
/org.eclipse.swt/Eclipse SWT/win32/org/eclipse/swt/widgets/Canvas.java;6;2;8;1;3;2;3;5;10;1;5;106;37;37;2;0;1;5;8;4557;1;4701;7;6;
/org.eclipse.jdt.ui/core refactoring/org/eclipse/jdt/internal/core/refactoring/rename/RenameParametersRefactoring.java;2;0;6;1;0;0;0;6;159;2;5;1342;216;216;2;1;0;6;6;1937;1;1937;5;2;
/org.eclipse.jdt.ui/ui refactoring/org/eclipse/jdt/internal/ui/refactoring/nls/ListDialog.java;1;0;2;1;0;0;0;2;0;1;2;1922;0;0;1;0;0;2;2;1922;0;1944;2;1;
/org.eclipse.swt/Eclipse SWT Drag and Drop/carbon/org/eclipse/swt/dnd/DragSource.java;4;1;6;1;6;6;6;0;375;0;0;4147;502;502;1;0;0;0;6;4147;0;4824;6;4;
/org.eclipse.team.cvs.core/src/org/eclipse/team/internal/ccvs/core/response/StaticHandler.java;3;0;5;1;0;0;0;5;212;1;5;1978;381;381;1;0;0;5;5;1978;0;2607;5;3;
/org.eclipse.swt.tests/JUnit Tests/org/eclipse/swt/tests/junit/Test_org_eclipse_swt_custom_LineBackgroundListener.java;2;0;2;1;1;1;1;1;6;0;1;1792;6;6;1;0;0;1;2;1792;0;4706;2;2;
/org.eclipse.vcm.core.cvs/src/org/eclipse/vcm/internal/core/ccvs/Context.java;4;0;5;1;0;0;0;5;71;1;5;0;117;117;1;0;0;5;5;0;0;1002;5;4;
/org.eclipse.compare/compare/org/eclipse/compare/internal/AbstractViewer.java;2;0;3;1;0;0;0;3;5;1;3;14;7;7;1;0;0;3;3;14;0;1802;3;2;
/org.eclipse.pde.ui/src/org/eclipse/pde/internal/ui/model/ifeature/IFeatureInstallHandler.java;1;0;2;1;0;0;0;2;0;1;2;3579;0;0;1;0;0;2;2;3579;0;3591;2;1;
/org.eclipse.jdt.ui.tests.refactoring/resources/RenamePackage/test0/in/p/A.java;2;0;2;1;0;0;0;2;0;1;2;49;0;0;1;0;0;2;2;49;0;1258;2;2;
/org.eclipse.jdt.debug.ui/ui/org/eclipse/jdt/internal/debug/ui/launcher/SourceLookupBlock2.java;1;1;3;1;3;3;3;0;42;0;0;3927;43;43;1;0;0;0;3;3927;0;3958;3;1;
/org.eclipse.jdt.ui/ui/org/eclipse/jdt/internal/ui/text/javadoc/JavaDoc2HTMLTextReader.java;3;2;8;2;3;2;3;5;186;2;4;1384;441;441;2;1;1;5;8;1482;2;4641;6;3;
/org.eclipse.jdt.ui.tests.refactoring/resources/RenameType/testFail90/in/A.java;1;0;1;1;0;0;0;1;0;0;1;49;0;0;1;0;0;1;1;49;0;49;1;1;
/org.eclipse.team.ui/src/org/eclipse/team/internal/ui/target/TargetCatchupReleaseViewer.java;3;3;7;1;7;5;7;0;50;0;0;4215;97;97;3;0;2;0;7;4244;2;4636;5;3;
/org.eclipse.team.cvs.core/src/org/eclipse/team/internal/ccvs/core/resources/CVSFileNotFoundException.java;1;0;2;1;0;0;0;2;0;1;2;2156;0;0;1;0;0;2;2;2156;0;3089;2;1;
/org.eclipse.jdt.ui.tests.refactoring/resources/PullUpMethods/test4/out/A.java;1;0;4;1;0;0;0;4;2;1;4;2156;3;3;1;0;0;4;4;2156;0;2406;4;1;
/org.eclipse.ui/Eclipse UI/org/eclipse/ui/actions/ImportResourcesAction.java;3;3;8;2;7;5;7;1;79;0;1;3739;166;166;3;0;2;1;8;3916;2;4385;6;3;
/org.eclipse.help/src/org/eclipse/help/internal/protocols/SearchURL.java;2;2;9;1;4;3;4;5;159;1;5;2694;190;190;2;0;1;5;9;4000;1;4043;8;2;
/org.eclipse.pde.ui/Eclipse PDE UI/org/eclipse/pde/internal/editor/text/PDEWhitespaceDetector.java;2;0;5;2;0;0;0;5;12;3;3;267;12;12;3;2;0;5;5;324;2;1434;3;2;
/org.eclipse.jdt.debug.tests/tests/org/eclipse/jdt/debug/tests/eval/BooleanAssignmentOperatorsTests.java;2;2;3;2;3;2;3;0;18;0;0;4447;20;20;2;0;1;0;3;4447;1;4571;2;2;
/org.eclipse.jdt.ui.tests.refactoring/resources/RenamePrivateMethod/test13/in/A.java;1;0;1;1;0;0;0;1;0;0;1;49;0;0;1;0;0;1;1;49;0;49;1;1;
/org.eclipse.jdt.ui.tests.refactoring/resources/ExtractMethodWorkSpace/ExtractMethodTests/locals_out/A_test520.java;1;1;3;1;2;2;2;1;0;0;1;922;0;0;1;0;0;1;3;922;0;4419;3;1;
/org.eclipse.jdt.ui/ui/org/eclipse/jdt/ui/wizards/NewInterfaceWizardPage.java;3;1;4;1;2;2;2;2;33;1;2;3089;45;45;1;0;0;2;4;3089;0;4823;4;3;
/org.eclipse.ui/Eclipse UI/org/eclipse/ui/dialogs/ProjectLocationSelectionDialog.java;7;0;12;1;1;1;1;11;94;1;11;257;171;171;1;0;0;11;12;257;0;3918;12;7;
/org.eclipse.scripting/Eclipse Scripting/org/eclipse/scripting/internal/uirenderer/ScriptWizardPage.java;2;0;4;1;0;0;0;4;14;1;4;133;18;18;1;0;0;4;4;133;0;1424;4;2;
/org.eclipse.pde.ui/src/org/eclipse/pde/internal/core/plugin/PluginModelFactory.java;1;0;3;1;0;0;0;3;4;2;2;3579;4;4;2;1;0;3;3;3579;1;3607;2;1;
/org.eclipse.update.tests.core/src/org/eclipse/update/tests/api/TestUpdateManagerUtilsAPI.java;1;0;6;1;0;0;0;6;84;2;5;1674;146;146;2;1;0;6;6;1815;1;2589;5;1;
/org.eclipse.pde.ui/src/org/eclipse/pde/internal/editor/feature/NewFeaturePluginWizard.java;1;0;2;1;0;0;0;2;0;1;2;2953;0;0;1;0;0;2;2;2953;0;3579;2;1;
/org.eclipse.swt/Eclipse SWT PI/gtk1x/org/eclipse/swt/internal/gtk/GtkColorSelectionDialog.java;2;0;2;1;1;1;1;1;3;0;1;2107;3;3;1;0;0;1;2;2107;0;4701;2;2;
/org.eclipse.jdt.ui.tests.refactoring/resources/SelectionAnalyzerWorkSpace/SelectionAnalyzerTests/invalidSelection/A_test101.java;1;0;1;1;0;0;0;1;0;0;1;1368;0;0;1;0;0;1;1;1368;0;1368;1;1;
/org.eclipse.jdt.ui/core refactoring/org/eclipse/jdt/internal/corext/refactoring/code/flow/DoWhileFlowInfo.java;1;0;1;1;0;0;0;1;0;0;1;1939;0;0;1;0;0;1;1;1939;0;1939;1;1;
/org.eclipse.swt/Eclipse SWT PI/win32/org/eclipse/swt/internal/win32/NMTTDISPINFO.java;3;0;3;1;1;1;1;2;6;1;2;2069;10;10;1;0;0;2;3;2069;0;4701;3;3;
/org.eclipse.swt/Eclipse SWT Printing/photon/org/eclipse/swt/printing/PrintDialog.java;4;1;7;1;3;3;3;4;286;1;4;135;524;524;1;0;0;4;7;135;0;4701;7;4;
/org.eclipse.jdt.debug.tests/test programs/TestIO.java;1;0;2;1;0;0;0;2;0;1;2;3701;0;0;1;0;0;2;2;3701;0;3719;2;1;
/org.eclipse.ant.ui/src/org/eclipse/ant/internal/ui/HackUIBuildListener.java;1;0;1;1;0;0;0;1;0;0;1;3365;0;0;1;0;0;1;1;3365;0;3365;1;1;
/org.eclipse.scripting/Eclipse Scripting/org/eclipse/scripting/internal/ScriptToolkitUI.java;2;0;4;1;0;0;0;4;34;1;4;133;38;38;1;0;0;4;4;133;0;1424;4;2;
/org.eclipse.ui.externaltools/External Tools/org/eclipse/ui/externaltools/internal/ui/AntPage.java;1;0;1;1;1;1;1;0;0;0;0;4123;0;0;1;0;0;0;1;4123;0;4123;1;1;
/org.eclipse.jdt.ui.tests.refactoring/resources/RenameStaticMethod/test7/in/A.java;1;0;1;1;0;0;0;1;0;0;1;49;0;0;1;0;0;1;1;49;0;49;1;1;
/org.eclipse.help/src/org/eclipse/help/internal/context/ContextManager.java;2;0;12;2;0;0;0;12;136;2;11;1675;464;464;2;1;0;12;12;3093;1;3400;11;2;
/org.eclipse.update.ui/src/org/eclipse/update/internal/ui/wizards/LicensePage.java;3;1;18;1;6;6;6;12;288;2;11;1703;651;651;2;1;0;12;18;2434;1;4630;17;3;
/org.eclipse.update.core/src/org/eclipse/update/core/BaseSiteFactory.java;2;1;18;2;2;2;2;16;83;2;13;2465;389;389;2;3;0;16;18;2976;3;4104;15;2;
/org.eclipse.team.ui/src/org/eclipse/team/internal/ui/NatureToPropertyAction.java;3;1;3;1;3;3;3;0;53;0;0;4514;104;104;1;0;0;0;3;4514;0;4730;3;3;
/org.eclipse.jdt.ui/core refactoring/org/eclipse/jdt/internal/core/refactoring/reorg/AddImportUtil.java;2;0;2;1;0;0;0;2;0;1;2;1877;0;0;1;0;0;2;2;1877;0;1939;2;2;
/org.eclipse.jdt.ui.tests.refactoring/resources/RenameType/testFail26/in/A.java;1;0;1;1;0;0;0;1;0;0;1;49;0;0;1;0;0;1;1;49;0;49;1;1;
/org.eclipse.update.core/src/org/eclipse/update/internal/core/TargetFeature.java;1;0;3;1;0;0;0;3;9;1;3;2981;17;17;1;0;0;3;3;2981;0;3796;3;1;
/org.eclipse.update/src/org/eclipse/update/internal/ui/UMWizardPageURLComplete.java;1;0;1;1;0;0;0;1;0;0;1;1424;0;0;1;0;0;1;1;1424;0;1424;1;1;
/org.eclipse.pde.core/src/org/eclipse/pde/internal/core/ischema/ISchema.java;1;0;2;1;0;0;0;2;7;1;2;3591;7;7;1;0;0;2;2;3591;0;3798;2;1;
/org.eclipse.pde.ui/src/org/eclipse/pde/internal/model/build/BuildModel.java;2;0;5;1;0;0;0;5;7;1;5;1434;11;11;1;0;0;5;5;1434;0;3579;5;2;
/org.eclipse.jdt.ui/ui/org/eclipse/jdt/internal/ui/packageview/ZoomInAction.java;1;0;3;1;0;0;0;3;4;1;3;213;4;4;1;0;0;3;3;213;0;390;3;1;
/org.eclipse.webdav/src/kernel/org/eclipse/webdav/internal/kernel/Context.java;2;0;4;1;1;1;1;3;4192;1;3;1635;6449;6449;1;0;0;3;4;1635;0;4211;4;2;
/org.eclipse.vcm.tests.core/src/org/eclipse/vcm/tests/core/base/IResourceEditionTest.java;1;0;1;1;0;0;0;1;0;0;1;1688;0;0;1;0;0;1;1;1688;0;1688;1;1;
/org.eclipse.jdt.junit/Eclipse JUnit/org/eclipse/jdt/junit/internal/util/SizingTestPass.java;2;0;2;1;0;0;0;2;0;1;2;1511;0;0;1;0;0;2;2;1511;0;1996;2;2;
/org.eclipse.debug.ui/ui/org/eclipse/debug/internal/ui/views/LaunchViewContentProvider.java;3;0;5;2;1;1;1;4;30;3;2;2307;30;30;3;2;0;4;5;3360;2;3975;3;3;
/org.eclipse.pde.ui/src/org/eclipse/pde/internal/editor/schema/CompositorPropertySource.java;2;0;2;1;0;0;0;2;0;1;2;1434;0;0;1;0;0;2;2;1434;0;3579;2;2;
/org.eclipse.help.ui/Eclipse Help UI/org/eclipse/help/internal/ui/IBrowserFactory.java;2;0;3;1;0;0;0;3;7;1;3;136;7;7;1;0;0;3;3;136;0;1420;3;2;
/org.eclipse.jdt.debug/jdi/org/eclipse/jdi/internal/event/MethodEntryEventImpl.java;2;0;4;1;0;0;0;4;17;1;4;187;31;31;1;0;0;4;4;187;0;3670;4;2;
/org.eclipse.update.ui/src/org/eclipse/update/internal/ui/manager/UpdateAdapterFactory.java;1;0;6;1;0;0;0;6;8;1;6;1477;16;16;1;0;0;6;6;1477;0;3662;6;1;
/org.eclipse.swt.tests/JUnit Tests/org/eclipse/swt/tests/junit/Test_org_eclipse_swt_events_SelectionAdapter.java;2;0;2;1;1;1;1;1;6;0;1;1792;6;6;1;0;0;1;2;1792;0;4706;2;2;
/org.eclipse.pde.ui/src/org/eclipse/pde/internal/ui/editor/manifest/ManifestForm.java;1;0;2;1;0;0;0;2;10;0;1;3579;10;10;2;1;0;2;2;3579;1;3579;1;1;
/org.eclipse.update.core/src/org/eclipse/update/core/SiteManager.java;3;1;30;2;2;2;2;28;293;2;24;1423;651;651;2;4;0;28;30;1423;4;4044;26;3;
/org.eclipse.debug.ui/ui/org/eclipse/debug/internal/ui/views/launch/LaunchViewContentProvider.java;1;1;2;1;2;2;2;0;254;0;0;3975;254;254;1;0;0;0;2;3975;0;4003;2;1;
/org.eclipse.ui.examples.javaeditor/Java Editor Example/org/eclipse/ui/examples/javaeditor/JavaEditorEnvironment.java;1;0;2;1;0;0;0;2;0;0;1;1066;0;0;2;1;0;2;2;1066;1;1066;1;1;
/org.eclipse.ui/Eclipse UI/org/eclipse/ui/internal/PartDropEvent.java;2;0;2;1;0;0;0;2;5;1;2;257;5;5;1;0;0;2;2;257;0;457;2;2;
/org.eclipse.core.tests.runtime/src/org/eclipse/core/tests/internal/plugins/PluginResolveTest_20.java;3;0;3;1;0;0;0;3;86;1;3;1794;96;96;1;0;0;3;3;1794;0;3476;3;3;
/org.eclipse.swt.tests/JUnit Tests/org/eclipse/swt/tests/junit/Test_org_eclipse_swt_custom_ScrolledComposite.java;2;0;2;1;1;1;1;1;6;0;1;1792;6;6;1;0;0;1;2;1792;0;4706;2;2;
/org.eclipse.update.ui/src/org/eclipse/update/internal/ui/search/BackgroundThread.java;1;0;3;1;1;1;1;2;9;1;2;3537;12;12;1;0;0;2;3;3537;0;4456;3;1;
/org.eclipse.jdt.ui.tests.refactoring/resources/SelectionAnalyzerWorkSpace/SelectionAnalyzerTests/validSelection/A_test145_.java;1;0;1;1;0;0;0;1;0;0;1;2139;0;0;1;0;0;1;1;2139;0;2139;1;1;
/org.eclipse.team.core/src/org/eclipse/team/internal/core/streams/LFtoCRLFInputStream.java;1;0;1;1;1;1;1;0;0;0;0;4169;0;0;1;0;0;0;1;4169;0;4169;1;1;
/org.eclipse.ui.tests/Eclipse UI Tests/org/eclipse/ui/tests/api/IActionDelegateTest.java;2;0;8;1;0;0;0;8;49;2;7;1080;138;138;2;1;0;8;8;1080;1;2785;7;2;
/org.eclipse.jdt.debug.ui/ui/org/eclipse/jdt/internal/debug/ui/JavaRemoteApplicationLaunchConfigurationDelegate.java;3;0;10;1;0;0;0;10;143;1;10;2556;352;352;1;0;0;10;10;2556;0;3055;10;3;
/org.eclipse.jdt.ui.tests.refactoring/resources/SefWorkSpace/SefTests/A.java;1;0;2;1;0;0;0;2;4;1;2;2876;4;4;1;0;0;2;2;2876;0;2915;2;1;
/org.eclipse.update.ui/src/org/eclipse/update/ui/model/ChecklistJob.java;1;0;3;1;0;0;0;3;3;1;3;1460;3;3;1;0;0;3;3;1460;0;1526;3;1;
/org.eclipse.jdt.ui.tests.refactoring/resources/RenameNonPrivateField/testFail7/in/A.java;1;0;1;1;0;0;0;1;0;0;1;49;0;0;1;0;0;1;1;49;0;49;1;1;
/org.eclipse.pde.ui/src/org/eclipse/pde/internal/ui/launcher/LauncherData.java;1;0;1;1;0;0;0;1;0;0;1;3579;0;0;1;0;0;1;1;3579;0;3579;1;1;
/org.eclipse.ui/Eclipse UI/org/eclipse/ui/internal/CoolBarManager.java;2;4;32;1;24;15;24;8;398;3;6;3484;1840;1840;4;2;9;8;32;4021;11;4637;21;2;
/org.eclipse.pde.ui/src/org/eclipse/pde/internal/ui/wizards/templates/PluginCodeGeneratorWizard.java;1;0;1;1;0;0;0;1;0;0;1;3579;0;0;1;0;0;1;1;3579;0;3579;1;1;
/org.eclipse.debug.ui/ui/org/eclipse/debug/internal/ui/launchConfigurations/LaunchConfigurationTabExtension.java;2;0;7;2;1;1;1;6;14;3;4;2161;44;44;3;2;0;6;7;2161;2;4367;5;2;
/org.eclipse.pde.build/src/plugin/org/eclipse/pde/internal/core/ant/Condition.java;1;0;1;1;0;0;0;1;0;0;1;3475;0;0;1;0;0;1;1;3475;0;3475;1;1;
/org.eclipse.scripting/Eclipse Scripting/org/eclipse/scripting/internal/IXGRElementUITextPresentationElement.java;1;0;3;1;0;0;0;3;4;1;3;133;4;4;1;0;0;3;3;133;0;1424;3;1;
/org.eclipse.jdt.debug/model/org/eclipse/jdt/internal/debug/core/JDIModificationVariable.java;4;0;9;1;0;0;0;9;31;2;8;187;99;99;2;1;0;9;9;1450;1;2517;8;4;
/org.eclipse.jdt.ui.tests.refactoring/resources/SelectionAnalyzerWorkSpace/SelectionAnalyzerTests/invalidSelection/A_test171.java;1;0;1;1;0;0;0;1;0;0;1;1368;0;0;1;0;0;1;1;1368;0;1368;1;1;
/org.eclipse.jdt.core/compiler/org/eclipse/jdt/internal/compiler/lookup/MethodVerifier.java;2;0;7;1;1;1;1;6;1662;1;6;455;1866;1866;1;0;0;6;7;455;0;4062;7;2;
/org.eclipse.jdt.ui.tests.refactoring/resources/RenameParameters/canRename/A_test0_out.java;1;0;1;1;0;0;0;1;0;0;1;233;0;0;1;0;0;1;1;233;0;233;1;1;
/org.eclipse.core.runtime/src/org/eclipse/core/runtime/Plugin.java;5;2;27;2;11;9;11;16;1028;1;16;12;1962;1962;2;0;2;16;27;4550;2;4629;25;5;
/org.eclipse.jdt.ui/core refactoring/org/eclipse/jdt/internal/core/refactoring/code/flow/TryFlowInfo.java;1;0;2;1;0;0;0;2;0;1;2;1236;0;0;1;0;0;2;2;1236;0;1939;2;1;
/org.eclipse.debug.core/core/org/eclipse/debug/internal/core/ExpressionManager.java;3;0;7;1;1;1;1;6;34;3;4;2346;61;61;3;2;0;6;7;2346;2;4007;5;3;
/org.eclipse.jdt.debug/jdi/org/eclipse/jdi/internal/ArrayTypeImpl.java;2;0;5;1;0;0;0;5;42;1;5;187;68;68;1;0;0;5;5;187;0;3678;5;2;
/org.eclipse.jdt.ui.tests.refactoring/resources/RenameType/testFail89/in/A.java;1;0;1;1;0;0;0;1;0;0;1;49;0;0;1;0;0;1;1;49;0;49;1;1;
/org.eclipse.ui/Eclipse UI/org/eclipse/ui/internal/dialogs/ResourceWorkingSetDialog.java;1;0;2;1;0;0;0;2;0;1;2;3494;0;0;1;0;0;2;2;3494;0;3576;2;1;
/org.eclipse.jdt.ui/core refactoring/org/eclipse/jdt/internal/core/refactoring/rename/RenameFieldRefactoring.java;2;0;14;1;0;0;0;14;94;2;12;1342;237;237;2;2;0;14;14;1342;2;1937;12;2;
/org.eclipse.scripting/Eclipse Scripting/org/eclipse/scripting/internal/uirenderer/ScriptPreferenceManager.java;2;0;4;1;0;0;0;4;4;1;4;133;8;8;1;0;0;4;4;133;0;1424;4;2;
/org.eclipse.pde.ui/src/org/eclipse/pde/internal/model/feature/AbstractFeatureModel.java;1;0;4;1;0;0;0;4;1;1;4;2951;2;2;1;0;0;4;4;2951;0;3579;4;1;
/org.eclipse.jdt.ui.tests.refactoring/resources/ExtractMethodWorkSpace/ExtractMethodTests/validSelection/A_test203.java;1;1;3;1;2;2;2;1;0;0;1;1236;0;0;1;0;0;1;3;1236;0;4419;3;1;
/org.eclipse.jdt.ui/core refactoring/org/eclipse/jdt/internal/core/refactoring/SearchResultCollector.java;2;0;3;1;0;0;0;3;5;1;3;15;5;5;1;0;0;3;3;15;0;1939;3;2;
/org.eclipse.pde.runtime/src/org/eclipse/pde/internal/runtime/logview/LogReader.java;1;1;5;1;5;5;5;0;48;0;0;4070;91;91;1;0;0;0;5;4070;0;4386;5;1;
/org.eclipse.debug.ui/ui/org/eclipse/debug/internal/ui/launchConfigurations/LaunchConfigurationDialog.java;4;4;129;3;40;23;40;89;743;4;53;2161;7920;7920;4;36;17;89;129;2176;53;4708;76;4;
/org.eclipse.pde.ui/src/org/eclipse/pde/internal/ui/editor/manifest/ResourceAttributeCellEditor.java;1;0;2;1;0;0;0;2;2;1;2;3579;2;2;1;0;0;2;2;3579;0;3591;2;1;
/org.eclipse.jdt.core/search/org/eclipse/jdt/internal/core/search/matching/ConstructorReferencePattern.java;2;0;13;1;1;1;1;12;1242;4;8;455;2328;2328;4;4;0;12;13;1039;4;4063;9;2;
/org.eclipse.update/src/org/eclipse/update/internal/core/UMSessionManagerMessage.java;1;0;1;1;0;0;0;1;0;0;1;1424;0;0;1;0;0;1;1;1424;0;1424;1;1;
/org.eclipse.swt/Eclipse SWT/motif/org/eclipse/swt/widgets/MenuItem.java;10;1;22;1;6;6;6;16;549;2;13;106;1631;1631;2;3;0;16;22;861;3;4701;19;10;
/org.eclipse.team.ui/src/org/eclipse/team/ui/sync/MergeResource.java;2;0;7;1;1;1;1;6;14;1;6;2233;35;35;1;0;0;6;7;2233;0;4005;7;2;
/org.eclipse.update.core/src/org/eclipse/update/configuration/IConfiguredSite.java;2;2;18;1;7;6;7;11;164;2;9;2994;465;465;2;2;1;11;18;2994;3;4687;15;2;
/org.eclipse.scripting/src/org/eclipse/scripting/internal/views/ScriptUIEditorModelException.java;1;0;1;1;0;0;0;1;0;0;1;1424;0;0;1;0;0;1;1;1424;0;1424;1;1;
/org.eclipse.core.tests.runtime/src/org/eclipse/core/tests/internal/runtimetests/SampleMPR.java;1;0;2;1;0;0;0;2;10;1;2;3611;10;10;1;0;0;2;2;3611;0;3678;2;1;
/org.eclipse.ui/Eclipse UI/org/eclipse/ui/IWorkbenchWindowActionDelegate.java;2;0;2;1;0;0;0;2;5;1;2;257;5;5;1;0;0;2;2;257;0;457;2;2;
/org.eclipse.jdt.ui.tests.refactoring/resources/InlineTemp/canInline/A_out.java;1;0;1;1;0;0;0;1;0;0;1;2015;0;0;1;0;0;1;1;2015;0;2015;1;1;
/org.eclipse.jdt.ui.tests.refactoring/resources/SafeDeleteType/testFail11/in/A.java;1;0;1;1;0;0;0;1;0;0;1;49;0;0;1;0;0;1;1;49;0;49;1;1;
/org.eclipse.pde.ui/src/org/eclipse/pde/internal/model/AttributeChangedEvent.java;1;0;3;1;0;0;0;3;5;1;3;2851;5;5;1;0;0;3;3;2851;0;3136;3;1;
/org.eclipse.pde.ui/src/org/eclipse/pde/internal/editor/component/SynchronizeVersionsAction.java;2;0;2;1;0;0;0;2;0;1;2;1434;0;0;1;0;0;2;2;1434;0;2951;2;2;
/org.eclipse.jdt.core/eval/org/eclipse/jdt/internal/eval/InstallException.java;2;0;4;1;1;1;1;3;32;1;3;455;56;56;1;0;0;3;4;455;0;4062;4;2;
/org.eclipse.jdt.ui/core refactoring/org/eclipse/jdt/internal/corext/refactoring/changes/AbstractTextChange.java;1;0;3;1;0;0;0;3;14;2;2;1939;14;14;2;1;0;3;3;2133;1;2133;2;1;
/org.eclipse.ui.tests/Eclipse JFace Tests/org/eclipse/jface/tests/viewers/interactive/TestTree.java;1;0;1;1;0;0;0;1;0;0;1;1488;0;0;1;0;0;1;1;1488;0;1488;1;1;
/org.eclipse.swt/Eclipse SWT/win32/org/eclipse/swt/internal/win32/NMTTDISPINFO.java;2;0;4;1;0;0;0;4;7;1;4;106;12;12;1;0;0;4;4;106;0;2069;4;2;
/org.eclipse.jdt.core/dom/org/eclipse/jdt/core/dom/TypeDeclaration.java;3;1;15;2;3;3;3;12;18;2;10;2669;107;107;2;2;0;12;15;2877;2;4453;13;3;
/org.eclipse.jdt.ui.tests.refactoring/resources/StructureSelectionAction/A_test29.java;1;0;1;1;1;1;1;0;0;0;0;4181;0;0;1;0;0;0;1;4181;0;4181;1;1;
/org.eclipse.help.ui/Eclipse Help UI/org/eclipse/help/internal/ui/NavigationWorkbook.java;2;0;5;1;0;0;0;5;13;1;5;136;25;25;1;0;0;5;5;136;0;1420;5;2;
/org.eclipse.help/src/org/eclipse/help/internal/protocols/livehelp/LiveHelpURL.java;1;0;3;1;0;0;0;3;12;2;2;2683;12;12;2;1;0;3;3;2692;1;2692;2;1;
/org.eclipse.pde.ui/Eclipse PDE UI/org/eclipse/pde/internal/editor/component/SynchronizeVersionsWizard.java;2;0;6;2;0;0;0;6;12;3;4;267;14;14;3;2;0;6;6;324;2;1434;4;2;
/org.eclipse.ui/Eclipse UI/org/eclipse/ui/internal/dialogs/WorkbenchWizardListSelectionPage.java;5;0;5;1;0;0;0;5;12;1;5;257;24;24;1;0;0;5;5;257;0;2050;5;5;
/org.eclipse.ui.tests/Eclipse UI Tests/org/eclipse/ui/tests/api/IWorkbenchPartTest.java;2;0;4;1;0;0;0;4;8;2;3;1453;12;12;2;1;0;4;4;1453;1;2785;3;2;
/org.eclipse.jdt.ui/core refactoring/org/eclipse/jdt/internal/corext/refactoring/structure/TypeReferenceFinder2.java;2;0;4;1;0;0;0;4;8;1;4;3082;14;14;1;0;0;4;4;3082;0;3186;4;2;
/org.eclipse.jdt.core/model/org/eclipse/jdt/internal/core/builder/impl/StateSpecificHandleImpl.java;1;0;3;1;0;0;0;3;28;1;3;455;28;28;1;0;0;3;3;455;0;2808;3;1;
/org.eclipse.jdt.ui.tests/ui/org/eclipse/jdt/ui/tests/dialogs/DialogsTest2.java;2;0;3;1;0;0;0;3;2;1;3;2269;4;4;1;0;0;3;3;2269;0;3849;3;2;
/org.eclipse.team.webdav/src/org/eclipse/team/internal/webdav/core/DavRemoteTargetResource.java;4;2;17;1;17;15;17;0;87;0;0;4209;406;406;2;0;2;0;17;4209;2;4636;15;4;
/org.eclipse.swt.examples.controls/org/eclipse/swt/examples/controls/ControlPlugin.java;3;0;4;1;1;1;1;3;128;1;3;513;232;232;1;0;0;3;4;513;0;4024;4;3;
/org.eclipse.ui/Eclipse UI Standard Components/org/eclipse/ui/views/navigator/GotoResourceDialog.java;4;0;10;1;0;0;0;10;109;1;10;257;194;194;1;0;0;10;10;257;0;3029;10;4;
/org.eclipse.help/Eclipse Help/org/eclipse/help/internal/protocols/help/Handler.java;2;0;2;1;0;0;0;2;0;1;2;1070;0;0;1;0;0;2;2;1070;0;1420;2;2;
/org.eclipse.swt/Eclipse SWT OLE Win32/win32/org/eclipse/swt/internal/ole/win32/IOleInPlaceActiveObject.java;2;0;3;1;0;0;0;3;9;1;3;106;9;9;1;0;0;3;3;106;0;2069;3;2;
/org.eclipse.pde.ui/Eclipse PDE UI/org/eclipse/pde/internal/editor/build/BuildPage.java;2;0;5;2;0;0;0;5;12;3;3;267;12;12;3;2;0;5;5;324;2;1434;3;2;
/org.eclipse.core.boot/src/org/eclipse/core/internal/boot/update/INLResourceHelper.java;2;0;3;1;0;0;0;3;7;1;3;12;7;7;1;0;0;3;3;12;0;2726;3;2;
/org.eclipse.swt/Eclipse SWT/common_j2se/org/eclipse/swt/internal/Compatability.java;1;0;1;1;0;0;0;1;0;0;1;1378;0;0;1;0;0;1;1;1378;0;1378;1;1;
/org.eclipse.ui.examples.javaeditor/Eclipse Java Editor Example/org/eclipse/ui/examples/javaeditor/java/JavaDoubleClickSelector.java;1;0;1;1;0;0;0;1;0;0;1;1067;0;0;1;0;0;1;1;1067;0;1067;1;1;
/org.eclipse.jdt.core/model/org/eclipse/jdt/internal/core/util/PerThreadObject.java;2;1;2;1;2;2;2;0;15;0;0;4310;15;15;1;0;0;0;2;4310;0;4422;2;2;
/org.eclipse.jdt.ui/core extension/org/eclipse/jdt/internal/corext/textmanipulation/TextEditNode.java;2;0;6;1;0;0;0;6;96;1;6;2137;106;106;1;0;0;6;6;2137;0;3825;6;2;
/org.eclipse.jdt.debug/jdi interfaces/com/sun/jdi/event/ClassUnloadEvent.java;2;0;2;1;0;0;0;2;6;1;2;2704;6;6;1;0;0;2;2;2704;0;3040;2;2;
/org.eclipse.swt/Eclipse SWT PI/win32/org/eclipse/swt/internal/win32/MSG.java;2;0;2;1;1;1;1;1;6;0;1;2069;6;6;1;0;0;1;2;2069;0;4701;2;2;
/org.eclipse.scripting/Eclipse Scripting/org/eclipse/scripting/internal/uirenderer/XGRElementUISwtText.java;2;0;6;1;0;0;0;6;79;1;6;133;130;130;1;0;0;6;6;133;0;1424;6;2;
/org.eclipse.pde.ui/src/org/eclipse/pde/internal/core/plugin/AbstractPluginModelBase.java;1;0;3;1;0;0;0;3;21;2;2;3579;21;21;2;1;0;3;3;3579;1;3607;2;1;
/org.eclipse.jdt.ui/ui/org/eclipse/jdt/internal/ui/javaeditor/JavaOutlinePage.java;11;3;108;3;24;17;24;84;198;4;66;15;2531;2531;4;18;7;84;108;3693;25;4630;83;11;
/org.eclipse.jdt.ui.tests.refactoring/resources/SurroundWithWorkSpace/SurroundWithTests/trycatch_out/TestSuperCall.java;1;0;1;1;1;1;1;0;0;0;0;4424;0;0;1;0;0;0;1;4424;0;4424;1;1;
/org.eclipse.core.resources/src/org/eclipse/core/resources/IMarker.java;3;1;7;1;2;2;2;5;952;1;5;12;1044;1044;1;0;0;5;7;12;0;4430;7;3;
/org.eclipse.jdt.ui/ui/org/eclipse/jdt/ui/actions/ExternalizeStringsAction.java;2;1;11;1;6;6;6;5;21;2;4;3533;79;79;2;1;0;5;11;3641;1;4770;10;2;
/org.eclipse.search/search/org/eclipse/search/internal/core/ISearchScope.java;2;0;3;1;0;0;0;3;9;1;3;15;17;17;1;0;0;3;3;15;0;1434;3;2;
/org.eclipse.jdt.junit/Eclipse JUnit/org/eclipse/jdt/internal/junit/ui/ITestRunListener.java;1;0;3;1;0;0;0;3;2;1;3;2007;2;2;1;0;0;3;3;2007;0;2399;3;1;
/org.eclipse.jdt.debug/jdi/org/eclipse/jdi/hcr/ReferenceType.java;1;0;2;1;0;0;0;2;12;1;2;187;12;12;1;0;0;2;2;187;0;366;2;1;
/org.eclipse.scripting/Eclipse Scripting/org/eclipse/scripting/internal/IXGRElementEventGeneratorOnSubmit.java;1;0;3;1;0;0;0;3;4;1;3;133;4;4;1;0;0;3;3;133;0;1424;3;1;
/org.eclipse.jdt.debug/model/org/eclipse/jdt/internal/debug/core/model/ITimeoutListener.java;1;0;1;1;0;0;0;1;0;0;1;3557;0;0;1;0;0;1;1;3557;0;3557;1;1;
/org.eclipse.team.core/src/org/eclipse/team/core/internal/simpleAccess/SimpleAccessOperations.java;2;0;2;1;0;0;0;2;0;1;2;3268;0;0;1;0;0;2;2;3268;0;3762;2;2;
/org.eclipse.jdt.ui.tests.refactoring/resources/StructureSelectionAction/A_test12.java;1;0;1;1;0;0;0;1;0;0;1;2139;0;0;1;0;0;1;1;2139;0;2139;1;1;
/org.eclipse.pde.ui/src/org/eclipse/pde/internal/ui/wizards/templates/FirstTemplateWizardPage.java;1;0;6;1;1;1;1;5;40;2;4;3579;49;49;2;1;0;5;6;3579;1;4567;5;1;
/org.eclipse.ui.examples.javaeditor/Java Editor Example/org/eclipse/ui/examples/javaeditor/util/JavaWhitespaceDetector.java;1;0;2;1;0;0;0;2;0;0;1;1066;0;0;2;1;0;2;2;1066;1;1066;1;1;
/org.eclipse.pde.ui/src/org/eclipse/pde/core/plugin/IFragment.java;1;0;2;1;0;0;0;2;0;1;2;3579;0;0;1;0;0;2;2;3579;0;3607;2;1;
/org.eclipse.update.ui/src/org/eclipse/update/internal/ui/properties/SiteBookmarkPropertyPage.java;1;0;2;1;0;0;0;2;50;1;2;3537;50;50;1;0;0;2;2;3537;0;3654;2;1;
/org.eclipse.jdt.debug.ui/ui/org/eclipse/jdt/internal/debug/ui/actions/ManageBreakpointRulerAction.java;1;3;9;1;6;4;6;3;157;2;2;3570;235;235;3;1;2;3;9;4255;3;4692;6;1;
/org.eclipse.swt.tests/JUnit Tests/org/eclipse/swt/tests/junit/Test_org_eclipse_swt_graphics_Color.java;2;0;2;1;1;1;1;1;6;0;1;1792;6;6;1;0;0;1;2;1792;0;4706;2;2;
/org.eclipse.jdt.ui.tests.refactoring/resources/RenamePackage/testFail0/in/r/A.java;1;0;1;1;0;0;0;1;0;0;1;1258;0;0;1;0;0;1;1;1258;0;1258;1;1;
/org.eclipse.help/Eclipse Help/org/eclipse/help/internal/server/HighlightProcessor.java;3;0;4;1;0;0;0;4;27;1;4;135;34;34;1;0;0;4;4;135;0;1420;4;3;
/org.eclipse.jdt.debug.tests/tests/org/eclipse/jdt/debug/tests/eval/NestedTypeFieldValue_518.java;2;1;3;1;3;3;3;0;12;0;0;4447;14;14;1;0;0;0;3;4447;0;4571;3;2;
/org.eclipse.swt.examples.paint/org/eclipse/swt/examples/paint/LineFigure.java;4;0;5;2;1;1;1;4;63;2;3;566;74;74;2;1;0;4;5;609;1;4024;4;4;
/org.eclipse.ui/Eclipse UI/org/eclipse/ui/internal/MultiEditorOuterPane.java;1;0;2;1;1;1;1;1;8;0;1;3127;8;8;1;0;0;1;2;3127;0;4082;2;1;
/org.eclipse.vcm.core.cvs/src/org/eclipse/vcm/internal/core/ccvs/RevisionComparator.java;2;0;2;1;0;0;0;2;7;1;2;0;7;7;1;0;0;2;2;0;0;298;2;2;
/org.eclipse.jdt.debug/eval/org/eclipse/jdt/internal/debug/eval/ast/instructions/PushFieldVariable.java;3;0;8;1;1;1;1;7;49;1;7;3421;104;104;1;0;0;7;8;3421;0;4426;8;3;
/org.eclipse.jdt.ui/ui/org/eclipse/jdt/internal/ui/actions/WorkbenchRunnableAdapter.java;1;0;1;1;0;0;0;1;0;0;1;2218;0;0;1;0;0;1;1;2218;0;2218;1;1;
/org.eclipse.jdt.ui/ui/org/eclipse/jdt/internal/ui/workingsets/WorkingSetMessages.java;1;0;2;1;0;0;0;2;15;0;1;3834;15;15;2;1;0;2;2;3834;1;3834;1;1;
/org.eclipse.jdt.ui/ui refactoring/org/eclipse/jdt/internal/ui/nls/search/NLSSearchMessages.java;1;0;2;1;0;0;0;2;0;1;2;1913;0;0;1;0;0;2;2;1913;0;1922;2;1;
/org.eclipse.vcm.ui/src/org/eclipse/vcm/internal/ui/merge/MergeWizardPage.java;2;0;2;1;0;0;0;2;13;1;2;1;13;13;1;0;0;2;2;1;0;298;2;2;
/org.eclipse.jdt.ui.tests.refactoring/resources/RenameType/test12/in/A.java;1;0;1;1;0;0;0;1;0;0;1;49;0;0;1;0;0;1;1;49;0;49;1;1;
/org.eclipse.jdt.core/compiler/org/eclipse/jdt/internal/compiler/ast/ClassLiteralAccess.java;2;1;14;1;2;2;2;12;129;4;9;455;313;313;4;3;0;12;14;1039;3;4421;11;2;
/org.eclipse.jdt.ui.tests.refactoring/resources/ExtractMethodWorkSpace/ExtractMethodTests/wiki_out/A_test2005.java;1;1;5;1;2;2;2;3;44;1;3;1236;52;52;1;0;0;3;5;1236;0;4419;5;1;
/org.eclipse.swt.examples/org/eclipse/swt/examples/hoverhelp/HoverHelp.java;4;0;5;1;1;1;1;4;336;1;4;513;406;406;1;0;0;4;5;513;0;4024;5;4;
/org.eclipse.ui.tests/Eclipse UI Tests/org/eclipse/ui/tests/api/ISelectionServiceTest.java;2;0;2;1;0;0;0;2;2;1;2;2008;2;2;1;0;0;2;2;2008;0;2785;2;2;
/org.eclipse.pde.ui/src/org/eclipse/pde/internal/wizards/PluginPathUpdater.java;2;0;14;1;0;0;0;14;705;1;14;1434;1000;1000;1;0;0;14;14;1434;0;3579;14;2;
/org.eclipse.team.cvs.core/src/org/eclipse/team/internal/ccvs/core/resources/CVSWorkspaceRoot.java;3;2;16;1;7;6;7;9;139;2;8;3012;308;308;2;1;1;9;16;3627;2;4632;14;3;
/org.eclipse.jdt.core/compiler/org/eclipse/jdt/internal/compiler/ast/CompilationUnitDeclaration.java;2;2;15;1;4;3;4;11;441;5;7;455;993;993;5;4;1;11;15;1038;5;4420;10;2;
/org.eclipse.team.cvs.ui/src/org/eclipse/team/internal/ccvs/ui/Policy.java;2;0;4;1;0;0;0;4;172;1;4;1978;183;183;1;0;0;4;4;1978;0;3746;4;2;
/org.eclipse.ui/Eclipse UI/org/eclipse/ui/internal/misc/CheckboxDoubleListGroup.java;3;0;4;1;0;0;0;4;5;1;4;257;13;13;1;0;0;4;4;257;0;2681;4;3;
/org.eclipse.jdt.core/search/org/eclipse/jdt/internal/core/search/matching/OrNameCombiner.java;2;0;3;1;1;1;1;2;98;1;2;455;120;120;1;0;0;2;3;455;0;4063;3;2;
/org.eclipse.update.ui/src/org/eclipse/update/internal/ui/parts/MultiPageView.java;1;0;5;1;0;0;0;5;27;1;5;1460;37;37;1;0;0;5;5;1460;0;3537;5;1;
/org.eclipse.jdt.ui.tests/ui/org/eclipse/jdt/ui/tests/core/ImportOrganizeTest.java;3;0;10;1;1;1;1;9;96;2;8;1379;269;269;2;1;0;9;10;3846;1;4381;9;3;
/org.eclipse.jdt.ui.tests.refactoring/resources/RenameType/testFail61/in/A.java;1;0;1;1;0;0;0;1;0;0;1;49;0;0;1;0;0;1;1;49;0;49;1;1;
/org.eclipse.jdt.core/compiler/org/eclipse/jdt/internal/compiler/ISourceElementRequestor.java;2;0;7;1;1;1;1;6;194;2;5;455;228;228;2;1;0;6;7;3084;1;4062;6;2;
/org.eclipse.jdt.ui.tests.refactoring/resources/PullUp/test16/in/A.java;1;0;1;1;0;0;0;1;0;0;1;2406;0;0;1;0;0;1;1;2406;0;2406;1;1;
/org.eclipse.jdt.ui/core extension/org/eclipse/jdt/internal/corext/CorextMessages.java;2;0;3;1;1;1;1;2;4;1;2;2327;6;6;1;0;0;2;3;2327;0;3967;3;2;
/org.eclipse.pde.ui/src/org/eclipse/pde/internal/parts/SharedPartWithButtons.java;1;0;5;1;0;0;0;5;18;1;5;2981;23;23;1;0;0;5;5;2981;0;3579;5;1;
/org.eclipse.jdt.ui/ui/org/eclipse/jdt/internal/ui/javaeditor/BracketPainter.java;1;0;2;1;0;0;0;2;4;1;2;3087;4;4;1;0;0;2;2;3087;0;3324;2;1;
/org.eclipse.swt/Eclipse SWT/gtk1x/org/eclipse/swt/widgets/Button.java;3;0;3;1;1;1;1;2;6;1;2;2107;9;9;1;0;0;2;3;2107;0;4701;3;3;
/org.eclipse.update.core/src/org/eclipse/update/internal/core/ContentReference.java;1;0;1;1;0;0;0;1;0;0;1;2438;0;0;1;0;0;1;1;2438;0;2438;1;1;
/org.eclipse.ui/Eclipse UI/org/eclipse/ui/internal/CyclePartAction.java;4;1;16;2;4;4;4;12;78;2;10;1800;245;245;2;2;0;12;16;3212;2;4730;14;4;
/org.eclipse.jdt.core/compiler/org/eclipse/jdt/internal/compiler/impl/CharConstant.java;2;0;10;1;1;1;1;9;90;4;6;455;148;148;4;3;0;9;10;1039;3;4062;7;2;
/org.eclipse.swt/Eclipse SWT OLE Win32/win32/org/eclipse/swt/ole/win32/OleFile.java;2;0;3;1;1;1;1;2;6;1;2;106;11;11;1;0;0;2;3;106;0;4701;3;2;
/org.eclipse.swt.examples.paint/src/org/eclipse/swt/examples/paint/PaintSession.java;3;0;3;1;1;1;1;2;52;1;2;513;58;58;1;0;0;2;3;513;0;4705;3;3;
/org.eclipse.swt/Eclipse SWT Custom Widgets/common/org/eclipse/swt/custom/StyledTextBidi.java;6;1;36;2;4;4;4;32;719;3;27;1036;2074;2074;3;5;0;32;36;1472;5;4845;31;6;
/org.eclipse.jdt.ui.tests.refactoring/resources/MoveMembers/test16/in/B.java;1;0;1;1;0;0;0;1;0;0;1;2738;0;0;1;0;0;1;1;2738;0;2738;1;1;
/org.eclipse.jdt.debug.tests/tests/org/eclipse/jdt/debug/tests/eval/NestedTypeFieldValue_406.java;2;1;3;1;3;3;3;0;12;0;0;4447;14;14;1;0;0;0;3;4447;0;4571;3;2;
/org.eclipse.pde.ui/src/org/eclipse/pde/internal/ui/editor/FormOutlinePage.java;1;0;2;1;0;0;0;2;21;0;1;3579;21;21;2;1;0;2;2;3579;1;3579;1;1;
/org.eclipse.webdav/src/interface/org/eclipse/webdav/dom/MalformedElementException.java;2;0;4;1;1;1;1;3;58;1;3;12;85;85;1;0;0;3;4;12;0;4211;4;2;
/org.eclipse.scripting/src/org/eclipse/scripting/internal/ScriptEngineException.java;1;0;1;1;0;0;0;1;0;0;1;1424;0;0;1;0;0;1;1;1424;0;1424;1;1;
/org.eclipse.debug.ui/ui/org/eclipse/debug/internal/ui/views/VariablesViewEventHandler.java;3;0;8;1;1;1;1;7;47;1;7;2344;98;98;1;0;0;7;8;2344;0;3975;8;3;
/org.eclipse.core.runtime/src/org/eclipse/core/internal/plugins/RegistryCacheWriter.java;4;2;23;1;5;4;5;18;1260;2;16;12;2098;2098;2;2;1;18;23;1657;3;4726;20;4;
/org.eclipse.jdt.ui.tests.refactoring/test cases/org/eclipse/jdt/ui/tests/nls/NLSRefactoringTester.java;1;0;1;1;0;0;0;1;0;0;1;2015;0;0;1;0;0;1;1;2015;0;2015;1;1;
/org.eclipse.ui/Eclipse UI/org/eclipse/ui/internal/dialogs/WizardNewProjectNameAndLocationPage.java;1;2;3;1;3;2;3;0;11;0;0;4082;13;13;2;0;1;0;3;4082;1;4567;2;1;
/org.eclipse.pde.core/src/org/eclipse/pde/internal/core/build/BuildModelFactory.java;1;0;1;1;0;0;0;1;0;0;1;3591;0;0;1;0;0;1;1;3591;0;3591;1;1;
/org.eclipse.scripting/src/org/eclipse/scripting/IDataModel.java;1;0;1;1;0;0;0;1;0;0;1;1424;0;0;1;0;0;1;1;1424;0;1424;1;1;
/org.eclipse.update.ui.forms/src/org/eclipse/update/ui/forms/internal/SectionChangeManager.java;1;0;1;1;0;0;0;1;0;0;1;2470;0;0;1;0;0;1;1;2470;0;2470;1;1;
/org.eclipse.jdt.ui/ui/org/eclipse/jdt/internal/ui/preferences/JavadocPreferencePage.java;3;2;9;2;4;3;4;5;41;1;5;2878;100;100;2;0;1;5;9;4181;1;4630;8;3;
/org.eclipse.pde.ui/src/org/eclipse/pde/internal/editor/manifest/JavaAttributeValue.java;2;0;3;1;0;0;0;3;2;1;3;1434;2;2;1;0;0;3;3;1434;0;3579;3;2;
/org.eclipse.jdt.ui/core refactoring/org/eclipse/jdt/internal/corext/refactoring/util/AbstractExceptionAnalyzer2.java;1;0;2;1;0;0;0;2;0;1;2;3106;0;0;1;0;0;2;2;3106;0;3209;2;1;
/org.eclipse.pde.ui/Eclipse PDE UI/org/eclipse/pde/internal/editor/schema/NewElementAction.java;2;0;5;2;0;0;0;5;12;3;3;267;12;12;3;2;0;5;5;324;2;1434;3;2;
/org.eclipse.ui/Eclipse UI/org/eclipse/ui/actions/ScrubLocalAction.java;3;0;3;1;0;0;0;3;20;1;3;257;22;22;1;0;0;3;3;257;0;3029;3;3;
/org.eclipse.core.resources/src/org/eclipse/core/internal/utils/PluginStats.java;2;0;5;1;1;1;1;4;160;1;4;12;201;201;1;0;0;4;5;12;0;4214;5;2;
/org.eclipse.jdt.ui/core refactoring/org/eclipse/jdt/internal/corext/refactoring/ListenerList.java;1;0;2;1;0;0;0;2;46;1;2;1939;46;46;1;0;0;2;2;1939;0;2215;2;1;
/org.eclipse.debug.ui/ui/org/eclipse/debug/ui/ILaunchConfigurationTab.java;3;1;17;2;4;4;4;13;176;2;10;2161;372;372;2;3;0;13;17;2161;3;4653;14;3;
/org.eclipse.ui/Eclipse UI/org/eclipse/ui/internal/WorkbenchPartLabelProvider.java;4;0;4;1;0;0;0;4;8;1;4;257;15;15;1;0;0;4;4;257;0;3607;4;4;
/org.eclipse.pde.ui/src/org/eclipse/pde/internal/ui/editor/manifest/ManifestEditorContributor.java;1;0;1;1;0;0;0;1;0;0;1;3579;0;0;1;0;0;1;1;3579;0;3579;1;1;
/org.eclipse.jdt.ui.tests.refactoring/resources/MoveMembers/test7/out/A.java;1;0;1;1;0;0;0;1;0;0;1;2738;0;0;1;0;0;1;1;2738;0;2738;1;1;
/org.eclipse.jdt.core/compiler/org/eclipse/jdt/internal/compiler/lookup/TypeBinding.java;2;0;5;1;1;1;1;4;201;1;4;455;248;248;1;0;0;4;5;455;0;4062;5;2;
/org.eclipse.ui/Eclipse UI/org/eclipse/ui/internal/dialogs/HistoryDialog.java;1;0;1;1;0;0;0;1;0;0;1;941;0;0;1;0;0;1;1;941;0;941;1;1;
/org.eclipse.core.resources/src/org/eclipse/core/internal/indexing/ObjectStore.java;4;1;11;1;4;4;4;7;884;1;7;12;1578;1578;1;0;0;7;11;12;0;4632;11;4;
/org.eclipse.jdt.ui/core extension/org/eclipse/jdt/internal/corext/textmanipulation/SimpleTextEdit.java;2;0;5;1;0;0;0;5;4;1;5;2137;11;11;1;0;0;5;5;2137;0;3825;5;2;
/org.eclipse.jdt.ui.tests.refactoring/resources/RenameType/testIllegalTypeName5/in/A.java;1;0;1;1;0;0;0;1;0;0;1;49;0;0;1;0;0;1;1;49;0;49;1;1;
/org.eclipse.core.tests.runtime/src/org/eclipse/core/tests/internal/plugin/c/ExportedClass.java;3;0;3;1;0;0;0;3;10;1;3;1794;20;20;1;0;0;3;3;1794;0;3476;3;3;
/org.eclipse.jdt.ui.tests.refactoring/resources/ReorderParameters/canReorder/A_test10_out.java;1;0;3;1;0;0;0;3;0;1;3;724;0;0;1;0;0;3;3;724;0;2270;3;1;
/org.eclipse.swt.tests/JUnit Tests/org/eclipse/swt/tests/junit/Test_org_eclipse_swt_graphics_GC.java;2;0;2;1;1;1;1;1;6;0;1;1792;6;6;1;0;0;1;2;1792;0;4706;2;2;
/org.eclipse.help/src/org/eclipse/help/internal/contributors/ViewContributor.java;2;0;2;1;0;0;0;2;0;1;2;1420;0;0;1;0;0;2;2;1420;0;1675;2;2;
/org.eclipse.jdt.debug/eval/org/eclipse/jdt/internal/debug/eval/ast/ASTCodeSnippetToCuMapper.java;1;0;4;1;0;0;0;4;714;1;4;3329;1063;1063;1;0;0;4;4;3329;0;3421;4;1;
/org.eclipse.jdt.ui.tests/refactoring/org/eclipse/jdt/refactoring/tests/MySetup.java;2;0;3;1;0;0;0;3;2;1;3;1258;2;2;1;0;0;3;3;1258;0;1896;3;2;
/org.eclipse.ui/Eclipse JFace Text/org/eclipse/jface/text/source/CompositeRuler.java;2;1;8;1;8;8;8;0;300;0;0;4038;620;620;1;0;0;0;8;4038;0;4853;8;2;
/org.eclipse.vcm.ui.cvs/src/org/eclipse/vcm/internal/ui/ccvs/WorkbenchUserAuthenticator.java;4;0;10;2;0;0;0;10;45;2;9;1;209;209;2;1;0;10;10;295;1;1682;9;4;
/org.eclipse.jdt.debug/eval/org/eclipse/jdt/internal/debug/eval/ast/JDIStackFrameToEvalSourceMapper.java;2;0;4;1;0;0;0;4;38;1;4;3344;45;45;1;0;0;4;4;3344;0;3421;4;2;
/org.eclipse.core.boot/src/org/eclipse/core/internal/boot/PlatformURLHandler.java;4;1;7;1;2;2;2;5;130;1;5;23;197;197;1;0;0;5;7;23;0;4214;7;4;
/org.eclipse.jdt.ui.tests.refactoring/resources/RefactoringScanner/A.java;1;0;1;1;0;0;0;1;0;0;1;1547;0;0;1;0;0;1;1;1547;0;1547;1;1;
/org.eclipse.jdt.ui/ui/org/eclipse/jdt/internal/ui/text/correction/JavaCorrectionSourceViewer.java;2;0;3;1;0;0;0;3;17;1;3;3306;22;22;1;0;0;3;3;3306;0;3507;3;2;
/org.eclipse.jdt.core/search/org/eclipse/jdt/internal/core/index/impl/JarFileEntryDocument.java;2;1;10;1;2;2;2;8;79;4;5;455;146;146;4;3;0;8;10;1039;3;4063;7;2;
/org.eclipse.jdt.ui/ui/org/eclipse/jdt/internal/ui/widgets/MessageLine.java;3;0;4;1;0;0;0;4;7;1;4;15;9;9;1;0;0;4;4;15;0;1416;4;3;
/org.eclipse.jdt.ui.tests.refactoring/resources/PullUp/test1/in/A.java;1;0;1;1;0;0;0;1;0;0;1;2406;0;0;1;0;0;1;1;2406;0;2406;1;1;
/org.eclipse.jdt.ui.tests.refactoring/resources/RenameParameters/cannotRename/A_testFail5.java;1;0;1;1;0;0;0;1;0;0;1;233;0;0;1;0;0;1;1;233;0;233;1;1;
/org.eclipse.core.resources/src/org/eclipse/core/internal/dtree/NodeInfo.java;2;0;5;1;1;1;1;4;242;1;4;12;487;487;1;0;0;4;5;12;0;4214;5;2;
/org.eclipse.jdt.ui/nls/org/eclipse/jdt/internal/nls/changes/Messages.java;1;0;2;1;0;0;0;2;0;1;2;1880;0;0;1;0;0;2;2;1880;0;1913;2;1;
/org.eclipse.jdt.ui.tests.refactoring/resources/RenameMethodInInterface/testFail3/in/A.java;1;0;1;1;0;0;0;1;0;0;1;49;0;0;1;0;0;1;1;49;0;49;1;1;
/org.eclipse.jdt.ui/core refactoring/org/eclipse/jdt/internal/corext/refactoring/nls/changes/NLSChangesMessages.java;1;0;1;1;0;0;0;1;0;0;1;1939;0;0;1;0;0;1;1;1939;0;1939;1;1;
/org.eclipse.search/search/org/eclipse/search/ui/IContextMenuContributor.java;2;0;3;1;0;0;0;3;9;1;3;15;10;10;1;0;0;3;3;15;0;1434;3;2;
/org.eclipse.core.resources/src/org/eclipse/core/internal/localstore/IsSynchronizedVisitor.java;2;0;2;1;1;1;1;1;2;0;1;3875;2;2;1;0;0;1;2;3875;0;4214;2;2;
/org.eclipse.team.cvs.ui/src/org/eclipse/team/internal/ccvs/ui/actions/RemoveBranchTagAction.java;2;0;8;1;1;1;1;7;4;1;7;2126;17;17;1;0;0;7;8;2126;0;4021;8;2;
/org.eclipse.help/src/org/eclipse/help/internal/contributors/xml1_0/XMLTopicContributor.java;1;0;2;1;0;0;0;2;0;1;2;1675;0;0;1;0;0;2;2;1675;0;2217;2;1;
/org.eclipse.jdt.ui/core extension/org/eclipse/jdt/internal/corext/codemanipulation/AddMethodStubOperation.java;2;0;3;1;0;0;0;3;7;1;3;2137;8;8;1;0;0;3;3;2137;0;2246;3;2;
/org.eclipse.ui/Eclipse JFace Text/org/eclipse/jface/text/TextSelection.java;3;0;3;1;0;0;0;3;69;1;3;257;74;74;1;0;0;3;3;257;0;1066;3;3;
/org.eclipse.pde.ui/src/org/eclipse/pde/internal/model/ImportObject.java;1;0;3;1;0;0;0;3;2;1;3;2477;2;2;1;0;0;3;3;2477;0;3136;3;1;
/org.eclipse.jdt.ui/core refactoring/org/eclipse/jdt/internal/corext/refactoring/nls/NLSMessages.java;2;0;2;1;0;0;0;2;17;1;2;1939;17;17;1;0;0;2;2;1939;0;3694;2;2;
/org.eclipse.jdt.ui.tests.refactoring/resources/SelectionAnalyzerWorkSpace/SelectionAnalyzerTests/validSelection/A_test353.java;1;0;1;1;0;0;0;1;0;0;1;1368;0;0;1;0;0;1;1;1368;0;1368;1;1;
/org.eclipse.jdt.ui.tests.refactoring/resources/ReorderParameters/canReorder/A_test11_out.java;1;0;4;1;0;0;0;4;2;2;3;724;2;2;2;1;0;4;4;724;1;2270;3;1;
/org.eclipse.update.ui/src/org/eclipse/update/internal/ui/manager/CDROMForm.java;1;0;5;1;0;0;0;5;14;1;5;1905;17;17;1;0;0;5;5;1905;0;2651;5;1;
/org.eclipse.jdt.core/compiler/org/eclipse/jdt/internal/compiler/ast/Expression.java;2;1;14;1;2;2;2;12;727;4;9;455;1587;1587;4;3;0;12;14;1039;3;4421;11;2;
/org.eclipse.update.ui/src/org/eclipse/update/internal/ui/manager/ConfigurationPropertyPage.java;2;0;5;1;0;0;0;5;13;1;5;2308;16;16;1;0;0;5;5;2308;0;3537;5;2;
/org.eclipse.update/Eclipse Update/org/eclipse/update/internal/ui/UMPreferencePageSettings.java;2;0;4;1;0;0;0;4;288;1;4;108;292;292;1;0;0;4;4;108;0;1424;4;2;
/org.eclipse.ui.externaltools/External Tools/org/eclipse/ui/externaltools/internal/ui/AntAction.java;1;2;5;1;5;4;5;0;20;0;0;4090;52;52;2;0;1;0;5;4425;1;4425;4;1;
/org.eclipse.jdt.debug/eval/org/eclipse/jdt/internal/debug/eval/model/IRuntimeContext.java;2;0;2;1;0;0;0;2;0;1;2;3555;0;0;1;0;0;2;2;3555;0;3645;2;2;
/org.eclipse.swt/Eclipse SWT/carbon/org/eclipse/swt/widgets/ProgressBar.java;3;1;4;1;4;4;4;0;12;0;0;4147;21;21;1;0;0;0;4;4147;0;4701;4;3;
/org.eclipse.core.boot/src/org/eclipse/core/internal/boot/EclipseURLPlatformConnection.java;1;0;2;1;0;0;0;2;0;1;2;12;0;0;1;0;0;2;2;12;0;23;2;1;
/org.eclipse.pde.ui/src/org/eclipse/pde/internal/ui/feature/BuildFeatureAction.java;1;1;5;1;3;3;3;2;46;1;2;3579;101;101;1;0;0;2;5;3579;0;4825;5;1;
/org.eclipse.pde.ui/src/org/eclipse/pde/model/plugin/IPluginElement.java;1;0;2;1;0;0;0;2;0;1;2;3039;0;0;1;0;0;2;2;3039;0;3579;2;1;
/org.eclipse.jdt.core/compiler/org/eclipse/jdt/internal/compiler/ast/MagicLiteral.java;2;0;4;1;1;1;1;3;40;1;3;455;60;60;1;0;0;3;4;455;0;4062;4;2;
/org.eclipse.ui/Eclipse JFace Text/org/eclipse/jface/text/source/AnnotationBarHoverManager.java;2;1;4;1;2;2;2;2;23;1;2;1435;27;27;1;0;0;2;4;1435;0;4853;4;2;
/org.eclipse.core.target/src/org/eclipse/core/target/IRemoteFile.java;1;0;4;1;0;0;0;4;9;3;2;666;9;9;3;2;0;4;4;666;2;713;2;1;
/org.eclipse.jdt.ui.tests.refactoring/resources/ExtractMethodWorkSpace/ExtractMethodTests/return_out/A_test718.java;1;1;3;1;2;2;2;1;30;0;1;1236;30;30;1;0;0;1;3;1236;0;4419;3;1;
/org.eclipse.pde.ui/src/org/eclipse/pde/internal/ui/ischema/ISchemaAttribute.java;1;0;2;1;0;0;0;2;0;1;2;3579;0;0;1;0;0;2;2;3579;0;3591;2;1;
/org.eclipse.pde.ui/src/org/eclipse/pde/internal/wizards/templates/BooleanOption.java;1;0;4;1;0;0;0;4;13;1;4;3278;19;19;1;0;0;4;4;3278;0;3579;4;1;
/org.eclipse.core.resources/src/org/eclipse/core/internal/localstore/SafeChunkyOutputStream.java;2;0;5;1;1;1;1;4;128;1;4;12;152;152;1;0;0;4;5;12;0;4214;5;2;
/org.eclipse.jdt.ui.tests.refactoring/resources/StructureSelectionAction/A_test7.java;1;0;2;1;0;0;0;2;2;1;2;2139;2;2;1;0;0;2;2;2139;0;2412;2;1;
/org.eclipse.team.cvs.core/src/org/eclipse/team/internal/ccvs/core/response/StickyHandler.java;2;0;3;1;0;0;0;3;181;1;3;2016;181;181;1;0;0;3;3;2016;0;2607;3;2;
/org.eclipse.debug.core/core/org/eclipse/debug/internal/core/ProcessMonitor.java;3;0;6;1;0;0;0;6;36;1;6;187;55;55;1;0;0;6;6;187;0;2164;6;3;
/org.eclipse.team.ui/src/org/eclipse/team/ui/actions/UndoCheckOutAction.java;2;0;8;1;1;1;1;7;136;1;7;1978;182;182;1;0;0;7;8;1978;0;4020;8;2;
/org.eclipse.update/Eclipse Update/org/eclipse/update/internal/ui/UMWizardPageInstallable.java;3;0;10;1;0;0;0;10;2129;2;9;108;2267;2267;2;1;0;10;10;161;1;1424;9;3;
/org.eclipse.team.cvs.ui/src/org/eclipse/team/internal/ccvs/ui/model/VersionCategory.java;3;0;12;2;0;0;0;12;40;2;11;2055;96;96;2;1;0;12;12;2726;1;3791;11;3;
/org.eclipse.debug.ui/ui/org/eclipse/debug/internal/ui/views/LaunchViewEventHandler.java;3;0;37;2;1;1;1;36;196;4;25;2307;915;915;4;11;0;36;37;2307;11;3975;26;3;
/org.eclipse.core.tests.runtime/src/org/eclipse/core/tests/plugintests/PreferencesRuntimeTests.java;1;1;2;1;2;2;2;0;227;0;0;4006;227;227;1;0;0;0;2;4006;0;4191;2;1;
/org.eclipse.swt.tests/JUnit Tests/org/eclipse/swt/tests/junit/Test_org_eclipse_swt_dnd_Clipboard.java;2;0;2;1;1;1;1;1;6;0;1;1792;6;6;1;0;0;1;2;1792;0;4706;2;2;
/org.eclipse.swt/Eclipse SWT PI/win32/org/eclipse/swt/internal/ole/win32/GUID.java;2;0;2;1;1;1;1;1;6;0;1;2069;6;6;1;0;0;1;2;2069;0;4701;2;2;
/org.eclipse.swt/Eclipse SWT Custom Widgets/common_j2se/org/eclipse/swt/custom/PopupList.java;1;0;1;1;0;0;0;1;0;0;1;1378;0;0;1;0;0;1;1;1378;0;1378;1;1;
/org.eclipse.jdt.ui.tests.refactoring/resources/PullUp/test5/in/A.java;1;0;1;1;0;0;0;1;0;0;1;2406;0;0;1;0;0;1;1;2406;0;2406;1;1;
/org.eclipse.pde.ui/Eclipse PDE UI/org/eclipse/pde/internal/schema/SchemaElement.java;2;0;6;2;0;0;0;6;12;3;4;267;13;13;3;2;0;6;6;324;2;1434;4;2;
/org.eclipse.jdt.ui.tests.refactoring/resources/RenameVirtualMethodInClass/test21/out/A.java;1;0;1;1;0;0;0;1;0;0;1;49;0;0;1;0;0;1;1;49;0;49;1;1;
/org.eclipse.jdt.ui.tests.refactoring/resources/RenameVariables/canRename/A_test25_in.java;1;0;2;1;0;0;0;2;0;1;2;724;0;0;1;0;0;2;2;724;0;1665;2;1;
/org.eclipse.ui.tests/Eclipse JFace Tests/org/eclipse/jface/tests/viewers/interactive/TestTableTree.java;1;0;1;1;0;0;0;1;0;0;1;1488;0;0;1;0;0;1;1;1488;0;1488;1;1;
/org.eclipse.jdt.ui.tests.refactoring/resources/ExtractMethodWorkSpace/ExtractMethodTests/locals_in/A_test531.java;1;1;3;1;2;2;2;1;18;0;1;922;18;18;1;0;0;1;3;922;0;4419;3;1;
/org.eclipse.jdt.ui.tests.refactoring/resources/ReorderParameters/cannotReorder/A_testFail1.java;1;0;1;1;0;0;0;1;0;0;1;2270;0;0;1;0;0;1;1;2270;0;2270;1;1;
/org.eclipse.jdt.debug.tests/test programs/org/eclipse/debug/tests/targets/HelloLauncher.java;1;0;2;1;0;0;0;2;0;1;2;3701;0;0;1;0;0;2;2;3701;0;3719;2;1;
/org.eclipse.swt.examples/Eclipse SWT Examples/common/org/eclipse/swt/examples/controlexample/Tab.java;1;0;2;1;0;0;0;2;0;1;2;107;0;0;1;0;0;2;2;107;0;611;2;1;
/org.eclipse.pde.ui/Eclipse PDE UI/org/eclipse/pde/internal/editor/jars/FolderSection.java;2;0;6;2;0;0;0;6;12;3;4;267;13;13;3;2;0;6;6;324;2;1434;4;2;
/org.eclipse.core.tests.resources/src/org/eclipse/core/tests/resources/regression/PR_1GALH44_2Test.java;3;0;4;1;0;0;0;4;13;1;4;1794;17;17;1;0;0;4;4;1794;0;3287;4;3;
/org.eclipse.team.cvs.ui/src/org/eclipse/team/internal/ccvs/ui/actions/RemoveModuleVersionAction.java;2;0;5;1;0;0;0;5;35;1;5;2126;40;40;1;0;0;5;5;2126;0;3577;5;2;
/org.eclipse.pde.ui/src/org/eclipse/pde/internal/core/builders/PluginErrorReporter.java;1;0;2;1;0;0;0;2;0;1;2;3579;0;0;1;0;0;2;2;3579;0;3607;2;1;
/org.eclipse.team.cvs.core/src/org/eclipse/team/internal/ccvs/core/client/Checkout.java;3;1;23;2;2;2;2;21;85;2;18;2572;342;342;2;3;0;21;23;2702;3;4213;20;3;
/org.eclipse.update.examples/Eclipse Update Examples/org/eclipse/update/examples/SampleAction.java;1;0;3;1;0;0;0;3;5;1;3;474;5;5;1;0;0;3;3;474;0;1424;3;1;
/org.eclipse.update.ui/src/org/eclipse/update/internal/ui/search/ExpressionSearchCategory.java;1;1;6;1;2;2;2;4;42;2;3;3553;110;110;2;1;0;4;6;3658;1;4435;5;1;
/org.eclipse.swt/Eclipse SWT/motif/org/eclipse/swt/internal/motif/XGCValues.java;2;0;3;1;0;0;0;3;4;1;3;106;4;4;1;0;0;3;3;106;0;2069;3;2;
/org.eclipse.debug.ui/ui/org/eclipse/debug/internal/ui/views/LaunchView.java;3;0;50;2;1;1;1;49;188;8;28;2307;1188;1188;8;21;0;49;50;2327;21;3975;29;3;
/org.eclipse.jdt.ui/ui/org/eclipse/jdt/internal/ui/viewsupport/OverlayIconManager.java;4;0;6;1;0;0;0;6;10;1;6;15;31;31;1;0;0;6;6;15;0;1310;6;4;
/org.eclipse.scripting/src/org/eclipse/scripting/internal/IXGRElementEventGenerator.java;1;0;1;1;0;0;0;1;0;0;1;1424;0;0;1;0;0;1;1;1424;0;1424;1;1;
/org.eclipse.pde.ui/src/org/eclipse/pde/internal/ui/wizards/PluginPathUpdater.java;1;1;8;1;5;5;5;3;137;2;2;3579;269;269;2;1;0;3;8;3579;1;4637;7;1;
/org.eclipse.help.ui/Eclipse Help UI/org/eclipse/help/internal/ui/StyledLineWrapper.java;3;0;6;2;0;0;0;6;225;2;4;313;268;268;2;2;0;6;6;323;2;1420;4;3;
/org.eclipse.pde.ui/src/org/eclipse/pde/internal/editor/schema/SchemaContentProvider.java;2;0;2;1;0;0;0;2;0;1;2;1434;0;0;1;0;0;2;2;1434;0;3579;2;2;
/org.eclipse.core.tests.resources/src/org/eclipse/core/tests/internal/indexing/StandAloneFieldTest.java;3;0;4;1;1;1;1;3;32;1;3;1794;54;54;1;0;0;3;4;1794;0;4516;4;3;
/org.eclipse.ui/Eclipse UI/org/eclipse/ui/internal/SplashWindow.java;4;1;4;1;2;2;2;2;6;1;2;257;8;8;1;0;0;2;4;257;0;4210;4;4;
/org.eclipse.ui/Eclipse UI/org/eclipse/ui/ICapabilityUninstallWizard.java;1;0;1;1;0;0;0;1;0;0;1;3506;0;0;1;0;0;1;1;3506;0;3506;1;1;
/org.eclipse.jdt.core/model/org/eclipse/jdt/core/IRegion.java;2;0;4;1;1;1;1;3;75;1;3;455;148;148;1;0;0;3;4;455;0;4061;4;2;
/org.eclipse.ui/Eclipse UI/org/eclipse/ui/IExportWizard.java;2;0;2;1;0;0;0;2;5;1;2;257;5;5;1;0;0;2;2;257;0;457;2;2;
/org.eclipse.core.tests.runtime/src/org/eclipse/core/tests/internal/plugins/SoftPrereqTest_16.java;3;0;3;1;0;0;0;3;106;1;3;1794;116;116;1;0;0;3;3;1794;0;3476;3;3;
/org.eclipse.swt.examples/src/org/eclipse/swt/examples/controlexample/Images.java;2;0;3;1;0;0;0;3;50;1;3;513;50;50;1;0;0;3;3;513;0;970;3;2;
/org.eclipse.swt/Eclipse SWT Custom Widgets/common_j2se/org/eclipse/swt/custom/StyledTextListener.java;1;0;1;1;0;0;0;1;0;0;1;1378;0;0;1;0;0;1;1;1378;0;1378;1;1;
/org.eclipse.update.ui/src/org/eclipse/update/internal/ui/model/MyComputerFile.java;1;0;2;1;0;0;0;2;6;1;2;2797;6;6;1;0;0;2;2;2797;0;3740;2;1;
/org.eclipse.core.resources/src/org/eclipse/core/internal/indexing/FieldArray.java;3;0;6;1;1;1;1;5;150;1;5;12;287;287;1;0;0;5;6;12;0;4214;6;3;
/org.eclipse.core.resources/src/org/eclipse/core/internal/resources/ResourceInfo.java;2;0;8;1;1;1;1;7;626;1;7;12;679;679;1;0;0;7;8;12;0;4213;8;2;
/org.eclipse.swt.tests/JUnit Tests/org/eclipse/swt/tests/junit/Test_org_eclipse_swt_dnd_DropTargetEvent.java;2;0;2;1;1;1;1;1;6;0;1;1792;6;6;1;0;0;1;2;1792;0;4706;2;2;
/org.eclipse.jdt.ui/ui/org/eclipse/jdt/internal/ui/text/java/JavaCompletionProposalComparator.java;1;0;1;1;0;0;0;1;0;0;1;3643;0;0;1;0;0;1;1;3643;0;3643;1;1;
/org.eclipse.pde.ui/src/org/eclipse/pde/internal/parts/TablePart.java;1;0;2;1;0;0;0;2;0;1;2;2998;0;0;1;0;0;2;2;2998;0;3579;2;1;
/org.eclipse.swt/Eclipse SWT PI/win32/org/eclipse/swt/internal/win32/BITMAP.java;2;0;2;1;1;1;1;1;6;0;1;2069;6;6;1;0;0;1;2;2069;0;4701;2;2;
/org.eclipse.pde.ui/src/org/eclipse/pde/internal/ui/preferences/AdvancedTracingPreferencePage.java;1;0;3;1;0;0;0;3;11;1;3;3579;11;11;1;0;0;3;3;3579;0;3634;3;1;
/org.eclipse.ui/Eclipse JFace/org/eclipse/jface/viewers/IBasicPropertyConstants.java;3;0;3;1;0;0;0;3;8;1;3;257;13;13;1;0;0;3;3;257;0;719;3;3;
/org.eclipse.pde.ui/src/org/eclipse/pde/internal/PDELabelProvider.java;1;0;9;1;0;0;0;9;265;4;6;3031;434;434;4;3;0;9;9;3031;3;3579;6;1;
/org.eclipse.help.ui/Eclipse Help UI/org/eclipse/help/internal/ui/util/HelpPreferencePage.java;2;0;5;2;0;0;0;5;84;2;4;136;99;99;2;1;0;5;5;323;1;1420;4;2;
/org.eclipse.pde.ui/src/org/eclipse/pde/internal/ui/wizards/templates/PropertyPageTemplate.java;1;0;5;1;1;1;1;4;92;1;4;3812;133;133;1;0;0;4;5;3812;0;4316;5;1;
/org.eclipse.jdt.ui/ui/org/eclipse/jdt/internal/ui/text/correction/NewConstructorCompletionProposal.java;2;1;5;1;5;5;5;0;11;0;0;4189;21;21;1;0;0;0;5;4189;0;4621;5;2;
/org.eclipse.swt.tests/JUnit Tests/org/eclipse/swt/tests/junit/Test_org_eclipse_swt_dnd_DropTargetListener.java;2;0;2;1;1;1;1;1;6;0;1;1792;6;6;1;0;0;1;2;1792;0;4706;2;2;
/org.eclipse.update.core/src/org/eclipse/update/core/BaseFeature.java;1;0;1;1;0;0;0;1;0;0;1;2442;0;0;1;0;0;1;1;2442;0;2442;1;1;
/org.eclipse.core.runtime/src/org/eclipse/core/runtime/model/ConfigurationElementModel.java;3;1;5;1;2;2;2;3;276;1;3;12;305;305;1;0;0;3;5;12;0;4855;5;3;
/org.eclipse.ui.tests/Eclipse UI Tests/org/eclipse/ui/tests/propertysheet/PropertySheetTestSuite.java;2;0;2;1;0;0;0;2;9;1;2;1396;9;9;1;0;0;2;2;1396;0;1405;2;2;
/org.eclipse.help/Eclipse Help/org/eclipse/help/internal/server/HelpHttpRequest.java;3;0;8;2;0;0;0;8;7;2;7;135;26;26;2;1;0;8;8;490;1;1420;7;3;
/org.eclipse.help/Eclipse Help/org/eclipse/help/internal/contributors/xml/XMLTopicContributorCreator.java;2;0;3;1;0;0;0;3;7;1;3;135;7;7;1;0;0;3;3;135;0;1420;3;2;
/org.eclipse.jdt.ui/ui/org/eclipse/jdt/internal/ui/codemanipulation/AddGetterSetterOperation.java;2;0;21;1;0;0;0;21;172;3;18;15;573;573;3;3;0;21;21;2007;3;2007;18;2;
/org.eclipse.jdt.ui.tests.refactoring/resources/RenamePrivateField/testFail8/in/A.java;1;0;1;1;0;0;0;1;0;0;1;1547;0;0;1;0;0;1;1;1547;0;1547;1;1;
/org.eclipse.jdt.ui/core refactoring/org/eclipse/jdt/internal/core/refactoring/util/TextBufferChangeManager.java;2;0;4;1;0;0;0;4;39;1;4;1453;65;65;1;0;0;4;4;1453;0;1939;4;2;
/org.eclipse.core.resources/src/org/eclipse/core/internal/indexing/IndexedStoreContextFactory.java;3;0;3;1;0;0;0;3;5;1;3;12;5;5;1;0;0;3;3;12;0;448;3;3;
/org.eclipse.jdt.ui.tests.refactoring/resources/RenameNonPrivateField/test11/in/A.java;1;0;1;1;0;0;0;1;0;0;1;49;0;0;1;0;0;1;1;49;0;49;1;1;
/org.eclipse.ui/Eclipse UI Standard Components/org/eclipse/ui/wizards/datatransfer/WizardFileSystemResourceImportPage1.java;5;1;28;1;3;3;3;25;315;2;22;257;831;831;2;3;0;25;28;2960;3;4751;25;5;
/org.eclipse.help/src/org/eclipse/help/internal/remote/Help.java;1;0;2;1;0;0;0;2;0;1;2;1420;0;0;1;0;0;2;2;1420;0;1502;2;1;
/org.eclipse.swt.tests/JUnit Tests/org/eclipse/swt/tests/junit/Test_org_eclipse_swt_widgets_List.java;2;0;2;1;1;1;1;1;6;0;1;1792;6;6;1;0;0;1;2;1792;0;4706;2;2;
/org.eclipse.jdt.ui/nls/org/eclipse/jdt/internal/nls/changes/DeleteFileChange.java;1;0;3;1;0;0;0;3;4;2;2;1880;4;4;2;1;0;3;3;1880;1;1913;2;1;
/org.eclipse.jdt.ui/ui/org/eclipse/jdt/internal/ui/launcher/ProcessPropertyPage.java;3;0;7;1;0;0;0;7;7;1;7;143;21;21;1;0;0;7;7;143;0;1916;7;3;
/org.eclipse.ui/Eclipse UI/org/eclipse/ui/internal/dialogs/WorkbenchPreferenceDialog.java;1;2;3;1;3;2;3;0;52;0;0;4447;54;54;2;0;1;0;3;4447;1;4602;2;1;
/org.eclipse.pde.ui/src/org/eclipse/pde/internal/editor/manifest/JavaAttributeCellEditor.java;2;0;3;1;0;0;0;3;2;1;3;1434;2;2;1;0;0;3;3;1434;0;3579;3;2;
/org.eclipse.jdt.ui.tests/test plugin/org/eclipse/jdt/testplugin/JavaTestPlugin.java;2;0;3;1;0;0;0;3;20;1;3;49;24;24;1;0;0;3;3;49;0;1228;3;2;
/org.eclipse.help/src/org/eclipse/help/internal/contributions/xml1_0/HelpTopicRef.java;1;0;2;1;0;0;0;2;0;1;2;1675;0;0;1;0;0;2;2;1675;0;2217;2;1;
/org.eclipse.jdt.debug.ui/ui/org/eclipse/jdt/internal/debug/ui/actions/RemoveAction.java;1;0;2;1;1;1;1;1;2;0;1;3875;2;2;1;0;0;1;2;3875;0;4025;2;1;
/org.eclipse.core.resources/src/org/eclipse/core/internal/resources/File.java;3;1;23;1;2;2;2;21;584;2;19;12;881;881;2;2;0;21;23;3415;2;4454;21;3;
/org.eclipse.jdt.ui.tests.refactoring/resources/MoveMembers/testFail13/in/A.java;1;0;1;1;0;0;0;1;0;0;1;2738;0;0;1;0;0;1;1;2738;0;2738;1;1;
/org.eclipse.update.ui/src/org/eclipse/update/internal/ui/security/CertificateDialog.java;1;0;2;1;0;0;0;2;0;1;2;3174;0;0;1;0;0;2;2;3174;0;3191;2;1;
/org.eclipse.pde.ui/src/org/eclipse/pde/internal/ui/editor/ModifiedTextPropertyDescriptor.java;1;0;1;1;0;0;0;1;0;0;1;3579;0;0;1;0;0;1;1;3579;0;3579;1;1;
/org.eclipse.jdt.ui.tests.refactoring/resources/RenameParameters/canRename/A_test5_out.java;1;0;1;1;0;0;0;1;0;0;1;233;0;0;1;0;0;1;1;233;0;233;1;1;
/org.eclipse.pde.ui/Eclipse PDE UI/org/eclipse/pde/internal/wizards/extension/NewSchemaFileWizard.java;2;0;5;2;0;0;0;5;12;3;3;267;12;12;3;2;0;5;5;324;2;1434;3;2;
/org.eclipse.scripting/Eclipse Scripting/org/eclipse/scripting/internal/IXGRDataChangedNotifier.java;1;0;3;1;0;0;0;3;4;1;3;133;4;4;1;0;0;3;3;133;0;1424;3;1;
/org.eclipse.jdt.ui/ui debug/org/eclipse/jdt/internal/debug/ui/HexValuesAction.java;2;0;6;1;0;0;0;6;15;1;6;15;39;39;1;0;0;6;6;15;0;965;6;2;
/org.eclipse.jdt.core/compiler/org/eclipse/jdt/internal/compiler/ast/ArrayInitializer.java;2;0;13;1;1;1;1;12;303;4;9;455;431;431;4;3;0;12;13;1039;3;4062;10;2;
/org.eclipse.update.core/src/org/eclipse/update/internal/core/SiteContentConsumer.java;1;0;1;1;0;0;0;1;0;0;1;3018;0;0;1;0;0;1;1;3018;0;3018;1;1;
/org.eclipse.pde.ui/src/org/eclipse/pde/internal/wizards/templates/PDETemplateSection.java;1;0;5;1;0;0;0;5;30;1;5;3356;42;42;1;0;0;5;5;3356;0;3579;5;1;
/org.eclipse.swt.tests/JUnit Tests/org/eclipse/swt/tests/junit/Test_org_eclipse_swt_events_TreeAdapter.java;2;0;2;1;1;1;1;1;6;0;1;1792;6;6;1;0;0;1;2;1792;0;4706;2;2;
/org.eclipse.jdt.debug.ui/ui/org/eclipse/jdt/internal/debug/ui/snippeteditor/StopAction.java;2;0;3;1;0;0;0;3;7;1;3;1915;9;9;1;0;0;3;3;1915;0;3548;3;2;
/org.eclipse.pde.ui/src/org/eclipse/pde/internal/feature/FeatureSpecPage.java;1;0;5;1;0;0;0;5;5;1;5;2951;9;9;1;0;0;5;5;2951;0;3579;5;1;
/org.eclipse.jdt.ui/ui/org/eclipse/jdt/internal/ui/text/JavaReconciler.java;2;1;4;1;2;2;2;2;284;1;2;15;316;316;1;0;0;2;4;15;0;4599;4;2;
/org.eclipse.help.ui/src/org/eclipse/help/internal/ui/util/HelpWorkbenchException.java;2;0;4;1;1;1;1;3;6;1;3;1420;8;8;1;0;0;3;4;1420;0;4439;4;2;
/org.eclipse.ant.ui/src/org/eclipse/ant/internal/ui/OutputStructureElement.java;3;0;3;1;0;0;0;3;194;1;3;981;209;209;1;0;0;3;3;981;0;3606;3;3;
/org.eclipse.jdt.debug/eval/org/eclipse/jdt/internal/debug/eval/ast/engine/ArrayAccess.java;1;0;3;1;0;0;0;3;70;1;3;3329;70;70;1;0;0;3;3;3329;0;3421;3;1;
/org.eclipse.ui/Eclipse UI/org/eclipse/ui/internal/IObjectActionContributor.java;3;0;3;1;0;0;0;3;10;1;3;257;15;15;1;0;0;3;3;257;0;1528;3;3;
/org.eclipse.jdt.ui.tests.refactoring/resources/RenameVirtualMethodInClass/test31/in/A.java;1;0;2;1;0;0;0;2;2;1;2;49;2;2;1;0;0;2;2;49;0;512;2;1;
/org.eclipse.jdt.ui.tests/refactoring/org/eclipse/jdt/refactoring/tests/RenameSourceFolderChangeTests.java;2;0;5;1;0;0;0;5;6;1;5;1258;10;10;1;0;0;5;5;1258;0;1896;5;2;
/org.eclipse.debug.core/core/org/eclipse/debug/core/model/IExpression.java;2;0;4;1;1;1;1;3;8;2;2;2343;18;18;2;1;0;3;4;2343;1;4651;3;2;
/org.eclipse.ui/Eclipse UI/org/eclipse/ui/actions/CopyFilesAndFoldersOperation.java;3;4;8;2;8;4;8;0;503;0;0;4208;576;576;4;0;4;0;8;4261;4;4705;4;3;
/org.eclipse.pde.ui/Eclipse PDE UI/org/eclipse/pde/internal/forms/Form.java;2;0;12;2;0;0;0;12;21;3;10;267;69;69;3;2;0;12;12;324;2;1434;10;2;
/org.eclipse.pde.ui/src/org/eclipse/pde/internal/ui/editor/feature/ReferenceWizard.java;1;0;1;1;1;1;1;0;0;0;0;4262;0;0;1;0;0;0;1;4262;0;4262;1;1;
/org.eclipse.pde.ui/src/org/eclipse/pde/internal/ui/wizards/templates/ITemplateSection.java;1;0;2;1;0;0;0;2;0;1;2;3579;0;0;1;0;0;2;2;3579;0;3819;2;1;
/org.eclipse.ui.examples.propertysheet/Eclipse UI Examples PropertySheet/org/eclipse/ui/examples/propertysheet/MessageUtil.java;1;0;1;1;0;0;0;1;0;0;1;946;0;0;1;0;0;1;1;946;0;946;1;1;
/org.eclipse.jdt.core/eval/org/eclipse/jdt/internal/eval/CodeSnippetQualifiedNameReference.java;2;0;17;1;1;1;1;16;1008;4;12;455;1487;1487;4;4;0;16;17;1039;4;4062;13;2;
/org.eclipse.core.resources/src/org/eclipse/core/internal/indexing/Referable.java;2;0;3;1;1;1;1;2;50;1;2;448;65;65;1;0;0;2;3;448;0;4214;3;2;
/org.eclipse.compare/compare/org/eclipse/compare/patch/Diff.java;1;0;6;1;0;0;0;6;86;1;6;1516;168;168;1;0;0;6;6;1516;0;2876;6;1;
/org.eclipse.vcm.ui/src/org/eclipse/vcm/internal/ui/HistoryAction.java;1;0;1;1;0;0;0;1;0;0;1;1056;0;0;1;0;0;1;1;1056;0;1056;1;1;
/org.eclipse.jdt.ui.tests.refactoring/resources/ExtractMethodWorkSpace/ExtractMethodTests/locals_in/A_test552.java;1;1;3;1;2;2;2;1;24;0;1;1236;24;24;1;0;0;1;3;1236;0;4419;3;1;
/org.eclipse.jdt.ui/core refactoring/org/eclipse/jdt/internal/corext/refactoring/rename/RenameTypeRefactoring.java;2;1;22;2;2;2;2;20;226;3;16;1939;606;606;3;4;0;20;22;2133;4;4014;18;2;
/org.eclipse.jdt.ui/ui/org/eclipse/jdt/internal/ui/search/WorkingSetAction.java;1;2;6;1;4;3;4;2;21;1;2;1801;44;44;2;0;1;2;6;4137;1;4137;5;1;
/org.eclipse.update.core/src/org/eclipse/update/internal/model/InstallConfigurationParser.java;2;1;7;1;4;4;4;3;92;2;2;3027;219;219;2;1;0;3;7;3027;1;4170;6;2;
/org.eclipse.jdt.ui.tests.refactoring/resources/RenameTemp/cannotRename/A_testFail25.java;1;0;1;1;0;0;0;1;0;0;1;3309;0;0;1;0;0;1;1;3309;0;3309;1;1;
/org.eclipse.ant.ui/src/org/eclipse/ant/internal/ui/AntLaunchWizard.java;4;0;25;2;0;0;0;25;102;4;14;300;393;393;4;11;0;25;25;326;11;3601;14;4;
/org.eclipse.update.core/src/org/eclipse/update/internal/core/InstallConfigurationParser.java;2;0;11;1;0;0;0;11;109;2;10;2035;223;223;2;1;0;11;11;2098;1;2764;10;2;
/org.eclipse.jdt.ui.tests.refactoring/resources/RenamePackage/test4/in/r/A.java;1;0;1;1;0;0;0;1;0;0;1;1258;0;0;1;0;0;1;1;1258;0;1258;1;1;
/org.eclipse.vcm.ui.cvs/src/org/eclipse/vcm/internal/ui/ccvs/NewRepositoryMainPage.java;5;0;21;2;0;0;0;21;132;3;18;31;641;641;3;3;0;21;21;31;3;1682;18;5;
/org.eclipse.ui/Eclipse UI/org/eclipse/ui/internal/registry/MarkerQuery.java;1;0;1;1;0;0;0;1;0;0;1;2497;0;0;1;0;0;1;1;2497;0;2497;1;1;
/org.eclipse.update.ui.forms/src/org/eclipse/update/ui/forms/Form.java;1;0;2;1;0;0;0;2;0;1;2;1423;0;0;1;0;0;2;2;1423;0;1542;2;1;
/org.eclipse.jdt.junit/Eclipse JUnit/org/eclipse/jdt/junit/internal/IRunViewContext.java;2;0;2;1;0;0;0;2;0;1;2;1531;0;0;1;0;0;2;2;1531;0;2007;2;2;
/org.eclipse.core.resources/src/org/eclipse/core/internal/localstore/RefreshLocalWithStatusVisitor.java;4;0;6;1;0;0;0;6;56;2;5;12;118;118;2;1;0;6;6;327;1;3360;5;4;
/org.eclipse.swt.examples.ole.win32/org/eclipse/swt/examples/ole/win32/OlePlugin.java;3;0;3;1;1;1;1;2;170;1;2;513;170;170;1;0;0;2;3;513;0;4024;3;3;
/org.eclipse.jdt.debug.tests/testprograms/StepFilterOne.java;2;1;2;1;2;2;2;0;11;0;0;4510;11;11;1;0;0;0;2;4510;0;4571;2;2;
/org.eclipse.team.tests.cvs.core/src/org/eclipse/team/tests/ccvs/ui/logformatter/PrintDiffVisitor.java;2;0;4;1;0;0;0;4;158;1;4;2977;184;184;1;0;0;4;4;2977;0;3873;4;2;
/org.eclipse.debug.ui/ui/org/eclipse/debug/internal/ui/preferences/IDebugPreferenceConstants.java;3;1;8;1;8;8;8;0;160;0;0;3975;188;188;1;0;0;0;8;3975;0;4594;8;3;
/org.eclipse.jdt.debug/model/org/eclipse/jdt/internal/debug/core/AbstractJavaLineBreakpoint.java;4;0;9;2;0;0;0;9;92;2;8;1280;137;137;2;1;0;9;9;1449;1;1569;8;4;
/org.eclipse.pde.runtime/Eclipse PDE Runtime/org/eclipse/pde/internal/runtime/registry/ExtensionPropertySource.java;2;0;3;1;0;0;0;3;4;1;3;267;4;4;1;0;0;3;3;267;0;1434;3;2;
/org.eclipse.team.cvs.core/src/org/eclipse/team/internal/ccvs/core/util/CVSDateFormatter.java;2;1;6;1;2;2;2;4;59;1;4;3362;151;151;1;0;0;4;6;3362;0;4674;6;2;
/org.eclipse.jdt.ui.tests.refactoring/resources/DeleteSourceReferenceEdit/A_test0_in.java;1;0;1;1;0;0;0;1;0;0;1;2857;0;0;1;0;0;1;1;2857;0;2857;1;1;
/org.eclipse.jdt.ui/ui/org/eclipse/jdt/internal/ui/search/PrettySignature.java;3;0;7;1;0;0;0;7;11;1;7;15;32;32;1;0;0;7;7;15;0;2155;7;3;
/org.eclipse.jdt.ui.tests.refactoring/resources/MultiMove/test0/in/p2/C.java;1;0;1;1;0;0;0;1;0;0;1;1157;0;0;1;0;0;1;1;1157;0;1157;1;1;
/org.eclipse.jdt.debug.ui/ui/org/eclipse/jdt/internal/debug/ui/launcher/AddExceptionDialog.java;2;0;4;1;0;0;0;4;2;1;4;1915;4;4;1;0;0;4;4;1915;0;2384;4;2;
/org.eclipse.ui/Eclipse UI/org/eclipse/ui/internal/DecoratorDefinition.java;1;3;26;1;10;7;10;16;135;3;11;1990;830;830;3;5;3;16;26;3484;8;4429;18;1;
/org.eclipse.core.resources/src/org/eclipse/core/internal/watson/ElementTreeReaderImpl_1.java;2;0;7;1;1;1;1;6;200;1;6;12;242;242;1;0;0;6;7;12;0;4214;7;2;
/org.eclipse.pde.runtime/src/org/eclipse/pde/internal/runtime/registry/ExtensionPointPropertySource.java;1;0;1;1;0;0;0;1;0;0;1;1434;0;0;1;0;0;1;1;1434;0;1434;1;1;
/org.eclipse.jdt.ui/core refactoring/org/eclipse/jdt/internal/core/refactoring/changes/RenameSourceFolderChange.java;2;0;3;1;0;0;0;3;8;1;3;1342;8;8;1;0;0;3;3;1342;0;1939;3;2;
/org.eclipse.jdt.debug/eval/org/eclipse/jdt/internal/debug/eval/ast/instructions/PrefixMinusMinusOperator.java;3;0;6;1;0;0;0;6;20;1;6;3421;32;32;1;0;0;6;6;3421;0;3677;6;3;
/org.eclipse.jdt.ui/core refactoring/org/eclipse/jdt/internal/core/refactoring/changes/DeleteRefactoring.java;1;0;2;1;0;0;0;2;0;1;2;1108;0;0;1;0;0;2;2;1108;0;1257;2;1;
/org.eclipse.ui/Eclipse UI/org/eclipse/ui/internal/registry/ICategory.java;3;0;7;1;0;0;0;7;67;1;7;257;110;110;1;0;0;7;7;257;0;3529;7;3;
/org.eclipse.jdt.debug/jdi interfaces/com/sun/jdi/InvalidLineNumberException.java;2;0;2;1;0;0;0;2;7;1;2;2704;7;7;1;0;0;2;2;2704;0;3033;2;2;
/org.eclipse.swt.examples/org/eclipse/swt/examples/helloworld/HelloWorld3.java;4;0;5;1;1;1;1;4;40;1;4;513;75;75;1;0;0;4;5;513;0;4024;5;4;
/org.eclipse.jdt.core/model/org/eclipse/jdt/internal/core/builder/impl/StateSnapConstantPool.java;1;0;11;1;0;0;0;11;1274;4;7;455;1850;1850;4;4;0;11;11;1039;4;2808;7;1;
/org.eclipse.update.ui.forms/src/org/eclipse/update/ui/forms/WebForm.java;1;0;8;1;0;0;0;8;120;2;7;1542;223;223;2;1;0;8;8;1542;1;2474;7;1;
/org.eclipse.update.core/src/org/eclipse/update/internal/core/obsolete/SiteFile.java;1;0;1;1;0;0;0;1;0;0;1;2487;0;0;1;0;0;1;1;2487;0;2487;1;1;
/org.eclipse.jdt.debug/model/org/eclipse/jdt/internal/debug/core/JavaLineBreakpoint.java;3;0;24;1;0;0;0;24;283;2;21;1035;1010;1010;2;3;0;24;24;1035;3;2517;21;3;
/org.eclipse.jdt.ui.tests.refactoring/resources/MoveMembers/test6/out/B.java;1;0;1;1;0;0;0;1;0;0;1;2738;0;0;1;0;0;1;1;2738;0;2738;1;1;
/org.eclipse.jdt.ui/ui/org/eclipse/jdt/internal/ui/javaeditor/JarEntryEditorInput.java;1;0;4;1;0;0;0;4;12;1;4;15;19;19;1;0;0;4;4;15;0;437;4;1;
/org.eclipse.jdt.ui.tests.refactoring/resources/ExtractMethodWorkSpace/ExtractMethodTests/locals_out/A_test563.java;1;1;3;1;2;2;2;1;34;0;1;1236;34;34;1;0;0;1;3;1236;0;4419;3;1;
/org.eclipse.vcm.ui/src/org/eclipse/vcm/internal/ui/actions/CompareWithTeamStreamAction.java;3;0;9;2;0;0;0;9;25;3;6;1;79;79;3;3;0;9;9;295;3;531;6;3;
/org.eclipse.swt/Eclipse SWT/carbon/org/eclipse/swt/widgets/Sash.java;3;1;4;1;4;4;4;0;14;0;0;4147;24;24;1;0;0;0;4;4147;0;4701;4;3;
/org.eclipse.ui.tests/Eclipse JFace Tests/org/eclipse/jface/tests/viewers/interactive/TestCheckboxTree.java;1;0;1;1;0;0;0;1;0;0;1;1488;0;0;1;0;0;1;1;1488;0;1488;1;1;
/org.eclipse.jdt.ui.tests.refactoring/resources/ExtractMethodWorkSpace/ExtractMethodTests/validSelection_out/A_test365.java;1;1;4;1;2;2;2;2;1;1;2;3736;1;1;1;0;0;2;4;3736;0;4419;4;1;
/org.eclipse.compare/compare/org/eclipse/compare/IPropertyChangeNotifier.java;1;0;2;1;0;0;0;2;5;1;2;14;5;5;1;0;0;2;2;14;0;329;2;1;
/org.eclipse.jdt.ui.tests.refactoring/resources/RenameVariables/cannotRename/A_testFail5.java;1;0;2;1;0;0;0;2;0;1;2;724;0;0;1;0;0;2;2;724;0;1665;2;1;
/org.eclipse.jdt.ui/core refactoring/org/eclipse/jdt/internal/core/refactoring/cus/MoveCompilationUnitRefactoring.java;3;0;9;1;0;0;0;9;75;2;8;408;128;128;2;1;0;9;9;962;1;1257;8;3;
/org.eclipse.swt/Eclipse SWT/carbon/org/eclipse/swt/widgets/Shell.java;3;1;4;1;4;4;4;0;126;0;0;4147;144;144;1;0;0;0;4;4147;0;4701;4;3;
/org.eclipse.swt/Eclipse SWT PI/gtk/org/eclipse/swt/internal/gtk/GtkSelectionData.java;2;2;6;1;3;2;3;3;29;1;3;3605;65;65;2;0;1;3;6;4701;1;4701;5;2;
/org.eclipse.jdt.ui/ui/org/eclipse/jdt/internal/ui/reorg/DeleteSupport.java;3;0;8;1;0;0;0;8;52;1;8;15;81;81;1;0;0;8;8;15;0;1258;8;3;
/org.eclipse.jdt.ui.tests.refactoring/resources/DeleteSourceReference/A_test0_in.java;1;0;2;1;0;0;0;2;0;1;2;2003;0;0;1;0;0;2;2;2003;0;2857;2;1;
/org.eclipse.pde.core/src/org/eclipse/pde/internal/core/IModelProvider.java;1;0;1;1;0;0;0;1;0;0;1;3591;0;0;1;0;0;1;1;3591;0;3591;1;1;
/org.eclipse.jdt.ui/core refactoring/org/eclipse/jdt/internal/core/refactoring/base/IUndoManager.java;2;0;4;1;0;0;0;4;46;1;4;408;52;52;1;0;0;4;4;408;0;1939;4;2;
/org.eclipse.jdt.ui/ui/org/eclipse/jdt/internal/ui/wizards/swt/MGridData.java;2;0;5;1;0;0;0;5;14;2;4;15;21;21;2;1;0;5;5;3084;1;3084;4;2;
/org.eclipse.jdt.ui/core refactoring/org/eclipse/jdt/internal/core/refactoring/util/WorkingCopyUtil.java;2;0;2;1;0;0;0;2;0;1;2;1910;0;0;1;0;0;2;2;1910;0;1939;2;2;
/org.eclipse.team.cvs.ui/src/org/eclipse/team/internal/ccvs/ui/IDecorationNotifier.java;1;0;2;1;0;0;0;2;7;1;2;2484;7;7;1;0;0;2;2;2484;0;3207;2;1;
/org.eclipse.help/src/org/eclipse/help/internal/topics/Include.java;2;0;2;1;0;0;0;2;0;1;2;1675;0;0;1;0;0;2;2;1675;0;1804;2;2;
/org.eclipse.jdt.ui.tests.refactoring/resources/ExtractMethodWorkSpace/ExtractMethodTests/expression_out/A_test612.java;1;1;4;1;2;2;2;2;4;1;2;1236;4;4;1;0;0;2;4;1236;0;4419;4;1;
/org.eclipse.swt/Eclipse SWT/carbon/org/eclipse/swt/widgets/FontDialog.java;3;1;4;1;4;4;4;0;6;0;0;4147;14;14;1;0;0;0;4;4147;0;4701;4;3;
/org.eclipse.jdt.ui.tests.refactoring/resources/ExtractMethodWorkSpace/ExtractMethodTests/locals_out/A_test566.java;1;1;2;1;2;2;2;0;0;0;0;4383;0;0;1;0;0;0;2;4383;0;4419;2;1;
/org.eclipse.swt/Eclipse SWT PI/gtk1x/org/eclipse/swt/internal/gtk/GtkCListColumn.java;2;0;2;1;1;1;1;1;3;0;1;2107;3;3;1;0;0;1;2;2107;0;4701;2;2;
/org.eclipse.core.tests.runtime/src/org/eclipse/core/tests/plugintests/CmdLineAndPrimaryFeatureTest.java;1;0;1;1;1;1;1;0;0;0;0;4006;0;0;1;0;0;0;1;4006;0;4006;1;1;
/org.eclipse.scripting/Eclipse Scripting/org/eclipse/scripting/IDataElement.java;1;0;3;1;0;0;0;3;7;1;3;133;7;7;1;0;0;3;3;133;0;1424;3;1;
/org.eclipse.ui.examples.propertysheet/Eclipse UI Examples PropertySheet/org/eclipse/ui/examples/propertysheet/EmailAddressValidator.java;2;0;2;1;0;0;0;2;4;1;2;931;4;4;1;0;0;2;2;931;0;946;2;2;
/org.eclipse.core.boot/src/org/eclipse/core/internal/boot/update/ComponentEntryDescriptorModel.java;3;0;5;1;0;0;0;5;7;1;5;12;13;13;1;0;0;5;5;12;0;2726;5;3;
/org.eclipse.update.ui.forms/src/org/eclipse/update/ui/forms/internal/IHyperlinkListener.java;1;0;1;1;0;0;0;1;0;0;1;2470;0;0;1;0;0;1;1;2470;0;2470;1;1;
/org.eclipse.jdt.core/model/org/eclipse/jdt/internal/core/newbuilder/SimpleLookupTable.java;1;0;7;1;0;0;0;7;46;1;7;1961;85;85;1;0;0;7;7;1961;0;2979;7;1;
/org.eclipse.ui/Eclipse UI/org/eclipse/ui/internal/RootLayoutContainer.java;3;0;4;1;0;0;0;4;11;1;4;257;20;20;1;0;0;4;4;257;0;1915;4;3;
/org.eclipse.jdt.ui.tests.refactoring/resources/RenameType/test2/in/A.java;1;0;1;1;0;0;0;1;0;0;1;49;0;0;1;0;0;1;1;49;0;49;1;1;
/org.eclipse.jdt.ui/nls/org/eclipse/jdt/internal/ui/nls/search/GotoMarkerAction.java;1;0;2;1;0;0;0;2;0;1;2;1880;0;0;1;0;0;2;2;1880;0;1913;2;1;
/org.eclipse.jdt.debug.ui/ui/org/eclipse/jdt/internal/debug/ui/JavaStackFrameAdapterFactory.java;1;0;1;1;1;1;1;0;0;0;0;4552;0;0;1;0;0;0;1;4552;0;4552;1;1;
/org.eclipse.jdt.ui.tests.refactoring/resources/RenameStaticMethod/test4/in/A.java;1;0;1;1;0;0;0;1;0;0;1;49;0;0;1;0;0;1;1;49;0;49;1;1;
/org.eclipse.swt/Eclipse SWT/emulated/treetable/org/eclipse/swt/widgets/Table.java;9;2;24;2;12;8;12;12;242;1;12;1028;559;559;2;0;4;12;24;3938;4;4701;20;9;
/org.eclipse.jdt.ui.tests.refactoring/resources/RenameNonPrivateField/test2/out/A.java;2;0;2;1;0;0;0;2;2;1;2;49;2;2;1;0;0;2;2;49;0;1297;2;2;
/org.eclipse.jdt.ui/core extension/org/eclipse/jdt/internal/corext/codemanipulation/AddImportsOperation.java;1;0;1;1;0;0;0;1;0;0;1;2137;0;0;1;0;0;1;1;2137;0;2137;1;1;
/org.eclipse.swt/Eclipse SWT/motif/org/eclipse/swt/widgets/TabFolder.java;2;0;5;1;0;0;0;5;322;1;5;106;600;600;1;0;0;5;5;106;0;1029;5;2;
/org.eclipse.team.cvs.core/src/org/eclipse/team/internal/ccvs/core/client/RemovedHandler.java;2;0;8;1;0;0;0;8;54;1;8;2572;82;82;1;0;0;8;8;2572;0;3610;8;2;
/org.eclipse.jdt.ui/core refactoring/org/eclipse/jdt/internal/core/refactoring/tagging/IPreactivatedRefactoring.java;2;0;2;1;0;0;0;2;0;1;2;408;0;0;1;0;0;2;2;408;0;1406;2;2;
/org.eclipse.jdt.ui/ui/org/eclipse/jdt/internal/ui/text/java/IJavaCompletionProposal.java;1;0;2;1;0;0;0;2;8;0;1;3643;8;8;2;1;0;2;2;3643;1;3643;1;1;
/org.eclipse.pde.ui/Eclipse PDE UI/org/eclipse/pde/internal/preferences/ManifestPreferencePage.java;2;0;3;2;0;0;0;3;4;2;2;324;4;4;2;1;0;3;3;324;1;337;2;2;
/org.eclipse.core.runtime/src/org/eclipse/core/runtime/model/PluginFragmentModel.java;4;0;9;1;1;1;1;8;252;1;8;23;333;333;1;0;0;8;9;23;0;4214;9;4;
/org.eclipse.debug.core/core/org/eclipse/debug/core/IStatusHandler.java;3;0;4;1;1;1;1;3;6;1;3;3122;12;12;1;0;0;3;4;3122;0;4650;4;3;
/org.eclipse.webdav/src/client/org/eclipse/webdav/client/URLKey.java;3;0;3;1;0;0;0;3;13;1;3;12;13;13;1;0;0;3;3;12;0;1874;3;3;
/org.eclipse.ui/Eclipse JFace/org/eclipse/jface/action/SubToolBarManager.java;2;0;2;1;0;0;0;2;5;1;2;257;5;5;1;0;0;2;2;257;0;457;2;2;
/org.eclipse.jdt.ui/core refactoring/org/eclipse/jdt/internal/core/refactoring/ASTParentTrackingAdapter.java;3;0;6;1;0;0;0;6;21;1;6;216;44;44;1;0;0;6;6;216;0;1462;6;3;
/org.eclipse.ui/Eclipse UI Standard Components/org/eclipse/ui/wizards/datatransfer/FileSystemStructureProvider.java;2;0;2;1;0;0;0;2;14;1;2;257;14;14;1;0;0;2;2;257;0;457;2;2;
/org.eclipse.core.tests.runtime/src/org/eclipse/core/tests/internal/plugins/PluginResolveTest_7.java;4;0;4;1;0;0;0;4;102;1;4;1794;117;117;1;0;0;4;4;1794;0;3476;4;4;
/org.eclipse.jdt.debug.ui/ui/org/eclipse/jdt/internal/debug/ui/launcher/StandardVM.java;2;0;8;1;0;0;0;8;2;1;8;1915;12;12;1;0;0;8;8;1915;0;3122;8;2;
/org.eclipse.swt.tests/JUnit Tests/org/eclipse/swt/tests/junit/Test_org_eclipse_swt_dnd_RTFTransfer.java;2;0;2;1;1;1;1;1;6;0;1;1792;6;6;1;0;0;1;2;1792;0;4706;2;2;
/org.eclipse.scripting/Eclipse Scripting/org/eclipse/scripting/internal/IXGRElementUIRunnable.java;1;0;3;1;0;0;0;3;4;1;3;133;4;4;1;0;0;3;3;133;0;1424;3;1;
/org.eclipse.pde.ui/src/org/eclipse/pde/internal/ui/editor/build/BuildPage.java;1;0;1;1;0;0;0;1;0;0;1;3579;0;0;1;0;0;1;1;3579;0;3579;1;1;
/org.eclipse.jdt.ui.tests.refactoring/resources/RenameTemp/canRename/A_test16_out.java;1;0;2;1;0;0;0;2;2;1;2;1625;2;2;1;0;0;2;2;1625;0;1652;2;1;
/org.eclipse.jdt.core/dom/org/eclipse/jdt/core/dom/Modifier.java;2;0;3;1;1;1;1;2;22;1;2;2669;24;24;1;0;0;2;3;2669;0;4452;3;2;
/org.eclipse.pde.build/src/plugin/org/eclipse/pde/internal/core/IPDECoreConstants.java;1;0;1;1;0;0;0;1;0;0;1;3475;0;0;1;0;0;1;1;3475;0;3475;1;1;
/org.eclipse.jdt.core/search/org/eclipse/jdt/internal/core/search/processing/JobManager.java;4;2;31;2;10;7;10;21;464;4;16;455;1484;1484;4;5;3;21;31;1039;8;4322;23;4;
/org.eclipse.ui/Eclipse JFace Text/org/eclipse/jface/text/contentassist/ContentAssistant.java;5;1;19;1;4;4;4;15;593;1;15;257;1335;1335;1;0;0;15;19;257;0;4853;19;5;
/org.eclipse.jdt.debug/eval/org/eclipse/jdt/internal/debug/eval/ast/engine/DivideOperator.java;1;0;2;1;0;0;0;2;0;1;2;3329;0;0;1;0;0;2;2;3329;0;3421;2;1;
/org.eclipse.update.ui/src/org/eclipse/update/internal/ui/search/UpdatesSearchCategory.java;2;2;13;1;9;8;9;4;143;2;3;3553;358;358;2;1;1;4;13;3658;2;4715;11;2;
/org.eclipse.swt/Eclipse SWT OLE Win32/win32/org/eclipse/swt/ole/win32/OleListener.java;2;0;3;1;1;1;1;2;6;1;2;106;11;11;1;0;0;2;3;106;0;4701;3;2;
/org.eclipse.help.ui/src/org/eclipse/help/internal/ui/HelpPerspective.java;2;0;4;1;0;0;0;4;14;1;4;1420;15;15;1;0;0;4;4;1420;0;3030;4;2;
/org.eclipse.swt/Eclipse SWT/win32/org/eclipse/swt/internal/BidiUtil.java;5;1;16;3;2;2;2;14;202;3;11;1349;436;436;3;3;0;14;16;2053;3;4701;13;5;
/org.eclipse.pde.ui/src/org/eclipse/pde/internal/editor/manifest/ManifestTemplatePage.java;1;0;2;1;0;0;0;2;0;1;2;3365;0;0;1;0;0;2;2;3365;0;3579;2;1;
/org.eclipse.jdt.ui.tests.refactoring/resources/RenameParameters/canRename/A_test1_in.java;1;0;1;1;0;0;0;1;0;0;1;233;0;0;1;0;0;1;1;233;0;233;1;1;
/org.eclipse.pde.ui/src/org/eclipse/pde/internal/ui/editor/schema/IRestrictionPage.java;1;0;2;1;0;0;0;2;2;1;2;3579;2;2;1;0;0;2;2;3579;0;3591;2;1;
/org.eclipse.vcm.core.cvs/src/org/eclipse/vcm/internal/core/ccvs/CVSAdapter.java;6;0;58;3;0;0;0;58;187;4;40;0;2162;2162;4;18;0;58;58;292;18;2366;40;6;
/org.eclipse.jdt.ui.tests.refactoring/resources/ExtractMethodWorkSpace/ExtractMethodTests/expression_out/A_test600.java;2;1;4;1;2;2;2;2;22;1;2;239;23;23;1;0;0;2;4;239;0;4419;4;2;
/org.eclipse.team.cvs.core/src/org/eclipse/team/internal/ccvs/core/commands/Add.java;3;0;7;1;0;0;0;7;246;1;7;1978;520;520;1;0;0;7;7;1978;0;2607;7;3;
/org.eclipse.core.resources/src/org/eclipse/core/resources/IWorkspaceRoot.java;3;0;10;1;1;1;1;9;248;2;8;12;324;324;2;1;0;9;10;1394;1;4214;9;3;
/org.eclipse.swt/Eclipse SWT/carbon/org/eclipse/swt/widgets/DirectoryDialog.java;3;1;4;1;4;4;4;0;6;0;0;4147;15;15;1;0;0;0;4;4147;0;4701;4;3;
/org.eclipse.swt/Eclipse SWT/win32/org/eclipse/swt/internal/win32/LOGFONT.java;2;0;4;1;0;0;0;4;5;1;4;106;9;9;1;0;0;4;4;106;0;2069;4;2;
/org.eclipse.core.resources/src/org/eclipse/core/internal/resources/WorkManager.java;4;1;7;1;2;2;2;5;446;1;5;12;569;569;1;0;0;5;7;12;0;4213;7;4;
/org.eclipse.update/Eclipse Update/org/eclipse/update/internal/ui/UMWizardPageURLInstalling.java;2;0;4;1;0;0;0;4;493;1;4;108;497;497;1;0;0;4;4;108;0;1424;4;2;
/org.eclipse.jdt.ui.tests/ui/org/eclipse/jdt/internal/ui/dialogs/tests/StringInputDialogTest.java;2;0;2;1;0;0;0;2;0;1;2;522;0;0;1;0;0;2;2;522;0;1186;2;2;
/org.eclipse.jdt.debug.tests/tests/org/eclipse/jdt/debug/tests/eval/TestsOperators1.java;2;2;4;2;4;3;4;0;12;0;0;4447;18;18;2;0;1;0;4;4568;1;4568;3;2;
/org.eclipse.jdt.ui/ui refactoring/org/eclipse/jdt/internal/ui/refactoring/IPreviewViewer.java;1;0;2;1;0;0;0;2;2;1;2;1800;2;2;1;0;0;2;2;1800;0;2512;2;1;
/org.eclipse.jdt.ui.tests/nls/org/eclipse/jdt/ui/nls/tests/OrderedMapTester.java;1;0;3;1;0;0;0;3;2;1;3;1754;2;2;1;0;0;3;3;1754;0;1939;3;1;
/org.eclipse.jdt.ui.tests.refactoring/resources/ExtractMethodWorkSpace/ExtractMethodTests/return_out/A_test723.java;1;1;4;1;2;2;2;2;30;1;2;2580;32;32;1;0;0;2;4;2580;0;4419;4;1;
/org.eclipse.pde.ui/Eclipse PDE UI/org/eclipse/pde/internal/editor/jars/JarsForm.java;2;0;5;2;0;0;0;5;12;3;3;267;12;12;3;2;0;5;5;324;2;1434;3;2;
/org.eclipse.swt.examples.launcher/org/eclipse/swt/examples/launcher/SplitLayout.java;3;0;3;1;1;1;1;2;12;1;2;581;12;12;1;0;0;2;3;581;0;4024;3;3;
/org.eclipse.debug.ui/ui/org/eclipse/debug/internal/ui/RunWithAction.java;1;0;2;1;0;0;0;2;0;1;2;2254;0;0;1;0;0;2;2;2254;0;2382;2;1;
/org.eclipse.core.tests.resources/src/org/eclipse/core/tests/resources/perf/MarkerPerformanceTest.java;3;0;3;1;0;0;0;3;230;1;3;1794;235;235;1;0;0;3;3;1794;0;3420;3;3;
/org.eclipse.jdt.ui/ui/org/eclipse/jdt/internal/ui/codemanipulation/AddMethodStubOperation.java;2;0;18;1;0;0;0;18;132;1;18;15;325;325;1;0;0;18;18;15;0;2016;18;2;
/org.eclipse.jdt.debug.tests/tests/org/eclipse/jdt/debug/tests/eval/TypeHierarchy_21_2.java;2;1;3;1;3;3;3;0;13;0;0;4447;15;15;1;0;0;0;3;4447;0;4571;3;2;
/org.eclipse.help.webapp/src/org/eclipse/help/servlet/ContentUtil.java;1;0;2;1;0;0;0;2;13;1;2;3449;13;13;1;0;0;2;2;3449;0;3776;2;1;
/org.eclipse.jdt.ui/core refactoring/org/eclipse/jdt/core/refactoring/packages/RenamePackageRefactoring.java;1;0;11;1;0;0;0;11;49;2;10;15;162;162;2;1;0;11;11;325;1;408;10;1;
/org.eclipse.pde.ui/src/org/eclipse/pde/ITemplateSection.java;1;0;4;1;0;0;0;4;23;2;3;3240;25;25;2;1;0;4;4;3240;1;3278;3;1;
/org.eclipse.core.runtime/src/org/eclipse/core/internal/runtime/AdapterManager.java;4;1;6;1;2;2;2;4;416;1;4;12;451;451;1;0;0;4;6;12;0;4824;6;4;
/org.eclipse.help/src/org/eclipse/help/internal/search/IndexProgressMonitor.java;2;0;3;1;1;1;1;2;2;1;2;2429;2;2;1;0;0;2;3;2429;0;4000;3;2;
/org.eclipse.pde.ui/Eclipse PDE UI/org/eclipse/pde/internal/component/FragmentListPage.java;2;0;5;2;0;0;0;5;12;3;3;267;12;12;3;2;0;5;5;324;2;1434;3;2;
/org.eclipse.webdav/src/kernel/org/eclipse/webdav/internal/kernel/ContextFactoryImpl.java;2;0;3;1;0;0;0;3;5;1;3;12;5;5;1;0;0;3;3;12;0;1874;3;2;
/org.eclipse.jdt.ui.tests.refactoring/resources/SelectionAnalyzerWorkSpace/SelectionAnalyzerTests/invalidSelection/A_test112.java;1;0;1;1;0;0;0;1;0;0;1;1368;0;0;1;0;0;1;1;1368;0;1368;1;1;
/org.eclipse.webdav/src/interface/org/eclipse/webdav/dom/ConflictReportResponse.java;2;0;4;1;1;1;1;3;88;1;3;12;118;118;1;0;0;3;4;12;0;4211;4;2;
/org.eclipse.swt/Eclipse SWT/common/org/eclipse/swt/internal/image/JPEGFileFormat.java;3;0;6;1;1;1;1;5;72;1;5;106;99;99;1;0;0;5;6;106;0;4701;6;3;
/org.eclipse.update.tests.core/src/org/eclipse/update/tests/model/AllModelTests.java;1;0;1;1;0;0;0;1;0;0;1;2858;0;0;1;0;0;1;1;2858;0;2858;1;1;
/org.eclipse.ui/Eclipse UI Standard Components/org/eclipse/ui/views/internal/framelist/BackAction.java;3;0;4;1;0;0;0;4;20;1;4;257;23;23;1;0;0;4;4;257;0;3816;4;3;
/org.eclipse.jdt.ui/ui/org/eclipse/jdt/internal/ui/javaeditor/CompilationUnitDocumentProvider.java;9;2;53;3;18;16;18;35;362;4;24;15;2203;2203;4;11;2;35;53;413;13;4805;40;9;
/org.eclipse.ui/Eclipse JFace Text/org/eclipse/jface/text/reconciler/Reconciler.java;4;1;6;1;2;2;2;4;325;1;4;257;592;592;1;0;0;4;6;257;0;4838;6;4;
/org.eclipse.jdt.core/compiler/org/eclipse/jdt/internal/compiler/impl/NullConstant.java;2;0;11;1;1;1;1;10;32;4;6;455;72;72;4;4;0;10;11;1039;4;4062;7;2;
/org.eclipse.jdt.ui.tests.refactoring/resources/RenamePrivateMethod/test25/in/A.java;1;0;1;1;0;0;0;1;0;0;1;49;0;0;1;0;0;1;1;49;0;49;1;1;
/org.eclipse.swt.examples/src/org/eclipse/swt/examples/layoutexample/GridLayoutTab.java;3;1;6;1;3;3;3;3;198;1;3;3420;229;229;1;0;0;3;6;3420;0;4705;6;3;
/org.eclipse.help/src/org/eclipse/help/internal/contributors/xml/XMLTopicContributorCreator.java;2;0;2;1;0;0;0;2;0;1;2;1420;0;0;1;0;0;2;2;1420;0;1675;2;2;
/org.eclipse.team.cvs.ui/src/org/eclipse/team/internal/ccvs/ui/CVSOperationCancelledException.java;2;0;3;1;0;0;0;3;62;1;3;1978;62;62;1;0;0;3;3;1978;0;2739;3;2;
/org.eclipse.swt.examples.paint/org/eclipse/swt/examples/paint/EllipseTool.java;4;0;5;2;1;1;1;4;81;2;3;513;83;83;2;1;0;4;5;609;1;4024;4;4;
/org.eclipse.help/src/org/eclipse/help/internal/contributions1_0/Visitor.java;1;0;2;1;0;0;0;2;0;1;2;1675;0;0;1;0;0;2;2;1675;0;2217;2;1;
/org.eclipse.help/Eclipse Help/org/eclipse/help/internal/remote/Help.java;3;0;4;1;0;0;0;4;12;1;4;135;19;19;1;0;0;4;4;135;0;1420;4;3;
/org.eclipse.ui/Eclipse UI/org/eclipse/ui/internal/OpenWorkbenchAction.java;3;0;4;1;0;0;0;4;18;1;4;1673;20;20;1;0;0;4;4;1673;0;3050;4;3;
/org.eclipse.jdt.ui/ui/org/eclipse/jdt/internal/ui/launcher/JDK12DebugLauncher.java;5;0;18;1;0;0;0;18;57;2;16;15;287;287;2;2;0;18;18;218;2;1916;16;5;
/org.eclipse.pde.ui/src/org/eclipse/pde/internal/core/schema/SchemaCompositor.java;1;0;4;1;0;0;0;4;208;2;3;3579;210;210;2;1;0;4;4;3579;1;3607;3;1;
/org.eclipse.jdt.core/search/org/eclipse/jdt/internal/core/search/matching/FieldDeclarationPattern.java;2;0;13;1;1;1;1;12;942;4;8;455;1962;1962;4;4;0;12;13;1039;4;4063;9;2;
/org.eclipse.pde.build/src/plugin/org/eclipse/pde/internal/core/Utils.java;1;0;1;1;0;0;0;1;0;0;1;3475;0;0;1;0;0;1;1;3475;0;3475;1;1;
/org.eclipse.jdt.core/model/org/eclipse/jdt/core/IImportDeclaration.java;2;1;6;1;3;3;3;3;31;1;3;455;82;82;1;0;0;3;6;455;0;4421;6;2;
/org.eclipse.jdt.ui/ui refactoring/org/eclipse/jdt/internal/ui/refactoring/TextInputWizardPage.java;3;0;10;1;0;0;0;10;167;2;9;15;272;272;2;1;0;10;10;142;1;1939;9;3;
/org.eclipse.core.tests.runtime/src/org/eclipse/core/tests/internal/plugins/ActivationTest_Base.java;4;0;4;1;0;0;0;4;136;1;4;1794;166;166;1;0;0;4;4;1794;0;3476;4;4;
/org.eclipse.pde.ui/src/org/eclipse/pde/internal/ui/editor/text/PDEScanner.java;1;0;2;1;1;1;1;1;2;0;1;3579;2;2;1;0;0;1;2;3579;0;4588;2;1;
/org.eclipse.vcm.ui/src/org/eclipse/vcm/internal/ui/ResourceLoader.java;6;0;27;2;0;0;0;27;232;4;16;1;1243;1243;4;11;0;27;27;160;11;1591;16;6;
/org.eclipse.help/src/org/eclipse/help/internal/navigation1_0/NavigationModel.java;2;0;3;1;0;0;0;3;32;1;3;1675;32;32;1;0;0;3;3;1675;0;2217;3;2;
/org.eclipse.jdt.ui.tests.refactoring/resources/RenameType/test5/out/A.java;1;0;2;1;0;0;0;2;0;1;2;49;0;0;1;0;0;2;2;49;0;522;2;1;
/org.eclipse.update.ui/src/org/eclipse/update/internal/ui/manager/DetailsHistoryItem.java;1;0;4;1;0;0;0;4;14;1;4;1562;19;19;1;0;0;4;4;1562;0;3662;4;1;
/org.eclipse.ui/Eclipse UI/org/eclipse/ui/actions/MoveProjectAction.java;5;0;7;1;0;0;0;7;25;1;7;257;46;46;1;0;0;7;7;257;0;3607;7;5;
/org.eclipse.jdt.ui.tests.refactoring/resources/RenameParameters/canRename/A_test8_out.java;1;0;1;1;0;0;0;1;0;0;1;233;0;0;1;0;0;1;1;233;0;233;1;1;
/org.eclipse.update.core/src/org/eclipse/update/internal/core/IWritable.java;1;0;1;1;0;0;0;1;0;0;1;1948;0;0;1;0;0;1;1;1948;0;1948;1;1;
/org.eclipse.swt/Eclipse SWT/photon/org/eclipse/swt/internal/photon/PhRegion_t.java;2;0;3;1;0;0;0;3;6;1;3;106;6;6;1;0;0;3;3;106;0;2069;3;2;
/org.eclipse.jdt.debug/eval/org/eclipse/jdt/internal/debug/eval/ast/instructions/UnsignedRightShiftAssignmentOperator.java;2;0;5;1;1;1;1;4;4;1;4;3421;10;10;1;0;0;4;5;3421;0;3955;5;2;
/org.eclipse.jdt.core/model/org/eclipse/jdt/internal/core/util/LRUCache.java;3;1;11;1;3;3;3;8;255;4;5;455;358;358;4;3;0;8;11;1039;3;4422;8;3;
/org.eclipse.update.ui/src/org/eclipse/update/ui/internal/model/MissingFeature.java;3;0;8;1;0;0;0;8;88;2;7;2189;151;151;2;1;0;8;8;2434;1;2797;7;3;
/org.eclipse.swt/Eclipse SWT PI/win32/org/eclipse/swt/internal/ole/win32/EXCEPINFO.java;2;0;2;1;1;1;1;1;6;0;1;2069;6;6;1;0;0;1;2;2069;0;4701;2;2;
/org.eclipse.jdt.ui/ui refactoring/org/eclipse/jdt/internal/ui/refactoring/actions/UndoRefactoringAction.java;2;0;6;1;2;1;2;4;80;1;4;1345;136;136;2;0;1;4;6;4094;1;4094;5;2;
/org.eclipse.jdt.ui.tests.refactoring/resources/RenameTemp/canRename/A_test40_in.java;1;0;1;1;0;0;0;1;0;0;1;3322;0;0;1;0;0;1;1;3322;0;3322;1;1;
/org.eclipse.core.resources/src/org/eclipse/core/internal/watson/ElementTreeWriter.java;2;0;5;1;1;1;1;4;476;1;4;12;509;509;1;0;0;4;5;12;0;4214;5;2;
/org.eclipse.pde.ui/Eclipse PDE UI/org/eclipse/pde/internal/base/model/IModelChangedListener.java;2;0;5;2;0;0;0;5;12;3;3;267;12;12;3;2;0;5;5;324;2;1434;3;2;
/org.eclipse.jdt.core/compiler/org/eclipse/jdt/internal/compiler/ast/ThrowStatement.java;2;0;15;1;1;1;1;14;630;4;11;455;1104;1104;4;3;0;14;15;1039;3;4062;12;2;
/org.eclipse.pde.ui/Eclipse PDE UI/org/eclipse/pde/internal/editor/PDEMultiPageContentOutline.java;2;0;6;2;0;0;0;6;15;3;4;267;27;27;3;2;0;6;6;324;2;1434;4;2;
/org.eclipse.jdt.ui.tests.refactoring/resources/RenameType/test51/out/B.java;1;0;1;1;0;0;0;1;0;0;1;49;0;0;1;0;0;1;1;49;0;49;1;1;
/org.eclipse.jdt.ui.tests.refactoring/resources/RenameMethodInInterface/test15/out/A.java;1;0;1;1;0;0;0;1;0;0;1;49;0;0;1;0;0;1;1;49;0;49;1;1;
/org.eclipse.jdt.ui/ui/org/eclipse/jdt/internal/ui/compare/JavaTextBufferNode.java;2;0;3;1;0;0;0;3;2;1;3;2052;2;2;1;0;0;3;3;2052;0;2153;3;2;
/org.eclipse.ui/Eclipse UI/org/eclipse/ui/internal/WWinPartService.java;4;0;5;1;1;1;1;4;30;1;4;257;61;61;1;0;0;4;5;257;0;4082;5;4;
/org.eclipse.core.tests.resources/src/org/eclipse/core/tests/internal/indexing/TestObjectPolicy.java;3;0;4;1;1;1;1;3;2;1;3;1794;4;4;1;0;0;3;4;1794;0;4516;4;3;
/org.eclipse.jdt.core/codeassist/org/eclipse/jdt/internal/codeassist/complete/CompletionOnQualifiedClassReference.java;2;2;3;1;3;2;3;0;17;0;0;3890;20;20;2;0;1;0;3;3890;1;4062;2;2;
/org.eclipse.ui/Eclipse UI Text Editor/org/eclipse/ui/editors/text/IEncodingActionsDefinitionIds.java;1;1;2;1;2;2;2;0;58;0;0;4138;58;58;1;0;0;0;2;4138;0;4838;2;1;
/org.eclipse.swt.examples.paint/src/org/eclipse/swt/examples/paint/PencilTool.java;3;0;4;2;1;1;1;3;72;2;2;513;78;78;2;1;0;3;4;609;1;4705;3;3;
/org.eclipse.jdt.ui.tests.refactoring/resources/RenameVirtualMethodInClass/test23/out/A.java;1;0;1;1;0;0;0;1;0;0;1;49;0;0;1;0;0;1;1;49;0;49;1;1;
/org.eclipse.jdt.ui.tests.refactoring/resources/DeleteSourceReference/A_test1_in.java;1;0;2;1;0;0;0;2;0;1;2;2003;0;0;1;0;0;2;2;2003;0;2857;2;1;
/org.eclipse.jdt.debug/model/org/eclipse/jdt/debug/core/JDIDebugModel.java;4;1;47;2;4;4;4;43;427;4;36;187;2700;2700;4;7;0;43;47;2566;7;4768;40;4;
/org.eclipse.pde.ui/src/org/eclipse/pde/core/plugin/IPlugin.java;1;0;3;1;0;0;0;3;3;2;2;3579;3;3;2;1;0;3;3;3579;1;3607;2;1;
/org.eclipse.pde.ui/src/org/eclipse/pde/internal/ui/editor/schema/TypeRestrictionDescriptor.java;1;0;1;1;0;0;0;1;0;0;1;3579;0;0;1;0;0;1;1;3579;0;3579;1;1;
/org.eclipse.help/src/org/eclipse/help/internal/ServletFacade.java;1;0;2;1;0;0;0;2;0;1;2;2429;0;0;1;0;0;2;2;2429;0;3015;2;1;
/org.eclipse.update.ui/src/org/eclipse/update/internal/ui/parts/Sorter.java;1;0;1;1;1;1;1;0;0;0;0;4300;0;0;1;0;0;0;1;4300;0;4300;1;1;
/org.eclipse.ui/Eclipse UI/org/eclipse/ui/internal/dialogs/MultiStepConfigureWizardPage.java;1;0;12;1;0;0;0;12;395;5;8;3211;478;478;5;4;0;12;12;3227;4;3488;8;1;
/org.eclipse.pde.ui/Eclipse PDE UI/org/eclipse/pde/internal/editor/manifest/ManifestSourceOutlinePage.java;2;0;5;2;0;0;0;5;12;3;3;267;12;12;3;2;0;5;5;324;2;1434;3;2;
/org.eclipse.vcm.core.cvs/src/org/eclipse/vcm/internal/core/ccvs/requests/IFileContent.java;2;0;2;1;0;0;0;2;5;1;2;0;5;5;1;0;0;2;2;0;0;298;2;2;
/org.eclipse.help.tests/src/org/eclipse/help/tests/launching/DisplayHelpResource_IHrefResource_topic.java;1;0;1;1;1;1;1;0;0;0;0;4045;0;0;1;0;0;0;1;4045;0;4045;1;1;
/org.eclipse.scripting/Eclipse Scripting/org/eclipse/scripting/internal/IXGRNodeInterface.java;1;0;3;1;0;0;0;3;4;1;3;133;4;4;1;0;0;3;3;133;0;1424;3;1;
/org.eclipse.jdt.debug/model/org/eclipse/jdt/internal/debug/core/JDIArrayEntryVariable.java;4;0;13;2;0;0;0;13;35;2;11;187;146;146;2;2;0;13;13;1471;2;2513;11;4;
/org.eclipse.pde.core/src/org/eclipse/pde/internal/core/ischema/ISchemaCompositor.java;1;0;1;1;0;0;0;1;0;0;1;3591;0;0;1;0;0;1;1;3591;0;3591;1;1;
/org.eclipse.swt/Eclipse SWT/common/org/eclipse/swt/internal/image/PngHuffmanTables.java;2;0;3;1;1;1;1;2;6;1;2;106;12;12;1;0;0;2;3;106;0;4701;3;2;
/org.eclipse.swt.examples.paint/org/eclipse/swt/examples/paint/SegmentedPaintSession.java;3;0;4;2;1;1;1;3;163;2;2;586;163;163;2;1;0;3;4;609;1;4024;3;3;
/org.eclipse.ui/Eclipse UI/org/eclipse/ui/internal/DetachedPlaceHolder.java;2;0;2;1;0;0;0;2;5;1;2;257;5;5;1;0;0;2;2;257;0;457;2;2;
/org.eclipse.ui/Eclipse JFace/org/eclipse/jface/viewers/CombinedDecoratingLabelProvider.java;1;2;6;1;3;2;3;3;175;1;3;3484;203;203;2;0;1;3;6;3955;1;4006;5;1;
/org.eclipse.jdt.core/model/org/eclipse/jdt/internal/core/builder/impl/ProblemTable.java;1;0;10;1;0;0;0;10;298;4;6;455;370;370;4;4;0;10;10;1039;4;2808;6;1;
/org.eclipse.update.ui.forms/src/org/eclipse/update/ui/forms/internal/FormSection.java;2;1;14;1;3;3;3;11;656;2;10;2470;695;695;2;1;0;11;14;3139;1;4628;13;2;
/org.eclipse.core.tests.resources/src/org/eclipse/core/tests/resources/perf/BenchMiscWorkspace.java;1;0;1;1;0;0;0;1;0;0;1;3643;0;0;1;0;0;1;1;3643;0;3643;1;1;
/org.eclipse.jdt.ui/ui/org/eclipse/jdt/internal/ui/text/java/IReconcilingParticipant.java;1;0;1;1;0;0;0;1;0;0;1;3324;0;0;1;0;0;1;1;3324;0;3324;1;1;
/org.eclipse.core.tests.resources/src/org/eclipse/core/tests/internal/utils/AllTests.java;3;0;3;1;0;0;0;3;58;1;3;1794;63;63;1;0;0;3;3;1794;0;3420;3;3;
/org.eclipse.swt/Eclipse SWT/win32/org/eclipse/swt/internal/win32/MENUITEMINFO.java;2;0;4;1;0;0;0;4;5;1;4;106;9;9;1;0;0;4;4;106;0;2069;4;2;
/org.eclipse.core.tests.resources/src/org/eclipse/core/tests/internal/builders/RefreshLocalJavaFileBuilder.java;3;0;3;1;0;0;0;3;100;1;3;1794;113;113;1;0;0;3;3;1794;0;3420;3;3;
/org.eclipse.team.cvs.core/src/org/eclipse/team/internal/ccvs/core/response/custom/StatusMessageHandler.java;3;0;5;1;0;0;0;5;152;1;5;1978;164;164;1;0;0;5;5;1978;0;2607;5;3;
/org.eclipse.ui/Eclipse UI Standard Components/org/eclipse/ui/views/internal/framelist/UpAction.java;3;0;4;1;0;0;0;4;16;1;4;257;19;19;1;0;0;4;4;257;0;3816;4;3;
/org.eclipse.swt/Eclipse SWT/motif/org/eclipse/swt/internal/motif/XExposeEvent.java;2;0;3;1;0;0;0;3;4;1;3;106;4;4;1;0;0;3;3;106;0;2069;3;2;
/org.eclipse.swt.tests/JUnit Tests/org/eclipse/swt/tests/junit/Test_org_eclipse_swt_widgets_ToolBar.java;2;0;2;1;1;1;1;1;6;0;1;1792;6;6;1;0;0;1;2;1792;0;4706;2;2;
/org.eclipse.jdt.ui.tests.refactoring/resources/ExtractMethodWorkSpace/ExtractMethodTests/error_in/A_test802.java;1;1;3;1;2;2;2;1;0;0;1;3150;0;0;1;0;0;1;3;3150;0;4419;3;1;
/org.eclipse.pde.ui/src/org/eclipse/pde/internal/wizards/extension/NewExtensionMainPage.java;2;0;4;1;0;0;0;4;51;1;4;1434;55;55;1;0;0;4;4;1434;0;3579;4;2;
/org.eclipse.jdt.ui/core refactoring/org/eclipse/jdt/internal/corext/refactoring/rename/TempDeclarationFinder2.java;1;0;3;1;0;0;0;3;4;1;3;3048;4;4;1;0;0;3;3;3048;0;3309;3;1;
/org.eclipse.ui/Eclipse UI/org/eclipse/ui/internal/dialogs/ShowViewDialog.java;7;2;9;2;3;2;3;6;234;1;6;257;257;257;2;0;1;6;9;4134;1;4363;8;7;
/org.eclipse.jdt.ui/core refactoring/org/eclipse/jdt/internal/corext/refactoring/sef/EncapsulateWriteAccess.java;1;0;7;1;0;0;0;7;78;2;6;1939;179;179;2;1;0;7;7;2133;1;3150;6;1;
/org.eclipse.help/src/org/eclipse/help/internal/contributions1_0/Topic.java;2;0;3;1;0;0;0;3;2;1;3;1675;2;2;1;0;0;3;3;1675;0;2217;3;2;
/org.eclipse.debug.ui/ui/org/eclipse/debug/internal/ui/launchConfigurations/LaunchConfigurationPresentationManager.java;2;0;9;2;0;0;0;9;105;3;7;2161;200;200;3;2;0;9;9;2161;2;3667;7;2;
/org.eclipse.team.ui/src/org/eclipse/team/ui/sync/TeamFile.java;3;1;11;1;3;3;3;8;265;1;8;2233;380;380;1;0;0;8;11;2233;0;4005;11;3;
/org.eclipse.core.tests.resources/src/org/eclipse/core/tests/resources/IResourceDeltaTest.java;3;0;3;1;1;1;1;2;260;1;2;1794;270;270;1;0;0;2;3;1794;0;4516;3;3;
/org.eclipse.team.cvs.core/src/org/eclipse/team/internal/ccvs/core/ICVSListener.java;2;0;2;1;0;0;0;2;6;1;2;2433;6;6;1;0;0;2;2;2433;0;3610;2;2;
/org.eclipse.pde.build/src/org/eclipse/pde/internal/build/PluginTool.java;6;0;16;1;0;0;0;16;110;2;15;245;339;339;2;1;0;16;16;349;1;3089;15;6;
/org.eclipse.swt.tests/JUnit Tests/org/eclipse/swt/tests/junit/Test_org_eclipse_swt_printing_Printer.java;2;0;2;1;1;1;1;1;6;0;1;1792;6;6;1;0;0;1;2;1792;0;4706;2;2;
/org.eclipse.update.core/src/org/eclipse/update/core/InstallMonitor.java;2;0;6;1;0;0;0;6;104;2;5;2619;179;179;2;1;0;6;6;2619;1;3570;5;2;
/org.eclipse.jdt.ui.tests.refactoring/resources/RenameType/testFail22/in/B.java;1;0;1;1;0;0;0;1;0;0;1;49;0;0;1;0;0;1;1;49;0;49;1;1;
/org.eclipse.swt/Eclipse SWT OLE Win32/win32/org/eclipse/swt/internal/ole/win32/COM.java;3;0;6;1;0;0;0;6;75;1;6;106;105;105;1;0;0;6;6;106;0;2069;6;3;
/org.eclipse.jdt.ui.tests/JUnit/junit/tests/NoTestCaseClass.java;2;0;2;1;0;0;0;2;0;1;2;49;0;0;1;0;0;2;2;49;0;1186;2;2;
/org.eclipse.pde.ui/Eclipse PDE UI/org/eclipse/pde/internal/model/AbstractPluginModelBase.java;2;0;6;2;0;0;0;6;13;3;4;267;25;25;3;2;0;6;6;324;2;1434;4;2;
/org.eclipse.swt/Eclipse SWT Custom Widgets/common/org/eclipse/swt/custom/TreeEditor.java;3;0;5;1;1;1;1;4;13;1;4;106;33;33;1;0;0;4;5;106;0;4701;5;3;
/org.eclipse.ui/Eclipse UI Text Editor/org/eclipse/ui/texteditor/AbstractRulerActionDelegate.java;2;1;7;2;4;4;4;3;107;2;2;3592;212;212;2;1;0;3;7;3592;1;4838;6;2;
/org.eclipse.team.cvs.ui/src/org/eclipse/team/internal/ccvs/ui/wizards/BranchWizardPage.java;3;0;17;2;1;1;1;16;146;2;14;2578;514;514;2;2;0;16;17;3467;2;3957;15;3;
/org.eclipse.help/Eclipse Help/org/eclipse/help/internal/util/HelpException.java;2;0;3;1;0;0;0;3;7;1;3;135;7;7;1;0;0;3;3;135;0;1420;3;2;
/org.eclipse.core.boot/src/org/eclipse/core/internal/boot/update/XmlLiteElement.java;2;0;3;1;0;0;0;3;7;1;3;12;7;7;1;0;0;3;3;12;0;2726;3;2;
/org.eclipse.jdt.ui.tests.refactoring/resources/RenameNonPrivateField/testFail14/in/A.java;1;0;1;1;0;0;0;1;0;0;1;49;0;0;1;0;0;1;1;49;0;49;1;1;
/org.eclipse.help/webapps/examples/WEB-INF/classes/compressionFilters/CompressionFilterTestServlet.java;1;0;2;1;0;0;0;2;0;1;2;1882;0;0;1;0;0;2;2;1882;0;1930;2;1;
/org.eclipse.core.runtime/src/org/eclipse/core/runtime/model/ConfigurationModel.java;4;0;6;1;0;0;0;6;138;1;6;82;161;161;1;0;0;6;6;82;0;3719;6;4;
/org.eclipse.help.ui/src/org/eclipse/help/internal/ui/OpenHelpSearchPageAction.java;1;1;2;1;2;2;2;0;0;0;0;4064;0;0;1;0;0;0;2;4064;0;4439;2;1;
/org.eclipse.ant.core/src/org/eclipse/ant/internal/core/old/EclipseJavac.java;1;0;1;1;0;0;0;1;0;0;1;3270;0;0;1;0;0;1;1;3270;0;3270;1;1;
/org.eclipse.pde.ui/Eclipse PDE UI/org/eclipse/pde/internal/base/IPluginStructureData.java;2;0;6;2;0;0;0;6;12;3;4;267;24;24;3;2;0;6;6;324;2;1434;4;2;
/org.eclipse.pde.ui/Eclipse PDE UI/org/eclipse/pde/internal/component/ComponentJarWizard.java;2;0;6;2;0;0;0;6;12;3;4;267;14;14;3;2;0;6;6;324;2;1434;4;2;
/org.eclipse.vcm.ui.cvs/src/org/eclipse/vcm/internal/ui/ccvs/LoadModuleAliasDialog.java;1;0;2;1;0;0;0;2;205;0;1;1385;205;205;2;1;0;2;2;1385;1;1385;1;1;
/org.eclipse.pde.ui/src/org/eclipse/pde/internal/editor/manifest/NullToolBarManager.java;2;0;3;1;0;0;0;3;95;1;3;1434;95;95;1;0;0;3;3;1434;0;3579;3;2;
/org.eclipse.jdt.debug/eval/org/eclipse/jdt/internal/debug/eval/ast/instructions/UnaryOperator.java;1;0;2;1;0;0;0;2;4;1;2;3421;4;4;1;0;0;2;2;3421;0;3505;2;1;
/org.eclipse.jdt.ui.tests.refactoring/resources/RenameParameters/cannotRename/A_testFail3.java;1;0;1;1;0;0;0;1;0;0;1;233;0;0;1;0;0;1;1;233;0;233;1;1;
/org.eclipse.search/search/org/eclipse/search/internal/workingsets/WorkingSet.java;1;0;8;1;0;0;0;8;103;1;8;1494;179;179;1;0;0;8;8;1494;0;3849;8;1;
/org.eclipse.swt/Eclipse SWT PI/win32/org/eclipse/swt/internal/win32/PRINTDLG.java;2;0;2;1;1;1;1;1;6;0;1;2069;6;6;1;0;0;1;2;2069;0;4701;2;2;
/org.eclipse.swt/Eclipse SWT Custom Widgets/common_j2se/org/eclipse/swt/custom/CTabFolderAdapter.java;1;0;1;1;0;0;0;1;0;0;1;1378;0;0;1;0;0;1;1;1378;0;1378;1;1;
/org.eclipse.jdt.ui/ui/org/eclipse/jdt/internal/ui/text/HTMLTextPresenter.java;3;1;7;2;2;2;2;5;13;2;3;1482;36;36;2;2;0;5;7;1482;2;4706;5;3;
/org.eclipse.ui/Eclipse UI Tool Script/org/eclipse/toolscript/ui/internal/ToolScriptConfigurationDialog.java;1;1;5;1;4;4;4;1;89;0;1;3766;158;158;1;0;0;1;5;3766;0;4087;5;1;
/org.eclipse.swt/Eclipse SWT PI/motif/org/eclipse/swt/internal/motif/XWindowAttributes.java;2;0;2;1;1;1;1;1;6;0;1;2069;6;6;1;0;0;1;2;2069;0;4701;2;2;
/org.eclipse.jdt.ui/core refactoring/org/eclipse/jdt/internal/core/refactoring/fields/RenameFieldRefactoring.java;3;0;14;1;0;0;0;14;254;3;12;408;428;428;3;2;0;14;14;408;2;1342;12;3;
/org.eclipse.jdt.ui/core refactoring/org/eclipse/jdt/internal/corext/refactoring/code/ExtractMethodAnalyzer.java;2;1;24;2;5;5;5;19;384;3;17;1939;1011;1011;3;2;0;19;24;3737;2;4421;22;2;
/org.eclipse.ui.tests/Eclipse UI Tests/org/eclipse/ui/tests/api/MockPartListener.java;3;0;7;1;0;0;0;7;34;1;7;1007;53;53;1;0;0;7;7;1007;0;2785;7;3;
/org.eclipse.jdt.ui/ui debug/org/eclipse/jdt/internal/debug/ui/ExceptionUncaughtToggleAction.java;2;0;8;1;0;0;0;8;11;1;8;15;35;35;1;0;0;8;8;15;0;1916;8;2;
/org.eclipse.jdt.ui.tests.refactoring/resources/ReorderParameters/canReorder/A_test4_out.java;1;0;3;1;0;0;0;3;0;1;3;724;0;0;1;0;0;3;3;724;0;2270;3;1;
/org.eclipse.scripting/Eclipse Scripting/org/eclipse/scripting/internal/uirenderer/XGRElementUISwtTree.java;2;0;6;1;0;0;0;6;61;1;6;133;115;115;1;0;0;6;6;133;0;1424;6;2;
/org.eclipse.ui/Eclipse UI Standard Components/org/eclipse/ui/views/tasklist/FiltersDialog.java;6;1;11;1;4;4;4;7;143;1;7;257;388;388;1;0;0;7;11;257;0;4385;11;6;
/org.eclipse.team.ftp/src/org/eclipse/team/internal/ftp/target/FTPSiteFactory.java;2;1;2;1;2;2;2;0;4;0;0;4241;4;4;1;0;0;0;2;4241;0;4636;2;2;
/org.eclipse.pde.ui/src/org/eclipse/pde/internal/core/plugin/WorkspacePluginModelBase.java;1;0;3;1;0;0;0;3;14;2;2;3579;14;14;2;1;0;3;3;3579;1;3607;2;1;
/org.eclipse.jdt.core/model/org/eclipse/jdt/core/IJavaElementDelta.java;3;2;12;2;8;6;8;4;131;1;4;455;346;346;2;0;2;4;12;4281;2;4489;10;3;
/org.eclipse.ui/Eclipse UI/org/eclipse/ui/internal/ReferenceCounter.java;2;0;2;1;0;0;0;2;5;1;2;257;5;5;1;0;0;2;2;257;0;457;2;2;
/org.eclipse.team.cvs.ui/src/org/eclipse/team/internal/ccvs/ui/actions/TagAction.java;3;1;30;3;8;8;8;22;174;3;19;1978;859;859;3;3;0;22;30;3676;3;4256;27;3;
/org.eclipse.jdt.ui.tests.refactoring/test cases/org/eclipse/jdt/ui/tests/refactoring/ExtractTempTests.java;1;1;28;1;7;7;7;21;54;1;21;2481;319;319;1;0;0;21;28;2481;0;4763;28;1;
/org.eclipse.jdt.ui.tests.refactoring/resources/SurroundWithWorkSpace/SurroundWithTests/trycatch_in/TestInvalidParent1.java;1;0;1;1;0;0;0;1;0;0;1;2327;0;0;1;0;0;1;1;2327;0;2327;1;1;
/org.eclipse.core.tests.resources/src/org/eclipse/core/tests/resources/session/TestSaveSnap.java;2;0;3;1;0;0;0;3;128;1;3;2390;138;138;1;0;0;3;3;2390;0;3475;3;2;
/org.eclipse.ui/Eclipse UI/org/eclipse/ui/part/DrillStack.java;2;0;2;1;0;0;0;2;5;1;2;257;5;5;1;0;0;2;2;257;0;457;2;2;
/org.eclipse.jdt.ui.tests.refactoring/resources/MoveMembers/testFail17/in/A.java;1;0;1;1;0;0;0;1;0;0;1;2738;0;0;1;0;0;1;1;2738;0;2738;1;1;
/org.eclipse.jdt.core/search/org/eclipse/jdt/internal/core/index/impl/Field.java;2;0;3;1;1;1;1;2;329;1;2;455;345;345;1;0;0;2;3;455;0;4063;3;2;
/org.eclipse.jdt.ui.tests.refactoring/resources/PullUpMethods/test7/in/A.java;1;0;3;1;0;0;0;3;2;1;3;2156;2;2;1;0;0;3;3;2156;0;2406;3;1;
/org.eclipse.vcm.core/src/org/eclipse/vcm/internal/core/AssertionFailedException.java;2;0;2;1;0;0;0;2;4;1;2;0;4;4;1;0;0;2;2;0;0;297;2;2;
/org.eclipse.ui.tests/Eclipse UI Tests/org/eclipse/ui/tests/dialogs/UIMessageDialogsAuto.java;3;0;6;1;1;1;1;5;28;1;5;1113;42;42;1;0;0;5;6;1113;0;4261;6;3;
/org.eclipse.pde.ui/src/org/eclipse/pde/internal/ui/editor/feature/FeatureAdapterFactory.java;1;0;3;1;0;0;0;3;14;2;2;3579;16;16;2;1;0;3;3;3579;1;3591;2;1;
/org.eclipse.ui/Eclipse UI/org/eclipse/ui/IPageService.java;2;0;2;1;0;0;0;2;5;1;2;257;5;5;1;0;0;2;2;257;0;457;2;2;
/org.eclipse.swt/Eclipse SWT PI/photon/org/eclipse/swt/internal/photon/PhCursorDef_t.java;2;0;2;1;1;1;1;1;6;0;1;2069;6;6;1;0;0;1;2;2069;0;4701;2;2;
/org.eclipse.vcm.ui/src/org/eclipse/vcm/internal/ui/model/ProjectVersionsCategory.java;5;0;6;2;0;0;0;6;26;2;5;1;51;51;2;1;0;6;6;297;1;1436;5;5;
/org.eclipse.jdt.ui.tests.refactoring/resources/DeleteSourceReference/A_test4_out.java;1;0;2;1;0;0;0;2;0;1;2;2003;0;0;1;0;0;2;2;2003;0;2857;2;1;
/org.eclipse.pde.ui/Eclipse PDE UI/org/eclipse/pde/internal/model/RuntimeLibrary.java;2;0;5;2;0;0;0;5;12;3;3;267;12;12;3;2;0;5;5;324;2;1434;3;2;
/org.eclipse.swt/Eclipse SWT PI/motif/org/eclipse/swt/internal/motif/XConfigureEvent.java;2;0;2;1;1;1;1;1;6;0;1;2069;6;6;1;0;0;1;2;2069;0;4701;2;2;
/org.eclipse.pde.ui/src/org/eclipse/pde/internal/ui/model/ifeature/IFeature.java;1;0;3;1;0;0;0;3;5;2;2;3579;5;5;2;1;0;3;3;3579;1;3591;2;1;
/org.eclipse.jdt.debug/model/org/eclipse/jdt/internal/debug/core/JDIClassType.java;2;0;3;1;0;0;0;3;45;1;3;1675;45;45;1;0;0;3;3;1675;0;2517;3;2;
/org.eclipse.scripting/src/org/eclipse/scripting/internal/uirenderer/XGRElementUISwtWizard.java;1;0;1;1;0;0;0;1;0;0;1;1424;0;0;1;0;0;1;1;1424;0;1424;1;1;
/org.eclipse.pde.ui/src/org/eclipse/pde/internal/WorkspaceModelManager.java;2;0;16;1;0;0;0;16;938;1;16;1434;1146;1146;1;0;0;16;16;1434;0;3579;16;2;
/org.eclipse.help/src/org/eclipse/help/internal/util/Resources.java;2;0;3;1;0;0;0;3;76;1;3;1420;78;78;1;0;0;3;3;1420;0;3873;3;2;
/org.eclipse.jdt.ui/core refactoring/org/eclipse/jdt/internal/core/refactoring/rename/RenamePackageASTAnalyzer.java;2;0;5;1;0;0;0;5;6;2;4;1342;9;9;2;1;0;5;5;1910;1;1939;4;2;
/org.eclipse.team.ftp/src/org/eclipse/team/internal/ftp/FTPProviderPlugin.java;1;1;2;1;2;2;2;0;0;0;0;4169;0;0;1;0;0;0;2;4169;0;4241;2;1;
/org.eclipse.help/Eclipse Help/org/eclipse/help/internal/util/HelpPreferences.java;1;0;2;1;0;0;0;2;0;1;2;1377;0;0;1;0;0;2;2;1377;0;1420;2;1;
/org.eclipse.jdt.core/model/org/eclipse/jdt/internal/core/ICacheEnumeration.java;1;0;2;1;0;0;0;2;0;1;2;455;0;0;1;0;0;2;2;455;0;1755;2;1;
/org.eclipse.core.boot/src/org/eclipse/core/internal/boot/update/IComponentDescriptor.java;4;0;6;2;0;0;0;6;14;2;5;12;41;41;2;1;0;6;6;324;1;2726;5;4;
/org.eclipse.ui/Eclipse JFace Text/org/eclipse/jface/text/presentation/PresentationReconciler.java;4;1;8;1;3;3;3;5;222;1;5;257;332;332;1;0;0;5;8;257;0;4838;8;4;
/org.eclipse.jdt.ui.tests.refactoring/resources/ExtractMethodWorkSpace/ExtractMethodTests/return_out/A_test721.java;1;1;4;1;2;2;2;2;42;1;2;1851;44;44;1;0;0;2;4;1851;0;4419;4;1;
/org.eclipse.jdt.ui.tests.refactoring/resources/ExtractTemp/canExtract/A_test22_in.java;1;0;1;1;0;0;0;1;0;0;1;2498;0;0;1;0;0;1;1;2498;0;2498;1;1;
/org.eclipse.jdt.ui.tests.refactoring/resources/PasteSourceReference/test1/in/B.java;1;0;1;1;0;0;0;1;0;0;1;2064;0;0;1;0;0;1;1;2064;0;2064;1;1;
/org.eclipse.update.core/src/org/eclipse/update/core/ContentConsumer.java;2;0;3;1;0;0;0;3;21;1;3;2448;21;21;1;0;0;3;3;2448;0;2994;3;2;
/org.eclipse.pde.ui/src/org/eclipse/pde/internal/core/schema/SchemaElement.java;1;0;3;1;0;0;0;3;2;1;3;3579;2;2;1;0;0;3;3;3579;0;3607;3;1;
/org.eclipse.ui.examples.javaeditor/Java Editor Example/org/eclipse/ui/examples/javaeditor/java/JavaWordDetector.java;1;0;2;1;0;0;0;2;0;0;1;1066;0;0;2;1;0;2;2;1066;1;1066;1;1;
/org.eclipse.swt.tests/JUnit Tests/org/eclipse/swt/tests/junit/Test_org_eclipse_swt_custom_TextChangedEvent.java;2;0;2;1;1;1;1;1;6;0;1;1792;6;6;1;0;0;1;2;1792;0;4706;2;2;
/org.eclipse.search/search/org/eclipse/search/internal/ui/ScopePart.java;1;0;13;1;1;1;1;12;125;1;12;1434;376;376;1;0;0;12;13;1434;0;4273;13;1;
/org.eclipse.jdt.ui/ui/org/eclipse/jdt/ui/actions/OpenTypeHierarchyAction.java;2;1;8;1;3;3;3;5;16;1;5;3533;72;72;1;0;0;5;8;3533;0;4770;8;2;
/org.eclipse.help.ui/src/org/eclipse/help/internal/ui/HelpContentsAction1.java;2;0;2;1;0;0;0;2;0;1;2;2830;0;0;1;0;0;2;2;2830;0;3053;2;2;
/org.eclipse.jdt.core/codeassist/org/eclipse/jdt/internal/codeassist/CompletionEngine.java;3;4;81;2;14;11;14;67;13416;4;54;455;27179;27179;4;13;3;67;81;1039;16;4628;65;3;
/org.eclipse.core.tests.resources/src/org/eclipse/core/tests/internal/dtree/DataTreeTest.java;3;0;4;1;0;0;0;4;1060;1;4;1794;1076;1076;1;0;0;4;4;1794;0;3420;4;3;
/org.eclipse.core.resources/src/org/eclipse/core/internal/resources/Resource.java;4;1;32;2;3;3;3;29;2359;2;26;12;3264;3264;2;3;0;29;32;48;3;4628;29;4;
/org.eclipse.jdt.core/search/org/eclipse/jdt/internal/core/search/IndexSelector.java;3;1;12;1;4;4;4;8;354;1;8;455;520;520;1;0;0;8;12;455;0;4525;12;3;
/org.eclipse.jdt.core/model/org/eclipse/jdt/core/util/IClassFileAttribute.java;2;1;4;1;3;3;3;1;19;0;1;3629;41;41;1;0;0;1;4;3629;0;4454;4;2;
/org.eclipse.jdt.ui.tests.refactoring/resources/SefWorkSpace/SefTests/X.java;1;0;1;1;0;0;0;1;0;0;1;2915;0;0;1;0;0;1;1;2915;0;2915;1;1;
/org.eclipse.jdt.core/model/org/eclipse/jdt/internal/core/CreateElementInCUOperation.java;3;2;13;1;4;3;4;9;437;1;9;455;613;613;2;0;1;9;13;3960;1;4424;12;3;
/org.eclipse.scripting/Eclipse Scripting/org/eclipse/scripting/internal/IXGRElementEventGeneratorOnBlur.java;1;0;3;1;0;0;0;3;4;1;3;133;4;4;1;0;0;3;3;133;0;1424;3;1;
/org.eclipse.pde.ui/Eclipse PDE UI/org/eclipse/pde/internal/base/model/plugin/IPluginImport.java;2;0;5;2;0;0;0;5;21;3;3;267;21;21;3;2;0;5;5;324;2;1434;3;2;
/org.eclipse.pde.ui/src/org/eclipse/pde/internal/editor/feature/FeatureFormPage.java;1;0;2;1;0;0;0;2;0;1;2;2951;0;0;1;0;0;2;2;2951;0;3579;2;1;
/org.eclipse.jdt.ui.tests.refactoring/resources/ExtractMethodWorkSpace/ExtractMethodTests/expression_in/A_test601.java;2;1;3;1;2;2;2;1;14;0;1;239;14;14;1;0;0;1;3;239;0;4419;3;2;
/org.eclipse.team.ui/src/org/eclipse/team/internal/ui/sync/SyncSet.java;3;1;5;1;3;3;3;2;104;1;2;2054;112;112;1;0;0;2;5;2054;0;4282;5;3;
/org.eclipse.jdt.ui.tests.refactoring/resources/RenameType/test20/out/B.java;1;0;1;1;0;0;0;1;0;0;1;522;0;0;1;0;0;1;1;522;0;522;1;1;
/org.eclipse.jdt.ui/core extension/org/eclipse/jdt/internal/corext/template/java/CompilationUnitCompletion.java;4;0;6;1;1;1;1;5;181;1;5;2784;197;197;1;0;0;5;6;2784;0;4181;6;4;
/org.eclipse.jdt.launching.j9/j9/org/eclipse/jdt/internal/launching/j9/J9DebugVMRunner.java;3;1;11;1;5;5;5;6;51;1;6;3314;123;123;1;0;0;6;11;3314;0;4449;11;3;
/org.eclipse.ui/Eclipse UI/org/eclipse/ui/internal/dialogs/UpdateProjectCapabilityWizard.java;2;0;9;1;0;0;0;9;88;2;8;3238;203;203;2;1;0;9;9;3506;1;3607;8;2;
/org.eclipse.swt/Eclipse SWT Drag and Drop/emulated/org/eclipse/swt/dnd/TextTransfer.java;2;1;5;1;4;4;4;1;43;0;1;3126;59;59;1;0;0;1;5;3126;0;4824;5;2;
/org.eclipse.pde.build/src/plugin/org/eclipse/pde/internal/core/AbstractApplication.java;1;0;1;1;0;0;0;1;0;0;1;3475;0;0;1;0;0;1;1;3475;0;3475;1;1;
/org.eclipse.team.ui/src/org/eclipse/team/internal/ui/ExportProjectSetMainPage.java;2;1;8;1;6;6;6;2;184;1;2;3728;224;224;1;0;0;2;8;3728;0;4708;8;2;
/org.eclipse.jdt.ui/nls/org/eclipse/jdt/internal/ui/nls/model/Messages.java;1;0;2;1;0;0;0;2;0;1;2;1880;0;0;1;0;0;2;2;1880;0;1913;2;1;
/org.eclipse.update/src/org/eclipse/update/internal/ui/UMWizardPageInstalling.java;1;0;1;1;0;0;0;1;0;0;1;1424;0;0;1;0;0;1;1;1424;0;1424;1;1;
/org.eclipse.compare/compare/org/eclipse/compare/contentmergeviewer/DelayedProgressMonitor.java;1;0;1;1;0;0;0;1;0;0;1;2017;0;0;1;0;0;1;1;2017;0;2017;1;1;
/org.eclipse.jdt.debug.tests/tests/org/eclipse/jdt/debug/tests/eval/NestedTypeFieldValue_304.java;2;1;3;1;3;3;3;0;12;0;0;4447;14;14;1;0;0;0;3;4447;0;4571;3;2;
/org.eclipse.update.ui/src/org/eclipse/update/internal/ui/UpdateUIPluginImages.java;1;1;23;1;4;4;4;19;66;1;19;1428;192;192;1;0;0;19;23;1428;0;4616;23;1;
/org.eclipse.team.ftp/src/org/eclipse/team/internal/ftp/target/FTPRemoteTargetResource.java;3;7;23;2;23;13;23;0;401;0;0;4241;769;769;7;0;10;0;23;4285;10;4636;13;3;
/org.eclipse.core.resources/src/org/eclipse/core/resources/IStorage.java;1;0;4;1;1;1;1;3;124;1;3;12;145;145;1;0;0;3;4;12;0;4214;4;1;
/org.eclipse.update.core/src/org/eclipse/update/core/IFeature.java;3;2;40;2;7;6;7;33;431;3;26;1423;1251;1251;3;7;1;33;40;3570;8;4531;32;3;
/org.eclipse.ui.tests/Eclipse UI Tests/org/eclipse/ui/tests/api/IResourceMock.java;1;0;2;1;0;0;0;2;0;1;2;983;0;0;1;0;0;2;2;983;0;1038;2;1;
/org.eclipse.core.tests.runtime/src/org/eclipse/core/tests/internal/plugins/ActivationTest_DirectPluginRef.java;4;0;4;1;0;0;0;4;164;1;4;1794;194;194;1;0;0;4;4;1794;0;3476;4;4;
/org.eclipse.ui/Eclipse JFace Text/org/eclipse/jface/text/ChildDocumentEvent.java;4;0;4;1;1;1;1;3;5;1;3;257;13;13;1;0;0;3;4;257;0;4853;4;4;
/org.eclipse.core.tests.resources/src/org/eclipse/core/tests/resources/usecase/Snapshot1Test.java;3;0;4;1;0;0;0;4;206;1;4;1794;254;254;1;0;0;4;4;1794;0;3420;4;3;
/org.eclipse.swt/Eclipse SWT Drag and Drop/carbon/org/eclipse/swt/dnd/FileTransfer.java;4;1;6;1;6;6;6;0;51;0;0;4147;120;120;1;0;0;0;6;4147;0;4824;6;4;
/org.eclipse.jdt.ui.tests.refactoring/resources/RenameNonPrivateField/testFail4/in/A.java;1;0;1;1;0;0;0;1;0;0;1;49;0;0;1;0;0;1;1;49;0;49;1;1;
/org.eclipse.ui/Eclipse UI/org/eclipse/ui/internal/dialogs/ExportWizard.java;4;0;4;1;0;0;0;4;9;1;4;257;17;17;1;0;0;4;4;257;0;3029;4;4;
/org.eclipse.help.ui/Eclipse Help UI/org/eclipse/help/internal/ui/NestedPrintAction.java;3;0;4;1;0;0;0;4;17;1;4;136;24;24;1;0;0;4;4;136;0;1420;4;3;
/org.eclipse.jdt.ui.tests.refactoring/resources/RenameType/testFail75/in/A.java;1;0;1;1;0;0;0;1;0;0;1;49;0;0;1;0;0;1;1;49;0;49;1;1;
/org.eclipse.ui/Eclipse JFace Text/org/eclipse/jface/text/rules/WordRule.java;4;0;4;1;0;0;0;4;31;1;4;257;38;38;1;0;0;4;4;257;0;2102;4;4;
/org.eclipse.pde.ui/src/org/eclipse/pde/internal/ui/wizards/templates/ViewNewWizard.java;1;0;3;1;0;0;0;3;8;1;3;3579;9;9;1;0;0;3;3;3579;0;3870;3;1;
/org.eclipse.jdt.ui.tests.refactoring/resources/ReorderParameters/canReorder/A_test15_out.java;1;0;1;1;0;0;0;1;0;0;1;2296;0;0;1;0;0;1;1;2296;0;2296;1;1;
/org.eclipse.vcm.tests.core.cvs/src/org/eclipse/vcm/tests/core/cvs/RepoUploader.java;1;0;1;1;0;0;0;1;0;0;1;1688;0;0;1;0;0;1;1;1688;0;1688;1;1;
/org.eclipse.jdt.ui.tests.refactoring/resources/RenameType/testFail73/in/A.java;1;0;1;1;0;0;0;1;0;0;1;49;0;0;1;0;0;1;1;49;0;49;1;1;
/org.eclipse.jdt.ui/ui/org/eclipse/jdt/internal/ui/compare/JavaCompareUtilities.java;3;2;16;2;3;2;3;13;102;2;12;15;303;303;2;1;1;13;16;2153;2;4621;14;3;
/org.eclipse.jdt.ui.tests.refactoring/resources/ExtractTemp/canExtract/A_test20_out.java;1;0;1;1;0;0;0;1;0;0;1;2498;0;0;1;0;0;1;1;2498;0;2498;1;1;
/org.eclipse.jdt.ui.tests.refactoring/resources/PullUpMethods/testFail4/in/A.java;1;0;2;1;0;0;0;2;0;1;2;2156;0;0;1;0;0;2;2;2156;0;2406;2;1;
/org.eclipse.pde.ui/Eclipse PDE UI/org/eclipse/pde/internal/codegen/AttributeClassCodeGenerator.java;2;0;9;2;0;0;0;9;62;3;7;267;142;142;3;2;0;9;9;324;2;1434;7;2;
/org.eclipse.pde.ui/src/org/eclipse/pde/internal/model/XMLErrorHandler.java;2;0;2;1;0;0;0;2;0;1;2;1434;0;0;1;0;0;2;2;1434;0;3136;2;2;
/org.eclipse.pde.core/src/org/eclipse/pde/internal/core/FileAdapter.java;1;0;2;1;0;0;0;2;42;1;2;3591;42;42;1;0;0;2;2;3591;0;3610;2;1;
/org.eclipse.jdt.ui.tests.refactoring/resources/ExtractMethodWorkSpace/ExtractMethodTests/expression_in/A_test600.java;2;1;3;1;2;2;2;1;14;0;1;239;14;14;1;0;0;1;3;239;0;4419;3;2;
/org.eclipse.pde.ui/src/org/eclipse/pde/internal/schema/SchemaElement.java;2;0;4;1;0;0;0;4;9;1;4;1434;15;15;1;0;0;4;4;1434;0;3579;4;2;
/org.eclipse.debug.ui/ui/org/eclipse/debug/ui/IDebugView.java;3;0;5;1;1;1;1;4;75;1;4;3309;139;139;1;0;0;4;5;3309;0;4653;5;3;
/org.eclipse.jdt.debug/model/org/eclipse/jdt/internal/debug/core/JDIStackFrame.java;4;0;40;2;0;0;0;40;293;2;35;187;1010;1010;2;5;0;40;40;876;5;2517;35;4;
/org.eclipse.ui.tests/Eclipse UI Tests/org/eclipse/ui/tests/adaptable/TestAdaptableWorkbenchAdapter.java;1;0;1;1;0;0;0;1;0;0;1;2863;0;0;1;0;0;1;1;2863;0;2863;1;1;
/org.eclipse.ui/Eclipse UI/org/eclipse/ui/ISelectionService.java;3;0;4;1;1;1;1;3;43;1;3;257;90;90;1;0;0;3;4;257;0;4195;4;3;
/org.eclipse.swt/Eclipse SWT/motif/org/eclipse/swt/widgets/Menu.java;7;1;15;2;7;7;7;8;663;2;7;106;1703;1703;2;1;0;8;15;2058;1;4701;14;7;
/org.eclipse.pde.ui/src/org/eclipse/pde/internal/model/feature/FeatureURL.java;1;0;3;1;0;0;0;3;2;1;3;2951;2;2;1;0;0;3;3;2951;0;3579;3;1;
/org.eclipse.ui/Eclipse UI Standard Components/org/eclipse/ui/views/navigator/FiltersContentProvider.java;2;0;2;1;0;0;0;2;10;1;2;257;10;10;1;0;0;2;2;257;0;457;2;2;
/org.eclipse.jdt.launching/launching/org/eclipse/jdt/launching/VMRunnerConfiguration.java;3;1;14;1;6;6;6;8;34;1;8;2022;209;209;1;0;0;8;14;2022;0;4651;14;3;
/org.eclipse.ui/Eclipse UI/org/eclipse/ui/dialogs/WizardResourceImportPage.java;4;1;13;1;2;2;2;11;174;2;10;257;331;331;2;1;0;11;13;3225;1;4143;12;4;
/org.eclipse.jdt.debug.ui/ui/org/eclipse/jdt/internal/debug/ui/actions/ShowFinalFieldsAction.java;3;1;14;1;2;2;2;12;70;2;11;1915;157;157;2;1;0;12;14;2328;1;3933;13;3;
/org.eclipse.jdt.launching/launching/org/eclipse/jdt/launching/JavaRuntime.java;2;5;61;2;46;26;46;15;491;2;13;2022;2545;2545;5;2;20;15;61;4121;22;4686;39;2;
/org.eclipse.pde.ui/src/org/eclipse/pde/internal/ui/util/PixelConverter.java;1;0;1;1;0;0;0;1;0;0;1;3579;0;0;1;0;0;1;1;3579;0;3579;1;1;
/org.eclipse.jdt.core/codeassist/org/eclipse/jdt/internal/codeassist/complete/CompletionOnImportReference.java;2;0;9;1;1;1;1;8;36;4;5;455;96;96;4;3;0;8;9;1039;3;4062;6;2;
/org.eclipse.jdt.ui/ui/org/eclipse/jdt/internal/ui/actions/CompositeActionGroup.java;1;0;4;1;1;1;1;3;35;1;3;3533;57;57;1;0;0;3;4;3533;0;4019;4;1;
/org.eclipse.jdt.ui/ui/org/eclipse/jdt/internal/ui/packageview/FrameUpAction.java;1;0;3;1;0;0;0;3;4;1;3;213;4;4;1;0;0;3;3;213;0;390;3;1;
/org.eclipse.help.webapp/src/org/eclipse/help/servlet/WebappResources.java;2;0;4;1;0;0;0;4;39;1;4;2835;42;42;1;0;0;4;4;2835;0;3449;4;2;
/org.eclipse.jdt.ui.tests.refactoring/resources/ExtractTemp/canExtract/A_test30_in.java;1;0;1;1;0;0;0;1;0;0;1;3210;0;0;1;0;0;1;1;3210;0;3210;1;1;
/org.eclipse.jdt.ui.tests.refactoring/resources/RenameMethodInInterface/test4/out/A.java;1;0;1;1;0;0;0;1;0;0;1;49;0;0;1;0;0;1;1;49;0;49;1;1;
/org.eclipse.jdt.core/model/org/eclipse/jdt/core/jdom/IDOMInitializer.java;2;0;4;1;1;1;1;3;54;1;3;455;82;82;1;0;0;3;4;455;0;4061;4;2;
/org.eclipse.help.ui/src/org/eclipse/help/internal/ui/Actions.java;2;0;3;1;0;0;0;3;59;1;3;1420;59;59;1;0;0;3;3;1420;0;3030;3;2;
/org.eclipse.ui/Eclipse UI/org/eclipse/ui/part/EditorPart.java;2;0;2;1;0;0;0;2;5;1;2;257;5;5;1;0;0;2;2;257;0;457;2;2;
/org.eclipse.jdt.ui.tests.refactoring/resources/RenameMethodInInterface/test21/in/A.java;1;0;1;1;0;0;0;1;0;0;1;49;0;0;1;0;0;1;1;49;0;49;1;1;
/org.eclipse.pde.ui/src/org/eclipse/pde/internal/editor/XMLDoubleClickStrategy.java;2;0;2;1;0;0;0;2;0;1;2;1434;0;0;1;0;0;2;2;1434;0;3579;2;2;
/org.eclipse.jdt.ui.tests.refactoring/resources/ExtractMethodWorkSpace/ExtractMethodTests/return_in/A_test703.java;1;1;3;1;2;2;2;1;22;0;1;887;22;22;1;0;0;1;3;887;0;4419;3;1;
/org.eclipse.help.ui/Eclipse Help UI/org/eclipse/help/internal/ui/TopicsPage.java;3;0;4;1;0;0;0;4;11;1;4;136;18;18;1;0;0;4;4;136;0;1420;4;3;
/org.eclipse.swt/Eclipse SWT PI/photon/org/eclipse/swt/internal/photon/PhWindowEvent_t.java;2;0;2;1;1;1;1;1;6;0;1;2069;6;6;1;0;0;1;2;2069;0;4701;2;2;
/org.eclipse.pde.ui/src/org/eclipse/pde/internal/forms/renamed/CustomWorkbook.java;1;0;2;1;0;0;0;2;0;1;2;2470;0;0;1;0;0;2;2;2470;0;2691;2;1;
/org.eclipse.update.tests.core/src/org/eclipse/update/tests/UpdateManagerTestCase.java;2;1;20;1;3;3;3;17;104;2;16;1531;285;285;2;1;0;17;20;1638;1;4329;19;2;
/org.eclipse.help/src/org/eclipse/help/internal/contributors1_0/TopicContributor.java;1;0;2;1;0;0;0;2;0;1;2;1675;0;0;1;0;0;2;2;1675;0;2217;2;1;
/org.eclipse.team.core/src/org/eclipse/team/internal/core/target/IRemoteTargetResource.java;1;0;2;1;2;1;2;0;10;0;0;4636;10;10;2;0;1;0;2;4636;1;4636;1;1;
/org.eclipse.vcm.ui/src/org/eclipse/vcm/internal/ui/actions/GlobalReleaseAction.java;2;0;2;1;0;0;0;2;0;1;2;1;0;0;1;0;0;2;2;1;0;161;2;2;
/org.eclipse.jdt.ui/ui/org/eclipse/jdt/internal/ui/wizards/TypedViewerFilter.java;1;0;1;1;0;0;0;1;0;0;1;1254;0;0;1;0;0;1;1;1254;0;1254;1;1;
/org.eclipse.jdt.ui.tests.refactoring/resources/InlineTemp/canInline/A_test12_out.java;1;0;1;1;0;0;0;1;0;0;1;2758;0;0;1;0;0;1;1;2758;0;2758;1;1;
/org.eclipse.ui/Eclipse UI Standard Components/org/eclipse/ui/views/internal/navigator/GotoActionContributionFactory.java;1;0;2;1;0;0;0;2;0;1;2;1757;0;0;1;0;0;2;2;1757;0;1830;2;1;
/org.eclipse.update.core/src/org/eclipse/update/core/model/DefaultSiteParser.java;2;1;30;1;4;4;4;26;848;5;20;2413;2670;2670;5;6;0;26;30;2782;6;4617;24;2;
/org.eclipse.swt/Eclipse SWT/gtk/org/eclipse/swt/widgets/Trim.java;2;0;2;1;0;0;0;2;0;1;2;2107;0;0;1;0;0;2;2;2107;0;3337;2;2;
/org.eclipse.pde.build/src/org/eclipse/pde/internal/build/PluginScriptGenerator.java;1;0;1;1;0;0;0;1;0;0;1;2896;0;0;1;0;0;1;1;2896;0;2896;1;1;
/org.eclipse.jdt.ui.tests.refactoring/resources/RenameVirtualMethodInClass/testFail17/in/A.java;1;0;1;1;0;0;0;1;0;0;1;49;0;0;1;0;0;1;1;49;0;49;1;1;
/org.eclipse.jdt.ui.tests.refactoring/resources/ExtractMethodWorkSpace/ExtractMethodTests/validSelection/A_test201.java;2;1;3;1;2;2;2;1;0;0;1;49;0;0;1;0;0;1;3;49;0;4419;3;2;
/org.eclipse.update.ui/src/org/eclipse/update/internal/ui/manager/MyComputerForm.java;1;0;3;1;0;0;0;3;2;1;3;2651;2;2;1;0;0;3;3;2651;0;3662;3;1;
/org.eclipse.swt.examples/src/org/eclipse/swt/examples/controlexample/AlignableTab.java;3;0;4;1;1;1;1;3;106;1;3;513;185;185;1;0;0;3;4;513;0;4705;4;3;
/org.eclipse.jdt.ui/core refactoring/org/eclipse/jdt/internal/core/refactoring/base/IRefactoring.java;2;0;2;1;0;0;0;2;0;1;2;408;0;0;1;0;0;2;2;408;0;1939;2;2;
/org.eclipse.team.cvs.core/src/org/eclipse/team/internal/ccvs/core/connection/CVSServerException.java;3;0;7;1;1;1;1;6;94;1;6;1978;125;125;1;0;0;6;7;1978;0;3914;7;3;
/org.eclipse.jdt.ui/core extension/org/eclipse/jdt/internal/corext/codemanipulation/IImportsStructure.java;3;0;3;2;0;0;0;3;10;2;2;2137;14;14;2;1;0;3;3;2137;1;3873;2;3;
/org.eclipse.jdt.debug/eval/org/eclipse/jdt/internal/debug/eval/ast/EvaluationPrimitiveType.java;1;0;2;1;0;0;0;2;0;1;2;3329;0;0;1;0;0;2;2;3329;0;3421;2;1;
/org.eclipse.pde.ui/src/org/eclipse/pde/internal/editor/build/TokenSection.java;2;0;8;1;0;0;0;8;88;1;8;1434;99;99;1;0;0;8;8;1434;0;3579;8;2;
/org.eclipse.ui/Eclipse UI Editor Support/org/eclipse/ui/internal/editorsupport/ComponentSupport.java;3;1;5;1;3;3;3;2;122;1;2;257;135;135;1;0;0;2;5;257;0;4069;5;3;
/org.eclipse.debug.ui/ui/org/eclipse/debug/internal/ui/launchConfigurations/PerspectiveTab.java;3;0;8;2;0;0;0;8;399;2;6;2180;420;420;2;2;0;8;8;2283;2;2569;6;3;
/org.eclipse.jdt.debug/jdi/org/eclipse/jdi/hcr/ThreadReference.java;1;0;2;1;0;0;0;2;12;1;2;187;12;12;1;0;0;2;2;187;0;366;2;1;
/org.eclipse.swt.examples.paint/org/eclipse/swt/examples/paint/ContinuousPaintSession.java;3;0;5;2;1;1;1;4;243;2;3;513;282;282;2;1;0;4;5;609;1;4024;4;3;
/org.eclipse.core.tests.harness/src/org/eclipse/core/tests/harness/FussyProgressMonitor.java;3;0;4;1;1;1;1;3;288;1;3;1794;309;309;1;0;0;3;4;1794;0;4516;4;3;
/org.eclipse.scripting/Eclipse Scripting/org/eclipse/scripting/internal/views/ScriptUIEditorDocumentProvider.java;2;0;6;1;0;0;0;6;22;1;6;133;65;65;1;0;0;6;6;133;0;1424;6;2;
/org.eclipse.jdt.ui.tests.refactoring/resources/RenameMethodInInterface/test20/in/A.java;1;0;1;1;0;0;0;1;0;0;1;49;0;0;1;0;0;1;1;49;0;49;1;1;
/org.eclipse.update.tests.core/src/org/eclipse/update/tests/regularInstall/TestLocalSite.java;2;2;39;1;12;10;12;27;125;3;21;2017;735;735;3;6;2;27;39;2067;8;4424;31;2;
/org.eclipse.swt/Eclipse SWT/photon/org/eclipse/swt/widgets/ScrollBar.java;7;1;16;1;5;5;5;11;389;1;11;106;715;715;1;0;0;11;16;106;0;4701;16;7;
/org.eclipse.debug.core/core/org/eclipse/debug/core/DebugEvent.java;4;1;16;2;2;2;2;14;76;2;12;187;378;378;2;2;0;14;16;1726;2;4650;14;4;
/org.eclipse.jdt.core/model/org/eclipse/jdt/internal/core/newbuilder/ClasspathJar.java;1;0;10;1;0;0;0;10;19;1;10;1764;70;70;1;0;0;10;10;1764;0;2979;10;1;
/org.eclipse.ui/Eclipse JFace Text/org/eclipse/jface/text/contentassist/PopupCloser.java;3;0;3;1;0;0;0;3;39;1;3;257;44;44;1;0;0;3;3;257;0;1066;3;3;
/org.eclipse.jdt.ui.tests.refactoring/resources/ExtractMethodWorkSpace/ExtractMethodTests/invalidSelection/A_test172.java;2;1;3;1;2;2;2;1;0;0;1;511;0;0;1;0;0;1;3;511;0;4419;3;2;
/org.eclipse.debug.ui/ui/org/eclipse/debug/internal/ui/actions/AbstractDebugActionDelegate.java;2;2;14;2;5;4;5;9;45;2;8;2919;178;178;2;1;1;9;14;3833;2;4406;12;2;
/org.eclipse.scripting/Eclipse Scripting/org/eclipse/scripting/internal/IXGRDataChangedListener.java;1;0;3;1;0;0;0;3;4;1;3;133;4;4;1;0;0;3;3;133;0;1424;3;1;
/org.eclipse.update.ui/src/org/eclipse/update/internal/ui/forms/MyComputerSearchDialog.java;3;1;5;1;2;2;2;3;11;1;3;3662;15;15;1;0;0;3;5;3662;0;4100;5;3;
/org.eclipse.jdt.ui.tests.refactoring/resources/RenameTemp/canRename/A_test29_in.java;1;0;2;1;0;0;0;2;2;1;2;1625;2;2;1;0;0;2;2;1625;0;1652;2;1;
/org.eclipse.team.cvs.core/src/org/eclipse/team/internal/ccvs/core/resources/ResourceFactory.java;2;0;2;1;0;0;0;2;0;1;2;1978;0;0;1;0;0;2;2;1978;0;2156;2;2;
/org.eclipse.core.tests.runtime/src/org/eclipse/core/tests/internal/plugins/SoftPrereqTest_7.java;3;0;3;1;0;0;0;3;206;1;3;1794;216;216;1;0;0;3;3;1794;0;3476;3;3;
/org.eclipse.jdt.ui.tests.refactoring/resources/InlineTemp/canInline/A_test20_in.java;1;0;1;1;1;1;1;0;0;0;0;4165;0;0;1;0;0;0;1;4165;0;4165;1;1;
/org.eclipse.vcm.ui/src/org/eclipse/vcm/internal/ui/merge/ProjectAndRepositoryPage.java;4;0;5;2;0;0;0;5;29;2;4;1;66;66;2;1;0;5;5;297;1;397;4;4;
/org.eclipse.compare/compare/org/eclipse/compare/internal/NavigationAction.java;2;0;3;1;1;1;1;2;2;1;2;419;2;2;1;0;0;2;3;419;0;4451;3;2;
/org.eclipse.update.ui/src/org/eclipse/update/internal/ui/pages/UpdatesPage.java;1;0;2;1;0;0;0;2;0;1;2;3537;0;0;1;0;0;2;2;3537;0;3561;2;1;
/org.eclipse.pde.ui/src/org/eclipse/pde/internal/ui/editor/PDEMultiPageXMLEditor.java;1;1;5;1;3;3;3;2;206;1;2;3579;349;349;1;0;0;2;5;3579;0;4568;5;1;
/org.eclipse.jdt.ui/core refactoring/org/eclipse/jdt/internal/corext/refactoring/structure/ModifyParametersrRefactoring.java;1;0;3;1;0;0;0;3;7;1;3;2820;7;7;1;0;0;3;3;2820;0;2933;3;1;
/org.eclipse.pde.ui/Eclipse PDE UI/org/eclipse/pde/internal/PluginProject.java;2;0;5;2;0;0;0;5;21;3;3;267;21;21;3;2;0;5;5;324;2;1434;3;2;
/org.eclipse.team.cvs.ssh/src/org/eclipse/team/internal/ccvs/ssh/ServerPacket.java;2;0;2;1;0;0;0;2;316;1;2;1978;316;316;1;0;0;2;2;1978;0;2963;2;2;
/org.eclipse.jdt.debug.tests/tests/org/eclipse/jdt/debug/tests/eval/NestedTypeFieldValue_555.java;2;1;3;1;3;3;3;0;12;0;0;4447;14;14;1;0;0;0;3;4447;0;4571;3;2;
/org.eclipse.jdt.core/model/org/eclipse/jdt/internal/core/PackageFragmentRootInfo.java;3;1;13;1;2;2;2;11;181;4;8;455;234;234;4;3;0;11;13;1039;3;4421;10;3;
/org.eclipse.jdt.debug.ui/ui/org/eclipse/jdt/internal/debug/ui/launcher/VMSelector.java;1;0;2;1;1;1;1;1;0;0;1;1915;0;0;1;0;0;1;2;1915;0;4131;2;1;
/org.eclipse.ui.externaltools/External Tools/org/eclipse/ui/externaltools/internal/ui/AntPageLabelProvider.java;1;0;1;1;1;1;1;0;0;0;0;4123;0;0;1;0;0;0;1;4123;0;4123;1;1;
/org.eclipse.core.resources/src/org/eclipse/core/internal/indexing/ObjectAddress.java;3;0;6;1;1;1;1;5;192;1;5;12;224;224;1;0;0;5;6;12;0;4214;6;3;
/org.eclipse.jdt.ui/core refactoring/org/eclipse/jdt/internal/corext/refactoring/CompositeChange.java;3;1;6;1;2;2;2;4;28;1;4;1939;45;45;1;0;0;4;6;1939;0;4427;6;3;
/org.eclipse.swt.tests/JUnit Tests/org/eclipse/swt/tests/junit/Test_org_eclipse_swt_widgets_Group.java;2;0;2;1;1;1;1;1;6;0;1;1792;6;6;1;0;0;1;2;1792;0;4706;2;2;
/org.eclipse.core.resources/src/org/eclipse/core/internal/localstore/IHistoryStoreVisitor.java;2;0;4;1;1;1;1;3;34;1;3;12;54;54;1;0;0;3;4;12;0;4214;4;2;
/org.eclipse.jdt.ui/core refactoring/org/eclipse/jdt/internal/corext/refactoring/sef/SelfEncapsulateFieldRefactoring.java;2;1;19;2;2;2;2;17;245;2;14;1939;497;497;2;3;0;17;19;2876;3;4165;16;2;
/org.eclipse.core.resources/src/org/eclipse/core/resources/IProjectDescription.java;2;0;7;1;1;1;1;6;382;2;5;12;418;418;2;1;0;6;7;3415;1;4214;6;2;
/org.eclipse.pde.ui/src/org/eclipse/pde/internal/ui/launcher/AbstractLauncherTab.java;1;2;4;1;3;2;3;1;11;0;1;3579;17;17;2;0;1;1;4;4428;1;4428;3;1;
/org.eclipse.swt/Eclipse SWT/win32/org/eclipse/swt/internal/win32/LOGPEN.java;2;0;3;1;0;0;0;3;5;1;3;106;5;5;1;0;0;3;3;106;0;2069;3;2;
/org.eclipse.jdt.ui.tests/ui/org/eclipse/jdt/ui/wizards/examples/TabTest.java;2;0;2;1;0;0;0;2;0;1;2;522;0;0;1;0;0;2;2;522;0;1186;2;2;
/org.eclipse.jdt.ui.tests.refactoring/resources/ExtractTemp/canExtract/A_test32_in.java;1;0;1;1;0;0;0;1;0;0;1;3210;0;0;1;0;0;1;1;3210;0;3210;1;1;
/org.eclipse.jdt.junit/Eclipse JUnit/org/eclipse/jdt/junit/internal/JUnitUIPlugin.java;2;0;3;1;0;0;0;3;5;1;3;1511;8;8;1;0;0;3;3;1511;0;1996;3;2;
/org.eclipse.pde.ui/src/org/eclipse/pde/internal/core/schema/DocumentSection.java;1;0;3;1;0;0;0;3;2;1;3;3579;2;2;1;0;0;3;3;3579;0;3607;3;1;
/org.eclipse.jdt.debug.ui/ui/org/eclipse/jdt/internal/debug/ui/actions/ThreadFilterViewer.java;2;0;6;1;0;0;0;6;34;2;5;2895;54;54;2;1;0;6;6;3362;1;3362;5;2;
/org.eclipse.pde.ui/src/org/eclipse/pde/internal/wizards/templates/FieldData.java;1;0;2;1;0;0;0;2;0;1;2;3240;0;0;1;0;0;2;2;3240;0;3579;2;1;
/org.eclipse.ui/Eclipse JFace Text/org/eclipse/jface/text/contentassist/IContentAssistListener.java;4;0;4;1;1;1;1;3;5;1;3;257;9;9;1;0;0;3;4;257;0;4853;4;4;
/org.eclipse.update/src/org/eclipse/update/internal/ui/UMWizardTreeItemComparator.java;1;0;1;1;0;0;0;1;0;0;1;1424;0;0;1;0;0;1;1;1424;0;1424;1;1;
/org.eclipse.jdt.ui/ui debug/org/eclipse/jdt/internal/debug/ui/CRCCache.java;1;0;2;1;0;0;0;2;0;1;2;97;0;0;1;0;0;2;2;97;0;133;2;1;
/org.eclipse.ui/Eclipse UI/org/eclipse/ui/internal/registry/ProjectImageRegistryReader.java;2;0;2;1;0;0;0;2;2;1;2;620;2;2;1;0;0;2;2;620;0;3250;2;2;
/org.eclipse.jdt.debug/model/org/eclipse/jdt/internal/debug/core/hcr/CompilationUnitDelta.java;2;0;7;2;1;1;1;6;30;2;5;2585;51;51;2;1;0;6;7;3149;1;4602;6;2;
/org.eclipse.core.runtime/src/org/eclipse/core/internal/runtime/PlatformMetaArea.java;4;1;10;1;4;4;4;6;322;1;6;12;430;430;1;0;0;6;10;12;0;4550;10;4;
/org.eclipse.ant.core/src/org/eclipse/ant/internal/core/old/CommaPatternSet.java;1;0;1;1;0;0;0;1;0;0;1;3270;0;0;1;0;0;1;1;3270;0;3270;1;1;
/org.eclipse.jdt.ui.tests.refactoring/resources/ExtractMethodWorkSpace/ExtractMethodTests/wiki_in/A_test2004.java;1;1;3;1;2;2;2;1;32;0;1;1236;32;32;1;0;0;1;3;1236;0;4419;3;1;
/org.eclipse.ui/Eclipse UI Standard Components/org/eclipse/ui/views/properties/IPropertiesHelpContextIds.java;3;0;3;1;0;0;0;3;10;1;3;620;11;11;1;0;0;3;3;620;0;3091;3;3;
/org.eclipse.ui/Eclipse UI Standard Components/org/eclipse/ui/views/bookmarkexplorer/SelectAllAction.java;4;0;6;1;0;0;0;6;9;1;6;257;23;23;1;0;0;6;6;257;0;3029;6;4;
/org.eclipse.ui.tests/Eclipse UI Tests/org/eclipse/ui/tests/dialogs/ResourceNavigatorMessagesCopy.java;1;0;1;1;0;0;0;1;0;0;1;1113;0;0;1;0;0;1;1;1113;0;1113;1;1;
/org.eclipse.swt/Eclipse SWT/carbon/org/eclipse/swt/widgets/Combo.java;3;1;4;1;4;4;4;0;57;0;0;4147;79;79;1;0;0;0;4;4147;0;4701;4;3;
/org.eclipse.compare/compare/org/eclipse/compare/internal/ComparePreferencePage.java;2;1;13;1;2;2;2;11;289;2;10;107;638;638;2;1;0;11;13;3571;1;4541;12;2;
/org.eclipse.team.ftp/src/org/eclipse/team/internal/ftp/FTPException.java;1;1;3;1;3;3;3;0;11;0;0;4169;15;15;1;0;0;0;3;4169;0;4327;3;1;
/org.eclipse.jdt.debug/eval/org/eclipse/jdt/internal/debug/eval/ast/engine/RemainderOperator.java;1;0;2;1;0;0;0;2;0;1;2;3329;0;0;1;0;0;2;2;3329;0;3421;2;1;
/org.eclipse.jdt.debug.ui/ui/org/eclipse/jdt/internal/debug/ui/DebugUIMessages.java;1;0;1;1;0;0;0;1;0;0;1;1944;0;0;1;0;0;1;1;1944;0;1944;1;1;
/org.eclipse.jdt.core/dom/org/eclipse/jdt/core/dom/FieldAccess.java;2;1;6;1;2;2;2;4;16;1;4;2669;55;55;1;0;0;4;6;2669;0;4453;6;2;
/org.eclipse.team.ftp/src/org/eclipse/team/internal/ftp/client/IFTPRunnable.java;1;0;1;1;1;1;1;0;0;0;0;4241;0;0;1;0;0;0;1;4241;0;4241;1;1;
/org.eclipse.jdt.ui.tests/JUnit/junit/tests/ClassLoaderTestCase.java;2;0;2;1;0;0;0;2;0;1;2;49;0;0;1;0;0;2;2;49;0;1186;2;2;
/org.eclipse.team.cvs.core/src/org/eclipse/team/internal/ccvs/core/resources/ResourceSyncInfo.java;3;0;14;2;0;0;0;14;333;2;12;2156;433;433;2;2;0;14;14;2156;2;2690;12;3;
/org.eclipse.pde.ui/src/org/eclipse/pde/internal/ui/launcher/WorkbenchLauncherWizardBasicPage.java;1;0;4;1;0;0;0;4;12;1;4;3579;15;15;1;0;0;4;4;3579;0;3634;4;1;
/org.eclipse.jdt.core/model/org/eclipse/jdt/core/ElementChangedEvent.java;3;2;8;1;4;3;4;4;115;2;3;455;185;185;2;1;1;4;8;3643;2;4422;6;3;
/org.eclipse.team.cvs.core/src/org/eclipse/team/internal/ccvs/core/response/UnsupportedHandler.java;3;0;3;1;0;0;0;3;4;1;3;1978;4;4;1;0;0;3;3;1978;0;2607;3;3;
/org.eclipse.swt.tests/JUnit Tests/org/eclipse/swt/tests/junit/Test_org_eclipse_swt_events_PaintEvent.java;2;0;2;1;1;1;1;1;6;0;1;1792;6;6;1;0;0;1;2;1792;0;4706;2;2;
/org.eclipse.debug.ui/ui/org/eclipse/debug/internal/ui/DebugUIPropertiesAdapterFactory.java;1;0;1;1;0;0;0;1;0;0;1;2206;0;0;1;0;0;1;1;2206;0;2206;1;1;
/org.eclipse.update.ui/src/org/eclipse/update/internal/ui/pages/IUpdateFormPage.java;1;0;1;1;0;0;0;1;0;0;1;3662;0;0;1;0;0;1;1;3662;0;3662;1;1;
/org.eclipse.update.ui/src/org/eclipse/update/internal/ui/parts/UpdateFormPage.java;1;0;8;1;0;0;0;8;19;1;8;1428;42;42;1;0;0;8;8;1428;0;3662;8;1;
/org.eclipse.pde.ui/src/org/eclipse/pde/internal/core/ifeature/IFeatureModel.java;1;0;2;1;0;0;0;2;0;1;2;3591;0;0;1;0;0;2;2;3591;0;3607;2;1;
/org.eclipse.ui/Eclipse UI Text Editor/org/eclipse/ui/texteditor/SelectMarkerRulerInfoAction.java;1;1;3;1;2;2;2;1;235;0;1;3592;252;252;1;0;0;1;3;3592;0;4838;3;1;
/org.eclipse.vcm.ui/src/org/eclipse/vcm/internal/ui/syncdialog/MergeResource.java;2;0;2;1;0;0;0;2;0;1;2;1;0;0;1;0;0;2;2;1;0;68;2;2;
/org.eclipse.jdt.ui.tests.refactoring/resources/RenameVirtualMethodInClass/test18/in/C.java;1;0;1;1;0;0;0;1;0;0;1;49;0;0;1;0;0;1;1;49;0;49;1;1;
/org.eclipse.jdt.ui.tests.refactoring/resources/SelectionAnalyzerWorkSpace/SelectionAnalyzerTests/validSelection/A_test234.java;1;0;1;1;0;0;0;1;0;0;1;1368;0;0;1;0;0;1;1;1368;0;1368;1;1;
/org.eclipse.jdt.junit/Eclipse JUnit/org/eclipse/jdt/junit/internal/FailureDetailView.java;2;0;2;1;0;0;0;2;0;1;2;1531;0;0;1;0;0;2;2;1531;0;2007;2;2;
/org.eclipse.ant.ui/src/org/eclipse/ant/internal/ui/ClasspathPage.java;1;0;2;1;0;0;0;2;109;1;2;3476;109;109;1;0;0;2;2;3476;0;3490;2;1;
/org.eclipse.help/src/org/eclipse/help/internal/contributions/xml1_0/HelpAction.java;1;0;2;1;0;0;0;2;0;1;2;1675;0;0;1;0;0;2;2;1675;0;2217;2;1;
/org.eclipse.jdt.ui.tests.refactoring/resources/ExtractTemp/cannotExtract/A_testFail10.java;1;0;1;1;0;0;0;1;0;0;1;2873;0;0;1;0;0;1;1;2873;0;2873;1;1;
/org.eclipse.swt/Eclipse SWT/motif/org/eclipse/swt/widgets/TreeRoots.java;2;0;4;1;0;0;0;4;19;1;4;106;21;21;1;0;0;4;4;106;0;1028;4;2;
/org.eclipse.update.ui/src/org/eclipse/update/internal/ui/model/BookmarkFolder.java;1;0;2;1;0;0;0;2;6;1;2;3517;6;6;1;0;0;2;2;3517;0;3653;2;1;
/org.eclipse.jdt.ui.tests.refactoring/resources/RenameType/test15/out/A.java;1;0;2;1;0;0;0;2;0;1;2;49;0;0;1;0;0;2;2;49;0;522;2;1;
/org.eclipse.swt.examples.layouts/org/eclipse/swt/examples/layouts/LayoutView.java;2;0;2;1;1;1;1;1;0;0;1;3451;0;0;1;0;0;1;2;3451;0;4024;2;2;
/org.eclipse.swt/Eclipse SWT PI/gtk1x/org/eclipse/swt/internal/gtk/GtkFontSelectionDialog.java;2;0;2;1;1;1;1;1;3;0;1;2107;3;3;1;0;0;1;2;2107;0;4701;2;2;
/org.eclipse.ui/Eclipse JFace Text/org/eclipse/jface/text/JFaceTextMessages.java;1;0;1;1;0;0;0;1;0;0;1;1066;0;0;1;0;0;1;1;1066;0;1066;1;1;
/org.eclipse.update.tests.core/src/org/eclipse/update/tests/api/TestLocalSiteAPI.java;2;0;8;2;0;0;0;8;35;2;6;1932;57;57;2;2;0;8;8;2434;2;3570;6;2;
/org.eclipse.search/search/org/eclipse/search/internal/ui/ShowPreviousResultAction.java;2;0;4;1;0;0;0;4;9;1;4;15;16;16;1;0;0;4;4;15;0;687;4;2;
/org.eclipse.ui.tests/UI Test Utils/org/eclipse/ui/tests/internal/util/SizingTestPass.java;1;0;1;1;0;0;0;1;0;0;1;2785;0;0;1;0;0;1;1;2785;0;2785;1;1;
/org.eclipse.ui/Eclipse UI/org/eclipse/ui/internal/dialogs/IElementFilter.java;1;0;1;1;0;0;0;1;0;0;1;3229;0;0;1;0;0;1;1;3229;0;3229;1;1;
/org.eclipse.jdt.core/compiler/org/eclipse/jdt/internal/compiler/parser/RecoveredLocalVariable.java;2;0;11;1;1;1;1;10;140;4;7;455;183;183;4;3;0;10;11;1039;3;4062;8;2;
/org.eclipse.pde.ui/src/org/eclipse/pde/internal/wizards/WizardTreeSelectionPage.java;2;0;4;1;0;0;0;4;4;1;4;1434;6;6;1;0;0;4;4;1434;0;3579;4;2;
/org.eclipse.core.tests.resources/src/org/eclipse/core/tests/resources/usecase/AllTests.java;3;0;3;1;0;0;0;3;60;1;3;1794;70;70;1;0;0;3;3;1794;0;3475;3;3;
/org.eclipse.jdt.ui.tests.refactoring/resources/PasteSourceReference/test3/in/B.java;1;0;1;1;1;1;1;0;0;0;0;4544;0;0;1;0;0;0;1;4544;0;4544;1;1;
/org.eclipse.jdt.core/model/org/eclipse/jdt/internal/core/newbuilder/ImageBuilderInternalException.java;1;0;4;1;0;0;0;4;18;1;4;1764;19;19;1;0;0;4;4;1764;0;2979;4;1;
/org.eclipse.jdt.ui.tests.refactoring/resources/RenameVirtualMethodInClass/testFail25/in/A.java;1;0;1;1;0;0;0;1;0;0;1;49;0;0;1;0;0;1;1;49;0;49;1;1;
/org.eclipse.jdt.core/model/org/eclipse/jdt/internal/core/JavaElementDelta.java;3;1;24;1;4;4;4;20;1050;4;17;455;1725;1725;4;3;0;20;24;1039;3;4304;21;3;
/org.eclipse.ui/Eclipse JFace Text/org/eclipse/jface/text/IInformationControl.java;2;0;4;1;1;1;1;3;44;1;3;1435;71;71;1;0;0;3;4;1435;0;4838;4;2;
/org.eclipse.jdt.ui/ui/org/eclipse/jdt/internal/ui/javadocexport/DialogSettingsModel.java;1;0;2;1;0;0;0;2;0;1;2;3070;0;0;1;0;0;2;2;3070;0;3171;2;1;
/org.eclipse.core.resources/src/org/eclipse/core/resources/IMarkerDelta.java;3;0;6;1;1;1;1;5;322;1;5;12;348;348;1;0;0;5;6;12;0;4214;6;3;
/org.eclipse.core.resources/src/org/eclipse/core/internal/properties/QueryResults.java;2;0;4;1;1;1;1;3;108;1;3;12;129;129;1;0;0;3;4;12;0;4214;4;2;
/org.eclipse.swt.examples/Eclipse SWT Examples/common/org/eclipse/swt/examples/controlexample/DialogTab.java;1;0;2;1;0;0;0;2;0;1;2;107;0;0;1;0;0;2;2;107;0;611;2;1;
/org.eclipse.jdt.ui.tests.refactoring/resources/DeleteSourceReferenceEdit/A_test2_in.java;1;0;1;1;0;0;0;1;0;0;1;2857;0;0;1;0;0;1;1;2857;0;2857;1;1;
/org.eclipse.jdt.debug/eval/org/eclipse/jdt/internal/debug/eval/ast/instructions/GreaterEqualOperator.java;3;0;7;1;1;1;1;6;36;1;6;3421;50;50;1;0;0;6;7;3421;0;3955;7;3;
/org.eclipse.core.resources/src/org/eclipse/core/internal/dtree/AbstractDataTreeNode.java;2;0;6;1;1;1;1;5;1156;2;4;12;2097;2097;2;1;0;5;6;1241;1;4214;5;2;
/org.eclipse.jdt.debug/eval/org/eclipse/jdt/internal/debug/eval/model/IVirtualMachine.java;2;0;2;1;0;0;0;2;0;1;2;3555;0;0;1;0;0;2;2;3555;0;3645;2;2;
/org.eclipse.update.ui/src/org/eclipse/update/internal/ui/search/SearchCategoryRegistryReader.java;1;0;2;1;0;0;0;2;39;1;2;3553;39;39;1;0;0;2;2;3553;0;3561;2;1;
/org.eclipse.pde.ui/templates/editor/java/XMLDoubleClickStrategy.java;1;0;2;1;1;1;1;1;4;0;1;3812;4;4;1;0;0;1;2;3812;0;4318;2;1;
/org.eclipse.core.tests.runtime/src/org/eclipse/core/tests/internal/plugins/AllTests.java;4;0;5;1;0;0;0;5;228;1;5;1794;251;251;1;0;0;5;5;1794;0;3476;5;4;
/org.eclipse.jdt.ui.tests.refactoring/resources/MoveMembers/test15/in/B.java;1;0;1;1;0;0;0;1;0;0;1;2738;0;0;1;0;0;1;1;2738;0;2738;1;1;
/org.eclipse.team.cvs.core/src/org/eclipse/team/internal/ccvs/core/client/RTag.java;2;1;10;2;2;2;2;8;40;2;7;2874;116;116;2;1;0;8;10;3089;1;4081;9;2;
/org.eclipse.swt.tests/JUnit Tests/org/eclipse/swt/tests/junit/Test_org_eclipse_swt_widgets_MessageBox.java;2;0;2;1;1;1;1;1;6;0;1;1792;6;6;1;0;0;1;2;1792;0;4706;2;2;
/org.eclipse.swt/Eclipse SWT/motif/org/eclipse/swt/internal/motif/XWindowEvent.java;2;0;3;1;0;0;0;3;4;1;3;106;4;4;1;0;0;3;3;106;0;2069;3;2;
/org.eclipse.jdt.core/compiler/org/eclipse/jdt/internal/compiler/ast/PrefixExpression.java;2;1;13;1;2;2;2;11;76;4;8;455;248;248;4;3;0;11;13;1039;3;4421;10;2;
/org.eclipse.debug.core/core/org/eclipse/debug/core/model/ILaunchConfigurationDelegate.java;3;1;11;1;2;2;2;9;23;1;9;1819;103;103;1;0;0;9;11;1819;0;4651;11;3;
/org.eclipse.pde.ui/src/org/eclipse/pde/internal/base/model/IIdentifiable.java;2;0;3;1;0;0;0;3;10;1;3;1434;10;10;1;0;0;3;3;1434;0;3039;3;2;
/org.eclipse.jdt.debug/eval/org/eclipse/jdt/internal/debug/eval/ast/engine/RightShiftOperator.java;1;0;3;1;0;0;0;3;2;1;3;3329;2;2;1;0;0;3;3;3329;0;3421;3;1;
/org.eclipse.scripting/src/org/eclipse/scripting/internal/IXGRParentComposite.java;1;0;1;1;0;0;0;1;0;0;1;1424;0;0;1;0;0;1;1;1424;0;1424;1;1;
/org.eclipse.swt/Eclipse SWT/gtk1x/org/eclipse/swt/graphics/GC.java;4;0;5;1;1;1;1;4;64;2;3;2107;78;78;2;1;0;4;5;2365;1;4701;4;4;
/org.eclipse.pde.ui/Eclipse PDE UI/org/eclipse/pde/internal/editor/schema/SchemaPropertySheet.java;2;0;5;2;0;0;0;5;12;3;3;267;12;12;3;2;0;5;5;324;2;1434;3;2;
/org.eclipse.vcm.ui/src/org/eclipse/vcm/internal/ui/IVCMHelpContextIds.java;3;0;5;2;0;0;0;5;14;2;3;353;22;22;2;2;0;5;5;353;2;438;3;3;
/org.eclipse.jdt.core/model/org/eclipse/jdt/core/util/Util.java;1;0;2;1;0;0;0;2;148;1;2;3565;148;148;1;0;0;2;2;3565;0;3790;2;1;
/org.eclipse.swt/Eclipse SWT/carbon/org/eclipse/swt/widgets/Slider.java;3;1;4;1;4;4;4;0;32;0;0;4147;44;44;1;0;0;0;4;4147;0;4701;4;3;
/org.eclipse.jdt.ui/ui/org/eclipse/jdt/internal/ui/typehierarchy/TypeHierarchyViewPart.java;9;4;110;3;19;15;19;91;445;4;64;15;3345;3345;4;27;4;91;110;432;31;4700;79;9;
/org.eclipse.jdt.ui.tests.refactoring/test cases/org/eclipse/jdt/ui/tests/refactoring/RenameParametersTests.java;2;0;11;1;0;0;0;11;23;3;9;1896;74;74;3;2;0;11;11;2751;2;3394;9;2;
/org.eclipse.team.core/src/org/eclipse/team/core/target/TargetLocation.java;2;2;3;2;3;2;3;0;32;0;0;4113;32;32;2;0;1;0;3;4128;1;4128;2;2;
/org.eclipse.jdt.ui.tests.refactoring/resources/ExtractMethodWorkSpace/ExtractMethodTests/locals_out/A_test518.java;2;1;4;1;2;2;2;2;5;1;2;511;5;5;1;0;0;2;4;511;0;4419;4;2;
/org.eclipse.jdt.core/dom/org/eclipse/jdt/core/dom/BindingResolver.java;3;1;10;1;2;2;2;8;81;1;8;2669;250;250;1;0;0;8;10;2669;0;4421;10;3;
/org.eclipse.swt.examples/org/eclipse/swt/examples/explorer/TreeExpandDropListener.java;1;0;1;1;0;0;0;1;0;0;1;513;0;0;1;0;0;1;1;513;0;513;1;1;
/org.eclipse.jdt.debug.tests/testprograms/org/eclipse/debug/tests/targets/InfiniteLoop.java;2;0;2;1;1;1;1;1;11;0;1;3719;11;11;1;0;0;1;2;3719;0;4571;2;2;
/org.eclipse.jdt.ui.tests.refactoring/resources/ExtractMethodWorkSpace/ExtractMethodTests/validSelection_out/A_test362.java;1;1;4;1;2;2;2;2;34;1;2;2621;38;38;1;0;0;2;4;2621;0;4419;4;1;
/org.eclipse.pde/src/org/eclipse/pde/internal/builders/ManifestParser.java;1;0;1;1;0;0;0;1;0;0;1;3631;0;0;1;0;0;1;1;3631;0;3631;1;1;
/org.eclipse.jdt.debug.ui/ui/org/eclipse/jdt/internal/debug/ui/launcher/JREContainerWizardPage.java;1;2;6;1;6;5;6;0;31;0;0;4145;49;49;2;0;1;0;6;4145;1;4536;5;1;
/org.eclipse.jdt.junit/src/org/eclipse/jdt/junit/wizards/UpdateTestSuite.java;2;0;8;1;0;0;0;8;40;3;6;3247;52;52;3;2;0;8;8;3392;2;3527;6;2;
/org.eclipse.ui.tests/Eclipse UI Tests/org/eclipse/ui/tests/api/ListContentProvider.java;1;0;2;1;0;0;0;2;31;0;1;1403;31;31;2;1;0;2;2;1403;1;1403;1;1;
/org.eclipse.jdt.ui/core refactoring/org/eclipse/jdt/internal/core/refactoring/changes/DeleteProjectChange.java;2;0;4;1;0;0;0;4;16;1;4;1108;22;22;1;0;0;4;4;1108;0;1939;4;2;
/org.eclipse.jdt.ui/core refactoring/org/eclipse/jdt/internal/corext/refactoring/util/IParentTracker.java;2;0;2;1;0;0;0;2;0;1;2;1939;0;0;1;0;0;2;2;1939;0;3357;2;2;
/org.eclipse.swt/Eclipse SWT/common/org/eclipse/swt/internal/image/PngIdatChunk.java;2;0;3;1;1;1;1;2;10;1;2;106;16;16;1;0;0;2;3;106;0;4701;3;2;
/org.eclipse.jdt.ui/ui refactoring/org/eclipse/jdt/internal/ui/nls/search/ExceptionHandler.java;1;0;2;1;0;0;0;2;0;1;2;1913;0;0;1;0;0;2;2;1913;0;1922;2;1;
/org.eclipse.help/src/org/eclipse/help/internal/server/HighlightProcessor.java;2;0;5;1;0;0;0;5;2;1;5;1420;5;5;1;0;0;5;5;1420;0;3095;5;2;
/org.eclipse.pde.ui/src/org/eclipse/pde/internal/ui/editor/feature/FeatureAdvancedPage.java;1;0;1;1;1;1;1;0;0;0;0;3982;0;0;1;0;0;0;1;3982;0;3982;1;1;
/org.eclipse.team.webdav/src/org/eclipse/team/internal/webdav/core/WebDavSite.java;3;3;16;2;16;10;16;0;99;0;0;4132;262;262;3;0;6;0;16;4149;6;4636;10;3;
/org.eclipse.jdt.ui.tests.refactoring/resources/RenamePackage/testFail1/in/p/p1/A.java;2;0;2;1;0;0;0;2;0;1;2;49;0;0;1;0;0;2;2;49;0;1258;2;2;
/org.eclipse.jdt.ui/ui refactoring/org/eclipse/jdt/internal/ui/refactoring/actions/IRefactoringAction.java;1;0;3;1;0;0;0;3;4;1;3;2769;4;4;1;0;0;3;3;2769;0;3807;3;1;
/org.eclipse.pde.ui/src/org/eclipse/pde/internal/ui/editor/SystemFileEditorInput.java;1;0;1;1;0;0;0;1;0;0;1;3579;0;0;1;0;0;1;1;3579;0;3579;1;1;
/org.eclipse.team.tests.cvs.core/src/org/eclipse/team/tests/ccvs/ui/logformatter/PrintRawMain.java;1;0;4;1;0;0;0;4;12;1;4;2977;14;14;1;0;0;4;4;2977;0;3452;4;1;
/org.eclipse.jdt.debug.ui/ui/org/eclipse/jdt/internal/debug/ui/actions/ManageBreakpointRulerActionDelegate.java;1;0;1;1;0;0;0;1;0;0;1;3570;0;0;1;0;0;1;1;3570;0;3570;1;1;
/org.eclipse.core.target/src/org/eclipse/core/internal/target/webdav/DavStore.java;3;0;7;1;1;1;1;6;1122;1;6;12;1386;1386;1;0;0;6;7;12;0;4196;7;3;
/org.eclipse.jdt.ui.tests.refactoring/resources/RenameMethodInInterface/testFail9/in/A.java;1;0;1;1;0;0;0;1;0;0;1;49;0;0;1;0;0;1;1;49;0;49;1;1;
/org.eclipse.team.cvs.core/src/org/eclipse/team/internal/ccvs/core/IServerConnection.java;3;0;4;1;0;0;0;4;2;1;4;1978;6;6;1;0;0;4;4;1978;0;3610;4;3;
/org.eclipse.ui/Eclipse UI Text Editor/org/eclipse/ui/texteditor/IncrementalFindTarget.java;2;1;9;2;4;4;4;5;162;1;5;3250;333;333;1;0;0;5;9;3250;0;4838;9;2;
/org.eclipse.pde.ui/src/org/eclipse/pde/internal/editor/manifest/DependencyGraph.java;2;0;5;1;0;0;0;5;25;2;4;1434;26;26;2;1;0;5;5;2470;1;3050;4;2;
/org.eclipse.ui.tests/Eclipse UI Tests/RunUiTestSuite.java;1;0;2;1;0;0;0;2;0;1;2;1041;0;0;1;0;0;2;2;1041;0;1407;2;1;
/org.eclipse.pde.ui/src/org/eclipse/pde/internal/wizards/extension/BaseExtensionPointMainPage.java;2;0;7;1;0;0;0;7;438;1;7;1434;450;450;1;0;0;7;7;1434;0;3579;7;2;
/org.eclipse.jdt.ui.tests.refactoring/resources/ExtractMethodWorkSpace/ExtractMethodTests/validSelection/A_test260.java;2;1;3;1;2;2;2;1;0;0;1;49;0;0;1;0;0;1;3;49;0;4419;3;2;
/org.eclipse.compare/compare/org/eclipse/compare/EditionSelectionDialog.java;2;1;33;1;4;4;4;29;464;2;26;14;1482;1482;2;3;0;29;33;25;3;4820;30;2;
/org.eclipse.ui.examples.javaeditor/Eclipse Java Editor Example/org/eclipse/ui/examples/javaeditor/java/JavaCompletionProcessor.java;1;0;1;1;0;0;0;1;0;0;1;1067;0;0;1;0;0;1;1;1067;0;1067;1;1;
/org.eclipse.swt/Eclipse SWT Custom Widgets/common/org/eclipse/swt/custom/BidiSegmentListener.java;2;0;2;1;1;1;1;1;6;0;1;1624;6;6;1;0;0;1;2;1624;0;4701;2;2;
/org.eclipse.pde.ui/src/org/eclipse/pde/internal/ui/preferences/TargetPlatformPreferencePage.java;1;0;4;1;1;1;1;3;301;1;3;3579;336;336;1;0;0;3;4;3579;0;4221;4;1;
/org.eclipse.ui/Eclipse UI/org/eclipse/ui/internal/dialogs/WorkingSetNewWizard.java;1;0;7;1;2;1;2;5;46;2;4;3576;105;105;2;1;1;5;7;3576;2;3936;5;1;
/org.eclipse.core.target/src/org/eclipse/core/target/IResourceMapping.java;1;0;5;1;1;1;1;4;220;1;4;12;277;277;1;0;0;4;5;12;0;4196;5;1;
/org.eclipse.help/Eclipse Help/org/eclipse/help/internal/util/HelpLogListener.java;4;0;6;1;0;0;0;6;38;1;6;135;53;53;1;0;0;6;6;135;0;1420;6;4;
/org.eclipse.ant.ui/src/org/eclipse/ant/internal/ui/toolscripts/GlobalToolScriptWizard.java;1;0;3;1;0;0;0;3;15;2;2;2933;15;15;2;1;0;3;3;2933;1;2979;2;1;
/org.eclipse.team.cvs.ui/src/org/eclipse/team/internal/ccvs/ui/actions/MoveRemoteTagAction.java;1;1;3;1;3;3;3;0;6;0;0;4082;8;8;1;0;0;0;3;4082;0;4455;3;1;
/org.eclipse.debug.ui/ui/org/eclipse/debug/ui/CommonTab.java;3;1;15;1;9;9;9;6;62;1;6;3313;216;216;1;0;0;6;15;3313;0;4708;15;3;
/org.eclipse.jdt.debug/jdi/org/eclipse/jdi/internal/ByteTypeImpl.java;2;0;4;1;0;0;0;4;13;1;4;187;27;27;1;0;0;4;4;187;0;3670;4;2;
/org.eclipse.jdt.ui.tests.refactoring/resources/PasteSourceReference/Copy of test0/out/B.java;1;0;2;1;0;0;0;2;0;1;2;2003;0;0;1;0;0;2;2;2003;0;2156;2;1;
/org.eclipse.scripting/src/org/eclipse/scripting/internal/uirenderer/ScriptPreferencePage.java;1;0;1;1;0;0;0;1;0;0;1;1424;0;0;1;0;0;1;1;1424;0;1424;1;1;
/org.eclipse.jdt.debug/model/org/eclipse/jdt/debug/core/IJavaArray.java;1;0;4;1;1;1;1;3;9;1;3;1758;12;12;1;0;0;3;4;1758;0;4423;4;1;
/org.eclipse.jdt.debug.ui/ui/org/eclipse/jdt/internal/debug/ui/display/DataDisplay.java;2;0;3;1;1;1;1;2;11;1;2;2342;15;15;1;0;0;2;3;2342;0;4567;3;2;
/org.eclipse.jdt.ui.tests.refactoring/resources/RenamePrivateField/test6/in/A.java;1;0;1;1;0;0;0;1;0;0;1;2931;0;0;1;0;0;1;1;2931;0;2931;1;1;
/org.eclipse.ui/Eclipse JFace Text/org/eclipse/jface/text/contentassist/IContextInformation.java;3;0;3;1;0;0;0;3;21;1;3;257;26;26;1;0;0;3;3;257;0;1066;3;3;
/org.eclipse.jdt.ui/ui/org/eclipse/jdt/internal/ui/jarexporter/WizardFileSystemExportPage1.java;1;0;3;1;0;0;0;3;2;1;3;15;2;2;1;0;0;3;3;15;0;239;3;1;
/org.eclipse.jdt.debug.ui/ui/org/eclipse/jdt/internal/debug/ui/ImageDescriptorRegistry.java;2;0;3;2;0;0;0;3;98;2;2;2911;99;99;2;1;0;3;3;2911;1;2933;2;2;
/org.eclipse.core.resources/src/org/eclipse/core/internal/events/NotificationManager.java;3;0;13;2;1;1;1;12;332;2;11;12;448;448;2;1;0;12;13;318;1;4214;12;3;
/org.eclipse.jdt.ui/core extension/org/eclipse/jdt/internal/corext/dom/GenericVisitor.java;1;0;4;1;0;0;0;4;22;1;4;2876;42;42;1;0;0;4;4;2876;0;3826;4;1;
/org.eclipse.jdt.debug/jdi/org/eclipse/jdi/internal/ShortValueImpl.java;2;0;4;1;0;0;0;4;19;1;4;187;37;37;1;0;0;4;4;187;0;3670;4;2;
/org.eclipse.jdt.ui.tests.refactoring/resources/ExtractMethodWorkSpace/ExtractMethodTests/expression_in/A_test602.java;2;1;3;1;2;2;2;1;14;0;1;239;14;14;1;0;0;1;3;239;0;4419;3;2;
/org.eclipse.jdt.ui.tests.refactoring/resources/RenameVariables/canRename/A_test9_in.java;1;0;2;1;0;0;0;2;0;1;2;724;0;0;1;0;0;2;2;724;0;1665;2;1;
/org.eclipse.pde.ui/src/org/eclipse/pde/internal/component/ComponentProject.java;2;0;2;1;0;0;0;2;0;1;2;1434;0;0;1;0;0;2;2;1434;0;2951;2;2;
/org.eclipse.ui/Eclipse UI/org/eclipse/ui/internal/WorkingSetManager.java;3;2;12;1;6;5;6;6;123;2;5;3494;278;278;2;1;1;6;12;3774;2;4675;10;3;
/org.eclipse.jdt.ui.tests/JUnit/junit/samples/money/MoneyBag.java;2;0;2;1;0;0;0;2;0;1;2;49;0;0;1;0;0;2;2;49;0;1186;2;2;
/org.eclipse.jdt.ui/ui/org/eclipse/jdt/internal/ui/reorg/SourceReferenceUtil.java;1;0;2;1;0;0;0;2;0;1;2;2003;0;0;1;0;0;2;2;2003;0;2212;2;1;
/org.eclipse.jdt.ui/core refactoring/org/eclipse/jdt/internal/core/refactoring/text/SimpleReplaceTextChange.java;3;0;5;1;0;0;0;5;14;1;5;408;20;20;1;0;0;5;5;408;0;1939;5;3;
/org.eclipse.jdt.ui.tests.refactoring/resources/RenameNonPrivateField/testFail1/in/A.java;1;0;1;1;0;0;0;1;0;0;1;49;0;0;1;0;0;1;1;49;0;49;1;1;
/org.eclipse.scripting/src/org/eclipse/scripting/internal/views/ScriptUIPreviewEditor.java;1;0;1;1;0;0;0;1;0;0;1;1424;0;0;1;0;0;1;1;1424;0;1424;1;1;
/org.eclipse.pde.ui/src/org/eclipse/pde/internal/ui/editor/feature/FeatureForm.java;1;0;4;1;1;1;1;3;7;2;2;3579;12;12;2;1;0;3;4;3579;1;3982;3;1;
/org.eclipse.jdt.ui/ui/org/eclipse/jdt/internal/ui/javadocexport/JavadocReader.java;1;0;3;1;0;0;0;3;20;1;3;3070;24;24;1;0;0;3;3;3070;0;3589;3;1;
/org.eclipse.core.tests.runtime/src/org/eclipse/core/tests/plugintests/CmdLineAndStateTest.java;1;0;1;1;1;1;1;0;0;0;0;4006;0;0;1;0;0;0;1;4006;0;4006;1;1;
/org.eclipse.pde.ui/src/org/eclipse/pde/internal/ui/editor/PDEFormSection.java;1;0;2;1;0;0;0;2;4;0;1;3579;4;4;2;1;0;2;2;3579;1;3579;1;1;
/org.eclipse.help/src/org/eclipse/help/internal/contributions/Visitor.java;2;0;2;1;0;0;0;2;0;1;2;1420;0;0;1;0;0;2;2;1420;0;1675;2;2;
/org.eclipse.vcm.tests.core/src/org/eclipse/vcm/tests/core/base/IRepositoryTest.java;1;0;1;1;0;0;0;1;0;0;1;1688;0;0;1;0;0;1;1;1688;0;1688;1;1;
/org.eclipse.swt/Eclipse SWT Drag and Drop/win32/org/eclipse/swt/dnd/RTFTransfer.java;2;1;6;1;4;4;4;2;77;1;2;106;177;177;1;0;0;2;6;106;0;4824;6;2;
/org.eclipse.jdt.ui.tests.refactoring/resources/ExtractMethodWorkSpace/ExtractMethodTests/semicolon_out/A_test407.java;1;1;3;1;2;2;2;1;4;0;1;1236;4;4;1;0;0;1;3;1236;0;4419;3;1;
/org.eclipse.team.cvs.core/src/org/eclipse/team/internal/ccvs/core/response/CopyHandler.java;3;0;6;1;0;0;0;6;144;1;6;1978;300;300;1;0;0;6;6;1978;0;2607;6;3;
/org.eclipse.scripting/src/org/eclipse/scripting/StringDataMultiple.java;1;0;1;1;0;0;0;1;0;0;1;1424;0;0;1;0;0;1;1;1424;0;1424;1;1;
/org.eclipse.jdt.core/compiler/org/eclipse/jdt/internal/compiler/lookup/UnresolvedReferenceBinding.java;3;1;11;1;2;2;2;9;55;4;6;455;108;108;4;3;0;9;11;1039;3;4405;8;3;
/org.eclipse.jdt.ui/core refactoring/org/eclipse/jdt/internal/core/refactoring/changes/AbstractDeleteChange.java;2;0;2;1;0;0;0;2;0;1;2;1257;0;0;1;0;0;2;2;1257;0;1939;2;2;
/org.eclipse.swt/Eclipse SWT/win32/org/eclipse/swt/widgets/FileDialog.java;8;3;13;1;5;3;5;8;133;2;7;106;371;371;3;1;2;8;13;4554;3;4701;10;8;
/org.eclipse.swt.examples.controls/org/eclipse/swt/examples/controls/DialogTab.java;2;0;3;1;0;0;0;3;424;1;3;513;424;424;1;0;0;3;3;513;0;970;3;2;
/org.eclipse.swt/Eclipse SWT/gtk1x/org/eclipse/swt/widgets/DirectoryDialog.java;4;0;4;1;1;1;1;3;15;1;3;2107;22;22;1;0;0;3;4;2107;0;4701;4;4;
/org.eclipse.team.cvs.ui/src/org/eclipse/team/internal/ccvs/ui/TagSelectionDialog.java;3;1;19;1;5;5;5;14;204;1;14;2388;598;598;1;0;0;14;19;2388;0;4455;19;3;
/org.eclipse.jdt.ui/core refactoring/org/eclipse/jdt/internal/corext/refactoring/structure/PermuteSourceRangesTextEdit.java;1;0;1;1;0;0;0;1;0;0;1;2270;0;0;1;0;0;1;1;2270;0;2270;1;1;
/org.eclipse.core.tests.runtime/src/org/eclipse/core/tests/internal/runtimetests/SampleKFR.java;1;0;2;1;0;0;0;2;10;1;2;3611;10;10;1;0;0;2;2;3611;0;3678;2;1;
/org.eclipse.ui/Eclipse UI/org/eclipse/ui/internal/dialogs/WorkingSetSelectionDialog.java;1;1;9;1;3;3;3;6;277;2;5;3287;623;623;2;1;0;6;9;3774;1;4675;8;1;
/org.eclipse.jdt.ui/ui refactoring/org/eclipse/jdt/internal/ui/refactoring/actions/RedoRefactoringAction.java;2;0;6;1;2;1;2;4;66;1;4;1345;125;125;2;0;1;4;6;4094;1;4094;5;2;
/org.eclipse.team.ftp/src/org/eclipse/team/internal/ftp/ui/FTPMainPage.java;4;2;7;2;7;5;7;0;99;0;0;4250;160;160;2;0;2;0;7;4250;2;4636;5;4;
/org.eclipse.team.cvs.ui/src/org/eclipse/team/internal/ccvs/ui/actions/DefineBranchAction.java;2;0;8;1;1;1;1;7;14;1;7;2126;40;40;1;0;0;7;8;2126;0;4021;8;2;
/org.eclipse.jdt.ui.tests.refactoring/resources/MoveMembers/testFail9/in/B.java;1;0;1;1;0;0;0;1;0;0;1;2738;0;0;1;0;0;1;1;2738;0;2738;1;1;
/org.eclipse.ui/Eclipse UI/org/eclipse/ui/internal/ChangeToPerspectiveMenu.java;2;1;4;1;3;3;3;1;42;0;1;3049;57;57;1;0;0;1;4;3049;0;4429;4;2;
/org.eclipse.team.cvs.core/src/org/eclipse/team/internal/ccvs/core/client/Command.java;3;1;34;2;3;3;3;31;561;2;26;2572;1723;1723;2;5;0;31;34;3053;5;4111;29;3;
/org.eclipse.update.ui/src/org/eclipse/update/internal/ui/manager/UIProblemHandler.java;2;0;4;1;0;0;0;4;9;1;4;2224;12;12;1;0;0;4;4;2224;0;3662;4;2;
/org.eclipse.pde.ui/Eclipse PDE UI/org/eclipse/pde/internal/editor/manifest/LibrarySection.java;2;0;6;2;0;0;0;6;12;3;4;267;13;13;3;2;0;6;6;324;2;1434;4;2;
/org.eclipse.jdt.ui.tests/ui/org/eclipse/jdt/ui/wizards/examples/CheckBoxExample.java;2;0;2;1;0;0;0;2;0;1;2;522;0;0;1;0;0;2;2;522;0;1186;2;2;
/org.eclipse.jdt.ui.tests.refactoring/resources/SelectionAnalyzerWorkSpace/SelectionAnalyzerTests/invalidSelection/A_test010.java;1;0;1;1;0;0;0;1;0;0;1;1368;0;0;1;0;0;1;1;1368;0;1368;1;1;
/org.eclipse.compare/compare/org/eclipse/compare/internal/TabFolderLayout.java;1;0;1;1;0;0;0;1;0;0;1;3571;0;0;1;0;0;1;1;3571;0;3571;1;1;
/org.eclipse.jdt.ui.tests.refactoring/resources/MoveMembers/test12/in/B.java;1;0;1;1;0;0;0;1;0;0;1;2738;0;0;1;0;0;1;1;2738;0;2738;1;1;
/org.eclipse.jdt.ui.tests.refactoring/resources/RenamePackage/testFail5/in/p/A.java;2;0;2;1;0;0;0;2;0;1;2;49;0;0;1;0;0;2;2;49;0;1258;2;2;
/org.eclipse.swt/Eclipse SWT/common/org/eclipse/swt/graphics/PaletteData.java;2;0;3;1;1;1;1;2;6;1;2;106;10;10;1;0;0;2;3;106;0;4701;3;2;
/org.eclipse.pde.ui/src/org/eclipse/pde/internal/ui/wizards/WizardCollectionSorter.java;1;0;1;1;0;0;0;1;0;0;1;3579;0;0;1;0;0;1;1;3579;0;3579;1;1;
/org.eclipse.ui/Eclipse UI/org/eclipse/ui/internal/dialogs/NewProjectWizard.java;2;0;15;1;1;1;1;14;100;2;11;3186;293;293;2;3;0;14;15;3193;3;4082;12;2;
/org.eclipse.ui.tests/Eclipse JFace Tests/org/eclipse/jface/tests/viewers/interactive/CreateModelAction.java;1;0;1;1;0;0;0;1;0;0;1;1488;0;0;1;0;0;1;1;1488;0;1488;1;1;
/org.eclipse.ui/Eclipse JFace Text/org/eclipse/jface/text/IInformationControlExtension.java;1;1;2;1;2;2;2;0;22;0;0;4606;22;22;1;0;0;0;2;4606;0;4838;2;1;
/org.eclipse.jdt.ui/ui/org/eclipse/jdt/internal/ui/text/template/TemplateModel.java;1;0;4;1;0;0;0;4;156;1;4;1587;158;158;1;0;0;4;4;1587;0;1720;4;1;
/org.eclipse.jdt.debug/eval/org/eclipse/jdt/internal/debug/eval/ast/instructions/EvalMessages.java;1;0;2;1;0;0;0;2;0;1;2;3670;0;0;1;0;0;2;2;3670;0;3677;2;1;
/org.eclipse.jdt.core/codeassist/org/eclipse/jdt/internal/codeassist/impl/AssistParser.java;3;0;17;1;1;1;1;16;1776;4;13;455;2011;2011;4;3;0;16;17;1039;3;4062;14;3;
/org.eclipse.update.core/src/org/eclipse/update/core/IFeatureContentConsumer.java;2;1;7;1;3;3;3;4;112;1;4;2465;276;276;1;0;0;4;7;2465;0;4207;7;2;
/org.eclipse.jdt.ui/ui/org/eclipse/jdt/internal/ui/text/correction/NewMethodCompletionProposal.java;4;1;23;1;5;5;5;18;150;3;14;3306;582;582;3;4;0;18;23;3737;4;4621;19;4;
/org.eclipse.team.cvs.core/src/org/eclipse/team/internal/ccvs/core/connection/CVSFileException.java;2;0;3;1;1;1;1;2;70;1;2;1978;70;70;1;0;0;2;3;1978;0;4368;3;2;
/org.eclipse.jdt.ui.tests.refactoring/resources/SefWorkSpace/SefTests/object_out/TestSetterInExpression.java;1;0;1;1;0;0;0;1;0;0;1;2876;0;0;1;0;0;1;1;2876;0;2876;1;1;
/org.eclipse.update.core/src/org/eclipse/update/core/model/ConfigurationSiteModel.java;1;0;9;1;0;0;0;9;23;2;8;2764;88;88;2;1;0;9;9;2994;1;3018;8;1;
/org.eclipse.webdav/src/interface/org/eclipse/webdav/IResponse.java;2;0;4;1;1;1;1;3;900;1;3;1635;1367;1367;1;0;0;3;4;1635;0;4211;4;2;
/org.eclipse.help.ui/src/org/eclipse/help/ui/internal/util/StreamConsumer.java;1;1;2;1;2;2;2;0;6;0;0;4439;6;6;1;0;0;0;2;4439;0;4673;2;1;
/org.eclipse.swt/Eclipse SWT/common/org/eclipse/swt/layout/RowLayout.java;5;1;9;1;3;3;3;6;99;2;4;106;173;173;2;2;0;6;9;2635;2;4701;7;5;
/org.eclipse.ui/Eclipse UI Text Editor/org/eclipse/ui/texteditor/FindNextAction.java;1;0;4;1;1;1;1;3;67;1;3;3170;74;74;1;0;0;3;4;3170;0;4838;4;1;
/org.eclipse.pde.ui/Eclipse PDE UI/org/eclipse/pde/internal/editor/ModifiedTextCellEditor.java;2;0;6;2;0;0;0;6;12;3;4;267;14;14;3;2;0;6;6;324;2;1434;4;2;
/org.eclipse.jdt.ui/core extension/org/eclipse/jdt/internal/corext/codemanipulation/DeleteNodeEdit.java;2;1;8;1;2;2;2;6;93;1;6;2327;176;176;1;0;0;6;8;2327;0;4000;8;2;
/org.eclipse.jdt.ui.tests.refactoring/resources/SelectionAnalyzerWorkSpace/SelectionAnalyzerTests/validSelection/A_test255.java;1;0;1;1;0;0;0;1;0;0;1;1368;0;0;1;0;0;1;1;1368;0;1368;1;1;
/org.eclipse.ui/Eclipse UI/org/eclipse/ui/internal/ActionSetToolBarManager.java;1;0;1;1;0;0;0;1;0;0;1;457;0;0;1;0;0;1;1;457;0;457;1;1;
/org.eclipse.jdt.debug.tests/tests/org/eclipse/jdt/debug/tests/eval/DoubleOperatorsTests.java;2;2;3;2;3;2;3;0;17;0;0;4447;19;19;2;0;1;0;3;4447;1;4571;2;2;
/org.eclipse.pde.ui/src/org/eclipse/pde/internal/launcher/AdvancedTracingLauncherTab.java;1;0;2;1;0;0;0;2;0;1;2;3113;0;0;1;0;0;2;2;3113;0;3121;2;1;
/org.eclipse.jdt.ui/core refactoring/org/eclipse/jdt/core/refactoring/ITextChange.java;1;0;3;1;0;0;0;3;5;1;3;15;5;5;1;0;0;3;3;15;0;408;3;1;
/org.eclipse.ui/Eclipse JFace/org/eclipse/jface/preference/PathEditor.java;2;0;2;1;0;0;0;2;5;1;2;257;5;5;1;0;0;2;2;257;0;457;2;2;
/org.eclipse.help.ui/src/org/eclipse/help/internal/ui/TopicsPage.java;2;0;2;1;0;0;0;2;0;1;2;1420;0;0;1;0;0;2;2;1420;0;1675;2;2;
/org.eclipse.jdt.ui/core refactoring/org/eclipse/jdt/internal/corext/refactoring/text/ITextBufferChange.java;1;0;2;1;0;0;0;2;0;1;2;1939;0;0;1;0;0;2;2;1939;0;2216;2;1;
/org.eclipse.pde.build/src/org/eclipse/pde/internal/build/FeatureScriptGenerator.java;1;0;1;1;0;0;0;1;0;0;1;2896;0;0;1;0;0;1;1;2896;0;2896;1;1;
/org.eclipse.jdt.ui.tests.refactoring/resources/PullUp/testFail7/in/B.java;1;0;1;1;0;0;0;1;0;0;1;2406;0;0;1;0;0;1;1;2406;0;2406;1;1;
/org.eclipse.jdt.ui.tests.refactoring/resources/RenameVirtualMethodInClass/testFail11/in/A.java;1;0;1;1;0;0;0;1;0;0;1;49;0;0;1;0;0;1;1;49;0;49;1;1;
/org.eclipse.core.tests.resources/src/org/eclipse/core/tests/internal/localstore/SafeChunkyInputOutputStreamTest.java;3;0;4;1;1;1;1;3;548;1;3;1794;579;579;1;0;0;3;4;1794;0;4516;4;3;
/org.eclipse.update.core/src/org/eclipse/update/configuration/IConfigurationPolicy.java;1;0;2;1;0;0;0;2;0;0;1;2994;0;0;2;1;0;2;2;2994;1;2994;1;1;
/org.eclipse.jdt.ui/core extension/org/eclipse/jdt/internal/corext/util/JavaModelUtil.java;3;1;15;1;5;5;5;10;160;1;10;2016;446;446;1;0;0;10;15;2016;0;4621;15;3;
/org.eclipse.vcm.ui/src/org/eclipse/vcm/internal/ui/actions/VersionResourceEditionAction.java;4;0;5;2;0;0;0;5;23;2;4;1;43;43;2;1;0;5;5;297;1;1794;4;4;
/org.eclipse.update/Eclipse Update/org/eclipse/update/internal/ui/JarVerificationResult.java;2;0;4;1;0;0;0;4;55;1;4;108;59;59;1;0;0;4;4;108;0;1424;4;2;
/org.eclipse.ui/Eclipse UI/org/eclipse/ui/internal/PerspectiveContributionItem.java;3;1;5;1;2;2;2;3;415;1;3;257;442;442;1;0;0;3;5;257;0;4365;5;3;
/org.eclipse.team.ui/src/org/eclipse/team/internal/ui/PromptingDialog.java;3;1;4;1;4;4;4;0;44;0;0;4256;54;54;1;0;0;0;4;4256;0;4447;4;3;
/org.eclipse.ui/Eclipse UI/org/eclipse/ui/internal/misc/ItemListener.java;2;0;2;1;0;0;0;2;5;1;2;257;5;5;1;0;0;2;2;257;0;457;2;2;
/org.eclipse.jdt.ui.tests.refactoring/resources/ExtractMethodWorkSpace/ExtractMethodTests/C.java;1;1;4;1;3;3;3;1;33;0;1;1236;41;41;1;0;0;1;4;1236;0;4419;4;1;
/org.eclipse.jdt.debug.tests/test programs/WorkingDirectoryTest.java;1;0;2;1;0;0;0;2;0;1;2;3701;0;0;1;0;0;2;2;3701;0;3719;2;1;
/org.eclipse.jdt.core/model/org/eclipse/jdt/internal/core/util/ConstantPool.java;2;1;3;1;2;2;2;1;18;0;1;3629;32;32;1;0;0;1;3;3629;0;4422;3;2;
/org.eclipse.team.ui/src/org/eclipse/team/ui/actions/CheckInAction.java;2;0;8;1;1;1;1;7;136;1;7;1978;177;177;1;0;0;7;8;1978;0;4020;8;2;
/org.eclipse.jdt.ui.tests.refactoring/resources/SelectionAnalyzerWorkSpace/SelectionAnalyzerTests/invalidSelection/A_test021.java;1;0;1;1;0;0;0;1;0;0;1;1368;0;0;1;0;0;1;1;1368;0;1368;1;1;
/org.eclipse.update.ui/src/org/eclipse/update/internal/ui/wizards/BaseNewWizardPage.java;1;1;5;1;3;3;3;2;43;0;1;3653;68;68;2;1;0;2;5;3653;1;4336;4;1;
/org.eclipse.update.ui.forms/src/org/eclipse/update/ui/forms/FormSection.java;1;0;3;1;0;0;0;3;14;2;2;1423;14;14;2;1;0;3;3;1423;1;2474;2;1;
/org.eclipse.jdt.debug.ui/ui/org/eclipse/jdt/internal/debug/ui/actions/OpenOnConsoleTypeAction.java;4;1;20;1;5;5;5;15;148;2;12;1915;575;575;2;3;0;15;20;2824;3;4423;17;4;
/org.eclipse.jdt.ui.tests.refactoring/resources/MoveMembers/test7/in/A.java;1;0;1;1;0;0;0;1;0;0;1;2738;0;0;1;0;0;1;1;2738;0;2738;1;1;
/org.eclipse.debug.ui/ui/org/eclipse/debug/internal/ui/views/breakpoints/BreakpointsViewEventHandler.java;2;1;2;1;2;2;2;0;11;0;0;3975;11;11;1;0;0;0;2;3975;0;4208;2;2;
/org.eclipse.jdt.ui.tests.refactoring/resources/SefWorkSpace/SefTests/object_out/TestCompoundWrite3.java;1;0;1;1;0;0;0;1;0;0;1;2876;0;0;1;0;0;1;1;2876;0;2876;1;1;
/org.eclipse.pde.ui/src/org/eclipse/pde/internal/model/component/ComponentFragment.java;2;0;2;1;0;0;0;2;0;1;2;1434;0;0;1;0;0;2;2;1434;0;2951;2;2;
/org.eclipse.pde.ui/src/org/eclipse/pde/internal/editor/schema/DocForm.java;2;0;3;1;0;0;0;3;6;1;3;1434;6;6;1;0;0;3;3;1434;0;3579;3;2;
/org.eclipse.pde.runtime/src/org/eclipse/pde/internal/runtime/logview/LogEntry.java;1;1;3;1;2;2;2;1;86;0;1;3877;95;95;1;0;0;1;3;3877;0;4089;3;1;
/org.eclipse.swt/Eclipse SWT/common_j2se/org/eclipse/swt/internal/CloneableCompatability.java;1;0;1;1;0;0;0;1;0;0;1;1386;0;0;1;0;0;1;1;1386;0;1386;1;1;
/org.eclipse.update.ui/src/org/eclipse/update/internal/ui/manager/SearchForm.java;1;0;6;1;0;0;0;6;88;3;4;3553;136;136;3;2;0;6;6;3657;2;3657;4;1;
/org.eclipse.ui.examples.javaeditor/Java Editor Example/org/eclipse/ui/examples/javaeditor/java/JavaPartitionScanner.java;1;0;2;1;0;0;0;2;0;0;1;1066;0;0;2;1;0;2;2;1066;1;1066;1;1;
/org.eclipse.jdt.ui.tests.refactoring/resources/SelectionAnalyzerWorkSpace/SelectionAnalyzerTests/invalidSelection/A_test110.java;1;0;1;1;0;0;0;1;0;0;1;1368;0;0;1;0;0;1;1;1368;0;1368;1;1;
/org.eclipse.jdt.ui.tests.refactoring/resources/MoveMembers/test1/in/B.java;1;0;1;1;0;0;0;1;0;0;1;2738;0;0;1;0;0;1;1;2738;0;2738;1;1;
/org.eclipse.pde.ui/src/org/eclipse/pde/internal/ModelSynchronizer.java;1;0;4;1;0;0;0;4;179;2;3;3213;183;183;2;1;0;4;4;3213;1;3579;3;1;
/org.eclipse.help.ui/src/org/eclipse/help/ui/internal/search/SearchQueryData.java;2;1;9;1;3;3;3;6;62;1;6;2429;195;195;1;0;0;6;9;2429;0;4527;9;2;
/org.eclipse.pde.ui/Eclipse PDE UI/org/eclipse/pde/internal/editor/jars/JarsSourcePage.java;2;0;5;2;0;0;0;5;12;3;3;267;12;12;3;2;0;5;5;324;2;1434;3;2;
/org.eclipse.jdt.ui.tests.refactoring/resources/RenameNonPrivateField/test1/out/A.java;1;0;1;1;0;0;0;1;0;0;1;49;0;0;1;0;0;1;1;49;0;49;1;1;
/org.eclipse.pde.ui/Eclipse PDE UI/org/eclipse/pde/internal/editor/text/ColorManager.java;2;0;5;2;0;0;0;5;12;3;3;267;12;12;3;2;0;5;5;324;2;1434;3;2;
/org.eclipse.pde.ui/src/org/eclipse/pde/internal/launcher/TracingPropertySource.java;1;0;3;1;0;0;0;3;1;1;3;3113;1;1;1;0;0;3;3;3113;0;3579;3;1;
/org.eclipse.core.resources/src/org/eclipse/core/internal/resources/IManager.java;2;0;4;1;1;1;1;3;28;1;3;12;48;48;1;0;0;3;4;12;0;4213;4;2;
/org.eclipse.jdt.ui.tests.refactoring/resources/SelectionAnalyzerWorkSpace/SelectionAnalyzerTests/validSelection/A_test305.java;1;0;1;1;0;0;0;1;0;0;1;1368;0;0;1;0;0;1;1;1368;0;1368;1;1;
/org.eclipse.jdt.debug.ui/ui/org/eclipse/jdt/internal/debug/ui/launcher/ExecutionArgsPropertyPage.java;2;0;6;1;0;0;0;6;10;2;5;1915;15;15;2;1;0;6;6;3362;1;3648;5;2;
/org.eclipse.jdt.ui.tests.refactoring/resources/MoveMembers/test16/out/A.java;1;0;1;1;0;0;0;1;0;0;1;2738;0;0;1;0;0;1;1;2738;0;2738;1;1;
/org.eclipse.pde.ui/src/org/eclipse/pde/internal/wizards/ListUtil.java;2;0;2;1;0;0;0;2;0;1;2;1434;0;0;1;0;0;2;2;1434;0;3579;2;2;
/org.eclipse.jdt.core/compiler/org/eclipse/jdt/internal/compiler/ast/BinaryExpression.java;2;0;16;2;1;1;1;15;2756;4;11;455;5671;5671;4;4;0;15;16;1039;4;4062;12;2;
/org.eclipse.jdt.ui.tests.refactoring/resources/ExtractTemp/canExtract/A_test16_out.java;1;0;1;1;0;0;0;1;0;0;1;2481;0;0;1;0;0;1;1;2481;0;2481;1;1;
/org.eclipse.team.cvs.core/src/org/eclipse/team/internal/ccvs/core/Client.java;3;0;12;1;0;0;0;12;694;1;12;1978;1749;1749;1;0;0;12;12;1978;0;2607;12;3;
/org.eclipse.jdt.ui.tests.refactoring/resources/ExtractMethodWorkSpace/ExtractMethodTests/locals_in/A_test569.java;1;1;2;1;2;2;2;0;0;0;0;4383;0;0;1;0;0;0;2;4383;0;4419;2;1;
/org.eclipse.core.resources/src/org/eclipse/core/internal/localstore/BlobStore.java;3;1;6;1;2;2;2;4;322;1;4;12;352;352;1;0;0;4;6;12;0;4607;6;3;
/org.eclipse.pde.ui/src/org/eclipse/pde/internal/base/schema/ISchemaEnumeration.java;2;0;2;1;0;0;0;2;0;1;2;1434;0;0;1;0;0;2;2;1434;0;3579;2;2;
/org.eclipse.pde.ui/src/org/eclipse/pde/internal/ui/BaseProject.java;1;0;2;1;0;0;0;2;0;1;2;3579;0;0;1;0;0;2;2;3579;0;3607;2;1;
/org.eclipse.team.cvs.ui/src/org/eclipse/team/internal/ccvs/ui/actions/CheckoutAction.java;3;1;6;1;4;4;4;2;189;1;2;1978;202;202;1;0;0;2;6;1978;0;4426;6;3;
/org.eclipse.jdt.ui.tests.refactoring/resources/InlineTemp/canInline/A_test6_in.java;1;0;2;1;0;0;0;2;2;1;2;2051;2;2;1;0;0;2;2;2051;0;3048;2;1;
/org.eclipse.jdt.core/model/org/eclipse/jdt/internal/core/JavaElementInfo.java;2;1;5;1;2;2;2;3;185;1;3;455;374;374;1;0;0;3;5;455;0;4063;5;2;
/org.eclipse.ui/Eclipse UI Standard Components/org/eclipse/ui/views/navigator/CopyAction.java;2;0;5;1;0;0;0;5;23;1;5;2830;32;32;1;0;0;5;5;2830;0;3607;5;2;
/org.eclipse.team.cvs.core/src/org/eclipse/team/internal/ccvs/core/util/MoveDeleteHook.java;1;1;4;1;4;4;4;0;267;0;0;3978;301;301;1;0;0;0;4;3978;0;4424;4;1;
/org.eclipse.jdt.core/search/org/eclipse/jdt/internal/core/index/impl/PropertyDocument.java;2;0;3;1;1;1;1;2;20;1;2;455;26;26;1;0;0;2;3;455;0;4063;3;2;
/org.eclipse.jdt.ui/core refactoring/org/eclipse/jdt/core/refactoring/IChangeExceptionHandler.java;1;0;3;1;0;0;0;3;5;1;3;157;5;5;1;0;0;3;3;157;0;408;3;1;
/org.eclipse.swt.examples/org/eclipse/swt/examples/helloworld/HelloWorld5.java;4;0;5;1;1;1;1;4;43;1;4;513;93;93;1;0;0;4;5;513;0;4024;5;4;
/org.eclipse.pde.ui/src/org/eclipse/pde/internal/ui/view/ShowInWorkspaceAction.java;1;0;1;1;0;0;0;1;0;0;1;3579;0;0;1;0;0;1;1;3579;0;3579;1;1;
/org.eclipse.jdt.debug.ui/ui/org/eclipse/jdt/internal/debug/ui/DebugUIUtils.java;2;0;3;1;0;0;0;3;10;1;3;1915;10;10;1;0;0;3;3;1915;0;1944;3;2;
/org.eclipse.pde.ui/src/org/eclipse/pde/internal/ui/wizards/ListUtil.java;1;0;1;1;0;0;0;1;0;0;1;3579;0;0;1;0;0;1;1;3579;0;3579;1;1;
/org.eclipse.scripting/Eclipse Scripting/org/eclipse/scripting/internal/PluginParser.java;1;0;3;1;0;0;0;3;7;1;3;133;7;7;1;0;0;3;3;133;0;1424;3;1;
/org.eclipse.jdt.debug.tests/tests/org/eclipse/jdt/debug/tests/eval/TestsTypeHierarchy1.java;2;2;4;2;4;3;4;0;13;0;0;4447;21;21;2;0;1;0;4;4568;1;4568;3;2;
/org.eclipse.jdt.ui.tests.refactoring/resources/RenamePrivateField/testFail9/in/A.java;1;0;1;1;0;0;0;1;0;0;1;2875;0;0;1;0;0;1;1;2875;0;2875;1;1;
/org.eclipse.jdt.core/compiler/org/eclipse/jdt/internal/compiler/codegen/QualifiedNamesConstants.java;2;0;12;1;1;1;1;11;630;4;8;455;1156;1156;4;3;0;11;12;1039;3;4062;9;2;
/org.eclipse.pde.ui/Eclipse PDE UI/org/eclipse/pde/internal/editor/component/SynchronizeVersionsAction.java;2;0;5;2;0;0;0;5;12;3;3;267;12;12;3;2;0;5;5;324;2;1434;3;2;
/org.eclipse.scripting/src/org/eclipse/scripting/IToolkit.java;1;0;1;1;0;0;0;1;0;0;1;1424;0;0;1;0;0;1;1;1424;0;1424;1;1;
/org.eclipse.debug.ui/ui/org/eclipse/debug/internal/ui/actions/RunDropDownAction.java;4;1;7;1;2;2;2;5;14;1;5;2382;40;40;1;0;0;5;7;2382;0;3975;7;4;
/org.eclipse.compare/compare/org/eclipse/compare/internal/BufferedCanvas.java;1;0;2;1;0;0;0;2;5;1;2;14;5;5;1;0;0;2;2;14;0;329;2;1;
/org.eclipse.help/Eclipse Help/org/eclipse/help/internal/contributions/xml/HelpInsert.java;3;0;5;1;0;0;0;5;27;1;5;135;35;35;1;0;0;5;5;135;0;1420;5;3;
/org.eclipse.help.webapp/src/org/eclipse/help/servlet/InitServlet.java;3;0;8;2;0;0;0;8;20;2;6;2409;61;61;2;2;0;8;8;2409;2;3609;6;3;
/org.eclipse.jdt.debug/jdi/org/eclipse/jdi/internal/ValueImpl.java;2;0;5;1;0;0;0;5;21;1;5;187;43;43;1;0;0;5;5;187;0;3678;5;2;
/org.eclipse.jdt.ui.tests.refactoring/resources/RenameTemp/canRename/A_test34_in.java;1;0;2;1;0;0;0;2;2;1;2;1625;2;2;1;0;0;2;2;1625;0;1652;2;1;
/org.eclipse.jdt.debug.tests/tests/org/eclipse/jdt/debug/tests/ProjectCreationDecorator.java;4;4;15;1;13;9;13;2;18;1;2;3701;56;56;4;0;4;2;15;4307;4;4571;11;4;
/org.eclipse.pde.ui/Eclipse PDE UI/org/eclipse/pde/internal/schema/Schema.java;2;0;7;2;0;0;0;7;12;3;5;267;24;24;3;2;0;7;7;324;2;1434;5;2;
/org.eclipse.jdt.core/model/org/eclipse/jdt/core/JavaConventions.java;4;3;38;2;7;3;8;30;1307;5;23;455;3148;3148;5;7;5;31;38;1039;12;4493;26;4;
/org.eclipse.ui/Eclipse UI/org/eclipse/ui/internal/PartDropTarget.java;2;0;2;1;0;0;0;2;5;1;2;257;5;5;1;0;0;2;2;257;0;457;2;2;
/org.eclipse.jdt.ui.tests.refactoring/resources/SurroundWithWorkSpace/SurroundWithTests/trycatch_in/TestWrappedLocal3.java;1;0;1;1;0;0;0;1;0;0;1;2327;0;0;1;0;0;1;1;2327;0;2327;1;1;
/org.eclipse.core.boot/src/org/eclipse/core/internal/boot/PlatformClassLoader.java;2;0;7;1;1;1;1;6;198;1;6;12;244;244;1;0;0;6;7;12;0;4214;7;2;
/org.eclipse.jdt.ui.tests.refactoring/resources/SelectionAnalyzerWorkSpace/SelectionAnalyzerTests/invalidSelection/A_test151.java;1;0;1;1;0;0;0;1;0;0;1;1368;0;0;1;0;0;1;1;1368;0;1368;1;1;
/org.eclipse.team.cvs.core/src/org/eclipse/team/internal/ccvs/core/resources/LocalFile.java;2;0;18;2;0;0;0;18;116;2;15;2156;489;489;2;3;0;18;18;2156;3;3089;15;2;
/org.eclipse.team.ui/src/org/eclipse/team/ui/actions/ConfigureProjectAction.java;2;0;7;1;1;1;1;6;102;1;6;1978;113;113;1;0;0;6;7;1978;0;4020;7;2;
/org.eclipse.pde.core/src/org/eclipse/pde/core/IModel.java;1;0;4;1;2;1;2;2;96;1;2;3591;102;102;2;0;1;2;4;4751;1;4751;3;1;
/org.eclipse.jdt.ui/ui/org/eclipse/jdt/internal/ui/text/java/IProblemAcceptor.java;1;0;2;1;0;0;0;2;0;1;2;3324;0;0;1;0;0;2;2;3324;0;3418;2;1;
/org.eclipse.update.core/src/org/eclipse/update/core/ISiteLocalChangedListener.java;1;0;2;1;0;0;0;2;0;1;2;2017;0;0;1;0;0;2;2;2017;0;2157;2;1;
/org.eclipse.ui.examples.javaeditor/Eclipse Java Editor Example/org/eclipse/ui/examples/javaeditor/JavaEditorEnvironment.java;1;0;1;1;0;0;0;1;0;0;1;1067;0;0;1;0;0;1;1;1067;0;1067;1;1;
/org.eclipse.help/src/org/eclipse/help/internal/navigation/XMLNavGenerator.java;2;0;4;1;0;0;0;4;11;1;4;1420;17;17;1;0;0;4;4;1420;0;1675;4;2;
/org.eclipse.ui/Eclipse JFace/org/eclipse/jface/preference/BorderedFontFieldEditor.java;1;0;4;1;0;0;0;4;248;2;3;1077;248;248;2;1;0;4;4;1095;1;1108;3;1;
/org.eclipse.update.ui/src/org/eclipse/update/internal/ui/security/JarVerificationDialog.java;2;0;16;2;1;1;1;15;312;2;14;3122;1426;1426;2;1;0;15;16;3866;1;4448;15;2;
/org.eclipse.ui/Eclipse UI/org/eclipse/ui/IElementFactory.java;2;0;2;1;0;0;0;2;5;1;2;257;5;5;1;0;0;2;2;257;0;457;2;2;
/org.eclipse.team.ui/src/org/eclipse/team/internal/ui/target/RemoteResourceElement.java;3;2;10;1;10;9;10;0;156;0;0;4168;273;273;2;0;1;0;10;4448;1;4636;9;3;
/org.eclipse.core.tests.runtime/src/org/eclipse/core/tests/plugintests/CmdLineAndStateAndPrimaryFeatureTest.java;1;0;1;1;1;1;1;0;0;0;0;4006;0;0;1;0;0;0;1;4006;0;4006;1;1;
/org.eclipse.jdt.ui.tests.refactoring/resources/RenameTemp/canRename/A_test34_out.java;1;0;3;1;0;0;0;3;2;1;3;1625;4;4;1;0;0;3;3;1625;0;1652;3;1;
/org.eclipse.pde.runtime/src/org/eclipse/pde/internal/runtime/logview/LogSession.java;1;0;1;1;1;1;1;0;0;0;0;4089;0;0;1;0;0;0;1;4089;0;4089;1;1;
/org.eclipse.team.core/src/org/eclipse/team/core/TeamPlugin.java;4;1;13;1;3;3;3;10;292;2;9;1978;857;857;2;1;0;10;13;3762;1;4123;12;4;
/org.eclipse.jdt.ui/ui/org/eclipse/jdt/internal/ui/text/correction/ProblemPosition.java;3;0;4;1;1;1;1;3;14;1;3;3418;29;29;1;0;0;3;4;3418;0;4452;4;3;
/org.eclipse.update.core/src/org/eclipse/update/internal/core/InstallHandlerProxy.java;2;1;5;1;2;2;2;3;41;2;2;3398;81;81;2;1;0;3;5;3398;1;4688;4;2;
/org.eclipse.team.cvs.ui/src/org/eclipse/team/internal/ccvs/ui/CVSRepositoryPropertiesPage.java;2;1;6;1;5;5;5;1;19;0;1;3763;30;30;1;0;0;1;6;3763;0;4829;6;2;
/org.eclipse.ui.externaltools/External Tools/org/eclipse/ui/externaltools/internal/core/AntTargetList.java;1;1;2;1;2;2;2;0;29;0;0;4145;29;29;1;0;0;0;2;4145;0;4425;2;1;
/org.eclipse.jdt.ui/core refactoring/org/eclipse/jdt/internal/corext/refactoring/util/JdtFlags.java;1;0;1;1;0;0;0;1;0;0;1;3185;0;0;1;0;0;1;1;3185;0;3185;1;1;
/org.eclipse.ui/Eclipse UI Standard Components/org/eclipse/ui/views/internal/navigator/ActionBarMenuContributionFactory.java;1;0;2;1;0;0;0;2;0;1;2;1757;0;0;1;0;0;2;2;1757;0;1830;2;1;
/org.eclipse.jdt.debug/jdi/org/eclipse/jdi/internal/VirtualMachineImpl.java;4;0;9;1;1;1;1;8;161;1;8;187;386;386;1;0;0;8;9;187;0;4328;9;4;
/org.eclipse.pde.ui/src/org/eclipse/pde/internal/base/model/plugin/IMatchRules.java;1;0;2;1;0;0;0;2;0;1;2;2730;0;0;1;0;0;2;2;2730;0;3039;2;1;
/org.eclipse.help/Eclipse Help/org/eclipse/help/internal/contributions/InfoView.java;2;0;3;1;0;0;0;3;7;1;3;135;7;7;1;0;0;3;3;135;0;1420;3;2;
/org.eclipse.jdt.ui.tests.refactoring/resources/RenameTemp/canRename/A_test35_in.java;1;0;2;1;0;0;0;2;4;0;1;2751;4;4;2;1;0;2;2;2751;1;2751;1;1;
/org.eclipse.pde.ui/src/org/eclipse/pde/internal/forms/renamed/HyperlinkAdapter.java;1;0;2;1;0;0;0;2;0;1;2;2470;0;0;1;0;0;2;2;2470;0;2691;2;1;
/org.eclipse.pde.ui/src/org/eclipse/pde/internal/core/ischema/ISchemaAttribute.java;1;0;2;1;0;0;0;2;0;1;2;3591;0;0;1;0;0;2;2;3591;0;3607;2;1;
/org.eclipse.update.examples/src/org/eclipse/update/examples/buildzip/BuildZipSiteContentProvider.java;2;0;2;1;0;0;0;2;3;1;2;2762;3;3;1;0;0;2;2;2762;0;3027;2;2;
/org.eclipse.swt.examples/src/org/eclipse/swt/examples/texteditor/Images.java;4;0;4;1;1;1;1;3;52;1;3;513;80;80;1;0;0;3;4;513;0;4705;4;4;
/org.eclipse.ui/Eclipse UI Standard Components/org/eclipse/ui/views/properties/FilterAction.java;4;0;4;1;0;0;0;4;7;1;4;257;11;11;1;0;0;4;4;257;0;3029;4;4;
/org.eclipse.swt.tests/JUnit Tests/org/eclipse/swt/tests/junit/Test_org_eclipse_swt_dnd_DragSource.java;2;0;2;1;1;1;1;1;6;0;1;1792;6;6;1;0;0;1;2;1792;0;4706;2;2;
/org.eclipse.swt/Eclipse SWT PI/win32/org/eclipse/swt/internal/win32/SHMENUBARINFO.java;2;0;2;1;1;1;1;1;6;0;1;2723;6;6;1;0;0;1;2;2723;0;4701;2;2;
/org.eclipse.jdt.core/model/org/eclipse/jdt/internal/core/util/MethodInfo.java;2;1;5;1;3;3;3;2;23;0;1;3629;79;79;2;1;0;2;5;3629;1;4422;4;2;
/org.eclipse.ui/Eclipse UI/org/eclipse/ui/internal/misc/WizardStepGroup.java;2;0;7;1;0;0;0;7;73;2;6;3193;197;197;2;1;0;7;7;3193;1;3607;6;2;
/org.eclipse.ui/Eclipse UI/org/eclipse/ui/internal/OpenNewPageAction.java;4;0;4;1;0;0;0;4;11;1;4;257;13;13;1;0;0;4;4;257;0;2247;4;4;
/org.eclipse.compare/compare/org/eclipse/compare/internal/ChangePropertyAction.java;2;0;3;1;0;0;0;3;11;1;3;14;16;16;1;0;0;3;3;14;0;1167;3;2;
/org.eclipse.update.ui/src/org/eclipse/update/internal/ui/manager/InfoLink.java;1;0;4;1;0;0;0;4;9;1;4;2781;10;10;1;0;0;4;4;2781;0;3662;4;1;
/org.eclipse.jdt.ui.tests.refactoring/resources/RenameParameters/canRename/A_test9_in.java;1;0;1;1;0;0;0;1;0;0;1;233;0;0;1;0;0;1;1;233;0;233;1;1;
/org.eclipse.team.cvs.core/src/org/eclipse/team/internal/ccvs/core/client/Update.java;2;0;15;2;1;1;1;14;77;2;12;2572;244;244;2;2;0;14;15;2791;2;4450;13;2;
/org.eclipse.webdav/src/client/org/eclipse/webdav/client/AbstractResourceHandle.java;4;1;12;1;5;5;5;7;3046;1;7;12;5799;5799;1;0;0;7;12;12;0;4520;12;4;
/org.eclipse.jdt.core/codeassist/org/eclipse/jdt/internal/codeassist/RelevanceConstants.java;3;1;2;2;2;2;2;0;15;0;0;3897;19;19;1;0;0;0;2;3897;0;4062;2;3;
/org.eclipse.update.ui/src/org/eclipse/update/internal/ui/search/DefaultUpdatesSearchObject.java;1;0;2;1;0;0;0;2;37;1;2;3572;37;37;1;0;0;2;2;3572;0;3662;2;1;
/org.eclipse.jdt.debug/jdi/org/eclipse/jdi/internal/connect/PacketManager.java;2;0;3;1;0;0;0;3;12;1;3;187;16;16;1;0;0;3;3;187;0;3040;3;2;
/org.eclipse.jdt.debug.tests/test programs/NativeDropTests.java;1;0;2;1;0;0;0;2;0;1;2;3701;0;0;1;0;0;2;2;3701;0;3719;2;1;
/org.eclipse.ui/Eclipse UI/org/eclipse/ui/IPageListener.java;2;0;2;1;0;0;0;2;5;1;2;257;5;5;1;0;0;2;2;257;0;457;2;2;
/org.eclipse.update.ui/src/org/eclipse/update/internal/ui/manager/InstallableSitePage.java;1;0;3;1;0;0;0;3;2;1;3;1900;2;2;1;0;0;3;3;1900;0;3537;3;1;
/org.eclipse.jdt.ui/core refactoring/org/eclipse/jdt/internal/corext/refactoring/RefactoringMatchLocator.java;2;0;2;1;0;0;0;2;0;1;2;1939;0;0;1;0;0;2;2;1939;0;2212;2;2;
/org.eclipse.jdt.ui.tests.refactoring/resources/MoveMembers/testFail10/in/A.java;1;0;1;1;0;0;0;1;0;0;1;2738;0;0;1;0;0;1;1;2738;0;2738;1;1;
/org.eclipse.core.boot/src/org/eclipse/core/internal/boot/LaunchInfo.java;3;0;25;2;0;0;0;25;3478;3;20;12;7883;7883;3;5;0;25;25;120;5;2802;20;3;
/org.eclipse.jdt.ui.tests.refactoring/resources/InlineTemp/cannotInline/A_testFail3.java;1;0;1;1;0;0;0;1;0;0;1;2015;0;0;1;0;0;1;1;2015;0;2015;1;1;
/org.eclipse.ui.tests/Benchmarks/org/eclipse/ui/benchmarks/OpenCloseTest.java;1;0;2;1;0;0;0;2;0;0;1;2978;0;0;2;1;0;2;2;2978;1;2978;1;1;
/org.eclipse.jdt.core/model/org/eclipse/jdt/internal/core/builder/impl/BinaryBrokerOutput.java;1;0;3;1;0;0;0;3;146;1;3;455;146;146;1;0;0;3;3;455;0;2808;3;1;
/org.eclipse.jdt.ui/ui/org/eclipse/jdt/internal/ui/util/OpenTypeHierarchyHelper.java;4;0;7;1;0;0;0;7;65;1;7;421;93;93;1;0;0;7;7;421;0;1310;7;4;
/org.eclipse.jdt.ui/ui/org/eclipse/jdt/internal/ui/snippeteditor/JavaSnippetViewerConfiguration.java;5;0;10;2;0;0;0;10;71;2;9;15;154;154;2;1;0;10;10;1407;1;1916;9;5;
/org.eclipse.jdt.ui.tests.refactoring/resources/RenameVirtualMethodInClass/test30/out/A.java;1;0;1;1;0;0;0;1;0;0;1;49;0;0;1;0;0;1;1;49;0;49;1;1;
/org.eclipse.jdt.ui/ui/org/eclipse/jdt/internal/ui/dnd/TransferDropTargetListener.java;1;0;2;1;0;0;0;2;8;1;2;15;8;8;1;0;0;2;2;15;0;327;2;1;
/org.eclipse.vcm.ui.cvs/src/org/eclipse/vcm/internal/ui/ccvs/WorkbenchCVSPlugin.java;4;0;10;1;0;0;0;10;127;1;10;1;205;205;1;0;0;10;10;1;0;1578;10;4;
/org.eclipse.jdt.ui.tests.refactoring/resources/ExtractMethodWorkSpace/ExtractMethodTests/expression_in/A_test610.java;1;1;3;1;2;2;2;1;0;0;1;1236;0;0;1;0;0;1;3;1236;0;4419;3;1;
/org.eclipse.debug.ui/ui/org/eclipse/debug/internal/ui/actions/AbstractRemoveAllActionDelegate.java;1;0;5;1;0;0;0;5;34;1;5;2919;82;82;1;0;0;5;5;2919;0;3547;5;1;
/org.eclipse.core.resources/src/org/eclipse/core/internal/indexing/IndexNodeFactory.java;3;0;3;1;0;0;0;3;5;1;3;12;5;5;1;0;0;3;3;12;0;448;3;3;
/org.eclipse.jdt.core/model/org/eclipse/jdt/internal/core/newbuilder/SourceFile.java;1;0;4;1;0;0;0;4;16;1;4;1947;24;24;1;0;0;4;4;1947;0;2979;4;1;
/org.eclipse.ui/Eclipse UI/org/eclipse/ui/IMarkerResolution.java;1;0;2;1;0;0;0;2;27;1;2;2497;27;27;1;0;0;2;2;2497;0;2895;2;1;
/org.eclipse.webdav/src/interface/org/eclipse/webdav/dom/Bindings.java;2;0;4;1;1;1;1;3;282;1;3;12;326;326;1;0;0;3;4;12;0;4211;4;2;
/org.eclipse.vcm.ui/src/org/eclipse/vcm/internal/ui/actions/VCMAction.java;4;0;6;1;0;0;0;6;37;1;6;1;59;59;1;0;0;6;6;1;0;531;6;4;
/org.eclipse.jdt.ui/core refactoring/org/eclipse/jdt/internal/core/refactoring/cus/MoveCompilationUnitChange.java;2;0;5;1;0;0;0;5;93;1;5;408;121;121;1;0;0;5;5;408;0;1342;5;2;
/org.eclipse.jdt.ui.tests.refactoring/resources/RenameType/test39/out/B.java;1;0;1;1;0;0;0;1;0;0;1;49;0;0;1;0;0;1;1;49;0;49;1;1;
/org.eclipse.jdt.ui.tests.refactoring/resources/ExtractMethodWorkSpace/ExtractMethodTests/validSelection/A_test240.java;2;1;3;1;2;2;2;1;0;0;1;49;0;0;1;0;0;1;3;49;0;4419;3;2;
/org.eclipse.jdt.launching/launching/org/eclipse/jdt/launching/sourcelookup/ZipEntryStorage.java;1;0;4;1;1;1;1;3;25;2;2;2372;32;32;2;1;0;3;4;2372;1;4198;3;1;
/org.eclipse.jdt.debug.tests/tests/org/eclipse/jdt/debug/tests/core/ExceptionBreakpointTests.java;3;2;8;1;7;5;7;1;60;0;1;3701;151;151;2;0;2;1;8;4296;2;4652;6;3;
/org.eclipse.update.ui/src/org/eclipse/update/internal/ui/model/DiscoveryFolder.java;2;0;2;1;1;1;1;1;14;0;1;3517;14;14;1;0;0;1;2;3517;0;4596;2;2;
/org.eclipse.jdt.core/compiler/org/eclipse/jdt/internal/compiler/env/ISourceType.java;2;0;4;1;1;1;1;3;186;1;3;455;206;206;1;0;0;3;4;455;0;4062;4;2;
/org.eclipse.ui/Eclipse UI/org/eclipse/ui/part/Page.java;3;0;7;1;0;0;0;7;39;2;6;257;59;59;2;1;0;7;7;1816;1;2229;6;3;
/org.eclipse.ant.core/src/org/eclipse/ant/core/XercesRegexpMatcher.java;4;0;7;1;0;0;0;7;176;1;7;14;223;223;1;0;0;7;7;14;0;3489;7;4;
/org.eclipse.help.ui/src/org/eclipse/help/ui/internal/util/SWTUtil.java;1;0;1;1;1;1;1;0;0;0;0;4439;0;0;1;0;0;0;1;4439;0;4439;1;1;
/org.eclipse.swt/Eclipse SWT Drag and Drop/win32/org/eclipse/swt/dnd/ByteArrayTransfer.java;2;1;5;1;3;3;3;2;93;1;2;106;195;195;1;0;0;2;5;106;0;4824;5;2;
/org.eclipse.scripting/Eclipse Scripting/org/eclipse/scripting/internal/IXGRElementEventGeneratorOnLoad.java;1;0;3;1;0;0;0;3;4;1;3;133;4;4;1;0;0;3;3;133;0;1424;3;1;
/org.eclipse.jdt.ui/ui/org/eclipse/jdt/internal/ui/compare/JavaTextViewer.java;3;1;7;1;2;2;2;5;29;1;5;15;50;50;1;0;0;5;7;15;0;4621;7;3;
/org.eclipse.jdt.ui.tests.refactoring/resources/StructureSelectionAction/A_test10.java;1;0;1;1;0;0;0;1;0;0;1;2139;0;0;1;0;0;1;1;2139;0;2139;1;1;
/org.eclipse.ui.tests/Eclipse UI Tests/org/eclipse/ui/tests/navigator/NavigatorTest.java;3;0;5;1;0;0;0;5;56;1;5;1488;62;62;1;0;0;5;5;1488;0;2785;5;3;
/org.eclipse.jdt.ui/ui refactoring/org/eclipse/jdt/internal/ui/refactoring/RefactoringWizardPage.java;2;0;5;1;0;0;0;5;27;1;5;15;37;37;1;0;0;5;5;15;0;1939;5;2;
/org.eclipse.ui/Eclipse UI Text Editor/org/eclipse/ui/editors/text/IEncodingActionsConstants.java;1;1;2;1;2;2;2;0;59;0;0;4138;59;59;1;0;0;0;2;4138;0;4838;2;1;
/org.eclipse.swt/Eclipse SWT/common/org/eclipse/swt/layout/GridLayout.java;5;1;12;2;3;3;3;9;118;2;8;106;351;351;2;1;0;9;12;2881;1;4701;11;5;
/org.eclipse.core.tests.runtime/src/org/eclipse/core/tests/internal/runtimetests/SampleJFB.java;1;0;2;1;0;0;0;2;10;1;2;3611;10;10;1;0;0;2;2;3611;0;3678;2;1;
/org.eclipse.pde.core/src/org/eclipse/pde/internal/core/ifeature/IFeatureChild.java;1;0;1;1;1;1;1;0;0;0;0;3982;0;0;1;0;0;0;1;3982;0;3982;1;1;
/org.eclipse.pde.ui/src/org/eclipse/pde/internal/elements/ElementList.java;2;0;2;1;0;0;0;2;0;1;2;1434;0;0;1;0;0;2;2;1434;0;3579;2;2;
/org.eclipse.ui.externaltools/External Tools/org/eclipse/ui/externaltools/internal/core/ExternalToolsRegistry.java;1;1;3;1;3;3;3;0;34;0;0;4090;39;39;1;0;0;0;3;4090;0;4573;3;1;
/org.eclipse.pde.core/src/org/eclipse/pde/core/plugin/IPluginModel.java;1;0;3;1;2;1;2;1;16;0;1;3591;16;16;2;0;1;1;3;4751;1;4751;2;1;
/org.eclipse.pde.ui/src/org/eclipse/pde/internal/core/build/WorkspaceBuildModel.java;1;0;3;1;0;0;0;3;8;2;2;3579;8;8;2;1;0;3;3;3579;1;3607;2;1;
/org.eclipse.pde.ui/Eclipse PDE UI/org/eclipse/pde/internal/forms/FormWidgetFactory.java;2;0;8;2;0;0;0;8;18;3;6;267;47;47;3;2;0;8;8;324;2;1434;6;2;
/org.eclipse.jdt.ui/core refactoring/org/eclipse/jdt/internal/corext/refactoring/rename/UpdateMethodReferenceEdit.java;1;0;1;1;0;0;0;1;0;0;1;2804;0;0;1;0;0;1;1;2804;0;2804;1;1;
/org.eclipse.core.tests.harness/src/org/eclipse/core/tests/harness/ExampleTest.java;3;0;4;1;1;1;1;3;96;1;3;1794;124;124;1;0;0;3;4;1794;0;4516;4;3;
/org.eclipse.jdt.junit/src/org/eclipse/jdt/internal/junit/ui/JUnitPlugin.java;2;1;12;1;3;3;3;9;67;1;9;3171;234;234;1;0;0;9;12;3171;0;4254;12;2;
/org.eclipse.compare/compare/org/eclipse/compare/contentmergeviewer/IDocumentRange.java;2;0;5;1;1;1;1;4;14;2;3;14;23;23;2;1;0;4;5;3164;1;4820;4;2;
/org.eclipse.ui/Eclipse JFace Text/org/eclipse/jface/text/IInformationControlCreator.java;2;0;2;1;1;1;1;1;25;0;1;1435;25;25;1;0;0;1;2;1435;0;4838;2;2;
/org.eclipse.pde.ui/src/org/eclipse/pde/internal/core/builders/ExtensionPointSchemaBuilder.java;1;0;2;1;0;0;0;2;0;1;2;3579;0;0;1;0;0;2;2;3579;0;3607;2;1;
/org.eclipse.ui/Eclipse UI/org/eclipse/ui/internal/CoolBarContributionItem.java;1;1;8;1;4;4;4;4;481;1;4;3484;755;755;1;0;0;4;8;3484;0;4045;8;1;
/org.eclipse.debug.ui/ui/org/eclipse/debug/internal/ui/actions/RunWithAction.java;2;0;2;1;0;0;0;2;0;1;2;2382;0;0;1;0;0;2;2;2382;0;3634;2;2;
/org.eclipse.jdt.debug/jdi interfaces/com/sun/jdi/ByteValue.java;2;0;2;1;0;0;0;2;6;1;2;2704;6;6;1;0;0;2;2;2704;0;3033;2;2;
/org.eclipse.jdt.debug/jdi/org/eclipse/jdi/internal/FieldImpl.java;2;0;5;1;0;0;0;5;20;1;5;187;50;50;1;0;0;5;5;187;0;3678;5;2;
/org.eclipse.swt.examples.paint/org/eclipse/swt/examples/paint/SegmentedInteractivePaintSession.java;1;0;1;1;0;0;0;1;0;0;1;513;0;0;1;0;0;1;1;513;0;513;1;1;
/org.eclipse.jdt.ui/ui/org/eclipse/jdt/internal/ui/text/javadoc/JavaDocAccess.java;3;0;8;1;0;0;0;8;23;2;7;15;61;61;2;1;0;8;8;25;1;2495;7;3;
/org.eclipse.pde.ui/src/org/eclipse/pde/internal/core/IModelProviderListener.java;1;0;2;1;0;0;0;2;0;1;2;3579;0;0;1;0;0;2;2;3579;0;3607;2;1;
/org.eclipse.jdt.ui.tests.refactoring/resources/SurroundWithWorkSpace/SurroundWithTests/trycatch_in/TestWrappedLocal5.java;1;0;1;1;0;0;0;1;0;0;1;3870;0;0;1;0;0;1;1;3870;0;3870;1;1;
/org.eclipse.jdt.ui/ui/org/eclipse/jdt/internal/ui/javadocexport/JavadocOptionsManager.java;3;1;17;1;4;4;4;13;431;2;11;3171;1119;1119;2;2;0;13;17;3247;2;4621;15;3;
/org.eclipse.pde.ui/Eclipse PDE UI/org/eclipse/pde/internal/editor/manifest/AlertSection.java;2;0;7;2;0;0;0;7;27;3;5;267;40;40;3;2;0;7;7;324;2;1434;5;2;
/org.eclipse.ui.examples.readmetool/Eclipse UI Examples Readme Tool/org/eclipse/ui/examples/readmetool/ReadmePreferencePage.java;3;0;4;1;1;1;1;3;20;1;3;932;23;23;1;0;0;3;4;932;0;4144;4;3;
/org.eclipse.jdt.core/dom/org/eclipse/jdt/core/dom/ASTMatcher.java;2;2;8;1;4;3;4;4;27;1;4;2961;68;68;2;0;1;4;8;3960;1;4058;7;2;
/org.eclipse.jdt.ui.tests.refactoring/resources/SelectionAnalyzerWorkSpace/SelectionAnalyzerTests/validSelection/A_test180_.java;1;0;1;1;0;0;0;1;0;0;1;2139;0;0;1;0;0;1;1;2139;0;2139;1;1;
/org.eclipse.jdt.debug/model/org/eclipse/jdt/internal/debug/core/JDIArrayPartitionValue.java;4;0;15;2;0;0;0;15;46;2;13;187;133;133;2;2;0;15;15;1451;2;2517;13;4;
/org.eclipse.core.boot/src/com/ibm/oti/vm/VM.java;3;0;5;1;1;1;1;4;22;1;4;61;45;45;1;0;0;4;5;61;0;4214;5;3;
/org.eclipse.update.ui/src/org/eclipse/update/ui/internal/model/SiteBookmark.java;1;0;10;1;0;0;0;10;67;1;10;1526;273;273;1;0;0;10;10;1526;0;2797;10;1;
/org.eclipse.jdt.ui.tests.refactoring/resources/RenamePackage/test0/out/p1/A.java;1;0;1;1;0;0;0;1;0;0;1;49;0;0;1;0;0;1;1;49;0;49;1;1;
/org.eclipse.team.cvs.ui/src/org/eclipse/team/internal/ccvs/ui/wizards/LocationWizard.java;1;0;3;1;0;0;0;3;90;1;3;1978;90;90;1;0;0;3;3;1978;0;2577;3;1;
/org.eclipse.ui/Eclipse UI/org/eclipse/ui/internal/registry/PreferencePageRegistryReader.java;5;0;4;2;0;0;0;4;23;1;4;257;33;33;1;0;0;4;4;257;0;1886;4;5;
/org.eclipse.help.ui/src/org/eclipse/help/ui/internal/browser/hpux/NetscapeFactory.java;1;1;2;1;2;2;2;0;2;0;0;4209;2;2;1;0;0;0;2;4209;0;4439;2;1;
/org.eclipse.jdt.ui/ui/org/eclipse/jdt/ui/actions/RenameAction.java;2;1;4;1;4;4;4;0;32;0;0;3970;44;44;1;0;0;0;4;3970;0;4770;4;2;
/org.eclipse.debug.core/core/org/eclipse/debug/core/DebugException.java;2;0;6;1;1;1;1;5;39;2;4;187;57;57;2;1;0;5;6;1724;1;4423;5;2;
/org.eclipse.jdt.ui.tests.refactoring/resources/RenameType/test39/in/A.java;1;0;1;1;0;0;0;1;0;0;1;49;0;0;1;0;0;1;1;49;0;49;1;1;
/org.eclipse.swt.examples/org/eclipse/swt/examples/layoutexample/LayoutExample.java;2;0;4;1;1;1;1;3;25;1;3;3420;27;27;1;0;0;3;4;3420;0;4024;4;2;
/org.eclipse.core.resources/src/org/eclipse/core/internal/resources/WorkspaceRoot.java;4;0;14;1;1;1;1;13;360;2;12;12;561;561;2;1;0;13;14;1394;1;4213;13;4;
/org.eclipse.jdt.ui/core refactoring/org/eclipse/jdt/internal/corext/refactoring/changes/Utils.java;1;0;1;1;0;0;0;1;0;0;1;1939;0;0;1;0;0;1;1;1939;0;1939;1;1;
/org.eclipse.swt/Eclipse SWT/win32/org/eclipse/swt/internal/win32/CHOOSECOLOR.java;2;0;3;1;0;0;0;3;5;1;3;106;5;5;1;0;0;3;3;106;0;2069;3;2;
/org.eclipse.debug.core/core/org/eclipse/debug/core/model/IStackFrame.java;3;0;11;1;1;1;1;10;43;1;10;187;196;196;1;0;0;10;11;187;0;4652;11;3;
/org.eclipse.pde.ui/Eclipse PDE UI/org/eclipse/pde/internal/elements/IPDEElement.java;2;0;5;2;0;0;0;5;12;3;3;267;12;12;3;2;0;5;5;324;2;1434;3;2;
/org.eclipse.jdt.debug/model/org/eclipse/jdt/internal/debug/core/IJavaDebugConstants.java;2;0;5;1;0;0;0;5;42;1;5;1270;77;77;1;0;0;5;5;1270;0;1493;5;2;
/org.eclipse.jdt.ui.tests.refactoring/resources/RenamePrivateField/test2/in/A.java;1;0;1;1;0;0;0;1;0;0;1;1274;0;0;1;0;0;1;1;1274;0;1274;1;1;
/org.eclipse.jdt.ui/ui/org/eclipse/jdt/internal/ui/packageview/ErrorTickManager.java;2;0;11;1;0;0;0;11;69;2;10;15;157;157;2;1;0;11;11;435;1;1004;10;2;
/org.eclipse.jdt.ui.tests.refactoring/resources/RenameType/test31/in/A.java;1;0;1;1;0;0;0;1;0;0;1;49;0;0;1;0;0;1;1;49;0;49;1;1;
/org.eclipse.jdt.ui.tests.refactoring/resources/SelectionAnalyzerWorkSpace/SelectionAnalyzerTests/invalidSelection/A_test062.java;1;0;1;1;0;0;0;1;0;0;1;1368;0;0;1;0;0;1;1;1368;0;1368;1;1;
/org.eclipse.jdt.ui/ui/org/eclipse/jdt/internal/ui/reorg/CopyElementsValidator.java;5;0;7;3;0;0;0;7;25;3;5;15;37;37;3;2;0;7;7;1254;2;1254;5;5;
/org.eclipse.pde.ui/src/org/eclipse/pde/internal/ui/editor/text/PDECommentScanner.java;1;0;2;1;1;1;1;1;2;0;1;3579;2;2;1;0;0;1;2;3579;0;4588;2;1;
/org.eclipse.swt/Eclipse SWT/photon/org/eclipse/swt/internal/photon/OS.java;4;0;11;2;0;0;0;11;108;2;9;106;166;166;2;2;0;11;11;621;2;2069;9;4;
/org.eclipse.swt/Eclipse SWT Drag and Drop/win32/org/eclipse/swt/dnd/TextTransfer.java;2;1;6;1;3;3;3;3;71;1;3;106;167;167;1;0;0;3;6;106;0;4824;6;2;
/org.eclipse.ui/Eclipse UI/org/eclipse/ui/IEditorRegistry.java;2;0;2;1;0;0;0;2;5;1;2;257;5;5;1;0;0;2;2;257;0;457;2;2;
/org.eclipse.jdt.ui.tests.refactoring/resources/ReorderParameters/canReorder/A_test15_in.java;1;0;1;1;0;0;0;1;0;0;1;2296;0;0;1;0;0;1;1;2296;0;2296;1;1;
/org.eclipse.jdt.debug/eval/org/eclipse/jdt/internal/debug/eval/ast/engine/LessOperator.java;1;0;2;1;0;0;0;2;0;1;2;3329;0;0;1;0;0;2;2;3329;0;3421;2;1;
/org.eclipse.ui/Eclipse UI/org/eclipse/ui/internal/registry/IActionSet.java;2;0;2;1;0;0;0;2;8;1;2;257;8;8;1;0;0;2;2;257;0;457;2;2;
/org.eclipse.jdt.ui.tests.refactoring/resources/ExtractMethodWorkSpace/ExtractMethodTests/T10031.java;1;1;3;1;2;2;2;1;0;0;1;3168;0;0;1;0;0;1;3;3168;0;4419;3;1;
/org.eclipse.vcm.core.cvs/src/org/eclipse/vcm/internal/core/ccvs/utils/PathComparator.java;2;0;2;1;0;0;0;2;9;1;2;0;9;9;1;0;0;2;2;0;0;298;2;2;
/org.eclipse.jdt.ui/core extension/org/eclipse/jdt/internal/corext/codegeneration/AddJavaDocStubOperation.java;2;0;4;1;0;0;0;4;6;2;2;2016;9;9;2;2;0;4;4;2016;2;2133;2;2;
/org.eclipse.jdt.core/search/org/eclipse/jdt/internal/core/index/impl/SafeRandomAccessFile.java;2;0;3;1;1;1;1;2;17;1;2;455;26;26;1;0;0;2;3;455;0;4063;3;2;
/org.eclipse.swt/Eclipse SWT/photon/org/eclipse/swt/internal/photon/FontQueryInfo.java;2;0;3;1;0;0;0;3;4;1;3;106;4;4;1;0;0;3;3;106;0;2069;3;2;
/org.eclipse.swt/Eclipse SWT/win32/org/eclipse/swt/widgets/TabFolder.java;9;2;21;2;3;2;3;18;73;3;14;106;414;414;3;4;1;18;21;1696;5;4701;16;9;
/org.eclipse.debug.core/core/org/eclipse/debug/internal/core/BreakpointFactory.java;2;0;3;1;0;0;0;3;78;1;3;831;78;78;1;0;0;3;3;831;0;1118;3;2;
/org.eclipse.swt/Eclipse SWT Custom Widgets/common_j2se/org/eclipse/swt/custom/LineStyleEvent.java;1;0;1;1;0;0;0;1;0;0;1;1378;0;0;1;0;0;1;1;1378;0;1378;1;1;
/org.eclipse.search/search/org/eclipse/search/internal/ui/util/StringMatcher.java;2;0;7;1;0;0;0;7;264;1;7;15;415;415;1;0;0;7;7;15;0;2935;7;2;
/org.eclipse.jdt.ui.tests.refactoring/resources/ExtractMethodWorkSpace/ExtractMethodTests/locals_out/A_test559.java;1;1;5;1;2;2;2;3;34;1;3;1236;41;41;1;0;0;3;5;1236;0;4419;5;1;
/org.eclipse.core.resources/src/org/eclipse/core/internal/watson/DeltaIterator.java;1;0;4;1;1;1;1;3;300;1;3;12;321;321;1;0;0;3;4;12;0;4214;4;1;
/org.eclipse.jdt.debug.ui/ui/org/eclipse/jdt/internal/debug/ui/actions/AddExternalJarAction.java;1;0;1;1;1;1;1;0;0;0;0;3905;0;0;1;0;0;0;1;3905;0;3905;1;1;
/org.eclipse.swt/Eclipse SWT/win32/org/eclipse/swt/graphics/Region.java;5;1;7;1;2;2;2;5;47;1;5;106;73;73;1;0;0;5;7;106;0;4701;7;5;
/org.eclipse.pde.ui/src/org/eclipse/pde/internal/ui/editor/text/PDETagScanner.java;1;0;2;1;1;1;1;1;2;0;1;3579;2;2;1;0;0;1;2;3579;0;4588;2;1;
/org.eclipse.swt/Eclipse SWT/common_j2me/org/eclipse/swt/internal/CloneableCompatability.java;1;0;1;1;0;0;0;1;0;0;1;1386;0;0;1;0;0;1;1;1386;0;1386;1;1;
/org.eclipse.jdt.ui.tests.refactoring/resources/MoveMembers/test1/out/B.java;1;0;1;1;0;0;0;1;0;0;1;2738;0;0;1;0;0;1;1;2738;0;2738;1;1;
/org.eclipse.ui/Eclipse UI/org/eclipse/ui/internal/EditorWorkbook.java;6;2;37;2;6;5;6;31;86;2;27;257;477;477;2;4;1;31;37;1828;5;4367;32;6;
/org.eclipse.jdt.debug/eval/org/eclipse/jdt/internal/debug/eval/ast/EvaluationClassType.java;1;0;3;1;0;0;0;3;228;1;3;3329;228;228;1;0;0;3;3;3329;0;3421;3;1;
/org.eclipse.swt/Eclipse SWT/motif/org/eclipse/swt/internal/motif/XmDragProcCallback.java;2;0;3;1;0;0;0;3;4;1;3;106;4;4;1;0;0;3;3;106;0;2069;3;2;
/org.eclipse.ui/Eclipse UI/org/eclipse/ui/internal/misc/AssertionFailedException.java;2;0;2;1;0;0;0;2;5;1;2;257;5;5;1;0;0;2;2;257;0;457;2;2;
/org.eclipse.swt.examples.ole.win32/org/eclipse/swt/examples/ole/win32/OleWebBrowser.java;3;0;3;1;1;1;1;2;251;1;2;513;251;251;1;0;0;2;3;513;0;4024;3;3;
/org.eclipse.jdt.debug.tests/tests/org/eclipse/jdt/debug/tests/eval/NestedTypeFieldValue_679.java;2;1;3;1;3;3;3;0;12;0;0;4447;14;14;1;0;0;0;3;4447;0;4571;3;2;
/org.eclipse.jdt.ui.tests.refactoring/resources/ExtractTemp/canExtract/A_test17_in.java;1;0;1;1;0;0;0;1;0;0;1;2481;0;0;1;0;0;1;1;2481;0;2481;1;1;
/org.eclipse.swt.examples.paint/org/eclipse/swt/examples/paint/DragPaintSession.java;3;0;4;2;1;1;1;3;137;2;2;586;137;137;2;1;0;3;4;609;1;4024;3;3;
/org.eclipse.jdt.ui.tests.refactoring/resources/RenameType/test46/out/B.java;2;0;2;1;0;0;0;2;2;1;2;522;2;2;1;0;0;2;2;522;0;1297;2;2;
/org.eclipse.jdt.ui/ui/org/eclipse/jdt/internal/ui/javaeditor/BreakpointRulerAction.java;6;0;21;1;0;0;0;21;62;1;21;15;300;300;1;0;0;21;21;15;0;3568;21;6;
/org.eclipse.pde.ui/src/org/eclipse/pde/internal/core/plugin/PluginObject.java;1;0;3;1;0;0;0;3;14;2;2;3579;14;14;2;1;0;3;3;3579;1;3607;2;1;
/org.eclipse.jdt.ui.tests.refactoring/resources/ExtractTemp/cannotExtract/A_testFail14.java;1;0;1;1;0;0;0;1;0;0;1;2873;0;0;1;0;0;1;1;2873;0;2873;1;1;
/org.eclipse.swt.examples.launcher/org/eclipse/swt/examples/launcher/ProgramLaunchDelegate.java;3;0;4;1;0;0;0;4;79;1;4;513;83;83;1;0;0;4;4;513;0;3690;4;3;
/org.eclipse.ui/Eclipse UI/org/eclipse/ui/internal/model/WorkbenchStatus.java;2;0;2;1;0;0;0;2;4;1;2;257;4;4;1;0;0;2;2;257;0;457;2;2;
/org.eclipse.update/src/org/eclipse/update/internal/core/UMSessionManagerEntry.java;1;0;1;1;0;0;0;1;0;0;1;1424;0;0;1;0;0;1;1;1424;0;1424;1;1;
/org.eclipse.jdt.ui.tests.refactoring/resources/RenameTemp/canRename/A_in.java;1;0;1;1;0;0;0;1;0;0;1;1625;0;0;1;0;0;1;1;1625;0;1625;1;1;
/org.eclipse.jdt.ui/ui refactoring/org/eclipse/jdt/internal/ui/refactoring/actions/RenameParametersActionDelegate.java;3;0;5;1;0;0;0;5;2;1;5;1359;4;4;1;0;0;5;5;1359;0;2630;5;3;
/org.eclipse.jdt.ui/ui/org/eclipse/jdt/ui/actions/ShowInPackageViewAction.java;4;2;18;1;11;10;11;7;81;2;6;3533;254;254;2;1;1;7;18;3641;2;4770;16;4;
/org.eclipse.jdt.ui.tests.refactoring/resources/ExtractTemp/canExtract/A_test36_in.java;1;0;1;1;0;0;0;1;0;0;1;3355;0;0;1;0;0;1;1;3355;0;3355;1;1;
/org.eclipse.jdt.debug.ui/ui/org/eclipse/jdt/internal/debug/ui/actions/EntryToggleAction.java;2;0;2;1;0;0;0;2;1;1;2;2646;1;1;1;0;0;2;2;2646;0;2844;2;2;
/org.eclipse.jdt.debug.tests/tests/org/eclipse/jdt/debug/tests/core/ProcessTests.java;3;1;4;1;4;4;4;0;21;0;0;4186;30;30;1;0;0;0;4;4186;0;4571;4;3;
/org.eclipse.core.resources/src/org/eclipse/core/internal/indexing/LogWriter.java;3;1;7;1;2;2;2;5;158;1;5;12;288;288;1;0;0;5;7;12;0;4632;7;3;
/org.eclipse.swt/Eclipse SWT PI/gtk/org/eclipse/swt/internal/gtk/GtkRequisition.java;2;0;5;1;2;1;2;3;7;1;3;2107;17;17;2;0;1;3;5;4701;1;4701;4;2;
/org.eclipse.scripting/src/org/eclipse/scripting/internal/views/ScriptUIEditorModelElement.java;1;0;1;1;0;0;0;1;0;0;1;1424;0;0;1;0;0;1;1;1424;0;1424;1;1;
/org.eclipse.jdt.ui.examples.projects/examples/org/eclipse/jdt/internal/ui/exampleprojects/ExampleProjectCreationWizardPage.java;2;0;2;1;1;1;1;1;16;0;1;2085;16;16;1;0;0;1;2;2085;0;4440;2;2;
/org.eclipse.jdt.ui.tests.refactoring/resources/RenameVirtualMethodInClass/test14/in/A.java;1;0;1;1;0;0;0;1;0;0;1;49;0;0;1;0;0;1;1;49;0;49;1;1;
/org.eclipse.ui/Eclipse UI Text Editor/org/eclipse/ui/texteditor/MarkAction.java;1;2;3;1;3;2;3;0;11;0;0;4209;18;18;2;0;1;0;3;4209;1;4838;2;1;
/org.eclipse.jdt.ui.tests.refactoring/resources/MoveMembers/test20/out/A.java;1;0;1;1;0;0;0;1;0;0;1;2738;0;0;1;0;0;1;1;2738;0;2738;1;1;
/org.eclipse.scripting/Eclipse Scripting/org/eclipse/scripting/internal/views/ScriptUIEditorTreeViewerDragAdapter.java;2;0;4;1;0;0;0;4;13;1;4;133;17;17;1;0;0;4;4;133;0;1424;4;2;
/org.eclipse.core.tests.runtime/src/org/eclipse/core/tests/internal/plugins/SoftPrereqTest_15.java;3;0;3;1;0;0;0;3;110;1;3;1794;120;120;1;0;0;3;3;1794;0;3476;3;3;
/org.eclipse.jdt.ui.tests.refactoring/resources/DeleteSourceReference/A_testField1_out.java;1;0;2;1;0;0;0;2;0;1;2;2003;0;0;1;0;0;2;2;2003;0;2857;2;1;
/org.eclipse.jdt.core/model/org/eclipse/jdt/core/ClasspathContainerResolver.java;1;0;4;1;0;0;0;4;3;2;3;3771;5;5;2;1;0;4;4;3771;1;3850;3;1;
/org.eclipse.pde.ui/Eclipse PDE UI/org/eclipse/pde/internal/wizards/WizardCollectionSorter.java;2;0;5;2;0;0;0;5;12;3;3;267;12;12;3;2;0;5;5;324;2;1434;3;2;
/org.eclipse.swt/Eclipse SWT/photon/org/eclipse/swt/internal/photon/PhPoint_t.java;2;0;3;1;0;0;0;3;6;1;3;106;6;6;1;0;0;3;3;106;0;2069;3;2;
/org.eclipse.pde.ui/src/org/eclipse/pde/internal/base/model/plugin/IJarsModel.java;2;0;2;1;0;0;0;2;0;1;2;1434;0;0;1;0;0;2;2;1434;0;2691;2;2;
/org.eclipse.swt/Eclipse SWT PI/win32/org/eclipse/swt/internal/ole/win32/IEnumVARIANT.java;2;1;2;1;2;2;2;0;6;0;0;4430;6;6;1;0;0;0;2;4430;0;4701;2;2;
/org.eclipse.jdt.debug.tests/tests/org/eclipse/jdt/debug/tests/eval/DoubleAssignmentOperatorsTests.java;2;2;3;2;3;2;3;0;18;0;0;4447;20;20;2;0;1;0;3;4447;1;4571;2;2;
/org.eclipse.ant.ui/src/org/eclipse/ant/internal/ui/toolscripts/AbstractToolScriptWizard.java;1;0;3;1;0;0;0;3;7;2;2;2933;7;7;2;1;0;3;3;2933;1;2979;2;1;
/org.eclipse.jdt.ui.tests.refactoring/resources/MoveMembers/test16/in/A.java;1;0;1;1;0;0;0;1;0;0;1;2738;0;0;1;0;0;1;1;2738;0;2738;1;1;
/org.eclipse.core.runtime/src/org/eclipse/core/internal/plugins/Library.java;3;0;5;1;1;1;1;4;50;1;4;12;73;73;1;0;0;4;5;12;0;4213;5;3;
/org.eclipse.jdt.ui.tests/examples/org/eclipse/jdt/ui/examples/TestMainMethodFinderAction.java;3;0;4;1;0;0;0;4;30;1;4;1290;36;36;1;0;0;4;4;1290;0;2439;4;3;
/org.eclipse.debug.ui/ui/org/eclipse/debug/internal/ui/CopyToClipboardActionDelegate.java;3;0;17;2;0;0;0;17;100;3;15;187;325;325;3;2;0;17;17;888;2;2382;15;3;
/org.eclipse.jdt.ui/ui/org/eclipse/jdt/internal/ui/search/FindHierarchyReferencesAction.java;3;0;4;3;0;0;0;4;39;2;3;1371;39;39;2;1;0;4;4;1707;1;1707;3;3;
/org.eclipse.scripting/src/org/eclipse/scripting/internal/IXGRElementUIChecked.java;1;0;1;1;0;0;0;1;0;0;1;1424;0;0;1;0;0;1;1;1424;0;1424;1;1;
/org.eclipse.debug.ui/ui/org/eclipse/debug/internal/ui/preferences/LaunchHistoryPreferencePage.java;2;2;6;1;6;5;6;0;13;0;0;3975;29;29;2;0;1;0;6;4164;1;4207;5;2;
/org.eclipse.ui.tests/Eclipse JFace Tests/org/eclipse/jface/tests/viewers/interactive/DeleteAction.java;1;0;1;1;0;0;0;1;0;0;1;1488;0;0;1;0;0;1;1;1488;0;1488;1;1;
/org.eclipse.jdt.ui/nls/org/eclipse/jdt/internal/ui/nls/OrderedMap.java;1;0;2;1;0;0;0;2;0;1;2;1880;0;0;1;0;0;2;2;1880;0;1913;2;1;
/org.eclipse.jdt.ui/ui/org/eclipse/jdt/internal/ui/jarexporter/ZipFileExportOperation.java;1;0;2;1;0;0;0;2;0;1;2;15;0;0;1;0;0;2;2;15;0;239;2;1;
/org.eclipse.jdt.ui/ui/org/eclipse/jdt/internal/ui/jarexporter/Base64Encoder.java;1;0;2;1;0;0;0;2;0;1;2;15;0;0;1;0;0;2;2;15;0;239;2;1;
/org.eclipse.ui/Eclipse UI Text Editor/org/eclipse/ui/editors/text/ITextEditorHelpContextIds.java;3;0;3;1;1;1;1;2;33;1;2;620;39;39;1;0;0;2;3;620;0;4838;3;3;
/org.eclipse.update.ui/src/org/eclipse/update/internal/ui/manager/UnknownObjectForm.java;1;0;3;1;0;0;0;3;14;1;3;2827;14;14;1;0;0;3;3;2827;0;3662;3;1;
/org.eclipse.swt/Eclipse SWT Custom Widgets/common_j2se/org/eclipse/swt/custom/ST.java;1;0;1;1;0;0;0;1;0;0;1;1378;0;0;1;0;0;1;1;1378;0;1378;1;1;
/org.eclipse.jdt.core/search/org/eclipse/jdt/internal/core/index/impl/Block.java;2;0;3;1;1;1;1;2;17;1;2;455;26;26;1;0;0;2;3;455;0;4063;3;2;
/org.eclipse.core.tests.resources/src/org/eclipse/core/tests/internal/builders/BuilderTest.java;3;1;6;1;3;3;3;3;1024;1;3;1794;1120;1120;1;0;0;3;6;1794;0;4516;6;3;
/org.eclipse.jdt.ui.tests.refactoring/resources/DeleteSourceReference/test9/in/A.java;1;0;1;1;0;0;0;1;0;0;1;2857;0;0;1;0;0;1;1;2857;0;2857;1;1;
/org.eclipse.ui/Eclipse JFace Text/org/eclipse/jface/text/IDocumentAdapter.java;3;0;3;1;0;0;0;3;12;1;3;257;17;17;1;0;0;3;3;257;0;1066;3;3;
/org.eclipse.core.tests.runtime/src/org/eclipse/core/tests/internal/plugins/FragmentResolveTest_13.java;2;0;2;1;0;0;0;2;10;1;2;3168;10;10;1;0;0;2;2;3168;0;3476;2;2;
/org.eclipse.team.tests.cvs.core/src/org/eclipse/team/tests/ccvs/ui/Waiter.java;1;0;1;1;0;0;0;1;0;0;1;2977;0;0;1;0;0;1;1;2977;0;2977;1;1;
/org.eclipse.pde.ui/src/org/eclipse/pde/internal/wizards/imports/PluginImportWizard.java;1;0;15;1;0;0;0;15;90;2;14;2522;255;255;2;1;0;15;15;3444;1;3579;14;1;
/org.eclipse.team.cvs.ui/src/org/eclipse/team/internal/ccvs/ui/actions/ConfigureTagsFromRepoViewOnFolder.java;2;0;5;1;1;1;1;4;92;1;4;3549;113;113;1;0;0;4;5;3549;0;4021;5;2;
/org.eclipse.swt.examples/org/eclipse/swt/examples/controlexample/SashTab.java;4;1;5;1;2;2;2;3;260;1;3;513;417;417;1;0;0;3;5;513;0;4024;5;4;
/org.eclipse.team.cvs.ui/src/org/eclipse/team/internal/ccvs/ui/UserValidationDialog.java;2;0;4;1;1;1;1;3;372;1;3;1978;384;384;1;0;0;3;4;1978;0;4165;4;2;
/org.eclipse.ui/Eclipse UI Standard Components/org/eclipse/ui/views/navigator/GotoActionFactory.java;2;0;8;1;1;1;1;7;10;2;5;1830;24;24;2;2;0;7;8;1830;2;4067;6;2;
/org.eclipse.jdt.core/compiler/org/eclipse/jdt/internal/compiler/parser/SourceConstructorDeclaration.java;2;0;3;1;1;1;1;2;18;1;2;455;23;23;1;0;0;2;3;455;0;4062;3;2;
/org.eclipse.ui/Eclipse UI Standard Components/org/eclipse/ui/views/framelist/FrameAction.java;1;0;1;1;0;0;0;1;0;0;1;3498;0;0;1;0;0;1;1;3498;0;3498;1;1;
/org.eclipse.jdt.core/model/org/eclipse/jdt/internal/core/newbuilder/ReferenceCollection.java;1;0;11;1;0;0;0;11;219;2;9;1764;426;426;2;2;0;11;11;1886;2;2979;9;1;
/org.eclipse.ui/Eclipse UI Text Editor/org/eclipse/ui/texteditor/ShiftAction.java;1;1;4;1;4;4;4;0;108;0;0;3956;146;146;1;0;0;0;4;3956;0;4838;4;1;
/org.eclipse.swt/Eclipse SWT Program/gtk/org/eclipse/swt/program/Program.java;3;1;3;1;2;2;2;1;6;0;1;2107;8;8;1;0;0;1;3;2107;0;4701;3;3;
/org.eclipse.jdt.launching/launching/org/eclipse/jdt/launching/StandardClasspathProvider.java;1;1;2;1;2;2;2;0;3;0;0;4168;3;3;1;0;0;0;2;4168;0;4651;2;1;
/org.eclipse.pde.ui/src/org/eclipse/pde/internal/component/NewComponentProjectWizard.java;2;0;4;1;0;0;0;4;5;1;4;1434;7;7;1;0;0;4;4;1434;0;2951;4;2;
/org.eclipse.jdt.debug.ui/ui/org/eclipse/jdt/internal/debug/ui/Timer.java;2;0;5;1;0;0;0;5;8;1;5;1915;20;20;1;0;0;5;5;1915;0;3557;5;2;
/org.eclipse.jdt.ui/core extension/org/eclipse/jdt/internal/corext/codemanipulation/AddGetterSetterOperation.java;4;1;7;1;4;4;4;3;215;1;3;2137;345;345;1;0;0;3;7;2137;0;4379;7;4;
/org.eclipse.scripting/Eclipse Scripting/org/eclipse/scripting/IScriptPreferencePage.java;2;0;4;1;0;0;0;4;10;1;4;133;17;17;1;0;0;4;4;133;0;1424;4;2;
/org.eclipse.jdt.ui.tests.refactoring/resources/RenameType/testFail23/in/B.java;1;0;1;1;0;0;0;1;0;0;1;49;0;0;1;0;0;1;1;49;0;49;1;1;
/org.eclipse.jdt.ui.tests.refactoring/resources/PullUpMethods/testFail11/in/A.java;1;0;2;1;0;0;0;2;0;1;2;2156;0;0;1;0;0;2;2;2156;0;2406;2;1;
/org.eclipse.jdt.ui/core refactoring/org/eclipse/jdt/internal/core/refactoring/ExtendedBuffer.java;2;0;6;1;0;0;0;6;184;2;5;25;217;217;2;1;0;6;6;25;1;1939;5;2;
/org.eclipse.jdt.ui.tests.refactoring/resources/DeleteSourceReference/test8/out/A.java;1;0;1;1;0;0;0;1;0;0;1;2857;0;0;1;0;0;1;1;2857;0;2857;1;1;
/org.eclipse.swt/Eclipse SWT/motif/org/eclipse/swt/graphics/Region.java;5;1;7;1;3;3;3;4;193;1;4;106;282;282;1;0;0;4;7;106;0;4701;7;5;
/org.eclipse.swt/Eclipse SWT PI/win32/org/eclipse/swt/internal/ole/win32/IOleControl.java;2;0;2;1;1;1;1;1;6;0;1;2069;6;6;1;0;0;1;2;2069;0;4701;2;2;
/org.eclipse.ui/Eclipse UI Standard Components/org/eclipse/ui/views/properties/PropertySheet.java;4;0;6;1;0;0;0;6;9;1;6;257;28;28;1;0;0;6;6;257;0;3029;6;4;
/org.eclipse.pde.ui/src/org/eclipse/pde/internal/ui/wizards/imports/UpdateClasspathAction.java;1;1;4;1;2;2;2;2;3;1;2;3579;8;8;1;0;0;2;4;3579;0;4238;4;1;
/org.eclipse.jdt.ui/ui/org/eclipse/jdt/internal/ui/javaeditor/IProblemAnnotation.java;1;1;4;1;2;2;2;2;18;1;2;3418;35;35;1;0;0;2;4;3418;0;4182;4;1;
/org.eclipse.help.ui/src/org/eclipse/help/ui/internal/browser/linux/MozillaBrowserAdapter.java;2;0;3;1;1;1;1;2;17;1;2;2429;21;21;1;0;0;2;3;2429;0;4439;3;2;
/org.eclipse.jdt.ui.tests.refactoring/resources/InlineTemp/canInline/A_test0_in.java;1;0;1;1;0;0;0;1;0;0;1;2015;0;0;1;0;0;1;1;2015;0;2015;1;1;
/org.eclipse.jdt.ui/ui/org/eclipse/jdt/internal/ui/search/FindDeclarationsInWorkingSetAction.java;1;2;11;1;4;3;4;7;54;2;6;1707;159;159;2;1;1;7;11;1717;2;4140;9;1;
/org.eclipse.core.boot/src/org/eclipse/core/internal/boot/update/XmlLiteStore.java;5;0;9;3;0;0;0;9;69;4;6;12;129;129;4;3;0;9;9;323;3;2726;6;5;
/org.eclipse.jdt.ui.tests.refactoring/resources/RenameTemp/canRename/A_test43_in.java;1;0;1;1;0;0;0;1;0;0;1;3322;0;0;1;0;0;1;1;3322;0;3322;1;1;
/org.eclipse.pde.ui/src/org/eclipse/pde/internal/editor/feature/PortabilityChoiceCellEditor.java;1;0;4;1;0;0;0;4;5;1;4;2953;7;7;1;0;0;4;4;2953;0;3579;4;1;
/org.eclipse.swt/Eclipse SWT OLE Win32/win32/org/eclipse/swt/internal/ole/win32/ISpecifyPropertyPages.java;2;0;3;1;0;0;0;3;5;1;3;106;5;5;1;0;0;3;3;106;0;2069;3;2;
/org.eclipse.ui/Eclipse UI/org/eclipse/ui/internal/ClosePerspectiveAction.java;1;0;1;1;0;0;0;1;0;0;1;3103;0;0;1;0;0;1;1;3103;0;3103;1;1;
/org.eclipse.jdt.ui.tests.refactoring/resources/ExtractMethodWorkSpace/ExtractMethodTests/invalidSelection/A_test021.java;2;1;3;1;2;2;2;1;0;0;1;49;0;0;1;0;0;1;3;49;0;4419;3;2;
/org.eclipse.ui/Eclipse JFace Text/org/eclipse/jface/text/IWidgetTokenOwner.java;1;1;3;1;2;2;2;1;23;0;1;2416;29;29;1;0;0;1;3;2416;0;4838;3;1;
/org.eclipse.jdt.ui/ui/org/eclipse/jdt/internal/ui/actions/OverrideMethodQuery.java;6;2;13;1;7;6;7;6;79;2;5;2246;173;173;2;1;1;6;13;2585;2;4630;11;6;
/org.eclipse.pde.ui/Eclipse PDE UI/org/eclipse/pde/internal/editor/manifest/RequiresSection.java;2;0;6;2;0;0;0;6;12;3;4;267;13;13;3;2;0;6;6;324;2;1434;4;2;
/org.eclipse.jdt.debug/eval/org/eclipse/jdt/internal/debug/eval/model/EvaluationType.java;2;0;3;1;0;0;0;3;1;1;3;3421;1;1;1;0;0;3;3;3421;0;3645;3;2;
/org.eclipse.vcm.core.cvs/src/org/eclipse/vcm/internal/core/ccvs/base/IConnectionMethod.java;3;0;3;1;0;0;0;3;6;1;3;168;11;11;1;0;0;3;3;168;0;1191;3;3;
/org.eclipse.jdt.core/codeassist/org/eclipse/jdt/internal/codeassist/select/SelectionScanner.java;2;0;10;1;1;1;1;9;72;4;6;455;136;136;4;3;0;9;10;1039;3;4062;7;2;
/org.eclipse.jdt.debug/jdi/org/eclipse/jdi/internal/event/ExceptionEventImpl.java;2;0;4;1;0;0;0;4;20;1;4;187;34;34;1;0;0;4;4;187;0;3670;4;2;
/org.eclipse.pde.ui/src/org/eclipse/pde/internal/model/plugin/ExternalPluginModelBase.java;1;0;3;1;0;0;0;3;141;1;3;3136;141;141;1;0;0;3;3;3136;0;3579;3;1;
/org.eclipse.team.cvs.ui/src/org/eclipse/team/internal/ccvs/ui/CVSPerspective.java;2;0;3;1;1;1;1;2;50;1;2;3537;58;58;1;0;0;2;3;3537;0;3960;3;2;
/org.eclipse.swt/Eclipse SWT Drag and Drop/gtk/org/eclipse/swt/dnd/ClipboardProxy.java;1;1;3;1;3;3;3;0;6;0;0;4381;11;11;1;0;0;0;3;4381;0;4701;3;1;
/org.eclipse.jdt.debug.tests/testprograms/InstanceVariablesTests.java;2;0;2;1;1;1;1;1;11;0;1;3719;11;11;1;0;0;1;2;3719;0;4571;2;2;
/org.eclipse.team.cvs.ui/src/org/eclipse/team/internal/ccvs/ui/ExtMethodPreferencePage.java;3;1;7;1;2;2;2;5;20;1;5;2956;39;39;1;0;0;5;7;2956;0;4829;7;3;
/org.eclipse.pde.ui/src/org/eclipse/pde/core/plugin/IPluginObject.java;1;0;2;1;0;0;0;2;0;1;2;3579;0;0;1;0;0;2;2;3579;0;3607;2;1;
/org.eclipse.pde.ui/src/org/eclipse/pde/internal/ui/editor/manifest/ManifestSourcePage.java;1;0;1;1;0;0;0;1;0;0;1;3579;0;0;1;0;0;1;1;3579;0;3579;1;1;
/org.eclipse.jdt.ui/ui/org/eclipse/jdt/internal/ui/viewsupport/JavaTextLabelProvider.java;4;0;11;1;0;0;0;11;44;1;11;15;130;130;1;0;0;11;11;15;0;2151;11;4;
/org.eclipse.core.tests.resources/src/org/eclipse/core/tests/resources/IResourceChangeEventTest.java;3;0;3;1;1;1;1;2;440;1;2;1794;450;450;1;0;0;2;3;1794;0;4516;3;3;
/org.eclipse.ui/Eclipse UI Tool Script/org/eclipse/toolscript/core/internal/ProgramScriptRunner.java;1;2;5;1;5;4;5;0;17;0;0;3920;23;23;2;0;1;0;5;4060;1;4087;4;1;
/org.eclipse.jdt.junit/Eclipse JUnit/org/eclipse/jdt/internal/junit/ui/TestSearchEngine.java;2;0;4;1;0;0;0;4;218;1;4;2007;220;220;1;0;0;4;4;2007;0;3313;4;2;
/org.eclipse.update.ui/src/org/eclipse/update/internal/ui/search/ISearchQuery.java;1;1;5;1;2;2;2;3;19;1;3;3537;35;35;1;0;0;3;5;3537;0;4435;5;1;
/org.eclipse.ant.core/src/org/eclipse/ant/core/RefreshLocal.java;5;0;8;1;0;0;0;8;284;1;8;14;514;514;1;0;0;8;8;14;0;3489;8;5;
/org.eclipse.jdt.core/search/org/eclipse/jdt/internal/core/search/indexing/ReadWriteMonitor.java;3;0;6;1;1;1;1;5;82;1;5;455;123;123;1;0;0;5;6;455;0;4063;6;3;
/org.eclipse.jdt.debug.ui/ui/org/eclipse/jdt/internal/debug/ui/actions/AddProjectAction.java;1;1;4;1;3;3;3;1;2;0;1;3875;5;5;1;0;0;1;4;3875;0;4432;4;1;
/org.eclipse.scripting/Eclipse Scripting/org/eclipse/scripting/internal/views/ScriptUIEditorJavaDocCompletionProcessor.java;2;0;4;1;0;0;0;4;7;1;4;133;9;9;1;0;0;4;4;133;0;1424;4;2;
/org.eclipse.jdt.ui.tests.refactoring/resources/ExtractMethodWorkSpace/ExtractMethodTests/locals_out/A_test564.java;1;1;4;1;2;2;2;2;36;1;2;2580;38;38;1;0;0;2;4;2580;0;4419;4;1;
/org.eclipse.pde.ui/src/org/eclipse/pde/internal/elements/DefaultElement.java;2;0;2;1;0;0;0;2;0;1;2;1434;0;0;1;0;0;2;2;1434;0;3579;2;2;
/org.eclipse.pde.ui/src/org/eclipse/pde/internal/ui/editor/build/VariableSelectionDialog.java;1;0;2;1;1;1;1;1;7;0;1;3579;7;7;1;0;0;1;2;3579;0;4780;2;1;
/org.eclipse.jdt.ui.tests.refactoring/resources/MoveMembers/testFail9/in/A.java;1;0;1;1;0;0;0;1;0;0;1;2738;0;0;1;0;0;1;1;2738;0;2738;1;1;
/org.eclipse.jdt.debug.ui/ui/org/eclipse/jdt/internal/debug/ui/snippeteditor/SnippetMessages.java;1;0;1;1;0;0;0;1;0;0;1;1915;0;0;1;0;0;1;1;1915;0;1915;1;1;
/org.eclipse.jdt.ui.tests.refactoring/resources/RenameParameters/cannotRename/A_testFail0.java;1;0;1;1;0;0;0;1;0;0;1;233;0;0;1;0;0;1;1;233;0;233;1;1;
/org.eclipse.jdt.ui/ui/org/eclipse/jdt/ui/actions/OpenEditorActionGroup.java;2;1;9;1;7;7;7;2;11;1;2;3716;43;43;1;0;0;2;9;3716;0;4770;9;2;
/org.eclipse.jdt.ui.tests.refactoring/resources/ExtractMethodWorkSpace/ExtractMethodTests/branch_in/A_test754.java;1;1;3;1;2;2;2;1;26;0;1;1851;26;26;1;0;0;1;3;1851;0;4419;3;1;
/org.eclipse.scripting/src/org/eclipse/scripting/internal/views/ScriptUIEditorModelAttribute.java;1;0;1;1;0;0;0;1;0;0;1;1424;0;0;1;0;0;1;1;1424;0;1424;1;1;
/org.eclipse.swt/Eclipse SWT/gtk1x/org/eclipse/swt/widgets/TableItem.java;3;0;5;1;1;1;1;4;83;1;4;2107;153;153;1;0;0;4;5;2107;0;4701;5;3;
/org.eclipse.pde.ui/src/org/eclipse/pde/internal/preferences/StringFieldEditorWithSpace.java;2;0;2;1;0;0;0;2;0;1;2;1434;0;0;1;0;0;2;2;1434;0;3579;2;2;
/org.eclipse.pde.core/src/org/eclipse/pde/internal/core/plugin/PluginExtension.java;1;0;2;1;0;0;0;2;6;1;2;3591;6;6;1;0;0;2;2;3591;0;3607;2;1;
/org.eclipse.jdt.ui/ui/org/eclipse/jdt/internal/ui/compare/JavaStructureDiffViewer.java;1;0;2;1;0;0;0;2;38;1;2;2717;38;38;1;0;0;2;2;2717;0;2960;2;1;
/org.eclipse.jdt.debug.tests/tests/org/eclipse/jdt/debug/tests/eval/NestedTypeFieldValue_495.java;2;1;3;1;3;3;3;0;12;0;0;4447;14;14;1;0;0;0;3;4447;0;4571;3;2;
/org.eclipse.core.boot/src/org/eclipse/core/internal/boot/update/XmlLite.java;2;0;3;1;0;0;0;3;7;1;3;12;7;7;1;0;0;3;3;12;0;2726;3;2;
/org.eclipse.jdt.ui/core refactoring/org/eclipse/jdt/internal/core/refactoring/changes/TextFileChange.java;1;0;5;1;0;0;0;5;60;2;4;1800;72;72;2;1;0;5;5;1937;1;1937;4;1;
/org.eclipse.jdt.ui.tests.refactoring/resources/RenameVariables/canRename/A_test27_in.java;1;0;2;1;0;0;0;2;0;1;2;724;0;0;1;0;0;2;2;724;0;1665;2;1;
/org.eclipse.jdt.ui/ui/org/eclipse/jdt/internal/ui/search/JavaSearchGroup.java;3;1;17;1;5;5;5;12;68;2;11;15;241;241;2;1;0;12;17;343;1;4146;16;3;
/org.eclipse.swt/Eclipse SWT PI/win32/org/eclipse/swt/internal/ole/win32/IOleCommandTarget.java;2;0;2;1;1;1;1;1;6;0;1;2069;6;6;1;0;0;1;2;2069;0;4701;2;2;
/org.eclipse.jdt.ui.tests.refactoring/test cases/org/eclipse/jdt/ui/tests/refactoring/infra/AbstractCUTestCase.java;1;0;2;1;0;0;0;2;13;1;2;2216;13;13;1;0;0;2;2;2216;0;3811;2;1;
/org.eclipse.jdt.core/model/org/eclipse/jdt/internal/core/builder/AbstractImageBuilder.java;4;2;23;2;9;7;9;14;71;3;8;2979;191;191;3;6;2;14;23;3081;8;4378;15;4;
/org.eclipse.jdt.debug.tests/testprograms/org/eclipse/debug/tests/targets/HelloLauncherWithArg.java;2;0;2;1;1;1;1;1;11;0;1;3719;11;11;1;0;0;1;2;3719;0;4571;2;2;
/org.eclipse.pde.ui/src/org/eclipse/pde/internal/ui/ischema/ISchemaCompositor.java;1;0;2;1;0;0;0;2;0;1;2;3579;0;0;1;0;0;2;2;3579;0;3591;2;1;
/org.eclipse.pde.ui/src/org/eclipse/pde/internal/model/feature/FeaturePlugin.java;1;0;7;1;0;0;0;7;153;3;4;2951;240;240;3;3;0;7;7;2951;3;3579;4;1;
/org.eclipse.swt.tests/JUnit Tests/org/eclipse/swt/tests/junit/Test_org_eclipse_swt_widgets_Slider.java;2;0;2;1;1;1;1;1;6;0;1;1792;6;6;1;0;0;1;2;1792;0;4706;2;2;
/org.eclipse.jdt.ui/core refactoring/org/eclipse/jdt/internal/core/refactoring/projects/RenameProjectRefactoring.java;1;0;3;1;0;0;0;3;4;2;2;988;4;4;2;1;0;3;3;988;1;1258;2;1;
/org.eclipse.help/Eclipse Help/org/eclipse/help/internal/contributions/xml/HelpInfoView.java;3;0;4;1;0;0;0;4;43;1;4;135;50;50;1;0;0;4;4;135;0;1420;4;3;
/org.eclipse.jdt.ui.tests.refactoring/resources/ExtractMethodWorkSpace/ExtractMethodTests/locals_out/A_test565.java;1;1;3;1;2;2;2;1;0;0;1;3220;0;0;1;0;0;1;3;3220;0;4419;3;1;
/org.eclipse.jdt.ui.tests.refactoring/resources/MoveMembers/testFail11/in/B.java;1;0;1;1;0;0;0;1;0;0;1;2738;0;0;1;0;0;1;1;2738;0;2738;1;1;
/org.eclipse.jdt.core/compiler/org/eclipse/jdt/internal/compiler/parser/RecoveredField.java;2;0;12;1;1;1;1;11;274;4;8;455;342;342;4;3;0;11;12;1039;3;4062;9;2;
/org.eclipse.jdt.ui.tests.refactoring/resources/ReorderParameters/canReorder/A_test0_out.java;1;0;3;1;0;0;0;3;0;1;3;724;0;0;1;0;0;3;3;724;0;2270;3;1;
/org.eclipse.pde.core/src/org/eclipse/pde/core/ISourceObject.java;1;0;4;1;2;1;2;2;16;1;2;3591;18;18;2;0;1;2;4;4751;1;4751;3;1;
/org.eclipse.jdt.ui.tests.refactoring/resources/RenameParameters/canRename/A_test29_in.java;2;0;2;1;0;0;0;2;2;1;2;233;2;2;1;0;0;2;2;233;0;952;2;2;
/org.eclipse.jdt.debug/jdi interfaces/com/sun/jdi/DoubleType.java;2;0;2;1;0;0;0;2;6;1;2;2704;6;6;1;0;0;2;2;2704;0;3033;2;2;
/org.eclipse.jdt.debug/model/org/eclipse/jdt/internal/debug/core/hcr/JDIDebugHCRMessages.java;1;0;1;1;0;0;0;1;0;0;1;2523;0;0;1;0;0;1;1;2523;0;2523;1;1;
/org.eclipse.swt.tests/JUnit Tests/org/eclipse/swt/tests/junit/Test_org_eclipse_swt_widgets_Dialog.java;2;0;2;1;1;1;1;1;6;0;1;1792;6;6;1;0;0;1;2;1792;0;4706;2;2;
/org.eclipse.compare/compare/org/eclipse/compare/patch/Hunk.java;1;0;6;1;0;0;0;6;168;1;6;1516;199;199;1;0;0;6;6;1516;0;2876;6;1;
/org.eclipse.update.ui/src/org/eclipse/update/internal/ui/manager/MyComputerSearchDialog.java;1;0;4;1;0;0;0;4;9;2;3;2797;9;9;2;1;0;4;4;3532;1;3662;3;1;
/org.eclipse.jdt.ui/ui/org/eclipse/jdt/internal/ui/wizards/AbstractOpenWizardAction.java;3;0;7;1;1;1;1;6;31;1;6;1941;60;60;1;0;0;6;7;1941;0;3968;7;3;
/org.eclipse.jdt.debug/jdi interfaces/com/sun/jdi/IntegerValue.java;2;0;2;1;0;0;0;2;6;1;2;2704;6;6;1;0;0;2;2;2704;0;3033;2;2;
/org.eclipse.pde.ui/Eclipse PDE UI/org/eclipse/pde/internal/base/schema/ISchemaComplexType.java;2;0;5;2;0;0;0;5;12;3;3;267;12;12;3;2;0;5;5;324;2;1434;3;2;
/org.eclipse.update.ui/src/org/eclipse/update/internal/ui/manager/CategoryForm.java;3;0;10;1;0;0;0;10;12;2;8;2172;31;31;2;2;0;10;10;2172;2;3662;8;3;
/org.eclipse.pde.ui/src/org/eclipse/pde/internal/ui/wizards/imports/UpdateBuildpathWizard.java;1;0;2;1;1;1;1;1;2;0;1;3579;2;2;1;0;0;1;2;3579;0;4238;2;1;
/org.eclipse.tomcat/src/org/eclipse/tomcat/internal/JdtJasperCompiler.java;2;0;4;1;1;1;1;3;12;1;3;3356;17;17;1;0;0;3;4;3356;0;4121;4;2;
/org.eclipse.debug.ui/ui/org/eclipse/debug/internal/ui/views/AbstractDebugEventHandlerView.java;2;0;2;1;0;0;0;2;6;1;2;2344;6;6;1;0;0;2;2;2344;0;2465;2;2;
/org.eclipse.help/Eclipse Help/org/eclipse/help/internal/util/TString.java;3;0;6;1;0;0;0;6;28;1;6;135;62;62;1;0;0;6;6;135;0;1420;6;3;
/org.eclipse.vcm.core/src/org/eclipse/vcm/internal/core/base/IStateInfo.java;3;0;3;1;0;0;0;3;12;1;3;0;17;17;1;0;0;3;3;0;0;297;3;3;
/org.eclipse.debug.ui/ui/org/eclipse/debug/internal/ui/actions/SelectAllAction.java;2;0;6;2;0;0;0;6;84;2;5;3177;112;112;2;1;0;6;6;3177;1;3730;5;2;
/org.eclipse.pde.ui/src/org/eclipse/pde/internal/editor/PDEMultiPageEditor.java;2;0;12;1;0;0;0;12;747;2;11;1434;842;842;2;1;0;12;12;3136;1;3579;11;2;
/org.eclipse.update/Eclipse Update/org/eclipse/update/internal/ui/UMApplicationUserInterfaceProperties.java;2;0;4;1;0;0;0;4;155;1;4;108;162;162;1;0;0;4;4;108;0;1424;4;2;
/org.eclipse.vcm.ui/src/org/eclipse/vcm/internal/ui/syncdialog/SyncAction.java;2;0;3;2;0;0;0;3;11;2;2;1;11;11;2;1;0;3;3;1;1;68;2;2;
/org.eclipse.swt/Eclipse SWT PI/win32/org/eclipse/swt/internal/win32/HDITEM.java;2;0;2;1;1;1;1;1;6;0;1;2069;6;6;1;0;0;1;2;2069;0;4701;2;2;
/org.eclipse.jdt.ui/ui refactoring/org/eclipse/jdt/internal/ui/nls/ExternalizeWizardPage.java;1;0;3;1;0;0;0;3;62;2;2;1913;62;62;2;1;0;3;3;1921;1;1921;2;1;
/org.eclipse.core.resources/src/org/eclipse/core/internal/resources/SyncInfoReader.java;3;0;7;2;1;1;1;6;130;2;5;12;220;220;2;1;0;6;7;158;1;4213;6;3;
/org.eclipse.swt.tests/JUnit Tests/org/eclipse/swt/tests/junit/Test_org_eclipse_swt_widgets_Table.java;2;0;2;1;1;1;1;1;6;0;1;1792;6;6;1;0;0;1;2;1792;0;4706;2;2;
/org.eclipse.ui/Eclipse UI/org/eclipse/ui/internal/ReopenEditorMenu.java;5;1;14;1;3;3;3;11;250;1;11;257;621;621;1;0;0;11;14;257;0;4363;14;5;
/org.eclipse.jdt.debug/model/org/eclipse/jdt/internal/debug/core/JavaBreakpoint.java;4;0;35;2;0;0;0;35;391;2;24;831;1469;1469;2;11;0;35;35;1035;11;2514;24;4;
/org.eclipse.swt/Eclipse SWT/win32/org/eclipse/swt/widgets/FontDialog.java;7;2;10;2;3;2;3;7;78;2;6;106;110;110;2;1;1;7;10;1608;2;4701;8;7;
/org.eclipse.pde.junit/src/org/eclipse/pde/internal/junit/ui/RemotePluginTestRunner.java;1;0;1;1;0;0;0;1;0;0;1;3171;0;0;1;0;0;1;1;3171;0;3171;1;1;
/org.eclipse.jdt.ui.tests.refactoring/resources/ExtractMethodWorkSpace/ExtractMethodTests/invalidSelection/A_test010.java;2;1;3;1;2;2;2;1;0;0;1;49;0;0;1;0;0;1;3;49;0;4419;3;2;
/org.eclipse.pde.ui/src/org/eclipse/pde/internal/ui/editor/manifest/NewDependencyWizardPage.java;1;1;5;1;2;2;2;3;5;1;3;3579;14;14;1;0;0;3;5;3579;0;4324;5;1;
/org.eclipse.swt/Eclipse SWT PI/win32/org/eclipse/swt/internal/win32/NMHDR.java;2;0;2;1;1;1;1;1;6;0;1;2069;6;6;1;0;0;1;2;2069;0;4701;2;2;
/org.eclipse.scripting/src/org/eclipse/scripting/internal/IXGRElementUITextPresentationElement.java;1;0;1;1;0;0;0;1;0;0;1;1424;0;0;1;0;0;1;1;1424;0;1424;1;1;
/org.eclipse.pde.ui/src/org/eclipse/pde/internal/core/plugin/WorkspacePluginModel.java;1;0;2;1;0;0;0;2;0;1;2;3579;0;0;1;0;0;2;2;3579;0;3607;2;1;
/org.eclipse.pde.ui/Eclipse PDE UI/org/eclipse/pde/internal/editor/component/DescriptionSection.java;2;0;9;2;0;0;0;9;12;3;7;267;21;21;3;2;0;9;9;324;2;1434;7;2;
/org.eclipse.jdt.debug/jdi/org/eclipse/jdi/internal/ClassLoaderReferenceImpl.java;2;0;4;1;0;0;0;4;25;1;4;187;43;43;1;0;0;4;4;187;0;3670;4;2;
/org.eclipse.jdt.ui.tests.refactoring/resources/ExtractMethodWorkSpace/ExtractMethodTests/locals_out/A_test504.java;2;1;4;1;2;2;2;2;24;1;2;80;24;24;1;0;0;2;4;80;0;4419;4;2;
/org.eclipse.core.boot/src/org/eclipse/core/internal/boot/PlatformURLBaseConnection.java;2;0;4;1;1;1;1;3;94;1;3;23;135;135;1;0;0;3;4;23;0;4214;4;2;
/org.eclipse.swt/Eclipse SWT PI/win32/org/eclipse/swt/internal/win32/LRESULT.java;2;0;2;1;1;1;1;1;6;0;1;2069;6;6;1;0;0;1;2;2069;0;4701;2;2;
/org.eclipse.jdt.core/codeassist/org/eclipse/jdt/internal/codeassist/complete/CompletionOnExceptionReference.java;2;1;11;1;2;2;2;9;31;4;6;455;83;83;4;3;0;9;11;1039;3;4421;8;2;
/org.eclipse.debug.ui/ui/org/eclipse/debug/internal/ui/actions/TerminateAllAction.java;2;1;8;1;2;2;2;6;77;1;6;2382;109;109;1;0;0;6;8;2382;0;4409;8;2;
/org.eclipse.jdt.ui.tests.refactoring/resources/RenamePackage/testFail7/in/p1/A.java;2;0;2;1;0;0;0;2;2;1;2;49;2;2;1;0;0;2;2;49;0;1258;2;2;
/org.eclipse.jdt.ui.tests/JUnit/junit/ui/TraceFrame.java;2;0;2;1;0;0;0;2;0;1;2;49;0;0;1;0;0;2;2;49;0;1186;2;2;
/org.eclipse.jdt.ui.tests.refactoring/resources/ExtractMethodWorkSpace/ExtractMethodTests/locals_out/A_test503.java;2;1;4;1;2;2;2;2;24;1;2;80;26;26;1;0;0;2;4;80;0;4419;4;2;
/org.eclipse.jdt.ui.tests.refactoring/resources/PullUp/testTemplate/out/A.java;1;0;1;1;0;0;0;1;0;0;1;2406;0;0;1;0;0;1;1;2406;0;2406;1;1;
/org.eclipse.jdt.core/compiler/org/eclipse/jdt/internal/compiler/ast/TypeDeclaration.java;2;1;24;1;3;3;3;21;1806;4;16;455;3962;3962;4;5;0;21;24;1039;5;4062;19;2;
/org.eclipse.pde.junit/src/org/eclipse/pde/internal/junit/oldlauncher/JUnitPdeLauncherDelegate.java;2;0;4;1;0;0;0;4;3;1;4;3171;5;5;1;0;0;4;4;3171;0;3638;4;2;
/org.eclipse.debug.ui/ui/org/eclipse/debug/internal/ui/InspectorViewAddToInspectorAction.java;2;0;4;1;0;0;0;4;10;1;4;187;15;15;1;0;0;4;4;187;0;2348;4;2;
/org.eclipse.team.cvs.ui/src/org/eclipse/team/internal/ccvs/ui/sync/UpdateSyncAction.java;3;2;18;2;5;4;5;13;83;2;11;2828;354;354;2;2;1;13;18;3156;3;4455;15;3;
/org.eclipse.jdt.ui.tests.refactoring/resources/InlineTemp/cannotInline/A_testFail6.java;1;0;1;1;0;0;0;1;0;0;1;2015;0;0;1;0;0;1;1;2015;0;2015;1;1;
/org.eclipse.swt/Eclipse SWT Printing/carbon/org/eclipse/swt/printing/PrintDialog.java;3;1;4;1;4;4;4;0;6;0;0;4147;14;14;1;0;0;0;4;4147;0;4701;4;3;
/org.eclipse.pde.ui/src/org/eclipse/pde/internal/wizards/BaseWizardSelectionPage.java;2;0;5;1;0;0;0;5;12;1;5;1434;20;20;1;0;0;5;5;1434;0;3579;5;2;
/org.eclipse.help.ui/src/org/eclipse/help/ui/internal/browser/BrowsersPreferencePage.java;2;1;6;1;2;2;2;4;25;1;4;2429;63;63;1;0;0;4;6;2429;0;4439;6;2;
/org.eclipse.jdt.ui/ui refactoring/org/eclipse/jdt/internal/ui/refactoring/actions/TextSelectionBasedRefactoringAction.java;2;0;14;2;0;0;0;14;157;2;12;1665;206;206;2;2;0;14;14;1939;2;3791;12;2;
/org.eclipse.debug.ui/ui/org/eclipse/debug/internal/ui/InspectorContentProvider.java;3;0;9;1;0;0;0;9;100;1;9;187;173;173;1;0;0;9;9;187;0;2348;9;3;
/org.eclipse.pde.ui/src/org/eclipse/pde/internal/ui/launcher/WorkbenchLauncherTabGroup.java;1;0;1;1;0;0;0;1;0;0;1;3583;0;0;1;0;0;1;1;3583;0;3583;1;1;
/org.eclipse.jdt.debug.ui/ui/org/eclipse/jdt/internal/debug/ui/snippeteditor/DisplayAction.java;2;0;2;1;0;0;0;2;0;1;2;1915;0;0;1;0;0;2;2;1915;0;2813;2;2;
/org.eclipse.core.tests.resources/src/org/eclipse/core/tests/resources/usecase/BuilderUseCaseTest.java;3;0;3;1;0;0;0;3;330;1;3;1794;340;340;1;0;0;3;3;1794;0;3475;3;3;
/org.eclipse.jdt.core/model/org/eclipse/jdt/internal/core/builder/impl/DependencyGraphImpl.java;1;0;3;1;0;0;0;3;16;1;3;455;16;16;1;0;0;3;3;455;0;2808;3;1;
/org.eclipse.jdt.ui/ui/org/eclipse/jdt/internal/ui/compare/TextBufferNode.java;1;0;3;1;0;0;0;3;4;2;2;1955;4;4;2;1;0;3;3;1955;1;2052;2;1;
/org.eclipse.jdt.core/codeassist/org/eclipse/jdt/internal/codeassist/complete/CompletionScanner.java;2;1;15;1;2;2;2;13;1087;4;10;455;1170;1170;4;3;0;13;15;1039;3;4062;12;2;
/org.eclipse.vcm.core.cvs.ssh/src/org/eclipse/vcm/internal/core/ccvs/ssh/Misc.java;2;0;5;1;0;0;0;5;692;2;4;111;888;888;2;1;0;5;5;239;1;298;4;2;
/org.eclipse.jdt.core/model/org/eclipse/jdt/internal/core/jdom/DOMNode.java;3;0;13;1;1;1;1;12;1535;4;9;455;1815;1815;4;3;0;12;13;1039;3;4063;10;3;
/org.eclipse.jdt.ui.tests/ui/com/ibm/jdt/ui/wizards/examples/DialogFieldExample.java;1;0;3;1;0;0;0;3;4;1;3;255;4;4;1;0;0;3;3;255;0;522;3;1;
/org.eclipse.pde.ui/src/org/eclipse/pde/internal/schema/FileSchemaDescriptor.java;2;0;3;1;0;0;0;3;4;1;3;1434;4;4;1;0;0;3;3;1434;0;3579;3;2;
/org.eclipse.debug.ui/ui/org/eclipse/debug/internal/ui/launchConfigurations/LaunchConfigurationTabGroupExtension.java;2;0;2;1;0;0;0;2;4;1;2;3313;4;4;1;0;0;2;2;3313;0;3667;2;2;
/org.eclipse.webdav/src/kernel/org/eclipse/webdav/internal/kernel/DAVException.java;2;0;4;1;1;1;1;3;40;1;3;1635;77;77;1;0;0;3;4;1635;0;4211;4;2;
/org.eclipse.ui/Eclipse UI Standard Components/org/eclipse/ui/views/tasklist/TaskPropertiesAction.java;2;1;4;1;2;2;2;2;17;1;2;3148;28;28;1;0;0;2;4;3148;0;4608;4;2;
/org.eclipse.pde/src/org/eclipse/pde/internal/builders/ManifestConsistencyChecker.java;1;0;2;1;0;0;0;2;8;1;2;3631;8;8;1;0;0;2;2;3631;0;3802;2;1;
/org.eclipse.ui/Eclipse JFace Text/org/eclipse/jface/text/source/LineNumberRulerColumn.java;1;1;4;1;4;4;4;0;45;0;0;4038;68;68;1;0;0;0;4;4038;0;4838;4;1;
/org.eclipse.jdt.debug.tests/testprograms/org/eclipse/debug/tests/targets/CallLoop.java;2;0;2;1;1;1;1;1;11;0;1;3719;11;11;1;0;0;1;2;3719;0;4571;2;2;
/org.eclipse.swt/Eclipse SWT/gtk/org/eclipse/swt/widgets/ToolBar.java;6;1;18;2;6;6;6;12;134;2;11;2107;340;340;2;1;0;12;18;3209;1;4701;17;6;
/org.eclipse.jdt.core/model/org/eclipse/jdt/internal/core/newbuilder/ClasspathLocation.java;1;0;6;1;0;0;0;6;12;2;5;1764;21;21;2;1;0;6;6;1807;1;2979;5;1;
/org.eclipse.update.core/src/org/eclipse/update/internal/core/DataEntry.java;2;0;2;1;0;0;0;2;0;1;2;2008;0;0;1;0;0;2;2;2008;0;2583;2;2;
/org.eclipse.swt/Eclipse SWT/win32/org/eclipse/swt/widgets/ColorDialog.java;7;2;10;1;3;2;3;7;26;1;7;106;57;57;2;0;1;7;10;4557;1;4701;9;7;
/org.eclipse.ui/Eclipse UI/org/eclipse/ui/internal/ActivateEditorAction.java;4;1;7;1;3;3;3;4;26;2;3;1737;36;36;2;1;0;4;7;3212;1;4730;6;4;
/org.eclipse.jdt.ui.tests.refactoring/resources/InlineTemp/canInline/A_test9_out.java;1;0;1;1;0;0;0;1;0;0;1;2051;0;0;1;0;0;1;1;2051;0;2051;1;1;
/org.eclipse.jdt.ui/nls/org/eclipse/jdt/internal/ui/nls/model/Utils.java;1;0;2;1;0;0;0;2;0;1;2;1880;0;0;1;0;0;2;2;1880;0;1913;2;1;
/org.eclipse.webdav/src/client/org/eclipse/webdav/http/client/IRequestBodyWriter.java;2;0;4;1;1;1;1;3;64;1;3;12;92;92;1;0;0;3;4;12;0;4211;4;2;
/org.eclipse.jdt.ui.tests.refactoring/resources/MoveCU/testFail4/in/p/A.java;2;0;2;1;0;0;0;2;0;1;2;49;0;0;1;0;0;2;2;49;0;2769;2;2;
/org.eclipse.compare/compare/org/eclipse/compare/IEditableContent.java;2;0;3;1;0;0;0;3;31;1;3;14;36;36;1;0;0;3;3;14;0;3053;3;2;
/org.eclipse.swt/Eclipse SWT/win32/org/eclipse/swt/widgets/Table.java;10;3;41;2;11;7;11;30;140;1;30;106;663;663;3;0;4;30;41;4081;4;4701;37;10;
/org.eclipse.jdt.debug/jdi interfaces/com/sun/jdi/VMDisconnectedException.java;2;0;2;1;0;0;0;2;7;1;2;2704;7;7;1;0;0;2;2;2704;0;3033;2;2;
/org.eclipse.jdt.core/compiler/org/eclipse/jdt/internal/compiler/ast/Initializer.java;2;1;15;1;3;3;3;12;165;5;8;455;407;407;5;4;0;12;15;1037;4;4421;11;2;
/org.eclipse.jdt.core/compiler/org/eclipse/jdt/internal/compiler/classfmt/FieldInfo.java;2;1;15;1;3;3;3;12;518;4;8;455;1050;1050;4;4;0;12;15;1039;4;4062;11;2;
/org.eclipse.pde.ui/src/org/eclipse/pde/internal/model/PluginLibrary.java;2;0;5;1;0;0;0;5;39;1;5;1434;60;60;1;0;0;5;5;1434;0;3136;5;2;
/org.eclipse.jdt.debug/eval/org/eclipse/jdt/internal/debug/eval/ast/engine/MinusAssignmentOperator.java;1;0;2;1;0;0;0;2;0;1;2;3329;0;0;1;0;0;2;2;3329;0;3421;2;1;
/org.eclipse.team.cvs.ui/src/org/eclipse/team/internal/ccvs/ui/sync/IgnoreAction.java;3;1;9;1;5;5;5;4;25;1;4;2865;84;84;1;0;0;4;9;2865;0;4455;9;3;
/org.eclipse.jdt.ui.tests.refactoring/resources/ExtractMethodWorkSpace/ExtractMethodTests/semicolon_out/A_test403.java;2;1;3;1;2;2;2;1;0;0;1;49;0;0;1;0;0;1;3;49;0;4419;3;2;
/org.eclipse.debug.ui/ui/org/eclipse/debug/internal/ui/actions/OpenMarkerAction.java;1;0;2;1;0;0;0;2;0;1;2;2382;0;0;1;0;0;2;2;2382;0;3362;2;1;
/org.eclipse.jdt.ui/ui/org/eclipse/jdt/ui/text/JavaTextTools.java;4;2;15;1;4;3;4;11;71;1;11;15;284;284;2;0;1;11;15;4810;1;4810;14;4;
/org.eclipse.jdt.ui.tests.refactoring/resources/ExtractMethodWorkSpace/ExtractMethodTests/locals_in/A_test553.java;1;1;3;1;2;2;2;1;24;0;1;1236;24;24;1;0;0;1;3;1236;0;4419;3;1;
/org.eclipse.core.resources/src/org/eclipse/core/internal/utils/ResourceStats.java;2;0;6;1;1;1;1;5;458;1;5;12;582;582;1;0;0;5;6;12;0;4214;6;2;
/org.eclipse.jdt.ui.tests.refactoring/test cases/org/eclipse/jdt/ui/tests/nls/NLSScannerTester.java;1;0;3;1;0;0;0;3;76;1;3;2015;91;91;1;0;0;3;3;2015;0;3467;3;1;
/org.eclipse.swt/Eclipse SWT PI/win32/org/eclipse/swt/internal/win32/NMLISTVIEW.java;2;0;2;1;1;1;1;1;6;0;1;2069;6;6;1;0;0;1;2;2069;0;4701;2;2;
/org.eclipse.pde.ui/src/org/eclipse/pde/internal/ui/ischema/ISchemaSimpleType.java;1;0;2;1;0;0;0;2;0;1;2;3579;0;0;1;0;0;2;2;3579;0;3591;2;1;
/org.eclipse.jdt.ui.tests.refactoring/resources/RenameVariables/canRename/A_test20_out.java;1;0;2;1;0;0;0;2;0;1;2;724;0;0;1;0;0;2;2;724;0;1665;2;1;
/org.eclipse.jdt.ui/core refactoring/org/eclipse/jdt/internal/corext/refactoring/changes/CompilationUnitChange.java;2;0;5;1;0;0;0;5;12;2;4;1939;21;21;2;1;0;5;5;2133;1;3307;4;2;
/org.eclipse.pde.ui/src/org/eclipse/pde/internal/ui/wizards/templates/PreferencePageTemplate.java;1;0;5;1;1;1;1;4;73;1;4;3579;107;107;1;0;0;4;5;3579;0;4316;5;1;
/org.eclipse.ui.tests/UI Test Utils/org/eclipse/ui/tests/internal/util/FocusTestPass.java;1;0;1;1;0;0;0;1;0;0;1;2785;0;0;1;0;0;1;1;2785;0;2785;1;1;
/org.eclipse.jdt.ui.tests.refactoring/resources/ExtractTemp/canExtract/A_test7_out.java;1;0;1;1;0;0;0;1;0;0;1;2481;0;0;1;0;0;1;1;2481;0;2481;1;1;
/org.eclipse.pde.ui/src/org/eclipse/pde/internal/wizards/templates/NewPluginTemplateWizard.java;1;0;4;1;0;0;0;4;214;1;4;3278;270;270;1;0;0;4;4;3278;0;3579;4;1;
/org.eclipse.swt/Eclipse SWT OLE Win32/win32/org/eclipse/swt/internal/ole/win32/STGMEDIUM.java;2;0;3;1;0;0;0;3;5;1;3;106;5;5;1;0;0;3;3;106;0;2069;3;2;
/org.eclipse.pde.ui/src/org/eclipse/pde/internal/editor/PDEMultiPagePropertySheet.java;2;0;3;1;0;0;0;3;1;1;3;1434;1;1;1;0;0;3;3;1434;0;3579;3;2;
/org.eclipse.jdt.ui/ui/org/eclipse/jdt/internal/ui/browsing/ProjectsView.java;3;1;14;1;7;7;7;7;20;1;7;2878;86;86;1;0;0;7;14;2878;0;4643;14;3;
/org.eclipse.team.tests.cvs.core/src/org/eclipse/team/tests/ccvs/ui/benchmark/SyncTests.java;1;0;3;1;0;0;0;3;119;1;3;2977;121;121;1;0;0;3;3;2977;0;3610;3;1;
/org.eclipse.jdt.ui.tests.refactoring/resources/SelectionAnalyzerWorkSpace/SelectionAnalyzerTests/invalidSelection/A_test082.java;1;0;1;1;0;0;0;1;0;0;1;1368;0;0;1;0;0;1;1;1368;0;1368;1;1;
/org.eclipse.jdt.ui/ui/org/eclipse/jdt/internal/ui/javaeditor/_ClassFileDocumentProvider.java;2;0;4;1;1;1;1;3;3;2;2;3147;6;6;2;1;0;3;4;3147;1;4137;3;2;
/org.eclipse.jdt.ui.tests.refactoring/resources/ExtractMethodWorkSpace/ExtractMethodTests/invalidSelection/A_test180.java;1;1;3;1;2;2;2;1;0;0;1;922;0;0;1;0;0;1;3;922;0;4419;3;1;
/org.eclipse.jdt.ui.tests.refactoring/resources/MoveCU/testFail4/in/p1/C.java;2;0;2;1;0;0;0;2;0;1;2;49;0;0;1;0;0;2;2;49;0;2769;2;2;
/org.eclipse.help.ui.win32/src/org/eclipse/help/ui/internal/browser/win32/IEResources.java;1;0;1;1;1;1;1;0;0;0;0;4427;0;0;1;0;0;0;1;4427;0;4427;1;1;
/org.eclipse.ui/Eclipse UI/org/eclipse/ui/internal/Workbench.java;9;3;84;3;27;17;27;57;1703;4;47;257;4728;4728;4;10;10;57;84;3851;20;4637;64;9;
/org.eclipse.jdt.core/model/org/eclipse/jdt/internal/core/builder/impl/FieldImpl.java;1;0;9;1;0;0;0;9;49;4;6;455;67;67;4;3;0;9;9;1039;3;2808;6;1;
/org.eclipse.team.cvs.core/src/org/eclipse/team/internal/ccvs/core/util/EntriesVisitor.java;2;0;2;1;0;0;0;2;0;1;2;1978;0;0;1;0;0;2;2;1978;0;2156;2;2;
/org.eclipse.team.cvs.core/src/org/eclipse/team/internal/ccvs/core/client/ModuleExpansionHandler.java;1;0;2;1;0;0;0;2;2;1;2;2933;2;2;1;0;0;2;2;2933;0;2963;2;1;
/org.eclipse.team.core/src/org/eclipse/team/internal/core/target/SynchronizedTargetProvider.java;4;3;24;2;24;16;24;0;472;0;0;4010;1238;1238;3;0;8;0;24;4367;8;4636;16;4;
/org.eclipse.jdt.ui.tests.refactoring/resources/MoveCU/testFail8/in/p/A.java;2;0;2;1;0;0;0;2;0;1;2;49;0;0;1;0;0;2;2;49;0;2769;2;2;
/org.eclipse.vcm.ui/src/org/eclipse/vcm/internal/ui/syncdialog/UnchangedVCMContainer.java;2;0;2;1;0;0;0;2;0;1;2;1;0;0;1;0;0;2;2;1;0;68;2;2;
/org.eclipse.pde.ui/src/org/eclipse/pde/internal/editor/schema/GrammarPropertySource.java;2;0;2;1;0;0;0;2;0;1;2;1434;0;0;1;0;0;2;2;1434;0;3579;2;2;
/org.eclipse.jdt.ui/core refactoring/org/eclipse/jdt/internal/core/refactoring/AbstractRefactoringASTAnalyzer.java;3;0;9;1;0;0;0;9;13;1;9;47;33;33;1;0;0;9;9;47;0;1939;9;3;
/org.eclipse.ui/Eclipse UI/org/eclipse/ui/internal/IWorkbenchConstants.java;8;1;20;2;2;2;2;18;162;2;17;257;229;229;2;1;0;18;20;3052;1;4069;19;8;
/org.eclipse.jdt.junit/Eclipse JUnit/org/eclipse/jdt/internal/junit/runner/ITestRunListener.java;2;0;2;1;0;0;0;2;0;1;2;2399;0;0;1;0;0;2;2;2399;0;3205;2;2;
/org.eclipse.jdt.ui/ui refactoring/org/eclipse/jdt/internal/ui/refactoring/nls/search/NLSSearchResultCollector.java;3;1;8;1;3;3;3;5;27;3;3;1922;54;54;3;2;0;5;8;3527;2;4602;6;3;
/org.eclipse.pde.ui/Eclipse PDE UI/org/eclipse/pde/internal/base/model/build/IBuildModelFactory.java;2;0;5;2;0;0;0;5;12;3;3;267;12;12;3;2;0;5;5;324;2;1434;3;2;
/org.eclipse.update.ui/src/org/eclipse/update/internal/ui/forms/DetailsHistoryItem.java;1;0;1;1;0;0;0;1;0;0;1;3662;0;0;1;0;0;1;1;3662;0;3662;1;1;
/org.eclipse.vcm.core/src/org/eclipse/vcm/internal/core/MergeManager.java;3;0;3;1;0;0;0;3;6;1;3;0;8;8;1;0;0;3;3;0;0;1584;3;3;
/org.eclipse.pde.ui/src/org/eclipse/pde/internal/ui/wizards/templates/EditorNewWizard.java;1;0;3;1;0;0;0;3;8;1;3;3812;9;9;1;0;0;3;3;3812;0;3870;3;1;
/org.eclipse.jdt.ui.tests.refactoring/resources/RenameVariables/canRename/A_test14_out.java;1;0;2;1;0;0;0;2;0;1;2;724;0;0;1;0;0;2;2;724;0;1665;2;1;
/org.eclipse.pde.runtime/src/org/eclipse/pde/internal/runtime/logview/LineReader.java;1;0;1;1;1;1;1;0;0;0;0;4070;0;0;1;0;0;0;1;4070;0;4070;1;1;
/org.eclipse.jdt.debug.ui/ui/org/eclipse/jdt/internal/debug/ui/LocalFileStorageEditorInput.java;1;0;1;1;0;0;0;1;0;0;1;2372;0;0;1;0;0;1;1;2372;0;2372;1;1;
/org.eclipse.jdt.ui.tests.refactoring/resources/RenamePrivateMethod/test25/out/A.java;1;0;1;1;0;0;0;1;0;0;1;49;0;0;1;0;0;1;1;49;0;49;1;1;
/org.eclipse.update.ui/src/org/eclipse/update/internal/ui/parts/IUpdateForm.java;1;0;4;1;0;0;0;4;5;1;4;1542;7;7;1;0;0;4;4;1542;0;3662;4;1;
/org.eclipse.jdt.ui.tests.refactoring/resources/ExtractMethodWorkSpace/ExtractMethodTests/locals_out/A_test511.java;2;1;6;1;2;2;2;4;15;1;4;226;24;24;1;0;0;4;6;226;0;4419;6;2;
/org.eclipse.jdt.ui.tests.refactoring/resources/ExtractMethodWorkSpace/ExtractMethodTests/invalidSelection/A_test063.java;2;1;3;1;2;2;2;1;0;0;1;49;0;0;1;0;0;1;3;49;0;4419;3;2;
/org.eclipse.ui/Eclipse UI/org/eclipse/ui/internal/IWorkbenchPreferenceConstants.java;2;0;2;1;0;0;0;2;0;1;2;257;0;0;1;0;0;2;2;257;0;457;2;2;
/org.eclipse.jdt.ui/ui/org/eclipse/jdt/internal/ui/compare/CompareMessages.java;1;0;1;1;0;0;0;1;0;0;1;771;0;0;1;0;0;1;1;771;0;771;1;1;
/org.eclipse.jdt.ui.tests.refactoring/resources/RenameVirtualMethodInClass/test18/in/A.java;1;0;1;1;0;0;0;1;0;0;1;49;0;0;1;0;0;1;1;49;0;49;1;1;
/org.eclipse.pde.ui/src/org/eclipse/pde/internal/ui/editor/schema/AttributePropertySource.java;1;0;2;1;0;0;0;2;4;1;2;3579;4;4;1;0;0;2;2;3579;0;3591;2;1;
/org.eclipse.pde.ui/src/org/eclipse/pde/internal/ui/editor/schema/SchemaFormPage.java;1;0;2;1;0;0;0;2;22;0;1;3579;22;22;2;1;0;2;2;3579;1;3579;1;1;
/org.eclipse.jdt.ui/ui/org/eclipse/jdt/internal/ui/browsing/JavaBrowsingMessages.java;1;0;1;1;0;0;0;1;0;0;1;2878;0;0;1;0;0;1;1;2878;0;2878;1;1;
/org.eclipse.pde.core/src/org/eclipse/pde/internal/core/feature/FeatureInfo.java;1;0;2;1;1;1;1;1;10;0;1;3591;10;10;1;0;0;1;2;3591;0;3994;2;1;
/org.eclipse.update.core/src/org/eclipse/update/core/IConfigurationSite.java;2;0;17;1;0;0;0;17;38;2;14;2032;152;152;2;3;0;17;17;2032;3;2994;14;2;
/org.eclipse.pde.ui/Eclipse PDE UI/org/eclipse/pde/internal/editor/component/ComponentSourceOutlinePage.java;2;0;5;2;0;0;0;5;12;3;3;267;12;12;3;2;0;5;5;324;2;1434;3;2;
/org.eclipse.ui/Eclipse UI/org/eclipse/ui/internal/ObjectContributorManager.java;5;2;10;1;3;2;3;7;233;2;6;257;488;488;2;1;1;7;10;2300;2;4689;8;5;
/org.eclipse.jdt.ui.tests.refactoring/resources/DeleteSourceReference/test9/out/A.java;1;0;1;1;0;0;0;1;0;0;1;2857;0;0;1;0;0;1;1;2857;0;2857;1;1;
/org.eclipse.pde.ui/Eclipse PDE UI/org/eclipse/pde/internal/editor/component/ComponentFormPage.java;2;0;6;2;0;0;0;6;12;3;4;267;14;14;3;2;0;6;6;324;2;1434;4;2;
/org.eclipse.core.resources/src/org/eclipse/core/internal/resources/Folder.java;3;0;15;1;1;1;1;14;314;1;14;12;474;474;1;0;0;14;15;12;0;4213;15;3;
/org.eclipse.help/src/org/eclipse/help/internal/contributors/xml/XMLViewContributorCreator.java;2;0;2;1;0;0;0;2;0;1;2;1420;0;0;1;0;0;2;2;1420;0;1675;2;2;
/org.eclipse.jdt.ui/core extension/org/eclipse/jdt/internal/corext/codemanipulation/CodeBlockEdit.java;1;0;2;1;0;0;0;2;30;0;1;3870;30;30;2;1;0;2;2;3870;1;3870;1;1;
/org.eclipse.ui/Eclipse UI/org/eclipse/ui/part/IDropActionDelegate.java;2;0;2;1;0;0;0;2;4;1;2;257;4;4;1;0;0;2;2;257;0;457;2;2;
/org.eclipse.jdt.core/compiler/org/eclipse/jdt/internal/compiler/classfmt/ClassFormatException.java;3;1;5;1;2;2;2;3;65;1;3;455;103;103;1;0;0;3;5;455;0;4420;5;3;
/org.eclipse.jdt.ui/ui/org/eclipse/jdt/internal/ui/util/MainMethodSearchEngine.java;4;0;11;1;0;0;0;11;126;1;11;15;264;264;1;0;0;11;11;15;0;3846;11;4;
/org.eclipse.jdt.core/model/org/eclipse/jdt/internal/core/JavaModelOperation.java;2;1;15;1;3;3;3;12;978;4;9;455;1111;1111;4;3;0;12;15;1039;3;4568;12;2;
/org.eclipse.ui/Eclipse UI/org/eclipse/ui/IFileEditorInput.java;2;0;2;1;0;0;0;2;5;1;2;257;5;5;1;0;0;2;2;257;0;457;2;2;
/org.eclipse.jdt.ui.tests.refactoring/resources/RenamePackage/test4/out/r/A.java;2;0;2;1;0;0;0;2;2;1;2;91;2;2;1;0;0;2;2;91;0;1258;2;2;
/org.eclipse.pde.build/src_ant/org/eclipse/pde/internal/core/JDTCompilerAdapter.java;1;1;4;1;2;2;2;2;2;1;2;3509;4;4;1;0;0;2;4;3509;0;4125;4;1;
/org.eclipse.jdt.debug.ui/ui/org/eclipse/jdt/internal/debug/ui/actions/InspectVariableAction.java;2;0;2;1;0;0;0;2;0;1;2;2647;0;0;1;0;0;2;2;2647;0;2813;2;2;
/org.eclipse.debug.ui/ui/org/eclipse/debug/internal/ui/launchConfigurations/LaunchConfigurationHistoryElement.java;3;0;10;1;1;1;1;9;113;2;8;2881;349;349;2;1;0;9;10;3362;1;4423;9;3;
/org.eclipse.jdt.ui.tests.refactoring/resources/ExtractMethodWorkSpace/ExtractMethodTests/locals_in/A_test521.java;1;1;3;1;2;2;2;1;26;0;1;1851;26;26;1;0;0;1;3;1851;0;4419;3;1;
/org.eclipse.team.cvs.core/src/org/eclipse/team/internal/ccvs/core/connection/CVSRepositoryLocation.java;3;1;30;2;5;5;5;25;1200;2;22;1978;4209;4209;2;3;0;25;30;2049;3;4425;27;3;
/org.eclipse.jdt.ui/ui/org/eclipse/jdt/internal/ui/javaeditor/ProblemPainter.java;2;2;16;2;6;5;6;10;171;2;9;3166;398;398;2;1;1;10;16;3466;2;4621;14;2;
/org.eclipse.swt.examples/org/eclipse/swt/examples/explorer/TableView.java;1;0;1;1;0;0;0;1;0;0;1;547;0;0;1;0;0;1;1;547;0;547;1;1;
/org.eclipse.pde.ui/src/org/eclipse/pde/internal/builders/BuildpathConsistencyChecker.java;1;0;5;1;0;0;0;5;4;1;5;2691;7;7;1;0;0;5;5;2691;0;3446;5;1;
/org.eclipse.swt/Eclipse SWT/photon/org/eclipse/swt/graphics/DeviceData.java;3;1;4;1;2;2;2;2;6;1;2;106;14;14;1;0;0;2;4;106;0;4701;4;3;
/org.eclipse.scripting/src/org/eclipse/scripting/internal/uirenderer/XGRElementUISwtPreferenceDialog.java;1;0;1;1;0;0;0;1;0;0;1;1424;0;0;1;0;0;1;1;1424;0;1424;1;1;
/org.eclipse.core.tests.runtime/src/org/eclipse/core/tests/internal/plugins/FragmentResolveTest_7.java;3;0;4;1;0;0;0;4;746;1;4;1819;763;763;1;0;0;4;4;1819;0;3476;4;3;
/org.eclipse.pde.ui/src/org/eclipse/pde/internal/builders/FeatureConsistencyChecker.java;1;0;5;1;0;0;0;5;16;2;4;2951;28;28;2;1;0;5;5;2951;1;3579;4;1;
/org.eclipse.pde.ui/src/org/eclipse/pde/internal/editor/manifest/ManifestEditorContributor.java;2;0;2;1;0;0;0;2;0;1;2;1434;0;0;1;0;0;2;2;1434;0;3579;2;2;
/org.eclipse.jdt.ui/ui/org/eclipse/jdt/internal/ui/search/FindImplementorsAction.java;2;2;12;1;4;3;4;8;34;1;8;15;93;93;2;0;1;8;12;4140;1;4140;11;2;
/org.eclipse.jdt.debug/eval/org/eclipse/jdt/internal/debug/eval/ast/engine/RightShiftAssignmentOperator.java;1;0;2;1;0;0;0;2;0;1;2;3329;0;0;1;0;0;2;2;3329;0;3421;2;1;
/org.eclipse.vcm.core/src/org/eclipse/vcm/internal/core/HackFinder.java;2;0;3;1;0;0;0;3;4;1;3;0;4;4;1;0;0;3;3;0;0;413;3;2;
/org.eclipse.jdt.ui.tests.refactoring/resources/ExtractMethodWorkSpace/ExtractMethodTests/locals_out/A_test512.java;2;1;5;1;2;2;2;3;17;1;3;296;25;25;1;0;0;3;5;296;0;4419;5;2;
/org.eclipse.jdt.core/dom/org/eclipse/jdt/core/dom/SuperFieldAccess.java;2;1;6;1;2;2;2;4;14;1;4;2669;42;42;1;0;0;4;6;2669;0;4453;6;2;
/org.eclipse.jdt.ui/ui/org/eclipse/jdt/internal/ui/browsing/ProjectAndSourceFolderContentProvider.java;1;0;2;1;1;1;1;1;2;0;1;2878;2;2;1;0;0;1;2;2878;0;4020;2;1;
/org.eclipse.ui/Eclipse UI/org/eclipse/ui/internal/WorkbenchPartReference.java;1;1;3;1;3;3;3;0;47;0;0;4063;48;48;1;0;0;0;3;4063;0;4604;3;1;
/org.eclipse.help.ui/src/org/eclipse/help/internal/ui/IBrowserFactory.java;2;0;3;1;0;0;0;3;5;1;3;1420;5;5;1;0;0;3;3;1420;0;3030;3;2;
/org.eclipse.team.core/src/org/eclipse/team/internal/core/streams/PollingInputStream.java;1;0;1;1;1;1;1;0;0;0;0;4169;0;0;1;0;0;0;1;4169;0;4169;1;1;
/org.eclipse.ui/Eclipse UI/org/eclipse/ui/internal/ClearWorkingSetAction.java;1;0;2;1;1;1;1;1;0;0;1;3494;0;0;1;0;0;1;2;3494;0;3940;2;1;
/org.eclipse.jdt.core/model/org/eclipse/jdt/internal/core/hierarchy/RegionBasedTypeHierarchy.java;3;1;8;1;2;2;2;6;144;1;6;455;250;250;1;0;0;6;8;455;0;4590;8;3;
/org.eclipse.debug.ui/ui/org/eclipse/debug/internal/ui/RelaunchHistoryLaunchAction.java;3;0;7;1;0;0;0;7;13;2;6;187;34;34;2;1;0;7;7;1885;1;2382;6;3;
/org.eclipse.jdt.ui/core refactoring/org/eclipse/jdt/core/refactoring/types/SafeDeleteTypeRefactoring.java;1;0;2;1;0;0;0;2;0;1;2;15;0;0;1;0;0;2;2;15;0;47;2;1;
/org.eclipse.jdt.ui.tests.refactoring/resources/RenamePackage/testReadOnly/out/p1/A.java;1;0;1;1;0;0;0;1;0;0;1;1930;0;0;1;0;0;1;1;1930;0;1930;1;1;
/org.eclipse.jdt.ui/ui/org/eclipse/jdt/internal/ui/dnd/DelegatingDragAdapter.java;4;0;6;1;0;0;0;6;23;1;6;15;68;68;1;0;0;6;6;15;0;3807;6;4;
/org.eclipse.ui/Eclipse UI Standard Components/org/eclipse/ui/wizards/newresource/ResourceMessages.java;1;0;1;1;0;0;0;1;0;0;1;457;0;0;1;0;0;1;1;457;0;457;1;1;
/org.eclipse.ui/Eclipse UI/org/eclipse/ui/internal/IPreferenceConstants.java;7;2;24;2;7;6;7;17;12;2;16;457;126;126;2;1;1;17;24;3816;2;4428;22;7;
/org.eclipse.update.core/src/org/eclipse/update/configuration/IInstallDeltaHandler.java;2;1;2;1;2;2;2;0;20;0;0;3901;20;20;1;0;0;0;2;3901;0;4687;2;2;
/org.eclipse.jdt.ui.tests.refactoring/resources/RenamePackage/testFail10/in/p/p1/A.java;2;0;2;1;0;0;0;2;0;1;2;91;0;0;1;0;0;2;2;91;0;1258;2;2;
/org.eclipse.help.ui/src/org/eclipse/help/ui/internal/search/CheckboxTreeContentProvider.java;2;0;2;1;0;0;0;2;0;1;2;2429;0;0;1;0;0;2;2;2429;0;3074;2;2;
/org.eclipse.swt/Eclipse SWT/photon/org/eclipse/swt/internal/photon/PhEvent_t.java;2;0;3;1;0;0;0;3;6;1;3;106;6;6;1;0;0;3;3;106;0;2069;3;2;
/org.eclipse.team.cvs.core/src/org/eclipse/team/internal/ccvs/core/commands/Import.java;3;0;4;1;0;0;0;4;166;1;4;1978;174;174;1;0;0;4;4;1978;0;2607;4;3;
/org.eclipse.pde.ui/src/org/eclipse/pde/internal/ui/wizards/WizardTreeSelectionPage.java;1;0;1;1;0;0;0;1;0;0;1;3579;0;0;1;0;0;1;1;3579;0;3579;1;1;
/org.eclipse.jdt.ui.tests.refactoring/resources/PullUp/test3/out/A.java;1;0;1;1;0;0;0;1;0;0;1;2406;0;0;1;0;0;1;1;2406;0;2406;1;1;
/org.eclipse.pde.ui/Eclipse PDE UI/org/eclipse/pde/internal/editor/PDEFormSection.java;2;0;5;2;0;0;0;5;12;3;3;267;12;12;3;2;0;5;5;324;2;1434;3;2;
/org.eclipse.swt/Eclipse SWT/photon/org/eclipse/swt/widgets/DirectoryDialog.java;3;1;8;1;3;3;3;5;101;2;4;106;120;120;2;1;0;5;8;2064;1;4701;7;3;
/org.eclipse.jdt.core/search/org/eclipse/jdt/internal/core/index/impl/ILRUCacheable.java;2;0;3;1;1;1;1;2;15;1;2;455;27;27;1;0;0;2;3;455;0;4063;3;2;
/org.eclipse.help.ui/Eclipse Help UI/org/eclipse/help/internal/ui/ContextHelpDialog.java;3;0;17;2;0;0;0;17;108;2;13;136;382;382;2;4;0;17;17;370;4;1420;13;3;
/org.eclipse.ui/Eclipse JFace/org/eclipse/jface/viewers/IStructuredContentProvider.java;2;0;2;1;0;0;0;2;5;1;2;257;5;5;1;0;0;2;2;257;0;457;2;2;
/org.eclipse.jdt.ui.tests.refactoring/resources/RenameParameters/cannotRename/A_testFail16.java;1;0;1;1;0;0;0;1;0;0;1;233;0;0;1;0;0;1;1;233;0;233;1;1;
/org.eclipse.update.core/src/org/eclipse/update/internal/security/JarVerifier.java;2;1;24;2;5;5;5;19;315;2;15;3122;1265;1265;2;4;0;19;24;3169;4;4104;20;2;
/org.eclipse.jdt.ui.tests.refactoring/resources/ExtractMethodWorkSpace/ExtractMethodTests/return_out/A_test703.java;1;1;3;1;2;2;2;1;28;0;1;887;28;28;1;0;0;1;3;887;0;4419;3;1;
/org.eclipse.ui/Eclipse JFace Text/org/eclipse/jface/text/rules/IWordDetector.java;3;0;3;1;0;0;0;3;11;1;3;257;16;16;1;0;0;3;3;257;0;1066;3;3;
/org.eclipse.swt/Eclipse SWT Drag and Drop/motif/org/eclipse/swt/dnd/DragSource.java;3;1;8;1;5;5;5;3;238;1;3;106;601;601;1;0;0;3;8;106;0;4824;8;3;
/org.eclipse.pde.ui/src/org/eclipse/pde/internal/base/model/plugin/IPluginElement.java;2;0;3;1;0;0;0;3;8;1;3;1434;8;8;1;0;0;3;3;1434;0;3039;3;2;
/org.eclipse.update.examples/src/org/eclipse/update/examples/buildzip/ZipSiteContentProvider.java;2;0;2;1;0;0;0;2;0;1;2;2689;0;0;1;0;0;2;2;2689;0;2762;2;2;
/org.eclipse.ant.core/src/org/eclipse/ant/core/toolscripts/AntToolScript.java;1;0;3;1;0;0;0;3;3;1;3;2919;3;3;1;0;0;3;3;2919;0;2979;3;1;
/org.eclipse.update/src/org/eclipse/update/internal/ui/Installation.java;1;0;1;1;0;0;0;1;0;0;1;1424;0;0;1;0;0;1;1;1424;0;1424;1;1;
/org.eclipse.jdt.ui/core refactoring/org/eclipse/jdt/internal/corext/refactoring/util/AST.java;3;0;4;1;0;0;0;4;6;1;4;1939;8;8;1;0;0;4;4;1939;0;3357;4;3;
/org.eclipse.swt/Eclipse SWT/gtk/org/eclipse/swt/graphics/Pixbuffer.java;1;0;3;1;0;0;0;3;26;1;3;2107;26;26;1;0;0;3;3;2107;0;3252;3;1;
/org.eclipse.jdt.ui.tests.refactoring/resources/SefWorkSpace/SefTests/object_out/TestCompoundWrite.java;1;0;1;1;0;0;0;1;0;0;1;2876;0;0;1;0;0;1;1;2876;0;2876;1;1;
/org.eclipse.jdt.junit/src/org/eclipse/jdt/internal/junit/oldlauncher/IJUnitLauncherDelegate.java;2;0;2;1;0;0;0;2;0;1;2;3171;0;0;1;0;0;2;2;3171;0;3638;2;2;
/org.eclipse.debug.ui/ui/org/eclipse/debug/internal/ui/ConsoleGotoLineAction.java;2;0;4;1;0;0;0;4;33;1;4;187;38;38;1;0;0;4;4;187;0;1714;4;2;
/org.eclipse.jdt.ui/ui/org/eclipse/jdt/internal/ui/viewsupport/StandardJavaUILabelProvider.java;3;0;5;1;1;1;1;4;25;1;4;3068;42;42;1;0;0;4;5;3068;0;4018;5;3;
/org.eclipse.debug.ui/ui/org/eclipse/debug/internal/ui/actions/RunHistoryMenuAction.java;2;1;5;1;2;2;2;3;38;1;3;2382;68;68;1;0;0;3;5;2382;0;4452;5;2;
/org.eclipse.pde.ui/src/org/eclipse/pde/internal/ui/editor/manifest/ExtensionPropertySource.java;1;0;2;1;0;0;0;2;2;0;1;3579;2;2;2;1;0;2;2;3579;1;3579;1;1;
/org.eclipse.swt/Eclipse SWT/motif/org/eclipse/swt/widgets/Composite.java;6;1;29;2;6;6;6;23;243;3;19;106;1049;1049;3;4;0;23;29;1911;4;4701;25;6;
/org.eclipse.jdt.launching/launching/org/eclipse/jdt/internal/launching/ListenerList.java;1;0;1;1;1;1;1;0;0;0;0;4097;0;0;1;0;0;0;1;4097;0;4097;1;1;
/org.eclipse.pde.ui/src/org/eclipse/pde/internal/base/schema/ISchemaRepeatable.java;2;0;2;1;0;0;0;2;0;1;2;1434;0;0;1;0;0;2;2;1434;0;3579;2;2;
/org.eclipse.pde.ui/Eclipse PDE UI/org/eclipse/pde/internal/base/model/component/IComponent.java;2;0;5;2;0;0;0;5;12;3;3;267;12;12;3;2;0;5;5;324;2;1434;3;2;
/org.eclipse.ui/Eclipse JFace Text/org/eclipse/jface/text/reconciler/IReconciler.java;3;0;3;1;0;0;0;3;20;1;3;257;25;25;1;0;0;3;3;257;0;1066;3;3;
/org.eclipse.core.resources/src/org/eclipse/core/resources/ICommand.java;1;1;5;1;2;2;2;3;138;1;3;12;163;163;1;0;0;3;5;12;0;4214;5;1;
/org.eclipse.scripting/src/org/eclipse/scripting/internal/views/ScriptUIEditorModel.java;1;0;2;1;0;0;0;2;1;1;2;1424;1;1;1;0;0;2;2;1424;0;1590;2;1;
/org.eclipse.jdt.core/compiler/org/eclipse/jdt/internal/compiler/ast/ArrayReference.java;2;0;12;1;1;1;1;11;275;4;8;455;594;594;4;3;0;11;12;1039;3;4422;9;2;
/org.eclipse.scripting/src/org/eclipse/scripting/internal/uirenderer/XGRElementUISwtWizardPage.java;1;0;1;1;0;0;0;1;0;0;1;1424;0;0;1;0;0;1;1;1424;0;1424;1;1;
/org.eclipse.ui/Eclipse UI/org/eclipse/ui/internal/dialogs/PreferenceErrorDialog.java;1;0;1;1;1;1;1;0;0;0;0;4601;0;0;1;0;0;0;1;4601;0;4601;1;1;
/org.eclipse.update.ui/src/org/eclipse/update/ui/internal/model/CDROM.java;1;0;3;1;0;0;0;3;5;1;3;1905;5;5;1;0;0;3;3;1905;0;2651;3;1;
/org.eclipse.pde.build/src/org/eclipse/pde/internal/build/VersionIdentifier.java;2;0;4;1;0;0;0;4;0;1;4;2763;0;0;1;0;0;4;4;2763;0;3089;4;2;
/org.eclipse.update/src/org/eclipse/update/internal/ui/UserValidationDialog.java;1;0;1;1;0;0;0;1;0;0;1;1424;0;0;1;0;0;1;1;1424;0;1424;1;1;
/org.eclipse.debug.ui/ui/org/eclipse/debug/ui/AbstractLaunchConfigurationTabGroup.java;1;0;1;1;0;0;0;1;0;0;1;3313;0;0;1;0;0;1;1;3313;0;3313;1;1;
/org.eclipse.scripting/src/org/eclipse/scripting/internal/uirenderer/XGRXmlParserException.java;1;0;1;1;0;0;0;1;0;0;1;1424;0;0;1;0;0;1;1;1424;0;1424;1;1;
/org.eclipse.swt.tests/JUnit Tests/org/eclipse/swt/tests/junit/Test_org_eclipse_swt_custom_ViewForm.java;2;0;2;1;1;1;1;1;6;0;1;1792;6;6;1;0;0;1;2;1792;0;4706;2;2;
/org.eclipse.swt/Eclipse SWT PI/gtk/org/eclipse/swt/internal/gtk/GtkHBox.java;1;0;2;1;0;0;0;2;0;1;2;2107;0;0;1;0;0;2;2;2107;0;3209;2;1;
/org.eclipse.help.ui/src/org/eclipse/help/internal/ui/EmbeddedHelpView.java;2;0;7;1;0;0;0;7;225;1;7;1420;321;321;1;0;0;7;7;1420;0;3030;7;2;
/org.eclipse.ui/Eclipse UI Standard Components/org/eclipse/ui/views/navigator/ResourceSorter.java;4;0;4;1;1;1;1;3;271;1;3;257;280;280;1;0;0;3;4;257;0;4067;4;4;
/org.eclipse.core.tests.runtime/src/org/eclipse/core/tests/internal/registrycache/AllTests.java;3;0;3;1;0;0;0;3;34;1;3;1794;44;44;1;0;0;3;3;1794;0;3476;3;3;
/org.eclipse.jdt.ui.tests/refactoring/org/eclipse/jdt/refactoring/tests/MoveCUTests.java;4;0;13;1;0;0;0;13;271;1;13;49;337;337;1;0;0;13;13;49;0;1896;13;4;
/org.eclipse.jdt.ui/core refactoring/org/eclipse/jdt/internal/core/refactoring/SearchResultGroup.java;2;0;2;1;0;0;0;2;0;1;2;1258;0;0;1;0;0;2;2;1258;0;1939;2;2;
/org.eclipse.ui/Eclipse UI Standard Components/org/eclipse/ui/views/properties/IPropertySheetEntry.java;4;0;4;1;0;0;0;4;23;1;4;257;30;30;1;0;0;4;4;257;0;3029;4;4;
/org.eclipse.jdt.debug/jdi/org/eclipse/jdi/internal/DoubleValueImpl.java;2;0;4;1;0;0;0;4;19;1;4;187;37;37;1;0;0;4;4;187;0;3670;4;2;
/org.eclipse.jdt.ui/core refactoring/org/eclipse/jdt/internal/core/refactoring/rename/RenameParameterASTAnalyzer.java;2;0;6;1;0;0;0;6;45;2;5;1342;57;57;2;1;0;6;6;1910;1;1939;5;2;
/org.eclipse.team.cvs.core/src/org/eclipse/team/internal/ccvs/core/syncinfo/ICache.java;1;0;2;1;0;0;0;2;0;1;2;2690;0;0;1;0;0;2;2;2690;0;3125;2;1;
/org.eclipse.jdt.ui.tests.refactoring/resources/RenameVariables/canRename/A_test7_in.java;1;0;2;1;0;0;0;2;0;1;2;724;0;0;1;0;0;2;2;724;0;1665;2;1;
/org.eclipse.swt/Eclipse SWT/motif/org/eclipse/swt/widgets/Scale.java;6;1;10;1;4;4;4;6;351;1;6;106;832;832;1;0;0;6;10;106;0;4701;10;6;
/org.eclipse.update.ui/src/org/eclipse/update/internal/ui/wizards/InstallDeltaWizard.java;2;2;7;2;7;6;7;0;54;0;0;4082;112;112;2;0;1;0;7;4082;1;4348;6;2;
/org.eclipse.team.cvs.core/src/org/eclipse/team/internal/ccvs/core/client/listeners/IConsoleListener.java;1;0;1;1;0;0;0;1;0;0;1;3452;0;0;1;0;0;1;1;3452;0;3452;1;1;
/org.eclipse.jdt.core/codeassist/org/eclipse/jdt/internal/codeassist/select/SelectionOnImportReference.java;2;0;9;1;1;1;1;8;36;4;5;455;102;102;4;3;0;8;9;1039;3;4062;6;2;
/org.eclipse.pde.ui/src/org/eclipse/pde/internal/editor/schema/SchemaObjectPropertySource.java;2;0;2;1;0;0;0;2;0;1;2;1434;0;0;1;0;0;2;2;1434;0;3579;2;2;
/org.eclipse.jdt.ui/core extension/org/eclipse/jdt/internal/corext/dom/ASTNode2String.java;1;0;5;1;0;0;0;5;904;1;5;2876;932;932;1;0;0;5;5;2876;0;3870;5;1;
/org.eclipse.compare/compare/org/eclipse/compare/rangedifferencer/IRangeComparator.java;1;0;2;1;0;0;0;2;5;1;2;14;5;5;1;0;0;2;2;14;0;329;2;1;
/org.eclipse.jdt.core/dom/org/eclipse/jdt/core/dom/TypeDeclarationStatement.java;2;1;6;1;2;2;2;4;12;1;4;2669;36;36;1;0;0;4;6;2669;0;4453;6;2;
/org.eclipse.team.ftp/src/org/eclipse/team/internal/ftp/FTPProxyLocation.java;1;1;3;1;3;3;3;0;14;0;0;4169;14;14;1;0;0;0;3;4169;0;4285;3;1;
/org.eclipse.vcm.core.cvs/src/org/eclipse/vcm/internal/core/ccvs/requests/UpdatedHandler.java;4;0;5;1;0;0;0;5;14;1;5;0;28;28;1;0;0;5;5;0;0;1568;5;4;
/org.eclipse.jdt.ui/core refactoring/org/eclipse/jdt/internal/core/refactoring/rename/RenamePackageRefactoring.java;2;0;9;1;0;0;0;9;94;2;8;1342;140;140;2;1;0;9;9;1937;1;1937;8;2;
/org.eclipse.ui/Eclipse UI/org/eclipse/ui/internal/EditorPane.java;4;0;17;1;1;1;1;16;43;2;15;257;260;260;2;1;0;16;17;1828;1;4082;16;4;
/org.eclipse.jdt.ui.tests.refactoring/resources/ExtractMethodWorkSpace/ExtractMethodTests/locals_out/A_test519.java;2;1;4;1;2;2;2;2;15;1;2;511;15;15;1;0;0;2;4;511;0;4419;4;2;
/org.eclipse.jdt.ui.tests.refactoring/resources/RenameVirtualMethodInClass/test24/out/A.java;1;0;1;1;0;0;0;1;0;0;1;49;0;0;1;0;0;1;1;49;0;49;1;1;
/org.eclipse.pde.runtime/Eclipse PDE Runtime/org/eclipse/pde/internal/runtime/logview/LogViewLabelProvider.java;2;0;3;1;0;0;0;3;4;1;3;267;4;4;1;0;0;3;3;267;0;1434;3;2;
/org.eclipse.jdt.core/dom/org/eclipse/jdt/core/dom/ImportDeclaration.java;2;1;7;1;2;2;2;5;16;1;5;2669;47;47;1;0;0;5;7;2669;0;4453;7;2;
/org.eclipse.jdt.ui.tests.refactoring/resources/ExtractTemp/canExtract/A_test28_out.java;1;0;1;1;0;0;0;1;0;0;1;3121;0;0;1;0;0;1;1;3121;0;3121;1;1;
/org.eclipse.scripting/Eclipse Scripting/org/eclipse/scripting/internal/IXGRElementEventGeneratorOnKeyPress.java;1;0;3;1;0;0;0;3;4;1;3;133;4;4;1;0;0;3;3;133;0;1424;3;1;
/org.eclipse.swt/Eclipse SWT/photon/org/eclipse/swt/widgets/Decorations.java;6;1;12;1;3;3;3;9;299;2;8;106;442;442;2;1;0;9;12;3024;1;4701;11;6;
/org.eclipse.core.resources/src_ant/org/eclipse/core/resources/ant/IncrementalBuild.java;2;1;6;1;4;4;4;2;17;1;2;3509;50;50;1;0;0;2;6;3509;0;4633;6;2;
/org.eclipse.pde.core/src/org/eclipse/pde/internal/core/schema/Schema.java;1;0;4;1;0;0;0;4;8;1;4;3591;19;19;1;0;0;4;4;3591;0;3798;4;1;
/org.eclipse.jdt.debug/jdi interfaces/com/sun/jdi/request/ClassPrepareRequest.java;2;0;2;1;0;0;0;2;8;1;2;2704;8;8;1;0;0;2;2;2704;0;3040;2;2;
/org.eclipse.jdt.core/dom/org/eclipse/jdt/core/dom/SynchronizedStatement.java;2;1;6;1;2;2;2;4;18;1;4;2669;52;52;1;0;0;4;6;2669;0;4453;6;2;
/org.eclipse.swt.tests/JUnit Tests/org/eclipse/swt/tests/junit/Test_org_eclipse_swt_widgets_ToolItem.java;2;0;2;1;1;1;1;1;6;0;1;1792;6;6;1;0;0;1;2;1792;0;4706;2;2;
/org.eclipse.jdt.ui/ui/org/eclipse/jdt/internal/ui/launcher/VMWizardPage.java;1;0;8;1;0;0;0;8;76;2;7;15;106;106;2;1;0;8;8;218;1;394;7;1;
/org.eclipse.vcm.ui/src/org/eclipse/vcm/internal/ui/VersionResourcesOperation.java;4;0;4;2;0;0;0;4;61;2;3;1;70;70;2;1;0;4;4;295;1;1794;3;4;
/org.eclipse.vcm.core/src/org/eclipse/vcm/internal/core/adapter/IServerResource.java;3;0;3;1;0;0;0;3;26;1;3;0;32;32;1;0;0;3;3;0;0;297;3;3;
/org.eclipse.pde.ui/src/org/eclipse/pde/internal/model/build/BuildModelFactory.java;2;0;3;1;0;0;0;3;4;1;3;1434;4;4;1;0;0;3;3;1434;0;3579;3;2;
/org.eclipse.jdt.ui/core refactoring/org/eclipse/jdt/internal/core/refactoring/changes/MoveResourceChange.java;2;0;3;1;0;0;0;3;25;1;3;1108;25;25;1;0;0;3;3;1108;0;1939;3;2;
/org.eclipse.scripting/src/org/eclipse/scripting/internal/uirenderer/XGRElementUISwtList.java;1;0;1;1;0;0;0;1;0;0;1;1424;0;0;1;0;0;1;1;1424;0;1424;1;1;
/org.eclipse.jdt.core/compiler/org/eclipse/jdt/internal/compiler/util/Util.java;2;1;18;1;2;2;2;16;487;4;12;635;914;914;4;4;0;16;18;1039;4;4062;14;2;
/org.eclipse.jdt.ui.tests.refactoring/resources/RenameType/testFail66/in/A.java;1;0;1;1;0;0;0;1;0;0;1;49;0;0;1;0;0;1;1;49;0;49;1;1;
/org.eclipse.team.ui/src/org/eclipse/team/internal/ui/target/SiteRootsElement.java;3;2;8;1;8;7;8;0;29;0;0;4164;99;99;2;0;1;0;8;4448;1;4636;7;3;
/org.eclipse.swt/Eclipse SWT/common/org/eclipse/swt/internal/image/JPEGVariableSizeSegment.java;2;0;3;1;1;1;1;2;6;1;2;106;10;10;1;0;0;2;3;106;0;4701;3;2;
/org.eclipse.scripting/Eclipse Scripting/org/eclipse/scripting/internal/datamodels/XGRXmlElementsAndAttributesSaxHandler.java;2;0;4;1;0;0;0;4;4;1;4;133;6;6;1;0;0;4;4;133;0;1424;4;2;
/org.eclipse.update/Eclipse Update/org/eclipse/update/internal/core/UpdateManagerStrings.java;2;0;4;1;0;0;0;4;4;1;4;108;6;6;1;0;0;4;4;108;0;1424;4;2;
/org.eclipse.update.ui.forms/src/org/eclipse/update/ui/forms/internal/TableLayoutTest.java;1;0;5;1;0;0;0;5;101;3;3;2470;104;104;3;2;0;5;5;2745;2;3667;3;1;
/org.eclipse.pde.ui/Eclipse PDE UI/org/eclipse/pde/internal/schema/SchemaSimpleType.java;2;0;5;2;0;0;0;5;12;3;3;267;12;12;3;2;0;5;5;324;2;1434;3;2;
/org.eclipse.jdt.debug.ui/ui/org/eclipse/jdt/internal/debug/ui/snippeteditor/SnippetEditorPropertyPage.java;3;1;9;1;9;9;9;0;83;0;0;4046;147;147;1;0;0;0;9;4046;0;4423;9;3;
/org.eclipse.jdt.ui.tests.refactoring/resources/ExtractMethodWorkSpace/ExtractMethodTests/invalidSelection/A_test022.java;2;1;3;1;2;2;2;1;0;0;1;49;0;0;1;0;0;1;3;49;0;4419;3;2;
/org.eclipse.jdt.ui.tests.refactoring/resources/ExtractMethodWorkSpace/ExtractMethodTests/expression_in/A_test612.java;1;1;4;1;2;2;2;2;2;1;2;1236;2;2;1;0;0;2;4;1236;0;4419;4;1;
/org.eclipse.scripting/src/org/eclipse/scripting/internal/views/ScriptUIEditorPartitionScanner.java;1;0;1;1;0;0;0;1;0;0;1;1424;0;0;1;0;0;1;1;1424;0;1424;1;1;
/org.eclipse.help/src/org/eclipse/help/internal/contributors/xml1_0/ContributionParser.java;1;0;2;1;0;0;0;2;0;1;2;1675;0;0;1;0;0;2;2;1675;0;2217;2;1;
/org.eclipse.webdav/src/kernel/org/eclipse/webdav/internal/kernel/RedirectionException.java;1;0;4;1;1;1;1;3;82;1;3;12;102;102;1;0;0;3;4;12;0;4211;4;1;
/org.eclipse.jdt.ui/ui/org/eclipse/jdt/internal/ui/util/AllTypesSearchEngine.java;3;0;10;1;0;0;0;10;83;2;8;15;105;105;2;2;0;10;10;326;2;3069;8;3;
/org.eclipse.swt/Eclipse SWT Drag and Drop/motif/org/eclipse/swt/dnd/TableDragUnderEffect.java;3;1;6;1;2;2;2;4;65;1;4;106;130;130;1;0;0;4;6;106;0;4701;6;3;
/org.eclipse.help/src/org/eclipse/help/IHelpResource.java;2;0;9;1;0;0;0;9;22;1;9;1694;52;52;1;0;0;9;9;1694;0;3697;9;2;
/org.eclipse.jdt.debug.ui/ui/org/eclipse/jdt/internal/debug/ui/launcher/JavaMainTab.java;4;1;32;3;7;7;7;25;287;2;22;2586;1049;1049;2;3;0;25;32;3085;3;4098;29;4;
/org.eclipse.ui.tests/Eclipse UI Tests/org/eclipse/ui/tests/api/EmptyPerspective2.java;1;0;2;1;0;0;0;2;0;1;2;983;0;0;1;0;0;2;2;983;0;1038;2;1;
/org.eclipse.jdt.ui/nls/org/eclipse/jdt/internal/ui/nls/search/INLSSearchUIConstants.java;1;0;2;1;0;0;0;2;0;1;2;1880;0;0;1;0;0;2;2;1880;0;1913;2;1;
/org.eclipse.update.core/src/org/eclipse/update/core/ILocalSiteChangedListener.java;1;0;5;1;0;0;0;5;6;1;5;1863;6;6;1;0;0;5;5;1863;0;3018;5;1;
/org.eclipse.jdt.ui.tests.refactoring/resources/RenameType/testFail72/in/A.java;1;0;1;1;0;0;0;1;0;0;1;49;0;0;1;0;0;1;1;49;0;49;1;1;
/org.eclipse.pde.ui/src/org/eclipse/pde/internal/ui/editor/manifest/LibrarySection.java;1;0;4;1;0;0;0;4;15;2;3;3579;19;19;2;1;0;4;4;3579;1;3720;3;1;
/org.eclipse.pde.core/src/org/eclipse/pde/core/plugin/IMatchRules.java;1;0;3;1;2;1;2;1;68;0;1;3591;68;68;2;0;1;1;3;4751;1;4751;2;1;
/org.eclipse.pde.ui/Eclipse PDE UI/org/eclipse/pde/internal/builders/ExtensionPointSchemaBuilder.java;2;0;7;2;0;0;0;7;12;3;5;267;22;22;3;2;0;7;7;324;2;1434;5;2;
/org.eclipse.jdt.ui/core refactoring/org/eclipse/jdt/core/refactoring/cus/RenameCompilationUnitRefactoring.java;1;0;7;1;0;0;0;7;53;2;6;130;99;99;2;1;0;7;7;130;1;408;6;1;
/org.eclipse.ant.core/src/org/eclipse/ant/internal/core/old/RefreshLocal.java;1;0;1;1;0;0;0;1;0;0;1;3270;0;0;1;0;0;1;1;3270;0;3270;1;1;
/org.eclipse.jdt.core/search/org/eclipse/jdt/internal/core/search/matching/TypeDeclarationPattern.java;3;0;15;1;1;1;1;14;960;4;10;455;2163;2163;4;4;0;14;15;1039;4;4063;11;3;
/org.eclipse.jdt.ui/ui/org/eclipse/jdt/internal/ui/viewsupport/ProblemMarkerFilter.java;1;0;3;1;0;0;0;3;4;1;3;1035;4;4;1;0;0;3;3;1035;0;1256;3;1;
/org.eclipse.jdt.ui.tests.refactoring/resources/SelectionAnalyzerWorkSpace/SelectionAnalyzerTests/invalidSelection/A_test011.java;1;0;1;1;0;0;0;1;0;0;1;1368;0;0;1;0;0;1;1;1368;0;1368;1;1;
/org.eclipse.jdt.ui.tests/ui/org/eclipse/jdt/ui/tests/text/PartitionTokenScannerTest.java;1;0;1;1;1;1;1;0;0;0;0;3892;0;0;1;0;0;0;1;3892;0;3892;1;1;
/org.eclipse.ui.examples.readmetool/Eclipse UI Examples Readme Tool/org/eclipse/ui/examples/readmetool/ReadmeSectionsView.java;2;0;2;1;0;0;0;2;2;1;2;932;2;2;1;0;0;2;2;932;0;3029;2;2;
/org.eclipse.pde.ui/src/org/eclipse/pde/internal/ui/wizards/templates/ChoiceOption.java;1;0;3;1;0;0;0;3;3;1;3;3579;3;3;1;0;0;3;3;3579;0;3840;3;1;
/org.eclipse.jdt.ui.tests.refactoring/resources/RenameType/testFail20/in/A.java;1;0;1;1;0;0;0;1;0;0;1;49;0;0;1;0;0;1;1;49;0;49;1;1;
/org.eclipse.jdt.ui.tests.refactoring/resources/ExtractMethodWorkSpace/ExtractMethodTests/invalidSelection/A_test114.java;2;1;3;1;2;2;2;1;0;0;1;49;0;0;1;0;0;1;3;49;0;4419;3;2;
/org.eclipse.jdt.core/eval/org/eclipse/jdt/internal/eval/CodeSnippetAllocationExpression.java;2;0;6;1;1;1;1;5;270;1;5;455;305;305;1;0;0;5;6;455;0;4062;6;2;
/org.eclipse.pde.ui/src/org/eclipse/pde/internal/wizards/project/ProjectStructurePage.java;2;0;10;1;0;0;0;10;380;2;9;1434;438;438;2;1;0;10;10;2691;1;3579;9;2;
/org.eclipse.pde.ui/templates/view/java/SampleAction.java;1;0;2;1;0;0;0;2;0;1;2;3278;0;0;1;0;0;2;2;3278;0;3388;2;1;
/org.eclipse.swt.tests/JUnit Tests/org/eclipse/swt/tests/junit/Test_org_eclipse_swt_widgets_Sash.java;2;0;2;1;1;1;1;1;6;0;1;1792;6;6;1;0;0;1;2;1792;0;4706;2;2;
/org.eclipse.jdt.ui.tests.refactoring/resources/RenameTemp/canRename/A_test39_out.java;1;0;1;1;0;0;0;1;0;0;1;3229;0;0;1;0;0;1;1;3229;0;3229;1;1;
/org.eclipse.scripting/Eclipse Scripting/org/eclipse/scripting/internal/uirenderer/XGRElementUISwtTableData.java;2;0;4;1;0;0;0;4;21;1;4;133;25;25;1;0;0;4;4;133;0;1424;4;2;
/org.eclipse.jdt.ui.tests.refactoring/test cases/org/eclipse/jdt/ui/tests/refactoring/infra/MockUnifiedSite.java;2;0;2;1;0;0;0;2;0;1;2;3739;0;0;1;0;0;2;2;3739;0;3826;2;2;
/org.eclipse.team.tests.cvs.core/src/org/eclipse/team/tests/ccvs/core/ICVSClient.java;1;0;2;1;1;1;1;1;10;0;1;3873;10;10;1;0;0;1;2;3873;0;4545;2;1;
/org.eclipse.ui/Eclipse UI Standard Components/org/eclipse/ui/views/properties/DefaultsAction.java;4;0;4;1;0;0;0;4;7;1;4;257;11;11;1;0;0;4;4;257;0;3029;4;4;
/org.eclipse.swt.tests/JUnit Tests/org/eclipse/swt/tests/junit/Test_org_eclipse_swt_widgets_ColorDialog.java;2;0;2;1;1;1;1;1;6;0;1;1792;6;6;1;0;0;1;2;1792;0;4706;2;2;
/org.eclipse.update.core/src/org/eclipse/update/internal/core/URLEncoder.java;2;1;4;1;2;2;2;2;6;1;2;2743;13;13;1;0;0;2;4;2743;0;4127;4;2;
/org.eclipse.jdt.ui.tests.refactoring/resources/ExtractMethodWorkSpace/ExtractMethodTests/locals_out/A_test555.java;1;1;4;1;2;2;2;2;38;1;2;1236;40;40;1;0;0;2;4;1236;0;4419;4;1;
/org.eclipse.vcm.tests.core/src/org/eclipse/vcm/tests/core/base/ISyncInfoTest.java;1;0;1;1;0;0;0;1;0;0;1;1688;0;0;1;0;0;1;1;1688;0;1688;1;1;
/org.eclipse.jdt.ui/ui/org/eclipse/jdt/internal/ui/text/template/TemplateVariableProposal.java;1;0;2;1;0;0;0;2;33;1;2;1929;33;33;1;0;0;2;2;1929;0;2784;2;1;
/org.eclipse.jdt.debug/eval/org/eclipse/jdt/internal/debug/eval/ast/EvaluationArray.java;1;0;3;1;0;0;0;3;122;1;3;3329;122;122;1;0;0;3;3;3329;0;3421;3;1;
/org.eclipse.swt/Eclipse SWT/win32/org/eclipse/swt/internal/win32/WNDCLASS.java;2;0;3;1;0;0;0;3;19;1;3;1507;19;19;1;0;0;3;3;1507;0;2069;3;2;
/org.eclipse.jdt.core/search/org/eclipse/jdt/internal/core/search/indexing/RemoveFromIndex.java;3;1;17;1;3;3;3;14;72;4;10;455;248;248;4;4;0;14;17;1039;4;4525;13;3;
/org.eclipse.jdt.junit/Eclipse JUnit/org/eclipse/jdt/junit/internal/util/IDialogTestPass.java;2;0;2;1;0;0;0;2;0;1;2;1511;0;0;1;0;0;2;2;1511;0;1996;2;2;
/org.eclipse.pde.core/src/org/eclipse/pde/core/IIdentifiable.java;1;0;3;1;2;1;2;1;30;0;1;3591;30;30;2;0;1;1;3;4751;1;4751;2;1;
/org.eclipse.jdt.debug.ui/ui/org/eclipse/jdt/internal/debug/ui/actions/ManageWatchpointActionDelegate.java;3;2;10;2;10;9;10;0;41;0;0;4025;148;148;2;0;1;0;10;4391;1;4688;9;3;
/org.eclipse.team.cvs.ui/src/org/eclipse/team/internal/ccvs/ui/actions/ReplaceWithAction.java;3;0;8;1;0;0;0;8;51;1;8;2806;134;134;1;0;0;8;8;2806;0;3760;8;3;
/org.eclipse.vcm.core.cvs/src/org/eclipse/vcm/internal/core/ccvs/utils/StreamUtil.java;5;0;6;1;0;0;0;6;44;1;6;0;56;56;1;0;0;6;6;0;0;1564;6;5;
/org.eclipse.jdt.debug.tests/tests/org/eclipse/jdt/debug/tests/eval/QualifiedStaticFieldValueTests.java;2;1;3;1;3;3;3;0;17;0;0;4447;19;19;1;0;0;0;3;4447;0;4571;3;2;
/org.eclipse.pde.ui/src/org/eclipse/pde/internal/base/schema/IDocumentSection.java;2;0;2;1;0;0;0;2;0;1;2;1434;0;0;1;0;0;2;2;1434;0;3579;2;2;
/org.eclipse.ui.tests/Eclipse JFace Tests/org/eclipse/jface/tests/viewers/interactive/SetLabelProviderAction.java;1;0;1;1;0;0;0;1;0;0;1;1488;0;0;1;0;0;1;1;1488;0;1488;1;1;
/org.eclipse.core.tests.resources/src/org/eclipse/core/tests/internal/properties/AllTests.java;3;0;3;1;0;0;0;3;44;1;3;1794;49;49;1;0;0;3;3;1794;0;3420;3;3;
/org.eclipse.help/src/org/eclipse/help/internal/search/QueryWordsPhrase.java;2;0;2;1;0;0;0;2;17;1;2;3186;17;17;1;0;0;2;2;3186;0;3211;2;2;
/org.eclipse.webdav/src/client/org/eclipse/webdav/internal/authentication/DigestAuthority.java;4;0;7;1;1;1;1;6;1274;1;6;12;2423;2423;1;0;0;6;7;12;0;4211;7;4;
/org.eclipse.ui/Eclipse UI/org/eclipse/ui/dialogs/ElementListSelectionDialog.java;1;0;2;1;0;0;0;2;5;1;2;3733;5;5;1;0;0;2;2;3733;0;3740;2;1;
/org.eclipse.jdt.ui/ui/org/eclipse/jdt/internal/ui/javaeditor/JavaSelectRulerAction.java;1;0;1;1;1;1;1;0;0;0;0;4466;0;0;1;0;0;0;1;4466;0;4466;1;1;
/org.eclipse.ui.externaltools/External Tools/org/eclipse/ui/externaltools/internal/ui/LogConsoleDocument.java;1;3;8;1;8;6;8;0;116;0;0;4090;274;274;3;0;2;0;8;4164;2;4404;6;1;
/org.eclipse.core.tests.runtime/src/org/eclipse/core/tests/internal/runtimetests/SampleMFR.java;1;0;2;1;0;0;0;2;10;1;2;3611;10;10;1;0;0;2;2;3611;0;3678;2;1;
/org.eclipse.jdt.debug/model/org/eclipse/jdt/internal/debug/core/hcr/JavaHotCodeReplaceManager.java;3;1;30;2;3;3;3;27;598;3;19;2517;1491;1491;3;8;0;27;30;2517;8;4423;22;3;
/org.eclipse.jdt.ui/ui/org/eclipse/jdt/internal/ui/wizards/buildpaths/SourceContainerWorkbookPage.java;4;1;27;1;5;5;5;22;98;2;21;15;561;561;2;1;0;22;27;1254;1;4450;26;4;
/org.eclipse.jdt.debug/jdi interfaces/com/sun/jdi/request/ClassUnloadRequest.java;2;0;2;1;0;0;0;2;6;1;2;2704;6;6;1;0;0;2;2;2704;0;3040;2;2;
/org.eclipse.jdt.debug.tests/tests/org/eclipse/jdt/debug/tests/eval/generator/OtherTestsGenerator.java;2;2;3;2;3;2;3;0;120;0;0;4453;120;120;2;0;1;0;3;4568;1;4568;2;2;
/org.eclipse.jdt.ui/core refactoring/org/eclipse/jdt/internal/corext/refactoring/AbstractJavaElementRenameChange.java;2;0;3;1;1;1;1;2;2;1;2;1939;4;4;1;0;0;2;3;1939;0;4379;3;2;
/org.eclipse.jdt.core/model/org/eclipse/jdt/internal/core/builder/impl/ZipNode.java;1;0;10;1;0;0;0;10;87;4;6;455;105;105;4;4;0;10;10;1039;4;2808;6;1;
/org.eclipse.update.ui/src/org/eclipse/update/internal/ui/manager/DetailsHistory.java;1;0;7;1;0;0;0;7;38;1;7;1562;79;79;1;0;0;7;7;1562;0;3662;7;1;
/org.eclipse.core.resources/src/org/eclipse/core/internal/events/ResourceComparator.java;3;0;8;1;1;1;1;7;280;1;7;12;336;336;1;0;0;7;8;12;0;4214;8;3;
/org.eclipse.jdt.ui/core refactoring/org/eclipse/jdt/internal/corext/refactoring/code/flow/FlowContext.java;1;0;4;1;0;0;0;4;51;1;4;1939;106;106;1;0;0;4;4;1939;0;3106;4;1;
/org.eclipse.jdt.ui.tests.refactoring/resources/SelectionAnalyzerWorkSpace/SelectionAnalyzerTests/invalidSelection/A_test063.java;1;0;2;1;0;0;0;2;2;1;2;1368;2;2;1;0;0;2;2;1368;0;2327;2;1;
/org.eclipse.jdt.ui.tests.refactoring/resources/RenameVariables/cannotRename/A_testFail0.java;1;0;2;1;0;0;0;2;0;1;2;724;0;0;1;0;0;2;2;724;0;1665;2;1;
/org.eclipse.pde.ui/src/org/eclipse/pde/internal/PluginProfile.java;1;0;2;1;0;0;0;2;0;1;2;2650;0;0;1;0;0;2;2;2650;0;2691;2;1;
/org.eclipse.jdt.debug.tests/testprograms/MethodLoop.java;2;1;2;1;2;2;2;0;11;0;0;4310;11;11;1;0;0;0;2;4310;0;4571;2;2;
/org.eclipse.jdt.ui.tests.refactoring/resources/ExtractMethodWorkSpace/ExtractMethodTests/locals_in/A_test558.java;1;1;3;1;2;2;2;1;24;0;1;1236;24;24;1;0;0;1;3;1236;0;4419;3;1;
/org.eclipse.jdt.ui.tests.refactoring/resources/DeleteSourceReferenceEdit/A_testField2_out.java;1;0;1;1;0;0;0;1;0;0;1;2857;0;0;1;0;0;1;1;2857;0;2857;1;1;
/org.eclipse.jdt.ui.tests.refactoring/resources/RenameType/testFail31/in/A.java;1;0;1;1;0;0;0;1;0;0;1;49;0;0;1;0;0;1;1;49;0;49;1;1;
/org.eclipse.jdt.ui.tests.refactoring/resources/RenamePrivateMethod/test11/out/A.java;1;0;1;1;0;0;0;1;0;0;1;49;0;0;1;0;0;1;1;49;0;49;1;1;
/org.eclipse.ui/Eclipse JFace/org/eclipse/jface/viewers/Decoration.java;1;0;2;1;0;0;0;2;0;1;2;3404;0;0;1;0;0;2;2;3404;0;3415;2;1;
/org.eclipse.update.core/src/org/eclipse/update/core/PluginEntry.java;2;0;8;1;1;1;1;7;55;1;7;2449;125;125;1;0;0;7;8;2449;0;4102;8;2;
/org.eclipse.swt/Eclipse SWT Custom Widgets/common/org/eclipse/swt/custom/LineBackgroundListener.java;4;0;6;1;1;1;1;5;7;1;5;106;25;25;1;0;0;5;6;106;0;4701;6;4;
/org.eclipse.jdt.ui/core refactoring/org/eclipse/jdt/internal/core/refactoring/rename/RenameTempOccurrenceOffsetFinder.java;2;0;2;1;0;0;0;2;0;1;2;1665;0;0;1;0;0;2;2;1665;0;1939;2;2;
/org.eclipse.jdt.debug/jdi/org/eclipse/jdi/internal/jdwp/JdwpCommandPacket.java;3;0;6;1;0;0;0;6;12;1;6;187;35;35;1;0;0;6;6;187;0;3670;6;3;
/org.eclipse.help/src/org/eclipse/help/internal/util/TString.java;2;0;2;1;0;0;0;2;59;1;2;1420;59;59;1;0;0;2;2;1420;0;1675;2;2;
/org.eclipse.pde.ui/Eclipse PDE UI/org/eclipse/pde/internal/base/schema/ISchemaCompositor.java;2;0;5;2;0;0;0;5;12;3;3;267;12;12;3;2;0;5;5;324;2;1434;3;2;
/org.eclipse.vcm.ui/src/org/eclipse/vcm/internal/ui/actions/GlobalSyncAction.java;2;0;2;1;0;0;0;2;0;1;2;1;0;0;1;0;0;2;2;1;0;161;2;2;
/org.eclipse.swt.examples.paint/src/org/eclipse/swt/examples/paint/RectangleTool.java;4;0;5;2;1;1;1;4;91;2;3;513;101;101;2;1;0;4;5;609;1;4705;4;4;
/org.eclipse.core.tests.runtime/src/org/eclipse/core/tests/internal/runtimetests/SampleFFB.java;1;0;3;1;0;0;0;3;10;2;2;3605;13;13;2;1;0;3;3;3605;1;3678;2;1;
/org.eclipse.jdt.debug/model/org/eclipse/jdt/internal/debug/core/model/JDIVoidValue.java;2;0;2;2;0;0;0;2;6;0;1;2517;6;6;2;1;0;2;2;2517;1;2517;1;2;
/org.eclipse.jdt.ui/core refactoring/org/eclipse/jdt/internal/core/refactoring/base/Refactoring.java;4;0;11;1;0;0;0;11;28;1;11;408;90;90;1;0;0;11;11;408;0;1939;11;4;
/org.eclipse.pde.ui/src/org/eclipse/pde/internal/ui/wizards/project/ConvertedProjectWizard.java;1;0;1;1;0;0;0;1;0;0;1;3579;0;0;1;0;0;1;1;3579;0;3579;1;1;
/org.eclipse.jdt.core/compiler/org/eclipse/jdt/internal/compiler/classfmt/InnerClassInfo.java;2;0;13;1;1;1;1;12;202;4;8;455;287;287;4;4;0;12;13;1039;4;4062;9;2;
/org.eclipse.ui.tests/Eclipse UI Tests/org/eclipse/ui/tests/api/SessionPerspective.java;1;0;1;1;0;0;0;1;0;0;1;1066;0;0;1;0;0;1;1;1066;0;1066;1;1;
/org.eclipse.debug.ui/ui/org/eclipse/debug/internal/ui/StepIntoActionDelegate.java;3;0;7;1;0;0;0;7;42;1;7;187;69;69;1;0;0;7;7;187;0;2382;7;3;
/org.eclipse.jdt.core/model/org/eclipse/jdt/internal/core/builder/IncrementalImageBuilder.java;3;2;25;2;12;10;12;13;75;2;10;2979;314;314;2;3;2;13;25;3084;5;4607;20;3;
/org.eclipse.ui/Eclipse JFace/org/eclipse/jface/viewers/StructuredSelection.java;2;0;2;1;0;0;0;2;5;1;2;257;5;5;1;0;0;2;2;257;0;457;2;2;
/org.eclipse.jdt.ui.tests.refactoring/resources/ExtractMethodWorkSpace/ExtractMethodTests/invalidSelection/A_test043.java;2;1;3;1;2;2;2;1;0;0;1;49;0;0;1;0;0;1;3;49;0;4419;3;2;
/org.eclipse.jdt.ui.tests.refactoring/resources/ExtractMethodWorkSpace/ExtractMethodTests/invalidSelection/A_test080.java;2;1;4;1;2;2;2;2;2;1;2;49;2;2;1;0;0;2;4;49;0;4419;4;2;
/org.eclipse.update/src/org/eclipse/update/internal/core/UMSessionDefinerReferenceUpdate.java;1;0;1;1;0;0;0;1;0;0;1;1424;0;0;1;0;0;1;1;1424;0;1424;1;1;
/org.eclipse.swt/Eclipse SWT/common/org/eclipse/swt/internal/image/JPEGQuantizationTable.java;2;0;3;1;1;1;1;2;6;1;2;106;10;10;1;0;0;2;3;106;0;4701;3;2;
/org.eclipse.pde.ui/src/org/eclipse/pde/internal/editor/schema/SchemaDoubleClickStrategy.java;2;0;2;1;0;0;0;2;0;1;2;1434;0;0;1;0;0;2;2;1434;0;3579;2;2;
/org.eclipse.ui/Eclipse UI Standard Components/org/eclipse/ui/views/tasklist/ResolveMarkerAction.java;2;1;5;1;2;2;2;3;28;1;3;2497;45;45;1;0;0;3;5;2497;0;4608;5;2;
/org.eclipse.update.ui.forms/src/org/eclipse/update/ui/forms/internal/HTMLFormLabel.java;1;0;2;1;0;0;0;2;0;0;1;2745;0;0;2;1;0;2;2;2745;1;2745;1;1;
/org.eclipse.jdt.ui/core refactoring/org/eclipse/jdt/internal/corext/refactoring/code/flow/GenericSequentialFlowInfo.java;1;0;1;1;0;0;0;1;0;0;1;1939;0;0;1;0;0;1;1;1939;0;1939;1;1;
/org.eclipse.jdt.launching/launching/org/eclipse/jdt/launching/IVMRunner.java;2;1;7;2;2;2;2;5;27;2;4;2022;76;76;2;1;0;5;7;3511;1;4423;6;2;
/org.eclipse.pde.ui/src/org/eclipse/pde/internal/schema/SchemaEnumeration.java;2;0;2;1;0;0;0;2;0;1;2;1434;0;0;1;0;0;2;2;1434;0;3579;2;2;
/org.eclipse.jdt.ui/ui refactoring/org/eclipse/jdt/internal/ui/refactoring/actions/ReorderParametersActionDelegate.java;1;0;3;1;0;0;0;3;2;1;3;2270;2;2;1;0;0;3;3;2270;0;2820;3;1;
/org.eclipse.team.examples.filesystem/src/org/eclipse/team/examples/filesystem/ui/FileSystemAction.java;1;0;1;1;1;1;1;0;0;0;0;4674;0;0;1;0;0;0;1;4674;0;4674;1;1;
/org.eclipse.scripting/Eclipse Scripting/org/eclipse/scripting/internal/datamodels/XGRXmlDataNode.java;2;0;4;1;0;0;0;4;53;1;4;133;57;57;1;0;0;4;4;133;0;1424;4;2;
/org.eclipse.jdt.ui.tests.refactoring/resources/RenameVariables/cannotRename/A_testFail15.java;1;0;2;1;0;0;0;2;0;1;2;724;0;0;1;0;0;2;2;724;0;1665;2;1;
/org.eclipse.swt/Eclipse SWT/gtk1x/org/eclipse/swt/graphics/FontData.java;3;0;3;1;1;1;1;2;6;1;2;2107;11;11;1;0;0;2;3;2107;0;4701;3;3;
/org.eclipse.ui/Eclipse JFace Text/org/eclipse/jface/text/rules/IWhitespaceDetector.java;3;0;3;1;0;0;0;3;5;1;3;257;7;7;1;0;0;3;3;257;0;1066;3;3;
/org.eclipse.swt/Eclipse SWT/photon/org/eclipse/swt/widgets/Tracker.java;7;2;17;2;5;4;5;12;424;2;11;106;935;935;2;1;1;12;17;2064;2;4701;15;7;
/org.eclipse.swt.examples.controls/org/eclipse/swt/examples/controls/ShellTab.java;2;0;3;1;0;0;0;3;217;1;3;513;217;217;1;0;0;3;3;513;0;970;3;2;
/org.eclipse.help.ui/src/org/eclipse/help/internal/ui/StyledLineWrapper.java;2;0;7;1;1;1;1;6;126;1;6;1420;150;150;1;0;0;6;7;1420;0;4439;7;2;
/org.eclipse.core.resources/src/org/eclipse/core/internal/resources/Project.java;5;1;46;2;3;3;3;43;1587;3;38;12;3281;3281;3;5;0;43;46;38;5;4692;41;5;
/org.eclipse.jdt.debug/jdi/org/eclipse/jdi/internal/jdwp/JdwpThreadID.java;2;0;3;1;0;0;0;3;5;1;3;187;8;8;1;0;0;3;3;187;0;3040;3;2;
/org.eclipse.jdt.debug.tests/tests/org/eclipse/jdt/debug/tests/eval/StringPlusAssignmentOpTests.java;2;1;3;1;3;3;3;0;18;0;0;4447;20;20;1;0;0;0;3;4447;0;4571;3;2;
/org.eclipse.update.core/src/org/eclipse/update/core/ISiteContentConsumer.java;2;0;3;1;0;0;0;3;67;1;3;2465;67;67;1;0;0;3;3;2465;0;3018;3;2;
/org.eclipse.team.cvs.ui/src/org/eclipse/team/internal/ccvs/ui/RepositoryMappingListener.java;1;0;1;1;1;1;1;0;0;0;0;4663;0;0;1;0;0;0;1;4663;0;4663;1;1;
/org.eclipse.core.tests.runtime/src/org/eclipse/core/tests/runtime/QualifiedNameTest.java;3;0;3;1;0;0;0;3;254;1;3;1794;264;264;1;0;0;3;3;1794;0;3476;3;3;
/org.eclipse.pde.ui/src/org/eclipse/pde/internal/ui/launcher/AdvancedLauncherTab.java;1;2;14;1;9;7;9;5;163;2;4;3579;492;492;2;1;2;5;14;3579;3;4633;11;1;
/org.eclipse.jdt.core/model/org/eclipse/jdt/internal/core/util/ExceptionAttribute.java;3;2;7;2;5;3;5;2;18;0;1;3629;51;51;2;1;2;2;7;3629;3;4421;4;3;
/org.eclipse.ui/Eclipse UI/org/eclipse/ui/actions/GlobalBuildAction.java;4;1;5;1;3;3;3;2;69;1;2;2779;112;112;1;0;0;2;5;2779;0;4429;5;4;
/org.eclipse.swt/Eclipse SWT/motif/org/eclipse/swt/widgets/Widget.java;11;3;24;2;8;6;8;16;636;1;16;106;1700;1700;3;0;2;16;24;4606;2;4701;22;11;
/org.eclipse.help/src/org/eclipse/help/internal/contributors/xml1_0/HelpContributionManager.java;2;0;3;1;0;0;0;3;3;1;3;1675;3;3;1;0;0;3;3;1675;0;2217;3;2;
/org.eclipse.jdt.ui.tests/JUnit/junit/framework/TestSuite.java;2;0;2;1;0;0;0;2;0;1;2;49;0;0;1;0;0;2;2;49;0;1186;2;2;
/org.eclipse.pde.ui/src/org/eclipse/pde/internal/ui/view/PluginsView.java;1;0;4;1;1;1;1;3;25;1;3;3579;31;31;1;0;0;3;4;3579;0;4167;4;1;
/org.eclipse.jdt.ui.tests.refactoring/resources/StructureSelectionAction/A_test25.java;1;0;1;1;0;0;0;1;0;0;1;3353;0;0;1;0;0;1;1;3353;0;3353;1;1;
/org.eclipse.pde.ui/src/org/eclipse/pde/internal/IEnvironmentVariables.java;1;0;2;1;0;0;0;2;0;1;2;3113;0;0;1;0;0;2;2;3113;0;3579;2;1;
/org.eclipse.team.cvs.core/src/org/eclipse/team/internal/ccvs/core/resources/EclipseSynchronizer.java;2;1;24;2;3;3;3;21;740;3;15;3027;2398;2398;3;6;0;21;24;3417;6;4607;18;2;
/org.eclipse.update.core/src/org/eclipse/update/internal/core/FeaturePackagedFactory.java;2;1;12;1;3;3;3;9;76;3;7;2251;158;158;3;2;0;9;12;2583;2;4421;10;2;
/org.eclipse.jdt.ui.tests.refactoring/resources/ExtractMethodWorkSpace/ExtractMethodTests/validSelection/A_test248.java;2;1;4;1;2;2;2;2;51;1;2;178;59;59;1;0;0;2;4;178;0;4419;4;2;
/org.eclipse.ui/Eclipse JFace Text/org/eclipse/jface/text/contentassist/AdditionalInfoPopup.java;3;0;6;1;0;0;0;6;146;1;6;257;155;155;1;0;0;6;6;257;0;1435;6;3;
/org.eclipse.team.cvs.core/src/org/eclipse/team/internal/ccvs/core/client/listeners/IUpdateMessageListener.java;2;0;4;1;0;0;0;4;49;1;4;2572;80;80;1;0;0;4;4;2572;0;3812;4;2;
/org.eclipse.team.tests.cvs.core/src/org/eclipse/team/tests/ccvs/core/provider/CVSProviderTest.java;2;0;25;2;0;0;0;25;149;2;21;2536;432;432;2;4;0;25;25;3089;4;3610;21;2;
/org.eclipse.jdt.core/dom/org/eclipse/jdt/core/dom/LabeledStatement.java;2;1;6;1;2;2;2;4;16;1;4;2669;46;46;1;0;0;4;6;2669;0;4453;6;2;
/org.eclipse.update.ui/src/org/eclipse/update/internal/ui/parts/UpdateForm.java;1;0;5;1;0;0;0;5;10;1;5;1428;17;17;1;0;0;5;5;1428;0;3662;5;1;
/org.eclipse.jdt.core/model/org/eclipse/jdt/internal/core/util/IComparator.java;1;0;3;1;0;0;0;3;8;1;3;455;8;8;1;0;0;3;3;455;0;2811;3;1;
/org.eclipse.pde.ui/src/org/eclipse/pde/internal/wizards/extension/GenericExtensionWizard.java;2;0;4;1;0;0;0;4;4;1;4;1434;6;6;1;0;0;4;4;1434;0;3579;4;2;
/org.eclipse.jdt.ui/core refactoring/org/eclipse/jdt/internal/corext/refactoring/util/NewSelectionAnalyzer.java;3;0;9;1;0;0;0;9;15;2;8;2327;26;26;2;1;0;9;9;2621;1;3357;8;3;
/org.eclipse.webdav/src/interface/org/eclipse/webdav/dom/ResourceID.java;3;0;5;1;1;1;1;4;130;1;4;12;172;172;1;0;0;4;5;12;0;4211;5;3;
/org.eclipse.core.tests.runtime/src/org/eclipse/core/tests/internal/plugins/PluginResolveTest_6.java;4;0;4;1;0;0;0;4;106;1;4;1794;121;121;1;0;0;4;4;1794;0;3476;4;4;
/org.eclipse.pde.ui/Eclipse PDE UI/org/eclipse/pde/internal/base/model/IModelChangeProvider.java;2;0;5;2;0;0;0;5;12;3;3;267;12;12;3;2;0;5;5;324;2;1434;3;2;
/org.eclipse.jdt.debug.ui/ui/org/eclipse/jdt/internal/debug/ui/launcher/SourceLookupPropertyPage.java;2;0;5;1;1;1;1;4;5;1;4;1915;12;12;1;0;0;4;5;1915;0;3958;5;2;
/org.eclipse.jdt.ui/ui refactoring/org/eclipse/jdt/internal/ui/refactoring/actions/ExtractTempAction.java;2;0;7;1;1;1;1;6;19;1;6;2480;50;50;1;0;0;6;7;2480;0;3970;7;2;
/org.eclipse.jdt.core/compiler/org/eclipse/jdt/internal/compiler/problem/ProblemIrritants.java;1;0;17;1;0;0;0;17;36;4;14;455;115;115;4;3;0;17;17;1039;3;3071;14;1;
/org.eclipse.pde.runtime/src/org/eclipse/pde/internal/runtime/PDERuntimePluginImages.java;2;0;4;1;1;1;1;3;150;1;3;1434;174;174;1;0;0;3;4;1434;0;4556;4;2;
/org.eclipse.jdt.ui.tests.refactoring/resources/PullUpMethods/test11/out/A.java;1;0;3;1;0;0;0;3;2;1;3;2212;2;2;1;0;0;3;3;2212;0;2406;3;1;
/org.eclipse.jdt.junit/src/org/eclipse/jdt/internal/junit/ui/FailureRunView.java;2;1;6;1;4;4;4;2;11;1;2;3171;34;34;1;0;0;2;6;3171;0;4276;6;2;
/org.eclipse.pde.ui/Eclipse PDE UI/org/eclipse/pde/internal/wizards/PluginPathUpdater.java;2;0;9;2;0;0;0;9;75;3;6;267;164;164;3;3;0;9;9;324;3;1434;6;2;
/org.eclipse.jdt.ui/ui debug/org/eclipse/jdt/internal/debug/ui/JavaApplicationWizardPage.java;4;0;13;1;0;0;0;13;48;2;12;15;136;136;2;1;0;13;13;413;1;1916;12;4;
/org.eclipse.pde.ui/src/org/eclipse/pde/internal/schema/ChoiceRestriction.java;2;0;3;1;0;0;0;3;3;1;3;1434;3;3;1;0;0;3;3;1434;0;3579;3;2;
/org.eclipse.pde.ui/src/org/eclipse/pde/internal/ui/util/SWTUtil.java;1;0;2;1;1;1;1;1;67;0;1;3579;67;67;1;0;0;1;2;3579;0;4567;2;1;
/org.eclipse.jdt.ui/core refactoring/org/eclipse/jdt/internal/core/refactoring/util/Strings.java;1;0;2;1;0;0;0;2;0;0;1;1927;0;0;2;1;0;2;2;1927;1;1927;1;1;
/org.eclipse.core.tests.resources/src/org/eclipse/core/tests/resources/usecase/IProjectTest.java;3;0;3;1;0;0;0;3;530;1;3;1794;542;542;1;0;0;3;3;1794;0;3420;3;3;
/org.eclipse.jdt.ui/core refactoring/org/eclipse/jdt/internal/core/refactoring/methods/RenameParameterASTAnalyzer.java;2;0;5;1;0;0;0;5;9;1;5;408;22;22;1;0;0;5;5;408;0;1342;5;2;
/org.eclipse.pde.ui/src/org/eclipse/pde/internal/editor/component/ComponentEditorContributor.java;2;0;2;1;0;0;0;2;0;1;2;1434;0;0;1;0;0;2;2;1434;0;2951;2;2;
/org.eclipse.ui.tests/UI Test Utils/org/eclipse/ui/tests/internal/util/AccessibilityTestPass.java;1;0;1;1;0;0;0;1;0;0;1;2785;0;0;1;0;0;1;1;2785;0;2785;1;1;
/org.eclipse.pde.ui/Eclipse PDE UI/org/eclipse/pde/internal/editor/manifest/JavaAttributeWizardPage.java;2;0;8;2;0;0;0;8;31;3;6;267;57;57;3;2;0;8;8;324;2;1434;6;2;
/org.eclipse.jdt.ui/ui/org/eclipse/jdt/internal/ui/javaeditor/OrganizeImportsAction.java;6;0;20;1;0;0;0;20;113;1;20;15;320;320;1;0;0;20;20;15;0;3834;20;6;
/org.eclipse.jdt.ui.tests.refactoring/resources/ExtractMethodWorkSpace/ExtractMethodTests/validSelection/A_test247.java;2;1;3;1;2;2;2;1;0;0;1;49;0;0;1;0;0;1;3;49;0;4419;3;2;
/org.eclipse.jdt.ui/core extension/org/eclipse/jdt/internal/corext/util/TypeInfo.java;1;0;1;1;0;0;0;1;0;0;1;2820;0;0;1;0;0;1;1;2820;0;2820;1;1;
/org.eclipse.scripting/Eclipse Scripting/org/eclipse/scripting/internal/uirenderer/XGRElementUISwtTableRow.java;2;0;4;1;0;0;0;4;13;1;4;133;17;17;1;0;0;4;4;133;0;1424;4;2;
/org.eclipse.jdt.debug.tests/tests/org/eclipse/jdt/debug/tests/eval/ArrayAssignementTests.java;2;2;3;2;3;2;3;0;16;0;0;4447;18;18;2;0;1;0;3;4447;1;4571;2;2;
/org.eclipse.jdt.ui.tests.refactoring/resources/RenameMethodInInterface/test32/in/A.java;1;0;1;1;0;0;0;1;0;0;1;49;0;0;1;0;0;1;1;49;0;49;1;1;
/org.eclipse.ui.externaltools/External Tools/org/eclipse/ui/externaltools/internal/ui/AntPropertyChangeListener.java;1;1;2;1;2;2;2;0;0;0;0;4090;0;0;1;0;0;0;2;4090;0;4145;2;1;
/org.eclipse.pde.ui/src/org/eclipse/pde/internal/core/plugin/Fragment.java;1;0;3;1;0;0;0;3;13;2;2;3579;13;13;2;1;0;3;3;3579;1;3607;2;1;
/org.eclipse.jdt.ui.tests/ui/com/ibm/jdt/ui/tests/TypeRefTest.java;1;0;3;1;0;0;0;3;4;1;3;255;4;4;1;0;0;3;3;255;0;522;3;1;
/org.eclipse.webdav/src/interface/org/eclipse/webdav/dom/Prop.java;3;0;5;1;1;1;1;4;310;1;4;12;350;350;1;0;0;4;5;12;0;4211;5;3;
/org.eclipse.update.ui/src/org/eclipse/update/internal/ui/model/SiteBookmark.java;1;0;5;1;0;0;0;5;64;1;5;2797;76;76;1;0;0;5;5;2797;0;3699;5;1;
/org.eclipse.update.ui/src/org/eclipse/update/internal/ui/manager/InstallForm.java;1;0;3;1;0;0;0;3;12;2;2;1428;12;12;2;1;0;3;3;1457;1;1457;2;1;
/org.eclipse.swt/Eclipse SWT/gtk/org/eclipse/swt/widgets/Menu.java;6;3;24;2;16;13;16;8;194;2;7;2107;735;735;3;1;3;8;24;4124;4;4701;20;6;
/org.eclipse.ant.core/src/org/eclipse/ant/internal/core/old/ConvertPath.java;1;0;1;1;0;0;0;1;0;0;1;3270;0;0;1;0;0;1;1;3270;0;3270;1;1;
/org.eclipse.jdt.ui.tests.refactoring/resources/PullUp/testFail11/in/A.java;1;0;1;1;0;0;0;1;0;0;1;2406;0;0;1;0;0;1;1;2406;0;2406;1;1;
/org.eclipse.jdt.debug/eval/org/eclipse/jdt/internal/debug/eval/ast/engine/Cast.java;1;0;3;1;0;0;0;3;3;1;3;3329;3;3;1;0;0;3;3;3329;0;3421;3;1;
/org.eclipse.jdt.debug.tests/test programs/LocalVariablesTests.java;1;0;2;1;0;0;0;2;0;1;2;3701;0;0;1;0;0;2;2;3701;0;3719;2;1;
/org.eclipse.jdt.ui/core refactoring/org/eclipse/jdt/internal/corext/refactoring/reorg/DeleteSourceReferenceEdit.java;2;0;4;1;1;1;1;3;17;1;3;2310;21;21;1;0;0;3;4;2310;0;4424;4;2;
/org.eclipse.jdt.ui.tests.refactoring/resources/RenameVariables/canRename/A_test5_in.java;1;0;2;1;0;0;0;2;0;1;2;724;0;0;1;0;0;2;2;724;0;1665;2;1;
/org.eclipse.core.tests.resources/src/org/eclipse/core/tests/internal/localstore/FileSystemResourceManagerTest.java;3;0;7;1;1;1;1;6;1030;1;6;1794;1085;1085;1;0;0;6;7;1794;0;4516;7;3;
/org.eclipse.jdt.ui.tests.refactoring/resources/RenameVirtualMethodInClass/testFail27/in/A.java;1;0;1;1;0;0;0;1;0;0;1;49;0;0;1;0;0;1;1;49;0;49;1;1;
/org.eclipse.pde.ui/src/org/eclipse/pde/internal/wizards/templates/NewPluginTemplateChoiceWizard.java;1;0;2;1;0;0;0;2;0;1;2;3442;0;0;1;0;0;2;2;3442;0;3579;2;1;
/org.eclipse.compare/compare/org/eclipse/compare/internal/CompareUIPlugin.java;4;1;27;1;3;3;3;24;77;1;24;14;424;424;1;0;0;24;27;14;0;4403;27;4;
/org.eclipse.help/Eclipse Help/org/eclipse/help/internal/contributors/ContributionManager.java;2;0;3;1;0;0;0;3;7;1;3;135;7;7;1;0;0;3;3;135;0;1420;3;2;
/org.eclipse.core.resources/src/org/eclipse/core/resources/ISavedState.java;1;0;4;1;1;1;1;3;162;1;3;12;183;183;1;0;0;3;4;12;0;4214;4;1;
/org.eclipse.jdt.core/search/org/eclipse/jdt/internal/core/index/IIndex.java;2;0;2;1;1;1;1;1;17;0;1;455;17;17;1;0;0;1;2;455;0;4063;2;2;
/org.eclipse.swt/Eclipse SWT Printing/win32/org/eclipse/swt/printing/PrintDialog.java;5;2;10;1;4;3;4;6;23;1;6;106;59;59;2;0;1;6;10;4557;1;4701;9;5;
/org.eclipse.update.core/src/org/eclipse/update/core/CopyHelper.java;1;0;2;1;0;0;0;2;0;0;1;2757;0;0;2;1;0;2;2;2757;1;2757;1;1;
/org.eclipse.jdt.core/model/org/eclipse/jdt/internal/core/SearchableEnvironment.java;3;1;23;1;3;3;3;20;3390;4;15;455;5922;5922;4;5;0;20;23;1039;5;4310;18;3;
/org.eclipse.jdt.ui.tests.refactoring/resources/RenameVariables/canRename/A_test13_in.java;1;0;2;1;0;0;0;2;0;1;2;724;0;0;1;0;0;2;2;724;0;1665;2;1;
/org.eclipse.team.cvs.ui/src/org/eclipse/team/internal/ccvs/ui/RemoteFileEditorInput.java;3;0;6;1;0;0;0;6;382;1;6;1978;411;411;1;0;0;6;6;1978;0;3791;6;3;
/org.eclipse.ui/Eclipse UI/org/eclipse/ui/internal/misc/TestSelectionListener.java;2;0;2;1;0;0;0;2;6;1;2;257;6;6;1;0;0;2;2;257;0;457;2;2;
/org.eclipse.ui/Eclipse UI Standard Components/org/eclipse/ui/views/navigator/PasteAction.java;1;0;10;1;1;1;1;9;66;2;8;2830;131;131;2;1;0;9;10;3356;1;4208;9;1;
/org.eclipse.team.tests.cvs.core/src/org/eclipse/team/tests/ccvs/core/cvsresources/CVSProviderTest.java;1;0;2;1;0;0;0;2;0;1;2;3105;0;0;1;0;0;2;2;3105;0;3287;2;1;
/org.eclipse.jdt.core/search/org/eclipse/jdt/internal/core/search/matching/SearchPattern.java;3;2;36;2;4;3;4;32;2321;5;26;455;5605;5605;5;6;1;32;36;1039;7;4722;29;3;
/org.eclipse.jdt.ui/core refactoring/org/eclipse/jdt/internal/core/refactoring/methods/RenameMethodASTAnalyzer.java;2;0;4;1;0;0;0;4;11;1;4;408;15;15;1;0;0;4;4;408;0;1342;4;2;
/org.eclipse.team.cvs.core/src/org/eclipse/team/internal/ccvs/core/commands/Status.java;3;0;3;1;0;0;0;3;76;1;3;1978;76;76;1;0;0;3;3;1978;0;2607;3;3;
/org.eclipse.jdt.ui/core refactoring/org/eclipse/jdt/internal/corext/refactoring/base/StringContext.java;1;0;1;1;1;1;1;0;0;0;0;4014;0;0;1;0;0;0;1;4014;0;4014;1;1;
/org.eclipse.jdt.ui.tests.refactoring/resources/PullUp/test11/in/A.java;1;0;1;1;0;0;0;1;0;0;1;2406;0;0;1;0;0;1;1;2406;0;2406;1;1;
/org.eclipse.pde.ui/src/org/eclipse/pde/internal/core/schema/FileSchemaDescriptor.java;1;0;2;1;0;0;0;2;0;1;2;3579;0;0;1;0;0;2;2;3579;0;3607;2;1;
/org.eclipse.jdt.ui.tests.refactoring/resources/ExtractMethodWorkSpace/ExtractMethodTests/return_in/A_test711.java;1;1;3;1;2;2;2;1;24;0;1;887;24;24;1;0;0;1;3;887;0;4419;3;1;
/org.eclipse.pde.ui/src/org/eclipse/pde/internal/ui/wizards/imports/PluginImportWizard.java;1;0;1;1;0;0;0;1;0;0;1;3579;0;0;1;0;0;1;1;3579;0;3579;1;1;
/org.eclipse.jdt.ui.tests.refactoring/resources/RenameMethodInInterface/test25/in/A.java;1;0;1;1;0;0;0;1;0;0;1;49;0;0;1;0;0;1;1;49;0;49;1;1;
/org.eclipse.jdt.ui.tests.refactoring/resources/RenameVirtualMethodInClass/testFail21/in/A.java;1;0;1;1;0;0;0;1;0;0;1;49;0;0;1;0;0;1;1;49;0;49;1;1;
/org.eclipse.scripting/src/org/eclipse/scripting/internal/ScriptToolkit.java;1;0;1;1;0;0;0;1;0;0;1;1424;0;0;1;0;0;1;1;1424;0;1424;1;1;
/org.eclipse.ui/Eclipse UI/org/eclipse/ui/internal/NewProjectAction.java;5;0;5;1;0;0;0;5;15;1;5;257;20;20;1;0;0;5;5;257;0;2664;5;5;
/org.eclipse.debug.ui/ui/org/eclipse/debug/internal/ui/ColorManager.java;4;0;4;1;1;1;1;3;12;1;3;187;18;18;1;0;0;3;4;187;0;3975;4;4;
/org.eclipse.swt.examples/org/eclipse/swt/examples/explorer/TreeScrollDropListener.java;1;0;1;1;0;0;0;1;0;0;1;513;0;0;1;0;0;1;1;513;0;513;1;1;
/org.eclipse.swt/Eclipse SWT/common/org/eclipse/swt/events/MouseAdapter.java;2;0;3;1;1;1;1;2;6;1;2;106;12;12;1;0;0;2;3;106;0;4701;3;2;
/org.eclipse.ui/Eclipse UI/org/eclipse/ui/IResourceActionFilter.java;3;1;5;1;2;2;2;3;30;1;3;257;53;53;1;0;0;3;5;257;0;4435;5;3;
/org.eclipse.scripting/src/org/eclipse/scripting/IStringData.java;1;0;1;1;0;0;0;1;0;0;1;1424;0;0;1;0;0;1;1;1424;0;1424;1;1;
/org.eclipse.ui/Eclipse UI/org/eclipse/ui/internal/dialogs/ActionSetLabelProvider.java;3;0;5;1;1;1;1;4;36;1;4;257;58;58;1;0;0;4;5;257;0;4042;5;3;
/org.eclipse.pde.ui/Eclipse PDE UI/org/eclipse/pde/internal/editor/schema/SchemaEditorContributor.java;2;0;5;2;0;0;0;5;12;3;3;267;12;12;3;2;0;5;5;324;2;1434;3;2;
/org.eclipse.jdt.junit/Eclipse JUnit/org/eclipse/jdt/internal/junit/ui/OpenTestAction.java;2;0;2;1;0;0;0;2;0;1;2;2399;0;0;1;0;0;2;2;2399;0;3313;2;2;
/org.eclipse.jdt.core/model/org/eclipse/jdt/core/ITypeHierarchy.java;2;1;5;1;3;3;3;2;326;1;2;455;414;414;1;0;0;2;5;455;0;4295;5;2;
/org.eclipse.jdt.ui.tests.refactoring/resources/ExtractMethodWorkSpace/ExtractMethodTests/validSelection/A_test352.java;2;1;3;1;2;2;2;1;12;0;1;254;12;12;1;0;0;1;3;254;0;4419;3;2;
/org.eclipse.pde.ui/src/org/eclipse/pde/internal/editor/manifest/TemplateForm.java;1;0;3;1;0;0;0;3;1;1;3;3365;1;1;1;0;0;3;3;3365;0;3579;3;1;
/org.eclipse.pde.ui/src/org/eclipse/pde/internal/ui/editor/schema/DescriptionSection.java;1;1;7;1;4;4;4;3;363;2;2;3579;409;409;2;1;0;3;7;3579;1;4573;6;1;
/org.eclipse.jdt.ui.tests.refactoring/resources/ExtractMethodWorkSpace/ExtractMethodTests/locals_out/A_test540.java;1;1;3;1;2;2;2;1;4;0;1;922;4;4;1;0;0;1;3;922;0;4419;3;1;
/org.eclipse.ant.core/src/org/eclipse/ant/internal/core/old/AntNotificationManager.java;1;0;1;1;0;0;0;1;0;0;1;3270;0;0;1;0;0;1;1;3270;0;3270;1;1;
/org.eclipse.jdt.core/model/org/eclipse/jdt/internal/core/builder/IHandle.java;1;0;4;1;0;0;0;4;94;1;4;455;98;98;1;0;0;4;4;455;0;2808;4;1;
/org.eclipse.jdt.debug.tests/tests/org/eclipse/jdt/debug/tests/eval/TestsOperators2.java;2;2;4;2;4;3;4;0;12;0;0;4447;18;18;2;0;1;0;4;4568;1;4568;3;2;
/org.eclipse.swt/Eclipse SWT Custom Widgets/common/org/eclipse/swt/custom/StyledTextPrinter.java;5;0;8;1;0;0;0;8;133;1;8;106;201;201;1;0;0;8;8;106;0;3357;8;5;
/org.eclipse.jdt.ui/core extension/org/eclipse/jdt/internal/corext/codegeneration/AddMethodStubOperation.java;2;0;2;1;0;0;0;2;0;1;2;2016;0;0;1;0;0;2;2;2016;0;2137;2;2;
/org.eclipse.pde.ui/templates/editor/java/XMLWhitespaceDetector.java;1;1;3;1;2;2;2;1;4;0;1;3812;6;6;1;0;0;1;3;3812;0;4381;3;1;
/org.eclipse.ui/Eclipse JFace/org/eclipse/jface/viewers/DoubleClickEvent.java;2;0;2;1;0;0;0;2;5;1;2;257;5;5;1;0;0;2;2;257;0;457;2;2;
/org.eclipse.ui.externaltools/External Tools/org/eclipse/ui/externaltools/internal/ui/BuilderPropertyPage.java;1;2;8;1;8;6;8;0;54;0;0;4090;158;158;2;0;2;0;8;4188;2;4726;6;1;
/org.eclipse.jdt.ui.tests.refactoring/resources/ExtractMethodWorkSpace/ExtractMethodTests/invalidSelection/A_test061.java;2;1;3;1;2;2;2;1;0;0;1;49;0;0;1;0;0;1;3;49;0;4419;3;2;
/org.eclipse.jdt.ui.tests.refactoring/resources/ExtractMethodWorkSpace/ExtractMethodTests/validSelection/A_test263.java;2;1;3;1;2;2;2;1;8;0;1;195;8;8;1;0;0;1;3;195;0;4419;3;2;
/org.eclipse.swt/Eclipse SWT/win32/org/eclipse/swt/graphics/Cursor.java;6;1;9;1;4;4;4;5;28;1;5;106;87;87;1;0;0;5;9;106;0;4701;9;6;
/org.eclipse.ui/Eclipse UI/org/eclipse/ui/internal/OpenPagesMenu.java;2;0;2;1;0;0;0;2;0;1;2;1890;0;0;1;0;0;2;2;1890;0;3050;2;2;
/org.eclipse.swt/Eclipse SWT/gtk1x/org/eclipse/swt/widgets/TreeItem.java;4;0;8;2;1;1;1;7;164;3;5;2107;288;288;3;2;0;7;8;2275;2;4701;6;4;
/org.eclipse.help/src/HelloWorldExample.java;1;0;2;1;0;0;0;2;0;1;2;1882;0;0;1;0;0;2;2;1882;0;1930;2;1;
/org.eclipse.ui/Eclipse UI/org/eclipse/ui/internal/misc/ActivatorItem.java;3;0;4;1;0;0;0;4;9;2;3;257;13;13;2;1;0;4;4;2426;1;2426;3;3;
/org.eclipse.jdt.ui/ui/org/eclipse/jdt/ui/actions/OpenJavaBrowsingPerspectiveAction.java;1;1;2;1;2;2;2;0;6;0;0;4641;6;6;1;0;0;0;2;4641;0;4770;2;1;
/org.eclipse.ui.tests/Eclipse UI Tests/org/eclipse/ui/tests/api/SessionTest2.java;1;0;2;1;0;0;0;2;0;1;2;1041;0;0;1;0;0;2;2;1041;0;1067;2;1;
/org.eclipse.team.cvs.ui/src/org/eclipse/team/internal/ccvs/ui/sync/CVSSyncCompareInput.java;3;2;36;2;15;12;15;21;220;3;17;2231;1185;1185;3;4;3;21;36;3570;7;4823;29;3;
/org.eclipse.core.tests.resources/src/org/eclipse/core/tests/resources/usecase/Snapshot4Test.java;3;0;6;1;0;0;0;6;288;2;5;1794;316;316;2;1;0;6;6;3415;1;3415;5;3;
/org.eclipse.jdt.ui/ui/org/eclipse/jdt/internal/ui/packageview/FileTransferDropAdapter.java;3;1;12;1;3;3;3;9;66;2;8;15;165;165;2;1;0;9;12;1310;1;4598;11;3;
/org.eclipse.webdav/src/kernel/org/eclipse/webdav/internal/kernel/utils/SimpleISO8601DateFormat.java;2;0;5;1;1;1;1;4;514;1;4;12;564;564;1;0;0;4;5;12;0;4211;5;2;
/org.eclipse.ui.tests/Eclipse UI Tests/org/eclipse/ui/tests/adaptable/AdaptedResourceNavigator.java;2;1;7;1;3;3;3;4;78;2;3;2863;129;129;2;1;0;4;7;3573;1;4194;6;2;
/org.eclipse.ui.tests/Eclipse JFace Tests/org/eclipse/jface/tests/viewers/interactive/ExpandAllAction.java;1;0;1;1;0;0;0;1;0;0;1;1488;0;0;1;0;0;1;1;1488;0;1488;1;1;
/org.eclipse.help/src/org/eclipse/help/internal/context/ContextsFile.java;1;0;3;1;0;0;0;3;8;1;3;2829;14;14;1;0;0;3;3;2829;0;3400;3;1;
/org.eclipse.team.cvs.core/src/org/eclipse/team/internal/ccvs/core/CVSException.java;4;1;13;1;3;3;3;10;255;1;10;1978;401;401;1;0;0;10;13;1978;0;4569;13;4;
/org.eclipse.help/src/org/eclipse/help/internal/contributions/xml/HelpContextTopic.java;2;0;2;1;0;0;0;2;0;1;2;1533;0;0;1;0;0;2;2;1533;0;1675;2;2;
/org.eclipse.ui/Eclipse JFace/org/eclipse/jface/viewers/CheckboxTableViewer.java;3;0;7;1;0;0;0;7;83;2;6;257;189;189;2;1;0;7;7;2313;1;2681;6;3;
/org.eclipse.pde.ui/Eclipse PDE UI/org/eclipse/pde/internal/component/BuildPluginWizard.java;2;0;3;1;0;0;0;3;1;2;2;512;1;1;2;1;0;3;3;512;1;1434;2;2;
/org.eclipse.team.cvs.ui/src/org/eclipse/team/internal/ccvs/ui/merge/TagRootElement.java;3;0;5;1;1;1;1;4;98;1;4;3545;114;114;1;0;0;4;5;3545;0;4426;5;3;
/org.eclipse.jdt.core/compiler/org/eclipse/jdt/internal/compiler/ast/FieldDeclaration.java;2;1;14;1;3;3;3;11;295;5;7;455;723;723;5;4;0;11;14;1037;4;4421;10;2;
/org.eclipse.team.cvs.core/src/org/eclipse/team/internal/ccvs/core/resources/CVSCompareSyncElement.java;1;0;1;1;0;0;0;1;0;0;1;3794;0;0;1;0;0;1;1;3794;0;3794;1;1;
/org.eclipse.core.target/src/org/eclipse/core/internal/target/Assert.java;2;0;5;1;1;1;1;4;196;1;4;12;231;231;1;0;0;4;5;12;0;4196;5;2;
/org.eclipse.debug.ui/ui/org/eclipse/debug/internal/ui/DebugMenuManager.java;3;0;3;1;0;0;0;3;5;1;3;187;5;5;1;0;0;3;3;187;0;3286;3;3;
/org.eclipse.pde.ui/src/org/eclipse/pde/internal/codegen/AttributeClassCodeGenerator.java;2;0;4;1;0;0;0;4;822;1;4;1434;822;822;1;0;0;4;4;1434;0;3579;4;2;
/org.eclipse.help/src/org/eclipse/help/internal/util/DocResources.java;1;0;2;1;0;0;0;2;0;1;2;1533;0;0;1;0;0;2;2;1533;0;3095;2;1;
/org.eclipse.pde.ui/src/org/eclipse/pde/ui/templates/AbstractTemplateSection.java;1;1;6;1;3;3;3;3;132;1;3;3819;159;159;1;0;0;3;6;3819;0;4752;6;1;
/org.eclipse.jdt.debug/jdi interfaces/com/sun/jdi/ByteType.java;2;0;2;1;0;0;0;2;6;1;2;2704;6;6;1;0;0;2;2;2704;0;3033;2;2;
/org.eclipse.ui.examples.javaeditor/Java Editor Example/org/eclipse/ui/examples/javaeditor/java/JavaEditorMessages.java;1;0;2;1;0;0;0;2;0;0;1;1066;0;0;2;1;0;2;2;1066;1;1066;1;1;
/org.eclipse.update.ui.forms/src/org/eclipse/update/ui/forms/AbstractSectionForm.java;1;0;3;1;0;0;0;3;5;1;3;1542;5;5;1;0;0;3;3;1542;0;2474;3;1;
/org.eclipse.jdt.junit/Eclipse JUnit/org/eclipse/jdt/junit/internal/Launcher.java;3;0;6;1;0;0;0;6;58;2;5;1511;106;106;2;1;0;6;6;1511;1;2007;5;3;
/org.eclipse.jdt.ui.tests.refactoring/resources/MoveMembers/test14/out/A.java;1;0;1;1;0;0;0;1;0;0;1;2738;0;0;1;0;0;1;1;2738;0;2738;1;1;
/org.eclipse.pde.ui/Eclipse PDE UI/org/eclipse/pde/internal/editor/manifest/ExtensionPointForm.java;2;0;5;2;0;0;0;5;12;3;3;267;12;12;3;2;0;5;5;324;2;1434;3;2;
/org.eclipse.jdt.core/search/org/eclipse/jdt/internal/core/index/impl/FileDocument.java;2;1;12;1;2;2;2;10;20;4;7;455;62;62;4;3;0;10;12;1039;3;4421;9;2;
/org.eclipse.pde.ui/src/org/eclipse/pde/internal/forms/renamed/IHyperlinkListener.java;1;0;2;1;0;0;0;2;0;1;2;2470;0;0;1;0;0;2;2;2470;0;2691;2;1;
/org.eclipse.pde.runtime/src/org/eclipse/pde/internal/runtime/registry/LibraryPropertySource.java;1;0;1;1;0;0;0;1;0;0;1;1434;0;0;1;0;0;1;1;1434;0;1434;1;1;
/org.eclipse.swt/Eclipse SWT PI/photon/org/eclipse/swt/internal/photon/PtTextCallback_t.java;2;0;2;1;1;1;1;1;6;0;1;2069;6;6;1;0;0;1;2;2069;0;4701;2;2;
/org.eclipse.pde.ui/src/org/eclipse/pde/internal/parts/SharedPart.java;1;0;4;1;0;0;0;4;40;1;4;2981;44;44;1;0;0;4;4;2981;0;3579;4;1;
/org.eclipse.jdt.ui.tests/JUnit/junit/swingui/ProgressBar.java;2;0;2;1;0;0;0;2;0;1;2;49;0;0;1;0;0;2;2;49;0;1186;2;2;
/org.eclipse.swt/Eclipse SWT/win32/org/eclipse/swt/graphics/GCData.java;3;0;4;1;1;1;1;3;6;1;3;106;13;13;1;0;0;3;4;106;0;4701;4;3;
/org.eclipse.pde.runtime/src/org/eclipse/pde/internal/runtime/OverlayIcon.java;1;0;1;1;0;0;0;1;0;0;1;1434;0;0;1;0;0;1;1;1434;0;1434;1;1;
/org.eclipse.ui/Eclipse UI/org/eclipse/ui/internal/dialogs/ProjectCapabilityEditingPropertyPage.java;1;0;3;1;0;0;0;3;44;1;3;3576;61;61;1;0;0;3;3;3576;0;3740;3;1;
/org.eclipse.jdt.ui.tests/JUnit/junit/samples/AllTests.java;2;0;2;1;0;0;0;2;0;1;2;49;0;0;1;0;0;2;2;49;0;1186;2;2;
/org.eclipse.jdt.ui.tests.refactoring/resources/SurroundWithWorkSpace/SurroundWithTests/trycatch_out/TestOneLine.java;1;0;2;1;0;0;0;2;2;1;2;2327;2;2;1;0;0;2;2;2327;0;3870;2;1;
/org.eclipse.core.tests.resources/src/org/eclipse/core/tests/internal/builders/DeltaVerifierBuilder.java;3;0;5;1;1;1;1;4;462;1;4;1794;502;502;1;0;0;4;5;1794;0;4451;5;3;
/org.eclipse.jdt.core/eval/org/eclipse/jdt/internal/eval/IRequestor.java;2;1;7;1;2;2;2;5;16;2;4;455;42;42;2;1;0;5;7;3084;1;4062;6;2;
/org.eclipse.help/src/org/eclipse/help/internal/context/ContextsFileParser.java;1;0;3;1;0;0;0;3;14;1;3;2829;20;20;1;0;0;3;3;2829;0;3875;3;1;
/org.eclipse.jdt.ui.tests.refactoring/resources/RenameType/test17/in/A.java;1;0;1;1;0;0;0;1;0;0;1;49;0;0;1;0;0;1;1;49;0;49;1;1;
/org.eclipse.swt/Eclipse SWT OLE Win32/win32/org/eclipse/swt/internal/ole/win32/EXCEPINFO.java;2;0;3;1;0;0;0;3;5;1;3;106;5;5;1;0;0;3;3;106;0;2069;3;2;
/org.eclipse.jdt.ui.tests.refactoring/resources/RenameVariables/canRename/A_test6_in.java;1;0;2;1;0;0;0;2;0;1;2;724;0;0;1;0;0;2;2;724;0;1665;2;1;
/org.eclipse.core.resources/src/org/eclipse/core/internal/resources/SyncInfoReader_2.java;3;0;10;2;1;1;1;9;174;2;8;12;383;383;2;1;0;9;10;158;1;4213;9;3;
/org.eclipse.swt/Eclipse SWT/photon/org/eclipse/swt/widgets/Slider.java;6;1;14;1;4;4;4;10;284;1;10;106;428;428;1;0;0;10;14;106;0;4701;14;6;
/org.eclipse.swt/Eclipse SWT Drag and Drop/gtk/org/eclipse/swt/dnd/RTFTransfer.java;3;2;8;1;6;5;6;2;80;1;2;2107;144;144;2;0;1;2;8;4016;1;4824;7;3;
/org.eclipse.team.cvs.core/src/org/eclipse/team/internal/ccvs/core/response/custom/LogEntry.java;3;0;8;1;0;0;0;8;169;2;6;1978;360;360;2;2;0;8;8;2032;2;2607;6;3;
/org.eclipse.jdt.ui.tests.refactoring/resources/MultiMove/test0/in/p1/B.java;1;0;1;1;0;0;0;1;0;0;1;1157;0;0;1;0;0;1;1;1157;0;1157;1;1;
/org.eclipse.jdt.ui/core refactoring/org/eclipse/jdt/internal/core/refactoring/IParentTracker.java;2;0;4;1;0;0;0;4;13;1;4;216;18;18;1;0;0;4;4;216;0;1462;4;2;
/org.eclipse.webdav/src/client/org/eclipse/webdav/client/LocalDAVClient.java;3;0;5;1;1;1;1;4;574;1;4;12;1106;1106;1;0;0;4;5;12;0;4211;5;3;
/org.eclipse.jdt.ui/ui/org/eclipse/jdt/ui/wizards/JavaCapatibilityConfigurationPage.java;2;0;6;1;1;1;1;5;145;2;4;3419;218;218;2;1;0;5;6;3465;1;4450;5;2;
/org.eclipse.jdt.ui/ui/org/eclipse/jdt/internal/ui/viewsupport/MemberFilterAction.java;4;2;6;1;4;3;4;2;86;1;2;3123;92;92;2;0;1;2;6;4036;1;4541;5;4;
/org.eclipse.jdt.debug/model/org/eclipse/jdt/internal/debug/core/SnippetSupportLineBreakpoint.java;2;0;6;1;0;0;0;6;12;1;6;1035;25;25;1;0;0;6;6;1035;0;1639;6;2;
/org.eclipse.update.core/src/org/eclipse/update/core/FeatureReference.java;2;1;7;2;4;4;4;3;138;2;2;3569;211;211;2;1;0;3;7;3569;1;4424;6;2;
/org.eclipse.swt/Eclipse SWT PI/motif/org/eclipse/swt/internal/motif/XCrossingEvent.java;2;0;2;1;1;1;1;1;6;0;1;2069;6;6;1;0;0;1;2;2069;0;4701;2;2;
/org.eclipse.jdt.core/dom/org/eclipse/jdt/core/dom/MethodInvocation.java;2;1;6;1;2;2;2;4;16;1;4;2669;47;47;1;0;0;4;6;2669;0;4453;6;2;
/org.eclipse.swt/Eclipse SWT PI/gtk1x/org/eclipse/swt/internal/gtk/GtkEditable.java;2;0;2;1;1;1;1;1;3;0;1;2107;3;3;1;0;0;1;2;2107;0;4701;2;2;
/org.eclipse.jdt.core/search/org/eclipse/jdt/internal/core/search/PathCollector.java;2;0;4;1;1;1;1;3;257;1;3;455;314;314;1;0;0;3;4;455;0;4063;4;2;
/org.eclipse.jdt.ui.tests/refactoring/experiments/ReorderParameterMoveFinder.java;1;0;3;1;0;0;0;3;9;1;3;729;9;9;1;0;0;3;3;729;0;1895;3;1;
/org.eclipse.ui/Eclipse JFace Text/org/eclipse/jface/text/ChildDocument.java;4;0;5;1;1;1;1;4;84;1;4;257;186;186;1;0;0;4;5;257;0;4838;5;4;
/org.eclipse.jdt.debug/model/org/eclipse/jdt/internal/debug/core/hcr/JavaNode.java;2;0;5;1;0;0;0;5;31;1;5;2585;37;37;1;0;0;5;5;2585;0;3568;5;2;
/org.eclipse.jdt.ui/core refactoring/org/eclipse/jdt/core/refactoring/code/ExtractMethodRefactoring.java;1;0;15;1;0;0;0;15;49;2;12;15;296;296;2;3;0;15;15;25;3;408;12;1;
/org.eclipse.jdt.ui/ui/org/eclipse/jdt/internal/ui/launcher/ListContentProvider.java;2;0;2;1;0;0;0;2;0;1;2;413;0;0;1;0;0;2;2;413;0;1916;2;2;
/org.eclipse.pde.core/src/org/eclipse/pde/internal/core/ischema/ISchemaObjectReference.java;1;0;1;1;0;0;0;1;0;0;1;3591;0;0;1;0;0;1;1;3591;0;3591;1;1;
/org.eclipse.pde.ui/src/org/eclipse/pde/internal/base/model/plugin/IPlugin.java;2;0;3;1;0;0;0;3;24;1;3;1434;24;24;1;0;0;3;3;1434;0;3039;3;2;
/org.eclipse.ui.tests/Eclipse UI Tests/RunSessionTest2.java;1;0;2;1;0;0;0;2;0;1;2;1041;0;0;1;0;0;2;2;1041;0;1066;2;1;
/org.eclipse.jdt.debug.tests/tests/org/eclipse/jdt/debug/tests/eval/NestedTypeFieldValue_370.java;2;1;3;1;3;3;3;0;12;0;0;4447;14;14;1;0;0;0;3;4447;0;4571;3;2;
/org.eclipse.pde.ui/Eclipse PDE UI/org/eclipse/pde/internal/editor/manifest/ExtensionPropertySource.java;2;0;5;2;0;0;0;5;12;3;3;267;12;12;3;2;0;5;5;324;2;1434;3;2;
/org.eclipse.pde.ui/src/org/eclipse/pde/internal/model/plugin/WorkspaceFragmentModel.java;1;0;2;1;0;0;0;2;0;1;2;3136;0;0;1;0;0;2;2;3136;0;3579;2;1;
/org.eclipse.swt/Eclipse SWT/gtk/org/eclipse/swt/widgets/Button.java;6;2;22;2;12;10;12;10;400;2;9;2107;890;890;2;1;2;10;22;3330;3;4701;19;6;
/org.eclipse.swt/Eclipse SWT Printing/common/org/eclipse/swt/printing/PrinterData.java;3;0;4;1;1;1;1;3;7;1;3;106;17;17;1;0;0;3;4;106;0;4701;4;3;
/org.eclipse.jdt.core/compiler/org/eclipse/jdt/internal/compiler/impl/DoubleConstant.java;2;0;12;1;1;1;1;11;93;4;7;455;265;265;4;4;0;11;12;1039;4;4062;8;2;
/org.eclipse.debug.ui/ui/org/eclipse/debug/internal/ui/actions/LaunchWithAction.java;2;0;5;1;0;0;0;5;13;2;4;2382;22;22;2;1;0;5;5;2787;1;3634;4;2;
/org.eclipse.ui.externaltools/External Tools/org/eclipse/ui/externaltools/internal/ui/ExternalToolsAction.java;2;2;10;1;10;8;10;0;45;0;0;4090;156;156;2;0;2;0;10;4361;2;4605;8;2;
/org.eclipse.jdt.debug/jdi interfaces/com/sun/jdi/connect/AttachingConnector.java;2;0;2;1;0;0;0;2;11;1;2;2704;11;11;1;0;0;2;2;2704;0;3033;2;2;
/org.eclipse.jdt.ui.tests.refactoring/resources/PullUp/testFail9/in/A.java;1;0;1;1;0;0;0;1;0;0;1;2406;0;0;1;0;0;1;1;2406;0;2406;1;1;
/org.eclipse.jdt.ui.tests.refactoring/resources/ExtractMethodWorkSpace/ExtractMethodTests/locals_in/A_test501.java;2;1;4;1;2;2;2;2;14;1;2;80;16;16;1;0;0;2;4;80;0;4419;4;2;
/org.eclipse.core.resources/src/org/eclipse/core/resources/IncrementalProjectBuilder.java;2;0;5;1;1;1;1;4;396;1;4;12;419;419;1;0;0;4;5;12;0;4214;5;2;
/org.eclipse.pde.ui/src/org/eclipse/pde/internal/editor/manifest/IRootNodeListener.java;2;0;2;1;0;0;0;2;0;1;2;1434;0;0;1;0;0;2;2;1434;0;3050;2;2;
/org.eclipse.jdt.ui.tests.refactoring/resources/StructureSelectionAction/A_testZeroLength0.java;1;0;1;1;0;0;0;1;0;0;1;2139;0;0;1;0;0;1;1;2139;0;2139;1;1;
/org.eclipse.debug.ui/ui/org/eclipse/debug/internal/ui/actions/StepReturnActionDelegate.java;2;0;3;1;1;1;1;2;42;1;2;2382;46;46;1;0;0;2;3;2382;0;4163;3;2;
/org.eclipse.team.ui/src/org/eclipse/team/internal/ui/ConfigurationWizardElement.java;1;0;2;1;0;0;0;2;274;1;2;1978;274;274;1;0;0;2;2;1978;0;3102;2;1;
/org.eclipse.jdt.ui.tests.refactoring/resources/RenamePrivateField/test6/out/A.java;1;0;1;1;0;0;0;1;0;0;1;2931;0;0;1;0;0;1;1;2931;0;2931;1;1;
/org.eclipse.jdt.core/compiler/org/eclipse/jdt/internal/compiler/parser/Parser.java;4;2;73;2;5;4;5;68;14226;4;56;455;35679;35679;4;12;1;68;73;1039;13;4187;60;4;
/org.eclipse.jdt.ui.tests.refactoring/resources/DeleteSourceReference/test14/out/A.java;1;0;1;1;0;0;0;1;0;0;1;2859;0;0;1;0;0;1;1;2859;0;2859;1;1;
/org.eclipse.jdt.ui.tests.refactoring/resources/PullUp/test2/in/A.java;1;0;1;1;0;0;0;1;0;0;1;2406;0;0;1;0;0;1;1;2406;0;2406;1;1;
/org.eclipse.jdt.debug/jdi/org/eclipse/jdi/internal/request/BreakpointRequestImpl.java;4;0;6;1;0;0;0;6;16;1;6;187;35;35;1;0;0;6;6;187;0;3670;6;4;
/org.eclipse.update.tests.core/src/org/eclipse/update/tests/sitevalidation/TestSiteValidation.java;1;1;3;1;3;3;3;0;32;0;0;4191;36;36;1;0;0;0;3;4191;0;4324;3;1;
/org.eclipse.pde.core/src/org/eclipse/pde/internal/core/schema/SchemaCompositor.java;1;0;3;1;0;0;0;3;8;1;3;3591;10;10;1;0;0;3;3;3591;0;3719;3;1;
/org.eclipse.ui/Eclipse UI Standard Components/org/eclipse/ui/views/framelist/ForwardAction.java;2;0;2;1;1;1;1;1;4;0;1;3498;4;4;1;0;0;1;2;3498;0;4609;2;2;
/org.eclipse.scripting/Eclipse Scripting/org/eclipse/scripting/internal/uirenderer/XGRElementUISwtList.java;2;0;6;1;0;0;0;6;49;1;6;133;76;76;1;0;0;6;6;133;0;1424;6;2;
/org.eclipse.help/src/org/eclipse/help/internal/navigation/HelpNavigationManager.java;2;0;3;1;0;0;0;3;9;1;3;1420;9;9;1;0;0;3;3;1420;0;1675;3;2;
/org.eclipse.update.ui/src/org/eclipse/update/internal/ui/forms/IUpdateForm.java;1;0;1;1;0;0;0;1;0;0;1;3662;0;0;1;0;0;1;1;3662;0;3662;1;1;
/org.eclipse.jdt.ui/core refactoring/org/eclipse/jdt/internal/corext/refactoring/rename/RenameFieldASTAnalyzer.java;2;0;4;1;0;0;0;4;6;1;4;1939;8;8;1;0;0;4;4;1939;0;3486;4;2;
/org.eclipse.jdt.ui.tests.refactoring/resources/MoveMembers/testFail1/in/B.java;1;0;1;1;0;0;0;1;0;0;1;2738;0;0;1;0;0;1;1;2738;0;2738;1;1;
/org.eclipse.swt/Eclipse SWT PI/win32/org/eclipse/swt/internal/ole/win32/IAccessible.java;2;0;4;1;1;1;1;3;80;1;3;2645;88;88;1;0;0;3;4;2645;0;4701;4;2;
/org.eclipse.update.ui/src/org/eclipse/update/internal/ui/DeltaWizardAction.java;1;0;2;1;2;1;2;0;8;0;0;4195;8;8;2;0;1;0;2;4195;1;4195;1;1;
/org.eclipse.pde.ui/src/org/eclipse/pde/internal/ui/wizards/project/NewProjectWizard.java;1;0;3;1;1;1;1;2;242;0;1;3579;253;253;2;1;0;2;3;3579;1;4167;2;1;
/org.eclipse.jdt.debug/eval/org/eclipse/jdt/internal/debug/eval/ast/instructions/AndOperator.java;3;0;6;1;0;0;0;6;35;1;6;3421;47;47;1;0;0;6;6;3421;0;3677;6;3;
/org.eclipse.update.ui.forms/src/org/eclipse/update/ui/forms/internal/IFormWorkbook.java;1;0;1;1;0;0;0;1;0;0;1;2470;0;0;1;0;0;1;1;2470;0;2470;1;1;
/org.eclipse.jdt.ui/ui/org/eclipse/jdt/internal/ui/actions/OpenTypeInHierarchyAction.java;2;1;2;1;2;2;2;0;3;0;0;4381;3;3;1;0;0;0;2;4381;0;4630;2;2;
/org.eclipse.jdt.core/model/org/eclipse/jdt/core/util/IConstantPool.java;2;1;5;1;4;4;4;1;18;0;1;3629;45;45;1;0;0;1;5;3629;0;4573;5;2;
/org.eclipse.vcm.core.cvs/src/org/eclipse/vcm/internal/core/ccvs/requests/Checkout.java;3;0;3;1;0;0;0;3;13;1;3;0;17;17;1;0;0;3;3;0;0;1098;3;3;
/org.eclipse.pde.build/src/org/eclipse/pde/internal/build/PluginModelSourceBuildScriptGenerator.java;1;2;20;1;9;7;9;11;268;3;7;3672;721;721;3;4;2;11;20;3718;6;4272;14;1;
/org.eclipse.pde.build/src/antlib/org/eclipse/pde/internal/core/types/StripMapper.java;1;0;1;1;0;0;0;1;0;0;1;3475;0;0;1;0;0;1;1;3475;0;3475;1;1;
/org.eclipse.jdt.ui.tests.refactoring/resources/RenameParameters/canRename/A_test11_out.java;1;0;1;1;0;0;0;1;0;0;1;233;0;0;1;0;0;1;1;233;0;233;1;1;
/org.eclipse.pde.ui/src/org/eclipse/pde/internal/ui/ischema/ISchema.java;1;0;3;1;0;0;0;3;8;2;2;3579;8;8;2;1;0;3;3;3579;1;3591;2;1;
/org.eclipse.vcm.core.cvs.ssh/src/org/eclipse/vcm/internal/core/ccvs/ssh/ServerPacket.java;3;0;8;1;0;0;0;8;30;2;7;111;77;77;2;1;0;8;8;1653;1;1653;7;3;
/org.eclipse.jdt.ui/ui/org/eclipse/jdt/ui/actions/MemberFilterActionGroup.java;4;2;7;1;6;5;6;1;100;0;1;3793;341;341;2;0;1;1;7;4036;1;4770;6;4;
/org.eclipse.pde.ui/src/org/eclipse/pde/internal/schema/AbstractSchemaDescriptor.java;2;0;3;1;0;0;0;3;2;1;3;1434;2;2;1;0;0;3;3;1434;0;3579;3;2;
/org.eclipse.jdt.core/model/org/eclipse/jdt/internal/core/builder/impl/ConvertedCompilationResult.java;1;0;9;1;0;0;0;9;33;4;6;455;51;51;4;3;0;9;9;1039;3;2808;6;1;
/org.eclipse.update.tests.core/src/org/eclipse/update/tests/AllTests.java;1;1;18;1;3;3;3;15;40;2;14;1531;81;81;2;1;0;15;18;2216;1;4191;17;1;
/org.eclipse.swt/Eclipse SWT Drag and Drop/gtk/org/eclipse/swt/dnd/TextTransfer.java;3;2;8;1;6;5;6;2;87;1;2;2107;148;148;2;0;1;2;8;4016;1;4824;7;3;
/org.eclipse.swt/Eclipse SWT Custom Widgets/common_j2se/org/eclipse/swt/custom/VerifyKeyListener.java;1;0;1;1;0;0;0;1;0;0;1;1378;0;0;1;0;0;1;1;1378;0;1378;1;1;
/org.eclipse.ui/Eclipse UI/org/eclipse/ui/internal/registry/EditorRegistry.java;6;1;13;1;3;3;3;10;40;1;10;257;226;226;1;0;0;10;13;257;0;4573;13;6;
/org.eclipse.team.cvs.core/src/org/eclipse/team/internal/ccvs/core/response/custom/IUpdateMessageListener.java;3;0;5;1;0;0;0;5;66;1;5;1978;130;130;1;0;0;5;5;1978;0;2607;5;3;
/org.eclipse.vcm.tests.core/src/org/eclipse/vcm/tests/core/PerformanceTest.java;1;0;1;1;0;0;0;1;0;0;1;1688;0;0;1;0;0;1;1;1688;0;1688;1;1;
/org.eclipse.jdt.debug/model/org/eclipse/jdt/debug/core/IJavaThread.java;4;1;21;2;2;2;2;19;38;2;18;187;210;210;2;1;0;19;21;3557;1;4766;20;4;
/org.eclipse.pde.ui/src/org/eclipse/pde/internal/editor/feature/PortabilityChoiceDescriptor.java;1;0;3;1;0;0;0;3;5;1;3;2953;5;5;1;0;0;3;3;2953;0;3579;3;1;
/org.eclipse.jdt.ui/ui/org/eclipse/jdt/internal/ui/reorg/IMoveSupport.java;2;0;4;1;0;0;0;4;10;1;4;15;15;15;1;0;0;4;4;15;0;1258;4;2;
/org.eclipse.debug.ui/ui/org/eclipse/debug/internal/ui/views/launch/LaunchViewer.java;1;1;2;1;2;2;2;0;132;0;0;3975;132;132;1;0;0;0;2;3975;0;4003;2;1;
/org.eclipse.jdt.core/model/org/eclipse/jdt/internal/core/hierarchy/TypeHierarchy.java;3;1;36;1;5;5;5;31;2136;4;23;455;3129;3129;4;8;0;31;36;1039;8;4569;28;3;
/org.eclipse.pde.ui/Eclipse PDE UI/org/eclipse/pde/internal/editor/manifest/RuntimeSection.java;2;0;6;2;0;0;0;6;12;3;4;267;13;13;3;2;0;6;6;324;2;1434;4;2;
/org.eclipse.pde.ui/src/org/eclipse/pde/ui/templates/OptionTemplateSection.java;1;0;4;1;1;1;1;3;411;1;3;3819;753;753;1;0;0;3;4;3819;0;4752;4;1;
/org.eclipse.jdt.ui/core refactoring/org/eclipse/jdt/internal/corext/refactoring/changes/RenameSourceFolderChange.java;2;0;4;1;1;1;1;3;50;1;3;1939;61;61;1;0;0;3;4;1939;0;4379;4;2;
/org.eclipse.jdt.core/model/org/eclipse/jdt/core/jdom/IDOMNode.java;2;0;4;1;2;1;2;2;369;1;2;455;392;392;2;0;1;2;4;4058;1;4058;3;2;
/org.eclipse.jdt.ui/ui refactoring/org/eclipse/jdt/internal/ui/refactoring/MoveMembersInputPage.java;2;0;8;1;1;1;1;7;64;2;6;2737;137;137;2;1;0;7;8;2928;1;4630;7;2;
/org.eclipse.ui/src-workbench/org/eclipse/ui/internal/SystemSummaryEditor.java;1;0;2;1;2;1;2;0;0;0;0;4386;0;0;2;0;1;0;2;4386;1;4386;1;1;
/org.eclipse.jdt.ui/core extension/org/eclipse/jdt/internal/corext/codemanipulation/StubUtility.java;4;1;28;2;7;7;7;21;74;2;18;2137;252;252;2;3;0;21;28;2232;3;4642;25;4;
/org.eclipse.ui/Eclipse UI/org/eclipse/ui/internal/registry/Capability.java;2;0;16;1;0;0;0;16;136;2;14;3074;410;410;2;2;0;16;16;3487;2;3607;14;2;
/org.eclipse.core.boot/src/org/eclipse/core/internal/boot/update/ILogEntry.java;2;0;3;1;0;0;0;3;7;1;3;12;7;7;1;0;0;3;3;12;0;2726;3;2;
/org.eclipse.update.core/src/org/eclipse/update/core/ICategory.java;2;0;9;1;0;0;0;9;66;2;8;1577;138;138;2;1;0;9;9;3571;1;3571;8;2;
/org.eclipse.pde.ui/src/org/eclipse/pde/core/plugin/IFragmentModel.java;1;0;3;1;0;0;0;3;4;2;2;3579;4;4;2;1;0;3;3;3579;1;3607;2;1;
/org.eclipse.update.core/src/org/eclipse/update/internal/core/PluginEntryContentConsumer.java;2;1;5;1;2;2;2;3;54;1;3;2487;95;95;1;0;0;3;5;2487;0;4207;5;2;
/org.eclipse.debug.core/core/org/eclipse/debug/core/IBreakpointListener.java;3;0;7;1;0;0;0;7;12;1;7;187;47;47;1;0;0;7;7;187;0;3460;7;3;
/org.eclipse.core.resources/src/org/eclipse/core/internal/resources/SyncInfoWriter.java;2;0;5;1;1;1;1;4;174;1;4;158;295;295;1;0;0;4;5;158;0;4213;5;2;
/org.eclipse.jdt.ui.tests.refactoring/resources/SelectionAnalyzerWorkSpace/SelectionAnalyzerTests/validSelection/A_test271.java;1;0;1;1;0;0;0;1;0;0;1;1368;0;0;1;0;0;1;1;1368;0;1368;1;1;
/org.eclipse.swt.tests/JUnit Tests/org/eclipse/swt/tests/junit/EmulatedWidgetsTests.java;2;0;2;1;1;1;1;1;6;0;1;1792;6;6;1;0;0;1;2;1792;0;4706;2;2;
/org.eclipse.update.tests.core/src/org/eclipse/update/tests/nestedfeatures/TestExecutableInstall.java;1;0;2;1;2;1;2;0;0;0;0;3974;0;0;2;0;1;0;2;3974;1;3974;1;1;
/org.eclipse.jdt.ui.tests.refactoring/resources/MoveMembers/test4/in/A.java;1;0;1;1;0;0;0;1;0;0;1;2738;0;0;1;0;0;1;1;2738;0;2738;1;1;
/org.eclipse.ui/Eclipse UI/org/eclipse/ui/part/CellEditorActionHandler.java;4;1;7;1;2;2;2;5;64;2;4;457;118;118;2;1;0;5;7;1436;1;4608;6;4;
/org.eclipse.jdt.ui.tests.refactoring/resources/SelectionAnalyzerWorkSpace/SelectionAnalyzerTests/invalidSelection/A_test140.java;2;0;2;1;0;0;0;2;0;1;2;1368;0;0;1;0;0;2;2;1368;0;2139;2;2;
/org.eclipse.jdt.ui.tests.refactoring/resources/RenameVirtualMethodInClass/test32/in/A.java;1;0;1;1;0;0;0;1;0;0;1;1274;0;0;1;0;0;1;1;1274;0;1274;1;1;
/org.eclipse.jdt.core/model/org/eclipse/jdt/internal/core/CreateInitializerOperation.java;2;1;11;1;2;2;2;9;146;4;6;455;196;196;4;3;0;9;11;1039;3;4063;8;2;
/org.eclipse.jdt.ui/ui refactoring/org/eclipse/jdt/internal/ui/refactoring/nls/Messages.java;1;0;2;1;0;0;0;2;7;0;1;1922;7;7;2;1;0;2;2;1922;1;1922;1;1;
/org.eclipse.jdt.debug/eval/org/eclipse/jdt/internal/debug/eval/ast/instructions/LeftShiftOperator.java;3;0;6;1;0;0;0;6;36;1;6;3421;48;48;1;0;0;6;6;3421;0;3677;6;3;
/org.eclipse.pde.core/src/org/eclipse/pde/internal/core/plugin/ExternalPluginModel.java;1;0;1;1;0;0;0;1;0;0;1;3591;0;0;1;0;0;1;1;3591;0;3591;1;1;
/org.eclipse.jdt.core/model/org/eclipse/jdt/internal/core/JavaModelCache.java;3;2;8;2;5;4;5;3;22;1;3;3429;59;59;2;0;1;3;8;4421;1;4421;7;3;
/org.eclipse.jdt.ui/ui refactoring/org/eclipse/jdt/internal/ui/refactoring/nls/ExternalizeWizard.java;2;1;11;1;5;5;5;6;15;2;5;1922;56;56;2;1;0;6;11;1922;1;4719;10;2;
/org.eclipse.jdt.ui/ui/org/eclipse/jdt/internal/ui/codemanipulation/CodeManipulationMessages.java;1;0;2;1;0;0;0;2;0;1;2;742;0;0;1;0;0;2;2;742;0;2016;2;1;
/org.eclipse.ui/Eclipse UI/org/eclipse/ui/dialogs/IWorkingSetPage.java;1;0;3;1;0;0;0;3;5;2;2;3576;9;9;2;1;0;3;3;3576;1;3816;2;1;
/org.eclipse.jdt.debug/model/org/eclipse/jdt/debug/core/IJavaValue.java;3;0;12;1;0;0;0;12;37;2;11;187;163;163;2;1;0;12;12;1449;1;3573;11;3;
/org.eclipse.jdt.ui/core refactoring/org/eclipse/jdt/internal/core/refactoring/Utils.java;2;0;2;1;0;0;0;2;0;1;2;1258;0;0;1;0;0;2;2;1258;0;1939;2;2;
/org.eclipse.team.cvs.ui/src/org/eclipse/team/internal/ccvs/ui/VersionCollator.java;1;0;3;1;1;1;1;2;75;0;1;1991;80;80;2;1;0;2;3;1991;1;4551;2;1;
/org.eclipse.search/search/org/eclipse/search/internal/ui/text/GroupByKeyComputer.java;1;0;2;1;0;0;0;2;9;1;2;15;9;9;1;0;0;2;2;15;0;343;2;1;
/org.eclipse.jdt.ui.tests.refactoring/resources/RenameNonPrivateField/test7/in/A.java;1;0;1;1;0;0;0;1;0;0;1;49;0;0;1;0;0;1;1;49;0;49;1;1;
/org.eclipse.jdt.ui/ui/org/eclipse/jdt/internal/ui/viewsupport/ProblemTableViewer.java;4;2;13;1;7;6;7;6;75;1;6;2460;313;313;2;0;1;6;13;3985;1;4629;12;4;
/org.eclipse.team.webdav/src/org/eclipse/team/internal/webdav/core/WebDavProvider.java;4;2;19;2;19;17;19;0;130;0;0;4073;416;416;2;0;2;0;19;4113;2;4636;17;4;
/org.eclipse.swt/Eclipse SWT/motif/org/eclipse/swt/internal/motif/XCharStruct.java;2;0;3;1;0;0;0;3;4;1;3;106;4;4;1;0;0;3;3;106;0;2069;3;2;
/org.eclipse.jdt.ui.tests.refactoring/resources/ExtractMethodWorkSpace/ExtractMethodTests/invalidSelection/A_test046.java;2;1;4;1;2;2;2;2;2;1;2;49;2;2;1;0;0;2;4;49;0;4419;4;2;
/org.eclipse.swt/Eclipse SWT/motif/org/eclipse/swt/widgets/Tracker.java;6;2;27;2;5;4;5;22;227;3;18;106;1211;1211;3;4;1;22;27;1736;5;4701;22;6;
/org.eclipse.jdt.ui.tests.refactoring/resources/RenameVirtualMethodInClass/test23/in/A.java;1;0;1;1;0;0;0;1;0;0;1;49;0;0;1;0;0;1;1;49;0;49;1;1;
/org.eclipse.jdt.ui.tests.refactoring/resources/RenameType/testFail25/in/A.java;1;0;1;1;0;0;0;1;0;0;1;49;0;0;1;0;0;1;1;49;0;49;1;1;
/org.eclipse.jdt.core/model/org/eclipse/jdt/internal/core/ClassFileInfo.java;3;0;12;1;1;1;1;11;293;4;8;455;377;377;4;3;0;11;12;1039;3;4063;9;3;
/org.eclipse.jdt.ui.tests.refactoring/resources/ExtractMethodWorkSpace/ExtractMethodTests/return_out/A_test702.java;1;1;3;1;2;2;2;1;20;0;1;887;20;20;1;0;0;1;3;887;0;4419;3;1;
/org.eclipse.jdt.launching/launching/org/eclipse/jdt/internal/launching/JREContainerInitializer.java;3;2;8;1;8;7;8;0;91;0;0;4008;265;265;2;0;1;0;8;4163;1;4688;7;3;
/org.eclipse.jdt.ui.tests.refactoring/resources/MoveCU/testFail2/in/p/A.java;2;0;2;1;0;0;0;2;0;1;2;49;0;0;1;0;0;2;2;49;0;2769;2;2;
/org.eclipse.jdt.ui/ui/org/eclipse/jdt/internal/ui/text/template/TemplateEngine.java;3;1;19;1;2;2;2;17;111;2;14;1469;366;366;2;3;0;17;19;1605;3;4275;16;3;
/org.eclipse.pde.ui/src/org/eclipse/pde/internal/model/plugin/Plugin.java;1;0;2;1;0;0;0;2;0;1;2;3136;0;0;1;0;0;2;2;3136;0;3579;2;1;
/org.eclipse.jdt.junit/src/org/eclipse/jdt/internal/junit/util/SocketUtil.java;1;0;2;1;0;0;0;2;4;1;2;3171;4;4;1;0;0;2;2;3171;0;3527;2;1;
/org.eclipse.core.boot/src/org/eclipse/core/boot/IPlatformConfiguration.java;3;2;12;2;5;4;5;7;978;2;6;2285;1604;1604;2;1;1;7;12;3417;2;4365;10;3;
/org.eclipse.compare/compare/org/eclipse/compare/contentmergeviewer/ITokenComparator.java;1;0;2;1;0;0;0;2;5;1;2;14;5;5;1;0;0;2;2;14;0;329;2;1;
/org.eclipse.pde.ui/Eclipse PDE UI/org/eclipse/pde/internal/base/schema/ISchemaObject.java;2;0;5;2;0;0;0;5;12;3;3;267;12;12;3;2;0;5;5;324;2;1434;3;2;
/org.eclipse.compare/compare/org/eclipse/compare/internal/CompareEditorContributor.java;3;1;10;1;3;3;3;7;69;1;7;14;187;187;1;0;0;7;10;14;0;4699;10;3;
/org.eclipse.ui/Eclipse UI/org/eclipse/ui/internal/model/WorkbenchProject.java;4;0;4;1;0;0;0;4;39;1;4;257;48;48;1;0;0;4;4;257;0;3312;4;4;
/org.eclipse.jdt.ui/ui/org/eclipse/jdt/internal/ui/preferences/TemplatePreferencePage.java;4;2;30;2;6;5;6;24;472;3;19;1469;1203;1203;3;5;1;24;30;1525;6;4700;24;4;
/org.eclipse.core.resources/src/org/eclipse/core/internal/indexing/AbstractObjectPolicy.java;2;0;3;1;1;1;1;2;30;1;2;448;45;45;1;0;0;2;3;448;0;4214;3;2;
/org.eclipse.jdt.core/codeassist/org/eclipse/jdt/internal/codeassist/complete/CompletionOnMethodName.java;2;1;5;1;2;2;2;3;64;1;3;1580;81;81;1;0;0;3;5;1580;0;4421;5;2;
/org.eclipse.jdt.ui.tests.refactoring/resources/RenameVirtualMethodInClass/testFail32/in/A.java;1;0;1;1;0;0;0;1;0;0;1;49;0;0;1;0;0;1;1;49;0;49;1;1;
/org.eclipse.jdt.ui/ui/org/eclipse/jdt/internal/ui/util/TypeInfo.java;2;0;8;1;0;0;0;8;200;2;7;1258;233;233;2;1;0;8;8;2820;1;3069;7;2;
/org.eclipse.jdt.ui/core codemanipulation/org/eclipse/jdt/internal/core/codemanipulation/TextBufferFactory.java;1;0;4;1;0;0;0;4;57;2;3;1800;57;57;2;1;0;4;4;1878;1;1937;3;1;
/org.eclipse.vcm.core.cvs.ssh/src/org/eclipse/vcm/internal/core/ccvs/ssh/SSHMethod.java;4;0;4;1;0;0;0;4;6;1;4;197;12;12;1;0;0;4;4;197;0;1191;4;4;
/org.eclipse.jdt.debug/eval/org/eclipse/jdt/debug/eval/model/IPrimitiveValue.java;2;0;2;1;0;0;0;2;0;1;2;3421;0;0;1;0;0;2;2;3421;0;3555;2;2;
/org.eclipse.jdt.ui/ui/org/eclipse/jdt/internal/ui/wizards/buildpaths/ClasspathOrderingWorkbookPage.java;2;0;6;1;0;0;0;6;16;1;6;15;38;38;1;0;0;6;6;15;0;3084;6;2;
/org.eclipse.ui.examples.javaeditor/Java Editor Example/org/eclipse/ui/examples/javaeditor/java/JavaCompletionProcessor.java;1;0;2;1;0;0;0;2;0;0;1;1066;0;0;2;1;0;2;2;1066;1;1066;1;1;
/org.eclipse.jdt.ui/ui refactoring/org/eclipse/jdt/internal/ui/nls/Messages.java;1;0;2;1;0;0;0;2;0;1;2;1913;0;0;1;0;0;2;2;1913;0;1922;2;1;
/org.eclipse.jdt.ui.tests.refactoring/resources/PullUp/test18/in/A.java;1;0;1;1;0;0;0;1;0;0;1;2406;0;0;1;0;0;1;1;2406;0;2406;1;1;
/org.eclipse.jdt.ui/ui debug/org/eclipse/jdt/internal/debug/ui/IJDIStatusConstants.java;2;0;3;1;0;0;0;3;8;1;3;15;8;8;1;0;0;3;3;15;0;1916;3;2;
/org.eclipse.jdt.ui/ui/org/eclipse/jdt/internal/ui/reorg/SourceReferenceClipboard.java;1;0;2;1;0;0;0;2;0;1;2;2003;0;0;1;0;0;2;2;2003;0;2049;2;1;
/org.eclipse.update.ui.forms/src/org/eclipse/update/ui/forms/internal/AbstractForm.java;1;0;4;1;1;1;1;3;110;1;3;2470;114;114;1;0;0;3;4;2470;0;4217;4;1;
/org.eclipse.jdt.ui.tests.refactoring/resources/MoveMembers/test4/out/A.java;1;0;1;1;0;0;0;1;0;0;1;2738;0;0;1;0;0;1;1;2738;0;2738;1;1;
/org.eclipse.jdt.ui.tests.refactoring/resources/InlineTemp/cannotInline/A_testFail7.java;1;0;1;1;0;0;0;1;0;0;1;3357;0;0;1;0;0;1;1;3357;0;3357;1;1;
/org.eclipse.jdt.ui.tests.refactoring/resources/RenameStaticMethod/testFail5/in/A.java;1;0;1;1;0;0;0;1;0;0;1;49;0;0;1;0;0;1;1;49;0;49;1;1;
/org.eclipse.jdt.ui/ui/org/eclipse/jdt/internal/ui/preferences/JavaBuilderPreferencePage.java;3;1;9;1;5;5;5;4;50;1;4;3226;143;143;1;0;0;4;9;3226;0;4425;9;3;
/org.eclipse.jdt.debug.tests/tests/org/eclipse/jdt/debug/tests/eval/generator/TypeHierarchyTestsGenerator.java;2;1;2;1;2;2;2;0;11;0;0;4447;11;11;1;0;0;0;2;4447;0;4454;2;2;
/org.eclipse.ant.ui/src/org/eclipse/ant/internal/ui/TypesPage.java;1;0;3;1;0;0;0;3;64;1;3;3476;119;119;1;0;0;3;3;3476;0;3506;3;1;
/org.eclipse.swt.tests/JUnit Tests/org/eclipse/swt/tests/junit/Test_org_eclipse_swt_printing_PrintDialog.java;2;0;2;1;1;1;1;1;6;0;1;1792;6;6;1;0;0;1;2;1792;0;4706;2;2;
/org.eclipse.pde.ui/src/org/eclipse/pde/internal/IPDEPluginListener.java;1;0;2;1;0;0;0;2;0;1;2;2470;0;0;1;0;0;2;2;2470;0;2650;2;1;
/org.eclipse.pde.ui/src/org/eclipse/pde/internal/editor/component/OpenReferenceAction.java;2;0;2;1;0;0;0;2;0;1;2;1434;0;0;1;0;0;2;2;1434;0;2951;2;2;
/org.eclipse.core.boot/src/org/eclipse/core/internal/boot/update/UMRegistryManagerModel.java;2;0;3;1;0;0;0;3;7;1;3;12;7;7;1;0;0;3;3;12;0;2726;3;2;
/org.eclipse.jdt.ui/ui refactoring/org/eclipse/jdt/internal/ui/refactoring/nls/MultiStateCellEditor.java;2;0;2;1;0;0;0;2;2;1;2;1922;2;2;1;0;0;2;2;1922;0;1939;2;2;
/org.eclipse.jdt.ui.tests/examples/org/eclipse/jdt/ui/examples/DialogFieldExample.java;2;0;6;1;1;1;1;5;16;1;5;1186;56;56;1;0;0;5;6;1186;0;4682;6;2;
/org.eclipse.jdt.junit/Eclipse JUnit/org/eclipse/jdt/internal/junit/ui/FailureTraceView.java;2;0;3;1;0;0;0;3;6;1;3;2399;6;6;1;0;0;3;3;2399;0;3313;3;2;
/org.eclipse.swt.examples.paint/org/eclipse/swt/examples/paint/ToolSettings.java;3;0;4;2;1;1;1;3;31;2;2;513;31;31;2;1;0;3;4;609;1;4024;3;3;
/org.eclipse.ui/Eclipse JFace Text/org/eclipse/jface/text/source/Annotation.java;3;0;3;1;0;0;0;3;52;1;3;257;91;91;1;0;0;3;3;257;0;1066;3;3;
/org.eclipse.scripting/Eclipse Scripting/org/eclipse/scripting/internal/views/ScriptUIEditorModelAttribute.java;2;0;4;1;0;0;0;4;8;1;4;133;15;15;1;0;0;4;4;133;0;1424;4;2;
/org.eclipse.jdt.ui.tests.refactoring/resources/ExtractMethodWorkSpace/ExtractMethodTests/errors_in/A_test801.java;1;0;2;1;0;0;0;2;0;1;2;3124;0;0;1;0;0;2;2;3124;0;3736;2;1;
/org.eclipse.pde.ui/src/org/eclipse/pde/internal/ui/SourceLocationManager.java;1;2;6;1;6;5;6;0;62;0;0;4228;143;143;2;0;1;0;6;4228;1;4408;5;1;
/org.eclipse.jdt.ui/ui/org/eclipse/jdt/internal/ui/javaeditor/CompilationUnitEditorActionContributor.java;8;2;27;2;9;8;9;18;251;2;17;15;898;898;2;1;1;18;27;2876;2;4597;25;8;
/org.eclipse.swt/Eclipse SWT/photon/org/eclipse/swt/widgets/Menu.java;8;1;18;1;9;9;9;9;323;1;9;106;715;715;1;0;0;9;18;106;0;4701;18;8;
/org.eclipse.jdt.debug/jdi/org/eclipse/jdi/internal/spy/SpyMessages.java;1;0;1;1;0;0;0;1;0;0;1;3678;0;0;1;0;0;1;1;3678;0;3678;1;1;
/org.eclipse.jdt.ui.tests.refactoring/resources/RenameType/test32/out/B.java;1;0;1;1;0;0;0;1;0;0;1;522;0;0;1;0;0;1;1;522;0;522;1;1;
/org.eclipse.jdt.ui/core refactoring/org/eclipse/jdt/internal/core/refactoring/JavaModelUtility.java;4;0;8;1;0;0;0;8;31;1;8;15;76;76;1;0;0;8;8;15;0;1939;8;4;
/org.eclipse.swt/Eclipse SWT/common/org/eclipse/swt/events/MenuAdapter.java;2;0;3;1;1;1;1;2;6;1;2;106;10;10;1;0;0;2;3;106;0;4701;3;2;
/org.eclipse.pde.runtime/Eclipse PDE Runtime/org/eclipse/pde/internal/runtime/registry/PluginPropertySource.java;2;0;3;1;0;0;0;3;4;1;3;267;4;4;1;0;0;3;3;267;0;1434;3;2;
/org.eclipse.vcm.core.cvs/src/org/eclipse/vcm/internal/core/ccvs/requests/History.java;3;0;3;1;0;0;0;3;13;1;3;0;16;16;1;0;0;3;3;0;0;1098;3;3;
/org.eclipse.update/src/org/eclipse/update/internal/core/UpdateManagerURLComparator.java;1;0;1;1;0;0;0;1;0;0;1;1424;0;0;1;0;0;1;1;1424;0;1424;1;1;
/org.eclipse.jdt.ui.tests.refactoring/resources/RenameType/test42/in/A.java;1;0;1;1;0;0;0;1;0;0;1;49;0;0;1;0;0;1;1;49;0;49;1;1;
/org.eclipse.jdt.ui.tests.refactoring/resources/SelectionAnalyzerWorkSpace/SelectionAnalyzerTests/invalidSelection/A_test041.java;2;0;2;1;0;0;0;2;0;1;2;1368;0;0;1;0;0;2;2;1368;0;2139;2;2;
/org.eclipse.jdt.ui.tests.refactoring/resources/PullUpMethods/test15/in/A.java;1;0;2;1;0;0;0;2;0;1;2;2286;0;0;1;0;0;2;2;2286;0;2406;2;1;
/org.eclipse.pde.ui/src/org/eclipse/pde/internal/core/plugin/WorkspaceFragmentModel.java;1;0;2;1;0;0;0;2;0;1;2;3579;0;0;1;0;0;2;2;3579;0;3607;2;1;
/org.eclipse.jdt.launching/launching/org/eclipse/jdt/internal/launching/JavaLaunchConfigurationHelper.java;2;0;5;1;0;0;0;5;30;1;5;3055;55;55;1;0;0;5;5;3055;0;3313;5;2;
/org.eclipse.jdt.debug/eval/org/eclipse/jdt/internal/debug/eval/ast/engine/OrAssignmentOperator.java;1;0;2;1;0;0;0;2;0;1;2;3329;0;0;1;0;0;2;2;3329;0;3421;2;1;
/org.eclipse.jdt.core/compiler/org/eclipse/jdt/internal/compiler/ast/QualifiedNameReference.java;2;0;20;1;1;1;1;19;1238;4;14;455;2717;2717;4;5;0;19;20;1039;5;4062;15;2;
/org.eclipse.swt/Eclipse SWT/win32/org/eclipse/swt/internal/win32/DLLVERSIONINFO.java;2;0;3;1;0;0;0;3;5;1;3;106;5;5;1;0;0;3;3;106;0;2069;3;2;
/org.eclipse.jdt.debug.ui/ui/org/eclipse/jdt/internal/debug/ui/display/ClearDisplayAction.java;2;0;2;1;1;1;1;1;5;0;1;1915;5;5;1;0;0;1;2;1915;0;4412;2;2;
/org.eclipse.jdt.core/dom/org/eclipse/jdt/core/dom/Block.java;2;0;4;1;0;0;0;4;11;1;4;2669;20;20;1;0;0;4;4;2669;0;3637;4;2;
/org.eclipse.jdt.junit/src/org/eclipse/jdt/internal/junit/ui/OpenTestAction.java;1;1;3;1;2;2;2;1;2;0;1;3171;4;4;1;0;0;1;3;3171;0;4634;3;1;
/org.eclipse.jdt.ui.tests.refactoring/resources/RenameMethodInInterface/test35/out/A.java;1;0;1;1;0;0;0;1;0;0;1;49;0;0;1;0;0;1;1;49;0;49;1;1;
/org.eclipse.core.tests.runtime/src/org/eclipse/core/tests/internal/plugins/PluginResolveTest_8.java;4;0;4;1;0;0;0;4;102;1;4;1794;117;117;1;0;0;4;4;1794;0;3476;4;4;
/org.eclipse.jdt.ui/ui/org/eclipse/jdt/internal/ui/dnd/ResourceTransferDragAdapter.java;2;0;4;2;0;0;0;4;7;2;3;1848;9;9;2;1;0;4;4;3641;1;3641;3;2;
/org.eclipse.ui.tests/Eclipse UI Tests/org/eclipse/ui/tests/navigator/TestDecoratorContributor.java;1;0;1;1;0;0;0;1;0;0;1;2290;0;0;1;0;0;1;1;2290;0;2290;1;1;
/org.eclipse.vcm.core/src/org/eclipse/vcm/internal/core/adapter/IAdapterServerEvent.java;1;0;1;1;0;0;0;1;0;0;1;951;0;0;1;0;0;1;1;951;0;951;1;1;
/org.eclipse.team.cvs.core/src/org/eclipse/team/internal/ccvs/core/client/listeners/IStatusListener.java;1;0;5;1;0;0;0;5;22;1;5;2572;52;52;1;0;0;5;5;2572;0;3812;5;1;
/org.eclipse.update.core/src/org/eclipse/update/internal/core/SiteFileFactory.java;2;3;41;2;9;6;9;32;339;2;29;2251;1612;1612;3;3;3;32;41;4084;6;4595;35;2;
/org.eclipse.scripting/Eclipse Scripting/org/eclipse/scripting/internal/views/ScriptUIEditorAutoIndentStrategy.java;2;0;4;1;0;0;0;4;21;1;4;133;33;33;1;0;0;4;4;133;0;1424;4;2;
/org.eclipse.help/src/org/eclipse/help/internal/HelpPlugin.java;2;0;5;1;0;0;0;5;137;1;5;1420;151;151;1;0;0;5;5;1420;0;3762;5;2;
/org.eclipse.pde.core/src/org/eclipse/pde/internal/core/build/BuildObject.java;1;0;1;1;0;0;0;1;0;0;1;3591;0;0;1;0;0;1;1;3591;0;3591;1;1;
/org.eclipse.jdt.ui.tests.refactoring/resources/ExtractMethodWorkSpace/ExtractMethodTests/locals_out/A_test554.java;1;1;3;1;2;2;2;1;32;0;1;1236;32;32;1;0;0;1;3;1236;0;4419;3;1;
/org.eclipse.update.ui/src/org/eclipse/update/internal/ui/forms/UpdateSearchContribution.java;1;0;2;1;0;0;0;2;0;1;2;3662;0;0;1;0;0;2;2;3662;0;3749;2;1;
/org.eclipse.pde.ui/src/org/eclipse/pde/internal/ui/util/Choice.java;1;0;1;1;0;0;0;1;0;0;1;3579;0;0;1;0;0;1;1;3579;0;3579;1;1;
/org.eclipse.vcm.ui.cvs/src/org/eclipse/vcm/internal/ui/ccvs/RemoveStreamAction.java;1;0;2;1;0;0;0;2;0;0;1;397;0;0;2;1;0;2;2;397;1;397;1;1;
/org.eclipse.jdt.ui/ui/org/eclipse/jdt/internal/ui/compare/JavaTokenComparator.java;2;0;9;1;1;1;1;8;120;1;8;15;187;187;1;0;0;8;9;15;0;3913;9;2;
/org.eclipse.debug.ui/ui/org/eclipse/debug/internal/ui/launchConfigurations/LaunchConfigurationsMessages.java;1;0;1;1;0;0;0;1;0;0;1;2165;0;0;1;0;0;1;1;2165;0;2165;1;1;
/org.eclipse.jdt.core/compiler/org/eclipse/jdt/internal/compiler/lookup/TagBits.java;2;0;3;1;1;1;1;2;15;1;2;455;20;20;1;0;0;2;3;455;0;4062;3;2;
/org.eclipse.jdt.ui/ui/org/eclipse/jdt/internal/ui/packageview/PackageExplorerPart.java;10;3;134;3;23;16;23;111;440;4;81;15;4477;4477;4;30;7;111;134;1610;37;4720;97;10;
/org.eclipse.jdt.core/compiler/org/eclipse/jdt/internal/compiler/env/ISourceField.java;2;0;4;1;1;1;1;3;46;1;3;455;66;66;1;0;0;3;4;455;0;4062;4;2;
/org.eclipse.debug.ui/ui/org/eclipse/debug/internal/ui/actions/RemoveBreakpointAction.java;2;1;9;1;2;2;2;7;21;1;7;2382;56;56;1;0;0;7;9;2382;0;4409;9;2;
/org.eclipse.jdt.core/model/org/eclipse/jdt/internal/core/BufferCache.java;3;1;6;2;2;2;2;4;60;2;3;455;107;107;2;1;0;4;6;3397;1;4522;5;3;
/org.eclipse.core.tests.resources/src/org/eclipse/core/tests/internal/watson/DeltaIteratorTest.java;3;0;3;1;1;1;1;2;154;1;2;1794;175;175;1;0;0;2;3;1794;0;4516;3;3;
/org.eclipse.pde.ui/src/org/eclipse/pde/internal/forms/IFormWorkbook.java;2;0;2;1;0;0;0;2;0;1;2;1434;0;0;1;0;0;2;2;1434;0;2470;2;2;
/org.eclipse.swt/Eclipse SWT Program/photon/org/eclipse/swt/program/Program.java;6;1;9;1;3;3;3;6;196;1;6;106;302;302;1;0;0;6;9;106;0;4701;9;6;
/org.eclipse.jdt.ui.tests.refactoring/resources/RenameTemp/canRename/A_test46_in.java;1;0;1;1;0;0;0;1;0;0;1;3356;0;0;1;0;0;1;1;3356;0;3356;1;1;
/org.eclipse.jdt.debug/eval/org/eclipse/jdt/internal/debug/eval/ast/instructions/ArrayInitializerInstruction.java;3;0;6;1;0;0;0;6;8;1;6;3421;20;20;1;0;0;6;6;3421;0;3677;6;3;
/org.eclipse.pde.ui/src/org/eclipse/pde/internal/core/NLResourceHelper.java;1;0;2;1;0;0;0;2;0;1;2;3579;0;0;1;0;0;2;2;3579;0;3607;2;1;
/org.eclipse.jdt.ui/core extension/org/eclipse/jdt/internal/corext/template/java/TemplateMessages.java;2;0;2;1;0;0;0;2;0;1;2;2784;0;0;1;0;0;2;2;2784;0;3683;2;2;
/org.eclipse.jdt.ui.tests.refactoring/resources/MoveMembers/testFail23/in/B.java;1;0;1;1;0;0;0;1;0;0;1;2928;0;0;1;0;0;1;1;2928;0;2928;1;1;
/org.eclipse.team.cvs.core/src/org/eclipse/team/internal/ccvs/core/resources/api/FileProperties.java;2;0;2;1;0;0;0;2;0;1;2;1978;0;0;1;0;0;2;2;1978;0;2156;2;2;
/org.eclipse.pde.ui/Eclipse PDE UI/org/eclipse/pde/internal/model/IdentifiablePluginObject.java;2;0;5;2;0;0;0;5;12;3;3;267;12;12;3;2;0;5;5;324;2;1434;3;2;
/org.eclipse.vcm.ui/src/org/eclipse/vcm/internal/ui/VCMDiffTreeViewer.java;1;0;2;1;0;0;0;2;16;1;2;1566;16;16;1;0;0;2;2;1566;0;1672;2;1;
/org.eclipse.swt.examples/src/org/eclipse/swt/examples/layoutexample/FormLayoutTab.java;3;1;7;1;3;3;3;4;170;1;4;3420;409;409;1;0;0;4;7;3420;0;4705;7;3;
/org.eclipse.ui/Eclipse JFace/org/eclipse/jface/dialogs/IDialogPage.java;3;0;3;1;0;0;0;3;6;1;3;257;11;11;1;0;0;3;3;257;0;2584;3;3;
/org.eclipse.vcm.core.cvs/src/org/eclipse/vcm/internal/core/ccvs/requests/Update.java;3;0;6;1;0;0;0;6;13;1;6;0;32;32;1;0;0;6;6;0;0;1900;6;3;
/org.eclipse.jdt.debug/jdi interfaces/com/sun/jdi/VirtualMachine.java;2;0;2;1;0;0;0;2;42;1;2;2704;42;42;1;0;0;2;2;2704;0;3033;2;2;
/org.eclipse.jdt.debug/eval/org/eclipse/jdt/internal/debug/eval/ast/ASTCuToMagicSourceMapper.java;1;0;2;1;0;0;0;2;0;1;2;3329;0;0;1;0;0;2;2;3329;0;3344;2;1;
/org.eclipse.jdt.debug/eval/org/eclipse/jdt/internal/debug/eval/ast/engine/PrefixMinusMinusOperator.java;1;0;3;1;0;0;0;3;2;1;3;3329;2;2;1;0;0;3;3;3329;0;3421;3;1;
/org.eclipse.jdt.ui.tests.refactoring/resources/RenameStaticMethod/test4/out/A.java;1;0;1;1;0;0;0;1;0;0;1;49;0;0;1;0;0;1;1;49;0;49;1;1;
/org.eclipse.jdt.ui/ui/org/eclipse/jdt/internal/ui/launcher/LauncherMessages.java;3;0;3;1;0;0;0;3;23;1;3;749;23;23;1;0;0;3;3;749;0;1916;3;3;
/org.eclipse.swt/Eclipse SWT/photon/org/eclipse/swt/widgets/TabItem.java;5;1;15;1;6;6;6;9;135;2;8;106;254;254;2;1;0;9;15;2064;1;4701;14;5;
/org.eclipse.swt/Eclipse SWT PI/gtk/org/eclipse/swt/internal/gtk/GdkEvent.java;2;0;5;1;2;1;2;3;40;1;3;2107;47;47;2;0;1;3;5;4701;1;4701;4;2;
/org.eclipse.jdt.debug/model/org/eclipse/jdt/internal/debug/core/model/JDIVoidType.java;2;0;2;2;0;0;0;2;5;0;1;2517;5;5;2;1;0;2;2;2517;1;2517;1;2;
/org.eclipse.jdt.ui.tests.refactoring/resources/RenameTemp/canRename/A_test40_out.java;1;0;1;1;0;0;0;1;0;0;1;3322;0;0;1;0;0;1;1;3322;0;3322;1;1;
/org.eclipse.core.tests.resources/src/org/eclipse/core/tests/internal/resources/ModelObjectWriterTest.java;3;1;5;1;2;2;2;3;244;1;3;1794;370;370;1;0;0;3;5;1794;0;4368;5;3;
/org.eclipse.jdt.ui.tests.refactoring/resources/RenameParameters/canRename/A_test23_in.java;1;0;1;1;0;0;0;1;0;0;1;233;0;0;1;0;0;1;1;233;0;233;1;1;
/org.eclipse.jdt.core/compiler/org/eclipse/jdt/internal/compiler/impl/FloatConstant.java;2;0;12;1;1;1;1;11;90;4;7;455;239;239;4;4;0;11;12;1039;4;4062;8;2;
/org.eclipse.jdt.ui.tests.refactoring/resources/RenameMethodInInterface/test33/in/A.java;1;0;1;1;0;0;0;1;0;0;1;49;0;0;1;0;0;1;1;49;0;49;1;1;
/org.eclipse.jdt.debug/model/org/eclipse/jdt/internal/debug/core/IJavaConditionalBreakpointListener.java;2;0;4;1;0;0;0;4;22;1;4;3329;35;35;1;0;0;4;4;3329;0;3558;4;2;
/org.eclipse.pde.core/src/org/eclipse/pde/internal/core/schema/SchemaEnumeration.java;1;0;2;1;0;0;0;2;5;1;2;3591;5;5;1;0;0;2;2;3591;0;3607;2;1;
/org.eclipse.jdt.core/compiler/org/eclipse/jdt/internal/compiler/ast/IntLiteralMinValue.java;2;1;4;1;2;2;2;2;22;1;2;455;38;38;1;0;0;2;4;455;0;4421;4;2;
/org.eclipse.jdt.ui.tests.refactoring/resources/RenameType/testFail53/in/A.java;1;0;1;1;0;0;0;1;0;0;1;49;0;0;1;0;0;1;1;49;0;49;1;1;
/org.eclipse.jdt.ui.tests.refactoring/resources/RenamePackage/testFail8/in/p1/A.java;2;0;2;1;0;0;0;2;4;1;2;49;4;4;1;0;0;2;2;49;0;1258;2;2;
/org.eclipse.swt.examples/org/eclipse/swt/examples/controlexample/ProgressBarTab.java;5;1;8;1;4;4;4;4;169;1;4;513;341;341;1;0;0;4;8;513;0;4024;8;5;
/org.eclipse.jdt.ui/core extension/org/eclipse/jdt/internal/corext/template/TemplateMessages.java;1;0;1;1;0;0;0;1;0;0;1;2784;0;0;1;0;0;1;1;2784;0;2784;1;1;
/org.eclipse.swt/Eclipse SWT/win32/org/eclipse/swt/widgets/Shell.java;9;2;45;2;8;7;8;37;66;2;31;106;746;746;2;6;1;37;45;1699;7;4701;38;9;
/org.eclipse.jdt.ui/core extension/org/eclipse/jdt/internal/corext/util/Binding2JavaModel.java;1;0;3;1;0;0;0;3;2;1;3;1930;2;2;1;0;0;3;3;1930;0;3106;3;1;
/org.eclipse.jdt.ui/ui/org/eclipse/jdt/internal/ui/actions/AddMethodStubAction.java;6;2;24;2;6;5;6;18;197;2;17;15;599;599;2;1;1;18;24;740;2;4621;22;6;
/org.eclipse.jdt.ui.tests.refactoring/resources/MoveCU/testFail0/in/p1/A.java;2;0;2;1;0;0;0;2;0;1;2;49;0;0;1;0;0;2;2;49;0;2769;2;2;
/org.eclipse.jdt.debug/jdi interfaces/com/sun/jdi/InconsistentDebugInfoException.java;2;0;2;1;0;0;0;2;4;1;2;2704;4;4;1;0;0;2;2;2704;0;3033;2;2;
/org.eclipse.jdt.debug/model/org/eclipse/jdt/internal/debug/core/MethodEntryBreakpoint.java;1;0;1;1;0;0;0;1;0;0;1;831;0;0;1;0;0;1;1;831;0;831;1;1;
/org.eclipse.jdt.core/compiler/org/eclipse/jdt/internal/compiler/lookup/ProblemReferenceBinding.java;3;0;7;1;1;1;1;6;33;3;4;455;86;86;3;2;0;6;7;2295;2;4062;5;3;
/org.eclipse.vcm.tests.core.cvs.ssh/src/org/eclipse/vcm/tests/core/ccvs/ssh/HexConverter.java;1;0;1;1;0;0;0;1;0;0;1;1688;0;0;1;0;0;1;1;1688;0;1688;1;1;
/org.eclipse.ui.tests/Eclipse UI Tests/org/eclipse/ui/tests/api/IActionBarsTest.java;2;0;6;1;0;0;0;6;22;1;6;1107;54;54;1;0;0;6;6;1107;0;2785;6;2;
/org.eclipse.jdt.ui.tests/refactoring/org/eclipse/jdt/refactoring/tests/RenameMethodInInterfaceTests.java;4;0;15;1;0;0;0;15;35;2;14;49;149;149;2;1;0;15;15;1342;1;1896;14;4;
/org.eclipse.jdt.ui.tests/JUnit/junit/extensions/ActiveTest.java;2;0;2;1;0;0;0;2;0;1;2;49;0;0;1;0;0;2;2;49;0;1186;2;2;
/org.eclipse.search/search/org/eclipse/search/internal/ui/MatchSorter.java;2;0;4;1;0;0;0;4;9;1;4;15;13;13;1;0;0;4;4;15;0;1117;4;2;
/org.eclipse.pde.ui/src/org/eclipse/pde/internal/feature/FeatureData.java;1;0;2;1;0;0;0;2;0;1;2;2951;0;0;1;0;0;2;2;2951;0;3579;2;1;
/org.eclipse.pde.ui/src/org/eclipse/pde/internal/editor/jars/FolderSection.java;2;0;3;1;0;0;0;3;2;1;3;1434;2;2;1;0;0;3;3;1434;0;2650;3;2;
/org.eclipse.jdt.core/model/org/eclipse/jdt/core/util/ILocalVariableAttribute.java;2;1;6;1;4;4;4;2;18;0;1;3629;42;42;2;1;0;2;6;3629;1;4573;5;2;
/org.eclipse.update.ui/src/org/eclipse/update/ui/internal/parts/UpdateForm.java;1;0;2;1;0;0;0;2;0;0;1;1426;0;0;2;1;0;2;2;1426;1;1426;1;1;
/org.eclipse.jdt.ui/ui/org/eclipse/jdt/internal/ui/viewsupport/MemberFilterActionGroup.java;2;0;3;1;0;0;0;3;2;1;3;3123;2;2;1;0;0;3;3;3123;0;3793;3;2;
/org.eclipse.vcm.core/src/org/eclipse/vcm/internal/core/base/ISyncInfoVisitor.java;1;0;2;1;0;0;0;2;5;1;2;1330;5;5;1;0;0;2;2;1330;0;1349;2;1;
/org.eclipse.update.ui/src/org/eclipse/update/internal/ui/forms/UpdateAdapterFactory.java;1;0;1;1;0;0;0;1;0;0;1;3662;0;0;1;0;0;1;1;3662;0;3662;1;1;
/org.eclipse.ui/Eclipse UI/org/eclipse/ui/internal/EditorManager.java;9;3;43;2;18;14;18;25;1618;2;22;257;3194;3194;3;3;4;25;43;4402;7;4688;36;9;
/org.eclipse.pde.ui/src/org/eclipse/pde/internal/editor/component/ComponentSourceOutlinePage.java;2;0;2;1;0;0;0;2;0;1;2;1434;0;0;1;0;0;2;2;1434;0;2951;2;2;
/org.eclipse.jdt.ui.tests.refactoring/resources/SelectionAnalyzerWorkSpace/SelectionAnalyzerTests/validSelection/A_test096_.java;1;0;1;1;0;0;0;1;0;0;1;2139;0;0;1;0;0;1;1;2139;0;2139;1;1;
/org.eclipse.jdt.ui.tests.refactoring/resources/templates/testFail/in/A.java;1;0;1;1;0;0;0;1;0;0;1;49;0;0;1;0;0;1;1;49;0;49;1;1;
/org.eclipse.ui.examples.readmetool/Eclipse UI Examples Readme Tool/org/eclipse/ui/examples/readmetool/AdaptableList.java;2;0;2;1;0;0;0;2;2;1;2;932;2;2;1;0;0;2;2;932;0;945;2;2;
/org.eclipse.core.runtime/src/org/eclipse/core/internal/runtime/InternalPlatform.java;6;3;53;3;16;12;16;37;1722;3;31;12;3032;3032;3;6;4;37;53;177;10;4753;43;6;
/org.eclipse.pde.core/src/org/eclipse/pde/internal/core/ifeature/IFeaturePlugin.java;1;0;1;1;0;0;0;1;0;0;1;3591;0;0;1;0;0;1;1;3591;0;3591;1;1;
/org.eclipse.ui/Eclipse UI/org/eclipse/ui/dialogs/ContainerGenerator.java;2;0;2;1;0;0;0;2;10;1;2;257;10;10;1;0;0;2;2;257;0;457;2;2;
/org.eclipse.jdt.core/model/org/eclipse/jdt/internal/core/builder/ISourceFragment.java;1;0;3;1;0;0;0;3;3;1;3;455;3;3;1;0;0;3;3;455;0;2808;3;1;
/org.eclipse.help.ui/Eclipse Help UI Win32/org/eclipse/help/internal/ui/win32/WebBrowser.java;4;0;5;1;0;0;0;5;20;1;5;136;43;43;1;0;0;5;5;136;0;1420;5;4;
/org.eclipse.jdt.debug/model/org/eclipse/jdt/debug/core/IJavaArrayType.java;1;0;3;1;0;0;0;3;12;1;3;1758;18;18;1;0;0;3;3;1758;0;3558;3;1;
/org.eclipse.jdt.ui.tests.refactoring/resources/RenameMethodInInterface/test23/out/A.java;2;0;2;1;0;0;0;2;0;1;2;49;0;0;1;0;0;2;2;49;0;1258;2;2;
/org.eclipse.team.cvs.core/src/org/eclipse/team/internal/ccvs/core/DateUtil.java;2;0;2;1;0;0;0;2;164;1;2;3380;164;164;1;0;0;2;2;3380;0;3533;2;2;
/org.eclipse.pde.ui/src/org/eclipse/pde/internal/model/plugin/XMLErrorHandler.java;1;0;2;1;0;0;0;2;0;1;2;3136;0;0;1;0;0;2;2;3136;0;3579;2;1;
/org.eclipse.ui/Eclipse UI Text Editor/org/eclipse/ui/texteditor/IUpdate.java;3;0;3;1;0;0;0;3;5;1;3;257;7;7;1;0;0;3;3;257;0;1066;3;3;
/org.eclipse.jdt.ui/ui/org/eclipse/jdt/internal/ui/viewsupport/ResourceFilter.java;2;0;5;1;0;0;0;5;36;1;5;15;60;60;1;0;0;5;5;15;0;1256;5;2;
/org.eclipse.pde.ui/src/org/eclipse/pde/internal/ui/codegen/JavaCodeGenerator.java;1;0;1;1;0;0;0;1;0;0;1;3579;0;0;1;0;0;1;1;3579;0;3579;1;1;
/org.eclipse.jdt.ui/core extension/org/eclipse/jdt/internal/corext/dom/LocalVariableIndex.java;1;0;2;1;1;1;1;1;11;0;1;3049;11;11;1;0;0;1;2;3049;0;3972;2;1;
/org.eclipse.jdt.core/model/org/eclipse/jdt/internal/core/hierarchy/HierarchyBuilder.java;3;1;24;1;6;6;6;18;326;2;17;455;1034;1034;2;1;0;18;24;1046;1;4382;23;3;
/org.eclipse.jdt.core/search/org/eclipse/jdt/internal/core/index/impl/IndexedFile.java;4;1;14;1;2;2;2;12;90;4;9;455;244;244;4;3;0;12;14;1039;3;4063;11;4;
/org.eclipse.jdt.ui/ui/org/eclipse/jdt/internal/ui/jarpackager/CreateJarActionDelegate.java;3;0;11;1;0;0;0;11;121;2;10;349;194;194;2;1;0;11;11;3734;1;3791;10;3;
/org.eclipse.ui/Eclipse UI Text Editor/org/eclipse/ui/texteditor/MarkerRulerInfoAction.java;1;1;3;1;2;2;2;1;375;0;1;3592;392;392;1;0;0;1;3;3592;0;4838;3;1;
/org.eclipse.jdt.ui.tests.refactoring/resources/MoveMembers/testFail5/in/A.java;1;0;1;1;0;0;0;1;0;0;1;2738;0;0;1;0;0;1;1;2738;0;2738;1;1;
/org.eclipse.team.tests.core/src/org/eclipse/team/tests/core/RepositoryProviderNaish.java;2;0;5;1;1;1;1;4;27;0;1;3271;37;37;4;3;0;4;5;3271;3;4545;2;2;
/org.eclipse.swt.tests/JUnit Tests/org/eclipse/swt/tests/junit/Test_org_eclipse_swt_graphics_Image.java;2;0;2;1;1;1;1;1;6;0;1;1792;6;6;1;0;0;1;2;1792;0;4706;2;2;
/org.eclipse.jdt.ui/core refactoring/org/eclipse/jdt/internal/corext/refactoring/tagging/IRenameRefactoring.java;2;0;3;1;0;0;0;3;7;1;3;1939;13;13;1;0;0;3;3;1939;0;2784;3;2;
/org.eclipse.team.cvs.ui/src/org/eclipse/team/internal/ccvs/ui/IHelpContextIds.java;3;2;14;2;14;11;14;0;54;0;0;4051;215;215;2;0;3;0;14;4425;3;4839;11;3;
/org.eclipse.swt.tests/JUnit Tests/org/eclipse/swt/tests/junit/Test_org_eclipse_swt_events_TraverseListener.java;2;0;2;1;1;1;1;1;6;0;1;1792;6;6;1;0;0;1;2;1792;0;4706;2;2;
/org.eclipse.pde.ui/src/org/eclipse/pde/internal/core/plugin/Plugin.java;1;0;3;1;0;0;0;3;13;2;2;3579;13;13;2;1;0;3;3;3579;1;3607;2;1;
/org.eclipse.ui/Eclipse UI/org/eclipse/ui/actions/WorkspaceModifyOperation.java;2;0;2;1;0;0;0;2;5;1;2;257;5;5;1;0;0;2;2;257;0;457;2;2;
/org.eclipse.jdt.ui.tests.refactoring/resources/RenameStaticMethod/testFail4/in/A.java;1;0;1;1;0;0;0;1;0;0;1;49;0;0;1;0;0;1;1;49;0;49;1;1;
/org.eclipse.team.core/src/org/eclipse/team/core/ISerializedReferencing.java;1;0;1;1;0;0;0;1;0;0;1;3704;0;0;1;0;0;1;1;3704;0;3704;1;1;
/org.eclipse.ui/Eclipse JFace Text/org/eclipse/jface/text/source/IVerticalRuler.java;4;1;7;1;3;3;3;4;67;1;4;257;200;200;1;0;0;4;7;257;0;4838;7;4;
/org.eclipse.jdt.ui.tests.refactoring/resources/RenameType/test11/in/AA.java;1;0;1;1;0;0;0;1;0;0;1;49;0;0;1;0;0;1;1;49;0;49;1;1;
/org.eclipse.swt.examples/org/eclipse/swt/examples/controlexample/ListTab.java;5;1;6;1;3;3;3;3;106;1;3;513;227;227;1;0;0;3;6;513;0;4024;6;5;
/org.eclipse.jdt.launching/launching/org/eclipse/jdt/internal/launching/SocketAttachConnector.java;2;2;8;1;6;5;6;2;83;1;2;3453;165;165;2;0;1;2;8;4568;1;4568;7;2;
/org.eclipse.jdt.debug.ui/ui/org/eclipse/jdt/internal/debug/ui/launcher/RemoteJavaApplicationTabGroup.java;1;1;4;1;2;2;2;2;8;1;2;3313;11;11;1;0;0;2;4;3313;0;4098;4;1;
/org.eclipse.jdt.ui/ui/org/eclipse/jdt/internal/ui/dnd/DelegatingDropAdapter.java;2;0;3;1;0;0;0;3;66;1;3;15;74;74;1;0;0;3;3;15;0;2148;3;2;
/org.eclipse.jdt.core/model/org/eclipse/jdt/internal/core/JarPackageFragment.java;3;1;11;1;2;2;2;9;254;2;8;455;348;348;2;1;0;9;11;2027;1;4063;10;3;
/org.eclipse.webdav/src/interface/org/eclipse/webdav/dom/PropertyUpdate.java;3;0;5;1;1;1;1;4;488;1;4;12;586;586;1;0;0;4;5;12;0;4211;5;3;
/org.eclipse.swt/Eclipse SWT/common/org/eclipse/swt/events/HelpEvent.java;2;0;3;1;1;1;1;2;6;1;2;106;10;10;1;0;0;2;3;106;0;4701;3;2;
/org.eclipse.pde.ui/src/org/eclipse/pde/internal/base/schema/ISchemaObjectReference.java;2;0;2;1;0;0;0;2;0;1;2;1434;0;0;1;0;0;2;2;1434;0;3579;2;2;
/org.eclipse.scripting/Eclipse Scripting/org/eclipse/scripting/internal/ScriptToolkit.java;2;0;4;1;0;0;0;4;50;1;4;133;54;54;1;0;0;4;4;133;0;1424;4;2;
/org.eclipse.jdt.ui/ui/org/eclipse/jdt/internal/ui/javaeditor/OpenHierarchyOnSelectionAction.java;5;0;14;1;1;1;1;13;52;1;13;15;221;221;1;0;0;13;14;15;0;3968;14;5;
/org.eclipse.jdt.debug.ui/ui/org/eclipse/jdt/internal/debug/ui/launcher/JavaClasspathTab.java;2;2;9;2;8;7;8;1;38;0;1;3875;114;114;2;0;1;1;9;3921;1;4098;8;2;
/org.eclipse.scripting/src/org/eclipse/scripting/internal/uirenderer/XGRXmlAttribute.java;1;0;1;1;0;0;0;1;0;0;1;1424;0;0;1;0;0;1;1;1424;0;1424;1;1;
/org.eclipse.jdt.debug.ui/ui/org/eclipse/jdt/internal/debug/ui/launcher/DebugJavaApplicationAction.java;1;1;2;1;2;2;2;0;0;0;0;3952;0;0;1;0;0;0;2;3952;0;4367;2;1;
/org.eclipse.jdt.ui.tests.refactoring/resources/RenameParameters/canRename/A_test13_in.java;1;0;1;1;0;0;0;1;0;0;1;233;0;0;1;0;0;1;1;233;0;233;1;1;
/org.eclipse.help/src/org/eclipse/help/internal/protocols/SearchProgressMonitor.java;2;1;2;1;2;2;2;0;0;0;0;4000;0;0;1;0;0;0;2;4000;0;4008;2;2;
/org.eclipse.core.runtime/src/org/eclipse/core/runtime/model/ExtensionModel.java;3;0;5;1;1;1;1;4;298;1;4;12;344;344;1;0;0;4;5;12;0;4214;5;3;
/org.eclipse.jdt.ui/core refactoring/org/eclipse/jdt/internal/core/nls/changes/CreateFileChange.java;1;0;2;1;0;0;0;2;0;1;2;1913;0;0;1;0;0;2;2;1913;0;1922;2;1;
/org.eclipse.jdt.debug/eval/org/eclipse/jdt/internal/debug/eval/ast/EvaluationElement.java;1;0;3;1;0;0;0;3;76;1;3;3329;76;76;1;0;0;3;3;3329;0;3421;3;1;
/org.eclipse.pde.ui/src/org/eclipse/pde/internal/model/jars/JarsModel.java;2;0;2;1;0;0;0;2;0;1;2;1434;0;0;1;0;0;2;2;1434;0;2650;2;2;
/org.eclipse.pde.ui/src/org/eclipse/pde/internal/ui/FeatureProject.java;1;0;2;1;0;0;0;2;0;1;2;3579;0;0;1;0;0;2;2;3579;0;3607;2;1;
/org.eclipse.swt/Eclipse SWT/motif/org/eclipse/swt/internal/motif/Visual.java;2;0;3;1;0;0;0;3;4;1;3;106;4;4;1;0;0;3;3;106;0;2069;3;2;
/org.eclipse.swt/Eclipse SWT Drag and Drop/common/org/eclipse/swt/dnd/DragSourceAdapter.java;2;1;4;1;2;2;2;2;23;1;2;106;35;35;1;0;0;2;4;106;0;4824;4;2;
/org.eclipse.jdt.ui.tests.refactoring/resources/MoveMembers/testFail22/in/B.java;1;0;1;1;0;0;0;1;0;0;1;2928;0;0;1;0;0;1;1;2928;0;2928;1;1;
/org.eclipse.core.tests.resources/src/org/eclipse/core/tests/internal/indexing/StandAloneObjectStoreTest.java;3;0;4;1;1;1;1;3;32;1;3;1794;54;54;1;0;0;3;4;1794;0;4516;4;3;
/org.eclipse.vcm.core.cvs/src/org/eclipse/vcm/internal/core/ccvs/client/Connection.java;6;0;11;2;0;0;0;11;118;2;10;0;258;258;2;1;0;11;11;1564;1;1564;10;6;
/org.eclipse.ui.externaltools/External Tools/org/eclipse/ui/externaltools/internal/core/IPreferenceConstants.java;1;1;2;1;2;2;2;0;22;0;0;4090;22;22;1;0;0;0;2;4090;0;4123;2;1;
/org.eclipse.debug.ui/ui/org/eclipse/debug/internal/ui/ConsoleView.java;4;0;26;2;0;0;0;26;176;3;22;187;437;437;3;4;0;26;26;2331;4;2331;22;4;
/org.eclipse.jdt.core/search/org/eclipse/jdt/internal/core/search/matching/PotentialMatch.java;1;0;18;1;0;0;0;18;104;4;15;678;248;248;4;3;0;18;18;1039;3;1906;15;1;
/org.eclipse.ant.core/src_ant/org/eclipse/ant/internal/core/ant/CommaPatternSet.java;1;0;3;1;1;1;1;2;426;1;2;3489;450;450;1;0;0;2;3;3489;0;4026;3;1;
/org.eclipse.ui/Eclipse JFace Text/org/eclipse/jface/text/rules/RuleBasedScanner.java;5;0;7;1;1;1;1;6;107;1;6;257;231;231;1;0;0;6;7;257;0;4838;7;5;
/org.eclipse.ui/Eclipse UI/org/eclipse/ui/internal/ProblemImageProvider.java;2;0;3;1;0;0;0;3;15;1;3;257;22;22;1;0;0;3;3;257;0;2568;3;2;
/org.eclipse.jdt.ui.tests.refactoring/resources/MoveCU/test1/out/p/B.java;2;0;2;1;0;0;0;2;0;1;2;49;0;0;1;0;0;2;2;49;0;2769;2;2;
/org.eclipse.jdt.ui.tests.refactoring/resources/ExtractMethodWorkSpace/ExtractMethodTests/validSelection/A_test282.java;2;1;3;1;2;2;2;1;0;0;1;49;0;0;1;0;0;1;3;49;0;4419;3;2;
/org.eclipse.jdt.junit/Eclipse JUnit/org/eclipse/jdt/internal/junit/util/SocketUtil.java;2;0;2;1;0;0;0;2;0;1;2;2861;0;0;1;0;0;2;2;2861;0;3205;2;2;
/org.eclipse.help/Eclipse Help/org/eclipse/help/internal/contributors/xml/ContributorFactory.java;2;0;4;1;0;0;0;4;26;1;4;135;33;33;1;0;0;4;4;135;0;1420;4;2;
/org.eclipse.jdt.debug/model/org/eclipse/jdt/internal/debug/pattern/PatternBreakpointFactory.java;1;0;1;1;0;0;0;1;0;0;1;971;0;0;1;0;0;1;1;971;0;971;1;1;
/org.eclipse.update/Eclipse Update/org/eclipse/update/internal/ui/UMWizardTreeItemComparator.java;2;0;4;1;0;0;0;4;90;1;4;108;94;94;1;0;0;4;4;108;0;1424;4;2;
/org.eclipse.swt/Eclipse SWT Printing/gtk1x/org/eclipse/swt/printing/PrintDialog.java;3;0;3;1;1;1;1;2;6;1;2;2107;7;7;1;0;0;2;3;2107;0;4701;3;3;
/org.eclipse.pde.core/src/org/eclipse/pde/core/plugin/IPluginModelFactory.java;1;0;3;1;2;1;2;1;56;0;1;3591;56;56;2;0;1;1;3;4751;1;4751;2;1;
/org.eclipse.pde.core/src/org/eclipse/pde/core/IEditable.java;1;0;4;1;2;1;2;2;40;1;2;3591;42;42;2;0;1;2;4;4751;1;4751;3;1;
/org.eclipse.swt/Eclipse SWT Drag and Drop/gtk1x/org/eclipse/swt/dnd/TableDragUnderEffect.java;2;0;2;1;0;0;0;2;0;1;2;2107;0;0;1;0;0;2;2;2107;0;3127;2;2;
/org.eclipse.jdt.debug.ui/ui/org/eclipse/jdt/internal/debug/ui/actions/ManageMethodBreakpointActionDelegate.java;2;2;6;2;6;5;6;0;58;0;0;4025;130;130;2;0;1;0;6;4391;1;4391;5;2;
/org.eclipse.jdt.core/search/org/eclipse/jdt/internal/core/search/matching/QualifiedTypeDeclarationPattern.java;2;0;2;1;1;1;1;1;15;0;1;2964;15;15;1;0;0;1;2;2964;0;4063;2;2;
/org.eclipse.jdt.core/dom/org/eclipse/jdt/core/dom/MethodBinding.java;3;0;6;1;0;0;0;6;19;1;6;2669;28;28;1;0;0;6;6;2669;0;3645;6;3;
/org.eclipse.jdt.junit/src/org/eclipse/jdt/internal/junit/util/LayoutUtil.java;2;0;4;1;0;0;0;4;12;2;3;3247;14;14;2;1;0;4;4;3396;1;3527;3;2;
/org.eclipse.jdt.ui/core codemanipulation/org/eclipse/jdt/internal/core/codemanipulation/TextBuffer.java;2;0;7;2;0;0;0;7;100;2;5;1800;169;169;2;2;0;7;7;1878;2;1937;5;2;
/org.eclipse.update.core/src/org/eclipse/update/core/model/DefaultModelWriter.java;2;0;3;1;0;0;0;3;231;1;3;2462;231;231;1;0;0;3;3;2462;0;2976;3;2;
/org.eclipse.jdt.core/compiler/org/eclipse/jdt/internal/compiler/lookup/InnerEmulationDependency.java;2;0;4;1;1;1;1;3;16;1;3;455;37;37;1;0;0;3;4;455;0;4062;4;2;
/org.eclipse.jdt.ui.tests.refactoring/resources/RenameNonPrivateField/testFail10/in/A.java;1;0;1;1;0;0;0;1;0;0;1;49;0;0;1;0;0;1;1;49;0;49;1;1;
/org.eclipse.ui/Eclipse UI Standard Components/org/eclipse/ui/views/bookmarkexplorer/CopyBookmarkAction.java;2;0;3;1;0;0;0;3;2;1;3;2994;4;4;1;0;0;3;3;2994;0;3607;3;2;
/org.eclipse.swt.examples.paint/org/eclipse/swt/examples/paint/SolidRectangleFigure.java;3;0;4;2;1;1;1;3;53;2;2;566;53;53;2;1;0;3;4;609;1;4024;3;3;
/org.eclipse.ui/Eclipse UI/org/eclipse/ui/internal/registry/ActionSetDescriptor.java;2;0;2;1;0;0;0;2;29;1;2;257;29;29;1;0;0;2;2;257;0;457;2;2;
/org.eclipse.webdav/src/client/org/eclipse/webdav/internal/authentication/DigestOutputStream.java;3;0;5;1;1;1;1;4;158;1;4;12;288;288;1;0;0;4;5;12;0;4211;5;3;
/org.eclipse.pde.ui/src/org/eclipse/pde/internal/component/BuildPluginAction.java;2;0;3;1;0;0;0;3;225;1;3;1434;225;225;1;0;0;3;3;1434;0;2951;3;2;
/org.eclipse.jdt.ui.tests.refactoring/resources/RenameType/test31/out/B.java;1;0;1;1;0;0;0;1;0;0;1;522;0;0;1;0;0;1;1;522;0;522;1;1;
/org.eclipse.pde.ui/Eclipse PDE UI/org/eclipse/pde/internal/model/PluginBase.java;2;0;8;2;0;0;0;8;12;3;6;267;31;31;3;2;0;8;8;324;2;1434;6;2;
/org.eclipse.help/src/org/eclipse/help/internal/protocols/search/SearchURLConnection.java;3;0;5;1;0;0;0;5;6;1;5;2318;6;6;1;0;0;5;5;2318;0;2694;5;3;
/org.eclipse.jdt.ui.tests.refactoring/resources/MoveMembers/test8/in/B.java;1;0;1;1;0;0;0;1;0;0;1;2738;0;0;1;0;0;1;1;2738;0;2738;1;1;
/org.eclipse.jdt.ui.tests.refactoring/resources/ExtractMethodWorkSpace/ExtractMethodTests/nested_out/A_test654.java;1;1;3;1;2;2;2;1;22;0;1;2327;22;22;1;0;0;1;3;2327;0;4419;3;1;
/org.eclipse.jdt.ui/ui/org/eclipse/jdt/internal/ui/reorg/ReorgMessages.java;2;0;3;1;0;0;0;3;13;1;3;739;19;19;1;0;0;3;3;739;0;2138;3;2;
/org.eclipse.help.ui/src/org/eclipse/help/internal/ui/win32/WebBrowser.java;2;0;5;1;0;0;0;5;103;1;5;1420;196;196;1;0;0;5;5;1420;0;3030;5;2;
/org.eclipse.update.core/src/org/eclipse/update/internal/core/UpdateManagerUtils.java;2;2;72;2;22;19;22;50;287;3;39;1577;2429;2429;3;11;3;50;72;1638;14;4820;58;2;
/org.eclipse.core.boot/src/org/eclipse/core/internal/boot/update/PluginEntryDescriptor.java;2;0;3;1;0;0;0;3;7;1;3;12;7;7;1;0;0;3;3;12;0;2726;3;2;
/org.eclipse.jdt.ui.tests.refactoring/resources/RenameType/testWrongArg4/in/A.java;1;0;1;1;0;0;0;1;0;0;1;49;0;0;1;0;0;1;1;49;0;49;1;1;
/org.eclipse.scripting/Eclipse Scripting/org/eclipse/scripting/internal/uirenderer/XGRElementUISwtPropertySheet.java;2;0;5;1;0;0;0;5;17;1;5;133;24;24;1;0;0;5;5;133;0;1424;5;2;
/org.eclipse.jdt.ui.tests.refactoring/resources/DeleteSourceReference/A_test3_out.java;1;0;2;1;0;0;0;2;0;1;2;2003;0;0;1;0;0;2;2;2003;0;2857;2;1;
/org.eclipse.core.runtime/src/org/eclipse/core/runtime/Path.java;4;0;15;1;1;1;1;14;1696;2;12;12;2762;2762;2;2;0;14;15;497;2;4214;13;4;
/org.eclipse.pde.ui/src/org/eclipse/pde/internal/base/IPluginStructureData.java;2;0;4;1;0;0;0;4;20;1;4;1434;28;28;1;0;0;4;4;1434;0;3039;4;2;
/org.eclipse.ui/Eclipse UI/org/eclipse/ui/internal/DecoratorRegistryReader.java;1;0;10;1;1;1;1;9;78;1;9;1932;163;163;1;0;0;9;10;1932;0;3918;10;1;
/org.eclipse.pde.ui/Eclipse PDE UI/org/eclipse/pde/internal/forms/IFormTextListener.java;2;0;6;2;0;0;0;6;12;3;4;267;13;13;3;2;0;6;6;324;2;1434;4;2;
/org.eclipse.update.core/src/org/eclipse/update/core/IInstallHandler.java;1;0;2;1;0;0;0;2;180;1;2;3398;180;180;1;0;0;2;2;3398;0;3529;2;1;
/org.eclipse.ui/Eclipse UI/org/eclipse/ui/dialogs/FileEditorMappingContentProvider.java;2;0;2;1;0;0;0;2;5;1;2;257;5;5;1;0;0;2;2;257;0;457;2;2;
/org.eclipse.jdt.core/compiler/org/eclipse/jdt/internal/compiler/IDocumentElementRequestor.java;2;1;7;1;2;2;2;5;727;2;4;455;759;759;2;1;0;5;7;3084;1;4062;6;2;
/org.eclipse.vcm.core.cvs/src/org/eclipse/vcm/internal/core/ccvs/client/ProcessConnection.java;2;0;3;1;0;0;0;3;25;1;3;0;25;25;1;0;0;3;3;0;0;197;3;2;
/org.eclipse.pde.ui/src/org/eclipse/pde/internal/ui/util/ChoiceCellEditor.java;1;0;1;1;0;0;0;1;0;0;1;3579;0;0;1;0;0;1;1;3579;0;3579;1;1;
/org.eclipse.compare/compare/org/eclipse/compare/internal/TextViewerCreator.java;2;0;3;1;0;0;0;3;5;1;3;14;7;7;1;0;0;3;3;14;0;3183;3;2;
/org.eclipse.swt/Eclipse SWT/gtk/org/eclipse/swt/widgets/Display.java;6;2;35;2;13;11;13;22;1077;4;15;2107;2230;2230;4;7;2;22;35;3604;9;4701;26;6;
/org.eclipse.jdt.core/model/org/eclipse/jdt/internal/core/IJavaReconciler.java;1;0;4;1;0;0;0;4;76;1;4;455;93;93;1;0;0;4;4;455;0;1755;4;1;
/org.eclipse.vcm.core/src/org/eclipse/vcm/internal/core/ProjectDescriptionContentHandler.java;4;0;4;2;0;0;0;4;18;2;3;0;22;22;2;1;0;4;4;292;1;292;3;4;
/org.eclipse.pde.ui/Eclipse PDE UI/org/eclipse/pde/internal/base/model/component/IComponentPlugin.java;2;0;5;2;0;0;0;5;12;3;3;267;12;12;3;2;0;5;5;324;2;1434;3;2;
/org.eclipse.jdt.ui.tests.refactoring/resources/ExtractMethodWorkSpace/ExtractMethodTests/validSelection_in/A_test361.java;1;1;3;1;2;2;2;1;16;0;1;2621;16;16;1;0;0;1;3;2621;0;4419;3;1;
/org.eclipse.pde.ui/Eclipse PDE UI/org/eclipse/pde/internal/editor/component/ComponentOutlinePage.java;2;0;5;2;0;0;0;5;12;3;3;267;12;12;3;2;0;5;5;324;2;1434;3;2;
/org.eclipse.pde.ui/src/org/eclipse/pde/internal/editor/feature/PluginSection.java;1;0;11;1;0;0;0;11;399;3;8;2951;553;553;3;3;0;11;11;2951;3;3579;8;1;
/org.eclipse.compare/compare/org/eclipse/compare/structuremergeviewer/DiffContainer.java;1;0;2;1;0;0;0;2;5;1;2;14;5;5;1;0;0;2;2;14;0;329;2;1;
/org.eclipse.jdt.ui.tests.refactoring/resources/AbstractField/can/A_test3_out.java;1;0;1;1;0;0;0;1;0;0;1;751;0;0;1;0;0;1;1;751;0;751;1;1;
/org.eclipse.ui/Eclipse UI Tool Script/org/eclipse/toolscript/ui/internal/LogConsoleDocument.java;1;1;2;1;2;2;2;0;11;0;0;4065;11;11;1;0;0;0;2;4065;0;4087;2;1;
/org.eclipse.swt/Eclipse SWT Custom Widgets/common_j2se/org/eclipse/swt/custom/StyleRange.java;1;0;1;1;0;0;0;1;0;0;1;1378;0;0;1;0;0;1;1;1378;0;1378;1;1;
/org.eclipse.jdt.ui.tests.refactoring/resources/RenameMethodInInterface/test17/out/A.java;2;0;2;1;0;0;0;2;4;1;2;49;4;4;1;0;0;2;2;49;0;1297;2;2;
/org.eclipse.vcm.core.cvs/src/org/eclipse/vcm/internal/core/ccvs/client/Client.java;6;0;23;2;0;0;0;23;76;2;21;0;426;426;2;2;0;23;23;148;2;1627;21;6;
/org.eclipse.jdt.ui.tests.refactoring/resources/PullUpMethods/test5/in/B.java;1;0;2;1;0;0;0;2;0;1;2;2156;0;0;1;0;0;2;2;2156;0;2406;2;1;
/org.eclipse.pde.ui/Eclipse PDE UI/org/eclipse/pde/internal/editor/schema/GrammarPropertySource.java;2;0;5;2;0;0;0;5;12;3;3;267;12;12;3;2;0;5;5;324;2;1434;3;2;
/org.eclipse.jdt.ui/ui/org/eclipse/jdt/internal/ui/browsing/JavaElementContentProvider.java;1;2;14;1;4;3;4;10;51;1;10;2878;212;212;2;0;1;10;14;4018;1;4018;13;1;
/org.eclipse.jdt.ui.tests.refactoring/resources/RenamePrivateMethod/test18/in/A.java;1;0;1;1;0;0;0;1;0;0;1;49;0;0;1;0;0;1;1;49;0;49;1;1;
/org.eclipse.jdt.debug/jdi interfaces/com/sun/jdi/event/BreakpointEvent.java;2;0;2;1;0;0;0;2;8;1;2;2704;8;8;1;0;0;2;2;2704;0;3040;2;2;
/org.eclipse.jdt.ui.tests.refactoring/resources/RenameType/testFail57/in/A.java;1;0;1;1;0;0;0;1;0;0;1;49;0;0;1;0;0;1;1;49;0;49;1;1;
/org.eclipse.swt.examples.paint/org/eclipse/swt/examples/paint/RectangleTool.java;4;0;5;2;1;1;1;4;91;2;3;513;95;95;2;1;0;4;5;609;1;4024;4;4;
/org.eclipse.team.core/src/org/eclipse/team/core/sync/RemoteSyncElement.java;3;2;24;2;9;7;9;15;204;4;10;2019;650;650;4;5;2;15;24;2053;7;4707;17;3;
/org.eclipse.ui/Eclipse JFace/org/eclipse/jface/viewers/ContentViewer.java;4;0;4;1;0;0;0;4;16;1;4;257;31;31;1;0;0;4;4;257;0;3850;4;4;
/org.eclipse.vcm.core.cvs/src/org/eclipse/vcm/internal/core/ccvs/client/CVSAuthenticationException.java;5;0;8;2;0;0;0;8;14;2;7;0;39;39;2;1;0;8;8;241;1;1568;7;5;
/org.eclipse.jdt.core/model/org/eclipse/jdt/internal/core/builder/impl/INode.java;1;0;2;1;0;0;0;2;0;1;2;455;0;0;1;0;0;2;2;455;0;2808;2;1;
/org.eclipse.core.boot/src/org/eclipse/core/internal/boot/update/LogStore.java;5;0;8;2;0;0;0;8;71;3;6;12;90;90;3;2;0;8;8;323;2;2726;6;5;
/org.eclipse.jdt.debug/eval/org/eclipse/jdt/internal/debug/eval/ast/engine/Jump.java;1;0;2;1;0;0;0;2;0;1;2;3329;0;0;1;0;0;2;2;3329;0;3421;2;1;
/org.eclipse.jdt.ui.tests.refactoring/resources/RenameTemp/cannotRename/A_testFail14.java;1;0;2;1;0;0;0;2;2;1;2;1625;2;2;1;0;0;2;2;1625;0;1652;2;1;
/org.eclipse.help/webapps/examples/WEB-INF/classes/sessions/DummyCart.java;1;0;2;1;0;0;0;2;0;1;2;1882;0;0;1;0;0;2;2;1882;0;1930;2;1;
/org.eclipse.team.cvs.ui/src/org/eclipse/team/internal/ccvs/ui/actions/UnmanageAction.java;3;1;15;1;3;3;3;12;79;2;11;2690;158;158;2;1;0;12;15;3701;1;4632;14;3;
/org.eclipse.team.cvs.ui/src/org/eclipse/team/internal/ccvs/ui/model/CVSResourceElement.java;1;0;3;1;0;0;0;3;33;1;3;3545;35;35;1;0;0;3;3;3545;0;3610;3;1;
/org.eclipse.jdt.ui/core refactoring/org/eclipse/jdt/internal/core/refactoring/reorg/ReorgUtils.java;2;0;3;1;0;0;0;3;2;1;3;1258;2;2;1;0;0;3;3;1258;0;1939;3;2;
/org.eclipse.pde.ui/src/org/eclipse/pde/internal/editor/manifest/ManifestSourcePage.java;2;0;2;1;0;0;0;2;0;1;2;1434;0;0;1;0;0;2;2;1434;0;3579;2;2;
/org.eclipse.pde.ui/src/org/eclipse/pde/internal/ui/view/ModelEntryPropertySource.java;1;0;1;1;0;0;0;1;0;0;1;3579;0;0;1;0;0;1;1;3579;0;3579;1;1;
/org.eclipse.update.ui.forms/src/org/eclipse/update/ui/forms/internal/ExpandableGroup.java;1;0;3;1;0;0;0;3;5;1;3;2470;7;7;1;0;0;3;3;2470;0;3727;3;1;
/org.eclipse.vcm.ui.cvs/src/org/eclipse/vcm/internal/ui/ccvs/FilterRepositoryMainPage.java;1;0;4;1;0;0;0;4;309;1;4;1424;462;462;1;0;0;4;4;1424;0;1578;4;1;
/org.eclipse.scripting/src/org/eclipse/scripting/internal/views/ScriptUIEditorContextContributor.java;1;0;1;1;0;0;0;1;0;0;1;1424;0;0;1;0;0;1;1;1424;0;1424;1;1;
/org.eclipse.pde.ui/src/org/eclipse/pde/internal/component/ComponentJarWizard.java;2;0;2;1;0;0;0;2;0;1;2;1434;0;0;1;0;0;2;2;1434;0;2951;2;2;
/org.eclipse.jdt.ui.tests/JUnit/junit/framework/TestResult.java;2;0;2;1;0;0;0;2;0;1;2;49;0;0;1;0;0;2;2;49;0;1186;2;2;
/org.eclipse.ui/Eclipse UI/org/eclipse/ui/internal/dialogs/DialogUtil.java;3;0;3;1;0;0;0;3;18;1;3;257;23;23;1;0;0;3;3;257;0;1382;3;3;
/org.eclipse.pde/src/org/eclipse/pde/internal/builders/SchemaTransformer.java;1;0;3;1;0;0;0;3;569;2;2;3631;569;569;2;1;0;3;3;3798;1;3798;2;1;
/org.eclipse.ui/Eclipse UI Text Editor/org/eclipse/ui/texteditor/AddMarkerAction.java;4;0;5;1;1;1;1;4;137;1;4;257;181;181;1;0;0;4;5;257;0;4465;5;4;
/org.eclipse.search/search/org/eclipse/search/internal/ui/WorkingSetComparator.java;1;0;1;1;0;0;0;1;0;0;1;3760;0;0;1;0;0;1;1;3760;0;3760;1;1;
/org.eclipse.swt/Eclipse SWT/gtk1x/org/eclipse/swt/widgets/TabFolder.java;2;0;2;1;1;1;1;1;6;0;1;2107;6;6;1;0;0;1;2;2107;0;4701;2;2;
/org.eclipse.ui.examples.javaeditor/Java Editor Example/org/eclipse/ui/examples/javaeditor/JavaTextHover.java;1;0;2;1;0;0;0;2;0;0;1;1066;0;0;2;1;0;2;2;1066;1;1066;1;1;
/org.eclipse.ui.tests/Eclipse UI Tests/org/eclipse/ui/tests/dialogs/PropertyDialogWrapper.java;1;0;1;1;0;0;0;1;0;0;1;1113;0;0;1;0;0;1;1;1113;0;1113;1;1;
/org.eclipse.jdt.ui.tests.refactoring/resources/MoveCU/testFail9/in/p1/C.java;2;0;2;1;0;0;0;2;0;1;2;49;0;0;1;0;0;2;2;49;0;2769;2;2;
/org.eclipse.scripting/src/org/eclipse/scripting/internal/ScriptManager.java;1;0;1;1;0;0;0;1;0;0;1;1424;0;0;1;0;0;1;1;1424;0;1424;1;1;
/org.eclipse.jdt.ui/ui/org/eclipse/jdt/internal/ui/wizards/NewInterfaceCreationWizard.java;3;1;11;1;2;2;2;9;14;2;7;15;53;53;2;2;0;9;11;144;2;4621;9;3;
/org.eclipse.pde.ui/src/org/eclipse/pde/internal/ui/wizards/imports/BinaryProjectDecorator.java;1;1;5;1;3;3;3;2;48;1;2;3579;93;93;1;0;0;2;5;3579;0;4554;5;1;
/org.eclipse.pde.ui/Eclipse PDE UI/org/eclipse/pde/internal/wizards/WizardTreeSelectionPage.java;2;0;5;2;0;0;0;5;12;3;3;267;12;12;3;2;0;5;5;324;2;1434;3;2;
/org.eclipse.vcm.ui/src/org/eclipse/vcm/internal/ui/actions/BrowseHistoryAction.java;3;0;13;2;0;0;0;13;67;2;9;1;226;226;2;4;0;13;13;1;4;1637;9;3;
/org.eclipse.team.cvs.core/src/org/eclipse/team/internal/ccvs/core/connection/PServerConnection.java;3;0;6;1;1;1;1;5;508;1;5;1978;592;592;1;0;0;5;6;1978;0;4169;6;3;
/org.eclipse.update.ui/src/org/eclipse/update/internal/ui/parts/EnvironmentUtil.java;1;0;1;1;1;1;1;0;0;0;0;4108;0;0;1;0;0;0;1;4108;0;4108;1;1;
/org.eclipse.jdt.ui.tests.refactoring/resources/RenameVariables/canRename/A_test1_out.java;1;0;2;1;0;0;0;2;0;1;2;724;0;0;1;0;0;2;2;724;0;1665;2;1;
/org.eclipse.ui/Eclipse UI/org/eclipse/ui/part/DrillDownComposite.java;2;0;2;1;0;0;0;2;5;1;2;257;5;5;1;0;0;2;2;257;0;457;2;2;
/org.eclipse.team.examples.filesystem/src/org/eclipse/team/examples/filesystem/FileSystemSimpleAccessOperations.java;1;1;2;1;2;2;2;0;140;0;0;4674;140;140;1;0;0;0;2;4674;0;4727;2;1;
/org.eclipse.pde.ui/src/org/eclipse/pde/core/build/IBuild.java;1;0;3;1;0;0;0;3;5;2;2;3579;5;5;2;1;0;3;3;3579;1;3607;2;1;
/org.eclipse.core.target/src/org/eclipse/core/internal/target/RemoteFile.java;1;0;3;1;0;0;0;3;15;2;2;668;15;15;2;1;0;3;3;668;1;713;2;1;
/org.eclipse.pde.ui/src/org/eclipse/pde/internal/editor/component/SynchronizeVersionsWizardPage.java;2;0;2;1;0;0;0;2;0;1;2;1434;0;0;1;0;0;2;2;1434;0;2951;2;2;
/org.eclipse.team.ftp/src/org/eclipse/team/internal/ftp/FTPPlugin.java;1;1;2;1;2;2;2;0;4;0;0;4241;4;4;1;0;0;0;2;4241;0;4250;2;1;
/org.eclipse.jdt.ui/ui debug/org/eclipse/jdt/internal/debug/ui/ITimeoutListener.java;2;0;2;1;0;0;0;2;0;1;2;1805;0;0;1;0;0;2;2;1805;0;1916;2;2;
/org.eclipse.pde.ui/src/org/eclipse/pde/core/plugin/IPluginExtension.java;1;0;3;1;0;0;0;3;4;2;2;3579;4;4;2;1;0;3;3;3579;1;3607;2;1;
/org.eclipse.jdt.debug/eval/org/eclipse/jdt/internal/debug/eval/ast/engine/ConditionalJump.java;1;0;2;1;0;0;0;2;0;1;2;3329;0;0;1;0;0;2;2;3329;0;3421;2;1;
/org.eclipse.ui/Eclipse UI/org/eclipse/ui/internal/model/WorkbenchAdapterBuilder.java;2;0;2;1;0;0;0;2;5;1;2;257;5;5;1;0;0;2;2;257;0;457;2;2;
/org.eclipse.pde.ui/src/org/eclipse/pde/internal/ui/wizards/WizardListSelectionPage.java;1;0;2;1;1;1;1;1;14;0;1;3579;14;14;1;0;0;1;2;3579;0;4167;2;1;
/org.eclipse.pde.ui/src/org/eclipse/pde/internal/wizards/templates/PluginReference.java;1;0;2;1;0;0;0;2;0;1;2;3278;0;0;1;0;0;2;2;3278;0;3579;2;1;
/org.eclipse.pde.ui/src/org/eclipse/pde/internal/core/ifeature/IFeatureURL.java;1;0;2;1;0;0;0;2;0;1;2;3591;0;0;1;0;0;2;2;3591;0;3607;2;1;
/org.eclipse.swt/Eclipse SWT OLE Win32/win32/org/eclipse/swt/internal/ole/win32/IOleObject.java;2;0;3;1;0;0;0;3;5;1;3;106;5;5;1;0;0;3;3;106;0;2069;3;2;
/org.eclipse.ui.tests/Eclipse JFace Tests/org/eclipse/jface/tests/viewers/interactive/ResetFilterAction.java;1;0;1;1;0;0;0;1;0;0;1;1488;0;0;1;0;0;1;1;1488;0;1488;1;1;
/org.eclipse.pde.ui/Eclipse PDE UI/org/eclipse/pde/internal/model/PluginModelFactory.java;2;0;5;2;0;0;0;5;12;3;3;267;12;12;3;2;0;5;5;324;2;1434;3;2;
/org.eclipse.jdt.ui.tests.refactoring/resources/RenameType/testFail6/in/B.java;1;0;1;1;0;0;0;1;0;0;1;49;0;0;1;0;0;1;1;49;0;49;1;1;
/org.eclipse.pde.core/src/org/eclipse/pde/internal/core/schema/MappedSchemaDescriptor.java;1;0;2;1;0;0;0;2;39;1;2;3591;39;39;1;0;0;2;2;3591;0;3607;2;1;
/org.eclipse.swt/Eclipse SWT PI/win32/org/eclipse/swt/internal/win32/TCITEM.java;2;0;2;1;1;1;1;1;6;0;1;2069;6;6;1;0;0;1;2;2069;0;4701;2;2;
/org.eclipse.pde.ui/src/org/eclipse/pde/internal/ui/editor/schema/SchemaFormOutlinePage.java;1;0;3;1;0;0;0;3;16;2;2;3579;18;18;2;1;0;3;3;3579;1;3591;2;1;
/org.eclipse.update/Eclipse Update/org/eclipse/update/internal/ui/UMWizardPageComplete.java;2;0;4;1;0;0;0;4;198;1;4;108;202;202;1;0;0;4;4;108;0;1424;4;2;
/org.eclipse.update.ui/src/org/eclipse/update/ui/internal/UpdateUIPlugin.java;1;0;2;1;0;0;0;2;0;0;1;1426;0;0;2;1;0;2;2;1426;1;1426;1;1;
/org.eclipse.jdt.core/compiler/org/eclipse/jdt/internal/compiler/ast/TypeReference.java;2;1;4;1;2;2;2;2;148;1;2;455;163;163;1;0;0;2;4;455;0;4421;4;2;
/org.eclipse.jdt.ui.tests.refactoring/resources/DeleteSourceReferenceEdit/A_test3_in.java;1;0;1;1;0;0;0;1;0;0;1;2857;0;0;1;0;0;1;1;2857;0;2857;1;1;
/org.eclipse.swt/Eclipse SWT Drag and Drop/photon/org/eclipse/swt/dnd/TreeDragUnderEffect.java;3;1;5;1;2;2;2;3;6;1;3;106;20;20;1;0;0;3;5;106;0;4701;5;3;
/org.eclipse.jdt.ui/core refactoring/org/eclipse/jdt/internal/corext/refactoring/changes/MoveResourceChange.java;2;0;3;1;1;1;1;2;7;1;2;1939;13;13;1;0;0;2;3;1939;0;4212;3;2;
/org.eclipse.swt/Eclipse SWT/motif/org/eclipse/swt/internal/motif/XFocusChangeEvent.java;2;0;3;1;0;0;0;3;4;1;3;106;4;4;1;0;0;3;3;106;0;2069;3;2;
/org.eclipse.pde.ui/src/org/eclipse/pde/internal/ui/RunningInstanceManager.java;1;0;3;1;0;0;0;3;12;1;3;3579;12;12;1;0;0;3;3;3579;0;3679;3;1;
/org.eclipse.core.resources/src/org/eclipse/core/internal/localstore/SafeChunkyInputStream.java;3;0;8;1;1;1;1;7;289;1;7;12;304;304;1;0;0;7;8;12;0;4214;8;3;
/org.eclipse.jdt.ui/ui/org/eclipse/jdt/internal/ui/launcher/StackFrameAction.java;2;0;3;1;0;0;0;3;5;1;3;15;5;5;1;0;0;3;3;15;0;1916;3;2;
/org.eclipse.swt.tests/JUnit Tests/org/eclipse/swt/tests/junit/Test_org_eclipse_swt_events_MouseEvent.java;2;0;2;1;1;1;1;1;6;0;1;1792;6;6;1;0;0;1;2;1792;0;4706;2;2;
/org.eclipse.help/src/org/eclipse/help/internal/util/URLCoder.java;1;0;4;1;0;0;0;4;83;1;4;1420;149;149;1;0;0;4;4;1420;0;3820;4;1;
/org.eclipse.vcm.ui.cvs/src/org/eclipse/vcm/internal/ui/ccvs/FilterProjectsAction.java;2;0;4;1;0;0;0;4;227;1;4;1008;229;229;1;0;0;4;4;1008;0;1387;4;2;
/org.eclipse.jdt.ui/core refactoring/org/eclipse/jdt/internal/corext/refactoring/structure/RenameParametersRefactoring.java;1;1;10;1;2;2;2;8;116;1;8;2630;159;159;1;0;0;8;10;2630;0;4013;10;1;
/org.eclipse.pde.ui/Eclipse PDE UI/org/eclipse/pde/internal/wizards/NewWizard.java;2;0;5;2;0;0;0;5;12;3;3;267;12;12;3;2;0;5;5;324;2;1434;3;2;
/org.eclipse.team.cvs.ui/src/org/eclipse/team/internal/ccvs/ui/model/RemoteRootElement.java;2;0;5;2;0;0;0;5;93;2;4;1978;141;141;2;1;0;5;5;2049;1;2126;4;2;
/org.eclipse.ui/Eclipse JFace Text/org/eclipse/jface/text/source/SourceViewerConfiguration.java;4;0;7;1;1;1;1;6;120;1;6;257;194;194;1;0;0;6;7;257;0;4838;7;4;
/org.eclipse.compare/compare/org/eclipse/compare/internal/ISavable.java;1;0;1;1;0;0;0;1;0;0;1;3170;0;0;1;0;0;1;1;3170;0;3170;1;1;
/org.eclipse.swt.tests/JUnit Tests/org/eclipse/swt/tests/junit/Test_org_eclipse_swt_widgets_Combo.java;2;0;2;1;1;1;1;1;6;0;1;1792;6;6;1;0;0;1;2;1792;0;4706;2;2;
/org.eclipse.team.tests.cvs.core/src/org/eclipse/team/tests/ccvs/core/JUnitTestCase.java;2;0;14;1;1;1;1;13;431;1;13;2536;648;648;1;0;0;13;14;2536;0;4568;14;2;
/org.eclipse.jdt.ui/ui/org/eclipse/jdt/internal/ui/javaeditor/AnnotationErrorTickProvider.java;1;0;3;1;0;0;0;3;7;1;3;1241;7;7;1;0;0;3;3;1241;0;2581;3;1;
/org.eclipse.jdt.ui/ui refactoring/org/eclipse/jdt/internal/ui/refactoring/nls/search/LibraryFilter.java;2;0;2;1;0;0;0;2;0;1;2;1922;0;0;1;0;0;2;2;1922;0;2155;2;2;
/org.eclipse.jdt.debug/eval/org/eclipse/jdt/internal/debug/eval/ast/instructions/ArrayInstruction.java;3;0;5;1;0;0;0;5;18;1;5;3421;34;34;1;0;0;5;5;3421;0;3670;5;3;
/org.eclipse.ui/Eclipse UI Standard Components/org/eclipse/ui/views/properties/StandardPropertiesAdapterFactory.java;2;0;2;1;0;0;0;2;5;1;2;257;5;5;1;0;0;2;2;257;0;457;2;2;
/org.eclipse.update.ui/src/org/eclipse/update/internal/ui/search/SearchSettings.java;1;0;2;1;1;1;1;1;0;0;1;3537;0;0;1;0;0;1;2;3537;0;4108;2;1;
/org.eclipse.jdt.debug/eval/org/eclipse/jdt/internal/debug/eval/model/EvaluationVM.java;2;0;4;1;0;0;0;4;14;2;3;3421;14;14;2;1;0;4;4;3555;1;3645;3;2;
/org.eclipse.scripting/Eclipse Scripting/org/eclipse/scripting/internal/IXGRElementUITableDataElement.java;1;0;3;1;0;0;0;3;4;1;3;133;4;4;1;0;0;3;3;133;0;1424;3;1;
/org.eclipse.jdt.ui/ui refactoring/org/eclipse/jdt/internal/ui/refactoring/nls/search/GotoMarkerAction.java;2;0;3;1;0;0;0;3;8;1;3;1922;8;8;1;0;0;3;3;1922;0;3530;3;2;
/org.eclipse.jdt.ui.tests/test plugin/org/eclipse/jdt/testplugin/util/FocusTestPass.java;2;0;2;1;1;1;1;1;9;0;1;2180;9;9;1;0;0;1;2;2180;0;4682;2;2;
/org.eclipse.jdt.ui.tests.refactoring/resources/RenameTemp/canRename/A_test35_out.java;1;0;2;1;0;0;0;2;2;0;1;2751;2;2;2;1;0;2;2;2751;1;2751;1;1;
/org.eclipse.scripting/Eclipse Scripting/org/eclipse/scripting/internal/ScriptNLTranslationManager.java;2;0;5;1;0;0;0;5;16;1;5;133;25;25;1;0;0;5;5;133;0;1424;5;2;
/org.eclipse.jdt.debug.tests/tests/org/eclipse/jdt/debug/tests/eval/StringPlusOpTests.java;2;1;3;1;3;3;3;0;18;0;0;4447;20;20;1;0;0;0;3;4447;0;4571;3;2;
/org.eclipse.jdt.ui.tests.refactoring/resources/RenameType/test10/out/A.java;1;0;2;1;0;0;0;2;0;1;2;49;0;0;1;0;0;2;2;49;0;522;2;1;
/org.eclipse.ui/Eclipse JFace/org/eclipse/jface/viewers/ViewerFilter.java;2;0;2;1;0;0;0;2;5;1;2;257;5;5;1;0;0;2;2;257;0;457;2;2;
/org.eclipse.core.tests.resources/src/org/eclipse/core/tests/resources/regression/SimpleBuilder.java;3;0;5;1;1;1;1;4;96;1;4;1794;124;124;1;0;0;4;5;1794;0;4516;5;3;
/org.eclipse.jdt.ui/ui refactoring/org/eclipse/jdt/internal/ui/refactoring/actions/NewMoveWrapper.java;1;0;2;1;0;0;0;2;0;1;2;3758;0;0;1;0;0;2;2;3758;0;3791;2;1;
/org.eclipse.pde.build/src/org/eclipse/pde/internal/build/IPDEBuildConstants.java;1;1;6;1;3;3;3;3;42;1;3;3672;47;47;1;0;0;3;6;3672;0;4273;6;1;
/org.eclipse.webdav/src/interface/org/eclipse/webdav/dom/Label.java;3;0;5;1;1;1;1;4;110;1;4;12;160;160;1;0;0;4;5;12;0;4211;5;3;
/org.eclipse.ui/Eclipse UI/org/eclipse/ui/internal/dialogs/WorkingSetDialog.java;1;0;1;1;0;0;0;1;0;0;1;3287;0;0;1;0;0;1;1;3287;0;3287;1;1;
/org.eclipse.jdt.ui/ui/org/eclipse/jdt/internal/ui/preferences/JavaElementInfoPage.java;5;1;12;1;4;4;4;8;34;1;8;15;104;104;1;0;0;8;12;15;0;4631;12;5;
/org.eclipse.update.ui/src/org/eclipse/update/internal/ui/UpdatePerspective.java;1;0;2;1;1;1;1;1;4;0;1;3662;4;4;1;0;0;1;2;3662;0;4409;2;1;
/org.eclipse.pde.ui/src/org/eclipse/pde/internal/preferences/ComboFieldEditor.java;1;0;4;1;0;0;0;4;46;1;4;3103;69;69;1;0;0;4;4;3103;0;3579;4;1;
/org.eclipse.ui/Eclipse JFace Text/org/eclipse/jface/text/IPositionUpdater.java;2;0;2;1;0;0;0;2;6;1;2;257;6;6;1;0;0;2;2;257;0;457;2;2;
/org.eclipse.ui/Eclipse JFace/org/eclipse/jface/action/SubMenuManager.java;5;1;11;1;5;5;5;6;79;1;6;257;306;306;1;0;0;6;11;257;0;4688;11;5;
/org.eclipse.jdt.ui/ui/org/eclipse/jdt/internal/ui/wizards/OpenClassWizardAction.java;4;1;6;1;2;2;2;4;12;1;4;15;28;28;1;0;0;4;6;15;0;4630;6;4;
/org.eclipse.swt.examples.paint/org/eclipse/swt/examples/paint/PaintTool.java;3;0;3;1;1;1;1;2;13;1;2;513;13;13;1;0;0;2;3;513;0;4024;3;3;
/org.eclipse.compare/compare/org/eclipse/compare/internal/patch/PatchErrorDialog.java;1;0;1;1;0;0;0;1;0;0;1;2876;0;0;1;0;0;1;1;2876;0;2876;1;1;
/org.eclipse.pde.ui/src/org/eclipse/pde/internal/preferences/MainPreferencePage.java;1;0;8;1;0;0;0;8;28;1;8;2750;69;69;1;0;0;8;8;2750;0;3579;8;1;
/org.eclipse.jdt.ui.tests.refactoring/resources/ReorderParameters/canReorder/A_test5_out.java;1;0;3;1;0;0;0;3;0;1;3;724;0;0;1;0;0;3;3;724;0;2270;3;1;
/org.eclipse.swt.tests/JUnit Tests/org/eclipse/swt/tests/junit/Test_org_eclipse_swt_custom_TreeEditor.java;2;0;2;1;1;1;1;1;6;0;1;1792;6;6;1;0;0;1;2;1792;0;4706;2;2;
/org.eclipse.swt/Eclipse SWT/motif/org/eclipse/swt/widgets/TabItem.java;2;0;5;1;0;0;0;5;158;1;5;106;376;376;1;0;0;5;5;106;0;1029;5;2;
/org.eclipse.jdt.debug.tests/tests/org/eclipse/jdt/debug/tests/eval/TypeHierarchy_21_6.java;2;1;3;1;3;3;3;0;13;0;0;4447;15;15;1;0;0;0;3;4447;0;4571;3;2;
/org.eclipse.jdt.ui/ui/org/eclipse/jdt/ui/actions/CustomFiltersActionGroup.java;3;2;8;1;8;7;8;0;33;0;0;4211;107;107;2;0;1;0;8;4360;1;4751;7;3;
/org.eclipse.team.cvs.ui/src/org/eclipse/team/internal/ccvs/ui/CVSProjectPropertiesPage.java;2;1;4;1;3;3;3;1;21;0;1;3763;25;25;1;0;0;1;4;3763;0;4829;4;2;
/org.eclipse.ui/Eclipse JFace Text/org/eclipse/jface/text/source/IAnnotationHover.java;3;0;3;1;0;0;0;3;5;1;3;257;7;7;1;0;0;3;3;257;0;1066;3;3;
/org.eclipse.jdt.core/search/org/eclipse/jdt/internal/core/index/impl/IndexBlock.java;2;2;5;1;3;2;3;2;18;1;2;455;47;47;2;0;1;2;5;3959;1;4063;4;2;
/org.eclipse.update.core/src/org/eclipse/update/internal/core/AbstractSite.java;1;0;11;1;0;0;0;11;73;3;8;1643;243;243;3;3;0;11;11;1740;3;1791;8;1;
/org.eclipse.update.core/src/org/eclipse/update/internal/security/CertificatePair.java;1;0;1;1;0;0;0;1;0;0;1;3191;0;0;1;0;0;1;1;3191;0;3191;1;1;
/org.eclipse.jdt.ui/ui refactoring/org/eclipse/jdt/internal/ui/refactoring/actions/RenameJavaElementAction.java;2;1;17;2;6;6;6;11;174;3;7;1258;309;309;3;4;0;11;17;3847;4;4629;13;2;
/org.eclipse.core.tests.runtime/src/org/eclipse/core/tests/internal/runtimetests/SampleLPB.java;1;0;2;1;0;0;0;2;10;1;2;3611;10;10;1;0;0;2;2;3611;0;3678;2;1;
/org.eclipse.pde.ui/Eclipse PDE UI/org/eclipse/pde/internal/wizards/extension/GenericExtensionWizard.java;2;0;7;2;0;0;0;7;12;3;5;267;19;19;3;2;0;7;7;324;2;1434;5;2;
/org.eclipse.pde.ui/Eclipse PDE UI/org/eclipse/pde/internal/base/model/plugin/IPluginAttribute.java;2;0;5;2;0;0;0;5;12;3;3;267;12;12;3;2;0;5;5;324;2;1434;3;2;
/org.eclipse.jdt.ui.tests/refactoring/org/eclipse/jdt/refactoring/tests/RenameVirtualMethodInClassTests.java;4;0;16;1;0;0;0;16;35;2;15;49;155;155;2;1;0;16;16;1342;1;1896;15;4;
/org.eclipse.pde.ui/src/org/eclipse/pde/internal/editor/text/IColorManager.java;2;0;2;1;0;0;0;2;0;1;2;1434;0;0;1;0;0;2;2;1434;0;3579;2;2;
/org.eclipse.jdt.ui.tests/JUnit/junit/tests/AllTests.java;2;0;2;1;0;0;0;2;0;1;2;49;0;0;1;0;0;2;2;49;0;1186;2;2;
/org.eclipse.jdt.junit/src/org/eclipse/jdt/internal/junit/launcher/JUnitLaunchConfiguration.java;2;1;6;1;3;3;3;3;24;1;3;3171;42;42;1;0;0;3;6;3171;0;4600;6;2;
/org.eclipse.jdt.ui.tests.refactoring/resources/ExtractMethodWorkSpace/ExtractMethodTests/invalidSelection/A_test105.java;2;1;3;1;2;2;2;1;0;0;1;49;0;0;1;0;0;1;3;49;0;4419;3;2;
/org.eclipse.jdt.core/model/org/eclipse/jdt/internal/core/jdom/AbstractDOMBuilder.java;2;3;9;1;4;2;4;5;296;2;4;455;337;337;3;1;2;5;9;3959;3;4063;6;2;
/org.eclipse.ui/Eclipse JFace Text/org/eclipse/jface/text/ITextOperationTargetExtension.java;1;1;2;1;2;2;2;0;23;0;0;4468;23;23;1;0;0;0;2;4468;0;4838;2;1;
/org.eclipse.scripting/Eclipse Scripting/org/eclipse/scripting/ScriptAdapterDelegatingWizard.java;2;0;4;1;0;0;0;4;16;1;4;133;22;22;1;0;0;4;4;133;0;1424;4;2;
/org.eclipse.jdt.core/model/org/eclipse/jdt/internal/core/builder/impl/ImageImpl.java;1;0;9;1;0;0;0;9;322;4;6;455;340;340;4;3;0;9;9;1039;3;2808;6;1;
/org.eclipse.swt/Eclipse SWT/photon/org/eclipse/swt/internal/photon/PgVideoModeInfo_t.java;2;0;2;1;0;0;0;2;0;1;2;621;0;0;1;0;0;2;2;621;0;2069;2;2;
/org.eclipse.jdt.ui.tests.refactoring/resources/RenamePackage/testFail10/in/r/A.java;1;0;1;1;0;0;0;1;0;0;1;1258;0;0;1;0;0;1;1;1258;0;1258;1;1;
/org.eclipse.jdt.debug.ui/ui/org/eclipse/jdt/internal/debug/ui/snippeteditor/SnippetOpenOnSelectionAction.java;2;1;5;1;2;2;2;3;91;1;3;1915;110;110;1;0;0;3;5;1915;0;4431;5;2;
/org.eclipse.jdt.ui.tests.refactoring/resources/MoveMembers/testFail22/in/A.java;1;0;1;1;0;0;0;1;0;0;1;2928;0;0;1;0;0;1;1;2928;0;2928;1;1;
/org.eclipse.jdt.debug/jdi/org/eclipse/jdi/internal/event/EventIteratorImpl.java;2;0;4;1;0;0;0;4;12;1;4;187;25;25;1;0;0;4;4;187;0;3677;4;2;
/org.eclipse.swt/Eclipse SWT PI/motif/org/eclipse/swt/internal/motif/XKeyEvent.java;2;0;2;1;1;1;1;1;6;0;1;2069;6;6;1;0;0;1;2;2069;0;4701;2;2;
/org.eclipse.team.webdav/src/org/eclipse/team/internal/webdav/ui/WebDavMainPage.java;4;3;14;2;14;10;14;0;60;0;0;4073;176;176;3;0;4;0;14;4164;4;4636;10;4;
/org.eclipse.pde.ui/Eclipse PDE UI/org/eclipse/pde/internal/editor/manifest/JavaAttributeCellEditor.java;2;0;6;2;0;0;0;6;12;3;4;267;16;16;3;2;0;6;6;324;2;1434;4;2;
/org.eclipse.vcm.tests.core.cvs/src/org/eclipse/vcm/tests/core/cvs/AllCVSTests.java;2;0;2;1;0;0;0;2;3;1;2;1688;3;3;1;0;0;2;2;1688;0;2085;2;2;
/org.eclipse.jdt.ui/ui/org/eclipse/jdt/internal/ui/search/WorkingSetComparator.java;1;0;4;1;1;1;1;3;2;1;3;1801;6;6;1;0;0;3;4;1801;0;4040;4;1;
/org.eclipse.jdt.core/dom/org/eclipse/jdt/core/dom/NumberLiteral.java;3;1;12;1;2;2;2;10;33;2;9;2669;85;85;2;1;0;10;12;2773;1;4421;11;3;
/org.eclipse.swt.examples.launcher/src/org/eclipse/swt/examples/launcher/LaunchDelegate.java;2;0;2;1;0;0;0;2;0;1;2;391;0;0;1;0;0;2;2;391;0;611;2;2;
/org.eclipse.ui/Eclipse JFace/org/eclipse/jface/viewers/ILabelProviderListener.java;2;0;2;1;0;0;0;2;5;1;2;257;5;5;1;0;0;2;2;257;0;457;2;2;
/org.eclipse.jdt.ui/ui/org/eclipse/jdt/internal/ui/util/TypeRef.java;3;0;6;1;0;0;0;6;24;1;6;15;55;55;1;0;0;6;6;15;0;1258;6;3;
/org.eclipse.jdt.core/model/org/eclipse/jdt/core/IType.java;4;2;14;1;6;5;6;8;992;2;6;455;1802;1802;2;2;1;8;14;3565;3;4493;11;4;
/org.eclipse.jdt.debug/jdi interfaces/com/sun/jdi/request/ExceptionRequest.java;2;0;2;1;0;0;0;2;14;1;2;2704;14;14;1;0;0;2;2;2704;0;3040;2;2;
/org.eclipse.jdt.ui.tests.refactoring/resources/DeleteSourceReference/test11/out/A.java;1;0;1;1;0;0;0;1;0;0;1;2857;0;0;1;0;0;1;1;2857;0;2857;1;1;
/org.eclipse.jdt.ui.tests.refactoring/resources/RenameMethodInInterface/test24/in/A.java;1;0;1;1;0;0;0;1;0;0;1;49;0;0;1;0;0;1;1;49;0;49;1;1;
/org.eclipse.help/webapps/examples/WEB-INF/classes/num/NumberGuessBean.java;1;0;2;1;0;0;0;2;0;1;2;1882;0;0;1;0;0;2;2;1882;0;1930;2;1;
/org.eclipse.pde.ui/templates/editor/java/IXMLColorConstants.java;1;0;2;1;1;1;1;1;4;0;1;3812;4;4;1;0;0;1;2;3812;0;4316;2;1;
/org.eclipse.ui/Eclipse UI/org/eclipse/ui/plugin/AbstractUIPlugin.java;7;0;13;1;0;0;0;13;641;2;12;257;830;830;2;1;0;13;13;3517;1;3649;12;7;
/org.eclipse.debug.core/core/org/eclipse/debug/core/model/IDebugElement.java;3;0;8;1;0;0;0;8;93;1;8;187;180;180;1;0;0;8;8;187;0;3512;8;3;
/org.eclipse.pde.ui/src/org/eclipse/pde/model/plugin/IPluginObject.java;1;0;2;1;0;0;0;2;0;1;2;3039;0;0;1;0;0;2;2;3039;0;3579;2;1;
/org.eclipse.scripting/Eclipse Scripting/org/eclipse/scripting/internal/uirenderer/XGRElementUISwtWizardPage.java;2;0;4;1;0;0;0;4;38;1;4;133;60;60;1;0;0;4;4;133;0;1424;4;2;
/org.eclipse.swt/Eclipse SWT Custom Widgets/common_j2se/org/eclipse/swt/custom/LineBackgroundListener.java;1;0;1;1;0;0;0;1;0;0;1;1378;0;0;1;0;0;1;1;1378;0;1378;1;1;
/org.eclipse.jdt.debug/eval/org/eclipse/jdt/internal/debug/eval/ast/engine/PushVariable.java;1;0;3;1;0;0;0;3;150;1;3;3329;150;150;1;0;0;3;3;3329;0;3421;3;1;
/org.eclipse.jdt.ui.tests.refactoring/resources/SurroundWithWorkSpace/SurroundWithTests/trycatch_out/TestWrappedLocal4.java;1;0;2;1;0;0;0;2;8;1;2;3209;8;8;1;0;0;2;2;3209;0;3870;2;1;
/org.eclipse.jdt.ui/core refactoring/org/eclipse/jdt/internal/corext/refactoring/code/flow/InputFlowAnalyzer.java;2;0;4;1;0;0;0;4;128;1;4;1939;190;190;1;0;0;4;4;1939;0;3173;4;2;
/org.eclipse.jdt.junit/Eclipse JUnit/org/eclipse/jdt/internal/junit/ui/CounterPanel.java;2;0;4;1;0;0;0;4;19;1;4;2007;38;38;1;0;0;4;4;2007;0;3313;4;2;
/org.eclipse.pde.build/src/org/eclipse/pde/internal/build/antwrappers/Cvs.java;2;0;2;1;0;0;0;2;0;1;2;2859;0;0;1;0;0;2;2;2859;0;2900;2;2;
/org.eclipse.core.resources/src/org/eclipse/core/internal/indexing/Field.java;3;0;7;1;1;1;1;6;394;1;6;12;701;701;1;0;0;6;7;12;0;4214;7;3;
/org.eclipse.help.ui/Eclipse Help UI/org/eclipse/help/internal/ui/ShowHelp.java;3;0;4;1;0;0;0;4;15;1;4;136;22;22;1;0;0;4;4;136;0;1420;4;3;
/org.eclipse.jdt.ui/ui/org/eclipse/jdt/internal/ui/text/template/TemplateCollector.java;4;0;10;1;0;0;0;10;34;1;10;1786;100;100;1;0;0;10;10;1786;0;2784;10;4;
/org.eclipse.jdt.debug.ui/ui/org/eclipse/jdt/internal/debug/ui/ProblemManager.java;1;0;3;1;0;0;0;3;54;2;2;2737;54;54;2;1;0;3;3;2737;1;2762;2;1;
/org.eclipse.update.core/src/org/eclipse/update/internal/core/SiteURL.java;2;0;11;1;0;0;0;11;15;2;10;1791;55;55;2;1;0;11;11;2004;1;2583;10;2;
/org.eclipse.jdt.ui.tests.refactoring/resources/ExtractTemp/canExtract/A_test25_in.java;1;0;1;1;0;0;0;1;0;0;1;2807;0;0;1;0;0;1;1;2807;0;2807;1;1;
/org.eclipse.ui.tests/Eclipse JFace Tests/org/eclipse/jface/tests/viewers/TestModel.java;1;0;1;1;0;0;0;1;0;0;1;1488;0;0;1;0;0;1;1;1488;0;1488;1;1;
/org.eclipse.jdt.ui/core refactoring/org/eclipse/jdt/internal/core/refactoring/nls/NLSRefactoring.java;2;0;4;1;0;0;0;4;48;2;2;1922;58;58;2;2;0;4;4;1922;2;1937;2;2;
/org.eclipse.jdt.ui/ui/org/eclipse/jdt/ui/actions/PullUpAction.java;3;2;8;2;8;7;8;0;130;0;0;3970;189;189;2;0;1;0;8;4382;1;4770;7;3;
/org.eclipse.jdt.ui.tests.refactoring/resources/SefWorkSpace/SefTests/base_in/TestPrefixBoolean.java;1;0;1;1;0;0;0;1;0;0;1;2876;0;0;1;0;0;1;1;2876;0;2876;1;1;
/org.eclipse.jdt.ui/ui refactoring/org/eclipse/jdt/internal/ui/refactoring/actions/RenameActionDelegate.java;3;0;10;1;0;0;0;10;65;2;9;1358;100;100;2;1;0;10;10;1358;1;3791;9;3;
/org.eclipse.jdt.ui/ui/org/eclipse/jdt/internal/ui/preferences/ZipFileFieldEditor.java;1;0;3;1;0;0;0;3;5;1;3;15;5;5;1;0;0;3;3;15;0;416;3;1;
/org.eclipse.jdt.core/compiler/org/eclipse/jdt/internal/compiler/ast/QualifiedAllocationExpression.java;2;1;16;1;2;2;2;14;522;4;11;455;1119;1119;4;3;0;14;16;1039;3;4421;13;2;
/org.eclipse.pde/src/org/eclipse/pde/internal/PluginProject.java;1;0;1;1;0;0;0;1;0;0;1;3631;0;0;1;0;0;1;1;3631;0;3631;1;1;
/org.eclipse.pde.ui/Eclipse PDE UI/org/eclipse/pde/internal/PDEPlugin.java;2;0;10;2;0;0;0;10;12;3;8;267;25;25;3;2;0;10;10;324;2;1434;8;2;
/org.eclipse.jdt.ui/ui/org/eclipse/jdt/internal/ui/dialogs/SelectionList.java;4;0;10;1;0;0;0;10;12;1;10;15;43;43;1;0;0;10;10;15;0;1299;10;4;
/org.eclipse.jdt.debug/jdi/org/eclipse/jdi/internal/event/StepEventImpl.java;3;0;5;1;1;1;1;4;16;1;4;187;32;32;1;0;0;4;5;187;0;4572;5;3;
/org.eclipse.swt/Eclipse SWT/gtk1x/org/eclipse/swt/widgets/Group.java;4;0;4;1;1;1;1;3;8;1;3;2107;16;16;1;0;0;3;4;2107;0;4701;4;4;
/org.eclipse.pde.ui/src/org/eclipse/pde/internal/wizards/project/WizardIdProjectCreationPage.java;2;0;3;1;0;0;0;3;4;1;3;1434;4;4;1;0;0;3;3;1434;0;3190;3;2;
/org.eclipse.jdt.ui.tests.refactoring/resources/StructureSelectionAction/A_test1.java;1;0;1;1;0;0;0;1;0;0;1;2139;0;0;1;0;0;1;1;2139;0;2139;1;1;
/org.eclipse.vcm.core/src/org/eclipse/vcm/internal/core/adapter/IServerWorkspace.java;2;0;2;1;0;0;0;2;6;1;2;0;6;6;1;0;0;2;2;0;0;297;2;2;
/org.eclipse.jdt.ui.tests.refactoring/resources/ReorderParameters/canReorder/A_test13_in.java;1;0;3;1;0;0;0;3;0;1;3;724;0;0;1;0;0;3;3;724;0;2270;3;1;
/org.eclipse.swt.examples/Eclipse SWT Examples/common/org/eclipse/swt/examples/helloworld/HelloWorld2.java;1;0;2;1;0;0;0;2;0;1;2;107;0;0;1;0;0;2;2;107;0;611;2;1;
/org.eclipse.jdt.ui/core refactoring/org/eclipse/jdt/internal/corext/refactoring/structure/MethodInvocationFinder.java;2;0;5;1;0;0;0;5;6;1;5;3065;15;15;1;0;0;5;5;3065;0;3188;5;2;
/org.eclipse.jdt.core/dom/org/eclipse/jdt/core/dom/SuperConstructorInvocation.java;2;1;7;1;2;2;2;5;15;1;5;2669;50;50;1;0;0;5;7;2669;0;4453;7;2;
/org.eclipse.pde.build/src/org/eclipse/pde/internal/build/ScriptBuilderTask.java;3;0;5;1;0;0;0;5;6;1;5;1331;17;17;1;0;0;5;5;1331;0;3089;5;3;
/org.eclipse.jdt.debug/eval/org/eclipse/jdt/internal/debug/eval/ast/instructions/OrOperator.java;3;0;6;1;0;0;0;6;35;1;6;3421;47;47;1;0;0;6;6;3421;0;3677;6;3;
/org.eclipse.core.tests.resources.saveparticipant/src/org/eclipse/core/tests/resources/saveparticipant/SaveManager3Test.java;3;0;6;1;0;0;0;6;304;1;6;1794;336;336;1;0;0;6;6;1794;0;3475;6;3;
/org.eclipse.help/src/org/eclipse/help/internal/topics/Topic.java;2;0;4;1;0;0;0;4;26;1;4;1675;30;30;1;0;0;4;4;1675;0;1857;4;2;
/org.eclipse.jdt.ui.tests.refactoring/resources/RenameType/test11/in/A.java;1;0;1;1;0;0;0;1;0;0;1;49;0;0;1;0;0;1;1;49;0;49;1;1;
/org.eclipse.jdt.ui/ui/org/eclipse/jdt/internal/ui/javadocexport/JavadocMemberContentProvider.java;4;1;9;1;3;3;3;6;12;1;6;2878;28;28;1;0;0;6;9;2878;0;4621;9;4;
/org.eclipse.pde.ui/src/org/eclipse/pde/internal/base/model/IModelProviderListener.java;2;0;2;1;0;0;0;2;0;1;2;1434;0;0;1;0;0;2;2;1434;0;3136;2;2;
/org.eclipse.pde.ui/Eclipse PDE UI/org/eclipse/pde/internal/editor/component/OpenReferenceAction.java;2;0;5;2;0;0;0;5;12;3;3;267;12;12;3;2;0;5;5;324;2;1434;3;2;
/org.eclipse.pde.ui/src/org/eclipse/pde/internal/core/plugin/PluginReference.java;1;0;2;1;0;0;0;2;0;1;2;3579;0;0;1;0;0;2;2;3579;0;3607;2;1;
/org.eclipse.jdt.ui.tests.refactoring/resources/RenameType/testFail26/in/B.java;1;0;1;1;0;0;0;1;0;0;1;49;0;0;1;0;0;1;1;49;0;49;1;1;
/org.eclipse.core.tests.resources/src/org/eclipse/core/tests/resources/regression/PR_1GHOM0N_Test.java;3;0;4;1;1;1;1;3;162;1;3;1794;182;182;1;0;0;3;4;1794;0;4516;4;3;
/org.eclipse.ui/Eclipse UI Standard Components/org/eclipse/ui/views/navigator/RefactorActionFactory.java;4;0;14;2;1;1;1;13;36;2;9;1830;146;146;2;4;0;13;14;1830;4;4067;10;4;
/org.eclipse.core.resources/src/org/eclipse/core/internal/indexing/Log.java;2;1;5;1;2;2;2;3;88;1;3;12;114;114;1;0;0;3;5;12;0;4632;5;2;
/org.eclipse.jdt.ui/ui/org/eclipse/jdt/internal/ui/snippeteditor/ScrapbookLauncherDelegate.java;2;0;7;1;0;0;0;7;28;1;7;1313;47;47;1;0;0;7;7;1313;0;1916;7;2;
/org.eclipse.scripting/src/org/eclipse/scripting/internal/views/ScriptUIEditorButtonPalette.java;1;0;1;1;0;0;0;1;0;0;1;1424;0;0;1;0;0;1;1;1424;0;1424;1;1;
/org.eclipse.jdt.ui/core refactoring/org/eclipse/jdt/internal/corext/refactoring/changes/DeleteProjectChange.java;2;0;2;1;0;0;0;2;0;1;2;1939;0;0;1;0;0;2;2;1939;0;2773;2;2;
/org.eclipse.jdt.core/model/org/eclipse/jdt/internal/core/SourceType.java;4;2;30;2;7;6;7;23;673;4;18;455;1011;1011;4;5;1;23;30;1039;6;4404;24;4;
/org.eclipse.swt/Eclipse SWT PI/photon/org/eclipse/swt/internal/photon/PhKeyEvent_t.java;2;0;2;1;1;1;1;1;6;0;1;2069;6;6;1;0;0;1;2;2069;0;4701;2;2;
/org.eclipse.jdt.ui.tests.refactoring/resources/MoveCU/test0/in/p1/C.java;2;0;2;1;0;0;0;2;0;1;2;49;0;0;1;0;0;2;2;49;0;2769;2;2;
/org.eclipse.swt/Eclipse SWT PI/win32/org/eclipse/swt/internal/win32/TVINSERTSTRUCT.java;2;0;2;1;1;1;1;1;6;0;1;2069;6;6;1;0;0;1;2;2069;0;4701;2;2;
/org.eclipse.core.tests.runtime/src/org/eclipse/core/tests/internal/plugins/RegressionResolveTest_1.java;3;0;3;1;0;0;0;3;132;1;3;1794;142;142;1;0;0;3;3;1794;0;3476;3;3;
/org.eclipse.swt/Eclipse SWT PI/gtk1x/org/eclipse/swt/internal/gtk/GtkBin.java;2;0;2;1;1;1;1;1;3;0;1;2107;3;3;1;0;0;1;2;2107;0;4701;2;2;
/org.eclipse.jdt.ui.tests.refactoring/resources/RenameNonPrivateField/test10/out/A.java;1;0;1;1;0;0;0;1;0;0;1;49;0;0;1;0;0;1;1;49;0;49;1;1;
/org.eclipse.jdt.core/codeassist/org/eclipse/jdt/internal/codeassist/select/SelectionOnSingleNameReference.java;2;0;10;1;1;1;1;9;44;4;6;455;96;96;4;3;0;9;10;1039;3;4062;7;2;
/org.eclipse.team.ftp/src/org/eclipse/team/internal/ftp/client/DataTransferInputStream.java;1;1;2;1;2;2;2;0;4;0;0;4287;4;4;1;0;0;0;2;4287;0;4573;2;1;
/org.eclipse.jdt.ui.tests.refactoring/resources/RenameType/testFail55/in/A.java;1;0;1;1;0;0;0;1;0;0;1;49;0;0;1;0;0;1;1;49;0;49;1;1;
/org.eclipse.debug.ui/ui/org/eclipse/debug/internal/ui/actions/RunWithConfigurationAction.java;2;1;3;1;2;2;2;1;11;0;1;3648;18;18;1;0;0;1;3;3648;0;4401;3;2;
/org.eclipse.pde.ui/src/org/eclipse/pde/internal/feature/BuildPluginWizardPage.java;1;0;6;1;0;0;0;6;54;2;5;2951;60;60;2;1;0;6;6;3102;1;3113;5;1;
/org.eclipse.jdt.debug.ui/ui/org/eclipse/jdt/internal/debug/ui/JDIAttachLauncher.java;2;0;11;1;0;0;0;11;92;1;11;1915;149;149;1;0;0;11;11;1915;0;3634;11;2;
/org.eclipse.jdt.ui.tests.refactoring/resources/RenameMethodInInterface/test21/out/A.java;1;0;1;1;0;0;0;1;0;0;1;49;0;0;1;0;0;1;1;49;0;49;1;1;
/org.eclipse.jdt.debug/eval/org/eclipse/jdt/internal/debug/eval/ast/instructions/EqualEqualOperator.java;3;0;7;1;1;1;1;6;44;1;6;3421;56;56;1;0;0;6;7;3421;0;3955;7;3;
/org.eclipse.swt/Eclipse SWT/common/org/eclipse/swt/events/SelectionAdapter.java;2;0;3;1;1;1;1;2;6;1;2;106;10;10;1;0;0;2;3;106;0;4701;3;2;
/org.eclipse.vcm.ui.cvs/src/org/eclipse/vcm/internal/ui/ccvs/DefineVersionAction.java;1;0;2;1;0;0;0;2;169;1;2;663;169;169;1;0;0;2;2;663;0;1240;2;1;
/org.eclipse.core.target/src/org/eclipse/core/target/IRemoteFolder.java;1;0;4;1;0;0;0;4;11;3;2;666;11;11;3;2;0;4;4;666;2;713;2;1;
/org.eclipse.update.tests.core/src/org/eclipse/update/tests/regularInstall/Test2.java;1;0;2;1;0;0;0;2;0;1;2;1497;0;0;1;0;0;2;2;1497;0;1643;2;1;
/org.eclipse.jdt.core/model/org/eclipse/jdt/internal/core/builder/impl/ReportCardImpl.java;1;0;10;1;0;0;0;10;247;4;6;455;265;265;4;4;0;10;10;1039;4;2808;6;1;
/org.eclipse.vcm.ui/src/org/eclipse/vcm/internal/ui/IVersionInfoRequestor.java;2;0;2;1;0;0;0;2;6;1;2;1;6;6;1;0;0;2;2;1;0;298;2;2;
/org.eclipse.vcm.core.cvs/src/org/eclipse/vcm/internal/core/ccvs/CVSEventThread.java;1;0;1;1;0;0;0;1;0;0;1;1050;0;0;1;0;0;1;1;1050;0;1050;1;1;
/org.eclipse.swt.tests/JUnit Tests/org/eclipse/swt/tests/junit/Test_org_eclipse_swt_custom_ST.java;2;0;2;1;1;1;1;1;6;0;1;1792;6;6;1;0;0;1;2;1792;0;4706;2;2;
/org.eclipse.jdt.ui.tests.refactoring/resources/MoveMembers/test2/out/B.java;1;0;1;1;0;0;0;1;0;0;1;2738;0;0;1;0;0;1;1;2738;0;2738;1;1;
/org.eclipse.jdt.core/model/org/eclipse/jdt/core/IJavaModelStatusConstants.java;3;1;17;1;5;5;5;12;56;4;9;455;255;255;4;3;0;12;17;1039;3;4573;14;3;
/org.eclipse.core.tests.runtime/src/org/eclipse/core/tests/internal/runtimetests/SampleB.java;1;0;3;1;0;0;0;3;10;2;2;3605;13;13;2;1;0;3;3;3605;1;3678;2;1;
/org.eclipse.jdt.ui.tests.refactoring/resources/RenamePackage/testFail8/in/p/A.java;2;0;2;1;0;0;0;2;0;1;2;49;0;0;1;0;0;2;2;49;0;1258;2;2;
/org.eclipse.swt/Eclipse SWT/photon/org/eclipse/swt/internal/photon/PhKeyEvent_t.java;3;0;4;1;0;0;0;4;6;1;4;106;11;11;1;0;0;4;4;106;0;2069;4;3;
/org.eclipse.jdt.debug/jdi/org/eclipse/jdi/internal/jdwp/JdwpString.java;2;0;4;1;0;0;0;4;8;1;4;187;21;21;1;0;0;4;4;187;0;3677;4;2;
/org.eclipse.team.core/src/org/eclipse/team/core/RepositoryProviderType.java;1;0;5;1;0;0;0;5;149;1;5;3193;158;158;1;0;0;5;5;3193;0;3268;5;1;
/org.eclipse.jdt.ui.tests.refactoring/resources/RenameNonPrivateField/test3/in/A.java;1;0;1;1;0;0;0;1;0;0;1;49;0;0;1;0;0;1;1;49;0;49;1;1;
/org.eclipse.team.ui/src/org/eclipse/team/internal/ui/target/CreateNewFolderAction.java;3;2;7;1;7;6;7;0;102;0;0;4256;267;267;2;0;1;0;7;4388;1;4636;6;3;
/org.eclipse.swt/Eclipse SWT PI/win32/org/eclipse/swt/internal/win32/TBBUTTONINFO.java;2;0;2;1;1;1;1;1;6;0;1;2069;6;6;1;0;0;1;2;2069;0;4701;2;2;
/org.eclipse.jdt.core/model/org/eclipse/jdt/internal/core/ValidateSourceElementOperation.java;1;0;3;1;0;0;0;3;77;1;3;455;77;77;1;0;0;3;3;455;0;1844;3;1;
/org.eclipse.vcm.core.cvs/src/org/eclipse/vcm/internal/core/ccvs/requests/ModTimeHandler.java;2;0;2;1;0;0;0;2;6;1;2;0;6;6;1;0;0;2;2;0;0;298;2;2;
/org.eclipse.jdt.debug.tests/testprograms/GotNewName.java;2;0;2;1;1;1;1;1;11;0;1;3719;11;11;1;0;0;1;2;3719;0;4571;2;2;
/org.eclipse.pde.ui/src/org/eclipse/pde/internal/core/ifeature/IFeatureImport.java;1;0;2;1;0;0;0;2;0;1;2;3591;0;0;1;0;0;2;2;3591;0;3607;2;1;
/org.eclipse.jdt.ui.tests.refactoring/resources/ExtractMethodWorkSpace/ExtractMethodTests/T11337.java;1;1;3;1;2;2;2;1;0;0;1;3220;0;0;1;0;0;1;3;3220;0;4419;3;1;
/org.eclipse.jdt.ui.tests.refactoring/resources/ExtractMethodWorkSpace/ExtractMethodTests/return_in/A_test700.java;1;1;3;1;2;2;2;1;8;0;1;887;8;8;1;0;0;1;3;887;0;4419;3;1;
/org.eclipse.swt/Eclipse SWT OLE Win32/win32/org/eclipse/swt/internal/ole/win32/IUnknown.java;2;0;3;1;0;0;0;3;5;1;3;106;5;5;1;0;0;3;3;106;0;2069;3;2;
/org.eclipse.jdt.ui/core refactoring/org/eclipse/jdt/core/refactoring/methods/ParameterOffsetFinder.java;1;0;5;1;0;0;0;5;11;2;4;233;22;22;2;1;0;5;5;233;1;408;4;1;
/org.eclipse.jdt.ui/core refactoring/org/eclipse/jdt/core/refactoring/RefactoringStatus.java;1;0;3;1;0;0;0;3;5;1;3;15;5;5;1;0;0;3;3;15;0;408;3;1;
/org.eclipse.core.resources/src/org/eclipse/core/internal/indexing/Convert.java;3;0;5;1;1;1;1;4;74;1;4;12;99;99;1;0;0;4;5;12;0;4214;5;3;
/org.eclipse.search/search/org/eclipse/search/internal/ui/ISearchHelpContextIds.java;2;0;5;1;1;1;1;4;10;1;4;472;22;22;1;0;0;4;5;472;0;4148;5;2;
/org.eclipse.core.resources/src/org/eclipse/core/internal/resources/ModelObjectWriter.java;3;0;8;1;2;1;2;6;276;2;5;12;355;355;2;1;1;6;8;1394;2;4209;6;3;
/org.eclipse.jdt.ui/ui/org/eclipse/jdt/ui/text/JavaSourceViewerConfiguration.java;5;2;37;2;7;5;7;30;64;2;26;15;580;580;2;4;2;30;37;1112;6;4810;31;5;
/org.eclipse.pde.build/src/org/eclipse/pde/internal/build/AbstractBuildScriptGeneratorTemp.java;1;3;11;1;10;6;10;1;108;0;1;3830;247;247;3;0;4;1;11;3956;4;4062;7;1;
/org.eclipse.jdt.debug/eval/org/eclipse/jdt/debug/eval/IEvaluationResult.java;2;0;6;1;0;0;0;6;40;1;6;1675;85;85;1;0;0;6;6;1675;0;3683;6;2;
/org.eclipse.help/Eclipse Help/org/eclipse/help/internal/contributions/Contribution.java;2;0;4;1;0;0;0;4;9;1;4;135;16;16;1;0;0;4;4;135;0;1420;4;2;
/org.eclipse.core.resources/src/org/eclipse/core/internal/resources/SyncInfoSnapReader_3.java;2;0;4;1;1;1;1;3;98;1;3;299;124;124;1;0;0;3;4;299;0;4213;4;2;
/org.eclipse.swt/Eclipse SWT/common/org/eclipse/swt/internal/image/PNGFileFormat.java;3;0;5;1;1;1;1;4;26;1;4;106;37;37;1;0;0;4;5;106;0;4701;5;3;
/org.eclipse.swt/Eclipse SWT PI/win32/org/eclipse/swt/internal/win32/OPENFILENAME.java;2;0;2;1;1;1;1;1;6;0;1;2069;6;6;1;0;0;1;2;2069;0;4701;2;2;
/org.eclipse.jdt.ui/ui/org/eclipse/jdt/internal/ui/workingsets/SelectWorkingSetAction.java;2;1;5;1;5;5;5;0;8;0;0;3897;18;18;1;0;0;0;5;3897;0;4630;5;2;
/org.eclipse.core.runtime/src/org/eclipse/core/internal/runtime/Assert.java;4;0;5;2;2;1;2;3;196;1;3;12;232;232;2;0;1;3;5;4213;1;4213;4;4;
/org.eclipse.jdt.ui/core extension/org/eclipse/jdt/internal/corext/codemanipulation/TextEdit.java;1;0;4;1;0;0;0;4;67;2;3;1937;69;69;2;1;0;4;4;2133;1;2133;3;1;
/org.eclipse.jdt.ui.tests.refactoring/resources/ExtractTemp/cannotExtract/A_testFail11.java;1;0;1;1;0;0;0;1;0;0;1;2873;0;0;1;0;0;1;1;2873;0;2873;1;1;
/org.eclipse.jdt.ui.tests.refactoring/resources/ExtractMethodWorkSpace/ExtractMethodTests/expression_in/A_test616.java;1;1;3;1;2;2;2;1;0;0;1;1236;0;0;1;0;0;1;3;1236;0;4419;3;1;
/org.eclipse.swt.examples.launcher/src/org/eclipse/swt/examples/launcher/URLAsFileInputAdapter.java;2;0;2;1;0;0;0;2;0;1;2;391;0;0;1;0;0;2;2;391;0;611;2;2;
/org.eclipse.ui/Eclipse JFace Text/org/eclipse/jface/text/rules/WordPatternRule.java;3;0;3;1;0;0;0;3;5;1;3;257;8;8;1;0;0;3;3;257;0;1066;3;3;
/org.eclipse.pde.ui/Eclipse PDE UI/org/eclipse/pde/internal/component/BuildConsoleViewer.java;2;0;5;2;0;0;0;5;12;3;3;267;12;12;3;2;0;5;5;324;2;1434;3;2;
/org.eclipse.ui/Eclipse JFace/org/eclipse/jface/viewers/ICombinedLabelDecorator.java;2;0;5;1;1;1;1;4;22;1;4;3420;30;30;1;0;0;4;5;3420;0;4006;5;2;
/org.eclipse.ui/Eclipse UI/org/eclipse/ui/internal/ResourcePerspective.java;2;0;2;1;0;0;0;2;15;1;2;257;15;15;1;0;0;2;2;257;0;457;2;2;
/org.eclipse.ui.externaltools/External Tools/org/eclipse/ui/externaltools/internal/ui/AntRunActionDelegate.java;1;0;1;1;1;1;1;0;0;0;0;4090;0;0;1;0;0;0;1;4090;0;4090;1;1;
/org.eclipse.pde.core/src/org/eclipse/pde/internal/core/ischema/ISchemaSimpleType.java;1;0;1;1;0;0;0;1;0;0;1;3591;0;0;1;0;0;1;1;3591;0;3591;1;1;
/org.eclipse.pde.ui/Eclipse PDE UI/org/eclipse/pde/internal/wizards/extension/NewExtensionPointWizard.java;2;0;5;2;0;0;0;5;12;3;3;267;12;12;3;2;0;5;5;324;2;1434;3;2;
/org.eclipse.jdt.ui.tests.refactoring/resources/RenameParameters/canRename/A_test5_in.java;1;0;1;1;0;0;0;1;0;0;1;233;0;0;1;0;0;1;1;233;0;233;1;1;
/org.eclipse.ui/Eclipse UI Standard Components/org/eclipse/ui/wizards/datatransfer/ZipFileExportWizard.java;2;0;3;1;0;0;0;3;17;1;3;257;24;24;1;0;0;3;3;257;0;2568;3;2;
/org.eclipse.jdt.ui/ui/org/eclipse/jdt/internal/ui/typehierarchy/TypeHierarchyMessages.java;1;0;1;1;0;0;0;1;0;0;1;742;0;0;1;0;0;1;1;742;0;742;1;1;
/org.eclipse.core.resources/src/org/eclipse/core/internal/indexing/FieldDef.java;2;0;3;1;1;1;1;2;36;1;2;448;51;51;1;0;0;2;3;448;0;4214;3;2;
/org.eclipse.jdt.core/dom/org/eclipse/jdt/core/dom/ExpressionStatement.java;2;1;6;1;2;2;2;4;11;1;4;2669;35;35;1;0;0;4;6;2669;0;4453;6;2;
/org.eclipse.jdt.ui/ui refactoring/org/eclipse/jdt/internal/ui/refactoring/AbstractOpenRefactoringWizardAction.java;2;0;9;1;0;0;0;9;8;2;8;15;28;28;2;1;0;9;9;433;1;1258;8;2;
/org.eclipse.jdt.ui/ui refactoring/org/eclipse/jdt/internal/ui/refactoring/RenameFieldWizard.java;1;0;1;1;0;0;0;1;0;0;1;2804;0;0;1;0;0;1;1;2804;0;2804;1;1;
/org.eclipse.jdt.ui/ui/org/eclipse/jdt/ui/text/java/hover/IJavaEditorTextHover.java;2;0;2;1;1;1;1;1;19;0;1;2006;19;19;1;0;0;1;2;2006;0;4810;2;2;
/org.eclipse.scripting/src/org/eclipse/scripting/internal/views/ScriptUIEditorContentOutlinePage.java;1;0;1;1;0;0;0;1;0;0;1;1424;0;0;1;0;0;1;1;1424;0;1424;1;1;
/org.eclipse.update.ui/src/org/eclipse/update/internal/ui/manager/InstallableSiteForm.java;2;0;9;1;0;0;0;9;19;1;9;1900;64;64;1;0;0;9;9;1900;0;3662;9;2;
/org.eclipse.team.core/src/org/eclipse/team/core/StandardOperations.java;1;0;3;1;0;0;0;3;291;1;3;3193;291;291;1;0;0;3;3;3193;0;3268;3;1;
/org.eclipse.ui.tests/Eclipse UI Tests/org/eclipse/ui/tests/api/MockEditorActionDelegate.java;1;0;1;1;0;0;0;1;0;0;1;1456;0;0;1;0;0;1;1;1456;0;1456;1;1;
/org.eclipse.pde.ui/src/org/eclipse/pde/internal/ui/preferences/BuildpathPreferencePage.java;1;0;2;1;1;1;1;1;193;0;1;3579;193;193;1;0;0;1;2;3579;0;4221;2;1;
/org.eclipse.vcm.ui/src/org/eclipse/vcm/internal/ui/wizards/NewTeamStreamWizard.java;4;0;8;2;0;0;0;8;16;2;7;1;48;48;2;1;0;8;8;295;1;1273;7;4;
/org.eclipse.jdt.ui.tests.refactoring/resources/RenameType/testFail92/in/A.java;1;0;1;1;0;0;0;1;0;0;1;49;0;0;1;0;0;1;1;49;0;49;1;1;
/org.eclipse.ui/Eclipse UI/org/eclipse/ui/internal/PluginAction.java;5;0;13;1;1;1;1;12;344;2;10;257;616;616;2;2;0;12;13;2235;2;4001;11;5;
/org.eclipse.jdt.ui.tests.refactoring/resources/AbstractField/can/A_test4_out.java;1;0;1;1;0;0;0;1;0;0;1;751;0;0;1;0;0;1;1;751;0;751;1;1;
/org.eclipse.jdt.debug/jdi/org/eclipse/jdi/internal/event/LocatableEventImpl.java;2;0;3;1;0;0;0;3;22;1;3;187;34;34;1;0;0;3;3;187;0;2155;3;2;
/org.eclipse.core.resources/src/org/eclipse/core/resources/IResourceStatus.java;2;0;7;1;1;1;1;6;438;1;6;12;488;488;1;0;0;6;7;12;0;4214;7;2;
/org.eclipse.jdt.ui.tests.refactoring/resources/RenameVariables/cannotRename/A_testFail18.java;1;0;2;1;0;0;0;2;0;1;2;724;0;0;1;0;0;2;2;724;0;1665;2;1;
/org.eclipse.jdt.debug.tests/tests/org/eclipse/jdt/debug/tests/eval/NestedTypeFieldValue_581.java;2;1;3;1;3;3;3;0;12;0;0;4447;14;14;1;0;0;0;3;4447;0;4571;3;2;
/org.eclipse.pde.ui/Eclipse PDE UI/org/eclipse/pde/internal/preferences/PDEBasePreferencePage.java;3;0;9;2;0;0;0;9;41;2;8;267;97;97;2;1;0;9;9;324;1;1434;8;3;
/org.eclipse.jdt.ui/ui/org/eclipse/jdt/ui/actions/ShowActionGroup.java;2;2;11;1;7;6;7;4;23;1;4;3533;108;108;2;0;1;4;11;3894;1;4770;10;2;
/org.eclipse.core.tests.runtime/src/org/eclipse/core/tests/internal/plugins/PluginResolveTest_32.java;3;0;3;1;0;0;0;3;110;1;3;1794;120;120;1;0;0;3;3;1794;0;3476;3;3;
/org.eclipse.jdt.ui.tests.refactoring/resources/MoveMembers/testFail16/in/A.java;1;0;1;1;0;0;0;1;0;0;1;2738;0;0;1;0;0;1;1;2738;0;2738;1;1;
/org.eclipse.team.cvs.core/src/org/eclipse/team/internal/ccvs/core/client/Session.java;3;1;42;2;3;3;3;39;371;4;29;2572;1995;1995;4;10;0;39;42;3569;10;4169;32;3;
/org.eclipse.core.tests.resources/src/org/eclipse/core/tests/internal/resources/ResourceInfoTest.java;3;0;3;1;0;0;0;3;236;1;3;1794;251;251;1;0;0;3;3;1794;0;3420;3;3;
/org.eclipse.ui/Eclipse UI Text Editor/org/eclipse/ui/texteditor/SaveAction.java;3;0;3;1;0;0;0;3;5;1;3;257;7;7;1;0;0;3;3;257;0;1066;3;3;
/org.eclipse.jdt.ui/ui/org/eclipse/jdt/internal/ui/javaeditor/JavaEditorErrorTickUpdater.java;2;1;11;1;2;2;2;9;87;2;7;1241;200;200;2;2;0;9;11;1732;2;4145;9;2;
/org.eclipse.jdt.junit/src/org/eclipse/jdt/internal/junit/launcher/TestSelectionDialog.java;1;0;2;1;1;1;1;1;2;0;1;3171;2;2;1;0;0;1;2;3171;0;3978;2;1;
/org.eclipse.help.ui/src/org/eclipse/help/internal/ui/motif/BrowserFactory.java;2;0;2;1;0;0;0;2;0;1;2;1420;0;0;1;0;0;2;2;1420;0;3030;2;2;
/org.eclipse.swt/Eclipse SWT/carbon/org/eclipse/swt/widgets/TabFolder.java;3;1;4;1;4;4;4;0;6;0;0;4305;14;14;1;0;0;0;4;4305;0;4701;4;3;
/org.eclipse.jdt.core/model/org/eclipse/jdt/internal/core/builder/ISearch.java;1;0;4;1;0;0;0;4;139;1;4;455;191;191;1;0;0;4;4;455;0;2808;4;1;
/org.eclipse.swt/Eclipse SWT/common/org/eclipse/swt/internal/image/JPEGFixedSizeSegment.java;2;0;3;1;1;1;1;2;6;1;2;106;10;10;1;0;0;2;3;106;0;4701;3;2;
/org.eclipse.jdt.core/model/org/eclipse/jdt/internal/core/builder/impl/ConstructorImpl.java;1;0;9;1;0;0;0;9;64;4;6;455;82;82;4;3;0;9;9;1039;3;2808;6;1;
/org.eclipse.ui/Eclipse UI/org/eclipse/ui/internal/dialogs/FileEditorsPreferencePage.java;7;0;14;1;0;0;0;14;61;1;14;257;339;339;1;0;0;14;14;257;0;3699;14;7;
/org.eclipse.team.cvs.core/src/org/eclipse/team/internal/ccvs/core/resources/api/CVSFileNotFoundException.java;2;0;2;1;0;0;0;2;0;1;2;1978;0;0;1;0;0;2;2;1978;0;2156;2;2;
/org.eclipse.jdt.debug/jdi interfaces/com/sun/jdi/event/EventSet.java;2;0;2;1;0;0;0;2;10;1;2;2704;10;10;1;0;0;2;2;2704;0;3040;2;2;
/org.eclipse.jdt.debug.tests/tests/org/eclipse/jdt/debug/tests/eval/ArrayInitializationTests.java;2;2;3;2;3;2;3;0;16;0;0;4447;18;18;2;0;1;0;3;4447;1;4571;2;2;
/org.eclipse.pde.core/src/org/eclipse/pde/internal/core/schema/SchemaElementReference.java;1;0;2;1;0;0;0;2;21;1;2;3591;21;21;1;0;0;2;2;3591;0;3607;2;1;
/org.eclipse.ui/Eclipse UI/org/eclipse/ui/internal/registry/MarkerHelpRegistry.java;1;0;3;1;0;0;0;3;49;2;2;2497;94;94;2;1;0;3;3;2497;1;2895;2;1;
/org.eclipse.ui/Eclipse UI/org/eclipse/ui/internal/IPartDropTarget.java;2;0;2;1;0;0;0;2;5;1;2;257;5;5;1;0;0;2;2;257;0;457;2;2;
/org.eclipse.pde.ui/src/org/eclipse/pde/internal/core/ischema/ISchemaType.java;1;0;2;1;0;0;0;2;0;1;2;3591;0;0;1;0;0;2;2;3591;0;3607;2;1;
/org.eclipse.jdt.ui/ui/org/eclipse/jdt/internal/ui/text/correction/InsertCharacterCorrectionProposal.java;2;0;6;1;0;0;0;6;15;2;5;3306;27;27;2;1;0;6;6;3528;1;3528;5;2;
/org.eclipse.jdt.ui.tests.refactoring/resources/RenameVariables/canRename/A_out.java;1;0;2;1;0;0;0;2;0;1;2;724;0;0;1;0;0;2;2;724;0;1665;2;1;
/org.eclipse.jdt.ui/ui/org/eclipse/jdt/internal/ui/javaeditor/JavaEditorPreferencePage.java;1;0;2;1;0;0;0;2;0;1;2;15;0;0;1;0;0;2;2;15;0;191;2;1;
/org.eclipse.jdt.ui/core refactoring/org/eclipse/jdt/internal/core/nls/model/NLSSubstitution.java;1;0;2;1;0;0;0;2;0;1;2;1913;0;0;1;0;0;2;2;1913;0;1922;2;1;
/org.eclipse.jdt.debug.ui/ui/org/eclipse/jdt/internal/debug/ui/actions/JavaBreakpointsPropertyStore.java;2;0;6;1;0;0;0;6;4;1;6;2845;7;7;1;0;0;6;6;2845;0;3508;6;2;
/org.eclipse.jdt.ui/ui/org/eclipse/jdt/internal/ui/dialogs/TypedViewerFilter.java;2;0;3;1;0;0;0;3;7;1;3;15;7;7;1;0;0;3;3;15;0;1254;3;2;
/org.eclipse.ui.externaltools/External Tools/org/eclipse/ui/externaltools/internal/core/ExternalToolsPlugin.java;1;1;5;1;5;5;5;0;27;0;0;4090;32;32;1;0;0;0;5;4090;0;4605;5;1;
/org.eclipse.core.tests.resources/src/org/eclipse/core/tests/internal/localstore/AllTests.java;3;0;3;1;1;1;1;2;76;1;2;1794;86;86;1;0;0;2;3;1794;0;4516;3;3;
/org.eclipse.team.cvs.core/src/org/eclipse/team/internal/ccvs/core/commands/Admin.java;3;0;3;1;0;0;0;3;78;1;3;1978;78;78;1;0;0;3;3;1978;0;2607;3;3;
/org.eclipse.jdt.ui/core refactoring/org/eclipse/jdt/internal/corext/refactoring/reorg/ReorgRefactoring.java;2;0;10;1;1;1;1;9;47;1;9;1939;188;188;1;0;0;9;10;1939;0;3995;10;2;
/org.eclipse.jdt.ui.tests.refactoring/resources/RenameType/testFail34/in/A.java;1;0;1;1;0;0;0;1;0;0;1;49;0;0;1;0;0;1;1;49;0;49;1;1;
/org.eclipse.pde.ui/src/org/eclipse/pde/internal/editor/manifest/ExtensionsForm.java;2;0;5;1;0;0;0;5;8;1;5;1434;17;17;1;0;0;5;5;1434;0;3579;5;2;
/org.eclipse.help/src/org/eclipse/help/internal/contributions/Context.java;2;0;2;1;0;0;0;2;0;1;2;1420;0;0;1;0;0;2;2;1420;0;1675;2;2;
/org.eclipse.swt/Eclipse SWT PI/gtk/org/eclipse/swt/internal/gtk/GdkEventKey.java;2;0;5;1;2;1;2;3;49;1;3;2107;56;56;2;0;1;3;5;4701;1;4701;4;2;
/org.eclipse.team.cvs.ui/src/org/eclipse/team/internal/ccvs/ui/actions/MoveTagAction.java;3;1;4;1;4;4;4;0;12;0;0;3914;14;14;1;0;0;0;4;3914;0;4081;4;3;
/org.eclipse.pde.ui/src/org/eclipse/pde/internal/preferences/CheckOption.java;2;0;2;1;0;0;0;2;0;1;2;1434;0;0;1;0;0;2;2;1434;0;3579;2;2;
/org.eclipse.jdt.debug/model/org/eclipse/jdt/debug/core/IJavaInterfaceType.java;1;0;3;1;0;0;0;3;7;2;2;3161;7;7;2;1;0;3;3;3571;1;3571;2;1;
/org.eclipse.core.resources/src/org/eclipse/core/internal/resources/MarkerTypeDefinitionCache.java;2;0;4;1;1;1;1;3;134;1;3;12;155;155;1;0;0;3;4;12;0;4213;4;2;
/org.eclipse.jdt.ui.tests.refactoring/resources/ExtractMethodWorkSpace/ExtractMethodTests/return_out/A_test725.java;1;1;3;1;2;2;2;1;42;0;1;2684;42;42;1;0;0;1;3;2684;0;4419;3;1;
/org.eclipse.jdt.ui.tests.refactoring/resources/ExtractMethodWorkSpace/ExtractMethodTests/locals_in/A_test541.java;1;1;3;1;2;2;2;1;4;0;1;922;4;4;1;0;0;1;3;922;0;4419;3;1;
/org.eclipse.jdt.core/compiler/org/eclipse/jdt/internal/compiler/problem/AbortMethod.java;2;0;3;1;1;1;1;2;16;1;2;455;23;23;1;0;0;2;3;455;0;4062;3;2;
/org.eclipse.swt/Eclipse SWT PI/gtk1x/org/eclipse/swt/internal/gtk/GdkEvent.java;2;0;2;1;1;1;1;1;3;0;1;2107;3;3;1;0;0;1;2;2107;0;4701;2;2;
/org.eclipse.ui/Eclipse UI/org/eclipse/ui/model/WorkbenchContentProvider.java;3;0;3;1;0;0;0;3;60;1;3;257;64;64;1;0;0;3;3;257;0;620;3;3;
/org.eclipse.compare/compare/org/eclipse/compare/internal/IOpenable.java;1;0;1;1;1;1;1;0;0;0;0;4699;0;0;1;0;0;0;1;4699;0;4699;1;1;
/org.eclipse.swt/Eclipse SWT OLE Win32/win32/org/eclipse/swt/internal/ole/win32/IConnectionPoint.java;2;0;3;1;0;0;0;3;5;1;3;106;5;5;1;0;0;3;3;106;0;2069;3;2;
/org.eclipse.update.ui/src/org/eclipse/update/internal/ui/manager/RevertSection.java;2;0;11;1;0;0;0;11;149;3;9;2146;204;204;3;2;0;11;11;2172;2;3662;9;2;
/org.eclipse.scripting/src/org/eclipse/scripting/internal/views/ScriptUIEditorAutoIndentStrategy.java;1;0;1;1;0;0;0;1;0;0;1;1424;0;0;1;0;0;1;1;1424;0;1424;1;1;
/org.eclipse.jdt.ui.tests.refactoring/resources/RenameVariables/canRename/A_test15_out.java;1;0;2;1;0;0;0;2;0;1;2;724;0;0;1;0;0;2;2;724;0;1665;2;1;
/org.eclipse.jdt.ui.tests.refactoring/resources/RenameType/test49/out/B.java;1;0;1;1;0;0;0;1;0;0;1;522;0;0;1;0;0;1;1;522;0;522;1;1;
/org.eclipse.pde.junit/Pde JUnit/org/eclipse/pde/internal/junit/launcher/JUnitLaunchConfigurationTab.java;2;0;2;1;0;0;0;2;0;1;2;3098;0;0;1;0;0;2;2;3098;0;3205;2;2;
/org.eclipse.update.ui.forms/src/org/eclipse/update/ui/forms/internal/engine/IHyperlinkSegment.java;1;0;4;1;2;1;2;2;8;0;1;2745;12;12;2;1;1;2;4;2745;2;4351;2;1;
/org.eclipse.pde.ui/src/org/eclipse/pde/internal/editor/schema/NewAttributeAction.java;2;0;2;1;0;0;0;2;0;1;2;1434;0;0;1;0;0;2;2;1434;0;3579;2;2;
/org.eclipse.jdt.ui.tests.refactoring/resources/SelectionAnalyzerWorkSpace/SelectionAnalyzerTests/validSelection/A_test041_.java;1;0;1;1;0;0;0;1;0;0;1;2139;0;0;1;0;0;1;1;2139;0;2139;1;1;
/org.eclipse.swt.tests/JUnit Tests/org/eclipse/swt/tests/junit/Test_org_eclipse_swt_widgets_TableItem.java;2;0;3;1;1;1;1;2;708;1;2;1792;714;714;1;0;0;2;3;1792;0;4706;3;2;
/org.eclipse.ui/Eclipse JFace/org/eclipse/jface/viewers/ICellEditorListener.java;2;0;2;1;0;0;0;2;5;1;2;257;5;5;1;0;0;2;2;257;0;457;2;2;
/org.eclipse.update.ui/src/org/eclipse/update/internal/ui/manager/SitePage.java;1;0;4;1;0;0;0;4;5;1;4;1570;7;7;1;0;0;4;4;1570;0;3537;4;1;
/org.eclipse.jdt.core/codeassist/org/eclipse/jdt/internal/codeassist/complete/CompletionOnSingleNameReference.java;2;0;9;1;1;1;1;8;23;4;5;455;55;55;4;3;0;8;9;1039;3;4062;6;2;
/org.eclipse.update.ui/src/org/eclipse/update/internal/ui/search/PluginsSearchCategory.java;1;1;7;1;3;3;3;4;141;3;2;3553;282;282;3;2;0;4;7;3657;2;4460;5;1;
/org.eclipse.swt.examples/Eclipse SWT Examples/common/org/eclipse/swt/examples/explorer/TreeExpandDropListener.java;1;0;1;1;0;0;0;1;0;0;1;480;0;0;1;0;0;1;1;480;0;480;1;1;
/org.eclipse.ui/Eclipse UI/org/eclipse/ui/internal/registry/PerspectiveRegistry.java;5;3;7;1;4;2;4;3;29;1;3;257;67;67;3;0;2;3;7;4210;2;4573;5;5;
/org.eclipse.jdt.ui/core extension/org/eclipse/jdt/internal/corext/codemanipulation/TextRegion.java;1;0;2;1;0;0;0;2;0;1;2;1937;0;0;1;0;0;2;2;1937;0;2137;2;1;
/org.eclipse.jdt.ui/ui/org/eclipse/jdt/internal/ui/packageview/ShowBinariesAction.java;2;0;2;1;0;0;0;2;0;1;2;1368;0;0;1;0;0;2;2;1368;0;3657;2;2;
/org.eclipse.jdt.core/model/org/eclipse/jdt/internal/core/builder/impl/OldBuilderType.java;1;0;10;1;0;0;0;10;88;4;6;455;106;106;4;4;0;10;10;1039;4;2808;6;1;
/org.eclipse.team.cvs.core/src/org/eclipse/team/internal/ccvs/core/response/ModTimeHandler.java;3;0;4;1;0;0;0;4;184;1;4;1978;190;190;1;0;0;4;4;1978;0;2607;4;3;
/org.eclipse.team.cvs.ui/src/org/eclipse/team/internal/ccvs/ui/actions/RemoveTagAction.java;2;0;5;2;0;0;0;5;11;2;4;1997;14;14;2;1;0;5;5;2049;1;2126;4;2;
/org.eclipse.core.resources/src/org/eclipse/core/internal/properties/StoredProperty.java;2;0;4;1;1;1;1;3;46;1;3;12;67;67;1;0;0;3;4;12;0;4214;4;2;
/org.eclipse.ui/Eclipse UI/org/eclipse/ui/internal/registry/WorkingSetRegistryReader.java;1;0;2;1;0;0;0;2;47;1;2;3400;47;47;1;0;0;2;2;3400;0;3494;2;1;
/org.eclipse.pde.ui/src/org/eclipse/pde/internal/core/ModelProviderEvent.java;1;0;2;1;0;0;0;2;0;1;2;3579;0;0;1;0;0;2;2;3579;0;3607;2;1;
/org.eclipse.swt/Eclipse SWT/motif/org/eclipse/swt/internal/Converter.java;7;0;11;2;1;1;1;10;444;2;9;106;596;596;2;1;0;10;11;2069;1;4701;10;7;
/org.eclipse.vcm.core.cvs/src/org/eclipse/vcm/internal/core/ccvs/CVSDirectoryBuildVisitor.java;2;0;2;1;0;0;0;2;0;1;2;0;0;0;1;0;0;2;2;0;0;292;2;2;
/org.eclipse.core.target/src/org/eclipse/core/internal/target/webdav/RefreshVisitor.java;2;0;5;1;0;0;0;5;9;1;5;12;23;23;1;0;0;5;5;12;0;753;5;2;
/org.eclipse.ui/Eclipse UI Text Editor/org/eclipse/ui/texteditor/MarkerUtilities.java;3;0;3;1;0;0;0;3;116;1;3;257;121;121;1;0;0;3;3;257;0;1066;3;3;
/org.eclipse.swt/Eclipse SWT Drag and Drop/gtk1x/org/eclipse/swt/dnd/RTFTransfer.java;2;0;2;1;0;0;0;2;0;1;2;2107;0;0;1;0;0;2;2;2107;0;3127;2;2;
/org.eclipse.jdt.ui.tests.refactoring/resources/ExtractMethodWorkSpace/ExtractMethodTests/validSelection/A_test351.java;2;1;3;1;2;2;2;1;16;0;1;254;16;16;1;0;0;1;3;254;0;4419;3;2;
/org.eclipse.ant.core/src/org/eclipse/ant/core/CopyProject.java;3;0;3;1;0;0;0;3;572;1;3;896;572;572;1;0;0;3;3;896;0;3489;3;3;
/org.eclipse.jdt.ui.tests.refactoring/resources/RenameTemp/canRename/A_test5_in.java;1;0;2;1;0;0;0;2;2;1;2;1625;2;2;1;0;0;2;2;1625;0;1652;2;1;
/org.eclipse.jdt.core/model/org/eclipse/jdt/internal/core/util/ReferenceInfoAdapter.java;3;1;5;1;2;2;2;3;82;1;3;455;120;120;1;0;0;3;5;455;0;4422;5;3;
/org.eclipse.pde.ui/src/org/eclipse/pde/internal/editor/PDEChildFormPage.java;2;0;5;1;0;0;0;5;6;1;5;1434;12;12;1;0;0;5;5;1434;0;3579;5;2;
/org.eclipse.jdt.debug.ui/ui/org/eclipse/jdt/internal/debug/ui/launcher/ZipLabelProvider.java;1;0;1;1;1;1;1;0;0;0;0;4101;0;0;1;0;0;0;1;4101;0;4101;1;1;
/org.eclipse.pde.ui/src/org/eclipse/pde/internal/editor/manifest/ExtensionPropertySource.java;2;0;4;1;0;0;0;4;5;2;3;1434;5;5;2;1;0;4;4;3035;1;3579;3;2;
/org.eclipse.update.core/src/org/eclipse/update/configuration/ISessionDelta.java;2;1;4;1;4;4;4;0;49;0;0;3901;92;92;1;0;0;0;4;3901;0;4687;4;2;
/org.eclipse.jdt.ui/core refactoring/org/eclipse/jdt/internal/corext/refactoring/structure/PullUpRefactoring.java;2;2;25;2;5;4;5;20;137;2;19;2406;794;794;2;1;1;20;25;3185;2;4452;23;2;
/org.eclipse.jdt.ui.tests.refactoring/resources/ExtractMethodWorkSpace/ExtractMethodTests/selection/A_test2.java;2;1;3;1;2;2;2;1;0;0;1;49;0;0;1;0;0;1;3;49;0;4419;3;2;
/org.eclipse.jdt.core/compiler/org/eclipse/jdt/internal/compiler/impl/ShortConstant.java;2;0;11;1;1;1;1;10;90;4;6;455;150;150;4;4;0;10;11;1039;4;4062;7;2;
/org.eclipse.jdt.ui/core refactoring/org/eclipse/jdt/internal/core/refactoring/projects/RenameJavaProjectRefactoring.java;1;0;4;1;0;0;0;4;96;1;4;1108;116;116;1;0;0;4;4;1108;0;1342;4;1;
/org.eclipse.jdt.core/model/org/eclipse/jdt/core/jdom/IDOMFactory.java;2;0;7;2;2;1;2;5;262;2;4;455;340;340;2;1;1;5;7;3187;2;4058;5;2;
/org.eclipse.jdt.ui/ui/org/eclipse/jdt/internal/ui/javaeditor/structureselection/SelectionHistory.java;2;0;2;1;0;0;0;2;4;1;2;3188;4;4;1;0;0;2;2;3188;0;3567;2;2;
/org.eclipse.help.ui/src/org/eclipse/help/internal/ui/util/SWTUtil.java;1;0;2;1;1;1;1;1;0;0;1;3074;0;0;1;0;0;1;2;3074;0;4439;2;1;
/org.eclipse.pde.ui/src/org/eclipse/pde/internal/core/plugin/PluginImport.java;1;0;3;1;0;0;0;3;10;2;2;3579;10;10;2;1;0;3;3;3579;1;3607;2;1;
/org.eclipse.pde.ui/src/org/eclipse/pde/internal/model/plugin/PluginImport.java;1;0;2;1;0;0;0;2;0;1;2;3136;0;0;1;0;0;2;2;3136;0;3579;2;1;
/org.eclipse.ui/Eclipse UI/org/eclipse/ui/actions/ExportResourcesAction.java;2;2;7;1;6;5;6;1;50;0;1;3739;100;100;2;0;1;1;7;3917;1;4423;6;2;
/org.eclipse.pde.ui/src/org/eclipse/pde/model/IEditable.java;1;0;3;1;0;0;0;3;11;1;3;3039;11;11;1;0;0;3;3;3039;0;3579;3;1;
/org.eclipse.search/search/org/eclipse/search/internal/workingsets/WorkingSetComparator.java;1;0;3;1;0;0;0;3;3;1;3;1704;3;3;1;0;0;3;3;1704;0;3849;3;1;
/org.eclipse.jdt.debug/eval/org/eclipse/jdt/internal/debug/eval/ast/engine/Constructor.java;1;0;3;1;0;0;0;3;88;1;3;3329;88;88;1;0;0;3;3;3329;0;3421;3;1;
/org.eclipse.core.resources/src/org/eclipse/core/internal/indexing/Pointer.java;3;0;5;1;1;1;1;4;174;1;4;12;326;326;1;0;0;4;5;12;0;4214;5;3;
/org.eclipse.jdt.ui.tests.refactoring/resources/InlineTemp/canInline/A_test18_out.java;1;0;1;1;0;0;0;1;0;0;1;3355;0;0;1;0;0;1;1;3355;0;3355;1;1;
/org.eclipse.swt/Eclipse SWT PI/gtk1x/org/eclipse/swt/internal/gtk/GdkVisual.java;2;0;2;1;1;1;1;1;3;0;1;2107;3;3;1;0;0;1;2;2107;0;4701;2;2;
/org.eclipse.core.boot/src/org/eclipse/core/internal/boot/update/IPluginEntryDescriptor.java;3;0;4;2;0;0;0;4;9;2;3;12;9;9;2;1;0;4;4;324;1;2726;3;3;
/org.eclipse.jdt.ui.tests.refactoring/resources/RenameType/testIllegalTypeName3/in/A.java;1;0;1;1;0;0;0;1;0;0;1;49;0;0;1;0;0;1;1;49;0;49;1;1;
/org.eclipse.help/Eclipse Help/org/eclipse/help/internal/contributions/Topic.java;2;0;3;1;0;0;0;3;7;1;3;135;7;7;1;0;0;3;3;135;0;1420;3;2;
/org.eclipse.jdt.ui.tests.refactoring/resources/ExtractMethodWorkSpace/ExtractMethodTests/nested_out/A_test650.java;2;1;3;1;2;2;2;1;16;0;1;354;16;16;1;0;0;1;3;354;0;4419;3;2;
/org.eclipse.team.core/src/org/eclipse/team/core/target/TargetManager.java;3;3;15;2;15;10;15;0;249;0;0;4113;389;389;3;0;5;0;15;4128;5;4636;10;3;
/org.eclipse.jdt.core/compiler/org/eclipse/jdt/internal/compiler/codegen/LongCache.java;2;1;12;1;2;2;2;10;295;4;6;455;404;404;4;4;0;10;12;1039;4;4062;8;2;
/org.eclipse.team.cvs.ui/src/org/eclipse/team/internal/ccvs/ui/VersionSelectionDialog.java;1;0;2;1;0;0;0;2;0;1;2;2374;0;0;1;0;0;2;2;2374;0;2388;2;1;
/org.eclipse.pde.core/src/org/eclipse/pde/core/plugin/IPluginImport.java;1;0;4;1;2;1;2;2;52;1;2;3591;54;54;2;0;1;2;4;4751;1;4751;3;1;
/org.eclipse.update.core/src/org/eclipse/update/core/BaseFeatureFactory.java;2;1;13;1;2;2;2;11;114;3;8;2462;301;301;3;3;0;11;13;2583;3;4104;10;2;
/org.eclipse.pde.ui/src/org/eclipse/pde/internal/ui/editor/feature/PortabilityChoicesDialog.java;1;0;2;1;0;0;0;2;2;1;2;3579;2;2;1;0;0;2;2;3579;0;3591;2;1;
/org.eclipse.jdt.core/compiler/org/eclipse/jdt/internal/compiler/DocumentElementParser.java;2;1;30;1;3;3;3;27;2545;4;22;455;2939;2939;4;5;0;27;30;1039;5;4421;25;2;
/org.eclipse.pde.ui/src/org/eclipse/pde/internal/editor/feature/URLElementPropertySource.java;1;0;2;1;0;0;0;2;0;1;2;2951;0;0;1;0;0;2;2;2951;0;3579;2;1;
/org.eclipse.webdav/src/kernel/org/eclipse/webdav/internal/kernel/DocumentMarshaler.java;2;0;5;1;1;1;1;4;86;1;4;12;158;158;1;0;0;4;5;12;0;4211;5;2;
/org.eclipse.core.tests.resources.saveparticipant/src/org/eclipse/core/tests/resources/saveparticipant/SimpleBuilder.java;2;0;2;1;0;0;0;2;0;1;2;1794;0;0;1;0;0;2;2;1794;0;3287;2;2;
/org.eclipse.jdt.ui/ui/org/eclipse/jdt/internal/ui/javaeditor/AddImportOnSelectionAction.java;7;1;33;2;7;7;7;26;96;2;25;15;510;510;2;1;0;26;33;1299;1;4568;32;7;
/org.eclipse.core.resources/src/org/eclipse/core/internal/watson/IElementComparator.java;1;0;4;1;1;1;1;3;40;1;3;12;61;61;1;0;0;3;4;12;0;4214;4;1;
/org.eclipse.jdt.ui.tests/ui/org/eclipse/jdt/ui/tests/core/TextBufferTest.java;2;0;5;1;0;0;0;5;439;2;4;1800;462;462;2;1;0;5;5;2133;1;2583;4;2;
/org.eclipse.pde.ui/Eclipse PDE UI/org/eclipse/pde/internal/Sorter.java;2;0;5;2;0;0;0;5;12;3;3;267;12;12;3;2;0;5;5;324;2;1434;3;2;
/org.eclipse.debug.core/core/org/eclipse/debug/core/model/IMemoryBlock.java;3;0;6;1;1;1;1;5;5;1;5;1963;12;12;1;0;0;5;6;1963;0;4651;6;3;
/org.eclipse.core.resources/src/org/eclipse/core/resources/IResource.java;4;1;23;2;2;2;2;21;3422;2;18;12;4430;4430;2;3;0;21;23;319;3;4628;20;4;
/org.eclipse.jdt.ui.tests.refactoring/resources/RenameMethodInInterface/testFail25/in/A.java;1;0;1;1;0;0;0;1;0;0;1;49;0;0;1;0;0;1;1;49;0;49;1;1;
/org.eclipse.swt/Eclipse SWT/motif/org/eclipse/swt/internal/motif/XWindowChanges.java;2;0;3;1;0;0;0;3;4;1;3;106;4;4;1;0;0;3;3;106;0;2069;3;2;
/org.eclipse.jdt.debug.ui/ui/org/eclipse/jdt/internal/debug/ui/ExceptionHandler.java;2;0;4;1;1;1;1;3;5;2;2;2965;9;9;2;1;0;3;4;3362;1;4423;3;2;
/org.eclipse.jdt.ui/core refactoring/org/eclipse/jdt/internal/corext/refactoring/nls/Utils.java;2;0;2;1;0;0;0;2;0;1;2;1939;0;0;1;0;0;2;2;1939;0;2769;2;2;
/org.eclipse.jdt.debug/eval/org/eclipse/jdt/internal/debug/eval/model/IClassType.java;2;0;2;1;0;0;0;2;0;1;2;3555;0;0;1;0;0;2;2;3555;0;3645;2;2;
/org.eclipse.ui/Eclipse JFace/org/eclipse/jface/viewers/CheckboxCellEditor.java;2;0;2;1;0;0;0;2;5;1;2;257;5;5;1;0;0;2;2;257;0;457;2;2;
/org.eclipse.jdt.core/compiler/org/eclipse/jdt/internal/compiler/codegen/CharArrayCache.java;2;1;11;1;2;2;2;9;344;4;6;455;443;443;4;3;0;9;11;1039;3;4062;8;2;
/org.eclipse.pde.ui/src/org/eclipse/pde/internal/ui/model/ifeature/IFeatureModelFactory.java;1;0;2;1;0;0;0;2;0;1;2;3579;0;0;1;0;0;2;2;3579;0;3591;2;1;
/org.eclipse.jdt.ui/ui/org/eclipse/jdt/internal/ui/snippeteditor/SnippetAction.java;4;0;9;1;0;0;0;9;49;1;9;15;123;123;1;0;0;9;9;15;0;1916;9;4;
/org.eclipse.jdt.debug.ui/ui/org/eclipse/jdt/internal/debug/ui/StorageEditorInput.java;1;0;2;1;0;0;0;2;4;1;2;2372;4;4;1;0;0;2;2;2372;0;3724;2;1;
/org.eclipse.help/src/org/eclipse/help/internal/contributors/xml1_0/XMLViewContributor.java;1;0;2;1;0;0;0;2;0;1;2;1675;0;0;1;0;0;2;2;1675;0;2217;2;1;
/org.eclipse.ui/Eclipse UI/org/eclipse/ui/actions/WorkspaceModifyDelegatingOperation.java;2;0;2;1;0;0;0;2;5;1;2;257;5;5;1;0;0;2;2;257;0;457;2;2;
/org.eclipse.jdt.ui.tests.refactoring/resources/RenameNonPrivateField/test16/in/A.java;1;0;1;1;1;1;1;0;0;0;0;4742;0;0;1;0;0;0;1;4742;0;4742;1;1;
/org.eclipse.swt/Eclipse SWT PI/gtk1x/org/eclipse/swt/internal/gtk/GtkAdjustment.java;2;0;2;1;1;1;1;1;3;0;1;2107;3;3;1;0;0;1;2;2107;0;4701;2;2;
/org.eclipse.swt.examples.paint/org/eclipse/swt/examples/paint/MetaRectangle.java;1;0;1;1;0;0;0;1;0;0;1;513;0;0;1;0;0;1;1;513;0;513;1;1;
/org.eclipse.jdt.ui.tests.refactoring/resources/ExtractMethodWorkSpace/ExtractMethodTests/Bug_5690.java;1;1;3;1;2;2;2;1;26;0;1;1851;26;26;1;0;0;1;3;1851;0;4419;3;1;
/org.eclipse.pde.ui/src/org/eclipse/pde/model/plugin/IPluginModelBase.java;1;0;2;1;0;0;0;2;0;1;2;3039;0;0;1;0;0;2;2;3039;0;3579;2;1;
/org.eclipse.ui/Eclipse UI Standard Components/org/eclipse/ui/views/bookmarkexplorer/BookmarkAction.java;2;0;2;1;0;0;0;2;5;1;2;257;5;5;1;0;0;2;2;257;0;457;2;2;
/org.eclipse.jdt.ui.tests.refactoring/resources/RenameMethodInInterface/testFail30/in/A.java;1;0;1;1;0;0;0;1;0;0;1;49;0;0;1;0;0;1;1;49;0;49;1;1;
/org.eclipse.swt/Eclipse SWT PI/win32/org/eclipse/swt/internal/ole/win32/STATSTG.java;2;0;2;1;1;1;1;1;6;0;1;2069;6;6;1;0;0;1;2;2069;0;4701;2;2;
/org.eclipse.ui/Eclipse UI/org/eclipse/ui/internal/dialogs/WorkingSetEditWizard.java;1;0;3;1;1;1;1;2;2;0;1;3576;4;4;2;1;0;2;3;3576;1;3936;2;1;
/org.eclipse.pde.build/src/org/eclipse/pde/core/internal/ant/FileSet.java;1;0;2;1;0;0;0;2;0;1;2;3128;0;0;1;0;0;2;2;3128;0;3194;2;1;
/org.eclipse.scripting/src/org/eclipse/scripting/internal/IXGRNodeInterface.java;1;0;1;1;0;0;0;1;0;0;1;1424;0;0;1;0;0;1;1;1424;0;1424;1;1;
/org.eclipse.jdt.core/compiler/org/eclipse/jdt/internal/compiler/ast/Continue.java;2;0;12;1;1;1;1;11;144;4;8;455;316;316;4;3;0;11;12;1039;3;4062;9;2;
/org.eclipse.jdt.ui/core refactoring/org/eclipse/jdt/internal/corext/refactoring/base/IChange.java;1;0;2;1;1;1;1;1;7;0;1;1939;7;7;1;0;0;1;2;1939;0;4400;2;1;
/org.eclipse.jdt.ui/core extension/org/eclipse/jdt/internal/corext/textmanipulation/TextEditNodeComparator.java;1;0;2;1;0;0;0;2;2;1;2;2137;2;2;1;0;0;2;2;2137;0;2512;2;1;
/org.eclipse.vcm.tests.core/src/org/eclipse/vcm/tests/core/base/AllTests.java;1;0;1;1;0;0;0;1;0;0;1;1688;0;0;1;0;0;1;1;1688;0;1688;1;1;
/org.eclipse.ui/Eclipse UI Standard Components/org/eclipse/ui/wizards/datatransfer/FileSystemExporter.java;2;0;2;1;0;0;0;2;5;1;2;257;5;5;1;0;0;2;2;257;0;457;2;2;
/org.eclipse.update.tests.core/src/org/eclipse/update/tests/api/AllAPITests.java;2;0;10;1;1;1;1;9;9;2;8;1531;29;29;2;1;0;9;10;2791;1;3973;9;2;
/org.eclipse.jdt.ui.tests.refactoring/resources/ExtractMethodWorkSpace/ExtractMethodTests/locals_in/A_test567.java;1;1;2;1;2;2;2;0;0;0;0;4383;0;0;1;0;0;0;2;4383;0;4419;2;1;
/org.eclipse.jdt.core/codeassist/org/eclipse/jdt/internal/codeassist/complete/CompletionOnQualifiedAllocationExpression.java;2;0;9;1;1;1;1;8;63;4;5;455;131;131;4;3;0;8;9;1039;3;4062;6;2;
/org.eclipse.ui/Eclipse JFace/org/eclipse/jface/preference/StringButtonFieldEditor.java;3;0;3;1;0;0;0;3;5;1;3;257;8;8;1;0;0;3;3;257;0;620;3;3;
/org.eclipse.jdt.ui.tests.refactoring/resources/RenameTemp/canRename/A_test4_out.java;1;0;2;1;0;0;0;2;2;1;2;1625;2;2;1;0;0;2;2;1625;0;1652;2;1;
/org.eclipse.jdt.debug.ui/ui/org/eclipse/jdt/internal/debug/ui/launcher/WorkingDirectoryBlock.java;3;2;8;2;8;6;8;0;217;0;0;4042;279;279;2;0;2;0;8;4042;2;4403;6;3;
/org.eclipse.jdt.debug/eval/org/eclipse/jdt/internal/debug/eval/ast/instructions/PushFloat.java;2;0;3;1;0;0;0;3;2;1;3;3421;4;4;1;0;0;3;3;3421;0;3677;3;2;
/org.eclipse.core.target/src/org/eclipse/core/internal/target/filesystem/PushPullTargetVisitor.java;2;0;5;1;0;0;0;5;12;1;5;12;20;20;1;0;0;5;5;12;0;713;5;2;
/org.eclipse.team.cvs.ui/src/org/eclipse/team/internal/ccvs/ui/actions/CVSAction.java;3;3;12;1;10;8;10;2;166;1;2;3738;508;508;3;0;2;2;12;4120;2;4569;10;3;
/org.eclipse.jdt.ui/core codemanipulation/org/eclipse/jdt/internal/core/codemanipulation/TextEdit.java;1;0;2;1;0;0;0;2;0;1;2;1800;0;0;1;0;0;2;2;1800;0;1937;2;1;
/org.eclipse.jdt.ui.tests.refactoring/resources/RenameTemp/canRename/A_test30_out.java;1;0;2;1;0;0;0;2;2;1;2;1625;2;2;1;0;0;2;2;1625;0;1652;2;1;
/org.eclipse.ui/Eclipse UI/org/eclipse/ui/internal/dialogs/ResourceWorkingSetPage.java;2;1;10;1;6;6;6;4;23;1;4;3576;73;73;1;0;0;4;10;3576;0;4675;10;2;
/org.eclipse.help/src/org/eclipse/help/internal/contributors/xml/XMLContextContributor.java;2;0;3;1;0;0;0;3;2;1;3;1420;2;2;1;0;0;3;3;1420;0;1675;3;2;
/org.eclipse.jdt.ui.tests.refactoring/resources/RenameTemp/canRename/A_test37_out.java;1;0;1;1;0;0;0;1;0;0;1;3086;0;0;1;0;0;1;1;3086;0;3086;1;1;
/org.eclipse.jdt.ui/ui/org/eclipse/jdt/internal/ui/text/java/hover/JavaDebugHover.java;3;0;5;1;0;0;0;5;89;1;5;15;149;149;1;0;0;5;5;15;0;2010;5;3;
/org.eclipse.pde.ui/src/org/eclipse/pde/internal/core/schema/SchemaSimpleType.java;1;0;4;1;0;0;0;4;6;2;3;3579;8;8;2;1;0;4;4;3579;1;3607;3;1;
/org.eclipse.jdt.core/compiler/org/eclipse/jdt/internal/compiler/ICompilerRequestor.java;2;1;5;1;2;2;2;3;15;1;3;455;26;26;1;0;0;3;5;455;0;4421;5;2;
/org.eclipse.jdt.ui/ui/org/eclipse/jdt/internal/ui/dialogs/StatusTool.java;4;0;6;2;0;0;0;6;36;2;5;144;40;40;2;1;0;6;6;1272;1;1272;5;4;
/org.eclipse.scripting/Eclipse Scripting/org/eclipse/scripting/internal/uirenderer/XGRElementUISwtPreferenceDialog.java;2;0;4;1;0;0;0;4;34;1;4;133;38;38;1;0;0;4;4;133;0;1424;4;2;
/org.eclipse.pde.ui/src/org/eclipse/pde/internal/editor/feature/FeatureEditor.java;1;0;7;1;0;0;0;7;276;3;4;2951;291;291;3;3;0;7;7;2951;3;3579;4;1;
/org.eclipse.swt/Eclipse SWT/gtk1x/org/eclipse/swt/graphics/GCData.java;3;0;3;1;1;1;1;2;6;1;2;2107;8;8;1;0;0;2;3;2107;0;4701;3;3;
/org.eclipse.pde.ui/src/org/eclipse/pde/internal/core/ischema/ISchemaRepeatable.java;1;0;2;1;0;0;0;2;0;1;2;3591;0;0;1;0;0;2;2;3591;0;3607;2;1;
/org.eclipse.pde.ui/src/org/eclipse/pde/internal/util/PixelConverter.java;1;0;2;1;0;0;0;2;0;1;2;2998;0;0;1;0;0;2;2;2998;0;3579;2;1;
/org.eclipse.jdt.core/model/org/eclipse/jdt/core/ITypeHierarchyChangedListener.java;2;0;4;1;1;1;1;3;29;1;3;455;53;53;1;0;0;3;4;455;0;4061;4;2;
/org.eclipse.ui.tests/Eclipse JFace Tests/org/eclipse/jface/tests/viewers/ListViewerTest.java;1;0;1;1;0;0;0;1;0;0;1;1488;0;0;1;0;0;1;1;1488;0;1488;1;1;
/org.eclipse.swt/Eclipse SWT OLE Win32/win32/org/eclipse/swt/ole/win32/TypeInfoBrowser.java;1;0;1;1;0;0;0;1;0;0;1;2689;0;0;1;0;0;1;1;2689;0;2689;1;1;
/org.eclipse.pde.ui/src/org/eclipse/pde/internal/core/schema/SchemaObject.java;1;0;3;1;0;0;0;3;2;1;3;3579;2;2;1;0;0;3;3;3579;0;3607;3;1;
/org.eclipse.ui/Eclipse UI/org/eclipse/ui/internal/dialogs/RegistryPageContributor.java;4;0;6;1;1;1;1;5;83;1;5;257;164;164;1;0;0;5;6;257;0;3973;6;4;
/org.eclipse.pde.ui/src/org/eclipse/pde/internal/forms/renamed/IFormSelectionListener.java;1;0;2;1;0;0;0;2;0;1;2;2470;0;0;1;0;0;2;2;2470;0;2691;2;1;
/org.eclipse.jdt.ui.tests.refactoring/resources/ExtractMethodWorkSpace/ExtractMethodTests/validSelection/A_test231.java;2;1;3;1;2;2;2;1;0;0;1;49;0;0;1;0;0;1;3;49;0;4419;3;2;
/org.eclipse.pde.ui/Eclipse PDE UI/org/eclipse/pde/internal/editor/PDEMultiPagePropertySheet.java;2;0;7;2;0;0;0;7;21;3;5;267;35;35;3;2;0;7;7;324;2;1434;5;2;
/org.eclipse.help/src/org/eclipse/help/internal/topics/TopicsFile.java;2;0;4;1;0;0;0;4;18;1;4;1675;30;30;1;0;0;4;4;1675;0;1857;4;2;
