filename;TotalPeopleInBurst;MaximumChangeBurstLate;NumberOfChanges;MaxPeopleInBurst;TotalBurstSizeLate;NumberOfChangeBurstsLate;NumberOfChangesLate;NumberOfChangesEarly;MaxChurnInBurst;MaximumChangeBurstEarly;NumberOfChangeBurstsEarly;TimeFirstBurst;TotalChurnInBurst;ChurnTotal;MaximumChangeBurst;NumberOfConsecutiveChangesEarly;NumberOfConsecutiveChangesLate;TotalBurstSizeEarly;TotalBurstSize;TimeMaxBurst;NumberOfConsecutiveChanges;TimeLastBurst;NumberOfChangeBursts;PeopleTotal;
/org.eclipse.help/src/org/eclipse/help/internal/search/QueryWordsExactPhrase.java;1;0;1;1;0;0;0;1;0;0;1;2732;0;0;1;0;0;1;1;2732;0;2732;1;1;
/org.eclipse.debug.ui/ui/org/eclipse/debug/internal/ui/actions/CopyVariablesToClipboardActionDelegate.java;2;0;2;1;0;0;0;2;40;1;2;2060;64;64;1;0;0;2;2;2060;0;2555;2;2;
/org.eclipse.update.ui/src/org/eclipse/update/internal/ui/wizards/ReplaceFeatureVersionWizardPage.java;1;0;6;1;1;1;1;5;37;1;5;1242;54;54;1;0;0;5;6;1242;0;6336;6;1;
/org.eclipse.update.configurator/src/org/eclipse/update/internal/configurator/InstalledSiteParser.java;1;0;3;1;0;0;0;3;8;1;3;3265;8;8;1;0;0;3;3;3265;0;4095;3;1;
/org.eclipse.team.cvs.ui/src/org/eclipse/team/internal/ccvs/ui/repo/NewCVSAnonEclipseConnection.java;1;0;1;1;0;0;0;1;0;0;1;4519;0;0;1;0;0;1;1;4519;0;4519;1;1;
/org.eclipse.jdt.ui.tests.refactoring/resources/ChangeTypeRefactoring/positive/A_testLocalVarName_out.java;1;0;1;1;0;0;0;1;0;0;1;2844;0;0;1;0;0;1;1;2844;0;2844;1;1;
/org.eclipse.osgi/osgi/src/org/osgi/framework/PackagePermission.java;2;0;2;1;1;1;1;1;3;0;1;3013;3;3;1;0;0;1;2;3013;0;5536;2;2;
/org.eclipse.jdt.debug.ui/ui/org/eclipse/jdt/internal/debug/ui/actions/ExceptionBreakpointFilterEditor.java;1;0;1;1;0;0;0;1;0;0;1;1484;0;0;1;0;0;1;1;1484;0;1484;1;1;
/org.eclipse.pde.ui/src/org/eclipse/pde/internal/ui/editor/text/ReconcilingStrategy.java;1;1;2;1;2;2;2;0;10;0;0;5431;10;10;1;0;0;0;2;5431;0;6336;2;1;
/org.eclipse.core.resources/src/org/eclipse/core/internal/events/AutoBuildJob.java;2;1;25;1;11;11;11;14;95;2;12;2057;324;324;2;2;0;14;25;2057;2;6265;23;2;
/org.eclipse.jdt.ui/ui/org/eclipse/jdt/internal/ui/search/IOccurrencesFinder.java;3;0;4;1;1;1;1;3;14;2;2;3759;28;28;2;1;0;3;4;3759;1;5396;3;3;
/org.eclipse.ant.ui/Ant Editor/org/eclipse/ant/internal/ui/editor/model/IAntEditorConstants.java;1;0;2;1;0;0;0;2;0;1;2;3661;0;0;1;0;0;2;2;3661;0;4224;2;1;
/org.eclipse.sdk.tests-feature/plugins/org.eclipse.perfmsr.ui.client/src/org/eclipse/perfmsr/ui/client/StepComparison.java;1;1;2;1;2;2;2;0;10;0;0;5443;10;10;1;0;0;0;2;5443;0;5513;2;1;
/org.eclipse.jdt.core.tests.compiler/src/org/eclipse/jdt/core/tests/compiler/parser/SourceElementParserTest.java;4;0;5;1;0;0;0;5;10;1;5;85;25;25;1;0;0;5;5;85;0;3560;5;4;
/org.eclipse.ui.forms.examples/src/org/eclipse/ui/forms/examples/internal/rcp/TypeTwoDetailsPage.java;1;1;6;1;2;2;2;4;19;2;3;4075;42;42;2;1;0;4;6;4284;1;6269;5;1;
/org.eclipse.swt/Eclipse SWT Printing/gtk/org/eclipse/swt/printing/Printer.java;4;1;8;2;2;2;2;6;15;2;5;0;37;37;2;1;0;6;8;2492;1;6352;7;4;
/org.eclipse.jdt.core.tests.model/workspace/Formatter/test306/A_in.java;1;0;1;1;0;0;0;1;0;0;1;2442;0;0;1;0;0;1;1;2442;0;2442;1;1;
/org.eclipse.update.ui.forms/Eclipse Forms/org/eclipse/ui/forms/widgets/FormToolkit.java;1;0;17;1;0;0;0;17;427;3;12;3138;776;776;3;5;0;17;17;3174;5;4157;12;1;
/org.eclipse.jdt.core.tests.model/workspace/Converter/src/test0255/Test.java;1;0;1;1;0;0;0;1;0;0;1;3714;0;0;1;0;0;1;1;3714;0;3714;1;1;
/org.eclipse.team.ui/src/org/eclipse/team/ui/synchronize/SyncInfoDiffCheckboxTreeViewer.java;1;0;1;1;0;0;0;1;0;0;1;3619;0;0;1;0;0;1;1;3619;0;3619;1;1;
/org.eclipse.team.ui/src/org/eclipse/team/internal/ui/target/GetAction.java;2;0;4;1;0;0;0;4;5;1;4;790;10;10;1;0;0;4;4;790;0;2495;4;2;
/org.eclipse.pde.ui/src/org/eclipse/pde/internal/ui/PDEPlugin.java;3;1;18;1;5;5;5;13;46;1;13;368;238;238;1;0;0;13;18;368;0;6336;18;3;
/org.eclipse.update.ui/srcnew/org/eclipse/update/internal/ui/wizards/UnifiedSitePage.java;3;0;22;2;0;0;0;22;366;4;14;329;1048;1048;4;8;0;22;22;572;8;825;14;3;
/org.eclipse.swt/Eclipse SWT/gtk1x/org/eclipse/swt/widgets/Caret.java;1;0;1;1;0;0;0;1;0;0;1;2327;0;0;1;0;0;1;1;2327;0;2327;1;1;
/org.eclipse.ui.ide/src/org/eclipse/ui/views/bookmarkexplorer/RemoveBookmarkAction.java;1;0;1;1;0;0;0;1;0;0;1;2208;0;0;1;0;0;1;1;2208;0;2208;1;1;
/org.eclipse.jdt.text.tests/src/org/eclipse/jdt/text/tests/SmartSemicolonAutoEditStrategyTest.java;1;1;2;1;2;2;2;0;2;0;0;5129;2;2;1;0;0;0;2;5129;0;6340;2;1;
/org.eclipse.jdt.core.tests.model/src/org/eclipse/jdt/core/tests/model/CreateCompilationUnitTests.java;2;0;4;1;1;1;1;3;6;1;3;2722;10;10;1;0;0;3;4;2722;0;5397;4;2;
/org.eclipse.ui.workbench/Eclipse UI/org/eclipse/ui/internal/ObjectContributorManager.java;2;0;3;1;0;0;0;3;253;1;3;2737;478;478;1;0;0;3;3;2737;0;3150;3;2;
/org.eclipse.jdt.ui.tests/activation/org/eclipse/jdt/ui/tests/activation/JavaActivationTest.java;2;0;2;1;1;1;1;1;2;0;1;3345;2;2;1;0;0;1;2;3345;0;6340;2;2;
/org.eclipse.jdt.debug.tests/tests/org/eclipse/jdt/debug/tests/core/DeferredBreakpointTests.java;1;0;1;1;0;0;0;1;2;0;1;2429;2;2;1;0;0;1;1;2429;0;2429;1;1;
/org.eclipse.pde.core/src_OSGi/org/eclipse/pde/internal/core/osgi/OSGiWorkspaceModelManager.java;2;0;11;1;0;0;0;11;300;2;10;2229;532;532;2;1;0;11;11;2376;1;4203;10;2;
/org.eclipse.jdt.core/search/org/eclipse/jdt/internal/core/index/impl/JarFileDocument.java;2;0;3;1;0;0;0;3;7;1;3;883;10;10;1;0;0;3;3;883;0;3240;3;2;
/org.eclipse.search/search/org/eclipse/search/internal/ui/text/ResourcePathSorter.java;2;0;2;1;1;1;1;1;3;0;1;3711;5;5;1;0;0;1;2;3711;0;6340;2;2;
/org.eclipse.jdt.core.tests.model/workspace/Converter/test0268/Test.java;1;0;1;1;0;0;0;1;0;0;1;3714;0;0;1;0;0;1;1;3714;0;3714;1;1;
/org.eclipse.jdt.ui.tests.refactoring/resources/ExtractConstant/canExtract/A_testZeroLengthSelection0_out.java;1;0;1;1;0;0;0;1;0;0;1;1687;0;0;1;0;0;1;1;1687;0;1687;1;1;
/org.eclipse.pde.ui/src/org/eclipse/pde/internal/ui/wizards/convert/ConvertedProjectWizard.java;1;0;2;1;0;0;0;2;0;0;1;3839;0;0;2;1;0;2;2;3839;1;3839;1;1;
/org.eclipse.team.ui/src/org/eclipse/team/ui/sync/actions/SyncViewerShowPreferencesAction.java;1;0;1;1;0;0;0;1;0;0;1;2433;0;0;1;0;0;1;1;2433;0;2433;1;1;
/org.eclipse.team.ui/src/org/eclipse/team/ui/synchronize/viewers/SyncInfoDiffTreeViewer.java;1;0;1;1;0;0;0;1;0;0;1;3972;0;0;1;0;0;1;1;3972;0;3972;1;1;
/org.eclipse.ant.ui/Ant Tools Support/org/eclipse/ant/internal/ui/preferences/AntClasspathBlock.java;2;1;30;1;3;3;3;27;559;3;22;1811;1423;1423;3;5;0;27;30;2569;5;5802;25;2;
/org.eclipse.team.ftp/src/org/eclipse/team/internal/ftp/Policy.java;1;0;2;1;1;1;1;1;4;0;1;4216;6;6;1;0;0;1;2;4216;0;6337;2;1;
/org.eclipse.jdt.ui.tests.refactoring/resources/PasteSourceReference/test4/out/A.java;1;0;1;1;0;0;0;1;0;0;1;1311;0;0;1;0;0;1;1;1311;0;1311;1;1;
/org.eclipse.team.webdav/src/org/eclipse/team/ui/target/DepolymentProviderContentProvider.java;1;0;1;1;0;0;0;1;0;0;1;3461;0;0;1;0;0;1;1;3461;0;3461;1;1;
/org.eclipse.jdt.debug/jdi/org/eclipse/jdi/internal/TypeImpl.java;1;0;1;1;0;0;0;1;156;0;1;4267;156;156;1;0;0;1;1;4267;0;4267;1;1;
/org.eclipse.team.ui/src/org/eclipse/team/internal/ui/jobs/JobStatusHandler.java;2;0;9;2;0;0;0;9;134;2;7;2008;378;378;2;2;0;9;9;2040;2;4216;7;2;
/org.eclipse.jdt.ui.tests.refactoring/resources/ExtractMethodWorkSpace/ExtractMethodTests/try_out/A_test455.java;1;0;2;1;0;0;0;2;6;1;2;130;10;10;1;0;0;2;2;130;0;844;2;1;
/org.eclipse.search/search/org/eclipse/search/internal/core/text/TypedResourceVisitor.java;1;0;1;1;1;1;1;0;2;0;0;6340;2;2;1;0;0;0;1;6340;0;6340;1;1;
/org.eclipse.osgi/core/framework/org/eclipse/osgi/framework/internal/core/BundleRepository.java;5;3;13;2;5;3;5;8;75;1;8;3013;300;300;3;0;2;8;13;5109;2;5625;11;5;
/org.eclipse.pde.ui/templates/editor/java/NonRuleBasedDamagerRepairer.java;1;0;1;1;0;0;0;1;12;0;1;851;12;12;1;0;0;1;1;851;0;851;1;1;
/org.eclipse.swt/Eclipse SWT/motif/org/eclipse/swt/widgets/ColorDialog.java;3;1;5;1;2;2;2;3;16;1;3;270;35;35;1;0;0;3;5;270;0;6352;5;3;
/org.eclipse.core.runtime/src/org/eclipse/core/runtime/QualifiedName.java;2;1;5;1;2;2;2;3;220;1;3;3013;448;448;1;0;0;3;5;3013;0;6340;5;2;
/org.eclipse.ui.workbench/Eclipse UI/org/eclipse/ui/dialogs/FileEditorMappingContentProvider.java;1;0;1;1;0;0;0;1;1;0;1;1;1;1;1;0;0;1;1;1;0;1;1;1;
/org.eclipse.pde.core/src/org/eclipse/pde/internal/core/bundle/BundlePluginModelBase.java;1;2;5;1;5;4;5;0;127;0;0;5445;155;155;2;0;1;0;5;5537;1;6336;4;1;
/org.eclipse.search/search/org/eclipse/search/internal/ui/text/SearchResultUpdater.java;2;1;2;1;2;2;2;0;4;0;0;5199;4;4;1;0;0;0;2;5199;0;6340;2;2;
/org.eclipse.ui.ide/src/org/eclipse/ui/internal/ide/dialogs/AboutFeaturesButtonManager.java;2;0;2;1;1;1;1;1;0;0;1;4936;0;0;1;0;0;1;2;4936;0;5483;2;2;
/org.eclipse.jdt.core.tests.model/workspace/Formatter/test025/A_out.java;1;0;1;1;0;0;0;1;0;0;1;2425;0;0;1;0;0;1;1;2425;0;2425;1;1;
/org.eclipse.team.ui/src/org/eclipse/team/internal/ui/widgets/IChangePreviewViewer.java;1;0;1;1;0;0;0;1;0;0;1;3280;0;0;1;0;0;1;1;3280;0;3280;1;1;
/org.eclipse.jdt.core.tests.model/workspace/Formatter/test302/A_out.java;1;0;1;1;0;0;0;1;0;0;1;2442;0;0;1;0;0;1;1;2442;0;2442;1;1;
/org.eclipse.jdt.ui/ui refactoring/org/eclipse/jdt/internal/ui/refactoring/RefactoringWizardDialog.java;1;0;1;1;0;0;0;1;0;0;1;4965;0;0;1;0;0;1;1;4965;0;4965;1;1;
/org.eclipse.team.core/src/org/eclipse/team/internal/core/VestigeXMLWriter.java;1;0;1;1;0;0;0;1;0;0;1;649;0;0;1;0;0;1;1;649;0;649;1;1;
/org.eclipse.team.cvs.core/src/org/eclipse/team/internal/ccvs/core/client/AbstractStructureVisitor.java;1;0;3;1;0;0;0;3;33;1;3;1173;48;48;1;0;0;3;3;1173;0;2461;3;1;
/org.eclipse.jdt.ui/ui/org/eclipse/jdt/internal/ui/text/spelling/engine/PersistentSpellDictionary.java;2;0;2;1;1;1;1;1;2;0;1;3930;2;2;1;0;0;1;2;3930;0;6340;2;2;
/org.eclipse.team.ftp/src/org/eclipse/team/internal/ftp/client/Util.java;1;0;2;1;1;1;1;1;2;0;1;4216;4;4;1;0;0;1;2;4216;0;6337;2;1;
/org.eclipse.jdt.core.tests.model/workspace/Converter/test0136/Test.java;1;0;1;1;0;0;0;1;0;0;1;3714;0;0;1;0;0;1;1;3714;0;3714;1;1;
/org.eclipse.jdt.core.tests.model/workspace/Formatter/test065/A_in.java;1;0;1;1;0;0;0;1;0;0;1;2425;0;0;1;0;0;1;1;2425;0;2425;1;1;
/org.eclipse.pde.build/src/org/eclipse/pde/internal/build/ant/TarFileSet.java;1;1;3;1;3;3;3;0;10;0;0;5515;12;12;1;0;0;0;3;5515;0;6097;3;1;
/org.eclipse.pde.ui/src/org/eclipse/pde/internal/ui/launcher/JUnitArgumentsTab.java;2;1;12;1;2;2;2;10;147;1;10;1459;469;469;1;0;0;10;12;1459;0;6336;12;2;
/org.eclipse.jdt.ui.tests.refactoring/resources/DeleteSourceReference/test14/in/A.java;1;0;1;1;0;0;0;1;0;0;1;1652;0;0;1;0;0;1;1;1652;0;1652;1;1;
/org.eclipse.team.cvs.ui/src/org/eclipse/team/internal/ccvs/ui/AddToVersionControlDialog.java;1;0;3;1;0;0;0;3;15;1;3;790;18;18;1;0;0;3;3;790;0;2381;3;1;
/org.eclipse.jdt.ui.tests.refactoring/resources/ExtractMethodWorkSpace/ExtractMethodTests/locals_in/A_test560.java;1;0;1;1;0;0;0;1;2;0;1;844;2;2;1;0;0;1;1;844;0;844;1;1;
/org.eclipse.core.tests.resources/src/org/eclipse/core/tests/resources/perf/WorkspacePerformanceTest.java;1;0;2;1;2;1;2;0;23;0;0;5147;23;23;2;0;1;0;2;5147;1;5147;1;1;
/org.eclipse.core.tests.runtime/src/org/eclipse/core/tests/internal/runtimetests/SampleOFR.java;1;0;1;1;1;1;1;0;21;0;0;5149;21;21;1;0;0;0;1;5149;0;5149;1;1;
/org.eclipse.ui.externaltools/Ant Editor/org/eclipse/ui/externaltools/internal/ant/dtd/schema/Schema.java;1;0;2;1;0;0;0;2;9;1;2;245;9;9;1;0;0;2;2;245;0;282;2;1;
/org.eclipse.team.examples.filesystem/src/org/eclipse/team/examples/filesystem/Policy.java;1;0;1;1;0;0;0;1;4;0;1;1708;4;4;1;0;0;1;1;1708;0;1708;1;1;
/org.eclipse.jdt.ui/ui/org/eclipse/jdt/internal/ui/actions/QuickAccessAction.java;1;0;2;1;0;0;0;2;0;1;2;4864;0;0;1;0;0;2;2;4864;0;5052;2;1;
/org.eclipse.ui.ide/src/org/eclipse/ui/ResourceWorkingSetFilter.java;2;0;2;1;0;0;0;2;0;1;2;1511;0;0;1;0;0;2;2;1511;0;2263;2;2;
/org.eclipse.jdt.debug.ui/ui/org/eclipse/jdt/internal/debug/ui/launchConfigurations/ClasspathModel.java;1;0;2;1;0;0;0;2;0;0;1;2685;0;0;2;1;0;2;2;2685;1;2685;1;1;
/org.eclipse.debug.core/core/org/eclipse/debug/internal/core/variables/RefreshScopeVariableRegistry.java;1;0;2;1;0;0;0;2;0;1;2;737;0;0;1;0;0;2;2;737;0;754;2;1;
/org.eclipse.ui.workbench/Eclipse UI/org/eclipse/ui/internal/dialogs/PreferenceImportExportFileSelectionPage.java;4;2;9;1;7;6;7;2;74;1;2;3636;187;187;2;0;1;2;9;5800;1;6338;8;4;
/org.eclipse.update.core/src/org/eclipse/update/internal/search/UnifiedUpdatesSearchCategory.java;2;0;3;1;0;0;0;3;8;2;2;825;8;8;2;1;0;3;3;890;1;890;2;2;
/org.eclipse.jdt.ui/ui/org/eclipse/jdt/ui/wizards/IClasspathContainerPageExtension.java;1;0;1;1;1;1;1;0;2;0;0;6340;2;2;1;0;0;0;1;6340;0;6340;1;1;
/org.eclipse.jdt.ui.tests.refactoring/resources/ExtractInterface/test64/out/A.java;1;0;1;1;0;0;0;1;2;0;1;1166;2;2;1;0;0;1;1;1166;0;1166;1;1;
/org.eclipse.ui.internal.r21presentation/src/org/eclipse/ui/internal/r21presentation/widgets/R21PaneFolderButtonListener.java;1;0;1;1;1;1;1;0;0;0;0;5444;0;0;1;0;0;0;1;5444;0;5444;1;1;
/org.eclipse.jdt.ui.tests.refactoring/resources/ExtractMethodWorkSpace/ExtractMethodTests/semicolon_out/A_test402.java;1;0;2;1;0;0;0;2;6;1;2;130;7;7;1;0;0;2;2;130;0;844;2;1;
/org.eclipse.swt/Eclipse SWT PI/win32/org/eclipse/swt/internal/win32/DRAWITEMSTRUCT.java;1;0;1;1;0;0;0;1;2;0;1;2915;2;2;1;0;0;1;1;2915;0;2915;1;1;
/org.eclipse.update.ui/src/org/eclipse/update/internal/ui/wizards/ISearchProvider.java;2;0;6;1;0;0;0;6;16;1;6;200;30;30;1;0;0;6;6;200;0;4949;6;2;
/org.eclipse.swt/Eclipse SWT/gtk1x/org/eclipse/swt/widgets/Slider.java;1;0;1;1;0;0;0;1;0;0;1;2327;0;0;1;0;0;1;1;2327;0;2327;1;1;
/org.eclipse.jdt.ui.tests.refactoring/resources/UseSupertypeWherePossible/testNew3/in/A.java;1;0;1;1;0;0;0;1;2;0;1;1272;2;2;1;0;0;1;1;1272;0;1272;1;1;
/org.eclipse.jface/src/org/eclipse/jface/viewers/StructuredSelection.java;1;0;1;1;0;0;0;1;8;0;1;1293;8;8;1;0;0;1;1;1293;0;1293;1;1;
/org.eclipse.core.runtime/src/org/eclipse/core/internal/registry/ListenerList.java;3;1;3;1;2;2;2;1;2;0;1;4882;2;2;1;0;0;1;3;4882;0;5686;3;3;
/org.eclipse.jface.text/projection/org/eclipse/jface/text/source/projection/ProjectionAnnotationModel.java;2;1;7;1;4;4;4;3;102;1;3;4866;211;211;1;0;0;3;7;4866;0;6362;7;2;
/org.eclipse.ui.workbench/Eclipse UI/org/eclipse/ui/internal/activities/ws/ActivityViewerFilter.java;1;0;1;1;1;1;1;0;0;0;0;5874;0;0;1;0;0;0;1;5874;0;5874;1;1;
/org.eclipse.debug.ui/ui/org/eclipse/debug/ui/variables/FolderPromptExpander.java;1;0;3;1;0;0;0;3;37;2;2;316;37;37;2;1;0;3;3;316;1;550;2;1;
/org.eclipse.ui.internal.r21presentation/src/org/eclipse/ui/internal/r21presentation/presentations/R21PresentationFactory.java;2;2;5;2;5;3;5;0;89;0;0;5275;96;96;2;0;2;0;5;5381;2;5531;3;2;
/org.eclipse.jface.text/src/org/eclipse/jface/text/contentassist/ICompletionProposal.java;1;3;4;1;4;2;4;0;59;0;0;6340;61;61;3;0;2;0;4;6353;2;6353;2;1;
/org.eclipse.jdt.core.tests.model/workspace/Converter/src/test0139/Test.java;1;0;1;1;0;0;0;1;0;0;1;3714;0;0;1;0;0;1;1;3714;0;3714;1;1;
/org.eclipse.ui.workbench/Eclipse UI/org/eclipse/ui/internal/registry/ViewRegistryReader.java;5;1;6;1;2;2;2;4;24;1;4;1035;79;79;1;0;0;4;6;1035;0;6338;6;5;
/org.eclipse.debug.ui/ui/org/eclipse/debug/internal/ui/views/DebugViewInterimLabelProvider.java;2;0;3;1;0;0;0;3;7;1;3;3495;11;11;1;0;0;3;3;3495;0;3594;3;2;
/org.eclipse.jdt.launching.macosx/macosx/org/eclipse/jdt/internal/ui/macbundler/BundleWizardPage2.java;1;0;1;1;0;0;0;1;0;0;1;3622;0;0;1;0;0;1;1;3622;0;3622;1;1;
/org.eclipse.jdt.core.tests.model/workspace/Converter/src/javadoc/test017/TestD2.java;1;0;2;1;0;0;0;2;0;1;2;4311;0;0;1;0;0;2;2;4311;0;4390;2;1;
/org.eclipse.ui.workbench/Eclipse UI/org/eclipse/ui/internal/about/ConfigurationLogDefaultSection.java;1;1;2;1;2;2;2;0;2;0;0;5483;2;2;1;0;0;0;2;5483;0;6338;2;1;
/org.eclipse.ui.intro/src/org/eclipse/ui/intro/internal/model/StandbyPartContent.java;1;0;4;1;1;1;1;3;4;1;3;4614;6;6;1;0;0;3;4;4614;0;5115;4;1;
/org.eclipse.team.cvs.ui/src/org/eclipse/team/internal/ccvs/ui/subscriber/CVSSynchronizeParticipant.java;1;0;1;1;0;0;0;1;0;0;1;2463;0;0;1;0;0;1;1;2463;0;2463;1;1;
/org.eclipse.jdt.debug/jdi/org/eclipse/jdi/internal/request/EventRequestManagerImpl.java;3;1;5;1;3;3;3;2;17;1;2;1240;31;31;1;0;0;2;5;1240;0;6336;5;3;
/org.eclipse.pde.core/src/org/eclipse/pde/internal/core/IEnvironmentVariables.java;2;1;2;1;2;2;2;0;8;0;0;5798;12;12;1;0;0;0;2;5798;0;6336;2;2;
/org.eclipse.team.webdav/src/org/eclipse/team/internal/core/target/IMemento.java;2;1;2;1;2;2;2;0;2;0;0;5754;2;2;1;0;0;0;2;5754;0;6337;2;2;
/org.eclipse.jdt.core.tests.model/workspace/Completion/src/CompletionAbstractMethod1.java;1;0;1;1;0;0;0;1;0;0;1;1702;0;0;1;0;0;1;1;1702;0;1702;1;1;
/org.eclipse.search/search/org/eclipse/search/internal/ui/SearchPlugin.java;2;1;9;1;4;4;4;5;29;1;5;1101;77;77;1;0;0;5;9;1101;0;6340;9;2;
/org.eclipse.jdt.ui/ui/org/eclipse/jdt/internal/ui/packageview/CollapseAllAction.java;1;0;1;1;1;1;1;0;2;0;0;6340;2;2;1;0;0;0;1;6340;0;6340;1;1;
/org.eclipse.ui.ide/src/org/eclipse/ui/views/markers/internal/TaskMarker.java;3;1;4;1;2;2;2;2;13;1;2;3214;17;17;1;0;0;2;4;3214;0;6338;4;3;
/org.eclipse.jdt.core/search/org/eclipse/jdt/internal/core/search/indexing/AddFolderToIndex.java;3;1;13;2;2;2;2;11;63;2;10;937;96;96;2;1;0;11;13;4887;1;6099;12;3;
/org.eclipse.jdt.core/compiler/org/eclipse/jdt/internal/compiler/parser/diagnose/LexStream.java;2;0;5;1;0;0;0;5;94;1;5;764;106;106;1;0;0;5;5;764;0;3560;5;2;
/org.eclipse.osgi/core/framework/org/eclipse/osgi/framework/internal/core/BundleSource.java;4;1;4;1;2;2;2;2;28;1;2;3013;34;34;1;0;0;2;4;3013;0;6337;4;4;
/org.eclipse.jdt.core.tests.model/workspace/Converter/src/test0345/A.java;1;0;1;1;0;0;0;1;0;0;1;3714;0;0;1;0;0;1;1;3714;0;3714;1;1;
/org.eclipse.pde.ui/src/org/eclipse/pde/internal/ui/wizards/feature/FeatureSelectionDialog.java;2;2;4;1;4;3;4;0;8;0;0;5563;12;12;2;0;1;0;4;5781;1;6336;3;2;
/org.eclipse.ui.workbench/Eclipse UI/org/eclipse/ui/IContributorResourceAdapter.java;1;0;1;1;0;0;0;1;0;0;1;2737;0;0;1;0;0;1;1;2737;0;2737;1;1;
/org.eclipse.jdt.debug.ui/ui/org/eclipse/jdt/internal/debug/ui/actions/DropToFrameButton.java;1;0;1;1;1;1;1;0;0;0;0;5620;0;0;1;0;0;0;1;5620;0;5620;1;1;
/org.eclipse.jdt.ui.tests.refactoring/resources/IntroduceParameter/simple/out/ConstantExpression1.java;1;0;1;1;0;0;0;1;0;0;1;2281;0;0;1;0;0;1;1;2281;0;2281;1;1;
/org.eclipse.ua.tests/src/org/eclipse/ui/examples/cheatsheets/pattern/actions/CustomizeAction.java;1;0;1;1;1;1;1;0;0;0;0;6081;0;0;1;0;0;0;1;6081;0;6081;1;1;
/org.eclipse.jdt.ui/ui refactoring/org/eclipse/jdt/internal/ui/refactoring/nls/search/NLSSearchResultRequestor.java;2;1;5;1;5;5;5;0;45;0;0;5268;55;55;1;0;0;0;5;5268;0;6340;5;2;
/org.eclipse.jdt.ui/ui refactoring/org/eclipse/jdt/internal/ui/refactoring/reorg/RenameMethodUserInterfaceStarter.java;2;0;8;1;1;1;1;7;10;1;7;1709;30;30;1;0;0;7;8;1709;0;6340;8;2;
/org.eclipse.jdt.ui/ui refactoring/org/eclipse/jdt/internal/ui/refactoring/IntroduceFactoryInputPage.java;2;0;9;1;1;1;1;8;118;2;7;2846;225;225;2;1;0;8;9;5052;1;6340;8;2;
/org.eclipse.ui.workbench/Eclipse UI/org/eclipse/ui/internal/dialogs/FileFolderSelectionDialog.java;1;0;1;1;0;0;0;1;0;0;1;2737;0;0;1;0;0;1;1;2737;0;2737;1;1;
/org.eclipse.jdt.ui/core refactoring/org/eclipse/jdt/internal/corext/refactoring/participants/xml/IVariablePool.java;1;0;3;1;0;0;0;3;11;1;3;2682;11;11;1;0;0;3;3;2682;0;4091;3;1;
/org.eclipse.ui.workbench/Eclipse UI/org/eclipse/ui/internal/csm/commands/ContextBindingDefinition.java;1;0;2;1;0;0;0;2;4;0;1;2532;4;4;2;1;0;2;2;2532;1;2532;1;1;
/org.eclipse.jdt.ui.tests.refactoring/resources/MoveInstanceMethod/canMove/test16/in/B.java;1;0;1;1;0;0;0;1;0;0;1;1570;0;0;1;0;0;1;1;1570;0;1570;1;1;
/org.eclipse.help/src/org/eclipse/help/internal/protocols/URLHandler.java;1;0;2;1;0;0;0;2;7;1;2;1010;7;7;1;0;0;2;2;1010;0;2769;2;1;
/org.eclipse.jdt.ui.tests.refactoring/resources/Copy/test_import_container_yes_method_in_different_cu/out/C.java;1;0;1;1;0;0;0;1;0;0;1;685;0;0;1;0;0;1;1;685;0;685;1;1;
/org.eclipse.jdt.core/model/org/eclipse/jdt/core/eval/ICodeSnippetRequestor.java;2;0;3;1;1;1;1;2;17;1;2;3560;23;23;1;0;0;2;3;3560;0;5871;3;2;
/org.eclipse.jdt.debug.tests/test plugin/org/eclipse/jdt/debug/testplugin/TestModeLaunchDelegate.java;4;1;4;1;2;2;2;2;4;1;2;463;8;8;1;0;0;2;4;463;0;6337;4;4;
/org.eclipse.jdt.ui/ui refactoring/org/eclipse/jdt/internal/ui/refactoring/reorg/DeleteUserInterfaceManager.java;1;0;1;1;0;0;0;1;0;0;1;4507;0;0;1;0;0;1;1;4507;0;4507;1;1;
/org.eclipse.pde.core/src/org/eclipse/pde/core/IModelChangedListener.java;2;1;3;1;3;3;3;0;12;0;0;5115;18;18;1;0;0;0;3;5115;0;6336;3;2;
/org.eclipse.pde.ui/src/org/eclipse/pde/internal/ui/editor/schema/CompositorPropertySource.java;2;1;2;1;2;2;2;0;4;0;0;5781;8;8;1;0;0;0;2;5781;0;6336;2;2;
/org.eclipse.jdt.ui/ui refactoring/org/eclipse/jdt/internal/ui/refactoring/reorg/RenameFieldWizard.java;3;0;7;1;1;1;1;6;29;2;5;1125;47;47;2;1;0;6;7;1125;1;6340;6;3;
/org.eclipse.jdt.core.tests.model/workspace/Converter/src/test0495/A.java;1;0;1;1;0;0;0;1;0;0;1;3714;0;0;1;0;0;1;1;3714;0;3714;1;1;
/org.eclipse.jdt.core/dom/org/eclipse/jdt/core/internal/dom/rewrite/ASTRewriteAnalyzer.java;2;0;3;2;0;0;0;3;24;2;2;4711;24;24;2;1;0;3;3;4711;1;4802;2;2;
/org.eclipse.jdt.ui/ui/org/eclipse/jdt/internal/ui/reorg/SourceReferenceAction.java;2;0;3;1;0;0;0;3;16;1;3;374;18;18;1;0;0;3;3;374;0;1111;3;2;
/org.eclipse.team.cvs.ui/src/org/eclipse/team/internal/ccvs/ui/model/CVSAdapterFactory.java;1;0;1;1;0;0;0;1;37;0;1;1065;37;37;1;0;0;1;1;1065;0;1065;1;1;
/org.eclipse.jdt.core.tests.model/workspace/Converter/junit/runner/TestCaseClassLoader.java;1;0;1;1;0;0;0;1;0;0;1;3714;0;0;1;0;0;1;1;3714;0;3714;1;1;
/org.eclipse.jdt.core.tests.model/workspace/Completion/src/CompletionStaticMethodDeclaration5.java;1;0;1;1;0;0;0;1;0;0;1;3039;0;0;1;0;0;1;1;3039;0;3039;1;1;
/org.eclipse.jdt.core.tests.model/workspace/Converter/junit/runner/TestCollector.java;1;0;2;1;0;0;0;2;1;1;2;787;1;1;1;0;0;2;2;787;0;3714;2;1;
/org.eclipse.jdt.ui.tests.refactoring/resources/IntroduceFactory/Bugzilla/46608/p2/TT.java;1;0;1;1;0;0;0;1;0;0;1;2888;0;0;1;0;0;1;1;2888;0;2888;1;1;
/org.eclipse.core.boot/src/org/eclipse/core/internal/boot/Policy.java;1;0;1;1;0;0;0;1;0;0;1;3013;0;0;1;0;0;1;1;3013;0;3013;1;1;
/org.eclipse.jdt.ui/ui/org/eclipse/jdt/internal/ui/text/correction/ReorgCorrectionsSubProcessor.java;3;1;17;1;4;4;4;13;110;1;13;1034;207;207;1;0;0;13;17;1034;0;6340;17;3;
/org.eclipse.ui.externaltools/Ant Editor/org/eclipse/ui/externaltools/internal/ant/editor/outline/LocationProvider.java;1;0;1;1;0;0;0;1;0;0;1;282;0;0;1;0;0;1;1;282;0;282;1;1;
/org.eclipse.update.core/srcnew/org/eclipse/update/internal/search/IUpdateSiteAdapter.java;2;0;4;2;0;0;0;4;12;3;2;553;12;12;3;2;0;4;4;569;2;569;2;2;
/org.eclipse.update.ui/srcnew/org/eclipse/update/internal/ui/views/NewExtensionLocationAction.java;3;0;5;3;0;0;0;5;75;4;2;745;75;75;4;3;0;5;5;745;3;825;2;3;
/org.eclipse.ant.ui/Ant Editor/org/eclipse/ant/internal/ui/dtd/IModel.java;1;0;1;1;0;0;0;1;0;0;1;1811;0;0;1;0;0;1;1;1811;0;1811;1;1;
/org.eclipse.jdt.core/model/org/eclipse/jdt/internal/core/SourceFieldElementInfo.java;1;0;2;1;0;0;0;2;2;1;2;2035;4;4;1;0;0;2;2;2035;0;3560;2;1;
/org.eclipse.pde.ui/src/org/eclipse/pde/internal/ui/wizards/imports/PluginImportOperation.java;2;1;20;1;5;5;5;15;780;3;12;368;1216;1216;3;3;0;15;20;2998;3;6336;17;2;
/org.eclipse.jface.text/src/org/eclipse/jface/text/IFindReplaceTargetExtension3.java;2;1;3;1;2;2;2;1;36;0;1;2121;38;38;1;0;0;1;3;2121;0;6359;3;2;
/org.eclipse.text/src/org/eclipse/jface/text/link/InclusivePositionUpdater.java;3;1;6;1;4;4;4;2;8;1;2;4214;31;31;1;0;0;2;6;4214;0;6340;6;3;
/org.eclipse.jdt.core.tests.model/workspace/JavaSearch/src/r7/A.java;1;0;1;1;0;0;0;1;0;0;1;543;0;0;1;0;0;1;1;543;0;543;1;1;
/org.eclipse.jdt.core/compiler/org/eclipse/jdt/internal/compiler/parser/Scanner.java;6;1;49;3;6;6;6;43;1268;4;32;13;2582;2582;4;11;0;43;49;2118;11;6162;38;6;
/org.eclipse.ant.ui/Ant Tools Support/org/eclipse/ant/ui/internal/preferences/AntClasspathPage.java;1;0;5;1;0;0;0;5;12;1;5;250;23;23;1;0;0;5;5;250;0;1811;5;1;
/org.eclipse.ant.ui/Ant Editor/org/eclipse/ant/ui/internal/editor/outline/AntOutlineMessages.java;1;0;2;1;0;0;0;2;0;1;2;250;0;0;1;0;0;2;2;250;0;1811;2;1;
/org.eclipse.jdt.core/compiler/org/eclipse/jdt/internal/compiler/util/CompoundNameVector.java;1;0;1;1;0;0;0;1;2;0;1;3560;2;2;1;0;0;1;1;3560;0;3560;1;1;
/org.eclipse.team.cvs.ui/src/org/eclipse/team/internal/ccvs/ui/subscriber/CVSSynchronizeViewerAdvisor.java;2;0;5;1;1;1;1;4;59;1;4;4244;100;100;1;0;0;4;5;4244;0;5358;5;2;
/org.eclipse.ui.workbench/Eclipse UI/org/eclipse/ui/keys/SpecialKey.java;3;1;17;2;2;2;2;15;214;2;12;1294;1174;1174;2;3;0;15;17;2141;3;6338;14;3;
/org.eclipse.jdt.core/search/org/eclipse/jdt/internal/core/search/matching/MatchLocatorParser.java;6;1;27;2;2;2;2;25;240;3;21;69;669;669;3;4;0;25;27;2580;4;6141;23;6;
/org.eclipse.ui.views/src/org/eclipse/ui/views/bookmarkexplorer/IBookmarkHelpContextIds.java;1;0;1;1;0;0;0;1;0;0;1;2738;0;0;1;0;0;1;1;2738;0;2738;1;1;
/org.eclipse.pde.ui/src/org/eclipse/pde/internal/ui/editor/site/FeaturesPage.java;2;2;6;1;5;4;5;1;59;0;1;3721;89;89;2;0;1;1;6;5682;1;6336;5;2;
/org.eclipse.core.tests.resources/src/org/eclipse/core/tests/resources/session/TestSaveWithClosedProject.java;1;0;1;1;1;1;1;0;93;0;0;5147;93;93;1;0;0;0;1;5147;0;5147;1;1;
/org.eclipse.jdt.core.tests.model/workspace/Converter/test0083/Test.java;1;0;1;1;0;0;0;1;0;0;1;3714;0;0;1;0;0;1;1;3714;0;3714;1;1;
/org.eclipse.update.core/src/org/eclipse/update/operations/IOperationValidator.java;1;2;8;1;4;3;4;4;22;1;4;825;54;54;2;0;1;4;8;6336;1;6336;7;1;
/org.eclipse.jface.text.tests/src/org/eclipse/jface/text/tests/JFaceTextTestSuite.java;1;1;2;1;2;2;2;0;6;0;0;5129;6;6;1;0;0;0;2;5129;0;5239;2;1;
/org.eclipse.swt/Eclipse SWT/motif/org/eclipse/swt/widgets/Label.java;5;0;12;2;1;1;1;11;61;2;10;267;192;192;2;1;0;11;12;267;1;6352;11;5;
/org.eclipse.jdt.ui.tests.refactoring/resources/ExtractMethodWorkSpace/ExtractMethodTests/try_out/A_test461.java;1;0;1;1;0;0;0;1;1;0;1;130;1;1;1;0;0;1;1;130;0;130;1;1;
/org.eclipse.pde.core/src/org/eclipse/pde/internal/core/feature/FeatureImport.java;2;1;3;1;2;2;2;1;36;0;1;4203;53;53;1;0;0;1;3;4203;0;6336;3;2;
/org.eclipse.text.tests/src/org/eclipse/text/tests/PositionUpdatingCornerCasesTest.java;1;2;4;1;3;2;3;1;8;0;1;5082;10;10;2;0;1;1;4;5100;1;6340;3;1;
/org.eclipse.pde.core/src/org/eclipse/pde/internal/core/PluginModelDelta.java;1;0;2;1;1;1;1;1;6;0;1;4203;8;8;1;0;0;1;2;4203;0;6336;2;1;
/org.eclipse.help.tests/src/org/eclipse/help/tests/base/TestLogFile.java;1;1;2;1;2;2;2;0;22;0;0;5827;38;38;1;0;0;0;2;5827;0;6337;2;1;
/org.eclipse.core.tests.resources/src/org/eclipse/core/tests/resources/regression/IProjectTest.java;2;0;4;1;2;1;2;2;390;1;2;1580;430;430;2;0;1;2;4;5147;1;5147;3;2;
/org.eclipse.debug.core/core/org/eclipse/debug/internal/core/sourcelookup/containers/FolderSourceContainerType.java;2;0;6;2;1;1;1;5;20;3;2;3678;26;26;3;3;0;5;6;4949;3;5672;3;2;
/org.eclipse.jface.text/src/org/eclipse/jface/text/source/IVerticalRulerListener.java;2;2;4;1;4;3;4;0;7;0;0;5177;17;17;2;0;1;0;4;5177;1;6361;3;2;
/org.eclipse.swt/Eclipse SWT/win32/org/eclipse/swt/graphics/Device.java;4;1;10;2;5;5;5;5;36;2;4;957;151;151;2;1;0;5;10;4997;1;6352;9;4;
/org.eclipse.team.ui/src/org/eclipse/team/internal/ui/synchronize/views/CompressFolderView.java;1;0;1;1;0;0;0;1;0;0;1;3748;0;0;1;0;0;1;1;3748;0;3748;1;1;
/org.eclipse.swt/Eclipse SWT Browser/common/org/eclipse/swt/browser/VisibilityWindowListener.java;2;0;5;1;1;1;1;4;50;2;3;3166;73;73;2;1;0;4;5;3166;1;6352;4;2;
/org.eclipse.search/search/org/eclipse/search/internal/ui/text/FileUIAdapter.java;1;0;4;1;0;0;0;4;110;1;4;3458;112;112;1;0;0;4;4;3458;0;3711;4;1;
/org.eclipse.jdt.ui/core refactoring/org/eclipse/ltk/internal/refactoring/core/StatusConstants.java;1;0;3;1;0;0;0;3;3;1;3;3708;3;3;1;0;0;3;3;3708;0;4510;3;1;
/org.eclipse.ui.workbench/Eclipse UI/org/eclipse/ui/internal/commands/CategoryDefinitionHandle.java;1;0;2;1;0;0;0;2;0;0;1;1389;0;0;2;1;0;2;2;1389;1;1389;1;1;
/org.eclipse.ui.views/src/org/eclipse/ui/views/navigator/ResourceNavigator.java;3;0;5;1;0;0;0;5;28;1;5;1;47;47;1;0;0;5;5;1;0;2738;5;3;
/org.eclipse.jdt.ui.tests.refactoring/resources/ExtractMethodWorkSpace/ExtractMethodTests/expression_in/A_test604.java;1;0;1;1;0;0;0;1;2;0;1;844;2;2;1;0;0;1;1;844;0;844;1;1;
/org.eclipse.jdt.ui/ui/org/eclipse/jdt/ui/actions/IJavaEditorActionDefinitionIds.java;7;2;24;2;4;3;4;20;21;2;18;237;200;200;2;2;1;20;24;500;3;6334;21;7;
/org.eclipse.jdt.core/model/org/eclipse/jdt/internal/core/RenameResourceElementsOperation.java;2;0;4;2;0;0;0;4;4;2;3;2157;7;7;2;1;0;4;4;2157;1;3560;3;2;
/org.eclipse.tomcat/src/org/eclipse/tomcat/internal/EclipseErrorReportValve.java;2;0;6;1;1;1;1;5;506;3;3;487;516;516;3;2;0;5;6;487;2;6337;4;2;
/org.eclipse.jdt.ui/ui/org/eclipse/jdt/internal/ui/reorg/PasteSourceReferencesFromClipboardAction.java;2;0;2;1;0;0;0;2;2;1;2;592;2;2;1;0;0;2;2;592;0;1111;2;2;
/org.eclipse.jdt.ui/ui/org/eclipse/jdt/internal/ui/text/java/JavaTextMessages.java;2;1;2;1;2;2;2;0;10;0;0;5505;12;12;1;0;0;0;2;5505;0;6340;2;2;
/org.eclipse.jdt.core/compiler/org/eclipse/jdt/internal/compiler/ast/Annotation.java;2;0;8;1;0;0;0;8;233;2;7;1366;475;475;2;1;0;8;8;2580;1;2887;7;2;
/org.eclipse.jdt.ui/ui/org/eclipse/jdt/internal/ui/text/link/ILinkedListener.java;1;0;3;1;0;0;0;3;50;1;3;2838;50;50;1;0;0;3;3;2838;0;4214;3;1;
/org.eclipse.team.ui/src/org/eclipse/team/ui/sync/ISynchronizePageListener.java;1;0;1;1;0;0;0;1;0;0;1;2406;0;0;1;0;0;1;1;2406;0;2406;1;1;
/org.eclipse.jdt.ui/core refactoring/org/eclipse/jdt/internal/corext/refactoring/UndoManager.java;1;0;6;1;0;0;0;6;416;1;6;2335;591;591;1;0;0;6;6;2335;0;4575;6;1;
/org.eclipse.pde.ui/src/org/eclipse/pde/internal/ui/wizards/exports/BaseExportWizard.java;2;1;15;1;4;4;4;11;317;2;10;94;797;797;2;1;0;11;15;1255;1;6336;14;2;
/org.eclipse.help.base/src/org/eclipse/help/internal/standalone/EclipseLifeCycleListener.java;1;1;3;1;2;2;2;1;6;0;1;1880;8;8;1;0;0;1;3;1880;0;6337;3;1;
/org.eclipse.team.tests.cvs.core/src/org/eclipse/team/tests/ccvs/ui/logformatter/LogFormatterUIMain.java;1;0;1;1;0;0;0;1;0;0;1;2632;0;0;1;0;0;1;1;2632;0;2632;1;1;
/org.eclipse.jdt.ui/ui refactoring/org/eclipse/jdt/internal/ui/refactoring/ErrorWizardPage.java;1;0;4;1;0;0;0;4;16;1;4;1047;34;34;1;0;0;4;4;1047;0;4965;4;1;
/org.eclipse.jdt.core.tests.model/workspace/Converter/test0210/Test.java;1;0;1;1;0;0;0;1;0;0;1;3714;0;0;1;0;0;1;1;3714;0;3714;1;1;
/org.eclipse.jdt.core.tests.model/workspace/Formatter/test072/A_out.java;1;0;1;1;0;0;0;1;0;0;1;2425;0;0;1;0;0;1;1;2425;0;2425;1;1;
/org.eclipse.jdt.core.tests.model/workspace/Formatter/test080/A_in.java;1;0;1;1;0;0;0;1;0;0;1;2425;0;0;1;0;0;1;1;2425;0;2425;1;1;
/org.eclipse.jdt.ui.tests/ui/org/eclipse/jdt/ui/tests/quickfix/TypeMismatchQuickFixTests.java;2;1;7;1;7;7;7;0;117;0;0;5377;318;318;1;0;0;0;7;5377;0;6340;7;2;
/org.eclipse.ui.ide/src/org/eclipse/ui/views/properties/FilePropertySource.java;1;0;1;1;0;0;0;1;0;0;1;2208;0;0;1;0;0;1;1;2208;0;2208;1;1;
/org.eclipse.jdt.ui/ui/org/eclipse/jdt/internal/ui/callhierarchy/AbstractGotoActionDelegate.java;1;0;2;1;0;0;0;2;0;1;2;155;0;0;1;0;0;2;2;155;0;169;2;1;
/org.eclipse.ui.workbench/Eclipse UI/org/eclipse/ui/dialogs/SelectionDialog.java;2;1;3;1;2;2;2;1;339;0;1;281;345;345;1;0;0;1;3;281;0;6338;3;2;
/org.eclipse.jdt.core/search/org/eclipse/jdt/internal/core/search/matching/SuperTypeReferenceLocator.java;4;0;9;2;1;1;1;8;46;2;6;1986;77;77;2;2;0;8;9;1986;2;5207;7;4;
/org.eclipse.swt/Eclipse SWT PI/gtk/org/eclipse/swt/internal/accessibility/gtk/GTypeQuery.java;4;0;5;1;1;1;1;4;11;1;4;1214;17;17;1;0;0;4;5;1214;0;6352;5;4;
/org.eclipse.jdt.ui.tests.refactoring/test cases/org/eclipse/jdt/ui/tests/refactoring/SurroundWithTests.java;4;0;9;1;1;1;1;8;6;1;8;130;32;32;1;0;0;8;9;130;0;6340;9;4;
/org.eclipse.debug.ui/ui/org/eclipse/debug/ui/variables/VariableSelectionDialog.java;1;0;5;1;0;0;0;5;100;4;2;316;100;100;4;3;0;5;5;316;3;550;2;1;
/org.eclipse.jdt.ui.tests.refactoring/test cases/org/eclipse/jdt/ui/tests/actions/DeleteSourceReferenceActionTests.java;1;0;1;1;0;0;0;1;0;0;1;1111;0;0;1;0;0;1;1;1111;0;1111;1;1;
/org.eclipse.core.tests.runtime/src/org/eclipse/core/tests/internal/plugins/CircularTest.java;1;0;1;1;0;0;0;1;0;0;1;3014;0;0;1;0;0;1;1;3014;0;3014;1;1;
/org.eclipse.jdt.core/search/org/eclipse/jdt/internal/core/index/impl/CodeByteStream.java;2;0;3;1;0;0;0;3;10;1;3;488;12;12;1;0;0;3;3;488;0;4060;3;2;
/org.eclipse.ui.workbench/Eclipse UI/org/eclipse/ui/internal/commands/old/IPropertyListener.java;1;0;3;1;0;0;0;3;6;1;3;1223;6;6;1;0;0;3;3;1223;0;1695;3;1;
/org.eclipse.team.core/src/org/eclipse/team/core/subscribers/ISubscriberResourceComparator.java;1;0;1;1;0;0;0;1;0;0;1;3966;0;0;1;0;0;1;1;3966;0;3966;1;1;
/org.eclipse.help/src/org/eclipse/help/internal/HelpResources.java;1;1;7;1;3;3;3;4;80;1;4;1781;135;135;1;0;0;4;7;1781;0;6337;7;1;
/org.eclipse.update.ui/srcnew/org/eclipse/update/internal/ui/views/InstallOptionalFeatureAction.java;3;0;10;2;0;0;0;10;212;2;7;478;271;271;2;3;0;10;10;583;3;825;7;3;
/org.eclipse.swt/Eclipse SWT PI/motif/org/eclipse/swt/internal/motif/XImage.java;1;0;1;1;0;0;0;1;19;0;1;829;19;19;1;0;0;1;1;829;0;829;1;1;
/org.eclipse.ui.workbench/Eclipse UI/org/eclipse/ui/activities/IActivityManager.java;5;1;22;1;2;2;2;20;125;2;18;2240;453;453;2;2;0;20;22;2800;2;6338;20;5;
/org.eclipse.jdt.core.tests.model/workspace/Formatter/test054/A_in.java;1;0;1;1;0;0;0;1;0;0;1;2425;0;0;1;0;0;1;1;2425;0;2425;1;1;
/org.eclipse.ui.workbench/Eclipse UI/org/eclipse/ui/internal/presentations/WorkbenchPresentationFactory.java;2;0;3;1;0;0;0;3;46;2;2;4469;64;64;2;1;0;3;3;4469;1;4508;2;2;
/org.eclipse.pde.ui/src/org/eclipse/pde/internal/ui/launcher/RuntimeWorkbenchShortcut.java;2;1;11;1;3;3;3;8;41;1;8;605;98;98;1;0;0;8;11;605;0;6336;11;2;
/org.eclipse.jdt.ui.tests.refactoring/test cases/org/eclipse/jdt/ui/tests/xml/I.java;1;0;2;1;0;0;0;2;0;1;2;2204;0;0;1;0;0;2;2;2204;0;4108;2;1;
/org.eclipse.jdt.core/search/org/eclipse/jdt/internal/core/search/matching/SuperTypeReferencePattern.java;3;3;23;2;5;3;5;18;322;3;14;786;1260;1260;3;4;2;18;23;3211;6;5610;17;3;
/org.eclipse.jface/src/org/eclipse/jface/preference/StringFieldEditor.java;2;1;4;1;2;2;2;2;15;1;2;1418;23;23;1;0;0;2;4;1418;0;6338;4;2;
/org.eclipse.jdt.launching/launching/org/eclipse/jdt/internal/launching/JRERuntimeClasspathEntryResolver.java;4;1;7;2;2;2;2;5;51;2;4;2497;120;120;2;1;0;5;7;3279;1;6336;6;4;
/org.eclipse.search.tests/src/org/eclipse/search/tests/filesearch/ResultUpdaterTest.java;1;1;2;1;2;2;2;0;4;0;0;5199;4;4;1;0;0;0;2;5199;0;5242;2;1;
/org.eclipse.swt/Eclipse SWT Custom Widgets/common/org/eclipse/swt/custom/DisplayRenderer.java;5;0;10;1;1;1;1;9;359;2;8;507;531;531;2;1;0;9;10;4612;1;6352;9;5;
/org.eclipse.pde.ui/srcnew/org/eclipse/pde/internal/ui/editor/manifest/ManifestSourceOutlinePageLabelProvider.java;1;0;2;1;0;0;0;2;3;1;2;1111;3;3;1;0;0;2;2;1111;0;2320;2;1;
/org.eclipse.core.resources/src/org/eclipse/core/internal/utils/Sorter.java;1;1;2;1;2;2;2;0;100;0;0;5146;100;100;1;0;0;0;2;5146;0;5271;2;1;
/org.eclipse.jdt.ui/core refactoring/org/eclipse/jdt/internal/corext/refactoring/reorg/DeleteChangeCreator.java;5;1;19;1;3;3;3;16;31;1;16;1114;132;132;1;0;0;16;19;1114;0;6340;19;5;
/org.eclipse.jdt.core/compiler/org/eclipse/jdt/internal/compiler/ast/JavadocSingleNameReference.java;3;0;5;1;1;1;1;4;21;1;4;2887;39;39;1;0;0;4;5;2887;0;5608;5;3;
/org.eclipse.core.filebuffers/src/org/eclipse/core/filebuffers/IAnnotationModelManager.java;1;0;1;1;0;0;0;1;0;0;1;2815;0;0;1;0;0;1;1;2815;0;2815;1;1;
/org.eclipse.jdt.debug.ui/ui/org/eclipse/jdt/internal/debug/ui/launcher/ZipTreeNode.java;1;0;1;1;0;0;0;1;0;0;1;1510;0;0;1;0;0;1;1;1510;0;1510;1;1;
/org.eclipse.jdt.ui.tests.refactoring/resources/MoveMembers/testFail23/in/A.java;1;0;1;1;0;0;0;1;0;0;1;1856;0;0;1;0;0;1;1;1856;0;1856;1;1;
/org.eclipse.jdt.core.tests.model/workspace/Converter/src/test0531/A.java;1;0;1;1;0;0;0;1;0;0;1;3714;0;0;1;0;0;1;1;3714;0;3714;1;1;
/org.eclipse.ui.workbench/Eclipse UI/org/eclipse/ui/internal/roles/api/IRoleListener.java;1;0;2;1;0;0;0;2;0;0;1;2202;0;0;2;1;0;2;2;2202;1;2202;1;1;
/org.eclipse.jdt.ui/ui refactoring/org/eclipse/jdt/internal/ui/refactoring/contentassist/JavaPackageFragmentRootCompletionProcessor.java;4;2;6;2;5;4;5;1;19;0;1;4417;43;43;2;0;1;1;6;5197;1;6340;5;4;
/org.eclipse.team.ui/src/org/eclipse/team/internal/ui/synchronize/PartNavigator.java;1;0;1;1;1;1;1;0;0;0;0;5436;0;0;1;0;0;0;1;5436;0;5436;1;1;
/org.eclipse.jdt.ui/ui/org/eclipse/jdt/internal/ui/text/link/contentassist/JFaceTextMessages2.java;2;0;2;1;0;0;0;2;0;1;2;1132;0;0;1;0;0;2;2;1132;0;4214;2;2;
/org.eclipse.ltk.ui.refactoring/src/org/eclipse/ltk/internal/ui/refactoring/FileStatusContextViewer.java;1;1;5;1;2;2;2;3;32;1;3;4965;50;50;1;0;0;3;5;4965;0;6340;5;1;
/org.eclipse.jdt.core/codeassist/org/eclipse/jdt/internal/codeassist/complete/CompletionOnExplicitConstructorCall.java;2;0;2;1;0;0;0;2;77;1;2;991;79;79;1;0;0;2;2;991;0;3560;2;2;
/org.eclipse.jdt.core.tests.model/workspace/Converter/src/test0333/Test.java;1;0;1;1;0;0;0;1;0;0;1;3714;0;0;1;0;0;1;1;3714;0;3714;1;1;
/org.eclipse.debug.core/core/org/eclipse/debug/internal/core/variables/RefreshLaunchVariableRegistry.java;2;0;2;1;0;0;0;2;0;1;2;754;0;0;1;0;0;2;2;754;0;2077;2;2;
/org.eclipse.jdt.core.tests.compiler/src/org/eclipse/jdt/core/tests/eval/SimpleCodeSnippetTest.java;1;0;1;1;0;0;0;1;2;0;1;3560;2;2;1;0;0;1;1;3560;0;3560;1;1;
/org.eclipse.jdt.core.tests.model/workspace/Formatter/test161/A_out.java;2;0;2;1;0;0;0;2;24;1;2;2425;24;24;1;0;0;2;2;2425;0;3362;2;2;
/org.eclipse.jdt.core.tests.model/workspace/Formatter/test133/A_out.java;1;0;1;1;0;0;0;1;0;0;1;2425;0;0;1;0;0;1;1;2425;0;2425;1;1;
/org.eclipse.jdt.core/dom/org/eclipse/jdt/core/dom/EnhancedForStatement.java;4;2;13;1;4;3;4;9;285;1;9;2867;580;580;2;0;1;9;13;5268;1;5335;12;4;
/org.eclipse.jdt.ui.tests.refactoring/resources/MoveInnerToTopLevel/test_nonstatic_36/out/Inner.java;3;0;3;1;1;1;1;2;4;1;2;305;7;7;1;0;0;2;3;305;0;5854;3;3;
/org.eclipse.compare/compare/org/eclipse/compare/internal/patch/LineReader.java;1;0;2;1;0;0;0;2;2;1;2;1289;4;4;1;0;0;2;2;1289;0;3938;2;1;
/org.eclipse.ui.ide/src/org/eclipse/ui/internal/ide/model/StandardPropertiesAdapterFactory.java;1;0;1;1;0;0;0;1;0;0;1;2264;0;0;1;0;0;1;1;2264;0;2264;1;1;
/org.eclipse.team.examples.filesystem/src/org/eclipse/team/examples/filesystem/FileSystemOperations.java;2;1;4;1;3;3;3;1;6;0;1;4368;11;11;1;0;0;1;4;4368;0;6337;4;2;
/org.eclipse.ui.workbench/Eclipse UI/org/eclipse/ui/internal/PartPane.java;7;2;43;2;13;12;13;30;121;2;27;887;921;921;2;3;1;30;43;2842;4;6338;39;7;
/org.eclipse.jdt.core.tests.model/workspace/Converter/src/test0556/A.java;1;0;1;1;1;1;1;0;0;0;0;5731;0;0;1;0;0;0;1;5731;0;5731;1;1;
/org.eclipse.jdt.ui/core refactoring/org/eclipse/jdt/internal/corext/refactoring/rename/RenameJavaProjectRefactoring.java;2;0;4;1;0;0;0;4;33;1;4;122;59;59;1;0;0;4;4;122;0;1125;4;2;
/org.eclipse.jdt.core.tests.model/workspace/Converter/test0203/Test.java;1;0;1;1;0;0;0;1;0;0;1;3714;0;0;1;0;0;1;1;3714;0;3714;1;1;
/org.eclipse.ui.workbench/Eclipse UI/org/eclipse/ui/internal/chris/roles/api/NotDefinedException.java;1;0;2;1;0;0;0;2;0;0;1;2207;0;0;2;1;0;2;2;2207;1;2207;1;1;
/org.eclipse.help.base/src/org/eclipse/help/internal/base/HelpDisplay.java;1;1;16;1;5;5;5;11;134;2;9;1776;451;451;2;2;0;11;16;1776;2;6337;14;1;
/org.eclipse.team.webdav/src/org/eclipse/team/internal/target/subscriber/ITargetOperations.java;2;0;2;1;1;1;1;1;2;0;1;4349;2;2;1;0;0;1;2;4349;0;6337;2;2;
/org.eclipse.jdt.ui.tests.refactoring/resources/Paste/testPastingTypedResources2/in/A.java;1;0;1;1;0;0;0;1;0;0;1;1646;0;0;1;0;0;1;1;1646;0;1646;1;1;
/org.eclipse.debug.ui/ui/org/eclipse/debug/internal/ui/views/variables/DefaultObjectBrowser.java;1;0;2;1;0;0;0;2;0;1;2;2564;0;0;1;0;0;2;2;2564;0;2647;2;1;
/org.eclipse.debug.ui/ui/org/eclipse/debug/internal/ui/views/console/ConsoleTerminateAction.java;1;0;1;1;0;0;0;1;0;0;1;1415;0;0;1;0;0;1;1;1415;0;1415;1;1;
/org.eclipse.jdt.core.tests.model/workspace/Converter/test0332/LocalSelectionTransfer.java;1;0;1;1;0;0;0;1;0;0;1;3714;0;0;1;0;0;1;1;3714;0;3714;1;1;
/org.eclipse.swt/Eclipse SWT/photon/org/eclipse/swt/graphics/GC.java;3;1;16;1;3;3;3;13;87;2;12;332;284;284;2;1;0;13;16;474;1;6352;15;3;
/org.eclipse.team.ui/src/org/eclipse/team/ui/sync/SyncResourceSet.java;2;0;4;1;0;0;0;4;231;1;4;595;271;271;1;0;0;4;4;595;0;1132;4;2;
/org.eclipse.ui.workbench/Eclipse UI/org/eclipse/ui/internal/commands/api/IKeySequenceBinding.java;1;0;2;1;0;0;0;2;2;0;1;2562;2;2;2;1;0;2;2;2562;1;2562;1;1;
/org.eclipse.jdt.ui/ui/org/eclipse/jdt/internal/ui/wizards/buildpaths/CPListElementSorter.java;2;0;2;1;1;1;1;1;11;0;1;5015;13;13;1;0;0;1;2;5015;0;6340;2;2;
/org.eclipse.core.resources/src/org/eclipse/core/internal/indexing/Reservation.java;1;0;1;1;1;1;1;0;31;0;0;5146;31;31;1;0;0;0;1;5146;0;5146;1;1;
/org.eclipse.jdt.ui.tests.refactoring/resources/MoveMembers/test37/out/A.java;1;0;1;1;0;0;0;1;0;0;1;2093;0;0;1;0;0;1;1;2093;0;2093;1;1;
/org.eclipse.jdt.core/model/org/eclipse/jdt/core/IClasspathContainer.java;3;1;4;1;2;2;2;2;29;1;2;2583;46;46;1;0;0;2;4;2583;0;5871;4;3;
/org.eclipse.jdt.text.tests/src/org/eclipse/jdt/ui/tests/comments/JavaDocTestCase.java;1;0;2;1;1;1;1;1;0;0;1;5082;0;0;1;0;0;1;2;5082;0;5130;2;1;
/org.eclipse.debug.ui/ui/org/eclipse/debug/internal/ui/views/variables/VariablesViewEventHandler.java;2;0;4;1;0;0;0;4;4;1;4;1986;9;9;1;0;0;4;4;1986;0;4425;4;2;
/org.eclipse.jdt.launching/launching/org/eclipse/jdt/internal/launching/ClasspathContainerSourceContainerTypeDelegate.java;2;1;6;1;2;2;2;4;17;2;3;4167;25;25;2;1;0;4;6;4949;1;5581;5;2;
/org.eclipse.jdt.core.tests.model/workspace/Converter/src/test0386/A.java;1;0;1;1;0;0;0;1;0;0;1;3714;0;0;1;0;0;1;1;3714;0;3714;1;1;
/org.eclipse.ui.workbench/Eclipse UI/org/eclipse/ui/internal/keys/NativeKeyFormatter.java;1;0;2;1;0;0;0;2;42;1;2;3310;42;42;1;0;0;2;2;3310;0;3350;2;1;
/org.eclipse.update.core/src/org/eclipse/update/internal/model/SiteLocalModel.java;2;1;10;1;4;4;4;6;66;1;6;890;111;111;1;0;0;6;10;890;0;6336;10;2;
/org.eclipse.swt/Eclipse SWT PI/photon/org/eclipse/swt/internal/photon/PhCursorInfo_t.java;1;0;2;1;0;0;0;2;14;1;2;808;15;15;1;0;0;2;2;808;0;921;2;1;
/org.eclipse.jdt.core/search/org/eclipse/jdt/internal/core/search/matching/AndPattern.java;3;1;16;2;2;2;2;14;129;2;13;751;314;314;2;1;0;14;16;3211;1;5335;15;3;
/org.eclipse.jdt.ui/ui/org/eclipse/jdt/internal/ui/reorg/DeleteSourceReferencesAction.java;1;0;1;1;0;0;0;1;0;0;1;457;0;0;1;0;0;1;1;457;0;457;1;1;
/org.eclipse.jdt.core.tests.model/workspace/Formatter/test260/A_out.java;1;0;1;1;0;0;0;1;0;0;1;2442;0;0;1;0;0;1;1;2442;0;2442;1;1;
/org.eclipse.jdt.ui/ui/org/eclipse/jdt/internal/ui/javaeditor/JavaTextSelection.java;4;0;4;1;1;1;1;3;12;1;3;3251;16;16;1;0;0;3;4;3251;0;6340;4;4;
/org.eclipse.ui.workbench/Eclipse UI/org/eclipse/ui/internal/util/StatusLineContributionItem.java;5;0;8;1;1;1;1;7;49;2;6;1722;132;132;2;1;0;7;8;2105;1;6338;7;5;
/org.eclipse.team.ui/src/org/eclipse/team/internal/ui/sync/actions/RefactorActionGroup.java;2;0;3;1;0;0;0;3;36;1;3;1876;36;36;1;0;0;3;3;1876;0;2632;3;2;
/org.eclipse.jdt.ui.tests.refactoring/resources/ExtractTemp/cannotExtract/A_testFail36.java;1;0;1;1;1;1;1;0;0;0;0;5916;0;0;1;0;0;0;1;5916;0;5916;1;1;
/org.eclipse.team.webdav/src/org/eclipse/team/internal/ui/target/AuthenticatedTargetSitePropertiesPage.java;2;1;5;1;3;3;3;2;15;1;2;2495;26;26;1;0;0;2;5;2495;0;6337;5;2;
/org.eclipse.ui.workbench/Eclipse UI/org/eclipse/ui/internal/dialogs/WelcomeEditorActionContributor.java;1;0;1;1;0;0;0;1;0;0;1;2737;0;0;1;0;0;1;1;2737;0;2737;1;1;
/org.eclipse.jdt.ui.tests.refactoring/resources/ConvertAnonymousToNested/canConvert/A_test27_in.java;1;0;1;1;0;0;0;1;0;0;1;3195;0;0;1;0;0;1;1;3195;0;3195;1;1;
/org.eclipse.jdt.core.tests.model/workspace/Resolve/src/ResolveLocalField.java;1;0;1;1;0;0;0;1;0;0;1;1970;0;0;1;0;0;1;1;1970;0;1970;1;1;
/org.eclipse.ui.intro/src/org/eclipse/ui/internal/intro/impl/model/IntroHead.java;1;1;4;1;4;4;4;0;7;0;0;5115;13;13;1;0;0;0;4;5115;0;5314;4;1;
/org.eclipse.ant.ui/Ant Editor/org/eclipse/ant/internal/ui/editor/text/NotifyingReconciler.java;1;0;3;1;1;1;1;2;7;1;2;1811;11;11;1;0;0;2;3;1811;0;6336;3;1;
/org.eclipse.update.core/src/org/eclipse/update/operations/OperationsManager.java;1;2;11;1;4;3;4;7;75;2;6;825;173;173;2;1;1;7;11;825;2;6336;9;1;
/org.eclipse.swt/Eclipse SWT/gtk1x/org/eclipse/swt/widgets/Text.java;2;0;2;1;0;0;0;2;11;1;2;110;11;11;1;0;0;2;2;110;0;2327;2;2;
/org.eclipse.jdt.core.tests.model/workspace/Formatter/test002/A_out.java;1;0;1;1;0;0;0;1;0;0;1;2425;0;0;1;0;0;1;1;2425;0;2425;1;1;
/org.eclipse.pde.core/src_OSGi/org/eclipse/pde/core/osgi/bundle/IBundlePlugin.java;2;0;2;1;0;0;0;2;0;1;2;2485;0;0;1;0;0;2;2;2485;0;4203;2;2;
/org.eclipse.ui.workbench/Eclipse UI/org/eclipse/ui/internal/contexts/api/IContextRegistry.java;1;0;3;1;0;0;0;3;2;1;3;1724;2;2;1;0;0;3;3;1724;0;2425;3;1;
/org.eclipse.jdt.core.tests.model/workspace/Converter/src/test0162/Test.java;1;0;1;1;0;0;0;1;0;0;1;3714;0;0;1;0;0;1;1;3714;0;3714;1;1;
/org.eclipse.jdt.core.tests.builder/src/org/eclipse/jdt/core/tests/builder/PackageTests.java;2;0;3;1;0;0;0;3;6;1;3;989;10;10;1;0;0;3;3;989;0;3560;3;2;
/org.eclipse.jdt.ui.tests.refactoring/test cases/org/eclipse/jdt/ui/tests/refactoring/MySetup.java;5;1;9;1;3;3;3;6;10;1;6;1642;47;47;1;0;0;6;9;1642;0;6340;9;5;
/org.eclipse.jdt.ui.tests.refactoring/resources/IntroduceFactory/Bugzilla/59283/proj1/pA/A_out.java;1;0;1;1;1;1;1;0;0;0;0;5661;0;0;1;0;0;0;1;5661;0;5661;1;1;
/org.eclipse.team.webdav/src/org/eclipse/team/internal/ui/target/subscriber/DeploymentProviderContentProvider.java;2;0;3;1;1;1;1;2;4;1;2;4311;6;6;1;0;0;2;3;4311;0;6337;3;2;
/org.eclipse.ui.externaltools/Ant Tools Support/org/eclipse/ui/externaltools/internal/ant/view/elements/AntNode.java;1;0;1;1;0;0;0;1;0;0;1;282;0;0;1;0;0;1;1;282;0;282;1;1;
/org.eclipse.jdt.core.tests.model/workspace/Converter/src/javadoc/test102/TestB2.java;1;0;1;1;0;0;0;1;0;0;1;4390;0;0;1;0;0;1;1;4390;0;4390;1;1;
/org.eclipse.jdt.core.tests.model/workspace/Converter/src/test0447/A.java;1;0;1;1;0;0;0;1;0;0;1;3714;0;0;1;0;0;1;1;3714;0;3714;1;1;
/org.eclipse.search/search/org/eclipse/search/internal/ui/text/ReplaceAction.java;2;0;5;1;1;1;1;4;277;1;4;2888;315;315;1;0;0;4;5;2888;0;6340;5;2;
/org.eclipse.jdt.debug/eval/org/eclipse/jdt/internal/debug/eval/ast/engine/InterpreterVariable.java;1;0;1;1;0;0;0;1;26;0;1;2497;26;26;1;0;0;1;1;2497;0;2497;1;1;
/org.eclipse.team.core/src/org/eclipse/team/core/subscribers/SubscriberResourceTree.java;1;0;1;1;0;0;0;1;0;0;1;3193;0;0;1;0;0;1;1;3193;0;3193;1;1;
/org.eclipse.jdt.ui/ui/org/eclipse/jdt/internal/ui/search/OccurrencesSearchResultPage.java;2;1;4;1;2;2;2;2;10;1;2;4888;18;18;1;0;0;2;4;4888;0;5528;4;2;
/org.eclipse.jdt.debug/eval/org/eclipse/jdt/internal/debug/eval/ast/engine/JavaObjectRuntimeContext.java;1;0;1;1;0;0;0;1;6;0;1;2497;6;6;1;0;0;1;1;2497;0;2497;1;1;
/org.eclipse.jdt.ui.tests.refactoring/resources/IntroduceFactory/positive/differentSigs_in.java;1;0;2;1;0;0;0;2;0;1;2;2846;0;0;1;0;0;2;2;2846;0;2862;2;1;
/org.eclipse.help/src/org/eclipse/help/internal/search/SearchQuery.java;1;0;1;1;0;0;0;1;0;0;1;2732;0;0;1;0;0;1;1;2732;0;2732;1;1;
/org.eclipse.jdt.ui/ui refactoring/org/eclipse/jdt/internal/ui/refactoring/CheckConditionsOperation.java;1;0;3;1;0;0;0;3;11;1;3;3536;17;17;1;0;0;3;3;3536;0;4575;3;1;
/org.eclipse.jdt.ui/core refactoring/org/eclipse/jdt/internal/corext/refactoring/reorg/ICreateTargetQuery.java;1;1;2;1;2;2;2;0;6;0;0;5896;6;6;1;0;0;0;2;5896;0;6013;2;1;
/org.eclipse.ui.console/src/org/eclipse/ui/internal/console/ConsoleMessages.java;1;0;1;1;0;0;0;1;0;0;1;1988;0;0;1;0;0;1;1;1988;0;1988;1;1;
/org.eclipse.jdt.core.tests.model/workspace/Formatter/test139/A_in.java;1;0;1;1;0;0;0;1;0;0;1;2425;0;0;1;0;0;1;1;2425;0;2425;1;1;
/org.eclipse.compare/compare/org/eclipse/compare/contentmergeviewer/IMergeViewerContentProvider.java;1;0;1;1;0;0;0;1;2;0;1;3935;2;2;1;0;0;1;1;3935;0;3935;1;1;
/org.eclipse.ui.workbench/Eclipse UI/org/eclipse/ui/dialogs/ResourceListSelectionDialog.java;2;0;2;1;0;0;0;2;2;1;2;1482;2;2;1;0;0;2;2;1482;0;2737;2;2;
/org.eclipse.ui.tests/Eclipse UI Tests/org/eclipse/ui/tests/navigator/ExceptionDecoratorTestCase.java;2;0;2;1;1;1;1;1;4;0;1;4238;4;4;1;0;0;1;2;4238;0;6077;2;2;
/org.eclipse.team.ui/src/org/eclipse/team/internal/ui/target/ExportTargetSiteMainPage.java;2;0;3;1;0;0;0;3;2;1;3;990;4;4;1;0;0;3;3;990;0;2495;3;2;
/org.eclipse.update.ui/src/org/eclipse/update/internal/ui/PatchCleaner.java;1;0;1;1;0;0;0;1;0;0;1;755;0;0;1;0;0;1;1;755;0;755;1;1;
/org.eclipse.debug.ui/ui/org/eclipse/debug/ui/actions/ILaunchable.java;1;0;1;1;1;1;1;0;0;0;0;5496;0;0;1;0;0;0;1;5496;0;5496;1;1;
/org.eclipse.ui.tutorials.rcp.part3/src/org/eclipse/ui/tutorials/rcp/part3/RcpWorkbenchAdvisor.java;1;1;3;1;3;3;3;0;214;0;0;5118;220;220;1;0;0;0;3;5118;0;5853;3;1;
/org.eclipse.jdt.ui.examples.javafamily/src/org/eclipse/jsp/JspTranslator.java;3;0;12;2;1;1;1;11;102;2;10;1033;361;361;2;1;0;11;12;1210;1;5122;11;3;
/org.eclipse.swt/Eclipse SWT PI/win32/org/eclipse/swt/internal/win32/NMREBARCHEVRON.java;1;0;1;1;0;0;0;1;11;0;1;2915;11;11;1;0;0;1;1;2915;0;2915;1;1;
/org.eclipse.jdt.ui.tests.refactoring/test cases/org/eclipse/jdt/ui/tests/nls/NlsRefactoringCheckFinalConditionsTest.java;3;1;8;1;7;7;7;1;322;0;1;4930;376;376;1;0;0;1;8;4930;0;6340;8;3;
/org.eclipse.swt.graphics.text/Eclipse SWT PI/win32/org/eclipse/swt/internal/win32/SCRIPT_ITEM.java;1;0;1;1;0;0;0;1;0;0;1;2985;0;0;1;0;0;1;1;2985;0;2985;1;1;
/org.eclipse.jdt.ui/ui refactoring/org/eclipse/jdt/internal/ui/refactoring/IChangeElementChildrenCreator.java;1;0;3;1;0;0;0;3;4;1;3;3930;6;6;1;0;0;3;3;3930;0;4965;3;1;
/org.eclipse.search/search/org/eclipse/search/internal/ui/text/SearchAgainConfirmationDialog.java;2;0;4;1;1;1;1;3;16;1;3;2907;34;34;1;0;0;3;4;2907;0;6340;4;2;
/org.eclipse.jdt.core.tests.model/workspace/Converter/junit/swingui/TestRunContext.java;1;0;1;1;0;0;0;1;0;0;1;3714;0;0;1;0;0;1;1;3714;0;3714;1;1;
/org.eclipse.swt/Eclipse SWT/win32/org/eclipse/swt/widgets/Caret.java;3;1;6;1;2;2;2;4;17;2;3;268;36;36;2;1;0;4;6;4421;1;6352;5;3;
/org.eclipse.ui.workbench/Eclipse UI/org/eclipse/ui/progress/ProgressUtil.java;1;0;2;1;0;0;0;2;0;0;1;2842;0;0;2;1;0;2;2;2842;1;2842;1;1;
/org.eclipse.webdav/src/kernel/org/eclipse/webdav/internal/kernel/StateToken.java;1;0;2;1;2;1;2;0;29;0;0;5151;29;29;2;0;1;0;2;5151;1;5151;1;1;
/org.eclipse.swt/Eclipse SWT PI/carbon/org/eclipse/swt/internal/carbon/CFRange.java;1;2;3;1;3;2;3;0;16;0;0;5534;20;20;2;0;1;0;3;5534;1;5614;2;1;
/org.eclipse.jdt.core.tests.model/workspace/Formatter/test160/A_in.java;1;0;1;1;0;0;0;1;0;0;1;2425;0;0;1;0;0;1;1;2425;0;2425;1;1;
/org.eclipse.releng.eclipsebuilder/plugins/org.eclipse.build.extra.tools/src/org/eclipse/releng/FetchValidator.java;1;0;1;1;0;0;0;1;0;0;1;991;0;0;1;0;0;1;1;991;0;991;1;1;
/org.eclipse.ui.editors/src/org/eclipse/ui/internal/editors/quickdiff/QuickDiffTestPlugin.java;1;0;2;1;0;0;0;2;0;1;2;1118;0;0;1;0;0;2;2;1118;0;1214;2;1;
/org.eclipse.swt/Eclipse SWT Drag and Drop/win32/org/eclipse/swt/dnd/Transfer.java;1;0;1;1;0;0;0;1;8;0;1;307;8;8;1;0;0;1;1;307;0;307;1;1;
/org.eclipse.team.webdav/src/org/eclipse/team/internal/core/target/ITeamStatusConstants.java;1;0;1;1;0;0;0;1;0;0;1;2495;0;0;1;0;0;1;1;2495;0;2495;1;1;
/org.eclipse.jdt.core/dom/org/eclipse/jdt/core/dom/DOMParser.java;3;0;4;2;0;0;0;4;8;3;2;3762;8;8;3;2;0;4;4;3762;2;3861;2;3;
/org.eclipse.ui.ide/src/org/eclipse/ui/internal/actions/ProjectPropertyDialogAction.java;2;0;8;1;0;0;0;8;79;2;7;1520;143;143;2;1;0;8;8;1520;1;2263;7;2;
/org.eclipse.jdt.core.tests.model/workspace/Converter/src/test0300/Test.java;1;0;1;1;0;0;0;1;0;0;1;3714;0;0;1;0;0;1;1;3714;0;3714;1;1;
/org.eclipse.swt/Eclipse SWT PI/motif/org/eclipse/swt/internal/motif/XFocusChangeEvent.java;1;0;2;1;0;0;0;2;7;1;2;825;12;12;1;0;0;2;2;825;0;868;2;1;
/org.eclipse.help/src/org/eclipse/help/internal/protocols/PluginURL.java;1;0;3;1;0;0;0;3;11;1;3;105;22;22;1;0;0;3;3;105;0;1010;3;1;
/org.eclipse.jdt.junit/src/org/eclipse/jdt/internal/junit/ui/TestRunInfo.java;2;0;3;1;1;1;1;2;29;1;2;498;57;57;1;0;0;2;3;498;0;6340;3;2;
/org.eclipse.team.ui/org.eclipse.jdt.ui.team/src/org/eclipse/jdt/ui/team/JavaSyncInfoDiffNode.java;1;0;1;1;0;0;0;1;0;0;1;3734;0;0;1;0;0;1;1;3734;0;3734;1;1;
/org.eclipse.debug.ui/ui/org/eclipse/debug/internal/ui/launchConfigurations/LaunchGroupFilter.java;2;0;2;2;2;1;2;0;10;0;0;5206;10;10;2;0;1;0;2;5206;1;5206;1;2;
/org.eclipse.swt/Eclipse SWT Browser/common/org/eclipse/swt/browser/VisibilityEvent.java;1;0;3;1;0;0;0;3;13;1;3;2849;13;13;1;0;0;3;3;2849;0;3166;3;1;
/org.eclipse.jdt.ui/core refactoring/org/eclipse/jdt/internal/corext/refactoring/reorg2/DeleteAction2.java;1;0;3;1;0;0;0;3;10;2;2;444;10;10;2;1;0;3;3;456;1;456;2;1;
/org.eclipse.core.resources/src/org/eclipse/core/internal/properties/PropertyManager.java;2;0;5;1;1;1;1;4;354;1;4;93;431;431;1;0;0;4;5;93;0;5146;5;2;
/org.eclipse.jdt.ui/ui/org/eclipse/jdt/internal/ui/text/JavaIndenter.java;3;1;25;2;2;2;2;23;1209;5;17;1968;2462;2462;5;6;0;23;25;1968;6;6340;19;3;
/org.eclipse.ui.workbench/Eclipse UI/org/eclipse/ui/IPerspectiveListener.java;1;0;1;1;0;0;0;1;4;0;1;1;4;4;1;0;0;1;1;1;0;1;1;1;
/org.eclipse.osgi/defaultAdaptor/src/org/eclipse/osgi/framework/internal/defaultadaptor/DefaultAdaptor.java;6;2;31;2;8;7;8;23;572;2;19;3013;1504;1504;2;4;1;23;31;4238;5;6098;26;6;
/org.eclipse.team.core/src/org/eclipse/team/core/sync/LocalSyncElement.java;1;0;2;1;0;0;0;2;10;1;2;790;10;10;1;0;0;2;2;790;0;4217;2;1;
/org.eclipse.jdt.core.tests.compiler/src/org/eclipse/jdt/core/tests/runtime/SideCarJ9VMLauncher.java;2;0;2;1;0;0;0;2;2;1;2;1417;2;2;1;0;0;2;2;1417;0;3560;2;2;
/org.eclipse.jdt.ui/ui/org/eclipse/jdt/ui/search/QuerySpecification.java;3;1;4;1;4;4;4;0;10;0;0;5398;20;20;1;0;0;0;4;5398;0;6334;4;3;
/org.eclipse.ui.editors/src/org/eclipse/ui/editors/text/templates/ContributionContextTypeRegistry.java;2;2;3;1;3;2;3;0;14;0;0;5360;14;14;2;0;1;0;3;6334;1;6334;2;2;
/org.eclipse.jdt.core.tests.model/workspace/Converter/test0433/A.java;1;0;1;1;0;0;0;1;0;0;1;3714;0;0;1;0;0;1;1;3714;0;3714;1;1;
/org.eclipse.osgi/eclipseAdaptor/src/org/eclipse/core/runtime/adaptor/Locker.java;2;1;3;1;2;2;2;1;3;0;1;4854;4;4;1;0;0;1;3;4854;0;6133;3;2;
/org.eclipse.swt.tests/JUnit Tests/org/eclipse/swt/tests/junit/Test_org_eclipse_swt_events_TreeEvent.java;1;0;2;1;1;1;1;1;7;0;1;3444;11;11;1;0;0;1;2;3444;0;6352;2;1;
/org.eclipse.ui.workbench.texteditor/src/org/eclipse/ui/texteditor/quickdiff/QuickDiffToggleAction.java;2;2;5;1;4;3;4;1;6;0;1;1644;15;15;2;0;1;1;5;5612;1;6340;4;2;
/org.eclipse.jdt.ui/core extension/org/eclipse/text/edits/InsertEdit.java;1;0;5;1;0;0;0;5;41;2;3;1953;51;51;2;2;0;5;5;1953;2;1985;3;1;
/org.eclipse.core.runtime/src/org/eclipse/core/internal/content/XMLRootHandler.java;1;1;6;1;6;6;6;0;72;0;0;5194;157;157;1;0;0;0;6;5194;0;6017;6;1;
/org.eclipse.jdt.core.tests.builder/src/org/eclipse/jdt/core/tests/builder/MultiProjectTests.java;4;1;10;1;4;4;4;6;67;1;6;557;234;234;1;0;0;6;10;557;0;6141;10;4;
/org.eclipse.jdt.core/search/org/eclipse/jdt/internal/core/search/matching/ClasspathSourceDirectory.java;3;0;5;1;0;0;0;5;27;1;5;1827;37;37;1;0;0;5;5;1827;0;4731;5;3;
/org.eclipse.jdt.core.tests.model/workspace/Converter/test0352/Test2.java;1;0;1;1;0;0;0;1;0;0;1;3714;0;0;1;0;0;1;1;3714;0;3714;1;1;
/org.eclipse.ui.tests/Eclipse UI Tests/org/eclipse/ui/tests/api/IEditorActionDelegateTest.java;1;0;1;1;0;0;0;1;3;0;1;2738;3;3;1;0;0;1;1;2738;0;2738;1;1;
/org.eclipse.jdt.core.tests.model/workspace/Converter/src/test0128/Test.java;1;0;1;1;0;0;0;1;0;0;1;3714;0;0;1;0;0;1;1;3714;0;3714;1;1;
/org.eclipse.ui.workbench.texteditor/src/org/eclipse/ui/texteditor/IFindReplaceTargetExtension2.java;2;0;2;2;2;1;2;0;8;0;0;6334;8;8;2;0;1;0;2;6334;1;6334;1;2;
/org.eclipse.ltk.ui.refactoring/src/org/eclipse/ltk/internal/ui/refactoring/RefactoringWizardDialog.java;1;1;5;1;3;3;3;2;12;1;2;5052;21;21;1;0;0;2;5;5052;0;6340;5;1;
/org.eclipse.jdt.core.tests.model/workspace/Converter/src/test0378/A.java;1;0;1;1;0;0;0;1;0;0;1;3714;0;0;1;0;0;1;1;3714;0;3714;1;1;
/org.eclipse.pde.core/srcnew/org/eclipse/pde/internal/core/plugin/DocumentModelChangeEvent.java;1;0;1;1;1;1;1;0;0;0;0;5431;0;0;1;0;0;0;1;5431;0;5431;1;1;
/org.eclipse.update.core/src/org/eclipse/update/core/IVerificationResult.java;2;1;3;1;2;2;2;1;6;0;1;0;11;11;1;0;0;1;3;0;0;6336;3;2;
/org.eclipse.ui.externaltools/External Tools Base/org/eclipse/ui/externaltools/internal/variable/BuildTypeExpander.java;1;0;1;1;0;0;0;1;0;0;1;321;0;0;1;0;0;1;1;321;0;321;1;1;
/org.eclipse.jdt.core.tests.builder/src/org/eclipse/jdt/core/tests/builder/AbstractMethodTests.java;4;0;6;2;0;0;0;6;94;2;5;989;109;109;2;1;0;6;6;1843;1;4041;5;4;
/org.eclipse.jdt.core/dom/org/eclipse/jdt/internal/core/dom/rewrite/ASTRewriteAnalyzer.java;2;1;5;1;2;2;2;3;291;1;3;4802;401;401;1;0;0;3;5;4802;0;5510;5;2;
/org.eclipse.jdt.core.tests.compiler/src/org/eclipse/jdt/core/tests/compiler/parser/CompletionParserTest.java;3;0;6;2;0;0;0;6;76;2;5;876;134;134;2;1;0;6;6;989;1;3560;5;3;
/org.eclipse.pde.ui/src_Forms/org/eclipse/pde/internal/ui/neweditor/build/BinSection.java;2;1;4;1;2;2;2;2;24;1;2;4406;30;30;1;0;0;2;4;4406;0;5431;4;2;
/org.eclipse.ui.workbench/Eclipse UI/org/eclipse/ui/internal/commands/IMutableRegistry.java;1;0;3;1;0;0;0;3;14;2;2;1356;14;14;2;1;0;3;3;1389;1;1389;2;1;
/org.eclipse.jdt.core/compiler/org/eclipse/jdt/internal/compiler/parser/SourceTypeConverter.java;3;0;8;1;0;0;0;8;102;1;8;69;179;179;1;0;0;8;8;69;0;4461;8;3;
/org.eclipse.jdt.core/model/org/eclipse/jdt/core/IInitializer.java;1;0;2;1;0;0;0;2;2;1;2;1790;3;3;1;0;0;2;2;1790;0;3560;2;1;
/org.eclipse.jdt.core/compiler/org/eclipse/jdt/internal/compiler/impl/IntConstant.java;2;0;3;1;1;1;1;2;8;1;2;1111;16;16;1;0;0;2;3;1111;0;5587;3;2;
/org.eclipse.core.tests.resources/src/org/eclipse/core/tests/internal/watson/PhantomComparator.java;1;0;2;1;2;1;2;0;120;0;0;5147;120;120;2;0;1;0;2;5147;1;5147;1;1;
/org.eclipse.ui.views/src/org/eclipse/ui/views/internal/markers/MarkerFilter.java;1;0;5;1;0;0;0;5;279;2;3;265;397;397;2;2;0;5;5;265;2;750;3;1;
/org.eclipse.jdt.ui.tests.refactoring/test cases/org/eclipse/jdt/ui/tests/nls/NlsRefactoringTestHelper.java;3;1;4;1;3;3;3;1;10;0;1;4930;21;21;1;0;0;1;4;4930;0;6340;4;3;
/org.eclipse.ui.workbench/Eclipse UI/org/eclipse/ui/internal/commands/registry/AbstractRegistry.java;1;0;5;1;0;0;0;5;99;2;4;1077;136;136;2;1;0;5;5;1396;1;1396;4;1;
/org.eclipse.team.ui/src/org/eclipse/team/internal/ui/synchronize/ReferenceCounter.java;1;0;3;1;1;1;1;2;140;1;2;4785;142;142;1;0;0;2;3;4785;0;6337;3;1;
/org.eclipse.jdt.core.tests.model/workspace/Formatter/test283/A_in.java;1;0;1;1;0;0;0;1;0;0;1;2443;0;0;1;0;0;1;1;2443;0;2443;1;1;
/org.eclipse.ui.views/src/org/eclipse/ui/views/tasklist/TaskList.java;1;0;1;1;0;0;0;1;0;0;1;2738;0;0;1;0;0;1;1;2738;0;2738;1;1;
/org.eclipse.jdt.ui/core refactoring/org/eclipse/jdt/internal/corext/refactoring/participants/xml/TypeExtenderDescriptor.java;1;0;4;1;0;0;0;4;12;1;4;2204;22;22;1;0;0;4;4;2204;0;4091;4;1;
/org.eclipse.jdt.ui/ui/org/eclipse/jdt/internal/ui/wizards/buildpaths/ArchiveFileFilter.java;2;1;2;1;2;2;2;0;9;0;0;5132;11;11;1;0;0;0;2;5132;0;6340;2;2;
/org.eclipse.team.ui/src/org/eclipse/team/ui/synchronize/TeamSubscriberParticipantPage.java;1;0;10;1;0;0;0;10;568;2;9;2590;630;630;2;1;0;10;10;2648;1;4216;9;1;
/org.eclipse.jdt.core.tests.model/src/org/eclipse/jdt/core/tests/rewrite/describing/ASTRewritingExpressionsTest.java;5;1;7;1;5;5;5;2;206;1;2;4711;493;493;1;0;0;2;7;4711;0;6336;7;5;
/org.eclipse.update.ui/srcnew/org/eclipse/update/internal/ui/UpdateAdapterFactory.java;2;0;2;1;0;0;0;2;0;1;2;755;0;0;1;0;0;2;2;755;0;794;2;2;
/org.eclipse.jdt.ui/ui/org/eclipse/jdt/internal/ui/text/correction/JavaCorrectionAssistant.java;2;1;9;1;2;2;2;7;75;2;6;974;156;156;2;1;0;7;9;1112;1;6340;8;2;
/org.eclipse.jdt.debug.ui/ui/org/eclipse/jdt/internal/debug/ui/classpath/VariableClasspathEntryAdapterFactory.java;1;0;1;1;0;0;0;1;0;0;1;4973;0;0;1;0;0;1;1;4973;0;4973;1;1;
/org.eclipse.ui.ide/src/org/eclipse/ui/internal/ide/dialogs/RemoveCapabilityStep.java;1;0;1;1;0;0;0;1;0;0;1;2264;0;0;1;0;0;1;1;2264;0;2264;1;1;
/org.eclipse.swt.tests/JUnit Tests/org/eclipse/swt/tests/junit/Test_org_eclipse_swt_dnd_FileTransfer.java;1;0;1;1;0;0;0;1;11;0;1;2176;11;11;1;0;0;1;1;2176;0;2176;1;1;
/org.eclipse.pde.runtime/src/org/eclipse/pde/internal/runtime/registry/RegistrySearchDialog.java;1;0;3;1;0;0;0;3;15;1;3;3933;15;15;1;0;0;3;3;3933;0;4090;3;1;
/org.eclipse.core.resources/src/org/eclipse/core/internal/properties/TestingSupport.java;1;0;1;1;1;1;1;0;26;0;0;5146;26;26;1;0;0;0;1;5146;0;5146;1;1;
/org.eclipse.ant.ui/Ant Editor/org/eclipse/ant/ui/internal/editor/derived/SubstitutionTextReader.java;1;0;2;1;0;0;0;2;0;1;2;250;0;0;1;0;0;2;2;250;0;1811;2;1;
/org.eclipse.team.cvs.core/src/org/eclipse/team/internal/ccvs/core/subscribers/CVSSyncTreeSubscriber.java;1;0;1;1;0;0;0;1;0;0;1;1427;0;0;1;0;0;1;1;1427;0;1427;1;1;
/org.eclipse.jdt.ui/ui/org/eclipse/jdt/internal/ui/text/correction/IAssistContext.java;1;0;3;1;0;0;0;3;20;1;3;1011;20;20;1;0;0;3;3;1011;0;1232;3;1;
/org.eclipse.help.base/src/org/eclipse/help/internal/browser/CustomBrowserFactory.java;1;1;3;1;2;2;2;1;6;0;1;1740;12;12;1;0;0;1;3;1740;0;6337;3;1;
/org.eclipse.jdt.ui/core extension/org/eclipse/jdt/internal/corext/callhierarchy/JavaImplementorFinder.java;2;0;3;1;1;1;1;2;5;1;2;155;7;7;1;0;0;2;3;155;0;6340;3;2;
/org.eclipse.core.tools/src/org/eclipse/core/tools/AbstractCopySelectionAction.java;1;0;1;1;1;1;1;0;0;0;0;6302;0;0;1;0;0;0;1;6302;0;6302;1;1;
/org.eclipse.compare.examples.xml/src/org/eclipse/compare/examples/xml/OrderedMatching.java;1;0;3;1;0;0;0;3;186;1;3;1106;188;188;1;0;0;3;3;1106;0;3938;3;1;
/org.eclipse.team.cvs.ui/src/org/eclipse/team/internal/ccvs/ui/sync/MergeAction.java;1;0;1;1;0;0;0;1;0;0;1;4217;0;0;1;0;0;1;1;4217;0;4217;1;1;
/org.eclipse.ant.ui/Ant Editor/org/eclipse/ant/internal/ui/editor/formatter/XmlDocumentFormatter.java;1;1;7;1;6;6;6;1;319;0;1;4583;551;551;1;0;0;1;7;4583;0;5901;7;1;
/org.eclipse.jdt.core.tests.model/workspace/Formatter/test135/A_in.java;1;0;1;1;0;0;0;1;0;0;1;2424;0;0;1;0;0;1;1;2424;0;2424;1;1;
/org.eclipse.pde.ui/src_Forms/org/eclipse/pde/internal/ui/neweditor/schema/SchemaInputContextManager.java;2;0;2;1;1;1;1;1;0;0;1;4856;0;0;1;0;0;1;2;4856;0;5431;2;2;
/org.eclipse.team.core/src/org/eclipse/team/core/subscribers/ISubscriberChangeEvent.java;2;1;5;1;3;3;3;2;39;1;2;3966;83;83;1;0;0;2;5;3966;0;6336;5;2;
/org.eclipse.team.webdav/src/org/eclipse/team/internal/core/target/XMLMemento.java;2;1;3;1;2;2;2;1;2;0;1;4633;3;3;1;0;0;1;3;4633;0;6337;3;2;
/org.eclipse.jdt.junit/src/org/eclipse/jdt/internal/junit/ui/HierarchyRunView.java;2;0;13;1;1;1;1;12;240;2;10;185;482;482;2;2;0;12;13;417;2;5633;11;2;
/org.eclipse.osgi/core/framework/org/eclipse/osgi/framework/internal/core/SystemBundle.java;4;2;12;1;6;5;6;6;499;1;6;3013;604;604;2;0;1;6;12;5116;1;6337;11;4;
/org.eclipse.jdt.core/formatter/org/eclipse/jdt/core/formatter/DefaultCodeFormatterConstants.java;3;3;37;3;6;4;6;31;2071;3;23;2178;4414;4414;3;8;2;31;37;2199;10;6140;27;3;
/org.eclipse.update.ui.forms/Eclipse Forms/org/eclipse/ui/forms/editor/IFormPage.java;1;0;5;1;0;0;0;5;40;1;5;3179;51;51;1;0;0;5;5;3179;0;4157;5;1;
/org.eclipse.help.base/src/org/eclipse/help/standalone/Infocenter.java;1;1;4;1;3;3;3;1;124;0;1;1740;145;145;1;0;0;1;4;1740;0;6337;4;1;
/org.eclipse.team.cvs.ui/src/org/eclipse/team/internal/ccvs/ui/operations/OverrideAndUpdateOperation.java;2;1;5;1;3;3;3;2;8;1;2;3113;22;22;1;0;0;2;5;3113;0;6337;5;2;
/org.eclipse.ui.tests/Eclipse UI Tests/org/eclipse/ui/tests/multipageeditor/TestKeyBindingMultiPageEditorPart.java;3;1;4;1;2;2;2;2;20;1;2;4218;26;26;1;0;0;2;4;4218;0;6338;4;3;
/org.eclipse.debug.core/core/org/eclipse/debug/core/model/IDebugModelProvider.java;2;0;3;1;1;1;1;2;18;1;2;3963;21;21;1;0;0;2;3;3963;0;5108;3;2;
/org.eclipse.jdt.ui.tests.refactoring/resources/ExtractMethodWorkSpace/ExtractMethodTests/branch_out/A_test751.java;1;0;4;1;0;0;0;4;6;1;4;844;6;6;1;0;0;4;4;844;0;2256;4;1;
/org.eclipse.pde.ui/sandbox/org/eclipse/pde/internal/ui/editor/standalone/text/PartiallySynchronizedDocument.java;1;0;2;1;0;0;0;2;0;1;2;2320;0;0;1;0;0;2;2;2320;0;2906;2;1;
/org.eclipse.core.runtime/src/org/eclipse/core/internal/dependencies/ISelectionPolicy.java;2;0;2;1;0;0;0;2;0;1;2;2105;0;0;1;0;0;2;2;2105;0;3013;2;2;
/org.eclipse.help.ide/src/org/eclipse/help/ui/internal/search/SorterByScore.java;1;1;2;1;2;2;2;0;2;0;0;5216;2;2;1;0;0;0;2;5216;0;5827;2;1;
/org.eclipse.ui.workbench/Eclipse UI/org/eclipse/ui/internal/activities/ActivityRequirementBinding.java;2;1;2;1;2;2;2;0;2;0;0;5760;2;2;1;0;0;0;2;5760;0;6338;2;2;
/org.eclipse.jdt.ui.tests.refactoring/resources/DeleteSourceReferenceEdit/A_testField4_out.java;1;0;1;1;0;0;0;1;0;0;1;1652;0;0;1;0;0;1;1;1652;0;1652;1;1;
/org.eclipse.swt/Eclipse SWT/common/org/eclipse/swt/internal/image/LEDataOutputStream.java;1;0;1;1;0;0;0;1;12;0;1;125;12;12;1;0;0;1;1;125;0;125;1;1;
/org.eclipse.jdt.core/model/org/eclipse/jdt/core/IBufferChangedListener.java;1;0;1;1;0;0;0;1;2;0;1;3560;2;2;1;0;0;1;1;3560;0;3560;1;1;
/org.eclipse.jdt.ui.tests.refactoring/resources/RenamePackage/testImportFromMultiRoots2/in/srcTest/p/p/ATest.java;1;0;2;1;0;0;0;2;12;1;2;3219;12;12;1;0;0;2;2;3219;0;4105;2;1;
/org.eclipse.jdt.ui.tests.refactoring/resources/PullUp/testEnablement0/in/A.java;1;0;1;1;0;0;0;1;0;0;1;1312;0;0;1;0;0;1;1;1312;0;1312;1;1;
/org.eclipse.ui.views/src/org/eclipse/ui/views/navigator/ResourceNavigatorMessages.java;1;0;1;1;0;0;0;1;0;0;1;2738;0;0;1;0;0;1;1;2738;0;2738;1;1;
/org.eclipse.jdt.core.tests.model/src/org/eclipse/jdt/core/tests/model/CreateMembersTests.java;1;0;1;1;0;0;0;1;2;0;1;3560;2;2;1;0;0;1;1;3560;0;3560;1;1;
/org.eclipse.jdt.core.tests.model/workspace/Formatter/test424/A_out.java;1;0;1;1;0;0;0;1;0;0;1;3478;0;0;1;0;0;1;1;3478;0;3478;1;1;
/org.eclipse.debug.ui/ui/org/eclipse/debug/internal/ui/launchConfigurations/LaunchConfigurationsDialog.java;5;1;28;2;7;7;7;21;136;2;19;309;784;784;2;2;0;21;28;1657;2;5466;26;5;
/org.eclipse.jdt.ui/core refactoring/org/eclipse/jdt/internal/corext/refactoring/code/flow/ThrowFlowInfo.java;1;0;1;1;1;1;1;0;2;0;0;6340;2;2;1;0;0;0;1;6340;0;6340;1;1;
/org.eclipse.osgi/eclipseAdaptor/src/org/eclipse/core/runtime/adaptor/PluginConverterImpl.java;7;3;64;3;26;20;26;38;247;2;31;3134;1655;1655;3;7;6;38;64;5246;13;6145;51;7;
/org.eclipse.team.core/src/org/eclipse/team/core/variants/IResourceVariantComparator.java;2;1;3;1;2;2;2;1;2;0;1;4349;4;4;1;0;0;1;3;4349;0;6336;3;2;
/org.eclipse.pde.ui/src_Forms/org/eclipse/pde/internal/ui/neweditor/site/SiteFeatureAdapter.java;2;0;2;1;1;1;1;1;0;0;1;4832;0;0;1;0;0;1;2;4832;0;5431;2;2;
/org.eclipse.swt/Eclipse SWT/gtk/org/eclipse/swt/widgets/TableItem.java;7;1;28;1;5;5;5;23;139;2;21;269;672;672;2;2;0;23;28;1238;2;6352;26;7;
/org.eclipse.swt/Eclipse SWT/win32/org/eclipse/swt/widgets/Tracker.java;5;1;24;2;2;2;2;22;399;2;17;109;691;691;2;5;0;22;24;109;5;6352;19;5;
/org.eclipse.ui.ide/src/org/eclipse/ui/internal/model/WorkbenchRootResource.java;2;0;3;1;0;0;0;3;4;1;3;1511;4;4;1;0;0;3;3;1511;0;2263;3;2;
/org.eclipse.ui.workbench/Eclipse UI/org/eclipse/ui/internal/activities/service/ActivityServiceEvent.java;1;0;2;1;0;0;0;2;0;1;2;2444;0;0;1;0;0;2;2;2444;0;2491;2;1;
/org.eclipse.osgi/osgi/src/org/osgi/framework/BundleException.java;3;1;5;1;4;4;4;1;60;0;1;3013;104;104;1;0;0;1;5;3013;0;5646;5;3;
/org.eclipse.pde.ui/src/org/eclipse/pde/internal/ui/wizards/tools/PluginToBundleWizard.java;1;0;2;1;0;0;0;2;0;1;2;3840;0;0;1;0;0;2;2;3840;0;4139;2;1;
/org.eclipse.team.ui/src/org/eclipse/team/internal/ui/wizards/ConfigureProjectWizard.java;2;1;11;1;6;6;6;5;236;2;4;987;327;327;2;1;0;5;11;987;1;6337;10;2;
/org.eclipse.ui.workbench/Eclipse UI/org/eclipse/ui/model/IWorkbenchAdapter2.java;1;0;2;1;0;0;0;2;14;1;2;4083;14;14;1;0;0;2;2;4083;0;4235;2;1;
/org.eclipse.jdt.ui.examples.javafamily/src/org/eclipse/core/indexsearch/SearchEngine.java;2;0;4;1;1;1;1;3;199;1;3;1033;208;208;1;0;0;3;4;1033;0;5607;4;2;
/org.eclipse.swt.tools/JNI Generation/org/eclipse/swt/tools/internal/MetaData.java;2;0;2;1;0;0;0;2;3;1;2;4175;3;3;1;0;0;2;2;4175;0;4269;2;2;
/org.eclipse.ui.intro/src/org/eclipse/ui/internal/intro/impl/model/IntroPartPresentation.java;2;2;17;1;17;15;17;0;96;0;0;5115;451;451;2;0;2;0;17;5314;2;6251;15;2;
/org.eclipse.jdt.core.tests.model/workspace/Converter/src/test0497/A.java;1;0;1;1;0;0;0;1;0;0;1;3714;0;0;1;0;0;1;1;3714;0;3714;1;1;
/org.eclipse.swt.tests/JUnit Tests/org/eclipse/swt/tests/junit/Test_org_eclipse_swt_browser_Browser.java;2;0;12;1;1;1;1;11;81;2;9;2104;431;431;2;2;0;11;12;2104;2;6352;10;2;
/org.eclipse.ui.workbench/Eclipse UI/org/eclipse/ui/internal/themes/WorkbenchThemeManager.java;2;1;13;1;3;3;3;10;228;1;10;3684;505;505;1;0;0;10;13;3684;0;5785;13;2;
/org.eclipse.jdt.ui/ui/org/eclipse/jdt/internal/ui/callhierarchy/OpenCallHierarchyAction.java;4;1;6;1;2;2;2;4;36;1;4;237;71;71;1;0;0;4;6;237;0;6340;6;4;
/org.eclipse.jdt.core.tests.compiler/src/org/eclipse/jdt/core/tests/compiler/regression/LogRequestor.java;1;0;1;1;0;0;0;1;0;0;1;1129;0;0;1;0;0;1;1;1129;0;1129;1;1;
/org.eclipse.team.core/src/org/eclipse/team/core/sync/RemoteContentsCacheEntry.java;2;0;3;1;0;0;0;3;12;1;3;3150;12;12;1;0;0;3;3;3150;0;4217;3;2;
/org.eclipse.jdt.core.tests.model/workspace/Converter/test0258/Test.java;1;0;1;1;0;0;0;1;0;0;1;3714;0;0;1;0;0;1;1;3714;0;3714;1;1;
/org.eclipse.ui.workbench/Eclipse UI/org/eclipse/ui/internal/dialogs/WelcomeEditorInput.java;1;0;1;1;0;0;0;1;0;0;1;2737;0;0;1;0;0;1;1;2737;0;2737;1;1;
/org.eclipse.ui.workbench/Eclipse UI/org/eclipse/ui/actions/OpenPerspectiveMenu.java;2;1;3;1;3;3;3;0;17;0;0;5319;28;28;1;0;0;0;3;5319;0;6338;3;2;
/org.eclipse.ant.tests.ui/Ant Editor Tests/org/eclipse/ui/externaltools/internal/ant/editor/support/TestUtils.java;1;0;2;1;0;0;0;2;6;1;2;283;6;6;1;0;0;2;2;283;0;1274;2;1;
/org.eclipse.swt/Eclipse SWT AWT/emulated/org/eclipse/swt/internal/awt/SWT_AWT.java;1;0;2;1;0;0;0;2;0;1;2;1651;0;0;1;0;0;2;2;1651;0;3013;2;1;
/org.eclipse.team.webdav/src/org/eclipse/team/core/target/TargetRefreshOperation.java;1;0;1;1;0;0;0;1;0;0;1;3477;0;0;1;0;0;1;1;3477;0;3477;1;1;
/org.eclipse.jdt.core/search/org/eclipse/jdt/internal/core/index/impl/SimpleIndexBlock.java;2;0;3;1;0;0;0;3;54;1;3;61;56;56;1;0;0;3;3;61;0;4060;3;2;
/org.eclipse.ui.workbench/Eclipse UI/org/eclipse/ui/roles/IRoleManagerEvent.java;1;0;6;1;0;0;0;6;24;1;6;1952;37;37;1;0;0;6;6;1952;0;2805;6;1;
/org.eclipse.update.core/srcnew/org/eclipse/update/internal/operations/OperationsManager.java;1;0;25;1;0;0;0;25;359;6;13;367;1546;1546;6;12;0;25;25;515;12;616;13;1;
/org.eclipse.team.cvs.ui/src/org/eclipse/team/internal/ccvs/ui/wizards/SharingWizardTreeAdviser.java;1;0;2;1;1;1;1;1;0;0;1;4699;0;0;1;0;0;1;2;4699;0;5359;2;1;
/org.eclipse.ui.ide/src/org/eclipse/ui/internal/dialogs/WorkbenchWizardNode.java;2;0;3;1;0;0;0;3;8;1;3;1526;8;8;1;0;0;3;3;1526;0;2263;3;2;
/org.eclipse.ui.workbench/Eclipse UI/org/eclipse/ui/internal/csm/commands/CommandManager.java;1;0;7;1;0;0;0;7;358;5;3;2515;421;421;5;4;0;7;7;2549;4;2549;3;1;
/org.eclipse.jdt.ui.tests.refactoring/resources/Delete/testDeleteWithinCu7/out/A.java;1;0;1;1;0;0;0;1;0;0;1;442;0;0;1;0;0;1;1;442;0;442;1;1;
/org.eclipse.jdt.junit/src/org/eclipse/jdt/internal/junit/ui/CounterPanel.java;2;1;4;1;2;2;2;2;8;1;2;1127;16;16;1;0;0;2;4;1127;0;6340;4;2;
/org.eclipse.releng.basebuilder/plugins/org.eclipse.build.tools/org.eclipse.build.tools/src/org/eclipse/releng/CvsDiffParser.java;1;0;1;1;1;1;1;0;0;0;0;5735;0;0;1;0;0;0;1;5735;0;5735;1;1;
/org.eclipse.jdt.debug/model/org/eclipse/jdt/internal/debug/core/model/JDIModificationVariable.java;3;1;5;1;2;2;2;3;28;1;3;363;67;67;1;0;0;3;5;363;0;5757;5;3;
/org.eclipse.search/new search/org/eclipse/search/ui/ISearchResultManagerListener.java;1;0;2;1;0;0;0;2;0;1;2;3711;0;0;1;0;0;2;2;3711;0;4345;2;1;
/org.eclipse.ui.tests/Eclipse UI Tests/org/eclipse/ui/tests/multipageeditor/TestMultiPageEditor.java;2;0;3;1;1;1;1;2;23;1;2;4218;27;27;1;0;0;2;3;4218;0;6338;3;2;
/org.eclipse.team.ui/src/org/eclipse/team/ui/synchronize/subscribers/SubscriberParticipantDialog.java;2;0;2;1;0;0;0;2;0;1;2;4632;0;0;1;0;0;2;2;4632;0;4653;2;2;
/org.eclipse.jdt.ui/core refactoring/org/eclipse/jdt/internal/corext/refactoring/reorg2/JavaElementTransfer.java;1;0;2;1;0;0;0;2;4;1;2;483;4;4;1;0;0;2;2;483;0;1114;2;1;
/org.eclipse.jdt.core.tests.model/workspace/Formatter/test373/A_out.java;2;0;3;1;0;0;0;3;12;1;3;3130;13;13;1;0;0;3;3;3130;0;3362;3;2;
/org.eclipse.jdt.core.tests.model/workspace/Converter/src/test0078/Test.java;1;0;1;1;0;0;0;1;0;0;1;3714;0;0;1;0;0;1;1;3714;0;3714;1;1;
/org.eclipse.jdt.core/model/org/eclipse/jdt/internal/core/jdom/DOMBuilder.java;2;0;6;1;1;1;1;5;23;1;5;90;37;37;1;0;0;5;6;90;0;5584;6;2;
/org.eclipse.jdt.ui.tests.refactoring/resources/ChangeSignature/canModify/A_testException04_out.java;1;0;1;1;0;0;0;1;0;0;1;4045;0;0;1;0;0;1;1;4045;0;4045;1;1;
/org.eclipse.ui.workbench/Eclipse UI/org/eclipse/ui/internal/IWorkbenchDragSource.java;3;0;3;1;0;0;0;3;35;1;3;3092;35;35;1;0;0;3;3;3092;0;4600;3;3;
/org.eclipse.team.cvs.core/src/org/eclipse/team/internal/ccvs/core/IResourceStateChangeListener.java;1;0;1;1;0;0;0;1;11;0;1;2181;11;11;1;0;0;1;1;2181;0;2181;1;1;
/org.eclipse.team.cvs.ssh2/src/org/eclipse/team/internal/ccvs/ssh2/Policy.java;2;1;3;1;2;2;2;1;9;0;1;4825;11;11;1;0;0;1;3;4825;0;6337;3;2;
/org.eclipse.releng.tools/src/org/eclipse/releng/tools/MapContentDocument.java;1;0;1;1;1;1;1;0;0;0;0;5183;0;0;1;0;0;0;1;5183;0;5183;1;1;
/org.eclipse.jdt.ui/core refactoring/org/eclipse/jdt/internal/corext/refactoring/participants/xml/IterateExpression.java;1;0;4;1;0;0;0;4;28;1;4;2682;34;34;1;0;0;4;4;2682;0;4108;4;1;
/org.eclipse.jdt.ui/ui/org/eclipse/jdt/internal/ui/actions/ActionUtil.java;3;1;4;1;3;3;3;1;11;0;1;5058;23;23;1;0;0;1;4;5058;0;6340;4;3;
/org.eclipse.jdt.ui/core refactoring/org/eclipse/jdt/internal/corext/refactoring/surround/SurroundWithTryCatchAnalyzer.java;2;0;3;1;1;1;1;2;21;1;2;882;31;31;1;0;0;2;3;882;0;6340;3;2;
/org.eclipse.ui.forms/src/org/eclipse/ui/forms/internal/widgets/ParagraphSegment.java;1;0;4;1;0;0;0;4;2;1;4;4068;4;4;1;0;0;4;4;4068;0;5044;4;1;
/org.eclipse.jdt.ui.tests.refactoring/resources/ChangeTypeRefactoring/negative/A_testMultiDeclaration_out.java;1;0;1;1;0;0;0;1;0;0;1;2844;0;0;1;0;0;1;1;2844;0;2844;1;1;
/org.eclipse.pde.ui/sandbox/org/eclipse/pde/internal/ui/editor/standalone/feature/FeatureSourceLabelProvider.java;1;0;2;1;0;0;0;2;0;1;2;2320;0;0;1;0;0;2;2;2320;0;2906;2;1;
/org.eclipse.jdt.debug.ui/ui/org/eclipse/jdt/internal/debug/ui/snippeteditor/SelectImportsDialog.java;4;1;5;1;4;4;4;1;23;0;1;5068;54;54;1;0;0;1;5;5068;0;5898;5;4;
/org.eclipse.jdt.ui.tests.refactoring/resources/MoveInnerToTopLevel/test_nonstatic_31/out/A.java;1;0;1;1;0;0;0;1;2;0;1;305;2;2;1;0;0;1;1;305;0;305;1;1;
/org.eclipse.jdt.core.tests.model/workspace/Formatter/test158/A_in.java;1;0;1;1;0;0;0;1;0;0;1;2425;0;0;1;0;0;1;1;2425;0;2425;1;1;
/org.eclipse.ui.workbench/Eclipse UI/org/eclipse/ui/internal/actions/HelpContentsAction.java;1;0;2;1;2;1;2;0;15;0;0;5802;15;15;2;0;1;0;2;5802;1;5802;1;1;
/org.eclipse.jdt.ui/core refactoring/org/eclipse/jdt/internal/corext/refactoring/code/ExtractConstantRefactoring.java;6;1;39;2;10;10;10;29;57;3;25;48;358;358;3;4;0;29;39;1952;4;6340;35;6;
/org.eclipse.ui.workbench/Eclipse UI/org/eclipse/ui/internal/handles/HandleEvent.java;1;0;5;1;0;0;0;5;5;1;5;1294;13;13;1;0;0;5;5;1294;0;1724;5;1;
/org.eclipse.jdt.core.tests.compiler/src/org/eclipse/jdt/core/tests/compiler/regression/JavadocTestForField.java;1;0;5;1;0;0;0;5;31;1;5;2887;49;49;1;0;0;5;5;2887;0;4561;5;1;
/org.eclipse.team.ui/src/org/eclipse/team/ui/sync/ISynchronizeTarget.java;1;0;1;1;0;0;0;1;0;0;1;2378;0;0;1;0;0;1;1;2378;0;2378;1;1;
/org.eclipse.jdt.core.tests.model/workspace/Formatter/test141/A_in.java;1;0;1;1;0;0;0;1;0;0;1;2425;0;0;1;0;0;1;1;2425;0;2425;1;1;
/org.eclipse.jdt.core.tests.model/workspace/Converter/src/test0545/Second.java;1;0;1;1;1;1;1;0;0;0;0;5313;0;0;1;0;0;0;1;5313;0;5313;1;1;
/org.eclipse.help.base/src/org/eclipse/help/internal/search/SearchResults.java;1;1;9;1;3;3;3;6;48;1;6;1740;103;103;1;0;0;6;9;1740;0;6337;9;1;
/org.eclipse.jdt.core/dom/org/eclipse/jdt/core/internal/dom/rewrite/Strings.java;2;0;3;2;0;0;0;3;4;2;2;4711;4;4;2;1;0;3;3;4711;1;4802;2;2;
/org.eclipse.jdt.core/search/org/eclipse/jdt/internal/core/search/SubTypeSearchJob.java;3;0;7;1;0;0;0;7;91;2;6;1893;138;138;2;1;0;7;7;2835;1;4060;6;3;
/org.eclipse.ant.ui/Ant Tools Support/org/eclipse/ant/ui/internal/launchConfigurations/IAntLaunchConfigurationConstants.java;1;0;2;1;0;0;0;2;0;1;2;1342;0;0;1;0;0;2;2;1342;0;1811;2;1;
/org.eclipse.team.core/src/org/eclipse/team/internal/core/target/TargetProvider.java;1;0;1;1;0;0;0;1;0;0;1;2495;0;0;1;0;0;1;1;2495;0;2495;1;1;
/org.eclipse.debug.ui/ui/org/eclipse/debug/internal/ui/launchConfigurations/LaunchConfigurationManager.java;4;2;18;2;5;4;5;13;47;1;13;976;231;231;2;0;1;13;18;5206;1;6336;17;4;
/org.eclipse.jdt.ui/ui/org/eclipse/jdt/internal/ui/search/SearchResultUpdater.java;2;1;9;1;4;4;4;5;159;1;5;3488;207;207;1;0;0;5;9;3488;0;6340;9;2;
/org.eclipse.help/src/org/eclipse/help/internal/context/PluginContexts.java;1;1;3;1;2;2;2;1;6;0;1;4893;7;7;1;0;0;1;3;4893;0;6337;3;1;
/org.eclipse.pde.ui/src/org/eclipse/pde/internal/ui/view/CopyToClipboardAction.java;2;1;2;1;2;2;2;0;6;0;0;5783;8;8;1;0;0;0;2;5783;0;6336;2;2;
/org.eclipse.team.cvs.ui/src/org/eclipse/team/internal/ccvs/ui/CVSUIPlugin.java;2;2;45;2;8;6;8;37;108;2;34;866;484;484;2;3;2;37;45;990;5;6337;40;2;
/org.eclipse.jdt.ui.tests/ui/org/eclipse/jdt/ui/tests/text/HTML2TextReaderTester.java;1;0;1;1;0;0;0;1;0;0;1;4516;0;0;1;0;0;1;1;4516;0;4516;1;1;
/org.eclipse.webdav/src/client/org/eclipse/webdav/http/client/HttpClient.java;1;0;2;1;2;1;2;0;150;0;0;5151;150;150;2;0;1;0;2;5151;1;5151;1;1;
/org.eclipse.jdt.ui.tests.refactoring/resources/InlineMethodWorkspace/TestCases/argument_out/TestLocalReferenceWrite.java;1;0;1;1;0;0;0;1;4;0;1;845;4;4;1;0;0;1;1;845;0;845;1;1;
/org.eclipse.ui.ide/extensions/org/eclipse/ui/actions/NewExampleAction.java;3;0;4;1;1;1;1;3;8;1;3;2263;16;16;1;0;0;3;4;2263;0;6338;4;3;
/org.eclipse.jdt.core.tests.model/workspace/Converter/test0135/Test.java;1;0;1;1;0;0;0;1;0;0;1;3714;0;0;1;0;0;1;1;3714;0;3714;1;1;
/org.eclipse.pde.core/src/org/eclipse/pde/internal/core/plugin/AbstractPluginModelBase.java;3;2;20;2;5;4;5;15;49;2;14;2184;276;276;2;1;1;15;20;2936;2;6336;18;3;
/org.eclipse.jdt.core/model/org/eclipse/jdt/core/ICodeCompletionRequestor.java;1;0;3;1;0;0;0;3;16;1;3;2583;20;20;1;0;0;3;3;2583;0;4843;3;1;
/org.eclipse.jdt.core/compiler/org/eclipse/jdt/internal/compiler/env/IConstants.java;2;0;3;1;0;0;0;3;11;1;3;85;15;15;1;0;0;3;3;85;0;4017;3;2;
/org.eclipse.jdt.core/codeassist/org/eclipse/jdt/internal/codeassist/complete/CompletionOnMethodReturnType.java;2;0;2;1;0;0;0;2;4;1;2;991;6;6;1;0;0;2;2;991;0;3560;2;2;
/org.eclipse.jdt.ui/core refactoring/org/eclipse/jdt/internal/corext/refactoring/participants/xml/PropertyInterface.java;1;0;3;1;0;0;0;3;35;1;3;1033;35;35;1;0;0;3;3;1033;0;2204;3;1;
/org.eclipse.jdt.ui/core extension/org/eclipse/jdt/internal/corext/textmanipulation/DeleteEdit.java;1;0;3;1;0;0;0;3;4;0;1;1946;4;4;3;2;0;3;3;1946;2;1946;1;1;
/org.eclipse.sdk.tests-feature/plugins/org.eclipse.perfmsr.ui/src/org/eclipse/perfmsr/ui/actions/SnapshotAll.java;2;1;4;1;3;3;3;1;12;0;1;4845;28;28;1;0;0;1;4;4845;0;6342;4;2;
/org.eclipse.debug.ui/ui/org/eclipse/debug/ui/launchVariables/ProjectNameExpander.java;1;0;2;1;0;0;0;2;0;1;2;550;0;0;1;0;0;2;2;550;0;562;2;1;
/org.eclipse.osgi/resolver/src/org/eclipse/core/internal/dependencies/AssertionFailedException.java;3;1;4;1;3;3;3;1;21;0;1;3013;24;24;1;0;0;1;4;3013;0;5529;4;3;
/org.eclipse.team.ui/src/org/eclipse/team/ui/sync/SyncInfoDirectionFilter.java;2;0;3;1;0;0;0;3;42;1;3;595;42;42;1;0;0;3;3;595;0;2632;3;2;
/org.eclipse.jdt.ui.tests.refactoring/resources/ExtractMethodWorkSpace/ExtractMethodTests/return_out/A_test715.java;1;0;1;1;0;0;0;1;6;0;1;844;6;6;1;0;0;1;1;844;0;844;1;1;
/org.eclipse.ui.ide/src/org/eclipse/ui/actions/WorkspaceModifyDelegatingOperation.java;2;0;2;1;0;0;0;2;0;1;2;1511;0;0;1;0;0;2;2;1511;0;2263;2;2;
/org.eclipse.jdt.core.tests.model/workspace/Formatter/test427/A_in.java;1;0;1;1;0;0;0;1;0;0;1;3478;0;0;1;0;0;1;1;3478;0;3478;1;1;
/org.eclipse.team.ui/src/org/eclipse/team/internal/ui/actions/ConfigureProjectAction.java;1;1;5;1;2;2;2;3;13;1;3;990;29;29;1;0;0;3;5;990;0;6337;5;1;
/org.eclipse.jdt.ui/ui/org/eclipse/jdt/internal/ui/browsing/TypesView.java;1;0;3;1;1;1;1;2;31;1;2;644;47;47;1;0;0;2;3;644;0;6340;3;1;
/org.eclipse.jdt.ui/core refactoring/org/eclipse/ltk/internal/core/refactoring/DelegatingValidationStateChange.java;1;0;4;1;0;0;0;4;2;1;4;4510;4;4;1;0;0;4;4;4510;0;4864;4;1;
/org.eclipse.jdt.ui.tests.refactoring/resources/IntroduceParameter/simple/out/StaticGetter1.java;2;0;2;1;1;1;1;1;2;0;1;2281;2;2;1;0;0;1;2;2281;0;5851;2;2;
/org.eclipse.jdt.junit/src/org/eclipse/jdt/internal/junit/wizards/MethodStubsSelectionButtonGroup.java;2;1;4;1;3;3;3;1;13;0;1;3699;27;27;1;0;0;1;4;3699;0;6340;4;2;
/org.eclipse.ui.intro/src/org/eclipse/ui/intro/internal/util/IntroModelSerializer.java;1;0;5;1;1;1;1;4;98;2;3;4835;102;102;2;1;0;4;5;4898;1;5115;4;1;
/org.eclipse.swt/Eclipse SWT PI/motif/org/eclipse/swt/internal/motif/XSetWindowAttributes.java;1;0;1;1;0;0;0;1;30;0;1;829;30;30;1;0;0;1;1;829;0;829;1;1;
/org.eclipse.jdt.core/compiler/org/eclipse/jdt/internal/compiler/lookup/TypeConstants.java;2;0;3;1;1;1;1;2;3;1;2;3560;6;6;1;0;0;2;3;3560;0;5871;3;2;
/org.eclipse.jdt.core.tests.model/workspace/Formatter/test485/A_out.java;1;0;1;1;1;1;1;0;0;0;0;5132;0;0;1;0;0;0;1;5132;0;5132;1;1;
/org.eclipse.update.ui/src/org/eclipse/update/internal/ui/wizards/UnifiedInstallWizard.java;1;0;4;1;0;0;0;4;114;3;2;196;114;114;3;2;0;4;4;196;2;329;2;1;
/org.eclipse.team.ui/src/org/eclipse/team/ui/synchronize/views/CompressedFolderContentProvider.java;1;0;1;1;0;0;0;1;0;0;1;3825;0;0;1;0;0;1;1;3825;0;3825;1;1;
/org.eclipse.jdt.ui/core extension/org/eclipse/jdt/internal/corext/template/ContextType.java;2;0;4;1;0;0;0;4;17;2;3;1953;19;19;2;1;0;4;4;1953;1;4258;3;2;
/org.eclipse.ui.editors/src/org/eclipse/ui/editors/text/WorkspaceOperationRunner.java;2;0;5;1;1;1;1;4;62;1;4;1983;77;77;1;0;0;4;5;1983;0;5177;5;2;
/org.eclipse.jdt.debug.tests/tests/org/eclipse/jdt/debug/tests/eval/StaticFieldValueTests.java;1;0;1;1;0;0;0;1;18;0;1;1274;18;18;1;0;0;1;1;1274;0;1274;1;1;
/org.eclipse.ui.intro/src/org/eclipse/ui/internal/intro/impl/model/IntroStandbyContentPart.java;1;1;2;1;2;2;2;0;2;0;0;5319;2;2;1;0;0;0;2;5319;0;5533;2;1;
/org.eclipse.core.resources/src/org/eclipse/core/internal/properties/PropertyStore.java;2;0;3;1;2;1;2;1;840;0;1;3108;854;854;2;0;1;1;3;5146;1;5146;2;2;
/org.eclipse.pde.ui/src/org/eclipse/pde/internal/ui/editor/site/StateListener.java;1;0;1;1;0;0;0;1;0;0;1;2311;0;0;1;0;0;1;1;2311;0;2311;1;1;
/org.eclipse.update.core/src/org/eclipse/update/internal/api/operations/IReplaceFeatureVersionOperation.java;1;0;2;1;0;0;0;2;0;1;2;3270;0;0;1;0;0;2;2;3270;0;4928;2;1;
/org.eclipse.ui.editors/src/org/eclipse/ui/internal/editors/text/NextPreviousPulldownActionDelegate.java;2;1;4;1;2;2;2;2;189;1;2;2080;196;196;1;0;0;2;4;2080;0;6340;4;2;
/org.eclipse.jdt.ui/ui/org/eclipse/jdt/internal/ui/text/java/JavaReconcilingStrategy.java;3;1;14;1;8;8;8;6;74;2;5;4627;236;236;2;1;0;6;14;4644;1;6340;13;3;
/org.eclipse.pde.core/src/org/eclipse/pde/core/IModelManager.java;2;0;4;1;1;1;1;3;2;1;3;2229;3;3;1;0;0;3;4;2229;0;5115;4;2;
/org.eclipse.ui.tests/Eclipse UI Tests/org/eclipse/ui/tests/api/NullTitleView.java;1;0;2;1;1;1;1;1;0;0;1;4855;0;0;1;0;0;1;2;4855;0;6101;2;1;
/org.eclipse.update.ui/srcnew/org/eclipse/update/internal/ui/EditBookmarksAction.java;2;0;2;1;0;0;0;2;0;1;2;768;0;0;1;0;0;2;2;768;0;825;2;2;
/org.eclipse.jdt.text.tests/src/org/eclipse/jdt/text/tests/JavaHeuristicScannerTest.java;1;1;2;1;2;2;2;0;2;0;0;5129;2;2;1;0;0;0;2;5129;0;6340;2;1;
/org.eclipse.swt/Eclipse SWT/gtk1x/org/eclipse/swt/widgets/Menu.java;1;0;1;1;0;0;0;1;0;0;1;2327;0;0;1;0;0;1;1;2327;0;2327;1;1;
/org.eclipse.jdt.core/search/org/eclipse/jdt/internal/core/search/matching/PossibleMatchSet.java;2;0;3;1;0;0;0;3;2;1;3;2010;4;4;1;0;0;3;3;2010;0;3560;3;2;
/org.eclipse.jdt.core.tests.model/workspace/JavaSearch/src/j1/AnnInvalidRef.java;1;0;2;1;0;0;0;2;0;1;2;2661;0;0;1;0;0;2;2;2661;0;3081;2;1;
/org.eclipse.help.base/src/org/eclipse/help/internal/base/HelpBasePlugin.java;1;1;15;1;6;6;6;9;109;2;8;1747;342;342;2;1;0;9;15;1747;1;6337;14;1;
/org.eclipse.jdt.core/model/org/eclipse/jdt/core/util/IRuntimeVisibleAnnotationsAttribute.java;2;0;2;1;0;0;0;2;36;1;2;4466;36;36;1;0;0;2;2;4466;0;4843;2;2;
/org.eclipse.swt/Eclipse SWT/common/org/eclipse/swt/SWTException.java;1;1;2;1;2;2;2;0;18;0;0;6192;22;22;1;0;0;0;2;6192;0;6352;2;1;
/org.eclipse.osgi/core/framework/org/eclipse/osgi/framework/internal/protocol/ProtocolActivator.java;5;1;5;1;2;2;2;3;4;1;3;3013;10;10;1;0;0;3;5;3013;0;6337;5;5;
/org.eclipse.jdt.ui/ui/org/eclipse/jdt/internal/ui/text/correction/NameMatcher.java;1;0;1;1;1;1;1;0;2;0;0;6340;2;2;1;0;0;0;1;6340;0;6340;1;1;
/org.eclipse.ant.ui/Ant Tools Support/org/eclipse/ant/ui/internal/launchConfigurations/AntTargetsTab.java;2;0;15;2;0;0;0;15;19;2;12;250;76;76;2;3;0;15;15;262;3;1811;12;2;
/org.eclipse.jdt.debug.ui/ui/org/eclipse/jdt/internal/debug/ui/launcher/VMLabelProvider.java;1;0;1;1;0;0;0;1;0;0;1;1036;0;0;1;0;0;1;1;1036;0;1036;1;1;
/org.eclipse.ui.tutorials.rcp.part2/src/org/eclipse/ui/tutorials/rcp/part2/RcpPerspective.java;1;0;1;1;1;1;1;0;0;0;0;5118;0;0;1;0;0;0;1;5118;0;5118;1;1;
/org.eclipse.jdt.junit/src/org/eclipse/jdt/internal/junit/ui/ITestRunListener3.java;2;0;3;1;1;1;1;2;2;1;2;3417;4;4;1;0;0;2;3;3417;0;6340;3;2;
/org.eclipse.jdt.core.tests.model/workspace/Formatter/test026/A_out.java;1;0;3;1;0;0;0;3;4;1;3;2425;7;7;1;0;0;3;3;2425;0;3029;3;1;
/org.eclipse.jdt.core/compiler/org/eclipse/jdt/internal/compiler/ast/TryStatement.java;4;0;26;2;2;1;2;24;224;4;18;85;680;680;4;6;1;24;26;147;7;5339;19;4;
/org.eclipse.jdt.debug.ui/ui/org/eclipse/jdt/debug/ui/IJavaObjectBrowser.java;2;0;3;1;0;0;0;3;5;1;3;861;5;5;1;0;0;3;3;861;0;2647;3;2;
/org.eclipse.team.ui/src/org/eclipse/team/ui/synchronize/TeamSubscriberConfiguration.java;1;0;1;1;0;0;0;1;0;0;1;3384;0;0;1;0;0;1;1;3384;0;3384;1;1;
/org.eclipse.team.ui/src/org/eclipse/team/internal/ui/jobs/IRefreshEvent.java;1;0;1;1;0;0;0;1;0;0;1;3384;0;0;1;0;0;1;1;3384;0;3384;1;1;
/org.eclipse.update.core/srcnew/org/eclipse/update/internal/search/UpdateSearchScope.java;1;0;2;1;0;0;0;2;0;0;1;572;0;0;2;1;0;2;2;572;1;572;1;1;
/org.eclipse.debug.ui/ui/org/eclipse/debug/internal/ui/actions/StepWithFiltersActionDelegate.java;1;0;1;1;0;0;0;1;0;0;1;3613;0;0;1;0;0;1;1;3613;0;3613;1;1;
/org.eclipse.jdt.core/search/org/eclipse/jdt/internal/core/search/matching/InternalSearchPattern.java;1;2;3;1;3;2;3;0;8;0;0;5207;14;14;2;0;1;0;3;5207;1;5335;2;1;
/org.eclipse.ui.workbench/Eclipse UI/org/eclipse/ui/commands/IKeyBindingDefinition.java;1;0;4;1;0;0;0;4;11;2;3;1389;11;11;2;1;0;4;4;1417;1;1417;3;1;
/org.eclipse.jface.text/src/org/eclipse/jface/internal/text/link/contentassist/HTMLTextPresenter.java;3;1;3;1;2;2;2;1;2;0;1;4214;4;4;1;0;0;1;3;4214;0;6340;3;3;
/org.eclipse.jface.text/src/org/eclipse/jface/text/IAutoIndentStrategy.java;2;1;2;1;2;2;2;0;3;0;0;5177;5;5;1;0;0;0;2;5177;0;6340;2;2;
/org.eclipse.jdt.ui.tests.refactoring/resources/RenameType/test50/out/B.java;1;0;1;1;0;0;0;1;4;0;1;4577;4;4;1;0;0;1;1;4577;0;4577;1;1;
/org.eclipse.jdt.core.tests.model/workspace/Formatter/test192/A_out.java;1;0;2;1;0;0;0;2;2;1;2;2425;2;2;1;0;0;2;2;2425;0;4173;2;1;
/org.eclipse.pde.ui/src/org/eclipse/pde/internal/ui/launcher/InstalledJREsPreferenceNode.java;2;1;4;1;2;2;2;2;103;1;2;1459;117;117;1;0;0;2;4;1459;0;6336;4;2;
/org.eclipse.update.core/src/org/eclipse/update/core/IFeatureReference.java;2;1;3;1;2;2;2;1;6;0;1;890;16;16;1;0;0;1;3;890;0;6336;3;2;
/org.eclipse.ui.externaltools/Ant Tools Support/org/eclipse/ui/externaltools/internal/ant/view/actions/AntViewActionMessages.java;1;0;1;1;0;0;0;1;0;0;1;282;0;0;1;0;0;1;1;282;0;282;1;1;
/org.eclipse.update.ui.forms/Eclipse Forms/org/eclipse/ui/forms/internal/parts/HyperlinkSegment.java;1;0;2;1;0;0;0;2;0;1;2;3096;0;0;1;0;0;2;2;3096;0;3138;2;1;
/org.eclipse.update.ui/src/org/eclipse/update/internal/ui/search/DriveSearchSettings.java;1;0;1;1;0;0;0;1;0;0;1;825;0;0;1;0;0;1;1;825;0;825;1;1;
/org.eclipse.swt.tests/JUnit Tests/org/eclipse/swt/tests/junit/Test_org_eclipse_swt_widgets_MenuItem.java;3;0;5;1;0;0;0;5;146;2;4;2123;257;257;2;1;0;5;5;2648;1;2824;4;3;
/org.eclipse.pde.ui/src/org/eclipse/pde/internal/ui/editor/manifest/RuntimeForm.java;1;0;2;1;1;1;1;1;128;0;1;1727;128;128;1;0;0;1;2;1727;0;5431;2;1;
/org.eclipse.ui.intro/src/org/eclipse/ui/intro/internal/html/IIntroHTMLConstants.java;2;0;3;1;1;1;1;2;4;1;2;4429;4;4;1;0;0;2;3;4429;0;5115;3;2;
/org.eclipse.team.webdav/src/org/eclipse/team/core/target/SyncByteConverter.java;1;0;1;1;0;0;0;1;0;0;1;3379;0;0;1;0;0;1;1;3379;0;3379;1;1;
/org.eclipse.jdt.ui/ui/org/eclipse/jdt/ui/text/java/IJavadocCompletionProcessor.java;1;1;2;1;2;2;2;0;3;0;0;5127;5;5;1;0;0;0;2;5127;0;6322;2;1;
/org.eclipse.jdt.ui.tests.refactoring/resources/ExtractMethodWorkSpace/ExtractMethodTests/wiki_out/A_test2002.java;1;0;2;1;0;0;0;2;6;1;2;130;10;10;1;0;0;2;2;130;0;844;2;1;
/org.eclipse.jdt.ui/ui/org/eclipse/jdt/internal/ui/wizards/dialogfields/DialogField.java;2;1;3;1;2;2;2;1;10;0;1;4407;15;15;1;0;0;1;3;4407;0;6340;3;2;
/org.eclipse.jdt.core.tests.model/workspace/Converter/test0348/Test2.java;1;0;1;1;0;0;0;1;0;0;1;3714;0;0;1;0;0;1;1;3714;0;3714;1;1;
/org.eclipse.jdt.ui/ui/org/eclipse/jdt/internal/ui/text/spelling/SpellReconcileStrategy.java;3;1;7;1;2;2;2;5;41;1;5;3930;121;121;1;0;0;5;7;3930;0;6340;7;3;
/org.eclipse.jdt.ui/core extension/org/eclipse/jdt/internal/corext/template/ITemplateEditor.java;1;0;1;1;0;0;0;1;0;0;1;4258;0;0;1;0;0;1;1;4258;0;4258;1;1;
/org.eclipse.jdt.core/dom/org/eclipse/jdt/core/dom/Assignment.java;4;1;9;1;2;2;2;7;136;1;7;1114;188;188;1;0;0;7;9;1114;0;5272;9;4;
/org.eclipse.swt/Eclipse SWT Custom Widgets/common/org/eclipse/swt/custom/TableTreeItem.java;5;1;6;1;3;3;3;3;46;1;3;268;73;73;1;0;0;3;6;268;0;6352;6;5;
/org.eclipse.osgi/core/framework/org/eclipse/osgi/framework/eventmgr/EventQueue.java;3;0;3;1;0;0;0;3;163;1;3;3013;163;163;1;0;0;3;3;3013;0;5097;3;3;
/org.eclipse.ant.tests.ui/Ant Editor Tests/org/eclipse/ant/tests/ui/editor/formatter/NonParsingXMLFormatterTest.java;1;0;2;1;0;0;0;2;0;1;2;4317;0;0;1;0;0;2;2;4317;0;4583;2;1;
/org.eclipse.jdt.debug.ui/ui/org/eclipse/jdt/internal/debug/core/refactoring/JavaBreakpointITypeMoveParticipant.java;2;1;2;1;2;2;2;0;8;0;0;5319;8;8;1;0;0;0;2;5319;0;6339;2;2;
/org.eclipse.swt/Eclipse SWT PI/motif/org/eclipse/swt/internal/motif/Visual.java;1;0;1;1;0;0;0;1;4;0;1;829;4;4;1;0;0;1;1;829;0;829;1;1;
/org.eclipse.debug.ui/ui/org/eclipse/debug/internal/ui/preferences/DebugActionGroupsLabelProvider.java;1;0;1;1;0;0;0;1;0;0;1;5086;0;0;1;0;0;1;1;5086;0;5086;1;1;
/org.eclipse.jdt.core.tests.model/workspace/Formatter/test246/A_in.java;1;0;1;1;0;0;0;1;0;0;1;2442;0;0;1;0;0;1;1;2442;0;2442;1;1;
/org.eclipse.pde.ui/sandbox/org/eclipse/pde/internal/ui/editor/standalone/parser/XMLCore.java;1;0;2;1;0;0;0;2;0;1;2;2320;0;0;1;0;0;2;2;2320;0;2931;2;1;
/org.eclipse.ui.workbench/Eclipse UI/org/eclipse/ui/internal/commands/keys/NonModifierKey.java;1;0;3;1;0;0;0;3;11;1;3;1264;18;18;1;0;0;3;3;1264;0;1294;3;1;
/org.eclipse.ant.ui/Ant Editor/org/eclipse/ant/internal/ui/editor/derived/HTMLPrinter.java;1;0;1;1;0;0;0;1;0;0;1;1811;0;0;1;0;0;1;1;1811;0;1811;1;1;
/org.eclipse.jdt.core/compiler/org/eclipse/jdt/internal/compiler/ConfigurableOption.java;2;0;2;1;1;1;1;1;2;0;1;3560;4;4;1;0;0;1;2;3560;0;5916;2;2;
/org.eclipse.jdt.core.tests.model/workspace/Completion/src/CompletionStaticMethodDeclaration2.java;1;0;1;1;0;0;0;1;0;0;1;3039;0;0;1;0;0;1;1;3039;0;3039;1;1;
/org.eclipse.team.ui/src/org/eclipse/team/ui/synchronize/viewers/CompareDialog.java;1;0;1;1;0;0;0;1;0;0;1;4319;0;0;1;0;0;1;1;4319;0;4319;1;1;
/org.eclipse.ui.workbench/Eclipse UI/org/eclipse/ui/internal/ViewSashContainer.java;2;1;3;1;3;3;3;0;11;0;0;5539;13;13;1;0;0;0;3;5539;0;6338;3;2;
/org.eclipse.pde.ui/sandbox/org/eclipse/pde/internal/ui/editor/standalone/text/NonRuleBasedDamagerRepairer.java;1;0;2;1;0;0;0;2;0;1;2;2320;0;0;1;0;0;2;2;2320;0;2906;2;1;
/org.eclipse.jdt.core/model/org/eclipse/jdt/core/util/IRuntimeVisibleAnnotations.java;1;0;1;1;0;0;0;1;0;0;1;4447;0;0;1;0;0;1;1;4447;0;4447;1;1;
/org.eclipse.jdt.core.tests.model/workspace/Converter/src/javadoc/test017/TestD1.java;1;0;2;1;0;0;0;2;0;1;2;4311;0;0;1;0;0;2;2;4311;0;4390;2;1;
/org.eclipse.team.cvs.core/src/org/eclipse/team/internal/ccvs/core/client/Log.java;1;0;1;1;0;0;0;1;2;0;1;1843;2;2;1;0;0;1;1;1843;0;1843;1;1;
/org.eclipse.ui.workbench/Eclipse UI/org/eclipse/ui/internal/commands/old/State.java;1;0;3;1;0;0;0;3;2;1;3;1222;2;2;1;0;0;3;3;1222;0;1695;3;1;
/org.eclipse.team.ui/src/org/eclipse/team/ui/synchronize/SyncInfoDiffNode.java;1;0;1;1;0;0;0;1;0;0;1;3286;0;0;1;0;0;1;1;3286;0;3286;1;1;
/org.eclipse.jdt.ui/core extension/org/eclipse/jdt/internal/corext/dom/JdtASTMatcher.java;1;0;1;1;1;1;1;0;2;0;0;6340;2;2;1;0;0;0;1;6340;0;6340;1;1;
/org.eclipse.jdt.ui.tests.refactoring/resources/IntroduceFactory/Bugzilla/46189/TestClass.java;1;0;2;1;1;1;1;1;2;0;1;2846;2;2;1;0;0;1;2;2846;0;5659;2;1;
/org.eclipse.jdt.core.tests.model/workspace/Formatter/test339/A_out.java;1;0;1;1;0;0;0;1;0;0;1;2863;0;0;1;0;0;1;1;2863;0;2863;1;1;
/org.eclipse.ant.ui/Ant Editor/org/eclipse/ant/internal/ui/editor/formatter/XmlElementFormattingStrategy.java;1;1;8;1;2;2;2;6;179;2;5;3916;465;465;2;1;0;6;8;3916;1;5739;7;1;
/org.eclipse.team.tests.cvs.core/src/org/eclipse/team/tests/ccvs/ui/unit/CompareOperationTests.java;2;0;3;1;0;0;0;3;184;1;3;2478;184;184;1;0;0;3;3;2478;0;2632;3;2;
/org.eclipse.team.tests.cvs.core/src/org/eclipse/team/tests/ccvs/ui/sync/SyncInfoFromSyncSet.java;2;0;8;1;0;0;0;8;23;1;8;1221;60;60;1;0;0;8;8;1221;0;2632;8;2;
/org.eclipse.team.ui/src/org/eclipse/team/ui/synchronize/actions/INavigableControl.java;1;0;1;1;0;0;0;1;0;0;1;2535;0;0;1;0;0;1;1;2535;0;2535;1;1;
/org.eclipse.team.cvs.ui/src/org/eclipse/team/internal/ccvs/ui/actions/CompareRemoteWithTagAction.java;2;0;4;1;1;1;1;3;63;1;3;276;135;135;1;0;0;3;4;276;0;6337;4;2;
/org.eclipse.update.ui/src/org/eclipse/update/internal/ui/parts/NewConfigurationInfo.java;1;0;4;1;0;0;0;4;5;1;4;2744;8;8;1;0;0;4;4;2744;0;4658;4;1;
/org.eclipse.ui.workbench/Eclipse UI/org/eclipse/ui/internal/roles/ICategoryRegistryListener.java;1;0;2;1;0;0;0;2;0;0;1;2864;0;0;2;1;0;2;2;2864;1;2864;1;1;
/org.eclipse.jdt.core.tests.model/workspace/Converter/src/test0069/Test.java;1;0;1;1;0;0;0;1;0;0;1;3714;0;0;1;0;0;1;1;3714;0;3714;1;1;
/org.eclipse.ant.ui/Ant Tools Support/org/eclipse/ant/ui/internal/launchConfigurations/AntTabGroup.java;3;0;12;2;0;0;0;12;15;2;10;250;54;54;2;2;0;12;12;321;2;1811;10;3;
/org.eclipse.jdt.ui.tests.refactoring/test cases/org/eclipse/jdt/ui/tests/refactoring/infra/TextRangeUtil.java;1;0;1;1;1;1;1;0;2;0;0;6340;2;2;1;0;0;0;1;6340;0;6340;1;1;
/org.eclipse.ui.workbench/Eclipse UI/org/eclipse/ui/internal/commands/registry/old/LocalRegistry.java;1;0;2;1;0;0;0;2;0;1;2;1222;0;0;1;0;0;2;2;1222;0;1322;2;1;
/org.eclipse.core.runtime.osgi/src/org/eclipse/core/runtime/jobs/Job.java;1;0;1;1;0;0;0;1;0;0;1;3013;0;0;1;0;0;1;1;3013;0;3013;1;1;
/org.eclipse.core.runtime/src/org/eclipse/core/runtime/IPluginListener.java;2;0;3;1;0;0;0;3;2;1;3;2105;2;2;1;0;0;3;3;2105;0;3013;3;2;
/org.eclipse.swt/Eclipse SWT/win32/org/eclipse/swt/widgets/Control.java;7;2;90;3;12;10;12;78;223;3;63;16;1878;1878;3;15;2;78;90;1219;17;6352;73;7;
/org.eclipse.team.ui/src/org/eclipse/team/ui/synchronize/actions/INavigableTree.java;1;0;1;1;0;0;0;1;0;0;1;3709;0;0;1;0;0;1;1;3709;0;3709;1;1;
/org.eclipse.jdt.ui/ui/org/eclipse/jdt/ui/actions/ConvertAnonymousToNestedAction.java;3;0;11;1;1;1;1;10;86;1;10;42;204;204;1;0;0;10;11;42;0;6340;11;3;
/org.eclipse.jface/src/org/eclipse/jface/action/CoolBarManager.java;6;2;21;2;5;4;5;16;1713;2;14;3220;2160;2160;2;2;1;16;21;3810;3;6338;18;6;
/org.eclipse.jdt.ui.tests.refactoring/resources/MoveInstanceMethod/canMove/test12/out/B.java;1;0;1;1;0;0;0;1;22;0;1;1603;22;22;1;0;0;1;1;1603;0;1603;1;1;
/org.eclipse.core.tests.runtime/src/org/eclipse/core/tests/internal/plugins/FragmentResolveTest_8.java;1;0;1;1;0;0;0;1;0;0;1;3014;0;0;1;0;0;1;1;3014;0;3014;1;1;
/org.eclipse.jdt.core/model/org/eclipse/jdt/internal/core/DeltaProcessor.java;4;1;52;2;12;12;12;40;1164;2;36;61;3750;3750;2;4;0;40;52;2170;4;6220;48;4;
/org.eclipse.jdt.ui.tests.refactoring/resources/RenamePackage/testImportFromMultiRoots7/in/srcPrj/pack/DingsDa.java;1;0;1;1;0;0;0;1;0;0;1;4105;0;0;1;0;0;1;1;4105;0;4105;1;1;
/org.eclipse.jdt.ui.tests/chkpii/org/eclipse/jdt/ui/tests/chkpii/BuildTests.java;1;0;1;1;0;0;0;1;0;0;1;85;0;0;1;0;0;1;1;85;0;85;1;1;
/org.eclipse.core.resources/src/org/eclipse/core/internal/indexing/ReservationTable.java;1;0;2;1;2;1;2;0;36;0;0;5146;36;36;2;0;1;0;2;5146;1;5146;1;1;
/org.eclipse.jdt.ui.tests.refactoring/resources/IntroduceFactory/Bugzilla/45942/TestClass.java;1;0;2;1;1;1;1;1;2;0;1;2846;2;2;1;0;0;1;2;2846;0;5659;2;1;
/org.eclipse.ui.tests/Eclipse UI Tests/org/eclipse/ui/tests/internal/EditorActionBarsTest.java;2;0;4;1;0;0;0;4;75;1;4;2307;159;159;1;0;0;4;4;2307;0;3220;4;2;
/org.eclipse.jdt.core.tests.model/workspace/Formatter/test408/A_out.java;1;0;1;1;0;0;0;1;0;0;1;3438;0;0;1;0;0;1;1;3438;0;3438;1;1;
/org.eclipse.help/src/org/eclipse/help/internal/toc/TocNode.java;1;1;5;1;2;2;2;3;23;1;3;630;50;50;1;0;0;3;5;630;0;6337;5;1;
/org.eclipse.ui.ide/src/org/eclipse/ui/views/tasklist/ITaskListHelpContextIds.java;1;0;1;1;0;0;0;1;0;0;1;2208;0;0;1;0;0;1;1;2208;0;2208;1;1;
/org.eclipse.jdt.ui.tests.refactoring/resources/ExtractMethodWorkSpace/ExtractMethodTests/locals_in/A_test523.java;1;0;2;1;0;0;0;2;4;1;2;130;8;8;1;0;0;2;2;130;0;844;2;1;
/org.eclipse.core.tests.runtime/src/org/eclipse/core/tests/runtime/locks/IJobManagerTest.java;1;0;2;1;0;0;0;2;0;1;2;698;0;0;1;0;0;2;2;698;0;850;2;1;
/org.eclipse.jdt.ui/ui/org/eclipse/jdt/ui/IPackagesViewPart.java;1;0;1;1;1;1;1;0;2;0;0;6340;2;2;1;0;0;0;1;6340;0;6340;1;1;
/org.eclipse.swt/Eclipse SWT/win32/org/eclipse/swt/widgets/Group.java;5;0;12;1;1;1;1;11;69;1;11;110;164;164;1;0;0;11;12;110;0;6352;12;5;
/org.eclipse.ui.workbench/Eclipse UI/org/eclipse/ui/internal/dialogs/FilteredPreferenceContentProvider.java;2;0;4;1;1;1;1;3;35;1;3;3131;60;60;1;0;0;3;4;3131;0;6338;4;2;
/org.eclipse.ui.workbench.texteditor/src/org/eclipse/ui/texteditor/ITextEditor.java;2;2;3;2;3;2;3;0;39;0;0;5123;41;41;2;0;1;0;3;6334;1;6334;2;2;
/org.eclipse.jdt.ui/core refactoring/org/eclipse/jdt/internal/corext/refactoring/code/ExtractMethodRefactoring.java;5;1;43;1;8;8;8;35;464;2;34;122;1270;1270;2;1;0;35;43;1952;1;6340;42;5;
/org.eclipse.ui.workbench/Eclipse UI/org/eclipse/ui/internal/commands/registry/old/ActiveConfiguration.java;1;0;3;1;0;0;0;3;2;2;2;1222;2;2;2;1;0;3;3;1321;1;1321;2;1;
/org.eclipse.jdt.debug.tests/tests/org/eclipse/jdt/debug/tests/core/BreakpointListenerTests.java;2;0;4;1;1;1;1;3;15;2;2;2081;20;20;2;1;0;3;4;2081;1;6339;3;2;
/org.eclipse.pde.ui/src_samples/org/eclipse/pde/ui/internal/samples/ShowSampleAction.java;3;1;11;1;6;6;6;5;127;2;4;4543;274;274;2;1;0;5;11;4630;1;6336;10;3;
/org.eclipse.core.resources/src/org/eclipse/core/internal/utils/Convert.java;1;1;2;1;2;2;2;0;171;0;0;5108;177;177;1;0;0;0;2;5108;0;5146;2;1;
/org.eclipse.ui.workbench/Eclipse UI/org/eclipse/ui/internal/themes/IThemeRegistry.java;2;0;7;1;1;1;1;6;158;2;5;3684;225;225;2;1;0;6;7;4559;1;5274;6;2;
/org.eclipse.jdt.core.tests.model/src/org/eclipse/jdt/core/tests/model/AllJavaModelTests.java;3;1;17;1;3;3;3;14;68;2;13;1032;139;139;2;1;0;14;17;1876;1;6099;16;3;
/org.eclipse.jdt.ui/ui/org/eclipse/jdt/ui/text/spelling/WordCompletionProcessor.java;1;0;2;1;0;0;0;2;0;1;2;3829;0;0;1;0;0;2;2;3829;0;3930;2;1;
/org.eclipse.jdt.core.tests.model/workspace/Converter/test0238/Test.java;1;0;1;1;0;0;0;1;0;0;1;3714;0;0;1;0;0;1;1;3714;0;3714;1;1;
/org.eclipse.ui.views/src/org/eclipse/ui/views/tasklist/MarkCompletedAction.java;1;0;1;1;0;0;0;1;0;0;1;2738;0;0;1;0;0;1;1;2738;0;2738;1;1;
/org.eclipse.jdt.core.tests.model/workspace/Converter/test0342/Test.java;1;0;1;1;0;0;0;1;0;0;1;3714;0;0;1;0;0;1;1;3714;0;3714;1;1;
/org.eclipse.jdt.ui/core extension/org/eclipse/jdt/internal/corext/dom/fragments/SimpleFragment.java;1;0;1;1;1;1;1;0;2;0;0;6340;2;2;1;0;0;0;1;6340;0;6340;1;1;
/org.eclipse.jdt.ui/ui/org/eclipse/jdt/internal/ui/javadocexport/JavadocCommandWizardPage.java;1;0;2;1;0;0;0;2;0;1;2;917;0;0;1;0;0;2;2;917;0;2490;2;1;
/org.eclipse.jdt.ui.tests.refactoring/resources/RenameTemp/canRename/A_test51_out.java;1;0;1;1;0;0;0;1;0;0;1;3218;0;0;1;0;0;1;1;3218;0;3218;1;1;
/org.eclipse.ant.ui/Ant Editor/org/eclipse/ant/ui/internal/editor/outline/ILocationProvider.java;1;0;2;1;0;0;0;2;0;1;2;250;0;0;1;0;0;2;2;250;0;1811;2;1;
/org.eclipse.jdt.core.tests.model/workspace/Converter/src/test0542/A.java;1;0;1;1;0;0;0;1;0;0;1;5038;0;0;1;0;0;1;1;5038;0;5038;1;1;
/org.eclipse.ui.tests/Eclipse UI Tests/org/eclipse/ui/tests/api/EditorIconTest.java;1;0;1;1;1;1;1;0;0;0;0;6037;0;0;1;0;0;0;1;6037;0;6037;1;1;
/org.eclipse.ltk.ui.refactoring/src/org/eclipse/ltk/internal/ui/refactoring/RefactoringUIPlugin.java;1;0;3;1;1;1;1;2;42;1;2;4845;54;54;1;0;0;2;3;4845;0;5380;3;1;
/org.eclipse.debug.ui/ui/org/eclipse/debug/internal/ui/actions/EditWatchExpressionAction.java;1;0;2;1;0;0;0;2;10;1;2;1516;10;10;1;0;0;2;2;1516;0;1524;2;1;
/org.eclipse.osgi/defaultAdaptor/src/org/eclipse/osgi/framework/internal/defaultadaptor/AdaptorMsg.java;3;0;3;1;0;0;0;3;14;1;3;3013;14;14;1;0;0;3;3;3013;0;4391;3;3;
/org.eclipse.jdt.ui/ui/org/eclipse/jdt/internal/ui/dialogs/StatusInfo.java;2;1;3;1;3;3;3;0;6;0;0;5612;10;10;1;0;0;0;3;5612;0;6340;3;2;
/org.eclipse.pde.ui/src_Forms/org/eclipse/pde/internal/ui/model/plugin/PluginAttribute.java;3;2;10;1;6;5;6;4;14;1;4;4438;56;56;2;0;1;4;10;5495;1;6336;9;3;
/org.eclipse.ui.ide/extensions/org/eclipse/ui/ICapabilityUninstallWizard.java;1;0;1;1;0;0;0;1;0;0;1;2263;0;0;1;0;0;1;1;2263;0;2263;1;1;
/org.eclipse.jdt.ui/core refactoring/org/eclipse/jdt/internal/corext/refactoring/reorg2/ReorgPolicyFactory.java;2;0;9;1;0;0;0;9;165;2;6;802;473;473;2;3;0;9;9;802;3;1111;6;2;
/org.eclipse.jdt.core.tests.model/workspace/Converter/src/javadoc/test019/TestD2.java;1;0;2;1;0;0;0;2;0;1;2;4311;0;0;1;0;0;2;2;4311;0;4390;2;1;
/org.eclipse.team.core/src/org/eclipse/team/internal/core/target/UrlUtil.java;1;0;1;1;0;0;0;1;0;0;1;2495;0;0;1;0;0;1;1;2495;0;2495;1;1;
/org.eclipse.debug.ui/ui/org/eclipse/debug/ui/launchVariables/expanders/ResourceNameExpander.java;1;0;2;1;0;0;0;2;0;1;2;562;0;0;1;0;0;2;2;562;0;737;2;1;
/org.eclipse.ui.workbench/Eclipse UI/org/eclipse/ui/internal/commands/api/NotDefinedException.java;1;0;2;1;0;0;0;2;2;0;1;2562;2;2;2;1;0;2;2;2562;1;2562;1;1;
/org.eclipse.team.webdav/src/org/eclipse/team/internal/ui/target/SiteElement.java;2;1;4;1;2;2;2;2;7;1;2;2495;11;11;1;0;0;2;4;2495;0;6337;4;2;
/org.eclipse.jdt.core.tests.builder/src/org/eclipse/jdt/core/tests/builder/Assert.java;2;0;2;1;0;0;0;2;2;1;2;3308;3;3;1;0;0;2;2;3308;0;3560;2;2;
/org.eclipse.jdt.ui/ui/org/eclipse/jdt/internal/ui/text/folding/EmptyJavaFoldingPreferenceBlock.java;1;1;2;1;2;2;2;0;6;0;0;5440;6;6;1;0;0;0;2;5440;0;6340;2;1;
/org.eclipse.jdt.ui.tests.refactoring/resources/ExtractInterface/test97/out/I.java;1;0;1;1;0;0;0;1;0;0;1;1315;0;0;1;0;0;1;1;1315;0;1315;1;1;
/org.eclipse.ui.editors/src/org/eclipse/ui/editors/quickdiff/IQuickDiffProviderImplementation.java;2;0;3;1;0;0;0;3;9;1;3;1118;9;9;1;0;0;3;3;1118;0;1644;3;2;
/org.eclipse.jdt.core/model/org/eclipse/jdt/internal/core/CompletionRequestorWrapper.java;2;0;4;1;1;1;1;3;62;1;3;1820;99;99;1;0;0;3;4;1820;0;5480;4;2;
/org.eclipse.update.core/srcnew/org/eclipse/update/standalone/InstallCommand.java;1;0;6;1;0;0;0;6;224;2;4;671;370;370;2;2;0;6;6;671;2;825;4;1;
/org.eclipse.jdt.core/dom/org/eclipse/jdt/core/dom/VariableDeclarationStatement.java;4;2;18;1;6;4;6;12;162;2;11;3560;380;380;2;1;2;12;18;4489;3;5781;15;4;
/org.eclipse.jdt.core.tests.model/src/org/eclipse/jdt/core/tests/model/AttachSourceTests.java;4;1;16;1;2;2;2;14;92;1;14;30;252;252;1;0;0;14;16;30;0;6217;16;4;
/org.eclipse.swt/Eclipse SWT PI/gtk/org/eclipse/swt/internal/gtk/GtkTargetEntry.java;3;0;4;1;1;1;1;3;17;1;3;1653;23;23;1;0;0;3;4;1653;0;6352;4;3;
/org.eclipse.jdt.core.tests.model/workspace/Converter/test0346/Test2.java;1;0;1;1;0;0;0;1;0;0;1;3714;0;0;1;0;0;1;1;3714;0;3714;1;1;
/org.eclipse.jdt.ui.tests.refactoring/resources/ChangeSignature/canModify/A_testImport06_out.java;1;0;1;1;0;0;0;1;0;0;1;3940;0;0;1;0;0;1;1;3940;0;3940;1;1;
/org.eclipse.ui.workbench/Eclipse UI/org/eclipse/ui/internal/commands/registry/CommandRegistry.java;1;0;2;1;0;0;0;2;0;0;1;1396;0;0;2;1;0;2;2;1396;1;1396;1;1;
/org.eclipse.jdt.ui/ui/org/eclipse/jdt/internal/ui/wizards/dialogfields/ComboDialogField.java;2;1;4;1;2;2;2;2;25;1;2;1235;37;37;1;0;0;2;4;1235;0;6340;4;2;
/org.eclipse.jdt.core.tests.model/workspace/Converter/src/test0367/A.java;1;0;1;1;0;0;0;1;0;0;1;3714;0;0;1;0;0;1;1;3714;0;3714;1;1;
/org.eclipse.osgi/core/framework/org/eclipse/osgi/framework/internal/core/FilteredServiceListener.java;4;2;6;1;4;3;4;2;118;1;2;3013;134;134;2;0;1;2;6;5116;1;6337;5;4;
/org.eclipse.ui.workbench/Eclipse UI/org/eclipse/ui/internal/keys/KeySupport.java;2;0;14;1;0;0;0;14;383;3;10;1711;1132;1132;3;4;0;14;14;2141;4;3009;10;2;
/org.eclipse.team.cvs.ui/src/org/eclipse/team/internal/ccvs/ui/subscriber/MergeParticipantActionContribution.java;1;0;1;1;0;0;0;1;0;0;1;5070;0;0;1;0;0;1;1;5070;0;5070;1;1;
/org.eclipse.jdt.core.tests.model/workspace/Formatter/test008/A_in.java;1;0;1;1;0;0;0;1;0;0;1;2425;0;0;1;0;0;1;1;2425;0;2425;1;1;
/org.eclipse.jdt.core.tests.model/workspace/Converter/src/junit/framework/Test.java;1;0;1;1;0;0;0;1;0;0;1;3714;0;0;1;0;0;1;1;3714;0;3714;1;1;
/org.eclipse.pde.ui/templates_3.0/newWizard/java/$wizardClassName$.java;1;0;1;1;0;0;0;1;0;0;1;2786;0;0;1;0;0;1;1;2786;0;2786;1;1;
/org.eclipse.jdt.core.tests.compiler/src/org/eclipse/jdt/core/tests/compiler/regression/AnnotationTestForClass.java;1;0;4;1;0;0;0;4;36;1;4;2397;42;42;1;0;0;4;4;2397;0;2887;4;1;
/org.eclipse.jdt.core.tests.compiler/src/org/eclipse/jdt/core/tests/compiler/regression/JavadocTestOptions.java;1;0;5;1;0;0;0;5;514;1;5;3283;649;649;1;0;0;5;5;3283;0;4561;5;1;
/org.eclipse.jdt.ui/ui/org/eclipse/jdt/ui/search/ElementQuerySpecification.java;3;1;4;1;4;4;4;0;12;0;0;5398;24;24;1;0;0;0;4;5398;0;6334;4;3;
/org.eclipse.swt/Eclipse SWT/gtk1x/org/eclipse/swt/graphics/Region.java;1;0;1;1;0;0;0;1;0;0;1;2327;0;0;1;0;0;1;1;2327;0;2327;1;1;
/org.eclipse.ant.ui/Ant Editor/org/eclipse/ant/internal/ui/editor/outline/FilterPropertiesAction.java;1;0;2;1;1;1;1;1;4;0;1;3663;4;4;1;0;0;1;2;3663;0;6336;2;1;
/org.eclipse.jdt.core.tests.model/workspace/Formatter/test234/A_in.java;1;0;1;1;0;0;0;1;0;0;1;2437;0;0;1;0;0;1;1;2437;0;2437;1;1;
/org.eclipse.jdt.ui.tests.refactoring/resources/ChangeTypeRefactoring/positive/A_testFieldDeclSubtypesOfList_out.java;1;0;1;1;0;0;0;1;0;0;1;2844;0;0;1;0;0;1;1;2844;0;2844;1;1;
/org.eclipse.ant.ui/Ant Tools Support/org/eclipse/ant/internal/ui/launchConfigurations/AntBuildTab.java;2;2;6;2;6;5;6;0;13;0;0;5602;22;22;2;0;1;0;6;5602;1;6336;5;2;
/org.eclipse.jdt.core.tests.model/workspace/Converter/test0234/Test.java;1;0;1;1;0;0;0;1;0;0;1;3714;0;0;1;0;0;1;1;3714;0;3714;1;1;
/org.eclipse.help.ui/src/org/eclipse/help/ui/internal/AppserverPreferencePage.java;1;1;7;1;3;3;3;4;57;1;4;1844;137;137;1;0;0;4;7;1844;0;6337;7;1;
/org.eclipse.core.runtime.osgi/src/org/eclipse/core/runtime/ProgressMonitorWrapper.java;1;0;2;1;0;0;0;2;262;1;2;3013;262;262;1;0;0;2;2;3013;0;3030;2;1;
/org.eclipse.jdt.core/model/org/eclipse/jdt/core/IMethod.java;3;0;5;1;0;0;0;5;57;1;5;88;88;88;1;0;0;5;5;88;0;5022;5;3;
/org.eclipse.jdt.core/model/org/eclipse/jdt/internal/core/util/EnclosingMethodAttribute.java;1;0;1;1;0;0;0;1;0;0;1;3791;0;0;1;0;0;1;1;3791;0;3791;1;1;
/org.eclipse.jdt.core.tests.model/workspace/Converter/test0021/Test.java;1;0;1;1;0;0;0;1;0;0;1;3714;0;0;1;0;0;1;1;3714;0;3714;1;1;
/org.eclipse.team.ui/src/org/eclipse/team/ui/synchronize/subscribers/SubscriberActionContribution.java;1;0;1;1;0;0;0;1;0;0;1;5043;0;0;1;0;0;1;1;5043;0;5043;1;1;
/org.eclipse.jdt.core/search/org/eclipse/jdt/internal/core/index/impl/LRUCache.java;1;0;3;1;0;0;0;3;6;1;3;1252;8;8;1;0;0;3;3;1252;0;4060;3;1;
/org.eclipse.team.cvs.ui/src/org/eclipse/team/internal/ccvs/ui/operations/ITagOperation.java;2;0;4;1;1;1;1;3;5;1;3;994;11;11;1;0;0;3;4;994;0;6337;4;2;
/org.eclipse.jdt.core.tests.model/workspace/Converter/src/test0076/Test.java;1;0;1;1;0;0;0;1;0;0;1;3714;0;0;1;0;0;1;1;3714;0;3714;1;1;
/org.eclipse.core.resources/src/org/eclipse/core/resources/refresh/IRefreshMonitor.java;2;0;2;1;0;0;0;2;5;1;2;3681;9;9;1;0;0;2;2;3681;0;5066;2;2;
/org.eclipse.pde.core/src/org/eclipse/pde/core/plugin/IPluginBase.java;3;1;11;1;4;4;4;7;120;1;7;2184;343;343;1;0;0;7;11;2184;0;6336;11;3;
/org.eclipse.ui.views/src/org/eclipse/ui/views/markers/internal/MarkerRegistry.java;2;0;3;1;0;0;0;3;32;1;3;755;32;32;1;0;0;3;3;755;0;2738;3;2;
/org.eclipse.jdt.ui.tests.refactoring/resources/DeleteSourceReferenceEdit/A_test6_out.java;1;0;1;1;0;0;0;1;0;0;1;1652;0;0;1;0;0;1;1;1652;0;1652;1;1;
/org.eclipse.jdt.core.tests.model/workspace/Converter/test0334/Test.java;1;0;1;1;0;0;0;1;0;0;1;3714;0;0;1;0;0;1;1;3714;0;3714;1;1;
/org.eclipse.update/src/org/eclipse/update/internal/core/ISessionDefiner.java;1;0;1;1;1;1;1;0;0;0;0;6339;0;0;1;0;0;0;1;6339;0;6339;1;1;
/org.eclipse.core.runtime/src/org/eclipse/core/runtime/IStatus.java;3;1;8;1;2;2;2;6;342;1;6;698;765;765;1;0;0;6;8;698;0;6267;8;3;
/org.eclipse.ui.workbench/Eclipse UI/org/eclipse/ui/internal/DetachedWindow.java;5;2;12;2;7;6;7;5;367;1;5;3828;446;446;2;0;1;5;12;5206;1;6338;11;5;
/org.eclipse.jface.text/src/org/eclipse/jface/text/rules/IRule.java;1;0;1;1;1;1;1;0;2;0;0;6340;2;2;1;0;0;0;1;6340;0;6340;1;1;
/org.eclipse.ui.workbench/Eclipse UI/org/eclipse/ui/internal/NewWorkbenchWindowLayout.java;1;0;1;1;0;0;0;1;0;0;1;2708;0;0;1;0;0;1;1;2708;0;2708;1;1;
/org.eclipse.jdt.core.tests.model/workspace/Formatter/test380/A_out.java;1;0;1;1;0;0;0;1;0;0;1;3148;0;0;1;0;0;1;1;3148;0;3148;1;1;
/org.eclipse.jdt.ui/core extension/org/eclipse/jdt/internal/corext/dom/fragments/SimpleExpressionFragment.java;1;0;1;1;1;1;1;0;2;0;0;6340;2;2;1;0;0;0;1;6340;0;6340;1;1;
/org.eclipse.jdt.core.tests.model/src/org/eclipse/jdt/core/tests/model/CompletionTests_1_5.java;1;0;1;1;0;0;0;1;0;0;1;5010;0;0;1;0;0;1;1;5010;0;5010;1;1;
/org.eclipse.jdt.ui.tests.refactoring/resources/InlineMethodWorkspace/TestCases/call_out/TestStatementWithFunction2.java;1;0;2;1;0;0;0;2;2;1;2;788;4;4;1;0;0;2;2;788;0;845;2;1;
/org.eclipse.jdt.core.tests.model/workspace/Formatter/test367/A_out.java;1;0;1;1;0;0;0;1;0;0;1;3128;0;0;1;0;0;1;1;3128;0;3128;1;1;
/org.eclipse.ui.workbench/Eclipse UI/org/eclipse/ui/internal/dialogs/ViewsPreferencePage.java;7;2;24;4;5;4;5;19;357;4;15;1858;1386;1386;4;4;1;19;24;4112;5;6338;19;7;
/org.eclipse.jdt.ui/ui refactoring/org/eclipse/jdt/internal/ui/refactoring/RefactoringWizardDescriptor.java;1;0;2;1;0;0;0;2;0;1;2;1047;0;0;1;0;0;2;2;1047;0;1709;2;1;
/org.eclipse.ui.ide/src/org/eclipse/ui/internal/dialogs/ProjectCapabilitySimpleAddWizard.java;2;0;3;1;0;0;0;3;8;1;3;1526;8;8;1;0;0;3;3;1526;0;2263;3;2;
/org.eclipse.core.tests.resources/src/org/eclipse/core/tests/internal/builders/MultiProjectBuildTest.java;2;0;4;1;2;1;2;2;431;1;2;1098;530;530;2;0;1;2;4;5147;1;5147;3;2;
/org.eclipse.core.tests.runtime/src/org/eclipse/core/tests/internal/plugins/PluginResolveTest_18.java;1;0;1;1;0;0;0;1;0;0;1;3014;0;0;1;0;0;1;1;3014;0;3014;1;1;
/org.eclipse.jdt.core/search/org/eclipse/jdt/internal/core/search/IndexQueryRequestor.java;1;0;2;1;0;0;0;2;2;1;2;3211;2;2;1;0;0;2;2;3211;0;3560;2;1;
/org.eclipse.ui.workbench/Eclipse UI/org/eclipse/ui/internal/activities/ActivityServiceEvent.java;1;0;2;1;0;0;0;2;0;1;2;2491;0;0;1;0;0;2;2;2491;0;2728;2;1;
/org.eclipse.swt/Eclipse SWT/gtk/org/eclipse/swt/widgets/FontDialog.java;4;1;10;2;2;2;2;8;46;3;4;166;107;107;3;4;0;8;10;166;4;6352;6;4;
/org.eclipse.jdt.core.tests.model/workspace/Formatter/test489/A_in.java;1;0;1;1;1;1;1;0;0;0;0;5188;0;0;1;0;0;0;1;5188;0;5188;1;1;
/org.eclipse.team.tests.cvs.core/src/org/eclipse/team/tests/ccvs/core/EclipseCVSClient.java;1;0;1;1;0;0;0;1;2;0;1;2043;2;2;1;0;0;1;1;2043;0;2043;1;1;
/org.eclipse.team.ui/src/org/eclipse/team/ui/synchronize/SyncInfoDiffViewerSyncViewConfiguration.java;1;0;1;1;0;0;0;1;0;0;1;3617;0;0;1;0;0;1;1;3617;0;3617;1;1;
/org.eclipse.compare/compare/org/eclipse/compare/internal/patch/Hunk.java;1;0;2;1;0;0;0;2;10;1;2;659;12;12;1;0;0;2;2;659;0;3938;2;1;
/org.eclipse.osgi/core/framework/org/eclipse/osgi/framework/internal/core/Bundle.java;6;0;25;3;3;1;3;22;2434;2;21;3013;4536;4536;3;1;2;22;25;5106;3;5106;22;6;
/org.eclipse.text/src/org/eclipse/jface/text/templates/SimpleTemplateVariableResolver.java;3;1;3;1;3;3;3;0;6;0;0;5177;8;8;1;0;0;0;3;5177;0;6340;3;3;
/org.eclipse.team.ui/src/org/eclipse/team/ui/synchronize/actions/OrSyncInfoFilter.java;1;0;1;1;0;0;0;1;0;0;1;2535;0;0;1;0;0;1;1;2535;0;2535;1;1;
/org.eclipse.jdt.core.tests.model/workspace/Formatter/test387/A_out.java;1;0;1;1;0;0;0;1;0;0;1;3169;0;0;1;0;0;1;1;3169;0;3169;1;1;
/org.eclipse.jdt.ui.tests.refactoring/resources/Paste/testPastingTypedResources2/out/A.java;1;0;2;1;0;0;0;2;1;1;2;1646;1;1;1;0;0;2;2;1646;0;1670;2;1;
/org.eclipse.jdt.core/model/org/eclipse/jdt/internal/core/WorkingCopyElementInfo.java;1;0;4;1;0;0;0;4;62;2;3;130;82;82;2;1;0;4;4;818;1;878;3;1;
/org.eclipse.jdt.ui.tests.refactoring/resources/DeleteSourceReference/test3/out/A.java;1;0;1;1;0;0;0;1;0;0;1;1652;0;0;1;0;0;1;1;1652;0;1652;1;1;
/org.eclipse.help/src/org/eclipse/help/internal/browser/MozillaFactory.java;1;0;1;1;0;0;0;1;0;0;1;2732;0;0;1;0;0;1;1;2732;0;2732;1;1;
/org.eclipse.core.runtime/src/org/eclipse/core/runtime/preferences/IEclipsePreferences.java;2;2;15;1;4;2;4;11;92;1;11;4033;368;368;2;0;2;11;15;5572;2;6340;13;2;
/org.eclipse.releng.tools/src/org/eclipse/releng/tools/JavaFile.java;1;1;2;1;2;2;2;0;4;0;0;5183;4;4;1;0;0;0;2;5183;0;6340;2;1;
/org.eclipse.jdt.ui/ui/org/eclipse/jdt/internal/ui/wizards/buildpaths/ExclusionPatternEntryDialog.java;2;0;2;1;0;0;0;2;5;1;2;1351;5;5;1;0;0;2;2;1351;0;4928;2;2;
/org.eclipse.jdt.ui/core refactoring/org/eclipse/jdt/internal/corext/refactoring/CollectingSearchRequestor.java;2;1;2;1;2;2;2;0;2;0;0;5375;2;2;1;0;0;0;2;5375;0;6340;2;2;
/org.eclipse.pde.ui/src/org/eclipse/pde/internal/ui/wizards/convert/PluginToBundleAction.java;1;0;2;1;0;0;0;2;0;0;1;3839;0;0;2;1;0;2;2;3839;1;3839;1;1;
/org.eclipse.jdt.ui.tests.refactoring/resources/ExtractMethodWorkSpace/ExtractMethodTests/locals_out/A_test537.java;1;0;2;1;0;0;0;2;6;1;2;130;7;7;1;0;0;2;2;130;0;844;2;1;
/org.eclipse.core.runtime.osgi/src/org/eclipse/core/runtime/registry/IRegistryChangeEvent.java;1;0;2;1;0;0;0;2;6;1;2;3013;6;6;1;0;0;2;2;3013;0;3030;2;1;
/org.eclipse.team.ui/src/org/eclipse/team/ui/synchronize/actions/SyncInfoChangeTypeFilter.java;1;0;1;1;0;0;0;1;0;0;1;2535;0;0;1;0;0;1;1;2535;0;2535;1;1;
/org.eclipse.ui.tests/Eclipse UI Tests/org/eclipse/ui/tests/dialogs/UIAutomatedSuite.java;1;0;1;1;0;0;0;1;3;0;1;2007;3;3;1;0;0;1;1;2007;0;2007;1;1;
/org.eclipse.swt/Eclipse SWT/motif/org/eclipse/swt/widgets/List.java;4;1;15;2;3;3;3;12;115;2;10;110;320;320;2;2;0;12;15;268;2;6352;13;4;
/org.eclipse.jdt.core.tests.compiler/src/org/eclipse/jdt/core/tests/compiler/regression/JavadocTestForInterface.java;1;0;6;1;0;0;0;6;32;1;6;2887;58;58;1;0;0;6;6;2887;0;4561;6;1;
/org.eclipse.update.ui/src/org/eclipse/update/internal/ui/parts/AboutInfo.java;2;0;2;1;0;0;0;2;24;1;2;890;24;24;1;0;0;2;2;890;0;4658;2;2;
/org.eclipse.jdt.ui.tests.refactoring/test cases/org/eclipse/jdt/ui/tests/refactoring/RenameFieldTests.java;1;0;1;1;1;1;1;0;2;0;0;6340;2;2;1;0;0;0;1;6340;0;6340;1;1;
/org.eclipse.jdt.core.tests.compiler/src/org/eclipse/jdt/core/tests/eval/SanityTestEvaluationResult.java;1;0;3;1;0;0;0;3;4;1;3;241;8;8;1;0;0;3;3;241;0;3560;3;1;
/org.eclipse.ui.workbench/Eclipse UI/org/eclipse/ui/dialogs/PropertyDialogAction.java;1;0;1;1;1;1;1;0;267;0;0;5464;267;267;1;0;0;0;1;5464;0;5464;1;1;
/org.eclipse.jdt.ui.tests.refactoring/resources/IntroduceFactory/positive/MultiUnit1C_in.java;1;0;2;1;1;1;1;1;2;0;1;2862;2;2;1;0;0;1;2;2862;0;5659;2;1;
/org.eclipse.team.core/src/org/eclipse/team/core/subscribers/ISyncInfoSetChangeListener.java;1;0;1;1;0;0;0;1;0;0;1;3966;0;0;1;0;0;1;1;3966;0;3966;1;1;
/org.eclipse.core.boot/src/org/eclipse/core/internal/boot/ResourceEnumeration.java;1;0;1;1;0;0;0;1;0;0;1;3013;0;0;1;0;0;1;1;3013;0;3013;1;1;
/org.eclipse.update.core/src/org/eclipse/update/internal/core/SiteStatusAnalyzer.java;2;1;10;1;3;3;3;7;64;1;7;890;224;224;1;0;0;7;10;890;0;6336;10;2;
/org.eclipse.jface.text/src/org/eclipse/jface/text/source/ITagHandler.java;1;0;4;1;1;1;1;3;9;1;3;1629;11;11;1;0;0;3;4;1629;0;5122;4;1;
/org.eclipse.ant.ui/Ant Editor/org/eclipse/ant/ui/internal/editor/AntEditorException.java;1;0;2;1;0;0;0;2;0;1;2;250;0;0;1;0;0;2;2;250;0;1811;2;1;
/org.eclipse.core.resources/src/org/eclipse/core/internal/events/ResourceChangeListenerList.java;2;2;4;1;4;2;4;0;315;0;0;5146;480;480;2;0;2;0;4;5146;2;5688;2;2;
/org.eclipse.update.core/src/org/eclipse/update/internal/api/search/VersionedIdentifiersFilter.java;1;0;2;1;0;0;0;2;0;1;2;3270;0;0;1;0;0;2;2;3270;0;4928;2;1;
/org.eclipse.pde.ui/sandbox/org/eclipse/pde/internal/ui/editor/standalone/text/XMLWhitespaceDetector.java;1;0;2;1;0;0;0;2;0;1;2;2320;0;0;1;0;0;2;2;2320;0;2906;2;1;
/org.eclipse.ui.workbench/Eclipse UI/org/eclipse/ui/internal/roles/ExtensionRoleRegistry.java;1;0;4;1;0;0;0;4;108;1;4;2444;132;132;1;0;0;4;4;2444;0;2864;4;1;
/org.eclipse.ui.workbench/Eclipse UI/org/eclipse/ui/activities/IActivityPatternBinding.java;3;1;5;1;2;2;2;3;10;1;3;2896;25;25;1;0;0;3;5;2896;0;6338;5;3;
/org.eclipse.swt.opengl.examples/src/org/eclipse/swt/opengl/examples/NurbTab.java;1;0;1;1;0;0;0;1;0;0;1;1175;0;0;1;0;0;1;1;1175;0;1175;1;1;
/org.eclipse.ui.examples.javaeditor/Eclipse Java Editor Example/org/eclipse/ui/examples/javaeditor/spelling/ISpellChecker.java;1;0;1;1;0;0;0;1;0;0;1;2565;0;0;1;0;0;1;1;2565;0;2565;1;1;
/org.eclipse.pde.build/src/org/eclipse/pde/internal/build/builder/IClasspathComputer.java;2;0;3;1;1;1;1;2;19;1;2;4175;21;21;1;0;0;2;3;4175;0;5145;3;2;
/org.eclipse.jdt.core.tests.model/workspace/Converter/src/test0182/Test.java;1;0;1;1;0;0;0;1;0;0;1;3714;0;0;1;0;0;1;1;3714;0;3714;1;1;
/org.eclipse.team.ui/src/org/eclipse/team/internal/ui/synchronize/ICompareContainer.java;1;0;1;1;1;1;1;0;0;0;0;5138;0;0;1;0;0;0;1;5138;0;5138;1;1;
/org.eclipse.ui.ide/src/org/eclipse/ui/internal/ide/dialogs/ProductInfoDialog.java;3;0;3;1;1;1;1;2;34;1;2;2264;34;34;1;0;0;2;3;2264;0;5483;3;3;
/org.eclipse.jdt.ui/ui/org/eclipse/jdt/internal/ui/jarpackager/IJarPackageWizardPage.java;1;0;1;1;1;1;1;0;2;0;0;6340;2;2;1;0;0;0;1;6340;0;6340;1;1;
/org.eclipse.jdt.ui.tests.refactoring/resources/InlineMethodWorkspace/TestCases/nameconflict_out/TestSameLocal.java;1;0;1;1;0;0;0;1;4;0;1;845;4;4;1;0;0;1;1;845;0;845;1;1;
/org.eclipse.pde.build/src/org/eclipse/pde/internal/build/ant/FileSet.java;2;1;7;1;2;2;2;5;88;1;5;447;453;453;1;0;0;5;7;447;0;6340;7;2;
/org.eclipse.jdt.ui.tests/ui/org/eclipse/jdt/ui/tests/browsing/PackagesViewContentProviderTests.java;2;1;3;1;2;2;2;1;29;0;1;1647;42;42;1;0;0;1;3;1647;0;6340;3;2;
/org.eclipse.team.cvs.ui/src/org/eclipse/team/internal/ccvs/ui/merge/MergeWizardStartPage.java;1;0;2;1;0;0;0;2;2;1;2;992;3;3;1;0;0;2;2;992;0;2632;2;1;
/org.eclipse.ui.workbench/Eclipse UI/org/eclipse/ui/internal/commands/CommandService.java;2;0;5;1;0;0;0;5;33;2;4;2562;40;40;2;1;0;5;5;2562;1;4144;4;2;
/org.eclipse.jdt.ui/ui/org/eclipse/jdt/internal/ui/text/comment/IJavaDocAttributes.java;1;0;4;1;0;0;0;4;32;1;4;1998;41;41;1;0;0;4;4;1998;0;2310;4;1;
/org.eclipse.text/src/org/eclipse/jface/text/templates/TextTemplateMessages.java;2;1;2;1;2;2;2;0;2;0;0;5304;2;2;1;0;0;0;2;5304;0;6340;2;2;
/org.eclipse.jdt.core.tests.model/workspace/Converter/src/javadoc/test108/Test.java;1;0;1;1;0;0;0;1;0;0;1;4390;0;0;1;0;0;1;1;4390;0;4390;1;1;
/org.eclipse.jdt.ui/core refactoring/org/eclipse/jdt/internal/corext/refactoring/rename/RenamePrivateMethodRefactoring.java;2;0;5;1;0;0;0;5;22;1;5;122;38;38;1;0;0;5;5;122;0;1125;5;2;
/org.eclipse.update.ui/srcnew/org/eclipse/update/internal/ui/views/InstallationHistoryAction.java;3;0;5;2;0;0;0;5;47;1;5;744;51;51;1;0;0;5;5;744;0;825;5;3;
/org.eclipse.swt/Eclipse SWT PI/win32/org/eclipse/swt/internal/ole/win32/COSERVERINFO.java;1;0;1;1;0;0;0;1;1;0;1;2915;1;1;1;0;0;1;1;2915;0;2915;1;1;
/org.eclipse.ui.workbench/Eclipse UI/org/eclipse/ui/internal/handles/Handle.java;1;0;8;1;0;0;0;8;21;2;7;1294;56;56;2;1;0;8;8;1629;1;1724;7;1;
/org.eclipse.swt/Eclipse SWT/carbon/org/eclipse/swt/widgets/List.java;5;1;30;2;8;8;8;22;125;2;19;110;582;582;2;3;0;22;30;2400;3;6352;27;5;
/org.eclipse.ui.ide/src/org/eclipse/ui/wizards/datatransfer/WizardZipFileImportPage1.java;1;0;1;1;0;0;0;1;0;0;1;1511;0;0;1;0;0;1;1;1511;0;1511;1;1;
/org.eclipse.ui.externaltools/Ant Editor/org/eclipse/ui/externaltools/internal/ant/dtd/schema/SchemaFactory.java;1;0;1;1;0;0;0;1;0;0;1;282;0;0;1;0;0;1;1;282;0;282;1;1;
/org.eclipse.core.resources/src/org/eclipse/core/internal/resources/ResourceException.java;1;0;1;1;1;1;1;0;119;0;0;5146;119;119;1;0;0;0;1;5146;0;5146;1;1;
/org.eclipse.jface/src/org/eclipse/jface/util/ListenerList.java;2;0;2;1;1;1;1;1;4;0;1;4113;6;6;1;0;0;1;2;4113;0;6338;2;2;
/org.eclipse.help.base/src/org/eclipse/help/internal/standalone/Eclipse.java;1;2;7;1;4;3;4;3;44;1;3;1740;126;126;2;0;1;3;7;5594;1;6337;6;1;
/org.eclipse.jdt.core/model/org/eclipse/jdt/core/CompletionProposal.java;3;0;10;2;1;1;1;9;84;2;7;4843;127;127;2;2;0;9;10;4995;2;5916;8;3;
/org.eclipse.jdt.ui.tests.refactoring/resources/MoveInstanceMethod/canMove/test17/out/Rectangle.java;1;0;1;1;0;0;0;1;0;0;1;1570;0;0;1;0;0;1;1;1570;0;1570;1;1;
/org.eclipse.help.ui.win32/src/org/eclipse/help/ui/internal/browser/win32/IDocumentCompleteListener.java;1;0;1;1;0;0;0;1;0;0;1;1710;0;0;1;0;0;1;1;1710;0;1710;1;1;
/org.eclipse.pde.ui/src/org/eclipse/pde/internal/ui/feature/BuildSiteAction.java;1;0;5;1;0;0;0;5;271;1;5;2311;450;450;1;0;0;5;5;2311;0;3840;5;1;
/org.eclipse.jdt.ui.tests.refactoring/resources/PromoteTempToField/canPromote/A_test20_out.java;1;0;1;1;0;0;0;1;0;0;1;3576;0;0;1;0;0;1;1;3576;0;3576;1;1;
/org.eclipse.jface/src/org/eclipse/jface/viewers/IPostSelectionProvider.java;1;0;1;1;0;0;0;1;0;0;1;1076;0;0;1;0;0;1;1;1076;0;1076;1;1;
/org.eclipse.jdt.core.tests.model/workspace/Converter/src/javadoc/testBug51226/X3.java;1;0;1;1;0;0;0;1;0;0;1;3899;0;0;1;0;0;1;1;3899;0;3899;1;1;
/org.eclipse.ui.intro/src/org/eclipse/ui/intro/internal/model/AbstractBaseIntroElement.java;1;0;2;1;1;1;1;1;0;0;1;4948;0;0;1;0;0;1;2;4948;0;5115;2;1;
/org.eclipse.ui.tests/Eclipse UI Tests/org/eclipse/ui/tests/propertysheet/PropertySheetAuto.java;1;0;1;1;0;0;0;1;9;0;1;3091;9;9;1;0;0;1;1;3091;0;3091;1;1;
/org.eclipse.jdt.ui.tests.refactoring/resources/Paste/test2/in/A.java;1;0;1;1;0;0;0;1;0;0;1;1311;0;0;1;0;0;1;1;1311;0;1311;1;1;
/org.eclipse.swt/Eclipse SWT PI/gtk1x/org/eclipse/swt/internal/gtk/GdkColor.java;1;0;1;1;0;0;0;1;0;0;1;2327;0;0;1;0;0;1;1;2327;0;2327;1;1;
/org.eclipse.help/src/org/eclipse/help/internal/toc/DirectoryToc.java;1;1;7;1;3;3;3;4;107;1;4;2732;250;250;1;0;0;4;7;2732;0;6337;7;1;
/org.eclipse.help.tests/src/org/eclipse/help/tests/appserver/AllHelpAppserverTests.java;1;1;2;1;2;2;2;0;16;0;0;5827;32;32;1;0;0;0;2;5827;0;6337;2;1;
/org.eclipse.jdt.junit/src/org/eclipse/jdt/internal/junit/launcher/JUnitLaunchShortcut.java;2;1;10;1;4;4;4;6;31;1;6;1624;90;90;1;0;0;6;10;1624;0;6340;10;2;
/org.eclipse.update.ui.forms/src/org/eclipse/ui/forms/internal/parts/HyperlinkSegment.java;1;0;3;1;0;0;0;3;51;1;3;2898;51;51;1;0;0;3;3;2898;0;3096;3;1;
/org.eclipse.jdt.core.tests.model/workspace/Converter/src/test0376/A.java;1;0;1;1;0;0;0;1;0;0;1;3714;0;0;1;0;0;1;1;3714;0;3714;1;1;
/org.eclipse.ui.workbench/Eclipse UI/org/eclipse/ui/internal/ide/IDEApplication.java;1;0;1;1;0;0;0;1;0;0;1;1259;0;0;1;0;0;1;1;1259;0;1259;1;1;
/org.eclipse.swt/Eclipse SWT PI/carbon/org/eclipse/swt/internal/carbon/ColorPickerInfo.java;1;2;3;1;3;2;3;0;16;0;0;5534;20;20;2;0;1;0;3;5534;1;5614;2;1;
/org.eclipse.jdt.core.tests.compiler/src/org/eclipse/jdt/core/tests/eval/target/CodeSnippetClassLoader.java;2;0;2;1;1;1;1;1;38;0;1;3560;40;40;1;0;0;1;2;3560;0;5853;2;2;
/org.eclipse.update.core/src/org/eclipse/update/internal/core/SiteTypeFactory.java;2;1;4;1;2;2;2;2;13;1;2;890;23;23;1;0;0;2;4;890;0;6336;4;2;
/org.eclipse.jdt.core.tests.model/workspace/Converter/test0197/Test.java;1;0;1;1;0;0;0;1;0;0;1;3714;0;0;1;0;0;1;1;3714;0;3714;1;1;
/org.eclipse.team.examples.filesystem/src/org/eclipse/team/examples/filesystem/ui/SynchronizeWizard.java;1;1;2;1;2;2;2;0;2;0;0;6103;2;2;1;0;0;0;2;6103;0;6337;2;1;
/org.eclipse.jdt.core/dom/org/eclipse/jdt/core/dom/rewrite/ASTRewrite.java;3;2;9;2;5;4;5;4;110;2;3;4802;294;294;2;1;1;4;9;4802;2;5404;7;3;
/org.eclipse.jdt.debug.ui/ui/org/eclipse/jdt/internal/debug/core/refactoring/JavaExceptionBreakpointTypeChange.java;2;1;3;1;3;3;3;0;8;0;0;5319;16;16;1;0;0;0;3;5319;0;6339;3;2;
/org.eclipse.jdt.core.tests.model/workspace/Converter/test0269/Test.java;1;0;1;1;0;0;0;1;0;0;1;3714;0;0;1;0;0;1;1;3714;0;3714;1;1;
/org.eclipse.debug.ui/ui/org/eclipse/debug/internal/ui/views/variables/VariablesContentProvidersToggleAction.java;2;0;4;2;0;0;0;4;6;2;3;670;6;6;2;1;0;4;4;689;1;861;3;2;
/org.eclipse.ui.workbench/Eclipse UI/org/eclipse/ui/internal/presentations/ProxyControl.java;1;1;2;1;2;2;2;0;12;0;0;5263;12;12;1;0;0;0;2;5263;0;5492;2;1;
/org.eclipse.ui.workbench/Eclipse UI/org/eclipse/ui/SelectionEnabler.java;4;0;6;2;3;1;3;3;414;1;3;1774;455;455;3;0;2;3;6;6338;2;6338;4;4;
/org.eclipse.ui.workbench.texteditor/src/org/eclipse/ui/texteditor/templates/TemplateVariableProcessor.java;3;2;5;2;4;3;4;1;8;0;1;4627;20;20;2;0;1;1;5;6334;1;6334;4;3;
/org.eclipse.ui.workbench/Eclipse UI/org/eclipse/ui/internal/progress/ErrorNotificationManager.java;1;1;3;1;2;2;2;1;17;0;1;3477;34;34;1;0;0;1;3;3477;0;5595;3;1;
/org.eclipse.jdt.ui/core extension/org/eclipse/jdt/internal/corext/dom/ASTNodeConstants.java;1;0;4;1;0;0;0;4;254;1;4;2505;437;437;1;0;0;4;4;2505;0;4439;4;1;
/org.eclipse.pde.ui/src_Forms/org/eclipse/pde/internal/ui/neweditor/NullUndoManager.java;2;0;2;1;1;1;1;1;0;0;1;4832;0;0;1;0;0;1;2;4832;0;5431;2;2;
/org.eclipse.compare/compare/org/eclipse/compare/internal/patch/Diff.java;1;0;2;1;0;0;0;2;2;1;2;1289;4;4;1;0;0;2;2;1289;0;3938;2;1;
/org.eclipse.ant.ui/Ant Editor/org/eclipse/ant/ui/internal/editor/text/NotifyingReconciler.java;1;0;2;1;0;0;0;2;0;1;2;250;0;0;1;0;0;2;2;250;0;1811;2;1;
/org.eclipse.ui.workbench/Eclipse UI/org/eclipse/ui/internal/registry/PropertyPagesRegistryReader.java;4;0;4;1;1;1;1;3;6;1;3;2861;14;14;1;0;0;3;4;2861;0;6338;4;4;
/org.eclipse.pde.core/src_OSGi/org/eclipse/pde/internal/core/bundle/Bundle.java;1;0;2;1;0;0;0;2;0;1;2;2193;0;0;1;0;0;2;2;2193;0;2229;2;1;
/org.eclipse.ui.workbench/Eclipse UI/org/eclipse/ui/IWorkbenchPartConstants.java;2;1;2;1;2;2;2;0;4;0;0;5555;4;4;1;0;0;0;2;5555;0;6338;2;2;
/org.eclipse.pde.ui/src/org/eclipse/pde/internal/ui/editor/schema/NewElementAction.java;2;1;2;1;2;2;2;0;12;0;0;5781;16;16;1;0;0;0;2;5781;0;6336;2;2;
/org.eclipse.pde.ui/src_Forms/org/eclipse/pde/internal/ui/neweditor/plugin/rows/BooleanAttributeRow.java;2;1;6;1;2;2;2;4;16;2;3;4354;24;24;2;1;0;4;6;4354;1;5431;5;2;
/org.eclipse.jdt.debug/jdi interfaces/com/sun/jdi/TypeComponent.java;1;0;1;1;0;0;0;1;3;0;1;4267;3;3;1;0;0;1;1;4267;0;4267;1;1;
/org.eclipse.core.resources/src/org/eclipse/core/internal/resources/IMarkerSetElement.java;1;0;1;1;1;1;1;0;6;0;0;5146;6;6;1;0;0;0;1;5146;0;5146;1;1;
/org.eclipse.ant.ui/Ant Editor/org/eclipse/ant/internal/ui/dtd/util/MapHolder.java;1;0;2;1;0;0;0;2;17;1;2;1811;17;17;1;0;0;2;2;1811;0;3615;2;1;
/org.eclipse.jdt.text.tests/src/org/eclipse/jdt/ui/text/tests/PartitionTokenScannerTest.java;1;1;3;1;2;2;2;1;6;0;1;5082;6;6;1;0;0;1;3;5082;0;5129;3;1;
/org.eclipse.osgi/resolver/src/org/eclipse/osgi/internal/resolver/UserState.java;3;1;6;1;3;3;3;3;54;1;3;3170;127;127;1;0;0;3;6;3170;0;5536;6;3;
/org.eclipse.jdt.core/compiler/org/eclipse/jdt/internal/compiler/ast/InnerTypeDeclaration.java;1;0;1;1;0;0;0;1;0;0;1;2974;0;0;1;0;0;1;1;2974;0;2974;1;1;
/org.eclipse.ui.workbench/Eclipse UI/org/eclipse/ui/activities/ICategory.java;3;1;10;1;2;2;2;8;94;2;7;2867;256;256;2;1;0;8;10;2896;1;6338;9;3;
/org.eclipse.jdt.core/model/org/eclipse/jdt/internal/core/builder/NameEnvironment.java;2;0;11;1;0;0;0;11;7;2;8;259;31;31;2;3;0;11;11;2046;3;4887;8;2;
/org.eclipse.core.expressions.tests/src/org/eclipse/core/internal/expressions/tests/A_TypeExtender.java;1;0;2;1;1;1;1;1;2;0;1;4108;2;2;1;0;0;1;2;4108;0;6340;2;1;
/org.eclipse.jdt.core.tests.model/workspace/Formatter/test492/Main_in.java;1;0;1;1;1;1;1;0;0;0;0;5253;0;0;1;0;0;0;1;5253;0;5253;1;1;
/org.eclipse.update.ui/src/org/eclipse/update/internal/ui/forms/MyComputerForm.java;1;0;1;1;0;0;0;1;0;0;1;755;0;0;1;0;0;1;1;755;0;755;1;1;
/org.eclipse.ui.tests/Eclipse UI Tests/org/eclipse/ui/tests/themes/ThemesTestSuite.java;1;0;1;1;0;0;0;1;0;0;1;5025;0;0;1;0;0;1;1;5025;0;5025;1;1;
/org.eclipse.update.core/src/org/eclipse/update/internal/core/FeatureTypeFactory.java;2;1;5;1;3;3;3;2;9;1;2;890;25;25;1;0;0;2;5;890;0;6336;5;2;
/org.eclipse.ui.workbench/Eclipse UI/org/eclipse/ui/internal/csm/commands/api/ICategory.java;1;0;2;1;0;0;0;2;8;1;2;2532;8;8;1;0;0;2;2;2532;0;2562;2;1;
/org.eclipse.update/src/org/eclipse/update/internal/core/UMSessionManagerOperation.java;1;0;1;1;1;1;1;0;0;0;0;6339;0;0;1;0;0;0;1;6339;0;6339;1;1;
/org.eclipse.jdt.core.tests.model/workspace/Converter/junit/extensions/ExceptionTestCase.java;1;0;1;1;0;0;0;1;0;0;1;3714;0;0;1;0;0;1;1;3714;0;3714;1;1;
/org.eclipse.pde.ui/src/org/eclipse/pde/internal/ui/wizards/extension/BaseExtensionPointMainPage.java;2;2;10;1;8;6;8;2;244;1;2;2751;613;613;2;0;2;2;10;5229;2;6336;8;2;
/org.eclipse.team.cvs.ui/src/org/eclipse/team/internal/ccvs/ui/subscriber/SubscriberCommitAction.java;2;0;14;1;1;1;1;13;305;2;12;603;720;720;2;1;0;13;14;1481;1;5508;13;2;
/org.eclipse.jdt.core/dom/org/eclipse/jdt/core/internal/dom/rewrite/RewriteEvent.java;1;0;2;1;0;0;0;2;0;1;2;4711;0;0;1;0;0;2;2;4711;0;4802;2;1;
/org.eclipse.team.ui/src/org/eclipse/team/ui/synchronize/subscriber/JobRunnableContext.java;1;0;1;1;0;0;0;1;0;0;1;4055;0;0;1;0;0;1;1;4055;0;4055;1;1;
/org.eclipse.ui.workbench/Eclipse UI/org/eclipse/ui/internal/dialogs/WelcomeEditorInputFactory.java;1;0;1;1;0;0;0;1;0;0;1;2737;0;0;1;0;0;1;1;2737;0;2737;1;1;
/org.eclipse.ui.workbench/Eclipse UI/org/eclipse/ui/internal/dialogs/PatternFilter.java;1;0;2;1;1;1;1;1;12;0;1;4968;12;12;1;0;0;1;2;4968;0;5892;2;1;
/org.eclipse.osgi/eclipseAdaptor/src/org/eclipse/core/runtime/adaptor/FileManager.java;1;0;3;1;0;0;0;3;10;1;3;4338;10;10;1;0;0;3;3;4338;0;4672;3;1;
/org.eclipse.jdt.ui.tests.refactoring/resources/ExtractMethodWorkSpace/ExtractMethodTests/expression_in/A_test608.java;1;0;2;1;0;0;0;2;6;1;2;130;8;8;1;0;0;2;2;130;0;844;2;1;
/org.eclipse.swt/Eclipse SWT Mozilla/common/org/eclipse/swt/internal/mozilla/nsIDOMUIEvent.java;2;1;2;1;2;2;2;0;2;0;0;5271;2;2;1;0;0;0;2;5271;0;6342;2;2;
/org.eclipse.pde.ui/src_Forms/org/eclipse/pde/internal/ui/neweditor/plugin/ChoiceAttributeRow.java;1;0;4;1;0;0;0;4;30;2;3;3834;30;30;2;1;0;4;4;3845;1;4354;3;1;
/org.eclipse.jdt.core.tests.model/workspace/Formatter/test367/A_in.java;1;0;1;1;0;0;0;1;0;0;1;3128;0;0;1;0;0;1;1;3128;0;3128;1;1;
/org.eclipse.jdt.ui.tests.refactoring/resources/ChangeTypeRefactoring/positive/A_testFieldUseSubtypesOfList_out.java;1;0;1;1;0;0;0;1;0;0;1;2844;0;0;1;0;0;1;1;2844;0;2844;1;1;
/org.eclipse.update.ui.forms/Eclipse Forms/org/eclipse/ui/forms/parts/Section.java;1;0;3;1;0;0;0;3;5;2;2;3116;5;5;2;1;0;3;3;3116;1;3138;2;1;
/org.eclipse.update/src/org/eclipse/update/internal/ui/JarVerifier.java;1;0;1;1;1;1;1;0;0;0;0;6339;0;0;1;0;0;0;1;6339;0;6339;1;1;
/org.eclipse.help.tests/src/org/eclipse/help/tests/webapp/TestIndexing.java;1;1;3;1;2;2;2;1;116;0;1;2732;136;136;1;0;0;1;3;2732;0;6337;3;1;
/org.eclipse.ui.externaltools/Ant Tools Support/org/eclipse/ui/externaltools/internal/ant/launchConfigurations/JavacLineTracker.java;1;0;1;1;0;0;0;1;0;0;1;282;0;0;1;0;0;1;1;282;0;282;1;1;
/org.eclipse.jdt.core.tests.model/workspace/Formatter/test091/A_in.java;1;0;1;1;0;0;0;1;0;0;1;2425;0;0;1;0;0;1;1;2425;0;2425;1;1;
/org.eclipse.team.ui/src/org/eclipse/team/ui/sync/actions/SyncInfoDirectionFilter.java;1;0;1;1;0;0;0;1;0;0;1;2405;0;0;1;0;0;1;1;2405;0;2405;1;1;
/org.eclipse.update.tests.core/src/org/eclipse/update/tests/api/TestSiteAPI.java;1;0;2;1;1;1;1;1;4;0;1;4928;8;8;1;0;0;1;2;4928;0;6336;2;1;
/org.eclipse.jdt.ui/ui/org/eclipse/jdt/internal/ui/util/ElementValidator.java;2;0;2;1;1;1;1;1;5;0;1;1386;7;7;1;0;0;1;2;1386;0;6340;2;2;
/org.eclipse.ui.workbench/Eclipse UI/org/eclipse/ui/internal/commands/older/KeySequenceBinding.java;1;0;2;1;0;0;0;2;0;0;1;2564;0;0;2;1;0;2;2;2564;1;2564;1;1;
/org.eclipse.pde.ui/src_Forms/org/eclipse/pde/internal/ui/neweditor/plugin/PluginExportAction.java;2;1;5;1;2;2;2;3;37;1;3;4537;67;67;1;0;0;3;5;4537;0;5431;5;2;
/org.eclipse.debug.ui/ui/org/eclipse/debug/internal/ui/views/registers/RegistersViewContentProvider.java;1;0;1;1;0;0;0;1;0;0;1;4348;0;0;1;0;0;1;1;4348;0;4348;1;1;
/org.eclipse.jdt.ui/ui/org/eclipse/jdt/internal/ui/actions/AbstractToggleLinkingAction.java;1;0;3;1;1;1;1;2;7;1;2;1285;9;9;1;0;0;2;3;1285;0;6340;3;1;
/org.eclipse.jdt.core.tests.model/src/org/eclipse/jdt/core/tests/model/GetSourceTests.java;2;0;6;1;0;0;0;6;78;2;5;2604;125;125;2;1;0;6;6;2684;1;3560;5;2;
/org.eclipse.ui.ide/extensions/org/eclipse/ui/actions/WorkspaceModifyDelegatingOperation.java;4;1;4;1;2;2;2;2;73;1;2;2263;77;77;1;0;0;2;4;2263;0;6338;4;4;
/org.eclipse.team.cvs.ui/src/org/eclipse/team/internal/ccvs/ui/ListSelectionArea.java;2;0;5;1;1;1;1;4;19;1;4;990;31;31;1;0;0;4;5;990;0;6337;5;2;
/org.eclipse.swt/Eclipse SWT Drag and Drop/carbon/org/eclipse/swt/dnd/TransferData.java;2;1;3;1;2;2;2;1;8;0;1;298;15;15;1;0;0;1;3;298;0;6352;3;2;
/org.eclipse.jdt.core.tests.model/workspace/Formatter/test263/A_in.java;1;0;1;1;0;0;0;1;0;0;1;2442;0;0;1;0;0;1;1;2442;0;2442;1;1;
/org.eclipse.core.resources/src/org/eclipse/core/internal/refresh/RefreshManager.java;2;1;6;1;3;3;3;3;34;1;3;3681;90;90;1;0;0;3;6;3681;0;6247;6;2;
/org.eclipse.jdt.ui.tests.refactoring/test cases/org/eclipse/jdt/ui/tests/refactoring/SefTestSetup.java;2;1;5;1;3;3;3;2;13;1;2;4575;31;31;1;0;0;2;5;4575;0;6340;5;2;
/org.eclipse.ui.ide/src/org/eclipse/ui/internal/ide/dialogs/InstallCapabilityStep.java;1;0;1;1;0;0;0;1;0;0;1;2264;0;0;1;0;0;1;1;2264;0;2264;1;1;
/org.eclipse.swt/Eclipse SWT/common/org/eclipse/swt/graphics/ImageData.java;4;1;12;1;2;2;2;10;50;4;6;0;121;121;4;4;0;10;12;4245;4;6352;8;4;
/org.eclipse.update.core/src/org/eclipse/update/internal/standalone/DisableCommand.java;2;0;13;1;0;0;0;13;49;2;12;828;114;114;2;1;0;13;13;4585;1;4928;12;2;
/org.eclipse.pde.ui/src_samples/org/eclipse/pde/ui/internal/samples/LastPage.java;1;0;2;1;0;0;0;2;0;1;2;4523;0;0;1;0;0;2;2;4523;0;4538;2;1;
/org.eclipse.pde.build/src/org/eclipse/pde/internal/build/ModelBuildScriptGenerator.java;2;0;5;1;0;0;0;5;0;1;5;447;0;0;1;0;0;5;5;447;0;1113;5;2;
/org.eclipse.update.core/srcnew/org/eclipse/update/operations/IBatchOperation.java;1;0;2;1;0;0;0;2;0;1;2;602;0;0;1;0;0;2;2;602;0;825;2;1;
/org.eclipse.jdt.core.tests.model/workspace/Converter/src/test0025/Test.java;1;0;1;1;0;0;0;1;0;0;1;3714;0;0;1;0;0;1;1;3714;0;3714;1;1;
/org.eclipse.jdt.ui/ui/org/eclipse/jdt/internal/ui/text/TypingRunDetector.java;2;1;2;1;2;2;2;0;6;0;0;5226;6;6;1;0;0;0;2;5226;0;6340;2;2;
/org.eclipse.jdt.core.tests.model/workspace/Converter/src/javadoc/testBug65253/Test.java;1;0;1;1;1;1;1;0;0;0;0;6100;0;0;1;0;0;0;1;6100;0;6100;1;1;
/org.eclipse.jface.text/src/org/eclipse/jface/text/source/LineNumberRulerColumn.java;4;1;11;1;5;5;5;6;102;1;6;1118;331;331;1;0;0;6;11;1118;0;6353;11;4;
/org.eclipse.ui.workbench.texteditor/src/org/eclipse/ui/texteditor/IncrementalFindTarget.java;1;1;8;1;2;2;2;6;84;1;6;802;153;153;1;0;0;6;8;802;0;6340;8;1;
/org.eclipse.team.tests.cvs.core/src/org/eclipse/team/tests/ccvs/ui/ICriteria.java;1;0;1;1;0;0;0;1;0;0;1;2632;0;0;1;0;0;1;1;2632;0;2632;1;1;
/org.eclipse.jdt.core.tests.model/workspace/Formatter/test121/A_in.java;1;0;1;1;0;0;0;1;0;0;1;2425;0;0;1;0;0;1;1;2425;0;2425;1;1;
/org.eclipse.ui.workbench/Eclipse UI/org/eclipse/ui/wizards/datatransfer/ZipFileExportOperation.java;2;0;2;1;0;0;0;2;34;1;2;1337;34;34;1;0;0;2;2;1337;0;2737;2;2;
/org.eclipse.jdt.core/model/org/eclipse/jdt/core/util/IBytecodeVisitor.java;1;0;1;1;0;0;0;1;2;0;1;3560;2;2;1;0;0;1;1;3560;0;3560;1;1;
/org.eclipse.ui.workbench/Eclipse UI/org/eclipse/ui/internal/contexts/Context.java;4;1;26;1;2;2;2;24;462;6;16;1220;1666;1666;6;8;0;24;26;1388;8;6338;18;4;
/org.eclipse.jdt.core/codeassist/org/eclipse/jdt/internal/codeassist/select/SelectionOnFieldType.java;2;0;2;1;0;0;0;2;4;1;2;991;6;6;1;0;0;2;2;991;0;3560;2;2;
/org.eclipse.update.core/src/org/eclipse/update/core/model/UpdateSiteParser.java;1;0;1;1;0;0;0;1;0;0;1;2634;0;0;1;0;0;1;1;2634;0;2634;1;1;
/org.eclipse.core.runtime/src/org/eclipse/core/runtime/CoreException.java;2;1;6;1;2;2;2;4;166;1;4;3013;346;346;1;0;0;4;6;3013;0;6340;6;2;
/org.eclipse.ui.ide/src/org/eclipse/ui/internal/registry/MarkerHelpRegistry.java;2;0;3;1;0;0;0;3;6;1;3;1526;6;6;1;0;0;3;3;1526;0;2263;3;2;
/org.eclipse.ui.cheatsheets/src/org/eclipse/ui/cheatsheets/IItemWithSubItems.java;1;0;2;1;0;0;0;2;0;1;2;4428;0;0;1;0;0;2;2;4428;0;4625;2;1;
/org.eclipse.jdt.core/model/org/eclipse/jdt/core/util/IModifierConstants.java;1;0;3;1;1;1;1;2;25;1;2;3560;31;31;1;0;0;2;3;3560;0;5733;3;1;
/org.eclipse.search/search/org/eclipse/search/internal/ui/text/SortAction.java;1;0;2;1;1;1;1;1;2;0;1;3711;2;2;1;0;0;1;2;3711;0;5461;2;1;
/org.eclipse.ui.workbench/Eclipse UI/org/eclipse/ui/dialogs/TwoPaneElementSelector.java;1;1;5;1;2;2;2;3;186;1;3;1;214;214;1;0;0;3;5;1;0;5464;5;1;
/org.eclipse.jdt.debug.ui/ui/org/eclipse/jdt/internal/debug/ui/DetailFormatterCompletionProcessor.java;4;0;5;1;1;1;1;4;20;1;4;1152;33;33;1;0;0;4;5;1152;0;6336;5;4;
/org.eclipse.ui.workbench/Eclipse UI/org/eclipse/ui/IEditorActionBarContributor.java;2;0;2;1;0;0;0;2;2;1;2;1;4;4;1;0;0;2;2;1;0;68;2;2;
/org.eclipse.ui.workbench/Eclipse UI/org/eclipse/ui/commands/CommandHandlerServiceEvent.java;1;0;4;1;0;0;0;4;18;1;4;3131;22;22;1;0;0;4;4;3131;0;4144;4;1;
/org.eclipse.jdt.ui.tests.refactoring/resources/ExtractMethodWorkSpace/ExtractMethodTests/semicolon_in/A_test410.java;1;0;1;1;0;0;0;1;4;0;1;844;4;4;1;0;0;1;1;844;0;844;1;1;
/org.eclipse.jdt.ui.tests.refactoring/resources/ChangeSignature/canModify/A_testImport03_out.java;1;0;1;1;0;0;0;1;0;0;1;3820;0;0;1;0;0;1;1;3820;0;3820;1;1;
/org.eclipse.jdt.core.tests.model/workspace/Converter/src/examples.oneofeach/ASTPosterChild.java;1;0;1;1;0;0;0;1;0;0;1;3714;0;0;1;0;0;1;1;3714;0;3714;1;1;
/org.eclipse.search/search/org/eclipse/search/internal/ui/RemoveResultAction.java;1;0;1;1;1;1;1;0;2;0;0;6340;2;2;1;0;0;0;1;6340;0;6340;1;1;
/org.eclipse.jdt.ui/ui/org/eclipse/jdt/internal/ui/search/WorkingSetsComparator.java;2;1;2;1;2;2;2;0;2;0;0;5396;3;3;1;0;0;0;2;5396;0;6340;2;2;
/org.eclipse.jdt.debug/jdi interfaces/com/sun/jdi/connect/spi/TransportService.java;1;0;1;1;0;0;0;1;0;0;1;4267;0;0;1;0;0;1;1;4267;0;4267;1;1;
/org.eclipse.debug.ui/ui/org/eclipse/debug/internal/ui/views/memory/EmptyRenderer.java;2;1;2;1;2;2;2;0;10;0;0;5254;10;10;1;0;0;0;2;5254;0;5364;2;2;
/org.eclipse.jdt.core.tests.model/workspace/Converter/test0463/A.java;1;0;1;1;0;0;0;1;0;0;1;3714;0;0;1;0;0;1;1;3714;0;3714;1;1;
/org.eclipse.ui.workbench/Eclipse UI/org/eclipse/ui/IPerspectiveRegistry.java;3;0;4;2;2;1;2;2;22;1;2;2737;28;28;2;0;1;2;4;6338;1;6338;3;3;
/org.eclipse.ui.externaltools/Ant Editor/org/eclipse/ui/externaltools/internal/ant/dtd/util/IMapHolder.java;1;0;1;1;0;0;0;1;0;0;1;282;0;0;1;0;0;1;1;282;0;282;1;1;
/org.eclipse.ui.workbench/Eclipse UI/org/eclipse/ui/internal/ActivityPersistanceHelper.java;3;0;6;1;1;1;1;5;188;1;5;3061;266;266;1;0;0;5;6;3061;0;6338;6;3;
/org.eclipse.pde.ui/src/org/eclipse/pde/internal/ui/editor/feature/IncludedFeaturesSection.java;3;1;10;1;4;4;4;6;117;1;6;2229;202;202;1;0;0;6;10;2229;0;6336;10;3;
/org.eclipse.swt/Eclipse SWT PI/gtk/org/eclipse/swt/internal/gtk/GtkCombo.java;3;0;3;1;1;1;1;2;17;1;2;1653;23;23;1;0;0;2;3;1653;0;6352;3;3;
/org.eclipse.team.ui/src/org/eclipse/team/ui/synchronize/SynchronizeCompareInput.java;2;0;2;1;1;1;1;1;0;0;1;4632;0;0;1;0;0;1;2;4632;0;5359;2;2;
/org.eclipse.jdt.ui.tests.refactoring/resources/MoveInstanceMethod/canMove/test17/out/Shape.java;1;0;1;1;0;0;0;1;0;0;1;1570;0;0;1;0;0;1;1;1570;0;1570;1;1;
/org.eclipse.team.ui/src/org/eclipse/team/internal/ui/dialogs/DetailsDialogWithProjects.java;1;0;4;1;0;0;0;4;115;2;3;987;124;124;2;1;0;4;4;987;1;2747;3;1;
/org.eclipse.ui.views/src/org/eclipse/ui/views/markers/internal/FieldLineNumber.java;2;0;2;1;0;0;0;2;0;1;2;755;0;0;1;0;0;2;2;755;0;2738;2;2;
/org.eclipse.debug.core/core/org/eclipse/debug/internal/core/ListenerList.java;2;1;2;1;2;2;2;0;4;0;0;6148;6;6;1;0;0;0;2;6148;0;6336;2;2;
/org.eclipse.jdt.ui/core refactoring/org/eclipse/jdt/internal/corext/refactoring/changes/DeleteFromClasspathChange.java;3;1;6;1;2;2;2;4;26;1;4;458;55;55;1;0;0;4;6;458;0;6340;6;3;
/org.eclipse.jdt.core.tests.model/workspace/Converter/src/test0075/Test.java;1;0;1;1;0;0;0;1;0;0;1;3714;0;0;1;0;0;1;1;3714;0;3714;1;1;
/org.eclipse.help.ide/src/org/eclipse/help/ui/internal/workingset/HelpWorkingSet.java;1;1;7;1;2;2;2;5;135;2;4;1738;224;224;2;1;0;5;7;1747;1;6337;6;1;
/org.eclipse.jface.text/src/org/eclipse/jface/text/templates/TemplateTranslator.java;1;0;2;1;0;0;0;2;0;0;1;4258;0;0;2;1;0;2;2;4258;1;4258;1;1;
/org.eclipse.update.ui.win32/src/org/eclipse/welcome/internal/ShowWelcomePageAction.java;1;0;1;1;0;0;0;1;0;0;1;907;0;0;1;0;0;1;1;907;0;907;1;1;
/org.eclipse.jdt.ui.tests.refactoring/resources/ExtractMethodWorkSpace/ExtractMethodTests/duplicates_in/A_test957.java;1;1;2;1;2;2;2;0;2;0;0;5650;2;2;1;0;0;0;2;5650;0;5681;2;1;
/org.eclipse.jdt.core/model/org/eclipse/jdt/internal/core/util/Disassembler.java;4;0;10;1;1;1;1;9;541;1;9;163;629;629;1;0;0;9;10;163;0;5916;10;4;
/org.eclipse.pde.ui/src/org/eclipse/pde/internal/ui/wizards/imports/FeatureImportOperation.java;2;1;4;1;2;2;2;2;115;1;2;368;137;137;1;0;0;2;4;368;0;6336;4;2;
/org.eclipse.jdt.ui.tests.refactoring/resources/ChangeSignature/canModify/A_testImport07_out.java;1;1;2;1;2;2;2;0;1;0;0;5434;1;1;1;0;0;0;2;5434;0;5612;2;1;
/org.eclipse.jdt.core.tests.model/workspace/Formatter/test081/A_in.java;1;0;1;1;0;0;0;1;0;0;1;2425;0;0;1;0;0;1;1;2425;0;2425;1;1;
/org.eclipse.search/new search/org/eclipse/search2/internal/ui/text/AnnotationHighlighter.java;1;2;6;1;6;4;6;0;43;0;0;5500;63;63;2;0;2;0;6;5500;2;6116;4;1;
/org.eclipse.jdt.core.tests.model/workspace/Converter/src/test0125/Test.java;1;0;1;1;0;0;0;1;0;0;1;3714;0;0;1;0;0;1;1;3714;0;3714;1;1;
/org.eclipse.ui.cheatsheets/src/org/eclipse/ui/internal/cheatsheets/views/ToggleableControl.java;2;0;3;1;0;0;0;3;17;1;3;4428;17;17;1;0;0;3;3;4428;0;4701;3;2;
/org.eclipse.ui.views/src/org/eclipse/ui/views/internal/markers/problems/ShowAction.java;1;0;2;1;0;0;0;2;0;1;2;536;0;0;1;0;0;2;2;536;0;749;2;1;
/org.eclipse.jdt.debug.tests/tests/org/eclipse/jdt/debug/tests/core/RemoteAttachTests.java;1;0;2;1;0;0;0;2;20;1;2;789;24;24;1;0;0;2;2;789;0;1860;2;1;
/org.eclipse.ui.workbench/Eclipse UI/org/eclipse/ui/internal/ide/AboutInfo.java;1;0;1;1;0;0;0;1;0;0;1;1259;0;0;1;0;0;1;1;1259;0;1259;1;1;
/org.eclipse.update.ui/src/org/eclipse/update/internal/ui/wizards/NewUpdatesWizardPage.java;2;0;2;1;0;0;0;2;25;1;2;550;25;25;1;0;0;2;2;550;0;755;2;2;
/org.eclipse.jdt.ui/core extension/org/eclipse/text/edits/MalformedTreeException.java;1;0;3;1;0;0;0;3;5;2;2;1953;5;5;2;1;0;3;3;1985;1;1985;2;1;
/org.eclipse.ui.workbench/Eclipse UI/org/eclipse/ui/internal/dialogs/PropertyDialog.java;4;0;8;2;0;0;0;8;118;2;6;2861;286;286;2;2;0;8;8;3008;2;3131;6;4;
/org.eclipse.jdt.ui/core refactoring/org/eclipse/jdt/internal/corext/refactoring/structure/ASTNodeMappingManager.java;1;0;2;1;0;0;0;2;2;1;2;42;2;2;1;0;0;2;2;42;0;1166;2;1;
/org.eclipse.core.resources/src/org/eclipse/core/internal/resources/NotificationJob.java;1;0;2;1;0;0;0;2;0;1;2;1915;0;0;1;0;0;2;2;1915;0;2057;2;1;
/org.eclipse.ltk.ui.refactoring.tests/src/org/eclipse/ltk/ui/refactoring/tests/EmptySuite.java;1;0;1;1;0;0;0;1;0;0;1;4845;0;0;1;0;0;1;1;4845;0;4845;1;1;
/org.eclipse.pde.ui/src/org/eclipse/pde/internal/ui/editor/manifest/BodyTextSection.java;1;0;4;1;1;1;1;3;12;1;3;368;16;16;1;0;0;3;4;368;0;5431;4;1;
/org.eclipse.team.cvs.ui/src/org/eclipse/team/internal/ccvs/ui/repo/RepositoriesView.java;2;1;8;1;4;4;4;4;47;1;4;1984;153;153;1;0;0;4;8;1984;0;6337;8;2;
/org.eclipse.core.filebuffers/src/org/eclipse/core/internal/filebuffers/JavaTextFileBuffer.java;3;2;9;1;7;6;7;2;148;1;2;2224;244;244;2;0;1;2;9;5918;1;6340;8;3;
/org.eclipse.jdt.launching/launching/org/eclipse/jdt/launching/sourcelookup/DirectorySourceLocation.java;4;0;9;2;1;1;1;8;31;2;7;811;91;91;2;1;0;8;9;811;1;6336;8;4;
/org.eclipse.jdt.ui/core refactoring/org/eclipse/jdt/internal/corext/refactoring/participants/xml/Scope.java;1;0;2;1;0;0;0;2;0;1;2;2253;0;0;1;0;0;2;2;2253;0;2682;2;1;
/org.eclipse.ui.forms/src/org/eclipse/ui/forms/HyperlinkGroup.java;1;0;4;1;1;1;1;3;10;1;3;4068;18;18;1;0;0;3;4;4068;0;6336;4;1;
/org.eclipse.ui.workbench/Eclipse UI/org/eclipse/ui/roles/CategoryManagerEvent.java;1;0;2;1;0;0;0;2;0;0;1;2864;0;0;2;1;0;2;2;2864;1;2864;1;1;
/org.eclipse.jdt.core/compiler/org/eclipse/jdt/internal/compiler/util/HashtableOfIntValues.java;2;0;2;1;0;0;0;2;26;1;2;3508;26;26;1;0;0;2;2;3508;0;4469;2;2;
/org.eclipse.ui.workbench/Eclipse UI/org/eclipse/ui/internal/presentation/FontDefinitionReader.java;1;0;2;1;0;0;0;2;0;1;2;4263;0;0;1;0;0;2;2;4263;0;4392;2;1;
/org.eclipse.jdt.core/model/org/eclipse/jdt/internal/core/OpenableElementInfo.java;1;0;3;1;0;0;0;3;3;1;3;878;7;7;1;0;0;3;3;878;0;3560;3;1;
/org.eclipse.jdt.ui/core refactoring/org/eclipse/jdt/internal/corext/refactoring/nls/PropertyFileDocumentModell.java;3;1;7;1;5;5;5;2;540;1;2;4930;723;723;1;0;0;2;7;4930;0;5375;7;3;
/org.eclipse.jdt.core.tests.model/workspace/Formatter/test189/A_in.java;1;0;1;1;0;0;0;1;0;0;1;2425;0;0;1;0;0;1;1;2425;0;2425;1;1;
/org.eclipse.ui.intro/src/org/eclipse/ui/intro/internal/presentations/BrowserIntroPartImplementation.java;1;0;9;1;1;1;1;8;444;2;6;4429;510;510;2;2;0;8;9;4724;2;5115;7;1;
/org.eclipse.ltk.ui.refactoring/src/org/eclipse/ltk/ui/refactoring/RefactoringWizardOpenOperation.java;1;1;8;1;6;6;6;2;57;0;1;5080;152;152;2;1;0;2;8;5080;1;6323;7;1;
/org.eclipse.jface/src/org/eclipse/jface/action/ExternalActionManager.java;2;1;3;1;3;3;3;0;32;0;0;5252;36;36;1;0;0;0;3;5252;0;6338;3;2;
/org.eclipse.pde.ui/src/org/eclipse/pde/internal/ui/search/ReferencesInPluginAction.java;2;1;3;1;2;2;2;1;14;0;1;2950;28;28;1;0;0;1;3;2950;0;6336;3;2;
/org.eclipse.ui.workbench/Eclipse UI/org/eclipse/ui/internal/commands/old/PropertyEvent.java;1;0;3;1;0;0;0;3;6;1;3;1223;6;6;1;0;0;3;3;1223;0;1695;3;1;
/org.eclipse.core.filebuffers/src/org/eclipse/core/filebuffers/ITextFileBufferManager.java;2;1;9;1;3;3;3;6;26;1;6;1522;133;133;1;0;0;6;9;1522;0;6340;9;2;
/org.eclipse.jdt.ui.tests.refactoring/resources/RenamePackage/testImportFromMultiRoots2/in/srcTest/p/p/TestHelper.java;1;0;2;1;0;0;0;2;7;1;2;3219;7;7;1;0;0;2;2;3219;0;4105;2;1;
/org.eclipse.jdt.ui.tests.refactoring/resources/MoveMembers/test34/in/A.java;1;0;1;1;0;0;0;1;0;0;1;1856;0;0;1;0;0;1;1;1856;0;1856;1;1;
/org.eclipse.ui.workbench/Eclipse UI/org/eclipse/ui/internal/layout/LayoutCache.java;1;0;1;1;0;0;0;1;0;0;1;5003;0;0;1;0;0;1;1;5003;0;5003;1;1;
/org.eclipse.jdt.ui.tests.refactoring/resources/InlineMethodWorkspace/TestCases/simple_in/TestBasic2.java;1;0;1;1;0;0;0;1;2;0;1;845;2;2;1;0;0;1;1;845;0;845;1;1;
/org.eclipse.team.tests.cvs.core/src/org/eclipse/team/tests/ccvs/ui/benchmark/BenchmarkTestSetup.java;1;0;1;1;0;0;0;1;0;0;1;2632;0;0;1;0;0;1;1;2632;0;2632;1;1;
/org.eclipse.jdt.ui.tests.refactoring/resources/ExtractMethodWorkSpace/ExtractMethodTests/try_in/A_test451.java;1;0;1;1;0;0;0;1;2;0;1;130;2;2;1;0;0;1;1;130;0;130;1;1;
/org.eclipse.ui.ide/src/org/eclipse/ui/internal/ide/model/WorkspaceFactory.java;3;1;3;1;2;2;2;1;2;0;1;2264;4;4;1;0;0;1;3;2264;0;6338;3;3;
/org.eclipse.jface.text/src/org/eclipse/jface/text/source/AnnotationEvent.java;2;0;2;1;1;1;1;1;0;0;1;3825;0;0;1;0;0;1;2;3825;0;5177;2;2;
/org.eclipse.search/search/org/eclipse/search/internal/ui/util/MessageLine.java;1;0;1;1;1;1;1;0;2;0;0;6340;2;2;1;0;0;0;1;6340;0;6340;1;1;
/org.eclipse.team.ui/src/org/eclipse/team/ui/controls/IHyperlinkListener.java;1;0;1;1;0;0;0;1;0;0;1;3200;0;0;1;0;0;1;1;3200;0;3200;1;1;
/org.eclipse.jdt.core.tests.model/workspace/Converter/test0107/Test.java;1;0;1;1;0;0;0;1;0;0;1;3714;0;0;1;0;0;1;1;3714;0;3714;1;1;
/org.eclipse.ui.intro/src/org/eclipse/ui/intro/internal/model/IIntroAction.java;1;0;3;1;1;1;1;2;17;1;2;4429;17;17;1;0;0;2;3;4429;0;5115;3;1;
/org.eclipse.ui.views/src/org/eclipse/ui/views/markers/internal/ActionShowOnBuild.java;2;0;2;1;0;0;0;2;0;1;2;755;0;0;1;0;0;2;2;755;0;2738;2;2;
/org.eclipse.jdt.ui/core extension/org/eclipse/jdt/internal/corext/util/IOCloser.java;1;0;1;1;1;1;1;0;2;0;0;6340;2;2;1;0;0;0;1;6340;0;6340;1;1;
/org.eclipse.jdt.ui.tests.refactoring/resources/ExtractMethodWorkSpace/ExtractMethodTests/error_out/A_test800.java;1;0;3;1;0;0;0;3;4;1;3;844;4;4;1;0;0;3;3;844;0;1474;3;1;
/org.eclipse.ui.workbench/Eclipse UI/org/eclipse/ui/internal/dialogs/WorkbenchPreferenceNode.java;5;0;8;2;1;1;1;7;148;2;6;1952;207;207;2;1;0;7;8;3061;1;6338;7;5;
/org.eclipse.pde.ui/src_Forms/org/eclipse/pde/internal/ui/model/DocumentNode.java;1;0;2;1;0;0;0;2;0;1;2;4438;0;0;1;0;0;2;2;4438;0;4552;2;1;
/org.eclipse.update.ui.forms/Eclipse Forms/org/eclipse/ui/forms/parts/HTMLTableLayout.java;1;0;2;1;0;0;0;2;0;1;2;3096;0;0;1;0;0;2;2;3096;0;3116;2;1;
/org.eclipse.swt.tests/JUnit Tests/org/eclipse/swt/tests/junit/Test_org_eclipse_swt_graphics_Point.java;1;0;1;1;0;0;0;1;8;0;1;2175;8;8;1;0;0;1;1;2175;0;2175;1;1;
/org.eclipse.jdt.ui.tests.refactoring/test cases/org/eclipse/jdt/ui/tests/refactoring/RefactoringScannerTests.java;2;0;2;1;1;1;1;1;73;0;1;4585;75;75;1;0;0;1;2;4585;0;6340;2;2;
/org.eclipse.jdt.core.tests.model/workspace/Converter/src/test0111/Test.java;1;0;1;1;0;0;0;1;0;0;1;3714;0;0;1;0;0;1;1;3714;0;3714;1;1;
/org.eclipse.jdt.ui/core extension/org/eclipse/jdt/internal/corext/dom/ASTWithExistingFlattener.java;2;0;7;1;0;0;0;7;100;1;7;802;168;168;1;0;0;7;7;802;0;1558;7;2;
/org.eclipse.jdt.core.tests.model/workspace/Formatter/test248/A_out.java;1;0;1;1;0;0;0;1;0;0;1;2442;0;0;1;0;0;1;1;2442;0;2442;1;1;
/org.eclipse.ui.examples.javaeditor/Eclipse Java Editor Example/org/eclipse/ui/examples/javaeditor/JavaDocumentProvider.java;1;0;1;1;0;0;0;1;0;0;1;1581;0;0;1;0;0;1;1;1581;0;1581;1;1;
/org.eclipse.update.core/src/org/eclipse/update/core/model/InstallHandlerEntry.java;1;0;1;1;0;0;0;1;0;0;1;2634;0;0;1;0;0;1;1;2634;0;2634;1;1;
/org.eclipse.osgi/resolver/src/org/eclipse/osgi/internal/resolver/StateReader.java;4;1;12;1;5;5;5;7;39;1;7;3013;113;113;1;0;0;7;12;3013;0;5536;12;4;
/org.eclipse.jdt.core.tests.compiler/src/org/eclipse/jdt/core/tests/compiler/regression/ConstantTest.java;3;0;5;1;1;1;1;4;126;1;4;1785;139;139;1;0;0;4;5;1785;0;6336;5;3;
/org.eclipse.ui.examples.job/org/eclipse/ui/examples/jobs/actions/ForegroundAction.java;1;0;2;1;2;1;2;0;0;0;0;5125;0;0;2;0;1;0;2;5125;1;5125;1;1;
/org.eclipse.jdt.core.tests.model/workspace/Converter/test0321/Test.java;1;0;1;1;0;0;0;1;0;0;1;3714;0;0;1;0;0;1;1;3714;0;3714;1;1;
/org.eclipse.debug.ui/ui/org/eclipse/debug/ui/launchVariables/ContainerNameExpander.java;1;0;2;1;0;0;0;2;0;1;2;550;0;0;1;0;0;2;2;550;0;562;2;1;
/org.eclipse.team.core/src/org/eclipse/team/core/sync/ILocalSyncElement.java;1;0;1;1;0;0;0;1;0;0;1;4217;0;0;1;0;0;1;1;4217;0;4217;1;1;
/org.eclipse.compare.examples.xml/src/org/eclipse/compare/examples/xml/XMLStructureViewer.java;1;0;6;1;1;1;1;5;397;1;5;1106;450;450;1;0;0;5;6;1106;0;5918;6;1;
/org.eclipse.team.ui/src/org/eclipse/team/ui/synchronize/TeamSubscriberPageDiffTreeViewerConfiguration.java;1;0;1;1;0;0;0;1;0;0;1;3796;0;0;1;0;0;1;1;3796;0;3796;1;1;
/org.eclipse.jdt.core/compiler/org/eclipse/jdt/internal/compiler/lookup/BindingIds.java;1;0;1;1;0;0;0;1;2;0;1;3560;2;2;1;0;0;1;1;3560;0;3560;1;1;
/org.eclipse.jdt.ui/core refactoring/org/eclipse/jdt/internal/corext/refactoring/participants/xml/LRUCache.java;1;0;2;1;0;0;0;2;0;1;2;2546;0;0;1;0;0;2;2;2546;0;4091;2;1;
/org.eclipse.debug.core/core/org/eclipse/debug/core/DebugPlugin.java;5;1;37;2;7;7;7;30;111;2;28;151;922;922;2;2;0;30;37;617;2;5803;35;5;
/org.eclipse.ui.workbench/Eclipse UI/org/eclipse/ui/internal/activities/ui/CategoryLabelProvider.java;2;0;4;2;0;0;0;4;34;2;2;2864;47;47;2;2;0;4;4;2864;2;3061;2;2;
/org.eclipse.swt/Eclipse SWT PI/win32/org/eclipse/swt/internal/Platform.java;1;0;1;1;0;0;0;1;0;0;1;1969;0;0;1;0;0;1;1;1969;0;1969;1;1;
/org.eclipse.jdt.ui/core extension/org/eclipse/jdt/internal/corext/userlibrary/IClasspathContainerComparator.java;1;0;2;1;1;1;1;1;0;0;1;5051;0;0;1;0;0;1;2;5051;0;5226;2;1;
/org.eclipse.ui.workbench/Eclipse UI/org/eclipse/ui/internal/commands/CategoryDefinition.java;2;0;14;1;1;1;1;13;103;5;8;1389;305;305;5;5;0;13;14;1389;5;6338;9;2;
/org.eclipse.ui.views/src/org/eclipse/ui/views/bookmarkexplorer/BookmarkSorter.java;1;0;1;1;0;0;0;1;0;0;1;2738;0;0;1;0;0;1;1;2738;0;2738;1;1;
/org.eclipse.jdt.ui/core refactoring/org/eclipse/jdt/internal/corext/refactoring/changes/DeletePackageFragmentRootChange.java;2;1;3;1;2;2;2;1;15;0;1;3930;25;25;1;0;0;1;3;3930;0;6340;3;2;
/org.eclipse.ui.workbench/Eclipse UI/org/eclipse/ui/commands/internal/SequenceBinding.java;1;0;2;1;0;0;0;2;0;1;2;786;0;0;1;0;0;2;2;786;0;956;2;1;
/org.eclipse.jdt.ui/ui/org/eclipse/jdt/internal/ui/text/java/ParameterGuesser.java;4;3;13;3;4;2;4;9;165;2;8;1214;534;534;3;1;2;9;13;5177;3;6340;10;4;
/org.eclipse.jdt.ui.tests.refactoring/resources/ExtractMethodWorkSpace/ExtractMethodTests/return_in/A_test725.java;1;0;1;1;0;0;0;1;2;0;1;844;2;2;1;0;0;1;1;844;0;844;1;1;
/org.eclipse.core.runtime/src/org/eclipse/core/internal/boot/PlatformURLConnection.java;4;1;8;1;3;3;3;5;954;1;5;3049;1062;1062;1;0;0;5;8;3049;0;5543;8;4;
/org.eclipse.ui.tests/Eclipse UI Tests/org/eclipse/ui/tests/dialogs/UIInteractiveSuite.java;1;0;1;1;0;0;0;1;3;0;1;2007;3;3;1;0;0;1;1;2007;0;2007;1;1;
/org.eclipse.releng.basebuilder/plugins/org.eclipse.build.tools/org.eclipse.build.tools/src/org/eclipse/releng/VersionNumberStripper.java;1;0;1;1;1;1;1;0;0;0;0;5735;0;0;1;0;0;0;1;5735;0;5735;1;1;
/org.eclipse.ui.workbench/Eclipse UI/org/eclipse/ui/internal/model/AdaptableList.java;1;0;1;1;0;0;0;1;0;0;1;2737;0;0;1;0;0;1;1;2737;0;2737;1;1;
/org.eclipse.jdt.ui/ui/org/eclipse/jdt/internal/ui/dialogs/MainTypeSelectionDialog.java;1;0;1;1;1;1;1;0;2;0;0;6340;2;2;1;0;0;0;1;6340;0;6340;1;1;
/org.eclipse.jdt.core.tests.model/workspace/Converter/test0230/Test.java;1;0;1;1;0;0;0;1;0;0;1;3714;0;0;1;0;0;1;1;3714;0;3714;1;1;
/org.eclipse.help.ui.win32/src/org/eclipse/help/ui/internal/browser/win32/WebBrowser.java;1;0;1;1;0;0;0;1;0;0;1;1710;0;0;1;0;0;1;1;1710;0;1710;1;1;
/org.eclipse.team.ui/src/org/eclipse/team/internal/ui/jobs/IRefreshSubscriberListener.java;1;0;1;1;0;0;0;1;0;0;1;3402;0;0;1;0;0;1;1;3402;0;3402;1;1;
/org.eclipse.ui.ide/src/org/eclipse/ui/internal/ide/roles/IDERoleManager.java;2;0;3;1;0;0;0;3;179;1;3;2264;179;179;1;0;0;3;3;2264;0;2707;3;2;
/org.eclipse.jdt.ui.tests.refactoring/resources/ChangeSignature/canModify/A_testException02_out.java;1;0;1;1;0;0;0;1;0;0;1;4045;0;0;1;0;0;1;1;4045;0;4045;1;1;
/org.eclipse.ui.workbench/Eclipse UI/org/eclipse/ui/internal/commands/older/Match.java;1;0;2;1;0;0;0;2;0;0;1;2562;0;0;2;1;0;2;2;2562;1;2562;1;1;
/org.eclipse.jdt.text.tests/src/org/eclipse/jdt/text/tests/comments/CommentsTestSuite.java;1;1;2;1;2;2;2;0;2;0;0;5129;2;2;1;0;0;0;2;5129;0;6340;2;1;
/org.eclipse.team.ui/src/org/eclipse/team/internal/ui/synchronize/views/SyncViewerTableSorter.java;1;0;3;1;0;0;0;3;158;1;3;2535;158;158;1;0;0;3;3;2535;0;4216;3;1;
/org.eclipse.jdt.core.tests.model/workspace/Completion/src/CompletionAfterSwitch.java;1;0;1;1;0;0;0;1;0;0;1;3041;0;0;1;0;0;1;1;3041;0;3041;1;1;
/org.eclipse.ui.workbench/Eclipse UI/org/eclipse/ui/internal/commands/old/NotActiveException.java;1;0;2;1;0;0;0;2;0;1;2;1430;0;0;1;0;0;2;2;1430;0;1695;2;1;
/org.eclipse.core.expressions/src/org/eclipse/core/internal/expressions/ResolveExpression.java;1;0;3;1;1;1;1;2;8;1;2;4108;10;10;1;0;0;2;3;4108;0;6340;3;1;
/org.eclipse.ltk.ui.refactoring/src/org/eclipse/ltk/ui/refactoring/TextStatusContextViewer.java;1;1;4;1;3;3;3;1;8;0;1;5052;17;17;1;0;0;1;4;5052;0;6340;4;1;
/org.eclipse.team.ui/src/org/eclipse/team/internal/ui/widgets/HyperlinkAdapter.java;1;0;1;1;0;0;0;1;0;0;1;3200;0;0;1;0;0;1;1;3200;0;3200;1;1;
/org.eclipse.jdt.core.tests.model/workspace/Formatter/test177/A_out.java;1;0;1;1;0;0;0;1;0;0;1;2425;0;0;1;0;0;1;1;2425;0;2425;1;1;
/org.eclipse.jdt.core.tests.model/workspace/Resolve/src/ResolveEndOfFile.java;1;0;1;1;0;0;0;1;0;0;1;4993;0;0;1;0;0;1;1;4993;0;4993;1;1;
/org.eclipse.team.cvs.ui/src/org/eclipse/team/internal/ccvs/ui/console/ConsoleDocument.java;2;1;4;1;2;2;2;2;110;1;2;4609;122;122;1;0;0;2;4;4609;0;6337;4;2;
/org.eclipse.ui.externaltools/Ant Tools Support/org/eclipse/ui/externaltools/internal/ant/launchConfigurations/TargetTableLabelProvider.java;1;0;1;1;0;0;0;1;0;0;1;282;0;0;1;0;0;1;1;282;0;282;1;1;
/org.eclipse.jdt.ui.tests.refactoring/test cases/org/eclipse/jdt/ui/tests/refactoring/NullRefactoring.java;2;0;6;1;1;1;1;5;21;1;5;3536;41;41;1;0;0;5;6;3536;0;6340;6;2;
/org.eclipse.swt.tests/JUnit Tests/org/eclipse/swt/tests/junit/Test_org_eclipse_swt_browser_StatusTextListener.java;1;0;2;1;0;0;0;2;12;1;2;2104;12;12;1;0;0;2;2;2104;0;2863;2;1;
/org.eclipse.ui.workbench/Eclipse UI/org/eclipse/ui/internal/roles/api/IRoleManagerEvent.java;1;0;2;1;0;0;0;2;0;0;1;2202;0;0;2;1;0;2;2;2202;1;2202;1;1;
/org.eclipse.ui.ide/src/org/eclipse/ui/IResourceActionFilter.java;1;0;2;1;0;0;0;2;0;1;2;1514;0;0;1;0;0;2;2;1514;0;2263;2;1;
/org.eclipse.ui.workbench/Eclipse UI/org/eclipse/ui/wizards/datatransfer/FileSystemExporter.java;1;0;1;1;0;0;0;1;0;0;1;2737;0;0;1;0;0;1;1;2737;0;2737;1;1;
/org.eclipse.ui.forms/src/org/eclipse/ui/forms/IDetailsPage.java;1;0;5;1;1;1;1;4;79;2;3;4068;87;87;2;1;0;4;5;4284;1;6336;4;1;
/org.eclipse.ui.workbench/Eclipse UI/org/eclipse/ui/internal/commands/CaptureEvent.java;1;0;6;1;0;0;0;6;4;1;6;607;6;6;1;0;0;6;6;607;0;1695;6;1;
/org.eclipse.swt.tests/JUnit Tests/org/eclipse/swt/tests/junit/Test_org_eclipse_swt_events_FocusAdapter.java;1;0;1;1;0;0;0;1;16;0;1;2175;16;16;1;0;0;1;1;2175;0;2175;1;1;
/org.eclipse.ui.workbench/Eclipse UI/org/eclipse/ui/internal/activities/ActivationService.java;1;0;3;1;0;0;0;3;2;2;2;2728;2;2;2;1;0;3;3;2728;1;2800;2;1;
/org.eclipse.ant.ui/Ant Editor/org/eclipse/ant/ui/internal/dtd/schema/NfmParser.java;1;0;5;1;0;0;0;5;5;2;4;250;8;8;2;1;0;5;5;1276;1;1811;4;1;
/org.eclipse.ui.workbench/Eclipse UI/org/eclipse/ui/internal/layout/CacheWrapper.java;2;1;2;1;2;2;2;0;10;0;0;5452;10;10;1;0;0;0;2;5452;0;5899;2;2;
/org.eclipse.pde.ui/src/org/eclipse/pde/internal/ui/view/FileAdapterPropertySource.java;2;1;2;1;2;2;2;0;24;0;0;5783;28;28;1;0;0;0;2;5783;0;6336;2;2;
/org.eclipse.ui.views/src/org/eclipse/ui/views/framelist/FrameListMessages.java;1;0;1;1;0;0;0;1;0;0;1;2738;0;0;1;0;0;1;1;2738;0;2738;1;1;
/org.eclipse.ui.externaltools/Ant Editor/org/eclipse/ui/externaltools/internal/ant/editor/text/AntEditorPartitionScanner.java;1;0;2;1;0;0;0;2;0;1;2;178;0;0;1;0;0;2;2;178;0;282;2;1;
/org.eclipse.jface.text/src/org/eclipse/jface/text/link/ProposalPosition.java;2;1;6;1;3;3;3;3;30;1;3;4214;53;53;1;0;0;3;6;4214;0;6340;6;2;
/org.eclipse.jdt.ui.tests.refactoring/resources/RenameVirtualMethodInClass/test39/in/A.java;1;0;1;1;1;1;1;0;0;0;0;5524;0;0;1;0;0;0;1;5524;0;5524;1;1;
/org.eclipse.jdt.ui.tests.refactoring/test cases/org/eclipse/jdt/ui/tests/actions/PasteResourcesFromClipboardActionTest.java;1;0;2;1;0;0;0;2;17;1;2;469;27;27;1;0;0;2;2;469;0;1111;2;1;
/org.eclipse.team.tests.cvs.core/src/org/eclipse/team/tests/ccvs/core/cvsresources/ResourceSyncBytesTest.java;2;0;3;1;1;1;1;2;3;1;2;2043;7;7;1;0;0;2;3;2043;0;6337;3;2;
/org.eclipse.swt/Eclipse SWT PI/gtk1x/org/eclipse/swt/internal/gtk/GtkCombo.java;1;0;1;1;0;0;0;1;0;0;1;2327;0;0;1;0;0;1;1;2327;0;2327;1;1;
/org.eclipse.webdav/src/client/org/eclipse/webdav/client/ResponseInputStream.java;1;0;1;1;1;1;1;0;57;0;0;5151;57;57;1;0;0;0;1;5151;0;5151;1;1;
/org.eclipse.jdt.core.tests.model/workspace/Formatter/test225/A_in.java;1;0;1;1;0;0;0;1;0;0;1;2426;0;0;1;0;0;1;1;2426;0;2426;1;1;
/org.eclipse.swt.tests/JUnit Tests/org/eclipse/swt/tests/junit/Test_org_eclipse_swt_graphics_FontMetrics.java;2;0;2;1;0;0;0;2;13;1;2;2175;16;16;1;0;0;2;2;2175;0;2227;2;2;
/org.eclipse.ui.views/src/org/eclipse/ui/views/markers/internal/TableContentProvider.java;2;0;2;1;0;0;0;2;0;1;2;755;0;0;1;0;0;2;2;755;0;2738;2;2;
/org.eclipse.jdt.ui.tests.refactoring/resources/DeleteSourceReferenceEdit/A_test1_in.java;1;0;1;1;0;0;0;1;0;0;1;1652;0;0;1;0;0;1;1;1652;0;1652;1;1;
/org.eclipse.ui.workbench/Eclipse UI/org/eclipse/ui/commands/IImageBinding.java;2;0;9;1;1;1;1;8;30;2;6;1239;84;84;2;2;0;8;9;1239;2;5231;7;2;
/org.eclipse.jdt.ui/ui/org/eclipse/jdt/internal/ui/text/comment/ILinkTagConstants.java;1;0;3;1;0;0;0;3;7;1;3;1998;7;7;1;0;0;3;3;1998;0;3829;3;1;
/org.eclipse.ui.workbench/Eclipse UI/org/eclipse/ui/internal/handles/api/NotDefinedException.java;1;0;2;1;0;0;0;2;0;1;2;1507;0;0;1;0;0;2;2;1507;0;1724;2;1;
/org.eclipse.jdt.ui/ui/org/eclipse/jdt/internal/ui/search/JavaElementLineSorter.java;1;0;1;1;0;0;0;1;0;0;1;4888;0;0;1;0;0;1;1;4888;0;4888;1;1;
/org.eclipse.jdt.core/compiler/org/eclipse/jdt/internal/compiler/parser/RecoveredType.java;4;0;9;1;1;1;1;8;50;1;8;488;129;129;1;0;0;8;9;488;0;5405;9;4;
/org.eclipse.jdt.core.tests.model/workspace/Resolve/src/ResolveLocalConstructorDeclaration.java;1;0;1;1;0;0;0;1;0;0;1;1970;0;0;1;0;0;1;1;1970;0;1970;1;1;
/org.eclipse.ui.workbench/Eclipse UI/org/eclipse/ui/activities/CategoryEvent.java;3;1;10;2;2;2;2;8;35;2;7;2867;125;125;2;1;0;8;10;4651;1;6338;9;3;
/org.eclipse.ui.workbench/Eclipse UI/org/eclipse/ui/internal/commands/util/old/CaptureListener.java;1;0;2;1;0;0;0;2;0;1;2;1222;0;0;1;0;0;2;2;1222;0;1322;2;1;
/org.eclipse.ui.editors/src/org/eclipse/ui/internal/editors/quickdiff/ReferenceProviderDescriptor.java;2;0;3;1;0;0;0;3;14;1;3;1118;14;14;1;0;0;3;3;1118;0;1644;3;2;
/org.eclipse.osgi/osgi/src/org/osgi/service/packageadmin/ProvidingBundle.java;1;1;2;1;2;2;2;0;4;0;0;5536;4;4;1;0;0;0;2;5536;0;5590;2;1;
/org.eclipse.jface.text/src/org/eclipse/jface/text/templates/InclusivePositionUpdater.java;2;1;3;1;3;3;3;0;6;0;0;5177;11;11;1;0;0;0;3;5177;0;6340;3;2;
/org.eclipse.jdt.ui.tests.refactoring/test cases/org/eclipse/jdt/ui/tests/refactoring/PromoteTempToFieldTests.java;5;1;13;1;2;2;2;11;20;1;11;130;115;115;1;0;0;11;13;130;0;6340;13;5;
/org.eclipse.jdt.core.tests.model/workspace/Converter/src/test0322/Test.java;1;0;1;1;0;0;0;1;0;0;1;3714;0;0;1;0;0;1;1;3714;0;3714;1;1;
/org.eclipse.jdt.ui/core extension/org/eclipse/jdt/internal/corext/codemanipulation/AddUnimplementedMethodsOperation.java;2;0;7;1;1;1;1;6;21;1;6;576;44;44;1;0;0;6;7;576;0;6340;7;2;
/org.eclipse.ui.workbench/Eclipse UI/org/eclipse/ui/internal/csm/commands/ICommandPatternBindingDefinition.java;1;0;2;1;0;0;0;2;0;1;2;2515;0;0;1;0;0;2;2;2515;0;2532;2;1;
/org.eclipse.jdt.ui/ui/org/eclipse/jdt/internal/ui/util/SWTUtil.java;3;0;3;1;1;1;1;2;14;1;2;1446;20;20;1;0;0;2;3;1446;0;6340;3;3;
/org.eclipse.help.ui.win32/src/org/eclipse/help/ui/internal/browser/win32/IEStore.java;1;0;1;1;0;0;0;1;0;0;1;2898;0;0;1;0;0;1;1;2898;0;2898;1;1;
/org.eclipse.ui.ide/src/org/eclipse/ui/internal/ide/dialogs/WelcomeEditorActionContributor.java;1;0;1;1;0;0;0;1;0;0;1;2264;0;0;1;0;0;1;1;2264;0;2264;1;1;
/org.eclipse.jdt.core.tests.model/workspace/Formatter/test402/A_in.java;1;0;1;1;0;0;0;1;0;0;1;3436;0;0;1;0;0;1;1;3436;0;3436;1;1;
/org.eclipse.jdt.ui/core refactoring/org/eclipse/jdt/internal/corext/refactoring/reorg2/ParentChecker.java;1;0;5;1;0;0;0;5;54;1;5;469;70;70;1;0;0;5;5;469;0;1114;5;1;
/org.eclipse.team.ui/src/org/eclipse/team/internal/ui/sync/views/SyncSetDirectionFilter.java;1;0;1;1;0;0;0;1;0;0;1;488;0;0;1;0;0;1;1;488;0;488;1;1;
/org.eclipse.team.examples.filesystem/src/org/eclipse/team/examples/filesystem/ui/SynchronizeAction.java;1;0;1;1;1;1;1;0;0;0;0;6206;0;0;1;0;0;0;1;6206;0;6206;1;1;
/org.eclipse.ui.workbench/Eclipse UI/org/eclipse/ui/internal/dialogs/FakeAction.java;1;0;1;1;0;0;0;1;0;0;1;830;0;0;1;0;0;1;1;830;0;830;1;1;
/org.eclipse.ui.console/src/org/eclipse/ui/internal/console/ConsolePluginImages.java;1;0;3;1;1;1;1;2;10;1;2;1988;18;18;1;0;0;2;3;1988;0;5475;3;1;
/org.eclipse.debug.ui/ui/org/eclipse/debug/ui/actions/ContextualLaunchAction.java;1;2;4;1;4;3;4;0;5;0;0;5496;8;8;2;0;1;0;4;5508;1;5682;3;1;
/org.eclipse.update.core/src/org/eclipse/update/internal/operations/FeatureOperation.java;1;1;9;1;2;2;2;7;58;1;7;825;128;128;1;0;0;7;9;825;0;6336;9;1;
/org.eclipse.ui.externaltools/Ant Editor/org/eclipse/ui/externaltools/internal/ant/editor/outline/AntEditorContentOutlinePage.java;1;0;3;1;0;0;0;3;5;1;3;178;5;5;1;0;0;3;3;178;0;282;3;1;
/org.eclipse.jdt.ui.tests.refactoring/resources/ChangeTypeRefactoring/negative/A_testArray_out.java;1;0;1;1;0;0;0;1;0;0;1;2844;0;0;1;0;0;1;1;2844;0;2844;1;1;
/org.eclipse.pde.ui/src/org/eclipse/pde/internal/ui/editor/build/BuildEditorContributor.java;2;1;4;1;3;3;3;1;19;0;1;1768;45;45;1;0;0;1;4;1768;0;6336;4;2;
/org.eclipse.team.tests.cvs.core/src/org/eclipse/team/tests/ccvs/ui/logformatter/PrintTextDiffVisitor.java;1;0;1;1;0;0;0;1;0;0;1;2632;0;0;1;0;0;1;1;2632;0;2632;1;1;
/org.eclipse.team.cvs.core/src/org/eclipse/team/internal/ccvs/core/client/listeners/AnnotateListener.java;2;1;6;1;2;2;2;4;27;1;4;784;60;60;1;0;0;4;6;784;0;6337;6;2;
/org.eclipse.ui.workbench/Eclipse UI/org/eclipse/ui/internal/commands/AbstractRegistry.java;1;0;8;1;0;0;0;8;42;2;7;607;112;112;2;1;0;8;8;1389;1;1389;7;1;
/org.eclipse.jdt.ui.tests.refactoring/resources/MoveInstanceMethod/cannotMove/testFail12/in/A.java;1;0;1;1;0;0;0;1;0;0;1;1184;0;0;1;0;0;1;1;1184;0;1184;1;1;
/org.eclipse.pde.ui/src/org/eclipse/pde/internal/ui/editor/site/SiteOutlinePage.java;1;0;2;1;0;0;0;2;7;1;2;368;7;7;1;0;0;2;2;368;0;2311;2;1;
/org.eclipse.team.core/src/org/eclipse/team/core/subscribers/SyncInfo.java;2;0;7;1;0;0;0;7;346;1;7;649;403;403;1;0;0;7;7;649;0;4216;7;2;
/org.eclipse.releng.tests/src/org/eclipse/releng/tests/BuildTests.java;2;2;41;1;11;9;11;30;51;2;26;57;223;223;2;4;2;30;41;2743;6;6300;35;2;
/org.eclipse.ui.workbench/Eclipse UI/org/eclipse/ui/keys/KeySequence.java;3;1;29;2;2;2;2;27;326;3;21;1294;1221;1221;3;6;0;27;29;2202;6;6338;23;3;
/org.eclipse.swt.tests/JUnit Tests/org/eclipse/swt/tests/junit/Test_org_eclipse_swt_custom_StyledText.java;7;0;13;1;1;1;1;12;102;2;10;97;366;366;2;2;0;12;13;2227;2;6352;11;7;
/org.eclipse.ui.ide/src/org/eclipse/ui/internal/dialogs/RemoveCapabilityStep.java;2;0;3;1;0;0;0;3;16;1;3;1526;16;16;1;0;0;3;3;1526;0;2263;3;2;
/org.eclipse.jface.text/src/org/eclipse/jface/text/source/ISourceViewerExtension.java;2;1;3;1;2;2;2;1;23;0;1;4689;27;27;1;0;0;1;3;4689;0;6361;3;2;
/org.eclipse.ui.tests/Eclipse UI Tests/org/eclipse/ui/tests/adaptable/AdaptableTestSuite.java;2;0;2;1;1;1;1;1;2;0;1;4245;3;3;1;0;0;1;2;4245;0;6338;2;2;
/org.eclipse.swt/Eclipse SWT/gtk/org/eclipse/swt/widgets/ColorDialog.java;2;1;3;1;2;2;2;1;4;0;1;4128;10;10;1;0;0;1;3;4128;0;6352;3;2;
/org.eclipse.team.webdav/src/org/eclipse/team/ui/target/SiteSelectionPage.java;1;0;1;1;0;0;0;1;0;0;1;3461;0;0;1;0;0;1;1;3461;0;3461;1;1;
/org.eclipse.swt/Eclipse SWT Drag and Drop/motif/org/eclipse/swt/dnd/Clipboard.java;3;1;8;1;2;2;2;6;207;1;6;0;318;318;1;0;0;6;8;0;0;6352;8;3;
/org.eclipse.jdt.ui/ui/org/eclipse/jdt/internal/ui/text/spelling/engine/IPhoneticDistanceAlgorithm.java;2;0;2;1;1;1;1;1;2;0;1;3930;2;2;1;0;0;1;2;3930;0;6340;2;2;
/org.eclipse.team.cvs.ui/src/org/eclipse/team/internal/ccvs/ui/actions/CheckoutAsAction.java;1;0;5;1;0;0;0;5;336;1;5;809;390;390;1;0;0;5;5;809;0;4969;5;1;
/org.eclipse.jdt.core/search/org/eclipse/jdt/core/search/IJavaSearchConstants.java;2;1;6;1;2;2;2;4;6;1;4;277;19;19;1;0;0;4;6;277;0;5676;6;2;
/org.eclipse.team.cvs.ui/src/org/eclipse/team/internal/ccvs/ui/subscriber/CVSSubscriberPage.java;1;0;1;1;0;0;0;1;0;0;1;2433;0;0;1;0;0;1;1;2433;0;2433;1;1;
/org.eclipse.ui.intro/src/org/eclipse/ui/internal/intro/impl/swt/PageFormWithNavigation.java;1;0;1;1;1;1;1;0;0;0;0;6280;0;0;1;0;0;0;1;6280;0;6280;1;1;
/org.eclipse.pde.ui/src_Forms/org/eclipse/pde/internal/ui/neweditor/build/JARFileFilter.java;2;0;4;1;1;1;1;3;21;1;3;4406;31;31;1;0;0;3;4;4406;0;5431;4;2;
/org.eclipse.update.ui.forms/Eclipse Forms/org/eclipse/ui/forms/internal/parts/RichTextModel.java;1;0;2;1;0;0;0;2;0;1;2;3096;0;0;1;0;0;2;2;3096;0;3138;2;1;
/org.eclipse.swt.tools/JNI Generation/org/eclipse/swt/tools/internal/FieldData.java;1;0;1;1;0;0;0;1;0;0;1;4175;0;0;1;0;0;1;1;4175;0;4175;1;1;
/org.eclipse.ui.views/src/org/eclipse/ui/views/internal/markers/ProblemView.java;1;0;2;1;0;0;0;2;0;0;1;749;0;0;2;1;0;2;2;749;1;749;1;1;
/org.eclipse.jdt.core.tests.model/workspace/Formatter/test220/A_in.java;1;0;1;1;0;0;0;1;0;0;1;2426;0;0;1;0;0;1;1;2426;0;2426;1;1;
/org.eclipse.jdt.core/antadapter/org/eclipse/jdt/internal/antadapter/Util.java;3;0;3;1;0;0;0;3;1;1;3;547;1;1;1;0;0;3;3;547;0;3194;3;3;
/org.eclipse.jdt.debug.ui/ui/org/eclipse/jdt/internal/debug/core/refactoring/LaunchConfigurationIPackageFragmentRenameParticipant.java;3;1;7;1;2;2;2;5;28;1;5;4498;83;83;1;0;0;5;7;4498;0;6339;7;3;
/org.eclipse.pde.core/src/org/eclipse/pde/core/plugin/IPluginElement.java;3;2;7;1;5;4;5;2;72;1;2;4203;114;114;2;0;1;2;7;5211;1;6336;6;3;
/org.eclipse.team.core/src/org/eclipse/team/core/subscribers/SyncTreeSubscriber.java;1;0;1;1;0;0;0;1;0;0;1;649;0;0;1;0;0;1;1;649;0;649;1;1;
/org.eclipse.ui.workbench/Eclipse UI/org/eclipse/ui/internal/presentations/NativeStackPresentation.java;6;2;16;2;7;6;7;9;35;2;7;4469;128;128;2;2;1;9;16;4569;3;6227;13;6;
/org.eclipse.ui.workbench/Eclipse UI/org/eclipse/ui/internal/ShortcutBarPartDragDrop.java;1;0;1;1;0;0;0;1;0;0;1;4015;0;0;1;0;0;1;1;4015;0;4015;1;1;
/org.eclipse.jdt.ui/core refactoring/org/eclipse/jdt/internal/corext/refactoring/util/DebugUtils.java;1;0;1;1;0;0;0;1;0;0;1;344;0;0;1;0;0;1;1;344;0;344;1;1;
/org.eclipse.ui.ide/extensions/org/eclipse/ui/dialogs/FileSelectionDialog.java;1;0;1;1;0;0;0;1;0;0;1;2263;0;0;1;0;0;1;1;2263;0;2263;1;1;
/org.eclipse.ui.workbench/Eclipse UI/org/eclipse/ui/internal/dialogs/WorkbenchEditorsDialog.java;6;1;7;1;2;2;2;5;95;1;5;121;215;215;1;0;0;5;7;121;0;6338;7;6;
/org.eclipse.swt/Eclipse SWT/photon/org/eclipse/swt/widgets/Combo.java;5;2;10;1;5;4;5;5;43;1;5;110;113;113;2;0;1;5;10;5897;1;6352;9;5;
/org.eclipse.ui.examples.propertysheet/Eclipse UI Examples PropertySheet/org/eclipse/ui/examples/propertysheet/GroupElement.java;1;0;1;1;0;0;0;1;14;0;1;4071;14;14;1;0;0;1;1;4071;0;4071;1;1;
/org.eclipse.swt/Eclipse SWT/win32/org/eclipse/swt/widgets/ProgressBar.java;3;0;5;1;1;1;1;4;42;2;3;2708;70;70;2;1;0;4;5;4735;1;6352;4;3;
/org.eclipse.ui.workbench/Eclipse UI/org/eclipse/ui/contexts/ContextManagerFactory.java;2;0;5;1;0;0;0;5;32;2;4;3066;35;35;2;1;0;5;5;4927;1;4949;4;2;
/org.eclipse.jdt.core/model/org/eclipse/jdt/core/IElementChangedListener.java;1;0;1;1;0;0;0;1;2;0;1;3560;2;2;1;0;0;1;1;3560;0;3560;1;1;
/org.eclipse.text/projection/org/eclipse/jface/text/ProjectionPosition.java;1;0;3;1;1;1;1;2;4;1;2;3217;7;7;1;0;0;2;3;3217;0;5177;3;1;
/org.eclipse.core.resources/src/org/eclipse/core/internal/localstore/HistoryStoreEntry.java;1;0;1;1;1;1;1;0;281;0;0;5146;281;281;1;0;0;0;1;5146;0;5146;1;1;
/org.eclipse.ui.workbench/Eclipse UI/org/eclipse/ui/part/Page.java;2;0;2;1;1;1;1;1;2;0;1;4873;4;4;1;0;0;1;2;4873;0;6338;2;2;
/org.eclipse.ui.externaltools/Ant Editor/org/eclipse/ui/externaltools/internal/ant/dtd/util/SortedMapFactory.java;1;0;1;1;0;0;0;1;0;0;1;282;0;0;1;0;0;1;1;282;0;282;1;1;
/org.eclipse.jdt.core.tests.model/workspace/Formatter/test112/A_out.java;1;0;1;1;0;0;0;1;0;0;1;2425;0;0;1;0;0;1;1;2425;0;2425;1;1;
/org.eclipse.webdav/src/client/org/eclipse/webdav/http/client/BufferPool.java;1;0;2;1;2;1;2;0;77;0;0;5151;77;77;2;0;1;0;2;5151;1;5151;1;1;
/org.eclipse.jdt.core.tests.model/workspace/Completion/src/CompletionStaticMethodDeclaration1.java;1;0;1;1;0;0;0;1;0;0;1;3039;0;0;1;0;0;1;1;3039;0;3039;1;1;
/org.eclipse.jdt.debug.tests/test plugin/org/eclipse/jdt/debug/testplugin/ValueVariableInitializer.java;2;0;2;1;0;0;0;2;4;1;2;2032;4;4;1;0;0;2;2;2032;0;2514;2;2;
/org.eclipse.swt/Eclipse SWT PI/carbon/org/eclipse/swt/internal/carbon/PixMap.java;1;2;3;1;3;2;3;0;16;0;0;5534;20;20;2;0;1;0;3;5534;1;5614;2;1;
/org.eclipse.ui.workbench/Eclipse UI/org/eclipse/ui/internal/progress/ProgressContributionItem.java;1;0;3;1;0;0;0;3;45;1;3;320;45;45;1;0;0;3;3;320;0;958;3;1;
/org.eclipse.jdt.core.tests.model/workspace/Converter/test0292/Test.java;1;0;1;1;0;0;0;1;0;0;1;3714;0;0;1;0;0;1;1;3714;0;3714;1;1;
/org.eclipse.ui.workbench/Eclipse UI/org/eclipse/ui/contexts/IContextActivationServiceListener.java;2;0;6;1;0;0;0;6;16;1;6;1220;25;25;1;0;0;6;6;1220;0;4144;6;2;
/org.eclipse.pde.ui/src/org/eclipse/pde/internal/ui/PDELabelProvider.java;3;3;14;2;8;6;8;6;57;1;6;1111;145;145;3;0;2;6;14;5431;2;6336;12;3;
/org.eclipse.team.tests.cvs.core/src/org/eclipse/team/tests/ccvs/ui/logformatter/MergeRunsVisitor.java;1;0;1;1;0;0;0;1;0;0;1;2632;0;0;1;0;0;1;1;2632;0;2632;1;1;
/org.eclipse.ui.workbench/Eclipse UI/org/eclipse/ui/internal/EditorActionBuilder.java;1;0;1;1;0;0;0;1;2;0;1;618;2;2;1;0;0;1;1;618;0;618;1;1;
/org.eclipse.core.resources/src/org/eclipse/core/internal/indexing/SpaceMapPage.java;1;0;1;1;1;1;1;0;49;0;0;5146;49;49;1;0;0;0;1;5146;0;5146;1;1;
/org.eclipse.jdt.core/compiler/org/eclipse/jdt/internal/compiler/ast/AnnotationArraySingleTypeReference.java;1;0;3;1;0;0;0;3;4;1;3;2397;4;4;1;0;0;3;3;2397;0;2887;3;1;
/org.eclipse.pde.ui/src/org/eclipse/pde/internal/ui/parts/SharedPart.java;1;1;2;1;2;2;2;0;18;0;0;5431;22;22;1;0;0;0;2;5431;0;6336;2;1;
/org.eclipse.help.base/src/org/eclipse/help/internal/search/ASCIIReader.java;1;1;3;1;2;2;2;1;12;0;1;1740;18;18;1;0;0;1;3;1740;0;6337;3;1;
/org.eclipse.ui.ide/src/org/eclipse/ui/internal/dialogs/PathVariableDialog.java;2;0;3;1;0;0;0;3;34;1;3;1526;34;34;1;0;0;3;3;1526;0;2263;3;2;
/org.eclipse.jface.text/src/org/eclipse/jface/text/ITextSelection.java;2;1;2;1;2;2;2;0;41;0;0;6340;43;43;1;0;0;0;2;6340;0;6359;2;2;
/org.eclipse.ui.workbench/Eclipse UI/org/eclipse/ui/activities/IActivationServiceListener.java;1;0;2;1;0;0;0;2;0;1;2;2728;0;0;1;0;0;2;2;2728;0;2800;2;1;
/org.eclipse.ui.workbench/Eclipse UI/org/eclipse/ui/activities/IActivityManagerEvent.java;1;0;6;1;0;0;0;6;19;2;5;2240;49;49;2;1;0;6;6;2800;1;2800;5;1;
/org.eclipse.ui.examples.javaeditor/Eclipse Java Editor Example/org/eclipse/ui/examples/javaeditor/spelling/ISpellEvent.java;1;0;1;1;0;0;0;1;0;0;1;2565;0;0;1;0;0;1;1;2565;0;2565;1;1;
/org.eclipse.jdt.core/model/org/eclipse/jdt/internal/core/DeleteElementsOperation.java;3;1;7;1;2;2;2;5;37;1;5;1059;81;81;1;0;0;5;7;1059;0;5916;7;3;
/org.eclipse.releng.basebuilder/plugins/org.eclipse.build.tools/src/org/eclipse/releng/FetchValidator.java;1;0;1;1;0;0;0;1;10;0;1;3597;10;10;1;0;0;1;1;3597;0;3597;1;1;
/org.eclipse.core.resources/src/org/eclipse/core/internal/indexing/IndexedStoreContext.java;1;0;1;1;1;1;1;0;24;0;0;5146;24;24;1;0;0;0;1;5146;0;5146;1;1;
/org.eclipse.sdk.tests-feature/plugins/org.eclipse.perfmsr.core/src/org/eclipse/perfmsr/core/LinuxProcStat.java;2;1;3;1;3;3;3;0;10;0;0;5638;12;12;1;0;0;0;3;5638;0;6342;3;2;
/org.eclipse.ui.intro/src/org/eclipse/ui/intro/internal/model/loader/IntroContentParser.java;1;0;2;1;1;1;1;1;0;0;1;4955;0;0;1;0;0;1;2;4955;0;5115;2;1;
/org.eclipse.ui.examples.job/src/org/eclipse/ui/examples/jobs/views/LazyTreeView.java;2;1;2;1;2;2;2;0;6;0;0;5126;6;6;1;0;0;0;2;5126;0;5800;2;2;
/org.eclipse.jdt.ui.tests.refactoring/resources/RenamePackage/testImportFromMultiRoots4/out/srcPrg/a/b/c/B.java;1;0;2;1;0;0;0;2;15;1;2;3219;15;15;1;0;0;2;2;3219;0;4105;2;1;
/org.eclipse.ui.workbench/Eclipse UI/org/eclipse/ui/internal/ObjectFilterTest.java;1;0;2;1;0;0;0;2;21;1;2;2737;24;24;1;0;0;2;2;2737;0;3150;2;1;
/org.eclipse.pde.core/src/org/eclipse/pde/internal/core/schema/SchemaElement.java;2;1;3;1;2;2;2;1;70;0;1;4203;76;76;1;0;0;1;3;4203;0;6336;3;2;
/org.eclipse.jdt.debug.ui/ui/org/eclipse/jdt/internal/debug/ui/JavaEvaluationEngineManager.java;1;0;1;1;0;0;0;1;2;0;1;1275;2;2;1;0;0;1;1;1275;0;1275;1;1;
/org.eclipse.ua.tests/src/org/eclipse/ui/examples/cheatsheets/pattern/actions/SingletonCustomizeAction.java;1;0;1;1;1;1;1;0;0;0;0;6081;0;0;1;0;0;0;1;6081;0;6081;1;1;
/org.eclipse.pde.ui/src_Forms/org/eclipse/pde/internal/ui/neweditor/KeyValueSourcePage.java;1;2;3;1;3;2;3;0;4;0;0;5371;4;4;2;0;1;0;3;5425;1;5425;2;1;
/org.eclipse.jdt.core.tests.model/workspace/Converter/test0190/Test.java;1;0;1;1;0;0;0;1;0;0;1;3714;0;0;1;0;0;1;1;3714;0;3714;1;1;
/org.eclipse.jdt.ui/ui/org/eclipse/jdt/internal/ui/typehierarchy/SortByDefiningTypeAction.java;1;0;1;1;1;1;1;0;2;0;0;6340;2;2;1;0;0;0;1;6340;0;6340;1;1;
/org.eclipse.jdt.core/model/org/eclipse/jdt/internal/core/jdom/SimpleDOMBuilder.java;3;0;9;3;1;1;1;8;32;3;6;85;46;46;3;2;0;8;9;85;2;5584;7;3;
/org.eclipse.jdt.core.tests.model/workspace/Formatter/test456/A_in.java;1;0;1;1;0;0;0;1;0;0;1;3788;0;0;1;0;0;1;1;3788;0;3788;1;1;
/org.eclipse.jdt.core.tests.model/workspace/Converter/src/test0280/Test.java;1;0;1;1;0;0;0;1;0;0;1;3714;0;0;1;0;0;1;1;3714;0;3714;1;1;
/org.eclipse.swt/Eclipse SWT PI/gtk1x/org/eclipse/swt/internal/gtk/GtkHBox.java;1;0;1;1;0;0;0;1;0;0;1;2327;0;0;1;0;0;1;1;2327;0;2327;1;1;
/org.eclipse.pde.ui/src/org/eclipse/pde/internal/ui/wizards/extension/ExtensionEditorWizard.java;3;1;3;1;3;3;3;0;6;0;0;5514;12;12;1;0;0;0;3;5514;0;6336;3;3;
/org.eclipse.jdt.core.tests.model/workspace/Converter/test0501/JavaEditor.java;1;0;2;1;0;0;0;2;0;1;2;2704;0;0;1;0;0;2;2;2704;0;3714;2;1;
/org.eclipse.update.core/src/org/eclipse/update/internal/operations/JobRoot.java;1;0;6;1;1;1;1;5;39;1;5;825;61;61;1;0;0;5;6;825;0;6336;6;1;
/org.eclipse.ui.ide/src/org/eclipse/ui/actions/MoveResourceAction.java;2;0;3;1;0;0;0;3;12;1;3;1511;12;12;1;0;0;3;3;1511;0;2263;3;2;
/org.eclipse.ant.ui/Ant Editor/org/eclipse/ant/ui/internal/editor/text/XMLProblemAnnotation.java;1;0;3;1;0;0;0;3;73;1;3;250;73;73;1;0;0;3;3;250;0;1811;3;1;
/org.eclipse.jdt.ui.tests.refactoring/resources/ExtractInterface/test96/in/A.java;1;0;1;1;0;0;0;1;0;0;1;1153;0;0;1;0;0;1;1;1153;0;1153;1;1;
/org.eclipse.jface/src/org/eclipse/jface/resource/GradientRegistry.java;1;0;5;1;0;0;0;5;79;1;5;4235;123;123;1;0;0;5;5;4235;0;4560;5;1;
/org.eclipse.jdt.ui/core refactoring/org/eclipse/jdt/internal/corext/refactoring/participants/IRenameProcessor.java;1;0;6;1;0;0;0;6;19;1;6;591;42;42;1;0;0;6;6;591;0;4624;6;1;
/org.eclipse.swt/Eclipse SWT/photon/org/eclipse/swt/graphics/Region.java;3;1;4;1;2;2;2;2;87;1;2;1657;218;218;1;0;0;2;4;1657;0;6352;4;3;
/org.eclipse.team.tests.cvs.core/src/org/eclipse/team/tests/ccvs/ui/logformatter/LogEntryContainer.java;1;0;1;1;0;0;0;1;0;0;1;2632;0;0;1;0;0;1;1;2632;0;2632;1;1;
/org.eclipse.ant.ui/Ant Editor/org/eclipse/ant/internal/ui/dtd/IElement.java;1;0;1;1;0;0;0;1;0;0;1;1811;0;0;1;0;0;1;1;1811;0;1811;1;1;
/org.eclipse.swt.tests/JUnit Tests/org/eclipse/swt/tests/junit/Test_org_eclipse_swt_custom_CTabFolderListener.java;1;0;1;1;0;0;0;1;16;0;1;2104;16;16;1;0;0;1;1;2104;0;2104;1;1;
/org.eclipse.jdt.ui.tests.refactoring/resources/TypeConstraints/A_testBad3.java;1;0;2;1;0;0;0;2;0;1;2;53;0;0;1;0;0;2;2;53;0;74;2;1;
/org.eclipse.ui.tests/Eclipse UI Tests/org/eclipse/ui/tests/intro/NoIntroPartTest.java;1;1;3;1;3;3;3;0;7;0;0;5384;12;12;1;0;0;0;3;5384;0;6319;3;1;
/org.eclipse.debug.ui/ui/org/eclipse/debug/ui/variables/DefaultVariableExpander.java;2;0;5;1;0;0;0;5;81;3;3;316;85;85;3;2;0;5;5;316;2;550;3;2;
/org.eclipse.search/new search/org/eclipse/search2/internal/ui/SearchView.java;3;5;35;2;18;11;18;17;139;2;15;3474;953;953;5;2;7;17;35;5396;9;6140;26;3;
/org.eclipse.ui.workbench/Eclipse UI/org/eclipse/ui/internal/commands/old/Capture.java;1;0;3;1;0;0;0;3;6;1;3;1322;6;6;1;0;0;3;3;1322;0;1507;3;1;
/org.eclipse.pde.core/src/org/eclipse/pde/internal/core/plugin/WorkspaceExtensionsModel.java;3;1;7;1;4;4;4;3;32;1;3;2184;58;58;1;0;0;3;7;2184;0;6336;7;3;
/org.eclipse.jdt.ui.tests.refactoring/resources/InlineMethodWorkspace/TestCases/expression_in/TestConditionalExpression.java;1;0;1;1;1;1;1;0;0;0;0;5682;0;0;1;0;0;0;1;5682;0;5682;1;1;
/org.eclipse.team.core/src/org/eclipse/team/core/subscribers/FastSyncInfoFilter.java;1;0;1;1;0;0;0;1;0;0;1;3713;0;0;1;0;0;1;1;3713;0;3713;1;1;
/org.eclipse.help.base/src/org/eclipse/help/internal/search/SearchIndexWithIndexingProgress.java;1;1;3;1;2;2;2;1;16;0;1;4972;32;32;1;0;0;1;3;4972;0;6337;3;1;
/org.eclipse.swt.examples/src/org/eclipse/swt/examples/controlexample/StyledTextTab.java;3;1;7;1;4;4;4;3;37;1;3;724;89;89;1;0;0;3;7;724;0;6352;7;3;
/org.eclipse.jdt.ui.tests.refactoring/resources/MoveMembers/test17/out/B.java;1;0;1;1;0;0;0;1;1;0;1;1522;1;1;1;0;0;1;1;1522;0;1522;1;1;
/org.eclipse.jdt.ui/ui/org/eclipse/jdt/internal/ui/preferences/IPreferenceConfigurationBlock.java;1;1;2;1;2;2;2;0;6;0;0;5482;6;6;1;0;0;0;2;5482;0;6340;2;1;
/org.eclipse.ui.ide/extensions/org/eclipse/ui/IMarkerResolution2.java;1;0;1;1;0;0;0;1;0;0;1;3246;0;0;1;0;0;1;1;3246;0;3246;1;1;
/org.eclipse.jdt.ui.tests.refactoring/resources/RenameStaticMethod/test10/out/A.java;1;0;1;1;0;0;0;1;0;0;1;1347;0;0;1;0;0;1;1;1347;0;1347;1;1;
/org.eclipse.ui.workbench/Eclipse UI/org/eclipse/ui/internal/dialogs/WorkbenchWizardSelectionPage.java;3;0;3;1;1;1;1;2;10;1;2;2737;14;14;1;0;0;2;3;2737;0;6338;3;3;
/org.eclipse.jdt.core/compiler/org/eclipse/jdt/internal/compiler/ast/LocalDeclaration.java;2;0;7;1;0;0;0;7;36;1;7;13;91;91;1;0;0;7;7;13;0;3560;7;2;
/org.eclipse.pde.ui/src/org/eclipse/pde/internal/ui/editor/plugin/LoopDialog.java;2;1;3;1;3;3;3;0;4;0;0;5431;6;6;1;0;0;0;3;5431;0;6336;3;2;
/org.eclipse.jdt.launching/launching/org/eclipse/jdt/internal/launching/JREContainer.java;2;0;2;1;0;0;0;2;10;1;2;307;16;16;1;0;0;2;2;307;0;810;2;2;
/org.eclipse.ui.editors/src/org/eclipse/ui/editors/quickdiff/IQuickDiffReferenceProvider.java;2;0;3;1;0;0;0;3;3;1;3;1118;3;3;1;0;0;3;3;1118;0;1644;3;2;
/org.eclipse.team.examples.filesystem/src/org/eclipse/team/examples/pessimistic/ui/ConfigurationWizard.java;1;0;2;1;1;1;1;1;54;0;1;3368;54;54;1;0;0;1;2;3368;0;6103;2;1;
/org.eclipse.pde.ui/src/org/eclipse/pde/internal/ui/wizards/extension/NewExtensionMainPage.java;1;0;1;1;0;0;0;1;0;0;1;4608;0;0;1;0;0;1;1;4608;0;4608;1;1;
/org.eclipse.jdt.ui/ui/org/eclipse/jdt/internal/ui/IJavaHelpContextIds.java;8;1;33;2;4;4;4;29;34;3;24;155;133;133;3;5;0;29;33;1044;5;6340;28;8;
/org.eclipse.ui.externaltools/External Tools Base/org/eclipse/ui/externaltools/internal/registry/ExternalToolMigration.java;3;0;25;1;1;1;1;24;111;2;22;282;470;470;2;2;0;24;25;846;2;6223;23;3;
/org.eclipse.jdt.core/search/org/eclipse/jdt/internal/core/search/matching/PackageReferenceLocator.java;5;2;18;2;4;3;4;14;159;2;12;1986;371;371;2;2;1;14;18;1986;3;5938;15;5;
/org.eclipse.compare.examples.xml/src/org/eclipse/compare/examples/xml/ui/StatusInfo.java;1;0;2;1;0;0;0;2;2;1;2;1106;2;2;1;0;0;2;2;1106;0;3938;2;1;
/org.eclipse.update.configurator/src/org/eclipse/update/internal/configurator/IConfigurationConstants.java;2;0;4;1;1;1;1;3;14;1;3;4095;18;18;1;0;0;3;4;4095;0;5616;4;2;
/org.eclipse.webdav/src/client/org/eclipse/webdav/client/URLTool.java;1;0;2;1;2;1;2;0;50;0;0;5151;50;50;2;0;1;0;2;5151;1;5151;1;1;
/org.eclipse.jdt.ui/ui/org/eclipse/jdt/internal/ui/jarpackager/ConfirmSaveModifiedResourcesDialog.java;1;0;1;1;1;1;1;0;2;0;0;6340;2;2;1;0;0;0;1;6340;0;6340;1;1;
/org.eclipse.ltk.ui.refactoring/src/org/eclipse/ltk/internal/ui/refactoring/ProgressService.java;1;1;2;1;2;2;2;0;0;0;0;5651;0;0;1;0;0;0;2;5651;0;5910;2;1;
/org.eclipse.debug.ui/ui/org/eclipse/debug/ui/variables/IVariableExpander.java;1;0;3;1;0;0;0;3;53;2;2;316;53;53;2;1;0;3;3;316;1;550;2;1;
/org.eclipse.core.tests.runtime/src/org/eclipse/core/tests/runtime/BenchPath.java;1;0;1;1;1;1;1;0;273;0;0;5149;273;273;1;0;0;0;1;5149;0;5149;1;1;
/org.eclipse.jdt.ui.examples.javafamily/coresearch-experiment/org/eclipse/search/internal/core/SearchQueryJob.java;1;0;2;1;0;0;0;2;0;1;2;1380;0;0;1;0;0;2;2;1380;0;3214;2;1;
/org.eclipse.osgi/core/framework/org/eclipse/osgi/framework/internal/core/BundleResourcePermission.java;4;1;5;1;3;3;3;2;152;1;2;3013;160;160;1;0;0;2;5;3013;0;6337;5;4;
/org.eclipse.update.core/srcnew/org/eclipse/update/operations/IInstallFeatureOperation.java;1;0;2;1;0;0;0;2;0;1;2;602;0;0;1;0;0;2;2;602;0;825;2;1;
/org.eclipse.core.tests.resources/src/org/eclipse/core/tests/resources/usecase/ConcurrencyTest.java;1;3;4;1;4;2;4;0;127;0;0;5147;133;133;3;0;2;0;4;5147;2;5686;2;1;
/org.eclipse.pde.ui/src_Forms/org/eclipse/pde/internal/ui/model/build/BuildModel.java;2;1;8;1;8;8;8;0;72;0;0;5258;173;173;1;0;0;0;8;5258;0;6336;8;2;
/org.eclipse.ui.workbench/Eclipse UI/org/eclipse/ui/internal/themes/ThemeRegistry.java;2;0;8;1;1;1;1;7;139;2;6;3684;309;309;2;1;0;7;8;4559;1;5274;7;2;
/org.eclipse.update.ui.forms/src/org/eclipse/ui/forms/events/HyperlinkEvent.java;1;0;2;1;0;0;0;2;0;0;1;3095;0;0;2;1;0;2;2;3095;1;3095;1;1;
/org.eclipse.ui.workbench/Eclipse UI/org/eclipse/ui/internal/ShowViewMenuAction.java;1;0;1;1;0;0;0;1;5;0;1;2737;5;5;1;0;0;1;1;2737;0;2737;1;1;
/org.eclipse.ui.cheatsheets/src/org/eclipse/ui/internal/cheatsheets/views/CheatSheetPage.java;1;1;11;1;6;6;6;5;82;2;4;4701;202;202;2;1;0;5;11;4701;1;5944;10;1;
/org.eclipse.jdt.ui/ui refactoring/org/eclipse/jdt/internal/ui/refactoring/ExtractTempInputPage.java;1;0;1;1;0;0;0;1;0;0;1;518;0;0;1;0;0;1;1;518;0;518;1;1;
/org.eclipse.ui.workbench/Eclipse UI/org/eclipse/ui/internal/roles/api/IRoleManager.java;1;0;2;1;0;0;0;2;0;0;1;2202;0;0;2;1;0;2;2;2202;1;2202;1;1;
/org.eclipse.ui.workbench/Eclipse UI/org/eclipse/ui/internal/colors/ColorDefinition.java;1;0;5;1;0;0;0;5;158;2;4;3216;251;251;2;1;0;5;5;4235;1;4235;4;1;
/org.eclipse.pde.ui/src_Forms/org/eclipse/pde/internal/ui/neweditor/feature/URLSection.java;2;0;2;1;1;1;1;1;0;0;1;4926;0;0;1;0;0;1;2;4926;0;5431;2;2;
/org.eclipse.jdt.core/model/org/eclipse/jdt/core/util/IStackMapAttribute.java;1;0;1;1;0;0;0;1;0;0;1;3791;0;0;1;0;0;1;1;3791;0;3791;1;1;
/org.eclipse.ui.intro/src/org/eclipse/ui/internal/intro/impl/presentations/BrowserIntroPartImplementation.java;2;3;27;1;27;17;27;0;200;0;0;5115;1014;1014;3;0;10;0;27;5797;10;6188;17;2;
/org.eclipse.core.tests.resources/src/org/eclipse/core/tests/internal/properties/PropertyManagerTest.java;2;0;4;1;3;1;3;1;706;0;1;3110;837;837;3;0;2;1;4;5147;2;5147;2;2;
/org.eclipse.jdt.ui/ui/org/eclipse/jdt/ui/OverrideIndicatorLabelDecorator.java;2;1;9;1;4;4;4;5;52;2;4;1503;157;157;2;1;0;5;9;2908;1;6340;8;2;
/org.eclipse.ui.workbench/Eclipse UI/org/eclipse/ui/commands/CommandManagerFactory.java;1;0;3;1;0;0;0;3;19;1;3;2569;19;19;1;0;0;3;3;2569;0;4927;3;1;
/org.eclipse.jdt.ui.tests/ui/org/eclipse/jdt/ui/tests/core/TypeRulesTest.java;3;1;6;1;4;4;4;2;22;1;2;2561;35;35;1;0;0;2;6;2561;0;6340;6;3;
/org.eclipse.swt/Eclipse SWT/common/org/eclipse/swt/widgets/Event.java;1;0;2;1;0;0;0;2;8;1;2;581;15;15;1;0;0;2;2;581;0;2106;2;1;
/org.eclipse.ui.workbench/Eclipse UI/org/eclipse/ui/internal/csm/commands/ICommandRegistry.java;1;0;4;1;0;0;0;4;14;2;3;2515;18;18;2;1;0;4;4;2556;1;2556;3;1;
/org.eclipse.ui.workbench/Eclipse UI/org/eclipse/ui/internal/PartTabFolder.java;8;5;63;4;14;9;14;49;2137;4;38;1092;9283;9283;5;11;5;49;63;5513;16;5539;47;8;
/org.eclipse.ui.workbench/Eclipse UI/org/eclipse/ui/internal/contexts/IContextRegistryListener.java;1;0;2;1;0;0;0;2;20;1;2;1422;20;20;1;0;0;2;2;1422;0;3066;2;1;
/org.eclipse.team.ui/src/org/eclipse/team/internal/ui/wizards/SubscriberRefreshWizard.java;1;0;2;1;0;0;0;2;0;1;2;4449;0;0;1;0;0;2;2;4449;0;4518;2;1;
/org.eclipse.jdt.ui/ui refactoring/org/eclipse/jdt/internal/ui/refactoring/contentassist/JavaTypeCompletionProcessor.java;5;2;19;2;8;7;8;11;268;3;5;3648;597;597;3;6;1;11;19;3648;7;6340;12;5;
/org.eclipse.pde.ui/src/org/eclipse/pde/internal/ui/wizards/extension/GenericExtensionWizard.java;2;0;2;1;0;0;0;2;2;1;2;648;2;2;1;0;0;2;2;648;0;4608;2;2;
/org.eclipse.pde.ui/src/org/eclipse/pde/ui/templates/BaseOptionTemplateSection.java;2;3;7;1;6;4;6;1;292;0;1;3986;427;427;3;0;2;1;7;5204;2;6336;5;2;
/org.eclipse.jdt.core.tests.model/workspace/Formatter/test393/A_out.java;1;0;1;1;0;0;0;1;0;0;1;3175;0;0;1;0;0;1;1;3175;0;3175;1;1;
/org.eclipse.jdt.core.tests.model/workspace/Converter/test0382/A.java;1;0;1;1;0;0;0;1;0;0;1;3714;0;0;1;0;0;1;1;3714;0;3714;1;1;
/org.eclipse.jdt.ui.tests.refactoring/resources/IntroduceFactory/positive/InstanceContext_FFF.java;1;0;2;1;1;1;1;1;2;0;1;2862;2;2;1;0;0;1;2;2862;0;5659;2;1;
/org.eclipse.team.cvs.ssh2/src/org/eclipse/team/ccvs/ssh2/JSchSession.java;3;0;13;2;0;0;0;13;530;2;12;2956;731;731;2;1;0;13;13;3027;1;4825;12;3;
/org.eclipse.jdt.core/dom/org/eclipse/jdt/core/dom/MethodDeclaration.java;5;2;20;1;6;4;6;14;346;2;13;1114;888;888;2;1;2;14;20;4900;3;5781;17;5;
/org.eclipse.jdt.debug/jdi/org/eclipse/jdi/internal/connect/SocketListeningConnectorImpl.java;3;0;5;1;1;1;1;4;6;1;4;149;17;17;1;0;0;4;5;149;0;6336;5;3;
/org.eclipse.ant.ui/Ant Tools Support/org/eclipse/ant/internal/ui/preferences/ClasspathEntry.java;1;0;6;1;1;1;1;5;62;1;5;2182;126;126;1;0;0;5;6;2182;0;5581;6;1;
/org.eclipse.jdt.ui/core refactoring/org/eclipse/jdt/internal/corext/refactoring/util/Changes.java;1;0;1;1;1;1;1;0;0;0;0;5162;0;0;1;0;0;0;1;5162;0;5162;1;1;
/org.eclipse.team.ui/src/org/eclipse/team/internal/ui/synchronize/SynchronizeModelElementSorter.java;1;0;2;1;1;1;1;1;2;0;1;4588;2;2;1;0;0;1;2;4588;0;6337;2;1;
/org.eclipse.debug.ui/ui/org/eclipse/debug/ui/IDebugEditorPresentation.java;2;1;5;1;2;2;2;3;65;2;2;1157;103;103;2;1;0;3;5;1157;1;6336;4;2;
/org.eclipse.ui.workbench/Eclipse UI/org/eclipse/ui/internal/registry/IViewDescriptor.java;3;0;3;1;1;1;1;2;7;1;2;830;16;16;1;0;0;2;3;830;0;6338;3;3;
/org.eclipse.jdt.core.tests.model/workspace/Completion/src3/test0017/Test.java;1;0;1;1;1;1;1;0;0;0;0;5181;0;0;1;0;0;0;1;5181;0;5181;1;1;
/org.eclipse.jdt.ui/core refactoring/org/eclipse/jdt/internal/corext/refactoring/structure/MoveStaticMembersRefactoring.java;5;1;41;2;2;2;2;39;1084;2;37;122;2519;2519;2;2;0;39;41;1952;2;5264;39;5;
/org.eclipse.jdt.core/model/org/eclipse/jdt/core/util/IRuntimeInvisibleParameterAnnotationsAttribute.java;2;0;2;1;0;0;0;2;36;1;2;4466;36;36;1;0;0;2;2;4466;0;4843;2;2;
/org.eclipse.ui.views/src/org/eclipse/ui/views/navigator/LocalSelectionTransfer.java;2;0;2;1;0;0;0;2;2;1;2;1;2;2;1;0;0;2;2;1;0;2738;2;2;
/org.eclipse.ui.workbench/Eclipse UI/org/eclipse/ui/internal/activities/ActivityServiceAdapter.java;1;0;3;1;0;0;0;3;10;2;2;2800;10;10;2;1;0;3;3;2800;1;2896;2;1;
/org.eclipse.jdt.ui/core refactoring/org/eclipse/jdt/internal/corext/refactoring/participants/ICopyParticipant.java;1;0;2;1;0;0;0;2;0;1;2;1125;0;0;1;0;0;2;2;1125;0;4624;2;1;
/org.eclipse.core.resources/src/org/eclipse/core/internal/resources/WorkspaceTreeReader_0.java;1;0;1;1;1;1;1;0;10;0;0;5146;10;10;1;0;0;0;1;5146;0;5146;1;1;
/org.eclipse.jdt.core/model/org/eclipse/jdt/internal/core/util/ClassFileAttribute.java;1;0;1;1;0;0;0;1;2;0;1;3560;2;2;1;0;0;1;1;3560;0;3560;1;1;
/org.eclipse.jdt.ui.tests.refactoring/resources/PullUp/test20/out/A.java;1;0;1;1;0;0;0;1;2;0;1;1690;2;2;1;0;0;1;1;1690;0;1690;1;1;
/org.eclipse.osgi/core/adaptor/org/eclipse/osgi/framework/util/FrameworkMessageFormat.java;1;1;2;1;2;2;2;0;1;0;0;5232;1;1;1;0;0;0;2;5232;0;5803;2;1;
/org.eclipse.ui.workbench.texteditor/src/org/eclipse/ui/internal/texteditor/quickdiff/compare/rangedifferencer/DocLineComparator.java;3;1;5;1;2;2;2;3;152;1;3;1644;277;277;1;0;0;3;5;1644;0;6340;5;3;
/org.eclipse.osgi/defaultAdaptor/src/org/eclipse/osgi/framework/internal/defaultadaptor/AdaptorElementFactory.java;2;0;4;1;0;0;0;4;10;1;4;3013;14;14;1;0;0;4;4;3013;0;4336;4;2;
/org.eclipse.ant.ui/Ant Tools Support/org/eclipse/ant/internal/ui/model/AntUIImages.java;3;1;20;2;3;3;3;17;10;2;15;1811;47;47;2;2;0;17;20;1915;2;5602;18;3;
/org.eclipse.ui.externaltools/Ant Editor/org/eclipse/ui/externaltools/internal/ant/editor/text/AntEditorWhitespaceDetector.java;1;0;2;1;0;0;0;2;0;1;2;178;0;0;1;0;0;2;2;178;0;282;2;1;
/org.eclipse.jdt.ui/core refactoring/org/eclipse/jdt/internal/corext/refactoring/nls/NLSPropertyFileModifier.java;3;1;10;1;10;10;10;0;198;0;0;5186;496;496;1;0;0;0;10;5186;0;6340;10;3;
/org.eclipse.jdt.ui.examples.javafamily/src/org/eclipse/jdt/internal/ui/examples/jspeditor/IAnnotationExtension.java;1;0;2;1;0;0;0;2;0;1;2;1112;0;0;1;0;0;2;2;1112;0;1150;2;1;
/org.eclipse.jdt.core/search/org/eclipse/jdt/internal/core/index/impl/IndexerOutput.java;2;0;3;1;0;0;0;3;10;1;3;488;11;11;1;0;0;3;3;488;0;3384;3;2;
/org.eclipse.swt/Eclipse SWT Browser/common/org/eclipse/swt/browser/WindowEvent.java;2;0;5;1;1;1;1;4;81;1;4;3167;94;94;1;0;0;4;5;3167;0;6352;5;2;
/org.eclipse.jdt.ui.tests.refactoring/resources/ChangeSignature/canModify/A_testAddReorderRename34_out.java;1;0;1;1;0;0;0;1;2;0;1;2093;2;2;1;0;0;1;1;2093;0;2093;1;1;
/org.eclipse.update.core/src/org/eclipse/update/core/model/FeatureContentProvider.java;1;0;1;1;0;0;0;1;0;0;1;2650;0;0;1;0;0;1;1;2650;0;2650;1;1;
/org.eclipse.jdt.ui.tests.refactoring/resources/ExtractInterface/test67/out/Outer.java;1;0;1;1;0;0;0;1;4;0;1;1166;4;4;1;0;0;1;1;1166;0;1166;1;1;
/org.eclipse.pde.ui/src/org/eclipse/pde/internal/ui/view/DependenciesView.java;2;1;7;1;3;3;3;4;13;1;4;368;47;47;1;0;0;4;7;368;0;6336;7;2;
/org.eclipse.ui.ide/src/org/eclipse/ui/views/markers/internal/IItemsChangedListener.java;1;0;1;1;0;0;0;1;0;0;1;2208;0;0;1;0;0;1;1;2208;0;2208;1;1;
/org.eclipse.core.resources/src/org/eclipse/core/internal/resources/MarkerSnapshotReader_1.java;1;0;1;1;1;1;1;0;175;0;0;5146;175;175;1;0;0;0;1;5146;0;5146;1;1;
/org.eclipse.core.expressions/src/org/eclipse/core/internal/expressions/TestExpression.java;1;1;5;1;2;2;2;3;8;1;3;4108;20;20;1;0;0;3;5;4108;0;6340;5;1;
/org.eclipse.pde.core/src/org/eclipse/pde/internal/core/osgi/bundle/BundlePluginBase.java;2;3;17;2;5;3;5;12;358;2;10;4203;648;648;3;2;2;12;17;5425;4;5445;13;2;
/org.eclipse.jdt.core.tests.model/workspace/Converter/test0195/Test.java;1;0;1;1;0;0;0;1;0;0;1;3714;0;0;1;0;0;1;1;3714;0;3714;1;1;
/org.eclipse.ant.ui/Remote Ant Support/org/eclipse/ant/ui/internal/antsupport/AntSecurityException.java;1;0;2;1;0;0;0;2;0;1;2;1696;0;0;1;0;0;2;2;1696;0;1811;2;1;
/org.eclipse.jdt.core.tests.model/workspace/Formatter/test475/A_in.java;1;0;1;1;0;0;0;1;0;0;1;3977;0;0;1;0;0;1;1;3977;0;3977;1;1;
/org.eclipse.team.ui/src/org/eclipse/team/ui/synchronize/actions/RemoveSynchronizeViewPageAction.java;1;0;1;1;0;0;0;1;0;0;1;2535;0;0;1;0;0;1;1;2535;0;2535;1;1;
/org.eclipse.osgi/osgi/src/org/eclipse/osgi/service/resolver/State.java;4;2;15;1;7;6;7;8;34;1;8;3013;165;165;2;0;1;8;15;5341;1;6337;14;4;
/org.eclipse.ui.workbench/Eclipse UI/org/eclipse/ui/internal/roles/IRoleRegistry.java;1;0;4;1;0;0;0;4;2;1;4;2444;4;4;1;0;0;4;4;2444;0;2864;4;1;
/org.eclipse.jdt.junit.runtime/src/org/eclipse/jdt/internal/junit/runner/MessageIds.java;2;0;3;1;1;1;1;2;28;1;2;1359;30;30;1;0;0;2;3;1359;0;6340;3;2;
/org.eclipse.swt/Eclipse SWT PI/photon/org/eclipse/swt/internal/photon/PtWebStatusCallback_t.java;1;0;1;1;0;0;0;1;0;0;1;2065;0;0;1;0;0;1;1;2065;0;2065;1;1;
/org.eclipse.jdt.core.tests.model/workspace/Formatter/test233/A_out.java;1;0;1;1;0;0;0;1;0;0;1;2437;0;0;1;0;0;1;1;2437;0;2437;1;1;
/org.eclipse.ui.workbench/Eclipse UI/org/eclipse/ui/internal/misc/ContainerSelectionGroup.java;2;0;3;1;0;0;0;3;7;1;3;1687;9;9;1;0;0;3;3;1687;0;2737;3;2;
/org.eclipse.ant.ui/Ant Tools Support/org/eclipse/ant/internal/ui/preferences/StatusDialog.java;1;0;3;1;0;0;0;3;4;1;3;1811;6;6;1;0;0;3;3;1811;0;1861;3;1;
/org.eclipse.team.ui/src/org/eclipse/team/internal/ui/synchronize/actions/AbstractActionContribution.java;1;0;1;1;0;0;0;1;0;0;1;5087;0;0;1;0;0;1;1;5087;0;5087;1;1;
/org.eclipse.jdt.ui.tests.refactoring/resources/Delete/testDeleteWithinCu7/in/A.java;1;0;1;1;0;0;0;1;0;0;1;442;0;0;1;0;0;1;1;442;0;442;1;1;
/org.eclipse.jdt.debug/model/org/eclipse/jdt/internal/debug/core/breakpoints/JavaMethodEntryBreakpoint.java;1;0;1;1;0;0;0;1;2;0;1;2740;2;2;1;0;0;1;1;2740;0;2740;1;1;
/org.eclipse.jdt.core.tests.model/workspace/Formatter/test388/A_out.java;1;0;1;1;0;0;0;1;0;0;1;3172;0;0;1;0;0;1;1;3172;0;3172;1;1;
/org.eclipse.core.tests.resources/src/org/eclipse/core/tests/internal/localstore/LocalSyncTest.java;2;0;3;1;2;1;2;1;326;0;1;1878;329;329;2;0;1;1;3;5147;1;5147;2;2;
/org.eclipse.jface/src/org/eclipse/jface/action/ICoolBarManager.java;5;1;6;1;2;2;2;4;176;1;4;3220;287;287;1;0;0;4;6;3220;0;6338;6;5;
/org.eclipse.jdt.ui/core refactoring/org/eclipse/jdt/internal/corext/refactoring/rename/TextMatchUpdater.java;2;1;6;1;3;3;3;3;14;1;3;4560;37;37;1;0;0;3;6;4560;0;6340;6;2;
/org.eclipse.jdt.core.tests.model/workspace/Converter/test0263/Test.java;1;0;1;1;0;0;0;1;0;0;1;3714;0;0;1;0;0;1;1;3714;0;3714;1;1;
/org.eclipse.webdav/src/client/org/eclipse/webdav/client/WorkspaceHandle.java;1;0;2;1;2;1;2;0;6;0;0;5151;6;6;2;0;1;0;2;5151;1;5151;1;1;
/org.eclipse.jdt.ui/ui/org/eclipse/jdt/internal/ui/preferences/JavaEditorPreferencePage.java;6;6;72;2;30;16;30;42;711;3;34;600;2921;2921;6;8;14;42;72;5498;22;6340;50;6;
/org.eclipse.swt/Eclipse SWT Mozilla/common/org/eclipse/swt/internal/mozilla/nsIWindowCreator.java;1;0;2;1;0;0;0;2;2;1;2;1855;2;2;1;0;0;2;2;1855;0;2568;2;1;
/org.eclipse.search/new search/org/eclipse/search2/internal/ui/basic/views/CollapseAllAction.java;2;1;2;1;2;2;2;0;4;0;0;5434;4;4;1;0;0;0;2;5434;0;6340;2;2;
/org.eclipse.ui.workbench/Eclipse UI/org/eclipse/ui/internal/ide/UISynchronizer.java;1;0;1;1;0;0;0;1;0;0;1;1480;0;0;1;0;0;1;1;1480;0;1480;1;1;
/org.eclipse.jdt.core/model/org/eclipse/jdt/internal/core/BufferManager.java;2;0;9;1;0;0;0;9;18;1;9;840;74;74;1;0;0;9;9;840;0;3560;9;2;
/org.eclipse.jdt.ui/ui/org/eclipse/jdt/internal/ui/text/link/contentassist/ContextInformationPopup2.java;3;0;4;1;0;0;0;4;4;1;4;1132;6;6;1;0;0;4;4;1132;0;4214;4;3;
/org.eclipse.ui.ide/src/org/eclipse/ui/internal/WorkbenchActionBuilder.java;2;0;17;2;0;0;0;17;459;3;13;1520;1026;1026;3;4;0;17;17;1739;4;2263;13;2;
/org.eclipse.pde.ui/src/org/eclipse/pde/internal/ui/editor/manifest/ResourceAttributeValue.java;1;0;1;1;1;1;1;0;0;0;0;5431;0;0;1;0;0;0;1;5431;0;5431;1;1;
/org.eclipse.jdt.core/compiler/org/eclipse/jdt/internal/compiler/flow/FlowInfo.java;2;0;3;1;0;0;0;3;25;1;3;953;35;35;1;0;0;3;3;953;0;3560;3;2;
/org.eclipse.jdt.core.tests.model/workspace/Converter/src/test0482/A.java;1;0;1;1;0;0;0;1;0;0;1;3714;0;0;1;0;0;1;1;3714;0;3714;1;1;
/org.eclipse.jdt.debug.ui/ui/org/eclipse/jdt/internal/debug/ui/jres/BuildJREDescriptor.java;2;0;3;1;0;0;0;3;13;1;3;1065;20;20;1;0;0;3;3;1065;0;4849;3;2;
/org.eclipse.jdt.core/dom/org/eclipse/jdt/internal/core/dom/rewrite/RewriteRuntimeException.java;2;0;2;1;0;0;0;2;0;1;2;4802;0;0;1;0;0;2;2;4802;0;5083;2;2;
/org.eclipse.jdt.ui/ui/org/eclipse/jdt/internal/ui/text/BufferedDocumentScanner.java;1;0;1;1;1;1;1;0;2;0;0;6340;2;2;1;0;0;0;1;6340;0;6340;1;1;
/org.eclipse.core.tools.resources/src/org/eclipse/core/tools/metadata/DumpException.java;1;0;1;1;1;1;1;0;0;0;0;6302;0;0;1;0;0;0;1;6302;0;6302;1;1;
/org.eclipse.swt/Eclipse SWT/carbon/org/eclipse/swt/widgets/WidgetTable.java;1;0;1;1;0;0;0;1;0;0;1;1190;0;0;1;0;0;1;1;1190;0;1190;1;1;
/org.eclipse.core.runtime/src/org/eclipse/core/internal/runtime/PlatformLogWriter.java;5;1;9;1;2;2;2;7;531;1;7;3013;1386;1386;1;0;0;7;9;3013;0;5150;9;5;
/org.eclipse.jdt.ui.tests.refactoring/test cases/org/eclipse/jdt/ui/tests/refactoring/RenameNonPrivateFieldTests.java;4;1;12;1;3;3;3;9;19;1;9;130;101;101;1;0;0;9;12;130;0;6340;12;4;
/org.eclipse.update.ui/src/org/eclipse/update/internal/ui/views/UpdateModelDataTransfer.java;1;0;1;1;0;0;0;1;0;0;1;755;0;0;1;0;0;1;1;755;0;755;1;1;
/org.eclipse.help.ui.win32/src/org/eclipse/help/ui/internal/browser/win32/ICommandStateChangedListener.java;1;0;1;1;0;0;0;1;0;0;1;1710;0;0;1;0;0;1;1;1710;0;1710;1;1;
/org.eclipse.team.cvs.ui/src/org/eclipse/team/internal/ccvs/ui/merge/MergeWizard.java;2;1;24;2;7;7;7;17;49;2;14;790;363;363;2;3;0;17;24;790;3;6337;21;2;
/org.eclipse.jdt.ui/ui refactoring/org/eclipse/jdt/internal/ui/refactoring/FileStatusContextViewer.java;1;0;5;1;0;0;0;5;22;1;5;882;25;25;1;0;0;5;5;882;0;4965;5;1;
/org.eclipse.pde.ui/src_Forms/org/eclipse/pde/internal/ui/neweditor/feature/FeatureUndoManager.java;2;1;4;1;2;2;2;2;11;0;1;4926;16;16;2;1;0;2;4;4926;1;5431;3;2;
/org.eclipse.jdt.debug/jdi/org/eclipse/jdi/internal/PrimitiveValueImpl.java;1;0;1;1;0;0;0;1;8;0;1;1276;8;8;1;0;0;1;1;1276;0;1276;1;1;
/org.eclipse.pde.ui/src/org/eclipse/pde/internal/ui/editor/feature/FeatureMatchSection.java;3;1;6;1;5;5;5;1;41;0;1;4203;83;83;1;0;0;1;6;4203;0;6336;6;3;
/org.eclipse.jdt.ui/core refactoring/org/eclipse/jdt/internal/corext/refactoring/base/RefactoringStatusCodes.java;2;0;2;1;1;1;1;1;2;0;1;3536;4;4;1;0;0;1;2;3536;0;6340;2;2;
/org.eclipse.ui.ide/src/org/eclipse/ui/internal/ide/dialogs/NewProjectWizard.java;2;0;2;1;0;0;0;2;1;1;2;2264;1;1;1;0;0;2;2;2264;0;2766;2;2;
/org.eclipse.jdt.core/dom/org/eclipse/jdt/core/dom/AnnotationTypeMemberDeclaration.java;3;2;13;1;5;4;5;8;255;1;8;4054;503;503;2;0;1;8;13;5268;1;5871;12;3;
/org.eclipse.ui.workbench/Eclipse UI/org/eclipse/ui/part/MessagePage.java;2;0;2;1;1;1;1;1;12;0;1;4873;14;14;1;0;0;1;2;4873;0;6338;2;2;
/org.eclipse.jdt.ui/ui/org/eclipse/jdt/internal/ui/viewsupport/StatusBarUpdater.java;1;0;1;1;1;1;1;0;2;0;0;6340;2;2;1;0;0;0;1;6340;0;6340;1;1;
/org.eclipse.pde.ui/templates/multiPageEditor/java/$editorClassName$.java;1;0;2;1;0;0;0;2;58;1;2;851;70;70;1;0;0;2;2;851;0;2765;2;1;
/org.eclipse.jdt.ui.tests.refactoring/resources/InlineMethodWorkspace/TestCases/call_out/TestStatementWithFunction1.java;1;0;1;1;0;0;0;1;2;0;1;845;2;2;1;0;0;1;1;845;0;845;1;1;
/org.eclipse.jdt.ui/ui/org/eclipse/jdt/internal/ui/text/spelling/engine/ISpellEvent.java;2;0;3;1;1;1;1;2;12;1;2;3930;14;14;1;0;0;2;3;3930;0;6340;3;2;
/org.eclipse.ant.ui/Ant Tools Support/org/eclipse/ant/ui/internal/launchConfigurations/AntStreamMonitor.java;1;0;3;1;0;0;0;3;3;1;3;250;3;3;1;0;0;3;3;250;0;1811;3;1;
/org.eclipse.pde.ui/src/org/eclipse/pde/internal/ui/wizards/project/MigratePluginWizard.java;2;0;8;1;0;0;0;8;42;1;8;2653;77;77;1;0;0;8;8;2653;0;3839;8;2;
/org.eclipse.ui.workbench/Eclipse UI/org/eclipse/ui/presentations/StackDropResult.java;2;1;3;1;2;2;2;1;29;0;1;4469;54;54;1;0;0;1;3;4469;0;5672;3;2;
/org.eclipse.debug.ui/ui/org/eclipse/debug/internal/ui/console/ConsoleRemoveAllTerminatedAction.java;1;0;2;1;0;0;0;2;0;1;2;1317;0;0;1;0;0;2;2;1317;0;1415;2;1;
/org.eclipse.jdt.core.tests.model/workspace/Formatter/test433/A_in.java;1;0;1;1;0;0;0;1;0;0;1;3495;0;0;1;0;0;1;1;3495;0;3495;1;1;
/org.eclipse.jdt.ui/ui/org/eclipse/jdt/internal/ui/text/HTMLPrinter.java;1;1;5;1;2;2;2;3;47;1;3;724;141;141;1;0;0;3;5;724;0;6340;5;1;
/org.eclipse.core.tests.runtime/src/org/eclipse/core/tests/runtime/jobs/RandomTestRunnable.java;2;0;3;1;1;1;1;2;17;1;2;2823;26;26;1;0;0;2;3;2823;0;5149;3;2;
/org.eclipse.ui.workbench/Eclipse UI/org/eclipse/ui/roles/IRoleEvent.java;1;0;6;1;0;0;0;6;23;1;6;1952;50;50;1;0;0;6;6;1952;0;2805;6;1;
/org.eclipse.jdt.core.tests.model/workspace/Resolve/src/ResolveLocalMemberTypeDeclaration2.java;1;0;1;1;0;0;0;1;0;0;1;1970;0;0;1;0;0;1;1;1970;0;1970;1;1;
/org.eclipse.jdt.ui.tests.refactoring/test cases/org/eclipse/jdt/ui/tests/refactoring/ExtractMethodTests.java;3;1;17;2;4;4;4;13;81;2;12;130;247;247;2;1;0;13;17;1442;1;6340;16;3;
/org.eclipse.swt/Eclipse SWT Mozilla/common/org/eclipse/swt/internal/mozilla/nsIPref.java;1;0;2;1;0;0;0;2;70;1;2;1654;70;70;1;0;0;2;2;1654;0;2568;2;1;
/org.eclipse.ui.workbench/Eclipse UI/org/eclipse/ui/internal/gestures/CaptureListener.java;1;0;1;1;0;0;0;1;0;0;1;1721;0;0;1;0;0;1;1;1721;0;1721;1;1;
/org.eclipse.swt/Eclipse SWT PI/win32/org/eclipse/swt/internal/win32/SCRIPT_LOGATTR.java;2;0;2;1;1;1;1;1;4;0;1;4563;4;4;1;0;0;1;2;4563;0;6352;2;2;
/org.eclipse.jdt.debug.ui/ui/org/eclipse/jdt/internal/debug/ui/propertypages/JavaExceptionBreakpointAdvancedPage.java;2;0;3;1;1;1;1;2;5;1;2;1358;8;8;1;0;0;2;3;1358;0;5581;3;2;
/org.eclipse.pde.ui/src/org/eclipse/pde/internal/ui/editor/site/NewArchiveDialog.java;1;0;3;1;1;1;1;2;50;1;2;2311;67;67;1;0;0;2;3;2311;0;6336;3;1;
/org.eclipse.update.ui/src/org/eclipse/update/internal/ui/AddBookmarksAction.java;3;0;4;1;0;0;0;4;18;1;4;825;27;27;1;0;0;4;4;825;0;4949;4;3;
/org.eclipse.core.resources/src/org/eclipse/core/internal/watson/IDeltaVisitor.java;1;0;1;1;1;1;1;0;31;0;0;5146;31;31;1;0;0;0;1;5146;0;5146;1;1;
/org.eclipse.jdt.ui.tests.refactoring/resources/ChangeTypeRefactoring/negative/A_testUpdateNotPossible_out.java;1;0;1;1;0;0;0;1;0;0;1;2844;0;0;1;0;0;1;1;2844;0;2844;1;1;
/org.eclipse.ui.workbench/Eclipse UI/org/eclipse/ui/internal/ClassicViewTitleHandler.java;1;0;1;1;0;0;0;1;0;0;1;2742;0;0;1;0;0;1;1;2742;0;2742;1;1;
/org.eclipse.swt/Eclipse SWT/emulated/tray/org/eclipse/swt/widgets/TrayItem.java;2;0;2;1;1;1;1;1;144;0;1;4557;144;144;1;0;0;1;2;4557;0;5606;2;2;
/org.eclipse.jdt.debug.tests/tests/org/eclipse/jdt/debug/tests/core/ClasspathVariableTests.java;1;0;1;1;0;0;0;1;13;0;1;266;13;13;1;0;0;1;1;266;0;266;1;1;
/org.eclipse.pde.core/src/org/eclipse/pde/internal/core/ModelEntry.java;3;1;16;1;6;6;6;10;84;2;8;2185;228;228;2;2;0;10;16;2678;2;6336;14;3;
/org.eclipse.team.cvs.ui/src/org/eclipse/team/internal/ccvs/ui/model/CVSRootFolderElement.java;1;0;3;1;1;1;1;2;2;1;2;990;6;6;1;0;0;2;3;990;0;6337;3;1;
/org.eclipse.jdt.ui.tests.refactoring/resources/RenamePackage/testImportFromMultiRoots7/in/srcPrj.other/pack/Namesake.java;1;0;1;1;0;0;0;1;0;0;1;4105;0;0;1;0;0;1;1;4105;0;4105;1;1;
/org.eclipse.ui.workbench/Eclipse UI/org/eclipse/ui/actions/RefreshAction.java;1;0;1;1;0;0;0;1;0;0;1;2737;0;0;1;0;0;1;1;2737;0;2737;1;1;
/org.eclipse.core.tests.harness/src/org/eclipse/core/tests/harness/CancelingProgressMonitor.java;1;0;1;1;1;1;1;0;18;0;0;5146;18;18;1;0;0;0;1;5146;0;5146;1;1;
/org.eclipse.ui.tests/Eclipse UI Tests/org/eclipse/ui/tests/popups/PopupsTestSuite.java;1;1;2;1;2;2;2;0;0;0;0;5225;0;0;1;0;0;0;2;5225;0;5535;2;1;
/org.eclipse.jdt.ui/ui/org/eclipse/jdt/ui/text/spelling/SpellReconcileStrategy.java;1;0;2;1;0;0;0;2;0;1;2;3829;0;0;1;0;0;2;2;3829;0;3930;2;1;
/org.eclipse.jdt.core.tests.model/workspace/Converter/test0066/Test.java;1;0;1;1;0;0;0;1;0;0;1;3714;0;0;1;0;0;1;1;3714;0;3714;1;1;
/org.eclipse.ui.ide/src/org/eclipse/ui/ide/IDEActionFactory.java;5;2;23;2;8;7;8;15;118;4;12;1622;485;485;4;3;1;15;23;1670;4;6338;19;5;
/org.eclipse.ltk.core.refactoring.tests/src/org/eclipse/ltk/core/refactoring/tests/participants/Element.java;1;0;1;1;1;1;1;0;0;0;0;6072;0;0;1;0;0;0;1;6072;0;6072;1;1;
/org.eclipse.debug.ui/ui/org/eclipse/debug/internal/ui/views/memory/HexRenderer.java;2;1;2;1;2;2;2;0;59;0;0;5254;59;59;1;0;0;0;2;5254;0;5364;2;2;
/org.eclipse.compare/compare/org/eclipse/compare/internal/patch/InputPatchPage.java;1;1;5;1;2;2;2;3;13;1;3;1289;26;26;1;0;0;3;5;1289;0;6061;5;1;
/org.eclipse.jdt.ui/ui/org/eclipse/jdt/internal/ui/compare/PropertiesStructureCreator.java;2;1;6;1;3;3;3;3;4;1;3;240;20;20;1;0;0;3;6;240;0;6340;6;2;
/org.eclipse.jface/src/org/eclipse/jface/resource/Gradient.java;1;0;3;1;0;0;0;3;73;1;3;4235;73;73;1;0;0;3;3;4235;0;4560;3;1;
/org.eclipse.jdt.ui.tests.refactoring/resources/ChangeSignature/canModify/A_testName02_out.java;1;0;1;1;0;0;0;1;0;0;1;3801;0;0;1;0;0;1;1;3801;0;3801;1;1;
/org.eclipse.jdt.launching.j9/j9/org/eclipse/jdt/internal/launching/j9/J9LaunchingPlugin.java;1;0;1;1;1;1;1;0;9;0;0;5475;9;9;1;0;0;0;1;5475;0;5475;1;1;
/org.eclipse.jdt.ui.tests.refactoring/resources/ExtractMethodWorkSpace/ExtractMethodTests/return_out/A_test701.java;1;0;2;1;0;0;0;2;4;1;2;130;5;5;1;0;0;2;2;130;0;844;2;1;
/org.eclipse.releng.basebuilder/plugins/org.eclipse.build.tools/src/org/eclipse/releng/CompileErrorCheck.java;1;0;3;1;0;0;0;3;47;2;2;993;47;47;2;1;0;3;3;3593;1;3593;2;1;
/org.eclipse.search.tests/src/org/eclipse/search/core/tests/NullSearchResult.java;1;1;3;1;2;2;2;1;34;0;1;4345;50;50;1;0;0;1;3;4345;0;5305;3;1;
/org.eclipse.team.webdav/src/org/eclipse/team/internal/webdav/core/Policy.java;1;0;2;1;1;1;1;1;4;0;1;4216;6;6;1;0;0;1;2;4216;0;6337;2;1;
/org.eclipse.jdt.core/model/org/eclipse/jdt/internal/core/util/StackMapFrame.java;1;0;1;1;0;0;0;1;0;0;1;3791;0;0;1;0;0;1;1;3791;0;3791;1;1;
/org.eclipse.jdt.debug.ui/Snippet Support/org/eclipse/jdt/internal/debug/ui/snippeteditor/ScrapbookMain1.java;1;0;1;1;0;0;0;1;0;0;1;724;0;0;1;0;0;1;1;724;0;724;1;1;
/org.eclipse.jdt.debug.ui/ui/org/eclipse/jdt/internal/debug/ui/console/JavaStackTraceHyperlink.java;1;1;3;1;2;2;2;1;105;0;1;5081;112;112;1;0;0;1;3;5081;0;6037;3;1;
/org.eclipse.jdt.ui/core extension/org/eclipse/jdt/internal/corext/util/TypeInfoRequestor.java;2;0;2;1;1;1;1;1;18;0;1;3168;20;20;1;0;0;1;2;3168;0;6340;2;2;
/org.eclipse.pde.ui/src_Forms/org/eclipse/pde/internal/ui/neweditor/build/BuildEditor.java;2;2;3;2;3;2;3;0;9;0;0;5391;9;9;2;0;1;0;3;5391;1;5431;2;2;
/org.eclipse.team.core/src/org/eclipse/team/core/variants/ThreeWayRemoteTree.java;1;1;3;1;2;2;2;1;28;0;1;4349;32;32;1;0;0;1;3;4349;0;6125;3;1;
/org.eclipse.jdt.core.tests.compiler/src/org/eclipse/jdt/core/tests/runtime/J9VirtualMachine.java;2;0;2;1;1;1;1;1;19;0;1;3560;21;21;1;0;0;1;2;3560;0;5853;2;2;
/org.eclipse.jdt.core.tests.model/workspace/Converter/src/test0145/Test.java;1;0;1;1;0;0;0;1;0;0;1;3714;0;0;1;0;0;1;1;3714;0;3714;1;1;
/org.eclipse.jdt.core.tests.model/workspace/Converter15/src/test0006/X.java;1;0;1;1;0;0;0;1;0;0;1;4631;0;0;1;0;0;1;1;4631;0;4631;1;1;
/org.eclipse.jdt.core.tests.compiler/src/org/eclipse/jdt/core/tests/compiler/regression/ProblemConstructorTest.java;3;0;3;2;0;0;0;3;32;2;2;1129;48;48;2;1;0;3;3;3557;1;3557;2;3;
/org.eclipse.jdt.core.tests.model/workspace/Converter/junit/ui/TestRunner.java;1;0;1;1;0;0;0;1;0;0;1;787;0;0;1;0;0;1;1;787;0;787;1;1;
/org.eclipse.core.tests.runtime/src/org/eclipse/core/tests/internal/runtimetests/SampleOPB.java;1;0;1;1;1;1;1;0;21;0;0;5149;21;21;1;0;0;0;1;5149;0;5149;1;1;
/org.eclipse.jdt.core.tests.model/workspace/Formatter/test094/A_in.java;1;0;1;1;0;0;0;1;0;0;1;2425;0;0;1;0;0;1;1;2425;0;2425;1;1;
/org.eclipse.ant.ui/Ant Editor/org/eclipse/ant/ui/internal/editor/xml/XmlElement.java;1;0;2;1;0;0;0;2;0;1;2;250;0;0;1;0;0;2;2;250;0;1811;2;1;
/org.eclipse.jface.text/src/org/eclipse/jface/text/source/SourceViewerConfiguration.java;2;1;7;1;3;3;3;4;26;1;4;1314;68;68;1;0;0;4;7;1314;0;6361;7;2;
/org.eclipse.jdt.ui/ui/org/eclipse/jdt/internal/ui/text/javadoc/ICommentTagConstants.java;2;0;2;1;1;1;1;1;6;0;1;3829;6;6;1;0;0;1;2;3829;0;6340;2;2;
/org.eclipse.ant.ui/Ant Editor/org/eclipse/ant/ui/internal/editor/text/XMLAnnotationIterator.java;1;0;2;1;0;0;0;2;0;1;2;250;0;0;1;0;0;2;2;250;0;1811;2;1;
/org.eclipse.pde.core/src_OSGi/org/eclipse/pde/internal/core/osgi/OSGiExternalModelManager.java;2;0;9;1;0;0;0;9;28;2;8;2229;80;80;2;1;0;9;9;3272;1;4203;8;2;
/org.eclipse.jdt.core.tests.model/workspace/Formatter/test394/A_in.java;1;0;1;1;0;0;0;1;0;0;1;3426;0;0;1;0;0;1;1;3426;0;3426;1;1;
/org.eclipse.debug.ui/ui/org/eclipse/debug/ui/ILaunchGroup.java;1;0;1;1;1;1;1;0;0;0;0;5207;0;0;1;0;0;0;1;5207;0;5207;1;1;
/org.eclipse.core.runtime/src/org/eclipse/core/runtime/model/PluginDescriptorModel.java;2;0;2;1;0;0;0;2;3;1;2;2105;3;3;1;0;0;2;2;2105;0;3013;2;2;
/org.eclipse.jdt.debug.tests/tests/org/eclipse/jdt/debug/tests/eval/TypeHierarchy_32_3.java;1;0;1;1;0;0;0;1;6;0;1;1274;6;6;1;0;0;1;1;1274;0;1274;1;1;
/org.eclipse.jdt.core.tests.model/workspace/Converter/src/test0051/Test.java;1;0;1;1;0;0;0;1;0;0;1;3714;0;0;1;0;0;1;1;3714;0;3714;1;1;
/org.eclipse.ui.ide/src/org/eclipse/ui/ide/IMarkerEditorPositioner.java;3;0;4;2;0;0;0;4;4;2;3;1634;6;6;2;1;0;4;4;1634;1;2241;3;3;
/org.eclipse.pde/src/org/eclipse/pde/internal/builders/SchemaHandler.java;2;1;7;1;3;3;3;4;10;1;4;2906;30;30;1;0;0;4;7;2906;0;6336;7;2;
/org.eclipse.help.base/src/org/eclipse/help/internal/search/ProgressDistributor.java;1;1;3;1;2;2;2;1;15;0;1;1740;21;21;1;0;0;1;3;1740;0;6337;3;1;
/org.eclipse.jdt.core.tests.model/workspace/Formatter/test110/A_out.java;1;0;1;1;0;0;0;1;0;0;1;2425;0;0;1;0;0;1;1;2425;0;2425;1;1;
/org.eclipse.update.scheduler/src/org/eclipse/update/internal/scheduler/UpdateScheduler.java;3;1;19;1;4;4;4;15;202;5;9;974;713;713;5;6;0;15;19;974;6;6336;13;3;
/org.eclipse.debug.ui/ui/org/eclipse/debug/internal/ui/actions/ShowTypesAction.java;1;0;1;1;0;0;0;1;3;0;1;1239;3;3;1;0;0;1;1;1239;0;1239;1;1;
/org.eclipse.jdt.core/search/org/eclipse/jdt/internal/core/index/impl/MergeFactory.java;1;0;3;1;0;0;0;3;2;1;3;3194;4;4;1;0;0;3;3;3194;0;4060;3;1;
/org.eclipse.ant.ui/Ant Editor/org/eclipse/ant/internal/ui/dtd/schema/Atom.java;1;0;1;1;0;0;0;1;0;0;1;1811;0;0;1;0;0;1;1;1811;0;1811;1;1;
/org.eclipse.team.core/src/org/eclipse/team/core/DeploymentProvider.java;1;0;3;1;0;0;0;3;136;1;3;2793;136;136;1;0;0;3;3;2793;0;4633;3;1;
/org.eclipse.ui.workbench/Eclipse UI/org/eclipse/ui/internal/registry/NavigatorRootDescriptor.java;1;0;1;1;0;0;0;1;0;0;1;1083;0;0;1;0;0;1;1;1083;0;1083;1;1;
/org.eclipse.webdav/src/kernel/org/eclipse/webdav/internal/kernel/WebDAVPropertyValues.java;1;0;1;1;1;1;1;0;7;0;0;5151;7;7;1;0;0;0;1;5151;0;5151;1;1;
/org.eclipse.debug.core/core/org/eclipse/debug/core/sourcelookup/ISourceLookupDirector.java;1;0;4;1;1;1;1;3;58;1;3;4949;66;66;1;0;0;3;4;4949;0;5109;4;1;
/org.eclipse.jdt.core.tests.model/src/org/eclipse/jdt/core/tests/model/SearchParticipantTests.java;1;0;1;1;1;1;1;0;0;0;0;6099;0;0;1;0;0;0;1;6099;0;6099;1;1;
/org.eclipse.jdt.ui/ui refactoring/org/eclipse/jdt/internal/ui/refactoring/CreateChangeOperation.java;2;0;4;1;0;0;0;4;44;1;4;3536;51;51;1;0;0;4;4;3536;0;4575;4;2;
/org.eclipse.jdt.ui/core extension/org/eclipse/jdt/internal/corext/textmanipulation/AutoOrganizingTextEdit.java;1;0;2;1;0;0;0;2;4;1;2;1012;4;4;1;0;0;2;2;1012;0;1576;2;1;
/org.eclipse.jdt.core/model/org/eclipse/jdt/core/util/OpcodeStringValues.java;1;0;1;1;0;0;0;1;2;0;1;3560;2;2;1;0;0;1;1;3560;0;3560;1;1;
/org.eclipse.ui.views/src/org/eclipse/ui/views/bookmarkexplorer/MarkerUtil.java;1;0;1;1;0;0;0;1;0;0;1;2738;0;0;1;0;0;1;1;2738;0;2738;1;1;
/org.eclipse.jdt.ui/ui/org/eclipse/jdt/internal/ui/text/spelling/engine/AbstractSpellDictionary.java;2;0;2;1;1;1;1;1;2;0;1;3930;2;2;1;0;0;1;2;3930;0;6340;2;2;
/org.eclipse.core.tests.runtime/src/org/eclipse/core/tests/runtime/TestAdapterFactory.java;2;0;2;1;1;1;1;1;3;0;1;4128;3;3;1;0;0;1;2;4128;0;5149;2;2;
/org.eclipse.jdt.core.tests.model/workspace/Converter/test0168/test1/Test.java;1;0;1;1;0;0;0;1;0;0;1;3714;0;0;1;0;0;1;1;3714;0;3714;1;1;
/org.eclipse.jdt.ui/core refactoring/org/eclipse/ltk/refactoring/core/NullChange.java;1;0;2;1;0;0;0;2;0;1;2;3930;0;0;1;0;0;2;2;3930;0;4510;2;1;
/org.eclipse.team.core/src/org/eclipse/team/core/subscribers/SynchronizationCache.java;1;0;1;1;0;0;0;1;0;0;1;3193;0;0;1;0;0;1;1;3193;0;3193;1;1;
/org.eclipse.jface/src/org/eclipse/jface/action/ToolBarManager.java;5;0;6;1;1;1;1;5;506;1;5;1;534;534;1;0;0;5;6;1;0;6338;6;5;
/org.eclipse.ui.workbench/Eclipse UI/org/eclipse/ui/internal/commands/ICategoryDefinition.java;1;0;4;1;0;0;0;4;33;1;4;1422;37;37;1;0;0;4;4;1422;0;3128;4;1;
/org.eclipse.ui.views/src/org/eclipse/ui/views/internal/markers/tasks/TaskFilter.java;1;0;3;1;0;0;0;3;317;1;3;265;317;317;1;0;0;3;3;265;0;749;3;1;
/org.eclipse.jdt.ui.tests/ui/org/eclipse/jdt/ui/tests/browsing/PackagesViewContentProviderTests2.java;2;1;3;1;2;2;2;1;26;0;1;1647;40;40;1;0;0;1;3;1647;0;6340;3;2;
/org.eclipse.ui.ide/extensions/org/eclipse/ui/actions/CopyFilesAndFoldersOperation.java;3;0;3;1;1;1;1;2;5;1;2;2263;7;7;1;0;0;2;3;2263;0;6338;3;3;
/org.eclipse.ui.workbench/Eclipse UI/org/eclipse/ui/contexts/IContextService.java;1;0;3;1;0;0;0;3;12;1;3;1119;12;12;1;0;0;3;3;1119;0;1220;3;1;
/org.eclipse.jdt.core/formatter/org/eclipse/jdt/internal/formatter/OptimizedReplaceEdit.java;2;0;2;1;0;0;0;2;2;1;2;2158;2;2;1;0;0;2;2;2158;0;3560;2;2;
/org.eclipse.jdt.ui.tests.refactoring/resources/ExtractMethodWorkSpace/ExtractMethodTests/locals_out/A_test562.java;1;0;1;1;0;0;0;1;4;0;1;844;4;4;1;0;0;1;1;844;0;844;1;1;
/org.eclipse.jface/src/org/eclipse/jface/dialogs/ErrorDialog.java;3;1;10;1;6;6;6;4;405;2;3;1;478;478;2;1;0;4;10;202;1;5615;9;3;
/org.eclipse.jdt.core/compiler/org/eclipse/jdt/internal/compiler/flow/InsideSubRoutineFlowContext.java;2;0;5;1;0;0;0;5;7;1;5;148;17;17;1;0;0;5;5;148;0;3560;5;2;
/org.eclipse.jdt.core.tests.model/workspace/Formatter/test069/A_in.java;1;0;1;1;0;0;0;1;0;0;1;2425;0;0;1;0;0;1;1;2425;0;2425;1;1;
/org.eclipse.team.ui/src/org/eclipse/team/ui/synchronize/subscriber/RefreshCompleteDialog.java;1;0;3;1;0;0;0;3;56;1;3;4518;56;56;1;0;0;3;3;4518;0;4632;3;1;
/org.eclipse.ui.views/src/org/eclipse/ui/views/internal/markers/tasks/TaskFiltersDialog.java;1;0;3;1;0;0;0;3;8;1;3;265;8;8;1;0;0;3;3;265;0;749;3;1;
/org.eclipse.ui.workbench/Eclipse UI/org/eclipse/ui/internal/commands/old/IContextEvent.java;1;0;2;1;0;0;0;2;0;0;1;1430;0;0;2;1;0;2;2;1430;1;1430;1;1;
/org.eclipse.jdt.ui.tests.refactoring/resources/Paste/test4/out/B.java;1;0;1;1;0;0;0;1;0;0;1;1311;0;0;1;0;0;1;1;1311;0;1311;1;1;
/org.eclipse.jdt.ui.tests.refactoring/resources/MoveMembers/test35/out/A.java;1;0;1;1;0;0;0;1;0;0;1;1856;0;0;1;0;0;1;1;1856;0;1856;1;1;
/org.eclipse.osgi/core/framework/org/eclipse/osgi/framework/internal/core/ServiceReference.java;3;0;3;1;1;1;1;2;383;1;2;3013;383;383;1;0;0;2;3;3013;0;5116;3;3;
/org.eclipse.team.ui/src/org/eclipse/team/internal/ui/synchronize/GlobalRefreshResourceSelectionPage.java;2;1;8;1;8;8;8;0;242;0;0;5362;626;626;1;0;0;0;8;5362;0;6337;8;2;
/org.eclipse.pde.ui/src_Forms/org/eclipse/pde/internal/ui/neweditor/build/SrcSection.java;2;1;5;1;3;3;3;2;17;1;2;4406;24;24;1;0;0;2;5;4406;0;5431;5;2;
/org.eclipse.jface.text/src/org/eclipse/jface/text/information/IInformationProviderExtension.java;1;1;2;1;2;2;2;0;6;0;0;6340;8;8;1;0;0;0;2;6340;0;6352;2;1;
/org.eclipse.ui.ide/src/org/eclipse/ui/internal/dialogs/ResourceSorter.java;2;0;2;1;0;0;0;2;0;1;2;1526;0;0;1;0;0;2;2;1526;0;2263;2;2;
/org.eclipse.jdt.ui/ui refactoring/org/eclipse/jdt/internal/ui/refactoring/actions/MoveInstanceMethodAction.java;3;0;11;1;1;1;1;10;72;2;9;142;182;182;2;1;0;10;11;142;1;6340;10;3;
/org.eclipse.pde.ui/src/org/eclipse/pde/internal/ui/editor/feature/PluginSection.java;3;1;9;1;4;4;4;5;98;1;5;648;195;195;1;0;0;5;9;648;0;6336;9;3;
/org.eclipse.jdt.debug.ui/ui/org/eclipse/jdt/internal/debug/core/refactoring/LaunchConfigurationIPackageFragmentMoveParticipant.java;2;1;2;1;2;2;2;0;9;0;0;6019;11;11;1;0;0;0;2;6019;0;6339;2;2;
/org.eclipse.releng.tools/src/org/eclipse/releng/tools/Messages.java;1;0;1;1;1;1;1;0;0;0;0;5183;0;0;1;0;0;0;1;5183;0;5183;1;1;
/org.eclipse.ui.externaltools/Ant Editor/org/eclipse/ui/externaltools/internal/ant/editor/outline/OutlinePreparingHandler.java;1;0;3;1;0;0;0;3;4;1;3;178;7;7;1;0;0;3;3;178;0;282;3;1;
/org.eclipse.update.ui/srcnew/org/eclipse/update/internal/ui/ConfigurationManagerAction.java;2;0;4;2;0;0;0;4;21;2;3;480;22;22;2;1;0;4;4;480;1;825;3;2;
/org.eclipse.swt/Eclipse SWT Drag and Drop/carbon/org/eclipse/swt/dnd/Clipboard.java;2;1;8;1;2;2;2;6;110;1;6;0;263;263;1;0;0;6;8;0;0;6352;8;2;
/org.eclipse.ant.ui/Ant Tools Support/org/eclipse/ui/ant/internal/views/actions/AntOpenWithMenu.java;1;0;2;1;0;0;0;2;28;1;2;250;28;28;1;0;0;2;2;250;0;263;2;1;
/org.eclipse.jdt.ui/core refactoring/org/eclipse/ltk/core/refactoring/IUndoManagerListener.java;1;0;2;1;0;0;0;2;0;1;2;4575;0;0;1;0;0;2;2;4575;0;4864;2;1;
/org.eclipse.jdt.ui/ui/org/eclipse/jdt/internal/ui/text/java/ExperimentalResultCollector.java;2;0;3;1;1;1;1;2;6;1;2;1234;10;10;1;0;0;2;3;1234;0;6340;3;2;
/org.eclipse.ui.ide/src/org/eclipse/ui/views/navigator/ResourceNavigatorActionGroup.java;2;0;2;1;0;0;0;2;2;1;2;2208;2;2;1;0;0;2;2;2208;0;3308;2;2;
/org.eclipse.osgi/core/framework/org/eclipse/osgi/framework/eventmgr/EventSource.java;4;0;4;1;0;0;0;4;47;1;4;3013;48;48;1;0;0;4;4;3013;0;5097;4;4;
/org.eclipse.pde.ui/src_Forms/org/eclipse/pde/internal/ui/neweditor/schema/ICloneablePropertySource.java;1;0;2;1;0;0;0;2;0;1;2;4856;0;0;1;0;0;2;2;4856;0;4879;2;1;
/org.eclipse.jdt.core/compiler/org/eclipse/jdt/internal/compiler/ast/ForStatement.java;3;0;12;2;2;1;2;10;74;3;8;953;141;141;3;2;1;10;12;989;3;5339;9;3;
/org.eclipse.core.tests.runtime/src/org/eclipse/core/tests/runtime/jobs/SimpleRuleRunner.java;1;0;1;1;1;1;1;0;0;0;0;5530;0;0;1;0;0;0;1;5530;0;5530;1;1;
/org.eclipse.jdt.ui.tests.refactoring/resources/DeleteSourceReference/test1/out/A.java;1;0;1;1;0;0;0;1;0;0;1;1652;0;0;1;0;0;1;1;1652;0;1652;1;1;
/org.eclipse.team.webdav/src/org/eclipse/team/internal/webdav/core/deployment/WebDavDeploymentProvider.java;1;0;1;1;0;0;0;1;0;0;1;3477;0;0;1;0;0;1;1;3477;0;3477;1;1;
/org.eclipse.core.filebuffers/src/org/eclipse/core/filebuffers/FileBuffers.java;2;2;12;2;6;4;6;6;63;2;5;1522;158;158;2;1;2;6;12;2446;3;6333;9;2;
/org.eclipse.swt/Eclipse SWT/common/org/eclipse/swt/internal/image/GIFFileFormat.java;1;0;1;1;0;0;0;1;7;0;1;491;7;7;1;0;0;1;1;491;0;491;1;1;
/org.eclipse.jdt.ui/ui/org/eclipse/jdt/internal/ui/wizards/buildpaths/EditVariableEntryDialog.java;2;1;3;1;2;2;2;1;25;0;1;1350;31;31;1;0;0;1;3;1350;0;6340;3;2;
/org.eclipse.help/src/org/eclipse/help/internal/toc/Topic.java;1;1;10;1;3;3;3;7;70;1;7;600;162;162;1;0;0;7;10;600;0;6337;10;1;
/org.eclipse.swt/Eclipse SWT/gtk1x/org/eclipse/swt/widgets/ToolBar.java;2;0;2;1;0;0;0;2;3;1;2;110;3;3;1;0;0;2;2;110;0;2327;2;2;
/org.eclipse.ant.core/src/org/eclipse/ant/core/Property.java;1;1;8;1;2;2;2;6;94;2;4;1401;175;175;2;2;0;6;8;1401;2;6335;6;1;
/org.eclipse.text/projection/org/eclipse/jface/text/ProjectionDocumentManager.java;1;0;2;1;1;1;1;1;1;0;1;4516;1;1;1;0;0;1;2;4516;0;5177;2;1;
/org.eclipse.ui.workbench/Eclipse UI/org/eclipse/ui/IWorkbenchPartReference.java;2;2;4;1;4;3;4;0;21;0;0;5805;25;25;2;0;1;0;4;5805;1;6338;3;2;
/org.eclipse.ui.views/src/org/eclipse/ui/views/markers/internal/IMarkerChangedListener.java;2;0;2;1;0;0;0;2;0;1;2;755;0;0;1;0;0;2;2;755;0;2738;2;2;
/org.eclipse.ant.ui/Ant Editor/org/eclipse/ant/internal/ui/editor/text/AbstractAntEditorScanner.java;1;0;1;1;1;1;1;0;0;0;0;5721;0;0;1;0;0;0;1;5721;0;5721;1;1;
/org.eclipse.ui.workbench/Eclipse UI/org/eclipse/ui/internal/contexts/ContextActivationService.java;1;0;9;1;0;0;0;9;60;2;7;1220;110;110;2;2;0;9;9;1239;2;3109;7;1;
/org.eclipse.pde.ui/templates/editor/java/TagRule.java;1;0;1;1;0;0;0;1;10;0;1;851;10;10;1;0;0;1;1;851;0;851;1;1;
/org.eclipse.pde.core/src/org/eclipse/pde/internal/core/site/SiteFeature.java;2;1;4;1;2;2;2;2;198;1;2;2311;255;255;1;0;0;2;4;2311;0;6336;4;2;
/org.eclipse.jdt.ui.tests.refactoring/resources/ExtractTemp/canExtract/A_test81_in.java;1;0;1;1;1;1;1;0;0;0;0;5911;0;0;1;0;0;0;1;5911;0;5911;1;1;
/org.eclipse.jdt.core.tests.model/workspace/Converter/src/test0262/Test.java;1;0;1;1;0;0;0;1;0;0;1;3714;0;0;1;0;0;1;1;3714;0;3714;1;1;
/org.eclipse.jdt.core.tests.model/workspace/Formatter/test004/A_in.java;1;0;1;1;0;0;0;1;0;0;1;2425;0;0;1;0;0;1;1;2425;0;2425;1;1;
/org.eclipse.jdt.ui/ui/org/eclipse/jdt/internal/ui/search/ISearchPatternData.java;1;0;1;1;0;0;0;1;0;0;1;3488;0;0;1;0;0;1;1;3488;0;3488;1;1;
/org.eclipse.pde.ui/src/org/eclipse/pde/internal/ui/search/FindPluginReferencesAction.java;2;1;3;1;2;2;2;1;18;0;1;1;32;32;1;0;0;1;3;1;0;6336;3;2;
/org.eclipse.jdt.ui/ui/org/eclipse/jdt/internal/ui/preferences/FoldingConfigurationBlock.java;1;1;2;1;2;2;2;0;2;0;0;5440;2;2;1;0;0;0;2;5440;0;6340;2;1;
/org.eclipse.update.ui.forms/Eclipse Forms/org/eclipse/ui/forms/DetailsPart.java;1;0;4;1;0;0;0;4;127;1;4;3733;131;131;1;0;0;4;4;3733;0;4157;4;1;
/org.eclipse.search/new search/org/eclipse/search2/internal/ui/basic/views/SearchResultsTreeViewer.java;1;0;2;1;1;1;1;1;0;0;1;3474;0;0;1;0;0;1;2;3474;0;5106;2;1;
/org.eclipse.pde.ui/src/org/eclipse/pde/internal/ui/wizards/project/PluginSelectionDialog.java;2;0;5;1;0;0;0;5;189;2;4;791;202;202;2;1;0;5;5;791;1;3393;4;2;
/org.eclipse.jdt.debug.ui/ui/org/eclipse/jdt/debug/ui/launchConfigurations/AppletParametersTab.java;4;1;8;1;2;2;2;6;78;2;5;112;136;136;2;1;0;6;8;2586;1;6336;7;4;
/org.eclipse.swt/Eclipse SWT OLE Win32/win32/org/eclipse/swt/ole/win32/OlePropertyChangeSink.java;2;1;2;1;2;2;2;0;4;0;0;5960;6;6;1;0;0;0;2;5960;0;6352;2;2;
/org.eclipse.jdt.core.tests.model/workspace/Formatter/test330/A_out.java;1;0;1;1;0;0;0;1;0;0;1;2640;0;0;1;0;0;1;1;2640;0;2640;1;1;
/org.eclipse.jdt.core.tests.model/src/org/eclipse/jdt/core/tests/dom/ASTConverterTest2.java;6;5;79;2;20;14;20;59;756;2;53;13;4650;4650;5;6;6;59;79;5632;12;6078;67;6;
/org.eclipse.core.resources/src/org/eclipse/core/internal/resources/ProjectNatureDescriptor.java;2;0;2;1;1;1;1;1;214;0;1;1477;216;216;1;0;0;1;2;1477;0;5146;2;2;
/org.eclipse.update.ui/src/org/eclipse/update/internal/ui/wizards/InstallWizard.java;4;1;21;2;4;4;4;17;801;2;15;755;1907;1907;2;2;0;17;21;1526;2;6336;19;4;
/org.eclipse.jdt.core/dom/org/eclipse/jdt/core/dom/SimplePropertyDescriptor.java;2;0;2;1;1;1;1;1;4;0;1;4202;4;4;1;0;0;1;2;4202;0;5871;2;2;
/org.eclipse.osgi/eclipseAdaptor/src/org/eclipse/osgi/framework/stats/ResourceBundleStats.java;3;1;3;1;2;2;2;1;20;0;1;3013;24;24;1;0;0;1;3;3013;0;6337;3;3;
/org.eclipse.core.tests.runtime/src/org/eclipse/core/tests/internal/runtimetests/SampleKPR.java;1;0;1;1;1;1;1;0;21;0;0;5149;21;21;1;0;0;0;1;5149;0;5149;1;1;
/org.eclipse.debug.ui/ui/org/eclipse/debug/ui/EnvironmentTab.java;4;1;42;2;5;5;5;37;263;4;26;265;988;988;4;11;0;37;42;1197;11;5855;31;4;
/org.eclipse.ui.workbench/Eclipse UI/org/eclipse/ui/commands/ActionHandler.java;2;1;11;1;2;2;2;9;134;5;5;4088;294;294;5;4;0;9;11;4952;4;5444;7;2;
/org.eclipse.jdt.ui/core extension/org/eclipse/jdt/internal/corext/dom/RewriteInsertPosition.java;1;0;2;1;0;0;0;2;0;1;2;3580;0;0;1;0;0;2;2;3580;0;3593;2;1;
/org.eclipse.swt/Eclipse SWT Mozilla/common/org/eclipse/swt/internal/mozilla/nsIEventSink.java;1;0;1;1;0;0;0;1;0;0;1;1691;0;0;1;0;0;1;1;1691;0;1691;1;1;
/org.eclipse.jdt.ui.tests.refactoring/resources/RenameNonPrivateField/test17/out/A.java;1;0;1;1;1;1;1;0;0;0;0;6118;0;0;1;0;0;0;1;6118;0;6118;1;1;
/org.eclipse.jdt.ui.tests.refactoring/resources/Delete/testDeleteWithinCu21/in/A.java;1;0;1;1;0;0;0;1;0;0;1;1186;0;0;1;0;0;1;1;1186;0;1186;1;1;
/org.eclipse.search/new search/org/eclipse/search2/internal/ui/text/MarkerHighlighter.java;1;2;7;1;7;5;7;0;22;0;0;5500;53;53;2;0;2;0;7;5500;2;6116;5;1;
/org.eclipse.team.cvs.ui/src/org/eclipse/team/internal/ccvs/ui/repo/NewDateTagAction.java;2;0;3;1;1;1;1;2;57;1;2;2569;59;59;1;0;0;2;3;2569;0;6337;3;2;
/org.eclipse.ant.tests.ui/test plugin/org/eclipse/ant/tests/ui/testplugin/DebugEventWaiter.java;1;0;1;1;0;0;0;1;0;0;1;1610;0;0;1;0;0;1;1;1610;0;1610;1;1;
/org.eclipse.jdt.ui/core refactoring/org/eclipse/jdt/internal/corext/refactoring/code/SourceAnalyzer.java;3;1;10;1;2;2;2;8;30;1;8;597;86;86;1;0;0;8;10;597;0;6340;10;3;
/org.eclipse.ui.workbench/Eclipse UI/org/eclipse/ui/internal/CoolItemGroup.java;1;0;1;1;0;0;0;1;0;0;1;3220;0;0;1;0;0;1;1;3220;0;3220;1;1;
/org.eclipse.ant.ui/Ant Tools Support/org/eclipse/ant/internal/ui/views/actions/AddBuildFilesAction.java;2;1;3;1;2;2;2;1;10;0;1;3147;12;12;1;0;0;1;3;3147;0;6039;3;2;
/org.eclipse.jdt.core.tests.model/workspace/Converter/src/testJ01/Test.java;1;0;2;1;0;0;0;2;0;1;2;3762;0;0;1;0;0;2;2;3762;0;3792;2;1;
/org.eclipse.jdt.core/model/org/eclipse/jdt/core/util/IMethodInfo.java;1;0;2;1;0;0;0;2;10;1;2;3560;12;12;1;0;0;2;2;3560;0;4843;2;1;
/org.eclipse.jdt.ui/core refactoring/org/eclipse/jdt/internal/corext/refactoring/sef/EncapsulatePrefixAccess.java;1;0;1;1;0;0;0;1;0;0;1;1492;0;0;1;0;0;1;1;1492;0;1492;1;1;
/org.eclipse.ui.workbench/Eclipse UI/org/eclipse/ui/testing/ITestableListener.java;1;0;1;1;0;0;0;1;0;0;1;2231;0;0;1;0;0;1;1;2231;0;2231;1;1;
/org.eclipse.ui.views/src/org/eclipse/ui/views/internal/markers/tasks/TaskPropertiesAction.java;1;0;2;1;0;0;0;2;0;1;2;265;0;0;1;0;0;2;2;265;0;749;2;1;
/org.eclipse.jdt.ui.tests.refactoring/resources/MoveInstanceMethod/canMove/test20/in/B.java;1;0;1;1;0;0;0;1;0;0;1;1586;0;0;1;0;0;1;1;1586;0;1586;1;1;
/org.eclipse.core.runtime.osgi/src/org/eclipse/core/internal/registry/Extension.java;1;0;2;1;0;0;0;2;7;1;2;3013;7;7;1;0;0;2;2;3013;0;3030;2;1;
/org.eclipse.ant.ui/Ant Tools Support/org/eclipse/ant/ui/internal/launchConfigurations/AntJRETab.java;2;0;10;1;0;0;0;10;214;1;10;250;385;385;1;0;0;10;10;250;0;1811;10;2;
/org.eclipse.swt/Eclipse SWT/gtk1x/org/eclipse/swt/widgets/Label.java;1;0;1;1;0;0;0;1;0;0;1;2327;0;0;1;0;0;1;1;2327;0;2327;1;1;
/org.eclipse.core.resources/src/org/eclipse/core/resources/team/IMoveDeleteHook.java;1;0;3;1;1;1;1;2;92;1;2;4994;100;100;1;0;0;2;3;4994;0;5146;3;1;
/org.eclipse.ui.workbench/Eclipse UI/org/eclipse/ui/internal/contexts/FileRegistry.java;1;0;4;1;0;0;0;4;4;2;3;1356;6;6;2;1;0;4;4;1356;1;1396;3;1;
/org.eclipse.team.ui/src/org/eclipse/team/internal/ui/sync/pages/SynchronizeViewWorkbenchPart.java;1;0;1;1;0;0;0;1;0;0;1;2406;0;0;1;0;0;1;1;2406;0;2406;1;1;
/org.eclipse.jdt.core.tests.model/workspace/Formatter/test350/A_out.java;2;0;3;1;1;1;1;2;46;1;2;3029;50;50;1;0;0;2;3;3029;0;5132;3;2;
/org.eclipse.jdt.core.tests.model/workspace/Formatter/test003/A_out.java;1;0;1;1;0;0;0;1;0;0;1;2425;0;0;1;0;0;1;1;2425;0;2425;1;1;
/org.eclipse.ui.workbench/Eclipse UI/org/eclipse/ui/internal/progress/TaskInfo.java;2;1;12;1;2;2;2;10;60;1;10;320;191;191;1;0;0;10;12;320;0;6338;12;2;
/org.eclipse.jdt.core.tests.model/workspace/Converter/test0483/A.java;1;0;2;1;0;0;0;2;0;1;2;1289;0;0;1;0;0;2;2;1289;0;3714;2;1;
/org.eclipse.jdt.ui/ui/org/eclipse/jdt/internal/ui/javaeditor/InternalClassFileEditorInput.java;1;0;1;1;1;1;1;0;2;0;0;6340;2;2;1;0;0;0;1;6340;0;6340;1;1;
/org.eclipse.ui.workbench.texteditor/src/org/eclipse/ui/texteditor/IAnnotationPresenter.java;1;0;1;1;0;0;0;1;0;0;1;2874;0;0;1;0;0;1;1;2874;0;2874;1;1;
/org.eclipse.jdt.ui.tests.refactoring/test cases/org/eclipse/jdt/ui/tests/refactoring/UseSupertypeWherePossibleTests.java;5;0;6;1;1;1;1;5;15;1;5;1166;53;53;1;0;0;5;6;1166;0;6340;6;5;
/org.eclipse.core.tests.harness/src/org/eclipse/core/tests/harness/WorkspaceSessionTest.java;1;0;1;1;1;1;1;0;38;0;0;5146;38;38;1;0;0;0;1;5146;0;5146;1;1;
/org.eclipse.ui.workbench/Eclipse UI/org/eclipse/ui/internal/commands/ws/WorkbenchCommandHandlerService.java;1;0;3;1;0;0;0;3;106;1;3;3129;106;106;1;0;0;3;3;3129;0;3172;3;1;
/org.eclipse.ui.ide/src/org/eclipse/ui/views/bookmarkexplorer/CopyBookmarkAction.java;1;0;2;1;0;0;0;2;4;1;2;2208;4;4;1;0;0;2;2;2208;0;2264;2;1;
/org.eclipse.core.tests.runtime/src/org/eclipse/core/tests/runtime/PreferencesTest.java;1;0;6;1;1;1;1;5;302;2;4;4351;403;403;2;1;0;5;6;4625;1;5149;5;1;
/org.eclipse.jdt.ui/core refactoring/org/eclipse/jdt/internal/corext/refactoring/rename/RenameFieldProcessor.java;4;1;35;2;10;10;10;25;265;3;20;1125;770;770;3;5;0;25;35;1946;5;6340;30;4;
/org.eclipse.ui.workbench/Eclipse UI/org/eclipse/ui/internal/csm/commands/IMutableCommandRegistry.java;1;0;3;1;0;0;0;3;6;2;2;2532;6;6;2;1;0;3;3;2556;1;2556;2;1;
/org.eclipse.ui.workbench/Eclipse UI/org/eclipse/ui/internal/commands/registry/Command.java;1;0;2;1;0;0;0;2;0;1;2;1077;0;0;1;0;0;2;2;1077;0;1222;2;1;
/org.eclipse.jdt.ui.tests.refactoring/resources/RenameVirtualMethodInClass/testFail39/in/A.java;1;0;1;1;1;1;1;0;0;0;0;5524;0;0;1;0;0;0;1;5524;0;5524;1;1;
/org.eclipse.ltk.core.refactoring/src/org/eclipse/ltk/core/refactoring/participants/CopyParticipant.java;1;1;4;1;2;2;2;2;20;1;2;4845;36;36;1;0;0;2;4;4845;0;5190;4;1;
/org.eclipse.ltk.ui.refactoring/src/org/eclipse/ltk/ui/refactoring/IStatusContextViewer.java;1;1;4;1;2;2;2;2;27;1;2;4965;40;40;1;0;0;2;4;4965;0;6340;4;1;
/org.eclipse.jdt.ui/core extension/org/eclipse/jdt/internal/corext/dom/OldASTRewrite.java;2;1;4;1;2;2;2;2;79;1;2;4794;95;95;1;0;0;2;4;4794;0;6340;4;2;
/org.eclipse.ltk.ui.refactoring/src/org/eclipse/ltk/ui/refactoring/RefactoringUI.java;1;1;11;1;6;6;6;5;32;2;4;4965;150;150;2;1;0;5;11;5080;1;6323;10;1;
/org.eclipse.core.tests.runtime/src/org/eclipse/core/tests/internal/plugins/PluginResolveTest_15.java;1;0;1;1;0;0;0;1;0;0;1;3014;0;0;1;0;0;1;1;3014;0;3014;1;1;
/org.eclipse.ui.workbench/Eclipse UI/org/eclipse/ui/internal/commands/registry/ContextBindingDefinition.java;1;0;5;1;0;0;0;5;45;2;4;1396;60;60;2;1;0;5;5;1396;1;1724;4;1;
/org.eclipse.jdt.core.tests.model/workspace/Formatter/test323/A_out.java;1;0;1;1;0;0;0;1;0;0;1;2462;0;0;1;0;0;1;1;2462;0;2462;1;1;
/org.eclipse.debug.ui/ui/org/eclipse/debug/ui/sourcelookup/AbstractSourceContainerBrowser.java;1;0;1;1;0;0;0;1;0;0;1;4970;0;0;1;0;0;1;1;4970;0;4970;1;1;
/org.eclipse.ui.views/src/org/eclipse/ui/views/markers/internal/ITableViewContentProvider.java;2;0;2;1;0;0;0;2;0;1;2;755;0;0;1;0;0;2;2;755;0;2738;2;2;
/org.eclipse.jdt.ui/core refactoring/org/eclipse/jdt/internal/corext/refactoring/reorg/INewNameQuery.java;1;0;1;1;1;1;1;0;2;0;0;6340;2;2;1;0;0;0;1;6340;0;6340;1;1;
/org.eclipse.ui.workbench.compatibility/src/org/eclipse/ui/internal/CompatibleWorkbenchPage.java;2;0;3;1;1;1;1;2;7;0;1;3335;9;9;2;1;0;2;3;3335;1;6321;2;2;
/org.eclipse.update.tests.core/src/org/eclipse/update/tests/types/TestSiteType.java;2;0;3;1;1;1;1;2;6;1;2;3813;12;12;1;0;0;2;3;3813;0;6336;3;2;
/org.eclipse.jdt.core.tests.model/workspace/Formatter/test484/A_in.java;1;0;1;1;1;1;1;0;0;0;0;5132;0;0;1;0;0;0;1;5132;0;5132;1;1;
/org.eclipse.jdt.debug.tests/tests/org/eclipse/jdt/debug/tests/eval/FloatAssignmentOperatorsTests.java;1;0;1;1;0;0;0;1;70;0;1;1274;70;70;1;0;0;1;1;1274;0;1274;1;1;
/org.eclipse.ui.externaltools/External Tools Base/org/eclipse/ui/externaltools/internal/ui/BuilderPropertyPage.java;3;1;31;2;3;3;3;28;431;2;24;33;1486;1486;2;4;0;28;31;1563;4;6151;27;3;
/org.eclipse.ui.workbench/Eclipse UI/org/eclipse/ui/internal/chris/roles/RoleManager.java;1;0;5;1;0;0;0;5;32;4;2;1952;32;32;4;3;0;5;5;2199;3;2199;2;1;
/org.eclipse.swt/Eclipse SWT Browser/common/org/eclipse/swt/browser/LocationListener.java;2;0;8;1;1;1;1;7;33;1;7;1654;99;99;1;0;0;7;8;1654;0;6352;8;2;
/org.eclipse.jdt.ui.tests.refactoring/resources/DeleteSourceReference/test16/out/A.java;1;0;1;1;0;0;0;1;0;0;1;1652;0;0;1;0;0;1;1;1652;0;1652;1;1;
/org.eclipse.jdt.core.tests.compiler/src/org/eclipse/jdt/core/tests/util/TestVerifier.java;3;0;6;1;1;1;1;5;18;1;5;241;36;36;1;0;0;5;6;241;0;5657;6;3;
/org.eclipse.jdt.core.tests.model/workspace/Formatter/test128/A_out.java;1;0;1;1;0;0;0;1;0;0;1;2425;0;0;1;0;0;1;1;2425;0;2425;1;1;
/org.eclipse.jdt.ui.tests.refactoring/resources/ExtractMethodWorkSpace/ExtractMethodTests/return_out/A_test719.java;1;0;2;1;0;0;0;2;6;1;2;130;7;7;1;0;0;2;2;130;0;844;2;1;
/org.eclipse.ant.ui/Ant Tools Support/org/eclipse/ant/ui/internal/launchConfigurations/TargetOrderDialog.java;1;0;3;1;0;0;0;3;3;1;3;250;3;3;1;0;0;3;3;250;0;1811;3;1;
/org.eclipse.pde.core/src/org/eclipse/pde/core/plugin/IExtensionsModelFactory.java;2;1;4;1;3;3;3;1;30;0;1;2184;38;38;1;0;0;1;4;2184;0;6336;4;2;
/org.eclipse.jdt.core.tests.model/workspace/Converter/src/test0303/Test.java;1;0;1;1;0;0;0;1;0;0;1;3714;0;0;1;0;0;1;1;3714;0;3714;1;1;
/org.eclipse.swt/Eclipse SWT PI/win32/org/eclipse/swt/internal/ole/win32/CAUUID.java;1;0;1;1;0;0;0;1;2;0;1;2915;2;2;1;0;0;1;1;2915;0;2915;1;1;
/org.eclipse.jdt.ui/ui/org/eclipse/jdt/internal/ui/util/ISelectionConverter.java;1;0;1;1;0;0;0;1;0;0;1;4575;0;0;1;0;0;1;1;4575;0;4575;1;1;
/org.eclipse.team.cvs.core/src/org/eclipse/team/internal/ccvs/core/connection/ExtConnection.java;1;0;2;1;0;0;0;2;6;1;2;1858;8;8;1;0;0;2;2;1858;0;2097;2;1;
/org.eclipse.jdt.core.tests.model/workspace/Converter/junit/extensions/ActiveTestSuite.java;1;0;2;1;0;0;0;2;15;1;2;787;15;15;1;0;0;2;2;787;0;3714;2;1;
/org.eclipse.ui.workbench/Eclipse UI/org/eclipse/ui/internal/keys/WorkbenchKeyboard.java;3;1;43;2;5;5;5;38;1541;4;27;3010;3409;3409;4;11;0;38;43;3214;11;6338;32;3;
/org.eclipse.jdt.ui/core refactoring/org/eclipse/jdt/internal/corext/refactoring/participants/xml/StandardElementHandler.java;1;0;8;1;0;0;0;8;61;1;8;1033;115;115;1;0;0;8;8;1033;0;4108;8;1;
/org.eclipse.team.core/src/org/eclipse/team/internal/core/subscribers/SubscriberErrorEvent.java;1;0;1;1;0;0;0;1;0;0;1;4002;0;0;1;0;0;1;1;4002;0;4002;1;1;
/org.eclipse.core.runtime/src/org/eclipse/core/internal/preferences/PreferenceForwarder.java;2;2;17;2;6;4;6;11;121;3;7;4351;374;374;3;4;2;11;17;4351;6;5752;11;2;
/org.eclipse.jdt.ui.tests.refactoring/resources/ChangeTypeRefactoring/positive/A_testLocalVarUse_in.java;1;0;1;1;0;0;0;1;0;0;1;2844;0;0;1;0;0;1;1;2844;0;2844;1;1;
/org.eclipse.jface.text/projection/org/eclipse/jface/text/source/ProjectionSourceViewer.java;1;0;2;1;1;1;1;1;1;0;1;4516;1;1;1;0;0;1;2;4516;0;5177;2;1;
/org.eclipse.debug.ui/ui/org/eclipse/debug/internal/ui/views/memory/MemoryBlockViewSynchronizer.java;2;1;2;1;2;2;2;0;42;0;0;5254;42;42;1;0;0;0;2;5254;0;5409;2;2;
/org.eclipse.debug.ui/ui/org/eclipse/debug/internal/ui/views/memory/ISynchronizedMemoryBlockView.java;1;0;1;1;1;1;1;0;0;0;0;5254;0;0;1;0;0;0;1;5254;0;5254;1;1;
/org.eclipse.help/src/org/eclipse/help/internal/search/SearchProgressMonitor.java;1;0;2;1;0;0;0;2;12;1;2;457;12;12;1;0;0;2;2;457;0;2732;2;1;
/org.eclipse.ui.workbench/Eclipse UI/org/eclipse/ui/wizards/datatransfer/ImportOperation.java;2;0;2;1;0;0;0;2;2;1;2;1;2;2;1;0;0;2;2;1;0;2737;2;2;
/org.eclipse.update.core/src/org/eclipse/update/internal/standalone/EnableCommand.java;2;0;13;1;0;0;0;13;47;2;12;828;114;114;2;1;0;13;13;4585;1;4928;12;2;
/org.eclipse.core.expressions.tests/src/org/eclipse/core/internal/expressions/tests/ExpressionTestPlugin.java;1;1;3;1;2;2;2;1;6;0;1;4108;8;8;1;0;0;1;3;4108;0;5485;3;1;
/org.eclipse.ui.workbench/Eclipse UI/org/eclipse/ui/internal/keys/KeyBindingState.java;2;0;5;1;0;0;0;5;86;2;4;3032;229;229;2;1;0;5;5;3032;1;3329;4;2;
/org.eclipse.team.ui/src/org/eclipse/team/ui/synchronize/ISynchronizePageSite.java;2;1;4;1;3;3;3;1;94;0;1;5036;116;116;1;0;0;1;4;5036;0;5508;4;2;
/org.eclipse.ant.ui/Ant Editor/org/eclipse/ant/internal/ui/editor/text/XMLReconcilingStrategy.java;1;0;7;1;0;0;0;7;39;2;6;1811;93;93;2;1;0;7;7;4606;1;4700;6;1;
/org.eclipse.jdt.core.tests.model/workspace/Converter/test0329/Test.java;1;0;1;1;0;0;0;1;0;0;1;3714;0;0;1;0;0;1;1;3714;0;3714;1;1;
/org.eclipse.pde.build/src/org/eclipse/pde/internal/build/builder/ClasspathComputer3_0.java;2;1;10;1;8;8;8;2;343;1;2;4175;458;458;1;0;0;2;10;4175;0;6011;10;2;
/org.eclipse.team.ui/src/org/eclipse/team/internal/ui/sync/views/CompressedFolder.java;2;0;5;1;0;0;0;5;28;2;4;1171;42;42;2;1;0;5;5;1171;1;2632;4;2;
/org.eclipse.debug.ui/ui/org/eclipse/debug/internal/ui/DelegatingModelPresentation.java;4;1;14;2;4;4;4;10;43;2;8;1157;244;244;2;2;0;10;14;1157;2;6336;12;4;
/org.eclipse.pde.ui/src/org/eclipse/pde/internal/ui/editor/IPDEEditorPage.java;1;0;1;1;1;1;1;0;0;0;0;5431;0;0;1;0;0;0;1;5431;0;5431;1;1;
/org.eclipse.pde.ui/src/org/eclipse/pde/internal/ui/wizards/imports/UpdateBuildpathWizardPage.java;2;0;9;1;0;0;0;9;21;2;8;368;102;102;2;1;0;9;9;3839;1;3839;8;2;
/org.eclipse.ui.workbench/Eclipse UI/org/eclipse/ui/internal/WorkbenchImages.java;6;1;17;2;3;3;3;14;496;3;10;2737;673;673;3;4;0;14;17;4649;4;6338;13;6;
/org.eclipse.jdt.ui.tests/ui/org/eclipse/jdt/ui/tests/search/FileAdapterTest.java;1;0;1;1;1;1;1;0;0;0;0;5676;0;0;1;0;0;0;1;5676;0;5676;1;1;
/org.eclipse.ui.workbench/Eclipse UI/org/eclipse/ui/internal/commands/IImageBindingDefinition.java;1;0;4;1;0;0;0;4;43;1;4;1422;47;47;1;0;0;4;4;1422;0;3128;4;1;
/org.eclipse.jdt.core.tests.model/workspace/Converter/src/javadoc/testBug51363/Test.java;1;0;1;1;0;0;0;1;0;0;1;3994;0;0;1;0;0;1;1;3994;0;3994;1;1;
/org.eclipse.ui.ide/src/org/eclipse/ui/views/markers/internal/BookmarkMarker.java;1;0;1;1;0;0;0;1;0;0;1;3214;0;0;1;0;0;1;1;3214;0;3214;1;1;
/org.eclipse.jdt.core.tests.compiler/src/org/eclipse/jdt/core/tests/eval/target/IDEInterface.java;1;0;1;1;0;0;0;1;2;0;1;3560;2;2;1;0;0;1;1;3560;0;3560;1;1;
/org.eclipse.jdt.core.tests.model/workspace/TypeHierarchyNotification/src/p3/B.java;1;0;1;1;0;0;0;1;0;0;1;4925;0;0;1;0;0;1;1;4925;0;4925;1;1;
/org.eclipse.ui.workbench/Eclipse UI/org/eclipse/ui/internal/misc/Policy.java;5;1;9;1;2;2;2;7;42;1;7;173;64;64;1;0;0;7;9;173;0;6338;9;5;
/org.eclipse.ui.workbench/Eclipse UI/org/eclipse/ui/wizards/datatransfer/WizardZipFileImportPage1.java;1;0;1;1;0;0;0;1;0;0;1;2737;0;0;1;0;0;1;1;2737;0;2737;1;1;
/org.eclipse.pde.ui/src/org/eclipse/pde/internal/ui/editor/site/SiteInputContextManager.java;2;1;3;1;3;3;3;0;10;0;0;5431;14;14;1;0;0;0;3;5431;0;6336;3;2;
/org.eclipse.update/src/org/eclipse/update/internal/ui/UMWizardPageURLInstall.java;1;0;1;1;1;1;1;0;0;0;0;6339;0;0;1;0;0;0;1;6339;0;6339;1;1;
/org.eclipse.jdt.ui.tests.refactoring/test cases/org/eclipse/jdt/ui/tests/xml/A_TypeExtender.java;1;0;5;1;0;0;0;5;24;1;5;2204;30;30;1;0;0;5;5;2204;0;4108;5;1;
/org.eclipse.jdt.ui/ui refactoring/org/eclipse/jdt/internal/ui/refactoring/UIPerformChangeOperation.java;1;0;2;1;0;0;0;2;0;1;2;4575;0;0;1;0;0;2;2;4575;0;4965;2;1;
/org.eclipse.jdt.ui/ui/org/eclipse/jdt/internal/ui/preferences/QuickDiffConfigurationBlock.java;1;0;2;1;2;1;2;0;0;0;0;5502;0;0;2;0;1;0;2;5502;1;5502;1;1;
/org.eclipse.jdt.core.tests.model/workspace/Formatter/test028/A_in.java;1;0;1;1;0;0;0;1;0;0;1;2425;0;0;1;0;0;1;1;2425;0;2425;1;1;
/org.eclipse.team.webdav/src/org/eclipse/team/internal/webdav/core/subscriber/WebDavSubscriber.java;1;0;1;1;0;0;0;1;0;0;1;3477;0;0;1;0;0;1;1;3477;0;3477;1;1;
/org.eclipse.pde.ui/sandbox/org/eclipse/pde/internal/ui/editor/standalone/parser/XMLDocumentModelBuilder.java;1;0;2;1;0;0;0;2;0;1;2;2320;0;0;1;0;0;2;2;2320;0;2931;2;1;
/org.eclipse.jdt.ui.tests.refactoring/resources/SurroundWithWorkSpace/SurroundWithTests/trycatch_in/TestSimple.java;1;0;1;1;0;0;0;1;2;0;1;845;2;2;1;0;0;1;1;845;0;845;1;1;
/org.eclipse.jdt.debug.ui/ui/org/eclipse/jdt/internal/debug/ui/JavaSourceLocationWorkbenchAdapterFactory.java;2;0;3;1;1;1;1;2;4;1;2;2745;9;9;1;0;0;2;3;2745;0;6336;3;2;
/org.eclipse.team.webdav/src/org/eclipse/team/ui/target/ExportSourceSelectionPage.java;1;0;1;1;0;0;0;1;0;0;1;3461;0;0;1;0;0;1;1;3461;0;3461;1;1;
/org.eclipse.team.tests.cvs.core/src/org/eclipse/team/tests/ccvs/ui/old/Utils.java;1;0;3;1;0;0;0;3;38;1;3;2632;38;38;1;0;0;3;3;2632;0;4216;3;1;
/org.eclipse.ui.workbench/Eclipse UI/org/eclipse/ui/internal/commands/registry/LocalRegistry.java;1;0;4;1;0;0;0;4;4;2;3;1077;5;5;2;1;0;4;4;1077;1;1222;3;1;
/org.eclipse.jdt.core/model/org/eclipse/jdt/core/IClasspathEntry.java;2;0;5;1;0;0;0;5;116;2;4;2583;207;207;2;1;0;5;5;4997;1;4997;4;2;
/org.eclipse.ui.ide/src/org/eclipse/ui/views/markers/internal/TaskFilter.java;2;0;2;1;0;0;0;2;31;1;2;2208;31;31;1;0;0;2;2;2208;0;3214;2;2;
/org.eclipse.jdt.ui.tests.refactoring/resources/Copy/test_type_yes_type/out/C.java;1;0;1;1;0;0;0;1;0;0;1;696;0;0;1;0;0;1;1;696;0;696;1;1;
/org.eclipse.jdt.ui.tests.refactoring/resources/ChangeSignature/canModify/A_testInStatic01_in.java;1;0;1;1;0;0;0;1;0;0;1;3216;0;0;1;0;0;1;1;3216;0;3216;1;1;
/org.eclipse.ant.ui/Ant Tools Support/org/eclipse/ant/ui/internal/views/actions/SearchForBuildFilesAction.java;1;0;4;1;0;0;0;4;13;2;3;263;17;17;2;1;0;4;4;263;1;1811;3;1;
/org.eclipse.ui.workbench/Eclipse UI/org/eclipse/ui/internal/registry/RegistryManager.java;3;1;7;1;2;2;2;5;20;1;5;4563;83;83;1;0;0;5;7;4563;0;6081;7;3;
/org.eclipse.jdt.ui/ui/org/eclipse/jdt/internal/ui/wizards/buildpaths/ClasspathContainerDescriptor.java;3;1;3;1;3;3;3;0;34;0;0;5165;40;40;1;0;0;0;3;5165;0;6340;3;3;
/org.eclipse.jdt.ui/ui/org/eclipse/jdt/internal/ui/search/OccurrencesGroupKey.java;1;0;1;1;0;0;0;1;0;0;1;4888;0;0;1;0;0;1;1;4888;0;4888;1;1;
/org.eclipse.pde.ui/src_Forms/org/eclipse/pde/internal/ui/neweditor/plugin/dummy/DummyExtensionPoint.java;1;0;2;1;0;0;0;2;0;1;2;4223;0;0;1;0;0;2;2;4223;0;4338;2;1;
/org.eclipse.jdt.core.tests.model/workspace/Converter/test0400/A.java;1;0;1;1;0;0;0;1;0;0;1;3714;0;0;1;0;0;1;1;3714;0;3714;1;1;
/org.eclipse.core.runtime.osgi/src/org/eclipse/core/internal/jobs/JobChangeEvent.java;1;0;1;1;0;0;0;1;0;0;1;3013;0;0;1;0;0;1;1;3013;0;3013;1;1;
/org.eclipse.jdt.core/model/org/eclipse/jdt/internal/core/util/InnerClassesAttributeEntry.java;1;0;1;1;0;0;0;1;2;0;1;3560;2;2;1;0;0;1;1;3560;0;3560;1;1;
/org.eclipse.jdt.core.tests.compiler/src/org/eclipse/jdt/core/tests/compiler/parser/SourcePackage.java;1;0;1;1;0;0;0;1;2;0;1;3560;2;2;1;0;0;1;1;3560;0;3560;1;1;
/org.eclipse.ui.workbench/Eclipse UI/org/eclipse/ui/internal/commands/gestures/GestureSequence.java;1;0;3;1;0;0;0;3;14;1;3;1264;25;25;1;0;0;3;3;1264;0;1294;3;1;
/org.eclipse.jdt.core.tests.model/workspace/Converter/test0064/Test.java;1;0;1;1;0;0;0;1;0;0;1;3714;0;0;1;0;0;1;1;3714;0;3714;1;1;
/org.eclipse.pde.ui/src/org/eclipse/pde/internal/ui/search/JavaSearchOperation.java;2;1;3;1;2;2;2;1;12;0;1;2950;26;26;1;0;0;1;3;2950;0;6336;3;2;
/org.eclipse.ui.cheatsheets/src/org/eclipse/ui/internal/cheatsheets/views/FastViewHack.java;2;0;3;1;0;0;0;3;17;1;3;4428;17;17;1;0;0;3;3;4428;0;4701;3;2;
/org.eclipse.core.boot/src/org/eclipse/core/internal/boot/BundleStats.java;1;0;1;1;0;0;0;1;0;0;1;3013;0;0;1;0;0;1;1;3013;0;3013;1;1;
/org.eclipse.swt/Eclipse SWT Printing/gtk/org/eclipse/swt/printing/PrintDialog.java;1;1;2;1;2;2;2;0;8;0;0;5606;12;12;1;0;0;0;2;5606;0;6352;2;1;
/org.eclipse.core.runtime/src/org/eclipse/core/runtime/IAdapterFactory.java;2;1;5;1;2;2;2;3;104;1;3;3013;213;213;1;0;0;3;5;3013;0;6340;5;2;
/org.eclipse.core.boot/src/org/eclipse/core/internal/boot/ClassStats.java;1;0;1;1;0;0;0;1;0;0;1;3013;0;0;1;0;0;1;1;3013;0;3013;1;1;
/org.eclipse.jdt.core.tests.model/workspace/Converter/src/test0023/Test.java;1;0;1;1;0;0;0;1;0;0;1;3714;0;0;1;0;0;1;1;3714;0;3714;1;1;
/org.eclipse.help/src/org/eclipse/help/internal/protocols/HelpURLFactory.java;1;0;1;1;0;0;0;1;0;0;1;1010;0;0;1;0;0;1;1;1010;0;1010;1;1;
/org.eclipse.ui.workbench/Eclipse UI/org/eclipse/ui/internal/activities/ActivityBindingDefinition.java;1;0;2;1;0;0;0;2;0;1;2;2867;0;0;1;0;0;2;2;2867;0;2896;2;1;
/org.eclipse.ui.workbench/Eclipse UI/org/eclipse/ui/internal/presentation/DisposableColorRegistry.java;1;0;2;1;0;0;0;2;0;1;2;4235;0;0;1;0;0;2;2;4235;0;4263;2;1;
/org.eclipse.pde.ui/sandbox/org/eclipse/pde/internal/ui/editor/standalone/text/ColorManager.java;1;0;2;1;0;0;0;2;0;1;2;2320;0;0;1;0;0;2;2;2320;0;2906;2;1;
/org.eclipse.ui.ide/src/org/eclipse/ui/internal/ide/actions/BuildContributionItem.java;2;0;2;1;0;0;0;2;0;1;2;2264;0;0;1;0;0;2;2;2264;0;3067;2;2;
/org.eclipse.core.tests.runtime/src/org/eclipse/core/tests/internal/runtimetests/SampleOPR.java;1;0;1;1;1;1;1;0;21;0;0;5149;21;21;1;0;0;0;1;5149;0;5149;1;1;
/org.eclipse.update.ui/src/org/eclipse/update/internal/ui/search/SearchResultSite.java;1;0;1;1;0;0;0;1;0;0;1;824;0;0;1;0;0;1;1;824;0;824;1;1;
/org.eclipse.ui.tests/Eclipse UI Tests/org/eclipse/ui/tests/preferences/FontPreferenceTestCase.java;1;0;2;1;0;0;0;2;7;1;2;2754;7;7;1;0;0;2;2;2754;0;3091;2;1;
/org.eclipse.pde.core/src/org/eclipse/pde/internal/core/ICoreConstants.java;3;1;4;1;2;2;2;2;24;1;2;2296;30;30;1;0;0;2;4;2296;0;6336;4;3;
/org.eclipse.jdt.ui/core refactoring/org/eclipse/jdt/internal/corext/refactoring/participants/xml/TestNotExpression.java;1;0;2;1;0;0;0;2;0;1;2;2204;0;0;1;0;0;2;2;2204;0;2253;2;1;
/org.eclipse.ui.tests/Eclipse UI Tests/org/eclipse/ui/tests/api/Bug42616Test.java;3;0;3;1;1;1;1;2;2;1;2;3472;3;3;1;0;0;2;3;3472;0;6338;3;3;
/org.eclipse.team.core/src/org/eclipse/team/internal/core/subscribers/caches/DescendantResourceVariantByteStore.java;1;0;4;1;0;0;0;4;172;1;4;4216;213;213;1;0;0;4;4;4216;0;4349;4;1;
/org.eclipse.core.resources/src/org/eclipse/core/resources/IProjectNatureDescriptor.java;1;0;2;1;1;1;1;1;116;0;1;4994;122;122;1;0;0;1;2;4994;0;5146;2;1;
/org.eclipse.pde.ui/sandbox/org/eclipse/pde/internal/ui/editor/standalone/text/XMLPartitionScanner.java;1;0;2;1;0;0;0;2;0;1;2;2320;0;0;1;0;0;2;2;2320;0;2906;2;1;
/org.eclipse.ui.workbench/Eclipse UI/org/eclipse/ui/internal/dialogs/ProjectCapabilityEditingPropertyPage.java;2;0;2;1;0;0;0;2;2;1;2;79;2;2;1;0;0;2;2;79;0;2737;2;2;
/org.eclipse.debug.ui/ui/org/eclipse/debug/internal/ui/preferences/UserPreferencePromptDialog.java;1;1;3;1;3;3;3;0;42;0;0;5283;42;42;1;0;0;0;3;5283;0;5407;3;1;
/org.eclipse.core.tests.resources/src/org/eclipse/core/tests/internal/watson/TestElementComparator.java;1;0;1;1;1;1;1;0;86;0;0;5147;86;86;1;0;0;0;1;5147;0;5147;1;1;
/org.eclipse.jdt.debug.ui/ui/org/eclipse/jdt/internal/debug/ui/IJavaDebugHelpContextIds.java;3;0;4;1;0;0;0;4;3;1;4;1524;9;9;1;0;0;4;4;1524;0;4956;4;3;
/org.eclipse.core.tests.resources/src/org/eclipse/core/tests/resources/AutomatedTests.java;1;1;2;1;2;2;2;0;47;0;0;5147;51;51;1;0;0;0;2;5147;0;5988;2;1;
/org.eclipse.jdt.ui.tests.refactoring/resources/MoveMembers/test6/out/A.java;1;0;1;1;0;0;0;1;3;0;1;1522;3;3;1;0;0;1;1;1522;0;1522;1;1;
/org.eclipse.pde.core/srcnew/org/eclipse/pde/internal/core/plugin/IDocumentModelFactory.java;1;0;1;1;1;1;1;0;0;0;0;5431;0;0;1;0;0;0;1;5431;0;5431;1;1;
/org.eclipse.update.core/src/org/eclipse/update/core/model/FeatureModelFactory.java;2;1;4;1;3;3;3;1;12;0;1;890;25;25;1;0;0;1;4;890;0;6336;4;2;
/org.eclipse.team.tests.cvs.core/src/org/eclipse/team/tests/ccvs/core/subscriber/TestCommitOperation.java;2;1;3;1;2;2;2;1;4;0;1;4450;6;6;1;0;0;1;3;4450;0;6337;3;2;
/org.eclipse.jdt.ui.tests.refactoring/resources/ExtractMethodWorkSpace/ExtractMethodTests/try_in/A_test460.java;1;0;2;1;0;0;0;2;4;1;2;130;6;6;1;0;0;2;2;130;0;844;2;1;
/org.eclipse.jdt.ui.tests.refactoring/test cases/org/eclipse/jdt/ui/tests/changes/TrackPositionTest.java;2;1;10;1;2;2;2;8;21;3;6;1925;76;76;3;2;0;8;10;1946;2;6340;8;2;
/org.eclipse.update.ui/src/org/eclipse/update/internal/ui/search/SearchObject.java;2;0;5;2;0;0;0;5;31;2;3;200;35;35;2;2;0;5;5;200;2;824;3;2;
/org.eclipse.swt/Eclipse SWT PI/motif/org/eclipse/swt/internal/motif/XExposeEvent.java;1;0;1;1;0;0;0;1;11;0;1;868;11;11;1;0;0;1;1;868;0;868;1;1;
/org.eclipse.jdt.ui/ui/org/eclipse/jdt/internal/ui/reorg/ReorgActionFactory.java;1;0;4;1;0;0;0;4;74;2;3;457;109;109;2;1;0;4;4;1111;1;1111;3;1;
/org.eclipse.ui.workbench/Eclipse UI/org/eclipse/ui/internal/ClassicWorkbenchWindowLayout.java;1;0;1;1;0;0;0;1;0;0;1;2728;0;0;1;0;0;1;1;2728;0;2728;1;1;
/org.eclipse.core.runtime/src/org/eclipse/core/internal/runtime/PlatformActivator.java;5;3;54;3;18;13;18;36;750;3;29;3049;1717;1717;3;7;5;36;54;3164;12;6251;42;5;
/org.eclipse.pde.ui/sandbox/org/eclipse/pde/internal/ui/editor/standalone/parser/DocumentModel.java;1;0;2;1;0;0;0;2;0;1;2;2320;0;0;1;0;0;2;2;2320;0;2906;2;1;
/org.eclipse.jdt.ui/core refactoring/org/eclipse/jdt/internal/corext/refactoring/code/SnippetFinder.java;3;2;11;2;4;3;4;7;47;2;6;130;168;168;2;1;1;7;11;1271;2;6340;9;3;
/org.eclipse.jdt.ui/core extension/org/eclipse/jdt/internal/corext/template/DocumentTemplateContext.java;1;0;1;1;0;0;0;1;0;0;1;4258;0;0;1;0;0;1;1;4258;0;4258;1;1;
/org.eclipse.pde.ui/src/org/eclipse/pde/ui/templates/ITemplateSection.java;2;2;7;1;5;4;5;2;194;1;2;2786;325;325;2;0;1;2;7;5204;1;6336;6;2;
/org.eclipse.pde.ui/src/org/eclipse/pde/internal/ui/wizards/project/ExtensionPointMappings.java;1;0;3;1;0;0;0;3;2;1;3;2653;2;2;1;0;0;3;3;2653;0;3839;3;1;
/org.eclipse.ui.externaltools/Ant Tools Support/org/eclipse/ui/externaltools/internal/ant/launchConfigurations/AntProcess.java;1;0;1;1;0;0;0;1;0;0;1;282;0;0;1;0;0;1;1;282;0;282;1;1;
/org.eclipse.jdt.core.tests.model/workspace/Formatter/test408/A_in.java;1;0;1;1;0;0;0;1;0;0;1;3438;0;0;1;0;0;1;1;3438;0;3438;1;1;
/org.eclipse.ant.ui/Ant Tools Support/org/eclipse/ant/internal/ui/preferences/IClasspathEntry.java;1;0;4;1;0;0;0;4;29;2;3;2288;38;38;2;1;0;4;4;2569;1;2867;3;1;
/org.eclipse.team.cvs.core/src/org/eclipse/team/internal/ccvs/core/client/Add.java;1;0;2;1;0;0;0;2;19;1;2;1672;23;23;1;0;0;2;2;1672;0;1843;2;1;
/org.eclipse.ui.ide/src/org/eclipse/ui/internal/FeatureSelectionDialog.java;2;0;3;1;0;0;0;3;10;1;3;1526;10;10;1;0;0;3;3;1526;0;2263;3;2;
/org.eclipse.debug.ui/ui/org/eclipse/debug/ui/ILaunchConfigurationDialog.java;1;0;1;1;0;0;0;1;3;0;1;1788;3;3;1;0;0;1;1;1788;0;1788;1;1;
/org.eclipse.releng.basebuilder/builderTemplate/tests/tools/TestVersionTracker.java;1;0;2;1;0;0;0;2;10;1;2;3148;10;10;1;0;0;2;2;3148;0;3597;2;1;
/org.eclipse.jdt.core.tests.model/workspace/Converter/src/javadoc/test012/Test.java;1;0;1;1;0;0;0;1;0;0;1;3875;0;0;1;0;0;1;1;3875;0;3875;1;1;
/org.eclipse.ui.ide/src/org/eclipse/ui/internal/NewWizardShortcutAction.java;2;0;4;1;0;0;0;4;6;1;4;1520;10;10;1;0;0;4;4;1520;0;2263;4;2;
/org.eclipse.jdt.ui/ui/org/eclipse/jdt/internal/ui/filters/StaticsFilter.java;1;0;2;1;1;1;1;1;2;0;1;2273;2;2;1;0;0;1;2;2273;0;6340;2;1;
/org.eclipse.ui.intro/src/org/eclipse/ui/intro/internal/parts/CategoryForm.java;1;0;8;1;1;1;1;7;676;1;7;4429;1977;1977;1;0;0;7;8;4429;0;5115;8;1;
/org.eclipse.osgi/core/framework/org/eclipse/osgi/framework/tracker/ServiceTracker.java;3;0;3;1;0;0;0;3;13;1;3;3013;13;13;1;0;0;3;3;3013;0;5079;3;3;
/org.eclipse.jdt.core.tests.model/workspace/Converter/src/test0432/A.java;1;0;1;1;0;0;0;1;0;0;1;3714;0;0;1;0;0;1;1;3714;0;3714;1;1;
/org.eclipse.jdt.core.tests.model/workspace/Converter/test0376/A.java;1;0;1;1;0;0;0;1;0;0;1;3714;0;0;1;0;0;1;1;3714;0;3714;1;1;
/org.eclipse.osgi/defaultAdaptor/src/org/eclipse/osgi/framework/internal/reliablefile/ReliableMsg.java;2;1;4;1;3;3;3;1;5;0;1;4391;7;7;1;0;0;1;4;4391;0;5275;4;2;
/org.eclipse.jdt.core/dom/org/eclipse/jdt/core/dom/ClassInstanceCreation.java;4;2;20;1;7;5;7;13;193;1;13;3560;606;606;2;0;2;13;20;5116;2;5871;18;4;
/org.eclipse.ui.workbench/Eclipse UI/org/eclipse/ui/internal/IPartDropTarget.java;1;0;1;1;0;0;0;1;0;0;1;4015;0;0;1;0;0;1;1;4015;0;4015;1;1;
/org.eclipse.jdt.core/dom/org/eclipse/jdt/internal/core/dom/rewrite/ASTRewriteFlattener.java;2;1;3;1;2;2;2;1;318;0;1;4802;319;319;1;0;0;1;3;4802;0;5482;3;2;
/org.eclipse.jface.text/src/org/eclipse/jface/text/JFaceTextMessages.java;1;0;1;1;1;1;1;0;2;0;0;6340;2;2;1;0;0;0;1;6340;0;6340;1;1;
/org.eclipse.pde.ui/src/org/eclipse/pde/internal/ui/editor/MultiSourceEditor.java;2;2;3;2;3;2;3;0;10;0;0;5431;12;12;2;0;1;0;3;5431;1;6336;2;2;
/org.eclipse.jface.text/src/org/eclipse/jface/text/reconciler/IReconcilableModel.java;1;2;4;1;3;2;3;1;17;0;1;1629;19;19;2;0;1;1;4;6353;1;6353;3;1;
/org.eclipse.jface.text/src/org/eclipse/jface/text/contentassist/CompletionProposal.java;2;2;4;1;3;2;3;1;22;0;1;4206;26;26;2;0;1;1;4;6353;1;6353;3;2;
/org.eclipse.jdt.debug.tests/tests/org/eclipse/jdt/debug/tests/core/LocalVariableTests.java;1;0;1;1;0;0;0;1;4;0;1;1222;4;4;1;0;0;1;1;1222;0;1222;1;1;
/org.eclipse.jdt.ui.tests.refactoring/resources/ExtractMethodWorkSpace/ExtractMethodTests/invalidSelection/A_test193.java;1;0;1;1;0;0;0;1;0;0;1;1444;0;0;1;0;0;1;1;1444;0;1444;1;1;
/org.eclipse.pde.core/src/org/eclipse/pde/internal/core/SourceDOMParser.java;1;0;1;1;0;0;0;1;0;0;1;2906;0;0;1;0;0;1;1;2906;0;2906;1;1;
/org.eclipse.core.tests.runtime/src/org/eclipse/core/tests/internal/plugins/RegressionResolveTest_8.java;1;0;1;1;0;0;0;1;0;0;1;3014;0;0;1;0;0;1;1;3014;0;3014;1;1;
/org.eclipse.jdt.core.tests.model/workspace/Converter/src/test0192/Test.java;1;0;1;1;0;0;0;1;0;0;1;3714;0;0;1;0;0;1;1;3714;0;3714;1;1;
/org.eclipse.pde.ui/srcnew/org/eclipse/pde/internal/ui/editor/manifest/ManifestSourcePageNew.java;1;0;4;1;0;0;0;4;26;1;4;875;37;37;1;0;0;4;4;875;0;2320;4;1;
/org.eclipse.jdt.ui/core refactoring/org/eclipse/ltk/core/refactoring/CreateChangeOperation.java;1;0;2;1;0;0;0;2;0;1;2;4575;0;0;1;0;0;2;2;4575;0;4864;2;1;
/org.eclipse.ant.ui/Ant Editor/org/eclipse/ant/internal/ui/editor/text/AntDocumentFactory.java;1;0;1;1;0;0;0;1;0;0;1;5047;0;0;1;0;0;1;1;5047;0;5047;1;1;
/org.eclipse.ui.externaltools/Ant Editor/org/eclipse/ui/externaltools/internal/ant/dtd/schema/Atom.java;1;0;1;1;0;0;0;1;0;0;1;282;0;0;1;0;0;1;1;282;0;282;1;1;
/org.eclipse.team.ui/src/org/eclipse/team/ui/synchronize/viewers/IInputChangedListener.java;1;0;1;1;0;0;0;1;0;0;1;4085;0;0;1;0;0;1;1;4085;0;4085;1;1;
/org.eclipse.ui.workbench.texteditor/src/org/eclipse/ui/texteditor/ResourceAction.java;1;1;3;1;2;2;2;1;2;0;1;4951;6;6;1;0;0;1;3;4951;0;6340;3;1;
/org.eclipse.jdt.core.tests.model/workspace/Converter/src/test0056/Test.java;1;0;1;1;0;0;0;1;0;0;1;3714;0;0;1;0;0;1;1;3714;0;3714;1;1;
/org.eclipse.ui.workbench/Eclipse UI/org/eclipse/ui/internal/commands/registry/KeyBindingDefinition.java;1;0;5;1;0;0;0;5;80;2;4;1396;125;125;2;1;0;5;5;1396;1;1724;4;1;
/org.eclipse.ui.externaltools/Ant Tools Support/org/eclipse/ui/externaltools/internal/ant/launchConfigurations/AntMainTab.java;1;0;1;1;0;0;0;1;0;0;1;282;0;0;1;0;0;1;1;282;0;282;1;1;
/org.eclipse.ui.workbench/Eclipse UI/org/eclipse/ui/internal/commands/CommandRegistryEvent.java;1;0;13;1;0;0;0;13;15;5;7;1389;34;34;5;6;0;13;13;1389;6;2823;7;1;
/org.eclipse.core.filebuffers/src/org/eclipse/core/filebuffers/IDocumentFactory.java;2;2;6;2;4;3;4;2;22;1;2;1522;39;39;2;0;1;2;6;6333;1;6333;5;2;
/org.eclipse.ui.workbench/Eclipse UI/org/eclipse/ui/internal/roles/CategoryManager.java;1;0;2;1;0;0;0;2;0;0;1;2864;0;0;2;1;0;2;2;2864;1;2864;1;1;
/org.eclipse.ui.workbench/Eclipse UI/org/eclipse/ui/internal/dialogs/NewWizardNewPage2.java;3;0;4;2;0;0;0;4;968;2;3;3061;974;974;2;1;0;4;4;3061;1;4063;3;3;
/org.eclipse.debug.ui/ui/org/eclipse/debug/internal/ui/views/launch/TextEditorSelection.java;1;0;3;1;1;1;1;2;7;1;2;1220;7;7;1;0;0;2;3;1220;0;5157;3;1;
/org.eclipse.team.ui/src/org/eclipse/team/ui/synchronize/actions/CompoundSyncInfoFilter.java;1;0;1;1;0;0;0;1;0;0;1;2535;0;0;1;0;0;1;1;2535;0;2535;1;1;
/org.eclipse.jface.text/src/org/eclipse/jface/text/templates/ContextType.java;1;0;2;1;0;0;0;2;0;0;1;4258;0;0;2;1;0;2;2;4258;1;4258;1;1;
/org.eclipse.team.ui/src/org/eclipse/team/ui/synchronize/actions/SubscriberAction.java;1;0;4;1;0;0;0;4;119;1;4;2535;139;139;1;0;0;4;4;2535;0;4216;4;1;
/org.eclipse.core.runtime/src/org/eclipse/core/internal/content/ContentTypeBuilder.java;2;1;6;1;5;5;5;1;23;0;1;4941;66;66;1;0;0;1;6;4941;0;5733;6;2;
/org.eclipse.swt/Eclipse SWT Mozilla/common/org/eclipse/swt/internal/mozilla/nsIController.java;1;0;2;1;0;0;0;2;8;1;2;1654;8;8;1;0;0;2;2;1654;0;2568;2;1;
/org.eclipse.ui.ide/src/org/eclipse/ui/internal/dialogs/WelcomeParser.java;2;0;4;1;0;0;0;4;11;1;4;1526;13;13;1;0;0;4;4;1526;0;2263;4;2;
/org.eclipse.core.tests.resources/src/org/eclipse/core/tests/resources/usecase/HistoryStorePerformanceTest.java;1;0;2;1;2;1;2;0;138;0;0;5147;138;138;2;0;1;0;2;5147;1;5147;1;1;
/org.eclipse.jface.text/src/org/eclipse/jface/internal/text/link/contentassist/LineBreakingReader.java;2;0;2;1;1;1;1;1;2;0;1;4214;2;2;1;0;0;1;2;4214;0;6340;2;2;
/org.eclipse.debug.ui/ui/org/eclipse/debug/internal/ui/sourcelookup/RemoveAction.java;1;0;1;1;0;0;0;1;0;0;1;3770;0;0;1;0;0;1;1;3770;0;3770;1;1;
/org.eclipse.update.core/src/org/eclipse/update/core/model/UpdateSite.java;1;0;1;1;0;0;0;1;0;0;1;2634;0;0;1;0;0;1;1;2634;0;2634;1;1;
/org.eclipse.swt.examples/src/org/eclipse/swt/examples/controlexample/ControlExample.java;1;1;6;1;2;2;2;4;163;1;4;2729;173;173;1;0;0;4;6;2729;0;6352;6;1;
/org.eclipse.text/src/org/eclipse/jface/text/ITextStore.java;1;0;1;1;1;1;1;0;8;0;0;6299;8;8;1;0;0;0;1;6299;0;6299;1;1;
/org.eclipse.help/src/org/eclipse/help/internal/browser/macosx/DefaultBrowserFactory.java;1;0;1;1;0;0;0;1;0;0;1;2732;0;0;1;0;0;1;1;2732;0;2732;1;1;
/org.eclipse.core.runtime/src/org/eclipse/core/internal/preferences/ConfigurationPreferences.java;1;1;11;1;3;3;3;8;79;2;7;4351;189;189;2;1;0;8;11;4561;1;5879;10;1;
/org.eclipse.ui.views/src/org/eclipse/ui/views/bookmarkexplorer/SelectAllAction.java;1;0;1;1;0;0;0;1;0;0;1;2738;0;0;1;0;0;1;1;2738;0;2738;1;1;
/org.eclipse.webdav/src/interface/org/eclipse/webdav/dom/AssertionFailedException.java;1;0;2;1;2;1;2;0;26;0;0;5151;26;26;2;0;1;0;2;5151;1;5151;1;1;
/org.eclipse.ui.cheatsheets/src/org/eclipse/ui/cheatsheets/events/ICheatSheetEvent.java;1;0;2;1;0;0;0;2;0;1;2;4428;0;0;1;0;0;2;2;4428;0;4625;2;1;
/org.eclipse.core.resources/src/org/eclipse/core/internal/indexing/Page.java;1;0;2;1;2;1;2;0;16;0;0;5146;16;16;2;0;1;0;2;5146;1;5146;1;1;
/org.eclipse.team.examples.filesystem/src/org/eclipse/team/examples/pessimistic/PessimisticFilesystemProvider.java;1;1;3;1;2;2;2;1;653;0;1;3368;714;714;1;0;0;1;3;3368;0;6151;3;1;
/org.eclipse.ui.workbench/Eclipse UI/org/eclipse/ui/internal/registry/ContentDescriptor.java;1;0;1;1;0;0;0;1;0;0;1;947;0;0;1;0;0;1;1;947;0;947;1;1;
/org.eclipse.ui.workbench/Eclipse UI/org/eclipse/ui/internal/progress/IProgressUpdateCollector.java;1;0;2;1;0;0;0;2;44;1;2;3560;44;44;1;0;0;2;2;3560;0;3630;2;1;
/org.eclipse.update.ui/src/org/eclipse/update/internal/ui/WebBookmarksDialog.java;3;0;5;1;1;1;1;4;37;1;4;825;51;51;1;0;0;4;5;825;0;5991;5;3;
/org.eclipse.jdt.core/model/org/eclipse/jdt/core/ICorrectionRequestor.java;1;0;2;1;0;0;0;2;6;1;2;2583;8;8;1;0;0;2;2;2583;0;3560;2;1;
/org.eclipse.update.core/src/org/eclipse/update/internal/core/Response.java;2;0;2;1;0;0;0;2;101;1;2;1291;122;122;1;0;0;2;2;1291;0;3015;2;2;
/org.eclipse.core.variables/src/org/eclipse/core/internal/variables/StringSubstitutionEngine.java;3;0;5;1;1;1;1;4;59;1;4;2514;169;169;1;0;0;4;5;2514;0;5520;5;3;
/org.eclipse.jdt.ui/ui/org/eclipse/jdt/internal/ui/search/GroupAction.java;1;0;2;1;0;0;0;2;3;1;2;4107;3;3;1;0;0;2;2;4107;0;4361;2;1;
/org.eclipse.jdt.ui.tests.refactoring/resources/UseSupertypeWherePossible/testNew38/in/A.java;1;0;1;1;0;0;0;1;0;0;1;1315;0;0;1;0;0;1;1;1315;0;1315;1;1;
/org.eclipse.jdt.core/search/org/eclipse/jdt/internal/core/search/JavaSearchScope.java;2;1;4;1;2;2;2;2;45;1;2;3560;89;89;1;0;0;2;4;3560;0;5728;4;2;
/org.eclipse.jdt.ui/ui/org/eclipse/jdt/internal/ui/javadocexport/JavadocWizardPage.java;2;0;3;1;0;0;0;3;11;1;3;1336;20;20;1;0;0;3;3;1336;0;4412;3;2;
/org.eclipse.jdt.ui.tests.refactoring/resources/ExtractMethodWorkSpace/ExtractMethodTests/nested_out/A_test651.java;1;0;2;1;0;0;0;2;4;1;2;130;5;5;1;0;0;2;2;130;0;844;2;1;
/org.eclipse.ui.workbench/Eclipse UI/org/eclipse/ui/internal/commands/CommandAndContextController.java;1;0;2;1;0;0;0;2;0;0;1;1715;0;0;2;1;0;2;2;1715;1;1715;1;1;
/org.eclipse.jdt.core.tests.model/workspace/Converter/src/junit/runner/Sorter.java;1;0;1;1;0;0;0;1;0;0;1;3714;0;0;1;0;0;1;1;3714;0;3714;1;1;
/org.eclipse.jdt.ui.tests.refactoring/resources/DeleteSourceReferenceEdit/A_testField4_in.java;1;0;1;1;0;0;0;1;0;0;1;1652;0;0;1;0;0;1;1;1652;0;1652;1;1;
/org.eclipse.jdt.core.tests.compiler/src/org/eclipse/jdt/core/tests/junit/extension/TestListener.java;1;0;1;1;0;0;0;1;2;0;1;3560;2;2;1;0;0;1;1;3560;0;3560;1;1;
/org.eclipse.jdt.ui/core refactoring/org/eclipse/jdt/internal/corext/refactoring/participants/properties/PropertyInterfaceManager.java;1;0;2;1;0;0;0;2;0;1;2;825;0;0;1;0;0;2;2;825;0;1033;2;1;
/org.eclipse.pde.ui/src_Forms/org/eclipse/pde/internal/ui/neweditor/feature/FeatureSourcePage.java;2;1;3;1;2;2;2;1;14;0;1;4926;14;14;1;0;0;1;3;4926;0;5431;3;2;
/org.eclipse.debug.ui/ui/org/eclipse/debug/internal/ui/views/memory/IMemoryViewTabFactory.java;1;0;1;1;1;1;1;0;0;0;0;5254;0;0;1;0;0;0;1;5254;0;5254;1;1;
/org.eclipse.jdt.core.tests.model/workspace/Converter/src/test0174/Test.java;1;0;1;1;0;0;0;1;0;0;1;3714;0;0;1;0;0;1;1;3714;0;3714;1;1;
/org.eclipse.swt/Eclipse SWT Printing/motif/org/eclipse/swt/printing/PrintDialog.java;1;1;2;1;2;2;2;0;8;0;0;5606;12;12;1;0;0;0;2;5606;0;6352;2;1;
/org.eclipse.jdt.debug.ui/ui/org/eclipse/jdt/internal/debug/ui/actions/JavaBreakpointPropertiesDialog.java;1;0;1;1;0;0;0;1;0;0;1;1484;0;0;1;0;0;1;1;1484;0;1484;1;1;
/org.eclipse.jdt.core.tests.model/workspace/Converter/src/test0239/Test.java;1;0;1;1;0;0;0;1;0;0;1;3714;0;0;1;0;0;1;1;3714;0;3714;1;1;
/org.eclipse.jdt.core.tests.model/workspace/Converter/src/test0058/Test.java;1;0;1;1;0;0;0;1;0;0;1;3714;0;0;1;0;0;1;1;3714;0;3714;1;1;
/org.eclipse.team.webdav/src/org/eclipse/team/internal/ui/target/subscriber/TargetParticpantActionContribution.java;1;1;3;1;2;2;2;1;64;0;1;5082;64;64;1;0;0;1;3;5082;0;5508;3;1;
/org.eclipse.ui.workbench/Eclipse UI/org/eclipse/ui/internal/handles/api/IHandleListener.java;1;0;2;1;0;0;0;2;0;1;2;1507;0;0;1;0;0;2;2;1507;0;1724;2;1;
/org.eclipse.ui.externaltools/External Tools Base/org/eclipse/ui/externaltools/internal/group/IGroupDialogPage.java;1;0;1;1;0;0;0;1;0;0;1;321;0;0;1;0;0;1;1;321;0;321;1;1;
/org.eclipse.jdt.core.tests.model/workspace/Converter/test0373/A.java;1;0;1;1;0;0;0;1;0;0;1;3714;0;0;1;0;0;1;1;3714;0;3714;1;1;
/org.eclipse.swt/Eclipse SWT PI/win32/org/eclipse/swt/internal/win32/LOGPEN.java;1;0;1;1;0;0;0;1;2;0;1;2915;2;2;1;0;0;1;1;2915;0;2915;1;1;
/org.eclipse.team.ui/src/org/eclipse/team/internal/ui/actions/SubscriberOperation.java;1;0;2;1;0;0;0;2;0;1;2;4450;0;0;1;0;0;2;2;4450;0;4466;2;1;
/org.eclipse.ant.ui/Ant Tools Support/org/eclipse/ant/internal/ui/console/AntConsoleColorProvider.java;1;0;2;1;1;1;1;1;15;0;1;4498;15;15;1;0;0;1;2;4498;0;5700;2;1;
/org.eclipse.ui.workbench/Eclipse UI/org/eclipse/ui/internal/progress/NewProgressViewer.java;5;6;50;3;48;26;48;2;551;1;2;5076;3864;3864;6;0;22;2;50;5303;22;6360;28;5;
/org.eclipse.team.cvs.ui/src/org/eclipse/team/internal/ccvs/ui/operations/BranchOperation.java;1;2;5;1;5;4;5;0;24;0;0;5463;49;49;2;0;1;0;5;5463;1;6067;4;1;
/org.eclipse.ltk.core.refactoring/src/org/eclipse/ltk/internal/core/refactoring/Resources.java;1;1;3;1;2;2;2;1;4;0;1;4845;6;6;1;0;0;1;3;4845;0;6340;3;1;
/org.eclipse.core.filebuffers.tests/src/org/eclipse/core/filebuffers/tests/FileBufferTest1.java;1;0;2;1;1;1;1;1;2;0;1;5082;2;2;1;0;0;1;2;5082;0;6340;2;1;
/org.eclipse.releng.basebuilder/plugins/org.eclipse.build.tools/org.eclipse.build.tools/src/org/eclipse/releng/generators/PlatformStatus.java;1;0;1;1;1;1;1;0;0;0;0;5735;0;0;1;0;0;0;1;5735;0;5735;1;1;
/org.eclipse.update.ui.win32/src/org/eclipse/welcome/internal/WebBrowserView.java;1;0;3;1;0;0;0;3;8;2;2;889;8;8;2;1;0;3;3;889;1;907;2;1;
/org.eclipse.jdt.core.tests.model/workspace/Formatter/test393/A_in.java;1;0;1;1;0;0;0;1;0;0;1;3175;0;0;1;0;0;1;1;3175;0;3175;1;1;
/org.eclipse.ui.workbench/Eclipse UI/org/eclipse/ui/part/ResourceTransfer.java;2;0;2;1;0;0;0;2;8;1;2;1;8;8;1;0;0;2;2;1;0;2737;2;2;
/org.eclipse.jdt.ui/ui/org/eclipse/jdt/ui/text/java/IQuickFixProcessor.java;2;1;5;1;3;3;3;2;14;1;2;1232;45;45;1;0;0;2;5;1232;0;6322;5;2;
/org.eclipse.ui.views/src/org/eclipse/ui/views/framelist/FrameAction.java;1;0;1;1;0;0;0;1;0;0;1;2738;0;0;1;0;0;1;1;2738;0;2738;1;1;
/org.eclipse.jdt.debug.ui/ui/org/eclipse/jdt/internal/debug/core/refactoring/JavaLineBreakpointTypeChange.java;2;1;3;1;3;3;3;0;8;0;0;5319;16;16;1;0;0;0;3;5319;0;6339;3;2;
/org.eclipse.core.runtime/src/org/eclipse/core/runtime/ProgressMonitorWrapper.java;3;1;8;1;2;2;2;6;318;1;6;2064;745;745;1;0;0;6;8;2064;0;6340;8;3;
/org.eclipse.ui.examples.javaeditor/Eclipse Java Editor Example/org/eclipse/ui/examples/javaeditor/JavaContentOutlinePage.java;1;0;2;1;1;1;1;1;6;0;1;1349;8;8;1;0;0;1;2;1349;0;6340;2;1;
/org.eclipse.ui.workbench/Eclipse UI/org/eclipse/ui/internal/commands/api/CommandManagerFactory.java;1;0;2;1;0;0;0;2;2;0;1;2562;2;2;2;1;0;2;2;2562;1;2562;1;1;
/org.eclipse.jdt.core.tests.model/workspace/Formatter/test168/A_in.java;1;0;1;1;0;0;0;1;0;0;1;2425;0;0;1;0;0;1;1;2425;0;2425;1;1;
/org.eclipse.jdt.ui.tests.refactoring/resources/MoveInnerToTopLevel/test13/out/Inner.java;1;0;1;1;0;0;0;1;2;0;1;305;2;2;1;0;0;1;1;305;0;305;1;1;
/org.eclipse.jdt.ui/ui/org/eclipse/jdt/internal/ui/callhierarchy/ToggleOrientationAction.java;3;1;4;1;2;2;2;2;16;1;2;155;20;20;1;0;0;2;4;155;0;6340;4;3;
/org.eclipse.ui.ide/src/org/eclipse/ui/views/markers/internal/MarkerTypesModel.java;1;0;1;1;0;0;0;1;0;0;1;2208;0;0;1;0;0;1;1;2208;0;2208;1;1;
/org.eclipse.debug.ui/ui/org/eclipse/debug/ui/variables/ExternalToolVariableForm.java;1;0;4;1;0;0;0;4;237;0;1;316;237;237;4;3;0;4;4;316;3;316;1;1;
/org.eclipse.team.core/src/org/eclipse/team/core/subscribers/ISubscriberResource.java;1;0;1;1;0;0;0;1;0;0;1;2786;0;0;1;0;0;1;1;2786;0;2786;1;1;
/org.eclipse.ui.workbench/Eclipse UI/org/eclipse/ui/commands/registry/ICommandRegistryListener.java;1;0;2;1;0;0;0;2;0;1;2;1400;0;0;1;0;0;2;2;1400;0;1417;2;1;
/org.eclipse.jdt.core.tests.model/workspace/Converter/src/javadoc/testBug51226/X2.java;1;0;1;1;0;0;0;1;0;0;1;3899;0;0;1;0;0;1;1;3899;0;3899;1;1;
/org.eclipse.ui.workbench/Eclipse UI/org/eclipse/ui/IPerspectiveListener2.java;1;0;1;1;1;1;1;0;0;0;0;5940;0;0;1;0;0;0;1;5940;0;5940;1;1;
/org.eclipse.jdt.core.tests.model/workspace/Formatter/test204/A_out.java;1;0;2;1;0;0;0;2;7;1;2;2424;7;7;1;0;0;2;2;2424;0;2643;2;1;
/org.eclipse.jdt.core.tests.model/workspace/Converter/test0355/Foo.java;1;0;1;1;0;0;0;1;0;0;1;3714;0;0;1;0;0;1;1;3714;0;3714;1;1;
/org.eclipse.pde.ui/sandbox/org/eclipse/pde/internal/ui/editor/standalone/manifest/BaseSourceLabelProvider.java;1;0;2;1;0;0;0;2;0;1;2;2320;0;0;1;0;0;2;2;2320;0;2906;2;1;
/org.eclipse.core.filebuffers/src/org/eclipse/core/filebuffers/annotations/DefaultMarkerUpdater.java;1;0;1;1;0;0;0;1;0;0;1;2815;0;0;1;0;0;1;1;2815;0;2815;1;1;
/org.eclipse.ant.ui/Ant Tools Support/org/eclipse/ant/internal/ui/views/actions/AntViewActionMessages.java;1;0;1;1;0;0;0;1;0;0;1;1811;0;0;1;0;0;1;1;1811;0;1811;1;1;
/org.eclipse.jdt.debug.tests/testprograms/org/eclipse/debug/tests/targets/HcrClass.java;1;0;1;1;0;0;0;1;0;0;1;629;0;0;1;0;0;1;1;629;0;629;1;1;
/org.eclipse.pde.ui/src_Forms/org/eclipse/pde/internal/ui/neweditor/build/BuildInputContext.java;2;1;11;1;6;6;6;5;132;1;5;4406;236;236;1;0;0;5;11;4406;0;5431;11;2;
/org.eclipse.ltk.ui.refactoring/src/org/eclipse/ltk/ui/refactoring/IRefactoringUIStatusCodes.java;1;0;2;1;1;1;1;1;6;0;1;4845;6;6;1;0;0;1;2;4845;0;5162;2;1;
/org.eclipse.jdt.core.tests.model/workspace/Converter/test0138/Test.java;1;0;1;1;0;0;0;1;0;0;1;3714;0;0;1;0;0;1;1;3714;0;3714;1;1;
/org.eclipse.jface.text/src/org/eclipse/jface/text/ITextHoverExtension.java;2;1;4;1;3;3;3;1;10;0;1;692;18;18;1;0;0;1;4;692;0;6359;4;2;
/org.eclipse.jdt.core.tests.model/workspace/Formatter/test122/A_out.java;1;0;1;1;0;0;0;1;0;0;1;2425;0;0;1;0;0;1;1;2425;0;2425;1;1;
/org.eclipse.debug.ui/ui/org/eclipse/debug/internal/ui/views/variables/ViewerState.java;3;0;7;2;1;1;1;6;153;2;5;1986;501;501;2;1;0;6;7;2691;1;6336;6;3;
/org.eclipse.pde.ui/src/org/eclipse/pde/internal/ui/wizards/exports/FeatureExportWizard.java;3;4;21;2;8;4;8;13;194;2;12;94;455;455;4;1;4;13;21;5800;5;6336;16;3;
/org.eclipse.ui.forms/src/org/eclipse/ui/forms/IDetailsPageProvider.java;1;0;4;1;1;1;1;3;45;1;3;4068;54;54;1;0;0;3;4;4068;0;6336;4;1;
/org.eclipse.pde.ui/src/org/eclipse/pde/internal/ui/editor/feature/InfoForm.java;1;0;2;1;1;1;1;1;7;0;1;4203;7;7;1;0;0;1;2;4203;0;5431;2;1;
/org.eclipse.team.cvs.ui/src/org/eclipse/team/internal/uijobs/BatchSimilarSchedulingRule.java;1;0;1;1;0;0;0;1;0;0;1;976;0;0;1;0;0;1;1;976;0;976;1;1;
/org.eclipse.ui.tests/Eclipse UI Tests/org/eclipse/ui/tests/dynamicplugins/ViewTests.java;1;0;2;1;1;1;1;1;71;0;1;4969;71;71;1;0;0;1;2;4969;0;6081;2;1;
/org.eclipse.team.cvs.core/src/org/eclipse/team/internal/ccvs/core/resources/SyncInfoCache.java;2;1;3;1;2;2;2;1;25;0;1;2061;33;33;1;0;0;1;3;2061;0;6337;3;2;
/org.eclipse.webdav/src/kernel/org/eclipse/webdav/internal/kernel/DAV4JRuntimeException.java;1;0;1;1;1;1;1;0;189;0;0;5151;189;189;1;0;0;0;1;5151;0;5151;1;1;
/org.eclipse.jdt.debug.ui/ui/org/eclipse/jdt/internal/debug/ui/launchConfigurations/RuntimeClasspathViewer.java;1;0;3;1;0;0;0;3;71;0;1;2685;71;71;3;2;0;3;3;2685;2;2685;1;1;
/org.eclipse.ui.examples.javaeditor/Eclipse Java Editor Example/org/eclipse/ui/examples/javaeditor/spelling/ISpellProblemRequestor.java;1;0;1;1;0;0;0;1;0;0;1;2565;0;0;1;0;0;1;1;2565;0;2565;1;1;
/org.eclipse.ui.ide/src/org/eclipse/ui/IEditorLauncher.java;1;0;2;1;0;0;0;2;0;1;2;1511;0;0;1;0;0;2;2;1511;0;1520;2;1;
/org.eclipse.update.ui/src/org/eclipse/update/internal/ui/views/UpdatesDropAdapter.java;1;0;1;1;0;0;0;1;0;0;1;755;0;0;1;0;0;1;1;755;0;755;1;1;
/org.eclipse.jdt.ui/ui/org/eclipse/jdt/internal/ui/actions/OpenBrowserUtil.java;2;0;7;1;1;1;1;6;29;1;6;678;78;78;1;0;0;6;7;678;0;6340;7;2;
/org.eclipse.jdt.ui.tests.refactoring/resources/MoveMembers/test36/in/A.java;1;0;1;1;0;0;0;1;0;0;1;2093;0;0;1;0;0;1;1;2093;0;2093;1;1;
/org.eclipse.ui.workbench/Eclipse UI/org/eclipse/ui/internal/ClosePerspectiveAction.java;1;0;1;1;0;0;0;1;48;0;1;2737;48;48;1;0;0;1;1;2737;0;2737;1;1;
/org.eclipse.jdt.ui/core refactoring/org/eclipse/ltk/core/refactoring/participants/RefactoringStyles.java;1;0;2;1;0;0;0;2;0;1;2;4624;0;0;1;0;0;2;2;4624;0;4864;2;1;
/org.eclipse.sdk.tests-feature/plugins/org.eclipse.perfmsr.ui.client/src/org/eclipse/perfmsr/ui/client/SnapshotsView.java;1;1;6;1;6;6;6;0;26;0;0;5443;46;46;1;0;0;0;6;5443;0;6359;6;1;
/org.eclipse.jdt.core/dom/org/eclipse/jdt/core/dom/Comment.java;1;0;3;1;0;0;0;3;8;1;3;3683;12;12;1;0;0;3;3;3683;0;4202;3;1;
/org.eclipse.jdt.core/compiler/org/eclipse/jdt/internal/compiler/parser/RecoveredMethod.java;4;0;7;1;1;1;1;6;36;1;6;488;97;97;1;0;0;6;7;488;0;5921;7;4;
/org.eclipse.jdt.core.tests.model/workspace/Converter/src/Test462.java;1;0;1;1;0;0;0;1;0;0;1;3714;0;0;1;0;0;1;1;3714;0;3714;1;1;
/org.eclipse.jdt.core/model/org/eclipse/jdt/internal/core/util/ClassFileStruct.java;3;0;3;1;1;1;1;2;14;1;2;1129;29;29;1;0;0;2;3;1129;0;5443;3;3;
/org.eclipse.jdt.core.tests.model/workspace/Converter/src/test0090/Test.java;1;0;1;1;0;0;0;1;0;0;1;3714;0;0;1;0;0;1;1;3714;0;3714;1;1;
/org.eclipse.jdt.core.tests.model/workspace/Formatter/test152/A_in.java;1;0;1;1;0;0;0;1;0;0;1;2425;0;0;1;0;0;1;1;2425;0;2425;1;1;
/org.eclipse.jdt.core.tests.compiler/src/org/eclipse/jdt/core/tests/eval/SimpleTest.java;3;0;6;1;0;0;0;6;10;1;6;241;20;20;1;0;0;6;6;241;0;3560;6;3;
/org.eclipse.swt.tests/JUnit Tests/org/eclipse/swt/tests/junit/Test_org_eclipse_swt_layout_FormData.java;1;0;1;1;0;0;0;1;0;0;1;2176;0;0;1;0;0;1;1;2176;0;2176;1;1;
/org.eclipse.pde.core/src/org/eclipse/pde/internal/core/TracingOptionsManager.java;3;1;9;1;2;2;2;7;86;1;7;2229;130;130;1;0;0;7;9;2229;0;6336;9;3;
/org.eclipse.jdt.core.tests.model/workspace/Formatter/test444/A_out.java;1;0;1;1;0;0;0;1;0;0;1;3513;0;0;1;0;0;1;1;3513;0;3513;1;1;
/org.eclipse.pde.core/srcnew/org/eclipse/pde/internal/core/plugin/XEParserConfiguration.java;1;0;1;1;0;0;0;1;0;0;1;2906;0;0;1;0;0;1;1;2906;0;2906;1;1;
/org.eclipse.swt.tests/JUnit Tests/org/eclipse/swt/tests/junit/Test_org_eclipse_swt_events_MouseListener.java;1;0;1;1;0;0;0;1;16;0;1;2175;16;16;1;0;0;1;1;2175;0;2175;1;1;
/org.eclipse.team.cvs.core/src/org/eclipse/team/internal/ccvs/core/subscribers/CVSSyncInfo.java;1;0;1;1;0;0;0;1;0;0;1;1427;0;0;1;0;0;1;1;1427;0;1427;1;1;
/org.eclipse.team.cvs.ui/src/org/eclipse/team/internal/ccvs/ui/WatchEditPreferencePage.java;2;0;2;1;1;1;1;1;61;0;1;3744;63;63;1;0;0;1;2;3744;0;6337;2;2;
/org.eclipse.update.ui/src/org/eclipse/update/internal/ui/pages/MyComputerPage.java;1;0;1;1;0;0;0;1;0;0;1;755;0;0;1;0;0;1;1;755;0;755;1;1;
/org.eclipse.pde.ui/src/org/eclipse/pde/internal/ui/preferences/CompilersPreferencePage.java;3;2;11;2;8;6;8;3;108;1;3;648;266;266;2;0;2;3;11;5782;2;6336;9;3;
/org.eclipse.jdt.ui.tests/ui/org/eclipse/jdt/ui/tests/callhierarchy/CallHierarchyContentProviderTest.java;3;0;5;1;1;1;1;4;3;1;4;329;10;10;1;0;0;4;5;329;0;6340;5;3;
/org.eclipse.pde.ui/src/org/eclipse/pde/internal/ui/editor/manifest/ExportSection.java;2;0;3;1;1;1;1;2;5;1;2;1011;8;8;1;0;0;2;3;1011;0;5431;3;2;
/org.eclipse.jdt.ui.tests.refactoring/resources/RenamePackage/testImportFromMultiRoots6/out/srcPrg/p/p/A.java;1;0;1;1;0;0;0;1;0;0;1;4105;0;0;1;0;0;1;1;4105;0;4105;1;1;
/org.eclipse.jdt.ui/ui/org/eclipse/jdt/internal/ui/actions/LexicalSortingAction.java;1;0;2;1;1;1;1;1;2;0;1;4486;2;2;1;0;0;1;2;4486;0;6340;2;1;
/org.eclipse.jdt.core.tests.model/src/org/eclipse/jdt/core/tests/model/CreatePackageTests.java;1;0;2;1;0;0;0;2;2;1;2;2722;2;2;1;0;0;2;2;2722;0;3560;2;1;
/org.eclipse.jdt.core.tests.model/workspace/Converter/test0397/A.java;1;0;1;1;0;0;0;1;0;0;1;3714;0;0;1;0;0;1;1;3714;0;3714;1;1;
/org.eclipse.jdt.ui/ui/org/eclipse/jdt/internal/ui/callhierarchy/CallHierarchyViewSiteAdapter.java;3;0;7;1;0;0;0;7;47;1;7;186;60;60;1;0;0;7;7;186;0;2893;7;3;
/org.eclipse.jdt.ui/ui/org/eclipse/jdt/internal/ui/typehierarchy/TypeHierarchyViewer.java;2;1;4;1;2;2;2;2;13;1;2;3111;18;18;1;0;0;2;4;3111;0;6340;4;2;
/org.eclipse.jdt.ui.tests.refactoring/resources/PushDown/test28/in/A.java;1;0;1;1;0;0;0;1;0;0;1;344;0;0;1;0;0;1;1;344;0;344;1;1;
/org.eclipse.update/src/org/eclipse/update/internal/ui/UMDialogAction.java;1;0;1;1;1;1;1;0;0;0;0;6339;0;0;1;0;0;0;1;6339;0;6339;1;1;
/org.eclipse.ui.workbench/Eclipse UI/org/eclipse/ui/internal/ResetPerspectiveAction.java;1;0;1;1;0;0;0;1;55;0;1;2737;55;55;1;0;0;1;1;2737;0;2737;1;1;
/org.eclipse.jdt.core.tests.model/workspace/Converter/src/test0085/Test.java;1;0;1;1;0;0;0;1;0;0;1;3714;0;0;1;0;0;1;1;3714;0;3714;1;1;
/org.eclipse.jdt.core.tests.model/workspace/Completion/src/CompletionAbstractMethod3.java;1;0;1;1;0;0;0;1;0;0;1;1702;0;0;1;0;0;1;1;1702;0;1702;1;1;
/org.eclipse.jface/src/org/eclipse/jface/util/Policy.java;1;1;4;1;4;4;4;0;29;0;0;5387;44;44;1;0;0;0;4;5387;0;6340;4;1;
/org.eclipse.jdt.core.tests.model/workspace/Formatter/test207/A_in.java;1;0;1;1;0;0;0;1;0;0;1;2424;0;0;1;0;0;1;1;2424;0;2424;1;1;
/org.eclipse.jface.text/src/org/eclipse/jface/text/rules/EndOfLineRule.java;1;1;3;1;2;2;2;1;21;0;1;4190;24;24;1;0;0;1;3;4190;0;6340;3;1;
/org.eclipse.team.cvs.ui/src/org/eclipse/team/internal/ccvs/ui/repo/RemoveDateTagAction.java;2;1;4;1;4;4;4;0;11;0;0;5109;18;18;1;0;0;0;4;5109;0;6337;4;2;
/org.eclipse.ui.tests/Eclipse UI Tests/org/eclipse/ui/tests/api/IPageListenerTest.java;1;0;1;1;0;0;0;1;13;0;1;3091;13;13;1;0;0;1;1;3091;0;3091;1;1;
/org.eclipse.jdt.ui.tests.refactoring/resources/InlineMethodWorkspace/TestCases/argument_out/TestLiteralReferenceWrite.java;1;0;1;1;0;0;0;1;4;0;1;845;4;4;1;0;0;1;1;845;0;845;1;1;
/org.eclipse.jdt.core/search/org/eclipse/jdt/internal/core/search/matching/VariablePattern.java;2;1;7;1;2;2;2;5;62;1;5;2514;96;96;1;0;0;5;7;2514;0;5335;7;2;
/org.eclipse.jdt.text.tests/src/org/eclipse/jdt/ui/text/tests/JavaPartitionerExtensionTest.java;1;1;3;1;2;2;2;1;7;0;1;5082;7;7;1;0;0;1;3;5082;0;5129;3;1;
/org.eclipse.jdt.ui/core refactoring/org/eclipse/jdt/internal/corext/refactoring/SearchResultGroup.java;3;1;4;1;2;2;2;2;23;1;2;80;53;53;1;0;0;2;4;80;0;6340;4;3;
/org.eclipse.debug.ui/ui/org/eclipse/debug/ui/launchVariables/ExpandVariableContext.java;1;0;3;1;0;0;0;3;1;2;2;550;1;1;2;1;0;3;3;550;1;562;2;1;
/org.eclipse.team.core/src/org/eclipse/team/core/subscribers/utils/SynchronizationSyncBytesCache.java;1;0;1;1;0;0;0;1;0;0;1;3563;0;0;1;0;0;1;1;3563;0;3563;1;1;
/org.eclipse.pde.ui/src/org/eclipse/pde/internal/ui/editor/manifest/RuntimeSection.java;1;0;1;1;1;1;1;0;0;0;0;5431;0;0;1;0;0;0;1;5431;0;5431;1;1;
/org.eclipse.ui.forms/src/org/eclipse/ui/forms/internal/widgets/HyperlinkSegment.java;1;0;3;1;0;0;0;3;8;1;3;4068;8;8;1;0;0;3;3;4068;0;5044;3;1;
/org.eclipse.ui.workbench/Eclipse UI/org/eclipse/ui/internal/commands/registry/old/IMutableRegistry.java;1;0;3;1;0;0;0;3;24;1;3;1222;24;24;1;0;0;3;3;1222;0;1322;3;1;
/org.eclipse.debug.ui/ui/org/eclipse/debug/internal/ui/actions/FollowHyperlinkAction.java;1;0;1;1;0;0;0;1;3;0;1;2745;3;3;1;0;0;1;1;2745;0;2745;1;1;
/org.eclipse.update.ui.forms/Eclipse Forms/org/eclipse/ui/forms/FormsResources.java;1;0;2;1;0;0;0;2;0;0;1;3096;0;0;2;1;0;2;2;3096;1;3096;1;1;
/org.eclipse.core.resources/src/org/eclipse/core/internal/dtree/IComparator.java;1;0;1;1;1;1;1;0;24;0;0;5146;24;24;1;0;0;0;1;5146;0;5146;1;1;
/org.eclipse.jdt.ui/ui/org/eclipse/jdt/internal/ui/text/template/preferences/TemplatePreferencesMessages.java;2;1;2;1;2;2;2;0;2;0;0;5264;2;2;1;0;0;0;2;5264;0;6340;2;2;
/org.eclipse.ui.workbench/Eclipse UI/org/eclipse/ui/internal/contexts/registry/AbstractMutableContextRegistry.java;1;0;2;1;0;0;0;2;0;1;2;1422;0;0;1;0;0;2;2;1422;0;1724;2;1;
/org.eclipse.jdt.ui/ui/org/eclipse/jdt/internal/ui/search/GroupByKeyComputer.java;2;1;3;1;2;2;2;1;5;0;1;1350;11;11;1;0;0;1;3;1350;0;6340;3;2;
/org.eclipse.jdt.debug/model/org/eclipse/jdt/internal/debug/core/hcr/JavaParseTreeBuilder.java;1;0;1;1;0;0;0;1;2;0;1;215;2;2;1;0;0;1;1;215;0;215;1;1;
/org.eclipse.team.core/src/org/eclipse/team/core/subscribers/utils/SyncTreeSubscriber.java;1;0;1;1;0;0;0;1;0;0;1;3563;0;0;1;0;0;1;1;3563;0;3563;1;1;
/org.eclipse.ui.forms/src/org/eclipse/ui/forms/widgets/Form.java;1;0;11;1;1;1;1;10;254;2;9;4068;335;335;2;1;0;10;11;4068;1;6044;10;1;
/org.eclipse.team.ui/src/org/eclipse/team/internal/ui/sync/pages/ToolItemActionContributionItem.java;1;0;1;1;0;0;0;1;0;0;1;2481;0;0;1;0;0;1;1;2481;0;2481;1;1;
/org.eclipse.update.core/src/org/eclipse/update/internal/core/ConnectionThreadManager.java;3;1;5;1;2;2;2;3;16;1;3;890;29;29;1;0;0;3;5;890;0;6336;5;3;
/org.eclipse.ant.tests.ui/External Tools/org/eclipse/ant/tests/ui/externaltools/MigrationTests.java;1;0;2;1;0;0;0;2;105;0;1;2689;105;105;2;1;0;2;2;2689;1;2689;1;1;
/org.eclipse.jdt.ui.examples.javafamily/src/org/eclipse/jsp/Util.java;2;0;3;1;1;1;1;2;79;1;2;1033;81;81;1;0;0;2;3;1033;0;5607;3;2;
/org.eclipse.jdt.debug.ui/ui/org/eclipse/jdt/internal/debug/ui/console/J9ConsoleTracker.java;2;0;3;1;0;0;0;3;6;1;3;2119;14;14;1;0;0;3;3;2119;0;2149;3;2;
/org.eclipse.jdt.core/compiler/org/eclipse/jdt/internal/compiler/lookup/RawTypeBinding.java;1;0;1;1;0;0;0;1;0;0;1;4555;0;0;1;0;0;1;1;4555;0;4555;1;1;
/org.eclipse.ui.workbench/Eclipse UI/org/eclipse/ui/internal/dialogs/AboutFeaturesDialog.java;3;0;3;1;1;1;1;2;1050;1;2;94;1051;1051;1;0;0;2;3;94;0;5483;3;3;
/org.eclipse.team.ui/src/org/eclipse/team/ui/synchronize/content/SyncViewerSorter.java;1;0;1;1;0;0;0;1;0;0;1;3748;0;0;1;0;0;1;1;3748;0;3748;1;1;
/org.eclipse.ui.workbench/Eclipse UI/org/eclipse/ui/internal/commands/old/Stroke.java;1;0;2;1;0;0;0;2;0;1;2;1322;0;0;1;0;0;2;2;1322;0;1695;2;1;
/org.eclipse.ui.views/src/org/eclipse/ui/views/internal/markers/ActionShowOnBuild.java;1;0;2;1;0;0;0;2;0;0;1;749;0;0;2;1;0;2;2;749;1;749;1;1;
/org.eclipse.jdt.ui.tests.refactoring/resources/PushDown/test28/out/A.java;1;0;3;1;0;0;0;3;7;2;2;344;8;8;2;1;0;3;3;344;1;1312;2;1;
/org.eclipse.compare.examples/src/org/eclipse/compare/examples/structurecreator/Util.java;1;0;3;1;0;0;0;3;17;1;3;2921;25;25;1;0;0;3;3;2921;0;3954;3;1;
/org.eclipse.jdt.ui/ui/org/eclipse/jdt/internal/ui/preferences/formatter/ModifyDialog.java;1;0;11;1;0;0;0;11;147;2;10;3103;362;362;2;1;0;11;11;3103;1;4790;10;1;
/org.eclipse.ui.workbench/Eclipse UI/org/eclipse/ui/internal/commands/older/ActionServiceEvent.java;1;0;1;1;0;0;0;1;4;0;1;2562;4;4;1;0;0;1;1;2562;0;2562;1;1;
/org.eclipse.pde.ui/sandbox/org/eclipse/pde/internal/ui/editor/standalone/site/MultiPageContributor.java;1;0;2;1;0;0;0;2;0;1;2;2320;0;0;1;0;0;2;2;2320;0;2906;2;1;
/org.eclipse.jdt.ui/ui/org/eclipse/jdt/internal/ui/wizards/buildpaths/SourceAttachmentBlock.java;2;3;11;1;6;3;6;5;85;1;5;661;135;135;3;0;3;5;11;5126;3;6340;8;2;
/org.eclipse.jdt.core.tests.model/src/org/eclipse/jdt/core/tests/model/TypeHierarchySerializationTests.java;1;0;1;1;0;0;0;1;2;0;1;3560;2;2;1;0;0;1;1;3560;0;3560;1;1;
/org.eclipse.pde.ui/src/org/eclipse/pde/internal/ui/editor/feature/RequiresSection.java;3;1;10;1;4;4;4;6;103;1;6;741;185;185;1;0;0;6;10;741;0;6336;10;3;
/org.eclipse.ui.workbench/Eclipse UI/org/eclipse/ui/internal/csm/roles/RoleDefinition.java;1;0;3;1;0;0;0;3;29;1;3;2225;29;29;1;0;0;3;3;2225;0;2444;3;1;
/org.eclipse.jdt.core.tests.model/workspace/Formatter/test425/A_out.java;1;0;1;1;0;0;0;1;0;0;1;3478;0;0;1;0;0;1;1;3478;0;3478;1;1;
/org.eclipse.pde.ui/src/org/eclipse/pde/internal/ui/editor/manifest/NewElementAction.java;2;1;3;1;2;2;2;1;3;0;1;5091;5;5;1;0;0;1;3;5091;0;5431;3;2;
/org.eclipse.jdt.ui/ui refactoring/org/eclipse/jdt/internal/ui/refactoring/nls/RenameKeysDialog.java;2;2;3;2;3;2;3;0;6;0;0;5375;10;10;2;0;1;0;3;5375;1;5401;2;2;
/org.eclipse.team.cvs.ui/src/org/eclipse/team/internal/ccvs/ui/actions/ShowAnnotationAction.java;2;1;10;1;2;2;2;8;74;1;8;784;252;252;1;0;0;8;10;784;0;6337;10;2;
/org.eclipse.osgi/core/framework/org/eclipse/osgi/framework/internal/core/UnresolvedPermission.java;4;1;5;1;3;3;3;2;322;1;2;3013;350;350;1;0;0;2;5;3013;0;6337;5;4;
/org.eclipse.core.runtime/src/org/eclipse/core/internal/plugins/PluginEvent.java;2;0;2;1;0;0;0;2;0;1;2;2105;0;0;1;0;0;2;2;2105;0;3013;2;2;
/org.eclipse.ui.forms.examples/src/org/eclipse/ui/forms/examples/internal/rcp/ThirdPage.java;1;0;6;1;1;1;1;5;16;1;5;4075;39;39;1;0;0;5;6;4075;0;5781;6;1;
/org.eclipse.core.tests.resources/src/org/eclipse/core/tests/internal/indexing/BasicObjectStoreTest.java;1;0;2;1;2;1;2;0;22;0;0;5147;22;22;2;0;1;0;2;5147;1;5147;1;1;
/org.eclipse.ui.externaltools/Ant Tools Support/org/eclipse/ui/externaltools/internal/ant/launchConfigurations/AntLaunchShortcut.java;1;0;2;1;0;0;0;2;2;1;2;222;2;2;1;0;0;2;2;222;0;282;2;1;
/org.eclipse.compare/compare/org/eclipse/compare/internal/CompareFilter.java;1;1;3;1;2;2;2;1;4;0;1;3416;7;7;1;0;0;1;3;3416;0;6354;3;1;
/org.eclipse.pde.ui/src/org/eclipse/pde/ui/templates/StringOption.java;3;1;5;1;5;5;5;0;56;0;0;5115;117;117;1;0;0;0;5;5115;0;6336;5;3;
/org.eclipse.team.tests.cvs.core/src/org/eclipse/team/tests/ccvs/ui/MiscOperationsTests.java;1;0;1;1;0;0;0;1;0;0;1;2762;0;0;1;0;0;1;1;2762;0;2762;1;1;
/org.eclipse.debug.ui/ui/org/eclipse/debug/internal/ui/sourcelookup/SourceContainerViewer.java;2;0;7;1;0;0;0;7;12;1;7;3770;36;36;1;0;0;7;7;3770;0;4970;7;2;
/org.eclipse.ui.views/src/org/eclipse/ui/views/internal/markers/problems/ProblemSeverity.java;1;0;3;1;0;0;0;3;4;1;3;265;4;4;1;0;0;3;3;265;0;749;3;1;
/org.eclipse.jdt.ui/core refactoring/org/eclipse/jdt/internal/corext/refactoring/participants/CreateExtensionManager.java;1;0;6;1;0;0;0;6;5;1;6;1125;11;11;1;0;0;6;6;1125;0;4624;6;1;
/org.eclipse.osgi.tests/src/org/eclipse/osgi/tests/internal/state/StateResolverTest.java;2;2;8;1;7;6;7;1;38;0;1;4705;123;123;2;0;1;1;8;5341;1;5993;7;2;
/org.eclipse.jdt.ui.tests.refactoring/resources/IntroduceFactory/positive/differentArgs_in.java;1;0;2;1;0;0;0;2;0;1;2;2846;0;0;1;0;0;2;2;2846;0;2862;2;1;
/org.eclipse.ui.workbench/Eclipse UI/org/eclipse/ui/commands/SimpleHandlerService.java;1;0;2;1;0;0;0;2;0;1;2;1119;0;0;1;0;0;2;2;1119;0;1135;2;1;
/org.eclipse.jdt.ui.tests.refactoring/resources/RenameNonPrivateField/test0/out/A.java;1;0;1;1;0;0;0;1;15;0;1;4560;15;15;1;0;0;1;1;4560;0;4560;1;1;
/org.eclipse.ui.externaltools/External Tools Base/org/eclipse/ui/externaltools/internal/model/ExternalToolsImages.java;2;0;7;1;1;1;1;6;29;2;5;53;69;69;2;1;0;6;7;282;1;5487;6;2;
/org.eclipse.swt/Eclipse SWT/common/org/eclipse/swt/widgets/EventTable.java;1;0;1;1;0;0;0;1;3;0;1;899;3;3;1;0;0;1;1;899;0;899;1;1;
/org.eclipse.jdt.ui/ui/org/eclipse/jdt/internal/ui/text/CompositeReconcilingStrategy.java;2;1;2;1;2;2;2;0;2;0;0;5177;2;2;1;0;0;0;2;5177;0;6340;2;2;
/org.eclipse.core.tests.runtime/src/org/eclipse/core/tests/internal/runtimetests/SampleA.java;1;0;1;1;1;1;1;0;21;0;0;5149;21;21;1;0;0;0;1;5149;0;5149;1;1;
/org.eclipse.core.tests.runtime/src/org/eclipse/core/tests/internal/plugins/ConflictResolveTest_5.java;1;0;1;1;0;0;0;1;0;0;1;3014;0;0;1;0;0;1;1;3014;0;3014;1;1;
/org.eclipse.jdt.ui/core refactoring/org/eclipse/jdt/internal/corext/refactoring/nls/changes/CreateFileChange.java;3;1;11;1;4;4;4;7;86;1;7;130;206;206;1;0;0;7;11;130;0;6340;11;3;
/org.eclipse.jdt.ui.tests.refactoring/resources/IntroduceFactory/positive/differentSigs.java;1;0;2;1;0;0;0;2;0;1;2;2846;0;0;1;0;0;2;2;2846;0;2862;2;1;
/org.eclipse.osgi/eclipseAdaptor/src/org/eclipse/osgi/service/datalocation/FileManager.java;3;2;11;1;7;6;7;4;335;1;4;4672;653;653;2;0;1;4;11;5505;1;5925;10;3;
/org.eclipse.jface.text/src/org/eclipse/jface/text/contentassist/Helper.java;1;1;2;1;2;2;2;0;2;0;0;6340;4;4;1;0;0;0;2;6340;0;6353;2;1;
/org.eclipse.debug.core/core/org/eclipse/debug/core/sourcelookup/containers/DefaultSourceContainer.java;1;0;5;1;1;1;1;4;14;3;2;4949;36;36;3;2;0;4;5;4949;2;5109;3;1;
/org.eclipse.team.tests.cvs.core/src/org/eclipse/team/tests/ccvs/ui/old/LogFormatterUIMain.java;1;0;2;1;0;0;0;2;0;1;2;2632;0;0;1;0;0;2;2;2632;0;4216;2;1;
/org.eclipse.jdt.core.tests.model/workspace/Formatter/test224/A_out.java;1;0;1;1;0;0;0;1;0;0;1;2426;0;0;1;0;0;1;1;2426;0;2426;1;1;
/org.eclipse.core.tests.runtime/src/org/eclipse/core/tests/runtime/PathTest.java;2;2;8;1;4;3;4;4;1400;1;4;1431;1514;1514;2;0;1;4;8;5379;1;5755;7;2;
/org.eclipse.ui.views/src/org/eclipse/ui/views/navigator/Navigator.java;1;0;1;1;0;0;0;1;0;0;1;947;0;0;1;0;0;1;1;947;0;947;1;1;
/org.eclipse.ui.workbench/Eclipse UI/org/eclipse/ui/internal/commands/CommandRegistry.java;1;0;2;1;0;0;0;2;0;0;1;1389;0;0;2;1;0;2;2;1389;1;1389;1;1;
/org.eclipse.ui.workbench/Eclipse UI/org/eclipse/ui/internal/commands/CommandHandlerServiceEvent.java;1;0;3;1;0;0;0;3;4;1;3;1223;4;4;1;0;0;3;3;1223;0;1321;3;1;
/org.eclipse.ui.forms/src/org/eclipse/ui/forms/internal/widgets/Locator.java;1;0;3;1;0;0;0;3;36;1;3;4068;36;36;1;0;0;3;3;4068;0;5044;3;1;
/org.eclipse.core.tests.runtime/src/org/eclipse/core/tests/runtime/locks/JobQueueTest.java;1;0;2;1;0;0;0;2;0;1;2;698;0;0;1;0;0;2;2;698;0;850;2;1;
/org.eclipse.pde.junit.runtime/src/org/eclipse/pde/internal/junit/runtime/UITestApplication.java;1;1;10;1;2;2;2;8;149;1;8;1453;453;453;1;0;0;8;10;1453;0;6039;10;1;
/org.eclipse.team.ui/src/org/eclipse/team/ui/synchronize/viewers/SynchronizeModelElement.java;1;0;4;1;0;0;0;4;186;2;3;4213;192;192;2;1;0;4;4;4213;1;4588;3;1;
/org.eclipse.jdt.core.tests.model/workspace/Converter/src/test0277/Test.java;1;0;1;1;0;0;0;1;0;0;1;3714;0;0;1;0;0;1;1;3714;0;3714;1;1;
/org.eclipse.pde.ui/templates/preferences/java/$pageClassName$.java;1;0;3;1;0;0;0;3;10;1;3;851;19;19;1;0;0;3;3;851;0;3986;3;1;
/org.eclipse.update.core/srcnew/org/eclipse/update/operations/IUnconfigFeatureOperation.java;1;0;2;1;0;0;0;2;0;1;2;602;0;0;1;0;0;2;2;602;0;825;2;1;
/org.eclipse.ui.workbench/Eclipse UI/org/eclipse/ui/internal/registry/ProjectImageRegistryReader.java;1;0;1;1;0;0;0;1;0;0;1;2737;0;0;1;0;0;1;1;2737;0;2737;1;1;
/org.eclipse.team.cvs.core/src/org/eclipse/team/internal/ccvs/core/client/Version.java;2;0;3;1;1;1;1;2;8;1;2;1672;13;13;1;0;0;2;3;1672;0;6337;3;2;
/org.eclipse.team.tests.cvs.core/src/org/eclipse/team/tests/ccvs/ui/EclipseUITestHarnessApplication.java;1;0;1;1;0;0;0;1;0;0;1;2632;0;0;1;0;0;1;1;2632;0;2632;1;1;
/org.eclipse.jdt.ui.tests.refactoring/resources/ExtractMethodWorkSpace/ExtractMethodTests/locals_out/A_test561.java;1;0;1;1;0;0;0;1;4;0;1;844;4;4;1;0;0;1;1;844;0;844;1;1;
/org.eclipse.pde.ui/src/org/eclipse/pde/internal/ui/editor/manifest/AlertSection.java;1;0;3;1;1;1;1;2;22;1;2;741;26;26;1;0;0;2;3;741;0;5431;3;1;
/org.eclipse.jdt.debug.ui/ui/org/eclipse/jdt/internal/debug/ui/actions/JavaBreakpointPropertiesRulerAction.java;1;0;1;1;0;0;0;1;24;0;1;1358;24;24;1;0;0;1;1;1358;0;1358;1;1;
/org.eclipse.core.runtime.osgi/src/org/eclipse/core/runtime/QualifiedName.java;1;0;2;1;0;0;0;2;156;1;2;3013;156;156;1;0;0;2;2;3013;0;3030;2;1;
/org.eclipse.ui.workbench/Eclipse UI/org/eclipse/ui/internal/dnd/IDragSource.java;3;0;3;1;0;0;0;3;62;1;3;3677;62;62;1;0;0;3;3;3677;0;5068;3;3;
/org.eclipse.jdt.junit/src/org/eclipse/jdt/internal/junit/ui/TypeRenameParticipant.java;2;0;10;1;0;0;0;10;80;2;9;3760;155;155;2;1;0;10;10;3760;1;5041;9;2;
/org.eclipse.webdav/src/kernel/org/eclipse/webdav/internal/kernel/WebDAVConstants.java;1;0;1;1;1;1;1;0;8;0;0;5151;8;8;1;0;0;0;1;5151;0;5151;1;1;
/org.eclipse.ui.workbench/Eclipse UI/org/eclipse/ui/internal/commands/registry/IKeyBindingDefinition.java;1;0;2;1;0;0;0;2;0;1;2;1422;0;0;1;0;0;2;2;1422;0;1724;2;1;
/org.eclipse.ui.workbench/Eclipse UI/org/eclipse/ui/internal/NewWizardDropDownAction.java;1;0;1;1;0;0;0;1;0;0;1;2737;0;0;1;0;0;1;1;2737;0;2737;1;1;
/org.eclipse.swt/Eclipse SWT Mozilla/common/org/eclipse/swt/internal/mozilla/nsICategoryManager.java;1;0;1;1;0;0;0;1;0;0;1;2663;0;0;1;0;0;1;1;2663;0;2663;1;1;
/org.eclipse.pde.core/src/org/eclipse/pde/internal/core/IModelProviderListener.java;1;0;1;1;0;0;0;1;0;0;1;2229;0;0;1;0;0;1;1;2229;0;2229;1;1;
/org.eclipse.jdt.ui/core refactoring/org/eclipse/ltk/internal/core/refactoring/Assert.java;1;0;2;1;0;0;0;2;0;1;2;4575;0;0;1;0;0;2;2;4575;0;4864;2;1;
/org.eclipse.core.resources/src/org/eclipse/core/internal/localstore/CollectSyncStatusVisitor.java;2;0;3;1;1;1;1;2;114;1;2;1477;119;119;1;0;0;2;3;1477;0;5146;3;2;
/org.eclipse.update.core/srcnew/org/eclipse/update/internal/operations/IOperationValidator.java;1;0;4;1;0;0;0;4;16;1;4;367;22;22;1;0;0;4;4;367;0;600;4;1;
/org.eclipse.jdt.ui/ui/org/eclipse/jdt/internal/ui/workingsets/JavaWorkingSetPageContentProvider.java;1;0;3;1;1;1;1;2;36;1;2;951;64;64;1;0;0;2;3;951;0;6340;3;1;
/org.eclipse.jdt.ui.tests.refactoring/test cases/org/eclipse/jdt/ui/tests/refactoring/MoveInnerToTopLevelTests.java;6;1;14;1;2;2;2;12;142;1;12;103;262;262;1;0;0;12;14;103;0;6340;14;6;
/org.eclipse.jdt.core/dom/org/eclipse/jdt/core/dom/CompilationUnit.java;5;1;24;2;4;4;4;20;185;3;16;229;824;824;3;4;0;20;24;4711;4;5916;20;5;
/org.eclipse.jdt.core.tests.model/workspace/Converter15/src/test0026/X.java;1;0;1;1;0;0;0;1;0;0;1;4856;0;0;1;0;0;1;1;4856;0;4856;1;1;
/org.eclipse.ui.workbench/Eclipse UI/org/eclipse/ui/internal/commands/api/ICommandManager.java;1;0;3;1;0;0;0;3;70;0;1;2562;70;70;3;2;0;3;3;2562;2;2562;1;1;
/org.eclipse.team.ui/src/org/eclipse/team/internal/ui/synchronize/actions/INavigableControl.java;1;0;3;1;0;0;0;3;25;1;3;2561;25;25;1;0;0;3;3;2561;0;4216;3;1;
/org.eclipse.ui.workbench/Eclipse UI/org/eclipse/ui/commands/NonModifierKey.java;1;0;3;1;0;0;0;3;4;2;2;1321;4;4;2;1;0;3;3;1339;1;1339;2;1;
/org.eclipse.jdt.debug.tests/tests/org/eclipse/jdt/debug/tests/eval/LocalVarValueTests.java;1;0;1;1;0;0;0;1;18;0;1;1274;18;18;1;0;0;1;1;1274;0;1274;1;1;
/org.eclipse.jdt.ui/core refactoring/org/eclipse/ltk/core/refactoring/RenameData.java;1;0;2;1;0;0;0;2;0;1;2;4510;0;0;1;0;0;2;2;4510;0;4624;2;1;
/org.eclipse.osgi/core/framework/org/eclipse/osgi/framework/internal/core/SystemBundleLoader.java;4;1;6;1;3;3;3;3;14;1;3;3013;28;28;1;0;0;3;6;3013;0;6337;6;4;
/org.eclipse.jdt.core.tests.model/workspace/Converter/test0427/A.java;1;0;1;1;0;0;0;1;0;0;1;3714;0;0;1;0;0;1;1;3714;0;3714;1;1;
/org.eclipse.swt.graphics.text/Examples/examples/AddStyleDialog.java;1;0;2;1;0;0;0;2;5;1;2;2937;5;5;1;0;0;2;2;2937;0;3154;2;1;
/org.eclipse.jdt.ui/ui/org/eclipse/jdt/internal/ui/typehierarchy/ToggleViewAction.java;1;0;1;1;1;1;1;0;2;0;0;6340;2;2;1;0;0;0;1;6340;0;6340;1;1;
/org.eclipse.debug.ui/ui/org/eclipse/debug/internal/ui/sourcelookup/AbstractUISourceLookupDirector.java;2;0;4;1;0;0;0;4;4;1;4;3770;7;7;1;0;0;4;4;3770;0;4609;4;2;
/org.eclipse.core.runtime.compatibility/src-runtime/org/eclipse/core/runtime/CompatibilityPlatform.java;1;0;3;1;0;0;0;3;22;1;3;3135;22;22;1;0;0;3;3;3135;0;3272;3;1;
/org.eclipse.core.tests.runtime/src/org/eclipse/core/tests/runtime/RuntimeTestsPlugin.java;1;0;1;1;1;1;1;0;0;0;0;6201;0;0;1;0;0;0;1;6201;0;6201;1;1;
/org.eclipse.jdt.ui.tests.refactoring/resources/ExtractMethodWorkSpace/ExtractMethodTests/return_out/A_test726.java;1;0;2;1;0;0;0;2;4;1;2;130;6;6;1;0;0;2;2;130;0;844;2;1;
/org.eclipse.update.ui/src/org/eclipse/update/internal/ui/wizards/MultiReviewPage.java;1;0;1;1;0;0;0;1;0;0;1;755;0;0;1;0;0;1;1;755;0;755;1;1;
/org.eclipse.jdt.core.tests.compiler/src/org/eclipse/jdt/core/tests/eval/NegativeCodeSnippetTest.java;4;0;7;1;0;0;0;7;21;1;7;764;45;45;1;0;0;7;7;764;0;3633;7;4;
/org.eclipse.ltk.core.refactoring/src/org/eclipse/ltk/core/refactoring/RefactoringStatusEntry.java;1;1;5;1;3;3;3;2;8;1;2;4845;15;15;1;0;0;2;5;4845;0;6338;5;1;
/org.eclipse.team.ui/src/org/eclipse/team/internal/ui/synchronize/views/SynchronizeViewNode.java;1;0;3;1;0;0;0;3;116;1;3;2535;116;116;1;0;0;3;3;2535;0;4216;3;1;
/org.eclipse.jdt.ui.tests.refactoring/resources/DeleteSourceReference/test7/out/A.java;1;0;1;1;0;0;0;1;0;0;1;1652;0;0;1;0;0;1;1;1652;0;1652;1;1;
/org.eclipse.jdt.ui.tests.refactoring/resources/Copy/test_type_yes_cu/in/A.java;1;0;2;1;0;0;0;2;0;1;2;696;0;0;1;0;0;2;2;696;0;1009;2;1;
/org.eclipse.core.expressions/src/org/eclipse/core/internal/expressions/AndExpression.java;1;0;2;1;1;1;1;1;8;0;1;4108;8;8;1;0;0;1;2;4108;0;6340;2;1;
/org.eclipse.help.base/src/org/eclipse/help/internal/search/ISearchHitCollector.java;1;1;3;1;2;2;2;1;10;0;1;1740;16;16;1;0;0;1;3;1740;0;6337;3;1;
/org.eclipse.jdt.ui.tests.refactoring/resources/ExtractTemp/canExtract/A_test77_in.java;1;0;1;1;0;0;0;1;0;0;1;1575;0;0;1;0;0;1;1;1575;0;1575;1;1;
/org.eclipse.jdt.core.tests.model/workspace/Converter/src/test0005/Test.java;1;0;1;1;0;0;0;1;0;0;1;3714;0;0;1;0;0;1;1;3714;0;3714;1;1;
/org.eclipse.jdt.ui.tests.refactoring/resources/ExtractMethodWorkSpace/ExtractMethodTests/semicolon_out/A_test404.java;1;0;2;1;0;0;0;2;6;1;2;130;7;7;1;0;0;2;2;130;0;844;2;1;
/org.eclipse.jdt.debug.jdi.tests/tests/org/eclipse/debug/jdi/tests/TestAll.java;2;0;2;1;0;0;0;2;6;1;2;1592;8;8;1;0;0;2;2;1592;0;4476;2;2;
/org.eclipse.ui.workbench.texteditor/src/org/eclipse/ui/texteditor/TextNavigationAction.java;3;1;8;1;2;2;2;6;39;1;6;600;63;63;1;0;0;6;8;600;0;6340;8;3;
/org.eclipse.jdt.ui/ui/org/eclipse/jdt/internal/ui/preferences/JavadocConfigurationBlock.java;2;1;12;1;2;2;2;10;658;3;8;661;1105;1105;3;2;0;10;12;1242;2;6340;10;2;
/org.eclipse.jdt.core/compiler/org/eclipse/jdt/internal/compiler/ast/CompoundAssignment.java;2;0;9;1;0;0;0;9;241;2;8;593;288;288;2;1;0;9;9;991;1;4256;8;2;
/org.eclipse.jface/src/org/eclipse/jface/instrumentation/JFaceInstrumentationManager.java;1;0;2;1;0;0;0;2;0;1;2;1634;0;0;1;0;0;2;2;1634;0;1674;2;1;
/org.eclipse.jdt.debug/eval/org/eclipse/jdt/internal/debug/eval/ast/instructions/SendStaticMessage.java;2;0;2;1;0;0;0;2;3;1;2;1240;5;5;1;0;0;2;2;1240;0;1276;2;2;
/org.eclipse.pde.ui/src/org/eclipse/pde/internal/ui/editor/build/SourceFolderSelectionDialog.java;1;0;2;1;0;0;0;2;0;1;2;1922;0;0;1;0;0;2;2;1922;0;2311;2;1;
/org.eclipse.jdt.core/search/org/eclipse/jdt/core/search/PackageReferenceMatch.java;3;1;8;1;4;4;4;4;23;1;4;3913;77;77;1;0;0;4;8;3913;0;5912;8;3;
/org.eclipse.jdt.ui.tests.refactoring/resources/ExtractInterface/test80/in/A.java;1;0;1;1;0;0;0;1;8;0;1;2274;8;8;1;0;0;1;1;2274;0;2274;1;1;
/org.eclipse.team.webdav/src/org/eclipse/team/internal/core/target/SynchronizedTargetProvider.java;2;0;3;1;1;1;1;2;16;1;2;2495;18;18;1;0;0;2;3;2495;0;6337;3;2;
/org.eclipse.team.core/src/org/eclipse/team/core/ResourceVariantCacheEntry.java;1;0;1;1;0;0;0;1;0;0;1;4084;0;0;1;0;0;1;1;4084;0;4084;1;1;
/org.eclipse.team.cvs.core/src/org/eclipse/team/internal/ccvs/core/client/Request.java;1;0;2;1;0;0;0;2;52;1;2;1242;102;102;1;0;0;2;2;1242;0;1672;2;1;
/org.eclipse.update.core/src/org/eclipse/update/operations/IOperationListener.java;1;2;8;1;3;2;3;5;24;2;4;825;45;45;2;1;1;5;8;825;2;6336;6;1;
/org.eclipse.jdt.ui.tests.refactoring/resources/ChangeTypeRefactoring/positive/A_testString_in.java;1;0;1;1;0;0;0;1;0;0;1;2844;0;0;1;0;0;1;1;2844;0;2844;1;1;
/org.eclipse.update.core/src/org/eclipse/update/internal/core/FileFragment.java;2;0;3;1;0;0;0;3;17;1;3;3090;23;23;1;0;0;3;3;3090;0;3110;3;2;
/org.eclipse.jface.text/projection/org/eclipse/jface/text/source/projection/ProjectionAnnotation.java;3;2;11;1;7;6;7;4;134;1;4;4516;306;306;2;0;1;4;11;5331;1;6362;10;3;
/org.eclipse.core.tests.harness/src/org/eclipse/core/tests/harness/EclipseTestHarnessApplication.java;1;1;3;1;2;2;2;1;225;0;1;2967;236;236;1;0;0;1;3;2967;0;5686;3;1;
/org.eclipse.jdt.ui/core refactoring/org/eclipse/ltk/internal/core/refactoring/RefactoringCoreMessages.java;1;0;3;1;0;0;0;3;2;1;3;4510;2;2;1;0;0;3;3;4510;0;4864;3;1;
/org.eclipse.swt/Eclipse SWT PI/carbon/org/eclipse/swt/internal/carbon/ThemeButtonDrawInfo.java;1;2;3;1;3;2;3;0;16;0;0;5534;20;20;2;0;1;0;3;5534;1;5614;2;1;
/org.eclipse.ui.workbench/Eclipse UI/org/eclipse/ui/commands/NotHandledException.java;3;1;6;1;2;2;2;4;43;1;4;1137;61;61;1;0;0;4;6;1137;0;6338;6;3;
/org.eclipse.jface/src/org/eclipse/jface/dialogs/DialogMessageArea.java;1;0;5;1;1;1;1;4;112;2;3;4217;181;181;2;1;0;4;5;4309;1;5468;4;1;
/org.eclipse.debug.ui/ui/org/eclipse/debug/internal/ui/views/expression/ExpressionViewEventHandler.java;4;0;7;1;1;1;1;6;22;1;6;307;78;78;1;0;0;6;7;307;0;6336;7;4;
/org.eclipse.ui.workbench/Eclipse UI/org/eclipse/ui/internal/commands/older/KeyBindingNode.java;1;0;2;1;0;0;0;2;2;0;1;2562;2;2;2;1;0;2;2;2562;1;2562;1;1;
/org.eclipse.pde.ui/src/org/eclipse/pde/internal/ui/editor/manifest/XMLViewerConfiguration.java;1;0;2;1;1;1;1;1;0;0;1;2320;0;0;1;0;0;1;2;2320;0;5431;2;1;
/org.eclipse.jdt.core/compiler/org/eclipse/jdt/internal/compiler/lookup/ProblemFieldBinding.java;2;0;2;1;1;1;1;1;8;0;1;3560;10;10;1;0;0;1;2;3560;0;6126;2;2;
/org.eclipse.pde.ui/src_Forms/org/eclipse/pde/internal/ui/neweditor/feature/PluginReference.java;2;0;2;1;1;1;1;1;0;0;1;4926;0;0;1;0;0;1;2;4926;0;5431;2;2;
/org.eclipse.jdt.core/search/org/eclipse/jdt/internal/core/index/impl/IFileDocument.java;2;0;2;1;0;0;0;2;3;1;2;883;3;3;1;0;0;2;2;883;0;3240;2;2;
/org.eclipse.ui.workbench.texteditor/src/org/eclipse/ui/internal/texteditor/EditorMessages.java;1;1;2;1;2;2;2;0;2;0;0;5478;4;4;1;0;0;0;2;5478;0;6340;2;1;
/org.eclipse.jdt.ui.tests.refactoring/resources/MoveInnerToTopLevel/test_nonstatic_5/out/Inner.java;2;0;2;1;1;1;1;1;2;0;1;305;4;4;1;0;0;1;2;305;0;5854;2;2;
/org.eclipse.jdt.text.tests/src/org/eclipse/jdt/text/tests/HTML2TextReaderTester.java;1;1;2;1;2;2;2;0;2;0;0;5129;2;2;1;0;0;0;2;5129;0;6340;2;1;
/org.eclipse.ant.ui/Ant Editor/org/eclipse/ant/internal/ui/editor/templates/AntContext.java;2;1;7;1;7;7;7;0;41;0;0;5107;77;77;1;0;0;0;7;5107;0;5901;7;2;
/org.eclipse.jdt.core/model/org/eclipse/jdt/internal/core/IJavaElementRequestor.java;1;0;1;1;0;0;0;1;2;0;1;3560;2;2;1;0;0;1;1;3560;0;3560;1;1;
/org.eclipse.ui.workbench/Eclipse UI/org/eclipse/ui/internal/activities/ActivityService.java;1;0;2;1;0;0;0;2;0;1;2;2491;0;0;1;0;0;2;2;2491;0;2728;2;1;
/org.eclipse.ui.workbench/Eclipse UI/org/eclipse/ui/internal/dialogs/OpenResourceDialog.java;1;0;1;1;0;0;0;1;0;0;1;2737;0;0;1;0;0;1;1;2737;0;2737;1;1;
/org.eclipse.ui.tests/Eclipse UI Tests/org/eclipse/ui/tests/api/workbenchpart/RawIViewPartTest.java;1;0;1;1;1;1;1;0;0;0;0;6101;0;0;1;0;0;0;1;6101;0;6101;1;1;
/org.eclipse.jdt.core.tests.compiler/src/org/eclipse/jdt/core/tests/runtime/VMInputStream.java;2;0;2;1;1;1;1;1;22;0;1;3560;24;24;1;0;0;1;2;3560;0;5853;2;2;
/org.eclipse.jdt.ui/ui/org/eclipse/jdt/internal/ui/typehierarchy/ToggleOrientationAction.java;2;1;2;1;2;2;2;0;16;0;0;5176;18;18;1;0;0;0;2;5176;0;6340;2;2;
/org.eclipse.jdt.core/search/org/eclipse/jdt/internal/core/search/matching/OrPattern.java;3;2;17;1;3;2;3;14;150;2;13;786;541;541;2;1;1;14;17;1136;2;5335;15;3;
/org.eclipse.help.ide/src/org/eclipse/help/ui/internal/search/SearchOperation.java;1;0;15;1;1;1;1;14;265;4;10;1738;567;567;4;4;0;14;15;1738;4;5216;11;1;
/org.eclipse.team.ui/src/org/eclipse/team/ui/synchronize/DiffTreeViewerConfiguration.java;1;0;1;1;0;0;0;1;0;0;1;3796;0;0;1;0;0;1;1;3796;0;3796;1;1;
/org.eclipse.ui.intro/src/org/eclipse/ui/internal/intro/impl/model/IntroHTML.java;1;1;5;1;5;5;5;0;13;0;0;5115;37;37;1;0;0;0;5;5115;0;6251;5;1;
/org.eclipse.debug.ui/ui/org/eclipse/debug/ui/console/IConsole.java;1;0;1;1;0;0;0;1;4;0;1;1579;4;4;1;0;0;1;1;1579;0;1579;1;1;
/org.eclipse.jdt.ui/ui refactoring/org/eclipse/jdt/internal/ui/refactoring/actions/RenameTempAction.java;3;0;13;1;1;1;1;12;20;1;12;122;82;82;1;0;0;12;13;122;0;6340;13;3;
/org.eclipse.ui.workbench/Eclipse UI/org/eclipse/ui/internal/commands/registry/Category.java;1;0;2;1;0;0;0;2;0;1;2;1077;0;0;1;0;0;2;2;1077;0;1222;2;1;
/org.eclipse.swt/Eclipse SWT/common/org/eclipse/swt/events/MouseListener.java;2;0;2;1;1;1;1;1;4;0;1;4062;6;6;1;0;0;1;2;4062;0;6352;2;2;
/org.eclipse.jdt.ui.tests.refactoring/resources/MoveMembers/test18/out/B.java;1;0;1;1;0;0;0;1;1;0;1;1522;1;1;1;0;0;1;1;1522;0;1522;1;1;
/org.eclipse.jdt.core.tests.model/workspace/Converter/src/test0560/A.java;1;0;1;1;1;1;1;0;0;0;0;6078;0;0;1;0;0;0;1;6078;0;6078;1;1;
/org.eclipse.team.webdav/src/org/eclipse/team/ui/target/ContainerContentProvider.java;1;0;1;1;0;0;0;1;0;0;1;3461;0;0;1;0;0;1;1;3461;0;3461;1;1;
/org.eclipse.jdt.ui/ui/org/eclipse/jdt/internal/ui/search/IJavaSearchUIConstants.java;1;0;1;1;1;1;1;0;2;0;0;6340;2;2;1;0;0;0;1;6340;0;6340;1;1;
/org.eclipse.jdt.core.tests.model/workspace/Formatter/test313/A_out.java;1;0;1;1;0;0;0;1;0;0;1;2444;0;0;1;0;0;1;1;2444;0;2444;1;1;
/org.eclipse.jdt.core.tests.model/workspace/Converter/src/test0028/Test.java;1;0;1;1;0;0;0;1;0;0;1;3714;0;0;1;0;0;1;1;3714;0;3714;1;1;
/org.eclipse.core.resources/src/org/eclipse/core/resources/IFolder.java;2;0;4;2;1;1;1;3;582;1;3;44;635;635;1;0;0;3;4;44;0;5146;4;2;
/org.eclipse.jdt.launching/launching/org/eclipse/jdt/launching/IRuntimeContainerComparator.java;3;1;3;1;2;2;2;1;6;0;1;2988;11;11;1;0;0;1;3;2988;0;6336;3;3;
/org.eclipse.debug.ui/ui/org/eclipse/debug/internal/ui/views/memory/GoToAddressDialog.java;1;0;1;1;1;1;1;0;0;0;0;5254;0;0;1;0;0;0;1;5254;0;5254;1;1;
/org.eclipse.jdt.debug/eval/org/eclipse/jdt/internal/debug/eval/ast/instructions/PushThis.java;1;0;1;1;0;0;0;1;3;0;1;1240;3;3;1;0;0;1;1;1240;0;1240;1;1;
/org.eclipse.help/src/org/eclipse/help/internal/context/ContextsBuilder.java;1;1;5;1;4;4;4;1;51;0;1;4893;109;109;1;0;0;1;5;4893;0;6337;5;1;
/org.eclipse.jdt.ui/ui refactoring/org/eclipse/jdt/internal/ui/refactoring/nls/search/NLSSearchResultCollector2.java;2;0;4;1;1;1;1;3;81;1;3;4943;89;89;1;0;0;3;4;4943;0;5268;4;2;
/org.eclipse.pde.ui/src/org/eclipse/pde/internal/ui/wizards/site/SiteHTMLPage.java;2;1;4;1;3;3;3;1;98;0;1;3840;120;120;1;0;0;1;4;3840;0;6020;4;2;
/org.eclipse.jdt.ui/ui/org/eclipse/jdt/internal/ui/javadocexport/JavadocProjectContentProvider.java;3;1;5;1;3;3;3;2;33;1;2;1336;64;64;1;0;0;2;5;1336;0;6340;5;3;
/org.eclipse.jdt.ui.tests.refactoring/resources/ExtractTemp/canExtract/A_test71_in.java;1;0;1;1;0;0;0;1;0;0;1;1569;0;0;1;0;0;1;1;1569;0;1569;1;1;
/org.eclipse.jdt.junit/src/org/eclipse/jdt/internal/junit/ui/JUnitAddLibraryProposal.java;2;1;4;1;2;2;2;2;10;1;2;1249;20;20;1;0;0;2;4;1249;0;6340;4;2;
/org.eclipse.jdt.core/model/org/eclipse/jdt/internal/core/hierarchy/HierarchyResolver.java;4;1;26;2;3;3;3;23;403;2;20;62;1279;1279;2;3;0;23;26;62;3;6073;23;4;
/org.eclipse.ui.ide/src/org/eclipse/ui/IContributorResourceAdapter.java;2;0;2;1;0;0;0;2;0;1;2;1511;0;0;1;0;0;2;2;1511;0;1680;2;2;
/org.eclipse.ui.tests/Eclipse UI Tests/org/eclipse/ui/tests/keys/PreferenceMutator.java;1;0;1;1;0;0;0;1;0;0;1;2307;0;0;1;0;0;1;1;2307;0;2307;1;1;
/org.eclipse.jdt.ui/core refactoring/org/eclipse/jdt/internal/corext/refactoring/nls/NLSUtil.java;3;1;4;1;2;2;2;2;111;0;1;1953;124;124;2;1;0;2;4;1953;1;6340;3;3;
/org.eclipse.search/search/org/eclipse/search/internal/ui/SearchDropDownAction.java;2;0;3;1;1;1;1;2;14;1;2;611;20;20;1;0;0;2;3;611;0;6340;3;2;
/org.eclipse.osgi/core/adaptor/org/eclipse/osgi/framework/adaptor/ImportClassNotFoundException.java;4;1;4;1;2;2;2;2;34;1;2;3013;40;40;1;0;0;2;4;3013;0;6337;4;4;
/org.eclipse.jdt.ui.tests.refactoring/resources/RenamePackage/testImportFromMultiRoots1/in/srcPrg/p/p/A.java;1;0;3;1;0;0;0;3;6;1;3;3219;11;11;1;0;0;3;3;3219;0;4585;3;1;
/org.eclipse.jdt.debug/jdi/org/eclipse/jdi/internal/GenericSignature.java;1;0;2;1;0;0;0;2;2;1;2;4267;2;2;1;0;0;2;2;4267;0;4297;2;1;
/org.eclipse.ui.workbench/Eclipse UI/org/eclipse/ui/internal/intro/IntroRegistry.java;1;0;5;1;0;0;0;5;60;1;5;3632;78;78;1;0;0;5;5;3632;0;4825;5;1;
/org.eclipse.jdt.debug/jdi/org/eclipse/jdi/Bootstrap.java;3;1;4;1;2;2;2;2;7;0;1;4264;15;15;2;1;0;2;4;4264;1;5680;3;3;
/org.eclipse.jdt.ui/core refactoring/org/eclipse/ltk/core/refactoring/RefactoringStatusEntry.java;1;0;3;1;0;0;0;3;2;1;3;4575;2;2;1;0;0;3;3;4575;0;4864;3;1;
/org.eclipse.jdt.ui/ui/org/eclipse/jdt/internal/ui/javaeditor/JavaAnnotationImageProvider.java;3;1;5;1;2;2;2;3;8;2;2;3217;14;14;2;1;0;3;5;3217;1;6340;4;3;
/org.eclipse.ui.externaltools/Ant Editor/org/eclipse/ui/externaltools/internal/ant/dtd/IAttribute.java;1;0;1;1;0;0;0;1;0;0;1;282;0;0;1;0;0;1;1;282;0;282;1;1;
/org.eclipse.pde.ui/src_Forms/org/eclipse/pde/internal/ui/neweditor/feature/FeatureReferencePage.java;2;0;3;1;1;1;1;2;97;0;1;4926;97;97;2;1;0;2;3;4926;1;5431;2;2;
/org.eclipse.debug.ui/ui/org/eclipse/debug/ui/launchVariables/LaunchConfigurationVariableForm.java;2;0;9;1;0;0;0;9;16;2;7;550;40;40;2;2;0;9;9;562;2;2120;7;2;
/org.eclipse.jdt.ui.tests.refactoring/resources/SurroundWithWorkSpace/SurroundWithTests/trycatch_out/TestWrappedLocal6.java;1;0;1;1;0;0;0;1;7;0;1;845;7;7;1;0;0;1;1;845;0;845;1;1;
/org.eclipse.jface.text/src/org/eclipse/jface/text/AbstractHoverInformationControlManager.java;2;1;5;1;3;3;3;2;25;1;2;1037;57;57;1;0;0;2;5;1037;0;6359;5;2;
/org.eclipse.jdt.ui.tests.refactoring/test cases/org/eclipse/jdt/ui/tests/nls/NLSSourceModifierTest.java;2;2;5;1;5;4;5;0;57;0;0;5248;122;122;2;0;1;0;5;5375;1;6340;4;2;
/org.eclipse.jdt.launching/launching/org/eclipse/jdt/launching/AbstractVMInstallType.java;1;0;2;1;0;0;0;2;18;1;2;2497;21;21;1;0;0;2;2;2497;0;2988;2;1;
/org.eclipse.ui.workbench/Eclipse UI/org/eclipse/ui/keys/CharacterKey.java;3;1;16;2;2;2;2;14;596;4;10;1294;1546;1546;4;4;0;14;16;2202;4;6338;12;3;
/org.eclipse.pde.core/src/org/eclipse/pde/internal/core/schema/SchemaType.java;1;0;2;1;1;1;1;1;4;0;1;4203;6;6;1;0;0;1;2;4203;0;6336;2;1;
/org.eclipse.jdt.text.tests/src/org/eclipse/jdt/text/tests/comments/CommentTestCase.java;2;1;3;1;3;3;3;0;6;0;0;5129;11;11;1;0;0;0;3;5129;0;6340;3;2;
/org.eclipse.osgi/supplement/src/org/eclipse/osgi/framework/internal/core/Msg.java;4;1;4;1;2;2;2;2;14;1;2;3013;25;25;1;0;0;2;4;3013;0;5232;4;4;
/org.eclipse.core.tests.resources/src/org/eclipse/core/tests/resources/perf/BenchWorkspace.java;1;0;3;1;3;1;3;0;34;0;0;5147;34;34;3;0;2;0;3;5147;2;5147;1;1;
/org.eclipse.jdt.ui/core refactoring/org/eclipse/jdt/internal/corext/refactoring/nls/NLSSubstitution.java;3;1;10;1;9;9;9;1;377;0;1;4930;707;707;1;0;0;1;10;4930;0;6340;10;3;
/org.eclipse.debug.ui/ui/org/eclipse/debug/internal/ui/views/console/ProcessDropDownAction.java;1;0;1;1;0;0;0;1;0;0;1;1414;0;0;1;0;0;1;1;1414;0;1414;1;1;
/org.eclipse.jdt.core.tests.model/workspace/Converter/test0261/Test.java;1;0;1;1;0;0;0;1;0;0;1;3714;0;0;1;0;0;1;1;3714;0;3714;1;1;
/org.eclipse.swt/Eclipse SWT/emulated/treetable/org/eclipse/swt/widgets/Header.java;4;1;4;1;2;2;2;2;17;1;2;269;26;26;1;0;0;2;4;269;0;6352;4;4;
/org.eclipse.ui.workbench/Eclipse UI/org/eclipse/ui/IWorkbenchPreferenceConstants.java;5;2;15;2;9;8;9;6;84;1;6;2737;296;296;2;0;1;6;15;5737;1;5804;14;5;
/org.eclipse.swt.tests/JUnit Tests/org/eclipse/swt/tests/junit/Test_org_eclipse_swt_widgets_Button.java;1;0;1;1;0;0;0;1;39;0;1;2649;39;39;1;0;0;1;1;2649;0;2649;1;1;
/org.eclipse.team.examples.filesystem/src/org/eclipse/team/examples/localhistory/LocalHistorySyncInfo.java;1;0;1;1;1;1;1;0;0;0;0;6319;0;0;1;0;0;0;1;6319;0;6319;1;1;
/org.eclipse.jdt.core.tests.model/workspace/Formatter/test362/A_out.java;1;0;1;1;0;0;0;1;0;0;1;3088;0;0;1;0;0;1;1;3088;0;3088;1;1;
/org.eclipse.swt.examples/src/org/eclipse/swt/examples/dnd/DNDExample.java;1;0;5;1;0;0;0;5;1520;1;5;163;3028;3028;1;0;0;5;5;163;0;539;5;1;
/org.eclipse.team.cvs.ui/src/org/eclipse/team/internal/ccvs/ui/subscriber/RefreshDirtyStateAction.java;1;1;3;1;3;3;3;0;44;0;0;5345;61;61;1;0;0;0;3;5345;0;5508;3;1;
/org.eclipse.pde.ui/src/org/eclipse/pde/internal/ui/editor/text/AnnotationHover.java;2;1;2;1;2;2;2;0;6;0;0;5781;8;8;1;0;0;0;2;5781;0;6336;2;2;
/org.eclipse.jdt.core/compiler/org/eclipse/jdt/internal/compiler/ast/JavadocReturnStatement.java;3;0;5;1;0;0;0;5;9;1;5;2887;19;19;1;0;0;5;5;2887;0;3560;5;3;
/org.eclipse.pde.ui/src_Forms/org/eclipse/pde/internal/ui/neweditor/ModelUndoManager.java;2;0;2;1;1;1;1;1;0;0;1;4832;0;0;1;0;0;1;2;4832;0;5431;2;2;
/org.eclipse.ui.cheatsheets/src/org/eclipse/ui/internal/cheatsheets/registry/RegistryReader.java;2;0;4;1;1;1;1;3;17;1;3;4428;29;29;1;0;0;3;4;4428;0;5759;4;2;
/org.eclipse.debug.ui/ui/org/eclipse/debug/internal/ui/views/memory/ResetMemoryBlockContextAction.java;1;0;1;1;1;1;1;0;0;0;0;5254;0;0;1;0;0;0;1;5254;0;5254;1;1;
/org.eclipse.ui.workbench/Eclipse UI/org/eclipse/ui/internal/commands/AbstractMutableCommandRegistry.java;3;1;12;1;2;2;2;10;88;2;8;1400;236;236;2;2;0;10;12;1400;2;6338;10;3;
/org.eclipse.ui.workbench/Eclipse UI/org/eclipse/ui/internal/csm/activities/api/IActivityListener.java;1;0;3;1;0;0;0;3;18;2;2;2225;18;18;2;1;0;3;3;2238;1;2238;2;1;
/org.eclipse.swt/Eclipse SWT/win32/org/eclipse/swt/graphics/GC.java;5;2;37;2;10;9;10;27;111;2;24;110;768;768;2;3;1;27;37;667;4;6352;33;5;
/org.eclipse.pde.ui/src/org/eclipse/pde/internal/ui/editor/KeyValueSourcePage.java;1;1;3;1;3;3;3;0;10;0;0;5431;11;11;1;0;0;0;3;5431;0;6336;3;1;
/org.eclipse.swt.tests/JUnit Tests/org/eclipse/swt/tests/junit/Test_org_eclipse_swt_browser_OpenWindowListener.java;1;0;2;1;0;0;0;2;8;1;2;3007;8;8;1;0;0;2;2;3007;0;3167;2;1;
/org.eclipse.jdt.core.tests.model/workspace/Formatter/test213/A_in.java;1;0;1;1;0;0;0;1;0;0;1;2425;0;0;1;0;0;1;1;2425;0;2425;1;1;
/org.eclipse.update.ui.forms/Eclipse Forms/org/eclipse/ui/forms/parts/TableWrapLayout.java;1;0;2;1;0;0;0;2;0;1;2;3116;0;0;1;0;0;2;2;3116;0;3138;2;1;
/org.eclipse.ui.ide/src/org/eclipse/ui/internal/dialogs/UpdateProjectCapabilityWizard.java;2;0;3;1;0;0;0;3;20;1;3;1526;20;20;1;0;0;3;3;1526;0;2263;3;2;
/org.eclipse.team.ui/src/org/eclipse/team/internal/ui/synchronize/actions/RefreshAction.java;1;0;3;1;0;0;0;3;100;1;3;2561;100;100;1;0;0;3;3;2561;0;4216;3;1;
/org.eclipse.swt/Eclipse SWT PI/win32/org/eclipse/swt/internal/win32/TRACKMOUSEEVENT.java;1;0;1;1;0;0;0;1;1;0;1;2915;1;1;1;0;0;1;1;2915;0;2915;1;1;
/org.eclipse.core.resources/src/org/eclipse/core/internal/localstore/FileSystemResourceManager.java;3;1;14;1;6;6;6;8;1535;2;7;178;1780;1780;2;1;0;8;14;4514;1;6036;13;3;
/org.eclipse.ui.workbench/Eclipse UI/org/eclipse/ui/internal/csm/roles/IRoleRegistryListener.java;1;0;3;1;0;0;0;3;18;1;3;2225;18;18;1;0;0;3;3;2225;0;2444;3;1;
/org.eclipse.ui.workbench/Eclipse UI/org/eclipse/ui/internal/activities/IPatternBindingDefinition.java;1;0;3;1;0;0;0;3;3;1;3;2533;3;3;1;0;0;3;3;2533;0;2896;3;1;
/org.eclipse.ui.examples.javaeditor/Eclipse Java Editor Example/org/eclipse/ui/examples/javaeditor/spelling/AbstractSpellDictionary.java;1;0;1;1;0;0;0;1;0;0;1;2565;0;0;1;0;0;1;1;2565;0;2565;1;1;
/org.eclipse.osgi/resolver/src/org/eclipse/core/dependencies/IElementChange.java;3;1;3;1;2;2;2;1;9;0;1;3013;9;9;1;0;0;1;3;3013;0;5226;3;3;
/org.eclipse.jdt.core.tests.model/workspace/Converter/test0239/Test.java;1;0;1;1;0;0;0;1;0;0;1;3714;0;0;1;0;0;1;1;3714;0;3714;1;1;
/org.eclipse.osgi/osgi/src/org/osgi/service/permissionadmin/PermissionAdmin.java;2;0;2;1;1;1;1;1;3;0;1;3013;3;3;1;0;0;1;2;3013;0;5536;2;2;
/org.eclipse.jdt.ui.tests.refactoring/resources/MoveMembers/test5/in/A.java;1;0;1;1;0;0;0;1;2;0;1;1522;2;2;1;0;0;1;1;1522;0;1522;1;1;
/org.eclipse.jdt.core/dom/org/eclipse/jdt/core/dom/ITypeBinding.java;4;0;9;2;0;0;0;9;540;2;8;2943;1655;1655;2;1;0;9;9;2943;1;4999;8;4;
/org.eclipse.jdt.debug.ui/ui/org/eclipse/jdt/internal/debug/ui/snippeteditor/JavaSnippetViewerConfiguration.java;2;0;3;1;1;1;1;2;8;1;2;1240;14;14;1;0;0;2;3;1240;0;6336;3;2;
/org.eclipse.jdt.ui/ui/org/eclipse/jdt/internal/ui/compare/JarStructureCreator.java;1;0;1;1;1;1;1;0;2;0;0;6340;2;2;1;0;0;0;1;6340;0;6340;1;1;
/org.eclipse.compare.examples.xml/src/org/eclipse/compare/examples/xml/AbstractMatching.java;1;0;2;1;0;0;0;2;2;1;2;1106;2;2;1;0;0;2;2;1106;0;3938;2;1;
/org.eclipse.jdt.core.tests.model/workspace/Converter/src/test0161/Test.java;1;0;1;1;0;0;0;1;0;0;1;3714;0;0;1;0;0;1;1;3714;0;3714;1;1;
/org.eclipse.jdt.core/dom/org/eclipse/jdt/core/dom/IfStatement.java;3;1;9;1;2;2;2;7;134;1;7;2872;203;203;1;0;0;7;9;2872;0;5272;9;3;
/org.eclipse.core.runtime.osgi/src/org/eclipse/core/runtime/IAdapterFactory.java;1;0;2;1;0;0;0;2;52;1;2;3013;52;52;1;0;0;2;2;3013;0;3030;2;1;
/org.eclipse.core.tests.runtime/src/org/eclipse/core/tests/runtime/PlatformTest.java;1;0;1;1;1;1;1;0;314;0;0;5149;314;314;1;0;0;0;1;5149;0;5149;1;1;
/org.eclipse.jface.text/src/org/eclipse/jface/text/IWidgetTokenKeeper.java;2;1;2;1;2;2;2;0;33;0;0;6340;35;35;1;0;0;0;2;6340;0;6359;2;2;
/org.eclipse.core.resources/src/org/eclipse/core/internal/utils/Queue.java;1;0;1;1;1;1;1;0;371;0;0;5146;371;371;1;0;0;0;1;5146;0;5146;1;1;
/org.eclipse.help/src/org/eclipse/help/internal/search/IndexingOperation.java;1;0;3;1;0;0;0;3;2;1;3;919;4;4;1;0;0;3;3;919;0;2732;3;1;
/org.eclipse.core.resources/src/org/eclipse/core/internal/dtree/DeletedNode.java;2;0;3;1;2;1;2;1;234;0;1;178;241;241;2;0;1;1;3;5146;1;5146;2;2;
/org.eclipse.ui.workbench/Eclipse UI/org/eclipse/ui/internal/activities/IActivityActivityBindingDefinition.java;1;0;2;1;0;0;0;2;0;1;2;2896;0;0;1;0;0;2;2;2896;0;3066;2;1;
/org.eclipse.jdt.ui/ui/org/eclipse/jdt/internal/ui/search/NewSearchViewActionGroup.java;2;1;5;1;3;3;3;2;32;1;2;3488;63;63;1;0;0;2;5;3488;0;6340;5;2;
/org.eclipse.jdt.core.tests.model/workspace/Formatter/test418/A_out.java;1;0;1;1;0;0;0;1;0;0;1;3461;0;0;1;0;0;1;1;3461;0;3461;1;1;
/org.eclipse.core.tests.runtime/src/org/eclipse/core/tests/internal/runtime/PlatformLogReader.java;1;0;1;1;1;1;1;0;370;0;0;5149;370;370;1;0;0;0;1;5149;0;5149;1;1;
/org.eclipse.ui.forms/src/org/eclipse/ui/forms/widgets/TableWrapData.java;1;0;6;1;1;1;1;5;212;1;5;4068;247;247;1;0;0;5;6;4068;0;6336;6;1;
/org.eclipse.team.core/src/org/eclipse/team/internal/core/VestigeConfigurationItem.java;1;0;1;1;0;0;0;1;0;0;1;649;0;0;1;0;0;1;1;649;0;649;1;1;
/org.eclipse.swt.examples/src/org/eclipse/swt/examples/browserexample/BrowserExample.java;2;0;10;1;1;1;1;9;81;2;7;2950;224;224;2;2;0;9;10;3115;2;6352;8;2;
/org.eclipse.jdt.core.tests.model/workspace/Formatter/test241/A_in.java;1;0;1;1;0;0;0;1;0;0;1;2437;0;0;1;0;0;1;1;2437;0;2437;1;1;
/org.eclipse.core.runtime.compatibility/src-boot/org/eclipse/core/boot/IPlatformConfiguration.java;3;2;10;1;4;3;4;6;21;1;6;3013;61;61;2;0;1;6;10;5117;1;6340;9;3;
/org.eclipse.pde.ui/src_Forms/org/eclipse/pde/internal/ui/neweditor/site/DescriptionSection.java;2;0;2;1;1;1;1;1;0;0;1;4832;0;0;1;0;0;1;2;4832;0;5431;2;2;
/org.eclipse.jdt.core.tests.model/src/org/eclipse/jdt/core/tests/model/TypeHierarchyNotificationTests.java;3;0;14;2;1;1;1;13;96;2;12;100;269;269;2;1;0;13;14;2094;1;5189;13;3;
/org.eclipse.jdt.ui/core refactoring/org/eclipse/jdt/internal/corext/refactoring/reorg/MoveCuUpdateCreator.java;5;1;21;1;5;5;5;16;305;3;12;290;705;705;3;4;0;16;21;1946;4;6340;17;5;
/org.eclipse.pde.build/src_ant/org/eclipse/pde/internal/build/tasks/BuildManifestTask.java;2;0;7;1;1;1;1;6;440;1;6;447;2214;2214;1;0;0;6;7;447;0;6340;7;2;
/org.eclipse.ltk.core.refactoring/src/org/eclipse/ltk/core/refactoring/participants/CreateParticipant.java;1;1;6;1;4;4;4;2;22;1;2;4845;58;58;1;0;0;2;6;4845;0;6351;6;1;
/org.eclipse.jdt.core/model/org/eclipse/jdt/core/util/IAnnotation.java;2;0;2;1;0;0;0;2;43;1;2;4447;43;43;1;0;0;2;2;4447;0;4843;2;2;
/org.eclipse.jdt.ui/ui/org/eclipse/jdt/internal/ui/preferences/JavaSourcePreviewerUpdater.java;1;0;3;1;1;1;1;2;19;1;2;2399;21;21;1;0;0;2;3;2399;0;6340;3;1;
/org.eclipse.jdt.core.tests.model/workspace/Converter/test0283/Test.java;1;0;1;1;0;0;0;1;0;0;1;3714;0;0;1;0;0;1;1;3714;0;3714;1;1;
/org.eclipse.jdt.ui/ui/org/eclipse/jdt/internal/ui/JavaEditorTextHoverDescriptorComparator.java;1;0;2;1;0;0;0;2;0;1;2;3743;0;0;1;0;0;2;2;3743;0;3787;2;1;
/org.eclipse.debug.ui/ui/org/eclipse/debug/ui/ILazyLabelListener.java;1;0;2;1;0;0;0;2;0;1;2;2184;0;0;1;0;0;2;2;2184;0;2210;2;1;
/org.eclipse.jdt.debug.tests/tests/org/eclipse/jdt/debug/tests/eval/ShortAssignmentOperatorsTests.java;1;0;1;1;0;0;0;1;130;0;1;1274;130;130;1;0;0;1;1;1274;0;1274;1;1;
/org.eclipse.jdt.ui/ui/org/eclipse/jdt/internal/ui/wizards/buildpaths/JavadocLocationDialog.java;2;1;2;1;2;2;2;0;2;0;0;5129;2;2;1;0;0;0;2;5129;0;6340;2;2;
/org.eclipse.pde.ui/src/org/eclipse/pde/internal/ui/parts/TreePart.java;1;1;2;1;2;2;2;0;10;0;0;5431;14;14;1;0;0;0;2;5431;0;6336;2;1;
/org.eclipse.pde.build/src/org/eclipse/pde/internal/build/IXMLConstants.java;2;1;12;1;3;3;3;9;49;1;9;447;284;284;1;0;0;9;12;447;0;6083;12;2;
/org.eclipse.jface/src/org/eclipse/jface/action/CommandResolver.java;2;0;7;1;1;1;1;6;19;1;6;2161;33;33;1;0;0;6;7;2161;0;5252;7;2;
/org.eclipse.jdt.junit/src/org/eclipse/jdt/internal/junit/wizards/NewTestSuiteCreationWizardPage.java;3;1;5;1;3;3;3;2;138;1;2;160;146;146;1;0;0;2;5;160;0;6340;5;3;
/org.eclipse.osgi/core/framework/org/eclipse/osgi/framework/internal/core/Util.java;4;1;5;1;3;3;3;2;390;1;2;3013;400;400;1;0;0;2;5;3013;0;6337;5;4;
/org.eclipse.ui.workbench/Eclipse UI/org/eclipse/ui/IPluginContribution.java;1;0;1;1;0;0;0;1;0;0;1;3066;0;0;1;0;0;1;1;3066;0;3066;1;1;
/org.eclipse.update.ui/srcnew/org/eclipse/update/internal/ui/wizards/ReviewPage2.java;1;0;2;1;0;0;0;2;0;1;2;367;0;0;1;0;0;2;2;367;0;433;2;1;
/org.eclipse.ui.workbench/Eclipse UI/org/eclipse/ui/internal/presentations/SystemMenuCloseAll.java;1;1;2;1;2;2;2;0;4;0;0;5522;4;4;1;0;0;0;2;5522;0;5539;2;1;
/org.eclipse.jdt.core/dom/org/eclipse/jdt/core/dom/SwitchStatement.java;3;1;8;1;2;2;2;6;102;1;6;3560;132;132;1;0;0;6;8;3560;0;5272;8;3;
/org.eclipse.jdt.core.tests.model/workspace/Formatter/test386/A_in.java;1;0;1;1;0;0;0;1;0;0;1;3164;0;0;1;0;0;1;1;3164;0;3164;1;1;
/org.eclipse.jdt.ui.tests.refactoring/resources/ExtractMethodWorkSpace/ExtractMethodTests/nested_out/A_test653.java;1;0;1;1;0;0;0;1;4;0;1;844;4;4;1;0;0;1;1;844;0;844;1;1;
/org.eclipse.ui.ide/src/org/eclipse/ui/views/navigator/MainActionGroup.java;5;1;8;1;3;3;3;5;22;1;5;2208;83;83;1;0;0;5;8;2208;0;6338;8;5;
/org.eclipse.jdt.core.tests.model/workspace/Converter/junit/framework/Protectable.java;1;0;1;1;0;0;0;1;0;0;1;3714;0;0;1;0;0;1;1;3714;0;3714;1;1;
/org.eclipse.jdt.debug/jdi interfaces/com/sun/jdi/VirtualMachineManager.java;1;0;1;1;0;0;0;1;6;0;1;4267;6;6;1;0;0;1;1;4267;0;4267;1;1;
/org.eclipse.update.ui.forms/Eclipse Forms/org/eclipse/ui/forms/widgets/ScrolledPageBook.java;1;0;7;1;0;0;0;7;20;2;5;3733;36;36;2;2;0;7;7;4003;2;4157;5;1;
/org.eclipse.jdt.ui.tests.refactoring/resources/ExtractMethodWorkSpace/ExtractMethodTests/parameterName_in/A_test906.java;1;0;1;1;0;0;0;1;0;0;1;4698;0;0;1;0;0;1;1;4698;0;4698;1;1;
/org.eclipse.swt/Eclipse SWT Drag and Drop/gtk/org/eclipse/swt/dnd/Transfer.java;2;1;3;1;2;2;2;1;4;0;1;4128;8;8;1;0;0;1;3;4128;0;6352;3;2;
/org.eclipse.jdt.ui.tests.refactoring/resources/ExtractMethodWorkSpace/ExtractMethodTests/locals_out/A_test553.java;1;0;1;1;0;0;0;1;4;0;1;844;4;4;1;0;0;1;1;844;0;844;1;1;
/org.eclipse.pde.ui/src/org/eclipse/pde/internal/ui/wizards/templates/FieldData.java;2;0;4;1;0;0;0;4;157;1;4;2501;181;181;1;0;0;4;4;2501;0;3986;4;2;
/org.eclipse.webdav/src/kernel/org/eclipse/webdav/internal/kernel/SystemException.java;1;0;1;1;1;1;1;0;4;0;0;5151;4;4;1;0;0;0;1;5151;0;5151;1;1;
/org.eclipse.jdt.ui.tests.refactoring/resources/Copy/test_method_yes_itself/in/A.java;1;0;1;1;0;0;0;1;2;0;1;685;2;2;1;0;0;1;1;685;0;685;1;1;
/org.eclipse.help.base/src/org/eclipse/help/internal/workingset/WorkingSetComparator.java;1;1;3;1;2;2;2;1;9;0;1;1740;15;15;1;0;0;1;3;1740;0;6337;3;1;
/org.eclipse.jdt.core.tests.model/workspace/Formatter/test050/A_out.java;1;0;1;1;0;0;0;1;0;0;1;2425;0;0;1;0;0;1;1;2425;0;2425;1;1;
/org.eclipse.team.ui/src/org/eclipse/team/internal/ui/synchronize/TeamSynchronizingPerspective.java;1;1;7;1;3;3;3;4;60;1;4;2584;81;81;1;0;0;4;7;2584;0;6337;7;1;
/org.eclipse.team.examples.filesystem/src/org/eclipse/team/examples/pessimistic/ui/UncheckOutAction.java;1;0;2;1;1;1;1;1;25;0;1;3368;25;25;1;0;0;1;2;3368;0;6103;2;1;
/org.eclipse.swt/Eclipse SWT/motif/org/eclipse/swt/graphics/FontData.java;2;1;4;1;2;2;2;2;41;1;2;174;52;52;1;0;0;2;4;174;0;6352;4;2;
/org.eclipse.jface.text/src/org/eclipse/jface/text/source/AnnotationModelEvent.java;2;1;6;1;3;3;3;3;104;1;3;3217;236;236;1;0;0;3;6;3217;0;5382;6;2;
/org.eclipse.pde.ui/src/org/eclipse/pde/internal/ui/editor/schema/SchemaForm.java;1;0;1;1;1;1;1;0;0;0;0;5431;0;0;1;0;0;0;1;5431;0;5431;1;1;
/org.eclipse.swt/Eclipse SWT/gtk1x/org/eclipse/swt/graphics/DefaultGtkStyle.java;1;0;1;1;0;0;0;1;0;0;1;2327;0;0;1;0;0;1;1;2327;0;2327;1;1;
/org.eclipse.debug.ui/ui/org/eclipse/debug/internal/ui/views/console/ShowProcessAction.java;1;0;1;1;0;0;0;1;0;0;1;1414;0;0;1;0;0;1;1;1414;0;1414;1;1;
/org.eclipse.jdt.ui/ui/org/eclipse/jdt/internal/ui/text/template/contentassist/InclusivePositionUpdater.java;2;1;3;1;3;3;3;0;6;0;0;5177;11;11;1;0;0;0;3;5177;0;6340;3;2;
/org.eclipse.ui.ide/src/org/eclipse/ui/internal/ide/StringMatcher.java;4;2;4;2;3;2;3;1;52;0;1;1526;90;90;2;0;1;1;4;6338;1;6338;3;4;
/org.eclipse.jdt.ui/ui refactoring/org/eclipse/jdt/internal/ui/refactoring/reorg/RenameResourceWizard.java;2;0;4;1;1;1;1;3;10;2;2;1125;19;19;2;1;0;3;4;1125;1;6340;3;2;
/org.eclipse.team.cvs.ui/src/org/eclipse/team/internal/ccvs/ui/subscriber/CompareParticipantActionContribution.java;1;0;1;1;0;0;0;1;0;0;1;5070;0;0;1;0;0;1;1;5070;0;5070;1;1;
/org.eclipse.debug.ui/ui/org/eclipse/debug/internal/ui/views/console/ShowCurrentProcessAction.java;1;0;1;1;0;0;0;1;0;0;1;1414;0;0;1;0;0;1;1;1414;0;1414;1;1;
/org.eclipse.team.core/src/org/eclipse/team/internal/core/subscribers/caches/IResourceVariantFactory.java;1;0;1;1;0;0;0;1;0;0;1;4208;0;0;1;0;0;1;1;4208;0;4208;1;1;
/org.eclipse.jdt.debug.ui/ui/org/eclipse/jdt/internal/debug/ui/launcher/WorkspaceOperationRunner.java;2;1;2;1;2;2;2;0;4;0;0;5187;4;4;1;0;0;0;2;5187;0;6336;2;2;
/org.eclipse.swt/Eclipse SWT PI/win32/org/eclipse/swt/internal/ole/win32/IPersistStreamInit.java;1;0;1;1;0;0;0;1;0;0;1;2660;0;0;1;0;0;1;1;2660;0;2660;1;1;
/org.eclipse.ui.workbench/Eclipse UI/org/eclipse/ui/internal/PlaceholderFolderLayout.java;2;1;4;1;3;3;3;1;12;0;1;4563;36;36;1;0;0;1;4;4563;0;6338;4;2;
/org.eclipse.team.ui/src/org/eclipse/team/ui/sync/ISynchronizeParticipant.java;1;0;1;1;0;0;0;1;0;0;1;2463;0;0;1;0;0;1;1;2463;0;2463;1;1;
/org.eclipse.osgi/resolver/src/org/eclipse/core/dependencies/ISelectionPolicy.java;3;1;3;1;2;2;2;1;5;0;1;3013;5;5;1;0;0;1;3;3013;0;5226;3;3;
/org.eclipse.ui.workbench/Eclipse UI/org/eclipse/ui/internal/csm/activities/ObjectContributionRecord.java;1;0;2;1;0;0;0;2;0;0;1;2443;0;0;2;1;0;2;2;2443;1;2443;1;1;
/org.eclipse.osgi/defaultAdaptor/src/org/eclipse/osgi/framework/adaptor/core/AdaptorMsg.java;2;1;3;1;2;2;2;1;5;0;1;4391;7;7;1;0;0;1;3;4391;0;5232;3;2;
/org.eclipse.jdt.core.tests.model/workspace/Formatter/test305/A_in.java;1;0;1;1;0;0;0;1;0;0;1;2442;0;0;1;0;0;1;1;2442;0;2442;1;1;
/org.eclipse.ui.tests/Eclipse UI Tests/org/eclipse/ui/tests/api/StartupTest.java;1;0;2;1;0;0;0;2;7;1;2;3012;7;7;1;0;0;2;2;3012;0;3091;2;1;
/org.eclipse.core.runtime/src/org/eclipse/core/runtime/preferences/UserScope.java;1;0;2;1;0;0;0;2;0;1;2;4351;0;0;1;0;0;2;2;4351;0;4632;2;1;
/org.eclipse.jdt.core.tests.model/src/org/eclipse/jdt/core/tests/model/CopyMoveTests.java;2;0;2;1;1;1;1;1;3;0;1;3560;5;5;1;0;0;1;2;3560;0;5853;2;2;
/org.eclipse.swt/Eclipse SWT/common/org/eclipse/swt/graphics/TextStyle.java;3;2;6;2;5;4;5;1;19;0;1;4873;54;54;2;0;1;1;6;5641;1;6352;5;3;
/org.eclipse.update.core/srcnew/org/eclipse/update/internal/operations/InstallOperation.java;1;0;15;1;0;0;0;15;95;2;10;442;303;303;2;5;0;15;15;442;5;825;10;1;
/org.eclipse.jdt.core.tests.model/workspace/Converter/test0165/Test.java;1;0;1;1;0;0;0;1;0;0;1;3714;0;0;1;0;0;1;1;3714;0;3714;1;1;
/org.eclipse.pde.ui/src/org/eclipse/pde/internal/ui/properties/SelfHostingPropertyPage.java;1;1;2;1;2;2;2;0;10;0;0;5875;10;10;1;0;0;0;2;5875;0;6336;2;1;
/org.eclipse.jdt.ui/ui/org/eclipse/jdt/internal/ui/search/DelegatingLabelProvider.java;2;0;5;1;1;1;1;4;35;1;4;3711;42;42;1;0;0;4;5;3711;0;5106;5;2;
/org.eclipse.swt/Eclipse SWT PI/photon/org/eclipse/swt/internal/photon/PtWebMetaDataCallback_t.java;2;0;2;1;1;1;1;1;6;0;1;3708;6;6;1;0;0;1;2;3708;0;6352;2;2;
/org.eclipse.jdt.core.tests.model/workspace/Formatter/test481/A_out.java;1;0;1;1;0;0;0;1;0;0;1;4173;0;0;1;0;0;1;1;4173;0;4173;1;1;
/org.eclipse.jdt.ui/ui/org/eclipse/jdt/ui/actions/FindReadReferencesInWorkingSetAction.java;2;0;2;1;1;1;1;1;9;0;1;3266;11;11;1;0;0;1;2;3266;0;6340;2;2;
/org.eclipse.pde.core/src/org/eclipse/pde/internal/core/ibundle/IBundlePluginModel.java;1;1;2;1;2;2;2;0;4;0;0;5445;4;4;1;0;0;0;2;5445;0;6336;2;1;
/org.eclipse.core.runtime/src/org/eclipse/core/internal/plugins/PluginDescriptor.java;3;0;11;1;0;0;0;11;22;1;11;407;102;102;1;0;0;11;11;407;0;3013;11;3;
/org.eclipse.jdt.core.tests.model/workspace/Converter/test0101/Test.java;1;0;1;1;0;0;0;1;0;0;1;3714;0;0;1;0;0;1;1;3714;0;3714;1;1;
/org.eclipse.jdt.core.tests.model/workspace/Formatter/test326/A_out.java;2;0;2;1;0;0;0;2;32;1;2;2552;32;32;1;0;0;2;2;2552;0;3362;2;2;
/org.eclipse.team.webdav/src/org/eclipse/team/internal/ui/target/SiteSelectionPage.java;2;0;3;1;1;1;1;2;23;1;2;2495;25;25;1;0;0;2;3;2495;0;6337;3;2;
/org.eclipse.ui.forms/src/org/eclipse/ui/forms/internal/widgets/BreakSegment.java;1;0;2;1;0;0;0;2;0;1;2;4197;0;0;1;0;0;2;2;4197;0;5044;2;1;
/org.eclipse.core.tests.resources/src/org/eclipse/core/tests/resources/perf/BenchLocalStoreTest.java;1;2;3;1;3;2;3;0;46;0;0;5147;49;49;2;0;1;0;3;5147;1;6127;2;1;
/org.eclipse.core.runtime/src/org/eclipse/core/internal/content/ContentType.java;3;6;29;1;25;18;25;4;293;1;4;4574;1269;1269;6;0;7;4;29;5247;7;6225;22;3;
/org.eclipse.ant.ui/Ant Tools Support/org/eclipse/ant/internal/ui/console/JavacLineTracker.java;3;0;5;2;0;0;0;5;19;2;4;1811;27;27;2;1;0;5;5;2148;1;2148;4;3;
/org.eclipse.swt/Eclipse SWT Custom Widgets/common/org/eclipse/swt/custom/TableTreeEditor.java;3;2;7;2;3;2;3;4;162;2;3;866;185;185;2;1;1;4;7;923;2;6352;5;3;
/org.eclipse.search/new search/org/eclipse/search2/internal/ui/SearchAgainAction.java;2;1;6;1;2;2;2;4;9;1;4;3474;21;21;1;0;0;4;6;3474;0;6340;6;2;
/org.eclipse.jdt.ui.tests.refactoring/resources/Copy/test_type_yes_cu/in/C.java;1;0;2;1;0;0;0;2;0;1;2;696;0;0;1;0;0;2;2;696;0;1009;2;1;
/org.eclipse.jdt.core.tests.model/workspace/Converter/test0259/Test.java;1;0;1;1;0;0;0;1;0;0;1;3714;0;0;1;0;0;1;1;3714;0;3714;1;1;
/org.eclipse.swt/Eclipse SWT/motif/org/eclipse/swt/widgets/Caret.java;2;1;6;1;2;2;2;4;15;1;4;270;43;43;1;0;0;4;6;270;0;6352;6;2;
/org.eclipse.jdt.ui.tests.refactoring/resources/Copy/test_inner_type_yes_cu/in/A.java;1;0;1;1;0;0;0;1;0;0;1;1009;0;0;1;0;0;1;1;1009;0;1009;1;1;
/org.eclipse.ui.workbench/Eclipse UI/org/eclipse/ui/commands/CharacterKey.java;1;0;4;1;0;0;0;4;15;3;2;1321;15;15;3;2;0;4;4;1339;2;1339;2;1;
/org.eclipse.pde.ui/src_Forms/org/eclipse/pde/internal/ui/neweditor/plugin/rows/ExtensionAttributeRow.java;2;1;4;1;2;2;2;2;36;1;2;4354;48;48;1;0;0;2;4;4354;0;5431;4;2;
/org.eclipse.update.ui.forms/src/org/eclipse/ui/forms/FormWidgetFactory.java;1;0;3;1;0;0;0;3;27;1;3;3038;27;27;1;0;0;3;3;3038;0;3071;3;1;
/org.eclipse.ui.workbench/Eclipse UI/org/eclipse/ui/internal/presentation/ColorsAndFontsPreferencePage.java;1;0;7;1;0;0;0;7;210;2;5;4235;437;437;2;2;0;7;7;4235;2;4386;5;1;
/org.eclipse.swt/Eclipse SWT Drag and Drop/carbon/org/eclipse/swt/dnd/RTFTransfer.java;1;0;4;1;0;0;0;4;94;2;3;222;143;143;2;1;0;4;4;298;1;316;3;1;
/org.eclipse.jdt.core/dom/org/eclipse/jdt/core/dom/MethodRefParameter.java;2;1;9;1;2;2;2;7;87;1;7;3683;132;132;1;0;0;7;9;3683;0;5272;9;2;
/org.eclipse.jdt.core.tests.model/workspace/Formatter/test196/A_in.java;1;0;1;1;0;0;0;1;0;0;1;2424;0;0;1;0;0;1;1;2424;0;2424;1;1;
/org.eclipse.jdt.core/compiler/org/eclipse/jdt/internal/compiler/ast/AnnotationArgumentExpression.java;1;0;4;1;0;0;0;4;55;1;4;2397;65;65;1;0;0;4;4;2397;0;2887;4;1;
/org.eclipse.pde.ui/src_Forms/org/eclipse/pde/internal/ui/neweditor/feature/FeatureEditor.java;2;1;4;1;2;2;2;2;8;0;1;4926;13;13;2;1;0;2;4;4926;1;5431;3;2;
/org.eclipse.ui.workbench/Eclipse UI/org/eclipse/ui/internal/ViewLayoutRec.java;1;0;1;1;1;1;1;0;0;0;0;5514;0;0;1;0;0;0;1;5514;0;5514;1;1;
/org.eclipse.ui.workbench/Eclipse UI/org/eclipse/ui/internal/about/AboutBundleData.java;1;0;1;1;1;1;1;0;0;0;0;5483;0;0;1;0;0;0;1;5483;0;5483;1;1;
/org.eclipse.jdt.ui/core extension/org/eclipse/jdt/internal/corext/dom/ASTFlattener.java;4;1;13;1;3;3;3;10;292;2;9;130;426;426;2;1;0;10;13;1574;1;6340;12;4;
/org.eclipse.ui.forms.examples/src/org/eclipse/ui/forms/examples/internal/FormEditorInput.java;1;1;3;1;2;2;2;1;16;0;1;4075;17;17;1;0;0;1;3;4075;0;5781;3;1;
/org.eclipse.team.cvs.core/src/org/eclipse/team/internal/ccvs/core/resources/RemoteResource.java;2;0;7;1;1;1;1;6;32;1;6;790;72;72;1;0;0;6;7;790;0;6337;7;2;
/org.eclipse.jdt.ui.tests.refactoring/resources/IntroduceFactory/positive/DifferentArgs2.java;1;0;2;1;1;1;1;1;2;0;1;2862;2;2;1;0;0;1;2;2862;0;5659;2;1;
/org.eclipse.ui.examples.javaeditor/Eclipse Java Editor Example/org/eclipse/ui/examples/javaeditor/spelling/DefaultPhoneticDistanceAlgorithm.java;1;0;1;1;0;0;0;1;0;0;1;2565;0;0;1;0;0;1;1;2565;0;2565;1;1;
/org.eclipse.jface.text/src/org/eclipse/jface/text/information/IInformationProviderExtension2.java;2;1;4;1;3;3;3;1;26;0;1;692;32;32;1;0;0;1;4;692;0;6352;4;2;
/org.eclipse.ui.internal.r21presentation/src/org/eclipse/ui/internal/r21presentation/widgets/ViewForm.java;2;1;2;1;2;2;2;0;8;0;0;5275;8;8;1;0;0;0;2;5275;0;5625;2;2;
/org.eclipse.jdt.core.tests.model/workspace/Converter/src/test0057/Test.java;1;0;1;1;0;0;0;1;0;0;1;3714;0;0;1;0;0;1;1;3714;0;3714;1;1;
/org.eclipse.ltk.core.refactoring/src/org/eclipse/ltk/core/refactoring/NullChange.java;1;1;5;1;2;2;2;3;4;1;3;4845;11;11;1;0;0;3;5;4845;0;6340;5;1;
/org.eclipse.swt.examples/src/org/eclipse/swt/examples/layoutexample/Tab.java;1;0;1;1;0;0;0;1;5;0;1;2774;5;5;1;0;0;1;1;2774;0;2774;1;1;
/org.eclipse.pde.core/src/org/eclipse/pde/internal/core/EntryFileAdapter.java;1;0;2;1;1;1;1;1;6;0;1;4203;8;8;1;0;0;1;2;4203;0;6336;2;1;
/org.eclipse.jdt.debug/jdi/org/eclipse/jdi/internal/InterfaceTypeImpl.java;1;0;1;1;0;0;0;1;13;0;1;4267;13;13;1;0;0;1;1;4267;0;4267;1;1;
/org.eclipse.jdt.ui.tests.refactoring/resources/InlineMethodWorkspace/TestCases/argument_in/TestLocalReferenceRead.java;1;0;1;1;0;0;0;1;2;0;1;845;2;2;1;0;0;1;1;845;0;845;1;1;
/org.eclipse.jdt.ui.tests.refactoring/resources/ChangeSignature/canModify/A_testAll59_in.java;1;0;1;1;0;0;0;1;0;0;1;4350;0;0;1;0;0;1;1;4350;0;4350;1;1;
/org.eclipse.ui.workbench/Eclipse UI/org/eclipse/ui/internal/dialogs/WorkbenchWizardDialog.java;1;0;2;1;1;1;1;1;0;0;1;5081;0;0;1;0;0;1;2;5081;0;5112;2;1;
/org.eclipse.core.resources/src/org/eclipse/core/resources/IWorkspace.java;2;1;21;2;2;2;2;19;2697;2;18;44;3601;3601;2;1;0;19;21;2426;1;6147;20;2;
/org.eclipse.jdt.ui/core extension/org/eclipse/text/edits/CopySourceEdit.java;1;0;4;1;0;0;0;4;115;2;3;1953;133;133;2;1;0;4;4;1985;1;1985;3;1;
/org.eclipse.swt/Eclipse SWT PI/carbon/org/eclipse/swt/internal/carbon/TXNLongRect.java;1;2;3;1;3;2;3;0;16;0;0;5534;20;20;2;0;1;0;3;5534;1;5614;2;1;
/org.eclipse.team.core/src/org/eclipse/team/core/subscribers/ISyncInfoTreeChangeEvent.java;1;0;1;1;0;0;0;1;0;0;1;4017;0;0;1;0;0;1;1;4017;0;4017;1;1;
/org.eclipse.ui.intro/src/org/eclipse/ui/internal/intro/impl/swt/SharedStyleManager.java;1;2;8;1;8;6;8;0;83;0;0;5714;137;137;2;0;2;0;8;5726;2;6280;6;1;
/org.eclipse.jdt.core.tests.model/workspace/Formatter/test094/A_out.java;1;0;1;1;0;0;0;1;0;0;1;2425;0;0;1;0;0;1;1;2425;0;2425;1;1;
/org.eclipse.ltk.core.refactoring/src/org/eclipse/ltk/core/refactoring/PerformChangeOperation.java;1;2;9;1;5;4;5;4;62;1;4;4845;127;127;2;0;1;4;9;6338;1;6338;8;1;
/org.eclipse.update.ui.forms/Eclipse Forms/org/eclipse/ui/forms/parts/ToggleHyperlink.java;1;0;4;1;0;0;0;4;13;2;3;3096;16;16;2;1;0;4;4;3096;1;3138;3;1;
/org.eclipse.ui.workbench/Eclipse UI/org/eclipse/ui/internal/csm/activities/api/IActivityManager.java;1;0;2;1;0;0;0;2;0;1;2;2225;0;0;1;0;0;2;2;2225;0;2240;2;1;
/org.eclipse.jdt.core.tests.model/workspace/JavaSearchMultipleProjects2/src/q/Z.java;1;0;1;1;0;0;0;1;11;0;1;3024;11;11;1;0;0;1;1;3024;0;3024;1;1;
/org.eclipse.jdt.core.tests.model/workspace/Formatter/test489/A_out.java;1;0;1;1;1;1;1;0;0;0;0;5188;0;0;1;0;0;0;1;5188;0;5188;1;1;
/org.eclipse.ui.intro/src/org/eclipse/ui/intro/internal/parts/FormStyleManager.java;1;0;5;1;1;1;1;4;257;1;4;4429;342;342;1;0;0;4;5;4429;0;5115;5;1;
/org.eclipse.jdt.debug.tests/tests/org/eclipse/jdt/debug/tests/core/MiscBreakpointsTests.java;1;0;1;1;0;0;0;1;16;0;1;1274;16;16;1;0;0;1;1;1274;0;1274;1;1;
/org.eclipse.osgi.tests/src/org/eclipse/osgi/tests/internal/state/AbstractStateTest.java;3;1;5;1;4;4;4;1;15;0;1;4705;28;28;1;0;0;1;5;4705;0;5993;5;3;
/org.eclipse.ui.ide/src/org/eclipse/ui/views/bookmarkexplorer/BookmarkSorter.java;1;0;1;1;0;0;0;1;0;0;1;2208;0;0;1;0;0;1;1;2208;0;2208;1;1;
/org.eclipse.jdt.ui.tests.refactoring/resources/ChangeTypeRefactoring/positive/A_testString_out.java;1;0;1;1;0;0;0;1;0;0;1;2844;0;0;1;0;0;1;1;2844;0;2844;1;1;
/org.eclipse.jdt.ui.tests.refactoring/test cases/org/eclipse/jdt/ui/tests/refactoring/RenameMethodTests.java;1;0;1;1;1;1;1;0;2;0;0;6340;2;2;1;0;0;0;1;6340;0;6340;1;1;
/org.eclipse.jdt.ui/ui/org/eclipse/jdt/internal/ui/callhierarchy/CallerMethodWrapper.java;1;0;2;1;0;0;0;2;0;1;2;155;0;0;1;0;0;2;2;155;0;169;2;1;
/org.eclipse.ui.forms/src/org/eclipse/ui/forms/AbstractFormPart.java;1;1;6;1;2;2;2;4;17;1;4;4354;38;38;1;0;0;4;6;4354;0;6336;6;1;
/org.eclipse.pde.ui/src/org/eclipse/pde/internal/ui/editor/schema/ElementSection.java;2;1;6;1;3;3;3;3;72;1;3;368;108;108;1;0;0;3;6;368;0;6336;6;2;
/org.eclipse.core.tests.resources/src/org/eclipse/core/tests/resources/ISynchronizerTest.java;2;0;3;1;2;1;2;1;1829;0;1;1635;1830;1830;2;0;1;1;3;5147;1;5147;2;2;
/org.eclipse.ui.workbench/Eclipse UI/org/eclipse/ui/internal/themes/ThemeRegistryReader.java;4;2;14;2;3;2;3;11;390;3;8;3684;757;757;3;3;1;11;14;4559;4;5898;10;4;
/org.eclipse.jdt.ui/ui/org/eclipse/jdt/internal/ui/text/comment/JavaSnippetFormattingStrategy.java;2;0;3;1;0;0;0;3;15;1;3;3573;15;15;1;0;0;3;3;3573;0;4365;3;2;
/org.eclipse.pde.ui/src/org/eclipse/pde/internal/ui/editor/manifest/XMLOutlinePage.java;1;0;2;1;1;1;1;1;0;0;1;2320;0;0;1;0;0;1;2;2320;0;5431;2;1;
/org.eclipse.jdt.ui/ui/org/eclipse/jdt/ui/text/spelling/WordQuickFixProcessor.java;1;0;2;1;0;0;0;2;0;1;2;3829;0;0;1;0;0;2;2;3829;0;3930;2;1;
/org.eclipse.jdt.ui/ui/org/eclipse/jdt/internal/ui/JavaTaskListAdapter.java;1;0;1;1;1;1;1;0;2;0;0;6340;2;2;1;0;0;0;1;6340;0;6340;1;1;
/org.eclipse.ui.workbench/Eclipse UI/org/eclipse/ui/gestures/GestureStroke.java;1;0;2;1;0;0;0;2;0;1;2;1294;0;0;1;0;0;2;2;1294;0;1321;2;1;
/org.eclipse.update.core/src/org/eclipse/update/standalone/ListFeaturesCommand.java;1;1;4;1;4;4;4;0;36;0;0;5489;57;57;1;0;0;0;4;5489;0;6336;4;1;
/org.eclipse.ui.cheatsheets/src/org/eclipse/ui/internal/cheatsheets/views/StringDelimitedTokenizer.java;1;0;1;1;1;1;1;0;0;0;0;5596;0;0;1;0;0;0;1;5596;0;5596;1;1;
/org.eclipse.pde.ui/sandbox/org/eclipse/pde/internal/ui/editor/standalone/text/XMLDoubleClickStrategy.java;1;0;2;1;0;0;0;2;0;1;2;2320;0;0;1;0;0;2;2;2320;0;2906;2;1;
/org.eclipse.team.cvs.ui/src/org/eclipse/team/internal/ccvs/ui/ICVSUIConstants.java;2;2;25;2;5;4;5;20;18;2;19;885;83;83;2;1;1;20;25;5039;2;6337;23;2;
/org.eclipse.jdt.core.tests.model/workspace/Converter/test0225/Test.java;1;0;1;1;0;0;0;1;0;0;1;3714;0;0;1;0;0;1;1;3714;0;3714;1;1;
/org.eclipse.ui.workbench/Eclipse UI/org/eclipse/ui/activities/IMutableActivityManager.java;3;1;10;1;2;2;2;8;13;1;8;2805;61;61;1;0;0;8;10;2805;0;6338;10;3;
/org.eclipse.ant.ui/Ant Tools Support/org/eclipse/ant/internal/ui/preferences/ClasspathModel.java;3;1;20;1;2;2;2;18;150;3;14;2182;702;702;3;4;0;18;20;2182;4;6336;16;3;
/org.eclipse.ui.workbench/Eclipse UI/org/eclipse/ui/commands/ICompoundCommandHandlerService.java;1;0;3;1;0;0;0;3;10;1;3;3131;10;10;1;0;0;3;3;3131;0;4144;3;1;
/org.eclipse.jdt.core/model/org/eclipse/jdt/core/util/ICodeAttribute.java;2;0;2;1;1;1;1;1;3;0;1;3560;5;5;1;0;0;1;2;3560;0;5871;2;2;
/org.eclipse.jdt.core/model/org/eclipse/jdt/internal/core/CommitWorkingCopyOperation.java;3;0;19;1;0;0;0;19;97;2;18;818;261;261;2;1;0;19;19;3509;1;4753;18;3;
/org.eclipse.ui.workbench/Eclipse UI/org/eclipse/ui/commands/registry/ICommandRegistry.java;1;0;2;1;0;0;0;2;0;1;2;1400;0;0;1;0;0;2;2;1400;0;1417;2;1;
/org.eclipse.team.core/src/org/eclipse/team/core/RepositoryProvider.java;2;1;10;1;4;4;4;6;209;1;6;790;373;373;1;0;0;6;10;790;0;6336;10;2;
/org.eclipse.update.core/srcnew/org/eclipse/update/operations/IUninstallOperation.java;1;0;2;1;0;0;0;2;0;1;2;569;0;0;1;0;0;2;2;569;0;602;2;1;
/org.eclipse.ui.ide/src/org/eclipse/ui/internal/ide/dialogs/WelcomeItem.java;1;0;1;1;0;0;0;1;0;0;1;2264;0;0;1;0;0;1;1;2264;0;2264;1;1;
/org.eclipse.ui.ide/extensions/org/eclipse/ui/part/FileEditorInputFactory.java;1;0;1;1;0;0;0;1;0;0;1;2263;0;0;1;0;0;1;1;2263;0;2263;1;1;
/org.eclipse.jdt.core/dom/org/eclipse/jdt/core/dom/ArrayInitializer.java;3;0;6;1;1;1;1;5;61;1;5;3560;73;73;1;0;0;5;6;3560;0;5272;6;3;
/org.eclipse.jdt.core/model/org/eclipse/jdt/internal/core/CreatePackageDeclarationOperation.java;2;1;5;1;2;2;2;3;10;1;3;1804;18;18;1;0;0;3;5;1804;0;5916;5;2;
/org.eclipse.team.cvs.ui/src/org/eclipse/team/internal/ccvs/ui/model/RemoteResourceElement.java;1;0;1;1;0;0;0;1;3;0;1;1187;3;3;1;0;0;1;1;1187;0;1187;1;1;
/org.eclipse.jdt.ui/ui refactoring/org/eclipse/jdt/internal/ui/refactoring/nls/JavaTypedViewerFilter.java;2;0;2;1;1;1;1;1;0;0;1;4930;0;0;1;0;0;1;2;4930;0;5375;2;2;
/org.eclipse.help.base/src/org/eclipse/help/internal/search/SearchProgressMonitor.java;1;1;12;1;3;3;3;9;27;3;7;1740;77;77;3;2;0;9;12;1740;2;6337;10;1;
/org.eclipse.jdt.ui/ui/org/eclipse/jdt/internal/ui/text/correction/TypeMismatchSubProcessor.java;1;2;10;1;10;9;10;0;100;0;0;5377;212;212;2;0;1;0;10;5524;1;5780;9;1;
/org.eclipse.core.tests.runtime/src/org/eclipse/core/tests/plugintests/CmdLineAndPluginLocalTest.java;1;0;1;1;0;0;0;1;0;0;1;3014;0;0;1;0;0;1;1;3014;0;3014;1;1;
/org.eclipse.ui.workbench/Eclipse UI/org/eclipse/ui/internal/roles/CheckboxActivityHelper.java;2;0;2;1;0;0;0;2;0;1;2;2279;0;0;1;0;0;2;2;2279;0;2443;2;2;
/org.eclipse.jface/src/org/eclipse/jface/viewers/Viewer.java;3;1;3;1;2;2;2;1;6;0;1;1;12;12;1;0;0;1;3;1;0;6338;3;3;
/org.eclipse.jdt.core.tests.model/workspace/Formatter/test379/A_in.java;1;0;2;1;0;0;0;2;1;1;2;3146;1;1;1;0;0;2;2;3146;0;3172;2;1;
/org.eclipse.search/search/org/eclipse/search/internal/ui/util/ExtendedDialogWindow.java;2;1;8;1;3;3;3;5;88;1;5;611;136;136;1;0;0;5;8;611;0;6340;8;2;
/org.eclipse.jdt.text.tests/src/org/eclipse/jdt/text/tests/JavaLineSegmentationTest.java;1;1;2;1;2;2;2;0;2;0;0;5129;2;2;1;0;0;0;2;5129;0;6340;2;1;
/org.eclipse.jdt.core.tests.model/workspace/Converter/junit/framework/Test.java;1;0;1;1;0;0;0;1;0;0;1;3714;0;0;1;0;0;1;1;3714;0;3714;1;1;
/org.eclipse.ui.cheatsheets/src/org/eclipse/ui/internal/cheatsheets/views/CheatSheetStandbyContent.java;3;0;4;3;0;0;0;4;168;3;2;4693;201;201;3;2;0;4;4;4693;2;5094;2;3;
/org.eclipse.jdt.ui/ui/org/eclipse/jdt/internal/ui/text/comment/JavaDocRegion.java;4;1;18;1;3;3;3;15;410;2;14;1589;1450;1450;2;1;0;15;18;3607;1;6340;17;4;
/org.eclipse.ui.workbench/Eclipse UI/org/eclipse/ui/internal/presentation/TemporaryGradientRegistry.java;1;0;2;1;0;0;0;2;0;1;2;4237;0;0;1;0;0;2;2;4237;0;4263;2;1;
/org.eclipse.ui.workbench/Eclipse UI/org/eclipse/ui/internal/commands/registry/ActiveKeyConfigurationDefinition.java;1;0;5;1;0;0;0;5;40;2;4;1396;55;55;2;1;0;5;5;1396;1;1724;4;1;
/org.eclipse.jdt.core.tests.model/workspace/Converter/src/javadoc/test100/TestB2.java;1;0;1;1;0;0;0;1;0;0;1;4390;0;0;1;0;0;1;1;4390;0;4390;1;1;
/org.eclipse.pde.ui/src/org/eclipse/pde/internal/ui/editor/FormEntryAdapter.java;2;1;3;1;3;3;3;0;10;0;0;5431;14;14;1;0;0;0;3;5431;0;6336;3;2;
/org.eclipse.pde.ui/src/org/eclipse/pde/internal/ui/wizards/IProjectProvider.java;2;1;2;1;2;2;2;0;6;0;0;5204;6;6;1;0;0;0;2;5204;0;6336;2;2;
/org.eclipse.jdt.ui.tests.refactoring/resources/ExtractInterface/testConstant85/out/A.java;1;0;1;1;0;0;0;1;6;0;1;1166;6;6;1;0;0;1;1;1166;0;1166;1;1;
/org.eclipse.debug.core/core/org/eclipse/debug/internal/core/memory/IMemoryBlockManager.java;1;0;1;1;1;1;1;0;0;0;0;5254;0;0;1;0;0;0;1;5254;0;5254;1;1;
/org.eclipse.jdt.ui/ui/org/eclipse/jdt/internal/ui/text/java/JavaAutoIndentStrategy.java;5;2;44;1;8;6;8;36;539;3;32;583;3097;3097;3;4;2;36;44;1250;6;6340;38;5;
/org.eclipse.compare/compare/org/eclipse/compare/internal/AddFromHistoryDialog.java;1;1;7;1;2;2;2;5;11;1;5;996;32;32;1;0;0;5;7;996;0;6354;7;1;
/org.eclipse.jdt.core.tests.model/workspace/Converter/src/test0146/Test.java;1;0;1;1;0;0;0;1;0;0;1;3714;0;0;1;0;0;1;1;3714;0;3714;1;1;
/org.eclipse.pde.ui/src/org/eclipse/pde/internal/ui/editor/manifest/DetailExtensionSection.java;2;1;12;1;2;2;2;10;9;1;10;368;51;51;1;0;0;10;12;368;0;5431;12;2;
/org.eclipse.jdt.ui/core refactoring/org/eclipse/ltk/core/refactoring/participants/ProcessorBasedRefactoring.java;1;0;3;1;0;0;0;3;38;1;3;4688;38;38;1;0;0;3;3;4688;0;4864;3;1;
/org.eclipse.ant.ui/Ant Editor/org/eclipse/ant/internal/ui/editor/model/AntTaskNode.java;1;0;11;1;2;1;2;9;24;1;9;3661;127;127;2;0;1;9;11;5920;1;5920;10;1;
/org.eclipse.core.boot/src/org/eclipse/core/internal/boot/PlatformConfiguration.java;1;0;5;1;0;0;0;5;77;1;5;1714;243;243;1;0;0;5;5;1714;0;3013;5;1;
/org.eclipse.team.ui/src/org/eclipse/team/ui/synchronize/presentation/UnchangedResourceDiffNode.java;1;0;1;1;0;0;0;1;0;0;1;4077;0;0;1;0;0;1;1;4077;0;4077;1;1;
/org.eclipse.jdt.core.tests.model/workspace/JavaSearch/src/e8/A.java;1;0;1;1;0;0;0;1;0;0;1;2000;0;0;1;0;0;1;1;2000;0;2000;1;1;
/org.eclipse.swt/Eclipse SWT/win32/org/eclipse/swt/widgets/Label.java;3;1;5;1;3;3;3;2;16;1;2;957;30;30;1;0;0;2;5;957;0;6352;5;3;
/org.eclipse.jdt.ui/ui/org/eclipse/jdt/internal/ui/search/JavaSearchEditorOpener.java;2;1;5;1;5;5;5;0;16;0;0;5460;27;27;1;0;0;0;5;5460;0;6340;5;2;
/org.eclipse.ui.views/src/org/eclipse/ui/views/internal/markers/DialogTaskProperties.java;1;0;2;1;0;0;0;2;0;0;1;749;0;0;2;1;0;2;2;749;1;749;1;1;
/org.eclipse.jdt.junit/src/org/eclipse/jdt/internal/junit/ui/JUnitQuickFixProcessor.java;2;0;4;1;1;1;1;3;29;1;3;1249;33;33;1;0;0;3;4;1249;0;6340;4;2;
/org.eclipse.jdt.ui.tests.refactoring/resources/ExtractMethodWorkSpace/ExtractMethodTests/locals_in/A_test527.java;1;0;2;1;0;0;0;2;4;1;2;130;6;6;1;0;0;2;2;130;0;844;2;1;
/org.eclipse.core.resources/src/org/eclipse/core/internal/resources/WorkspaceTreeReader.java;1;0;1;1;1;1;1;0;462;0;0;5146;462;462;1;0;0;0;1;5146;0;5146;1;1;
/org.eclipse.jdt.ui/ui/org/eclipse/jdt/internal/ui/JavaElementAdapterFactory.java;2;0;2;1;1;1;1;1;2;0;1;1336;4;4;1;0;0;1;2;1336;0;6340;2;2;
/org.eclipse.swt/Eclipse SWT/win32/org/eclipse/swt/widgets/Monitor.java;2;0;3;2;0;0;0;3;17;2;2;13;17;17;2;1;0;3;3;13;1;33;2;2;
/org.eclipse.jdt.ui/ui/org/eclipse/jdt/internal/ui/wizards/dialogfields/SelectionButtonDialogField.java;3;1;3;1;2;2;2;1;12;0;1;1446;16;16;1;0;0;1;3;1446;0;6340;3;3;
/org.eclipse.jdt.debug.ui/ui/org/eclipse/jdt/internal/debug/ui/propertypages/PropertyPageMessages.java;2;0;2;1;0;0;0;2;10;1;2;1358;10;10;1;0;0;2;2;1358;0;1435;2;2;
/org.eclipse.ui.workbench/Eclipse UI/org/eclipse/ui/internal/commands/ImageBindingElement.java;1;0;2;1;0;0;0;2;0;1;2;1244;0;0;1;0;0;2;2;1244;0;1321;2;1;
/org.eclipse.debug.ui/ui/org/eclipse/debug/ui/actions/LaunchAction.java;2;1;2;1;2;2;2;0;4;0;0;5207;6;6;1;0;0;0;2;5207;0;6336;2;2;
/org.eclipse.jdt.debug.ui/ui/org/eclipse/jdt/internal/debug/ui/classpath/ClasspathLabelProvider.java;2;0;3;1;0;0;0;3;3;1;3;2691;5;5;1;0;0;3;3;2691;0;4899;3;2;
/org.eclipse.core.tests.resources/src/org/eclipse/core/tests/resources/IFileTest.java;2;0;5;1;2;1;2;3;1651;1;3;447;1720;1720;2;0;1;3;5;5147;1;5147;4;2;
/org.eclipse.jdt.ui.tests.refactoring/resources/IntroduceFactory/Bugzilla/46373/ImplicitCtor.java;1;0;2;1;1;1;1;1;2;0;1;2846;2;2;1;0;0;1;2;2846;0;5659;2;1;
/org.eclipse.jdt.core.tests.model/workspace/Converter/src/test0537/B.java;1;0;1;1;0;0;0;1;0;0;1;3873;0;0;1;0;0;1;1;3873;0;3873;1;1;
/org.eclipse.jdt.ui/ui/org/eclipse/jdt/ui/actions/JavaSearchActionGroup.java;3;1;5;1;2;2;2;3;54;1;3;3216;87;87;1;0;0;3;5;3216;0;6340;5;3;
/org.eclipse.jdt.ui.tests.refactoring/resources/ExtractMethodWorkSpace/ExtractMethodTests/invalidSelection/A_test192.java;1;0;1;1;0;0;0;1;12;0;1;1444;12;12;1;0;0;1;1;1444;0;1444;1;1;
/org.eclipse.jdt.ui.tests.refactoring/resources/SefWorkSpace/SefTests/base_in/TestTwoFragments.java;1;0;1;1;0;0;0;1;0;0;1;4692;0;0;1;0;0;1;1;4692;0;4692;1;1;
/org.eclipse.ui.workbench/Eclipse UI/org/eclipse/ui/IWorkbenchSite.java;2;0;3;1;0;0;0;3;12;1;3;1;19;19;1;0;0;3;3;1;0;2897;3;2;
/org.eclipse.update.tests.core/src/org/eclipse/update/tests/parser/TestSiteParse.java;2;0;4;1;1;1;1;3;4;1;3;1674;16;16;1;0;0;3;4;1674;0;6336;4;2;
/org.eclipse.swt/Eclipse SWT PI/win32/org/eclipse/swt/internal/win32/OSVERSIONINFOA.java;2;0;2;1;0;0;0;2;1;1;2;957;1;1;1;0;0;2;2;957;0;2915;2;2;
/org.eclipse.swt/Eclipse SWT/carbon/org/eclipse/swt/widgets/Text.java;7;1;34;2;5;5;5;29;84;2;25;17;520;520;2;4;0;29;34;78;4;6352;30;7;
/org.eclipse.ant.ui/Ant Tools Support/org/eclipse/ant/internal/ui/preferences/AntContentProvider.java;1;0;2;1;0;0;0;2;2;0;1;1935;2;2;2;1;0;2;2;1935;1;1935;1;1;
/org.eclipse.team.cvs.core/src/org/eclipse/team/internal/ccvs/core/subscribers/CVSRevisionNumberCompareCriteria.java;1;0;1;1;0;0;0;1;0;0;1;1427;0;0;1;0;0;1;1;1427;0;1427;1;1;
/org.eclipse.jdt.core.tests.model/workspace/Formatter/test421/A_in.java;1;0;1;1;0;0;0;1;0;0;1;3475;0;0;1;0;0;1;1;3475;0;3475;1;1;
/org.eclipse.jdt.debug/model/org/eclipse/jdt/internal/debug/core/breakpoints/JavaStratumLineBreakpoint.java;4;1;11;1;4;4;4;7;146;1;7;805;312;312;1;0;0;7;11;805;0;6336;11;4;
/org.eclipse.ui.examples.javaeditor/Eclipse Java Editor Example/org/eclipse/ui/examples/javaeditor/java/JavaCodeScanner.java;1;0;1;1;1;1;1;0;2;0;0;6340;2;2;1;0;0;0;1;6340;0;6340;1;1;
/org.eclipse.jdt.core/model/org/eclipse/jdt/internal/core/Initializer.java;2;0;12;1;1;1;1;11;20;2;10;916;81;81;2;1;0;11;12;1089;1;5584;11;2;
/org.eclipse.ui.examples.job/src/org/eclipse/ui/examples/jobs/actions/CreateJobsAction.java;3;1;3;1;3;3;3;0;26;0;0;5126;28;28;1;0;0;0;3;5126;0;6077;3;3;
/org.eclipse.webdav/src/interface/org/eclipse/webdav/dom/MultiStatus.java;1;0;2;1;2;1;2;0;223;0;0;5151;223;223;2;0;1;0;2;5151;1;5151;1;1;
/org.eclipse.jdt.core/model/org/eclipse/jdt/internal/core/BasicCompilationUnit.java;2;0;4;1;0;0;0;4;55;1;4;1790;62;62;1;0;0;4;4;1790;0;4711;4;2;
/org.eclipse.update.ui/src/org/eclipse/update/internal/ui/views/ConfigurationPreview.java;3;1;8;1;2;2;2;6;183;1;6;825;208;208;1;0;0;6;8;825;0;6336;8;3;
/org.eclipse.ui.workbench/Eclipse UI/org/eclipse/ui/commands/internal/StatusLineContributionItem.java;1;0;4;1;0;0;0;4;13;2;3;774;21;21;2;1;0;4;4;774;1;956;3;1;
/org.eclipse.jdt.ui.tests.refactoring/resources/ExtractTemp/cannotExtract/A_testFail33.java;1;0;1;1;0;0;0;1;0;0;1;1575;0;0;1;0;0;1;1;1575;0;1575;1;1;
/org.eclipse.core.resources/src/org/eclipse/core/internal/watson/DefaultElementComparator.java;1;0;1;1;1;1;1;0;76;0;0;5146;76;76;1;0;0;0;1;5146;0;5146;1;1;
/org.eclipse.jdt.ui/ui refactoring/org/eclipse/jdt/internal/ui/refactoring/contentassist/CUPositionCompletionProcessor.java;2;1;3;1;3;3;3;0;3;0;0;5731;5;5;1;0;0;0;3;5731;0;6340;3;2;
/org.eclipse.ui.internal.r21presentation/src/org/eclipse/ui/internal/r21presentation/presentations/R21EditorStackPresentation.java;6;2;16;2;16;14;16;0;1156;0;0;5275;1555;1555;2;0;2;0;16;5381;2;6227;14;6;
/org.eclipse.ui.workbench.texteditor/src/org/eclipse/ui/texteditor/DefaultRangeIndicatorPresentation.java;1;0;1;1;0;0;0;1;0;0;1;2243;0;0;1;0;0;1;1;2243;0;2243;1;1;
/org.eclipse.ui.workbench/Eclipse UI/org/eclipse/ui/internal/commands/old/KeySupport.java;1;0;2;1;0;0;0;2;0;1;2;1322;0;0;1;0;0;2;2;1322;0;1695;2;1;
/org.eclipse.pde.ui/src_Forms/org/eclipse/pde/internal/ui/model/DocumentTextNode.java;3;2;6;1;6;5;6;0;38;0;0;5143;54;54;2;0;1;0;6;5160;1;6336;5;3;
/org.eclipse.ui.workbench/Eclipse UI/org/eclipse/ui/internal/EditorPane.java;6;2;18;1;11;10;11;7;51;2;6;2620;355;355;2;1;1;7;18;4517;2;6338;16;6;
/org.eclipse.pde.ui/templates/editor/java/XMLPartitionScanner.java;1;0;1;1;0;0;0;1;10;0;1;851;10;10;1;0;0;1;1;851;0;851;1;1;
/org.eclipse.team.ui/src/org/eclipse/team/ui/UIProjectSetSerializationContext.java;2;0;3;1;1;1;1;2;108;1;2;4857;108;108;1;0;0;2;3;4857;0;5362;3;2;
/org.eclipse.ui.workbench/Eclipse UI/org/eclipse/ui/internal/PinEditorAction.java;3;0;4;1;1;1;1;3;151;1;3;2737;162;162;1;0;0;3;4;2737;0;6338;4;3;
/org.eclipse.ui.cheatsheets/src/org/eclipse/ui/internal/cheatsheets/views/ViewItem.java;2;3;29;2;15;11;15;14;579;2;11;4428;1418;1418;3;3;4;14;29;5380;7;5944;22;2;
/org.eclipse.ui.workbench/Eclipse UI/org/eclipse/ui/commands/IActionServiceListener.java;1;0;9;1;0;0;0;9;15;2;7;772;22;22;2;2;0;9;9;1064;2;3258;7;1;
/org.eclipse.osgi/core/framework/org/eclipse/osgi/framework/internal/core/ServiceUse.java;5;3;11;2;6;4;6;5;565;1;5;3013;672;672;3;0;2;5;11;5109;2;6151;9;5;
/org.eclipse.team.ui/src/org/eclipse/team/internal/ui/jobs/RefreshSchedule.java;1;0;1;1;0;0;0;1;0;0;1;3436;0;0;1;0;0;1;1;3436;0;3436;1;1;
/org.eclipse.ui.workbench/Eclipse UI/org/eclipse/ui/internal/dialogs/PathVariableSelectionDialog.java;1;0;1;1;0;0;0;1;0;0;1;2737;0;0;1;0;0;1;1;2737;0;2737;1;1;
/org.eclipse.jdt.ui.tests.refactoring/resources/MoveMembers/test23/out/B.java;1;0;1;1;0;0;0;1;1;0;1;1522;1;1;1;0;0;1;1;1522;0;1522;1;1;
/org.eclipse.jdt.ui.tests/examples/org/eclipse/jdt/ui/examples/MyQuickAssistProcessor.java;2;1;5;1;2;2;2;3;128;1;3;4794;141;141;1;0;0;3;5;4794;0;6340;5;2;
/org.eclipse.osgi/resolver/src/org/eclipse/core/internal/dependencies/Assert.java;3;1;4;1;3;3;3;1;52;0;1;3013;56;56;1;0;0;1;4;3013;0;5529;4;3;
/org.eclipse.team.ui/src/org/eclipse/team/internal/ui/sync/views/SyncSetChangedEvent.java;1;0;3;1;0;0;0;3;157;1;3;488;157;157;1;0;0;3;3;488;0;1354;3;1;
/org.eclipse.jdt.text.tests/src/org/eclipse/jdt/ui/text/tests/ComilationUnitDocumentProviderTest.java;1;0;2;1;1;1;1;1;0;0;1;5082;0;0;1;0;0;1;2;5082;0;5129;2;1;
/org.eclipse.jdt.ui.tests.refactoring/resources/ExtractMethodWorkSpace/ExtractMethodTests/expression_in/A_test606.java;1;0;1;1;0;0;0;1;2;0;1;844;2;2;1;0;0;1;1;844;0;844;1;1;
/org.eclipse.jdt.ui.tests.refactoring/resources/RenameTemp/canRename/A_test0_in.java;1;0;1;1;0;0;0;1;4;0;1;4605;4;4;1;0;0;1;1;4605;0;4605;1;1;
/org.eclipse.update.ui/src/org/eclipse/update/internal/ui/search/SearchCategoryDescriptor.java;1;0;1;1;0;0;0;1;0;0;1;824;0;0;1;0;0;1;1;824;0;824;1;1;
/org.eclipse.jdt.ui/ui/org/eclipse/jdt/internal/ui/reorg/JdtMoveAction.java;2;0;5;1;0;0;0;5;4;1;5;130;10;10;1;0;0;5;5;130;0;1111;5;2;
/org.eclipse.jdt.core.tests.model/workspace/Formatter/test417/A_in.java;1;0;1;1;0;0;0;1;0;0;1;3461;0;0;1;0;0;1;1;3461;0;3461;1;1;
/org.eclipse.jdt.core/compiler/org/eclipse/jdt/internal/compiler/ast/AnnotationReturnStatement.java;1;0;3;1;0;0;0;3;9;1;3;2397;9;9;1;0;0;3;3;2397;0;2887;3;1;
/org.eclipse.jdt.core.tests.builder/src/org/eclipse/jdt/core/tests/builder/IncrementalTests.java;2;0;4;1;0;0;0;4;76;1;4;989;104;104;1;0;0;4;4;989;0;3560;4;2;
/org.eclipse.update.ui.forms/src/org/eclipse/update/ui/forms/internal/engine/HyperlinkSegment.java;1;0;2;1;0;0;0;2;15;1;2;480;27;27;1;0;0;2;2;480;0;489;2;1;
/org.eclipse.jdt.ui.tests/ui/org/eclipse/jdt/ui/tests/core/ProjectTestSetup.java;2;1;6;1;3;3;3;3;20;1;3;803;49;49;1;0;0;3;6;803;0;6340;6;2;
/org.eclipse.jdt.debug.ui/ui/org/eclipse/jdt/internal/debug/ui/actions/JavaBreakpointPreferencePage.java;2;0;3;1;0;0;0;3;7;1;3;134;12;12;1;0;0;3;3;134;0;1484;3;2;
/org.eclipse.team.cvs.core/src/org/eclipse/team/internal/ccvs/core/syncinfo/CVSRefreshOperation.java;2;0;4;1;0;0;0;4;120;2;3;3193;174;174;2;1;0;4;4;4233;1;4233;3;2;
/org.eclipse.ant.ui/Ant Tools Support/org/eclipse/ant/internal/ui/preferences/AntPreferencePage.java;1;0;8;1;1;1;1;7;158;2;6;1811;385;385;2;1;0;7;8;2139;1;5700;7;1;
/org.eclipse.core.resources/src/org/eclipse/core/internal/indexing/ObjectStorePagePolicy.java;1;0;2;1;2;1;2;0;6;0;0;5146;6;6;2;0;1;0;2;5146;1;5146;1;1;
/org.eclipse.core.runtime.compatibility/src-runtime/org/eclipse/core/runtime/Plugin.java;3;0;5;1;0;0;0;5;42;1;5;3013;59;59;1;0;0;5;5;3013;0;3169;5;3;
/org.eclipse.jdt.core/codeassist/org/eclipse/jdt/internal/codeassist/select/SelectionOnSingleTypeReference.java;2;0;2;1;0;0;0;2;8;1;2;991;10;10;1;0;0;2;2;991;0;3560;2;2;
/org.eclipse.osgi/osgi/src/org/osgi/service/packageadmin/ExportedPackage.java;2;0;2;1;1;1;1;1;3;0;1;3013;3;3;1;0;0;1;2;3013;0;5536;2;2;
/org.eclipse.jdt.core.tests.model/workspace/Converter/src/test0225/Test.java;1;0;1;1;0;0;0;1;0;0;1;3714;0;0;1;0;0;1;1;3714;0;3714;1;1;
/org.eclipse.ui.editors/src/org/eclipse/ui/internal/texteditor/AnnotationType.java;2;1;2;1;2;2;2;0;4;0;0;5177;4;4;1;0;0;0;2;5177;0;6340;2;2;
/org.eclipse.jdt.core/dom/org/eclipse/jdt/core/dom/Javadoc.java;3;1;15;1;3;3;3;12;123;1;12;3560;350;350;1;0;0;12;15;3560;0;5781;15;3;
/org.eclipse.ui.workbench/Eclipse UI/org/eclipse/ui/internal/commands/ExtensionCommandRegistry.java;3;1;16;2;3;3;3;13;220;2;12;2562;507;507;2;1;0;13;16;3170;1;6338;15;3;
/org.eclipse.jdt.core.tests.model/workspace/Formatter/test214/A_out.java;1;0;2;1;0;0;0;2;2;1;2;2426;2;2;1;0;0;2;2;2426;0;4173;2;1;
/org.eclipse.jdt.debug.ui/ui/org/eclipse/jdt/internal/debug/ui/launcher/JavaAppletTabGroup.java;3;0;4;2;1;1;1;3;10;2;2;4927;18;18;2;1;0;3;4;4927;1;6336;3;3;
/org.eclipse.jdt.core.tests.model/workspace/Formatter/test163/A_in.java;1;0;1;1;0;0;0;1;0;0;1;2425;0;0;1;0;0;1;1;2425;0;2425;1;1;
/org.eclipse.jdt.ui/core refactoring/org/eclipse/jdt/internal/corext/refactoring/surround/SurroundWithTryCatchRefactoring.java;5;1;33;1;5;5;5;28;281;2;27;122;523;523;2;1;0;28;33;1952;1;6340;32;5;
/org.eclipse.jdt.ui.tests.refactoring/resources/ExtractMethodWorkSpace/ExtractMethodTests/try_out/A_test450.java;1;0;1;1;0;0;0;1;4;0;1;844;4;4;1;0;0;1;1;844;0;844;1;1;
/org.eclipse.pde.core/src/org/eclipse/pde/core/plugin/IPluginReference.java;3;1;4;1;3;3;3;1;54;0;1;4203;66;66;1;0;0;1;4;4203;0;6336;4;3;
/org.eclipse.jdt.core/model/org/eclipse/jdt/internal/core/builder/QualifiedNameSet.java;3;0;4;2;1;1;1;3;67;2;2;2724;77;77;2;1;0;3;4;2724;1;5802;3;3;
/org.eclipse.ui.views/src/org/eclipse/ui/views/tasklist/TaskListContentProvider.java;1;0;1;1;0;0;0;1;0;0;1;2738;0;0;1;0;0;1;1;2738;0;2738;1;1;
/org.eclipse.team.ui/src/org/eclipse/team/internal/ui/target/GetAsAction.java;2;0;2;1;0;0;0;2;2;1;2;990;2;2;1;0;0;2;2;990;0;2495;2;2;
/org.eclipse.ui.presentations.r21/src/org/eclipse/ui/internal/presentations/R21ViewStackPresentation.java;1;0;1;1;1;1;1;0;0;0;0;6075;0;0;1;0;0;0;1;6075;0;6075;1;1;
/org.eclipse.jdt.ui.tests.refactoring/resources/ExtractConstant/nameGuessing/testGuessStringLiteral0.java;1;0;1;1;0;0;0;1;0;0;1;1191;0;0;1;0;0;1;1;1191;0;1191;1;1;
/org.eclipse.pde.ui/src_Forms/org/eclipse/pde/internal/ui/neweditor/PDEMasterDetailsBlock.java;2;0;8;1;1;1;1;7;6;1;7;3812;18;18;1;0;0;7;8;3812;0;5431;8;2;
/org.eclipse.jdt.core/compiler/org/eclipse/jdt/internal/compiler/ast/LongLiteralMinValue.java;1;0;1;1;0;0;0;1;2;0;1;3560;2;2;1;0;0;1;1;3560;0;3560;1;1;
/org.eclipse.jdt.ui/ui/org/eclipse/jdt/ui/wizards/NewPackageWizardPage.java;2;2;5;2;3;2;3;2;15;1;2;451;27;27;2;0;1;2;5;6334;1;6334;4;2;
/org.eclipse.jface.text/src/org/eclipse/jface/text/templates/persistence/TemplatePersistenceData.java;2;1;4;1;2;2;2;2;11;1;2;4627;20;20;1;0;0;2;4;4627;0;6353;4;2;
/org.eclipse.ui.workbench/Eclipse UI/org/eclipse/ui/internal/presentations/SystemMenuSizeFastView.java;2;0;3;1;1;1;1;2;2;1;2;4680;4;4;1;0;0;2;3;4680;0;5173;3;2;
/org.eclipse.jdt.debug/model/org/eclipse/jdt/internal/debug/core/logicalstructures/LogicalObjectStructureType.java;1;0;4;1;0;0;0;4;24;2;3;2647;30;30;2;1;0;4;4;2647;1;2709;3;1;
/org.eclipse.jdt.core/compiler/org/eclipse/jdt/internal/compiler/ast/ReturnStatement.java;2;0;4;1;0;0;0;4;419;1;4;148;459;459;1;0;0;4;4;148;0;3560;4;2;
/org.eclipse.jdt.ui.tests.refactoring/resources/Copy/test_field_yes_field/out/A.java;1;0;1;1;0;0;0;1;0;0;1;685;0;0;1;0;0;1;1;685;0;685;1;1;
/org.eclipse.swt/Eclipse SWT/gtk/org/eclipse/swt/widgets/Text.java;7;1;45;2;4;4;4;41;107;2;35;110;764;764;2;6;0;41;45;1277;6;6352;39;7;
/org.eclipse.update.ui/src/org/eclipse/update/internal/ui/wizards/UnifiedSitePage.java;1;0;2;1;0;0;0;2;0;1;2;201;0;0;1;0;0;2;2;201;0;329;2;1;
/org.eclipse.update.core/src/org/eclipse/update/internal/core/MultiDownloadManager.java;1;0;4;1;0;0;0;4;10;1;4;965;12;12;1;0;0;4;4;965;0;3012;4;1;
/org.eclipse.pde.ui/src/org/eclipse/pde/internal/ui/editor/build/BuildClasspathSection.java;3;1;20;1;8;8;8;12;244;2;11;1727;938;938;2;1;0;12;20;1746;1;6336;19;3;
/org.eclipse.swt/Eclipse SWT PI/win32/org/eclipse/swt/internal/win32/MOUSEINPUT.java;2;0;2;1;1;1;1;1;4;0;1;4632;4;4;1;0;0;1;2;4632;0;6352;2;2;
/org.eclipse.jdt.core.tests.model/workspace/Formatter/test158/A_out.java;2;0;2;1;0;0;0;2;2;1;2;2425;2;2;1;0;0;2;2;2425;0;3362;2;2;
/org.eclipse.ui.workbench/Eclipse UI/org/eclipse/ui/internal/contexts/registry/AbstractMutableRegistry.java;1;0;2;1;0;0;0;2;0;0;1;1396;0;0;2;1;0;2;2;1396;1;1396;1;1;
/org.eclipse.team.ui/src/org/eclipse/team/internal/ui/synchronize/compare/LocalResourceTypedElement.java;1;0;3;1;0;0;0;3;154;1;3;2535;154;154;1;0;0;3;3;2535;0;4216;3;1;
/org.eclipse.jdt.ui/core refactoring/org/eclipse/jdt/internal/corext/refactoring/participants/IRefactoringProcessor.java;1;0;8;1;0;0;0;8;7;1;8;825;25;25;1;0;0;8;8;825;0;4624;8;1;
/org.eclipse.jdt.ui/ui/org/eclipse/jdt/internal/ui/reorg/TypedSource.java;1;0;2;1;0;0;0;2;84;1;2;490;84;84;1;0;0;2;2;490;0;1112;2;1;
/org.eclipse.jdt.ui.tests.refactoring/resources/Delete/testDeleteWithinCu3/out/A.java;1;0;1;1;0;0;0;1;0;0;1;442;0;0;1;0;0;1;1;442;0;442;1;1;
/org.eclipse.jdt.debug.ui/ui/org/eclipse/jdt/internal/debug/ui/JavaUtilMapObjectBrowser.java;3;0;4;1;0;0;0;4;7;1;4;861;12;12;1;0;0;4;4;861;0;2647;4;3;
/org.eclipse.jdt.core.tests.compiler/src/org/eclipse/jdt/core/tests/util/VerifyTests.java;2;0;3;1;0;0;0;3;13;2;2;2005;15;15;2;1;0;3;3;2005;1;3560;2;2;
/org.eclipse.team.cvs.core/src/org/eclipse/team/internal/ccvs/core/client/Editors.java;1;0;1;1;0;0;0;1;7;0;1;4758;7;7;1;0;0;1;1;4758;0;4758;1;1;
/org.eclipse.jdt.core/dom/org/eclipse/jdt/core/dom/SuperMethodInvocation.java;3;2;11;1;4;3;4;7;127;1;7;3560;291;291;2;0;1;7;11;5268;1;5335;10;3;
/org.eclipse.ui.workbench.texteditor/src/org/eclipse/ui/texteditor/DocumentProviderRegistry.java;1;0;1;1;0;0;0;1;0;0;1;2741;0;0;1;0;0;1;1;2741;0;2741;1;1;
/org.eclipse.jdt.debug.tests/tests/org/eclipse/jdt/debug/tests/eval/LocalVarAssignmentTests.java;1;0;1;1;0;0;0;1;18;0;1;1274;18;18;1;0;0;1;1;1274;0;1274;1;1;
/org.eclipse.jdt.core.tests.model/workspace/Converter/src/test0167/Test.java;1;0;1;1;0;0;0;1;0;0;1;3714;0;0;1;0;0;1;1;3714;0;3714;1;1;
/org.eclipse.search/search/org/eclipse/search/internal/ui/util/TypeFilteringDialog.java;1;0;1;1;1;1;1;0;2;0;0;6340;2;2;1;0;0;0;1;6340;0;6340;1;1;
/org.eclipse.jdt.core.tests.model/workspace/Converter/test0057/Test.java;1;0;1;1;0;0;0;1;0;0;1;3714;0;0;1;0;0;1;1;3714;0;3714;1;1;
/org.eclipse.team.ui/src/org/eclipse/team/internal/ui/TeamCapabilityHelper.java;1;1;4;1;4;4;4;0;53;0;0;6082;95;95;1;0;0;0;4;6082;0;6337;4;1;
/org.eclipse.pde.ui/src_Forms/org/eclipse/pde/internal/ui/neweditor/schema/NoRestrictionPage.java;1;0;2;1;0;0;0;2;0;1;2;4856;0;0;1;0;0;2;2;4856;0;4879;2;1;
/org.eclipse.pde.ui/src/org/eclipse/pde/internal/ui/parts/StructuredViewerPart.java;1;1;2;1;2;2;2;0;46;0;0;5431;50;50;1;0;0;0;2;5431;0;6336;2;1;
/org.eclipse.ant.tests.ui/Ant Editor Tests/org/eclipse/ant/ui/internal/editor/support/TestLocationProvider.java;1;0;2;1;0;0;0;2;0;1;2;1274;0;0;1;0;0;2;2;1274;0;1811;2;1;
/org.eclipse.jdt.core/compiler/org/eclipse/jdt/core/compiler/IProblem.java;4;1;32;1;6;6;6;26;79;2;23;13;494;494;2;3;0;26;32;1088;3;5853;29;4;
/org.eclipse.jdt.core/model/org/eclipse/jdt/internal/core/JavaProject.java;5;1;86;2;9;9;9;77;322;3;60;13;3245;3245;3;17;0;77;86;1806;17;6079;69;5;
/org.eclipse.jdt.ui/core refactoring/org/eclipse/jdt/internal/corext/refactoring/participants/RenamePackageProcessor.java;2;0;4;1;0;0;0;4;10;1;4;825;14;14;1;0;0;4;4;825;0;1125;4;2;
/org.eclipse.jdt.ui.tests.refactoring/resources/InlineMethodWorkspace/TestCases/cast_out/TestOverloadedPrimitives.java;1;0;1;1;0;0;0;1;0;0;1;955;0;0;1;0;0;1;1;955;0;955;1;1;
/org.eclipse.jdt.ui.tests.refactoring/resources/MoveMembers/test25/out/B.java;1;0;1;1;0;0;0;1;1;0;1;1522;1;1;1;0;0;1;1;1522;0;1522;1;1;
/org.eclipse.jdt.ui/ui refactoring/org/eclipse/jdt/internal/ui/refactoring/reorg/ReorgCopyAction.java;3;0;7;1;1;1;1;6;24;1;6;1114;53;53;1;0;0;6;7;1114;0;6340;7;3;
/org.eclipse.ui.ide/src/org/eclipse/ui/wizards/datatransfer/PopulateRootOperation.java;1;0;1;1;0;0;0;1;0;0;1;1511;0;0;1;0;0;1;1;1511;0;1511;1;1;
/org.eclipse.jface/src/org/eclipse/jface/dialogs/Dialog.java;4;1;23;1;11;11;11;12;708;2;10;1;1158;1158;2;2;0;12;23;1671;2;6338;21;4;
/org.eclipse.ant.ui/Ant Tools Support/org/eclipse/ant/internal/ui/console/TaskLineTracker.java;3;0;5;1;0;0;0;5;12;1;5;1811;26;26;1;0;0;5;5;1811;0;2499;5;3;
/org.eclipse.team.core/src/org/eclipse/team/core/sync/SyncTreeSubscriber.java;1;0;1;1;0;0;0;1;0;0;1;488;0;0;1;0;0;1;1;488;0;488;1;1;
/org.eclipse.update.core/src/org/eclipse/update/core/model/ModelObject.java;2;2;6;1;5;4;5;1;21;0;1;890;56;56;2;0;1;1;6;5664;1;6336;5;2;
/org.eclipse.ui.workbench/Eclipse UI/org/eclipse/ui/internal/PerspectiveHistory.java;2;0;2;1;1;1;1;1;9;0;1;3500;11;11;1;0;0;1;2;3500;0;6338;2;2;
/org.eclipse.jdt.launching.macosx/macosx/org/eclipse/jdt/internal/launching/macosx/MacOSXVMInstall.java;1;0;1;1;0;0;0;1;2;0;1;3622;2;2;1;0;0;1;1;3622;0;3622;1;1;
/org.eclipse.swt/Eclipse SWT/gtk1x/org/eclipse/swt/widgets/Table.java;2;0;2;1;0;0;0;2;8;1;2;110;8;8;1;0;0;2;2;110;0;2327;2;2;
/org.eclipse.pde/src/org/eclipse/pde/internal/builders/CompilerFlags.java;2;1;7;1;2;2;2;5;32;1;5;910;63;63;1;0;0;5;7;910;0;6336;7;2;
/org.eclipse.jdt.ui.tests.refactoring/resources/InlineMethodWorkspace/TestCases/import_in/TestUseInDecl3.java;1;0;1;1;0;0;0;1;0;0;1;788;0;0;1;0;0;1;1;788;0;788;1;1;
/org.eclipse.team.cvs.ui/src/org/eclipse/team/internal/ccvs/ui/HistoryView.java;2;1;27;1;5;5;5;22;135;2;20;243;1019;1019;2;2;0;22;27;2040;2;6337;25;2;
/org.eclipse.ui.workbench/Eclipse UI/org/eclipse/ui/internal/commands/util/old/Stroke.java;1;0;2;1;0;0;0;2;0;1;2;1222;0;0;1;0;0;2;2;1222;0;1322;2;1;
/org.eclipse.debug.ui/ui/org/eclipse/debug/internal/ui/views/memory/HexRenderingFactory.java;1;0;1;1;1;1;1;0;0;0;0;5254;0;0;1;0;0;0;1;5254;0;5254;1;1;
/org.eclipse.core.filebuffers/src/org/eclipse/core/filebuffers/IFileBuffer.java;2;1;13;1;3;3;3;10;69;1;10;1522;207;207;1;0;0;10;13;1522;0;6340;13;2;
/org.eclipse.ui.externaltools/Ant Editor/org/eclipse/ui/externaltools/internal/ant/editor/tools/AntEditorToolsMessages.java;1;0;1;1;0;0;0;1;0;0;1;282;0;0;1;0;0;1;1;282;0;282;1;1;
/org.eclipse.team.core/src/org/eclipse/team/core/variants/ResourceVariantTreeSubscriber.java;2;1;5;1;4;4;4;1;10;0;1;4349;23;23;1;0;0;1;5;4349;0;6125;5;2;
/org.eclipse.update.ui/src/org/eclipse/update/internal/ui/views/SearchResultView.java;1;0;1;1;0;0;0;1;0;0;1;755;0;0;1;0;0;1;1;755;0;755;1;1;
/org.eclipse.jdt.core.tests.model/workspace/Converter/src/test0095/Test.java;1;0;1;1;0;0;0;1;0;0;1;3714;0;0;1;0;0;1;1;3714;0;3714;1;1;
/org.eclipse.jdt.core/eval/org/eclipse/jdt/internal/eval/CodeSnippetConstantPool.java;3;0;4;1;1;1;1;3;314;1;3;662;608;608;1;0;0;3;4;662;0;5916;4;3;
/org.eclipse.ui.workbench/Eclipse UI/org/eclipse/ui/internal/commands/ActivityBindingDefinition.java;1;0;3;1;0;0;0;3;75;1;3;2562;75;75;1;0;0;3;3;2562;0;3128;3;1;
/org.eclipse.ui.workbench/Eclipse UI/org/eclipse/ui/testing/ITestHarness.java;1;0;2;1;0;0;0;2;26;1;2;2246;26;26;1;0;0;2;2;2246;0;2737;2;1;
/org.eclipse.core.tests.resources/src/org/eclipse/core/tests/internal/builders/AbstractBuilderTest.java;2;2;6;2;4;2;4;2;462;1;2;1098;690;690;2;0;2;2;6;5147;2;5992;4;2;
/org.eclipse.pde.ui/src/org/eclipse/pde/internal/ui/search/JavaSearchCollector.java;2;1;2;1;2;2;2;0;6;0;0;5782;8;8;1;0;0;0;2;5782;0;6336;2;2;
/org.eclipse.team.ui/src/org/eclipse/team/ui/synchronize/subscribers/GlobalRefreshSchedulePage.java;1;0;2;1;1;1;1;1;0;0;1;4649;0;0;1;0;0;1;2;4649;0;5362;2;1;
/org.eclipse.ui.intro/src/org/eclipse/ui/internal/intro/impl/model/IntroStandbyPart.java;1;2;3;1;3;2;3;0;2;0;0;5305;2;2;2;0;1;0;3;5314;1;5314;2;1;
/org.eclipse.jdt.core.tests.model/workspace/Converter/test0315/Test.java;1;0;1;1;0;0;0;1;0;0;1;3714;0;0;1;0;0;1;1;3714;0;3714;1;1;
/org.eclipse.jdt.ui.examples.javafamily/coresearch-experiment/org/eclipse/search/internal/core/AndQuery.java;1;0;2;1;0;0;0;2;0;1;2;1380;0;0;1;0;0;2;2;1380;0;3214;2;1;
/org.eclipse.ui.workbench/Eclipse UI/org/eclipse/ui/internal/IntModel.java;3;0;3;1;0;0;0;3;41;1;3;3692;51;51;1;0;0;3;3;3692;0;4116;3;3;
/org.eclipse.jdt.ui/ui/org/eclipse/jdt/internal/ui/search/FilterAction.java;1;2;3;1;3;2;3;0;4;0;0;5396;4;4;2;0;1;0;3;6140;1;6140;2;1;
/org.eclipse.ui.workbench/Eclipse UI/org/eclipse/ui/internal/progress/ProgressLabelProvider.java;2;0;8;1;1;1;1;7;72;1;7;320;128;128;1;0;0;7;8;320;0;6338;8;2;
/org.eclipse.jdt.core.tests.model/workspace/Completion/src3/test0023/Test.java;1;0;1;1;1;1;1;0;0;0;0;5206;0;0;1;0;0;0;1;5206;0;5206;1;1;
/org.eclipse.jdt.core.tests.model/workspace/Converter/src/test0352/Test2.java;1;0;1;1;0;0;0;1;0;0;1;3714;0;0;1;0;0;1;1;3714;0;3714;1;1;
/org.eclipse.jdt.ui.tests.refactoring/resources/ChangeTypeRefactoring/positive/A_testParameterDecl_out.java;1;0;1;1;0;0;0;1;0;0;1;2844;0;0;1;0;0;1;1;2844;0;2844;1;1;
/org.eclipse.jdt.core.tests.model/workspace/Formatter/test210/A_out.java;1;0;1;1;0;0;0;1;0;0;1;2424;0;0;1;0;0;1;1;2424;0;2424;1;1;
/org.eclipse.update.configurator/src/org/eclipse/update/configurator/migration/IPluginInfo.java;2;0;2;1;0;0;0;2;0;1;2;3014;0;0;1;0;0;2;2;3014;0;3087;2;2;
/org.eclipse.jdt.core/model/org/eclipse/jdt/internal/core/BatchOperation.java;2;0;3;1;0;0;0;3;2;1;3;3034;6;6;1;0;0;3;3;3034;0;3560;3;2;
/org.eclipse.jdt.core.tests.model/workspace/Formatter/test385/A_in.java;1;0;1;1;0;0;0;1;0;0;1;3164;0;0;1;0;0;1;1;3164;0;3164;1;1;
/org.eclipse.jdt.debug.tests/tests/org/eclipse/jdt/debug/tests/core/InstanceVariableTests.java;2;2;5;1;4;3;4;1;90;0;1;2269;110;110;2;0;1;1;5;6036;1;6337;4;2;
/org.eclipse.swt/Eclipse SWT Custom Widgets/common/org/eclipse/swt/custom/TableTree.java;4;0;8;1;1;1;1;7;108;2;6;110;172;172;2;1;0;7;8;4371;1;6352;7;4;
/org.eclipse.jdt.ui.tests/ui/org/eclipse/jdt/ui/tests/UIInteractiveSuite.java;1;0;1;1;1;1;1;0;2;0;0;6340;2;2;1;0;0;0;1;6340;0;6340;1;1;
/org.eclipse.core.runtime/src/org/eclipse/core/runtime/jobs/IJobManager.java;3;1;36;1;5;5;5;31;489;2;30;320;1757;1757;2;1;0;31;36;1956;1;5688;35;3;
/org.eclipse.swt/Eclipse SWT PI/motif/org/eclipse/swt/internal/motif/XFontStruct.java;1;0;1;1;0;0;0;1;2;0;1;829;2;2;1;0;0;1;1;829;0;829;1;1;
/org.eclipse.ltk.ui.refactoring/src/org/eclipse/ltk/ui/refactoring/RedoRefactoringAction.java;1;1;2;1;2;2;2;0;2;0;0;5355;2;2;1;0;0;0;2;5355;0;6340;2;1;
/org.eclipse.jdt.ui.examples.javafamily/src/org/eclipse/jdt/internal/ui/examples/jspeditor/JspTranslatorResultCollector.java;1;0;2;1;1;1;1;1;2;0;1;1190;2;2;1;0;0;1;2;1190;0;5122;2;1;
/org.eclipse.core.runtime/src/org/eclipse/core/runtime/content/BinarySignatureDescriber.java;3;2;6;2;6;4;6;0;27;0;0;5231;58;58;2;0;2;0;6;5231;2;6125;4;3;
/org.eclipse.jdt.core/codeassist/org/eclipse/jdt/internal/codeassist/select/SelectionOnExplicitConstructorCall.java;2;0;2;1;0;0;0;2;66;1;2;991;68;68;1;0;0;2;2;991;0;3560;2;2;
/org.eclipse.help.base/src/org/eclipse/help/internal/base/IHelpActivitySupport.java;1;1;5;1;3;3;3;2;13;1;2;3319;32;32;1;0;0;2;5;3319;0;6337;5;1;
/org.eclipse.jdt.ui/ui/org/eclipse/jdt/internal/ui/reorg/DestinationContentProvider.java;1;0;2;1;0;0;0;2;0;1;2;802;0;0;1;0;0;2;2;802;0;1112;2;1;
/org.eclipse.update.ui.forms/src/org/eclipse/ui/forms/parts/IFormEntryListener.java;1;0;2;1;0;0;0;2;0;1;2;3071;0;0;1;0;0;2;2;3071;0;3096;2;1;
/org.eclipse.debug.ui/ui/org/eclipse/debug/ui/AbstractLaunchConfigurationTab.java;4;0;10;1;1;1;1;9;43;2;8;550;106;106;2;1;0;9;10;3112;1;6336;9;4;
/org.eclipse.jdt.core.tests.model/workspace/Formatter/test411/A_out.java;1;0;1;1;0;0;0;1;0;0;1;3460;0;0;1;0;0;1;1;3460;0;3460;1;1;
/org.eclipse.ui.ide/src/org/eclipse/ui/views/markers/internal/ActionShowOnBuild.java;2;0;3;1;0;0;0;3;5;1;3;2208;5;5;1;0;0;3;3;2208;0;5008;3;2;
/org.eclipse.osgi/osgi/src/org/osgi/service/url/AbstractURLStreamHandlerService.java;2;0;2;1;1;1;1;1;3;0;1;3013;3;3;1;0;0;1;2;3013;0;5536;2;2;
/org.eclipse.ui.workbench/Eclipse UI/org/eclipse/ui/internal/activities/AbstractActivityManager.java;1;0;4;1;0;0;0;4;21;1;4;2805;33;33;1;0;0;4;4;2805;0;2989;4;1;
/org.eclipse.core.tests.resources/src/org/eclipse/core/tests/internal/watson/ElementTreeDeltaChainTest.java;1;0;1;1;1;1;1;0;295;0;0;5147;295;295;1;0;0;0;1;5147;0;5147;1;1;
/org.eclipse.core.filebuffers/src/org/eclipse/core/internal/filebuffers/AnnotationModelManager.java;1;0;1;1;0;0;0;1;0;0;1;2815;0;0;1;0;0;1;1;2815;0;2815;1;1;
/org.eclipse.jdt.ui/ui/org/eclipse/jdt/internal/ui/text/correction/QuickAssistProcessor.java;1;1;39;1;5;5;5;34;110;2;30;88;1404;1404;2;4;0;34;39;1671;4;5891;35;1;
/org.eclipse.swt.tests/JUnit Tests/org/eclipse/swt/tests/junit/Test_org_eclipse_swt_ole_win32_Variant.java;1;0;1;1;0;0;0;1;0;0;1;2176;0;0;1;0;0;1;1;2176;0;2176;1;1;
/org.eclipse.jdt.debug.tests/tests/org/eclipse/jdt/debug/tests/core/MethodBreakpointTests.java;2;0;2;1;0;0;0;2;50;1;2;1274;60;60;1;0;0;2;2;1274;0;2167;2;2;
/org.eclipse.core.tests.runtime/src/org/eclipse/core/tests/internal/plugins/FragmentResolveTest_11.java;1;0;1;1;0;0;0;1;0;0;1;3014;0;0;1;0;0;1;1;3014;0;3014;1;1;
/org.eclipse.help.ui/src/org/eclipse/help/ui/internal/util/RuntimeErrorDialog.java;1;1;3;1;3;3;3;0;84;0;0;5592;92;92;1;0;0;0;3;5592;0;6337;3;1;
/org.eclipse.jdt.ui/ui/org/eclipse/jdt/internal/ui/packageview/LayoutActionGroup.java;2;0;2;1;1;1;1;1;2;0;1;4807;4;4;1;0;0;1;2;4807;0;6340;2;2;
/org.eclipse.jdt.ui.tests.refactoring/test cases/org/eclipse/jdt/ui/tests/reorg/AllTests.java;2;0;10;1;1;1;1;9;18;1;9;456;53;53;1;0;0;9;10;456;0;6340;10;2;
/org.eclipse.jdt.ui/ui/org/eclipse/jdt/internal/ui/text/link/LinkedManager.java;1;0;6;1;0;0;0;6;205;1;6;2838;324;324;1;0;0;6;6;2838;0;4214;6;1;
/org.eclipse.swt/Eclipse SWT PI/carbon/org/eclipse/swt/internal/carbon/DataBrowserCustomCallbacks.java;1;2;3;1;3;2;3;0;16;0;0;5534;20;20;2;0;1;0;3;5534;1;5614;2;1;
/org.eclipse.webdav/src/interface/org/eclipse/webdav/IServer.java;1;0;1;1;1;1;1;0;87;0;0;5151;87;87;1;0;0;0;1;5151;0;5151;1;1;
/org.eclipse.ui.workbench/Eclipse UI/org/eclipse/ui/internal/presentations/EditorList.java;3;1;7;1;4;4;4;3;106;2;2;4521;138;138;2;1;0;3;7;4521;1;5363;6;3;
/org.eclipse.pde.runtime/src/org/eclipse/pde/internal/runtime/registry/RegistryPropertySourceFactory.java;2;0;4;1;1;1;1;3;96;1;3;924;194;194;1;0;0;3;4;924;0;6336;4;2;
/org.eclipse.swt.graphics.text/JUnit/Test_org_eclipse_swt_graphics_TextLayout.java;1;0;1;1;0;0;0;1;0;0;1;4306;0;0;1;0;0;1;1;4306;0;4306;1;1;
/org.eclipse.update.core/src/org/eclipse/update/internal/mirror/MirrorSite.java;2;1;11;1;3;3;3;8;170;1;8;1566;421;421;1;0;0;8;11;1566;0;6336;11;2;
/org.eclipse.jdt.core/codeassist/org/eclipse/jdt/internal/codeassist/impl/Keywords.java;1;0;2;1;0;0;0;2;2;1;2;76;4;4;1;0;0;2;2;76;0;3557;2;1;
/org.eclipse.jdt.core/search/org/eclipse/jdt/internal/core/index/IDocument.java;1;0;1;1;0;0;0;1;0;0;1;3240;0;0;1;0;0;1;1;3240;0;3240;1;1;
/org.eclipse.jdt.core.tests.model/workspace/Converter/test0308/Test.java;1;0;1;1;0;0;0;1;0;0;1;3714;0;0;1;0;0;1;1;3714;0;3714;1;1;
/org.eclipse.ui.workbench/Eclipse UI/org/eclipse/ui/internal/commands/ICommandRegistryListener.java;1;0;3;1;0;0;0;3;18;1;3;1422;20;20;1;0;0;3;3;1422;0;2823;3;1;
/org.eclipse.jdt.core.tests.model/workspace/Converter/Test0157.java;1;0;1;1;0;0;0;1;0;0;1;3714;0;0;1;0;0;1;1;3714;0;3714;1;1;
/org.eclipse.swt.tests/JUnit Tests/org/eclipse/swt/tests/junit/Test_org_eclipse_swt_widgets_Event.java;1;0;2;1;1;1;1;1;8;0;1;3443;12;12;1;0;0;1;2;3443;0;6352;2;1;
/org.eclipse.jdt.core.tests.model/workspace/Formatter/test216/A_in.java;1;0;1;1;0;0;0;1;0;0;1;2426;0;0;1;0;0;1;1;2426;0;2426;1;1;
/org.eclipse.ui.workbench/Eclipse UI/org/eclipse/ui/internal/LockToolBarAction.java;2;0;3;1;0;0;0;3;86;1;3;2737;138;138;1;0;0;3;3;2737;0;3220;3;2;
/org.eclipse.pde.ui/src/org/eclipse/pde/internal/ui/wizards/project/MigrationAction.java;1;0;3;1;0;0;0;3;20;1;3;2653;20;20;1;0;0;3;3;2653;0;3839;3;1;
/org.eclipse.jdt.ui/ui/org/eclipse/jdt/internal/ui/callhierarchy/SearchScopeWorkingSetAction.java;3;2;5;2;4;3;4;1;10;0;1;4047;16;16;2;0;1;1;5;5531;1;6340;4;3;
/org.eclipse.pde.ui/src_Forms/org/eclipse/pde/internal/ui/neweditor/FormEntryAdapter.java;2;0;5;1;1;1;1;4;28;1;4;4289;47;47;1;0;0;4;5;4289;0;5431;5;2;
/org.eclipse.jface/src/org/eclipse/jface/progress/NotifyingJob.java;1;0;3;1;0;0;0;3;90;1;3;598;90;90;1;0;0;3;3;598;0;955;3;1;
/org.eclipse.ui.workbench/Eclipse UI/org/eclipse/ui/internal/commands/old/Path.java;1;0;3;1;0;0;0;3;2;1;3;1222;2;2;1;0;0;3;3;1222;0;1695;3;1;
/org.eclipse.osgi/defaultAdaptor/src/org/eclipse/osgi/framework/internal/defaultadaptor/DefaultElementFactory.java;2;0;3;1;1;1;1;2;10;1;2;4336;12;12;1;0;0;2;3;4336;0;5117;3;2;
/org.eclipse.jdt.core.tests.model/workspace/Converter/src/test0037/Test.java;1;0;1;1;0;0;0;1;0;0;1;3714;0;0;1;0;0;1;1;3714;0;3714;1;1;
/org.eclipse.team.ui/src/org/eclipse/team/internal/ui/sync/compare/RemoteResourceTypedElement.java;2;0;5;1;0;0;0;5;105;1;5;488;135;135;1;0;0;5;5;488;0;2632;5;2;
/org.eclipse.jdt.ui/core refactoring/org/eclipse/jdt/internal/corext/refactoring/code/flow/MessageSendFlowInfo.java;1;0;1;1;1;1;1;0;2;0;0;6340;2;2;1;0;0;0;1;6340;0;6340;1;1;
/org.eclipse.team.ui/src/org/eclipse/team/internal/ui/synchronize/TeamSubscriberParticipantLabelProvider.java;1;0;1;1;0;0;0;1;0;0;1;2590;0;0;1;0;0;1;1;2590;0;2590;1;1;
/org.eclipse.jdt.core/model/org/eclipse/jdt/internal/core/PackageFragmentInfo.java;1;0;8;1;0;0;0;8;27;2;7;132;75;75;2;1;0;8;8;818;1;4887;7;1;
/org.eclipse.update.core/src/org/eclipse/update/standalone/UpdateCommand.java;1;2;10;1;7;6;7;3;169;2;2;825;263;263;2;1;1;3;10;825;2;6335;8;1;
/org.eclipse.update.ui.win32/src/org/eclipse/welcome/internal/portal/IFormContentObserver.java;1;0;1;1;0;0;0;1;0;0;1;925;0;0;1;0;0;1;1;925;0;925;1;1;
/org.eclipse.team.core/src/org/eclipse/team/core/RemoteContentsCacheEntry.java;1;0;1;1;0;0;0;1;0;0;1;3966;0;0;1;0;0;1;1;3966;0;3966;1;1;
/org.eclipse.osgi/core/framework/org/eclipse/osgi/framework/internal/protocol/StreamHandlerFactory.java;5;1;7;1;2;2;2;5;207;1;5;3013;252;252;1;0;0;5;7;3013;0;5490;7;5;
/org.eclipse.pde.ui/src_OSGi/org/eclipse/pde/internal/ui/osgi/wizards/project/BundleProjectCodeGeneratorsPage.java;2;0;8;2;0;0;0;8;18;2;7;2498;25;25;2;1;0;8;8;3045;1;3986;7;2;
/org.eclipse.ui.workbench/Eclipse UI/org/eclipse/ui/internal/activities/ObjectActivityManager.java;2;0;12;1;0;0;0;12;484;2;9;2444;711;711;2;3;0;12;12;2864;3;3008;9;2;
/org.eclipse.ui.workbench/Eclipse UI/org/eclipse/ui/internal/EditorAreaHelper.java;5;1;7;1;7;7;7;0;15;0;0;5540;41;41;1;0;0;0;7;5540;0;6338;7;5;
/org.eclipse.ui.views/src/org/eclipse/ui/views/markers/internal/ActionTaskProperties.java;2;0;2;1;0;0;0;2;0;1;2;755;0;0;1;0;0;2;2;755;0;2738;2;2;
/org.eclipse.swt/Eclipse SWT/motif/org/eclipse/swt/widgets/Scrollable.java;4;1;8;1;3;3;3;5;11;1;5;17;45;45;1;0;0;5;8;17;0;6352;8;4;
/org.eclipse.jdt.ui/core refactoring/org/eclipse/jdt/internal/corext/refactoring/participants/IRenameParticipant.java;1;0;5;1;0;0;0;5;23;1;5;591;26;26;1;0;0;5;5;591;0;4624;5;1;
/org.eclipse.update.ui.forms/src/org/eclipse/update/ui/forms/internal/richtext/ImageSegment.java;1;0;2;1;0;0;0;2;0;1;2;2849;0;0;1;0;0;2;2;2849;0;2898;2;1;
/org.eclipse.jdt.core.tests.model/workspace/Converter/test0370/Test.java;1;0;1;1;0;0;0;1;0;0;1;3714;0;0;1;0;0;1;1;3714;0;3714;1;1;
/org.eclipse.jdt.ui.tests.refactoring/resources/Move/testDestination_yes_fieldToOtherType/out/A.java;1;0;2;1;0;0;0;2;1;0;1;1008;1;1;2;1;0;2;2;1008;1;1008;1;1;
/org.eclipse.core.resources/src/org/eclipse/core/internal/resources/CharsetManager.java;3;1;8;1;7;7;7;1;381;0;1;4340;460;460;1;0;0;1;8;4340;0;6270;8;3;
/org.eclipse.core.runtime/src/org/eclipse/core/internal/dependencies/IElement.java;2;0;2;1;0;0;0;2;0;1;2;2105;0;0;1;0;0;2;2;2105;0;3013;2;2;
/org.eclipse.jdt.ui.tests.refactoring/resources/ChangeSignature/canModify/A_testImport03_in.java;1;0;1;1;0;0;0;1;0;0;1;3820;0;0;1;0;0;1;1;3820;0;3820;1;1;
/org.eclipse.help.base/src/org/eclipse/help/internal/HelpBasePlugin.java;1;0;2;1;0;0;0;2;0;0;1;1740;0;0;2;1;0;2;2;1740;1;1740;1;1;
/org.eclipse.ui.externaltools/Ant Editor/org/eclipse/ui/externaltools/internal/ant/editor/outline/XEErrorHandler.java;1;0;2;1;0;0;0;2;6;1;2;245;6;6;1;0;0;2;2;245;0;282;2;1;
/org.eclipse.ui.forms/src/org/eclipse/ui/forms/ManagedForm.java;1;0;8;1;0;0;0;8;81;2;7;4068;122;122;2;1;0;8;8;4284;1;4491;7;1;
/org.eclipse.ui.externaltools/Ant Editor/org/eclipse/ui/externaltools/internal/ant/editor/text/TagRule.java;1;0;1;1;0;0;0;1;0;0;1;282;0;0;1;0;0;1;1;282;0;282;1;1;
/org.eclipse.jdt.ui/ui/org/eclipse/jdt/internal/ui/search/LimitElementsAction.java;1;0;2;1;2;1;2;0;0;0;0;6140;0;0;2;0;1;0;2;6140;1;6140;1;1;
/org.eclipse.debug.core/core/org/eclipse/debug/internal/core/stringsubstitution/IDynamicVariableResolver.java;2;0;2;1;0;0;0;2;0;1;2;2140;0;0;1;0;0;2;2;2140;0;2514;2;2;
/org.eclipse.team.ui/src/org/eclipse/team/internal/ui/synchronize/views/SyncSetTreeContentProvider.java;1;0;3;1;0;0;0;3;117;1;3;2535;117;117;1;0;0;3;3;2535;0;4216;3;1;
/org.eclipse.pde.ui/srcnew/org/eclipse/pde/internal/ui/editor/manifest/PartiallySynchronizedDocument.java;1;0;2;1;0;0;0;2;2;1;2;1307;2;2;1;0;0;2;2;1307;0;2320;2;1;
/org.eclipse.ui.ide/src/org/eclipse/ui/actions/SimpleWildcardTester.java;1;0;2;1;0;0;0;2;0;1;2;1511;0;0;1;0;0;2;2;1511;0;1520;2;1;
/org.eclipse.core.resources/src/org/eclipse/core/resources/IProjectNature.java;1;0;2;1;1;1;1;1;95;0;1;4994;105;105;1;0;0;1;2;4994;0;5146;2;1;
/org.eclipse.team.tests.cvs.core/src/org/eclipse/team/tests/ccvs/ui/old/PrintDiffMain.java;1;0;2;1;0;0;0;2;0;1;2;2632;0;0;1;0;0;2;2;2632;0;4216;2;1;
/org.eclipse.debug.core/core/org/eclipse/debug/core/sourcelookup/containers/ExternalArchiveSourceContainer.java;1;1;7;1;4;4;4;3;94;0;1;4949;141;141;3;2;0;3;7;4949;2;5927;5;1;
/org.eclipse.update.core/src/org/eclipse/update/internal/mirror/MirrorSiteFactory.java;3;0;9;1;1;1;1;8;80;1;8;1566;255;255;1;0;0;8;9;1566;0;5670;9;3;
/org.eclipse.jdt.core.tests.model/workspace/Converter/src/test0150/Test.java;1;0;1;1;0;0;0;1;0;0;1;3714;0;0;1;0;0;1;1;3714;0;3714;1;1;
/org.eclipse.ui.workbench/Eclipse UI/org/eclipse/ui/internal/handles/api/IHandle.java;1;0;2;1;0;0;0;2;0;1;2;1507;0;0;1;0;0;2;2;1507;0;1724;2;1;
/org.eclipse.ui.workbench/Eclipse UI/org/eclipse/ui/commands/IContextBinding.java;2;0;10;1;1;1;1;9;16;2;8;1239;62;62;2;1;0;9;10;1239;1;5231;9;2;
/org.eclipse.swt/Eclipse SWT/gtk/org/eclipse/swt/widgets/ToolItem.java;6;0;15;2;1;1;1;14;96;2;10;45;269;269;2;4;0;14;15;45;4;6352;11;6;
/org.eclipse.ant.ui/Ant Editor/org/eclipse/ant/internal/ui/editor/utils/ProjectHelperImpl.java;1;0;3;1;0;0;0;3;21;1;3;1811;21;21;1;0;0;3;3;1811;0;3504;3;1;
/org.eclipse.osgi/core/adaptor/org/eclipse/osgi/framework/adaptor/BundleOperation.java;4;1;4;1;2;2;2;2;53;1;2;3013;59;59;1;0;0;2;4;3013;0;6337;4;4;
/org.eclipse.jdt.ui.tests.refactoring/resources/MoveMembers/test41/in/A.java;1;0;1;1;0;0;0;1;0;0;1;4630;0;0;1;0;0;1;1;4630;0;4630;1;1;
/org.eclipse.pde.ui/src/org/eclipse/pde/internal/ui/editor/manifest/PluginAdapterFactory.java;2;1;2;1;2;2;2;0;2;0;0;5212;2;2;1;0;0;0;2;5212;0;5431;2;2;
/org.eclipse.pde.ui/src/org/eclipse/pde/internal/ui/editor/manifest/ExtensionPointPropertySource.java;2;0;3;1;1;1;1;2;3;1;2;2184;5;5;1;0;0;2;3;2184;0;5431;3;2;
/org.eclipse.ant.ui/Ant Editor/org/eclipse/ant/internal/ui/editor/outline/DocumentModelChangeEvent.java;1;0;2;1;1;1;1;1;15;0;1;1811;15;15;1;0;0;1;2;1811;0;6085;2;1;
/org.eclipse.jdt.core/search/org/eclipse/jdt/core/search/FieldReferenceMatch.java;4;2;12;2;5;4;5;7;41;3;5;3913;135;135;3;2;1;7;12;4302;3;5912;9;4;
/org.eclipse.ui.workbench/Eclipse UI/org/eclipse/ui/internal/commands/RegistryReader.java;1;0;8;1;0;0;0;8;178;2;5;1222;444;444;2;3;0;8;8;1222;3;1354;5;1;
/org.eclipse.jdt.core.tests.model/workspace/Converter/src/test0249/Test.java;1;0;1;1;0;0;0;1;0;0;1;3714;0;0;1;0;0;1;1;3714;0;3714;1;1;
/org.eclipse.update.ui.forms/src/org/eclipse/ui/forms/internal/parts/ParagraphSegment.java;1;0;2;1;0;0;0;2;0;1;2;2898;0;0;1;0;0;2;2;2898;0;3096;2;1;
/org.eclipse.jdt.core.tests.model/workspace/Formatter/test047/A_out.java;1;0;2;1;0;0;0;2;3;1;2;2425;3;3;1;0;0;2;2;2425;0;4173;2;1;
/org.eclipse.jdt.ui.tests.refactoring/resources/SurroundWithWorkSpace/SurroundWithTests/trycatch_in/TestDeclarationInitializer.java;1;0;2;1;0;0;0;2;3;1;2;155;3;3;1;0;0;2;2;155;0;845;2;1;
/org.eclipse.swt.tests/JUnit Tests/org/eclipse/swt/tests/junit/Test_org_eclipse_swt_custom_LineStyleListener.java;1;0;1;1;0;0;0;1;19;0;1;2104;19;19;1;0;0;1;1;2104;0;2104;1;1;
/org.eclipse.osgi/eclipseAdaptor/src/org/eclipse/core/runtime/adaptor/EclipseClassLoader.java;5;5;42;2;23;15;23;19;208;1;19;3013;771;771;5;0;8;19;42;5106;8;6245;34;5;
/org.eclipse.debug.ui/ui/org/eclipse/debug/internal/ui/launchConfigurations/PerspectiveTabGroup.java;1;0;1;1;0;0;0;1;0;0;1;618;0;0;1;0;0;1;1;618;0;618;1;1;
/org.eclipse.jdt.ui/core refactoring/org/eclipse/jdt/internal/corext/refactoring/reorg2/ReorgMoveAction.java;1;0;4;1;0;0;0;4;5;2;2;802;8;8;2;2;0;4;4;802;2;1111;2;1;
/org.eclipse.jdt.ui/ui/org/eclipse/jdt/internal/ui/packageview/GotoTypeAction.java;2;0;2;1;1;1;1;1;6;0;1;1386;8;8;1;0;0;1;2;1386;0;6340;2;2;
/org.eclipse.ui.ide/extensions/org/eclipse/ui/actions/MoveFilesAndFoldersOperation.java;1;0;1;1;0;0;0;1;0;0;1;2263;0;0;1;0;0;1;1;2263;0;2263;1;1;
/org.eclipse.jdt.core/model/org/eclipse/jdt/internal/core/builder/WorkQueue.java;1;0;1;1;0;0;0;1;2;0;1;3560;2;2;1;0;0;1;1;3560;0;3560;1;1;
/org.eclipse.swt/Eclipse SWT PI/carbon/org/eclipse/swt/internal/carbon/ATSUCaret.java;2;2;4;1;3;2;3;1;16;0;1;4535;20;20;2;0;1;1;4;5534;1;5614;3;2;
/org.eclipse.core.tests.runtime/src/org/eclipse/core/tests/internal/plugins/FragmentResolveTest_10.java;1;0;1;1;0;0;0;1;0;0;1;3014;0;0;1;0;0;1;1;3014;0;3014;1;1;
/org.eclipse.jdt.ui.tests.refactoring/resources/InlineMethodWorkspace/TestCases/nameconflict_out/TestSameTypeInSibling.java;1;0;1;1;0;0;0;1;4;0;1;845;4;4;1;0;0;1;1;845;0;845;1;1;
/org.eclipse.ui.workbench/Eclipse UI/org/eclipse/ui/internal/registry/PreferencePageRegistryReader.java;5;0;9;2;1;1;1;8;357;2;6;2737;480;480;2;2;0;8;9;2901;2;6338;7;5;
/org.eclipse.ant.ui/Ant Editor/org/eclipse/ant/internal/ui/dtd/ParseError.java;1;0;1;1;0;0;0;1;0;0;1;1811;0;0;1;0;0;1;1;1811;0;1811;1;1;
/org.eclipse.jface/src/org/eclipse/jface/viewers/TableViewerImpl.java;2;0;2;1;1;1;1;1;3;0;1;5037;5;5;1;0;0;1;2;5037;0;6338;2;2;
/org.eclipse.jdt.core.tests.model/workspace/Converter/src/test0216/Test.java;1;0;1;1;0;0;0;1;0;0;1;3714;0;0;1;0;0;1;1;3714;0;3714;1;1;
/org.eclipse.jdt.ui/ui/org/eclipse/jdt/internal/ui/wizards/dialogfields/LayoutUtil.java;4;0;4;1;1;1;1;3;24;1;3;1446;34;34;1;0;0;3;4;1446;0;6340;4;4;
/org.eclipse.core.runtime/src/org/eclipse/core/runtime/content/XMLRootElementContentDescriber.java;2;2;9;1;9;7;9;0;52;0;0;5231;125;125;2;0;2;0;9;5231;2;6012;7;2;
/org.eclipse.core.resources/src/org/eclipse/core/resources/ResourcesPlugin.java;2;1;16;1;2;2;2;14;227;1;14;44;376;376;1;0;0;14;16;44;0;6147;16;2;
/org.eclipse.core.tests.runtime/src/org/eclipse/core/tests/internal/plugins/PluginResolveTest_25.java;1;0;1;1;0;0;0;1;0;0;1;3014;0;0;1;0;0;1;1;3014;0;3014;1;1;
/org.eclipse.help/src/org/eclipse/help/internal/search/ASCIIReader.java;1;0;1;1;0;0;0;1;0;0;1;2732;0;0;1;0;0;1;1;2732;0;2732;1;1;
/org.eclipse.debug.ui/ui/org/eclipse/debug/internal/ui/views/memory/IMemoryBlockViewSynchronizer.java;1;0;1;1;1;1;1;0;0;0;0;5254;0;0;1;0;0;0;1;5254;0;5254;1;1;
/org.eclipse.jdt.core.tests.model/workspace/Formatter/test030/A_out.java;1;0;2;1;0;0;0;2;3;1;2;2425;3;3;1;0;0;2;2;2425;0;3086;2;1;
/org.eclipse.swt.examples/src/org/eclipse/swt/examples/controlexample/CustomControlExample.java;1;0;1;1;0;0;0;1;2;0;1;2729;2;2;1;0;0;1;1;2729;0;2729;1;1;
/org.eclipse.jdt.ui.tests.refactoring/resources/ExtractMethodWorkSpace/ExtractMethodTests/locals_out/A_test543.java;1;0;2;1;0;0;0;2;4;1;2;130;5;5;1;0;0;2;2;130;0;844;2;1;
/org.eclipse.core.tests.runtime/src/org/eclipse/core/tests/internal/runtimetests/SampleGFR.java;1;0;1;1;1;1;1;0;21;0;0;5149;21;21;1;0;0;0;1;5149;0;5149;1;1;
/org.eclipse.pde.ui/srcnew/org/eclipse/pde/internal/ui/editor/manifest/IReconcilingParticipant.java;1;0;1;1;0;0;0;1;0;0;1;2320;0;0;1;0;0;1;1;2320;0;2320;1;1;
/org.eclipse.team.ui/src/org/eclipse/team/internal/ui/synchronize/IRefreshSubscriberListener.java;1;1;5;1;2;2;2;3;42;1;3;3796;52;52;1;0;0;3;5;3796;0;6337;5;1;
/org.eclipse.ui.workbench.texteditor/src/org/eclipse/ui/texteditor/ContentAssistAction.java;2;0;5;1;1;1;1;4;8;1;4;2097;15;15;1;0;0;4;5;2097;0;6340;5;2;
/org.eclipse.ui.workbench/Eclipse UI/org/eclipse/ui/internal/commands/api/ICommandManagerListener.java;1;0;2;1;0;0;0;2;2;0;1;2562;2;2;2;1;0;2;2;2562;1;2562;1;1;
/org.eclipse.swt.examples/src/org/eclipse/swt/examples/clipboard/ClipboardExample.java;1;0;1;1;0;0;0;1;76;0;1;305;76;76;1;0;0;1;1;305;0;305;1;1;
/org.eclipse.ui.workbench/Eclipse UI/org/eclipse/ui/internal/commands/KeyConfiguration.java;3;1;15;1;2;2;2;13;279;2;11;1321;739;739;2;2;0;13;15;1629;2;6338;13;3;
/org.eclipse.pde.ui/src_Forms/org/eclipse/pde/internal/ui/neweditor/PDESourcePage.java;2;1;19;1;7;7;7;12;61;1;12;3749;197;197;1;0;0;12;19;3749;0;5431;19;2;
/org.eclipse.jdt.ui.examples.javafamily/src/org/eclipse/jface/text/source/ITagHandler.java;1;0;3;1;0;0;0;3;70;1;3;1172;70;70;1;0;0;3;3;1172;0;1642;3;1;
/org.eclipse.jdt.core/codeassist/org/eclipse/jdt/internal/codeassist/complete/CompletionOnKeyword1.java;2;0;2;1;0;0;0;2;5;1;2;991;7;7;1;0;0;2;2;991;0;3560;2;2;
/org.eclipse.core.runtime.osgi/src/org/eclipse/core/internal/runtime/PlatformMetaAreaLock.java;1;0;2;1;0;0;0;2;8;1;2;3013;8;8;1;0;0;2;2;3013;0;3030;2;1;
/org.eclipse.swt.tests/JUnit Tests/org/eclipse/swt/tests/junit/Test_org_eclipse_swt_events_HelpEvent.java;1;0;2;1;1;1;1;1;7;0;1;3444;11;11;1;0;0;1;2;3444;0;6352;2;1;
/org.eclipse.jdt.core.tests.compiler/src/org/eclipse/jdt/core/tests/compiler/regression/UtilTest.java;2;0;5;1;0;0;0;5;116;2;4;781;134;134;2;1;0;5;5;781;1;3560;4;2;
/org.eclipse.ui.editors/src/org/eclipse/ui/internal/editors/text/QuickdiffConfigurationBlock.java;2;2;6;2;6;4;6;0;80;0;0;5109;143;143;2;0;2;0;6;5126;2;5501;4;2;
/org.eclipse.ant.ui/Ant Editor/org/eclipse/ant/ui/internal/dtd/util/IValueHolder.java;1;0;2;1;0;0;0;2;0;1;2;250;0;0;1;0;0;2;2;250;0;1811;2;1;
/org.eclipse.ui.views/src/org/eclipse/ui/views/tasklist/TasksFilter.java;1;0;1;1;0;0;0;1;0;0;1;2738;0;0;1;0;0;1;1;2738;0;2738;1;1;
/org.eclipse.pde.ui/templates_3.0/editor/java/IXMLColorConstants.java;1;0;1;1;0;0;0;1;0;0;1;2786;0;0;1;0;0;1;1;2786;0;2786;1;1;
/org.eclipse.ui.workbench/Eclipse UI/org/eclipse/ui/internal/contexts/MutableContextActivationService.java;2;0;3;1;0;0;0;3;1;1;3;3109;1;1;1;0;0;3;3;3109;0;4144;3;2;
/org.eclipse.debug.ui/ui/org/eclipse/debug/internal/ui/views/memory/AddMemoryBlockAction.java;2;1;4;1;4;4;4;0;3;0;0;5254;7;7;1;0;0;0;4;5254;0;5475;4;2;
/org.eclipse.jdt.ui.tests.refactoring/resources/ChangeSignature/canModify/A_testException04_in.java;1;0;1;1;0;0;0;1;0;0;1;4045;0;0;1;0;0;1;1;4045;0;4045;1;1;
/org.eclipse.jdt.core.tests.model/workspace/Converter/src/Test0158.java;1;0;1;1;0;0;0;1;0;0;1;3714;0;0;1;0;0;1;1;3714;0;3714;1;1;
/org.eclipse.ui.ide/src/org/eclipse/ui/internal/dialogs/SystemSummaryDialog.java;2;0;2;1;0;0;0;2;0;1;2;1675;0;0;1;0;0;2;2;1675;0;2263;2;2;
/org.eclipse.jdt.core.tests.model/workspace/Converter/src/javadoc/testBug65288/Test.java;1;0;1;1;1;1;1;0;0;0;0;6100;0;0;1;0;0;0;1;6100;0;6100;1;1;
/org.eclipse.jdt.core.tests.model/workspace/Formatter/test142/A_in.java;1;0;1;1;0;0;0;1;0;0;1;2425;0;0;1;0;0;1;1;2425;0;2425;1;1;
/org.eclipse.jdt.ui/ui/org/eclipse/jdt/internal/ui/javadocexport/JavadocStandardWizardPage.java;2;1;6;1;3;3;3;3;201;1;3;1242;516;516;1;0;0;3;6;1242;0;6340;6;2;
/org.eclipse.ui.externaltools/Ant Editor/org/eclipse/ui/externaltools/internal/ant/editor/derived/SubstitutionTextReader.java;1;0;1;1;0;0;0;1;0;0;1;282;0;0;1;0;0;1;1;282;0;282;1;1;
/org.eclipse.pde.runtime/src/org/eclipse/pde/internal/runtime/registry/PrerequisitePropertySource.java;2;1;5;1;2;2;2;3;214;1;3;924;473;473;1;0;0;3;5;924;0;6336;5;2;
/org.eclipse.jdt.core/search/org/eclipse/jdt/internal/core/search/matching/TypeReferenceLocator.java;4;3;19;2;4;2;4;15;335;2;11;1986;589;589;3;4;2;15;19;5205;6;5205;13;4;
/org.eclipse.pde.ui/src/org/eclipse/pde/internal/ui/editor/text/XMLTagRule.java;3;1;3;1;2;2;2;1;4;0;1;3795;6;6;1;0;0;1;3;3795;0;6336;3;3;
/org.eclipse.ui.ide/src/org/eclipse/ui/internal/ide/model/WorkbenchAdapterFactory.java;1;0;1;1;0;0;0;1;0;0;1;2264;0;0;1;0;0;1;1;2264;0;2264;1;1;
/org.eclipse.jdt.ui/ui/org/eclipse/jdt/internal/ui/javaeditor/ISavePolicy.java;1;0;1;1;1;1;1;0;2;0;0;6340;2;2;1;0;0;0;1;6340;0;6340;1;1;
/org.eclipse.ui.examples.javaeditor/Template Editor Example/org/eclipse/ui/examples/templateeditor/editors/XMLPartitionScanner.java;2;0;2;1;1;1;1;1;10;0;1;4644;18;18;1;0;0;1;2;4644;0;6340;2;2;
/org.eclipse.pde.ui/src/org/eclipse/pde/internal/ui/editor/PDESourcePage.java;2;1;11;1;4;4;4;7;433;3;5;2751;537;537;3;2;0;7;11;2751;2;6336;9;2;
/org.eclipse.jdt.ui/ui refactoring/org/eclipse/jdt/internal/ui/refactoring/QualifiedNameComponent.java;1;0;1;1;1;1;1;0;2;0;0;6340;2;2;1;0;0;0;1;6340;0;6340;1;1;
/org.eclipse.jdt.core.tests.model/workspace/Formatter/test416/A_out.java;1;0;2;1;0;0;0;2;6;1;2;3460;6;6;1;0;0;2;2;3460;0;4994;2;1;
/org.eclipse.pde.core/src/org/eclipse/pde/internal/core/ClasspathUtilCore.java;3;1;33;2;7;7;7;26;239;3;18;18;960;960;3;8;0;26;33;3490;8;6336;25;3;
/org.eclipse.core.resources/src/org/eclipse/core/internal/resources/MarkerDeltaManager.java;2;0;2;1;1;1;1;1;14;0;1;1744;14;14;1;0;0;1;2;1744;0;5146;2;2;
/org.eclipse.ui.workbench.texteditor/src/org/eclipse/ui/texteditor/SelectAnnotationRulerAction.java;2;1;2;1;2;2;2;0;2;0;0;5177;2;2;1;0;0;0;2;5177;0;6340;2;2;
/org.eclipse.update.ui.forms/src/org/eclipse/update/ui/forms/internal/FormsPlugin.java;1;0;1;1;0;0;0;1;2;0;1;925;2;2;1;0;0;1;1;925;0;925;1;1;
/org.eclipse.osgi/osgi/src/org/eclipse/osgi/service/resolver/VersionRange.java;1;2;5;1;5;4;5;0;30;0;0;5408;56;56;2;0;1;0;5;5530;1;6244;4;1;
/org.eclipse.team.ui/src/org/eclipse/team/internal/ui/synchronize/sets/SyncInfoStatistics.java;1;0;3;1;0;0;0;3;107;1;3;2535;107;107;1;0;0;3;3;2535;0;4216;3;1;
/org.eclipse.jdt.debug/jdi/org/eclipse/jdi/internal/connect/SocketTransportImpl.java;3;0;3;1;0;0;0;3;8;1;3;1470;14;14;1;0;0;3;3;1470;0;3330;3;3;
/org.eclipse.core.runtime.compatibility/src-runtime/org/eclipse/core/runtime/PluginVersionIdentifier.java;2;0;3;1;0;0;0;3;802;1;3;3013;802;802;1;0;0;3;3;3013;0;3169;3;2;
/org.eclipse.ui.workbench/Eclipse UI/org/eclipse/ui/contexts/IContextServiceEvent.java;1;0;2;1;0;0;0;2;0;1;2;1137;0;0;1;0;0;2;2;1137;0;1220;2;1;
/org.eclipse.ui.workbench/Eclipse UI/org/eclipse/ui/internal/presentations/PresentablePart.java;1;0;1;1;1;1;1;0;0;0;0;5805;0;0;1;0;0;0;1;5805;0;5805;1;1;
/org.eclipse.ant.tests.ui/test support/org/eclipse/ant/tests/ui/support/tasks/AntTestTask2.java;1;0;4;1;0;0;0;4;22;2;3;4135;28;28;2;1;0;4;4;4917;1;4958;3;1;
/org.eclipse.swt/Eclipse SWT Mozilla/common/org/eclipse/swt/internal/mozilla/nsIChannel.java;1;0;1;1;0;0;0;1;0;0;1;2663;0;0;1;0;0;1;1;2663;0;2663;1;1;
/org.eclipse.ui.workbench/Eclipse UI/org/eclipse/ui/internal/roles/RoleSystemEnablementHelper.java;1;0;2;1;0;0;0;2;0;0;1;2279;0;0;2;1;0;2;2;2279;1;2279;1;1;
/org.eclipse.jdt.core.tests.model/workspace/Converter/src/test0379/Test.java;1;0;1;1;0;0;0;1;0;0;1;3714;0;0;1;0;0;1;1;3714;0;3714;1;1;
/org.eclipse.core.tools/src/org/eclipse/core/tools/runtime/StackTraceView.java;1;0;1;1;1;1;1;0;0;0;0;6302;0;0;1;0;0;0;1;6302;0;6302;1;1;
/org.eclipse.jdt.ui/ui/org/eclipse/jdt/internal/ui/search/JavaSearchDescription.java;2;0;3;1;1;1;1;2;66;1;2;3488;68;68;1;0;0;2;3;3488;0;6340;3;2;
/org.eclipse.jdt.ui/core refactoring/org/eclipse/jdt/internal/corext/refactoring/changes/TextFileChange.java;1;0;8;1;0;0;0;8;212;1;8;1953;338;338;1;0;0;8;8;1953;0;4624;8;1;
/org.eclipse.jdt.core.tests.model/workspace/Formatter/test047/A_in.java;1;0;1;1;0;0;0;1;0;0;1;2425;0;0;1;0;0;1;1;2425;0;2425;1;1;
/org.eclipse.jdt.core.tests.model/workspace/Formatter/test397/A_in.java;1;0;1;1;0;0;0;1;0;0;1;3436;0;0;1;0;0;1;1;3436;0;3436;1;1;
/org.eclipse.tomcat/src/org/eclipse/tomcat/internal/JndiURLHandler.java;1;1;4;1;3;3;3;1;99;0;1;3047;126;126;1;0;0;1;4;3047;0;6337;4;1;
/org.eclipse.swt/Eclipse SWT/motif/org/eclipse/swt/graphics/GC.java;5;1;19;2;3;3;3;16;168;2;15;16;918;918;2;1;0;16;19;1557;1;6352;18;5;
/org.eclipse.jdt.core.tests.model/workspace/Converter/test0345/A.java;1;0;1;1;0;0;0;1;0;0;1;3714;0;0;1;0;0;1;1;3714;0;3714;1;1;
/org.eclipse.jdt.core.tests.model/workspace/Formatter/test015/A_in.java;1;0;1;1;0;0;0;1;0;0;1;2425;0;0;1;0;0;1;1;2425;0;2425;1;1;
/org.eclipse.update.core/src/org/eclipse/update/core/model/DefaultFeatureParser.java;4;2;11;1;5;4;5;6;187;1;6;0;271;271;2;0;1;6;11;5664;1;5802;10;4;
/org.eclipse.help/src/org/eclipse/help/internal/protocols/HelpURLStreamHandler.java;1;1;4;1;3;3;3;1;16;0;1;2769;34;34;1;0;0;1;4;2769;0;6337;4;1;
/org.eclipse.jdt.ui.tests.refactoring/resources/MoveMembers/test10/out/B.java;1;0;1;1;0;0;0;1;1;0;1;1522;1;1;1;0;0;1;1;1522;0;1522;1;1;
/org.eclipse.ui.ide/src/org/eclipse/ui/internal/ide/registry/MarkerHelpRegistry.java;1;0;1;1;0;0;0;1;0;0;1;2264;0;0;1;0;0;1;1;2264;0;2264;1;1;
/org.eclipse.jface.text/src/org/eclipse/jface/text/IPaintPositionManager.java;2;1;2;1;2;2;2;0;3;0;0;6340;5;5;1;0;0;0;2;6340;0;6359;2;2;
/org.eclipse.osgi/defaultAdaptor/src/org/eclipse/osgi/framework/internal/protocol/bundleresource/Handler.java;2;0;5;1;2;1;2;3;15;1;3;3620;31;31;2;0;1;3;5;5116;1;5116;4;2;
/org.eclipse.jdt.ui.examples.javafamily/src/org/eclipse/jdt/internal/ui/examples/jspeditor/DefaultAnnotationHover.java;3;0;3;1;0;0;0;3;18;1;3;1629;19;19;1;0;0;3;3;1629;0;3235;3;3;
/org.eclipse.jdt.core.tests.model/workspace/Formatter/test297/A_in.java;1;0;1;1;0;0;0;1;0;0;1;2444;0;0;1;0;0;1;1;2444;0;2444;1;1;
/org.eclipse.ui.workbench/Eclipse UI/org/eclipse/ui/internal/csm/activities/workbench/ActivityActivationServiceEvent.java;1;0;2;1;0;0;0;2;0;1;2;2310;0;0;1;0;0;2;2;2310;0;2371;2;1;
/org.eclipse.jdt.core.tests.model/workspace/Converter/src/test0172/Test.java;1;0;1;1;0;0;0;1;0;0;1;3714;0;0;1;0;0;1;1;3714;0;3714;1;1;
/org.eclipse.core.tests.runtime/src/org/eclipse/core/tests/internal/plugins/PlatformURLPerformanceTestConnection.java;1;0;1;1;0;0;0;1;0;0;1;3014;0;0;1;0;0;1;1;3014;0;3014;1;1;
/org.eclipse.jdt.ui.tests.refactoring/resources/ExtractMethodWorkSpace/ExtractMethodTests/expression_in/A_test621.java;1;0;1;1;0;0;0;1;2;0;1;844;2;2;1;0;0;1;1;844;0;844;1;1;
/org.eclipse.jdt.debug/model/org/eclipse/jdt/internal/debug/core/EventDispatcher.java;4;0;5;2;1;1;1;4;32;2;3;363;47;47;2;1;0;4;5;3964;1;6336;4;4;
/org.eclipse.ui.workbench/Eclipse UI/org/eclipse/ui/internal/commands/registry/ICommandRegistry.java;1;0;2;1;0;0;0;2;0;1;2;1422;0;0;1;0;0;2;2;1422;0;1724;2;1;
/org.eclipse.jdt.ui/ui/org/eclipse/jdt/internal/ui/javaeditor/JavaEditorMessages.java;1;0;1;1;1;1;1;0;2;0;0;6340;2;2;1;0;0;0;1;6340;0;6340;1;1;
/org.eclipse.swt/Eclipse SWT/gtk1x/org/eclipse/swt/widgets/MessageBox.java;1;0;1;1;0;0;0;1;0;0;1;2327;0;0;1;0;0;1;1;2327;0;2327;1;1;
/org.eclipse.compare/compare/org/eclipse/compare/structuremergeviewer/StructureDiffViewer.java;1;0;2;1;0;0;0;2;4;1;2;257;6;6;1;0;0;2;2;257;0;3938;2;1;
/org.eclipse.jdt.ui.tests.refactoring/resources/ExtractMethodWorkSpace/ExtractMethodTests/duplicates_in/A_test964.java;1;0;1;1;1;1;1;0;0;0;0;5681;0;0;1;0;0;0;1;5681;0;5681;1;1;
/org.eclipse.jdt.ui/ui/org/eclipse/jdt/ui/actions/FindImplementorsAction.java;1;0;1;1;1;1;1;0;2;0;0;6340;2;2;1;0;0;0;1;6340;0;6340;1;1;
/org.eclipse.core.applicationrunner/src/org/eclipse/core/internal/applicationrunner/Policy.java;1;0;2;1;0;0;0;2;144;1;2;3013;144;144;1;0;0;2;2;3013;0;3028;2;1;
/org.eclipse.jdt.ui.tests.refactoring/test cases/org/eclipse/jdt/ui/tests/refactoring/UndoManagerTests.java;2;1;5;1;3;3;3;2;23;1;2;3930;56;56;1;0;0;2;5;3930;0;6340;5;2;
/org.eclipse.jface.text/src/org/eclipse/jface/text/source/CompositeRuler.java;3;1;11;1;4;4;4;7;71;1;7;936;258;258;1;0;0;7;11;936;0;6361;11;3;
/org.eclipse.core.runtime/src/org/eclipse/core/internal/registry/Namespace.java;3;1;3;1;3;3;3;0;56;0;0;5531;71;71;1;0;0;0;3;5531;0;5760;3;3;
/org.eclipse.ui.workbench/Eclipse UI/org/eclipse/ui/internal/ide/UIWorkspaceLock.java;1;0;1;1;0;0;0;1;0;0;1;1480;0;0;1;0;0;1;1;1480;0;1480;1;1;
/org.eclipse.jdt.ui.tests.refactoring/resources/InlineMethodWorkspace/TestCases/expression_out/TestConditionalExpression.java;1;0;1;1;1;1;1;0;0;0;0;5682;0;0;1;0;0;0;1;5682;0;5682;1;1;
/org.eclipse.jdt.core/dom/org/eclipse/jdt/internal/core/dom/rewrite/NodeInfoStore.java;3;0;3;1;1;1;1;2;244;1;2;4802;247;247;1;0;0;2;3;4802;0;5404;3;3;
/org.eclipse.jdt.ui.tests.refactoring/resources/IntroduceParameter/simple/Javadoc1.java;1;0;1;1;1;1;1;0;0;0;0;5851;0;0;1;0;0;0;1;5851;0;5851;1;1;
/org.eclipse.jdt.ui.tests.refactoring/resources/InlineMethodWorkspace/TestCases/argument_out/TestLocalReferenceRead.java;1;0;1;1;0;0;0;1;2;0;1;845;2;2;1;0;0;1;1;845;0;845;1;1;
/org.eclipse.jdt.ui.tests.refactoring/resources/IntroduceFactory/positive/staticInstance.java;1;0;2;1;0;0;0;2;0;1;2;2846;0;0;1;0;0;2;2;2846;0;2862;2;1;
/org.eclipse.osgi/resolver/src/org/eclipse/core/dependencies/IElementSet.java;3;1;3;1;2;2;2;1;20;0;1;3013;20;20;1;0;0;1;3;3013;0;5226;3;3;
/org.eclipse.osgi/supplement/src/org/eclipse/osgi/framework/log/FrameworkLog.java;3;1;4;1;2;2;2;2;15;1;2;3879;25;25;1;0;0;2;4;3879;0;5249;4;3;
/org.eclipse.jdt.core.tests.model/workspace/Formatter/test130/A_in.java;1;0;1;1;0;0;0;1;0;0;1;2425;0;0;1;0;0;1;1;2425;0;2425;1;1;
/org.eclipse.jdt.core/model/org/eclipse/jdt/internal/core/hierarchy/HierarchyType.java;1;0;2;1;0;0;0;2;15;1;2;2097;17;17;1;0;0;2;2;2097;0;3560;2;1;
/org.eclipse.jdt.core.tests.model/workspace/Formatter/test176/A_out.java;1;0;1;1;0;0;0;1;0;0;1;2425;0;0;1;0;0;1;1;2425;0;2425;1;1;
/org.eclipse.jdt.core.tests.model/workspace/Converter/test0017/Test.java;1;0;1;1;0;0;0;1;0;0;1;3714;0;0;1;0;0;1;1;3714;0;3714;1;1;
/org.eclipse.jdt.core.tests.model/workspace/Converter15/src/test0019/X.java;1;0;1;1;0;0;0;1;0;0;1;4826;0;0;1;0;0;1;1;4826;0;4826;1;1;
/org.eclipse.team.ui/src/org/eclipse/team/ui/synchronize/actions/SyncInfoFilter.java;1;0;3;1;0;0;0;3;155;1;3;2535;155;155;1;0;0;3;3;2535;0;4216;3;1;
/org.eclipse.search/new search/org/eclipse/search2/internal/ui/ShowSearchAction.java;2;0;4;1;1;1;1;3;6;1;3;3474;11;11;1;0;0;3;4;3474;0;6340;4;2;
/org.eclipse.ui.workbench/Eclipse UI/org/eclipse/ui/internal/PerspectivePresentation.java;6;2;21;2;6;5;6;15;2995;2;14;1092;5007;5007;2;1;1;15;21;4015;2;5539;19;6;
/org.eclipse.swt/Eclipse SWT PI/motif/org/eclipse/swt/internal/motif/XWindowEvent.java;1;0;2;1;0;0;0;2;10;1;2;825;10;10;1;0;0;2;2;825;0;868;2;1;
/org.eclipse.pde.core/src/org/eclipse/pde/core/IExternalModelManager.java;2;0;4;1;0;0;0;4;2;1;4;2229;3;3;1;0;0;4;4;2229;0;4726;4;2;
/org.eclipse.jdt.core.tests.model/workspace/Converter/src/test0222/Test.java;1;0;1;1;0;0;0;1;0;0;1;3714;0;0;1;0;0;1;1;3714;0;3714;1;1;
/org.eclipse.webdav/src/interface/org/eclipse/webdav/ILocator.java;1;0;1;1;1;1;1;0;92;0;0;5151;92;92;1;0;0;0;1;5151;0;5151;1;1;
/org.eclipse.ui.workbench/Eclipse UI/org/eclipse/ui/internal/registry/WorkingSetDescriptor.java;2;0;3;1;1;1;1;2;16;1;2;2737;21;21;1;0;0;2;3;2737;0;6338;3;2;
/org.eclipse.team.examples.filesystem/src/org/eclipse/team/examples/filesystem/subscriber/FileSystemResourceVariant.java;2;1;4;1;2;2;2;2;34;1;2;4349;40;40;1;0;0;2;4;4349;0;6337;4;2;
/org.eclipse.update/src/org/eclipse/update/internal/ui/UMPreferencePageSettings.java;1;0;1;1;1;1;1;0;0;0;0;6339;0;0;1;0;0;0;1;6339;0;6339;1;1;
/org.eclipse.ui.workbench/Eclipse UI/org/eclipse/ui/internal/csm/commands/KeySequenceBindingDefinition.java;1;0;3;1;0;0;0;3;36;2;2;2532;36;36;2;1;0;3;3;2532;1;2562;2;1;
/org.eclipse.jdt.ui/core extension/org/eclipse/jdt/internal/corext/callhierarchy/CalleeMethodWrapper.java;3;0;9;1;1;1;1;8;53;2;6;169;143;143;2;2;0;8;9;169;2;6340;7;3;
/org.eclipse.pde.ui/src/org/eclipse/pde/internal/ui/launcher/WorkbenchLaunchConfigurationDelegate.java;2;2;45;2;17;14;17;28;680;3;22;368;1294;1294;3;6;3;28;45;3775;9;6336;36;2;
/org.eclipse.ui.workbench/Eclipse UI/org/eclipse/ui/internal/commands/registry/Configuration.java;1;0;2;1;0;0;0;2;0;1;2;1077;0;0;1;0;0;2;2;1077;0;1222;2;1;
/org.eclipse.jdt.ui.tests.refactoring/resources/MoveMembers/test16/out/B.java;1;0;1;1;0;0;0;1;1;0;1;1522;1;1;1;0;0;1;1;1522;0;1522;1;1;
/org.eclipse.ui.workbench/Eclipse UI/org/eclipse/ui/internal/decorators/DecorationBuilder.java;2;1;3;1;3;3;3;0;14;0;0;5108;24;24;1;0;0;0;3;5108;0;6338;3;2;
/org.eclipse.team.ui/src/org/eclipse/team/ui/synchronize/actions/NavigateAction.java;1;0;1;1;0;0;0;1;0;0;1;2535;0;0;1;0;0;1;1;2535;0;2535;1;1;
/org.eclipse.ui.workbench/Eclipse UI/org/eclipse/ui/internal/registry/MarkerImageProviderRegistry.java;1;0;1;1;0;0;0;1;0;0;1;2737;0;0;1;0;0;1;1;2737;0;2737;1;1;
/org.eclipse.jdt.ui.tests.refactoring/resources/RenameVirtualMethodInClass/testLocal0/in/A.java;1;0;1;1;0;0;0;1;0;0;1;2821;0;0;1;0;0;1;1;2821;0;2821;1;1;
/org.eclipse.search/new search/org/eclipse/search2/internal/ui/ISearchQueryListener.java;1;0;2;1;0;0;0;2;0;1;2;3711;0;0;1;0;0;2;2;3711;0;4693;2;1;
/org.eclipse.jdt.ui.tests.refactoring/resources/SurroundWithWorkSpace/SurroundWithTests/trycatch_out/TestExpression.java;1;0;1;1;0;0;0;1;7;0;1;845;7;7;1;0;0;1;1;845;0;845;1;1;
/org.eclipse.jdt.ui.tests.refactoring/resources/ExtractMethodWorkSpace/ExtractMethodTests/nested_in/A_test654.java;1;0;1;1;0;0;0;1;2;0;1;844;2;2;1;0;0;1;1;844;0;844;1;1;
/org.eclipse.jdt.debug.ui/ui/org/eclipse/jdt/internal/debug/ui/actions/BreakpointLocationVerifier.java;1;0;1;1;0;0;0;1;0;0;1;3313;0;0;1;0;0;1;1;3313;0;3313;1;1;
/org.eclipse.jdt.ui.tests.refactoring/resources/PullUp/test19/out/A.java;1;0;1;1;0;0;0;1;2;0;1;1690;2;2;1;0;0;1;1;1690;0;1690;1;1;
/org.eclipse.team.ui/src/org/eclipse/team/ui/synchronize/SyncInfoDiffCheckboxTreeViewerConfiguration.java;1;0;1;1;0;0;0;1;0;0;1;3619;0;0;1;0;0;1;1;3619;0;3619;1;1;
/org.eclipse.ant.ui/Ant Editor/org/eclipse/ant/internal/ui/editor/templates/AntTemplateInformationControlCreator.java;1;0;1;1;1;1;1;0;0;0;0;5260;0;0;1;0;0;0;1;5260;0;5260;1;1;
/org.eclipse.jdt.core/search/org/eclipse/jdt/internal/core/index/impl/SimpleIndexInput.java;4;0;9;2;0;0;0;9;25;2;8;1824;64;64;2;1;0;9;9;3211;1;4060;8;4;
/org.eclipse.jdt.core/model/org/eclipse/jdt/core/ClasspathContainerInitializer.java;4;1;8;1;4;4;4;4;28;1;4;1802;88;88;1;0;0;4;8;1802;0;5660;8;4;
/org.eclipse.team.ui/src/org/eclipse/team/ui/sync/SyncInfoFilter.java;2;0;3;1;0;0;0;3;39;1;3;595;39;39;1;0;0;3;3;595;0;2632;3;2;
/org.eclipse.jdt.ui/ui/org/eclipse/jdt/internal/ui/text/java/hover/JavaSourceHover.java;3;1;9;1;2;2;2;7;106;1;7;692;138;138;1;0;0;7;9;692;0;6340;9;3;
/org.eclipse.jdt.core.tests.model/workspace/Formatter/test087/A_in.java;1;0;1;1;0;0;0;1;0;0;1;2425;0;0;1;0;0;1;1;2425;0;2425;1;1;
/org.eclipse.jdt.ui/ui/org/eclipse/jdt/internal/ui/text/correction/MissingReturnTypeCorrectionProposal.java;3;1;17;1;2;2;2;15;48;1;15;356;162;162;1;0;0;15;17;356;0;6340;17;3;
/org.eclipse.jdt.ui/core refactoring/org/eclipse/jdt/internal/corext/refactoring/changes/TextBufferChange.java;1;0;7;1;0;0;0;7;79;1;7;1953;142;142;1;0;0;7;7;1953;0;4624;7;1;
/org.eclipse.ui.workbench/Eclipse UI/org/eclipse/ui/internal/activities/ActivationServiceEvent.java;1;0;2;1;0;0;0;2;0;1;2;2728;0;0;1;0;0;2;2;2728;0;2800;2;1;
/org.eclipse.team.ui/src/org/eclipse/team/internal/ui/sync/ChangedTeamContainer.java;1;0;1;1;0;0;0;1;0;0;1;4216;0;0;1;0;0;1;1;4216;0;4216;1;1;
/org.eclipse.swt/Eclipse SWT/carbon/org/eclipse/swt/widgets/Display.java;7;2;67;2;12;11;12;55;389;2;44;5;2109;2109;2;11;1;55;67;174;12;6352;55;7;
/org.eclipse.compare/compare/org/eclipse/compare/internal/DocLineComparator.java;1;0;2;1;0;0;0;2;39;1;2;547;42;42;1;0;0;2;2;547;0;1289;2;1;
/org.eclipse.team.ui/src/org/eclipse/team/internal/ui/sync/views/SyncSet.java;2;0;7;1;0;0;0;7;390;2;6;488;541;541;2;1;0;7;7;1217;1;1354;6;2;
/org.eclipse.ui.workbench/Eclipse UI/org/eclipse/ui/actions/ActionContext.java;1;0;1;1;0;0;0;1;2;0;1;1;2;2;1;0;0;1;1;1;0;1;1;1;
/org.eclipse.debug.core/core/org/eclipse/debug/internal/core/variables/ContainerNameExpander.java;2;0;2;1;0;0;0;2;0;1;2;737;0;0;1;0;0;2;2;737;0;2120;2;2;
/org.eclipse.pde.runtime/src/org/eclipse/pde/internal/runtime/logview/BasePreviewSection.java;2;0;6;2;0;0;0;6;12;2;4;993;21;21;2;2;0;6;6;993;2;3754;4;2;
/org.eclipse.team.cvs.ui/src/org/eclipse/team/internal/ccvs/ui/wizards/CVSWizardPage.java;2;0;4;1;1;1;1;3;32;1;3;1080;81;81;1;0;0;3;4;1080;0;6337;4;2;
/org.eclipse.update.core/src/org/eclipse/update/core/InstallHandlerEntry.java;2;1;3;1;2;2;2;1;6;0;1;890;12;12;1;0;0;1;3;890;0;6336;3;2;
/org.eclipse.jdt.core.tests.model/workspace/Formatter/test086/A_in.java;1;0;1;1;0;0;0;1;0;0;1;2425;0;0;1;0;0;1;1;2425;0;2425;1;1;
/org.eclipse.ui.workbench/Eclipse UI/org/eclipse/ui/internal/commands/registry/RegistryEvent.java;1;0;2;1;0;0;0;2;0;1;2;1097;0;0;1;0;0;2;2;1097;0;1222;2;1;
/org.eclipse.sdk.tests-feature/plugins/org.eclipse.perfmsr.core/src/org/eclipse/perfmsr/core/PerformanceMonitor.java;2;2;17;2;16;14;16;1;90;0;1;4845;546;546;2;0;2;1;17;5400;2;6342;15;2;
/org.eclipse.team.tests.cvs.core/src/org/eclipse/team/tests/ccvs/ui/logformatter/PrintDiffMain.java;1;0;1;1;0;0;0;1;0;0;1;2632;0;0;1;0;0;1;1;2632;0;2632;1;1;
/org.eclipse.ant.ui/Ant Tools Support/org/eclipse/ant/internal/ui/launchConfigurations/AntPropertiesTab.java;2;0;5;1;0;0;0;5;29;1;5;1811;39;39;1;0;0;5;5;1811;0;4983;5;2;
/org.eclipse.update.ui/src/org/eclipse/update/internal/ui/views/FindUpdatesAction.java;3;1;16;2;3;3;3;13;18;2;11;825;90;90;2;2;0;13;16;890;2;6336;14;3;
/org.eclipse.pde.core/src/org/eclipse/pde/internal/core/search/IPluginSearchResultCollector.java;1;0;2;1;1;1;1;1;4;0;1;4203;8;8;1;0;0;1;2;4203;0;6336;2;1;
/org.eclipse.ui.workbench/Eclipse UI/org/eclipse/ui/commands/PropertyEvent.java;1;0;2;1;0;0;0;2;0;1;2;1119;0;0;1;0;0;2;2;1119;0;1222;2;1;
/org.eclipse.compare/compare/org/eclipse/compare/internal/Filter.java;1;0;2;1;0;0;0;2;0;0;1;3415;0;0;2;1;0;2;2;3415;1;3415;1;1;
/org.eclipse.jdt.core.tests.model/workspace/Converter/src/test0547/A.java;1;0;1;1;1;1;1;0;0;0;0;5334;0;0;1;0;0;0;1;5334;0;5334;1;1;
/org.eclipse.webdav/src/interface/org/eclipse/webdav/dom/ResponseBody.java;1;0;2;1;2;1;2;0;909;0;0;5151;909;909;2;0;1;0;2;5151;1;5151;1;1;
/org.eclipse.ui.examples.job/org/eclipse/ui/examples/jobs/actions/CreateJobsAction.java;1;0;2;1;2;1;2;0;0;0;0;5125;0;0;2;0;1;0;2;5125;1;5125;1;1;
/org.eclipse.team.cvs.ui/src/org/eclipse/team/internal/ccvs/ui/sync/CommitSyncAction.java;1;0;1;1;0;0;0;1;0;0;1;4217;0;0;1;0;0;1;1;4217;0;4217;1;1;
/org.eclipse.jdt.core.tests.model/workspace/Formatter/test473/A_out.java;1;0;1;1;0;0;0;1;0;0;1;3977;0;0;1;0;0;1;1;3977;0;3977;1;1;
/org.eclipse.jdt.ui.tests/examples/org/eclipse/jdt/ui/examples/TabExample.java;1;0;1;1;1;1;1;0;2;0;0;6340;2;2;1;0;0;0;1;6340;0;6340;1;1;
/org.eclipse.team.core/src/org/eclipse/team/core/subscribers/DescendantSynchronizationCache.java;1;0;1;1;0;0;0;1;0;0;1;3193;0;0;1;0;0;1;1;3193;0;3193;1;1;
/org.eclipse.jdt.ui.tests.refactoring/resources/RenameTemp/canRename/A_test0_out.java;1;0;1;1;0;0;0;1;4;0;1;4605;4;4;1;0;0;1;1;4605;0;4605;1;1;
/org.eclipse.team.ui/src/org/eclipse/team/ui/synchronize/subscriber/RefreshAction.java;1;0;6;1;0;0;0;6;98;2;5;3972;173;173;2;1;0;6;6;4240;1;4518;5;1;
/org.eclipse.update.ui.forms/src/org/eclipse/ui/forms/parts/Twistie.java;1;0;3;1;0;0;0;3;194;2;2;3071;194;194;2;1;0;3;3;3095;1;3095;2;1;
/org.eclipse.ui.workbench/Eclipse UI/org/eclipse/ui/model/WorkbenchLabelProvider.java;4;2;9;1;3;2;3;6;104;2;5;1;265;265;2;1;1;6;9;4083;2;6338;7;4;
/org.eclipse.swt/Eclipse SWT PI/motif/org/eclipse/swt/internal/motif/XEvent.java;1;0;2;1;0;0;0;2;4;1;2;868;6;6;1;0;0;2;2;868;0;1450;2;1;
/org.eclipse.jdt.ui.examples.javafamily/src/org/eclipse/core/indexsearch/SearchJob.java;1;0;4;1;0;0;0;4;6;1;4;1033;7;7;1;0;0;4;4;1033;0;3235;4;1;
/org.eclipse.compare.examples.xml/src/org/eclipse/compare/examples/xml/XMLStructureViewerCreator.java;1;0;2;1;0;0;0;2;2;1;2;1106;2;2;1;0;0;2;2;1106;0;3938;2;1;
/org.eclipse.jdt.core.tests.model/workspace/Converter/src/test0321/Test.java;1;0;1;1;0;0;0;1;0;0;1;3714;0;0;1;0;0;1;1;3714;0;3714;1;1;
/org.eclipse.pde.ui/src_Forms/org/eclipse/pde/internal/ui/neweditor/feature/IncludeFeaturesWizard.java;2;0;2;1;1;1;1;1;0;0;1;4926;0;0;1;0;0;1;2;4926;0;5431;2;2;
/org.eclipse.core.resources/src/org/eclipse/core/internal/events/InternalBuilder.java;2;0;5;1;2;1;2;3;217;1;3;3132;275;275;2;0;1;3;5;5146;1;5146;4;2;
/org.eclipse.search/search/org/eclipse/search/ui/ISearchPageScoreComputer.java;1;0;1;1;1;1;1;0;2;0;0;6340;2;2;1;0;0;0;1;6340;0;6340;1;1;
/org.eclipse.jdt.ui/ui refactoring/org/eclipse/jdt/internal/ui/refactoring/UseSupertypeInputPage.java;1;0;1;1;0;0;0;1;0;0;1;518;0;0;1;0;0;1;1;518;0;518;1;1;
/org.eclipse.jdt.core.tests.model/workspace/TypeHierarchy/src/q4/X.java;1;0;1;1;1;1;1;0;0;0;0;6073;0;0;1;0;0;0;1;6073;0;6073;1;1;
/org.eclipse.jdt.ui.tests.refactoring/resources/InlineMethodWorkspace/TestCases/invalid/TestFieldInitializer.java;1;0;1;1;0;0;0;1;0;0;1;2281;0;0;1;0;0;1;1;2281;0;2281;1;1;
/org.eclipse.pde.ui/src_Forms/org/eclipse/pde/internal/ui/neweditor/plugin/ClassAttributeRow.java;1;0;2;1;0;0;0;2;0;1;2;3834;0;0;1;0;0;2;2;3834;0;4354;2;1;
/org.eclipse.jdt.ui.tests.refactoring/resources/MoveInstanceMethod/canMove/test21/in/Second.java;1;0;1;1;0;0;0;1;0;0;1;1603;0;0;1;0;0;1;1;1603;0;1603;1;1;
/org.eclipse.ant.ui/Ant Tools Support/org/eclipse/ant/ui/internal/preferences/IAntBlockContainer.java;1;0;2;1;0;0;0;2;0;1;2;250;0;0;1;0;0;2;2;250;0;1811;2;1;
/org.eclipse.debug.ui/ui/org/eclipse/debug/internal/ui/actions/ProfileHistoryMenuAction.java;1;0;1;1;0;0;0;1;0;0;1;472;0;0;1;0;0;1;1;472;0;472;1;1;
/org.eclipse.jdt.ui/core extension/org/eclipse/jdt/internal/corext/template/TemplateVariable.java;1;0;1;1;0;0;0;1;0;0;1;4258;0;0;1;0;0;1;1;4258;0;4258;1;1;
/org.eclipse.jdt.core/model/org/eclipse/jdt/internal/core/Member.java;2;1;17;2;2;2;2;15;53;3;12;916;191;191;3;3;0;15;17;2053;3;5584;14;2;
/org.eclipse.ui.workbench/Eclipse UI/org/eclipse/ui/internal/csm/roles/api/IRoleListener.java;1;0;4;1;0;0;0;4;16;2;3;2213;18;18;2;1;0;4;4;2238;1;2238;3;1;
/org.eclipse.jdt.ui.tests/ui/org/eclipse/jdt/ui/tests/core/NameProposerTest.java;2;0;3;1;1;1;1;2;6;1;2;803;10;10;1;0;0;2;3;803;0;6340;3;2;
/org.eclipse.jdt.core.tests.model/workspace/Converter/src/javadoc/testBug51478/X2.java;1;0;2;1;1;1;1;1;2;0;1;3994;2;2;1;0;0;1;2;3994;0;5869;2;1;
/org.eclipse.jdt.core.tests.model/workspace/Converter/src/test0136/Test.java;1;0;1;1;0;0;0;1;0;0;1;3714;0;0;1;0;0;1;1;3714;0;3714;1;1;
/org.eclipse.team.cvs.ui/src/org/eclipse/team/internal/ccvs/ui/OverlayIcon.java;1;0;1;1;0;0;0;1;0;0;1;1955;0;0;1;0;0;1;1;1955;0;1955;1;1;
/org.eclipse.ant.ui/Ant Tools Support/org/eclipse/ant/internal/ui/launchConfigurations/AntConsoleColorProvider.java;2;0;5;1;0;0;0;5;62;1;5;1811;89;89;1;0;0;5;5;1811;0;4498;5;2;
/org.eclipse.core.resources/src/org/eclipse/core/internal/localstore/CoreFileSystemLibrary.java;3;0;4;1;1;1;1;3;43;1;3;121;61;61;1;0;0;3;4;121;0;5146;4;3;
/org.eclipse.team.ui/src/org/eclipse/team/internal/ui/synchronize/sets/SyncInfoWorkingSetFilter.java;1;0;3;1;0;0;0;3;127;1;3;2535;127;127;1;0;0;3;3;2535;0;4216;3;1;
/org.eclipse.ui.workbench/Eclipse UI/org/eclipse/ui/internal/contexts/registry/ContextDefinition.java;1;0;7;1;0;0;0;7;66;2;6;1396;159;159;2;1;0;7;7;1396;1;1724;6;1;
/org.eclipse.osgi/core/framework/org/eclipse/osgi/framework/launcher/EclipseLauncher.java;2;0;3;1;0;0;0;3;10;1;3;3013;10;10;1;0;0;3;3;3013;0;3163;3;2;
/org.eclipse.jdt.ui/ui/org/eclipse/jdt/internal/ui/callhierarchy/CallLocation.java;1;0;2;1;0;0;0;2;0;1;2;155;0;0;1;0;0;2;2;155;0;169;2;1;
/org.eclipse.jdt.core/compiler/org/eclipse/jdt/internal/compiler/IErrorHandlingPolicy.java;1;0;1;1;0;0;0;1;2;0;1;3560;2;2;1;0;0;1;1;3560;0;3560;1;1;
/org.eclipse.ui.externaltools/Ant Editor/org/eclipse/ui/externaltools/internal/ant/editor/EnclosingTargetSearchingHandler.java;1;0;2;1;0;0;0;2;8;1;2;178;8;8;1;0;0;2;2;178;0;282;2;1;
/org.eclipse.ui.workbench/Eclipse UI/org/eclipse/ui/contexts/ws/IWorkbenchContextSupport.java;1;0;1;1;0;0;0;1;0;0;1;3066;0;0;1;0;0;1;1;3066;0;3066;1;1;
/org.eclipse.jdt.core.tests.model/workspace/Formatter/test282/A_in.java;1;0;1;1;0;0;0;1;0;0;1;2443;0;0;1;0;0;1;1;2443;0;2443;1;1;
/org.eclipse.releng.tools/src/org/eclipse/releng/tools/LoadMap.java;2;1;4;1;4;4;4;0;13;0;0;5183;19;19;1;0;0;0;4;5183;0;6340;4;2;
/org.eclipse.jdt.ui/ui/org/eclipse/jdt/internal/ui/javaeditor/JavaSelectMarkerRulerAction2.java;4;1;6;1;2;2;2;4;100;1;4;2544;145;145;1;0;0;4;6;2544;0;6340;6;4;
/org.eclipse.jface.text/src/org/eclipse/jface/text/reconciler/DirtyRegionQueue.java;1;2;3;1;3;2;3;0;14;0;0;6340;16;16;2;0;1;0;3;6353;1;6353;2;1;
/org.eclipse.jdt.core.tests.builder/src/org/eclipse/jdt/core/tests/builder/ExecutionTests.java;3;0;5;1;0;0;0;5;4;1;5;764;14;14;1;0;0;5;5;764;0;3560;5;3;
/org.eclipse.team.webdav/src/org/eclipse/team/internal/ui/target/subscriber/PutAction.java;2;2;11;1;3;2;3;8;117;1;8;3499;249;249;2;0;1;8;11;5508;1;6337;10;2;
/org.eclipse.jdt.core.tests.model/workspace/Formatter/test118/A_out.java;1;0;1;1;0;0;0;1;0;0;1;2425;0;0;1;0;0;1;1;2425;0;2425;1;1;
/org.eclipse.jdt.ui/ui/org/eclipse/jdt/internal/ui/text/link/TabStopIterator.java;1;0;5;1;0;0;0;5;200;1;5;2838;206;206;1;0;0;5;5;2838;0;4214;5;1;
/org.eclipse.jdt.ui.tests.refactoring/test cases/org/eclipse/jdt/ui/tests/refactoring/RenameResourceChangeTests.java;3;0;4;1;1;1;1;3;36;1;3;469;47;47;1;0;0;3;4;469;0;6340;4;3;
/org.eclipse.jdt.ui.tests.refactoring/resources/ChangeTypeRefactoring/positive/A_testMultiCUInterface1.java;1;0;1;1;0;0;0;1;0;0;1;2844;0;0;1;0;0;1;1;2844;0;2844;1;1;
/org.eclipse.releng.tools/src/org/eclipse/releng/tools/FixCopyrightAction.java;2;2;4;1;4;3;4;0;680;0;0;5183;682;682;2;0;1;0;4;6322;1;6322;3;2;
/org.eclipse.ui.externaltools/External Tools Base/org/eclipse/ui/externaltools/internal/variable/ProjectExpander.java;1;0;1;1;0;0;0;1;0;0;1;321;0;0;1;0;0;1;1;321;0;321;1;1;
/org.eclipse.jdt.ui.tests.refactoring/resources/MoveInnerToTopLevel/test20/in/A1.java;1;0;1;1;0;0;0;1;2;0;1;305;2;2;1;0;0;1;1;305;0;305;1;1;
/org.eclipse.update.ui/src/org/eclipse/update/internal/ui/views/UpdatesDragAdapter.java;1;0;1;1;0;0;0;1;0;0;1;755;0;0;1;0;0;1;1;755;0;755;1;1;
/org.eclipse.ui.editors/src/org/eclipse/ui/internal/editors/quickdiff/RevertBlockAction.java;2;0;3;1;0;0;0;3;1;1;3;1214;1;1;1;0;0;3;3;1214;0;1644;3;2;
/org.eclipse.ltk.core.refactoring/src/org/eclipse/ltk/core/refactoring/TextFileChange.java;1;2;9;1;7;6;7;2;46;1;2;4845;92;92;2;0;1;2;9;6338;1;6352;8;1;
/org.eclipse.core.runtime/src/org/eclipse/core/internal/preferences/Base64.java;2;1;2;1;2;2;2;0;13;0;0;5108;18;18;1;0;0;0;2;5108;0;5879;2;2;
/org.eclipse.jdt.core/model/org/eclipse/jdt/internal/core/builder/AbortIncrementalBuildException.java;1;0;1;1;0;0;0;1;2;0;1;3560;2;2;1;0;0;1;1;3560;0;3560;1;1;
/org.eclipse.ui.workbench/Eclipse UI/org/eclipse/ui/internal/presentations/StandardSystemContribution.java;3;0;3;1;0;0;0;3;23;1;3;4504;23;23;1;0;0;3;3;4504;0;4680;3;3;
/org.eclipse.update.ui/src/org/eclipse/update/internal/ui/forms/UpdateWebForm.java;1;0;1;1;0;0;0;1;0;0;1;755;0;0;1;0;0;1;1;755;0;755;1;1;
/org.eclipse.swt/Eclipse SWT PI/carbon/org/eclipse/swt/internal/carbon/NavReplyRecord.java;1;2;3;1;3;2;3;0;16;0;0;5534;20;20;2;0;1;0;3;5534;1;5614;2;1;
/org.eclipse.jdt.ui/ui/org/eclipse/jdt/internal/ui/text/java/JavaStringDoubleClickSelector.java;3;0;3;1;1;1;1;2;15;1;2;1582;19;19;1;0;0;2;3;1582;0;6340;3;3;
/org.eclipse.jdt.ui/ui/org/eclipse/jdt/ui/actions/ProjectActionGroup.java;3;1;3;1;2;2;2;1;10;0;1;4307;16;16;1;0;0;1;3;4307;0;6340;3;3;
/org.eclipse.core.runtime/src/org/eclipse/core/internal/registry/ConfigurationProperty.java;3;1;6;1;3;3;3;3;122;1;3;3049;136;136;1;0;0;3;6;3049;0;6340;6;3;
/org.eclipse.ui.examples.javaeditor/Eclipse Java Editor Example/org/eclipse/ui/examples/javaeditor/spelling/DefaultSpellChecker.java;1;0;1;1;0;0;0;1;0;0;1;2565;0;0;1;0;0;1;1;2565;0;2565;1;1;
/org.eclipse.core.tests.runtime/src/org/eclipse/core/tests/internal/plugins/SoftPrereqTest_2.java;1;0;1;1;0;0;0;1;0;0;1;3014;0;0;1;0;0;1;1;3014;0;3014;1;1;
/org.eclipse.search/search/org/eclipse/search/internal/ui/util/ComboFieldEditor.java;1;0;1;1;1;1;1;0;2;0;0;6340;2;2;1;0;0;0;1;6340;0;6340;1;1;
/org.eclipse.jdt.ui/ui/org/eclipse/jdt/internal/ui/wizards/NewSnippetFileWizardPage.java;2;0;2;1;0;0;0;2;3;1;2;2742;3;3;1;0;0;2;2;2742;0;4920;2;2;
/org.eclipse.debug.ui/ui/org/eclipse/debug/internal/ui/views/console/ConsoleMessages.java;1;0;1;1;0;0;0;1;0;0;1;1415;0;0;1;0;0;1;1;1415;0;1415;1;1;
/org.eclipse.ltk.core.refactoring/src/org/eclipse/ltk/core/refactoring/participants/RenameProcessor.java;1;1;6;1;3;3;3;3;57;1;3;4845;129;129;1;0;0;3;6;4845;0;6340;6;1;
/org.eclipse.jdt.core.tests.model/workspace/Formatter/test121/A_out.java;1;0;1;1;0;0;0;1;0;0;1;2425;0;0;1;0;0;1;1;2425;0;2425;1;1;
/org.eclipse.help/src/org/eclipse/help/internal/search/SmartAnalyzer.java;1;0;1;1;0;0;0;1;0;0;1;2732;0;0;1;0;0;1;1;2732;0;2732;1;1;
/org.eclipse.ui.workbench/Eclipse UI/org/eclipse/ui/internal/decorators/DecoratorRegistryReader.java;3;0;4;1;1;1;1;3;30;1;3;2737;58;58;1;0;0;3;4;2737;0;6338;4;3;
/org.eclipse.ant.ui/Ant Editor/org/eclipse/ant/internal/ui/dtd/util/IValueHolder.java;1;0;1;1;0;0;0;1;0;0;1;1811;0;0;1;0;0;1;1;1811;0;1811;1;1;
/org.eclipse.jdt.core.tests.model/workspace/JavaSearch/src/j4/FF47209.java;1;0;1;1;0;0;0;1;0;0;1;3330;0;0;1;0;0;1;1;3330;0;3330;1;1;
/org.eclipse.jdt.ui.tests.refactoring/resources/MoveMembers/test39/in/A.java;1;0;1;1;0;0;0;1;0;0;1;2093;0;0;1;0;0;1;1;2093;0;2093;1;1;
/org.eclipse.jdt.ui.tests.refactoring/resources/DeleteSourceReference/test11/in/A.java;1;0;1;1;0;0;0;1;0;0;1;1652;0;0;1;0;0;1;1;1652;0;1652;1;1;
/org.eclipse.ui.workbench/Eclipse UI/org/eclipse/ui/internal/dialogs/PreferenceImportExportSettingsSelectionPage.java;3;0;3;1;1;1;1;2;10;1;2;3636;14;14;1;0;0;2;3;3636;0;6338;3;3;
/org.eclipse.search/new search/org/eclipse/search/ui/text/Match.java;3;1;7;1;5;5;5;2;79;1;2;3474;179;179;1;0;0;2;7;3474;0;6340;7;3;
/org.eclipse.ui.views/src/org/eclipse/ui/views/properties/PropertySheetPage.java;3;1;5;1;2;2;2;3;25;1;3;1;49;49;1;0;0;3;5;1;0;6338;5;3;
/org.eclipse.osgi/osgi/src/org/osgi/framework/Filter.java;2;0;2;1;1;1;1;1;3;0;1;3013;3;3;1;0;0;1;2;3013;0;5536;2;2;
/org.eclipse.jdt.ui.tests.refactoring/resources/ExtractMethodWorkSpace/ExtractMethodTests/try_out/A_test459.java;1;0;1;1;0;0;0;1;6;0;1;844;6;6;1;0;0;1;1;844;0;844;1;1;
/org.eclipse.update.ui.forms/src/org/eclipse/ui/forms/events/ExpansionListener.java;1;0;2;1;0;0;0;2;0;0;1;3095;0;0;2;1;0;2;2;3095;1;3095;1;1;
/org.eclipse.ui.workbench/Eclipse UI/org/eclipse/ui/internal/csm/commands/api/CategoryNotDefinedException.java;1;0;1;1;0;0;0;1;0;0;1;2532;0;0;1;0;0;1;1;2532;0;2532;1;1;
/org.eclipse.swt/Eclipse SWT/common/org/eclipse/swt/internal/image/PngIhdrChunk.java;2;0;2;1;1;1;1;1;4;0;1;4391;6;6;1;0;0;1;2;4391;0;6352;2;2;
/org.eclipse.swt/Eclipse SWT PI/gtk/org/eclipse/swt/internal/gtk/PangoLogAttr.java;2;0;2;1;1;1;1;1;2;0;1;4563;2;2;1;0;0;1;2;4563;0;6352;2;2;
/org.eclipse.ltk.core.refactoring/src/org/eclipse/ltk/core/refactoring/TextEditChangeGroup.java;1;1;3;1;2;2;2;1;3;0;1;4845;5;5;1;0;0;1;3;4845;0;6340;3;1;
/org.eclipse.jdt.ui.examples.javafamily/src/org/eclipse/jdt/internal/ui/examples/jspeditor/TemporaryAnnotation.java;1;0;4;1;0;0;0;4;149;1;4;1112;149;149;1;0;0;4;4;1112;0;2586;4;1;
/org.eclipse.update.core/src/org/eclipse/update/core/BaseInstallHandler.java;3;1;4;1;2;2;2;2;6;1;2;0;14;14;1;0;0;2;4;0;0;6336;4;3;
/org.eclipse.update.ui/src/org/eclipse/update/internal/ui/wizards/DeltaFeatureAdapter.java;2;0;5;1;1;1;1;4;4;2;3;755;8;8;2;1;0;4;5;755;1;5519;4;2;
/org.eclipse.ant.tests.ui/Ant Tests/org/eclipse/ant/tests/ui/BuildTests.java;1;1;13;1;2;2;2;11;84;2;8;1796;164;164;2;3;0;11;13;1865;3;6336;10;1;
/org.eclipse.jdt.ui.tests.refactoring/resources/ExtractMethodWorkSpace/ExtractMethodTests/locals_in/A_test514.java;1;0;1;1;0;0;0;1;3;0;1;844;3;3;1;0;0;1;1;844;0;844;1;1;
/org.eclipse.jdt.ui.tests.refactoring/resources/InlineMethodWorkspace/TestCases/argument_out/TestWrite.java;1;0;1;1;0;0;0;1;2;0;1;845;2;2;1;0;0;1;1;845;0;845;1;1;
/org.eclipse.update.ui.forms/src/org/eclipse/ui/forms/parts/ExpandableComposite.java;1;0;3;1;0;0;0;3;205;2;2;3080;205;205;2;1;0;3;3;3095;1;3095;2;1;
/org.eclipse.jdt.ui/core extension/org/eclipse/jdt/internal/corext/template/TemplateSet.java;2;0;3;1;0;0;0;3;39;1;3;664;62;62;1;0;0;3;3;664;0;4258;3;2;
/org.eclipse.jdt.ui.tests.refactoring/resources/ChangeSignature/canModify/A_testImport04_in.java;1;0;1;1;0;0;0;1;0;0;1;3820;0;0;1;0;0;1;1;3820;0;3820;1;1;
/org.eclipse.jdt.core/compiler/org/eclipse/jdt/internal/compiler/ast/MarkerAnnotation.java;1;0;1;1;0;0;0;1;0;0;1;4494;0;0;1;0;0;1;1;4494;0;4494;1;1;
/org.eclipse.update.ui/src/org/eclipse/update/internal/ui/wizards/ModeSelectionPage.java;3;0;14;1;1;1;1;13;57;3;10;196;165;165;3;3;0;13;14;196;3;6213;11;3;
/org.eclipse.jdt.ui/ui/org/eclipse/jdt/internal/ui/javaeditor/ToggleTextHoverAction.java;1;0;1;1;1;1;1;0;2;0;0;6340;2;2;1;0;0;0;1;6340;0;6340;1;1;
/org.eclipse.team.ui/src/org/eclipse/team/internal/ui/synchronize/UnchangedResourceModelElement.java;1;0;2;1;1;1;1;1;2;0;1;4588;2;2;1;0;0;1;2;4588;0;6337;2;1;
/org.eclipse.jdt.core.tests.model/workspace/Formatter/test036/A_in.java;1;0;1;1;0;0;0;1;0;0;1;2425;0;0;1;0;0;1;1;2425;0;2425;1;1;
/org.eclipse.pde.build/src/org/eclipse/pde/internal/build/Config.java;2;0;6;1;1;1;1;5;4;1;5;447;4;4;1;0;0;5;6;447;0;5145;6;2;
/org.eclipse.pde.ui/src_Forms/org/eclipse/pde/internal/ui/neweditor/feature/FeatureSpecSection.java;2;0;2;1;1;1;1;1;0;0;1;4926;0;0;1;0;0;1;2;4926;0;5431;2;2;
/org.eclipse.jdt.core/search/org/eclipse/jdt/core/search/SearchParticipant.java;4;2;15;1;7;6;7;8;171;2;7;3211;437;437;2;1;1;8;15;3332;2;6099;13;4;
/org.eclipse.ui.forms/src/org/eclipse/ui/internal/forms/widgets/FormsResources.java;1;0;2;1;1;1;1;1;6;0;1;5044;6;6;1;0;0;1;2;5044;0;6336;2;1;
/org.eclipse.ui.ide/src/org/eclipse/ui/internal/ResourcePerspective.java;2;0;2;1;0;0;0;2;0;1;2;1526;0;0;1;0;0;2;2;1526;0;2263;2;2;
/org.eclipse.jdt.ui/ui/org/eclipse/jdt/ui/wizards/BuildPathDialogs.java;1;0;2;1;2;1;2;0;0;0;0;5126;0;0;2;0;1;0;2;5126;1;5126;1;1;
/org.eclipse.jdt.ui.tests.refactoring/resources/ExtractMethodWorkSpace/ExtractMethodTests/expression_out/A_test602.java;1;0;3;1;0;0;0;3;4;1;3;844;4;4;1;0;0;3;3;844;0;1474;3;1;
/org.eclipse.jdt.ui/ui/org/eclipse/jdt/ui/JavaElementSorter.java;4;0;8;2;2;1;2;6;31;1;6;1441;82;82;2;0;1;6;8;6334;1;6334;7;4;
/org.eclipse.help.ui/src/org/eclipse/help/ui/internal/HyperlinkLabel.java;1;1;5;1;3;3;3;2;116;1;2;1879;197;197;1;0;0;2;5;1879;0;6337;5;1;
/org.eclipse.ui.workbench/Eclipse UI/org/eclipse/ui/internal/decorators/LightweightDecoratorDefinition.java;1;0;1;1;0;0;0;1;11;0;1;2737;11;11;1;0;0;1;1;2737;0;2737;1;1;
/org.eclipse.ui.views/src/org/eclipse/ui/views/properties/IResourcePropertyConstants.java;1;0;1;1;0;0;0;1;0;0;1;2738;0;0;1;0;0;1;1;2738;0;2738;1;1;
/org.eclipse.jdt.core.tests.model/workspace/JavaSearch/src/wc3/X44884.java;1;0;1;1;0;0;0;1;0;0;1;2659;0;0;1;0;0;1;1;2659;0;2659;1;1;
/org.eclipse.pde.ui/src/org/eclipse/pde/internal/ui/editor/manifest/JavaAttributeCellEditor.java;1;0;1;1;1;1;1;0;0;0;0;5431;0;0;1;0;0;0;1;5431;0;5431;1;1;
/org.eclipse.swt/Eclipse SWT Program/win32/org/eclipse/swt/program/Program.java;5;1;8;1;3;3;3;5;29;1;5;1512;123;123;1;0;0;5;8;1512;0;6352;8;5;
/org.eclipse.core.filebuffers/src/org/eclipse/core/internal/filebuffers/AbstractFileBuffer.java;2;2;4;1;3;2;3;1;60;0;1;2224;80;80;2;0;1;1;4;5918;1;6340;3;2;
/org.eclipse.team.core/src/org/eclipse/team/core/sync/TeamProvider.java;1;0;1;1;0;0;0;1;0;0;1;431;0;0;1;0;0;1;1;431;0;431;1;1;
/org.eclipse.update.ui/srcnew/org/eclipse/update/internal/ui/WebBookmarksDialog.java;2;0;4;1;0;0;0;4;25;1;4;705;26;26;1;0;0;4;4;705;0;825;4;2;
/org.eclipse.jdt.ui.tests.refactoring/resources/ExtractMethodWorkSpace/ExtractMethodTests/return_out/A_test707.java;1;0;1;1;0;0;0;1;6;0;1;844;6;6;1;0;0;1;1;844;0;844;1;1;
/org.eclipse.core.runtime.compatibility/src-boot/org/eclipse/core/boot/BootLoader.java;3;2;15;1;6;5;6;9;390;2;8;3013;644;644;2;1;1;9;15;3013;2;6340;13;3;
/org.eclipse.team.webdav/src/org/eclipse/team/ui/subscriber/ITeamRunnableContext.java;1;0;1;1;0;0;0;1;0;0;1;3373;0;0;1;0;0;1;1;3373;0;3373;1;1;
/org.eclipse.ui.ide/src/org/eclipse/ui/internal/dialogs/WelcomeEditor.java;2;0;5;1;0;0;0;5;65;1;5;1526;88;88;1;0;0;5;5;1526;0;2263;5;2;
/org.eclipse.jdt.ui/ui/org/eclipse/jdt/internal/ui/javaeditor/CustomBufferFactory.java;2;1;5;1;2;2;2;3;36;1;3;1136;73;73;1;0;0;3;5;1136;0;6340;5;2;
/org.eclipse.jdt.ui.tests/leaks/org/eclipse/jdt/ui/leaktest/example/LeakTestExample.java;2;0;3;1;1;1;1;2;14;1;2;3124;16;16;1;0;0;2;3;3124;0;6340;3;2;
/org.eclipse.update.ui/srcnew/org/eclipse/update/internal/ui/views/ConfigurationPreview.java;2;0;6;2;0;0;0;6;13;2;5;480;34;34;2;1;0;6;6;480;1;825;5;2;
/org.eclipse.jdt.ui/ui/org/eclipse/jdt/internal/ui/text/spelling/engine/ISpellCheckEngine.java;2;0;2;1;1;1;1;1;2;0;1;3930;2;2;1;0;0;1;2;3930;0;6340;2;2;
/org.eclipse.jdt.core/dom/org/eclipse/jdt/core/dom/IMethodBinding.java;3;0;5;1;0;0;0;5;25;1;5;3009;54;54;1;0;0;5;5;3009;0;4977;5;3;
/org.eclipse.jdt.core.tests.model/workspace/Converter/src/test0221/Test.java;1;0;1;1;0;0;0;1;0;0;1;3714;0;0;1;0;0;1;1;3714;0;3714;1;1;
/org.eclipse.jdt.ui.tests.refactoring/resources/IntroduceFactory/positive/MultiUnit1A_in.java;1;0;2;1;1;1;1;1;2;0;1;2862;2;2;1;0;0;1;2;2862;0;5659;2;1;
/org.eclipse.osgi/core/framework/org/eclipse/osgi/framework/internal/core/KeyedHashSet.java;5;1;6;1;4;4;4;2;632;1;2;3013;675;675;1;0;0;2;6;3013;0;6337;6;5;
/org.eclipse.search.tests/src/org/eclipse/search/tests/filesearch/JUnitSetup.java;1;0;1;1;1;1;1;0;0;0;0;5199;0;0;1;0;0;0;1;5199;0;5199;1;1;
/org.eclipse.releng.tools/src/org/eclipse/releng/tools/IBMCopyrightComment.java;1;3;5;1;5;2;5;0;14;0;0;6322;23;23;3;0;3;0;5;6322;3;6335;2;1;
/org.eclipse.team.cvs.ui/src/org/eclipse/team/internal/ccvs/ui/operations/CheckoutProjectOperation.java;2;2;25;1;9;8;9;16;426;1;16;664;1030;1030;2;0;1;16;25;5877;1;6337;24;2;
/org.eclipse.jdt.core/compiler/org/eclipse/jdt/internal/compiler/ast/ArrayQualifiedTypeReference.java;2;0;3;1;0;0;0;3;84;1;3;991;92;92;1;0;0;3;3;991;0;3560;3;2;
/org.eclipse.ui.workbench/Eclipse UI/org/eclipse/ui/internal/chris/roles/FileRoleRegistry.java;1;0;2;1;0;0;0;2;0;1;2;1952;0;0;1;0;0;2;2;1952;0;2213;2;1;
/org.eclipse.ui.workbench/Eclipse UI/org/eclipse/ui/internal/progress/AnimationManager.java;3;1;40;1;4;4;4;36;451;3;29;1496;1522;1522;3;7;0;36;40;1630;7;6338;33;3;
/org.eclipse.ui.externaltools/Ant Tools Support/org/eclipse/ui/externaltools/internal/ant/preferences/ColorEditor.java;1;0;1;1;0;0;0;1;0;0;1;282;0;0;1;0;0;1;1;282;0;282;1;1;
/org.eclipse.ui.workbench/Eclipse UI/org/eclipse/ui/internal/SystemSummaryEditorInputFactory.java;1;0;1;1;0;0;0;1;0;0;1;2737;0;0;1;0;0;1;1;2737;0;2737;1;1;
/org.eclipse.jdt.ui/ui/org/eclipse/jdt/internal/ui/callhierarchy/ICallHierarchyHelpContextIds.java;1;0;3;1;0;0;0;3;1;1;3;155;1;1;1;0;0;3;3;155;0;184;3;1;
/org.eclipse.pde.ui/src/org/eclipse/pde/internal/ui/search/UnusedDependenciesAction.java;3;1;5;1;3;3;3;2;80;1;2;2950;116;116;1;0;0;2;5;2950;0;6336;5;3;
/org.eclipse.text/src/org/eclipse/jface/text/IDocumentExtension3.java;3;1;5;1;3;3;3;2;81;1;2;1510;133;133;1;0;0;2;5;1510;0;6340;5;3;
/org.eclipse.search/search/org/eclipse/search/internal/ui/text/FileSearchDescription.java;2;0;2;1;1;1;1;1;2;0;1;3711;2;2;1;0;0;1;2;3711;0;6340;2;2;
/org.eclipse.jdt.core/compiler/org/eclipse/jdt/internal/compiler/ast/QualifiedThisReference.java;2;0;4;1;0;0;0;4;4;1;4;991;12;12;1;0;0;4;4;991;0;3560;4;2;
/org.eclipse.ui.intro/src/org/eclipse/ui/internal/intro/impl/html/HTMLElement.java;1;1;2;1;2;2;2;0;2;0;0;5115;2;2;1;0;0;0;2;5115;0;5314;2;1;
/org.eclipse.swt/Eclipse SWT Drag and Drop/emulated/org/eclipse/swt/dnd/DragSource.java;1;0;1;1;0;0;0;1;4;0;1;0;4;4;1;0;0;1;1;0;0;0;1;1;
/org.eclipse.jdt.debug.ui/ui/org/eclipse/jdt/internal/debug/ui/launcher/NameValuePairDialog.java;2;0;3;1;0;0;0;3;26;1;3;112;53;53;1;0;0;3;3;112;0;3201;3;2;
/org.eclipse.swt/Eclipse SWT Printing/carbon/org/eclipse/swt/printing/Printer.java;3;2;14;1;6;5;6;8;376;2;7;0;489;489;2;1;1;8;14;2492;2;6352;12;3;
/org.eclipse.help/src/org/eclipse/help/internal/standalone/EclipseController.java;1;0;3;1;0;0;0;3;241;1;3;1880;289;289;1;0;0;3;3;1880;0;2732;3;1;
/org.eclipse.team.cvs.core/src/org/eclipse/team/internal/ccvs/core/client/CRLFDetectInputStream.java;1;0;4;1;0;0;0;4;35;2;3;1985;66;66;2;1;0;4;4;1985;1;3131;3;1;
/org.eclipse.jdt.debug.ui/ui/org/eclipse/jdt/internal/debug/ui/JavaStepFilterPreferencePage.java;4;2;9;2;4;3;4;5;175;1;5;3114;260;260;2;0;1;5;9;5439;1;6336;8;4;
/org.eclipse.jdt.core.tests.model/workspace/JavaSearch/src/j4/FM47209.java;1;0;1;1;0;0;0;1;0;0;1;3330;0;0;1;0;0;1;1;3330;0;3330;1;1;
/org.eclipse.ui.forms.examples/src/org/eclipse/ui/forms/examples/internal/rcp/IModelListener.java;1;0;2;1;1;1;1;1;16;0;1;4075;16;16;1;0;0;1;2;4075;0;5781;2;1;
/org.eclipse.jface/src/org/eclipse/jface/preference/RadioGroupFieldEditor.java;2;1;3;1;2;2;2;1;4;0;1;5040;9;9;1;0;0;1;3;5040;0;6338;3;2;
/org.eclipse.team.ui/src/org/eclipse/team/ui/sync/actions/workingsets/WorkingSetMenuContributionItem.java;1;0;1;1;0;0;0;1;0;0;1;2451;0;0;1;0;0;1;1;2451;0;2451;1;1;
/org.eclipse.team.ui/src/org/eclipse/team/internal/ui/synchronize/RefreshEvent.java;1;1;5;1;2;2;2;3;4;2;2;4558;9;9;2;1;0;3;5;4558;1;6337;4;1;
/org.eclipse.jdt.ui.tests.refactoring/resources/ExtractMethodWorkSpace/ExtractMethodTests/duplicates_out/A_test960.java;1;1;2;1;2;2;2;0;2;0;0;5650;2;2;1;0;0;0;2;5650;0;5681;2;1;
/org.eclipse.jdt.core/model/org/eclipse/jdt/internal/compiler/parser/SourceConstructorDeclaration.java;1;0;1;1;0;0;0;1;0;0;1;4461;0;0;1;0;0;1;1;4461;0;4461;1;1;
/org.eclipse.jdt.ui/ui/org/eclipse/jdt/internal/ui/text/correction/LinkedModeProposal.java;1;0;3;1;0;0;0;3;56;2;2;1152;56;56;2;1;0;3;3;1152;1;1171;2;1;
/org.eclipse.jdt.core.tests.model/workspace/Converter/test0137/Test.java;1;0;1;1;0;0;0;1;0;0;1;3714;0;0;1;0;0;1;1;3714;0;3714;1;1;
/org.eclipse.jdt.ui.tests.refactoring/resources/Copy/test_import_container_yes_cu/out/A.java;1;0;1;1;0;0;0;1;0;0;1;696;0;0;1;0;0;1;1;696;0;696;1;1;
/org.eclipse.jdt.ui.tests.refactoring/resources/ExtractMethodWorkSpace/ExtractMethodTests/locals_in/A_test550.java;1;0;1;1;0;0;0;1;2;0;1;844;2;2;1;0;0;1;1;844;0;844;1;1;
/org.eclipse.jdt.ui.tests.refactoring/resources/ExtractMethodWorkSpace/ExtractMethodTests/return_out/A_test722.java;1;0;2;1;0;0;0;2;6;1;2;130;7;7;1;0;0;2;2;130;0;844;2;1;
/org.eclipse.core.runtime.osgi/src/org/eclipse/core/runtime/Preferences.java;2;0;3;2;0;0;0;3;29;2;2;3013;31;31;2;1;0;3;3;3013;1;3030;2;2;
/org.eclipse.ui.workbench/Eclipse UI/org/eclipse/ui/internal/commands/old/IKeyMachine.java;1;0;4;1;0;0;0;4;38;1;4;1321;44;44;1;0;0;4;4;1321;0;1695;4;1;
/org.eclipse.jdt.core.tests.model/workspace/Converter/test0020/Test.java;1;0;1;1;0;0;0;1;0;0;1;3714;0;0;1;0;0;1;1;3714;0;3714;1;1;
/org.eclipse.swt/Eclipse SWT/gtk/org/eclipse/swt/widgets/ImageList.java;4;0;5;1;1;1;1;4;21;1;4;649;49;49;1;0;0;4;5;649;0;6352;5;4;
/org.eclipse.jdt.core.tests.model/workspace/Formatter/test483/A_out.java;1;0;1;1;0;0;0;1;0;0;1;4173;0;0;1;0;0;1;1;4173;0;4173;1;1;
/org.eclipse.team.cvs.ui/src/org/eclipse/team/internal/ccvs/ui/WorkInProgressPreferencePage.java;2;0;7;1;0;0;0;7;11;1;7;1015;26;26;1;0;0;7;7;1015;0;2929;7;2;
/org.eclipse.jdt.ui/ui/org/eclipse/jdt/internal/ui/javaeditor/ClassFileDocumentProvider.java;2;0;5;1;1;1;1;4;25;1;4;1350;46;46;1;0;0;4;5;1350;0;6340;5;2;
/org.eclipse.jdt.ui/core refactoring/org/eclipse/jdt/internal/corext/refactoring/tagging/ITextUpdatingRefactoring.java;1;0;1;1;0;0;0;1;0;0;1;1126;0;0;1;0;0;1;1;1126;0;1126;1;1;
/org.eclipse.jdt.ui.tests.refactoring/resources/MoveInstanceMethod/canMove/test21/in/A.java;1;0;1;1;0;0;0;1;0;0;1;1603;0;0;1;0;0;1;1;1603;0;1603;1;1;
/org.eclipse.jdt.core/dom/org/eclipse/jdt/core/dom/Statement.java;2;0;6;1;1;1;1;5;26;1;5;3560;50;50;1;0;0;5;6;3560;0;5335;6;2;
/org.eclipse.debug.core/core/org/eclipse/debug/internal/core/LaunchConfigurationWorkingCopy.java;5;2;12;2;6;5;6;6;115;2;5;1239;248;248;2;1;1;6;12;2936;2;6336;10;5;
/org.eclipse.jdt.debug.ui/ui/org/eclipse/jdt/internal/debug/ui/actions/OpenDeclaringTypeAction.java;1;0;1;1;0;0;0;1;4;0;1;2497;4;4;1;0;0;1;1;2497;0;2497;1;1;
/org.eclipse.jdt.core.tests.model/workspace/Formatter/test275/A_out.java;1;0;1;1;0;0;0;1;0;0;1;2443;0;0;1;0;0;1;1;2443;0;2443;1;1;
/org.eclipse.compare/compare/org/eclipse/compare/internal/CompareOutlinePage.java;1;0;2;1;0;0;0;2;10;1;2;3935;12;12;1;0;0;2;2;3935;0;3954;2;1;
/org.eclipse.jdt.core.tests.model/workspace/Completion/src3/test0024/Test.java;1;0;1;1;1;1;1;0;0;0;0;5206;0;0;1;0;0;0;1;5206;0;5206;1;1;
/org.eclipse.jdt.core.tests.model/workspace/Formatter/test258/A_out.java;1;0;1;1;0;0;0;1;0;0;1;2442;0;0;1;0;0;1;1;2442;0;2442;1;1;
/org.eclipse.ui.workbench/Eclipse UI/org/eclipse/ui/application/IWorkbenchConfigurer.java;5;2;9;2;3;2;3;6;145;1;6;1259;218;218;2;0;1;6;9;6338;1;6338;8;5;
/org.eclipse.jdt.ui/core refactoring/org/eclipse/jdt/internal/corext/refactoring/participants/RenameRefactoring.java;1;0;3;1;0;0;0;3;95;1;3;591;95;95;1;0;0;3;3;591;0;1125;3;1;
/org.eclipse.ui.ide/src/org/eclipse/ui/views/markers/internal/RestartableJob.java;2;0;9;2;3;1;3;6;23;2;5;3214;64;64;3;1;2;6;9;6338;3;6338;6;2;
/org.eclipse.jdt.core/compiler/org/eclipse/jdt/internal/compiler/problem/AbortCompilationUnit.java;2;0;2;1;1;1;1;1;5;0;1;3560;7;7;1;0;0;1;2;3560;0;5615;2;2;
/org.eclipse.ltk.core.refactoring.tests/src/org/eclipse/ltk/core/refactoring/tests/AllTests.java;1;1;4;1;2;2;2;2;3;1;2;4845;7;7;1;0;0;2;4;4845;0;6340;4;1;
/org.eclipse.jdt.debug.ui/ui/org/eclipse/jdt/internal/debug/ui/monitors/MonitorsDebugEventHandler.java;2;1;2;1;2;2;2;0;37;0;0;5733;41;41;1;0;0;0;2;5733;0;6336;2;2;
/org.eclipse.update.ui/srcnew/org/eclipse/update/internal/ui/wizards/IUnifiedDynamicPage.java;2;0;3;1;0;0;0;3;5;1;3;488;5;5;1;0;0;3;3;488;0;825;3;2;
/org.eclipse.ui.workbench/Eclipse UI/org/eclipse/ui/internal/IChangeListener.java;2;0;2;1;0;0;0;2;24;1;2;3692;24;24;1;0;0;2;2;3692;0;4015;2;2;
/org.eclipse.pde.build/src/org/eclipse/pde/internal/build/site/BuildTimeFeatureFactory.java;2;1;13;1;5;5;5;8;15;1;8;447;36;36;1;0;0;8;13;447;0;5702;13;2;
/org.eclipse.jdt.core/eval/org/eclipse/jdt/internal/eval/CodeSnippetScope.java;4;0;7;1;1;1;1;6;20;1;6;85;37;37;1;0;0;6;7;85;0;6126;7;4;
/org.eclipse.pde.ui/src/org/eclipse/pde/internal/ui/preferences/ExternalPluginsBlock.java;3;2;23;2;9;7;9;14;69;2;13;217;266;266;2;1;2;14;23;2672;3;6336;20;3;
/org.eclipse.pde.ui/src_Forms/org/eclipse/pde/internal/ui/neweditor/schema/SchemaInputContext.java;2;0;3;2;1;1;1;2;5;0;1;4856;5;5;2;1;0;2;3;4856;1;5431;2;2;
/org.eclipse.ui.ide/src/org/eclipse/ui/internal/actions/AboutAction.java;2;0;3;1;0;0;0;3;34;2;2;1672;34;34;2;1;0;3;3;1672;1;2263;2;2;
/org.eclipse.debug.ui/ui/org/eclipse/debug/internal/ui/DebugUIPlugin.java;5;3;83;2;31;22;31;52;281;2;48;321;1486;1486;3;4;9;52;83;5129;13;6143;70;5;
/org.eclipse.update.ui/src/org/eclipse/update/internal/ui/forms/MainForm.java;1;0;1;1;0;0;0;1;0;0;1;755;0;0;1;0;0;1;1;755;0;755;1;1;
/org.eclipse.ua.tests/src/org/eclipse/ui/examples/cheatsheets/pattern/actions/OpenNewJavaProjectWizardWithNameAction.java;1;0;1;1;1;1;1;0;0;0;0;6081;0;0;1;0;0;0;1;6081;0;6081;1;1;
/org.eclipse.jdt.debug.ui/ui/org/eclipse/jdt/internal/debug/ui/snippeteditor/ScrapbookMain1.java;1;0;1;1;0;0;0;1;0;0;1;724;0;0;1;0;0;1;1;724;0;724;1;1;
/org.eclipse.team.tests.core/src/org/eclipse/team/tests/core/RemoteResourceTests.java;1;0;1;1;0;0;0;1;0;0;1;2495;0;0;1;0;0;1;1;2495;0;2495;1;1;
/org.eclipse.team.cvs.ui/src/org/eclipse/team/internal/ccvs/ui/subscriber/CompareRevertAction.java;2;1;8;1;2;2;2;6;101;1;6;3709;221;221;1;0;0;6;8;3709;0;6337;8;2;
/org.eclipse.jdt.ui.tests.refactoring/resources/SurroundWithWorkSpace/SurroundWithTests/trycatch_in/TestMultiLine.java;1;0;1;1;0;0;0;1;2;0;1;845;2;2;1;0;0;1;1;845;0;845;1;1;
/org.eclipse.tomcat/src/org/eclipse/tomcat/internal/TomcatResources.java;2;1;7;1;3;3;3;4;105;1;4;105;128;128;1;0;0;4;7;105;0;6337;7;2;
/org.eclipse.debug.ui/ui/org/eclipse/debug/internal/ui/actions/EditLaunchConfigurationAction.java;3;0;5;1;1;1;1;4;15;2;3;134;48;48;2;1;0;4;5;2589;1;5207;4;3;
/org.eclipse.help/src/org/eclipse/help/internal/workingset/IHelpWorkingSetManager.java;1;0;4;1;0;0;0;4;66;1;4;364;77;77;1;0;0;4;4;364;0;2732;4;1;
/org.eclipse.ui.workbench/Eclipse UI/org/eclipse/ui/internal/dialogs/ViewContentProvider.java;6;0;16;2;1;1;1;15;179;2;12;1938;609;609;2;3;0;15;16;2279;3;6338;13;6;
/org.eclipse.jdt.core.tests.model/workspace/Formatter/test335/A_out.java;1;0;2;1;0;0;0;2;4;1;2;2742;4;4;1;0;0;2;2;2742;0;3029;2;1;
/org.eclipse.jdt.ui/core extension/org/eclipse/jdt/internal/corext/callhierarchy/MethodReferencesSearchCollector.java;2;0;4;1;1;1;1;3;3;1;3;169;4;4;1;0;0;3;4;169;0;5264;4;2;
/org.eclipse.pde.core/src/org/eclipse/pde/internal/core/ModelProviderEvent.java;1;0;2;1;1;1;1;1;6;0;1;3604;10;10;1;0;0;1;2;3604;0;6336;2;1;
/org.eclipse.jdt.ui.tests.refactoring/resources/MoveInnerToTopLevel/test_nonstatic_32/out/A.java;1;0;1;1;0;0;0;1;2;0;1;305;2;2;1;0;0;1;1;305;0;305;1;1;
/org.eclipse.jdt.ui/core extension/org/eclipse/jdt/internal/corext/util/RefactoringWorkignCopyOwner.java;1;0;2;1;0;0;0;2;0;1;2;1166;0;0;1;0;0;2;2;1166;0;1185;2;1;
/org.eclipse.jdt.core/dom/org/eclipse/jdt/core/dom/ThrowStatement.java;3;1;8;1;2;2;2;6;78;1;6;3560;108;108;1;0;0;6;8;3560;0;5272;8;3;
/org.eclipse.team.ui/src/org/eclipse/team/internal/ui/jobs/RefreshSubscriberJob.java;2;0;18;1;0;0;0;18;213;2;15;1117;535;535;2;3;0;18;18;1187;3;4518;15;2;
/org.eclipse.ui.workbench/Eclipse UI/org/eclipse/ui/internal/csm/commands/PreferenceCommandRegistry.java;1;0;4;1;0;0;0;4;22;3;2;2532;22;22;3;2;0;4;4;2553;2;2553;2;1;
/org.eclipse.ui.workbench/Eclipse UI/org/eclipse/ui/commands/NaturalKey.java;1;0;2;1;0;0;0;2;0;0;1;1340;0;0;2;1;0;2;2;1340;1;1340;1;1;
/org.eclipse.core.runtime/src/org/eclipse/core/internal/plugins/InternalFactory.java;1;0;1;1;0;0;0;1;0;0;1;3013;0;0;1;0;0;1;1;3013;0;3013;1;1;
/org.eclipse.ui.ide/extensions/org/eclipse/ui/actions/CopyProjectOperation.java;3;0;3;1;1;1;1;2;19;1;2;2263;21;21;1;0;0;2;3;2263;0;6338;3;3;
/org.eclipse.ant.ui/Ant Tools Support/org/eclipse/ant/internal/ui/model/IAntUIConstants.java;3;1;19;2;2;2;2;17;8;2;15;1811;49;49;2;2;0;17;19;1915;2;5602;17;3;
/org.eclipse.ui.workbench/Eclipse UI/org/eclipse/ui/internal/IPartDropListener.java;1;0;1;1;0;0;0;1;0;0;1;4600;0;0;1;0;0;1;1;4600;0;4600;1;1;
/org.eclipse.jdt.core.tests.model/workspace/Formatter/test438/A_in.java;1;0;1;1;0;0;0;1;0;0;1;3498;0;0;1;0;0;1;1;3498;0;3498;1;1;
/org.eclipse.jdt.debug.tests/testprograms/org/eclipse/debug/tests/targets/SourceLookup.java;1;0;1;1;0;0;0;1;0;0;1;811;0;0;1;0;0;1;1;811;0;811;1;1;
/org.eclipse.ui.ide/extensions/org/eclipse/ui/actions/CreateProjectAction.java;3;0;4;1;1;1;1;3;4;1;3;2263;9;9;1;0;0;3;4;2263;0;6338;4;3;
/org.eclipse.ant.ui/Ant Editor/org/eclipse/ant/internal/ui/dtd/util/IKeyHolder.java;1;0;1;1;0;0;0;1;0;0;1;1811;0;0;1;0;0;1;1;1811;0;1811;1;1;
/org.eclipse.ui.tests/Eclipse UI Tests/org/eclipse/ui/tests/preferences/DeprecatedFontPreferenceTestCase.java;1;0;2;1;0;0;0;2;8;1;2;2754;8;8;1;0;0;2;2;2754;0;3091;2;1;
/org.eclipse.jface/src/org/eclipse/jface/util/Geometry.java;4;0;7;1;0;0;0;7;274;1;7;3712;571;571;1;0;0;7;7;3712;0;4623;7;4;
/org.eclipse.ant.ui/Ant Tools Support/org/eclipse/ant/internal/ui/views/actions/RemoveAllAction.java;1;0;2;1;0;0;0;2;4;1;2;1811;4;4;1;0;0;2;2;1811;0;1861;2;1;
/org.eclipse.sdk.tests-feature/plugins/org.eclipse.perfmsr.ui.client/src/org/eclipse/perfmsr/ui/client/StepDescriptor.java;1;1;4;1;4;4;4;0;12;0;0;5443;26;26;1;0;0;0;4;5443;0;5803;4;1;
/org.eclipse.ltk.ui.refactoring/src/org/eclipse/ltk/internal/ui/refactoring/TextChangePreviewViewer.java;1;1;8;1;5;5;5;3;71;1;3;4965;219;219;1;0;0;3;8;4965;0;6340;8;1;
/org.eclipse.ui.ide/src/org/eclipse/ui/internal/dialogs/CreateLinkedResourceGroup.java;2;0;4;1;0;0;0;4;25;1;4;1526;27;27;1;0;0;4;4;1526;0;2263;4;2;
/org.eclipse.ui.tests/Eclipse JFace Tests/org/eclipse/jface/tests/viewers/StructuredSelectionTest.java;1;0;1;1;0;0;0;1;13;0;1;1293;13;13;1;0;0;1;1;1293;0;1293;1;1;
/org.eclipse.ui.workbench.texteditor/src/org/eclipse/ui/internal/texteditor/quickdiff/QuickDiffRestoreAction.java;2;1;5;1;2;2;2;3;11;1;3;1644;21;21;1;0;0;3;5;1644;0;6340;5;2;
/org.eclipse.ui.ide/src/org/eclipse/ui/actions/ExportResourcesAction.java;2;0;11;1;0;0;0;11;83;2;10;1511;135;135;2;1;0;11;11;1632;1;2263;10;2;
/org.eclipse.jdt.core.tests.model/workspace/Formatter/test463/A_in.java;1;0;1;1;0;0;0;1;0;0;1;3902;0;0;1;0;0;1;1;3902;0;3902;1;1;
/org.eclipse.update.core/src/org/eclipse/update/internal/search/UnifiedSiteSearchCategory.java;2;0;3;1;0;0;0;3;2;2;2;825;2;2;2;1;0;3;3;890;1;890;2;2;
/org.eclipse.jdt.ui/core refactoring/org/eclipse/ltk/core/refactoring/PerformRefactoringOperation.java;1;0;3;1;0;0;0;3;36;1;3;4510;36;36;1;0;0;3;3;4510;0;4864;3;1;
/org.eclipse.core.tests.resources/src/org/eclipse/core/tests/internal/utils/CacheTest.java;1;0;1;1;1;1;1;0;0;0;0;5445;0;0;1;0;0;0;1;5445;0;5445;1;1;
/org.eclipse.jdt.ui/core extension/org/eclipse/jdt/internal/corext/textmanipulation/Updater.java;1;0;2;1;0;0;0;2;73;0;1;1946;73;73;2;1;0;2;2;1946;1;1946;1;1;
/org.eclipse.core.expressions/src/org/eclipse/core/expressions/ExpressionTagNames.java;1;0;3;1;1;1;1;2;5;1;2;4108;7;7;1;0;0;2;3;4108;0;5184;3;1;
/org.eclipse.swt.tests/JUnit Tests/org/eclipse/swt/tests/junit/Test_org_eclipse_swt_graphics_Font.java;2;0;2;1;0;0;0;2;8;1;2;2227;11;11;1;0;0;2;2;2227;0;2380;2;2;
/org.eclipse.ant.ui/Ant Tools Support/org/eclipse/ui/ant/internal/views/actions/RefreshBuildFilesAction.java;1;0;2;1;0;0;0;2;0;1;2;250;0;0;1;0;0;2;2;250;0;263;2;1;
/org.eclipse.jdt.core/dom/org/eclipse/jdt/core/dom/SimpleType.java;4;2;11;1;3;2;3;8;76;1;8;1114;124;124;2;0;1;8;11;5268;1;5268;10;4;
/org.eclipse.jdt.core.tests.model/workspace/Converter/test0494/A.java;1;0;2;1;0;0;0;2;0;1;2;1950;0;0;1;0;0;2;2;1950;0;3714;2;1;
/org.eclipse.ant.ui/Ant Editor/org/eclipse/ant/internal/ui/editor/AntEditorCompletionProcessor.java;2;2;64;1;20;16;20;44;325;3;36;1811;2658;2658;3;8;4;44;64;4219;12;6019;52;2;
/org.eclipse.ui.workbench/Eclipse UI/org/eclipse/ui/internal/registry/PerspectiveDescriptor.java;7;0;14;2;1;1;1;13;25;2;12;830;155;155;2;1;0;13;14;3061;1;6338;13;7;
/org.eclipse.debug.ui/ui/org/eclipse/debug/internal/ui/views/console/ConsoleViewer.java;4;1;14;1;4;4;4;10;19;1;10;1189;87;87;1;0;0;10;14;1189;0;6336;14;4;
/org.eclipse.jdt.core.tests.model/workspace/Converter/test0189/Test.java;1;0;1;1;0;0;0;1;0;0;1;3714;0;0;1;0;0;1;1;3714;0;3714;1;1;
/org.eclipse.jdt.ui/ui refactoring/org/eclipse/jdt/internal/ui/refactoring/actions/RefactoringStarter.java;3;0;13;1;1;1;1;12;87;1;12;42;214;214;1;0;0;12;13;42;0;6340;13;3;
/org.eclipse.ui.workbench/Eclipse UI/org/eclipse/ui/internal/registry/NewWizardsRegistryReader.java;5;0;7;1;1;1;1;6;93;1;6;2737;196;196;1;0;0;6;7;2737;0;6338;7;5;
/org.eclipse.jdt.ui/core refactoring/org/eclipse/ltk/core/refactoring/participants/ParticipantManager.java;1;0;2;1;0;0;0;2;0;1;2;4688;0;0;1;0;0;2;2;4688;0;4864;2;1;
/org.eclipse.jdt.ui/core extension/org/eclipse/jdt/internal/corext/dom/CopyIndentedSourceEdit.java;2;0;3;1;0;0;0;3;45;1;3;825;54;54;1;0;0;3;3;825;0;1626;3;2;
/org.eclipse.jdt.text.tests/src/org/eclipse/jdt/text/tests/comments/MultiLineTestCase.java;1;1;2;1;2;2;2;0;6;0;0;5129;6;6;1;0;0;0;2;5129;0;6340;2;1;
/org.eclipse.team.ui/src/org/eclipse/team/ui/sync/ISynchronizeTargetListener.java;1;0;1;1;0;0;0;1;0;0;1;2378;0;0;1;0;0;1;1;2378;0;2378;1;1;
/org.eclipse.ui.workbench/Eclipse UI/org/eclipse/ui/internal/roles/ICategoryDefinition.java;1;0;2;1;0;0;0;2;0;0;1;2864;0;0;2;1;0;2;2;2864;1;2864;1;1;
/org.eclipse.team.ui/src/org/eclipse/team/internal/ui/actions/DeconfigureProjectAction.java;1;0;1;1;1;1;1;0;0;0;0;5447;0;0;1;0;0;0;1;5447;0;5447;1;1;
/org.eclipse.pde.ui/templates_3.0/editor/java/XMLScanner.java;1;0;1;1;0;0;0;1;0;0;1;2786;0;0;1;0;0;1;1;2786;0;2786;1;1;
/org.eclipse.test/src/org/eclipse/test/RegressionTest.java;1;0;3;1;1;1;1;2;17;1;2;2984;35;35;1;0;0;2;3;2984;0;6297;3;1;
/org.eclipse.update.ui.win32/src/org/eclipse/welcome/internal/actions/WelcomeContentProvider.java;1;0;2;1;0;0;0;2;4;1;2;925;4;4;1;0;0;2;2;925;0;4143;2;1;
/org.eclipse.jdt.core.tests.model/workspace/Converter/src/test0486/A.java;1;0;1;1;0;0;0;1;0;0;1;3714;0;0;1;0;0;1;1;3714;0;3714;1;1;
/org.eclipse.jdt.ui/ui/org/eclipse/jdt/internal/ui/typehierarchy/MethodsContentProvider.java;2;0;2;1;1;1;1;1;9;0;1;3961;11;11;1;0;0;1;2;3961;0;6340;2;2;
/org.eclipse.ui.workbench/Eclipse UI/org/eclipse/ui/activities/ws/FilterableObject.java;1;0;1;1;0;0;0;1;0;0;1;3066;0;0;1;0;0;1;1;3066;0;3066;1;1;
/org.eclipse.team.ui/src/org/eclipse/team/ui/synchronize/TwoSectionParticipantPage.java;1;0;1;1;0;0;0;1;0;0;1;3185;0;0;1;0;0;1;1;3185;0;3185;1;1;
/org.eclipse.jdt.core/search/org/eclipse/jdt/internal/core/search/indexing/IndexRequest.java;2;0;6;1;0;0;0;6;18;2;5;2840;46;46;2;1;0;6;6;2840;1;4060;5;2;
/org.eclipse.jdt.ui/ui/org/eclipse/jdt/internal/ui/text/comment/JavaDocRange.java;1;0;5;1;0;0;0;5;150;1;5;1589;255;255;1;0;0;5;5;1589;0;2310;5;1;
/org.eclipse.jdt.core.tests.model/workspace/Converter/src/test0094/Test.java;1;0;1;1;0;0;0;1;0;0;1;3714;0;0;1;0;0;1;1;3714;0;3714;1;1;
/org.eclipse.core.tests.resources/src/org/eclipse/core/tests/internal/builders/SortBuilder.java;1;0;3;1;3;1;3;0;666;0;0;5147;666;666;3;0;2;0;3;5147;2;5147;1;1;
/org.eclipse.jdt.ui.tests.refactoring/test cases/org/eclipse/jdt/ui/tests/refactoring/RenameMethodInInterfaceTests.java;4;1;13;1;4;4;4;9;18;1;9;130;114;114;1;0;0;9;13;130;0;6340;13;4;
/org.eclipse.debug.ui/ui/org/eclipse/debug/internal/ui/stringsubstitution/SelectedTextResolver.java;2;0;4;1;0;0;0;4;25;1;4;3586;36;36;1;0;0;4;4;3586;0;4781;4;2;
/org.eclipse.osgi/core/framework/org/eclipse/osgi/framework/security/action/CreateThread.java;2;0;3;1;1;1;1;2;23;1;2;3013;23;23;1;0;0;2;3;3013;0;5107;3;2;
/org.eclipse.team.ui/src/org/eclipse/team/ui/sync/ISynchronizeManager.java;1;0;1;1;0;0;0;1;0;0;1;2406;0;0;1;0;0;1;1;2406;0;2406;1;1;
/org.eclipse.webdav/src/kernel/org/eclipse/webdav/internal/kernel/DocumentFactory.java;1;0;2;1;1;1;1;1;16;0;1;2549;21;21;1;0;0;1;2;2549;0;5151;2;1;
/org.eclipse.jdt.ui.tests.refactoring/resources/ExtractTemp/canExtract/A_test70_in.java;1;0;1;1;0;0;0;1;0;0;1;1569;0;0;1;0;0;1;1;1569;0;1569;1;1;
/org.eclipse.ui.ide/src/org/eclipse/ui/views/tasklist/NewTaskAction.java;1;0;1;1;0;0;0;1;0;0;1;2208;0;0;1;0;0;1;1;2208;0;2208;1;1;
/org.eclipse.ant.ui/Ant Tools Support/org/eclipse/ant/ui/internal/launchConfigurations/AntProcess.java;1;0;4;1;0;0;0;4;4;1;4;250;6;6;1;0;0;4;4;250;0;1811;4;1;
/org.eclipse.pde.ui/src/org/eclipse/pde/internal/ui/editor/manifest/ManifestSourcePageNew.java;1;0;6;1;1;1;1;5;31;1;5;2320;64;64;1;0;0;5;6;2320;0;5431;6;1;
/org.eclipse.jdt.ui/ui/org/eclipse/jdt/internal/ui/text/correction/ChangeCorrectionProposal.java;3;0;14;1;1;1;1;13;57;1;13;1152;207;207;1;0;0;13;14;1152;0;5128;14;3;
/org.eclipse.jdt.core/search/org/eclipse/jdt/internal/core/search/matching/MatchingOpenableSet.java;1;0;1;1;0;0;0;1;0;0;1;77;0;0;1;0;0;1;1;77;0;77;1;1;
/org.eclipse.ui.workbench/Eclipse UI/org/eclipse/ui/internal/presentations/SystemMenuMoveFolder.java;1;1;2;1;2;2;2;0;4;0;0;5173;4;4;1;0;0;0;2;5173;0;5517;2;1;
/org.eclipse.team.webdav/src/org/eclipse/team/ui/target/subscriber/ToolTipMessageDialog.java;1;0;1;1;0;0;0;1;0;0;1;3383;0;0;1;0;0;1;1;3383;0;3383;1;1;
/org.eclipse.ui.ide/src/org/eclipse/ui/views/tasklist/SelectAllTasksAction.java;1;0;1;1;0;0;0;1;0;0;1;2208;0;0;1;0;0;1;1;2208;0;2208;1;1;
/org.eclipse.jdt.core.tests.model/workspace/Converter/junit/framework/TestSuite.java;1;0;2;1;0;0;0;2;132;1;2;787;132;132;1;0;0;2;2;787;0;3714;2;1;
/org.eclipse.team.ui/src/org/eclipse/team/ui/sync/actions/ToggleViewLayoutAction.java;1;0;1;1;0;0;0;1;0;0;1;2446;0;0;1;0;0;1;1;2446;0;2446;1;1;
/org.eclipse.jdt.core.tests.model/workspace/Formatter/test103/A_in.java;1;0;1;1;0;0;0;1;0;0;1;2425;0;0;1;0;0;1;1;2425;0;2425;1;1;
/org.eclipse.team.core/src/org/eclipse/team/core/sync/TeamDelta.java;1;0;1;1;0;0;0;1;0;0;1;488;0;0;1;0;0;1;1;488;0;488;1;1;
/org.eclipse.jdt.ui/core refactoring/org/eclipse/jdt/internal/corext/refactoring/util/JavaElementUtil.java;3;0;5;1;1;1;1;4;17;1;4;328;59;59;1;0;0;4;5;328;0;6340;5;3;
/org.eclipse.ui.workbench/Eclipse UI/org/eclipse/ui/internal/dialogs/FilteredPreferenceLabelProvider.java;1;0;2;1;0;0;0;2;0;1;2;4068;0;0;1;0;0;2;2;4068;0;4530;2;1;
/org.eclipse.jdt.ui.tests.refactoring/resources/ExtractMethodWorkSpace/ExtractMethodTests/return_out/A_test710.java;1;0;2;1;0;0;0;2;6;1;2;130;7;7;1;0;0;2;2;130;0;844;2;1;
/org.eclipse.update.core/src/org/eclipse/update/search/UpdateSearchScope.java;2;1;6;1;2;2;2;4;21;1;4;825;42;42;1;0;0;4;6;825;0;6336;6;2;
/org.eclipse.osgi/core/framework/org/eclipse/osgi/framework/msg/MessageFormat.java;4;1;5;1;2;2;2;3;481;1;3;3013;504;504;1;0;0;3;5;3013;0;5232;5;4;
/org.eclipse.core.tests.runtime/src/org/eclipse/core/tests/internal/plugins/RegressionResolveTest_5.java;1;0;1;1;0;0;0;1;0;0;1;3014;0;0;1;0;0;1;1;3014;0;3014;1;1;
/org.eclipse.team.cvs.core/src/org/eclipse/team/internal/ccvs/core/syncinfo/CVSDescendantSynchronizationCache.java;2;0;4;1;0;0;0;4;62;2;3;3199;74;74;2;1;0;4;4;4233;1;4233;3;2;
/org.eclipse.jdt.ui.tests/test plugin/org/eclipse/jdt/testplugin/util/SizingTestPass.java;1;0;1;1;1;1;1;0;2;0;0;6340;2;2;1;0;0;0;1;6340;0;6340;1;1;
/org.eclipse.jface.text/src/org/eclipse/jface/contentassist/IContextInformationPresenterExtension.java;1;1;2;1;2;2;2;0;0;0;0;5181;0;0;1;0;0;0;2;5181;0;5199;2;1;
/org.eclipse.update.core/src/org/eclipse/update/internal/api/operations/IUninstallFeatureOperation.java;1;0;2;1;0;0;0;2;0;1;2;3270;0;0;1;0;0;2;2;3270;0;4928;2;1;
/org.eclipse.team.cvs.core/src/org/eclipse/team/internal/ccvs/core/util/ReplaceWithBaseVisitor.java;2;0;4;1;1;1;1;3;45;1;3;1672;64;64;1;0;0;3;4;1672;0;6337;4;2;
/org.eclipse.jdt.ui/core extension/org/eclipse/jdt/internal/corext/dom/RewriteRuntimeException.java;1;0;2;1;1;1;1;1;0;0;1;3692;0;0;1;0;0;1;2;3692;0;5406;2;1;
/org.eclipse.text/projection/org/eclipse/jface/text/ProjectionPositionUpdater.java;2;0;3;1;1;1;1;2;1;1;2;3648;2;2;1;0;0;2;3;3648;0;5177;3;2;
/org.eclipse.swt/Eclipse SWT/carbon/org/eclipse/swt/widgets/Monitor.java;1;0;3;1;0;0;0;3;9;2;2;20;9;9;2;1;0;3;3;29;1;29;2;1;
/org.eclipse.jdt.core/dom/org/eclipse/jdt/core/internal/dom/rewrite/NodeInfoStore.java;2;0;3;2;0;0;0;3;1;2;2;4711;1;1;2;1;0;3;3;4711;1;4802;2;2;
/org.eclipse.update/src/org/eclipse/update/internal/core/UpdateManagerException.java;1;0;1;1;1;1;1;0;0;0;0;6339;0;0;1;0;0;0;1;6339;0;6339;1;1;
/org.eclipse.ui.workbench/Eclipse UI/org/eclipse/ui/internal/commands/api/ICommand.java;1;0;2;1;0;0;0;2;2;0;1;2562;2;2;2;1;0;2;2;2562;1;2562;1;1;
/org.eclipse.jdt.launching/launching/org/eclipse/jdt/internal/launching/JavaLaunchConfigurationUtils.java;1;0;2;1;0;0;0;2;31;1;2;2449;35;35;1;0;0;2;2;2449;0;2463;2;1;
/org.eclipse.swt/Eclipse SWT Drag and Drop/gtk/org/eclipse/swt/dnd/ByteArrayTransfer.java;3;0;4;1;1;1;1;3;28;2;2;317;34;34;2;1;0;3;4;317;1;6352;3;3;
/org.eclipse.team.cvs.ui/src/org/eclipse/team/internal/ccvs/ui/subscriber/CVSParticipantLabelDecorator.java;2;1;4;1;4;4;4;0;70;0;0;5534;121;121;1;0;0;0;4;5534;0;6078;4;2;
/org.eclipse.jdt.ui.tests.refactoring/resources/ExtractMethodWorkSpace/ExtractMethodTests/duplicates_out/A_test959.java;1;1;2;1;2;2;2;0;2;0;0;5650;2;2;1;0;0;0;2;5650;0;5681;2;1;
/org.eclipse.jdt.core.tests.model/workspace/Formatter/test392/A_out.java;1;0;1;1;0;0;0;1;0;0;1;3175;0;0;1;0;0;1;1;3175;0;3175;1;1;
/org.eclipse.jdt.debug.ui/ui/org/eclipse/jdt/internal/debug/ui/actions/PopupDisplayAction.java;4;1;14;1;4;4;4;10;103;2;8;3833;383;383;2;2;0;10;14;3833;2;5802;12;4;
/org.eclipse.update.core/src/org/eclipse/update/internal/core/FileResponse.java;3;1;5;1;2;2;2;3;41;1;3;890;69;69;1;0;0;3;5;890;0;6336;5;3;
/org.eclipse.jdt.core.tests.model/workspace/Converter/test0141/Test.java;1;0;1;1;0;0;0;1;0;0;1;3714;0;0;1;0;0;1;1;3714;0;3714;1;1;
/org.eclipse.jdt.core.tests.model/workspace/Resolve/src/ResolveDuplicateMethodDeclaration5.java;1;0;1;1;1;1;1;0;0;0;0;6222;0;0;1;0;0;0;1;6222;0;6222;1;1;
/org.eclipse.ui.ide/src/org/eclipse/ui/internal/ide/registry/MarkerQuery.java;3;1;3;1;2;2;2;1;2;0;1;2264;4;4;1;0;0;1;3;2264;0;6338;3;3;
/org.eclipse.ui.workbench/Eclipse UI/org/eclipse/ui/internal/dialogs/WorkbenchPreferencePage.java;4;1;12;1;6;6;6;6;575;1;6;1080;917;917;1;0;0;6;12;1080;0;6338;12;4;
/org.eclipse.jdt.core.tests.model/workspace/Formatter/test016/A_out.java;1;0;1;1;0;0;0;1;0;0;1;2425;0;0;1;0;0;1;1;2425;0;2425;1;1;
/org.eclipse.ui.forms/src/org/eclipse/ui/forms/IPartSelectionListener.java;1;0;4;1;0;0;0;4;5;1;4;4068;10;10;1;0;0;4;4;4068;0;5044;4;1;
/org.eclipse.team.ui/src/org/eclipse/team/internal/ui/ConfigureProjectWizard.java;2;0;3;1;0;0;0;3;10;1;3;866;12;12;1;0;0;3;3;866;0;993;3;2;
/org.eclipse.jdt.ui/core refactoring/org/eclipse/jdt/internal/corext/refactoring/SearchResult.java;3;0;5;1;1;1;1;4;16;1;4;80;45;45;1;0;0;4;5;80;0;5375;5;3;
/org.eclipse.jdt.core.tests.model/workspace/Formatter/test008/A_out.java;1;0;1;1;0;0;0;1;0;0;1;2425;0;0;1;0;0;1;1;2425;0;2425;1;1;
/org.eclipse.team.tests.cvs.core/src/org/eclipse/team/tests/ccvs/core/subscriber/AllTestsTeamSubscriber.java;2;0;10;1;1;1;1;9;33;1;9;771;62;62;1;0;0;9;10;771;0;6337;10;2;
/org.eclipse.text/src/org/eclipse/text/edits/DeleteEdit.java;2;0;4;1;1;1;1;3;16;1;3;1986;32;32;1;0;0;3;4;1986;0;6340;4;2;
/org.eclipse.help.base/src/org/eclipse/help/internal/search/QueryBuilder.java;1;1;7;1;4;4;4;3;221;2;2;1740;329;329;2;1;0;3;7;1740;1;6337;6;1;
/org.eclipse.jdt.debug.tests/tests/org/eclipse/jdt/debug/tests/eval/FieldValueTests.java;1;0;1;1;0;0;0;1;18;0;1;1274;18;18;1;0;0;1;1;1274;0;1274;1;1;
/org.eclipse.swt/Eclipse SWT/motif/org/eclipse/swt/graphics/TextLayout.java;3;2;28;1;17;15;17;11;532;3;8;4564;1093;1093;3;3;2;11;28;4738;5;6352;23;3;
/org.eclipse.jdt.ui.tests.refactoring/resources/InlineMethodWorkspace/TestCases/call_out/TestParenthesis.java;1;0;1;1;0;0;0;1;2;0;1;845;2;2;1;0;0;1;1;845;0;845;1;1;
/org.eclipse.ui.workbench/Eclipse UI/org/eclipse/ui/commands/ActionServiceEvent.java;1;0;2;1;0;0;0;2;0;1;2;3129;0;0;1;0;0;2;2;3129;0;3258;2;1;
/org.eclipse.jdt.core.tests.model/workspace/Converter/src/test0551/A.java;1;0;1;1;1;1;1;0;0;0;0;5470;0;0;1;0;0;0;1;5470;0;5470;1;1;
/org.eclipse.jdt.ui.tests.refactoring/resources/IntroduceFactory/positive/UnmovableArg2_in.java;1;0;2;1;1;1;1;1;2;0;1;2846;2;2;1;0;0;1;2;2846;0;5659;2;1;
/org.eclipse.search/search/org/eclipse/search/ui/IGroupByKeyComputer.java;2;1;3;1;3;3;3;0;3;0;0;6116;7;7;1;0;0;0;3;6116;0;6340;3;2;
/org.eclipse.jdt.core/dom/org/eclipse/jdt/core/dom/MemberRef.java;2;1;9;1;2;2;2;7;90;1;7;3683;133;133;1;0;0;7;9;3683;0;5272;9;2;
/org.eclipse.debug.ui/ui/org/eclipse/debug/internal/ui/LazyModelPresentation.java;3;1;12;1;4;4;4;8;40;2;7;1157;191;191;2;1;0;8;12;1157;1;6336;11;3;
/org.eclipse.jdt.core.tests.model/workspace/Converter/src/test0193/Test.java;1;0;1;1;0;0;0;1;0;0;1;3714;0;0;1;0;0;1;1;3714;0;3714;1;1;
/org.eclipse.pde.ui/src/org/eclipse/pde/internal/ui/preferences/InProgressPreferencePage.java;2;0;4;1;0;0;0;4;5;1;4;2296;8;8;1;0;0;4;4;2296;0;4203;4;2;
/org.eclipse.team.core/src/org/eclipse/team/core/subscribers/ISyncInfoSetChangeEvent.java;1;0;1;1;0;0;0;1;0;0;1;3550;0;0;1;0;0;1;1;3550;0;3550;1;1;
/org.eclipse.pde.core/src_OSGi/org/eclipse/pde/internal/core/osgi/bundle/BundlePluginModel.java;2;0;2;1;0;0;0;2;0;1;2;2485;0;0;1;0;0;2;2;2485;0;4203;2;2;
/org.eclipse.jdt.ui/ui refactoring/org/eclipse/jdt/internal/ui/refactoring/participants/QualifiedNameComponent.java;1;0;2;1;0;0;0;2;0;1;2;591;0;0;1;0;0;2;2;591;0;1047;2;1;
/org.eclipse.team.cvs.ui/src/org/eclipse/team/internal/ccvs/ui/sync/CVSSyncSet.java;2;0;2;1;0;0;0;2;6;1;2;866;6;6;1;0;0;2;2;866;0;4217;2;2;
/org.eclipse.jdt.ui/ui/org/eclipse/jdt/internal/ui/preferences/CorrectionMessages.java;1;0;1;1;1;1;1;0;4;0;0;6340;4;4;1;0;0;0;1;6340;0;6340;1;1;
/org.eclipse.jdt.ui/ui/org/eclipse/jdt/internal/ui/preferences/formatter/CreateProfileDialog.java;2;0;10;1;1;1;1;9;74;2;8;3103;210;210;2;1;0;9;10;3103;1;6120;9;2;
/org.eclipse.jdt.core.tests.model/workspace/Converter/src/test0392/A.java;1;0;1;1;0;0;0;1;0;0;1;3714;0;0;1;0;0;1;1;3714;0;3714;1;1;
/org.eclipse.team.core/src/org/eclipse/team/core/synchronize/ISubscriberResourceComparator.java;1;0;1;1;0;0;0;1;0;0;1;4045;0;0;1;0;0;1;1;4045;0;4045;1;1;
/org.eclipse.pde.ui/src/org/eclipse/pde/internal/ui/wizards/StatusWizardPage.java;1;0;1;1;0;0;0;1;0;0;1;3839;0;0;1;0;0;1;1;3839;0;3839;1;1;
/org.eclipse.jdt.ui.tests.refactoring/resources/IntroduceFactory/positive/DifferentSigs.java;1;0;2;1;1;1;1;1;2;0;1;2862;2;2;1;0;0;1;2;2862;0;5659;2;1;
/org.eclipse.jdt.core.tests.model/workspace/Formatter/test370/A_out.java;2;0;3;1;0;0;0;3;12;1;3;3130;13;13;1;0;0;3;3;3130;0;3362;3;2;
/org.eclipse.jdt.ui.tests.refactoring/resources/IntroduceFactory/positive/multipleCallers_FFF.java;1;0;2;1;0;0;0;2;0;1;2;2846;0;0;1;0;0;2;2;2846;0;2862;2;1;
/org.eclipse.jdt.core/model/org/eclipse/jdt/internal/core/SourceMethodElementInfo.java;1;0;2;1;0;0;0;2;2;1;2;2035;4;4;1;0;0;2;2;2035;0;3560;2;1;
/org.eclipse.debug.core/core/org/eclipse/debug/internal/core/stringsubstitution/StringSubstitutionEngine.java;2;0;5;1;0;0;0;5;31;1;5;2032;53;53;1;0;0;5;5;2032;0;2514;5;2;
/org.eclipse.ui.forms/src/org/eclipse/ui/forms/internal/widgets/FormTextModel.java;1;0;4;1;0;0;0;4;4;2;3;4147;6;6;2;1;0;4;4;4147;1;5044;3;1;
/org.eclipse.swt/Eclipse SWT/motif/org/eclipse/swt/widgets/Monitor.java;1;0;4;1;0;0;0;4;18;2;2;16;24;24;2;2;0;4;4;16;2;28;2;1;
/org.eclipse.jdt.core/compiler/org/eclipse/jdt/internal/compiler/ast/ConstructorDeclaration.java;4;1;17;2;2;2;2;15;37;2;12;62;109;109;2;3;0;15;17;2397;3;5615;14;4;
/org.eclipse.webdav/src/kernel/org/eclipse/webdav/internal/kernel/EntityTag.java;1;0;2;1;2;1;2;0;33;0;0;5151;33;33;2;0;1;0;2;5151;1;5151;1;1;
/org.eclipse.jdt.ui/core extension/org/eclipse/jdt/internal/corext/template/java/JavaDocContext.java;3;1;8;1;2;2;2;6;16;2;5;4258;37;37;2;1;0;6;8;4258;1;6340;7;3;
/org.eclipse.jface.text/src/org/eclipse/jface/text/source/ICharacterPairMatcher.java;2;1;2;1;2;2;2;0;16;0;0;6340;18;18;1;0;0;0;2;6340;0;6361;2;2;
/org.eclipse.ui.workbench/Eclipse UI/org/eclipse/ui/internal/chris/roles/api/IRoleActivationService.java;1;0;2;1;0;0;0;2;0;0;1;2207;0;0;2;1;0;2;2;2207;1;2207;1;1;
/org.eclipse.update.ui/src/org/eclipse/update/internal/ui/wizards/NewUpdateSiteDialog.java;3;0;8;1;1;1;1;7;20;1;7;825;40;40;1;0;0;7;8;825;0;5660;8;3;
/org.eclipse.pde.core/src_OSGi/org/eclipse/pde/core/osgi/bundle/IBundleFragmentModel.java;2;0;2;1;0;0;0;2;0;1;2;2485;0;0;1;0;0;2;2;2485;0;4203;2;2;
/org.eclipse.jdt.debug.ui/ui/org/eclipse/jdt/internal/debug/ui/actions/BreakpointSuspendPolicyToggleAction.java;1;0;1;1;0;0;0;1;2;0;1;2497;2;2;1;0;0;1;1;2497;0;2497;1;1;
/org.eclipse.ui.workbench/Eclipse UI/org/eclipse/ui/keys/NonModifierKey.java;1;0;2;1;0;0;0;2;0;1;2;1294;0;0;1;0;0;2;2;1294;0;1321;2;1;
/org.eclipse.pde.ui/src_Forms/org/eclipse/pde/internal/ui/neweditor/EmptyOutlinePage.java;2;1;4;1;3;3;3;1;0;0;1;3795;0;0;1;0;0;1;4;3795;0;5431;4;2;
/org.eclipse.pde.core/src/org/eclipse/pde/internal/core/bundle/FragmentUtil.java;1;1;2;1;2;2;2;0;0;0;0;5445;0;0;1;0;0;0;2;5445;0;5512;2;1;
/org.eclipse.jdt.ui.tests.refactoring/resources/DeleteSourceReferenceEdit/A_test2_out.java;1;0;1;1;0;0;0;1;0;0;1;1652;0;0;1;0;0;1;1;1652;0;1652;1;1;
/org.eclipse.update.ui/src/org/eclipse/update/internal/ui/properties/ConfiguredSitePropertyPage.java;3;1;6;1;3;3;3;3;15;1;3;825;40;40;1;0;0;3;6;825;0;6336;6;3;
/org.eclipse.ui.ide/src/org/eclipse/ui/internal/dialogs/AboutPluginsDialog.java;2;0;3;1;0;0;0;3;26;1;3;1671;26;26;1;0;0;3;3;1671;0;2263;3;2;
/org.eclipse.swt/Eclipse SWT PI/gtk/org/eclipse/swt/internal/gtk/GnomeVFSMimeApplication.java;2;0;4;1;0;0;0;4;47;1;4;1653;57;57;1;0;0;4;4;1653;0;4333;4;2;
/org.eclipse.update.ui/src/org/eclipse/update/internal/ui/views/FeatureSorter.java;2;0;3;1;0;0;0;3;11;1;3;550;16;16;1;0;0;3;3;550;0;1489;3;2;
/org.eclipse.update.ui/srcnew/org/eclipse/update/internal/ui/preferences/UpdateSettingsPreferencePage.java;2;0;4;1;0;0;0;4;8;2;3;624;9;9;2;1;0;4;4;624;1;825;3;2;
/org.eclipse.osgi/resolver/src/org/eclipse/core/internal/dependencies/ElementChange.java;4;1;4;1;3;3;3;1;61;0;1;3013;84;84;1;0;0;1;4;3013;0;5507;4;4;
/org.eclipse.core.runtime/src/org/eclipse/core/internal/dependencies/ElementSet.java;2;0;2;1;0;0;0;2;0;1;2;2105;0;0;1;0;0;2;2;2105;0;3013;2;2;
/org.eclipse.core.tests.runtime/src/org/eclipse/core/tests/internal/plugins/SoftPrereqTest_13.java;1;0;1;1;0;0;0;1;0;0;1;3014;0;0;1;0;0;1;1;3014;0;3014;1;1;
/org.eclipse.jdt.ui/core refactoring/org/eclipse/jdt/internal/corext/refactoring/changes/AddToClasspathChange.java;4;1;8;1;2;2;2;6;67;1;6;458;140;140;1;0;0;6;8;458;0;6340;8;4;
/org.eclipse.jdt.ui.tests.refactoring/resources/InlineMethodWorkspace/TestCases/nameconflict_out/TestSwitchStatement.java;1;0;1;1;0;0;0;1;4;0;1;845;4;4;1;0;0;1;1;845;0;845;1;1;
/org.eclipse.jdt.core.tests.model/workspace/Converter15/src/test0018/X.java;1;0;1;1;0;0;0;1;0;0;1;4826;0;0;1;0;0;1;1;4826;0;4826;1;1;
/org.eclipse.core.tests.resources/src/org/eclipse/core/tests/internal/localstore/FileSystemStoreTest.java;1;0;3;1;3;1;3;0;812;0;0;5147;812;812;3;0;2;0;3;5147;2;5147;1;1;
/org.eclipse.jdt.ui/ui/org/eclipse/jdt/internal/ui/reorg/ClipboardActionUtil.java;1;0;2;1;0;0;0;2;13;1;2;130;13;13;1;0;0;2;2;130;0;1111;2;1;
/org.eclipse.jdt.junit/src/org/eclipse/jdt/internal/junit/wizards/NewTestCaseCreationWizardPage2.java;3;1;5;1;3;3;3;2;98;1;2;183;167;167;1;0;0;2;5;183;0;6340;5;3;
/org.eclipse.pde.core/src/org/eclipse/pde/internal/core/ibundle/IBundlePluginBase.java;1;1;2;1;2;2;2;0;6;0;0;5445;6;6;1;0;0;0;2;5445;0;6336;2;1;
/org.eclipse.pde.ui/src/org/eclipse/pde/internal/ui/preferences/ComboFieldEditor.java;1;0;2;1;0;0;0;2;7;1;2;368;7;7;1;0;0;2;2;368;0;3839;2;1;
/org.eclipse.team.ftp/src/org/eclipse/team/internal/ftp/ui/subscriber/FTPExportWizard.java;2;1;7;1;4;4;4;3;82;1;3;3494;130;130;1;0;0;3;7;3494;0;6337;7;2;
/org.eclipse.jdt.core.tests.model/workspace/Converter/src/test0211/Test.java;1;0;1;1;0;0;0;1;0;0;1;3714;0;0;1;0;0;1;1;3714;0;3714;1;1;
/org.eclipse.jdt.debug/model/org/eclipse/jdt/internal/debug/core/model/JDIObjectValue.java;2;0;2;1;1;1;1;1;6;0;1;3774;10;10;1;0;0;1;2;3774;0;6336;2;2;
/org.eclipse.team.cvs.ui/src/org/eclipse/team/internal/ccvs/ui/TimeoutProgressMonitorDialog.java;1;0;2;1;1;1;1;1;2;0;1;4216;4;4;1;0;0;1;2;4216;0;6337;2;1;
/org.eclipse.ui.workbench/Eclipse UI/org/eclipse/ui/internal/progress/NotifyingJob.java;1;0;1;1;0;0;0;1;0;0;1;532;0;0;1;0;0;1;1;532;0;532;1;1;
/org.eclipse.update.core/src/org/eclipse/update/internal/api/operations/IToggleSiteOperation.java;1;0;2;1;0;0;0;2;0;1;2;3270;0;0;1;0;0;2;2;3270;0;4928;2;1;
/org.eclipse.ant.ui/Ant Editor/org/eclipse/ant/ui/internal/editor/text/IAntEditorColorConstants.java;1;0;2;1;0;0;0;2;0;1;2;250;0;0;1;0;0;2;2;250;0;1811;2;1;
/org.eclipse.pde.ui/src/org/eclipse/pde/internal/ui/wizards/templates/PopupMenuTemplate.java;3;2;7;1;4;3;4;3;104;1;3;2184;125;125;2;0;1;3;7;5208;1;6336;6;3;
/org.eclipse.jdt.debug/model/org/eclipse/jdt/debug/core/IJavaBreakpoint.java;2;0;2;1;1;1;1;1;23;0;1;4525;27;27;1;0;0;1;2;4525;0;6336;2;2;
/org.eclipse.update.core/srcnew/org/eclipse/update/search/BackLevelFilter.java;2;0;5;1;0;0;0;5;32;2;4;580;54;54;2;1;0;5;5;580;1;825;4;2;
/org.eclipse.jdt.core.tests.model/workspace/Formatter/test421/A_out.java;1;0;1;1;0;0;0;1;0;0;1;3475;0;0;1;0;0;1;1;3475;0;3475;1;1;
/org.eclipse.jdt.ui/core refactoring/org/eclipse/jdt/internal/corext/refactoring/participants/MoveExtensionManager.java;1;0;7;1;0;0;0;7;8;1;7;825;22;22;1;0;0;7;7;825;0;4624;7;1;
/org.eclipse.jdt.debug.ui/ui/org/eclipse/jdt/internal/debug/ui/actions/OpenTypeAction.java;2;0;6;1;1;1;1;5;157;2;4;1593;184;184;2;1;0;5;6;5080;1;6038;5;2;
/org.eclipse.ui.tests/Eclipse UI Tests/org/eclipse/ui/tests/api/IViewPartTest.java;2;1;2;1;2;2;2;0;4;0;0;5533;6;6;1;0;0;0;2;5533;0;6338;2;2;
/org.eclipse.jdt.ui.examples.javafamily/coresearch-experiment/org/eclipse/search/core/SearchParticipant.java;1;0;3;1;0;0;0;3;2;2;2;1380;2;2;2;1;0;3;3;1380;1;3214;2;1;
/org.eclipse.ltk.core.refactoring.tests/src/org/eclipse/ltk/core/refactoring/tests/participants/ElementRenameRefactoring.java;1;1;2;1;2;2;2;0;2;0;0;6072;2;2;1;0;0;0;2;6072;0;6340;2;1;
/org.eclipse.jdt.debug.jdi.tests/tests/org/eclipse/debug/jdi/tests/program/TestClass2.java;1;0;1;1;1;1;1;0;3;0;0;6339;3;3;1;0;0;0;1;6339;0;6339;1;1;
/org.eclipse.pde.ui/src/org/eclipse/pde/internal/ui/search/FindDeclarationsAction.java;3;1;3;1;3;3;3;0;16;0;0;5658;22;22;1;0;0;0;3;5658;0;6336;3;3;
/org.eclipse.pde.core/src/org/eclipse/pde/internal/core/osgi/bundle/BundleObject.java;1;1;3;1;2;2;2;1;2;0;1;4203;2;2;1;0;0;1;3;4203;0;5445;3;1;
/org.eclipse.pde.ui/src/org/eclipse/pde/internal/ui/editor/manifest/ManifestExtensionPointPage.java;1;0;1;1;1;1;1;0;0;0;0;5431;0;0;1;0;0;0;1;5431;0;5431;1;1;
/org.eclipse.ui.workbench/Eclipse UI/org/eclipse/ui/commands/ICommandRegistry.java;1;0;4;1;0;0;0;4;37;2;3;1389;37;37;2;1;0;4;4;1417;1;1417;3;1;
/org.eclipse.debug.ui/ui/org/eclipse/debug/internal/ui/actions/ShowSupportedBreakpointsAction.java;3;1;3;1;3;3;3;0;22;0;0;5672;32;32;1;0;0;0;3;5672;0;6336;3;3;
/org.eclipse.jdt.core.tests.model/workspace/Formatter/test211/A_in.java;1;0;1;1;0;0;0;1;0;0;1;2424;0;0;1;0;0;1;1;2424;0;2424;1;1;
/org.eclipse.ui.ide/src/org/eclipse/ui/views/markers/internal/ConcreteMarker.java;3;1;4;1;3;3;3;1;40;0;1;3214;67;67;1;0;0;1;4;3214;0;6338;4;3;
/org.eclipse.help/src/org/eclipse/help/internal/search/SearchHit.java;1;0;1;1;0;0;0;1;0;0;1;2732;0;0;1;0;0;1;1;2732;0;2732;1;1;
/org.eclipse.webdav/src/interface/org/eclipse/webdav/dom/LockDiscovery.java;1;0;2;1;2;1;2;0;139;0;0;5151;139;139;2;0;1;0;2;5151;1;5151;1;1;
/org.eclipse.jdt.core/compiler/org/eclipse/jdt/internal/compiler/ast/JavadocArrayQualifiedTypeReference.java;3;0;5;1;0;0;0;5;10;1;5;2887;22;22;1;0;0;5;5;2887;0;3560;5;3;
/org.eclipse.jdt.ui/core extension/org/eclipse/jdt/internal/corext/callhierarchy/MethodCall.java;3;0;5;1;1;1;1;4;6;1;4;169;16;16;1;0;0;4;5;169;0;6340;5;3;
/org.eclipse.jdt.ui.tests.refactoring/resources/ExtractTemp/canExtract/A_test75_in.java;1;0;1;1;0;0;0;1;0;0;1;1569;0;0;1;0;0;1;1;1569;0;1569;1;1;
/org.eclipse.jdt.ui.tests.refactoring/resources/PasteSourceReference/test4/in/B.java;1;0;1;1;0;0;0;1;0;0;1;1311;0;0;1;0;0;1;1;1311;0;1311;1;1;
/org.eclipse.team.tests.core/src/org/eclipse/team/tests/ui/synchronize/AllTeamSynchronizeTests.java;1;0;3;1;1;1;1;2;42;1;2;4091;44;44;1;0;0;2;3;4091;0;6337;3;1;
/org.eclipse.jdt.ui/ui/org/eclipse/jdt/internal/ui/util/SelectionUtil.java;1;0;1;1;1;1;1;0;2;0;0;6340;2;2;1;0;0;0;1;6340;0;6340;1;1;
/org.eclipse.core.runtime/src/org/eclipse/core/runtime/PluginVersionIdentifier.java;4;1;9;1;5;5;5;4;803;1;4;3013;855;855;1;0;0;4;9;3013;0;6340;9;4;
/org.eclipse.ui.workbench/Eclipse UI/org/eclipse/ui/INavigatorTreeContentProvider.java;1;0;1;1;0;0;0;1;0;0;1;1053;0;0;1;0;0;1;1;1053;0;1053;1;1;
/org.eclipse.ui.workbench/Eclipse UI/org/eclipse/ui/wizards/datatransfer/WizardFileSystemResourceExportPage1.java;2;0;2;1;0;0;0;2;3;1;2;1336;3;3;1;0;0;2;2;1336;0;2737;2;2;
/org.eclipse.team.ui/src/org/eclipse/team/internal/ui/widgets/FormWidgetFactory.java;1;0;1;1;0;0;0;1;0;0;1;3176;0;0;1;0;0;1;1;3176;0;3176;1;1;
/org.eclipse.swt/Eclipse SWT PI/gtk/org/eclipse/swt/internal/gtk/GdkEventButton.java;3;0;4;1;1;1;1;3;17;1;3;1653;27;27;1;0;0;3;4;1653;0;6352;4;3;
/org.eclipse.team.tests.core/src/org/eclipse/team/tests/ui/synchronize/SyncInfoSetContentProviderTest.java;2;1;6;1;2;2;2;4;174;2;3;3715;184;184;2;1;0;4;6;3715;1;6337;5;2;
/org.eclipse.help/src/org/eclipse/help/internal/browser/BrowserDescriptor.java;1;0;1;1;0;0;0;1;0;0;1;2732;0;0;1;0;0;1;1;2732;0;2732;1;1;
/org.eclipse.ui.views/src/org/eclipse/ui/views/internal/markers/MarkerSortAction.java;1;0;2;1;0;0;0;2;0;0;1;265;0;0;2;1;0;2;2;265;1;265;1;1;
/org.eclipse.team.cvs.ui/src/org/eclipse/team/internal/ccvs/ui/repo/CVSWorkingSet.java;2;0;2;1;1;1;1;1;285;0;1;990;285;285;1;0;0;1;2;990;0;6015;2;2;
/org.eclipse.team.cvs.ui/src/org/eclipse/team/internal/ccvs/ui/IgnoreResourcesDialog.java;1;0;1;1;0;0;0;1;2;0;1;2381;2;2;1;0;0;1;1;2381;0;2381;1;1;
/org.eclipse.swt/Eclipse SWT/carbon/org/eclipse/swt/widgets/Button.java;3;1;17;1;6;6;6;11;36;1;11;16;125;125;1;0;0;11;17;16;0;6352;17;3;
/org.eclipse.ui.workbench.texteditor/src/org/eclipse/ui/texteditor/IAnnotationImageProvider.java;2;0;2;1;1;1;1;1;2;0;1;3217;2;2;1;0;0;1;2;3217;0;6340;2;2;
/org.eclipse.webdav/src/interface/org/eclipse/webdav/dom/ActiveLock.java;1;0;2;1;2;1;2;0;423;0;0;5151;423;423;2;0;1;0;2;5151;1;5151;1;1;
/org.eclipse.jdt.core.tests.model/workspace/Converter/src/test0344/Test.java;1;0;1;1;0;0;0;1;0;0;1;3714;0;0;1;0;0;1;1;3714;0;3714;1;1;
/org.eclipse.core.tests.resources/src/org/eclipse/core/tests/internal/resources/TestWorkspaceJob.java;2;0;4;1;2;1;2;2;5;0;1;5085;6;6;2;1;1;2;4;5085;2;5147;2;2;
/org.eclipse.osgi/console/src/org/eclipse/osgi/framework/internal/core/FrameworkCommandInterpreter.java;5;1;7;1;4;4;4;3;935;1;3;3013;1020;1020;1;0;0;3;7;3013;0;6337;7;5;
/org.eclipse.swt/Eclipse SWT/gtk/org/eclipse/swt/widgets/Tree.java;7;2;41;2;12;10;12;29;106;2;24;44;602;602;2;5;2;29;41;1094;7;6352;34;7;
/org.eclipse.jdt.core.tests.model/workspace/Converter/src/javadoc/testBug53075/X.java;1;0;1;1;0;0;0;1;0;0;1;4390;0;0;1;0;0;1;1;4390;0;4390;1;1;
/org.eclipse.debug.ui/ui/org/eclipse/debug/internal/ui/stringsubstitution/StringVariablePresentationManager.java;4;1;5;1;2;2;2;3;4;1;3;2088;11;11;1;0;0;3;5;2088;0;6336;5;4;
/org.eclipse.jdt.ui/ui/org/eclipse/jdt/internal/ui/search/SearchUtil.java;4;1;12;1;5;5;5;7;103;1;7;274;186;186;1;0;0;7;12;274;0;6340;12;4;
/org.eclipse.jdt.debug.ui/ui/org/eclipse/jdt/internal/debug/ui/DetailFormatterDialog.java;5;1;18;1;10;10;10;8;78;1;8;1814;221;221;1;0;0;8;18;1814;0;6336;18;5;
/org.eclipse.osgi/defaultAdaptor/src/org/eclipse/osgi/framework/adaptor/core/AbstractFrameworkAdaptor.java;3;2;15;1;8;7;8;7;93;1;7;4336;281;281;2;0;1;7;15;5507;1;6151;14;3;
/org.eclipse.pde.ui/src_Forms/org/eclipse/pde/internal/ui/neweditor/schema/SchemaFormPage.java;2;0;4;1;1;1;1;3;13;2;2;4856;13;13;2;1;0;3;4;4877;1;5431;3;2;
/org.eclipse.jdt.ui/ui/org/eclipse/jdt/internal/ui/callhierarchy/LocationLabelProvider.java;3;0;6;1;1;1;1;5;53;2;4;155;83;83;2;1;0;5;6;169;1;6340;5;3;
/org.eclipse.jdt.ui/core refactoring/org/eclipse/jdt/internal/corext/refactoring/typeconstraints/CompositeOrTypeConstraint.java;2;0;8;1;1;1;1;7;31;1;7;42;83;83;1;0;0;7;8;42;0;6340;8;2;
/org.eclipse.pde.core/src/org/eclipse/pde/internal/core/schema/DevelopmentSchemaDescriptor.java;2;2;4;2;3;2;3;1;35;0;1;4912;41;41;2;0;1;1;4;6220;1;6336;3;2;
/org.eclipse.ui.workbench/Eclipse UI/org/eclipse/ui/internal/ViewLayout.java;1;0;1;1;1;1;1;0;0;0;0;5514;0;0;1;0;0;0;1;5514;0;5514;1;1;
/org.eclipse.swt/Eclipse SWT Drag and Drop/carbon/org/eclipse/swt/dnd/Transfer.java;1;0;2;1;0;0;0;2;19;1;2;228;33;33;1;0;0;2;2;228;0;300;2;1;
/org.eclipse.pde.core/src/org/eclipse/pde/core/IModelProvider.java;2;1;5;1;3;3;3;2;126;1;2;2229;155;155;1;0;0;2;5;2229;0;6336;5;2;
/org.eclipse.ant.ui/Ant Tools Support/org/eclipse/ant/ui/internal/launchConfigurations/AntPropertiesTab.java;1;0;8;1;0;0;0;8;55;2;6;250;96;96;2;2;0;8;8;262;2;1811;6;1;
/org.eclipse.jdt.ui/ui/org/eclipse/jdt/internal/ui/wizards/dialogfields/StringButtonDialogField.java;2;0;2;1;1;1;1;1;2;0;1;1446;4;4;1;0;0;1;2;1446;0;6340;2;2;
/org.eclipse.swt.tests/JUnit Tests/org/eclipse/swt/tests/junit/Test_org_eclipse_swt_events_KeyEvent.java;1;0;2;1;1;1;1;1;7;0;1;3444;11;11;1;0;0;1;2;3444;0;6352;2;1;
/org.eclipse.team.tests.cvs.core/src/org/eclipse/team/tests/ccvs/core/subscriber/CVSSubscriberTest.java;1;0;1;1;0;0;0;1;0;0;1;493;0;0;1;0;0;1;1;493;0;493;1;1;
/org.eclipse.jdt.core.tests.model/workspace/Converter/src/test0552/A.java;1;1;2;1;2;2;2;0;0;0;0;5617;0;0;1;0;0;0;2;5617;0;5635;2;1;
/org.eclipse.jdt.core/dom/org/eclipse/jdt/core/dom/ParenthesizedExpression.java;3;1;8;1;2;2;2;6;78;1;6;3560;108;108;1;0;0;6;8;3560;0;5272;8;3;
/org.eclipse.jdt.ui/core extension/org/eclipse/jdt/internal/corext/codemanipulation/ASTNodeCodeBlock.java;1;0;1;1;0;0;0;1;0;0;1;155;0;0;1;0;0;1;1;155;0;155;1;1;
/org.eclipse.team.core/src/org/eclipse/team/core/WriteSyncSchedulingRule.java;1;0;1;1;0;0;0;1;0;0;1;1954;0;0;1;0;0;1;1;1954;0;1954;1;1;
/org.eclipse.jdt.core/model/org/eclipse/jdt/core/util/IClassFileReader.java;1;0;2;1;0;0;0;2;8;1;2;3560;10;10;1;0;0;2;2;3560;0;4843;2;1;
/org.eclipse.jdt.debug.tests/tests/org/eclipse/jdt/debug/tests/eval/TypeHierarchy_32_5.java;1;0;1;1;0;0;0;1;6;0;1;1274;6;6;1;0;0;1;1;1274;0;1274;1;1;
/org.eclipse.help.ui/src/org/eclipse/help/ui/internal/browser/embedded/EmbeddedBrowserStore.java;1;0;2;1;0;0;0;2;0;1;2;2898;0;0;1;0;0;2;2;2898;0;4559;2;1;
/org.eclipse.jdt.ui.tests.refactoring/resources/ExtractMethodWorkSpace/ExtractMethodTests/locals_out/A_test527.java;1;0;2;1;0;0;0;2;6;1;2;130;8;8;1;0;0;2;2;130;0;844;2;1;
/org.eclipse.ui.workbench/Eclipse UI/org/eclipse/ui/internal/presentations/DefaultViewPresentation.java;2;1;5;1;5;5;5;0;7;0;0;5539;16;16;1;0;0;0;5;5539;0;6227;5;2;
/org.eclipse.jdt.ui/ui/org/eclipse/jdt/internal/ui/reorg/DeleteResourcesAction.java;1;0;3;1;0;0;0;3;26;1;3;122;28;28;1;0;0;3;3;122;0;457;3;1;
/org.eclipse.jdt.core.tests.model/workspace/Converter/src/javadoc/testBug51478/X1.java;1;0;2;1;1;1;1;1;2;0;1;3994;2;2;1;0;0;1;2;3994;0;5869;2;1;
/org.eclipse.debug.core/core/org/eclipse/debug/internal/core/variables/ContextLaunchVariable.java;2;0;3;1;0;0;0;3;29;1;3;737;29;29;1;0;0;3;3;737;0;2120;3;2;
/org.eclipse.update.ui/src/org/eclipse/update/internal/ui/wizards/MultiTargetPage.java;1;0;1;1;0;0;0;1;0;0;1;755;0;0;1;0;0;1;1;755;0;755;1;1;
/org.eclipse.pde.ui/src_Forms/org/eclipse/pde/internal/ui/neweditor/site/NewCategoryDefinitionDialog.java;2;0;2;1;1;1;1;1;0;0;1;4832;0;0;1;0;0;1;2;4832;0;5431;2;2;
/org.eclipse.jdt.ui.examples.javafamily/src/org/eclipse/jsp/launching/JspTabGroup.java;1;0;2;1;0;0;0;2;0;1;2;1355;0;0;1;0;0;2;2;1355;0;1373;2;1;
/org.eclipse.ui.forms/src/org/eclipse/ui/forms/widgets/LayoutComposite.java;1;0;3;1;0;0;0;3;34;1;3;4068;35;35;1;0;0;3;3;4068;0;4374;3;1;
/org.eclipse.osgi/core/adaptor/org/eclipse/osgi/framework/adaptor/Version.java;3;0;3;1;0;0;0;3;25;1;3;3013;25;25;1;0;0;3;3;3013;0;4086;3;3;
/org.eclipse.jdt.core.tests.model/workspace/Formatter/test338/A_in.java;1;0;1;1;0;0;0;1;0;0;1;2863;0;0;1;0;0;1;1;2863;0;2863;1;1;
/org.eclipse.ui.externaltools/External Tools Base/org/eclipse/ui/externaltools/internal/registry/RefreshScopeVariableRegistry.java;1;0;1;1;0;0;0;1;0;0;1;321;0;0;1;0;0;1;1;321;0;321;1;1;
/org.eclipse.core.runtime.osgi/src/org/eclipse/core/internal/registry/ExtensionRegistry.java;1;0;2;1;0;0;0;2;26;1;2;3013;26;26;1;0;0;2;2;3013;0;3030;2;1;
/org.eclipse.ui.workbench/Eclipse UI/org/eclipse/ui/internal/model/WorkbenchFolder.java;1;0;1;1;0;0;0;1;0;0;1;2737;0;0;1;0;0;1;1;2737;0;2737;1;1;
/org.eclipse.team.cvs.core/src/org/eclipse/team/internal/ccvs/core/util/ProjectDescriptionWriter.java;1;0;1;1;0;0;0;1;0;0;1;2143;0;0;1;0;0;1;1;2143;0;2143;1;1;
/org.eclipse.jface/src/org/eclipse/jface/operation/AccumulatingProgressMonitor.java;2;1;4;1;3;3;3;1;50;0;1;2242;95;95;1;0;0;1;4;2242;0;6338;4;2;
/org.eclipse.ui.workbench/Eclipse UI/org/eclipse/ui/internal/EditorPresentation.java;4;2;8;1;3;2;3;5;729;1;5;2620;997;997;2;0;1;5;8;5539;1;5539;7;4;
/org.eclipse.update.ui.forms/Eclipse Forms/org/eclipse/ui/forms/IManagedForm.java;1;0;5;1;0;0;0;5;7;2;4;3176;17;17;2;1;0;5;5;3176;1;4157;4;1;
/org.eclipse.update.core/src/org/eclipse/update/core/model/IncludedFeatureReference.java;1;0;1;1;0;0;0;1;0;0;1;2715;0;0;1;0;0;1;1;2715;0;2715;1;1;
/org.eclipse.jdt.ui/ui/org/eclipse/jdt/internal/ui/search/JavaSearchTreeContentProvider.java;1;0;4;1;0;0;0;4;49;1;4;3711;52;52;1;0;0;4;4;3711;0;4625;4;1;
/org.eclipse.jdt.core.tests.model/workspace/Formatter/test021/A_out.java;1;0;1;1;0;0;0;1;0;0;1;2425;0;0;1;0;0;1;1;2425;0;2425;1;1;
/org.eclipse.swt/Eclipse SWT Mozilla/common/org/eclipse/swt/internal/mozilla/nsString.java;1;0;1;1;0;0;0;1;0;0;1;1654;0;0;1;0;0;1;1;1654;0;1654;1;1;
/org.eclipse.search/search/org/eclipse/search/internal/ui/RemoveAllResultsAction.java;1;0;1;1;1;1;1;0;2;0;0;6340;2;2;1;0;0;0;1;6340;0;6340;1;1;
/org.eclipse.update.core/src/org/eclipse/update/core/model/InvalidSiteTypeException.java;1;1;2;1;2;2;2;0;6;0;0;5423;10;10;1;0;0;0;2;5423;0;6336;2;1;
/org.eclipse.update.core/src/org/eclipse/update/internal/configuration/SiteLocalModel.java;1;0;1;1;0;0;0;1;0;0;1;2828;0;0;1;0;0;1;1;2828;0;2828;1;1;
/org.eclipse.pde.ui/src/org/eclipse/pde/internal/ui/editor/plugin/ResourceAttributeValue.java;1;1;2;1;2;2;2;0;4;0;0;5431;4;4;1;0;0;0;2;5431;0;6336;2;1;
/org.eclipse.jdt.core.tests.model/workspace/Converter/test0356/X.java;1;0;1;1;0;0;0;1;0;0;1;3714;0;0;1;0;0;1;1;3714;0;3714;1;1;
/org.eclipse.core.tests.resources/src/org/eclipse/core/tests/resources/WorkspaceJobTest.java;1;0;1;1;0;0;0;1;0;0;1;1137;0;0;1;0;0;1;1;1137;0;1137;1;1;
/org.eclipse.core.runtime/src/org/eclipse/core/runtime/IExecutableExtension.java;3;2;5;1;3;2;3;2;172;1;2;3013;180;180;2;0;1;2;5;5117;1;6340;4;3;
/org.eclipse.ant.ui/Ant Editor/org/eclipse/ant/internal/ui/dtd/schema/Model.java;1;0;3;1;1;1;1;2;5;1;2;1811;9;9;1;0;0;2;3;1811;0;5581;3;1;
/org.eclipse.ui.workbench/Eclipse UI/org/eclipse/ui/wizards/datatransfer/ZipFileImportWizard.java;1;0;1;1;0;0;0;1;0;0;1;2737;0;0;1;0;0;1;1;2737;0;2737;1;1;
/org.eclipse.ui.ide/src/org/eclipse/ui/views/markers/internal/ActionPasteMarker.java;3;1;3;1;2;2;2;1;2;0;1;2208;4;4;1;0;0;1;3;2208;0;6338;3;3;
/org.eclipse.jdt.ui/core refactoring/org/eclipse/ltk/core/refactoring/participants/RenameArguments.java;1;0;2;1;0;0;0;2;0;1;2;4624;0;0;1;0;0;2;2;4624;0;4864;2;1;
/org.eclipse.jdt.core.tests.model/workspace/Formatter/test182/A_in.java;1;0;1;1;0;0;0;1;0;0;1;2425;0;0;1;0;0;1;1;2425;0;2425;1;1;
/org.eclipse.update.ui.forms/Eclipse Forms/org/eclipse/ui/forms/FormColors.java;1;0;6;1;0;0;0;6;107;2;5;3096;126;126;2;1;0;6;6;3096;1;4157;5;1;
/org.eclipse.ui.workbench.texteditor/src/org/eclipse/ui/texteditor/templates/TemplateVariableProposal.java;2;2;4;2;3;2;3;1;9;0;1;4627;11;11;2;0;1;1;4;6334;1;6334;3;2;
/org.eclipse.ui.ide/src/org/eclipse/ui/dialogs/SaveAsDialog.java;2;0;5;1;0;0;0;5;17;1;5;1511;25;25;1;0;0;5;5;1511;0;2263;5;2;
/org.eclipse.jdt.ui/ui/org/eclipse/jdt/internal/ui/search/OccurrencesFinder.java;5;1;10;1;3;3;3;7;124;2;6;2562;377;377;2;1;0;7;10;3759;1;6340;9;5;
/org.eclipse.pde.ui/src/org/eclipse/pde/internal/ui/editor/plugin/rows/ClassAttributeRow.java;3;2;8;1;8;7;8;0;24;0;0;5431;63;63;2;0;1;0;8;6244;1;6336;7;3;
/org.eclipse.ui.workbench/Eclipse UI/org/eclipse/ui/internal/commands/ActiveContextService.java;1;0;2;1;0;0;0;2;0;1;2;689;0;0;1;0;0;2;2;689;0;767;2;1;
/org.eclipse.swt/Eclipse SWT/motif/org/eclipse/swt/graphics/Color.java;1;1;2;1;2;2;2;0;4;0;0;5606;8;8;1;0;0;0;2;5606;0;6352;2;1;
/org.eclipse.ui.tests/Eclipse UI Tests/org/eclipse/ui/tests/contexts/ContextsTestSuite.java;3;1;3;1;2;2;2;1;26;0;1;4896;36;36;1;0;0;1;3;4896;0;6338;3;3;
/org.eclipse.team.ui/src/org/eclipse/team/ui/synchronize/subscribers/RefreshCompleteDialog.java;2;0;5;2;2;1;2;3;59;1;3;4632;92;92;2;0;1;3;5;5358;1;5358;4;2;
/org.eclipse.jdt.ui/core extension/org/eclipse/jdt/internal/corext/dom/ASTRewriteFlattener.java;1;0;6;1;1;1;1;5;307;1;5;3647;406;406;1;0;0;5;6;3647;0;5406;6;1;
/org.eclipse.ant.core/src/org/eclipse/ant/core/AntRunner.java;2;1;15;1;2;2;2;13;58;2;12;6;216;216;2;1;0;13;15;642;1;5597;14;2;
/org.eclipse.jdt.ui.tests.refactoring/resources/PullUp/test41/out/A.java;1;0;2;1;0;0;0;2;2;1;2;328;2;2;1;0;0;2;2;328;0;1690;2;1;
/org.eclipse.jdt.ui.examples.javafamily/src/org/eclipse/jsp/copied_from_jdtcore/SourceIndexer.java;1;0;3;1;0;0;0;3;6;1;3;1033;6;6;1;0;0;3;3;1033;0;3235;3;1;
/org.eclipse.ui.externaltools/Ant Editor/org/eclipse/ui/externaltools/internal/ant/editor/derived/HTMLPrinter.java;1;0;1;1;0;0;0;1;0;0;1;282;0;0;1;0;0;1;1;282;0;282;1;1;
/org.eclipse.ui.workbench/Eclipse UI/org/eclipse/ui/internal/keys/AbstractModifierKeyComparator.java;2;0;2;1;1;1;1;1;10;0;1;3329;10;10;1;0;0;1;2;3329;0;6338;2;2;
/org.eclipse.team.tests.cvs.core/src/org/eclipse/team/tests/ccvs/ui/LoggingTestCase.java;1;0;2;1;0;0;0;2;10;1;2;1417;10;10;1;0;0;2;2;1417;0;2632;2;1;
/org.eclipse.ui.workbench/Eclipse UI/org/eclipse/ui/internal/dialogs/WorkingSetSelectionDialog.java;1;0;1;1;0;0;0;1;11;0;1;1671;11;11;1;0;0;1;1;1671;0;1671;1;1;
/org.eclipse.jdt.ui/ui/org/eclipse/jdt/ui/search/PatternQuerySpecification.java;3;2;5;1;5;4;5;0;35;0;0;5398;53;53;2;0;1;0;5;6310;1;6334;4;3;
/org.eclipse.jdt.ui/ui/org/eclipse/jdt/internal/ui/typehierarchy/ToggleLinkingAction.java;1;0;2;1;1;1;1;1;13;0;1;1285;15;15;1;0;0;1;2;1285;0;6340;2;1;
/org.eclipse.jdt.core/dom/org/eclipse/jdt/internal/core/dom/rewrite/TokenScanner.java;3;1;3;1;2;2;2;1;40;0;1;4802;44;44;1;0;0;1;3;4802;0;6336;3;3;
/org.eclipse.ui.internal.r21presentation/src/org/eclipse/ui/internal/r21presentation/presentations/R21ViewStackPresentation.java;3;1;6;1;6;6;6;0;454;0;0;5275;684;684;1;0;0;0;6;5275;0;5874;6;3;
/org.eclipse.releng.eclipsebuilder/plugins/org.eclipse.build.extra.tools/src/org/eclipse/releng/ElementParser.java;1;0;1;1;0;0;0;1;0;0;1;991;0;0;1;0;0;1;1;991;0;991;1;1;
/org.eclipse.jdt.ui.tests.refactoring/resources/Delete/testDeleteWithinCu6/in/A.java;1;0;1;1;0;0;0;1;0;0;1;442;0;0;1;0;0;1;1;442;0;442;1;1;
/org.eclipse.jdt.ui/ui/org/eclipse/jdt/internal/ui/callhierarchy/CallHierarchyPreferenceBasePage.java;1;0;4;1;0;0;0;4;17;2;3;155;17;17;2;1;0;4;4;169;1;218;3;1;
/org.eclipse.swt/Eclipse SWT Browser/common/org/eclipse/swt/browser/ProgressEvent.java;2;0;5;1;1;1;1;4;15;1;4;1654;35;35;1;0;0;4;5;1654;0;6352;5;2;
/org.eclipse.jdt.ui/ui/org/eclipse/jdt/internal/ui/text/template/TemplateVariableProcessor.java;2;0;2;1;0;0;0;2;7;1;2;761;7;7;1;0;0;2;2;761;0;4258;2;2;
/org.eclipse.update.ui.win32/src/org/eclipse/update/internal/ui/win32/views/WebBrowserView.java;2;0;2;1;0;0;0;2;1;1;2;786;1;1;1;0;0;2;2;786;0;889;2;2;
/org.eclipse.swt/Eclipse SWT/common/org/eclipse/swt/internal/image/JPEGFrameHeader.java;1;0;2;1;1;1;1;1;8;0;1;3903;12;12;1;0;0;1;2;3903;0;6352;2;1;
/org.eclipse.ant.ui/Ant Editor/org/eclipse/ant/internal/ui/editor/AbstractAntSourceViewerConfiguration.java;1;1;6;1;6;6;6;0;75;0;0;5301;118;118;1;0;0;0;6;5301;0;6028;6;1;
/org.eclipse.jdt.core.tests.model/workspace/Formatter/test292/A_in.java;1;0;1;1;0;0;0;1;0;0;1;2444;0;0;1;0;0;1;1;2444;0;2444;1;1;
/org.eclipse.osgi/core/framework/org/eclipse/osgi/framework/internal/core/BundlePermissionCollection.java;4;1;4;1;2;2;2;2;17;1;2;3013;23;23;1;0;0;2;4;3013;0;6337;4;4;
/org.eclipse.ui.workbench/Eclipse UI/org/eclipse/ui/commands/IKeyBinding.java;1;0;11;1;0;0;0;11;51;2;9;1239;91;91;2;2;0;11;11;1239;2;2562;9;1;
/org.eclipse.jdt.debug/jdi/org/eclipse/jdi/internal/event/ClassUnloadEventImpl.java;4;0;4;1;1;1;1;3;4;1;3;1240;12;12;1;0;0;3;4;1240;0;6336;4;4;
/org.eclipse.jdt.debug.ui/ui/org/eclipse/jdt/debug/ui/launchConfigurations/JavaJRETab.java;3;1;11;1;2;2;2;9;450;1;9;770;543;543;1;0;0;9;11;770;0;6336;11;3;
/org.eclipse.ui.editors/src/org/eclipse/ui/texteditor/ExtendedTextEditorPreferenceConstants.java;3;2;10;2;4;3;4;6;205;1;6;2080;333;333;2;0;1;6;10;5126;1;5181;9;3;
/org.eclipse.jdt.ui/core refactoring/org/eclipse/jdt/internal/corext/refactoring/reorg2/ReorgMoveStarter.java;1;0;2;1;0;0;0;2;0;0;1;1111;0;0;2;1;0;2;2;1111;1;1111;1;1;
/org.eclipse.swt/Eclipse SWT Drag and Drop/photon/org/eclipse/swt/dnd/Clipboard.java;3;1;7;1;2;2;2;5;82;1;5;0;182;182;1;0;0;5;7;0;0;6352;7;3;
/org.eclipse.debug.core/core/org/eclipse/debug/core/model/IErrorReportingExpression.java;2;0;2;1;0;0;0;2;2;1;2;1595;2;2;1;0;0;2;2;1595;0;1695;2;2;
/org.eclipse.jdt.core/compiler/org/eclipse/jdt/internal/compiler/ast/QualifiedParameterizedTypeReference.java;1;0;1;1;0;0;0;1;0;0;1;2749;0;0;1;0;0;1;1;2749;0;2749;1;1;
/org.eclipse.jdt.ui.tests.refactoring/resources/Delete/testDeleteWithinCu19/in/A.java;1;0;1;1;0;0;0;1;0;0;1;444;0;0;1;0;0;1;1;444;0;444;1;1;
/org.eclipse.jdt.core.tests.model/workspace/Formatter/test280/A_out.java;1;0;1;1;0;0;0;1;0;0;1;2443;0;0;1;0;0;1;1;2443;0;2443;1;1;
/org.eclipse.pde.ui/src/org/eclipse/pde/internal/ui/editor/feature/FeatureSpecSection.java;3;3;10;1;7;5;7;3;209;1;3;368;301;301;3;0;2;3;10;5658;2;6336;8;3;
/org.eclipse.ui.workbench/Eclipse UI/org/eclipse/ui/commands/internal/ContextService.java;1;0;2;1;0;0;0;2;0;0;1;767;0;0;2;1;0;2;2;767;1;767;1;1;
/org.eclipse.ant.ui/Ant Editor/org/eclipse/ant/ui/internal/editor/TaskDescriptionProvider.java;1;0;5;1;0;0;0;5;9;1;5;250;23;23;1;0;0;5;5;250;0;1811;5;1;
/org.eclipse.jdt.debug.ui/ui/org/eclipse/jdt/internal/debug/ui/launcher/SelectSystemLibraryQuickFix.java;3;1;4;1;2;2;2;2;6;1;2;307;17;17;1;0;0;2;4;307;0;6336;4;3;
/org.eclipse.swt/Eclipse SWT Mozilla/common/org/eclipse/swt/internal/mozilla/nsIWebBrowserFocus.java;1;0;2;1;0;0;0;2;8;1;2;1654;8;8;1;0;0;2;2;1654;0;2568;2;1;
/org.eclipse.swt/Eclipse SWT Custom Widgets/common/org/eclipse/swt/custom/CTabFolderCloseListener.java;1;0;3;1;0;0;0;3;31;1;3;2641;31;31;1;0;0;3;3;2641;0;4232;3;1;
/org.eclipse.jface.text/src/org/eclipse/jface/text/contentassist/ICompletionProposalExtension.java;1;3;5;1;4;2;4;1;26;0;1;4816;29;29;3;0;2;1;5;6353;2;6353;3;1;
/org.eclipse.jdt.ui.tests/leaks/org/eclipse/jdt/ui/leaktest/ProfileException.java;2;0;2;1;1;1;1;1;10;0;1;3124;10;10;1;0;0;1;2;3124;0;6340;2;2;
/org.eclipse.jdt.ui/core refactoring/org/eclipse/jdt/internal/corext/refactoring/reorg/MoveRefactoring.java;3;0;17;1;0;0;0;17;666;1;17;130;763;763;1;0;0;17;17;130;0;4688;17;3;
/org.eclipse.jdt.core/dom/org/eclipse/jdt/core/internal/dom/rewrite/ASTRewriteFlattener.java;2;0;3;2;0;0;0;3;2;2;2;4711;2;2;2;1;0;3;3;4711;1;4802;2;2;
/org.eclipse.core.tests.runtime/src/org/eclipse/core/tests/internal/plugins/ConflictResolveTest_4.java;1;0;1;1;0;0;0;1;0;0;1;3014;0;0;1;0;0;1;1;3014;0;3014;1;1;
/org.eclipse.jdt.ui.tests.refactoring/resources/MoveInnerToTopLevel/test18/in/A1.java;1;0;1;1;0;0;0;1;1;0;1;305;1;1;1;0;0;1;1;305;0;305;1;1;
/org.eclipse.jdt.ui.tests.refactoring/resources/IntroduceFactory/Bugzilla/46374/QualifiedName_out.java;1;0;2;1;1;1;1;1;2;0;1;2846;2;2;1;0;0;1;2;2846;0;5659;2;1;
/org.eclipse.swt/Eclipse SWT/win32/org/eclipse/swt/widgets/ImageList.java;1;0;1;1;0;0;0;1;18;0;1;398;18;18;1;0;0;1;1;398;0;398;1;1;
/org.eclipse.swt.tests/JUnit Tests/org/eclipse/swt/tests/junit/Test_org_eclipse_swt_custom_CTabFolder.java;1;0;1;1;0;0;0;1;115;0;1;2104;115;115;1;0;0;1;1;2104;0;2104;1;1;
/org.eclipse.swt.examples/src/org/eclipse/swt/examples/controlexample/CanvasTab.java;1;1;4;1;2;2;2;2;12;0;1;2863;20;20;2;1;0;2;4;2863;1;6352;3;1;
/org.eclipse.team.cvs.ui/src/org/eclipse/team/internal/ccvs/ui/model/BranchCategory.java;2;0;3;1;1;1;1;2;60;1;2;990;71;71;1;0;0;2;3;990;0;6337;3;2;
/org.eclipse.ui.ide/src/org/eclipse/ui/views/framelist/GoIntoAction.java;1;0;1;1;0;0;0;1;0;0;1;2208;0;0;1;0;0;1;1;2208;0;2208;1;1;
/org.eclipse.core.tests.runtime/src/org/eclipse/core/tests/internal/runtimetests/SampleGPR.java;1;0;1;1;1;1;1;0;21;0;0;5149;21;21;1;0;0;0;1;5149;0;5149;1;1;
/org.eclipse.update.ui.forms/src/org/eclipse/ui/forms/parts/HyperlinkAdapter.java;1;0;2;1;0;0;0;2;0;1;2;3071;0;0;1;0;0;2;2;3071;0;3095;2;1;
/org.eclipse.ui.workbench/Eclipse UI/org/eclipse/ui/contexts/AbstractContextService.java;1;0;2;1;0;0;0;2;0;1;2;1119;0;0;1;0;0;2;2;1119;0;1135;2;1;
/org.eclipse.ui.ide/src/org/eclipse/ui/views/navigator/PasteAction.java;1;0;2;1;0;0;0;2;2;1;2;2208;2;2;1;0;0;2;2;2208;0;2611;2;1;
/org.eclipse.jdt.core/search/org/eclipse/jdt/internal/core/search/matching/JavaSearchMatch.java;1;0;5;1;0;0;0;5;77;2;4;3211;100;100;2;1;0;5;5;4302;1;4302;4;1;
/org.eclipse.team.ui/src/org/eclipse/team/internal/ui/synchronize/actions/OpenFileInSystemEditorAction.java;1;0;4;1;1;1;1;3;53;1;3;2561;74;74;1;0;0;3;4;2561;0;6337;4;1;
/org.eclipse.jdt.core.tests.model/workspace/Formatter/test028/A_out.java;1;0;2;1;0;0;0;2;3;1;2;2425;3;3;1;0;0;2;2;2425;0;3086;2;1;
/org.eclipse.jdt.core.tests.model/workspace/Completion/src3/test0016/Test.java;1;0;1;1;1;1;1;0;0;0;0;5181;0;0;1;0;0;0;1;5181;0;5181;1;1;
/org.eclipse.jdt.core.tests.model/workspace/Converter/test0222/Test.java;1;0;1;1;0;0;0;1;0;0;1;3714;0;0;1;0;0;1;1;3714;0;3714;1;1;
/org.eclipse.jdt.ui.tests.refactoring/resources/PasteSourceReference/test0/out/B.java;1;0;1;1;0;0;0;1;0;0;1;1311;0;0;1;0;0;1;1;1311;0;1311;1;1;
/org.eclipse.jdt.core.tests.model/workspace/Formatter/test044/A_in.java;1;0;1;1;0;0;0;1;0;0;1;2425;0;0;1;0;0;1;1;2425;0;2425;1;1;
/org.eclipse.jdt.core.tests.model/workspace/Formatter/test297/A_out.java;1;0;2;1;0;0;0;2;1;1;2;2444;1;1;1;0;0;2;2;2444;0;3148;2;1;
/org.eclipse.jdt.core.tests.model/src/org/eclipse/jdt/core/tests/rewrite/describing/ASTRewritingMethodDeclTest.java;5;1;6;1;4;4;4;2;196;1;2;4711;285;285;1;0;0;2;6;4711;0;6336;6;5;
/org.eclipse.jdt.core.tests.model/workspace/Converter/src/test0276/Test.java;1;0;1;1;0;0;0;1;0;0;1;3714;0;0;1;0;0;1;1;3714;0;3714;1;1;
/org.eclipse.jdt.ui.tests.refactoring/resources/Delete/testDeleteWithinCu9/in/A.java;1;0;1;1;0;0;0;1;0;0;1;442;0;0;1;0;0;1;1;442;0;442;1;1;
/org.eclipse.jface.text/src/org/eclipse/jface/text/source/_AbstractAnnotationPresentation.java;1;0;1;1;0;0;0;1;0;0;1;2874;0;0;1;0;0;1;1;2874;0;2874;1;1;
/org.eclipse.jdt.ui/ui/org/eclipse/jdt/ui/text/spelling/engine/AbstractSpellDictionary.java;1;0;2;1;0;0;0;2;0;1;2;3829;0;0;1;0;0;2;2;3829;0;3930;2;1;
/org.eclipse.jdt.ui/ui/org/eclipse/jdt/internal/ui/text/java/JavaDoubleClickSelector.java;1;0;1;1;1;1;1;0;2;0;0;6340;2;2;1;0;0;0;1;6340;0;6340;1;1;
/org.eclipse.compare/compare/org/eclipse/compare/internal/SimpleTextViewer.java;1;0;2;1;0;0;0;2;3;1;2;1289;6;6;1;0;0;2;2;1289;0;2898;2;1;
/org.eclipse.ui.workbench/Eclipse UI/org/eclipse/ui/internal/OpenedPerspectivesMenu.java;1;0;1;1;0;0;0;1;14;0;1;2737;14;14;1;0;0;1;1;2737;0;2737;1;1;
/org.eclipse.update.core/src/org/eclipse/update/internal/operations/UninstallOperation.java;2;1;12;1;4;4;4;8;48;1;8;825;128;128;1;0;0;8;12;825;0;6336;12;2;
/org.eclipse.jdt.ui/core refactoring/org/eclipse/jdt/internal/corext/refactoring/surround/ISurroundWithTryCatchQuery.java;1;0;1;1;1;1;1;0;2;0;0;6340;2;2;1;0;0;0;1;6340;0;6340;1;1;
/org.eclipse.search/new search/org/eclipse/search/ui/ISearchResultChangedListener.java;1;0;2;1;0;0;0;2;0;1;2;3474;0;0;1;0;0;2;2;3474;0;3711;2;1;
/org.eclipse.jdt.ui/core refactoring/org/eclipse/jdt/internal/corext/refactoring/code/AstMatchingNodeFinder.java;1;0;1;1;1;1;1;0;2;0;0;6340;2;2;1;0;0;0;1;6340;0;6340;1;1;
/org.eclipse.core.tests.runtime/src/org/eclipse/core/tests/runtime/RuntimeTest.java;3;2;3;2;3;2;3;0;33;0;0;5149;42;42;2;0;1;0;3;6201;1;6201;2;3;
/org.eclipse.jdt.launching/launching/org/eclipse/jdt/launching/sourcelookup/ArchiveSourceLocation.java;3;0;8;2;1;1;1;7;73;2;6;347;173;173;2;1;0;7;8;811;1;6336;7;3;
/org.eclipse.jdt.core/model/org/eclipse/jdt/core/util/ILocalVariableTypeTableEntry.java;2;0;2;1;0;0;0;2;85;1;2;4394;85;85;1;0;0;2;2;4394;0;4843;2;2;
/org.eclipse.team.webdav/src/org/eclipse/team/internal/ui/target/TargetSiteContentHandler.java;2;0;2;1;0;0;0;2;0;1;2;2495;0;0;1;0;0;2;2;2495;0;4216;2;2;
/org.eclipse.team.ui/src/org/eclipse/team/internal/ui/sync/actions/ToggleViewAction.java;1;0;4;1;0;0;0;4;35;1;4;1181;51;51;1;0;0;4;4;1181;0;2632;4;1;
/org.eclipse.pde.core/src_OSGi/org/eclipse/pde/core/osgi/bundle/IBundleModel.java;2;0;3;1;0;0;0;3;2;1;3;2229;2;2;1;0;0;3;3;2229;0;4203;3;2;
/org.eclipse.jdt.ui/core refactoring/org/eclipse/jdt/internal/corext/refactoring/typeconstraints/Expressions.java;1;0;5;1;0;0;0;5;11;1;5;42;20;20;1;0;0;5;5;42;0;1557;5;1;
/org.eclipse.team.ui/src/org/eclipse/team/ui/sync/ISynchronizeViewPage.java;1;0;1;1;0;0;0;1;0;0;1;2406;0;0;1;0;0;1;1;2406;0;2406;1;1;
/org.eclipse.jdt.ui/ui/org/eclipse/jdt/internal/ui/text/spelling/engine/RankedWordProposal.java;2;0;2;1;1;1;1;1;2;0;1;3930;2;2;1;0;0;1;2;3930;0;6340;2;2;
/org.eclipse.jdt.ui/core extension/org/eclipse/text/edits/TreeIterationInfo.java;1;0;2;1;0;0;0;2;0;1;2;1953;0;0;1;0;0;2;2;1953;0;1987;2;1;
/org.eclipse.jdt.core.tests.model/workspace/Formatter/test309/A_in.java;1;0;1;1;0;0;0;1;0;0;1;2442;0;0;1;0;0;1;1;2442;0;2442;1;1;
/org.eclipse.jdt.launching/launching/org/eclipse/jdt/internal/launching/JavaProjectSourceContainerTypeDelegate.java;2;0;6;1;1;1;1;5;17;2;4;4109;27;27;2;1;0;5;6;4949;1;5581;5;2;
/org.eclipse.team.ui/src/org/eclipse/team/internal/ui/jobs/JobBusyCursor.java;2;0;8;1;0;0;0;8;54;2;7;2040;99;99;2;1;0;8;8;2040;1;4244;7;2;
/org.eclipse.jdt.ui.tests.refactoring/resources/IntroduceFactory/positive/StaticContext_FFF.java;1;0;2;1;1;1;1;1;2;0;1;2862;2;2;1;0;0;1;2;2862;0;5659;2;1;
/org.eclipse.update.ui/src/org/eclipse/update/internal/ui/model/MonitorAdapter.java;1;0;1;1;0;0;0;1;0;0;1;825;0;0;1;0;0;1;1;825;0;825;1;1;
/org.eclipse.update.ui/src/org/eclipse/update/internal/ui/properties/FeatureLicensePropertyPage.java;3;0;4;1;0;0;0;4;14;1;4;825;26;26;1;0;0;4;4;825;0;2049;4;3;
/org.eclipse.jdt.ui/ui/org/eclipse/jdt/internal/ui/infoviews/SourceView.java;6;1;15;1;3;3;3;12;160;1;12;724;533;533;1;0;0;12;15;724;0;6340;15;6;
/org.eclipse.ui.workbench/Eclipse UI/org/eclipse/ui/roles/IRoleManagerListener.java;1;0;6;1;0;0;0;6;20;1;6;1952;44;44;1;0;0;6;6;1952;0;2864;6;1;
/org.eclipse.swt.tests/JUnit Tests/org/eclipse/swt/tests/junit/Test_org_eclipse_swt_events_ShellEvent.java;1;0;2;1;1;1;1;1;7;0;1;3444;11;11;1;0;0;1;2;3444;0;6352;2;1;
/org.eclipse.ui.views/src/org/eclipse/ui/views/internal/tableview/IItemsChangedListener.java;1;0;2;1;0;0;0;2;0;1;2;267;0;0;1;0;0;2;2;267;0;749;2;1;
/org.eclipse.team.cvs.core/src/org/eclipse/team/internal/ccvs/core/util/Util.java;2;1;13;1;2;2;2;11;112;1;11;442;292;292;1;0;0;11;13;442;0;6337;13;2;
/org.eclipse.jdt.ui/ui/org/eclipse/jdt/internal/ui/javaeditor/GotoErrorAction.java;1;0;1;1;0;0;0;1;0;0;1;1520;0;0;1;0;0;1;1;1520;0;1520;1;1;
/org.eclipse.jdt.ui/ui/org/eclipse/jdt/internal/ui/text/correction/ICorrectionContext.java;1;0;2;1;0;0;0;2;45;1;2;1011;45;45;1;0;0;2;2;1011;0;1034;2;1;
/org.eclipse.pde.ui/sandbox/org/eclipse/pde/internal/ui/editor/standalone/site/SiteStandaloneEditor.java;1;0;2;1;0;0;0;2;0;1;2;2320;0;0;1;0;0;2;2;2320;0;2906;2;1;
/org.eclipse.ui.workbench/Eclipse UI/org/eclipse/ui/internal/Model.java;3;0;3;1;0;0;0;3;91;1;3;3692;106;106;1;0;0;3;3;3692;0;4116;3;3;
/org.eclipse.jdt.ui/ui/org/eclipse/jdt/internal/ui/util/OpenTypeHierarchyUtil.java;2;0;5;1;1;1;1;4;14;1;4;1494;24;24;1;0;0;4;5;1494;0;6340;5;2;
/org.eclipse.ui.workbench/Eclipse UI/org/eclipse/ui/part/DelegatingDropAdapter.java;1;0;2;1;0;0;0;2;0;0;1;173;0;0;2;1;0;2;2;173;1;173;1;1;
/org.eclipse.ltk.core.refactoring/src/org/eclipse/ltk/core/refactoring/participants/ExtensionManager.java;1;0;2;1;0;0;0;2;0;1;2;4845;0;0;1;0;0;2;2;4845;0;4913;2;1;
/org.eclipse.core.runtime/src/org/eclipse/core/internal/runtime/PluginStats.java;2;0;2;1;0;0;0;2;5;1;2;1369;5;5;1;0;0;2;2;1369;0;3013;2;2;
/org.eclipse.jdt.ui/core extension/org/eclipse/jdt/internal/corext/textmanipulation/TextRegion.java;1;0;1;1;1;1;1;0;2;0;0;6340;2;2;1;0;0;0;1;6340;0;6340;1;1;
/org.eclipse.jdt.ui.examples.javafamily/coresearch-experiment/org/eclipse/search/internal/core/InternalIndexer.java;1;0;3;1;0;0;0;3;27;1;3;1380;27;27;1;0;0;3;3;1380;0;3214;3;1;
/org.eclipse.jdt.core.tests.model/workspace/Formatter/test435/A_out.java;1;0;1;1;0;0;0;1;0;0;1;3495;0;0;1;0;0;1;1;3495;0;3495;1;1;
/org.eclipse.jface.text/src/org/eclipse/jface/text/TextViewer.java;4;2;62;2;18;16;18;44;233;4;36;663;1968;1968;4;8;2;44;62;707;10;6359;52;4;
/org.eclipse.jdt.core/model/org/eclipse/jdt/internal/core/PackageFragmentRoot.java;4;1;37;1;6;6;6;31;87;2;29;27;639;639;2;2;0;31;37;276;2;6217;35;4;
/org.eclipse.jdt.ui.tests.refactoring/resources/ExtractTemp/canExtract/A_test77_out.java;1;0;1;1;0;0;0;1;0;0;1;1575;0;0;1;0;0;1;1;1575;0;1575;1;1;
/org.eclipse.ui.forms.examples/src/org/eclipse/ui/forms/examples/views/FormView.java;1;1;9;1;2;2;2;7;106;5;3;4135;123;123;5;4;0;7;9;4135;4;5781;5;1;
/org.eclipse.team.cvs.ui/src/org/eclipse/team/internal/ccvs/ui/actions/CheckoutIntoAction.java;1;0;1;1;0;0;0;1;0;0;1;851;0;0;1;0;0;1;1;851;0;851;1;1;
/org.eclipse.swt.tests/JUnit Tests/org/eclipse/swt/tests/junit/Test_org_eclipse_swt_events_ModifyEvent.java;1;0;2;1;1;1;1;1;7;0;1;3444;11;11;1;0;0;1;2;3444;0;6352;2;1;
/org.eclipse.team.examples.filesystem/src/org/eclipse/team/examples/pessimistic/ui/DisconnectAction.java;1;0;2;1;1;1;1;1;90;0;1;3368;90;90;1;0;0;1;2;3368;0;6103;2;1;
/org.eclipse.update.ui/srcnew/org/eclipse/update/internal/ui/properties/FeatureCopyrightPropertyPage.java;3;0;7;1;0;0;0;7;24;1;7;307;36;36;1;0;0;7;7;307;0;825;7;3;
/org.eclipse.ui.ide/src/org/eclipse/ui/ICapabilityUninstallWizard.java;2;0;2;1;0;0;0;2;0;1;2;1511;0;0;1;0;0;2;2;1511;0;2263;2;2;
/org.eclipse.jdt.ui/ui refactoring/org/eclipse/jdt/internal/ui/refactoring/nls/NLSUIMessages.java;1;0;1;1;1;1;1;0;2;0;0;6340;2;2;1;0;0;0;1;6340;0;6340;1;1;
/org.eclipse.jdt.core/compiler/org/eclipse/jdt/internal/compiler/lookup/MethodBinding.java;2;1;8;1;2;2;2;6;12;2;5;24;38;38;2;1;0;6;8;24;1;5354;7;2;
/org.eclipse.ui.workbench/Eclipse UI/org/eclipse/ui/internal/dialogs/InternalErrorDialog.java;1;0;1;1;0;0;0;1;0;0;1;2737;0;0;1;0;0;1;1;2737;0;2737;1;1;
/org.eclipse.team.ui/src/org/eclipse/team/ui/synchronize/viewers/SyncInfoLabelProvider.java;1;0;1;1;0;0;0;1;0;0;1;3972;0;0;1;0;0;1;1;3972;0;3972;1;1;
/org.eclipse.jdt.core.tests.model/workspace/Converter/src/javadoc/testBug51770/X.java;1;0;1;1;0;0;0;1;0;0;1;3994;0;0;1;0;0;1;1;3994;0;3994;1;1;
/org.eclipse.update.ui.forms/Eclipse Forms/org/eclipse/ui/forms/internal/parts/ImageSegment.java;1;0;2;1;0;0;0;2;0;1;2;3096;0;0;1;0;0;2;2;3096;0;3138;2;1;
/org.eclipse.ui.workbench/Eclipse UI/org/eclipse/ui/internal/roles/RoleActivityBindingDefinition.java;1;0;2;1;0;0;0;2;0;1;2;2444;0;0;1;0;0;2;2;2444;0;2533;2;1;
/org.eclipse.team.core/src/org/eclipse/team/internal/core/BackgroundEventHandler.java;2;1;5;1;3;3;3;2;362;1;2;3966;408;408;1;0;0;2;5;3966;0;6336;5;2;
/org.eclipse.jdt.core/search/org/eclipse/jdt/internal/core/index/DocumentFactory.java;1;0;1;1;0;0;0;1;0;0;1;3216;0;0;1;0;0;1;1;3216;0;3216;1;1;
/org.eclipse.ui.tests/Eclipse UI Tests/org/eclipse/ui/tests/keys/Bug40023Test.java;3;0;14;1;1;1;1;13;144;1;13;2285;355;355;1;0;0;13;14;2285;0;6338;14;3;
/org.eclipse.pde.ui/src/org/eclipse/pde/internal/ui/editor/schema/SchemaPropertySheet.java;2;1;4;1;3;3;3;1;183;0;1;4986;194;194;1;0;0;1;4;4986;0;6336;4;2;
/org.eclipse.team.ui/src/org/eclipse/team/internal/ui/synchronize/SyncInfoModelElement.java;2;2;6;1;5;4;5;1;26;0;1;4588;62;62;2;0;1;1;6;6037;1;6337;5;2;
/org.eclipse.jdt.ui.tests.refactoring/resources/InlineMethodWorkspace/TestCases/simple_in/TestFieldInitializer1.java;1;0;1;1;0;0;0;1;0;0;1;2281;0;0;1;0;0;1;1;2281;0;2281;1;1;
/org.eclipse.pde.ui/src/org/eclipse/pde/internal/ui/wizards/tools/MigratePluginWizardPage.java;2;1;5;1;4;4;4;1;20;0;1;3840;42;42;1;0;0;1;5;3840;0;6336;5;2;
/org.eclipse.debug.ui/ui/org/eclipse/debug/internal/ui/console/IConsolePage.java;1;0;2;1;0;0;0;2;0;1;2;1317;0;0;1;0;0;2;2;1317;0;1422;2;1;
/org.eclipse.ui.workbench/Eclipse UI/org/eclipse/ui/internal/ToggleEditorsVisibilityAction.java;1;0;1;1;0;0;0;1;84;0;1;2737;84;84;1;0;0;1;1;2737;0;2737;1;1;
/org.eclipse.update.tests.core/src/org/eclipse/update/tests/branding/BundleProviderTest.java;1;1;3;1;2;2;2;1;4;0;1;4951;5;5;1;0;0;1;3;4951;0;6336;3;1;
/org.eclipse.jdt.ui.tests.refactoring/resources/ExtractMethodWorkSpace/ExtractMethodTests/try_in/A_test452.java;1;0;2;1;0;0;0;2;2;1;2;130;4;4;1;0;0;2;2;130;0;844;2;1;
/org.eclipse.jdt.launching/launching/org/eclipse/jdt/internal/launching/JavaRemoteApplicationLaunchConfigurationDelegate.java;2;0;2;1;1;1;1;1;4;0;1;3812;8;8;1;0;0;1;2;3812;0;6336;2;2;
/org.eclipse.swt/Eclipse SWT Browser/common/org/eclipse/swt/browser/CloseWindowEvent.java;1;0;4;1;0;0;0;4;18;2;3;2899;18;18;2;1;0;4;4;2899;1;3167;3;1;
/org.eclipse.jdt.ui.tests.refactoring/test cases/org/eclipse/jdt/ui/tests/reorg/DeleteTest.java;5;1;24;2;2;2;2;22;187;3;18;444;618;618;3;4;0;22;24;708;4;6340;20;5;
/org.eclipse.search/search/org/eclipse/search/internal/ui/Search.java;1;0;2;1;1;1;1;1;2;0;1;119;4;4;1;0;0;1;2;119;0;6340;2;1;
/org.eclipse.jdt.core/compiler/org/eclipse/jdt/internal/compiler/lookup/CompilationUnitScope.java;3;0;6;1;1;1;1;5;32;1;5;884;61;61;1;0;0;5;6;884;0;5587;6;3;
/org.eclipse.pde.ui/src_Forms/org/eclipse/pde/internal/ui/neweditor/PDEFormSelectionProvider.java;2;0;2;1;1;1;1;1;0;0;1;3749;0;0;1;0;0;1;2;3749;0;5431;2;2;
/org.eclipse.jdt.ui.tests.refactoring/resources/MoveInnerToTopLevel/test_nonstatic_33/out/I.java;2;0;2;1;1;1;1;1;2;0;1;305;4;4;1;0;0;1;2;305;0;5854;2;2;
/org.eclipse.jdt.core/dom/org/eclipse/jdt/core/dom/DocCommentParser.java;3;0;12;2;1;1;1;11;101;4;6;3762;197;197;4;5;0;11;12;3806;5;5608;7;3;
/org.eclipse.ui.workbench.texteditor/src/org/eclipse/ui/texteditor/ConfigurationElementSorter.java;3;2;5;2;4;3;4;1;56;0;1;3780;64;64;2;0;1;1;5;6334;1;6334;4;3;
/org.eclipse.jdt.ui/ui/org/eclipse/jdt/internal/ui/callhierarchy/SearchScopeActionGroup.java;3;1;8;1;2;2;2;6;811;2;5;155;1026;1026;2;1;0;6;8;171;1;6340;7;3;
/org.eclipse.compare/compare/org/eclipse/compare/internal/ImageMergeViewer.java;1;0;2;1;0;0;0;2;3;1;2;257;5;5;1;0;0;2;2;257;0;1289;2;1;
/org.eclipse.jdt.debug.ui/ui/org/eclipse/jdt/internal/debug/ui/launcher/JavaLaunchConfigurationTab.java;1;0;1;1;0;0;0;1;3;0;1;2691;3;3;1;0;0;1;1;2691;0;2691;1;1;
/org.eclipse.jdt.ui/ui/org/eclipse/jdt/internal/ui/actions/QuickMenuAction.java;1;1;4;1;3;3;3;1;97;0;1;5052;173;173;1;0;0;1;4;5052;0;6057;4;1;
/org.eclipse.jdt.core.tests.model/workspace/Converter/src/test0143/Test.java;1;0;1;1;0;0;0;1;0;0;1;3714;0;0;1;0;0;1;1;3714;0;3714;1;1;
/org.eclipse.jdt.core.tests.model/workspace/Converter/test0024/Test.java;1;0;1;1;0;0;0;1;0;0;1;3714;0;0;1;0;0;1;1;3714;0;3714;1;1;
/org.eclipse.jdt.ui/core refactoring/org/eclipse/jdt/internal/corext/refactoring/rename/RenamePackageRefactoring.java;2;0;6;1;0;0;0;6;26;1;6;122;56;56;1;0;0;6;6;122;0;1125;6;2;
/org.eclipse.ui.intro/src/org/eclipse/ui/intro/internal/model/AbstractTextElement.java;1;0;6;1;1;1;1;5;104;1;5;4429;138;138;1;0;0;5;6;4429;0;5115;6;1;
/org.eclipse.osgi/core/framework/org/eclipse/osgi/framework/internal/core/BundleNativeCode.java;5;2;16;1;4;3;4;12;760;1;12;3013;892;892;2;0;1;12;16;5116;1;5467;15;5;
/org.eclipse.jdt.ui.tests/ui/org/eclipse/jdt/ui/tests/astrewrite/ASTRewritingExpressionsTest.java;2;0;14;1;1;1;1;13;383;2;11;920;1045;1045;2;2;0;13;14;2814;2;5406;12;2;
/org.eclipse.core.expressions/src/org/eclipse/core/expressions/EvaluationContext.java;1;1;6;1;3;3;3;3;27;1;3;4108;75;75;1;0;0;3;6;4108;0;6340;6;1;
/org.eclipse.jdt.junit/src/org/eclipse/jdt/internal/junit/launcher/JUnitLaunchConfigurationTab.java;1;0;1;1;1;1;1;0;2;0;0;6340;2;2;1;0;0;0;1;6340;0;6340;1;1;
/org.eclipse.team.core/src/org/eclipse/team/core/subscribers/JobStatusHandler.java;1;0;1;1;0;0;0;1;0;0;1;3550;0;0;1;0;0;1;1;3550;0;3550;1;1;
/org.eclipse.jdt.ui.tests/leaks/org/eclipse/jdt/ui/leaktest/ProfilerConnector.java;3;0;3;2;1;1;1;2;5;1;2;3124;11;11;1;0;0;2;3;3124;0;6340;3;3;
/org.eclipse.ui.workbench/Eclipse UI/org/eclipse/ui/internal/activities/ws/CategoryContentProvider.java;2;0;2;1;0;0;0;2;0;1;2;3066;0;0;1;0;0;2;2;3066;0;4651;2;2;
/org.eclipse.help/src/org/eclipse/help/internal/toc/TocFile.java;1;1;3;1;3;3;3;0;34;0;0;5590;52;52;1;0;0;0;3;5590;0;6337;3;1;
/org.eclipse.swt/Eclipse SWT PI/gtk/org/eclipse/swt/internal/gtk/OS.java;7;3;122;3;30;23;30;92;1758;4;74;15;5810;5810;4;18;7;92;122;1097;25;6362;97;7;
/org.eclipse.jdt.ui/ui/org/eclipse/jdt/internal/ui/javaeditor/filebuffers/CustomBufferFactory2.java;2;0;4;1;0;0;0;4;13;1;4;1581;18;18;1;0;0;4;4;1581;0;4425;4;2;
/org.eclipse.core.runtime/src/org/eclipse/core/internal/registry/ExtensionLinker.java;3;1;5;2;2;2;2;3;54;2;2;3049;56;56;2;1;0;3;5;3164;1;5531;4;3;
/org.eclipse.team.ui/src/org/eclipse/team/internal/ui/synchronize/RefreshChangeListener.java;2;2;4;2;3;2;3;1;10;0;1;4518;13;13;2;0;1;1;4;5358;1;6337;3;2;
/org.eclipse.update.ui/src/org/eclipse/update/internal/ui/preferences/UpdateColors.java;1;0;1;1;0;0;0;1;0;0;1;774;0;0;1;0;0;1;1;774;0;774;1;1;
/org.eclipse.jdt.core.tests.model/workspace/Formatter/test153/A_in.java;1;0;1;1;0;0;0;1;0;0;1;2425;0;0;1;0;0;1;1;2425;0;2425;1;1;
/org.eclipse.jdt.ui/core refactoring/org/eclipse/jdt/internal/corext/refactoring/reorg2/IReorgEnablementPolicy.java;1;0;2;1;0;0;0;2;0;1;2;444;0;0;1;0;0;2;2;444;0;1114;2;1;
/org.eclipse.team.cvs.core/src/org/eclipse/team/internal/ccvs/core/CVSProjectSetCapability.java;1;0;2;1;0;0;0;2;516;1;2;4857;516;516;1;0;0;2;2;4857;0;4969;2;1;
/org.eclipse.ui.externaltools/Ant Tools Support/org/eclipse/ui/externaltools/internal/ant/preferences/AntClasspathContentProvider.java;2;0;2;1;0;0;0;2;6;1;2;244;6;6;1;0;0;2;2;244;0;282;2;2;
/org.eclipse.swt/Eclipse SWT Drag and Drop/win32/org/eclipse/swt/dnd/TreeDragUnderEffect.java;3;1;5;1;2;2;2;3;71;1;3;766;111;111;1;0;0;3;5;766;0;6352;5;3;
/org.eclipse.ui.workbench/Eclipse UI/org/eclipse/ui/internal/commands/keys/KeyStroke.java;1;0;3;1;0;0;0;3;95;1;3;1264;109;109;1;0;0;3;3;1264;0;1294;3;1;
/org.eclipse.jdt.core.tests.builder/src/org/eclipse/jdt/core/tests/builder/EfficiencyTests.java;2;0;2;1;0;0;0;2;12;1;2;1387;14;14;1;0;0;2;2;1387;0;3560;2;2;
/org.eclipse.jdt.core.tests.model/workspace/JavaSearch/src/j1/AnnHiddenRef.java;1;0;2;1;0;0;0;2;0;1;2;2661;0;0;1;0;0;2;2;2661;0;3081;2;1;
/org.eclipse.core.tests.resources/src/org/eclipse/core/tests/resources/session/TestMissingBuilder.java;1;0;2;1;2;1;2;0;307;0;0;5147;307;307;2;0;1;0;2;5147;1;5147;1;1;
/org.eclipse.jdt.core/model/org/eclipse/jdt/core/ISourceReference.java;1;0;3;1;0;0;0;3;6;1;3;2583;10;10;1;0;0;3;3;2583;0;3580;3;1;
/org.eclipse.ant.ui/Ant Editor/org/eclipse/ant/internal/ui/editor/formatter/XmlFormatter.java;1;1;5;1;5;5;5;0;232;0;0;5739;263;263;1;0;0;0;5;5739;0;6129;5;1;
/org.eclipse.jdt.ui/ui/org/eclipse/jdt/internal/ui/text/comment/CommentObjectFactory.java;2;0;7;1;1;1;1;6;37;1;6;1589;106;106;1;0;0;6;7;1589;0;6340;7;2;
/org.eclipse.ui.workbench/Eclipse UI/org/eclipse/ui/internal/csm/activities/Activity.java;1;0;10;1;0;0;0;10;92;3;7;2225;201;201;3;3;0;10;10;2225;3;2441;7;1;
/org.eclipse.jdt.text.tests/src/org/eclipse/jdt/text/tests/StringsTest.java;1;1;2;1;2;2;2;0;2;0;0;5129;2;2;1;0;0;0;2;5129;0;6340;2;1;
/org.eclipse.jdt.core.tests.model/workspace/Formatter/test342/A_in.java;1;0;1;1;0;0;0;1;0;0;1;2865;0;0;1;0;0;1;1;2865;0;2865;1;1;
/org.eclipse.releng.tools/src/org/eclipse/releng/tools/ProjectSelectionPage.java;2;1;3;1;3;3;3;0;11;0;0;5183;15;15;1;0;0;0;3;5183;0;5634;3;2;
/org.eclipse.ui.workbench/Eclipse UI/org/eclipse/ui/internal/keys/MacKeyFormatter.java;1;0;2;1;0;0;0;2;37;1;2;3329;61;61;1;0;0;2;2;3329;0;3350;2;1;
/org.eclipse.swt/Eclipse SWT Drag and Drop/common/org/eclipse/swt/dnd/DNDListener.java;1;0;1;1;0;0;0;1;6;0;1;1540;6;6;1;0;0;1;1;1540;0;1540;1;1;
/org.eclipse.pde.core/src/org/eclipse/pde/internal/core/schema/RepeatableSchemaObject.java;2;1;2;1;2;2;2;0;4;0;0;5799;8;8;1;0;0;0;2;5799;0;6336;2;2;
/org.eclipse.jdt.core/compiler/org/eclipse/jdt/internal/compiler/lookup/LookupEnvironment.java;3;1;6;1;2;2;2;4;35;2;3;3560;59;59;2;1;0;4;6;3811;1;5946;5;3;
/org.eclipse.core.tests.runtime/src/org/eclipse/core/tests/internal/runtimetests/SampleIFR.java;1;0;1;1;1;1;1;0;21;0;0;5149;21;21;1;0;0;0;1;5149;0;5149;1;1;
/org.eclipse.search/search/org/eclipse/search/internal/ui/text/EditorOpener.java;2;1;5;1;5;5;5;0;13;0;0;5460;20;20;1;0;0;0;5;5460;0;6340;5;2;
/org.eclipse.jdt.ui/ui/org/eclipse/jdt/internal/ui/reorg/PackageFragmentRootManipulationQuery.java;1;0;1;1;0;0;0;1;0;0;1;1111;0;0;1;0;0;1;1;1111;0;1111;1;1;
/org.eclipse.jdt.ui.tests.refactoring/resources/InlineMethodWorkspace/TestCases/invalid/TestInvalidFieldInitializer1.java;1;0;1;1;0;0;0;1;0;0;1;2281;0;0;1;0;0;1;1;2281;0;2281;1;1;
/org.eclipse.core.resources/src/org/eclipse/core/internal/localstore/TestingSupport.java;2;1;6;1;2;2;2;4;30;1;4;1653;75;75;1;0;0;4;6;1653;0;6127;6;2;
/org.eclipse.jdt.junit/src/org/eclipse/jdt/internal/junit/launcher/JUnitBaseLaunchConfiguration.java;4;2;12;1;5;4;5;7;27;1;7;185;93;93;2;0;1;7;12;6124;1;6340;11;4;
/org.eclipse.core.tools/src/org/eclipse/core/tools/TableWithTotalView.java;1;0;1;1;1;1;1;0;0;0;0;6302;0;0;1;0;0;0;1;6302;0;6302;1;1;
/org.eclipse.pde.core/src/org/eclipse/pde/internal/core/plugin/PluginObject.java;2;1;14;2;5;5;5;9;19;2;8;368;86;86;2;1;0;9;14;2931;1;6336;13;2;
/org.eclipse.ui.workbench/Eclipse UI/org/eclipse/ui/internal/contexts/PluginContextRegistry.java;1;0;7;1;0;0;0;7;5;2;5;1400;14;14;2;2;0;7;7;1400;2;2425;5;1;
/org.eclipse.swt/Eclipse SWT/photon/org/eclipse/swt/graphics/FontMetrics.java;2;0;2;1;1;1;1;1;9;0;1;4566;13;13;1;0;0;1;2;4566;0;6352;2;2;
/org.eclipse.team.cvs.ui/src/org/eclipse/team/internal/ccvs/ui/actions/EditAction.java;2;1;3;1;3;3;3;0;41;0;0;5447;56;56;1;0;0;0;3;5447;0;6337;3;2;
/org.eclipse.ui.workbench/Eclipse UI/org/eclipse/ui/presentations/AbstractPresentationFactory.java;3;1;7;1;3;3;3;4;110;2;3;4469;273;273;2;1;0;4;7;4469;1;5672;6;3;
/org.eclipse.swt/Eclipse SWT/carbon/org/eclipse/swt/widgets/Menu.java;4;1;14;2;3;3;3;11;107;1;11;33;318;318;1;0;0;11;14;33;0;6352;14;4;
/org.eclipse.ui.workbench.texteditor/src/org/eclipse/ui/texteditor/GotoLineAction.java;1;1;3;1;2;2;2;1;4;0;1;1346;8;8;1;0;0;1;3;1346;0;6340;3;1;
/org.eclipse.jdt.ui.examples.javafamily/src/org/eclipse/jface/text/source/translation/ITagHandlerFactory.java;1;0;1;1;1;1;1;0;0;0;0;5122;0;0;1;0;0;0;1;5122;0;5122;1;1;
/org.eclipse.osgi/core/framework/org/eclipse/osgi/framework/internal/core/StartLevelEvent.java;5;1;6;1;3;3;3;3;99;1;3;3013;164;164;1;0;0;3;6;3013;0;6337;6;5;
/org.eclipse.jdt.ui/core extension/org/eclipse/jdt/internal/corext/dom/ContainerFinder.java;1;0;2;1;0;0;0;2;0;1;2;130;0;0;1;0;0;2;2;130;0;155;2;1;
/org.eclipse.ant.tests.ui/Ant Editor Tests/org/eclipse/ant/ui/internal/editor/support/TestEditor.java;1;0;2;1;0;0;0;2;0;1;2;1274;0;0;1;0;0;2;2;1274;0;1811;2;1;
/org.eclipse.ui.ide/src/org/eclipse/ui/views/bookmarkexplorer/IBookmarkHelpContextIds.java;1;0;1;1;0;0;0;1;0;0;1;2208;0;0;1;0;0;1;1;2208;0;2208;1;1;
/org.eclipse.ltk.ui.refactoring/src/org/eclipse/ltk/internal/ui/refactoring/IChangeElementChildrenCreator.java;1;0;2;1;1;1;1;1;2;0;1;4965;2;2;1;0;0;1;2;4965;0;6340;2;1;
/org.eclipse.jdt.ui.tests/ui/org/eclipse/jdt/ui/tests/AutomatedSuite.java;6;1;9;2;2;2;2;7;12;2;6;329;39;39;2;1;0;7;9;4205;1;6340;8;6;
/org.eclipse.ui.workbench/Eclipse UI/org/eclipse/ui/internal/dialogs/FakeWizardActionSet.java;1;0;1;1;0;0;0;1;0;0;1;830;0;0;1;0;0;1;1;830;0;830;1;1;
/org.eclipse.ant.ui/Ant Tools Support/org/eclipse/ant/internal/ui/launchConfigurations/AntJavaLaunchDelegate.java;2;0;3;1;1;1;1;2;12;1;2;4876;17;17;1;0;0;2;3;4876;0;5879;3;2;
/org.eclipse.jdt.core/dom/org/eclipse/jdt/core/dom/PrefixExpression.java;3;1;8;1;2;2;2;6;105;1;6;3560;135;135;1;0;0;6;8;3560;0;5272;8;3;
/org.eclipse.jdt.core.tests.model/workspace/Converter/test0276/Test.java;1;0;1;1;0;0;0;1;0;0;1;3714;0;0;1;0;0;1;1;3714;0;3714;1;1;
/org.eclipse.jdt.core.tests.model/workspace/Formatter/test400/A_out.java;1;0;1;1;0;0;0;1;0;0;1;3436;0;0;1;0;0;1;1;3436;0;3436;1;1;
/org.eclipse.jdt.ui.tests.refactoring/resources/ExtractMethodWorkSpace/ExtractMethodTests/duplicates_in/A_test962.java;1;1;2;1;2;2;2;0;2;0;0;5650;2;2;1;0;0;0;2;5650;0;5681;2;1;
/org.eclipse.ui.workbench/Eclipse UI/org/eclipse/ui/actions/DeleteResourceAction.java;1;0;1;1;0;0;0;1;0;0;1;2737;0;0;1;0;0;1;1;2737;0;2737;1;1;
/org.eclipse.jdt.core.tests.model/workspace/Converter/src/javadoc/testBug54424/Test.java;1;0;1;1;1;1;1;0;0;0;0;5713;0;0;1;0;0;0;1;5713;0;5713;1;1;
/org.eclipse.team.tests.cvs.core/src/org/eclipse/team/tests/ccvs/ui/SequenceGenerator.java;1;0;1;1;0;0;0;1;0;0;1;2632;0;0;1;0;0;1;1;2632;0;2632;1;1;
/org.eclipse.ui.workbench/Eclipse UI/org/eclipse/ui/internal/roles/api/IRoleDefinition.java;1;0;2;1;0;0;0;2;0;1;2;1952;0;0;1;0;0;2;2;1952;0;2199;2;1;
/org.eclipse.pde.core/src_OSGi/org/eclipse/pde/internal/core/osgi/bundle/BundleFragmentModel.java;2;0;2;1;0;0;0;2;0;1;2;2485;0;0;1;0;0;2;2;2485;0;4203;2;2;
/org.eclipse.jdt.ui/core extension/org/eclipse/jdt/internal/corext/SourceRange.java;1;0;1;1;1;1;1;0;2;0;0;6340;2;2;1;0;0;0;1;6340;0;6340;1;1;
/org.eclipse.team.core/src/org/eclipse/team/core/TeamException.java;2;1;5;1;3;3;3;2;52;1;2;790;108;108;1;0;0;2;5;790;0;6336;5;2;
/org.eclipse.jdt.debug.ui/ui/org/eclipse/jdt/internal/debug/ui/actions/AddVariableAction.java;3;1;5;1;3;3;3;2;16;1;2;1240;37;37;1;0;0;2;5;1240;0;6336;5;3;
/org.eclipse.jdt.ui.tests.refactoring/resources/ExtractMethodWorkSpace/ExtractMethodTests/return_in/A_test707.java;1;0;1;1;0;0;0;1;4;0;1;844;4;4;1;0;0;1;1;844;0;844;1;1;
/org.eclipse.jdt.debug.tests/tests/org/eclipse/jdt/debug/tests/core/TargetPatternBreakpointTests.java;2;0;2;1;0;0;0;2;8;1;2;2210;10;10;1;0;0;2;2;2210;0;2429;2;2;
/org.eclipse.team.ui/src/org/eclipse/team/internal/ui/synchronize/ChangesSection.java;2;1;19;2;8;8;8;11;350;2;9;3221;552;552;2;2;0;11;19;4216;2;6337;17;2;
/org.eclipse.update.core/src/org/eclipse/update/core/IncludedFeatureReference.java;4;1;9;1;4;4;4;5;149;1;5;0;327;327;1;0;0;5;9;0;0;6336;9;4;
/org.eclipse.jdt.core/codeassist/org/eclipse/jdt/internal/codeassist/complete/CompletionOnArgumentName.java;2;0;2;1;0;0;0;2;35;1;2;991;37;37;1;0;0;2;2;991;0;3560;2;2;
/org.eclipse.ui.workbench/Eclipse UI/org/eclipse/ui/handlers/WidgetMethodHandler.java;2;0;3;1;0;0;0;3;75;1;3;4650;75;75;1;0;0;3;3;4650;0;4968;3;2;
/org.eclipse.jdt.core.tests.model/workspace/Converter/test0431/A.java;1;0;1;1;0;0;0;1;0;0;1;3714;0;0;1;0;0;1;1;3714;0;3714;1;1;
/org.eclipse.ui.workbench/Eclipse UI/org/eclipse/ui/internal/roles/api/secondstage/IRoleRegistryListener.java;1;0;2;1;0;0;0;2;0;1;2;2199;0;0;1;0;0;2;2;2199;0;2207;2;1;
/org.eclipse.ui.workbench/Eclipse UI/org/eclipse/ui/internal/csm/commands/api/CommandNotDefinedException.java;1;0;2;1;0;0;0;2;0;1;2;2515;0;0;1;0;0;2;2;2515;0;2532;2;1;
/org.eclipse.jdt.ui/core extension/org/eclipse/jdt/internal/corext/userlibrary/XMLWriter.java;1;0;2;1;1;1;1;1;0;0;1;4407;0;0;1;0;0;1;2;4407;0;5226;2;1;
/org.eclipse.core.resources/src/org/eclipse/core/internal/utils/Semaphore.java;2;0;2;1;1;1;1;1;67;0;1;1485;69;69;1;0;0;1;2;1485;0;5146;2;2;
/org.eclipse.debug.ui/ui/org/eclipse/debug/ui/launchVariables/SpecificFileResourceComponent.java;1;0;2;1;0;0;0;2;0;1;2;550;0;0;1;0;0;2;2;550;0;562;2;1;
/org.eclipse.ui.intro/src/org/eclipse/ui/intro/internal/model/IntroImage.java;1;0;5;1;1;1;1;4;74;1;4;4429;98;98;1;0;0;4;5;4429;0;5115;5;1;
/org.eclipse.team.ui/src/org/eclipse/team/internal/ui/sync/compare/SyncInfoCompareInputFinder.java;1;0;3;1;0;0;0;3;71;1;3;488;71;71;1;0;0;3;3;488;0;1974;3;1;
/org.eclipse.core.filebuffers/src/org/eclipse/core/filebuffers/ITextFileBuffer.java;2;1;6;1;4;4;4;2;28;1;2;1522;68;68;1;0;0;2;6;1522;0;6340;6;2;
/org.eclipse.debug.core/core/org/eclipse/debug/core/sourcelookup/containers/ProjectSourceContainer.java;1;1;5;1;2;2;2;3;37;0;1;4949;57;57;3;2;0;3;5;4949;2;5877;3;1;
/org.eclipse.jdt.ui.tests.refactoring/resources/ExtractMethodWorkSpace/ExtractMethodTests/semicolon_out/A_test401.java;1;0;2;1;0;0;0;2;4;1;2;130;5;5;1;0;0;2;2;130;0;844;2;1;
/org.eclipse.update/src/org/eclipse/update/internal/ui/UMWizardPersistentProperties.java;1;0;1;1;1;1;1;0;0;0;0;6339;0;0;1;0;0;0;1;6339;0;6339;1;1;
/org.eclipse.jdt.ui.tests.refactoring/resources/Copy/test_import_container_yes_method_in_different_cu/in/C.java;1;0;1;1;0;0;0;1;0;0;1;685;0;0;1;0;0;1;1;685;0;685;1;1;
/org.eclipse.jdt.core.tests.model/workspace/Converter/test0277/Test.java;1;0;1;1;0;0;0;1;0;0;1;3714;0;0;1;0;0;1;1;3714;0;3714;1;1;
/org.eclipse.jdt.core/model/org/eclipse/jdt/internal/core/util/RuntimeVisibleParameterAnnotationsAttribute.java;1;0;1;1;0;0;0;1;0;0;1;4466;0;0;1;0;0;1;1;4466;0;4466;1;1;
/org.eclipse.swt/Eclipse SWT PI/gtk/org/eclipse/swt/internal/gtk/GdkEventMotion.java;2;1;2;1;2;2;2;0;57;0;0;6266;59;59;1;0;0;0;2;6266;0;6352;2;2;
/org.eclipse.swt/Eclipse SWT Mozilla/common/org/eclipse/swt/internal/mozilla/nsIEmbeddingSiteWindow.java;1;0;2;1;0;0;0;2;10;1;2;1654;10;10;1;0;0;2;2;1654;0;2568;2;1;
/org.eclipse.ltk.ui.refactoring/src/org/eclipse/ltk/ui/refactoring/ChangePreviewViewerInput.java;1;1;4;1;2;2;2;2;8;1;2;4988;13;13;1;0;0;2;4;4988;0;6340;4;1;
/org.eclipse.core.resources/src/org/eclipse/core/internal/localstore/HistoryStore.java;2;1;9;1;6;6;6;3;924;1;3;93;1229;1229;1;0;0;3;9;93;0;6127;9;2;
/org.eclipse.swt/Eclipse SWT Browser/mozilla/org/eclipse/swt/browser/PromptDialog.java;2;0;2;1;1;1;1;1;6;0;1;4876;6;6;1;0;0;1;2;4876;0;6352;2;2;
/org.eclipse.jdt.ui/core refactoring/org/eclipse/jdt/internal/corext/refactoring/typeconstraints/TypeConstraints.java;1;0;6;1;0;0;0;6;145;3;3;42;219;219;3;3;0;6;6;64;3;64;3;1;
/org.eclipse.jdt.core.tests.model/workspace/Formatter/test152/A_out.java;1;0;2;1;0;0;0;2;3;1;2;2425;3;3;1;0;0;2;2;2425;0;4173;2;1;
/org.eclipse.jdt.ui/core extension/org/eclipse/jdt/internal/corext/textmanipulation/TextManipulationMessages.java;1;0;1;1;1;1;1;0;2;0;0;6340;2;2;1;0;0;0;1;6340;0;6340;1;1;
/org.eclipse.sdk.tests-feature/plugins/org.eclipse.perfmsr.core/src/org/eclipse/perfmsr/core/Sample.java;2;1;3;1;2;2;2;1;10;0;1;4845;12;12;1;0;0;1;3;4845;0;6342;3;2;
/org.eclipse.update.core/src/org/eclipse/update/internal/search/SiteSearchCategory.java;3;1;6;1;2;2;2;4;7;1;4;891;19;19;1;0;0;4;6;891;0;6336;6;3;
/org.eclipse.team.core/src/org/eclipse/team/internal/core/subscribers/caches/DescendantSynchronizationCache.java;1;0;1;1;0;0;0;1;0;0;1;3966;0;0;1;0;0;1;1;3966;0;3966;1;1;
/org.eclipse.ui.workbench/Eclipse UI/org/eclipse/ui/part/CellEditorActionHandler.java;1;0;1;1;0;0;0;1;17;0;1;2737;17;17;1;0;0;1;1;2737;0;2737;1;1;
/org.eclipse.pde.ui/sandbox/org/eclipse/pde/internal/ui/editor/standalone/manifest/FragmentManifestSourceEditor.java;1;0;2;1;0;0;0;2;0;1;2;2320;0;0;1;0;0;2;2;2320;0;2906;2;1;
/org.eclipse.pde.ui/src_Forms/org/eclipse/pde/internal/ui/neweditor/LinkSection.java;2;0;5;1;1;1;1;4;25;2;3;4219;39;39;2;1;0;4;5;4219;1;5431;4;2;
/org.eclipse.ui.workbench/Eclipse UI/org/eclipse/ui/internal/progress/IProgressService.java;1;0;1;1;0;0;0;1;0;0;1;320;0;0;1;0;0;1;1;320;0;320;1;1;
/org.eclipse.jdt.debug.ui/ui/org/eclipse/jdt/internal/debug/ui/actions/ShowConstantsAction.java;1;0;1;1;0;0;0;1;4;0;1;3296;4;4;1;0;0;1;1;3296;0;3296;1;1;
/org.eclipse.pde.ui/src/org/eclipse/pde/internal/ui/editor/StructuredViewerSection.java;1;1;2;1;2;2;2;0;36;0;0;5431;40;40;1;0;0;0;2;5431;0;6336;2;1;
/org.eclipse.jdt.ui/ui/org/eclipse/jdt/internal/ui/preferences/CompilerPropertyPage.java;2;0;3;1;1;1;1;2;26;1;2;1350;31;31;1;0;0;2;3;1350;0;6340;3;2;
/org.eclipse.jdt.debug.ui/ui/org/eclipse/jdt/internal/debug/ui/monitors/MonitorTraceAction.java;2;0;2;1;1;1;1;1;28;0;1;4480;44;44;1;0;0;1;2;4480;0;5733;2;2;
/org.eclipse.team.ui/src/org/eclipse/team/internal/ui/dialogs/DetailsDialog.java;2;1;6;1;2;2;2;4;293;2;3;987;352;352;2;1;0;4;6;987;1;6337;5;2;
/org.eclipse.jdt.core.tests.model/workspace/Formatter/test438/A_out.java;1;0;1;1;0;0;0;1;0;0;1;3498;0;0;1;0;0;1;1;3498;0;3498;1;1;
/org.eclipse.update.ui.forms/Eclipse Forms/org/eclipse/ui/forms/internal/widgets/Locator.java;1;0;2;1;0;0;0;2;0;1;2;3138;0;0;1;0;0;2;2;3138;0;4157;2;1;
/org.eclipse.jdt.core/compiler/org/eclipse/jdt/internal/compiler/lookup/BlockScope.java;4;1;19;1;3;3;3;16;206;2;15;13;757;757;2;1;0;16;19;13;1;6100;18;4;
/org.eclipse.ui.ide/src/org/eclipse/ui/views/tasklist/ITaskListResourceAdapter.java;1;0;1;1;0;0;0;1;0;0;1;2208;0;0;1;0;0;1;1;2208;0;2208;1;1;
/org.eclipse.jdt.ui/ui/org/eclipse/jdt/internal/ui/preferences/AbstractConfigurationBlockPreferencePage.java;1;1;2;1;2;2;2;0;13;0;0;5482;13;13;1;0;0;0;2;5482;0;5498;2;1;
/org.eclipse.team.ui/src/org/eclipse/team/ui/synchronize/viewers/SyncInfoDiffCheckboxTreeViewer.java;1;0;1;1;0;0;0;1;0;0;1;3972;0;0;1;0;0;1;1;3972;0;3972;1;1;
/org.eclipse.jdt.ui/core refactoring/org/eclipse/jdt/internal/corext/refactoring/structure/ChangeTypeRefactoring.java;5;2;30;2;12;10;12;18;156;2;17;2844;709;709;2;1;2;18;30;3708;3;6340;27;5;
/org.eclipse.help.tests/src/org/eclipse/help/tests/AllHelpCoreTests.java;2;1;4;1;2;2;2;2;16;1;2;2139;40;40;1;0;0;2;4;2139;0;6337;4;2;
/org.eclipse.webdav/src/kernel/org/eclipse/webdav/internal/kernel/Response.java;1;0;3;1;2;1;2;1;16;0;1;2549;20;20;2;0;1;1;3;5151;1;5151;2;1;
/org.eclipse.pde.core/src/org/eclipse/pde/internal/core/XMLErrorHandler.java;1;0;1;1;0;0;0;1;0;0;1;2906;0;0;1;0;0;1;1;2906;0;2906;1;1;
/org.eclipse.jdt.core.tests.model/workspace/Formatter/test072/A_in.java;1;0;1;1;0;0;0;1;0;0;1;2425;0;0;1;0;0;1;1;2425;0;2425;1;1;
/org.eclipse.core.tests.resources/src/org/eclipse/core/tests/internal/watson/PluggableDeltaLogicTest.java;1;0;1;1;1;1;1;0;379;0;0;5147;379;379;1;0;0;0;1;5147;0;5147;1;1;
/org.eclipse.update.ui/src/org/eclipse/update/internal/ui/views/SelectedUpdatesView.java;2;0;2;2;0;0;0;2;2;0;1;749;2;2;2;1;0;2;2;749;1;749;1;2;
/org.eclipse.pde.runtime/src/org/eclipse/pde/internal/runtime/registry/RegistryPropertySource.java;2;0;4;1;1;1;1;3;70;1;3;924;143;143;1;0;0;3;4;924;0;6336;4;2;
/org.eclipse.jdt.ui/ui refactoring/org/eclipse/jdt/internal/ui/refactoring/MessageInputPage.java;2;0;3;1;0;0;0;3;20;1;3;618;20;20;1;0;0;3;3;618;0;1668;3;2;
/org.eclipse.team.ui/src/org/eclipse/team/ui/synchronize/views/CompressedFolderDiffNode.java;1;0;1;1;0;0;0;1;0;0;1;3825;0;0;1;0;0;1;1;3825;0;3825;1;1;
/org.eclipse.ui.workbench/Eclipse UI/org/eclipse/ui/internal/chris/roles/api/secondstage/IRoleDefinition.java;1;0;2;1;0;0;0;2;0;0;1;2207;0;0;2;1;0;2;2;2207;1;2207;1;1;
/org.eclipse.debug.ui/ui/org/eclipse/debug/internal/ui/views/DebugViewDecoratingLabelProvider.java;2;0;3;1;1;1;1;2;30;1;2;3495;34;34;1;0;0;2;3;3495;0;6336;3;2;
/org.eclipse.jdt.ui/ui/org/eclipse/jdt/internal/ui/text/comment/CommentFormatter.java;2;0;3;1;0;0;0;3;4;1;3;1589;4;4;1;0;0;3;3;1589;0;1998;3;2;
/org.eclipse.osgi/eclipseAdaptor/src/org/eclipse/osgi/framework/stats/ClassloaderStats.java;3;1;5;1;4;4;4;1;94;0;1;3013;194;194;1;0;0;1;5;3013;0;6337;5;3;
/org.eclipse.jdt.core.tests.model/workspace/Converter/src/test0026/Test.java;1;0;1;1;0;0;0;1;0;0;1;3714;0;0;1;0;0;1;1;3714;0;3714;1;1;
/org.eclipse.ui.workbench/Eclipse UI/org/eclipse/ui/internal/RadioMenu.java;3;0;3;1;1;1;1;2;127;1;2;3692;137;137;1;0;0;2;3;3692;0;5172;3;3;
/org.eclipse.debug.ui/ui/org/eclipse/debug/ui/variables/StringPromptExpander.java;1;0;3;1;0;0;0;3;38;2;2;316;38;38;2;1;0;3;3;316;1;550;2;1;
/org.eclipse.debug.ui/ui/org/eclipse/debug/internal/ui/sourcelookup/browsers/ProjectSourceContainerBrowser.java;2;0;6;1;0;0;0;6;7;1;6;3770;25;25;1;0;0;6;6;3770;0;4970;6;2;
/org.eclipse.ui.workbench/Eclipse UI/org/eclipse/ui/internal/csm/roles/api/ActivityBindingDefinition.java;1;0;2;1;0;0;0;2;0;1;2;2213;0;0;1;0;0;2;2;2213;0;2225;2;1;
/org.eclipse.jdt.core.tests.model/workspace/Formatter/test469/A_out.java;1;0;1;1;0;0;0;1;0;0;1;3940;0;0;1;0;0;1;1;3940;0;3940;1;1;
/org.eclipse.jdt.core.tests.model/workspace/Converter/src/test0494/A.java;1;0;1;1;0;0;0;1;0;0;1;3714;0;0;1;0;0;1;1;3714;0;3714;1;1;
/org.eclipse.ui.workbench/Eclipse UI/org/eclipse/ui/wizards/datatransfer/FileSystemImportWizard.java;1;0;1;1;0;0;0;1;0;0;1;2737;0;0;1;0;0;1;1;2737;0;2737;1;1;
/org.eclipse.ui.workbench/Eclipse UI/org/eclipse/ui/internal/PerspectiveListenerListOld.java;2;1;3;1;3;3;3;0;17;0;0;5339;31;31;1;0;0;0;3;5339;0;6338;3;2;
/org.eclipse.jdt.ui.tests.refactoring/resources/ExtractMethodWorkSpace/ExtractMethodTests/duplicates_in/A_test960.java;1;1;2;1;2;2;2;0;2;0;0;5650;2;2;1;0;0;0;2;5650;0;5681;2;1;
/org.eclipse.swt/Eclipse SWT PI/motif/org/eclipse/swt/internal/motif/XAnyEvent.java;1;0;2;1;0;0;0;2;7;1;2;868;9;9;1;0;0;2;2;868;0;1450;2;1;
/org.eclipse.swt/Eclipse SWT PI/win32/org/eclipse/swt/internal/ole/win32/VARDESC1.java;1;0;1;1;0;0;0;1;8;0;1;2915;8;8;1;0;0;1;1;2915;0;2915;1;1;
/org.eclipse.jdt.core/search/org/eclipse/jdt/internal/core/index/impl/IndexInput.java;3;0;7;2;0;0;0;7;13;2;6;1824;24;24;2;1;0;7;7;3211;1;4060;6;3;
/org.eclipse.team.ui/src/org/eclipse/team/ui/sync/ISyncViewer.java;1;0;2;1;0;0;0;2;0;1;2;1155;0;0;1;0;0;2;2;1155;0;1354;2;1;
/org.eclipse.jdt.ui.tests.refactoring/resources/ExtractMethodWorkSpace/ExtractMethodTests/expression_in/A_test609.java;1;0;1;1;0;0;0;1;2;0;1;844;2;2;1;0;0;1;1;844;0;844;1;1;
/org.eclipse.jdt.core/dom/org/eclipse/jdt/core/dom/ASTParser.java;4;2;17;2;7;6;7;10;1604;2;8;4149;2804;2804;2;2;1;10;17;4149;3;5994;14;4;
/org.eclipse.jdt.core/compiler/org/eclipse/jdt/internal/compiler/ast/ArrayTypeReference.java;3;0;4;1;1;1;1;3;83;1;3;991;91;91;1;0;0;3;4;991;0;5916;4;3;
/org.eclipse.team.tests.cvs.core/src/org/eclipse/team/tests/ccvs/ui/benchmark/AllTests.java;1;0;1;1;0;0;0;1;0;0;1;2632;0;0;1;0;0;1;1;2632;0;2632;1;1;
/org.eclipse.ui.console/src/org/eclipse/ui/console/IConsole.java;1;0;1;1;0;0;0;1;0;0;1;1988;0;0;1;0;0;1;1;1988;0;1988;1;1;
/org.eclipse.ant.tests.ui/Ant Editor Tests/org/eclipse/ui/externaltools/internal/ant/editor/test/TaskDescriptionProviderTest.java;1;0;3;1;0;0;0;3;26;1;3;283;28;28;1;0;0;3;3;283;0;1274;3;1;
/org.eclipse.jdt.ui.tests.refactoring/resources/MoveMembers/test40/out/A.java;1;0;1;1;0;0;0;1;0;0;1;4630;0;0;1;0;0;1;1;4630;0;4630;1;1;
/org.eclipse.ui.workbench/Eclipse UI/org/eclipse/ui/internal/commands/util/CaptureListener.java;1;0;2;1;0;0;0;2;0;1;2;1077;0;0;1;0;0;2;2;1077;0;1222;2;1;
/org.eclipse.team.ui/src/org/eclipse/team/internal/ui/sync/TeamFile.java;2;0;2;1;0;0;0;2;2;1;2;866;2;2;1;0;0;2;2;866;0;4216;2;2;
/org.eclipse.swt/Eclipse SWT Accessibility/common/org/eclipse/swt/accessibility/AccessibleEvent.java;1;0;1;1;0;0;0;1;11;0;1;2729;11;11;1;0;0;1;1;2729;0;2729;1;1;
/org.eclipse.pde.core/src/org/eclipse/pde/internal/core/isite/ISiteCategoryDefinition.java;2;1;3;1;2;2;2;1;4;0;1;4203;10;10;1;0;0;1;3;4203;0;6336;3;2;
/org.eclipse.team.cvs.core/src/org/eclipse/team/internal/ccvs/core/client/listeners/UpdateListener.java;2;1;7;1;4;4;4;3;158;1;3;861;274;274;1;0;0;3;7;861;0;6337;7;2;
/org.eclipse.ui.views/src/org/eclipse/ui/views/internal/markers/problems/Messages.java;1;0;3;1;0;0;0;3;41;1;3;265;41;41;1;0;0;3;3;265;0;749;3;1;
/org.eclipse.jdt.ui/ui refactoring/org/eclipse/jdt/internal/ui/refactoring/ConvertAnonymousToNestedInputPage.java;2;0;2;1;0;0;0;2;3;1;2;363;3;3;1;0;0;2;2;363;0;518;2;2;
/org.eclipse.ui.workbench/Eclipse UI/org/eclipse/ui/internal/dialogs/PerspLabelProvider.java;2;0;2;1;0;0;0;2;6;1;2;1223;6;6;1;0;0;2;2;1223;0;2737;2;2;
/org.eclipse.jdt.ui/core refactoring/org/eclipse/jdt/internal/corext/refactoring/code/ConstantChecks.java;1;0;1;1;1;1;1;0;2;0;0;6340;2;2;1;0;0;0;1;6340;0;6340;1;1;
/org.eclipse.swt/Eclipse SWT/gtk1x/org/eclipse/swt/widgets/Trim.java;1;0;1;1;0;0;0;1;0;0;1;2327;0;0;1;0;0;1;1;2327;0;2327;1;1;
/org.eclipse.help/src/org/eclipse/help/internal/browser/CustomBrowser.java;1;0;2;1;0;0;0;2;11;1;2;31;11;11;1;0;0;2;2;31;0;2732;2;1;
/org.eclipse.jface/src/org/eclipse/jface/preference/PreferencePage.java;2;0;6;1;0;0;0;6;32;2;5;823;43;43;2;1;0;6;6;1671;1;2793;5;2;
/org.eclipse.ui.intro/src/org/eclipse/ui/intro/internal/model/IntroPage.java;1;0;4;1;1;1;1;3;31;1;3;4429;33;33;1;0;0;3;4;4429;0;5115;4;1;
/org.eclipse.help/src/org/eclipse/help/internal/model/IAnchorElement.java;1;0;2;1;1;1;1;1;9;0;1;3513;9;9;1;0;0;1;2;3513;0;5827;2;1;
/org.eclipse.jdt.ui/ui/org/eclipse/jdt/ui/actions/FindReadReferencesInHierarchyAction.java;2;0;2;1;1;1;1;1;5;0;1;3266;7;7;1;0;0;1;2;3266;0;6340;2;2;
/org.eclipse.update.core/src/org/eclipse/update/internal/configuration/BaseSiteLocalFactory.java;1;0;1;1;0;0;0;1;0;0;1;2828;0;0;1;0;0;1;1;2828;0;2828;1;1;
/org.eclipse.jdt.ui/core extension/org/eclipse/jdt/internal/corext/textmanipulation/UndoMemento.java;1;0;3;1;0;0;0;3;27;2;2;1875;33;33;2;1;0;3;3;1946;1;1946;2;1;
/org.eclipse.jdt.ui/ui/org/eclipse/jdt/internal/ui/viewsupport/LabelProviderDisposer.java;1;0;1;1;1;1;1;0;2;0;0;6340;2;2;1;0;0;0;1;6340;0;6340;1;1;
/org.eclipse.ui.workbench/Eclipse UI/org/eclipse/ui/activities/ActivityServiceAdapter.java;1;0;2;1;0;0;0;2;0;0;1;2800;0;0;2;1;0;2;2;2800;1;2800;1;1;
/org.eclipse.jdt.debug.ui/ui/org/eclipse/jdt/debug/ui/launchConfigurations/JavaConnectTab.java;4;0;5;1;1;1;1;4;14;1;4;714;30;30;1;0;0;4;5;714;0;6336;5;4;
/org.eclipse.team.cvs.core/src/org/eclipse/team/internal/ccvs/core/resources/FileContentCachingService.java;2;0;6;1;1;1;1;5;116;1;5;1650;145;145;1;0;0;5;6;1650;0;6337;6;2;
/org.eclipse.jdt.core.tests.model/workspace/JavaSearch/src/j4/TM47209.java;1;0;1;1;0;0;0;1;0;0;1;3330;0;0;1;0;0;1;1;3330;0;3330;1;1;
/org.eclipse.jdt.core.tests.model/workspace/Formatter/test255/A_out.java;1;0;2;1;0;0;0;2;4;1;2;2442;4;4;1;0;0;2;2;2442;0;3029;2;1;
/org.eclipse.ui.externaltools/Ant Editor/org/eclipse/ui/externaltools/internal/ant/dtd/schema/Element.java;1;0;1;1;0;0;0;1;0;0;1;282;0;0;1;0;0;1;1;282;0;282;1;1;
/org.eclipse.jdt.ui.tests/examples/org/eclipse/jdt/ui/examples/CheckBoxExample.java;1;0;1;1;1;1;1;0;2;0;0;6340;2;2;1;0;0;0;1;6340;0;6340;1;1;
/org.eclipse.team.cvs.ui/src/org/eclipse/team/internal/ccvs/ui/repo/RepositorySorter.java;2;0;3;1;1;1;1;2;12;1;2;276;22;22;1;0;0;2;3;276;0;6337;3;2;
/org.eclipse.swt/Eclipse SWT Browser/motif/org/eclipse/swt/browser/PromptDialog.java;2;0;2;1;1;1;1;1;6;0;1;4877;6;6;1;0;0;1;2;4877;0;6352;2;2;
/org.eclipse.jdt.ui/ui/org/eclipse/jdt/ui/text/spelling/engine/ISpellCheckIterator.java;1;0;2;1;0;0;0;2;0;1;2;3829;0;0;1;0;0;2;2;3829;0;3930;2;1;
/org.eclipse.ui.ide/src/org/eclipse/ui/views/markers/internal/ITableListener.java;1;0;1;1;0;0;0;1;0;0;1;3214;0;0;1;0;0;1;1;3214;0;3214;1;1;
/org.eclipse.core.runtime/src/org/eclipse/core/internal/registry/RegistryDelta.java;4;1;6;2;2;2;2;4;134;2;3;3049;146;146;2;1;0;4;6;3164;1;6340;5;4;
/org.eclipse.ant.ui/Ant Tools Support/org/eclipse/ant/internal/ui/preferences/AddPropertyDialog.java;2;0;5;2;0;0;0;5;48;2;4;1811;73;73;2;1;0;5;5;1856;1;4983;4;2;
/org.eclipse.ui.workbench/Eclipse UI/org/eclipse/ui/internal/csm/roles/api/IMutableRoleRegistry.java;1;0;2;1;0;0;0;2;0;1;2;2213;0;0;1;0;0;2;2;2213;0;2225;2;1;
/org.eclipse.jdt.core.tests.model/workspace/Converter/test0093/Test.java;1;0;1;1;0;0;0;1;0;0;1;3714;0;0;1;0;0;1;1;3714;0;3714;1;1;
/org.eclipse.ui.workbench/Eclipse UI/org/eclipse/ui/internal/ShowPartPaneMenuAction.java;1;0;1;1;0;0;0;1;45;0;1;2737;45;45;1;0;0;1;1;2737;0;2737;1;1;
/org.eclipse.ui.workbench/Eclipse UI/org/eclipse/ui/internal/presentations/PresentableEditorPart.java;1;1;2;1;2;2;2;0;0;0;0;5517;0;0;1;0;0;0;2;5517;0;5805;2;1;
/org.eclipse.jdt.core.tests.model/workspace/Converter/src/test0550/A.java;1;0;1;1;1;1;1;0;0;0;0;5407;0;0;1;0;0;0;1;5407;0;5407;1;1;
/org.eclipse.jdt.core.tests.model/workspace/Formatter/test131/A_in.java;1;0;1;1;0;0;0;1;0;0;1;2425;0;0;1;0;0;1;1;2425;0;2425;1;1;
/org.eclipse.jdt.ui.tests.refactoring/resources/InlineMethodWorkspace/TestCases/argument_out/TestParameterNameUsed1.java;1;0;1;1;0;0;0;1;4;0;1;845;4;4;1;0;0;1;1;845;0;845;1;1;
/org.eclipse.jdt.junit.runtime/src/org/eclipse/jdt/internal/junit/runner/RemoteTestRunner.java;2;1;9;1;3;3;3;6;64;1;6;1359;206;206;1;0;0;6;9;1359;0;6364;9;2;
/org.eclipse.ant.ui/Ant Tools Support/org/eclipse/ant/internal/ui/preferences/AntPropertiesBlock.java;2;0;14;1;1;1;1;13;98;2;9;1811;218;218;2;4;0;13;14;1859;4;5581;10;2;
/org.eclipse.update/src/org/eclipse/update/internal/ui/JarVerificationDialog.java;1;0;1;1;1;1;1;0;0;0;0;6339;0;0;1;0;0;0;1;6339;0;6339;1;1;
/org.eclipse.jdt.core.tests.model/workspace/Converter/p3/B.java;1;0;1;1;0;0;0;1;0;0;1;3714;0;0;1;0;0;1;1;3714;0;3714;1;1;
/org.eclipse.jdt.ui/ui/org/eclipse/jdt/internal/ui/text/link/LinkedUIControl.java;1;0;15;1;0;0;0;15;974;2;13;2838;1670;1670;2;2;0;15;15;3214;2;4214;13;1;
/org.eclipse.team.cvs.ui/src/org/eclipse/team/internal/ccvs/ui/wizards/KSubstWizard.java;2;1;3;1;2;2;2;1;5;0;1;4975;9;9;1;0;0;1;3;4975;0;6337;3;2;
/org.eclipse.pde.ui/src/org/eclipse/pde/internal/ui/editor/TableSection.java;2;1;3;1;2;2;2;1;43;0;1;1011;58;58;1;0;0;1;3;1011;0;6336;3;2;
/org.eclipse.ui.workbench/Eclipse UI/org/eclipse/ui/internal/ViewStack.java;3;1;5;1;5;5;5;0;81;0;0;5539;107;107;1;0;0;0;5;5539;0;6338;5;3;
/org.eclipse.jdt.core.tests.builder/src/org/eclipse/jdt/core/tests/builder/CopyResourceTests.java;2;0;3;1;0;0;0;3;16;1;3;989;23;23;1;0;0;3;3;989;0;3560;3;2;
/org.eclipse.jdt.ui/ui/org/eclipse/jdt/internal/ui/text/JavaCodeReader.java;1;0;1;1;1;1;1;0;2;0;0;6340;2;2;1;0;0;0;1;6340;0;6340;1;1;
/org.eclipse.text/src/org/eclipse/jface/text/DocumentEvent.java;1;0;1;1;1;1;1;0;18;0;0;6297;18;18;1;0;0;0;1;6297;0;6297;1;1;
/org.eclipse.pde.ui/src_Forms/org/eclipse/pde/internal/ui/model/plugin/FragmentNode.java;3;1;9;1;6;6;6;3;24;1;3;4438;102;102;1;0;0;3;9;4438;0;6336;9;3;
/org.eclipse.ui.workbench/Eclipse UI/org/eclipse/ui/internal/misc/CheckboxDoubleListGroup.java;2;1;2;1;2;2;2;0;6;0;0;5339;8;8;1;0;0;0;2;5339;0;6338;2;2;
/org.eclipse.debug.ui/ui/org/eclipse/debug/internal/ui/StepFilterManager.java;1;0;1;1;0;0;0;1;0;0;1;3613;0;0;1;0;0;1;1;3613;0;3613;1;1;
/org.eclipse.ui.views/src/org/eclipse/ui/views/internal/markers/ActionTaskProperties.java;1;0;2;1;0;0;0;2;0;0;1;749;0;0;2;1;0;2;2;749;1;749;1;1;
/org.eclipse.core.tests.resources/src/org/eclipse/core/tests/resources/regression/LocalStoreRegressionTests.java;1;0;2;1;2;1;2;0;169;0;0;5147;169;169;2;0;1;0;2;5147;1;5147;1;1;
/org.eclipse.update.core/src/org/eclipse/update/internal/api/operations/OperationsManager.java;1;0;2;1;0;0;0;2;0;1;2;3270;0;0;1;0;0;2;2;3270;0;4928;2;1;
/org.eclipse.jface.text/src/org/eclipse/jface/text/rules/ICharacterScanner.java;1;0;1;1;1;1;1;0;2;0;0;6340;2;2;1;0;0;0;1;6340;0;6340;1;1;
/org.eclipse.update.core/srcnew/org/eclipse/update/standalone/SearchCommand.java;1;0;3;1;0;0;0;3;4;2;2;699;4;4;2;1;0;3;3;699;1;825;2;1;
/org.eclipse.jdt.ui.tests.refactoring/resources/DeleteSourceReferenceEdit/A_test7_in.java;1;0;1;1;0;0;0;1;0;0;1;1652;0;0;1;0;0;1;1;1652;0;1652;1;1;
/org.eclipse.update.ui/src/org/eclipse/update/internal/ui/forms/UpdateSection.java;1;0;1;1;0;0;0;1;0;0;1;755;0;0;1;0;0;1;1;755;0;755;1;1;
/org.eclipse.core.resources/src/org/eclipse/core/internal/dtree/ObjectNotFoundException.java;1;0;1;1;1;1;1;0;31;0;0;5146;31;31;1;0;0;0;1;5146;0;5146;1;1;
/org.eclipse.jdt.core/model/org/eclipse/jdt/internal/core/util/ConstantPoolEntry.java;1;0;1;1;0;0;0;1;2;0;1;3560;2;2;1;0;0;1;1;3560;0;3560;1;1;
/org.eclipse.jdt.ui/core refactoring/org/eclipse/jdt/internal/corext/refactoring/participants/xml/ITestResult.java;1;0;4;1;0;0;0;4;12;1;4;1033;16;16;1;0;0;4;4;1033;0;2253;4;1;
/org.eclipse.jdt.core.tests.model/workspace/JavaSearch/src/s5/A.java;1;0;1;1;1;1;1;0;0;0;0;5853;0;0;1;0;0;0;1;5853;0;5853;1;1;
/org.eclipse.jdt.ui/core refactoring/org/eclipse/jdt/internal/corext/refactoring/participants/ICreateParticipant.java;1;0;3;1;0;0;0;3;2;1;3;825;2;2;1;0;0;3;3;825;0;4624;3;1;
/org.eclipse.pde.build/src/org/eclipse/pde/internal/build/site/BuildTimeSiteFactory.java;2;1;9;1;2;2;2;7;43;1;7;447;62;62;1;0;0;7;9;447;0;5530;9;2;
/org.eclipse.jdt.ui.tests/ui/org/eclipse/jdt/ui/tests/text/SmartSemicolonAutoEditStrategyTest.java;1;0;3;1;0;0;0;3;8;1;3;2004;8;8;1;0;0;3;3;2004;0;4210;3;1;
/org.eclipse.swt/Eclipse SWT/win32/org/eclipse/swt/widgets/CoolBar.java;5;1;14;2;4;4;4;10;81;2;9;1402;245;245;2;1;0;10;14;3313;1;6352;13;5;
/org.eclipse.team.ui/src/org/eclipse/team/internal/ui/synchronize/ISynchronizeModelProvider.java;2;1;5;1;4;4;4;1;20;0;1;4632;43;43;1;0;0;1;5;4632;0;6337;5;2;
/org.eclipse.swt/Eclipse SWT Accessibility/emulated/org/eclipse/swt/accessibility/AccessibleType.java;1;0;2;1;0;0;0;2;0;0;1;1102;0;0;2;1;0;2;2;1102;1;1102;1;1;
/org.eclipse.team.ftp/src/org/eclipse/team/internal/ftp/ui/SiteSelectionPage.java;1;0;1;1;0;0;0;1;0;0;1;3232;0;0;1;0;0;1;1;3232;0;3232;1;1;
/org.eclipse.jdt.ui/ui/org/eclipse/jdt/internal/ui/text/correction/LocalCorrectionsSubProcessor.java;5;2;59;2;12;11;12;47;222;3;41;88;1665;1665;3;6;1;47;59;2322;7;6340;52;5;
/org.eclipse.jdt.ui.tests.refactoring/resources/ExtractInterface/test98/in/Foo.java;1;0;1;1;0;0;0;1;0;0;1;1571;0;0;1;0;0;1;1;1571;0;1571;1;1;
/org.eclipse.jdt.core/compiler/org/eclipse/jdt/internal/compiler/lookup/LocalVariableBinding.java;1;0;2;1;0;0;0;2;3;1;2;173;5;5;1;0;0;2;2;173;0;3560;2;1;
/org.eclipse.jdt.ui.examples.javafamily/coresearch-experiment/org/eclipse/search/internal/core/Job.java;1;0;2;1;0;0;0;2;0;1;2;1380;0;0;1;0;0;2;2;1380;0;3214;2;1;
/org.eclipse.jdt.ui.tests.refactoring/test cases/org/eclipse/jdt/ui/tests/reorg/PasteResourcesFromClipboardActionTest.java;3;0;8;1;1;1;1;7;21;2;6;1111;53;53;2;1;0;7;8;1111;1;6340;7;3;
/org.eclipse.jdt.core.tests.model/workspace/Converter/src/junit/framework/TestListener.java;1;0;1;1;0;0;0;1;0;0;1;3714;0;0;1;0;0;1;1;3714;0;3714;1;1;
/org.eclipse.jdt.core.tests.model/workspace/Converter/src/test0087/Test.java;1;0;1;1;0;0;0;1;0;0;1;3714;0;0;1;0;0;1;1;3714;0;3714;1;1;
/org.eclipse.jdt.core.tests.model/workspace/Formatter/test343/A_in.java;1;0;1;1;0;0;0;1;0;0;1;2865;0;0;1;0;0;1;1;2865;0;2865;1;1;
/org.eclipse.ui.views/src/org/eclipse/ui/views/navigator/ShowInNavigatorAction.java;1;0;1;1;0;0;0;1;0;0;1;2738;0;0;1;0;0;1;1;2738;0;2738;1;1;
/org.eclipse.jdt.core.tests.model/workspace/Formatter/test346/A_out.java;1;0;1;1;0;0;0;1;0;0;1;2893;0;0;1;0;0;1;1;2893;0;2893;1;1;
/org.eclipse.debug.ui/ui/org/eclipse/debug/internal/ui/views/variables/SelectLogicalStructureAction.java;2;0;2;1;0;0;0;2;11;1;2;2687;11;11;1;0;0;2;2;2687;0;2903;2;2;
/org.eclipse.jdt.core.tests.model/workspace/Formatter/test343/A_out.java;1;0;1;1;0;0;0;1;0;0;1;2865;0;0;1;0;0;1;1;2865;0;2865;1;1;
/org.eclipse.jdt.ui/ui/org/eclipse/jdt/internal/ui/jarpackager/JarPackagerUtil.java;2;0;2;1;1;1;1;1;13;0;1;2081;15;15;1;0;0;1;2;2081;0;6340;2;2;
/org.eclipse.pde.ui/src_Forms/org/eclipse/pde/internal/ui/neweditor/site/SiteEditorContributor.java;2;0;2;1;1;1;1;1;0;0;1;4832;0;0;1;0;0;1;2;4832;0;5431;2;2;
/org.eclipse.team.tests.cvs.core/src/org/eclipse/team/tests/ccvs/core/subscriber/SyncInfoSource.java;2;1;6;1;2;2;2;4;28;1;4;1221;65;65;1;0;0;4;6;1221;0;6337;6;2;
/org.eclipse.ant.ui/Ant Tools Support/org/eclipse/ant/internal/ui/views/actions/RefreshBuildFilesAction.java;1;0;5;1;1;1;1;4;14;1;4;1811;28;28;1;0;0;4;5;1811;0;5370;5;1;
/org.eclipse.team.core/src/org/eclipse/team/internal/core/subscribers/caches/ResourceVariantTree.java;2;0;6;1;0;0;0;6;702;2;5;4194;947;947;2;1;0;6;6;4233;1;4349;5;2;
/org.eclipse.update.core/src/org/eclipse/update/internal/search/UpdatesSearchCategory.java;4;1;19;1;2;2;2;17;82;4;14;891;242;242;4;3;0;17;19;4695;3;6336;16;4;
/org.eclipse.swt.tests/JUnit Tests/org/eclipse/swt/tests/junit/Test_org_eclipse_swt_ole_win32_OleListener.java;1;0;1;1;0;0;0;1;0;0;1;2176;0;0;1;0;0;1;1;2176;0;2176;1;1;
/org.eclipse.swt/Eclipse SWT PI/gtk/org/eclipse/swt/internal/gtk/GtkAccessible.java;1;0;2;1;0;0;0;2;0;1;2;1102;0;0;1;0;0;2;2;1102;0;1214;2;1;
/org.eclipse.ant.ui/Ant Editor/org/eclipse/ant/internal/ui/dtd/schema/NfmNode.java;1;0;2;1;0;0;0;2;8;1;2;1811;8;8;1;0;0;2;2;1811;0;3614;2;1;
/org.eclipse.debug.core/core/org/eclipse/debug/internal/core/sourcelookup/containers/WorkspaceSourceContainerType.java;2;0;6;2;1;1;1;5;21;3;2;3678;27;27;3;3;0;5;6;4949;3;5672;3;2;
/org.eclipse.search/search/org/eclipse/search/ui/SearchUI.java;2;1;4;1;4;4;4;0;26;0;0;5398;47;47;1;0;0;0;4;5398;0;6340;4;2;
/org.eclipse.jdt.ui.tests.refactoring/resources/SurroundWithWorkSpace/SurroundWithTests/trycatch_out/TestWrappedLocal2.java;1;0;1;1;0;0;0;1;7;0;1;845;7;7;1;0;0;1;1;845;0;845;1;1;
/org.eclipse.jdt.core.tests.model/workspace/Formatter/test434/A_in.java;1;0;1;1;0;0;0;1;0;0;1;3495;0;0;1;0;0;1;1;3495;0;3495;1;1;
/org.eclipse.core.runtime/src/org/eclipse/core/internal/runtime/FindSupport.java;4;2;12;1;5;4;5;7;303;1;7;3153;612;612;2;0;1;7;12;5117;1;6340;11;4;
/org.eclipse.ui.workbench/Eclipse UI/org/eclipse/ui/internal/csm/activities/PreferenceActivityRegistry.java;1;0;2;1;0;0;0;2;0;1;2;2225;0;0;1;0;0;2;2;2225;0;2310;2;1;
/org.eclipse.jdt.debug/jdi/org/eclipse/jdi/internal/ThreadReferenceImpl.java;2;0;2;1;1;1;1;1;4;0;1;3694;6;6;1;0;0;1;2;3694;0;6336;2;2;
/org.eclipse.jdt.ui/ui/org/eclipse/jdt/ui/actions/FindAction.java;5;1;20;1;5;5;5;15;90;2;14;225;233;233;2;1;0;15;20;3940;1;6340;19;5;
/org.eclipse.jdt.core.tests.model/src/org/eclipse/jdt/core/tests/model/WorkingCopySearchTests.java;1;1;16;1;5;5;5;11;87;2;9;100;456;456;2;2;0;11;16;1824;2;5676;14;1;
/org.eclipse.help.ui/src/org/eclipse/help/ui/internal/DefaultHelpUI.java;1;1;6;1;3;3;3;3;83;1;3;1776;187;187;1;0;0;3;6;1776;0;6337;6;1;
/org.eclipse.ui.views/src/org/eclipse/ui/views/internal/markers/bookmarks/BookmarkView.java;1;0;4;1;0;0;0;4;272;2;3;265;299;299;2;1;0;4;4;265;1;749;3;1;
/org.eclipse.core.tests.resources/src/org/eclipse/core/tests/internal/watson/ElementDeltaTest.java;1;0;1;1;1;1;1;0;1107;0;0;5147;1107;1107;1;0;0;0;1;5147;0;5147;1;1;
/org.eclipse.update.ui.forms/src/org/eclipse/update/ui/forms/internal/CustomWorkbook.java;1;0;1;1;0;0;0;1;3;0;1;645;3;3;1;0;0;1;1;645;0;645;1;1;
/org.eclipse.ant.tests.ui/Ant Editor Tests/org/eclipse/ant/ui/internal/editor/test/AntEditorTests.java;1;0;2;1;0;0;0;2;0;1;2;1274;0;0;1;0;0;2;2;1274;0;1388;2;1;
/org.eclipse.ui.workbench/Eclipse UI/org/eclipse/ui/internal/PresentableEditorPart.java;4;1;10;1;2;2;2;8;160;3;6;4517;213;213;3;2;0;8;10;4517;2;5517;8;4;
/org.eclipse.osgi/core/adaptor/org/eclipse/osgi/framework/adaptor/ImportResourceNotFoundException.java;4;1;4;1;2;2;2;2;34;1;2;3013;40;40;1;0;0;2;4;3013;0;6337;4;4;
/org.eclipse.jdt.ui.tests.refactoring/resources/ChangeSignature/canModify/A_testException01_in.java;1;0;1;1;0;0;0;1;0;0;1;2562;0;0;1;0;0;1;1;2562;0;2562;1;1;
/org.eclipse.ui.views/src/org/eclipse/ui/views/internal/markers/ActionAddGlobalTask.java;1;0;2;1;0;0;0;2;0;0;1;749;0;0;2;1;0;2;2;749;1;749;1;1;
/org.eclipse.jdt.ui.tests.refactoring/resources/MoveMembers/test39/in/B.java;1;0;1;1;0;0;0;1;0;0;1;2093;0;0;1;0;0;1;1;2093;0;2093;1;1;
/org.eclipse.jdt.ui.tests.refactoring/resources/ExtractTemp/canExtract/A_test82_out.java;1;0;1;1;1;1;1;0;0;0;0;6051;0;0;1;0;0;0;1;6051;0;6051;1;1;
/org.eclipse.team.cvs.ssh2/src/org/eclipse/team/internal/ccvs/ssh2/PServerSSH2ServerConnection.java;1;0;2;1;1;1;1;1;2;0;1;4825;2;2;1;0;0;1;2;4825;0;5802;2;1;
/org.eclipse.ui.ide/src/org/eclipse/ui/internal/dialogs/AboutFeaturesDialog.java;2;0;4;1;0;0;0;4;38;2;3;1671;42;42;2;1;0;4;4;1671;1;2263;3;2;
/org.eclipse.ui.workbench/Eclipse UI/org/eclipse/ui/IInputProvider.java;1;0;1;1;0;0;0;1;0;0;1;947;0;0;1;0;0;1;1;947;0;947;1;1;
/org.eclipse.jdt.core/compiler/org/eclipse/jdt/internal/compiler/ast/Literal.java;2;0;3;1;0;0;0;3;57;1;3;437;64;64;1;0;0;3;3;437;0;3560;3;2;
/org.eclipse.jdt.core/compiler/org/eclipse/jdt/internal/compiler/lookup/InvocationSite.java;2;0;2;1;1;1;1;1;2;0;1;3560;4;4;1;0;0;1;2;3560;0;5615;2;2;
/org.eclipse.jdt.junit/src/org/eclipse/jdt/internal/junit/util/JUnitStatus.java;2;1;2;1;2;2;2;0;8;0;0;5112;10;10;1;0;0;0;2;5112;0;6340;2;2;
/org.eclipse.jdt.debug.tests/tests/org/eclipse/jdt/debug/tests/eval/NestedTypeFieldValue_724.java;1;0;1;1;0;0;0;1;62;0;1;1274;62;62;1;0;0;1;1;1274;0;1274;1;1;
/org.eclipse.search/new search/org/eclipse/search2/internal/ui/basic/views/DelegatingLabelProvider.java;1;0;2;1;0;0;0;2;0;1;2;3474;0;0;1;0;0;2;2;3474;0;3711;2;1;
/org.eclipse.ui.workbench/Eclipse UI/org/eclipse/ui/actions/QuickStartAction.java;2;0;3;1;0;0;0;3;77;1;3;974;77;77;1;0;0;3;3;974;0;2737;3;2;
/org.eclipse.update.configurator/src/org/eclipse/update/internal/configurator/branding/IniFileReader.java;1;1;8;1;3;3;3;5;45;2;3;4502;78;78;2;2;0;5;8;4653;2;6336;6;1;
/org.eclipse.swt/Eclipse SWT/motif/org/eclipse/swt/widgets/Control.java;7;1;50;2;14;14;14;36;174;3;30;0;1039;1039;3;6;0;36;50;279;6;6352;44;7;
/org.eclipse.team.tests.cvs.core/src/org/eclipse/team/tests/ccvs/ui/logformatter/DelimitedValuesWriter.java;1;0;1;1;0;0;0;1;0;0;1;2632;0;0;1;0;0;1;1;2632;0;2632;1;1;
/org.eclipse.pde.core/src/org/eclipse/pde/core/plugin/IPluginLibrary.java;3;1;7;1;4;4;4;3;108;1;3;4203;173;173;1;0;0;3;7;4203;0;6336;7;3;
/org.eclipse.jface/src/org/eclipse/jface/resource/ColorRegistry.java;2;0;7;1;1;1;1;6;83;1;6;3216;205;205;1;0;0;6;7;3216;0;6338;7;2;
/org.eclipse.update.ui.forms/src/org/eclipse/update/ui/forms/richtext/RichTextHTTPAction.java;1;0;2;1;0;0;0;2;0;1;2;2852;0;0;1;0;0;2;2;2852;0;2898;2;1;
/org.eclipse.jdt.ui/core extension/org/eclipse/jdt/internal/corext/dom/Selection.java;3;1;3;1;2;2;2;1;9;0;1;1953;13;13;1;0;0;1;3;1953;0;6340;3;3;
/org.eclipse.search/search/org/eclipse/search/internal/ui/text/TextSearchResultCollector.java;1;0;1;1;1;1;1;0;2;0;0;6340;2;2;1;0;0;0;1;6340;0;6340;1;1;
/org.eclipse.update/src/org/eclipse/update/internal/core/URLHandler.java;1;0;1;1;1;1;1;0;0;0;0;6339;0;0;1;0;0;0;1;6339;0;6339;1;1;
/org.eclipse.jdt.ui.tests.refactoring/resources/PullUp/test21/out/A.java;1;0;1;1;0;0;0;1;2;0;1;1690;2;2;1;0;0;1;1;1690;0;1690;1;1;
/org.eclipse.jdt.ui/ui/org/eclipse/jdt/internal/ui/filters/InterfaceFilter.java;1;0;1;1;1;1;1;0;2;0;0;6340;2;2;1;0;0;0;1;6340;0;6340;1;1;
/org.eclipse.team.examples.filesystem/src/org/eclipse/team/examples/filesystem/ui/FileSystemSynchronizeParticipant.java;2;1;3;1;3;3;3;0;67;0;0;6103;121;121;1;0;0;0;3;6103;0;6337;3;2;
/org.eclipse.search/new search/org/eclipse/search/ui/ISearchResultListener.java;3;1;7;1;3;3;3;4;40;1;4;3474;85;85;1;0;0;4;7;3474;0;6340;7;3;
/org.eclipse.swt.opengl/motif/org/eclipse/swt/opengl/GLContext.java;1;0;1;1;0;0;0;1;0;0;1;1175;0;0;1;0;0;1;1;1175;0;1175;1;1;
/org.eclipse.ui.workbench/Eclipse UI/org/eclipse/ui/internal/commands/XIPropertyListener.java;1;0;4;1;0;0;0;4;10;1;4;2532;10;10;1;0;0;4;4;2532;0;4088;4;1;
/org.eclipse.team.ui/src/org/eclipse/team/internal/ui/synchronize/ParticipantComposite.java;1;0;1;1;0;0;0;1;0;0;1;3170;0;0;1;0;0;1;1;3170;0;3170;1;1;
/org.eclipse.ui.workbench/Eclipse UI/org/eclipse/ui/internal/activities/ws/ActivityLabelProvider.java;1;0;2;1;0;0;0;2;4;1;2;3066;4;4;1;0;0;2;2;3066;0;3130;2;1;
/org.eclipse.ui.workbench/Eclipse UI/org/eclipse/ui/internal/csm/activities/workbench/IActivityActivationServiceEvent.java;1;0;2;1;0;0;0;2;0;1;2;2310;0;0;1;0;0;2;2;2310;0;2371;2;1;
/org.eclipse.ui.workbench/Eclipse UI/org/eclipse/ui/internal/dnd/DragListener.java;3;0;3;1;0;0;0;3;159;1;3;3677;159;159;1;0;0;3;3;3677;0;5068;3;3;
/org.eclipse.jdt.ui/core refactoring/org/eclipse/jdt/internal/corext/refactoring/base/RefactoringStatus.java;2;0;3;1;0;0;0;3;787;1;3;3536;790;790;1;0;0;3;3;3536;0;4575;3;2;
/org.eclipse.jdt.debug.ui/ui/org/eclipse/jdt/internal/debug/ui/jres/JREDescriptor.java;1;0;1;1;0;0;0;1;0;0;1;4849;0;0;1;0;0;1;1;4849;0;4849;1;1;
/org.eclipse.jdt.ui/ui/org/eclipse/jdt/internal/ui/javadocexport/JavadocSpecificsWizardPage.java;2;0;4;1;1;1;1;3;48;1;3;4047;77;77;1;0;0;3;4;4047;0;6340;4;2;
/org.eclipse.team.ui/src/org/eclipse/team/ui/synchronize/viewers/SyncInfoDiffNode.java;1;0;1;1;0;0;0;1;0;0;1;3972;0;0;1;0;0;1;1;3972;0;3972;1;1;
/org.eclipse.ui.workbench/Eclipse UI/org/eclipse/ui/contexts/registry/IContextRegistryListener.java;1;0;2;1;0;0;0;2;0;1;2;1400;0;0;1;0;0;2;2;1400;0;1417;2;1;
/org.eclipse.ui.workbench/Eclipse UI/org/eclipse/ui/internal/commands/old/PreferenceRegistry.java;1;0;4;1;0;0;0;4;7;1;4;1322;8;8;1;0;0;4;4;1322;0;1695;4;1;
/org.eclipse.text.tests/src/org/eclipse/text/tests/link/LinkedPositionGroupTest.java;2;1;3;1;2;2;2;1;4;0;1;5082;6;6;1;0;0;1;3;5082;0;6340;3;2;
/org.eclipse.team.cvs.core/src/org/eclipse/team/internal/ccvs/core/client/NOOPCommand.java;2;0;3;1;1;1;1;2;14;1;2;1843;18;18;1;0;0;2;3;1843;0;6337;3;2;
/org.eclipse.jdt.debug/model/org/eclipse/jdt/internal/debug/core/model/JDIArrayValue.java;2;1;4;1;2;2;2;2;40;1;2;2564;56;56;1;0;0;2;4;2564;0;6336;4;2;
/org.eclipse.ui.editors/src/org/eclipse/ui/internal/editors/quickdiff/compare/rangedifferencer/RangeDifferencer.java;2;0;3;1;0;0;0;3;2;1;3;1118;2;2;1;0;0;3;3;1118;0;1644;3;2;
/org.eclipse.jdt.core/model/org/eclipse/jdt/internal/core/Region.java;1;0;1;1;0;0;0;1;2;0;1;3560;2;2;1;0;0;1;1;3560;0;3560;1;1;
/org.eclipse.ui.workbench/Eclipse UI/org/eclipse/ui/activities/ActivityManagerFactory.java;2;0;7;1;0;0;0;7;39;2;6;2240;55;55;2;1;0;7;7;2800;1;4927;6;2;
/org.eclipse.ui.workbench/Eclipse UI/org/eclipse/ui/internal/PartStack.java;3;4;27;1;27;20;27;0;124;0;0;5367;643;643;4;0;7;0;27;5513;7;6248;20;3;
/org.eclipse.ui.workbench/Eclipse UI/org/eclipse/ui/internal/dialogs/FontPreferencePage.java;3;0;4;1;0;0;0;4;59;1;4;391;101;101;1;0;0;4;4;391;0;4235;4;3;
/org.eclipse.update.tests.core/src/org/eclipse/update/tests/mirror/TestRemoteFeatureVersionMirror.java;1;0;1;1;0;0;0;1;0;0;1;2104;0;0;1;0;0;1;1;2104;0;2104;1;1;
/org.eclipse.pde.ui/src_OSGi/org/eclipse/pde/internal/ui/osgi/templates/NewBundleTemplateWizard.java;2;0;2;1;0;0;0;2;0;1;2;2501;0;0;1;0;0;2;2;2501;0;3986;2;2;
/org.eclipse.ui.workbench/Eclipse UI/org/eclipse/ui/internal/ReopenEditorMenu.java;1;0;2;1;0;0;0;2;89;1;2;2737;168;168;1;0;0;2;2;2737;0;3046;2;1;
/org.eclipse.ui.externaltools/Ant Tools Support/org/eclipse/ui/externaltools/internal/ant/launchConfigurations/AntTabGroup.java;1;0;1;1;0;0;0;1;0;0;1;282;0;0;1;0;0;1;1;282;0;282;1;1;
/org.eclipse.ant.ui/Ant Tools Support/org/eclipse/ant/ui/internal/preferences/TabFolderLayout.java;1;0;2;1;0;0;0;2;0;1;2;250;0;0;1;0;0;2;2;250;0;1811;2;1;
/org.eclipse.team.ui/src/org/eclipse/team/internal/ui/sync/sets/SyncSetInputFromSyncSet.java;1;0;3;1;0;0;0;3;81;1;3;1289;81;81;1;0;0;3;3;1289;0;2632;3;1;
/org.eclipse.swt/Eclipse SWT/photon/org/eclipse/swt/graphics/Device.java;2;1;3;1;2;2;2;1;4;0;1;0;12;12;1;0;0;1;3;0;0;6352;3;2;
/org.eclipse.ui.workbench/Eclipse UI/org/eclipse/ui/internal/contexts/AbstractContextActivationService.java;1;0;3;1;0;0;0;3;9;1;3;3109;9;9;1;0;0;3;3;3109;0;4144;3;1;
/org.eclipse.jdt.core/model/org/eclipse/jdt/internal/core/TypeConverter.java;4;1;7;1;2;2;2;5;20;1;5;85;41;41;1;0;0;5;7;85;0;5726;7;4;
/org.eclipse.jdt.ui/core refactoring/org/eclipse/jdt/internal/corext/refactoring/structure/FieldReferenceFinder.java;1;0;1;1;0;0;0;1;0;0;1;1126;0;0;1;0;0;1;1;1126;0;1126;1;1;
/org.eclipse.jdt.core.tests.model/workspace/Formatter/test183/A_out.java;1;0;2;1;1;1;1;1;47;0;1;2425;47;47;1;0;0;1;2;2425;0;5132;2;1;
/org.eclipse.ui.workbench/Eclipse UI/org/eclipse/ui/internal/csm/commands/api/IKeySequenceBinding.java;1;0;2;1;0;0;0;2;0;1;2;2532;0;0;1;0;0;2;2;2532;0;2562;2;1;
/org.eclipse.jdt.core.tests.model/workspace/Converter/src/test0233/Test.java;1;0;1;1;0;0;0;1;0;0;1;3714;0;0;1;0;0;1;1;3714;0;3714;1;1;
/org.eclipse.jdt.junit/src/org/eclipse/jdt/internal/junit/wizards/NewTestSuiteCreationWizard.java;3;1;3;1;2;2;2;1;6;0;1;185;10;10;1;0;0;1;3;185;0;6340;3;3;
/org.eclipse.jdt.core.tests.model/workspace/Converter/src/test0437/A.java;1;0;1;1;0;0;0;1;0;0;1;3714;0;0;1;0;0;1;1;3714;0;3714;1;1;
/org.eclipse.debug.ui/ui/org/eclipse/debug/ui/ILazyDebugModelPresentation.java;1;0;2;1;0;0;0;2;0;1;2;2184;0;0;1;0;0;2;2;2184;0;2210;2;1;
/org.eclipse.jdt.ui/core refactoring/org/eclipse/jdt/internal/corext/refactoring/reorg/DeleteRefactoring.java;2;0;9;1;0;0;0;9;738;1;9;122;892;892;1;0;0;9;9;122;0;1668;9;2;
/org.eclipse.ui.workbench/Eclipse UI/org/eclipse/ui/internal/commands/api/IContextBindingDefinition.java;1;0;4;1;0;0;0;4;0;2;3;1724;0;0;2;1;0;4;4;2515;1;2532;3;1;
/org.eclipse.pde.ui/src/org/eclipse/pde/internal/ui/util/PDEProblemFinder.java;1;0;1;1;0;0;0;1;0;0;1;1962;0;0;1;0;0;1;1;1962;0;1962;1;1;
/org.eclipse.jdt.ui.tests.refactoring/resources/IntroduceParameter/simple/out/NewInstance1.java;1;0;1;1;0;0;0;1;0;0;1;2281;0;0;1;0;0;1;1;2281;0;2281;1;1;
/org.eclipse.jdt.junit/src/org/eclipse/jdt/internal/junit/ui/FailureTab.java;2;1;2;1;2;2;2;0;2;0;0;5633;2;2;1;0;0;0;2;5633;0;6340;2;2;
/org.eclipse.ui.views/src/org/eclipse/ui/views/internal/tableview/TableSorter.java;1;0;2;1;0;0;0;2;0;1;2;267;0;0;1;0;0;2;2;267;0;749;2;1;
/org.eclipse.ui.workbench/Eclipse UI/org/eclipse/ui/roles/IRoleManager.java;1;0;8;1;0;0;0;8;68;1;8;1952;154;154;1;0;0;8;8;1952;0;2864;8;1;
/org.eclipse.ui.editors/src/org/eclipse/ui/editors/text/templates/ContributionTemplateMessages.java;2;2;3;1;3;2;3;0;16;0;0;5636;16;16;2;0;1;0;3;6334;1;6334;2;2;
/org.eclipse.debug.core/core/org/eclipse/debug/internal/core/LaunchMode.java;1;0;1;1;1;1;1;0;0;0;0;5106;0;0;1;0;0;0;1;5106;0;5106;1;1;
/org.eclipse.swt.tests/JUnit Tests/org/eclipse/swt/tests/junit/Test_org_eclipse_swt_browser_NewWindowListener.java;1;0;3;1;0;0;0;3;12;2;2;2862;12;12;2;1;0;3;3;2862;1;3007;2;1;
/org.eclipse.ui.tests/Eclipse UI Tests/org/eclipse/ui/tests/compare/UIComparePreferencesAuto.java;1;0;1;1;0;0;0;1;0;0;1;2007;0;0;1;0;0;1;1;2007;0;2007;1;1;
/org.eclipse.ui.editors/src/org/eclipse/ui/internal/editors/text/UISynchronizationContext.java;2;1;2;1;2;2;2;0;20;0;0;5177;20;20;1;0;0;0;2;5177;0;6340;2;2;
/org.eclipse.ua.tests/src/org/eclipse/ui/examples/cheatsheets/pattern/actions/ExtensionActionII.java;1;0;1;1;1;1;1;0;0;0;0;6081;0;0;1;0;0;0;1;6081;0;6081;1;1;
/org.eclipse.ui.workbench/Eclipse UI/org/eclipse/ui/activities/IWorkbenchActivitySupport.java;3;1;6;1;2;2;2;4;20;1;4;3066;52;52;1;0;0;4;6;3066;0;6338;6;3;
/org.eclipse.jdt.ui.tests.refactoring/test cases/org/eclipse/jdt/ui/tests/refactoring/RenameJavaProjectTests.java;4;2;10;1;4;3;4;6;80;1;6;130;120;120;2;0;1;6;10;6117;1;6340;9;4;
/org.eclipse.debug.core/core/org/eclipse/debug/internal/core/sourcelookup/containers/LocalFileStorage.java;1;0;2;1;0;0;0;2;0;1;2;4072;0;0;1;0;0;2;2;4072;0;4949;2;1;
/org.eclipse.help.ui/src/org/eclipse/help/ui/internal/IHyperlinkListener.java;1;1;2;1;2;2;2;0;14;0;0;5827;20;20;1;0;0;0;2;5827;0;6337;2;1;
/org.eclipse.text/projection/org/eclipse/jface/text/projection/ChildDocumentManager.java;1;0;4;1;1;1;1;3;13;2;2;4623;34;34;2;1;0;3;4;4623;1;6301;3;1;
/org.eclipse.pde.ui/src/org/eclipse/pde/internal/ui/editor/plugin/JavaAttributeWizard.java;2;1;3;1;3;3;3;0;8;0;0;5431;14;14;1;0;0;0;3;5431;0;6336;3;2;
/org.eclipse.jdt.ui.tests.refactoring/resources/InlineMethodWorkspace/TestCases/argument_out/TestFieldReference.java;1;0;2;1;0;0;0;2;2;1;2;597;2;2;1;0;0;2;2;597;0;845;2;1;
/org.eclipse.debug.core/core/org/eclipse/debug/internal/core/WatchExpression.java;3;1;13;1;2;2;2;11;46;3;9;1524;169;169;3;2;0;11;13;1592;2;5635;11;3;
/org.eclipse.ui.ide/src/org/eclipse/ui/views/navigator/IResourceNavigator.java;1;0;1;1;0;0;0;1;0;0;1;2208;0;0;1;0;0;1;1;2208;0;2208;1;1;
/org.eclipse.ui.workbench/Eclipse UI/org/eclipse/ui/presentations/StackPresentation.java;6;2;15;2;8;7;8;7;41;2;5;4469;213;213;2;2;1;7;15;4469;3;6340;12;6;
/org.eclipse.swt/Eclipse SWT PI/photon/org/eclipse/swt/internal/photon/OS.java;4;0;20;1;1;1;1;19;3707;3;16;447;3821;3821;3;3;0;19;20;808;3;6352;17;4;
/org.eclipse.core.resources/src/org/eclipse/core/internal/resources/AliasManager.java;2;1;5;1;3;3;3;2;118;1;2;1915;143;143;1;0;0;2;5;1915;0;5741;5;2;
/org.eclipse.jdt.ui/core refactoring/org/eclipse/jdt/internal/corext/refactoring/structure/MoveInnerToTopRefactoring.java;5;2;51;2;13;12;13;38;832;2;35;103;1708;1708;2;3;1;38;51;546;4;6340;47;5;
/org.eclipse.pde.build/src/org/eclipse/pde/internal/build/packager/FetchFileGenerator.java;2;1;12;1;5;5;5;7;57;1;7;447;199;199;1;0;0;7;12;447;0;5754;12;2;
/org.eclipse.team.ui/src/org/eclipse/team/internal/ui/sync/pages/SynchronizeManager.java;1;0;1;1;0;0;0;1;0;0;1;2406;0;0;1;0;0;1;1;2406;0;2406;1;1;
/org.eclipse.team.tests.cvs.core/src/org/eclipse/team/tests/ccvs/core/provider/AllTestsProvider.java;2;0;2;1;0;0;0;2;13;1;2;2734;14;14;1;0;0;2;2;2734;0;2863;2;2;
/org.eclipse.ui.forms/src/org/eclipse/ui/forms/widgets/SharedScrolledComposite.java;1;0;7;1;1;1;1;6;43;1;6;4068;78;78;1;0;0;6;7;4068;0;6336;7;1;
/org.eclipse.jdt.core.tests.model/workspace/Resolve/src/ResolveDuplicateFieldDeclaration3.java;1;0;1;1;1;1;1;0;0;0;0;6222;0;0;1;0;0;0;1;6222;0;6222;1;1;
/org.eclipse.osgi/osgi/src/org/osgi/service/url/URLConstants.java;2;0;2;1;1;1;1;1;3;0;1;3013;3;3;1;0;0;1;2;3013;0;5536;2;2;
/org.eclipse.pde.ui/src_Forms/org/eclipse/pde/internal/ui/neweditor/schema/SchemaAdapterFactory.java;1;0;2;1;0;0;0;2;0;1;2;4856;0;0;1;0;0;2;2;4856;0;4879;2;1;
/org.eclipse.jdt.ui/ui/org/eclipse/jdt/internal/ui/actions/BlockCommentAction.java;3;1;7;1;2;2;2;5;256;1;5;1631;283;283;1;0;0;5;7;1631;0;6340;7;3;
/org.eclipse.core.runtime.osgi/src/org/eclipse/core/internal/registry/RegistryModelObject.java;1;0;2;1;0;0;0;2;9;1;2;3013;9;9;1;0;0;2;2;3013;0;3030;2;1;
/org.eclipse.ui.views/src/org/eclipse/ui/views/markers/internal/DialogTaskFilter.java;2;0;2;1;0;0;0;2;0;1;2;755;0;0;1;0;0;2;2;755;0;2738;2;2;
/org.eclipse.ui.externaltools/Ant Editor/org/eclipse/ui/externaltools/internal/ant/editor/text/IReconcilingParticipant.java;1;0;1;1;0;0;0;1;0;0;1;282;0;0;1;0;0;1;1;282;0;282;1;1;
/org.eclipse.jdt.ui/ui/org/eclipse/jdt/internal/ui/util/TypeInfoLabelProvider.java;2;1;2;1;2;2;2;0;5;0;0;5591;7;7;1;0;0;0;2;5591;0;6340;2;2;
/org.eclipse.swt/Eclipse SWT/motif/org/eclipse/swt/widgets/Button.java;5;1;14;2;3;3;3;11;55;2;9;267;137;137;2;2;0;11;14;267;2;6352;12;5;
/org.eclipse.jdt.core.tests.model/workspace/Converter/test0003/Test.java;1;0;1;1;0;0;0;1;0;0;1;3714;0;0;1;0;0;1;1;3714;0;3714;1;1;
/org.eclipse.jdt.ui.tests.refactoring/test cases/org/eclipse/jdt/ui/tests/refactoring/RenameTempTests.java;4;0;11;2;1;1;1;10;16;2;9;130;49;49;2;1;0;10;11;1602;1;6340;10;4;
/org.eclipse.jdt.core.tests.builder/src/org/eclipse/jdt/core/tests/builder/StaticFinalTests.java;3;0;4;1;0;0;0;4;18;1;4;312;25;25;1;0;0;4;4;312;0;3560;4;3;
/org.eclipse.pde.ui/src/org/eclipse/pde/internal/ui/wizards/extension/NewExtensionRegistryReader.java;3;1;4;1;4;4;4;0;357;0;0;5496;403;403;1;0;0;0;4;5496;0;6336;4;3;
/org.eclipse.debug.ui/ui/org/eclipse/debug/ui/launchVariables/expanders/PromptExpanderBase.java;1;0;3;1;0;0;0;3;7;1;3;562;7;7;1;0;0;3;3;562;0;771;3;1;
/org.eclipse.ui.workbench/Eclipse UI/org/eclipse/ui/internal/commands/GestureSupport.java;1;0;3;1;0;0;0;3;0;1;3;786;0;0;1;0;0;3;3;786;0;1077;3;1;
/org.eclipse.releng.tools/src/org/eclipse/releng/tools/SourceFile.java;1;0;1;1;1;1;1;0;0;0;0;5183;0;0;1;0;0;0;1;5183;0;5183;1;1;
/org.eclipse.jdt.ui/core refactoring/org/eclipse/jdt/internal/corext/refactoring/typeconstraints/IConstraintVariableFactory.java;2;0;2;1;1;1;1;1;2;0;1;3710;2;2;1;0;0;1;2;3710;0;6340;2;2;
/org.eclipse.jdt.ui/ui/org/eclipse/jdt/internal/ui/workingsets/JavaWorkingSetPage.java;1;0;4;1;1;1;1;3;45;1;3;951;81;81;1;0;0;3;4;951;0;6340;4;1;
/org.eclipse.jdt.core.tests.compiler/src/org/eclipse/jdt/core/tests/compiler/parser/DietRecoveryTest.java;4;0;16;1;0;0;0;16;98;2;15;69;478;478;2;1;0;16;16;991;1;3560;15;4;
/org.eclipse.osgi/defaultAdaptor/src/org/eclipse/osgi/framework/internal/defaultadaptor/BundleFile.java;3;0;6;2;0;0;0;6;203;2;5;3013;306;306;2;1;0;6;6;3419;1;4336;5;3;
/org.eclipse.help/src/org/eclipse/help/internal/browser/CustomBrowserFactory.java;1;0;1;1;0;0;0;1;0;0;1;2732;0;0;1;0;0;1;1;2732;0;2732;1;1;
/org.eclipse.core.runtime/src/org/eclipse/core/internal/plugins/IPluginVisitor.java;1;0;1;1;0;0;0;1;0;0;1;3013;0;0;1;0;0;1;1;3013;0;3013;1;1;
/org.eclipse.jdt.debug.ui/ui/org/eclipse/jdt/internal/debug/ui/EvaluationContextManager.java;2;0;2;1;0;0;0;2;10;1;2;1193;13;13;1;0;0;2;2;1193;0;2648;2;2;
/org.eclipse.ui.ide/src/org/eclipse/ui/internal/model/WorkbenchAdapterBuilder.java;2;0;3;1;0;0;0;3;20;1;3;1511;20;20;1;0;0;3;3;1511;0;2263;3;2;
/org.eclipse.swt/Eclipse SWT/gtk1x/org/eclipse/swt/widgets/GtkFileDialog.java;1;0;1;1;0;0;0;1;0;0;1;2327;0;0;1;0;0;1;1;2327;0;2327;1;1;
/org.eclipse.debug.core/core/org/eclipse/debug/internal/core/EnvironmentVariableResolver.java;3;0;5;1;1;1;1;4;14;1;4;2606;27;27;1;0;0;4;5;2606;0;5475;5;3;
/org.eclipse.swt.tests/JUnit Tests/org/eclipse/swt/tests/junit/Test_org_eclipse_swt_widgets_TabItem.java;2;0;4;1;0;0;0;4;36;2;3;2123;92;92;2;1;0;4;4;2802;1;2824;3;2;
/org.eclipse.update.ui.forms/src/org/eclipse/ui/forms/internal/parts/PartsTest.java;1;0;2;1;0;0;0;2;0;0;1;3095;0;0;2;1;0;2;2;3095;1;3095;1;1;
/org.eclipse.ui.workbench/Eclipse UI/org/eclipse/ui/internal/dialogs/ProjectCapabilitySimpleSelectionPage.java;1;0;1;1;0;0;0;1;0;0;1;2737;0;0;1;0;0;1;1;2737;0;2737;1;1;
/org.eclipse.ant.ui/Ant Tools Support/org/eclipse/ant/ui/internal/preferences/AntPropertiesBlock.java;1;0;15;1;0;0;0;15;116;3;12;250;232;232;3;3;0;15;15;1537;3;1811;12;1;
/org.eclipse.help/src/org/eclipse/help/internal/model/INavigationElement.java;1;0;3;1;1;1;1;2;11;1;2;3513;13;13;1;0;0;2;3;3513;0;5827;3;1;
/org.eclipse.jdt.ui/core refactoring/org/eclipse/jdt/internal/corext/refactoring/participants/RenameCompilationUnitProcessor.java;2;0;4;1;0;0;0;4;46;1;4;591;54;54;1;0;0;4;4;591;0;1125;4;2;
/org.eclipse.ui.workbench/Eclipse UI/org/eclipse/ui/IInPlaceEditorInput.java;2;0;2;1;0;0;0;2;39;1;2;2083;39;39;1;0;0;2;2;2083;0;2737;2;2;
/org.eclipse.compare/compare/org/eclipse/compare/contentmergeviewer/TextMergeViewer.java;1;2;25;1;10;8;10;15;124;3;11;257;582;582;3;4;2;15;25;4421;6;6244;19;1;
/org.eclipse.core.tests.runtime/src/org/eclipse/core/tests/internal/plugins/NumberOfElementsTest.java;1;0;1;1;0;0;0;1;0;0;1;3014;0;0;1;0;0;1;1;3014;0;3014;1;1;
/org.eclipse.ui.workbench/Eclipse UI/org/eclipse/ui/internal/csm/activities/ActivityDefinition.java;1;0;4;1;0;0;0;4;8;1;4;2225;11;11;1;0;0;4;4;2225;0;2444;4;1;
/org.eclipse.pde.ui/src_Forms/org/eclipse/pde/internal/ui/neweditor/feature/EditorBuildFeatureAction.java;2;0;2;1;1;1;1;1;0;0;1;4926;0;0;1;0;0;1;2;4926;0;5431;2;2;
/org.eclipse.debug.ui/ui/org/eclipse/debug/internal/ui/views/launch/LaunchViewContextListener.java;3;3;42;2;23;20;23;19;530;4;13;3815;2010;2010;4;6;3;19;42;4973;9;6227;33;3;
/org.eclipse.pde.ui/src_Forms/org/eclipse/pde/internal/ui/neweditor/schema/DocSection.java;2;1;6;1;3;3;3;3;29;2;2;4856;59;59;2;1;0;3;6;4856;1;5431;5;2;
/org.eclipse.ui.workbench/Eclipse UI/org/eclipse/ui/internal/dialogs/RegistryPageContributor.java;4;0;6;1;1;1;1;5;58;1;5;2737;134;134;1;0;0;5;6;2737;0;6338;6;4;
/org.eclipse.jdt.core.tests.model/workspace/Formatter/test213/A_out.java;1;0;1;1;0;0;0;1;0;0;1;2425;0;0;1;0;0;1;1;2425;0;2425;1;1;
/org.eclipse.core.tests.runtime/src/org/eclipse/core/tests/runtime/jobs/JobRuleRunner.java;1;1;2;1;2;2;2;0;2;0;0;5530;2;2;1;0;0;0;2;5530;0;5621;2;1;
/org.eclipse.osgi/eclipseAdaptor/src/org/eclipse/osgi/framework/stats/BundleStats.java;3;1;4;1;3;3;3;1;49;0;1;3013;75;75;1;0;0;1;4;3013;0;6337;4;3;
/org.eclipse.ui.carbon/src/org/eclipse/ui/carbon/CarbonUIEnhancer.java;1;0;5;1;0;0;0;5;30;2;4;2892;44;44;2;1;0;5;5;2892;1;4196;4;1;
/org.eclipse.jdt.ui/ui/org/eclipse/jdt/internal/ui/javaeditor/SemanticToken.java;2;1;3;1;3;3;3;0;18;0;0;5272;27;27;1;0;0;0;3;5272;0;5524;3;2;
/org.eclipse.osgi/resolver/src/org/eclipse/core/dependencies/IResolutionDelta.java;3;1;3;1;2;2;2;1;3;0;1;3013;3;3;1;0;0;1;3;3013;0;5226;3;3;
/org.eclipse.ant.ui/Ant Editor/org/eclipse/ant/internal/ui/editor/templates/AntTemplateAccess.java;1;1;4;1;2;2;2;2;21;1;2;4810;31;31;1;0;0;2;4;4810;0;5372;4;1;
/org.eclipse.jdt.core/model/org/eclipse/jdt/core/IParent.java;1;0;1;1;0;0;0;1;2;0;1;3560;2;2;1;0;0;1;1;3560;0;3560;1;1;
/org.eclipse.pde.core/src/org/eclipse/pde/internal/core/ibundle/IBundleModelFactory.java;1;1;2;1;2;2;2;0;4;0;0;5445;4;4;1;0;0;0;2;5445;0;6336;2;1;
/org.eclipse.core.runtime.osgi/src/org/eclipse/core/internal/registry/ExtensionLinker.java;1;0;2;1;0;0;0;2;2;1;2;3013;2;2;1;0;0;2;2;3013;0;3030;2;1;
/org.eclipse.search/search/org/eclipse/search/internal/ui/text/DelegatingLabelProvider.java;1;0;2;1;1;1;1;1;0;0;1;3711;0;0;1;0;0;1;2;3711;0;5305;2;1;
/org.eclipse.ltk.ui.refactoring/src/org/eclipse/ltk/internal/ui/refactoring/RefactoringPreferencePage.java;1;0;2;1;1;1;1;1;2;0;1;4965;2;2;1;0;0;1;2;4965;0;6340;2;1;
/org.eclipse.ui.workbench.texteditor/src/org/eclipse/ui/internal/texteditor/CircularLayouter.java;1;0;1;1;0;0;0;1;0;0;1;2564;0;0;1;0;0;1;1;2564;0;2564;1;1;
/org.eclipse.jdt.ui.tests.refactoring/resources/ChangeTypeRefactoring/negative/A_testBogusSelection_out.java;1;0;1;1;0;0;0;1;0;0;1;2844;0;0;1;0;0;1;1;2844;0;2844;1;1;
/org.eclipse.team.tests.cvs.core/src/org/eclipse/team/tests/ccvs/core/subscriber/TestWorkspaceUpdateAction.java;2;0;5;1;0;0;0;5;7;1;5;1241;18;18;1;0;0;5;5;1241;0;2206;5;2;
/org.eclipse.core.tools.resources/src/org/eclipse/core/tools/metadata/MarkersDumper.java;1;0;1;1;1;1;1;0;0;0;0;6302;0;0;1;0;0;0;1;6302;0;6302;1;1;
/org.eclipse.jdt.debug/model/org/eclipse/jdt/debug/core/IJavaPatternBreakpoint.java;2;1;2;1;2;2;2;0;4;0;0;5114;5;5;1;0;0;0;2;5114;0;6336;2;2;
/org.eclipse.ui.workbench/Eclipse UI/org/eclipse/ui/internal/WidgetHider.java;1;0;4;1;0;0;0;4;16;2;3;4504;16;16;2;1;0;4;4;4561;1;4725;3;1;
/org.eclipse.ui.externaltools/Ant Tools Support/org/eclipse/ui/externaltools/internal/ant/preferences/AntPreferencePage.java;2;0;3;1;0;0;0;3;27;1;3;33;34;34;1;0;0;3;3;33;0;282;3;2;
/org.eclipse.jdt.core.tests.model/workspace/Converter/src/junit/runner/TestCollector.java;1;0;1;1;0;0;0;1;0;0;1;3714;0;0;1;0;0;1;1;3714;0;3714;1;1;
/org.eclipse.jdt.ui.tests.refactoring/resources/SurroundWithWorkSpace/SurroundWithTests/trycatch_out/TestExceptionOrder.java;1;0;1;1;0;0;0;1;8;0;1;845;8;8;1;0;0;1;1;845;0;845;1;1;
/org.eclipse.jdt.ui.tests.refactoring/resources/ExtractMethodWorkSpace/ExtractMethodTests/A_test450.java;1;0;1;1;0;0;0;1;0;0;1;130;0;0;1;0;0;1;1;130;0;130;1;1;
/org.eclipse.jface/src/org/eclipse/jface/preference/PreferenceConverter.java;4;2;10;2;3;2;3;7;86;1;7;1;191;191;2;0;1;7;10;6338;1;6338;9;4;
/org.eclipse.core.tests.resources/src/org/eclipse/core/tests/resources/regression/Bug_29851.java;1;0;1;1;1;1;1;0;0;0;0;5512;0;0;1;0;0;0;1;5512;0;5512;1;1;
/org.eclipse.team.ui/src/org/eclipse/team/internal/ui/registry/RegistryReader.java;2;1;5;1;2;2;2;3;148;1;3;2493;178;178;1;0;0;3;5;2493;0;6337;5;2;
/org.eclipse.jdt.ui/ui/org/eclipse/jdt/internal/ui/text/java/hover/JavadocHover.java;1;1;3;1;2;2;2;1;9;0;1;2600;13;13;1;0;0;1;3;2600;0;6340;3;1;
/org.eclipse.help/src/org/eclipse/help/internal/util/RuntimeHelpStatus.java;1;0;1;1;0;0;0;1;0;0;1;2732;0;0;1;0;0;1;1;2732;0;2732;1;1;
/org.eclipse.jdt.core.tests.model/workspace/Formatter/test107/A_out.java;1;0;1;1;0;0;0;1;0;0;1;2425;0;0;1;0;0;1;1;2425;0;2425;1;1;
/org.eclipse.core.tests.resources/src/org/eclipse/core/tests/resources/regression/IResourceTest.java;1;0;2;1;2;1;2;0;1006;0;0;5147;1006;1006;2;0;1;0;2;5147;1;5147;1;1;
/org.eclipse.debug.ui/ui/org/eclipse/debug/internal/ui/launchVariables/AbstractVariableComponent.java;1;0;3;1;0;0;0;3;4;1;3;647;4;4;1;0;0;3;3;647;0;771;3;1;
/org.eclipse.jdt.ui.tests.refactoring/resources/ChangeTypeRefactoring/positive/A_testHashMap_out.java;1;0;1;1;0;0;0;1;0;0;1;2844;0;0;1;0;0;1;1;2844;0;2844;1;1;
/org.eclipse.jface.text/src/org/eclipse/jface/text/source/IAnnotationModelExtension.java;2;0;6;1;1;1;1;5;70;1;5;1118;101;101;1;0;0;5;6;1118;0;5382;6;2;
/org.eclipse.jdt.debug/jdi interfaces/com/sun/jdi/connect/spi/ClosedConnectionException.java;1;0;1;1;0;0;0;1;0;0;1;4267;0;0;1;0;0;1;1;4267;0;4267;1;1;
/org.eclipse.jdt.text.tests/src/org/eclipse/jdt/text/tests/JavaColoringTest.java;1;1;2;1;2;2;2;0;2;0;0;5129;2;2;1;0;0;0;2;5129;0;6340;2;1;
/org.eclipse.team.webdav/src/org/eclipse/team/internal/webdav/subscriber/WebDavRefreshOperation.java;2;0;3;1;0;0;0;3;83;1;3;3496;83;83;1;0;0;3;3;3496;0;4259;3;2;
/org.eclipse.ui.workbench/Eclipse UI/org/eclipse/ui/internal/dialogs/FilteredTree.java;1;1;4;1;2;2;2;2;13;1;2;4968;24;24;1;0;0;2;4;4968;0;5892;4;1;
/org.eclipse.core.resources/src/org/eclipse/core/internal/resources/SafeFileTable.java;1;0;1;1;1;1;1;0;132;0;0;5146;132;132;1;0;0;0;1;5146;0;5146;1;1;
/org.eclipse.pde.runtime/src/org/eclipse/pde/internal/runtime/logview/EventPropertyDialogAction.java;1;0;2;1;0;0;0;2;0;1;2;3621;0;0;1;0;0;2;2;3621;0;3630;2;1;
/org.eclipse.ui.editors/src/org/eclipse/ui/texteditor/DelegatingAnnotationPreference.java;1;0;2;1;1;1;1;1;0;0;1;3217;0;0;1;0;0;1;2;3217;0;5177;2;1;
/org.eclipse.jdt.core.tests.model/workspace/Converter/src/test0031/Test.java;1;0;1;1;0;0;0;1;0;0;1;3714;0;0;1;0;0;1;1;3714;0;3714;1;1;
/org.eclipse.jdt.core.tests.model/workspace/Formatter/test472/A_in.java;1;0;1;1;0;0;0;1;0;0;1;3977;0;0;1;0;0;1;1;3977;0;3977;1;1;
/org.eclipse.pde.core/srcnew/org/eclipse/pde/internal/core/plugin/XEErrorHandler.java;1;0;1;1;0;0;0;1;0;0;1;2906;0;0;1;0;0;1;1;2906;0;2906;1;1;
/org.eclipse.jdt.core/search/org/eclipse/jdt/internal/core/search/matching/MethodPattern.java;3;3;22;3;4;2;4;18;438;3;14;86;1196;1196;3;4;2;18;22;1126;6;5335;16;3;
/org.eclipse.team.cvs.core/src/org/eclipse/team/internal/ccvs/core/ICVSStorage.java;1;0;1;1;0;0;0;1;0;0;1;3131;0;0;1;0;0;1;1;3131;0;3131;1;1;
/org.eclipse.core.tests.runtime/src/org/eclipse/core/tests/internal/plugins/RegressionResolveTest_9.java;1;0;1;1;0;0;0;1;0;0;1;3014;0;0;1;0;0;1;1;3014;0;3014;1;1;
/org.eclipse.core.tools.resources/src/org/eclipse/core/tools/metadata/LocationDumper.java;1;0;1;1;1;1;1;0;0;0;0;6302;0;0;1;0;0;0;1;6302;0;6302;1;1;
/org.eclipse.ui.workbench/Eclipse UI/org/eclipse/ui/commands/internal/CommandEnvelope.java;1;0;2;1;0;0;0;2;0;1;2;786;0;0;1;0;0;2;2;786;0;956;2;1;
/org.eclipse.update.tests.core/src/org/eclipse/update/tests/regularInstall/TestSpaceInInstall.java;1;0;1;1;0;0;0;1;15;0;1;2048;15;15;1;0;0;1;1;2048;0;2048;1;1;
/org.eclipse.jdt.ui.tests.refactoring/resources/ExtractInterface/testConditional1/out/A.java;1;0;1;1;0;0;0;1;0;0;1;3902;0;0;1;0;0;1;1;3902;0;3902;1;1;
/org.eclipse.jdt.ui.tests.refactoring/resources/ExtractMethodWorkSpace/ExtractMethodTests/try_out/A_test451.java;1;0;1;1;0;0;0;1;2;0;1;130;2;2;1;0;0;1;1;130;0;130;1;1;
/org.eclipse.ui.workbench/Eclipse UI/org/eclipse/ui/internal/progress/ProgressUtil.java;1;0;4;1;0;0;0;4;15;1;4;1415;17;17;1;0;0;4;4;1415;0;2842;4;1;
/org.eclipse.team.cvs.core/src/org/eclipse/team/internal/ccvs/core/syncinfo/CVSBaseResourceVariantTree.java;2;1;4;1;2;2;2;2;70;1;2;4238;76;76;1;0;0;2;4;4238;0;6337;4;2;
/org.eclipse.jdt.ui.tests.refactoring/resources/ChangeSignature/canModify/A_testException02_in.java;1;0;1;1;0;0;0;1;0;0;1;4045;0;0;1;0;0;1;1;4045;0;4045;1;1;
/org.eclipse.jdt.ui/core refactoring/org/eclipse/jdt/internal/corext/refactoring/participants/xml/Expressions.java;1;0;4;1;0;0;0;4;155;1;4;2682;209;209;1;0;0;4;4;2682;0;4108;4;1;
/org.eclipse.jdt.debug.ui/ui/org/eclipse/jdt/internal/debug/ui/jres/InstalledJREsBlock.java;4;1;24;2;3;3;3;21;336;7;13;1035;686;686;7;8;0;21;24;1059;8;6336;16;4;
/org.eclipse.team.ui/src/org/eclipse/team/ui/synchronize/viewers/TreeViewerAdvisor.java;1;0;9;1;0;0;0;9;371;3;7;4213;760;760;3;2;0;9;9;4213;2;4632;7;1;
/org.eclipse.ui.workbench/Eclipse UI/org/eclipse/ui/internal/ViewSite.java;3;0;4;1;1;1;1;3;11;1;3;2765;18;18;1;0;0;3;4;2765;0;6338;4;3;
/org.eclipse.jdt.ui.tests.refactoring/resources/MoveInnerToTopLevel/test_nonstatic_26/out/Inner.java;2;0;2;1;1;1;1;1;2;0;1;305;4;4;1;0;0;1;2;305;0;5854;2;2;
/org.eclipse.jface.text/src/org/eclipse/jface/text/IWidgetTokenOwner.java;2;1;2;1;2;2;2;0;32;0;0;6340;34;34;1;0;0;0;2;6340;0;6359;2;2;
/org.eclipse.team.core/src/org/eclipse/team/internal/core/subscribers/caches/SessionResourceVariantTree.java;2;0;3;1;0;0;0;3;149;1;3;4194;149;149;1;0;0;3;3;4194;0;4233;3;2;
/org.eclipse.team.tests.cvs.core/src/org/eclipse/team/tests/ccvs/core/subscriber/SubscriberTestSetup.java;2;0;3;1;0;0;0;3;2;1;3;1221;2;2;1;0;0;3;3;1221;0;1417;3;2;
/org.eclipse.ui.ide/src/org/eclipse/ui/internal/ide/model/WorkbenchStatusList.java;1;0;2;1;0;0;0;2;2;1;2;2264;2;2;1;0;0;2;2;2264;0;2616;2;1;
/org.eclipse.swt.tests/JUnit Tests/org/eclipse/swt/tests/junit/Test_org_eclipse_swt_events_KeyAdapter.java;1;0;1;1;0;0;0;1;16;0;1;2175;16;16;1;0;0;1;1;2175;0;2175;1;1;
/org.eclipse.ant.ui/Ant Editor/org/eclipse/ant/internal/ui/editor/AntCompletionProposal.java;1;0;6;1;0;0;0;6;17;1;6;1811;47;47;1;0;0;6;6;1811;0;4447;6;1;
/org.eclipse.search.tests/src/org/eclipse/search/tests/filesearch/AnnotationManagerSetup.java;1;1;2;1;2;2;2;0;8;0;0;5500;8;8;1;0;0;0;2;5500;0;6035;2;1;
/org.eclipse.swt.tools/JNI Generation/org/eclipse/swt/tools/internal/CleanupClass.java;1;0;1;1;0;0;0;1;0;0;1;4175;0;0;1;0;0;1;1;4175;0;4175;1;1;
/org.eclipse.debug.core/core/org/eclipse/debug/internal/core/sourcelookup/ISourceLookupDirector.java;1;0;8;1;0;0;0;8;34;2;7;4109;72;72;2;1;0;8;8;4627;1;4949;7;1;
/org.eclipse.jdt.core.tests.model/workspace/Converter/src/testJ00/Test.java;1;0;3;1;0;0;0;3;2;1;3;3762;2;2;1;0;0;3;3;3762;0;3792;3;1;
/org.eclipse.ui.views/src/org/eclipse/ui/views/tasklist/SelectAllTasksAction.java;1;0;1;1;0;0;0;1;0;0;1;2738;0;0;1;0;0;1;1;2738;0;2738;1;1;
/org.eclipse.jdt.core/compiler/org/eclipse/jdt/internal/compiler/parser/diagnose/Util.java;3;0;7;1;0;0;0;7;176;1;7;764;304;304;1;0;0;7;7;764;0;3194;7;3;
/org.eclipse.jdt.core.tests.model/workspace/Formatter/test132/A_in.java;1;0;1;1;0;0;0;1;0;0;1;2425;0;0;1;0;0;1;1;2425;0;2425;1;1;
/org.eclipse.help.ide/src/org/eclipse/help/ui/internal/search/SorterByTitle.java;1;1;2;1;2;2;2;0;2;0;0;5216;2;2;1;0;0;0;2;5216;0;5827;2;1;
/org.eclipse.ltk.core.refactoring/src/org/eclipse/ltk/core/refactoring/participants/MoveArguments.java;1;1;4;1;2;2;2;2;3;1;2;4845;7;7;1;0;0;2;4;4845;0;5184;4;1;
/org.eclipse.jdt.ui.tests.refactoring/resources/ExtractMethodWorkSpace/ExtractMethodTests/initializer_out/A_test1003.java;1;0;1;1;0;0;0;1;0;0;1;3310;0;0;1;0;0;1;1;3310;0;3310;1;1;
/org.eclipse.ui.workbench/Eclipse UI/org/eclipse/ui/commands/internal/State.java;1;0;2;1;0;0;0;2;0;1;2;786;0;0;1;0;0;2;2;786;0;956;2;1;
/org.eclipse.jdt.ui/ui/org/eclipse/jdt/internal/ui/reorg/PasteInCompilationUnitEdit.java;1;0;1;1;0;0;0;1;0;0;1;1111;0;0;1;0;0;1;1;1111;0;1111;1;1;
/org.eclipse.ui.externaltools/External Tools Base/org/eclipse/ui/externaltools/internal/variable/ExpandVariableContext.java;1;0;1;1;0;0;0;1;0;0;1;321;0;0;1;0;0;1;1;321;0;321;1;1;
/org.eclipse.debug.core/core/org/eclipse/debug/core/variables/IVariableInitializer.java;1;0;2;1;0;0;0;2;0;1;2;550;0;0;1;0;0;2;2;550;0;616;2;1;
/org.eclipse.ui.workbench/Eclipse UI/org/eclipse/ui/internal/csm/roles/RoleActivationServiceEvent.java;1;0;2;1;0;0;0;2;0;1;2;2213;0;0;1;0;0;2;2;2213;0;2225;2;1;
/org.eclipse.ui.workbench/Eclipse UI/org/eclipse/ui/internal/presentations/ISelfUpdatingAction.java;1;0;1;1;1;1;1;0;0;0;0;5173;0;0;1;0;0;0;1;5173;0;5173;1;1;
/org.eclipse.jdt.text.tests/src/org/eclipse/jdt/ui/tests/comments/CommentTestCase.java;1;1;3;1;2;2;2;1;1;0;1;5082;1;1;1;0;0;1;3;5082;0;5130;3;1;
/org.eclipse.debug.ui/ui/org/eclipse/debug/ui/AbstractDebugView.java;3;0;10;1;1;1;1;9;19;2;8;770;78;78;2;1;0;9;10;2782;1;6336;9;3;
/org.eclipse.ui.ide/src/org/eclipse/ui/internal/registry/MarkerImageProviderRegistry.java;2;0;5;2;0;0;0;5;23;2;4;1526;32;32;2;1;0;5;5;1536;1;2263;4;2;
/org.eclipse.pde.ui/src/org/eclipse/pde/internal/ui/preferences/EditorPreferencePage.java;2;1;3;1;2;2;2;1;6;0;1;909;13;13;1;0;0;1;3;909;0;6336;3;2;
/org.eclipse.core.tests.runtime/src/org/eclipse/core/tests/internal/plugins/ActivationTest_DirectOtherRef.java;1;0;1;1;0;0;0;1;0;0;1;3014;0;0;1;0;0;1;1;3014;0;3014;1;1;
/org.eclipse.update.core/src/org/eclipse/update/core/IImport.java;3;1;4;1;2;2;2;2;6;1;2;0;16;16;1;0;0;2;4;0;0;6336;4;3;
/org.eclipse.ui.workbench/Eclipse UI/org/eclipse/ui/activities/IObjectActivityManager.java;2;0;9;1;0;0;0;9;174;2;7;2280;352;352;2;2;0;9;9;2280;2;3008;7;2;
/org.eclipse.jdt.core/codeassist/org/eclipse/jdt/internal/codeassist/complete/CompletionOnQualifiedInterfaceReference.java;2;0;2;1;0;0;0;2;13;1;2;991;15;15;1;0;0;2;2;991;0;3560;2;2;
/org.eclipse.help.base/src/org/eclipse/help/internal/base/HelpSystem.java;1;0;2;1;0;0;0;2;0;0;1;1747;0;0;2;1;0;2;2;1747;1;1747;1;1;
/org.eclipse.core.tests.runtime/src/org/eclipse/core/tests/internal/plugins/PlatformURLTest.java;1;0;1;1;0;0;0;1;0;0;1;3014;0;0;1;0;0;1;1;3014;0;3014;1;1;
/org.eclipse.jdt.core.tests.model/workspace/Formatter/test171/A_out.java;1;0;1;1;0;0;0;1;0;0;1;2425;0;0;1;0;0;1;1;2425;0;2425;1;1;
/org.eclipse.team.ui/src/org/eclipse/team/ui/synchronize/actions/OpenWithActionGroup.java;1;0;1;1;0;0;0;1;0;0;1;2535;0;0;1;0;0;1;1;2535;0;2535;1;1;
/org.eclipse.team.webdav/src/org/eclipse/team/internal/ui/target/SiteExplorerViewLabelProvider.java;2;0;3;1;1;1;1;2;2;1;2;2495;4;4;1;0;0;2;3;2495;0;6337;3;2;
/org.eclipse.ui.workbench/Eclipse UI/org/eclipse/ui/internal/commands/Path.java;1;0;10;1;0;0;0;10;75;1;10;607;125;125;1;0;0;10;10;607;0;1634;10;1;
/org.eclipse.jdt.ui.tests.refactoring/resources/ChangeTypeRefactoring/positive/A_testParameterTypeWithOverriding2.java;1;0;1;1;0;0;0;1;0;0;1;2844;0;0;1;0;0;1;1;2844;0;2844;1;1;
/org.eclipse.jdt.core.tests.model/workspace/JavaSearch/src/j7/qua/li/fied/Bug54962.java;1;1;2;1;2;2;2;0;0;0;0;5713;0;0;1;0;0;0;2;5713;0;5912;2;1;
/org.eclipse.jdt.ui.tests.refactoring/resources/PushDown/testEnablement0/in/A.java;1;0;1;1;0;0;0;1;0;0;1;1312;0;0;1;0;0;1;1;1312;0;1312;1;1;
/org.eclipse.jdt.ui.tests.refactoring/resources/InlineMethodWorkspace/TestCases/receiver_in/TestFieldReceiver.java;1;0;1;1;1;1;1;0;0;0;0;5747;0;0;1;0;0;0;1;5747;0;5747;1;1;
/org.eclipse.jdt.core/compiler/org/eclipse/jdt/internal/compiler/ast/AnnotationMessageSend.java;1;0;4;1;0;0;0;4;11;1;4;2397;14;14;1;0;0;4;4;2397;0;2887;4;1;
/org.eclipse.jdt.core.tests.builder/src/org/eclipse/jdt/core/tests/builder/FilteredTestSuite.java;1;0;1;1;0;0;0;1;0;0;1;989;0;0;1;0;0;1;1;989;0;989;1;1;
/org.eclipse.search/new search/org/eclipse/search2/internal/ui/SearchesDialog.java;2;1;2;1;2;2;2;0;2;0;0;5681;2;2;1;0;0;0;2;5681;0;6340;2;2;
/org.eclipse.ui.forms/src/org/eclipse/ui/forms/DetailsPart.java;1;2;11;1;4;3;4;7;121;2;6;4068;248;248;2;1;1;7;11;4284;2;6336;9;1;
/org.eclipse.ui.views/src/org/eclipse/ui/views/markers/internal/MarkerType.java;2;0;2;1;0;0;0;2;0;1;2;755;0;0;1;0;0;2;2;755;0;2738;2;2;
/org.eclipse.jdt.ui/ui/org/eclipse/jdt/internal/ui/javaeditor/PreferencesAdapter.java;1;1;2;1;2;2;2;0;0;0;0;5177;0;0;1;0;0;0;2;5177;0;5272;2;1;
/org.eclipse.ui.workbench/Eclipse UI/org/eclipse/ui/internal/commands/KeyBinding.java;1;0;10;1;0;0;0;10;157;2;9;1322;348;348;2;1;0;10;10;1631;1;2562;9;1;
/org.eclipse.pde.ui/src/org/eclipse/pde/internal/ui/wizards/tools/PluginToBundleWizardPage.java;1;0;2;1;0;0;0;2;0;1;2;3840;0;0;1;0;0;2;2;3840;0;4139;2;1;
/org.eclipse.team.webdav/src/org/eclipse/team/internal/ui/target/ConfigureTargetWizard.java;2;1;6;1;3;3;3;3;21;1;3;2495;38;38;1;0;0;3;6;2495;0;6337;6;2;
/org.eclipse.jdt.ui/core extension/org/eclipse/jdt/internal/corext/textmanipulation/CopySourceEdit.java;1;0;8;1;0;0;0;8;79;2;6;1012;221;221;2;2;0;8;8;1869;2;1946;6;1;
/org.eclipse.ui.workbench/Eclipse UI/org/eclipse/ui/internal/contexts/ContextRegistry.java;1;0;3;1;0;0;0;3;4;0;1;1388;4;4;3;2;0;3;3;1388;2;1388;1;1;
/org.eclipse.ui.workbench/Eclipse UI/org/eclipse/ui/internal/commands/older/KeysPreferencePage.java;1;0;1;1;0;0;0;1;26;0;1;2562;26;26;1;0;0;1;1;2562;0;2562;1;1;
/org.eclipse.pde.core/src_OSGi/org/eclipse/pde/internal/core/osgi/bundle/BundleFragment.java;2;0;2;1;0;0;0;2;0;1;2;2485;0;0;1;0;0;2;2;2485;0;4203;2;2;
/org.eclipse.jdt.core/model/org/eclipse/jdt/core/WorkingCopyOwner.java;2;0;10;2;1;1;1;9;28;3;7;825;76;76;3;2;0;9;10;1048;2;5359;8;2;
/org.eclipse.team.core/src/org/eclipse/team/internal/core/target/ISiteListener.java;1;0;1;1;0;0;0;1;0;0;1;2495;0;0;1;0;0;1;1;2495;0;2495;1;1;
/org.eclipse.core.tests.runtime/src/org/eclipse/core/tests/internal/plugin/c/api/ApiClass.java;1;0;1;1;1;1;1;0;11;0;0;5149;11;11;1;0;0;0;1;5149;0;5149;1;1;
/org.eclipse.swt/Eclipse SWT Program/gnome/org/eclipse/swt/internal/gnome/GNOME.java;2;0;4;1;1;1;1;3;23;1;3;4333;27;27;1;0;0;3;4;4333;0;6352;4;2;
/org.eclipse.team.ftp/src/org/eclipse/team/internal/ftp/ui/subscriber/FTPGetAction.java;2;2;7;1;3;2;3;4;37;1;4;3373;69;69;2;0;1;4;7;5508;1;6337;6;2;
/org.eclipse.pde.ui/src/org/eclipse/pde/internal/ui/preferences/MainPreferencePage.java;2;1;6;1;2;2;2;4;49;2;3;368;68;68;2;1;0;4;6;648;1;6336;5;2;
/org.eclipse.team.core/src/org/eclipse/team/internal/core/target/ISiteFactory.java;1;0;1;1;0;0;0;1;0;0;1;2495;0;0;1;0;0;1;1;2495;0;2495;1;1;
/org.eclipse.jdt.ui.tests.refactoring/resources/Copy/test_method_yes_field/out/A.java;1;0;1;1;0;0;0;1;2;0;1;685;2;2;1;0;0;1;1;685;0;685;1;1;
/org.eclipse.team.cvs.ui/src/org/eclipse/team/internal/ccvs/ui/subscriber/ChangeLogDiffNodeBuilder.java;1;0;1;1;0;0;0;1;0;0;1;3838;0;0;1;0;0;1;1;3838;0;3838;1;1;
/org.eclipse.jdt.core.tests.model/workspace/Formatter/test290/A_out.java;1;0;1;1;0;0;0;1;0;0;1;2444;0;0;1;0;0;1;1;2444;0;2444;1;1;
/org.eclipse.jdt.ui.tests.refactoring/resources/InlineMethodWorkspace/TestCases/simple_out/TestBasic1.java;1;0;1;1;0;0;0;1;2;0;1;845;2;2;1;0;0;1;1;845;0;845;1;1;
/org.eclipse.ui.workbench/Eclipse UI/org/eclipse/ui/contexts/activationservice/IContextActivationServiceListener.java;1;0;2;1;0;0;0;2;0;1;2;3066;0;0;1;0;0;2;2;3066;0;3109;2;1;
/org.eclipse.jdt.ui/ui/org/eclipse/jdt/ui/actions/ReadReferencesSearchGroup.java;3;1;5;1;2;2;2;3;11;1;3;1350;24;24;1;0;0;3;5;1350;0;6340;5;3;
/org.eclipse.jdt.core/dom/org/eclipse/jdt/core/dom/AssertStatement.java;3;1;8;1;2;2;2;6;95;1;6;3560;132;132;1;0;0;6;8;3560;0;5272;8;3;
/org.eclipse.ui.ide/src/org/eclipse/ui/internal/ide/actions/ToggleAutoBuildAction.java;1;0;1;1;1;1;1;0;0;0;0;5183;0;0;1;0;0;0;1;5183;0;5183;1;1;
/org.eclipse.jdt.ui/ui/org/eclipse/jdt/internal/ui/infoviews/JavadocView.java;3;2;19;2;11;9;11;8;240;2;7;724;695;695;2;1;2;8;19;5078;3;6340;16;3;
/org.eclipse.jdt.ui.tests/chkpii/org/eclipse/jdt/ui/tests/chkpii/ChkpiiTests.java;3;1;8;1;2;2;2;6;28;2;5;85;70;70;2;1;0;6;8;85;1;6340;7;3;
/org.eclipse.jdt.ui/ui/org/eclipse/jdt/internal/ui/text/correction/TypeChangeCompletionProposal.java;3;2;6;1;6;5;6;0;27;0;0;5226;38;38;2;0;1;0;6;5226;1;6340;5;3;
/org.eclipse.jdt.ui.tests.refactoring/test cases/org/eclipse/jdt/ui/tests/refactoring/TestUtil.java;1;0;1;1;0;0;0;1;0;0;1;1008;0;0;1;0;0;1;1;1008;0;1008;1;1;
/org.eclipse.jdt.debug/eval/org/eclipse/jdt/internal/debug/eval/ast/instructions/PushLocalVariable.java;1;0;1;1;0;0;0;1;3;0;1;1240;3;3;1;0;0;1;1;1240;0;1240;1;1;
/org.eclipse.jdt.core/compiler/org/eclipse/jdt/internal/compiler/lookup/CompilerModifiers.java;2;0;2;1;0;0;0;2;2;1;2;3009;3;3;1;0;0;2;2;3009;0;3560;2;2;
/org.eclipse.ui.ide/src/org/eclipse/ui/dialogs/WizardResourceImportPage.java;2;0;4;1;0;0;0;4;36;1;4;1511;38;38;1;0;0;4;4;1511;0;2263;4;2;
/org.eclipse.update.ui.forms/src/org/eclipse/ui/forms/internal/parts/TextSegment.java;1;0;2;1;0;0;0;2;0;1;2;2898;0;0;1;0;0;2;2;2898;0;3096;2;1;
/org.eclipse.team.ui/src/org/eclipse/team/internal/ui/sync/actions/SyncViewerShowPreferencesAction.java;1;0;5;1;0;0;0;5;36;2;4;984;51;51;2;1;0;5;5;984;1;2632;4;1;
/org.eclipse.core.runtime.osgi/src/org/eclipse/core/runtime/jobs/MultiRule.java;1;0;1;1;0;0;0;1;0;0;1;3013;0;0;1;0;0;1;1;3013;0;3013;1;1;
/org.eclipse.ui.ide/extensions/org/eclipse/ui/part/MarkerTransfer.java;1;0;1;1;0;0;0;1;0;0;1;2263;0;0;1;0;0;1;1;2263;0;2263;1;1;
/org.eclipse.help.base/src/org/eclipse/help/internal/search/PluginVersionInfo.java;1;1;7;1;3;3;3;4;88;1;4;1747;186;186;1;0;0;4;7;1747;0;6337;7;1;
/org.eclipse.jdt.core.tests.model/workspace/Formatter/test428/A_out.java;1;0;1;1;0;0;0;1;0;0;1;3478;0;0;1;0;0;1;1;3478;0;3478;1;1;
/org.eclipse.jdt.ui.tests.refactoring/resources/MultiMove/test1/in/p3/B.java;1;0;1;1;0;0;0;1;0;0;1;1111;0;0;1;0;0;1;1;1111;0;1111;1;1;
/org.eclipse.pde.ui/sandbox/org/eclipse/pde/internal/ui/editor/standalone/text/XMLConfiguration2.java;1;0;2;1;0;0;0;2;0;1;2;2320;0;0;1;0;0;2;2;2320;0;2906;2;1;
/org.eclipse.update.ui/src/org/eclipse/update/internal/ui/forms/InstallableSiteForm.java;1;0;1;1;0;0;0;1;0;0;1;755;0;0;1;0;0;1;1;755;0;755;1;1;
/org.eclipse.jdt.core.tests.model/workspace/Formatter/test215/A_out.java;1;0;1;1;0;0;0;1;0;0;1;2426;0;0;1;0;0;1;1;2426;0;2426;1;1;
/org.eclipse.jdt.debug/model/org/eclipse/jdt/internal/debug/core/logicalstructures/CollectionStructureType.java;1;0;2;1;0;0;0;2;4;1;2;2647;4;4;1;0;0;2;2;2647;0;2709;2;1;
/org.eclipse.help.base/src/org/eclipse/help/internal/DefaultHelpSupport.java;1;0;3;1;0;0;0;3;1;0;1;1740;1;1;3;2;0;3;3;1740;2;1740;1;1;
/org.eclipse.jdt.ui/ui/org/eclipse/jdt/internal/ui/wizards/NewSourceFolderWizardPage.java;2;1;5;1;2;2;2;3;40;1;3;1212;53;53;1;0;0;3;5;1212;0;6340;5;2;
/org.eclipse.ui.editors/src/org/eclipse/ui/texteditor/DefaultAnnotationAccess.java;1;0;1;1;0;0;0;1;0;0;1;2874;0;0;1;0;0;1;1;2874;0;2874;1;1;
/org.eclipse.ui.workbench/Eclipse UI/org/eclipse/ui/internal/commands/registry/old/ContextBinding.java;1;0;3;1;0;0;0;3;2;2;2;1222;2;2;2;1;0;3;3;1321;1;1321;2;1;
/org.eclipse.ui.ide/src/org/eclipse/ui/wizards/datatransfer/WizardFileSystemResourceExportPage1.java;3;1;4;1;2;2;2;2;8;1;2;1511;12;12;1;0;0;2;4;1511;0;6338;4;3;
/org.eclipse.core.runtime.osgi/src/org/eclipse/core/runtime/SubProgressMonitor.java;1;0;2;1;0;0;0;2;212;1;2;3013;212;212;1;0;0;2;2;3013;0;3030;2;1;
/org.eclipse.ui.views/src/org/eclipse/ui/views/internal/markers/MarkerLabelProvider.java;1;0;3;1;0;0;0;3;10;2;2;265;10;10;2;1;0;3;3;749;1;749;2;1;
/org.eclipse.jdt.core/compiler/org/eclipse/jdt/internal/compiler/env/IBinaryMethod.java;1;0;1;1;0;0;0;1;2;0;1;3560;2;2;1;0;0;1;1;3560;0;3560;1;1;
/org.eclipse.team.ui/src/org/eclipse/team/ui/synchronize/subscribers/IRefreshEvent.java;1;0;3;1;1;1;1;2;12;1;2;4632;12;12;1;0;0;2;3;4632;0;5362;3;1;
/org.eclipse.jdt.ui/ui/org/eclipse/jdt/ui/text/spelling/engine/ISpellEvent.java;1;0;2;1;0;0;0;2;0;1;2;3829;0;0;1;0;0;2;2;3829;0;3930;2;1;
/org.eclipse.ui.examples.rcp.browser/src/org/eclipse/ui/examples/rcp/browser/BrowserPerspectiveFactory.java;1;1;5;1;4;4;4;1;12;0;1;3532;17;17;1;0;0;1;5;3532;0;6341;5;1;
/org.eclipse.pde.ui/src/org/eclipse/pde/internal/ui/editor/feature/EditorBuildFeatureAction.java;3;1;7;1;5;5;5;2;81;1;2;4203;150;150;1;0;0;2;7;4203;0;6336;7;3;
/org.eclipse.jdt.core.tests.model/workspace/Converter/src/test0274/Test.java;1;0;1;1;0;0;0;1;0;0;1;3714;0;0;1;0;0;1;1;3714;0;3714;1;1;
/org.eclipse.jdt.core.tests.model/workspace/Formatter/test378/A_in.java;1;0;2;1;0;0;0;2;1;1;2;3146;1;1;1;0;0;2;2;3146;0;3172;2;1;
/org.eclipse.ui.ide/src/org/eclipse/ui/internal/ide/actions/OpenWorkspaceFileAction.java;1;0;1;1;0;0;0;1;0;0;1;2264;0;0;1;0;0;1;1;2264;0;2264;1;1;
/org.eclipse.jdt.ui.tests.refactoring/resources/MoveMembers/test27/out/A.java;1;0;1;1;0;0;0;1;0;0;1;1522;0;0;1;0;0;1;1;1522;0;1522;1;1;
/org.eclipse.jdt.ui.examples.javafamily/src/org/eclipse/jsp/launching/TomcatSourcePathComputer.java;1;0;2;1;1;1;1;1;0;0;1;5091;0;0;1;0;0;1;2;5091;0;5920;2;1;
/org.eclipse.jdt.core.tests.model/src/org/eclipse/jdt/core/tests/rewrite/modifying/ASTRewritingModifyingInsertTest.java;2;0;2;1;1;1;1;1;7;0;1;4711;7;7;1;0;0;1;2;4711;0;5853;2;2;
/org.eclipse.jdt.core/compiler/org/eclipse/jdt/internal/compiler/ast/LabeledStatement.java;3;0;7;2;2;1;2;5;18;2;4;937;52;52;2;1;1;5;7;989;2;5339;5;3;
/org.eclipse.ant.ui/Ant Tools Support/org/eclipse/ant/internal/ui/preferences/MinimizedFileSystemElement.java;1;1;3;1;2;2;2;1;4;0;1;1811;7;7;1;0;0;1;3;1811;0;6336;3;1;
/org.eclipse.ltk.core.refactoring.tests/src/org/eclipse/ltk/core/refactoring/tests/participants/FailingParticipant2.java;1;0;1;1;1;1;1;0;0;0;0;6072;0;0;1;0;0;0;1;6072;0;6072;1;1;
/org.eclipse.ant.ui/Ant Tools Support/org/eclipse/ant/ui/internal/preferences/MessageLine.java;1;0;2;1;0;0;0;2;0;1;2;267;0;0;1;0;0;2;2;267;0;1811;2;1;
/org.eclipse.core.tools.resources/src/org/eclipse/core/tools/metadata/WorkspaceContentProvider.java;1;0;1;1;1;1;1;0;0;0;0;6302;0;0;1;0;0;0;1;6302;0;6302;1;1;
/org.eclipse.jdt.core.tests.model/workspace/Converter/src/test0218/Test.java;1;0;1;1;0;0;0;1;0;0;1;3714;0;0;1;0;0;1;1;3714;0;3714;1;1;
/org.eclipse.update.ui.forms/Eclipse Forms/org/eclipse/ui/forms/SectionPart.java;1;0;7;1;0;0;0;7;70;3;5;3174;134;134;3;2;0;7;7;3174;2;4157;5;1;
/org.eclipse.swt/Eclipse SWT/common/org/eclipse/swt/internal/Callback.java;3;0;4;1;1;1;1;3;41;1;3;4017;53;53;1;0;0;3;4;4017;0;6352;4;3;
/org.eclipse.jdt.ui.tests.refactoring/resources/ConvertAnonymousToNested/canConvert/A_test22_out.java;1;0;1;1;0;0;0;1;0;0;1;3195;0;0;1;0;0;1;1;3195;0;3195;1;1;
/org.eclipse.ui.workbench/Eclipse UI/org/eclipse/ui/commands/ModifierKey.java;1;0;3;1;0;0;0;3;9;2;2;1321;9;9;2;1;0;3;3;1339;1;1339;2;1;
/org.eclipse.jdt.core.tests.model/workspace/Converter/src/test0156/Test.java;1;0;1;1;0;0;0;1;0;0;1;3714;0;0;1;0;0;1;1;3714;0;3714;1;1;
/org.eclipse.jdt.ui.tests.refactoring/test cases/org/eclipse/jdt/ui/tests/refactoring/RenamePrivateMethodTests.java;4;1;11;1;3;3;3;8;24;1;8;130;102;102;1;0;0;8;11;130;0;6340;11;4;
/org.eclipse.pde.build/src/org/eclipse/pde/internal/build/ant/JavacTask.java;2;1;9;1;2;2;2;7;244;1;7;447;1286;1286;1;0;0;7;9;447;0;5754;9;2;
/org.eclipse.pde.ui/src/org/eclipse/pde/internal/ui/search/PluginSearchResultCollector.java;3;1;5;1;2;2;2;3;12;1;3;648;22;22;1;0;0;3;5;648;0;6336;5;3;
/org.eclipse.ui.workbench/Eclipse UI/org/eclipse/ui/activities/IObjectContributionRecord.java;2;0;3;1;0;0;0;3;5;1;3;2280;5;5;1;0;0;3;3;2280;0;3008;3;2;
/org.eclipse.jdt.core/codeassist/org/eclipse/jdt/internal/codeassist/complete/CompletionOnInterfaceReference.java;2;0;2;1;0;0;0;2;4;1;2;991;6;6;1;0;0;2;2;991;0;3560;2;2;
/org.eclipse.update.ui.forms/src/org/eclipse/ui/forms/internal/parts/ImageSegment.java;1;0;3;1;0;0;0;3;2;1;3;2898;2;2;1;0;0;3;3;2898;0;3096;3;1;
/org.eclipse.jdt.core/model/org/eclipse/jdt/core/ICodeAssist.java;2;0;9;1;1;1;1;8;86;1;8;969;185;185;1;0;0;8;9;969;0;5268;9;2;
/org.eclipse.jdt.ui/ui/org/eclipse/jdt/internal/ui/jarpackager/SealPackagesFilter.java;1;0;1;1;1;1;1;0;2;0;0;6340;2;2;1;0;0;0;1;6340;0;6340;1;1;
/org.eclipse.jdt.ui.tests.refactoring/resources/ExtractTemp/cannotExtract/A_testFail37.java;1;0;1;1;1;1;1;0;0;0;0;5916;0;0;1;0;0;0;1;5916;0;5916;1;1;
/org.eclipse.team.ui/src/org/eclipse/team/internal/ui/synchronize/SynchronizeOverviewPage.java;1;0;1;1;0;0;0;1;0;0;1;3170;0;0;1;0;0;1;1;3170;0;3170;1;1;
/org.eclipse.jdt.core/compiler/org/eclipse/jdt/internal/compiler/ast/Assignment.java;2;0;6;1;0;0;0;6;45;1;6;76;75;75;1;0;0;6;6;76;0;3560;6;2;
/org.eclipse.pde.ui/src/org/eclipse/pde/internal/ui/editor/plugin/ExtensionsPage.java;2;1;4;1;4;4;4;0;12;0;0;5431;24;24;1;0;0;0;4;5431;0;6366;4;2;
/org.eclipse.update.ui/src/org/eclipse/update/internal/ui/wizards/DeltaAdapter.java;2;0;10;2;1;1;1;9;6;3;6;755;22;22;3;3;0;9;10;755;3;5519;7;2;
/org.eclipse.ui.ide/src/org/eclipse/ui/internal/ide/ResourcePerspective.java;3;1;3;1;2;2;2;1;2;0;1;2264;4;4;1;0;0;1;3;2264;0;6338;3;3;
/org.eclipse.swt/Eclipse SWT PI/motif/org/eclipse/swt/internal/motif/XmDropFinishCallbackStruct.java;1;0;2;1;0;0;0;2;4;1;2;829;6;6;1;0;0;2;2;829;0;868;2;1;
/org.eclipse.jface/src/org/eclipse/jface/action/StatusLineManager.java;4;1;11;2;3;3;3;8;215;4;5;2119;377;377;4;3;0;8;11;4503;3;6338;8;4;
/org.eclipse.swt.tools/JNI Generation/org/eclipse/swt/tools/internal/ConstantsGenerator.java;2;0;2;1;0;0;0;2;8;1;2;4175;8;8;1;0;0;2;2;4175;0;4270;2;2;
/org.eclipse.jdt.ui.tests.refactoring/resources/DeleteSourceReferenceEdit/A_testField1_out.java;1;0;1;1;0;0;0;1;0;0;1;1652;0;0;1;0;0;1;1;1652;0;1652;1;1;
/org.eclipse.team.core/src/org/eclipse/team/core/subscribers/ITeamOperations.java;1;0;1;1;0;0;0;1;0;0;1;3171;0;0;1;0;0;1;1;3171;0;3171;1;1;
/org.eclipse.jdt.core.tests.model/workspace/Formatter/test098/A_out.java;1;0;1;1;0;0;0;1;0;0;1;2425;0;0;1;0;0;1;1;2425;0;2425;1;1;
/org.eclipse.jdt.ui.tests.refactoring/resources/Copy/test_import_container_yes_type_in_different_cu/out/C.java;1;0;1;1;0;0;0;1;0;0;1;685;0;0;1;0;0;1;1;685;0;685;1;1;
/org.eclipse.jdt.ui/core refactoring/org/eclipse/jdt/internal/corext/refactoring/rename/UpdateTypeReferenceEdit.java;1;0;1;1;0;0;0;1;0;0;1;1576;0;0;1;0;0;1;1;1576;0;1576;1;1;
/org.eclipse.ui.workbench/Eclipse UI/org/eclipse/ui/internal/contexts/ws/IContextService.java;2;0;2;1;1;1;1;1;6;0;1;4953;6;6;1;0;0;1;2;4953;0;6338;2;2;
/org.eclipse.core.resources/src/org/eclipse/core/internal/resources/FileState.java;2;1;9;1;8;8;8;1;138;0;1;3960;252;252;1;0;0;1;9;3960;0;6127;9;2;
/org.eclipse.jface/src/org/eclipse/jface/viewers/DialogCellEditor.java;2;1;2;1;2;2;2;0;6;0;0;5530;8;8;1;0;0;0;2;5530;0;6338;2;2;
/org.eclipse.ui.workbench/Eclipse UI/org/eclipse/ui/internal/csm/roles/IRoleDefinition.java;1;0;3;1;0;0;0;3;40;1;3;2225;40;40;1;0;0;3;3;2225;0;2444;3;1;
/org.eclipse.jdt.ui.tests.refactoring/resources/Copy/test_method_yes_cu_with_main_type/out/C.java;1;0;1;1;0;0;0;1;0;0;1;685;0;0;1;0;0;1;1;685;0;685;1;1;
/org.eclipse.debug.core/core/org/eclipse/debug/internal/core/sourcelookup/containers/WorkspaceSourceContainer.java;2;0;6;2;0;0;0;6;20;3;4;3678;45;45;3;2;0;6;6;3678;2;4949;4;2;
/org.eclipse.ui.ide/src/org/eclipse/ui/views/markers/ProblemView.java;4;0;6;1;0;0;0;6;130;2;5;2208;204;204;2;1;0;6;6;3260;1;3939;5;4;
/org.eclipse.core.tests.resources/src/org/eclipse/core/tests/internal/indexing/TestEnvironment.java;1;0;1;1;1;1;1;0;8;0;0;5147;8;8;1;0;0;0;1;5147;0;5147;1;1;
/org.eclipse.ui.tests/Eclipse UI Tests/org/eclipse/ui/tests/api/IWorkbenchWindowTest.java;3;0;3;1;1;1;1;2;4;1;2;3091;11;11;1;0;0;2;3;3091;0;6338;3;3;
/org.eclipse.jdt.core/codeassist/org/eclipse/jdt/internal/codeassist/complete/CompletionOnKeyword3.java;2;0;3;1;0;0;0;3;7;1;3;134;12;12;1;0;0;3;3;134;0;3560;3;2;
/org.eclipse.jface/src/org/eclipse/jface/viewers/ComboBoxCellEditor.java;1;0;1;1;0;0;0;1;10;0;1;1713;10;10;1;0;0;1;1;1713;0;1713;1;1;
/org.eclipse.jdt.core.tests.model/workspace/Formatter/test403/A_in.java;1;0;1;1;0;0;0;1;0;0;1;3438;0;0;1;0;0;1;1;3438;0;3438;1;1;
/org.eclipse.ui.ide/src/org/eclipse/ui/internal/dialogs/CreateProjectWizard.java;2;0;3;1;0;0;0;3;12;1;3;1526;12;12;1;0;0;3;3;1526;0;2263;3;2;
/org.eclipse.jdt.ui/ui refactoring/org/eclipse/jdt/internal/ui/refactoring/ChangeSignatureWizard.java;5;1;20;1;5;5;5;15;186;1;15;518;559;559;1;0;0;15;20;518;0;6340;20;5;
/org.eclipse.help/src/org/eclipse/help/internal/standalone/StandaloneInfocenter.java;1;0;1;1;0;0;0;1;0;0;1;2732;0;0;1;0;0;1;1;2732;0;2732;1;1;
/org.eclipse.pde/src/org/eclipse/pde/internal/builders/DependencyLoopFinder.java;2;1;4;1;2;2;2;2;89;1;2;1944;105;105;1;0;0;2;4;1944;0;6336;4;2;
/org.eclipse.core.tests.runtime/src/org/eclipse/core/tests/internal/runtimetests/SampleIPB.java;1;0;1;1;1;1;1;0;21;0;0;5149;21;21;1;0;0;0;1;5149;0;5149;1;1;
/org.eclipse.ui.workbench/Eclipse UI/org/eclipse/ui/internal/activities/ActivityManager.java;2;0;10;1;0;0;0;10;150;2;8;2444;332;332;2;2;0;10;10;2490;2;2800;8;2;
/org.eclipse.jdt.ui/ui/org/eclipse/jdt/internal/ui/search/JavaSearchJob.java;1;0;1;1;0;0;0;1;0;0;1;3488;0;0;1;0;0;1;1;3488;0;3488;1;1;
/org.eclipse.jdt.ui.tests.refactoring/resources/ExtractMethodWorkSpace/ExtractMethodTests/try_in/A_test458.java;1;0;1;1;0;0;0;1;2;0;1;844;2;2;1;0;0;1;1;844;0;844;1;1;
/org.eclipse.jdt.debug.ui/ui/org/eclipse/jdt/internal/debug/ui/console/JavaConsoleTracker.java;2;0;5;1;0;0;0;5;28;1;5;2119;60;60;1;0;0;5;5;2119;0;2497;5;2;
/org.eclipse.jdt.ui.tests.refactoring/resources/IntroduceFactory/positive/DontMoveArgs1_in.java;1;0;2;1;1;1;1;1;2;0;1;2846;2;2;1;0;0;1;2;2846;0;5659;2;1;
/org.eclipse.jface/src/org/eclipse/jface/dialogs/IconAndMessageDialog.java;3;1;8;2;2;2;2;6;113;2;5;1;238;238;2;1;0;6;8;3743;1;5615;7;3;
/org.eclipse.swt.examples/src/org/eclipse/swt/examples/addressbook/Control.java;1;0;1;1;0;0;0;1;0;0;1;106;0;0;1;0;0;1;1;106;0;106;1;1;
/org.eclipse.jdt.ui/core extension/org/eclipse/jdt/internal/corext/dom/NewASTRewrite.java;3;0;22;1;0;0;0;22;566;2;19;2505;2210;2210;2;3;0;22;22;2796;3;4794;19;3;
/org.eclipse.pde.build/src/org/eclipse/pde/internal/build/builder/ClasspathComputer2_1.java;2;1;9;1;7;7;7;2;362;1;2;4175;473;473;1;0;0;2;9;4175;0;5872;9;2;
/org.eclipse.core.tests.runtime/src/org/eclipse/core/tests/internal/plugins/ConflictResolveTest_6.java;1;0;1;1;0;0;0;1;0;0;1;3014;0;0;1;0;0;1;1;3014;0;3014;1;1;
/org.eclipse.swt/Eclipse SWT/carbon/org/eclipse/swt/widgets/TableItem.java;4;1;20;1;6;6;6;14;478;2;12;231;949;949;2;2;0;14;20;231;2;6352;18;4;
/org.eclipse.pde.build/src/org/eclipse/pde/internal/build/FeatureBuildScriptGenerator.java;2;0;5;1;0;0;0;5;0;1;5;447;0;0;1;0;0;5;5;447;0;1113;5;2;
/org.eclipse.ui.workbench/Eclipse UI/org/eclipse/ui/internal/WorkbenchPlugin.java;9;3;64;3;17;15;17;47;122;3;43;941;1089;1089;3;4;2;47;64;4304;6;6338;58;9;
/org.eclipse.team.cvs.core/src/org/eclipse/team/internal/ccvs/core/CVSWorkspaceSubscriber.java;2;1;26;1;5;5;5;21;220;2;18;431;972;972;2;3;0;21;26;1954;3;6337;23;2;
/org.eclipse.jface.text/src/org/eclipse/jface/text/IPostSelectionProvider.java;1;0;2;1;0;0;0;2;0;1;2;1050;0;0;1;0;0;2;2;1050;0;1239;2;1;
/org.eclipse.jdt.ui/core refactoring/org/eclipse/jdt/internal/corext/refactoring/code/InlineMethodRefactoring.java;4;1;31;2;5;5;5;26;48;2;23;218;286;286;2;3;0;26;31;1386;3;6340;28;4;
/org.eclipse.pde.ui/src_Forms/org/eclipse/pde/internal/ui/neweditor/feature/HandlerSection.java;2;1;4;1;2;2;2;2;110;0;1;4926;122;122;2;1;0;2;4;4926;1;5431;3;2;
/org.eclipse.team.core/src/org/eclipse/team/internal/core/subscribers/ContentComparator.java;2;1;5;1;2;2;2;3;140;1;3;3772;146;146;1;0;0;3;5;3772;0;6336;5;2;
/org.eclipse.ui.workbench/Eclipse UI/org/eclipse/ui/SubActionBars2.java;4;1;4;1;2;2;2;2;4;1;2;3220;8;8;1;0;0;2;4;3220;0;6338;4;4;
/org.eclipse.core.resources/src/org/eclipse/core/resources/ISynchronizer.java;1;0;2;1;1;1;1;1;216;0;1;4994;220;220;1;0;0;1;2;4994;0;5146;2;1;
/org.eclipse.ui.forms/src/org/eclipse/ui/forms/MasterDetailsBlock.java;1;0;6;1;1;1;1;5;76;1;5;4068;117;117;1;0;0;5;6;4068;0;5736;6;1;
/org.eclipse.ui.examples.propertysheet/Eclipse UI Examples PropertySheet/org/eclipse/ui/examples/propertysheet/UserElement.java;1;0;1;1;0;0;0;1;12;0;1;4071;12;12;1;0;0;1;1;4071;0;4071;1;1;
/org.eclipse.update.tests.core/src/org/eclipse/update/tests/model/SiteMain.java;2;0;2;1;1;1;1;1;5;0;1;4173;9;9;1;0;0;1;2;4173;0;6336;2;2;
/org.eclipse.jdt.core.tests.model/workspace/Formatter/test017/A_in.java;1;0;1;1;0;0;0;1;0;0;1;2425;0;0;1;0;0;1;1;2425;0;2425;1;1;
/org.eclipse.pde.ui/src_Forms/org/eclipse/pde/internal/ui/neweditor/build/BuildPage.java;2;2;8;1;5;4;5;3;40;1;3;4406;53;53;2;0;1;3;8;5418;1;5431;7;2;
/org.eclipse.jdt.debug/model/org/eclipse/jdt/internal/debug/core/model/JDIInterfaceType.java;3;0;4;1;0;0;0;4;74;1;4;670;117;117;1;0;0;4;4;670;0;2269;4;3;
/org.eclipse.pde.ui/src_Forms/org/eclipse/pde/internal/ui/newparts/TreePart.java;2;0;2;1;1;1;1;1;0;0;1;3795;0;0;1;0;0;1;2;3795;0;5431;2;2;
/org.eclipse.debug.core/core/org/eclipse/debug/internal/core/stringsubstitution/StringSubstitutionMessages.java;2;0;2;1;0;0;0;2;0;1;2;2120;0;0;1;0;0;2;2;2120;0;2514;2;2;
/org.eclipse.ant.core/src/org/eclipse/ant/core/AntCorePlugin.java;1;2;12;1;6;4;6;6;30;2;5;245;101;101;2;1;2;6;12;1402;3;6222;9;1;
/org.eclipse.team.cvs.ui/src/org/eclipse/team/internal/ccvs/ui/model/RemoteFolderElement.java;2;1;7;1;2;2;2;5;101;1;5;66;162;162;1;0;0;5;7;66;0;6337;7;2;
/org.eclipse.ui.workbench/Eclipse UI/org/eclipse/ui/IProjectActionFilter.java;1;0;1;1;0;0;0;1;0;0;1;2737;0;0;1;0;0;1;1;2737;0;2737;1;1;
/org.eclipse.jdt.core.tests.model/workspace/TypeHierarchy/src/p48459/p1/X48459.java;1;0;1;1;0;0;0;1;0;0;1;3490;0;0;1;0;0;1;1;3490;0;3490;1;1;
/org.eclipse.ui.workbench/Eclipse UI/org/eclipse/ui/internal/csm/roles/api/RoleRegistryFactory.java;1;0;2;1;0;0;0;2;0;1;2;2213;0;0;1;0;0;2;2;2213;0;2225;2;1;
/org.eclipse.ui.workbench/Eclipse UI/org/eclipse/ui/commands/old/ICommandHandlerServiceListener.java;1;0;2;1;0;0;0;2;0;0;1;1222;0;0;2;1;0;2;2;1222;1;1222;1;1;
/org.eclipse.ui.intro/src/org/eclipse/ui/internal/intro/impl/model/loader/IntroContentParser.java;1;1;4;1;4;4;4;0;16;0;0;5115;30;30;1;0;0;0;4;5115;0;5314;4;1;
/org.eclipse.jdt.core/batch/org/eclipse/jdt/internal/compiler/batch/ClasspathDirectory.java;2;0;5;1;1;1;1;4;20;1;4;259;39;39;1;0;0;4;5;259;0;5340;5;2;
/org.eclipse.sdk.tests-feature/plugins/org.eclipse.perfmsr.core/src/org/eclipse/perfmsr/core/UploadCmd.java;2;0;2;1;1;1;1;1;10;0;1;4845;10;10;1;0;0;1;2;4845;0;6342;2;2;
/org.eclipse.jdt.ui/core extension/org/eclipse/jdt/internal/corext/callhierarchy/MethodWrapper.java;3;0;8;1;1;1;1;7;45;2;6;169;119;119;2;1;0;7;8;169;1;6340;7;3;
/org.eclipse.help.webapp/src_servlets/org/eclipse/help/internal/webapp/data/WorkingSetManagerData.java;1;1;7;1;3;3;3;4;50;1;4;106;155;155;1;0;0;4;7;106;0;6337;7;1;
/org.eclipse.jdt.ui.tests/ui/org/eclipse/jdt/ui/tests/leaks/LeakTests.java;1;0;1;1;0;0;0;1;0;0;1;3124;0;0;1;0;0;1;1;3124;0;3124;1;1;
/org.eclipse.team.cvs.ui/src/org/eclipse/team/internal/ccvs/ui/actions/ReplaceWithRemoteAction.java;2;0;6;1;1;1;1;5;45;1;5;469;66;66;1;0;0;5;6;469;0;6337;6;2;
/org.eclipse.pde.ui/src_Forms/org/eclipse/pde/internal/ui/neweditor/feature/RequiredFeaturesWizardPage.java;2;0;2;1;1;1;1;1;0;0;1;4926;0;0;1;0;0;1;2;4926;0;5431;2;2;
/org.eclipse.ui.externaltools/External Tools Base/org/eclipse/ui/externaltools/internal/variable/ContainerExpander.java;1;0;1;1;0;0;0;1;0;0;1;321;0;0;1;0;0;1;1;321;0;321;1;1;
/org.eclipse.ui.workbench.texteditor/src/org/eclipse/ui/texteditor/DefaultRangeIndicator.java;2;1;5;1;3;3;3;2;9;1;2;3217;20;20;1;0;0;2;5;3217;0;6340;5;2;
/org.eclipse.ui.workbench/Eclipse UI/org/eclipse/ui/internal/commands/PreferenceRegistry.java;1;0;9;1;0;0;0;9;147;2;7;607;226;226;2;2;0;9;9;1356;2;1389;7;1;
/org.eclipse.jdt.core.tests.model/src/org/eclipse/jdt/core/tests/rewrite/describing/ASTRewritingMoveCodeTest.java;4;1;5;1;3;3;3;2;603;1;2;4711;704;704;1;0;0;2;5;4711;0;5853;5;4;
/org.eclipse.pde.ui/src_Forms/org/eclipse/pde/internal/ui/neweditor/plugin/dummy/DummyExtension.java;1;0;2;1;0;0;0;2;0;1;2;4223;0;0;1;0;0;2;2;4223;0;4354;2;1;
/org.eclipse.swt/Eclipse SWT PI/win32/org/eclipse/swt/internal/ole/win32/OLEINPLACEFRAMEINFO.java;1;0;1;1;0;0;0;1;6;0;1;2915;6;6;1;0;0;1;1;2915;0;2915;1;1;
/org.eclipse.ui.externaltools/Program Tools Support/org/eclipse/ui/externaltools/internal/program/launchConfigurations/ProgramLaunchDelegate.java;3;0;16;1;0;0;0;16;64;2;15;219;185;185;2;1;0;16;16;1813;1;2120;15;3;
/org.eclipse.jdt.ui.tests.refactoring/resources/Move/testDestination_yes_initializerToOtherType/out/A.java;1;0;2;1;0;0;0;2;1;0;1;1008;1;1;2;1;0;2;2;1008;1;1008;1;1;
/org.eclipse.update.ui.win32/src/org/eclipse/update/internal/ui/win32/views/GlobalActionHandler.java;1;0;1;1;0;0;0;1;0;0;1;889;0;0;1;0;0;1;1;889;0;889;1;1;
/org.eclipse.ui.ide/src/org/eclipse/ui/views/framelist/IFrameSource.java;3;1;3;1;2;2;2;1;2;0;1;2208;4;4;1;0;0;1;3;2208;0;6338;3;3;
/org.eclipse.jdt.core/search/org/eclipse/jdt/internal/core/index/impl/IndexImpl.java;2;0;4;1;0;0;0;4;90;2;3;3384;92;92;2;1;0;4;4;3384;1;4060;3;2;
/org.eclipse.jdt.core/dom/org/eclipse/jdt/core/dom/InstanceofExpression.java;3;1;8;1;2;2;2;6;110;1;6;3560;158;158;1;0;0;6;8;3560;0;5272;8;3;
/org.eclipse.swt/Eclipse SWT Accessibility/emulated/org/eclipse/swt/accessibility/Accessible.java;3;1;8;1;2;2;2;6;990;3;4;0;1136;1136;3;2;0;6;8;1102;2;6352;6;3;
/org.eclipse.update.ui/src/org/eclipse/update/internal/ui/wizards/FeatureSorter.java;2;1;5;1;2;2;2;3;8;1;3;1489;16;16;1;0;0;3;5;1489;0;6336;5;2;
/org.eclipse.jdt.core.tests.model/workspace/Converter/test0240/Test.java;1;0;1;1;0;0;0;1;0;0;1;3714;0;0;1;0;0;1;1;3714;0;3714;1;1;
/org.eclipse.debug.ui/ui/org/eclipse/debug/ui/DefaultObjectBrowser.java;2;0;3;1;0;0;0;3;4;1;3;861;4;4;1;0;0;3;3;861;0;2564;3;2;
/org.eclipse.ui.cheatsheets/src/org/eclipse/ui/cheatsheets/ICheatSheetItemExtensionElement.java;1;0;2;1;0;0;0;2;0;1;2;4428;0;0;1;0;0;2;2;4428;0;4625;2;1;
/org.eclipse.search/search/org/eclipse/search/internal/ui/util/SWTUtil.java;1;0;2;1;1;1;1;1;73;0;1;1947;75;75;1;0;0;1;2;1947;0;6340;2;1;
/org.eclipse.jdt.core.tests.model/workspace/Converter/src/test0382/A.java;1;0;1;1;0;0;0;1;0;0;1;3714;0;0;1;0;0;1;1;3714;0;3714;1;1;
/org.eclipse.ui.forms/src/org/eclipse/ui/internal/forms/widgets/FormUtil.java;1;0;2;1;1;1;1;1;6;0;1;5044;6;6;1;0;0;1;2;5044;0;6336;2;1;
/org.eclipse.team.webdav/src/org/eclipse/team/internal/target/subscriber/RemoteSynchronizationCache.java;2;0;4;1;0;0;0;4;83;1;4;3494;91;91;1;0;0;4;4;3494;0;4259;4;2;
/org.eclipse.jdt.ui/ui/org/eclipse/jdt/internal/ui/preferences/JavadocConfigurationPropertyPage.java;2;0;4;1;1;1;1;3;26;1;3;597;33;33;1;0;0;3;4;597;0;6340;4;2;
/org.eclipse.team.ui/src/org/eclipse/team/ui/sync/INewSynchronizeView.java;1;0;1;1;0;0;0;1;0;0;1;2406;0;0;1;0;0;1;1;2406;0;2406;1;1;
/org.eclipse.jdt.core/model/org/eclipse/jdt/internal/core/eval/RequestorWrapper.java;1;0;1;1;0;0;0;1;2;0;1;3560;2;2;1;0;0;1;1;3560;0;3560;1;1;
/org.eclipse.debug.ui/ui/org/eclipse/debug/internal/ui/launchConfigurations/LaunchShortcutExtension.java;3;2;12;1;6;4;6;6;132;1;6;3806;316;316;2;0;2;6;12;5475;2;5511;10;3;
/org.eclipse.ui.workbench/Eclipse UI/org/eclipse/ui/internal/dialogs/AbstractPreferenceImportExportPage.java;4;0;4;2;1;1;1;3;32;2;2;3636;36;36;2;1;0;3;4;4609;1;6338;3;4;
/org.eclipse.core.runtime.osgi/src/org/eclipse/core/internal/jobs/WorkerPool.java;1;0;2;1;0;0;0;2;49;1;2;3013;49;49;1;0;0;2;2;3013;0;3028;2;1;
/org.eclipse.ui.workbench/Eclipse UI/org/eclipse/ui/commands/ICommandServiceEvent.java;1;0;3;1;0;0;0;3;16;1;3;2569;16;16;1;0;0;3;3;2569;0;4144;3;1;
/org.eclipse.team.webdav/src/org/eclipse/team/internal/webdav/core/Authenticator.java;1;1;4;1;2;2;2;2;18;1;2;4216;24;24;1;0;0;2;4;4216;0;6337;4;1;
/org.eclipse.ui.workbench/Eclipse UI/org/eclipse/ui/internal/roles/api/IRoleRegistry.java;1;0;3;1;0;0;0;3;2;1;3;1952;2;2;1;0;0;3;3;1952;0;2199;3;1;
/org.eclipse.swt/Eclipse SWT/motif/org/eclipse/swt/graphics/Cursor.java;4;1;11;1;3;3;3;8;96;2;6;217;246;246;2;2;0;8;11;217;2;6352;9;4;
/org.eclipse.ui.workbench/Eclipse UI/org/eclipse/ui/internal/activities/CategoryDefinition.java;4;0;10;1;1;1;1;9;36;2;8;2867;86;86;2;1;0;9;10;3128;1;6338;9;4;
/org.eclipse.core.runtime/src/org/eclipse/core/runtime/IPath.java;3;0;6;1;1;1;1;5;906;1;5;2567;1878;1878;1;0;0;5;6;2567;0;5117;6;3;
/org.eclipse.jdt.core/compiler/org/eclipse/jdt/internal/compiler/ast/Clinit.java;3;0;5;1;1;1;1;4;14;1;4;62;30;30;1;0;0;4;5;62;0;5343;5;3;
/org.eclipse.jdt.core.tests.model/workspace/Converter/src/test0153/Test.java;1;0;1;1;0;0;0;1;0;0;1;3714;0;0;1;0;0;1;1;3714;0;3714;1;1;
/org.eclipse.debug.core/core/org/eclipse/debug/core/sourcelookup/containers/AbstractSourceContainerTypeDelegate.java;1;0;2;1;1;1;1;1;2;0;1;4952;2;2;1;0;0;1;2;4952;0;5109;2;1;
/org.eclipse.ui.tests/Eclipse UI Tests/org/eclipse/ui/tests/commands/CommandsTestCase1.java;2;0;2;1;1;1;1;1;0;0;1;4896;0;0;1;0;0;1;2;4896;0;6224;2;2;
/org.eclipse.osgi.tests/src/org/eclipse/osgi/tests/BundleTestingHelper.java;2;1;3;1;2;2;2;1;7;0;1;5066;7;7;1;0;0;1;3;5066;0;6201;3;2;
/org.eclipse.jdt.ui/core extension/org/eclipse/jdt/internal/corext/util/SearchUtils.java;1;0;1;1;1;1;1;0;0;0;0;5375;0;0;1;0;0;0;1;5375;0;5375;1;1;
/org.eclipse.debug.ui/ui/org/eclipse/debug/internal/ui/launchVariables/PromptExpanderBase.java;2;0;2;1;0;0;0;2;0;1;2;771;0;0;1;0;0;2;2;771;0;2120;2;2;
/org.eclipse.ui.workbench.texteditor/src/org/eclipse/ui/texteditor/EditorMessages.java;1;0;1;1;1;1;1;0;2;0;0;6340;2;2;1;0;0;0;1;6340;0;6340;1;1;
/org.eclipse.core.resources/src/org/eclipse/core/resources/IResourceVisitor.java;1;0;2;1;1;1;1;1;22;0;1;4994;24;24;1;0;0;1;2;4994;0;5146;2;1;
/org.eclipse.jdt.debug.tests/tests/org/eclipse/jdt/debug/tests/eval/NestedTypeFieldValue_664.java;1;0;1;1;0;0;0;1;60;0;1;1274;60;60;1;0;0;1;1;1274;0;1274;1;1;
/org.eclipse.ui.workbench/Eclipse UI/org/eclipse/ui/internal/commands/old/Manager.java;1;0;7;1;0;0;0;7;59;2;6;1222;111;111;2;1;0;7;7;1321;1;1695;6;1;
/org.eclipse.jdt.core/compiler/org/eclipse/jdt/internal/compiler/env/INameEnvironment.java;1;0;1;1;0;0;0;1;2;0;1;3560;2;2;1;0;0;1;1;3560;0;3560;1;1;
/org.eclipse.team.ui/src/org/eclipse/team/ui/synchronize/actions/IRefreshEvent.java;1;0;1;1;0;0;0;1;0;0;1;3709;0;0;1;0;0;1;1;3709;0;3709;1;1;
/org.eclipse.jdt.core/dom/org/eclipse/jdt/core/dom/StringLiteral.java;5;0;10;1;1;1;1;9;69;1;9;1059;101;101;1;0;0;9;10;1059;0;5272;10;5;
/org.eclipse.core.filebuffers.tests/src/org/eclipse/core/filebuffers/tests/TestHelper.java;1;1;3;1;2;2;2;1;20;0;1;5082;26;26;1;0;0;1;3;5082;0;6340;3;1;
/org.eclipse.ant.ui/Ant Editor/org/eclipse/ant/ui/internal/editor/text/AntEditorProcInstrScanner.java;1;0;3;1;0;0;0;3;4;1;3;250;4;4;1;0;0;3;3;250;0;1811;3;1;
/org.eclipse.jdt.debug.ui/ui/org/eclipse/jdt/internal/debug/ui/console/JavaNativeStackTraceHyperlink.java;1;0;1;1;0;0;0;1;3;0;1;2497;3;3;1;0;0;1;1;2497;0;2497;1;1;
/org.eclipse.core.runtime/src/org/eclipse/core/internal/jobs/LockManager.java;3;1;23;1;4;4;4;19;441;3;17;351;1726;1726;3;2;0;19;23;2823;2;6220;21;3;
/org.eclipse.core.resources/src/org/eclipse/core/internal/dtree/DataTree.java;2;0;3;1;2;1;2;1;559;0;1;1477;561;561;2;0;1;1;3;5146;1;5146;2;2;
/org.eclipse.core.runtime/src/org/eclipse/core/internal/dependencies/IResolutionDelta.java;2;0;2;1;0;0;0;2;0;1;2;2105;0;0;1;0;0;2;2;2105;0;3013;2;2;
/org.eclipse.update.ui/src/org/eclipse/update/internal/ui/pages/ExtensionRootPage.java;1;0;1;1;0;0;0;1;0;0;1;755;0;0;1;0;0;1;1;755;0;755;1;1;
/org.eclipse.swt/Eclipse SWT/gtk1x/org/eclipse/swt/graphics/Cursor.java;1;0;1;1;0;0;0;1;0;0;1;2327;0;0;1;0;0;1;1;2327;0;2327;1;1;
/org.eclipse.jface/src/org/eclipse/jface/resource/JFaceColors.java;3;0;6;1;0;0;0;6;232;2;5;4015;558;558;2;1;0;6;6;4467;1;4626;5;3;
/org.eclipse.core.runtime/src/org/eclipse/core/internal/jobs/ObjectMap.java;2;1;3;1;2;2;2;1;70;0;1;4875;72;72;1;0;0;1;3;4875;0;5682;3;2;
/org.eclipse.webdav/src/client/org/eclipse/webdav/http/client/IAuthenticator.java;1;0;2;1;2;1;2;0;21;0;0;5151;21;21;2;0;1;0;2;5151;1;5151;1;1;
/org.eclipse.jdt.core/dom/org/eclipse/jdt/core/internal/dom/rewrite/ListRewriteEvent.java;1;0;2;1;0;0;0;2;0;1;2;4711;0;0;1;0;0;2;2;4711;0;4802;2;1;
/org.eclipse.jdt.core/compiler/org/eclipse/jdt/internal/compiler/env/IBinaryType.java;1;0;1;1;0;0;0;1;2;0;1;3560;2;2;1;0;0;1;1;3560;0;3560;1;1;
/org.eclipse.jdt.ui.tests.refactoring/resources/IntroduceFactory/positive/staticContext_FFF.java;1;0;2;1;0;0;0;2;0;1;2;2846;0;0;1;0;0;2;2;2846;0;2862;2;1;
/org.eclipse.jdt.core.tests.model/workspace/Converter/src/javadoc/testBug51226/X4.java;1;0;1;1;0;0;0;1;0;0;1;3899;0;0;1;0;0;1;1;3899;0;3899;1;1;
/org.eclipse.jdt.ui.tests.refactoring/resources/RenameType/test62/out/B.java;1;0;1;1;1;1;1;0;0;0;0;6118;0;0;1;0;0;0;1;6118;0;6118;1;1;
/org.eclipse.ui.tests/Eclipse UI Tests/org/eclipse/ui/tests/api/IPartServiceTest.java;2;1;4;1;4;4;4;0;109;0;0;5345;152;152;1;0;0;0;4;5345;0;6338;4;2;
/org.eclipse.jface/src/org/eclipse/jface/util/DelegatingDropAdapter.java;1;0;1;1;0;0;0;1;0;0;1;179;0;0;1;0;0;1;1;179;0;179;1;1;
/org.eclipse.swt/Eclipse SWT PI/gtk/org/eclipse/swt/internal/gtk/PangoAttribute.java;3;0;4;1;1;1;1;3;2;1;3;1915;6;6;1;0;0;3;4;1915;0;6352;4;3;
/org.eclipse.core.tests.resources/src/org/eclipse/core/tests/resources/WorkspaceTest.java;1;0;3;1;3;1;3;0;662;0;0;5147;662;662;3;0;2;0;3;5147;2;5147;1;1;
/org.eclipse.jdt.ui/core extension/org/eclipse/jdt/internal/corext/textmanipulation/MoveSourceEdit.java;2;0;10;1;0;0;0;10;149;2;8;949;486;486;2;2;0;10;10;1869;2;1946;8;2;
/org.eclipse.team.core/src/org/eclipse/team/internal/core/subscribers/ISyncInfoSetChangeListener2.java;1;0;1;1;0;0;0;1;0;0;1;4002;0;0;1;0;0;1;1;4002;0;4002;1;1;
/org.eclipse.team.cvs.ui/src/org/eclipse/team/internal/ccvs/ui/operations/SingleCommandOperation.java;2;1;11;1;2;2;2;9;66;2;7;1591;133;133;2;2;0;9;11;2495;2;6337;9;2;
/org.eclipse.jdt.ui.tests/ui/org/eclipse/jdt/ui/tests/search/WorkspaceReferenceTest.java;2;0;3;1;0;0;0;3;39;1;3;4345;41;41;1;0;0;3;3;4345;0;4419;3;2;
/org.eclipse.ui.workbench/Eclipse UI/org/eclipse/ui/internal/registry/ViewDescriptor.java;6;2;11;2;3;2;3;8;321;2;7;830;430;430;2;1;1;8;11;3061;2;6081;9;6;
/org.eclipse.jdt.ui/ui refactoring/org/eclipse/jdt/internal/ui/refactoring/VisibilityControlUtil.java;4;0;6;1;1;1;1;5;59;1;5;363;117;117;1;0;0;5;6;363;0;6340;6;4;
/org.eclipse.jdt.ui/ui/org/eclipse/jdt/internal/ui/preferences/formatter/CodingStyleConfigurationBlock.java;2;1;15;1;3;3;3;12;287;2;11;3103;656;656;2;1;0;12;15;3103;1;6144;14;2;
/org.eclipse.jdt.ui/ui/org/eclipse/jdt/internal/ui/callhierarchy/ICallHierarchyPreferencesConstants.java;1;0;4;1;0;0;0;4;8;2;3;155;8;8;2;1;0;4;4;169;1;218;3;1;
/org.eclipse.debug.ui/ui/org/eclipse/debug/internal/ui/views/memory/MemoryViewPreferencePage.java;2;1;2;1;2;2;2;0;0;0;0;5254;0;0;1;0;0;0;2;5254;0;5408;2;2;
/org.eclipse.jdt.ui.tests.refactoring/resources/MoveInstanceMethod/canMove/test20/in/StarDecorator.java;1;0;1;1;0;0;0;1;0;0;1;1586;0;0;1;0;0;1;1;1586;0;1586;1;1;
/org.eclipse.ant.ui/Ant Editor/org/eclipse/ant/internal/ui/editor/templates/TaskContextType.java;1;0;1;1;0;0;0;1;0;0;1;4916;0;0;1;0;0;1;1;4916;0;4916;1;1;
/org.eclipse.pde.ui/src/org/eclipse/pde/internal/ui/editor/feature/FeatureUndoManager.java;1;1;3;1;2;2;2;1;47;0;1;4203;57;57;1;0;0;1;3;4203;0;6336;3;1;
/org.eclipse.jdt.ui.tests.refactoring/resources/IntroduceFactory/Bugzilla/45942/UseTestClass.java;1;0;2;1;1;1;1;1;2;0;1;2846;2;2;1;0;0;1;2;2846;0;5659;2;1;
/org.eclipse.pde.ui/src_Forms/org/eclipse/pde/internal/ui/neweditor/GenericSourcePage.java;2;1;2;1;2;2;2;0;0;0;0;5341;0;0;1;0;0;0;2;5341;0;5431;2;2;
/org.eclipse.pde.ui/src_Forms/org/eclipse/pde/internal/ui/neweditor/schema/TypeRestrictionCellEditor.java;1;0;2;1;0;0;0;2;0;1;2;4856;0;0;1;0;0;2;2;4856;0;4879;2;1;
/org.eclipse.ui.workbench/Eclipse UI/org/eclipse/ui/internal/dialogs/NewProjectWizard.java;1;0;1;1;0;0;0;1;0;0;1;2737;0;0;1;0;0;1;1;2737;0;2737;1;1;
/org.eclipse.ui.ide/src/org/eclipse/ui/views/tasklist/ResolveMarkerAction.java;1;0;1;1;0;0;0;1;0;0;1;2208;0;0;1;0;0;1;1;2208;0;2208;1;1;
/org.eclipse.ui.workbench/Eclipse UI/org/eclipse/ui/internal/commands/registry/KeyConfigurationDefinition.java;1;0;8;1;0;0;0;8;68;2;6;1396;167;167;2;2;0;8;8;1396;2;1724;6;1;
/org.eclipse.osgi/core/framework/org/eclipse/osgi/framework/eventmgr/ListElement.java;1;0;2;1;1;1;1;1;6;0;1;5097;6;6;1;0;0;1;2;5097;0;5646;2;1;
/org.eclipse.ui.workbench/Eclipse UI/org/eclipse/ui/actions/NewExampleAction.java;1;0;1;1;0;0;0;1;0;0;1;2737;0;0;1;0;0;1;1;2737;0;2737;1;1;
/org.eclipse.ui.workbench/Eclipse UI/org/eclipse/ui/commands/HandlerEvent.java;2;0;4;1;1;1;1;3;122;2;2;4088;146;146;2;1;0;3;4;4953;1;5231;3;2;
/org.eclipse.osgi/osgi/src/org/eclipse/osgi/service/resolver/BundleDelta.java;3;1;4;1;2;2;2;2;10;1;2;3013;22;22;1;0;0;2;4;3013;0;6337;4;3;
/org.eclipse.swt/Eclipse SWT PI/gtk/org/eclipse/swt/internal/gtk/PangoRectangle.java;3;0;3;1;1;1;1;2;2;1;2;2781;4;4;1;0;0;2;3;2781;0;6352;3;3;
/org.eclipse.debug.core/core/org/eclipse/debug/core/model/RuntimeProcess.java;4;1;8;2;2;2;2;6;13;2;5;1932;44;44;2;1;0;6;8;1932;1;6336;7;4;
/org.eclipse.jdt.ui.tests.refactoring/resources/Copy/test_type_yes_type/in/C.java;1;0;1;1;0;0;0;1;0;0;1;696;0;0;1;0;0;1;1;696;0;696;1;1;
/org.eclipse.debug.core/core/org/eclipse/debug/internal/core/sourcelookup/ISourcePathComputerDelegate.java;1;0;3;1;0;0;0;3;4;1;3;3678;4;4;1;0;0;3;3;3678;0;4949;3;1;
/org.eclipse.jdt.core/model/org/eclipse/jdt/internal/core/OverflowingLRUCache.java;1;0;5;1;0;0;0;5;18;1;5;972;26;26;1;0;0;5;5;972;0;3560;5;1;
/org.eclipse.jdt.ui/core extension/org/eclipse/jdt/internal/corext/template/java/CodeTemplateContextType.java;4;1;12;1;3;3;3;9;166;2;8;664;343;343;2;1;0;9;12;4382;1;6340;11;4;
/org.eclipse.core.runtime/src/org/eclipse/core/runtime/preferences/IScope.java;2;0;5;1;1;1;1;4;48;1;4;4033;61;61;1;0;0;4;5;4033;0;5150;5;2;
/org.eclipse.ui.workbench/Eclipse UI/org/eclipse/ui/internal/activities/ui/CategoryContentProvider.java;2;0;4;2;0;0;0;4;15;2;2;2864;29;29;2;2;0;4;4;2864;2;3061;2;2;
/org.eclipse.jdt.ui.tests.refactoring/resources/RenamePackage/testImportFromMultiRoots5/in/srcTest/p/p/ATest.java;1;0;1;1;0;0;0;1;0;0;1;4105;0;0;1;0;0;1;1;4105;0;4105;1;1;
/org.eclipse.team.core/src/org/eclipse/team/core/subscribers/IJobListener.java;1;0;1;1;0;0;0;1;0;0;1;3550;0;0;1;0;0;1;1;3550;0;3550;1;1;
/org.eclipse.core.runtime/src/org/eclipse/core/internal/plugins/PluginRegistry.java;3;0;5;1;0;0;0;5;54;1;5;536;91;91;1;0;0;5;5;536;0;3013;5;3;
/org.eclipse.debug.core/core/org/eclipse/debug/internal/core/sourcelookup/containers/DefaultSourceContainerType.java;2;0;8;2;1;1;1;7;20;3;4;3678;52;52;3;3;0;7;8;4949;3;5672;5;2;
/org.eclipse.jdt.ui/ui refactoring/org/eclipse/jdt/internal/ui/refactoring/actions/InlineConstantAction.java;3;0;6;1;1;1;1;5;63;1;5;144;99;99;1;0;0;5;6;144;0;6340;6;3;
/org.eclipse.jdt.ui/ui/org/eclipse/jdt/internal/ui/dialogs/MessageLine.java;1;0;1;1;1;1;1;0;2;0;0;6340;2;2;1;0;0;0;1;6340;0;6340;1;1;
/org.eclipse.compare/compare/org/eclipse/compare/internal/EditionAction.java;1;0;6;1;1;1;1;5;41;1;5;1731;124;124;1;0;0;5;6;1731;0;6354;6;1;
/org.eclipse.team.webdav/src/org/eclipse/team/internal/ui/target/subscriber/DeploymentProviderLabelDecorator.java;2;0;5;1;1;1;1;4;79;1;4;3885;89;89;1;0;0;4;5;3885;0;6337;5;2;
/org.eclipse.text/src/org/eclipse/jface/text/ConfigurableLineTracker.java;1;0;1;1;1;1;1;0;21;0;0;6299;21;21;1;0;0;0;1;6299;0;6299;1;1;
/org.eclipse.jdt.core/search/org/eclipse/jdt/core/search/MethodReferenceMatch.java;3;2;10;1;5;4;5;5;26;1;5;3913;99;99;2;0;1;5;10;5200;1;5912;9;3;
/org.eclipse.jdt.core.tests.model/workspace/JavaSearchMultipleProjects2/lib/p/Y.java;1;0;1;1;0;0;0;1;3;0;1;3024;3;3;1;0;0;1;1;3024;0;3024;1;1;
/org.eclipse.core.filebuffers/src/org/eclipse/core/internal/filebuffers/ContainerGenerator.java;4;1;5;1;3;3;3;2;20;1;2;1522;51;51;1;0;0;2;5;1522;0;6340;5;4;
/org.eclipse.help.base/src/org/eclipse/help/internal/workingset/AdaptableTopic.java;1;1;4;1;3;3;3;1;33;0;1;1740;41;41;1;0;0;1;4;1740;0;6337;4;1;
/org.eclipse.swt/Eclipse SWT/gtk1x/org/eclipse/swt/widgets/TableColumn.java;1;0;1;1;0;0;0;1;0;0;1;2327;0;0;1;0;0;1;1;2327;0;2327;1;1;
/org.eclipse.jdt.ui/ui/org/eclipse/jdt/internal/ui/preferences/BuildPathPreferencesBlock.java;1;0;3;1;1;1;1;2;134;1;2;4407;134;134;1;0;0;2;3;4407;0;6034;3;1;
/org.eclipse.ui.workbench/Eclipse UI/org/eclipse/ui/internal/commands/Capture.java;1;0;5;1;0;0;0;5;6;1;5;786;6;6;1;0;0;5;5;786;0;1695;5;1;
/org.eclipse.ui.workbench/Eclipse UI/org/eclipse/ui/internal/WorkbenchPreferenceInitializer.java;3;2;8;2;8;7;8;0;18;0;0;5321;38;38;2;0;1;0;8;5532;1;6338;7;3;
/org.eclipse.jdt.ui.tests/ui/org/eclipse/jdt/ui/tests/core/ClassPathDetectorTest.java;2;0;4;1;1;1;1;3;25;1;3;803;35;35;1;0;0;3;4;803;0;6340;4;2;
/org.eclipse.jdt.core.tests.model/workspace/Formatter/test404/A_in.java;1;0;1;1;0;0;0;1;0;0;1;3438;0;0;1;0;0;1;1;3438;0;3438;1;1;
/org.eclipse.jdt.debug.ui/ui/org/eclipse/jdt/internal/debug/ui/breakpoints/ToggleClassPrepareBreakpointAction.java;2;0;2;1;0;0;0;2;11;1;2;4525;11;11;1;0;0;2;2;4525;0;4855;2;2;
/org.eclipse.team.core/src/org/eclipse/team/core/subscribers/utils/SynchronizationCache.java;1;0;1;1;0;0;0;1;0;0;1;3563;0;0;1;0;0;1;1;3563;0;3563;1;1;
/org.eclipse.jdt.ui/ui/org/eclipse/jdt/internal/ui/callhierarchy/CallHierarchyTransferDropAdapter.java;2;0;2;1;1;1;1;1;2;0;1;217;2;2;1;0;0;1;2;217;0;6340;2;2;
/org.eclipse.jdt.ui/core refactoring/org/eclipse/jdt/internal/corext/refactoring/code/flow/ConditionalFlowInfo.java;1;0;1;1;1;1;1;0;2;0;0;6340;2;2;1;0;0;0;1;6340;0;6340;1;1;
/org.eclipse.update.core/src/org/eclipse/update/core/IUpdateSite.java;1;0;1;1;0;0;0;1;0;0;1;2634;0;0;1;0;0;1;1;2634;0;2634;1;1;
/org.eclipse.ui.workbench/Eclipse UI/org/eclipse/ui/internal/contexts/api/IMutableContextRegistry.java;1;0;2;1;0;0;0;2;0;1;2;1724;0;0;1;0;0;2;2;1724;0;2425;2;1;
/org.eclipse.help/src/org/eclipse/help/internal/context/RelatedTopic.java;1;1;3;1;3;3;3;0;6;0;0;5595;14;14;1;0;0;0;3;5595;0;6337;3;1;
/org.eclipse.ui.workbench.texteditor/src/org/eclipse/ui/texteditor/quickdiff/QuickDiff.java;2;2;6;2;5;4;5;1;64;0;1;1644;85;85;2;0;1;1;6;6334;1;6334;5;2;
/org.eclipse.ui.intro/src/org/eclipse/ui/internal/intro/impl/model/IntroURLAction.java;1;0;1;1;1;1;1;0;0;0;0;5319;0;0;1;0;0;0;1;5319;0;5319;1;1;
/org.eclipse.update.core/src/org/eclipse/update/internal/operations/JobTargetSite.java;1;0;4;1;1;1;1;3;2;1;3;825;4;4;1;0;0;3;4;825;0;6147;4;1;
/org.eclipse.jdt.core/search/org/eclipse/jdt/internal/core/search/matching/MatchLocator.java;6;3;78;2;16;14;16;62;2355;2;52;69;6616;6616;3;10;2;62;78;5205;12;6261;66;6;
/org.eclipse.osgi/core/adaptor/org/eclipse/osgi/framework/util/Headers.java;3;1;9;1;4;4;4;5;536;1;5;3013;606;606;1;0;0;5;9;3013;0;6337;9;3;
/org.eclipse.jdt.core/model/org/eclipse/jdt/internal/core/CopyResourceElementsOperation.java;4;2;23;2;5;4;5;18;150;3;16;134;363;363;3;2;1;18;23;2002;3;6261;20;4;
/org.eclipse.swt/Eclipse SWT/motif/org/eclipse/swt/widgets/Group.java;2;0;8;1;0;0;0;8;29;1;8;83;97;97;1;0;0;8;8;83;0;2954;8;2;
/org.eclipse.jdt.ui/core refactoring/org/eclipse/jdt/internal/corext/refactoring/util/JavadocUtil.java;1;1;2;1;2;2;2;0;8;0;0;5854;8;8;1;0;0;0;2;5854;0;6012;2;1;
/org.eclipse.ui.workbench.texteditor/src/org/eclipse/ui/texteditor/MarkerRulerAction.java;2;0;4;1;0;0;0;4;17;1;4;1118;36;36;1;0;0;4;4;1118;0;2741;4;2;
/org.eclipse.ui.workbench/Eclipse UI/org/eclipse/ui/internal/commands/older/KeySequenceBindingNode.java;1;0;2;1;0;0;0;2;0;0;1;2565;0;0;2;1;0;2;2;2565;1;2565;1;1;
/org.eclipse.ui.workbench/Eclipse UI/org/eclipse/ui/internal/registry/EditorRegistry.java;7;1;13;2;7;7;7;6;1521;2;5;2737;2316;2316;2;1;0;6;13;3061;1;6338;12;7;
/org.eclipse.jdt.ui.tests.refactoring/resources/InlineMethodWorkspace/TestCases/simple_in/TestBasic1.java;1;0;1;1;0;0;0;1;2;0;1;845;2;2;1;0;0;1;1;845;0;845;1;1;
/org.eclipse.core.expressions/src/org/eclipse/core/internal/expressions/TypeExtension.java;1;1;5;1;2;2;2;3;76;1;3;4108;124;124;1;0;0;3;5;4108;0;6340;5;1;
/org.eclipse.core.runtime.osgi/src/org/eclipse/core/internal/registry/RegistryChangeEvent.java;1;0;2;1;0;0;0;2;6;1;2;3013;6;6;1;0;0;2;2;3013;0;3030;2;1;
/org.eclipse.debug.ui/ui/org/eclipse/debug/internal/ui/actions/ShowDetailPaneAction.java;1;0;1;1;0;0;0;1;0;0;1;689;0;0;1;0;0;1;1;689;0;689;1;1;
/org.eclipse.text/src/org/eclipse/text/edits/AbstractTransferEdit.java;1;0;2;1;0;0;0;2;0;1;2;1986;0;0;1;0;0;2;2;1986;0;2113;2;1;
/org.eclipse.team.core/src/org/eclipse/team/internal/core/subscribers/caches/SyncTreeSubscriber.java;2;0;3;1;0;0;0;3;112;1;3;3966;112;112;1;0;0;3;3;3966;0;4259;3;2;
/org.eclipse.core.expressions.tests/src/org/eclipse/core/internal/expressions/tests/AllTests.java;1;1;3;1;2;2;2;1;2;0;1;4108;4;4;1;0;0;1;3;4108;0;6340;3;1;
/org.eclipse.update.ui/srcnew/org/eclipse/update/internal/ui/properties/FeatureLicensePropertyPage.java;3;0;10;2;0;0;0;10;22;2;9;306;51;51;2;1;0;10;10;306;1;825;9;3;
/org.eclipse.team.ui/src/org/eclipse/team/internal/ui/synchronize/SummarySection.java;1;0;1;1;0;0;0;1;0;0;1;3221;0;0;1;0;0;1;1;3221;0;3221;1;1;
/org.eclipse.core.runtime.compatibility/src-runtime/org/eclipse/core/runtime/IExtension.java;2;0;5;1;0;0;0;5;3;1;5;3013;6;6;1;0;0;5;5;3013;0;3169;5;2;
/org.eclipse.ant.core/src_ant/org/eclipse/ant/internal/core/ant/InternalProject.java;2;1;5;2;2;2;2;3;63;1;3;1592;157;157;1;0;0;3;5;1592;0;5743;5;2;
/org.eclipse.jdt.ui.tests.refactoring/resources/ChangeTypeRefactoring/negative/A_testPrimitive_out.java;1;0;1;1;0;0;0;1;0;0;1;2844;0;0;1;0;0;1;1;2844;0;2844;1;1;
/org.eclipse.swt/Eclipse SWT/gtk1x/org/eclipse/swt/graphics/Color.java;1;0;1;1;0;0;0;1;0;0;1;2327;0;0;1;0;0;1;1;2327;0;2327;1;1;
/org.eclipse.webdav/src/client/org/eclipse/webdav/http/client/IStatusCodes.java;1;0;1;1;1;1;1;0;4;0;0;5151;4;4;1;0;0;0;1;5151;0;5151;1;1;
/org.eclipse.compare/compare/org/eclipse/compare/internal/Utilities.java;1;1;13;1;3;3;3;10;146;1;10;1289;469;469;1;0;0;10;13;1289;0;6354;13;1;
/org.eclipse.jdt.core.tests.model/workspace/Formatter/test274/A_in.java;1;0;1;1;0;0;0;1;0;0;1;2443;0;0;1;0;0;1;1;2443;0;2443;1;1;
/org.eclipse.help.webapp/src_servlets/org/eclipse/help/internal/webapp/data/WorkingSetData.java;1;1;6;1;3;3;3;3;16;1;3;106;51;51;1;0;0;3;6;106;0;6337;6;1;
/org.eclipse.ant.ui/Ant Editor/org/eclipse/ant/internal/ui/dtd/util/AntDTDUtilMessages.java;1;0;1;1;0;0;0;1;0;0;1;1811;0;0;1;0;0;1;1;1811;0;1811;1;1;
/org.eclipse.ui.workbench/Eclipse UI/org/eclipse/ui/commands/KeyStroke.java;1;0;5;1;0;0;0;5;447;4;2;1321;447;447;4;3;0;5;5;1336;3;1336;2;1;
/org.eclipse.ui.ide/src/org/eclipse/ui/views/markers/MarkerViewUtil.java;2;0;2;1;0;0;0;2;4;1;2;2208;4;4;1;0;0;2;2;2208;0;3214;2;2;
/org.eclipse.ant.ui/Ant Editor/org/eclipse/ant/internal/ui/editor/text/FileScanner.java;1;0;1;1;0;0;0;1;0;0;1;3737;0;0;1;0;0;1;1;3737;0;3737;1;1;
/org.eclipse.jdt.core/model/org/eclipse/jdt/core/util/IAttributeNamesConstants.java;1;0;2;1;0;0;0;2;120;1;2;3560;122;122;1;0;0;2;2;3560;0;4843;2;1;
/org.eclipse.team.ui/src/org/eclipse/team/ui/synchronize/viewers/DecoratingColorLabelProvider.java;1;0;2;1;0;0;0;2;0;1;2;4588;0;0;1;0;0;2;2;4588;0;4632;2;1;
/org.eclipse.jdt.core/search/org/eclipse/jdt/internal/core/index/impl/ICacheEnumeration.java;1;0;2;1;0;0;0;2;2;1;2;3560;2;2;1;0;0;2;2;3560;0;4060;2;1;
/org.eclipse.team.ui/src/org/eclipse/team/ui/sync/TeamSubscriberParticipant.java;1;0;1;1;0;0;0;1;0;0;1;2463;0;0;1;0;0;1;1;2463;0;2463;1;1;
/org.eclipse.jdt.core.tests.model/workspace/Converter/test0179/Test.java;1;0;1;1;0;0;0;1;0;0;1;3714;0;0;1;0;0;1;1;3714;0;3714;1;1;
/org.eclipse.pde.ui/src/org/eclipse/pde/internal/ui/editor/manifest/LibraryTypeSection.java;1;0;1;1;1;1;1;0;0;0;0;5431;0;0;1;0;0;0;1;5431;0;5431;1;1;
/org.eclipse.pde.ui/src/org/eclipse/pde/internal/ui/wizards/convert/ExtensionPointMappings.java;1;0;2;1;0;0;0;2;0;0;1;3839;0;0;2;1;0;2;2;3839;1;3839;1;1;
/org.eclipse.core.tests.resources/src/org/eclipse/core/tests/internal/watson/WatsonTest.java;1;0;1;1;1;1;1;0;31;0;0;5147;31;31;1;0;0;0;1;5147;0;5147;1;1;
/org.eclipse.jdt.ui/ui/org/eclipse/jdt/internal/ui/text/spelling/WordCorrectionProposal.java;2;0;3;1;1;1;1;2;2;1;2;3930;4;4;1;0;0;2;3;3930;0;6340;3;2;
/org.eclipse.jdt.core.tests.model/workspace/Formatter/test294/A_out.java;1;0;1;1;0;0;0;1;0;0;1;2444;0;0;1;0;0;1;1;2444;0;2444;1;1;
/org.eclipse.pde.ui/src/org/eclipse/pde/internal/ui/editor/plugin/GeneralInfoSection.java;3;1;12;2;12;12;12;0;140;0;0;5431;315;315;1;0;0;0;12;5431;0;6336;12;3;
/org.eclipse.pde.ui/src/org/eclipse/pde/internal/ui/launcher/JUnitLaunchConfiguration.java;3;2;44;2;14;12;14;30;368;2;27;1343;1185;1185;2;3;2;30;44;1611;5;6054;39;3;
/org.eclipse.jdt.core/model/org/eclipse/jdt/core/util/IFieldInfo.java;1;0;2;1;0;0;0;2;8;1;2;3560;10;10;1;0;0;2;2;3560;0;4843;2;1;
/org.eclipse.jdt.ui.tests.refactoring/resources/MoveInnerToTopLevel/test_nonstatic_37/out/Inner.java;2;0;2;1;1;1;1;1;2;0;1;1311;2;2;1;0;0;1;2;1311;0;5854;2;2;
/org.eclipse.jdt.ui/core extension/org/eclipse/jdt/internal/corext/dom/JavaElementMapper.java;2;1;4;1;3;3;3;1;6;0;1;4897;11;11;1;0;0;1;4;4897;0;6340;4;2;
/org.eclipse.jdt.ui.tests/test plugin/org/eclipse/jdt/testplugin/StringAsserts.java;1;0;1;1;0;0;0;1;0;0;1;3655;0;0;1;0;0;1;1;3655;0;3655;1;1;
/org.eclipse.ui.workbench/Eclipse UI/org/eclipse/ui/activities/ws/IWorkbenchActivitySupport.java;1;0;1;1;0;0;0;1;0;0;1;3066;0;0;1;0;0;1;1;3066;0;3066;1;1;
/org.eclipse.compare/compare/org/eclipse/compare/internal/NullViewer.java;1;0;1;1;0;0;0;1;4;0;1;1289;4;4;1;0;0;1;1;1289;0;1289;1;1;
/org.eclipse.ant.ui/Ant Tools Support/org/eclipse/ant/internal/ui/preferences/IAntBlockContainer.java;1;0;1;1;0;0;0;1;0;0;1;1811;0;0;1;0;0;1;1;1811;0;1811;1;1;
/org.eclipse.core.tools.resources/src/org/eclipse/core/tools/metadata/LocationStrategy.java;1;0;1;1;1;1;1;0;0;0;0;6302;0;0;1;0;0;0;1;6302;0;6302;1;1;
/org.eclipse.swt/Eclipse SWT Custom Widgets/common/org/eclipse/swt/custom/DefaultLineStyler.java;2;0;2;1;1;1;1;1;4;0;1;3517;7;7;1;0;0;1;2;3517;0;6352;2;2;
/org.eclipse.jdt.ui/ui/org/eclipse/jdt/internal/ui/IUIConstants.java;1;0;1;1;1;1;1;0;2;0;0;6340;2;2;1;0;0;0;1;6340;0;6340;1;1;
/org.eclipse.pde.ui/src/org/eclipse/pde/internal/ui/editor/feature/SynchronizeVersionsWizard.java;2;1;2;1;2;2;2;0;4;0;0;5778;6;6;1;0;0;0;2;5778;0;6336;2;2;
/org.eclipse.jdt.ui.tests.refactoring/resources/ExtractTemp/canExtract/A_test71_out.java;1;0;1;1;0;0;0;1;0;0;1;1569;0;0;1;0;0;1;1;1569;0;1569;1;1;
/org.eclipse.jdt.ui/ui/org/eclipse/jdt/internal/ui/actions/MultiActionGroup.java;2;0;2;1;1;1;1;1;7;0;1;4807;9;9;1;0;0;1;2;4807;0;6340;2;2;
/org.eclipse.jdt.launching/launching/org/eclipse/jdt/internal/launching/IRuntimeClasspathEntry2.java;1;0;4;1;0;0;0;4;8;1;4;3810;11;11;1;0;0;4;4;3810;0;4974;4;1;
/org.eclipse.jdt.core/dom/org/eclipse/jdt/core/dom/BreakStatement.java;3;0;7;1;1;1;1;6;68;1;6;3560;85;85;1;0;0;6;7;3560;0;5272;7;3;
/org.eclipse.team.ui/src/org/eclipse/team/internal/ui/synchronize/actions/TextToolbarManager.java;2;0;3;1;0;0;0;3;39;1;3;2535;39;39;1;0;0;3;3;2535;0;2641;3;2;
/org.eclipse.jdt.core.tests.model/workspace/Formatter/test359/A_out.java;1;0;1;1;0;0;0;1;0;0;1;3087;0;0;1;0;0;1;1;3087;0;3087;1;1;
/org.eclipse.team.cvs.core/src/org/eclipse/team/internal/ccvs/core/resources/EclipseFile.java;2;0;12;1;1;1;1;11;71;2;10;276;176;176;2;1;0;11;12;3144;1;6337;11;2;
/org.eclipse.help/src/org/eclipse/help/internal/HelpApplication.java;1;0;2;1;0;0;0;2;40;1;2;1880;40;40;1;0;0;2;2;1880;0;2732;2;1;
/org.eclipse.core.runtime.compatibility/src-runtime/org/eclipse/core/runtime/compatibility/PluginActivator.java;4;0;5;2;0;0;0;5;37;2;4;3013;73;73;2;1;0;5;5;3164;1;3164;4;4;
/org.eclipse.jdt.core.tests.model/workspace/Converter/src/test0116/Test.java;1;0;1;1;0;0;0;1;0;0;1;3714;0;0;1;0;0;1;1;3714;0;3714;1;1;
/org.eclipse.core.resources/src/org/eclipse/core/internal/indexing/BinarySmallObject.java;1;0;1;1;1;1;1;0;32;0;0;5146;32;32;1;0;0;0;1;5146;0;5146;1;1;
/org.eclipse.ui.workbench/Eclipse UI/org/eclipse/ui/IInPlaceEditor.java;2;0;2;1;0;0;0;2;36;1;2;2083;36;36;1;0;0;2;2;2083;0;2737;2;2;
/org.eclipse.jdt.core.tests.model/workspace/Formatter/test103/A_out.java;1;0;1;1;0;0;0;1;0;0;1;2425;0;0;1;0;0;1;1;2425;0;2425;1;1;
/org.eclipse.jdt.core/compiler/org/eclipse/jdt/internal/compiler/ast/SuperReference.java;2;0;4;1;0;0;0;4;82;1;4;991;90;90;1;0;0;4;4;991;0;4910;4;2;
/org.eclipse.team.ui/src/org/eclipse/team/internal/ui/synchronize/actions/NavigateAction.java;2;2;11;1;5;4;5;6;106;1;6;2561;335;335;2;0;1;6;11;5436;1;6337;10;2;
/org.eclipse.ui.externaltools/Ant Tools Support/org/eclipse/ui/externaltools/internal/ant/preferences/AntPropertiesBlock.java;1;0;1;1;0;0;0;1;0;0;1;282;0;0;1;0;0;1;1;282;0;282;1;1;
/org.eclipse.webdav/src/client/org/eclipse/webdav/client/RemoteDAVClient.java;1;2;3;1;3;2;3;0;329;0;0;5151;383;383;2;0;1;0;3;5151;1;5969;2;1;
/org.eclipse.jdt.ui/ui refactoring/org/eclipse/jdt/internal/ui/refactoring/PromoteTempInputPage.java;2;0;2;1;0;0;0;2;3;1;2;363;3;3;1;0;0;2;2;363;0;518;2;2;
/org.eclipse.team.ui/src/org/eclipse/team/internal/ui/target/GetSyncAction.java;1;0;1;1;0;0;0;1;0;0;1;2495;0;0;1;0;0;1;1;2495;0;2495;1;1;
/org.eclipse.jdt.core.tests.model/workspace/Converter/test0144/Test.java;1;0;1;1;0;0;0;1;0;0;1;3714;0;0;1;0;0;1;1;3714;0;3714;1;1;
/org.eclipse.jdt.core.tests.model/workspace/Formatter/test490/A_out.java;1;0;1;1;1;1;1;0;0;0;0;5188;0;0;1;0;0;0;1;5188;0;5188;1;1;
/org.eclipse.jdt.core.tests.model/workspace/Formatter/test348/A_out.java;1;0;1;1;0;0;0;1;0;0;1;3029;0;0;1;0;0;1;1;3029;0;3029;1;1;
/org.eclipse.jdt.core.tests.model/workspace/TypeHierarchy/src/q3/Z.java;1;0;1;1;0;0;0;1;0;0;1;4211;0;0;1;0;0;1;1;4211;0;4211;1;1;
/org.eclipse.pde.core/src/org/eclipse/pde/internal/core/PDERegistryCacheWriter.java;1;0;2;1;0;0;0;2;7;1;2;4203;7;7;1;0;0;2;2;4203;0;4897;2;1;
/org.eclipse.ant.ui/Remote Ant Support/org/eclipse/ant/internal/ui/antsupport/DemuxInputStreamSetter.java;1;0;1;1;0;0;0;1;0;0;1;3744;0;0;1;0;0;1;1;3744;0;3744;1;1;
/org.eclipse.ui.workbench/Eclipse UI/org/eclipse/ui/internal/CloseEditorAction.java;1;0;1;1;0;0;0;1;3;0;1;2737;3;3;1;0;0;1;1;2737;0;2737;1;1;
/org.eclipse.jdt.launching.macosx/macosx/org/eclipse/jdt/internal/ui/macbundler/BundleDescription.java;1;0;2;1;0;0;0;2;2;1;2;3622;2;2;1;0;0;2;2;3622;0;3895;2;1;
/org.eclipse.ui.ide/extensions/org/eclipse/ui/dialogs/ContainerGenerator.java;3;1;3;1;2;2;2;1;3;0;1;2263;5;5;1;0;0;1;3;2263;0;6338;3;3;
/org.eclipse.jdt.core.tests.model/workspace/Formatter/test335/A_in.java;1;0;1;1;0;0;0;1;0;0;1;2742;0;0;1;0;0;1;1;2742;0;2742;1;1;
/org.eclipse.ui.workbench/Eclipse UI/org/eclipse/ui/internal/chris/roles/api/secondstage/IRoleRegistry.java;1;0;2;1;0;0;0;2;0;0;1;2207;0;0;2;1;0;2;2;2207;1;2207;1;1;
/org.eclipse.ui.workbench/Eclipse UI/org/eclipse/ui/internal/ColorSchemeService.java;4;1;18;2;5;5;5;13;143;2;10;4049;515;515;2;3;0;13;18;4607;3;5463;15;4;
/org.eclipse.text/projection/org/eclipse/jface/text/projection/ProjectionMapping.java;1;1;7;1;6;6;6;1;125;0;1;4516;237;237;1;0;0;1;7;4516;0;6301;7;1;
/org.eclipse.jdt.ui.tests.refactoring/resources/SurroundWithWorkSpace/SurroundWithTests/trycatch_in/TestInitializerThrowsException.java;1;0;1;1;0;0;0;1;2;0;1;845;2;2;1;0;0;1;1;845;0;845;1;1;
/org.eclipse.ui.workbench/Eclipse UI/org/eclipse/ui/internal/roles/RoleEvent.java;1;0;2;1;0;0;0;2;0;1;2;2444;0;0;1;0;0;2;2;2444;0;2805;2;1;
/org.eclipse.search/search/org/eclipse/search/internal/ui/text/ResearchSelectionDialog.java;1;0;2;1;0;0;0;2;0;1;2;2888;0;0;1;0;0;2;2;2888;0;2907;2;1;
/org.eclipse.team.webdav/src/org/eclipse/team/ui/target/subscriber/TargetSubscriberAction.java;1;0;1;1;0;0;0;1;0;0;1;3379;0;0;1;0;0;1;1;3379;0;3379;1;1;
/org.eclipse.pde.core/src/org/eclipse/pde/internal/core/site/WorkspaceSiteModel.java;3;2;6;1;5;4;5;1;16;0;1;2501;35;35;2;0;1;1;6;5799;1;6336;5;3;
/org.eclipse.jdt.core.tests.model/workspace/Converter/src/test0446/A.java;1;0;1;1;0;0;0;1;0;0;1;3714;0;0;1;0;0;1;1;3714;0;3714;1;1;
/org.eclipse.ui.workbench/Eclipse UI/org/eclipse/ui/commands/internal/Context.java;1;0;2;1;0;0;0;2;0;1;2;786;0;0;1;0;0;2;2;786;0;956;2;1;
/org.eclipse.pde.ui/src_Forms/org/eclipse/pde/internal/ui/neweditor/site/NewArchiveDialog.java;2;0;2;1;1;1;1;1;0;0;1;4832;0;0;1;0;0;1;2;4832;0;5431;2;2;
/org.eclipse.jdt.debug.jdi.tests/tests/org/eclipse/debug/jdi/tests/TypeTest.java;1;0;1;1;0;0;0;1;2;0;1;1240;2;2;1;0;0;1;1;1240;0;1240;1;1;
/org.eclipse.pde.ui/src/org/eclipse/pde/internal/ui/editor/schema/SchemaSourcePage.java;1;1;3;1;2;2;2;1;39;0;1;909;59;59;1;0;0;1;3;909;0;6336;3;1;
/org.eclipse.jdt.debug.ui/ui/org/eclipse/jdt/internal/debug/ui/actions/InspectAction.java;3;0;4;1;1;1;1;3;170;2;2;1595;177;177;2;1;0;3;4;3828;1;6336;3;3;
/org.eclipse.core.runtime/src/org/eclipse/core/runtime/preferences/ConfigurationScope.java;2;0;4;1;1;1;1;3;19;1;3;4351;25;25;1;0;0;3;4;4351;0;5541;4;2;
/org.eclipse.update.ui.forms/Eclipse Forms/org/eclipse/ui/forms/widgets/ImageHyperlink.java;1;0;5;1;0;0;0;5;196;2;4;3174;234;234;2;1;0;5;5;3984;1;4157;4;1;
/org.eclipse.jdt.core.tests.compiler/src/org/eclipse/jdt/core/tests/junit/extension/TestCase.java;1;0;3;1;1;1;1;2;30;1;2;3560;55;55;1;0;0;2;3;3560;0;5972;3;1;
/org.eclipse.ui.workbench/Eclipse UI/org/eclipse/ui/internal/contexts/ws/WorkbenchWindowContextActivationService.java;3;0;7;1;0;0;0;7;133;1;7;3109;163;163;1;0;0;7;7;3109;0;4144;7;3;
/org.eclipse.jdt.core.tests.compiler/src/org/eclipse/jdt/core/tests/runtime/LocalVMLauncher.java;4;1;6;1;2;2;2;4;25;1;4;1387;59;59;1;0;0;4;6;1387;0;5853;6;4;
/org.eclipse.pde.ui/src/org/eclipse/pde/internal/ui/editor/feature/URLElementPropertySource.java;2;1;3;1;2;2;2;1;22;0;1;4203;33;33;1;0;0;1;3;4203;0;6336;3;2;
/org.eclipse.swt/Eclipse SWT PI/gtk/org/eclipse/swt/internal/accessibility/gtk/AtkComponentIface.java;4;0;4;1;1;1;1;3;26;1;3;1214;45;45;1;0;0;3;4;1214;0;6352;4;4;
/org.eclipse.jface.text/src/org/eclipse/jface/text/formatter/IContentFormatter.java;2;1;2;1;2;2;2;0;2;0;0;6340;4;4;1;0;0;0;2;6340;0;6357;2;2;
/org.eclipse.jdt.core.tests.model/workspace/Formatter/test378/A_out.java;1;0;2;1;0;0;0;2;1;1;2;3146;1;1;1;0;0;2;2;3146;0;3172;2;1;
/org.eclipse.jdt.ui/core refactoring/org/eclipse/jdt/internal/corext/refactoring/participants/xml/PropertyExpression.java;1;0;3;1;0;0;0;3;3;1;3;1033;3;3;1;0;0;3;3;1033;0;2204;3;1;
/org.eclipse.pde.ui/src/org/eclipse/pde/internal/ui/editor/manifest/SynchronizedStorageDocumentProvider.java;1;0;2;1;1;1;1;1;0;0;1;2320;0;0;1;0;0;1;2;2320;0;5431;2;1;
/org.eclipse.core.resources/src/org/eclipse/core/internal/utils/ObjectMap.java;1;1;3;1;3;3;3;0;462;0;0;5108;490;490;1;0;0;0;3;5108;0;5682;3;1;
/org.eclipse.jdt.ui/ui/org/eclipse/jdt/internal/ui/text/java/JavaTypeCompletionProposal.java;4;1;5;1;2;2;2;3;10;1;3;576;30;30;1;0;0;3;5;576;0;6340;5;4;
/org.eclipse.jdt.ui.tests.refactoring/test cases/org/eclipse/jdt/ui/tests/refactoring/MoveMembersTests.java;5;1;17;2;2;2;2;15;905;2;13;130;2288;2288;2;2;0;15;17;345;2;6340;15;5;
/org.eclipse.jdt.core.tests.model/workspace/Formatter/test241/A_out.java;1;0;1;1;0;0;0;1;0;0;1;2437;0;0;1;0;0;1;1;2437;0;2437;1;1;
/org.eclipse.webdav/src/interface/org/eclipse/webdav/IContext.java;1;0;2;1;2;1;2;0;1763;0;0;5151;1763;1763;2;0;1;0;2;5151;1;5151;1;1;
/org.eclipse.pde.runtime/src/org/eclipse/pde/internal/runtime/logview/FilterDialog.java;2;1;7;1;2;2;2;5;142;2;4;807;212;212;2;1;0;5;7;831;1;6336;6;2;
/org.eclipse.jdt.ui.examples.javafamily/coresearch-experiment/org/eclipse/search/core/Indexer.java;1;0;3;1;0;0;0;3;14;1;3;1380;14;14;1;0;0;3;3;1380;0;3214;3;1;
/org.eclipse.jdt.ui/core extension/org/eclipse/jdt/internal/corext/util/Strings.java;4;0;5;1;1;1;1;4;44;1;4;256;96;96;1;0;0;4;5;256;0;6340;5;4;
/org.eclipse.jdt.debug.tests/tests/org/eclipse/jdt/debug/tests/core/LaunchConfigurationArgumentTests.java;4;1;6;1;2;2;2;4;79;1;4;2166;101;101;1;0;0;4;6;2166;0;6337;6;4;
/org.eclipse.team.cvs.ui/src/org/eclipse/team/internal/ccvs/ui/subscriber/CVSLocalCompareConfiguration.java;2;0;4;1;0;0;0;4;108;1;4;3676;110;110;1;0;0;4;4;3676;0;4518;4;2;
/org.eclipse.jdt.ui.tests.refactoring/resources/MoveMembers/test28/in/A.java;1;0;1;1;0;0;0;1;0;0;1;1522;0;0;1;0;0;1;1;1522;0;1522;1;1;
/org.eclipse.ui.externaltools/Ant Editor/org/eclipse/ui/externaltools/internal/ant/dtd/Parser.java;1;0;1;1;0;0;0;1;0;0;1;282;0;0;1;0;0;1;1;282;0;282;1;1;
/org.eclipse.ui.editors/src/org/eclipse/ui/internal/editors/text/PixelConverter.java;1;0;1;1;1;1;1;0;0;0;0;5501;0;0;1;0;0;0;1;5501;0;5501;1;1;
/org.eclipse.webdav/src/client/org/eclipse/webdav/internal/authentication/AuthorizationAuthority.java;1;0;2;1;2;1;2;0;87;0;0;5151;87;87;2;0;1;0;2;5151;1;5151;1;1;
/org.eclipse.jdt.core.tests.model/workspace/Formatter/test364/A_in.java;1;0;1;1;0;0;0;1;0;0;1;3128;0;0;1;0;0;1;1;3128;0;3128;1;1;
/org.eclipse.jdt.core.tests.model/workspace/Formatter/test498/A_out.java;1;0;1;1;1;1;1;0;0;0;0;5624;0;0;1;0;0;0;1;5624;0;5624;1;1;
/org.eclipse.jdt.ui/core refactoring/org/eclipse/jdt/internal/corext/refactoring/nls/AccessorClass.java;3;1;6;1;5;5;5;1;126;0;1;4930;178;178;1;0;0;1;6;4930;0;6340;6;3;
/org.eclipse.ui.workbench/Eclipse UI/org/eclipse/ui/internal/intro/IIntroRegistry.java;1;0;6;1;1;1;1;5;17;1;5;3632;32;32;1;0;0;5;6;3632;0;5209;6;1;
/org.eclipse.ant.ui/Ant Editor/org/eclipse/ant/ui/internal/editor/text/XMLAnnotationHover.java;1;0;3;1;0;0;0;3;32;1;3;250;32;32;1;0;0;3;3;250;0;1811;3;1;
/org.eclipse.ui.ide/src/org/eclipse/ui/internal/ide/UISynchronizer.java;2;0;5;1;0;0;0;5;2;1;5;1512;4;4;1;0;0;5;5;1512;0;2059;5;2;
/org.eclipse.jdt.debug/model/org/eclipse/jdt/internal/debug/core/model/JDILocalVariable.java;3;1;3;1;2;2;2;1;6;0;1;2497;17;17;1;0;0;1;3;2497;0;6336;3;3;
/org.eclipse.ui.forms.examples/src/org/eclipse/ui/forms/examples/internal/OpenFormEditorAction.java;1;0;2;1;1;1;1;1;10;0;1;4075;10;10;1;0;0;1;2;4075;0;5781;2;1;
/org.eclipse.jdt.core.tests.model/workspace/Formatter/test486/A_out.java;1;0;1;1;1;1;1;0;0;0;0;5132;0;0;1;0;0;0;1;5132;0;5132;1;1;
/org.eclipse.jdt.ui/ui/org/eclipse/jdt/internal/ui/typehierarchy/SelectionProviderMediator.java;2;1;3;1;2;2;2;1;100;0;1;4847;104;104;1;0;0;1;3;4847;0;6340;3;2;
/org.eclipse.swt/Eclipse SWT/gtk/org/eclipse/swt/widgets/WidgetTable.java;1;0;1;1;0;0;0;1;0;0;1;1240;0;0;1;0;0;1;1;1240;0;1240;1;1;
/org.eclipse.team.cvs.ui/src/org/eclipse/team/internal/ccvs/ui/CVSPropertiesPage.java;1;0;1;1;0;0;0;1;318;0;1;442;318;318;1;0;0;1;1;442;0;442;1;1;
/org.eclipse.swt/Eclipse SWT Browser/mozilla/org/eclipse/swt/browser/AppFileLocProvider.java;2;1;5;1;2;2;2;3;49;1;3;1674;89;89;1;0;0;3;5;1674;0;6352;5;2;
/org.eclipse.pde.ui/src/org/eclipse/pde/internal/ui/editor/feature/InfoSection.java;3;2;12;1;6;5;6;6;248;1;6;368;346;346;2;0;1;6;12;5431;1;6336;11;3;
/org.eclipse.jdt.launching/launching/org/eclipse/jdt/internal/launching/JavaSourcePathComputer.java;1;0;3;1;0;0;0;3;13;2;2;4971;13;13;2;1;0;3;3;4971;1;5091;2;1;
/org.eclipse.ant.ui/Ant Editor/org/eclipse/ant/ui/internal/editor/tools/TaskXMLFileMerger.java;1;0;4;1;0;0;0;4;12;1;4;250;20;20;1;0;0;4;4;250;0;1811;4;1;
/org.eclipse.team.ui/src/org/eclipse/team/ui/synchronize/AbstractSynchronizeParticipant.java;2;2;15;2;9;8;9;6;271;1;6;2535;606;606;2;0;1;6;15;5401;1;6333;14;2;
/org.eclipse.pde.ui/src_Forms/org/eclipse/pde/internal/ui/newparts/SharedPart.java;2;0;2;1;1;1;1;1;0;0;1;3795;0;0;1;0;0;1;2;3795;0;5431;2;2;
/org.eclipse.compare.examples.xml/src/org/eclipse/compare/examples/xml/SelectMatcherAction.java;1;0;3;1;0;0;0;3;11;1;3;1106;13;13;1;0;0;3;3;1106;0;3938;3;1;
/org.eclipse.update.ui/src/org/eclipse/update/internal/ui/security/Authentication.java;2;1;2;1;2;2;2;0;4;0;0;5561;4;4;1;0;0;0;2;5561;0;6336;2;2;
/org.eclipse.team.cvs.ui/src/org/eclipse/team/internal/ccvs/ui/operations/CommitOperation.java;1;0;3;1;1;1;1;2;8;1;2;4780;15;15;1;0;0;2;3;4780;0;6067;3;1;
/org.eclipse.swt/Eclipse SWT/common/org/eclipse/swt/events/TypedEvent.java;1;0;1;1;0;0;0;1;28;0;1;2729;28;28;1;0;0;1;1;2729;0;2729;1;1;
/org.eclipse.ui.workbench/Eclipse UI/org/eclipse/ui/actions/NewProjectAction.java;1;0;1;1;0;0;0;1;0;0;1;2737;0;0;1;0;0;1;1;2737;0;2737;1;1;
/org.eclipse.jdt.core/compiler/org/eclipse/jdt/internal/compiler/ast/AnnotationTypeMemberDeclaration.java;1;0;1;1;0;0;0;1;0;0;1;4473;0;0;1;0;0;1;1;4473;0;4473;1;1;
/org.eclipse.update.core/srcnew/org/eclipse/update/operations/IConfigFeatureOperation.java;1;0;2;1;0;0;0;2;0;1;2;602;0;0;1;0;0;2;2;602;0;825;2;1;
/org.eclipse.update.ui/src/org/eclipse/update/internal/ui/search/UnifiedSearchCategory.java;1;0;2;1;0;0;0;2;0;1;2;200;0;0;1;0;0;2;2;200;0;369;2;1;
/org.eclipse.jdt.ui/ui/org/eclipse/jdt/internal/ui/typehierarchy/HistoryDropDownAction.java;2;0;2;1;1;1;1;1;2;0;1;3575;4;4;1;0;0;1;2;3575;0;6340;2;2;
/org.eclipse.jdt.core.tests.model/workspace/Converter/test0454/A.java;1;0;1;1;0;0;0;1;0;0;1;3714;0;0;1;0;0;1;1;3714;0;3714;1;1;
/org.eclipse.jdt.ui.tests.refactoring/resources/Copy/test_type_yes_cu/out/A.java;1;0;2;1;0;0;0;2;0;1;2;696;0;0;1;0;0;2;2;696;0;1009;2;1;
/org.eclipse.update/src/org/eclipse/update/internal/core/UMSessionManagerParcel.java;1;0;1;1;1;1;1;0;0;0;0;6339;0;0;1;0;0;0;1;6339;0;6339;1;1;
/org.eclipse.team.tests.cvs.core/src/org/eclipse/team/tests/ccvs/core/provider/RemoteResourceTest.java;2;0;7;1;1;1;1;6;37;1;6;994;148;148;1;0;0;6;7;994;0;6337;7;2;
/org.eclipse.jdt.ui.tests.refactoring/resources/ExtractMethodWorkSpace/ExtractMethodTests/validSelection_in/A_test362.java;1;0;2;1;0;0;0;2;4;1;2;130;8;8;1;0;0;2;2;130;0;844;2;1;
/org.eclipse.ui.workbench/Eclipse UI/org/eclipse/ui/part/MultiPageEditor.java;1;0;1;1;0;0;0;1;2;0;1;1;2;2;1;0;0;1;1;1;0;1;1;1;
/org.eclipse.ui.workbench/Eclipse UI/org/eclipse/ui/commands/internal/Point.java;1;0;2;1;0;0;0;2;0;1;2;786;0;0;1;0;0;2;2;786;0;956;2;1;
/org.eclipse.jdt.core.tests.model/workspace/Formatter/test100/A_in.java;1;0;1;1;0;0;0;1;0;0;1;2425;0;0;1;0;0;1;1;2425;0;2425;1;1;
/org.eclipse.core.resources/src/org/eclipse/core/internal/resources/ModelObject.java;1;0;2;1;1;1;1;1;35;0;1;3063;44;44;1;0;0;1;2;3063;0;5146;2;1;
/org.eclipse.team.webdav/src/org/eclipse/team/internal/webdav/subscriber/WebDavResourceVariantFactory.java;1;0;1;1;0;0;0;1;0;0;1;4208;0;0;1;0;0;1;1;4208;0;4208;1;1;
/org.eclipse.update.core/src/org/eclipse/update/internal/configuration/ConfigurationPolicy.java;1;0;1;1;0;0;0;1;0;0;1;2828;0;0;1;0;0;1;1;2828;0;2828;1;1;
/org.eclipse.jdt.core.tests.model/workspace/Formatter/test123/A_in.java;1;0;1;1;0;0;0;1;0;0;1;2425;0;0;1;0;0;1;1;2425;0;2425;1;1;
/org.eclipse.team.ui/src/org/eclipse/team/internal/ui/target/ProjectTargetMappingPropertiesPage.java;2;0;2;1;0;0;0;2;3;1;2;2381;3;3;1;0;0;2;2;2381;0;2495;2;2;
/org.eclipse.jface.text/src/org/eclipse/jface/text/source/ILineRange.java;2;1;3;1;3;3;3;0;6;0;0;5099;8;8;1;0;0;0;3;5099;0;6361;3;2;
/org.eclipse.jdt.ui.tests.refactoring/resources/ConvertAnonymousToNested/canConvert/A_test21_out.java;1;0;1;1;0;0;0;1;0;0;1;3195;0;0;1;0;0;1;1;3195;0;3195;1;1;
/org.eclipse.jdt.ui.tests.refactoring/resources/IntroduceParameter/simple/NewInstanceImport.java;1;0;1;1;0;0;0;1;0;0;1;2281;0;0;1;0;0;1;1;2281;0;2281;1;1;
/org.eclipse.help/src/org/eclipse/help/internal/context/Context.java;1;2;5;1;5;4;5;0;21;0;0;5404;49;49;2;0;1;0;5;5404;1;6337;4;1;
/org.eclipse.jdt.ui.tests.refactoring/resources/ExtractMethodWorkSpace/ExtractMethodTests/return_in/A_test720.java;1;0;1;1;0;0;0;1;4;0;1;844;4;4;1;0;0;1;1;844;0;844;1;1;
/org.eclipse.ui.externaltools/Ant Editor/org/eclipse/ui/externaltools/internal/ant/editor/PlantySaxDefaultHandler.java;1;0;2;1;0;0;0;2;2;1;2;34;2;2;1;0;0;2;2;34;0;178;2;1;
/org.eclipse.jdt.debug.ui/ui/org/eclipse/jdt/internal/debug/ui/ErrorDialogWithToggle.java;1;0;2;1;0;0;0;2;10;1;2;268;14;14;1;0;0;2;2;268;0;2066;2;1;
/org.eclipse.ui.console/src/org/eclipse/ui/console/actions/TextViewerGotoLineAction.java;2;0;2;1;0;0;0;2;8;1;2;1988;8;8;1;0;0;2;2;1988;0;2108;2;2;
/org.eclipse.jdt.ui/ui/org/eclipse/jdt/internal/ui/search/LRUWorkingSetsList.java;2;1;2;1;2;2;2;0;2;0;0;5396;3;3;1;0;0;0;2;5396;0;6340;2;2;
/org.eclipse.swt.examples/src/org/eclipse/swt/examples/hoverhelp/HoverHelp.java;1;0;2;1;0;0;0;2;7;1;2;89;14;14;1;0;0;2;2;89;0;104;2;1;
/org.eclipse.jdt.ui/ui/org/eclipse/jdt/internal/ui/search/ColorDecoratingLabelProvider.java;1;0;1;1;1;1;1;0;0;0;0;6037;0;0;1;0;0;0;1;6037;0;6037;1;1;
/org.eclipse.swt/Eclipse SWT Mozilla/common/org/eclipse/swt/internal/mozilla/nsISupports.java;1;0;1;1;0;0;0;1;0;0;1;1654;0;0;1;0;0;1;1;1654;0;1654;1;1;
/org.eclipse.ui.workbench/Eclipse UI/org/eclipse/example/ExampleWorkbenchAdviser.java;1;0;1;1;0;0;0;1;0;0;1;1259;0;0;1;0;0;1;1;1259;0;1259;1;1;
/org.eclipse.update.core/src/org/eclipse/update/internal/operations/OperationFactory.java;2;0;7;1;1;1;1;6;11;1;6;825;31;31;1;0;0;6;7;825;0;6336;7;2;
/org.eclipse.ui.examples.javaeditor/Template Editor Example/org/eclipse/ui/examples/templateeditor/editors/NonRuleBasedDamagerRepairer.java;2;0;2;1;1;1;1;1;10;0;1;4644;10;10;1;0;0;1;2;4644;0;6340;2;2;
/org.eclipse.ui.workbench/Eclipse UI/org/eclipse/ui/model/BaseWorkbenchContentProvider.java;2;0;2;1;0;0;0;2;104;1;2;2611;104;104;1;0;0;2;2;2611;0;2737;2;2;
/org.eclipse.osgi/eclipseAdaptor/src/org/eclipse/core/runtime/adaptor/EclipseCommandProvider.java;3;2;13;1;7;5;7;6;31;1;6;3773;129;129;2;0;2;6;13;5271;2;6133;11;3;
/org.eclipse.jdt.ui/core refactoring/org/eclipse/jdt/internal/corext/refactoring/structure/ConstructorReferenceFinder.java;3;1;9;1;4;4;4;5;209;1;5;244;412;412;1;0;0;5;9;244;0;6340;9;3;
/org.eclipse.ui.ide/src/org/eclipse/ui/internal/ide/IDEWorkbenchActivityHelper.java;5;1;8;1;2;2;2;6;69;1;6;2707;220;220;1;0;0;6;8;2707;0;6338;8;5;
/org.eclipse.ui.workbench/Eclipse UI/org/eclipse/ui/commands/IWorkbenchPartSiteCommandSupport.java;1;0;4;1;0;0;0;4;11;2;3;3129;13;13;2;1;0;4;4;3129;1;4144;3;1;
/org.eclipse.ui.workbench/Eclipse UI/org/eclipse/ui/internal/commands/XKeyFilter.java;1;0;2;1;0;0;0;2;0;1;2;1695;0;0;1;0;0;2;2;1695;0;1715;2;1;
/org.eclipse.ui.workbench.texteditor/src/org/eclipse/ui/texteditor/IncrementalFindAction.java;2;2;3;2;3;2;3;0;6;0;0;5123;10;10;2;0;1;0;3;6334;1;6334;2;2;
/org.eclipse.text/src/org/eclipse/jface/text/link/LinkedPositionGroup.java;2;2;7;2;6;4;6;1;128;0;1;4214;270;270;2;0;2;1;7;5105;2;6340;5;2;
/org.eclipse.ltk.ui.refactoring/src/org/eclipse/ltk/internal/ui/refactoring/TextEditChangeElement.java;1;1;5;1;3;3;3;2;31;1;2;4965;43;43;1;0;0;2;5;4965;0;6340;5;1;
/org.eclipse.jdt.ui/core refactoring/org/eclipse/jdt/internal/corext/refactoring/reorg/ReorgUtils2.java;1;0;2;1;0;0;0;2;0;1;2;1114;0;0;1;0;0;2;2;1114;0;1126;2;1;
/org.eclipse.debug.ui/ui/org/eclipse/debug/internal/ui/actions/ConvertToWatchExpressionAction.java;1;0;2;1;0;0;0;2;4;1;2;1516;4;4;1;0;0;2;2;1516;0;1524;2;1;
/org.eclipse.ant.ui/Ant Tools Support/org/eclipse/ant/internal/ui/launchConfigurations/AntClasspathTab.java;2;0;21;1;1;1;1;20;235;2;17;1811;552;552;2;3;0;20;21;2139;3;5805;18;2;
/org.eclipse.ui.workbench/Eclipse UI/org/eclipse/ui/part/FileEditorInputFactory.java;2;0;2;1;0;0;0;2;86;1;2;826;86;86;1;0;0;2;2;826;0;2737;2;2;
/org.eclipse.jdt.ui.examples.projects/examples/org/eclipse/jdt/internal/ui/exampleprojects/ExampleProjectCreationOperation.java;2;0;3;1;1;1;1;2;19;1;2;4061;22;22;1;0;0;2;3;4061;0;6340;3;2;
/org.eclipse.jdt.core/compiler/org/eclipse/jdt/internal/compiler/impl/ReferenceContext.java;2;0;2;1;1;1;1;1;3;0;1;3560;5;5;1;0;0;1;2;3560;0;5615;2;2;
/org.eclipse.ui.workbench/Eclipse UI/org/eclipse/ui/internal/commands/FileRegistry.java;1;0;5;1;0;0;0;5;28;2;3;1356;35;35;2;2;0;5;5;1356;2;1389;3;1;
/org.eclipse.jdt.debug.ui/ui/org/eclipse/jdt/internal/debug/ui/actions/BreakpointFieldLocator.java;1;0;1;1;0;0;0;1;0;0;1;1739;0;0;1;0;0;1;1;1739;0;1739;1;1;
/org.eclipse.ui.workbench/Eclipse UI/org/eclipse/ui/internal/csm/roles/RoleActivationService.java;1;0;2;1;0;0;0;2;0;1;2;2213;0;0;1;0;0;2;2;2213;0;2225;2;1;
/org.eclipse.search/search/org/eclipse/search/internal/ui/util/RowLayouter.java;1;0;1;1;1;1;1;0;2;0;0;6340;2;2;1;0;0;0;1;6340;0;6340;1;1;
/org.eclipse.core.resources/src/org/eclipse/core/internal/resources/Workspace.java;3;3;54;2;14;12;14;40;4185;2;36;178;9520;9520;3;4;2;40;54;5442;6;5946;48;3;
/org.eclipse.swt/Eclipse SWT/photon/org/eclipse/swt/widgets/List.java;4;1;7;1;2;2;2;5;75;1;5;110;164;164;1;0;0;5;7;110;0;6352;7;4;
/org.eclipse.jdt.debug.ui/ui/org/eclipse/jdt/internal/debug/ui/actions/JavaBreakpointPropertiesAction.java;1;0;2;1;0;0;0;2;23;1;2;1358;28;28;1;0;0;2;2;1358;0;1484;2;1;
/org.eclipse.team.core/src/org/eclipse/team/core/IDeploymentProviderManager.java;1;0;3;1;0;0;0;3;94;1;3;2793;94;94;1;0;0;3;3;2793;0;4633;3;1;
/org.eclipse.jdt.core/compiler/org/eclipse/jdt/internal/compiler/ast/AND_AND_Expression.java;2;0;7;1;0;0;0;7;384;2;6;693;404;404;2;1;0;7;7;3062;1;3560;6;2;
/org.eclipse.jdt.core.tests.model/workspace/Converter/src/test0032/Test.java;1;0;1;1;0;0;0;1;0;0;1;3714;0;0;1;0;0;1;1;3714;0;3714;1;1;
/org.eclipse.compare/compare/org/eclipse/compare/internal/merge/LineComparator.java;1;1;2;1;2;2;2;0;8;0;0;5165;8;8;1;0;0;0;2;5165;0;5199;2;1;
/org.eclipse.jdt.core/model/org/eclipse/jdt/core/util/IVerificationTypeInfo.java;2;0;2;1;0;0;0;2;68;1;2;3791;68;68;1;0;0;2;2;3791;0;4843;2;2;
/org.eclipse.team.examples.filesystem/src/org/eclipse/team/examples/filesystem/FileSystemRemoteResource.java;2;0;5;1;0;0;0;5;35;1;5;917;90;90;1;0;0;5;5;917;0;4368;5;2;
/org.eclipse.team.tests.cvs.core/src/org/eclipse/team/tests/ccvs/core/EclipseTest.java;2;2;30;2;5;4;5;25;98;2;23;790;743;743;2;2;1;25;30;2863;3;6337;27;2;
/org.eclipse.jdt.core.tests.model/src/org/eclipse/jdt/core/tests/model/TestProgressMonitor.java;1;0;1;1;0;0;0;1;2;0;1;3560;2;2;1;0;0;1;1;3560;0;3560;1;1;
/org.eclipse.debug.ui/ui/org/eclipse/debug/internal/ui/actions/ProfileAsAction.java;1;0;1;1;0;0;0;1;0;0;1;472;0;0;1;0;0;1;1;472;0;472;1;1;
/org.eclipse.pde.ui/src_Forms/org/eclipse/pde/internal/ui/neweditor/feature/AdvancedForm.java;1;0;2;1;0;0;0;2;0;0;1;4926;0;0;2;1;0;2;2;4926;1;4926;1;1;
/org.eclipse.ant.ui/Ant Tools Support/org/eclipse/ant/ui/internal/views/AntView.java;1;0;5;1;0;0;0;5;20;2;4;250;23;23;2;1;0;5;5;263;1;1811;4;1;
/org.eclipse.osgi/core/adaptor/org/eclipse/osgi/framework/adaptor/core/AbstractBundleData.java;2;0;2;1;0;0;0;2;0;1;2;3013;0;0;1;0;0;2;2;3013;0;4336;2;2;
/org.eclipse.ui.workbench/Eclipse UI/org/eclipse/ui/internal/progress/ProgressManagerUtil.java;5;3;23;2;17;13;17;6;267;2;5;2842;767;767;3;1;4;6;23;6077;5;6338;18;5;
/org.eclipse.ui.examples.javaeditor/Eclipse Java Editor Example/org/eclipse/ui/examples/javaeditor/util/JavaColorProvider.java;1;0;1;1;1;1;1;0;2;0;0;6340;2;2;1;0;0;0;1;6340;0;6340;1;1;
/org.eclipse.ant.ui/Ant Tools Support/org/eclipse/ant/internal/ui/views/actions/RemoveProjectAction.java;1;0;2;1;0;0;0;2;4;1;2;1811;4;4;1;0;0;2;2;1811;0;1861;2;1;
/org.eclipse.team.core/src/org/eclipse/team/core/synchronize/ISubscriberResource.java;1;0;1;1;0;0;0;1;0;0;1;4045;0;0;1;0;0;1;1;4045;0;4045;1;1;
/org.eclipse.jdt.core/model/org/eclipse/jdt/core/util/ILineNumberAttribute.java;1;0;1;1;0;0;0;1;2;0;1;3560;2;2;1;0;0;1;1;3560;0;3560;1;1;
/org.eclipse.core.runtime.osgi/src/org/eclipse/core/runtime/IAdapterManager.java;1;0;2;1;0;0;0;2;104;1;2;3013;104;104;1;0;0;2;2;3013;0;3030;2;1;
/org.eclipse.text/src/org/eclipse/jface/text/templates/GlobalTemplateVariables.java;3;1;4;1;4;4;4;0;16;0;0;5177;21;21;1;0;0;0;4;5177;0;6340;4;3;
/org.eclipse.ant.ui/Ant Editor/org/eclipse/ant/ui/internal/dtd/util/AntDTDUtilMessages.java;1;0;2;1;0;0;0;2;0;1;2;250;0;0;1;0;0;2;2;250;0;1811;2;1;
/org.eclipse.ui.workbench/Eclipse UI/org/eclipse/ui/internal/misc/CheckboxTreeAndListGroup.java;1;0;1;1;0;0;0;1;0;0;1;2737;0;0;1;0;0;1;1;2737;0;2737;1;1;
/org.eclipse.jdt.debug.ui/ui/org/eclipse/jdt/internal/debug/ui/launcher/VMLibraryBlock.java;2;0;2;1;0;0;0;2;2;1;2;685;2;2;1;0;0;2;2;685;0;1039;2;2;
/org.eclipse.ui.tests/Eclipse UI Tests/org/eclipse/ui/tests/dialogs/UIEditWorkingSetWizardAuto.java;3;0;3;2;0;0;0;3;11;2;2;374;18;18;2;1;0;3;3;374;1;3091;2;3;
/org.eclipse.text/src/org/eclipse/jface/text/SlaveDocumentEvent.java;1;0;1;1;1;1;1;0;4;0;0;6298;4;4;1;0;0;0;1;6298;0;6298;1;1;
/org.eclipse.team.core/src/org/eclipse/team/core/subscribers/TeamSubscriber.java;2;0;14;2;0;0;0;14;286;2;13;770;438;438;2;1;0;14;14;2460;1;4216;13;2;
/org.eclipse.update.core/src/org/eclipse/update/core/ContentReference.java;4;1;8;1;3;3;3;5;37;1;5;0;88;88;1;0;0;5;8;0;0;6336;8;4;
/org.eclipse.jdt.ui/ui/org/eclipse/jdt/internal/ui/text/spelling/engine/ISpellCheckIterator.java;2;0;2;1;1;1;1;1;2;0;1;3930;2;2;1;0;0;1;2;3930;0;6340;2;2;
/org.eclipse.ui.console/src/org/eclipse/ui/internal/console/MessageConsoleStream.java;1;0;2;1;0;0;0;2;0;0;1;1988;0;0;2;1;0;2;2;1988;1;1988;1;1;
/org.eclipse.ui.tests/Eclipse UI Tests/org/eclipse/ui/tests/dnd/DragTest.java;2;1;6;1;5;5;5;1;54;0;1;5007;90;90;1;0;0;1;6;5007;0;6101;6;2;
/org.eclipse.ui.cheatsheets/src/org/eclipse/ui/internal/cheatsheets/views/WizardReturnCodeHack.java;2;0;3;1;0;0;0;3;16;1;3;4428;16;16;1;0;0;3;3;4428;0;4701;3;2;
/org.eclipse.jdt.core.tests.model/workspace/Converter/test0343/Test.java;1;0;1;1;0;0;0;1;0;0;1;3714;0;0;1;0;0;1;1;3714;0;3714;1;1;
/org.eclipse.pde.ui/src/org/eclipse/pde/internal/ui/wizards/templates/DefaultPluginTemplateWizard.java;1;0;1;1;0;0;0;1;0;0;1;3986;0;0;1;0;0;1;1;3986;0;3986;1;1;
/org.eclipse.jdt.core.tests.model/workspace/Converter/src/javadoc/testBug48489/TestA.java;1;0;2;1;0;0;0;2;2;1;2;3890;2;2;1;0;0;2;2;3890;0;3899;2;1;
/org.eclipse.ui.workbench/Eclipse UI/org/eclipse/ui/internal/csm/commands/Category.java;1;0;2;1;0;0;0;2;0;1;2;2549;0;0;1;0;0;2;2;2549;0;2562;2;1;
/org.eclipse.pde.ui/src_Forms/org/eclipse/pde/internal/ui/model/XMLEditingModel.java;2;1;9;1;7;7;7;2;25;1;2;4438;92;92;1;0;0;2;9;4438;0;6336;9;2;
/org.eclipse.jdt.debug/eval/org/eclipse/jdt/internal/debug/eval/ast/instructions/BinaryOperator.java;1;0;1;1;0;0;0;1;14;0;1;1276;14;14;1;0;0;1;1;1276;0;1276;1;1;
/org.eclipse.jdt.core.tests.model/workspace/Converter/src/test0503/A.java;1;0;1;1;0;0;0;1;0;0;1;3714;0;0;1;0;0;1;1;3714;0;3714;1;1;
/org.eclipse.ui.workbench/Eclipse UI/org/eclipse/ui/commands/old/ICommandManager.java;1;0;1;1;0;0;0;1;0;0;1;1222;0;0;1;0;0;1;1;1222;0;1222;1;1;
/org.eclipse.update.ui/srcnew/org/eclipse/update/internal/ui/wizards/NewSiteDialog.java;2;0;6;2;0;0;0;6;33;2;5;478;54;54;2;1;0;6;6;617;1;705;5;2;
/org.eclipse.jdt.core.tests.model/workspace/Converter/test0351/Test2.java;1;0;1;1;0;0;0;1;0;0;1;3714;0;0;1;0;0;1;1;3714;0;3714;1;1;
/org.eclipse.jdt.ui.tests.refactoring/resources/MoveInnerToTopLevel/test_nonstatic_13/out/Inner.java;2;0;2;1;1;1;1;1;2;0;1;305;4;4;1;0;0;1;2;305;0;5854;2;2;
/org.eclipse.jdt.core.tests.model/workspace/Converter/src/javadoc/test100/TestD1.java;1;0;1;1;0;0;0;1;0;0;1;4390;0;0;1;0;0;1;1;4390;0;4390;1;1;
/org.eclipse.update/src/org/eclipse/update/internal/ui/UMWizardProductComponentUpdate.java;1;0;1;1;1;1;1;0;0;0;0;6339;0;0;1;0;0;0;1;6339;0;6339;1;1;
/org.eclipse.debug.ui/ui/org/eclipse/debug/ui/actions/LaunchAsAction.java;4;1;9;1;3;3;3;6;36;1;6;472;121;121;1;0;0;6;9;472;0;6336;9;4;
/org.eclipse.jdt.ui.tests.refactoring/resources/MoveMembers/test0/out/B.java;1;0;1;1;0;0;0;1;1;0;1;1522;1;1;1;0;0;1;1;1522;0;1522;1;1;
/org.eclipse.debug.core/core/org/eclipse/debug/internal/core/SystemVariableResolver.java;2;1;2;1;2;2;2;0;15;0;0;5229;15;15;1;0;0;0;2;5229;0;5475;2;2;
/org.eclipse.swt/Eclipse SWT Printing/win32/org/eclipse/swt/printing/Printer.java;2;1;8;1;3;3;3;5;11;1;5;332;39;39;1;0;0;5;8;332;0;6352;8;2;
/org.eclipse.jdt.core.tests.model/workspace/Converter/src/test0210/Test.java;1;0;1;1;0;0;0;1;0;0;1;3714;0;0;1;0;0;1;1;3714;0;3714;1;1;
/org.eclipse.ui.workbench/Eclipse UI/org/eclipse/ui/internal/activities/MutableActivityService.java;1;0;4;1;0;0;0;4;4;2;3;2800;5;5;2;1;0;4;4;2800;1;2896;3;1;
/org.eclipse.jdt.ui/core refactoring/org/eclipse/jdt/internal/corext/refactoring/rename/TempOccurrenceFinder.java;1;0;1;1;0;0;0;1;0;0;1;4605;0;0;1;0;0;1;1;4605;0;4605;1;1;
/org.eclipse.core.runtime/src/org/eclipse/core/internal/boot/PlatformURLHandler.java;4;1;7;1;3;3;3;4;148;1;4;3049;198;198;1;0;0;4;7;3049;0;5543;7;4;
/org.eclipse.jdt.core.tests.model/workspace/Formatter/test064/A_out.java;1;0;1;1;0;0;0;1;0;0;1;2425;0;0;1;0;0;1;1;2425;0;2425;1;1;
/org.eclipse.ui.console/src/org/eclipse/ui/internal/console/ConsolePlugin.java;1;0;2;1;0;0;0;2;0;1;2;1915;0;0;1;0;0;2;2;1915;0;1988;2;1;
/org.eclipse.swt/Eclipse SWT/gtk/org/eclipse/swt/graphics/GCData.java;5;0;7;1;1;1;1;6;10;1;6;0;23;23;1;0;0;6;7;0;0;6352;7;5;
/org.eclipse.jdt.ui.tests.refactoring/resources/ExtractMethodWorkSpace/ExtractMethodTests/wiki_in/A_test2001.java;1;0;1;1;0;0;0;1;4;0;1;844;4;4;1;0;0;1;1;844;0;844;1;1;
/org.eclipse.jdt.ui.tests.refactoring/resources/ExtractMethodWorkSpace/ExtractMethodTests/branch_out/A_test755.java;1;0;4;1;0;0;0;4;6;1;4;844;6;6;1;0;0;4;4;844;0;2256;4;1;
/org.eclipse.jdt.core.tests.model/workspace/Formatter/test219/A_in.java;1;0;1;1;0;0;0;1;0;0;1;2426;0;0;1;0;0;1;1;2426;0;2426;1;1;
/org.eclipse.jdt.core.tests.model/workspace/Converter/src/test0008/Test.java;1;0;1;1;0;0;0;1;0;0;1;3714;0;0;1;0;0;1;1;3714;0;3714;1;1;
/org.eclipse.jdt.core.tests.model/workspace/Formatter/test255/A_in.java;1;0;1;1;0;0;0;1;0;0;1;2442;0;0;1;0;0;1;1;2442;0;2442;1;1;
/org.eclipse.pde.ui/src_Forms/org/eclipse/pde/internal/ui/neweditor/plugin/rows/ResourceAttributeRow.java;2;1;3;1;2;2;2;1;3;0;1;4354;3;3;1;0;0;1;3;4354;0;5431;3;2;
/org.eclipse.releng.basebuilder/plugins/org.eclipse.build.tools/src/org/eclipse/releng/generators/PlatformStatus.java;1;0;1;1;0;0;0;1;10;0;1;3597;10;10;1;0;0;1;1;3597;0;3597;1;1;
/org.eclipse.jdt.debug.tests/tests/org/eclipse/jdt/debug/tests/core/StratumTests.java;2;0;2;1;0;0;0;2;59;1;2;2176;59;59;1;0;0;2;2;2176;0;2230;2;2;
/org.eclipse.core.tests.resources/src/org/eclipse/core/tests/resources/usecase/IResourceTest.java;1;0;2;1;2;1;2;0;61;0;0;5147;61;61;2;0;1;0;2;5147;1;5147;1;1;
/org.eclipse.ui.workbench/Eclipse UI/org/eclipse/ui/IWorkbenchActionConstants.java;8;2;14;2;4;3;4;10;122;1;10;1;167;167;2;0;1;10;14;6338;1;6338;13;8;
/org.eclipse.jdt.core.tests.model/workspace/Formatter/test134/A_in.java;1;0;1;1;0;0;0;1;0;0;1;2425;0;0;1;0;0;1;1;2425;0;2425;1;1;
/org.eclipse.debug.ui/ui/org/eclipse/debug/internal/ui/sourcelookup/ISourceContainerBrowser.java;2;0;6;1;0;0;0;6;15;1;6;3770;31;31;1;0;0;6;6;3770;0;4970;6;2;
/org.eclipse.jdt.core/model/org/eclipse/jdt/core/ICodeFormatter.java;3;0;6;2;0;0;0;6;6;3;4;822;11;11;3;2;0;6;6;822;2;3560;4;3;
/org.eclipse.compare.examples.xml/src/org/eclipse/compare/examples/xml/ChooseMatcherDropDownAction.java;1;0;2;1;0;0;0;2;2;1;2;1106;2;2;1;0;0;2;2;1106;0;3938;2;1;
/org.eclipse.jdt.ui.tests.refactoring/resources/Delete/testDeleteWithinCu18/in/A.java;1;0;1;1;0;0;0;1;0;0;1;442;0;0;1;0;0;1;1;442;0;442;1;1;
/org.eclipse.jdt.core.tests.model/workspace/Formatter/test062/A_in.java;1;0;1;1;0;0;0;1;0;0;1;2425;0;0;1;0;0;1;1;2425;0;2425;1;1;
/org.eclipse.ua.tests/src/org/eclipse/ui/examples/cheatsheets/pattern/listeners/PatternItemListener.java;1;0;1;1;1;1;1;0;0;0;0;6081;0;0;1;0;0;0;1;6081;0;6081;1;1;
/org.eclipse.jdt.ui.tests.refactoring/resources/InlineMethodWorkspace/TestCases/argument_in/TestLiteralReferenceWrite.java;1;0;1;1;0;0;0;1;2;0;1;845;2;2;1;0;0;1;1;845;0;845;1;1;
/org.eclipse.pde.runtime/src/org/eclipse/pde/internal/runtime/logview/LogViewLabelProvider.java;2;1;5;1;2;2;2;3;21;1;3;831;38;38;1;0;0;3;5;831;0;6336;5;2;
/org.eclipse.ui.workbench.texteditor/src/org/eclipse/ui/texteditor/MarkRegionTarget.java;2;1;3;1;2;2;2;1;6;0;1;4689;9;9;1;0;0;1;3;4689;0;6340;3;2;
/org.eclipse.pde.ui/src_Forms/org/eclipse/pde/internal/ui/neweditor/plugin/ExtensionPointsSection.java;3;1;13;1;2;2;2;11;214;2;10;3812;295;295;2;1;0;11;13;4972;1;5431;12;3;
/org.eclipse.ui.workbench/Eclipse UI/org/eclipse/ui/commands/internal/Sequence.java;1;0;2;1;0;0;0;2;0;1;2;786;0;0;1;0;0;2;2;786;0;956;2;1;
/org.eclipse.debug.core/core/org/eclipse/debug/core/model/IWatchExpressionResult.java;4;1;5;1;2;2;2;3;6;1;3;1516;13;13;1;0;0;3;5;1516;0;6336;5;4;
/org.eclipse.jdt.core.tests.model/workspace/Formatter/test332/A_out.java;1;0;1;1;0;0;0;1;0;0;1;2640;0;0;1;0;0;1;1;2640;0;2640;1;1;
/org.eclipse.ltk.core.refactoring/src/org/eclipse/ltk/core/refactoring/participants/DeleteProcessor.java;1;1;5;1;3;3;3;2;17;1;2;4845;47;47;1;0;0;2;5;4845;0;6340;5;1;
/org.eclipse.team.webdav/src/org/eclipse/team/internal/target/subscriber/ITeamStatus.java;1;0;1;1;0;0;0;1;0;0;1;3494;0;0;1;0;0;1;1;3494;0;3494;1;1;
/org.eclipse.help.base/src/org/eclipse/help/internal/search/SearchManager.java;1;1;13;1;7;7;7;6;103;2;4;1740;353;353;2;2;0;6;13;1740;2;6337;11;1;
/org.eclipse.sdk.tests-feature/plugins/org.eclipse.perfmsr.core/src/org/eclipse/perfmsr/core/Misc.java;2;1;3;1;2;2;2;1;10;0;1;4845;12;12;1;0;0;1;3;4845;0;6342;3;2;
/org.eclipse.jdt.ui/core refactoring/org/eclipse/jdt/internal/corext/refactoring/reorg2/ReorgMoveWizard.java;2;0;6;1;0;0;0;6;16;3;4;802;28;28;3;2;0;6;6;1111;2;1111;4;2;
/org.eclipse.update.core/srcnew/org/eclipse/update/internal/operations/OperationFactory.java;1;0;3;1;0;0;0;3;14;1;3;617;14;14;1;0;0;3;3;617;0;825;3;1;
/org.eclipse.jdt.ui/ui/org/eclipse/jdt/internal/ui/wizards/buildpaths/OutputLocationDialog.java;3;0;4;1;1;1;1;3;4;1;3;1350;10;10;1;0;0;3;4;1350;0;6340;4;3;
/org.eclipse.core.runtime/src/org/eclipse/core/runtime/content/IContentDescription.java;3;1;10;1;7;7;7;3;64;1;3;4574;163;163;1;0;0;3;10;4574;0;5918;10;3;
/org.eclipse.ui.workbench/Eclipse UI/org/eclipse/ui/internal/themes/TabThemeDescriptor.java;2;0;2;1;0;0;0;2;0;1;2;3684;0;0;1;0;0;2;2;3684;0;4471;2;2;
/org.eclipse.jdt.ui/ui/org/eclipse/jdt/internal/ui/compare/TextMergeViewerCreator.java;1;0;1;1;1;1;1;0;2;0;0;6340;2;2;1;0;0;0;1;6340;0;6340;1;1;
/org.eclipse.jdt.ui.tests.refactoring/resources/ExtractTemp/canExtract/A_test82_in.java;1;0;1;1;1;1;1;0;0;0;0;6051;0;0;1;0;0;0;1;6051;0;6051;1;1;
/org.eclipse.ui.intro/src/org/eclipse/ui/internal/intro/impl/model/loader/ExtensionPointManager.java;1;2;4;1;4;3;4;0;6;0;0;5115;8;8;2;0;1;0;4;5905;1;5905;3;1;
/org.eclipse.jdt.ui.tests.refactoring/resources/SurroundWithWorkSpace/SurroundWithTests/trycatch_out/TestSimple.java;1;0;1;1;0;0;0;1;6;0;1;845;6;6;1;0;0;1;1;845;0;845;1;1;
/org.eclipse.jdt.ui/ui/org/eclipse/jdt/internal/ui/search/JavaSearchMarkerUpdater.java;2;1;3;1;3;3;3;0;15;0;0;5396;21;21;1;0;0;0;3;5396;0;6340;3;2;
/org.eclipse.jdt.ui/ui/org/eclipse/jdt/internal/ui/reorg/DualReorgAction.java;1;0;1;1;0;0;0;1;0;0;1;1111;0;0;1;0;0;1;1;1111;0;1111;1;1;
/org.eclipse.pde.ui/sandbox/org/eclipse/pde/internal/ui/editor/standalone/parser/XEParseException.java;1;0;2;1;0;0;0;2;0;1;2;2320;0;0;1;0;0;2;2;2320;0;2931;2;1;
/org.eclipse.ui.workbench/Eclipse UI/org/eclipse/ui/internal/csm/activities/Persistence.java;1;0;7;1;0;0;0;7;89;3;5;2225;130;130;3;2;0;7;7;2406;2;2444;5;1;
/org.eclipse.webdav/src/interface/org/eclipse/webdav/dom/LockEntry.java;1;0;2;1;2;1;2;0;115;0;0;5151;115;115;2;0;1;0;2;5151;1;5151;1;1;
/org.eclipse.pde.core/src/org/eclipse/pde/internal/core/ifeature/IFeatureEntry.java;2;1;3;1;2;2;2;1;12;0;1;4203;20;20;1;0;0;1;3;4203;0;6336;3;2;
/org.eclipse.search/search/org/eclipse/search/internal/core/SearchScope.java;1;0;2;1;1;1;1;1;5;0;1;1627;7;7;1;0;0;1;2;1627;0;6340;2;1;
/org.eclipse.pde.core/src/org/eclipse/pde/internal/core/osgi/bundle/Bundle.java;1;0;4;1;0;0;0;4;136;1;4;4203;142;142;1;0;0;4;4;4203;0;4726;4;1;
/org.eclipse.search/new search/org/eclipse/search2/internal/ui/basic/views/SearchResultTableModel.java;1;0;2;1;0;0;0;2;0;1;2;3474;0;0;1;0;0;2;2;3474;0;3711;2;1;
/org.eclipse.ui.ide/src/org/eclipse/ui/internal/ide/registry/CapabilityRegistry.java;1;0;2;1;0;0;0;2;2;1;2;2264;2;2;1;0;0;2;2;2264;0;2616;2;1;
/org.eclipse.team.cvs.ui/src/org/eclipse/team/internal/ccvs/ui/wizards/CheckoutWizard.java;2;1;6;1;4;4;4;2;308;1;2;4875;359;359;1;0;0;2;6;4875;0;6099;6;2;
/org.eclipse.jdt.core.tests.model/workspace/Formatter/test023/A_in.java;1;0;1;1;0;0;0;1;0;0;1;2425;0;0;1;0;0;1;1;2425;0;2425;1;1;
/org.eclipse.jdt.core.tests.model/workspace/Formatter/test144/A_in.java;1;0;1;1;0;0;0;1;0;0;1;2425;0;0;1;0;0;1;1;2425;0;2425;1;1;
/org.eclipse.ui.views/src/org/eclipse/ui/views/markers/internal/IFilter.java;2;0;2;1;0;0;0;2;0;1;2;755;0;0;1;0;0;2;2;755;0;2738;2;2;
/org.eclipse.ui.workbench/Eclipse UI/org/eclipse/ui/wizards/newresource/BasicNewProjectResourceWizard.java;4;0;8;1;0;0;0;8;708;2;6;1952;801;801;2;2;0;8;8;1952;2;2737;6;4;
/org.eclipse.jdt.core.tests.model/workspace/Converter/src/test0175/Test.java;1;0;1;1;0;0;0;1;0;0;1;3714;0;0;1;0;0;1;1;3714;0;3714;1;1;
/org.eclipse.jdt.ui.tests.refactoring/resources/ConvertAnonymousToNested/canConvert/A_test16_in.java;1;0;1;1;0;0;0;1;4;0;1;1607;4;4;1;0;0;1;1;1607;0;1607;1;1;
/org.eclipse.team.cvs.ui/src/org/eclipse/team/internal/ccvs/ui/wizards/SharingWizardSyncPage.java;2;1;11;1;7;7;7;4;232;1;4;4519;449;449;1;0;0;4;11;4519;0;6337;11;2;
/org.eclipse.team.ui/src/org/eclipse/team/ui/synchronize/views/CompressedFolderDiffNodeRoot.java;1;0;1;1;0;0;0;1;0;0;1;3832;0;0;1;0;0;1;1;3832;0;3832;1;1;
/org.eclipse.ui.ide/src/org/eclipse/ui/part/FileEditorInput.java;2;0;5;2;0;0;0;5;217;2;4;1511;222;222;2;1;0;5;5;1634;1;2263;4;2;
/org.eclipse.jdt.ui/core refactoring/org/eclipse/ltk/core/refactoring/UndoDocumentChange.java;1;0;2;1;0;0;0;2;0;1;2;4624;0;0;1;0;0;2;2;4624;0;4864;2;1;
/org.eclipse.team.webdav/src/org/eclipse/team/internal/ui/target/subscriber/ExportSourceSelectionPage.java;2;0;3;1;1;1;1;2;47;1;2;3494;49;49;1;0;0;2;3;3494;0;6337;3;2;
/org.eclipse.jdt.ui/ui refactoring/org/eclipse/jdt/internal/ui/refactoring/reorg/RenameUserInterfaceStarter.java;2;0;8;1;1;1;1;7;6;1;7;1709;22;22;1;0;0;7;8;1709;0;6340;8;2;
/org.eclipse.pde.ui/src_Forms/org/eclipse/pde/internal/ui/neweditor/plugin/BodyTextSection.java;2;1;5;1;4;4;4;1;14;0;1;4972;20;20;1;0;0;1;5;4972;0;5431;5;2;
/org.eclipse.update.ui.forms/Eclipse Forms/org/eclipse/ui/forms/widgets/TreeNode.java;2;0;3;1;0;0;0;3;1;1;3;3138;1;1;1;0;0;3;3;3138;0;4157;3;2;
/org.eclipse.swt/Eclipse SWT/gtk/org/eclipse/swt/widgets/Label.java;6;1;14;1;2;2;2;12;47;1;12;269;119;119;1;0;0;12;14;269;0;6352;14;6;
/org.eclipse.jdt.core.tests.model/workspace/Formatter/test457/A_in.java;1;0;1;1;0;0;0;1;0;0;1;3861;0;0;1;0;0;1;1;3861;0;3861;1;1;
/org.eclipse.ui.workbench/Eclipse UI/org/eclipse/ui/internal/misc/ContainerContentProvider.java;1;0;1;1;0;0;0;1;0;0;1;2737;0;0;1;0;0;1;1;2737;0;2737;1;1;
/org.eclipse.core.tests.runtime/src/org/eclipse/core/tests/internal/plugin/a/api/ApiClass.java;1;0;1;1;1;1;1;0;11;0;0;5149;11;11;1;0;0;0;1;5149;0;5149;1;1;
/org.eclipse.swt/Eclipse SWT/win32/org/eclipse/swt/widgets/ScrollBar.java;5;1;14;2;2;2;2;12;29;2;10;17;102;102;2;2;0;12;14;17;2;6352;12;5;
/org.eclipse.jdt.ui.tests.refactoring/resources/MoveInnerToTopLevel/test_nonstatic_29/out/Inner.java;1;0;1;1;0;0;0;1;1;0;1;305;1;1;1;0;0;1;1;305;0;305;1;1;
/org.eclipse.update.ui/src/org/eclipse/update/internal/ui/pages/InstallConfigurationPage.java;1;0;1;1;0;0;0;1;0;0;1;755;0;0;1;0;0;1;1;755;0;755;1;1;
/org.eclipse.jdt.core/formatter/org/eclipse/jdt/internal/formatter/impl/SplitLine.java;2;0;4;1;0;0;0;4;302;1;4;2157;309;309;1;0;0;4;4;2157;0;3673;4;2;
/org.eclipse.team.ui/src/org/eclipse/team/ui/sync/AbstractSynchronizeViewPage.java;1;0;1;1;0;0;0;1;0;0;1;2406;0;0;1;0;0;1;1;2406;0;2406;1;1;
/org.eclipse.jface.text/src/org/eclipse/jface/text/rules/ITokenScanner.java;1;0;1;1;1;1;1;0;2;0;0;6340;2;2;1;0;0;0;1;6340;0;6340;1;1;
/org.eclipse.update.ui.forms/src/org/eclipse/ui/forms/parts/FormUtil.java;1;0;2;1;0;0;0;2;0;1;2;3071;0;0;1;0;0;2;2;3071;0;3096;2;1;
/org.eclipse.ant.ui/Ant Tools Support/org/eclipse/ant/internal/ui/preferences/AntPage.java;1;0;7;1;0;0;0;7;23;1;7;1811;72;72;1;0;0;7;7;1811;0;3087;7;1;
/org.eclipse.pde.ui/src_Forms/org/eclipse/pde/internal/ui/neweditor/PDEFormEditor.java;2;2;25;1;7;5;7;18;319;2;16;3749;944;944;2;2;2;18;25;3749;4;5431;21;2;
/org.eclipse.jdt.ui/ui/org/eclipse/jdt/internal/ui/text/JavaPairMatcher.java;1;0;1;1;1;1;1;0;2;0;0;6340;2;2;1;0;0;0;1;6340;0;6340;1;1;
/org.eclipse.jdt.core.tests.model/workspace/Converter/src/test0029/Test.java;1;0;1;1;0;0;0;1;0;0;1;3714;0;0;1;0;0;1;1;3714;0;3714;1;1;
/org.eclipse.update.ui/src/org/eclipse/update/internal/ui/forms/ActivityConstraints.java;1;0;1;1;0;0;0;1;0;0;1;755;0;0;1;0;0;1;1;755;0;755;1;1;
/org.eclipse.team.ui/src/org/eclipse/team/internal/ui/target/PutAction.java;1;0;1;1;0;0;0;1;0;0;1;2495;0;0;1;0;0;1;1;2495;0;2495;1;1;
/org.eclipse.team.ui/src/org/eclipse/team/internal/ui/OverlayIcon.java;1;0;4;1;1;1;1;3;183;1;3;1955;220;220;1;0;0;3;4;1955;0;6337;4;1;
/org.eclipse.ui.workbench/Eclipse UI/org/eclipse/ui/internal/presentation/PresentationCategory.java;1;0;2;1;0;0;0;2;0;1;2;4235;0;0;1;0;0;2;2;4235;0;4392;2;1;
/org.eclipse.jface.text/src/org/eclipse/jface/internal/text/link/contentassist/IContentAssistListener2.java;2;0;2;1;1;1;1;1;2;0;1;4214;2;2;1;0;0;1;2;4214;0;6340;2;2;
/org.eclipse.jdt.ui.tests.refactoring/resources/DeleteSourceReference/test0/in/A.java;1;0;1;1;0;0;0;1;0;0;1;1652;0;0;1;0;0;1;1;1652;0;1652;1;1;
/org.eclipse.core.resources.linux/src/org/eclipse/core/resources/refresh/linux/LinuxRequestHandler.java;1;0;3;1;0;0;0;3;4;1;3;4346;4;4;1;0;0;3;3;4346;0;4851;3;1;
/org.eclipse.team.ui/src/org/eclipse/team/ui/synchronize/actions/OpenInCompareAction.java;1;0;1;1;0;0;0;1;0;0;1;2535;0;0;1;0;0;1;1;2535;0;2535;1;1;
/org.eclipse.jdt.ui/core refactoring/org/eclipse/ltk/core/refactoring/ChangeAbortException.java;1;0;2;1;0;0;0;2;0;1;2;4575;0;0;1;0;0;2;2;4575;0;4864;2;1;
/org.eclipse.team.webdav/src/org/eclipse/team/internal/ui/target/subscriber/TargetSubscriberParticipantPage.java;2;0;6;2;0;0;0;6;149;2;4;3499;250;250;2;2;0;6;6;4309;2;4585;4;2;
/org.eclipse.jdt.core.tests.model/workspace/Converter/src/test0219/Test.java;1;0;1;1;0;0;0;1;0;0;1;3714;0;0;1;0;0;1;1;3714;0;3714;1;1;
/org.eclipse.update.core/src/org/eclipse/update/internal/core/SiteLocal.java;2;2;19;1;4;3;4;15;531;2;13;890;1157;1157;2;2;1;15;19;4217;3;6336;16;2;
/org.eclipse.jdt.ui/core extension/org/eclipse/text/edits/Regions.java;1;0;2;1;0;0;0;2;0;1;2;1953;0;0;1;0;0;2;2;1953;0;1972;2;1;
/org.eclipse.compare/compare/org/eclipse/compare/structuremergeviewer/ICompareInput.java;1;0;1;1;0;0;0;1;2;0;1;3938;2;2;1;0;0;1;1;3938;0;3938;1;1;
/org.eclipse.team.tests.cvs.core/src/org/eclipse/team/tests/ccvs/ui/Util.java;1;0;1;1;0;0;0;1;0;0;1;2632;0;0;1;0;0;1;1;2632;0;2632;1;1;
/org.eclipse.team.cvs.core/src/org/eclipse/team/internal/ccvs/core/syncinfo/MultiTagResourceVariantTree.java;2;0;5;2;1;1;1;4;11;2;3;4238;17;17;2;1;0;4;5;4238;1;6337;4;2;
/org.eclipse.jdt.ui.tests.refactoring/resources/Paste/test2/out/A.java;1;0;1;1;0;0;0;1;0;0;1;1311;0;0;1;0;0;1;1;1311;0;1311;1;1;
/org.eclipse.swt/Eclipse SWT/win32/org/eclipse/swt/widgets/Combo.java;6;2;32;2;12;10;12;20;149;1;20;110;605;605;2;0;2;20;32;5594;2;6352;30;6;
/org.eclipse.jdt.debug.ui/ui/org/eclipse/jdt/internal/debug/ui/display/DisplayCompletionProcessor.java;5;1;11;2;3;3;3;8;22;2;7;1152;65;65;2;1;0;8;11;4870;1;6336;10;5;
/org.eclipse.team.ui/src/org/eclipse/team/ui/sync/CompoundSyncInfoFilter.java;2;0;3;1;0;0;0;3;18;1;3;709;18;18;1;0;0;3;3;709;0;2632;3;2;
/org.eclipse.jdt.ui.tests.refactoring/resources/ExtractMethodWorkSpace/ExtractMethodTests/error_out/A_test801.java;1;0;4;1;0;0;0;4;4;1;4;130;6;6;1;0;0;4;4;130;0;1474;4;1;
/org.eclipse.webdav/src/client/org/eclipse/webdav/internal/authentication/AuthenticateChallenge.java;1;0;1;1;1;1;1;0;130;0;0;5151;130;130;1;0;0;0;1;5151;0;5151;1;1;
/org.eclipse.jdt.core.tests.model/workspace/Converter/src/test0270/Test.java;1;0;1;1;0;0;0;1;0;0;1;3714;0;0;1;0;0;1;1;3714;0;3714;1;1;
/org.eclipse.core.tests.runtime/src/org/eclipse/core/tests/internal/plugins/RegressionResolveTest_11.java;1;0;1;1;0;0;0;1;0;0;1;3014;0;0;1;0;0;1;1;3014;0;3014;1;1;
/org.eclipse.swt/Eclipse SWT/common/org/eclipse/swt/SWT.java;7;2;30;2;8;7;8;22;832;2;20;1;1373;1373;2;2;1;22;30;955;3;6352;27;7;
/org.eclipse.ui.editors/src/org/eclipse/ui/internal/texteditor/TextChangeHover.java;2;1;3;1;3;3;3;0;18;0;0;5311;24;24;1;0;0;0;3;5311;0;6340;3;2;
/org.eclipse.jdt.launching/launching/org/eclipse/jdt/launching/AbstractVMRunner.java;4;0;7;1;1;1;1;6;33;1;6;1455;97;97;1;0;0;6;7;1455;0;6336;7;4;
/org.eclipse.ui.externaltools/External Tools Base/org/eclipse/ui/externaltools/internal/variable/ProjectNameExpander.java;1;0;1;1;0;0;0;1;0;0;1;321;0;0;1;0;0;1;1;321;0;321;1;1;
/org.eclipse.pde.build/src/org/eclipse/pde/internal/build/builder/PluginBuildScriptGenerator.java;2;0;7;1;0;0;0;7;2;1;7;447;2;2;1;0;0;7;7;447;0;5036;7;2;
/org.eclipse.team.cvs.ui/src/org/eclipse/team/internal/ccvs/ui/operations/CVSOperation.java;2;1;30;1;4;4;4;26;305;2;24;276;1091;1091;2;2;0;26;30;885;2;6337;28;2;
/org.eclipse.ui.intro/src/org/eclipse/ui/internal/intro/impl/model/IntroAnchor.java;1;0;1;1;1;1;1;0;0;0;0;5700;0;0;1;0;0;0;1;5700;0;5700;1;1;
/org.eclipse.ui.workbench.texteditor/src/org/eclipse/ui/contentassist/ContentAssistMessages.java;1;0;1;1;1;1;1;0;0;0;0;5478;0;0;1;0;0;0;1;5478;0;5478;1;1;
/org.eclipse.team.cvs.ui/src/org/eclipse/team/internal/ccvs/ui/wizards/UpdateWizardPage.java;2;0;2;1;1;1;1;1;143;0;1;2381;145;145;1;0;0;1;2;2381;0;5463;2;2;
/org.eclipse.pde.ui/src/org/eclipse/pde/internal/ui/wizards/feature/FeatureData.java;2;2;5;1;4;3;4;1;44;0;1;3840;68;68;2;0;1;1;5;6108;1;6336;4;2;
/org.eclipse.jdt.launching/launching/org/eclipse/jdt/internal/launching/ClasspathVariableSourceContainer.java;1;0;4;1;0;0;0;4;14;2;3;4167;14;14;2;1;0;4;4;4949;1;4971;3;1;
/org.eclipse.swt.tests/JUnit Tests/org/eclipse/swt/tests/junit/Test_org_eclipse_swt_dnd_ByteArrayTransfer.java;1;0;1;1;0;0;0;1;22;0;1;2104;22;22;1;0;0;1;1;2104;0;2104;1;1;
/org.eclipse.jdt.ui/ui/org/eclipse/jdt/internal/ui/wizards/NewPackageCreationWizard.java;2;1;5;1;2;2;2;3;12;1;3;4064;35;35;1;0;0;3;5;4064;0;6340;5;2;
/org.eclipse.swt/Eclipse SWT/gtk/org/eclipse/swt/widgets/DirectoryDialog.java;4;1;11;1;2;2;2;9;25;2;7;902;92;92;2;2;0;9;11;1936;2;6352;9;4;
/org.eclipse.ui/src/org/eclipse/ui/internal/UIPlugin.java;4;1;13;1;7;7;7;6;43;1;6;2737;148;148;1;0;0;6;13;2737;0;6338;13;4;
/org.eclipse.swt/Eclipse SWT PI/gtk/org/eclipse/swt/internal/gtk/GtkColorSelectionDialog.java;3;0;3;1;1;1;1;2;17;1;2;1653;27;27;1;0;0;2;3;1653;0;6352;3;3;
/org.eclipse.ui.intro/src/org/eclipse/ui/internal/intro/impl/model/AbstractBaseIntroElement.java;1;2;12;1;12;10;12;0;76;0;0;5115;123;123;2;0;2;0;12;5314;2;5965;10;1;
/org.eclipse.update.core/src/org/eclipse/update/core/Site_OLD.java;1;0;1;1;0;0;0;1;0;0;1;2810;0;0;1;0;0;1;1;2810;0;2810;1;1;
/org.eclipse.jdt.ui/ui/org/eclipse/jdt/internal/ui/wizards/buildpaths/ExclusionPatternDialog.java;2;0;2;1;0;0;0;2;7;1;2;1350;7;7;1;0;0;2;2;1350;0;4928;2;2;
/org.eclipse.jdt.core.tests.model/workspace/Converter/src/junit/swingui/FailureRunView.java;1;0;1;1;0;0;0;1;0;0;1;3714;0;0;1;0;0;1;1;3714;0;3714;1;1;
/org.eclipse.jdt.core.tests.builder/src/org/eclipse/jdt/core/tests/builder/CompilationUnitLocationTests.java;1;0;1;1;0;0;0;1;0;0;1;989;0;0;1;0;0;1;1;989;0;989;1;1;
/org.eclipse.ant.ui/Ant Editor/org/eclipse/ant/ui/internal/editor/utils/AntEditorUtilsMessages.java;1;0;2;1;0;0;0;2;0;1;2;250;0;0;1;0;0;2;2;250;0;1811;2;1;
/org.eclipse.core.tests.runtime/src/org/eclipse/core/tests/runtime/jobs/AsynchExecThread.java;2;0;5;1;1;1;1;4;33;1;4;2160;84;84;1;0;0;4;5;2160;0;5149;5;2;
/org.eclipse.jdt.text.tests/src/org/eclipse/jdt/text/tests/spelling/SpellCheckEngineTestCase.java;1;1;2;1;2;2;2;0;6;0;0;5129;6;6;1;0;0;0;2;5129;0;6340;2;1;
/org.eclipse.update/src/org/eclipse/update/internal/core/UMLock.java;1;0;1;1;1;1;1;0;0;0;0;6339;0;0;1;0;0;0;1;6339;0;6339;1;1;
/org.eclipse.team.cvs.core/src/org/eclipse/team/internal/ccvs/core/client/listeners/IMessagePatterns.java;2;1;4;1;2;2;2;2;36;1;2;2509;40;40;1;0;0;2;4;2509;0;6337;4;2;
/org.eclipse.team.ui/src/org/eclipse/team/ui/synchronize/views/ILogicalView.java;1;0;1;1;0;0;0;1;0;0;1;3764;0;0;1;0;0;1;1;3764;0;3764;1;1;
/org.eclipse.jdt.ui.tests.refactoring/resources/SurroundWithWorkSpace/SurroundWithTests/trycatch_in/TestInitializer.java;1;0;1;1;0;0;0;1;2;0;1;845;2;2;1;0;0;1;1;845;0;845;1;1;
/org.eclipse.debug.core/core/org/eclipse/debug/core/variables/LaunchVariableUtil.java;2;0;12;1;0;0;0;12;102;3;10;754;280;280;3;2;0;12;12;846;2;2120;10;2;
/org.eclipse.jdt.ui.tests.refactoring/resources/ExtractMethodWorkSpace/ExtractMethodTests/try_out/A_test453.java;1;0;2;1;0;0;0;2;6;1;2;130;10;10;1;0;0;2;2;130;0;844;2;1;
/org.eclipse.jdt.core.tests.model/workspace/Converter/test0050/Test.java;1;0;1;1;0;0;0;1;0;0;1;3714;0;0;1;0;0;1;1;3714;0;3714;1;1;
/org.eclipse.swt/Eclipse SWT Browser/common/org/eclipse/swt/browser/StatusTextEvent.java;2;0;5;1;1;1;1;4;15;1;4;1654;35;35;1;0;0;4;5;1654;0;6352;5;2;
/org.eclipse.jdt.core.tests.model/workspace/Converter/test0455/A.java;1;0;1;1;0;0;0;1;0;0;1;3714;0;0;1;0;0;1;1;3714;0;3714;1;1;
/org.eclipse.jdt.core/dom/org/eclipse/jdt/core/dom/Message.java;1;0;1;1;0;0;0;1;2;0;1;3560;2;2;1;0;0;1;1;3560;0;3560;1;1;
/org.eclipse.swt/Eclipse SWT/gtk/org/eclipse/swt/widgets/Group.java;7;1;17;1;2;2;2;15;25;2;14;110;148;148;2;1;0;15;17;1398;1;6352;16;7;
/org.eclipse.jdt.debug.ui/ui/org/eclipse/jdt/internal/debug/ui/actions/AddAdvancedAction.java;1;0;1;1;0;0;0;1;20;0;1;2691;20;20;1;0;0;1;1;2691;0;2691;1;1;
/org.eclipse.pde.ui/src/org/eclipse/pde/internal/ui/parts/EditableTablePart.java;2;1;4;1;2;2;2;2;62;1;2;1011;75;75;1;0;0;2;4;1011;0;6336;4;2;
/org.eclipse.swt/Eclipse SWT/carbon/org/eclipse/swt/internal/Converter.java;1;0;1;1;0;0;0;1;2;0;1;0;2;2;1;0;0;1;1;0;0;0;1;1;
/org.eclipse.team.cvs.core/src/org/eclipse/team/internal/ccvs/core/CVSSyncTreeSubscriber.java;2;0;21;2;1;1;1;20;366;3;17;537;1158;1158;3;3;0;20;21;4233;3;6337;18;2;
/org.eclipse.jdt.core.tests.model/workspace/Converter/src/test0548/A.java;1;0;2;1;2;1;2;0;0;0;0;5382;0;0;2;0;1;0;2;5382;1;5382;1;1;
/org.eclipse.jface.text/projection/org/eclipse/jface/text/source/projection/ProjectionSummary.java;2;1;9;1;8;8;8;1;53;0;1;4974;216;216;1;0;0;1;9;4974;0;6362;9;2;
/org.eclipse.ui.workbench/Eclipse UI/org/eclipse/ui/internal/colors/ColorDefinitionReader.java;1;0;4;1;0;0;0;4;184;2;3;3216;205;205;2;1;0;4;4;4235;1;4235;3;1;
/org.eclipse.update.ui/src/org/eclipse/update/internal/ui/search/BackgroundProgressMonitor.java;1;0;1;1;0;0;0;1;0;0;1;825;0;0;1;0;0;1;1;825;0;825;1;1;
/org.eclipse.jdt.core.tests.model/workspace/Formatter/test223/A_out.java;1;0;1;1;0;0;0;1;0;0;1;2426;0;0;1;0;0;1;1;2426;0;2426;1;1;
/org.eclipse.team.tests.core/src/org/eclipse/team/tests/ui/synchronize/TestTreeViewerAdvisor.java;2;2;6;2;6;4;6;0;47;0;0;5314;53;53;2;0;2;0;6;5358;2;5505;4;2;
/org.eclipse.team.ui/src/org/eclipse/team/internal/ui/synchronize/actions/OpenInCompareAction.java;2;1;15;1;5;5;5;10;203;2;9;2561;446;446;2;1;0;10;15;4216;1;6337;14;2;
/org.eclipse.ui.workbench/Eclipse UI/org/eclipse/ui/internal/commands/CaptureListener.java;1;0;5;1;0;0;0;5;0;1;5;786;0;0;1;0;0;5;5;786;0;1695;5;1;
/org.eclipse.ui.workbench/Eclipse UI/org/eclipse/ui/internal/commands/Point.java;1;0;7;1;0;0;0;7;36;1;7;607;46;46;1;0;0;7;7;607;0;1695;7;1;
/org.eclipse.jdt.core.tests.model/workspace/Formatter/test270/A_in.java;1;0;1;1;0;0;0;1;0;0;1;2442;0;0;1;0;0;1;1;2442;0;2442;1;1;
/org.eclipse.jdt.core.tests.model/workspace/Formatter/test266/A_out.java;1;0;1;1;0;0;0;1;0;0;1;2442;0;0;1;0;0;1;1;2442;0;2442;1;1;
/org.eclipse.jdt.core.tests.model/workspace/Formatter/test300/A_in.java;1;0;1;1;0;0;0;1;0;0;1;2444;0;0;1;0;0;1;1;2444;0;2444;1;1;
/org.eclipse.ui.workbench/Eclipse UI/org/eclipse/ui/internal/registry/MarkerHelpRegistryReader.java;1;0;1;1;0;0;0;1;0;0;1;2737;0;0;1;0;0;1;1;2737;0;2737;1;1;
/org.eclipse.compare/compare/org/eclipse/compare/internal/ViewerDescriptor.java;1;0;1;1;0;0;0;1;1;0;1;1289;1;1;1;0;0;1;1;1289;0;1289;1;1;
/org.eclipse.osgi/osgi/src/org/eclipse/osgi/service/resolver/Resolver.java;4;1;5;1;2;2;2;3;14;1;3;3013;35;35;1;0;0;3;5;3013;0;6337;5;4;
/org.eclipse.jdt.core.tests.model/src/org/eclipse/jdt/core/tests/formatter/DecodeCodeFormatterPreferences.java;2;0;6;1;0;0;0;6;63;1;6;3479;139;139;1;0;0;6;6;3479;0;3742;6;2;
/org.eclipse.swt/Eclipse SWT PI/gtk/org/eclipse/swt/internal/accessibility/gtk/AtkActionIface.java;4;0;4;1;1;1;1;3;13;1;3;1214;27;27;1;0;0;3;4;1214;0;6352;4;4;
/org.eclipse.jdt.core.tests.compiler/src/org/eclipse/jdt/core/tests/compiler/regression/LookupTest.java;3;0;11;1;1;1;1;10;374;1;10;49;812;812;1;0;0;10;11;49;0;5888;11;3;
/org.eclipse.swt/Eclipse SWT Custom Widgets/common/org/eclipse/swt/custom/CTabFolderMinMaxListener.java;1;0;2;1;0;0;0;2;37;1;2;3812;37;37;1;0;0;2;2;3812;0;4232;2;1;
/org.eclipse.ui.workbench/Eclipse UI/org/eclipse/ui/internal/presentations/EditorPresentationSystemContribution.java;1;0;3;1;0;0;0;3;8;2;2;4517;8;8;2;1;0;3;3;4517;1;4680;2;1;
/org.eclipse.team.core/src/org/eclipse/team/core/synchronize/IRemoteResourceComparator.java;1;0;1;1;0;0;0;1;0;0;1;4048;0;0;1;0;0;1;1;4048;0;4048;1;1;
/org.eclipse.jdt.ui.tests.refactoring/resources/ExtractMethodWorkSpace/ExtractMethodTests/locals_in/A_test500.java;1;0;1;1;0;0;0;1;2;0;1;844;2;2;1;0;0;1;1;844;0;844;1;1;
/org.eclipse.update.core/src/org/eclipse/update/operations/IRevertConfigurationOperation.java;1;0;7;1;1;1;1;6;13;2;5;825;22;22;2;1;0;6;7;825;1;5423;6;1;
/org.eclipse.jdt.debug.ui/ui/org/eclipse/jdt/internal/debug/ui/actions/EditStepFiltersAction.java;1;0;1;1;0;0;0;1;0;0;1;3613;0;0;1;0;0;1;1;3613;0;3613;1;1;
/org.eclipse.pde.ui/src_Forms/org/eclipse/pde/internal/ui/model/plugin/PluginDocumentHandler.java;2;4;17;1;11;8;11;6;224;1;6;4438;582;582;4;0;3;6;17;5160;3;6336;14;2;
/org.eclipse.text/src/org/eclipse/jface/text/templates/TemplateTranslator.java;2;1;8;1;4;4;4;4;17;1;4;4259;70;70;1;0;0;4;8;4259;0;6340;8;2;
/org.eclipse.jdt.core/model/org/eclipse/jdt/core/Signature.java;3;0;13;1;1;1;1;12;1413;2;11;109;2195;2195;2;1;0;12;13;5022;1;5871;12;3;
/org.eclipse.ui.externaltools/Program Tools Support/org/eclipse/ui/externaltools/internal/program/launchConfigurations/BackgroundResourceRefresher.java;3;0;8;1;0;0;0;8;34;1;8;321;89;89;1;0;0;8;8;321;0;3569;8;3;
/org.eclipse.swt.tests/JUnit Tests/org/eclipse/swt/tests/junit/Test_org_eclipse_swt_widgets_Label.java;2;0;2;1;0;0;0;2;56;1;2;2123;62;62;1;0;0;2;2;2123;0;2157;2;2;
/org.eclipse.swt/Eclipse SWT/photon/org/eclipse/swt/widgets/ToolBar.java;4;1;6;1;2;2;2;4;18;2;3;46;32;32;2;1;0;4;6;46;1;6352;5;4;
/org.eclipse.jdt.core/model/org/eclipse/jdt/internal/core/JavaModelInfo.java;3;0;4;1;1;1;1;3;20;1;3;61;29;29;1;0;0;3;4;61;0;5916;4;3;
/org.eclipse.core.runtime.osgi/src/org/eclipse/core/runtime/NullProgressMonitor.java;1;0;2;1;0;0;0;2;169;1;2;3013;169;169;1;0;0;2;2;3013;0;3030;2;1;
/org.eclipse.jdt.ui/core extension/org/eclipse/jdt/internal/corext/codemanipulation/MethodBlock.java;1;0;1;1;0;0;0;1;0;0;1;155;0;0;1;0;0;1;1;155;0;155;1;1;
/org.eclipse.jdt.core.tests.model/src/org/eclipse/jdt/core/tests/dom/ASTMatcherTest.java;5;1;17;1;2;2;2;15;317;2;14;292;730;730;2;1;0;15;17;4801;1;5853;16;5;
/org.eclipse.ltk.core.refactoring/src/org/eclipse/ltk/internal/core/refactoring/RefactoringCorePreferences.java;1;1;2;1;2;2;2;0;2;0;0;5190;2;2;1;0;0;0;2;5190;0;6340;2;1;
/org.eclipse.jdt.core.tests.model/workspace/Completion/src/CompletionAbstractMethod4.java;1;0;1;1;0;0;0;1;0;0;1;1702;0;0;1;0;0;1;1;1702;0;1702;1;1;
/org.eclipse.pde.core/src/org/eclipse/pde/core/plugin/IPluginExtension.java;3;2;7;1;5;4;5;2;30;1;2;4203;59;59;2;0;1;2;7;5211;1;6336;6;3;
/org.eclipse.jdt.ui.tests.refactoring/resources/ExtractMethodWorkSpace/ExtractMethodTests/return_in/A_test718.java;1;0;1;1;0;0;0;1;4;0;1;844;4;4;1;0;0;1;1;844;0;844;1;1;
/org.eclipse.core.runtime.compatibility/src-model/org/eclipse/core/runtime/model/ConfigurationElementModel.java;3;2;6;1;4;3;4;2;26;1;2;3013;35;35;2;0;1;2;6;5117;1;6340;5;3;
/org.eclipse.jdt.ui/ui refactoring/org/eclipse/jdt/internal/ui/refactoring/PushDownWizard.java;3;0;9;1;1;1;1;8;530;2;7;518;590;590;2;1;0;8;9;1034;1;6340;8;3;
/org.eclipse.jdt.core.tests.model/workspace/Formatter/test076/A_out.java;1;0;1;1;0;0;0;1;0;0;1;2425;0;0;1;0;0;1;1;2425;0;2425;1;1;
/org.eclipse.text.tests/src/org/eclipse/text/tests/link/LinkedEnvironmentTest.java;2;0;3;1;2;1;2;1;8;0;1;5082;8;8;2;0;1;1;3;5127;1;5127;2;2;
/org.eclipse.ui.workbench/Eclipse UI/org/eclipse/ui/IFolderLayout.java;2;1;3;1;2;2;2;1;10;0;1;3828;22;22;1;0;0;1;3;3828;0;6338;3;2;
/org.eclipse.jdt.ui/ui/org/eclipse/jdt/internal/ui/wizards/buildpaths/FolderSelectionDialog.java;2;0;3;1;1;1;1;2;3;1;2;1212;7;7;1;0;0;2;3;1212;0;6340;3;2;
/org.eclipse.core.runtime/src/org/eclipse/core/internal/registry/ReadWriteMonitor.java;1;0;3;1;3;1;3;0;0;0;0;5637;0;0;3;0;2;0;3;5637;2;5637;1;1;
/org.eclipse.ui.workbench/Eclipse UI/org/eclipse/ui/internal/PerspectiveBarNewContributionItem.java;3;0;6;1;1;1;1;5;73;1;5;3806;125;125;1;0;0;5;6;3806;0;6338;6;3;
/org.eclipse.ui.ide/src/org/eclipse/ui/internal/model/AdaptableList.java;2;0;2;1;0;0;0;2;0;1;2;1511;0;0;1;0;0;2;2;1511;0;1561;2;2;
/org.eclipse.update/src/org/eclipse/update/internal/core/UMSessionManagerSession.java;1;0;1;1;1;1;1;0;0;0;0;6339;0;0;1;0;0;0;1;6339;0;6339;1;1;
/org.eclipse.ui.workbench/Eclipse UI/org/eclipse/ui/internal/contexts/registry/IContextDefinition.java;1;0;2;1;0;0;0;2;0;1;2;1422;0;0;1;0;0;2;2;1422;0;1724;2;1;
/org.eclipse.swt/Eclipse SWT Drag and Drop/carbon/org/eclipse/swt/dnd/TextTransfer.java;1;0;6;1;0;0;0;6;97;2;5;209;220;220;2;1;0;6;6;298;1;325;5;1;
/org.eclipse.jdt.core.tests.model/workspace/Converter/src/test0439/C.java;1;0;1;1;0;0;0;1;0;0;1;3714;0;0;1;0;0;1;1;3714;0;3714;1;1;
/org.eclipse.jdt.ui/ui/org/eclipse/jdt/internal/ui/dialogs/SourceActionDialog.java;3;1;21;2;4;4;4;17;316;3;12;502;1298;1298;3;5;0;17;21;502;5;6040;16;3;
/org.eclipse.jdt.ui.tests.refactoring/resources/RenameVirtualMethodInClass/test35/out/A.java;1;0;1;1;0;0;0;1;0;0;1;1653;0;0;1;0;0;1;1;1653;0;1653;1;1;
/org.eclipse.swt/Eclipse SWT PI/win32/org/eclipse/swt/internal/win32/KEYBDINPUT.java;2;0;2;1;1;1;1;1;4;0;1;4632;4;4;1;0;0;1;2;4632;0;6352;2;2;
/org.eclipse.debug.ui/ui/org/eclipse/debug/internal/ui/Pair.java;2;0;2;1;1;1;1;1;4;0;1;3806;4;4;1;0;0;1;2;3806;0;6336;2;2;
/org.eclipse.swt/Eclipse SWT/common/org/eclipse/swt/events/TraverseEvent.java;2;0;4;1;1;1;1;3;34;1;3;1;45;45;1;0;0;3;4;1;0;6352;4;2;
/org.eclipse.jdt.ui/core refactoring/org/eclipse/ltk/internal/core/refactoring/RefactoringCorePlugin.java;1;0;3;1;0;0;0;3;10;1;3;4510;10;10;1;0;0;3;3;4510;0;4864;3;1;
/org.eclipse.team.tests.cvs.core/src/org/eclipse/team/tests/ccvs/ui/CVSOperationTest.java;1;0;1;1;0;0;0;1;0;0;1;2632;0;0;1;0;0;1;1;2632;0;2632;1;1;
/org.eclipse.osgi/eclipseAdaptor/src/org/eclipse/core/runtime/adaptor/Locker_JavaNio.java;3;1;6;1;4;4;4;2;15;1;2;4854;27;27;1;0;0;2;6;4854;0;6133;6;3;
/org.eclipse.jdt.ui.examples.javafamily/coresearch-experiment/org/eclipse/search/core/MatchLocator.java;1;0;2;1;0;0;0;2;0;1;2;1380;0;0;1;0;0;2;2;1380;0;3214;2;1;
/org.eclipse.ui.tests/Eclipse UI Tests/org/eclipse/ui/tests/dnd/GenerateDragSnapshotAction.java;1;0;1;1;0;0;0;1;0;0;1;5007;0;0;1;0;0;1;1;5007;0;5007;1;1;
/org.eclipse.swt.tests/JUnit Tests/org/eclipse/swt/tests/junit/Test_org_eclipse_swt_accessibility_AccessibleTextListener.java;1;0;1;1;0;0;0;1;0;0;1;3373;0;0;1;0;0;1;1;3373;0;3373;1;1;
/org.eclipse.update.ui/src/org/eclipse/update/internal/ui/views/BaseTableView.java;1;0;1;1;0;0;0;1;0;0;1;755;0;0;1;0;0;1;1;755;0;755;1;1;
/org.eclipse.jdt.core.tests.model/workspace/Formatter/test340/A_in.java;1;0;1;1;0;0;0;1;0;0;1;2863;0;0;1;0;0;1;1;2863;0;2863;1;1;
/org.eclipse.team.cvs.ui/src/org/eclipse/team/internal/ccvs/ui/CVSDecoratorConfiguration.java;1;0;2;1;0;0;0;2;8;1;2;276;9;9;1;0;0;2;2;276;0;2627;2;1;
/org.eclipse.jdt.debug.tests/tests/org/eclipse/jdt/debug/tests/core/JavaBreakpointListenerTests.java;2;0;2;1;0;0;0;2;334;1;2;2210;342;342;1;0;0;2;2;2210;0;2227;2;2;
/org.eclipse.pde.ui/src/org/eclipse/pde/internal/ui/wizards/BaseWizardSelectionPage.java;3;1;4;1;4;4;4;0;68;0;0;5388;92;92;1;0;0;0;4;5388;0;6336;4;3;
/org.eclipse.debug.ui/ui/org/eclipse/debug/internal/ui/views/console/BreakPartition.java;1;0;1;1;0;0;0;1;2;0;1;2060;2;2;1;0;0;1;1;2060;0;2060;1;1;
/org.eclipse.jdt.debug.ui/ui/org/eclipse/jdt/internal/debug/ui/monitors/MonitorAction.java;2;0;3;1;0;0;0;3;12;2;2;206;14;14;2;1;0;3;3;4480;1;4480;2;2;
/org.eclipse.jdt.debug.ui/ui/org/eclipse/jdt/debug/ui/launchConfigurations/JavaClasspathTab.java;3;1;22;2;3;3;3;19;310;2;16;124;750;750;2;3;0;19;22;1893;3;5893;19;3;
/org.eclipse.swt/Eclipse SWT/emulated/treetable/org/eclipse/swt/widgets/TableItem.java;4;1;15;2;3;3;3;12;145;2;10;269;451;451;2;2;0;12;15;269;2;6352;13;4;
/org.eclipse.help.webapp/src_servlets/org/eclipse/help/internal/webapp/data/View.java;1;1;4;1;3;3;3;1;28;0;1;5043;48;48;1;0;0;1;4;5043;0;6337;4;1;
/org.eclipse.ui.workbench/Eclipse UI/org/eclipse/ui/internal/ShowInMenu.java;1;0;1;1;0;0;0;1;3;0;1;2737;3;3;1;0;0;1;1;2737;0;2737;1;1;
/org.eclipse.team.examples.filesystem/src/org/eclipse/team/examples/pessimistic/ui/RemoveFromControlAction.java;1;0;2;1;1;1;1;1;81;0;1;3368;81;81;1;0;0;1;2;3368;0;6103;2;1;
/org.eclipse.pde.ui/src/org/eclipse/pde/internal/ui/editor/XMLConfiguration.java;2;0;3;1;1;1;1;2;24;1;2;909;45;45;1;0;0;2;3;909;0;6336;3;2;
/org.eclipse.compare/compare/org/eclipse/compare/internal/StreamMergerDescriptor.java;1;1;2;1;2;2;2;0;8;0;0;5165;8;8;1;0;0;0;2;5165;0;5185;2;1;
/org.eclipse.jdt.core.tests.model/workspace/Converter/src/test0391/A.java;1;0;1;1;0;0;0;1;0;0;1;3714;0;0;1;0;0;1;1;3714;0;3714;1;1;
/org.eclipse.ui.intro/src/org/eclipse/ui/intro/internal/presentations/FormIntroPartImplementation.java;2;0;6;1;1;1;1;5;288;1;5;4429;352;352;1;0;0;5;6;4429;0;5115;6;2;
/org.eclipse.ant.ui/Ant Tools Support/org/eclipse/ant/internal/ui/launchConfigurations/RemoteAntRuntimeProcess.java;2;0;2;1;0;0;0;2;13;1;2;1879;15;15;1;0;0;2;2;1879;0;1932;2;2;
/org.eclipse.ui.editors/src/org/eclipse/ui/texteditor/AnnotationType.java;2;1;4;1;2;2;2;2;10;1;2;3217;18;18;1;0;0;2;4;3217;0;5177;4;2;
/org.eclipse.debug.ui/ui/org/eclipse/debug/internal/ui/views/memory/IMemoryViewTab.java;1;0;1;1;1;1;1;0;0;0;0;5254;0;0;1;0;0;0;1;5254;0;5254;1;1;
/org.eclipse.jdt.ui/core refactoring/org/eclipse/jdt/internal/corext/refactoring/participants/IMoveParticipant.java;1;0;2;1;0;0;0;2;0;1;2;825;0;0;1;0;0;2;2;825;0;4624;2;1;
/org.eclipse.pde.ui/src/org/eclipse/pde/internal/ui/wizards/tools/UpdateClasspathOperation.java;1;0;2;1;0;0;0;2;0;1;2;3840;0;0;1;0;0;2;2;3840;0;4202;2;1;
/org.eclipse.text/src/org/eclipse/jface/text/source/AnnotationModelEvent.java;1;1;3;1;2;2;2;1;254;0;1;2243;275;275;1;0;0;1;3;2243;0;6300;3;1;
/org.eclipse.jdt.debug.ui/ui/org/eclipse/jdt/internal/debug/core/refactoring/LaunchConfigurationProjectMainTypeChange.java;1;2;4;1;4;3;4;0;45;0;0;5515;60;60;2;0;1;0;4;5515;1;6019;3;1;
/org.eclipse.jdt.core.tests.model/workspace/Converter/test0461/A.java;1;0;1;1;0;0;0;1;0;0;1;3714;0;0;1;0;0;1;1;3714;0;3714;1;1;
/org.eclipse.ui.ide/src/org/eclipse/ui/internal/ide/actions/BuildSetAction.java;2;0;2;1;0;0;0;2;3;1;2;4651;3;3;1;0;0;2;2;4651;0;4737;2;2;
/org.eclipse.ui.externaltools/External Tools Base/org/eclipse/ui/externaltools/internal/variable/SpecificFileResourceComponent.java;1;0;1;1;0;0;0;1;0;0;1;321;0;0;1;0;0;1;1;321;0;321;1;1;
/org.eclipse.update.core/srcnew/org/eclipse/update/standalone/CmdLineArgs.java;2;0;5;2;0;0;0;5;43;2;3;671;47;47;2;2;0;5;5;671;2;825;3;2;
/org.eclipse.jdt.ui/ui/org/eclipse/jdt/internal/ui/search/JavaSearchContentProvider.java;2;1;4;1;2;2;2;2;24;1;2;3711;30;30;1;0;0;2;4;3711;0;6340;4;2;
/org.eclipse.ui.workbench/Eclipse UI/org/eclipse/ui/internal/commands/older/ImageBinding.java;1;0;2;1;0;0;0;2;2;0;1;2562;2;2;2;1;0;2;2;2562;1;2562;1;1;
/org.eclipse.jdt.core.tests.model/workspace/Converter/src/javadoc/testBug50898/TestB.java;1;0;2;1;0;0;0;2;0;1;2;3890;0;0;1;0;0;2;2;3890;0;3899;2;1;
/org.eclipse.pde.build/src/org/eclipse/pde/internal/build/builder/FeatureBuildScriptGenerator.java;2;2;33;1;17;15;17;16;646;2;15;447;1048;1048;2;1;2;16;33;1219;3;6336;30;2;
/org.eclipse.team.core/src/org/eclipse/team/core/variants/PersistantResourceVariantByteStore.java;1;1;3;1;2;2;2;1;26;0;1;4349;39;39;1;0;0;1;3;4349;0;6125;3;1;
/org.eclipse.ui.tests/Eclipse UI Tests/org/eclipse/ui/tests/internal/ActionExpressionTest.java;1;0;1;1;0;0;0;1;3;0;1;3091;3;3;1;0;0;1;1;3091;0;3091;1;1;
/org.eclipse.ui.workbench/Eclipse UI/org/eclipse/ui/internal/IWorkbenchConstants.java;11;2;39;2;12;10;12;27;18;3;24;368;135;135;3;3;2;27;39;3877;5;6338;34;11;
/org.eclipse.team.ui/src/org/eclipse/team/ui/synchronize/SyncInfoDiffNodeRoot.java;1;0;1;1;0;0;0;1;0;0;1;3832;0;0;1;0;0;1;1;3832;0;3832;1;1;
/org.eclipse.ui.workbench/Eclipse UI/org/eclipse/ui/IViewReference.java;2;1;3;1;2;2;2;1;17;0;1;3819;21;21;1;0;0;1;3;3819;0;6338;3;2;
/org.eclipse.jdt.ui/core refactoring/org/eclipse/ltk/internal/core/refactoring/Changes.java;1;0;2;1;0;0;0;2;0;1;2;4624;0;0;1;0;0;2;2;4624;0;4864;2;1;
/org.eclipse.osgi/resolver/src/org/eclipse/osgi/internal/resolver/BundleInstaller.java;2;0;3;1;1;1;1;2;4;0;1;4238;8;8;2;1;0;2;3;4238;1;5117;2;2;
/org.eclipse.team.ui/src/org/eclipse/team/internal/ui/IPromptCondition.java;1;0;1;1;0;0;0;1;0;0;1;993;0;0;1;0;0;1;1;993;0;993;1;1;
/org.eclipse.jdt.core.tests.model/workspace/Formatter/test203/A_out.java;1;0;1;1;0;0;0;1;0;0;1;2424;0;0;1;0;0;1;1;2424;0;2424;1;1;
/org.eclipse.jdt.junit/src/org/eclipse/jdt/internal/junit/ui/CompareResultDialog.java;3;1;8;1;3;3;3;5;32;1;5;3417;78;78;1;0;0;5;8;3417;0;6340;8;3;
/org.eclipse.jdt.core.tests.model/workspace/Converter/src/test0269/Test.java;1;0;1;1;0;0;0;1;0;0;1;3714;0;0;1;0;0;1;1;3714;0;3714;1;1;
/org.eclipse.team.core/src/org/eclipse/team/internal/core/XMLMemento.java;1;0;3;1;0;0;0;3;406;1;3;2793;406;406;1;0;0;3;3;2793;0;4633;3;1;
/org.eclipse.swt.examples/src/org/eclipse/swt/examples/controlexample/GroupTab.java;1;0;2;1;0;0;0;2;8;1;2;2787;8;8;1;0;0;2;2;2787;0;2863;2;1;
/org.eclipse.ui.editors/src/org/eclipse/ui/texteditor/MarkerRulerInfoAction.java;2;0;3;1;1;1;1;2;31;1;2;1983;35;35;1;0;0;2;3;1983;0;6337;3;2;
/org.eclipse.team.ui/src/org/eclipse/team/internal/ui/synchronize/sets/SubscriberInput.java;2;0;6;2;0;0;0;6;246;2;5;2535;292;292;2;1;0;6;6;2708;1;4216;5;2;
/org.eclipse.update.ui.forms/Eclipse Forms/org/eclipse/ui/forms/ManagedForm.java;1;0;5;1;0;0;0;5;310;3;3;3151;310;310;3;2;0;5;5;3174;2;4157;3;1;
/org.eclipse.jdt.core/search/org/eclipse/jdt/internal/core/index/IQueryResult.java;1;0;1;1;0;0;0;1;0;0;1;3218;0;0;1;0;0;1;1;3218;0;3218;1;1;
/org.eclipse.pde/src/org/eclipse/pde/internal/PDE.java;1;1;3;1;2;2;2;1;18;0;1;4203;26;26;1;0;0;1;3;4203;0;6336;3;1;
/org.eclipse.jdt.core.tests.model/workspace/Converter/src/javadoc/test000/Test.java;1;0;1;1;0;0;0;1;0;0;1;3792;0;0;1;0;0;1;1;3792;0;3792;1;1;
/org.eclipse.jdt.debug.tests/tests/org/eclipse/jdt/debug/tests/eval/NestedTypeFieldValue_214.java;1;0;1;1;0;0;0;1;90;0;1;1274;90;90;1;0;0;1;1;1274;0;1274;1;1;
/org.eclipse.jdt.ui/core extension/org/eclipse/jdt/internal/corext/util/EncodingSupport.java;1;0;2;1;0;0;0;2;0;1;2;4046;0;0;1;0;0;2;2;4046;0;4651;2;1;
/org.eclipse.jdt.core/model/org/eclipse/jdt/internal/core/ImportDeclaration.java;2;1;13;1;3;3;3;10;14;2;9;85;75;75;2;1;0;10;13;1089;1;5614;12;2;
/org.eclipse.ui.workbench/Eclipse UI/org/eclipse/ui/internal/csm/roles/api/RoleManagerFactory.java;1;0;5;1;0;0;0;5;61;2;3;2213;64;64;2;2;0;5;5;2225;2;2238;3;1;
/org.eclipse.jdt.ui.tests.refactoring/resources/Paste/testPastingTypedResources1/out/A.java;1;0;2;1;0;0;0;2;1;1;2;1646;1;1;1;0;0;2;2;1646;0;1670;2;1;
/org.eclipse.jdt.ui.tests.refactoring/resources/MoveMembers/test24/out/B.java;1;0;1;1;0;0;0;1;1;0;1;1522;1;1;1;0;0;1;1;1522;0;1522;1;1;
/org.eclipse.team.core/src/org/eclipse/team/core/subscribers/helpers/TeamSubscriberRefreshOperation.java;1;0;1;1;0;0;0;1;0;0;1;3430;0;0;1;0;0;1;1;3430;0;3430;1;1;
/org.eclipse.jdt.debug.ui/ui/org/eclipse/jdt/internal/debug/ui/launcher/AppletWorkingDirectoryBlock.java;1;0;1;1;1;1;1;0;6;0;0;6247;6;6;1;0;0;0;1;6247;0;6247;1;1;
/org.eclipse.jdt.core.tests.model/workspace/Formatter/test493/MyClass_out.java;1;0;1;1;1;1;1;0;0;0;0;5254;0;0;1;0;0;0;1;5254;0;5254;1;1;
/org.eclipse.ui.workbench/Eclipse UI/org/eclipse/ui/activities/IdentifierEvent.java;3;1;6;1;2;2;2;4;28;2;3;2989;71;71;2;1;0;4;6;2989;1;6338;5;3;
/org.eclipse.ui.workbench/Eclipse UI/org/eclipse/ui/internal/progress/ProgressFeedbackManager.java;1;1;8;1;2;2;2;6;74;1;6;2177;157;157;1;0;0;6;8;2177;0;5129;8;1;
/org.eclipse.ui.intro/src/org/eclipse/ui/internal/intro/impl/util/ImageUtil.java;1;1;6;1;6;6;6;0;22;0;0;5115;59;59;1;0;0;0;6;5115;0;5760;6;1;
/org.eclipse.jface/src/org/eclipse/jface/wizard/IWizardContainer2.java;1;0;1;1;0;0;0;1;0;0;1;5087;0;0;1;0;0;1;1;5087;0;5087;1;1;
/org.eclipse.jdt.core.tests.model/workspace/Formatter/test055/A_in.java;1;0;1;1;0;0;0;1;0;0;1;2425;0;0;1;0;0;1;1;2425;0;2425;1;1;
/org.eclipse.jdt.core.tests.compiler/src/org/eclipse/jdt/core/tests/compiler/parser/CompletionParserTestKeyword.java;2;0;2;1;0;0;0;2;20;1;2;991;22;22;1;0;0;2;2;991;0;3560;2;2;
/org.eclipse.help/src/org/eclipse/help/internal/browser/CurrentBrowser.java;1;0;2;1;0;0;0;2;0;1;2;460;0;0;1;0;0;2;2;460;0;2732;2;1;
/org.eclipse.jdt.ui/ui/org/eclipse/jdt/internal/ui/preferences/formatter/WhiteSpaceTabPage2.java;1;0;2;1;0;0;0;2;0;1;2;3809;0;0;1;0;0;2;2;3809;0;3828;2;1;
/org.eclipse.core.resources.linux/src/org/eclipse/core/resources/refresh/linux/LinuxReplyHandler.java;1;0;3;1;0;0;0;3;1;1;3;4346;1;1;1;0;0;3;3;4346;0;4851;3;1;
/org.eclipse.pde.ui/sandbox/org/eclipse/pde/internal/ui/editor/standalone/text/XMLReconcilingStrategy.java;1;0;2;1;0;0;0;2;0;1;2;2320;0;0;1;0;0;2;2;2320;0;2906;2;1;
/org.eclipse.team.cvs.ui/src/org/eclipse/team/internal/ccvs/ui/merge/UpdateMergeAction.java;1;0;2;1;0;0;0;2;2;1;2;790;2;2;1;0;0;2;2;790;0;4217;2;1;
/org.eclipse.jdt.ui/ui/org/eclipse/jdt/internal/ui/callhierarchy/HistoryAction.java;3;1;5;1;2;2;2;3;21;1;3;155;32;32;1;0;0;3;5;155;0;6340;5;3;
/org.eclipse.jdt.ui.tests.refactoring/resources/ExtractMethodWorkSpace/ExtractMethodTests/nested_out/A_test652.java;1;0;2;1;0;0;0;2;4;1;2;130;5;5;1;0;0;2;2;130;0;844;2;1;
/org.eclipse.jdt.core.tests.model/workspace/Converter/src/javadoc/testBug55223/TestB.java;1;0;1;1;0;0;0;1;0;0;1;4679;0;0;1;0;0;1;1;4679;0;4679;1;1;
/org.eclipse.jdt.junit/src/org/eclipse/jdt/internal/junit/ui/OpenEditorAction.java;3;1;6;1;2;2;2;4;18;1;4;417;46;46;1;0;0;4;6;417;0;6340;6;3;
/org.eclipse.core.variables/src/org/eclipse/core/internal/variables/DynamicVariable.java;4;1;4;1;3;3;3;1;15;0;1;2514;21;21;1;0;0;1;4;2514;0;6336;4;4;
/org.eclipse.jdt.core.tests.model/workspace/Converter/src/javadoc/test018c/Test.java;1;0;2;1;0;0;0;2;0;1;2;4311;0;0;1;0;0;2;2;4311;0;4390;2;1;
/org.eclipse.jdt.core.tests.model/workspace/Converter/test0422/A.java;1;0;1;1;0;0;0;1;0;0;1;3714;0;0;1;0;0;1;1;3714;0;3714;1;1;
/org.eclipse.jdt.ui.tests.refactoring/test cases/org/eclipse/jdt/ui/tests/refactoring/CopyPackageChangeTest.java;2;0;2;1;1;1;1;1;6;0;1;3930;8;8;1;0;0;1;2;3930;0;6340;2;2;
/org.eclipse.pde.build/src/org/eclipse/pde/internal/build/packager/PackagerBuildScriptGenerator.java;2;1;18;1;7;7;7;11;39;1;11;447;112;112;1;0;0;11;18;447;0;6272;18;2;
/org.eclipse.ui.cheatsheets/src/org/eclipse/ui/internal/cheatsheets/views/CheatSheetItemEvent.java;1;0;2;1;0;0;0;2;0;1;2;4428;0;0;1;0;0;2;2;4428;0;4625;2;1;
/org.eclipse.team.webdav/src/org/eclipse/team/internal/webdav/ui/subscriber/WebDavImportWizard.java;2;1;9;1;5;5;5;4;100;1;4;3805;147;147;1;0;0;4;9;3805;0;6337;9;2;
/org.eclipse.swt/Eclipse SWT/gtk1x/org/eclipse/swt/widgets/ColorDialog.java;1;0;1;1;0;0;0;1;0;0;1;2327;0;0;1;0;0;1;1;2327;0;2327;1;1;
/org.eclipse.ui.cheatsheets/src/org/eclipse/ui/internal/cheatsheets/actions/OpenPerspective.java;1;1;2;1;2;2;2;0;19;0;0;5436;19;19;1;0;0;0;2;5436;0;5723;2;1;
/org.eclipse.ant.ui/Ant Editor/org/eclipse/ant/internal/ui/dtd/ISchema.java;1;0;1;1;0;0;0;1;0;0;1;1811;0;0;1;0;0;1;1;1811;0;1811;1;1;
/org.eclipse.jdt.ui.tests.refactoring/test cases/org/eclipse/jdt/ui/tests/refactoring/ChangeTypeRefactoringTests.java;2;1;9;1;2;2;2;7;29;2;6;2844;83;83;2;1;0;7;9;2844;1;6340;8;2;
/org.eclipse.jdt.ui.tests.refactoring/resources/MultiMove/test1/in/p2/C.java;1;0;1;1;0;0;0;1;4;0;1;1111;4;4;1;0;0;1;1;1111;0;1111;1;1;
/org.eclipse.jdt.ui.tests.refactoring/resources/ExtractTemp/canExtract/A_test68_out.java;1;0;1;1;0;0;0;1;0;0;1;1309;0;0;1;0;0;1;1;1309;0;1309;1;1;
/org.eclipse.debug.ui/ui/org/eclipse/debug/internal/ui/console/IConsoleView.java;2;0;2;1;0;0;0;2;0;1;2;1294;0;0;1;0;0;2;2;1294;0;2060;2;2;
/org.eclipse.ui.workbench/Eclipse UI/org/eclipse/ui/internal/MultiEditorOuterPane.java;2;1;2;1;2;2;2;0;2;0;0;5539;4;4;1;0;0;0;2;5539;0;6338;2;2;
/org.eclipse.jdt.ui/ui refactoring/org/eclipse/jdt/internal/ui/refactoring/reorg/ReorgMoveAction.java;4;1;12;1;2;2;2;10;69;1;10;1114;144;144;1;0;0;10;12;1114;0;6340;12;4;
/org.eclipse.team.ui/src/org/eclipse/team/internal/ui/target/ImportTargetSiteMainPage.java;2;0;3;1;0;0;0;3;2;1;3;990;4;4;1;0;0;3;3;990;0;2495;3;2;
/org.eclipse.ui.workbench/Eclipse UI/org/eclipse/ui/presentations/IStackPresentationSite.java;4;3;10;2;6;4;6;4;63;1;4;4469;163;163;3;0;2;4;10;5514;2;6340;8;4;
/org.eclipse.ui.ide/src/org/eclipse/ui/wizards/datatransfer/MinimizedFileSystemElement.java;2;0;3;1;0;0;0;3;19;1;3;1511;23;23;1;0;0;3;3;1511;0;1561;3;2;
/org.eclipse.jdt.core.tests.model/workspace/Formatter/test447/A_out.java;1;0;2;1;0;0;0;2;0;1;2;3611;0;0;1;0;0;2;2;3611;0;3673;2;1;
/org.eclipse.jdt.core.tests.model/workspace/Converter/src/test0544/A.java;1;0;1;1;1;1;1;0;0;0;0;5313;0;0;1;0;0;0;1;5313;0;5313;1;1;
/org.eclipse.core.resources/src/org/eclipse/core/internal/dtree/DataTreeReader.java;1;0;1;1;1;1;1;0;200;0;0;5146;200;200;1;0;0;0;1;5146;0;5146;1;1;
/org.eclipse.team.cvs.ui/src/org/eclipse/team/internal/ccvs/ui/CVSDecoratorPreferencesPage.java;2;0;2;1;0;0;0;2;30;1;2;276;33;33;1;0;0;2;2;276;0;2632;2;2;
/org.eclipse.core.resources/src/org/eclipse/core/internal/resources/MarkerManager.java;2;2;7;1;4;3;4;3;958;1;3;1744;1228;1228;2;0;1;3;7;5104;1;6206;6;2;
/org.eclipse.jdt.core/model/org/eclipse/jdt/internal/core/ImportDeclarationElementInfo.java;3;0;3;1;1;1;1;2;2;1;2;85;4;4;1;0;0;2;3;85;0;5916;3;3;
/org.eclipse.ui.workbench/Eclipse UI/org/eclipse/ui/internal/commands/util/old/CaptureEvent.java;1;0;3;1;0;0;0;3;2;2;2;1222;2;2;2;1;0;3;3;1321;1;1321;2;1;
/org.eclipse.jdt.ui.tests.refactoring/resources/IntroduceFactory/positive/MultiUnit1A_FFF_out.java;1;0;2;1;1;1;1;1;2;0;1;2862;2;2;1;0;0;1;2;2862;0;5659;2;1;
/org.eclipse.ui.ide/src/org/eclipse/ui/actions/AddTaskAction.java;1;0;2;1;0;0;0;2;0;1;2;2208;0;0;1;0;0;2;2;2208;0;2263;2;1;
/org.eclipse.ui.views/src/org/eclipse/ui/views/internal/markers/SelectAllAction.java;1;0;3;1;0;0;0;3;7;2;2;265;7;7;2;1;0;3;3;265;1;749;2;1;
/org.eclipse.pde.ui/sandbox/org/eclipse/pde/internal/ui/editor/standalone/AbstractXMLEditor.java;1;0;2;1;0;0;0;2;0;1;2;2320;0;0;1;0;0;2;2;2320;0;2906;2;1;
/org.eclipse.jdt.core.tests.model/workspace/Converter/src/test0204/Test.java;1;0;1;1;0;0;0;1;0;0;1;3714;0;0;1;0;0;1;1;3714;0;3714;1;1;
/org.eclipse.jdt.core/model/org/eclipse/jdt/internal/core/InitializerElementInfo.java;1;0;3;1;0;0;0;3;2;1;3;1804;5;5;1;0;0;3;3;1804;0;3560;3;1;
/org.eclipse.jdt.core/model/org/eclipse/jdt/internal/compiler/SourceElementRequestorAdapter.java;1;0;2;1;1;1;1;1;51;0;1;4461;51;51;1;0;0;1;2;4461;0;6141;2;1;
/org.eclipse.update.ui.forms/Eclipse Forms/org/eclipse/ui/forms/internal/widgets/FormsResources.java;1;0;2;1;0;0;0;2;0;1;2;3138;0;0;1;0;0;2;2;3138;0;4157;2;1;
/org.eclipse.ui.workbench.texteditor/src/org/eclipse/ui/texteditor/BasicTextEditorActionContributor.java;3;2;10;2;6;4;6;4;53;1;4;600;124;124;2;0;2;4;10;5123;2;6334;8;3;
/org.eclipse.core.runtime/src/org/eclipse/core/internal/jobs/ListEntry.java;1;0;1;1;0;0;0;1;0;0;1;629;0;0;1;0;0;1;1;629;0;629;1;1;
/org.eclipse.jdt.core.tests.model/workspace/Converter/test0368/A.java;1;0;1;1;0;0;0;1;0;0;1;3714;0;0;1;0;0;1;1;3714;0;3714;1;1;
/org.eclipse.osgi/resolver/src/org/eclipse/core/internal/dependencies/Element.java;3;1;4;1;3;3;3;1;21;0;1;3013;51;51;1;0;0;1;4;3013;0;5530;4;3;
/org.eclipse.ui.views/src/org/eclipse/ui/views/markers/internal/MarkerView.java;3;0;8;1;0;0;0;8;128;1;8;755;317;317;1;0;0;8;8;755;0;2738;8;3;
/org.eclipse.ui.ide/src/org/eclipse/ui/views/navigator/LocalSelectionTransfer.java;4;2;4;2;3;2;3;1;27;0;1;2208;32;32;2;0;1;1;4;6338;1;6338;3;4;
/org.eclipse.jface.text/src/org/eclipse/jface/contentassist/IContentAssistSubjectControl.java;1;2;3;1;3;2;3;0;129;0;0;5199;131;131;2;0;1;0;3;6340;1;6340;2;1;
/org.eclipse.jdt.debug.ui/ui/org/eclipse/jdt/internal/debug/ui/snippeteditor/SnippetAction.java;1;0;2;1;1;1;1;1;57;0;1;5068;62;62;1;0;0;1;2;5068;0;5520;2;1;
/org.eclipse.ui.workbench/Eclipse UI/org/eclipse/ui/commands/IPropertyListener.java;1;0;2;1;0;0;0;2;0;1;2;1119;0;0;1;0;0;2;2;1119;0;1222;2;1;
/org.eclipse.jface.text.tests/src/org/eclipse/jface/text/tests/JFaceTextSuite.java;1;0;2;1;1;1;1;1;0;0;1;5082;0;0;1;0;0;1;2;5082;0;5129;2;1;
/org.eclipse.ui.ide/src/org/eclipse/ui/views/navigator/GotoActionGroup.java;1;0;1;1;0;0;0;1;0;0;1;2208;0;0;1;0;0;1;1;2208;0;2208;1;1;
/org.eclipse.team.cvs.ui/src/org/eclipse/team/internal/ccvs/ui/operations/CheckoutSingleProjectOperation.java;2;0;6;1;1;1;1;5;71;1;5;276;123;123;1;0;0;5;6;276;0;6337;6;2;
/org.eclipse.jdt.core.tests.model/workspace/Converter/src/test0562/A.java;1;0;1;1;1;1;1;0;0;0;0;6078;0;0;1;0;0;0;1;6078;0;6078;1;1;
/org.eclipse.ui.workbench/Eclipse UI/org/eclipse/ui/intro/IIntroPart.java;1;1;8;1;3;3;3;5;105;1;5;3541;247;247;1;0;0;5;8;3541;0;5533;8;1;
/org.eclipse.ui.workbench/Eclipse UI/org/eclipse/ui/internal/AbstractPartSelectionTracker.java;2;1;3;1;2;2;2;1;12;0;1;1076;20;20;1;0;0;1;3;1076;0;6338;3;2;
/org.eclipse.ui.tests/Eclipse UI Tests/org/eclipse/ui/tests/compare/UIComparePreferences.java;2;0;2;1;0;0;0;2;8;1;2;2007;8;8;1;0;0;2;2;2007;0;2549;2;2;
/org.eclipse.ui.examples.javaeditor/Eclipse Java Editor Example/org/eclipse/ui/examples/javaeditor/util/JavaWordDetector.java;1;0;1;1;1;1;1;0;2;0;0;6340;2;2;1;0;0;0;1;6340;0;6340;1;1;
/org.eclipse.jdt.core.tests.model/workspace/Converter/src/test0086/Test.java;1;0;1;1;0;0;0;1;0;0;1;3714;0;0;1;0;0;1;1;3714;0;3714;1;1;
/org.eclipse.swt/Eclipse SWT PI/win32/org/eclipse/swt/internal/ole/win32/TYPEATTR.java;1;0;1;1;0;0;0;1;13;0;1;2915;13;13;1;0;0;1;1;2915;0;2915;1;1;
/org.eclipse.pde.ui/src/org/eclipse/pde/internal/ui/editor/build/BuildUndoManager.java;1;1;2;1;2;2;2;0;4;0;0;5431;4;4;1;0;0;0;2;5431;0;6336;2;1;
/org.eclipse.jdt.core.tests.compiler/src/org/eclipse/jdt/core/tests/eval/VariableTest.java;1;0;1;1;0;0;0;1;2;0;1;3560;2;2;1;0;0;1;1;3560;0;3560;1;1;
/org.eclipse.update.core/srcnew/org/eclipse/update/internal/search/UpdateSearchRequest.java;2;0;3;2;0;0;0;3;169;2;2;553;171;171;2;1;0;3;3;572;1;572;2;2;
/org.eclipse.jdt.debug.ui/ui/org/eclipse/jdt/internal/debug/ui/JDIDebugUIPlugin.java;6;1;23;1;9;9;9;14;43;2;13;307;188;188;2;1;0;14;23;4492;1;6336;22;6;
/org.eclipse.swt/Eclipse SWT Accessibility/emulated/org/eclipse/swt/accessibility/AccessibleFactory.java;1;0;2;1;0;0;0;2;4;0;1;1102;4;4;2;1;0;2;2;1102;1;1102;1;1;
/org.eclipse.jdt.core.tests.model/src/org/eclipse/jdt/core/tests/model/ClassFileTests.java;1;0;1;1;1;1;1;0;0;0;0;6357;0;0;1;0;0;0;1;6357;0;6357;1;1;
/org.eclipse.debug.core/core/org/eclipse/debug/core/sourcelookup/containers/ZipEntryStorage.java;2;0;2;1;1;1;1;1;5;0;1;4949;5;5;1;0;0;1;2;4949;0;5672;2;2;
/org.eclipse.jdt.ui.examples.javafamily/src/org/eclipse/jsp/launching/TomcatTabGroup.java;1;0;4;1;0;0;0;4;5;2;3;1373;8;8;2;1;0;4;4;1384;1;5091;3;1;
/org.eclipse.help.ui/src/org/eclipse/help/ui/internal/browser/embedded/EmbeddedBrowserAdapter.java;2;1;7;1;2;2;2;5;471;1;5;2898;672;672;1;0;0;5;7;2898;0;5490;7;2;
/org.eclipse.ui.views/src/org/eclipse/ui/views/navigator/ResourcePatternFilter.java;1;0;1;1;0;0;0;1;0;0;1;2738;0;0;1;0;0;1;1;2738;0;2738;1;1;
/org.eclipse.jdt.core.tests.model/workspace/JavaSearch/src/e5/A1.java;1;0;1;1;0;0;0;1;0;0;1;1128;0;0;1;0;0;1;1;1128;0;1128;1;1;
/org.eclipse.jface.text.tests/src/org/eclipse/jface/text/tests/UndoManagerTest.java;1;0;2;1;1;1;1;1;8;0;1;5082;8;8;1;0;0;1;2;5082;0;5104;2;1;
/org.eclipse.team.ui/src/org/eclipse/team/internal/ui/sync/sets/WorkingSetSyncSetInput.java;1;0;3;1;0;0;0;3;44;1;3;1289;44;44;1;0;0;3;3;1289;0;2632;3;1;
/org.eclipse.debug.ui/ui/org/eclipse/debug/internal/ui/sourcelookup/AddContainerAction.java;2;0;7;1;0;0;0;7;21;1;7;3770;55;55;1;0;0;7;7;3770;0;4970;7;2;
/org.eclipse.text/src/org/eclipse/text/edits/RangeMarker.java;2;0;4;1;1;1;1;3;23;1;3;1986;39;39;1;0;0;3;4;1986;0;6340;4;2;
/org.eclipse.ui.workbench/Eclipse UI/org/eclipse/ui/internal/commands/registry/PreferenceCommandRegistry.java;1;0;2;1;0;0;0;2;0;1;2;1422;0;0;1;0;0;2;2;1422;0;1724;2;1;
/org.eclipse.jdt.debug.jdi.tests/tests/org/eclipse/debug/jdi/tests/LocationTest.java;1;0;1;1;0;0;0;1;19;0;1;4264;19;19;1;0;0;1;1;4264;0;4264;1;1;
/org.eclipse.core.tests.runtime/src/org/eclipse/core/tests/internal/plugins/RegressionResolveTest_2.java;1;0;1;1;0;0;0;1;0;0;1;3014;0;0;1;0;0;1;1;3014;0;3014;1;1;
/org.eclipse.jdt.junit/src/org/eclipse/jdt/internal/junit/launcher/ContainerComparator.java;1;0;1;1;1;1;1;0;2;0;0;6340;2;2;1;0;0;0;1;6340;0;6340;1;1;
/org.eclipse.core.runtime.osgi/src/org/eclipse/core/internal/runtime/SafeFileOutputStream.java;1;0;2;1;0;0;0;2;171;1;2;3013;171;171;1;0;0;2;2;3013;0;3030;2;1;
/org.eclipse.sdk.tests-feature/plugins/org.eclipse.perfmsr.core/src/org/eclipse/perfmsr/core/PerfApplication.java;2;2;6;2;5;4;5;1;5;0;1;4845;9;9;2;0;1;1;6;5638;1;5924;5;2;
/org.eclipse.swt/Eclipse SWT PI/gtk1x/org/eclipse/swt/internal/gtk/GtkFrame.java;1;0;1;1;0;0;0;1;0;0;1;2327;0;0;1;0;0;1;1;2327;0;2327;1;1;
/org.eclipse.jdt.ui.tests.refactoring/resources/InlineMethodWorkspace/TestCases/simple_in/TestConstructor1.java;1;0;1;1;0;0;0;1;0;0;1;2493;0;0;1;0;0;1;1;2493;0;2493;1;1;
/org.eclipse.ui.examples.readmetool/Eclipse UI Examples Readme Tool/org/eclipse/ui/examples/readmetool/AddSentenceResolution.java;1;0;1;1;0;0;0;1;3;0;1;2738;3;3;1;0;0;1;1;2738;0;2738;1;1;
/org.eclipse.ant.ui/Ant Tools Support/org/eclipse/ant/internal/ui/preferences/AntClasspathContentProvider.java;2;0;12;1;1;1;1;11;206;1;11;1811;290;290;1;0;0;11;12;1811;0;6336;12;2;
/org.eclipse.jdt.core.tests.model/workspace/Converter/src/test0488/A.java;1;0;1;1;0;0;0;1;0;0;1;3714;0;0;1;0;0;1;1;3714;0;3714;1;1;
/org.eclipse.ui.ide/src/org/eclipse/ui/internal/misc/ContainerContentProvider.java;2;0;3;1;0;0;0;3;2;1;3;1526;2;2;1;0;0;3;3;1526;0;2263;3;2;
/org.eclipse.team.tests.cvs.core/src/org/eclipse/team/tests/ccvs/ui/old/BenchmarkTestSetup.java;1;0;2;1;0;0;0;2;0;1;2;2632;0;0;1;0;0;2;2;2632;0;4216;2;1;
/org.eclipse.pde.runtime/src/org/eclipse/pde/internal/runtime/logview/EventDetailsDialog.java;2;1;20;1;4;4;4;16;81;3;12;3630;311;311;3;4;0;16;20;3630;4;6336;16;2;
/org.eclipse.jdt.core.tests.model/workspace/Formatter/test384/A_out.java;1;0;1;1;0;0;0;1;0;0;1;3164;0;0;1;0;0;1;1;3164;0;3164;1;1;
/org.eclipse.ui.workbench/Eclipse UI/org/eclipse/ui/internal/contexts/registry/AbstractContextRegistry.java;1;0;4;1;0;0;0;4;21;2;3;1422;21;21;2;1;0;4;4;1629;1;1724;3;1;
/org.eclipse.swt.tests/JUnit Tests/org/eclipse/swt/tests/junit/Test_org_eclipse_swt_accessibility_AccessibleEvent.java;2;0;3;1;1;1;1;2;19;1;2;2104;23;23;1;0;0;2;3;2104;0;6352;3;2;
/org.eclipse.pde.ui/src/org/eclipse/pde/internal/ui/editor/plugin/RequiresSection.java;3;2;9;1;9;8;9;0;29;0;0;5431;72;72;2;0;1;0;9;5800;1;6336;8;3;
/org.eclipse.jdt.core.tests.model/workspace/Formatter/test462/A_in.java;1;0;1;1;0;0;0;1;0;0;1;3901;0;0;1;0;0;1;1;3901;0;3901;1;1;
/org.eclipse.pde.ui/sandbox/org/eclipse/pde/internal/ui/editor/standalone/XMLOutlinePage.java;1;0;2;1;0;0;0;2;0;1;2;2320;0;0;1;0;0;2;2;2320;0;2906;2;1;
/org.eclipse.jdt.core/model/org/eclipse/jdt/core/CompletionRequestor.java;1;0;1;1;0;0;0;1;0;0;1;4843;0;0;1;0;0;1;1;4843;0;4843;1;1;
/org.eclipse.update.ui/src/org/eclipse/update/internal/ui/InstallWizardAction.java;3;2;11;1;6;4;6;5;19;1;5;891;59;59;2;0;2;5;11;5386;2;5783;9;3;
/org.eclipse.jdt.core/search/org/eclipse/jdt/internal/core/search/matching/MethodDeclarationPattern.java;1;0;2;1;0;0;0;2;72;1;2;786;72;72;1;0;0;2;2;786;0;1115;2;1;
/org.eclipse.jdt.ui/core refactoring/org/eclipse/jdt/internal/corext/refactoring/structure/MovedMemberAnalyzer.java;4;1;11;1;5;5;5;6;88;1;6;1522;175;175;1;0;0;6;11;1522;0;6340;11;4;
/org.eclipse.team.cvs.core/src/org/eclipse/team/internal/ccvs/core/client/RemoteCommand.java;1;0;2;1;0;0;0;2;23;1;2;1842;26;26;1;0;0;2;2;1842;0;2529;2;1;
/org.eclipse.team.examples.filesystem/src/org/eclipse/team/examples/filesystem/StreamUtil.java;1;0;1;1;0;0;0;1;2;0;1;1708;2;2;1;0;0;1;1;1708;0;1708;1;1;
/org.eclipse.jdt.core.tests.model/workspace/Formatter/test336/A_out.java;1;0;1;1;0;0;0;1;0;0;1;2742;0;0;1;0;0;1;1;2742;0;2742;1;1;
/org.eclipse.pde.core/src/org/eclipse/pde/core/plugin/IPlugin.java;3;1;6;1;4;4;4;2;24;1;2;4203;36;36;1;0;0;2;6;4203;0;6336;6;3;
/org.eclipse.team.cvs.ui/src/org/eclipse/team/internal/ccvs/ui/subscriber/MergeSynchronizePage.java;1;0;6;1;0;0;0;6;56;1;6;2590;83;83;1;0;0;6;6;2590;0;4588;6;1;
/org.eclipse.swt.tests/JUnit Tests/org/eclipse/swt/tests/junit/Test_org_eclipse_swt_widgets_Canvas.java;1;0;2;1;0;0;0;2;12;1;2;2162;13;13;1;0;0;2;2;2162;0;2227;2;1;
/org.eclipse.jdt.core.tests.model/workspace/Converter/src/test0407/A.java;1;0;1;1;0;0;0;1;0;0;1;3714;0;0;1;0;0;1;1;3714;0;3714;1;1;
/org.eclipse.jdt.core.tests.model/workspace/Formatter/test464/A_out.java;1;0;1;1;0;0;0;1;0;0;1;3915;0;0;1;0;0;1;1;3915;0;3915;1;1;
/org.eclipse.jdt.core.tests.model/workspace/Formatter/test349/A_in.java;1;0;1;1;0;0;0;1;0;0;1;3029;0;0;1;0;0;1;1;3029;0;3029;1;1;
/org.eclipse.jdt.core.tests.model/workspace/Formatter/test305/A_out.java;1;0;1;1;0;0;0;1;0;0;1;2442;0;0;1;0;0;1;1;2442;0;2442;1;1;
/org.eclipse.help.tests/src/org/eclipse/help/tests/webapp/AllHelpWebappTests.java;1;1;3;1;2;2;2;1;16;0;1;1010;33;33;1;0;0;1;3;1010;0;6337;3;1;
/org.eclipse.update.core/srcnew/org/eclipse/update/internal/operations/JobRoot.java;1;0;7;1;0;0;0;7;45;2;6;460;86;86;2;1;0;7;7;646;1;825;6;1;
/org.eclipse.core.tools.resources/src/org/eclipse/core/tools/metadata/IStringDumpingStrategy.java;1;0;1;1;1;1;1;0;0;0;0;6302;0;0;1;0;0;0;1;6302;0;6302;1;1;
/org.eclipse.jdt.ui/ui/org/eclipse/jdt/internal/ui/search/ISearchRequestor.java;1;0;2;1;0;0;0;2;0;1;2;4625;0;0;1;0;0;2;2;4625;0;5075;2;1;
/org.eclipse.jdt.launching/launching/org/eclipse/jdt/launching/VMStandin.java;2;0;2;1;0;0;0;2;5;1;2;2988;7;7;1;0;0;2;2;2988;0;4493;2;2;
/org.eclipse.jface/src/org/eclipse/jface/viewers/ListViewer.java;3;0;3;1;1;1;1;2;362;1;2;2609;367;367;1;0;0;2;3;2609;0;6338;3;3;
/org.eclipse.ant.ui/Ant Editor/org/eclipse/ant/internal/ui/editor/text/AntEditorWhitespaceDetector.java;1;0;1;1;0;0;0;1;0;0;1;1811;0;0;1;0;0;1;1;1811;0;1811;1;1;
/org.eclipse.jdt.ui/ui/org/eclipse/jdt/internal/ui/text/correction/CorrectionMarkerResolutionGenerator.java;3;1;13;1;2;2;2;11;37;1;11;1034;96;96;1;0;0;11;13;1034;0;6340;13;3;
/org.eclipse.ant.ui/Ant Editor/org/eclipse/ant/ui/internal/editor/derived/LineBreakingReader.java;1;0;2;1;0;0;0;2;0;1;2;250;0;0;1;0;0;2;2;250;0;1811;2;1;
/org.eclipse.swt.tests/JUnit Tests/org/eclipse/swt/tests/junit/Test_org_eclipse_swt_events_SelectionEvent.java;1;0;2;1;1;1;1;1;7;0;1;3444;11;11;1;0;0;1;2;3444;0;6352;2;1;
/org.eclipse.pde.ui/src/org/eclipse/pde/internal/ui/editor/feature/PluginReference.java;1;0;2;1;1;1;1;1;4;0;1;4203;6;6;1;0;0;1;2;4203;0;6336;2;1;
/org.eclipse.jdt.core/model/org/eclipse/jdt/core/jdom/IDOMType.java;2;0;4;1;1;1;1;3;80;1;3;3560;88;88;1;0;0;3;4;3560;0;5584;4;2;
/org.eclipse.jdt.ui.tests.refactoring/resources/MoveInnerToTopLevel/test18/out/A1.java;1;0;1;1;0;0;0;1;1;0;1;305;1;1;1;0;0;1;1;305;0;305;1;1;
/org.eclipse.pde.ui/src/org/eclipse/pde/ui/templates/IVariableProvider.java;2;1;3;1;3;3;3;0;16;0;0;5115;34;34;1;0;0;0;3;5115;0;6336;3;2;
/org.eclipse.ui.workbench.texteditor/src/org/eclipse/ui/texteditor/link/EditorHistoryUpdater.java;2;1;4;1;3;3;3;1;14;0;1;4214;22;22;1;0;0;1;4;4214;0;5177;4;2;
/org.eclipse.pde.ui/src/org/eclipse/pde/internal/ui/wizards/plugin/FragmentFieldData.java;2;1;3;1;2;2;2;1;10;0;1;3986;14;14;1;0;0;1;3;3986;0;6336;3;2;
/org.eclipse.debug.ui/ui/org/eclipse/debug/ui/sourcelookup/SourceLookupTab.java;2;2;6;1;4;3;4;2;8;1;2;4953;22;22;2;0;1;2;6;5533;1;5893;5;2;
/org.eclipse.debug.ui/ui/org/eclipse/debug/internal/ui/launchConfigurations/OrganizeFavoritesAction.java;1;0;1;1;0;0;0;1;0;0;1;2312;0;0;1;0;0;1;1;2312;0;2312;1;1;
/org.eclipse.jdt.core.tests.model/workspace/Converter/src/test0149/Test.java;1;0;1;1;0;0;0;1;0;0;1;3714;0;0;1;0;0;1;1;3714;0;3714;1;1;
/org.eclipse.osgi/resolver/src/org/eclipse/osgi/internal/resolver/ResolverHelper.java;4;1;9;1;4;4;4;5;91;1;5;3013;262;262;1;0;0;5;9;3013;0;5408;9;4;
/org.eclipse.compare.examples.xml/src/org/eclipse/compare/examples/xml/ui/StatusDialog.java;1;0;2;1;0;0;0;2;2;1;2;1106;2;2;1;0;0;2;2;1106;0;3938;2;1;
/org.eclipse.jdt.text.tests/src/org/eclipse/jdt/ui/text/tests/HTML2TextReaderTester.java;1;1;3;1;2;2;2;1;4;0;1;5082;4;4;1;0;0;1;3;5082;0;5129;3;1;
/org.eclipse.jface.text/src/org/eclipse/jface/text/IInformationControlCreator.java;2;1;2;1;2;2;2;0;15;0;0;6340;17;17;1;0;0;0;2;6340;0;6359;2;2;
/org.eclipse.team.cvs.core/src/org/eclipse/team/internal/ccvs/core/client/DiffStructureVisitor.java;1;0;2;1;0;0;0;2;25;1;2;865;30;30;1;0;0;2;2;865;0;1843;2;1;
/org.eclipse.jdt.ui/ui/org/eclipse/jdt/internal/ui/text/correction/NewVariableCompletionProposal.java;3;1;30;1;5;5;5;25;247;2;24;311;787;787;2;1;0;25;30;1212;1;6340;29;3;
/org.eclipse.jdt.ui.tests.refactoring/resources/Delete/testDeleteWithinCu15/out/A.java;1;0;1;1;0;0;0;1;0;0;1;442;0;0;1;0;0;1;1;442;0;442;1;1;
/org.eclipse.team.cvs.ui/src/org/eclipse/team/internal/ccvs/ui/sync/ForceUpdateSyncAction.java;1;0;1;1;0;0;0;1;0;0;1;4217;0;0;1;0;0;1;1;4217;0;4217;1;1;
/org.eclipse.debug.core/core/org/eclipse/debug/internal/core/memory/IDynamicRenderingFactory.java;1;0;1;1;1;1;1;0;0;0;0;5254;0;0;1;0;0;0;1;5254;0;5254;1;1;
/org.eclipse.jdt.debug.ui/ui/org/eclipse/jdt/internal/debug/ui/actions/RetargettableActionAdapterFactory.java;1;0;5;1;0;0;0;5;22;3;3;4425;39;39;3;2;0;5;5;4492;2;4492;3;1;
/org.eclipse.jdt.ui/ui/org/eclipse/jdt/ui/text/IColorManager.java;1;2;3;1;3;2;3;0;13;0;0;6322;20;20;2;0;1;0;3;6352;1;6352;2;1;
/org.eclipse.debug.core/core/org/eclipse/debug/core/sourcelookup/ISourceContainerType.java;1;0;2;1;1;1;1;1;13;0;1;4949;13;13;1;0;0;1;2;4949;0;5109;2;1;
/org.eclipse.jdt.core.tests.model/workspace/Converter/src/test0181/Test.java;1;0;1;1;0;0;0;1;0;0;1;3714;0;0;1;0;0;1;1;3714;0;3714;1;1;
/org.eclipse.jdt.core.tests.model/workspace/Converter/test0267/Test.java;1;0;1;1;0;0;0;1;0;0;1;3714;0;0;1;0;0;1;1;3714;0;3714;1;1;
/org.eclipse.update.ui.win32/src/org/eclipse/welcome/internal/portal/HelpSection.java;1;0;2;1;0;0;0;2;13;1;2;925;13;13;1;0;0;2;2;925;0;2690;2;1;
/org.eclipse.swt/Eclipse SWT PI/gtk/org/eclipse/swt/internal/gtk/LONG.java;2;0;3;1;1;1;1;2;2;1;2;4171;4;4;1;0;0;2;3;4171;0;6352;3;2;
/org.eclipse.swt/Eclipse SWT/gtk/org/eclipse/swt/graphics/TextLayout.java;4;2;25;2;14;12;14;11;532;2;9;4563;1268;1268;2;2;2;11;25;4563;4;6352;21;4;
/org.eclipse.ui.workbench/Eclipse UI/org/eclipse/ui/internal/commands/api/older/IImageBinding.java;1;0;2;1;0;0;0;2;0;0;1;2562;0;0;2;1;0;2;2;2562;1;2562;1;1;
/org.eclipse.jdt.core/compiler/org/eclipse/jdt/internal/compiler/lookup/ParameterizedMethodBinding.java;1;0;1;1;0;0;0;1;0;0;1;4311;0;0;1;0;0;1;1;4311;0;4311;1;1;
/org.eclipse.update/src/org/eclipse/update/internal/ui/Main.java;1;0;1;1;1;1;1;0;0;0;0;6339;0;0;1;0;0;0;1;6339;0;6339;1;1;
/org.eclipse.jdt.ui.tests.refactoring/test cases/org/eclipse/jdt/ui/tests/refactoring/TestCopyParticipantShared.java;1;0;2;1;1;1;1;1;0;0;1;4913;0;0;1;0;0;1;2;4913;0;5190;2;1;
/org.eclipse.ltk.core.refactoring/src/org/eclipse/ltk/internal/core/refactoring/SaveListener.java;1;0;1;1;1;1;1;0;0;0;0;5162;0;0;1;0;0;0;1;5162;0;5162;1;1;
/org.eclipse.core.tests.runtime/src/org/eclipse/core/tests/runtime/PreferenceExportTest.java;1;1;2;1;2;2;2;0;9;0;0;5108;13;13;1;0;0;0;2;5108;0;5149;2;1;
/org.eclipse.ui.workbench/Eclipse UI/org/eclipse/ui/internal/commands/api/ICommandRegistry.java;1;0;5;1;0;0;0;5;2;2;4;1724;2;2;2;1;0;5;5;2515;1;2532;4;1;
/org.eclipse.jdt.ui/core refactoring/org/eclipse/jdt/internal/corext/refactoring/structure/MoveInstanceMethodRefactoring.java;4;1;14;1;3;3;3;11;22;1;11;122;102;102;1;0;0;11;14;122;0;6340;14;4;
/org.eclipse.jdt.core/dom/org/eclipse/jdt/core/dom/AST.java;6;2;69;2;14;11;14;55;1183;4;40;69;6231;6231;4;15;3;55;69;4711;18;6078;51;6;
/org.eclipse.jdt.core/formatter/org/eclipse/jdt/internal/formatter/impl/FormatterOptions.java;2;0;3;1;0;0;0;3;3;1;3;1395;5;5;1;0;0;3;3;1395;0;3673;3;2;
/org.eclipse.pde.build/src/org/eclipse/pde/internal/build/builder/AbstractBuildScriptGenerator.java;2;1;11;1;3;3;3;8;36;2;7;447;79;79;2;1;0;8;11;5036;1;5491;10;2;
/org.eclipse.jdt.debug.jdi.tests/tests/org/eclipse/debug/jdi/tests/program/TestClass5.java;1;0;1;1;1;1;1;0;3;0;0;6339;3;3;1;0;0;0;1;6339;0;6339;1;1;
/org.eclipse.swt/Eclipse SWT/gtk1x/org/eclipse/swt/widgets/Display.java;1;0;1;1;0;0;0;1;0;0;1;2327;0;0;1;0;0;1;1;2327;0;2327;1;1;
/org.eclipse.jdt.core.tests.model/workspace/Converter/src/test0130/Test.java;1;0;1;1;0;0;0;1;0;0;1;3714;0;0;1;0;0;1;1;3714;0;3714;1;1;
/org.eclipse.ui.ide/src/org/eclipse/ui/internal/ide/AboutItem.java;2;0;2;1;1;1;1;1;0;0;1;2264;0;0;1;0;0;1;2;2264;0;5485;2;2;
/org.eclipse.pde.ui/src_Forms/org/eclipse/pde/internal/ui/neweditor/site/FeatureSection.java;2;0;4;1;1;1;1;3;68;2;2;4832;70;70;2;1;0;3;4;4832;1;5431;3;2;
/org.eclipse.jdt.ui/core refactoring/org/eclipse/jdt/internal/corext/refactoring/structure/ASTData.java;1;1;2;1;2;2;2;0;0;0;0;5434;0;0;1;0;0;0;2;5434;0;5534;2;1;
/org.eclipse.ui.workbench/Eclipse UI/org/eclipse/ui/internal/dialogs/PerspContentProvider.java;4;1;11;2;2;2;2;9;156;2;7;2083;347;347;2;2;0;9;11;3008;2;6338;9;4;
/org.eclipse.jdt.core.tests.model/workspace/Formatter/test079/A_out.java;1;0;1;1;0;0;0;1;0;0;1;2425;0;0;1;0;0;1;1;2425;0;2425;1;1;
/org.eclipse.ui.presentations.r21/src/org/eclipse/ui/internal/presentations/r21/R21Colors.java;1;1;2;1;2;2;2;0;2;0;0;6075;2;2;1;0;0;0;2;6075;0;6338;2;1;
/org.eclipse.jdt.core.tests.model/workspace/Converter/test0389/A.java;1;0;1;1;0;0;0;1;0;0;1;3714;0;0;1;0;0;1;1;3714;0;3714;1;1;
/org.eclipse.core.tests.runtime/src/org/eclipse/core/tests/internal/runtime/AllTests.java;1;0;1;1;1;1;1;0;34;0;0;5149;34;34;1;0;0;0;1;5149;0;5149;1;1;
/org.eclipse.update.ui.forms/src/org/eclipse/ui/forms/HyperlinkSettings.java;1;0;6;1;0;0;0;6;67;2;4;3038;85;85;2;2;0;6;6;3051;2;3095;4;1;
/org.eclipse.ui.workbench/Eclipse UI/org/eclipse/ui/internal/CloseAllSavedAction.java;1;0;1;1;0;0;0;1;115;0;1;2737;115;115;1;0;0;1;1;2737;0;2737;1;1;
/org.eclipse.swt/Eclipse SWT/photon/org/eclipse/swt/internal/Platform.java;1;0;2;1;0;0;0;2;0;1;2;1955;0;0;1;0;0;2;2;1955;0;1969;2;1;
/org.eclipse.jdt.core.tests.model/workspace/Converter/test0275/Test.java;1;0;1;1;0;0;0;1;0;0;1;3714;0;0;1;0;0;1;1;3714;0;3714;1;1;
/org.eclipse.text/projection/org/eclipse/jface/text/ProjectionDocument.java;1;0;2;1;1;1;1;1;1;0;1;4516;1;1;1;0;0;1;2;4516;0;5177;2;1;
/org.eclipse.pde.core/src/org/eclipse/pde/internal/core/plugin/AbstractExtensions.java;3;1;7;1;3;3;3;4;27;1;4;2184;68;68;1;0;0;4;7;2184;0;6336;7;3;
/org.eclipse.team.webdav/src/org/eclipse/team/internal/webdav/ui/subscriber/WebDavParticipantPage.java;2;0;3;1;0;0;0;3;36;1;3;3499;36;36;1;0;0;3;3;3499;0;4588;3;2;
/org.eclipse.ui.workbench/Eclipse UI/org/eclipse/ui/internal/commands/FileCommandRegistry.java;1;0;5;1;0;0;0;5;4;2;4;1400;8;8;2;1;0;5;5;1400;1;2532;4;1;
/org.eclipse.ui.workbench/Eclipse UI/org/eclipse/ui/internal/activities/ui/ActivityLabelProvider.java;2;0;6;1;0;0;0;6;52;1;6;2444;101;101;1;0;0;6;6;2444;0;3066;6;2;
/org.eclipse.ui.ide/src/org/eclipse/ui/dialogs/WizardNewFileCreationPage.java;2;0;3;1;0;0;0;3;24;1;3;1511;24;24;1;0;0;3;3;1511;0;2263;3;2;
/org.eclipse.pde.ui/src/org/eclipse/pde/internal/ui/preferences/TargetPlatformPreferenceNode.java;2;1;3;1;2;2;2;1;4;0;1;3986;8;8;1;0;0;1;3;3986;0;6336;3;2;
/org.eclipse.ui.tests/Eclipse UI Tests/org/eclipse/ui/tests/adaptable/TestMarkerImageProvider.java;1;0;1;1;0;0;0;1;0;0;1;4245;0;0;1;0;0;1;1;4245;0;4245;1;1;
/org.eclipse.jdt.debug.ui/ui/org/eclipse/jdt/internal/debug/ui/actions/AttachSourceAction.java;3;1;7;1;2;2;2;5;74;1;5;1240;174;174;1;0;0;5;7;1240;0;5475;7;3;
/org.eclipse.ui.workbench/Eclipse UI/org/eclipse/ui/internal/commands/PluginRegistry.java;1;0;5;1;0;0;0;5;152;2;3;1356;181;181;2;2;0;5;5;1370;2;1389;3;1;
/org.eclipse.jdt.core/search/org/eclipse/jdt/internal/core/search/matching/VariableLocator.java;2;0;4;1;1;1;1;3;103;1;3;2514;107;107;1;0;0;3;4;2514;0;5207;4;2;
/org.eclipse.jdt.ui.tests.refactoring/resources/Copy/test_initializer_yes_type/out/A.java;1;0;2;1;0;0;0;2;2;1;2;685;2;2;1;0;0;2;2;685;0;696;2;1;
/org.eclipse.ui.externaltools/Ant Tools Support/org/eclipse/ui/externaltools/internal/ant/launchConfigurations/AntTargetContentProvider.java;1;0;1;1;0;0;0;1;0;0;1;282;0;0;1;0;0;1;1;282;0;282;1;1;
/org.eclipse.pde.ui/src/org/eclipse/pde/internal/ui/editor/manifest/ManifestFormOutlinePage.java;2;0;4;1;1;1;1;3;3;1;3;368;7;7;1;0;0;3;4;368;0;5431;4;2;
/org.eclipse.jdt.core/compiler/org/eclipse/jdt/internal/compiler/problem/DefaultProblem.java;4;1;9;1;2;2;2;7;79;2;6;992;170;170;2;1;0;7;9;992;1;5615;8;4;
/org.eclipse.debug.ui/ui/org/eclipse/debug/internal/ui/console/MessageConsolePartitioner.java;2;0;3;1;0;0;0;3;32;2;2;1418;32;32;2;1;0;3;3;1418;1;2060;2;2;
/org.eclipse.jdt.ui/ui/org/eclipse/jdt/internal/ui/text/link/ILinkedPositionListener.java;1;0;2;1;0;0;0;2;2;1;2;2133;2;2;1;0;0;2;2;2133;0;3030;2;1;
/org.eclipse.jdt.debug.jdi.tests/tests/org/eclipse/debug/jdi/tests/program/TestClazz10.java;1;0;1;1;1;1;1;0;3;0;0;6339;3;3;1;0;0;0;1;6339;0;6339;1;1;
/org.eclipse.jface.text/src/org/eclipse/jface/text/templates/TemplateContext.java;1;0;2;1;0;0;0;2;0;0;1;4258;0;0;2;1;0;2;2;4258;1;4258;1;1;
/org.eclipse.jdt.ui.tests.refactoring/test cases/org/eclipse/jdt/ui/tests/refactoring/PathTransformationTests.java;1;0;1;1;1;1;1;0;2;0;0;6340;2;2;1;0;0;0;1;6340;0;6340;1;1;
/org.eclipse.osgi/eclipseAdaptor/src/org/eclipse/core/runtime/adaptor/EclipseStarter.java;5;3;69;2;26;19;26;43;240;3;34;3013;2327;2327;3;9;7;43;69;3275;16;6339;53;5;
/org.eclipse.jdt.core/model/org/eclipse/jdt/core/JavaCore.java;6;3;135;3;28;19;28;107;350;4;74;13;4387;4387;4;33;9;107;135;529;42;6077;93;6;
/org.eclipse.ui.cheatsheets/src/org/eclipse/ui/cheatsheets/IItem.java;1;0;2;1;0;0;0;2;0;1;2;4428;0;0;1;0;0;2;2;4428;0;4625;2;1;
/org.eclipse.jdt.ui.tests.refactoring/test cases/org/eclipse/jdt/ui/tests/refactoring/LineColumnSelectionTestCase.java;2;0;4;1;1;1;1;3;45;1;3;2281;52;52;1;0;0;3;4;2281;0;6340;4;2;
/org.eclipse.swt/Eclipse SWT Printing/motif/org/eclipse/swt/printing/Printer.java;4;1;8;1;4;4;4;4;15;1;4;0;46;46;1;0;0;4;8;0;0;6352;8;4;
/org.eclipse.team.ui/src/org/eclipse/team/internal/ui/sync/views/INavigableControl.java;1;0;3;1;0;0;0;3;16;1;3;1158;16;16;1;0;0;3;3;1158;0;2632;3;1;
/org.eclipse.swt/Eclipse SWT/emulated/tabfolder/org/eclipse/swt/widgets/TabFolder.java;3;1;6;1;2;2;2;4;20;1;4;269;36;36;1;0;0;4;6;269;0;6352;6;3;
/org.eclipse.jdt.ui.tests.refactoring/resources/Paste/test4/in/A.java;1;0;1;1;0;0;0;1;0;0;1;1311;0;0;1;0;0;1;1;1311;0;1311;1;1;
/org.eclipse.swt/Eclipse SWT/gtk/org/eclipse/swt/graphics/Region.java;4;1;6;2;2;2;2;4;87;2;3;1657;232;232;2;1;0;4;6;2261;1;6352;5;4;
/org.eclipse.jdt.ui.tests.refactoring/resources/TypeConstraints/A_testConstraints20.java;1;0;1;1;0;0;0;1;0;0;1;60;0;0;1;0;0;1;1;60;0;60;1;1;
/org.eclipse.core.resources/src/org/eclipse/core/resources/IResourceChangeListener.java;1;0;2;1;1;1;1;1;44;0;1;4994;46;46;1;0;0;1;2;4994;0;5146;2;1;
/org.eclipse.ui.workbench.texteditor/src/org/eclipse/ui/texteditor/IDocumentProviderOperationRunner.java;1;0;1;1;0;0;0;1;0;0;1;1983;0;0;1;0;0;1;1;1983;0;1983;1;1;
/org.eclipse.team.cvs.core/src/org/eclipse/team/internal/ccvs/core/syncinfo/CVSRemoteSynchronizer.java;2;0;4;1;0;0;0;4;5;2;3;1954;7;7;2;1;0;4;4;1954;1;4216;3;2;
/org.eclipse.jdt.core.tests.model/workspace/Formatter/test496/A_in.java;1;0;1;1;1;1;1;0;0;0;0;5381;0;0;1;0;0;0;1;5381;0;5381;1;1;
/org.eclipse.jdt.core.tests.model/workspace/Converter/src/test0520/A.java;1;0;2;1;0;0;0;2;5;1;2;3714;5;5;1;0;0;2;2;3714;0;3886;2;1;
/org.eclipse.jdt.debug.ui/ui/org/eclipse/jdt/internal/debug/ui/actions/ExecuteAction.java;2;0;2;1;0;0;0;2;16;1;2;1759;20;20;1;0;0;2;2;1759;0;1794;2;2;
/org.eclipse.jdt.ui/core refactoring/org/eclipse/jdt/internal/corext/refactoring/code/flow/TryFlowInfo.java;1;0;1;1;1;1;1;0;2;0;0;6340;2;2;1;0;0;0;1;6340;0;6340;1;1;
/org.eclipse.team.ui/src/org/eclipse/team/ui/synchronize/subscribers/SubscriberPageConfiguration.java;1;0;1;1;0;0;0;1;0;0;1;5048;0;0;1;0;0;1;1;5048;0;5048;1;1;
/org.eclipse.jdt.core.tests.model/workspace/Converter/src/javadoc/testBug52908/Y.java;1;0;1;1;0;0;0;1;0;0;1;4311;0;0;1;0;0;1;1;4311;0;4311;1;1;
/org.eclipse.jdt.core.tests.model/workspace/Formatter/test154/A_out.java;2;0;2;1;0;0;0;2;30;1;2;2425;30;30;1;0;0;2;2;2425;0;3362;2;2;
/org.eclipse.pde.ui/src/org/eclipse/pde/internal/ui/editor/site/CategorySection.java;3;1;11;1;9;9;9;2;576;1;2;2311;1017;1017;1;0;0;2;11;2311;0;6336;11;3;
/org.eclipse.ui.externaltools/Ant Editor/org/eclipse/ui/externaltools/internal/ant/editor/text/XMLMarkerAnnotation.java;1;0;1;1;0;0;0;1;0;0;1;282;0;0;1;0;0;1;1;282;0;282;1;1;
/org.eclipse.jdt.ui.tests/ui/org/eclipse/jdt/ui/tests/quickfix/LocalCorrectionsQuickFixTest.java;3;2;33;1;10;9;10;23;386;2;20;393;2847;2847;2;3;1;23;33;1312;4;6340;29;3;
/org.eclipse.pde.ui/src/org/eclipse/pde/internal/ui/search/PluginJavaSearchUtil.java;1;1;2;1;2;2;2;0;4;0;0;5661;8;8;1;0;0;0;2;5661;0;6336;2;1;
/org.eclipse.jdt.ui.tests.refactoring/resources/Delete/testDeleteWithinCu19/out/A.java;1;0;1;1;0;0;0;1;1;0;1;444;1;1;1;0;0;1;1;444;0;444;1;1;
/org.eclipse.ui.views/src/org/eclipse/ui/views/tasklist/PurgeCompletedAction.java;1;0;1;1;0;0;0;1;0;0;1;2738;0;0;1;0;0;1;1;2738;0;2738;1;1;
/org.eclipse.team.tests.cvs.core/src/org/eclipse/team/tests/ccvs/ui/unit/MenuEnablementTest.java;2;0;3;1;0;0;0;3;3;1;3;994;4;4;1;0;0;3;3;994;0;2632;3;2;
/org.eclipse.team.cvs.ui/src/org/eclipse/team/internal/ccvs/ui/repo/CVSRepoViewAction.java;2;0;3;1;1;1;1;2;48;1;2;2569;50;50;1;0;0;2;3;2569;0;6337;3;2;
/org.eclipse.ui.workbench/Eclipse UI/org/eclipse/ui/internal/keys/KdeKeyFormatter.java;1;0;2;1;0;0;0;2;6;1;2;3329;6;6;1;0;0;2;2;3329;0;3350;2;1;
/org.eclipse.pde.ui/src/org/eclipse/pde/internal/ui/editor/manifest/ExtensionSection.java;1;0;2;1;1;1;1;1;5;0;1;1111;5;5;1;0;0;1;2;1111;0;5431;2;1;
/org.eclipse.update.ui/srcnew/org/eclipse/update/internal/ui/wizards/UnifiedOptionalFeaturesPage.java;3;0;7;2;0;0;0;7;81;3;5;478;109;109;3;2;0;7;7;478;2;825;5;3;
/org.eclipse.ui.versioncheck/src/org/eclipse/ui/internal/versioncheck/VersionCheckPlugin.java;1;0;1;1;0;0;0;1;25;0;1;620;25;25;1;0;0;1;1;620;0;620;1;1;
/org.eclipse.ui.workbench/Eclipse UI/org/eclipse/ui/internal/commands/KeyBindingMachine.java;1;0;19;1;0;0;0;19;532;5;11;1374;1013;1013;5;8;0;19;19;1388;8;2562;11;1;
/org.eclipse.debug.ui/ui/org/eclipse/debug/internal/ui/sourcelookup/ResolveDuplicatesHandler.java;1;0;3;1;1;1;1;2;6;0;1;4609;9;9;2;1;0;2;3;4609;1;5896;2;1;
/org.eclipse.pde.ui/templates_3.0/popupMenus/java/$actionClass$.java;1;0;1;1;0;0;0;1;0;0;1;2786;0;0;1;0;0;1;1;2786;0;2786;1;1;
/org.eclipse.jdt.ui/core refactoring/org/eclipse/ltk/core/refactoring/participants/MoveParticipant.java;1;0;2;1;0;0;0;2;0;1;2;4624;0;0;1;0;0;2;2;4624;0;4864;2;1;
/org.eclipse.jdt.core/dom/org/eclipse/jdt/core/dom/ASTSyntaxErrorPropagator.java;4;0;4;1;1;1;1;3;14;1;3;764;20;20;1;0;0;3;4;764;0;5384;4;4;
/org.eclipse.jdt.core.tests.model/workspace/Converter/test0147/Test.java;1;0;1;1;0;0;0;1;0;0;1;3714;0;0;1;0;0;1;1;3714;0;3714;1;1;
/org.eclipse.jdt.core/compiler/org/eclipse/jdt/internal/compiler/ast/StringLiteralConcetanation.java;1;2;3;1;3;2;3;0;2;0;0;5617;2;2;2;0;1;0;3;5617;1;5635;2;1;
/org.eclipse.team.cvs.ui/src/org/eclipse/team/internal/ccvs/ui/wizards/SharingWizard.java;2;1;32;2;8;8;8;24;592;3;19;866;1141;1141;3;5;0;24;32;4869;5;6337;27;2;
/org.eclipse.pde.ui/src_samples/org/eclipse/pde/ui/internal/samples/SampleOperation.java;3;1;6;1;4;4;4;2;86;1;2;4523;163;163;1;0;0;2;6;4523;0;6336;6;3;
/org.eclipse.jdt.ui.tests.refactoring/resources/ExtractMethodWorkSpace/ExtractMethodTests/locals_out/A_test513.java;1;0;2;1;0;0;0;2;9;1;2;130;10;10;1;0;0;2;2;130;0;844;2;1;
/org.eclipse.jface.text/src/org/eclipse/jface/text/contentassist/IContextInformationExtension.java;1;2;3;1;3;2;3;0;7;0;0;6340;9;9;2;0;1;0;3;6353;1;6353;2;1;
/org.eclipse.jdt.ui.tests.refactoring/resources/ExtractInterface/testConditional1/in/A.java;1;0;1;1;0;0;0;1;0;0;1;3902;0;0;1;0;0;1;1;3902;0;3902;1;1;
/org.eclipse.ui.workbench/Eclipse UI/org/eclipse/ui/dialogs/ListSelectionDialog.java;2;0;3;1;1;1;1;2;296;1;2;1674;305;305;1;0;0;2;3;1674;0;5467;3;2;
/org.eclipse.jdt.core.tests.model/workspace/Resolve/src/ResolveLocalFieldDeclaration.java;1;0;1;1;0;0;0;1;0;0;1;1970;0;0;1;0;0;1;1;1970;0;1970;1;1;
/org.eclipse.ui.workbench.texteditor/src/org/eclipse/ui/texteditor/IMarkerUpdater.java;1;0;1;1;0;0;0;1;0;0;1;2741;0;0;1;0;0;1;1;2741;0;2741;1;1;
/org.eclipse.jdt.debug/jdi/org/eclipse/jdi/internal/VirtualMachineManagerImpl.java;3;1;3;1;2;2;2;1;20;0;1;4267;25;25;1;0;0;1;3;4267;0;6084;3;3;
/org.eclipse.team.core/src/org/eclipse/team/core/subscribers/helpers/SyncTreeSubscriber.java;1;0;1;1;0;0;0;1;0;0;1;3240;0;0;1;0;0;1;1;3240;0;3240;1;1;
/org.eclipse.jdt.ui/core refactoring/org/eclipse/jdt/internal/corext/refactoring/base/ChangeAbortException.java;1;0;1;1;0;0;0;1;0;0;1;4575;0;0;1;0;0;1;1;4575;0;4575;1;1;
/org.eclipse.team.core/src/org/eclipse/team/core/RemoteContentsCache.java;1;0;1;1;0;0;0;1;0;0;1;3966;0;0;1;0;0;1;1;3966;0;3966;1;1;
/org.eclipse.jdt.ui.tests.refactoring/resources/IntroduceFactory/Bugzilla/48504/p1/A_out.java;1;1;2;1;2;2;2;0;2;0;0;5629;2;2;1;0;0;0;2;5629;0;5659;2;1;
/org.eclipse.jdt.ui/core refactoring/org/eclipse/jdt/internal/corext/refactoring/participants/SharableParticipants.java;1;0;2;1;0;0;0;2;0;1;2;1668;0;0;1;0;0;2;2;1668;0;4624;2;1;
/org.eclipse.team.cvs.ui/src/org/eclipse/team/internal/ccvs/ui/actions/ReplaceWithTagAction.java;2;0;4;1;1;1;1;3;65;1;3;1133;82;82;1;0;0;3;4;1133;0;6337;4;2;
/org.eclipse.jdt.core.tests.model/workspace/Converter15/src/test0028/X.java;1;0;1;1;0;0;0;1;0;0;1;4870;0;0;1;0;0;1;1;4870;0;4870;1;1;
/org.eclipse.pde.ui/src/org/eclipse/pde/internal/ui/editor/PDEMasterDetailsBlock.java;2;2;4;1;4;3;4;0;10;0;0;5431;20;20;2;0;1;0;4;5431;1;6336;3;2;
/org.eclipse.team.core/src/org/eclipse/team/core/subscribers/ITeamStatus.java;1;0;1;1;0;0;0;1;0;0;1;3171;0;0;1;0;0;1;1;3171;0;3171;1;1;
/org.eclipse.update.tests.core/src/org/eclipse/update/tests/standalone/TestBundlesInstall.java;2;0;5;1;1;1;1;4;4;1;4;4134;9;9;1;0;0;4;5;4134;0;6336;5;2;
/org.eclipse.ui.workbench/Eclipse UI/org/eclipse/ui/internal/dialogs/CreateLinkedResourceGroup.java;2;0;4;1;0;0;0;4;46;2;3;534;48;48;2;1;0;4;4;534;1;2737;3;2;
/org.eclipse.core.resources/src/org/eclipse/core/internal/resources/MarkerReader_1.java;2;0;2;1;1;1;1;1;205;0;1;1744;207;207;1;0;0;1;2;1744;0;5146;2;2;
/org.eclipse.jdt.ui/ui/org/eclipse/jdt/internal/ui/filters/ClosedProjectFilter.java;1;0;1;1;1;1;1;0;2;0;0;6340;2;2;1;0;0;0;1;6340;0;6340;1;1;
/org.eclipse.ui.workbench.texteditor/src/org/eclipse/ui/texteditor/templates/EditTemplateDialog.java;3;1;11;1;7;7;7;4;35;2;3;4627;165;165;2;1;0;4;11;4627;1;6340;10;3;
/org.eclipse.debug.ui/ui/org/eclipse/debug/internal/ui/preferences/LaunchingPreferencePage.java;4;1;6;1;4;4;4;2;31;1;2;4855;62;62;1;0;0;2;6;4855;0;5407;6;4;
/org.eclipse.ui.intro/src/org/eclipse/ui/internal/intro/impl/parts/ContextHelpStandbyPart.java;1;1;7;1;7;7;7;0;46;0;0;5305;72;72;1;0;0;0;7;5305;0;5867;7;1;
/org.eclipse.jdt.core/search/org/eclipse/jdt/internal/core/search/matching/OrLocator.java;3;0;11;1;0;0;0;11;133;2;9;1986;187;187;2;2;0;11;11;2005;2;4304;9;3;
/org.eclipse.jface.text/src/org/eclipse/jface/text/contentassist/IContextInformationValidator.java;1;2;4;1;4;3;4;0;15;0;0;5199;19;19;2;0;1;0;4;6353;1;6353;3;1;
/org.eclipse.pde.ui/src/org/eclipse/pde/internal/ui/wizards/templates/PDETemplateSection.java;2;1;3;1;2;2;2;1;7;0;1;3986;15;15;1;0;0;1;3;3986;0;6336;3;2;
/org.eclipse.core.tests.resources/src/org/eclipse/core/tests/internal/localstore/LocalStoreTest.java;2;0;3;1;2;1;2;1;271;0;1;1878;289;289;2;0;1;1;3;5147;1;5147;2;2;
/org.eclipse.jdt.ui.examples.projects/examples/org/eclipse/jdt/internal/ui/exampleprojects/ExampleProjectsPlugin.java;1;0;1;1;1;1;1;0;2;0;0;6340;2;2;1;0;0;0;1;6340;0;6340;1;1;
/org.eclipse.update.core/src/org/eclipse/update/standalone/ListConfigFeaturesCommand.java;1;2;4;1;3;2;3;1;14;0;1;4928;21;21;2;0;1;1;4;5487;1;5487;3;1;
/org.eclipse.jdt.debug.ui/ui/org/eclipse/jdt/debug/ui/launchConfigurations/JavaArgumentsTab.java;2;1;6;1;2;2;2;4;40;1;4;1136;83;83;1;0;0;4;6;1136;0;6336;6;2;
/org.eclipse.swt.tests/JUnit Tests/org/eclipse/swt/tests/junit/Test_org_eclipse_swt_graphics_ImageLoaderListener.java;1;0;1;1;0;0;0;1;16;0;1;2175;16;16;1;0;0;1;1;2175;0;2175;1;1;
/org.eclipse.jdt.core.tests.model/workspace/Formatter/test188/A_in.java;1;0;1;1;0;0;0;1;0;0;1;2425;0;0;1;0;0;1;1;2425;0;2425;1;1;
/org.eclipse.ui.workbench/Eclipse UI/org/eclipse/ui/internal/dnd/AbstractDropTarget.java;2;0;2;1;0;0;0;2;35;1;2;3770;35;35;1;0;0;2;2;3770;0;4015;2;2;
/org.eclipse.debug.ui/ui/org/eclipse/debug/internal/ui/stringsubstitution/StringPrompt.java;2;0;2;1;1;1;1;1;2;0;1;2081;2;2;1;0;0;1;2;2081;0;6339;2;2;
/org.eclipse.ui.workbench/Eclipse UI/org/eclipse/ui/internal/PluginActionSet.java;2;1;2;1;2;2;2;0;2;0;0;6145;3;3;1;0;0;0;2;6145;0;6338;2;2;
/org.eclipse.pde.ui/src/org/eclipse/pde/internal/ui/build/ClasspathHelper.java;1;1;2;1;2;2;2;0;10;0;0;5880;10;10;1;0;0;0;2;5880;0;6336;2;1;
/org.eclipse.team.core/src/org/eclipse/team/core/subscribers/SyncInfoSet.java;1;0;1;1;0;0;0;1;0;0;1;3550;0;0;1;0;0;1;1;3550;0;3550;1;1;
/org.eclipse.ui.workbench/Eclipse UI/org/eclipse/ui/commands/internal/GestureSupport.java;1;0;2;1;0;0;0;2;0;1;2;786;0;0;1;0;0;2;2;786;0;956;2;1;
/org.eclipse.help.base/src/org/eclipse/help/internal/browser/BrowserLog.java;1;1;5;1;3;3;3;2;27;0;1;1740;47;47;2;1;0;2;5;1740;1;6337;4;1;
/org.eclipse.jdt.core.tests.model/workspace/Formatter/test210/A_in.java;1;0;1;1;0;0;0;1;0;0;1;2424;0;0;1;0;0;1;1;2424;0;2424;1;1;
/org.eclipse.ui.workbench/Eclipse UI/org/eclipse/ui/contexts/ContextException.java;3;1;3;1;2;2;2;1;22;0;1;4969;26;26;1;0;0;1;3;4969;0;6338;3;3;
/org.eclipse.jdt.core.tests.model/workspace/Formatter/test494/A_out.java;1;0;1;1;1;1;1;0;0;0;0;5381;0;0;1;0;0;0;1;5381;0;5381;1;1;
/org.eclipse.team.ui/src/org/eclipse/team/internal/ui/jobs/JobStateCategory.java;1;0;3;1;0;0;0;3;26;1;3;1081;30;30;1;0;0;3;3;1081;0;1369;3;1;
/org.eclipse.jdt.core.tests.model/workspace/Formatter/test184/A_in.java;1;0;2;1;1;1;1;1;19;0;1;2425;19;19;1;0;0;1;2;2425;0;5132;2;1;
/org.eclipse.ui.workbench/Eclipse UI/org/eclipse/ui/internal/commands/old/ICommand.java;1;0;9;1;0;0;0;9;26;2;8;1223;59;59;2;1;0;9;9;1321;1;1695;8;1;
/org.eclipse.jdt.ui/ui/org/eclipse/jdt/internal/ui/text/correction/NewDefiningMethodProposal.java;1;1;3;1;3;3;3;0;30;0;0;5530;36;36;1;0;0;0;3;5530;0;5780;3;1;
/org.eclipse.jdt.ui.tests.refactoring/resources/ExtractInterface/test96/out/A.java;1;0;1;1;0;0;0;1;0;0;1;1153;0;0;1;0;0;1;1;1153;0;1153;1;1;
/org.eclipse.pde.ui/src/org/eclipse/pde/internal/ui/editor/manifest/JavaAttributeValue.java;1;0;1;1;1;1;1;0;0;0;0;5431;0;0;1;0;0;0;1;5431;0;5431;1;1;
/org.eclipse.ui.tests/Eclipse UI Tests/org/eclipse/ui/tests/navigator/DuplicateMenuItemTest.java;1;0;1;1;0;0;0;1;3;0;1;3091;3;3;1;0;0;1;1;3091;0;3091;1;1;
/org.eclipse.jdt.core.tests.model/workspace/Formatter/test237/A_out.java;1;0;1;1;0;0;0;1;0;0;1;2437;0;0;1;0;0;1;1;2437;0;2437;1;1;
/org.eclipse.team.ui/src/org/eclipse/team/ui/synchronize/presentation/DiffNodeControllerCompressedFolders.java;1;0;1;1;0;0;0;1;0;0;1;4077;0;0;1;0;0;1;1;4077;0;4077;1;1;
/org.eclipse.jdt.ui/ui/org/eclipse/jdt/internal/ui/preferences/QuickdiffConfigurationBlock.java;2;3;9;1;9;6;9;0;86;0;0;5109;199;199;3;0;3;0;9;5500;3;5500;6;2;
/org.eclipse.ui.ide/src/org/eclipse/ui/views/navigator/OpenActionGroup.java;1;0;1;1;0;0;0;1;0;0;1;2208;0;0;1;0;0;1;1;2208;0;2208;1;1;
/org.eclipse.core.expressions/src/org/eclipse/core/expressions/IVariableResolver.java;1;0;2;1;1;1;1;1;6;0;1;4629;6;6;1;0;0;1;2;4629;0;5184;2;1;
/org.eclipse.ui.console/src/org/eclipse/ui/internal/console/ConsoleWorkbenchPart.java;1;0;2;1;0;0;0;2;6;1;2;1988;6;6;1;0;0;2;2;1988;0;2024;2;1;
/org.eclipse.jdt.ui.tests.refactoring/resources/IntroduceFactory/positive/multipleCallers_in.java;1;0;2;1;0;0;0;2;0;1;2;2846;0;0;1;0;0;2;2;2846;0;2862;2;1;
/org.eclipse.jdt.debug.ui/ui/org/eclipse/jdt/internal/debug/ui/propertypages/ThreadFilterEditor.java;1;0;1;1;0;0;0;1;0;0;1;1358;0;0;1;0;0;1;1;1358;0;1358;1;1;
/org.eclipse.debug.ui/ui/org/eclipse/debug/ui/RefreshTab.java;4;1;10;1;3;3;3;7;90;2;6;2120;164;164;2;1;0;7;10;2729;1;6336;9;4;
/org.eclipse.jdt.core.tests.model/workspace/Converter/src/test0068/Test.java;1;0;1;1;0;0;0;1;0;0;1;3714;0;0;1;0;0;1;1;3714;0;3714;1;1;
/org.eclipse.team.cvs.core/src/org/eclipse/team/internal/ccvs/core/resources/SynchronizerSyncInfoCache.java;2;1;13;1;6;6;6;7;73;1;7;790;307;307;1;0;0;7;13;790;0;6337;13;2;
/org.eclipse.jdt.core.tests.model/workspace/Converter/src/Test0157.java;1;0;1;1;0;0;0;1;0;0;1;3714;0;0;1;0;0;1;1;3714;0;3714;1;1;
/org.eclipse.ui.workbench.texteditor/src/org/eclipse/ui/texteditor/DefaultAnnotation.java;2;0;5;1;0;0;0;5;56;2;4;2562;91;91;2;1;0;5;5;2582;1;2741;4;2;
/org.eclipse.jdt.launching.macosx/macosx/org/eclipse/jdt/internal/ui/macbundler/BundleAttributes.java;1;0;1;1;0;0;0;1;0;0;1;3622;0;0;1;0;0;1;1;3622;0;3622;1;1;
/org.eclipse.osgi/eclipseAdaptor/src/org/eclipse/core/runtime/adaptor/testsupport/TestLocationManager.java;1;0;1;1;1;1;1;0;0;0;0;5995;0;0;1;0;0;0;1;5995;0;5995;1;1;
/org.eclipse.pde.ui/src_OSGi/org/eclipse/pde/internal/ui/osgi/templates/FirstBundleTemplateWizardPage.java;3;0;9;1;0;0;0;9;49;1;9;2501;97;97;1;0;0;9;9;2501;0;3986;9;3;
/org.eclipse.ui.externaltools/Ant Runner Support/org/eclipse/ui/externaltools/internal/ant/AntSupportMessages.java;1;0;1;1;0;0;0;1;0;0;1;282;0;0;1;0;0;1;1;282;0;282;1;1;
/org.eclipse.team.cvs.ui/src/org/eclipse/team/internal/ccvs/ui/merge/UpdateWithForcedJoinAction.java;1;0;1;1;0;0;0;1;0;0;1;4217;0;0;1;0;0;1;1;4217;0;4217;1;1;
/org.eclipse.team.tests.core/src/org/eclipse/team/tests/ui/synchronize/TestParticipant.java;2;1;3;1;3;3;3;0;65;0;0;5276;74;74;1;0;0;0;3;5276;0;5534;3;2;
/org.eclipse.ui.workbench/Eclipse UI/org/eclipse/ui/internal/commands/CommandActivationService.java;1;0;2;1;0;0;0;2;0;0;1;1222;0;0;2;1;0;2;2;1222;1;1222;1;1;
/org.eclipse.jdt.core.tests.model/workspace/Formatter/test035/A_in.java;1;0;1;1;0;0;0;1;0;0;1;2425;0;0;1;0;0;1;1;2425;0;2425;1;1;
/org.eclipse.team.tests.cvs.core/src/org/eclipse/team/tests/ccvs/ui/old/ArgumentParser.java;1;0;2;1;0;0;0;2;0;1;2;2632;0;0;1;0;0;2;2;2632;0;4216;2;1;
/org.eclipse.ant.tests.ui/EclipseCon/org/eclipse/ant/internal/ui/demo/ProjectCreator.java;1;0;5;1;0;0;0;5;66;3;3;3729;69;69;3;2;0;5;5;3729;2;4809;3;1;
/org.eclipse.jdt.ui/core refactoring/org/eclipse/ltk/core/refactoring/RefactoringCore.java;1;0;2;1;0;0;0;2;0;1;2;4575;0;0;1;0;0;2;2;4575;0;4864;2;1;
/org.eclipse.ant.ui/Ant Tools Support/org/eclipse/ant/internal/ui/views/actions/AntOpenWithMenu.java;2;0;7;1;1;1;1;6;71;2;4;1811;119;119;2;2;0;6;7;2746;2;5581;5;2;
/org.eclipse.ui.ide/src/org/eclipse/ui/views/tasklist/FiltersDialog.java;1;0;2;1;0;0;0;2;4;1;2;2208;4;4;1;0;0;2;2;2208;0;2264;2;1;
/org.eclipse.jdt.core.tests.model/workspace/Formatter/test227/A_out.java;1;0;1;1;0;0;0;1;0;0;1;2426;0;0;1;0;0;1;1;2426;0;2426;1;1;
/org.eclipse.update.scheduler/src/org/eclipse/update/internal/scheduler/SchedulerStartup.java;1;1;3;1;2;2;2;1;78;0;1;4705;84;84;1;0;0;1;3;4705;0;6336;3;1;
/org.eclipse.jdt.core.tests.model/workspace/Converter/test0488/A.java;1;0;2;1;0;0;0;2;0;1;2;1289;0;0;1;0;0;2;2;1289;0;3714;2;1;
/org.eclipse.ui.ide/extensions/org/eclipse/ui/actions/ReadOnlyStateChecker.java;1;0;1;1;0;0;0;1;0;0;1;2263;0;0;1;0;0;1;1;2263;0;2263;1;1;
/org.eclipse.jdt.ui.tests.refactoring/resources/ExtractMethodWorkSpace/ExtractMethodTests/try_out/A_test460.java;1;0;2;1;0;0;0;2;6;1;2;130;8;8;1;0;0;2;2;130;0;844;2;1;
/org.eclipse.ui.externaltools/Ant Editor/org/eclipse/ui/externaltools/internal/ant/editor/text/XMLProblemAnnotation.java;1;0;1;1;0;0;0;1;0;0;1;282;0;0;1;0;0;1;1;282;0;282;1;1;
/org.eclipse.swt.tests/JUnit Tests/org/eclipse/swt/tests/junit/Test_org_eclipse_swt_ole_win32_OleFunctionDescription.java;1;0;1;1;0;0;0;1;0;0;1;2176;0;0;1;0;0;1;1;2176;0;2176;1;1;
/org.eclipse.debug.ui/ui/org/eclipse/debug/internal/ui/views/memory/MemoryView.java;2;1;5;1;5;5;5;0;22;0;0;5254;37;37;1;0;0;0;5;5254;0;5475;5;2;
/org.eclipse.jdt.ui/ui/org/eclipse/jdt/internal/ui/util/JavaUIHelp.java;2;0;2;1;1;1;1;1;2;0;1;5058;4;4;1;0;0;1;2;5058;0;6340;2;2;
/org.eclipse.jdt.debug.tests/tests/org/eclipse/jdt/debug/tests/core/BootpathTests.java;3;0;3;1;1;1;1;2;36;1;2;2695;54;54;1;0;0;2;3;2695;0;6337;3;3;
/org.eclipse.ui.workbench/Eclipse UI/org/eclipse/ui/internal/model/WorkbenchResource.java;1;0;1;1;0;0;0;1;0;0;1;2737;0;0;1;0;0;1;1;2737;0;2737;1;1;
/org.eclipse.update.core/src/org/eclipse/update/internal/core/NonPluginEntryContentConsumer.java;2;1;3;1;2;2;2;1;6;0;1;890;14;14;1;0;0;1;3;890;0;6336;3;2;
/org.eclipse.jdt.core.tests.model/workspace/Converter/junit/swingui/TestRunView.java;1;0;2;1;0;0;0;2;3;1;2;787;3;3;1;0;0;2;2;787;0;3714;2;1;
/org.eclipse.ui.externaltools/Ant Editor/org/eclipse/ui/externaltools/internal/ant/editor/text/PlantyTagScanner.java;1;0;1;1;0;0;0;1;0;0;1;178;0;0;1;0;0;1;1;178;0;178;1;1;
/org.eclipse.update.core/src/org/eclipse/update/core/model/Category.java;1;0;1;1;0;0;0;1;0;0;1;2634;0;0;1;0;0;1;1;2634;0;2634;1;1;
/org.eclipse.jdt.debug/eval/org/eclipse/jdt/internal/debug/eval/ast/instructions/DivideOperator.java;1;0;1;1;0;0;0;1;5;0;1;1240;5;5;1;0;0;1;1;1240;0;1240;1;1;
/org.eclipse.jdt.debug.ui/ui/org/eclipse/jdt/internal/debug/ui/actions/BreakpointToggleAction.java;1;0;1;1;0;0;0;1;6;0;1;1593;6;6;1;0;0;1;1;1593;0;1593;1;1;
/org.eclipse.jdt.ui/ui refactoring/org/eclipse/jdt/internal/ui/refactoring/ComboContentAssistSubjectAdapter.java;1;0;3;1;0;0;0;3;41;1;3;3189;41;41;1;0;0;3;3;3189;0;3648;3;1;
/org.eclipse.jdt.ui/ui/org/eclipse/jdt/internal/ui/dnd/JdtViewerDragAdapter.java;1;0;1;1;1;1;1;0;2;0;0;6340;2;2;1;0;0;0;1;6340;0;6340;1;1;
/org.eclipse.core.runtime/src/org/eclipse/core/internal/jobs/PriorityQueue.java;1;0;1;1;0;0;0;1;0;0;1;376;0;0;1;0;0;1;1;376;0;376;1;1;
/org.eclipse.core.resources/src/org/eclipse/core/resources/IWorkspaceDescription.java;1;1;3;1;2;2;2;1;351;0;1;4994;416;416;1;0;0;1;3;4994;0;6147;3;1;
/org.eclipse.debug.core/core/org/eclipse/debug/core/model/IWatchExpression.java;3;1;11;2;2;2;2;9;47;2;7;1175;123;123;2;2;0;9;11;1595;2;6336;9;3;
/org.eclipse.text.tests/src/org/eclipse/text/tests/GapTextTest.java;1;2;4;1;3;2;3;1;8;0;1;5082;10;10;2;0;1;1;4;5100;1;6340;3;1;
/org.eclipse.jdt.ui/ui/org/eclipse/jdt/internal/ui/text/template/contentassist/MultiVariable.java;2;0;3;1;1;1;1;2;2;1;2;4927;4;4;1;0;0;2;3;4927;0;6340;3;2;
/org.eclipse.core.resources/src/org/eclipse/core/internal/indexing/Buffer.java;1;0;1;1;1;1;1;0;66;0;0;5146;66;66;1;0;0;0;1;5146;0;5146;1;1;
/org.eclipse.jdt.ui/ui/org/eclipse/jdt/internal/ui/wizards/buildpaths/NewVariableEntryDialog.java;2;1;6;1;2;2;2;4;29;1;4;451;73;73;1;0;0;4;6;451;0;6340;6;2;
/org.eclipse.jdt.core/model/org/eclipse/jdt/internal/core/jdom/DOMInitializer.java;3;1;5;1;2;2;2;3;10;1;3;90;29;29;1;0;0;3;5;90;0;5916;5;3;
/org.eclipse.jdt.ui/ui/org/eclipse/jdt/internal/ui/browsing/LogicalPackage.java;1;0;1;1;1;1;1;0;2;0;0;6340;2;2;1;0;0;0;1;6340;0;6340;1;1;
/org.eclipse.ui.workbench/Eclipse UI/org/eclipse/ui/internal/layout/TrimLayoutData.java;1;0;1;1;0;0;0;1;0;0;1;5000;0;0;1;0;0;1;1;5000;0;5000;1;1;
/org.eclipse.ui.workbench/Eclipse UI/org/eclipse/ui/internal/commands/Stroke.java;1;0;3;1;0;0;0;3;0;1;3;786;0;0;1;0;0;3;3;786;0;1077;3;1;
/org.eclipse.swt/Eclipse SWT Browser/mozilla/org/eclipse/swt/browser/EmbedFileLocProvider.java;1;0;2;1;0;0;0;2;0;1;2;1654;0;0;1;0;0;2;2;1654;0;1674;2;1;
/org.eclipse.team.ui/src/org/eclipse/team/internal/ui/synchronize/ISynchronizeModelProviderDescriptor.java;2;1;3;1;2;2;2;1;34;0;1;4896;36;36;1;0;0;1;3;4896;0;6337;3;2;
/org.eclipse.jdt.core.tests.model/workspace/Converter/src/test0445/A.java;1;0;1;1;0;0;0;1;0;0;1;3714;0;0;1;0;0;1;1;3714;0;3714;1;1;
/org.eclipse.ui.views/src/org/eclipse/ui/views/framelist/TreeFrame.java;1;0;1;1;0;0;0;1;0;0;1;2738;0;0;1;0;0;1;1;2738;0;2738;1;1;
/org.eclipse.ui.views/src/org/eclipse/ui/views/internal/markers/IField.java;1;0;2;1;0;0;0;2;0;1;2;265;0;0;1;0;0;2;2;265;0;755;2;1;
/org.eclipse.debug.ui/ui/org/eclipse/debug/ui/variables/WorkingSetComponent.java;2;0;7;1;0;0;0;7;194;4;4;316;383;383;4;3;0;7;7;316;3;550;4;2;
/org.eclipse.update.ui.forms/src/org/eclipse/ui/forms/parts/FormToolkit.java;1;0;4;1;0;0;0;4;123;2;3;3071;164;164;2;1;0;4;4;3095;1;3095;3;1;
/org.eclipse.swt/Eclipse SWT/gtk/org/eclipse/swt/widgets/Decorations.java;5;1;12;1;3;3;3;9;100;3;7;110;321;321;3;2;0;9;12;3237;2;6352;10;5;
/org.eclipse.update.ui.forms/src/org/eclipse/ui/forms/events/ExpansionEvent.java;1;0;2;1;0;0;0;2;0;0;1;3095;0;0;2;1;0;2;2;3095;1;3095;1;1;
/org.eclipse.jdt.ui.tests.refactoring/resources/MoveMembers/test30/in/A.java;1;0;1;1;0;0;0;1;0;0;1;1651;0;0;1;0;0;1;1;1651;0;1651;1;1;
/org.eclipse.jdt.core.tests.model/src/org/eclipse/jdt/code/tests/formatter/FormatterRegressionTests.java;2;0;4;2;0;0;0;4;177;0;1;2424;177;177;4;3;0;4;4;2424;3;2424;1;2;
/org.eclipse.ui.workbench/Eclipse UI/org/eclipse/ui/internal/presentations/SystemMenuStateChange.java;2;1;2;2;2;2;2;0;3;0;0;5173;3;3;1;0;0;0;2;5173;0;5536;2;2;
/org.eclipse.ant.ui/Ant Editor/org/eclipse/ant/internal/ui/editor/outline/FilterInternalTargetsAction.java;2;0;4;1;1;1;1;3;9;1;3;1917;15;15;1;0;0;3;4;1917;0;6336;4;2;
/org.eclipse.team.cvs.ui/src/org/eclipse/team/internal/ccvs/ui/model/CVSFileElement.java;1;0;1;1;0;0;0;1;2;0;1;990;2;2;1;0;0;1;1;990;0;990;1;1;
/org.eclipse.pde.ui/src_Forms/org/eclipse/pde/internal/ui/neweditor/schema/SchemaPropertySheet.java;2;0;5;1;1;1;1;4;187;2;3;4856;189;189;2;1;0;4;5;4877;1;5431;4;2;
/org.eclipse.ui.workbench/Eclipse UI/org/eclipse/ui/internal/AcceleratorMenu.java;1;0;4;1;0;0;0;4;28;1;4;516;34;34;1;0;0;4;4;516;0;1710;4;1;
/org.eclipse.ui.externaltools/Ant Editor/org/eclipse/ui/externaltools/internal/ant/dtd/IElement.java;1;0;1;1;0;0;0;1;0;0;1;282;0;0;1;0;0;1;1;282;0;282;1;1;
/org.eclipse.jdt.ui/ui/org/eclipse/jdt/internal/ui/packageview/PackageExplorerContentProvider.java;4;3;13;2;5;3;5;8;143;1;8;1231;298;298;3;0;2;8;13;6138;2;6340;11;4;
/org.eclipse.jdt.core.tests.model/workspace/Formatter/test479/A_out.java;1;0;1;1;0;0;0;1;0;0;1;4173;0;0;1;0;0;1;1;4173;0;4173;1;1;
/org.eclipse.ui.workbench.texteditor/src/org/eclipse/ui/texteditor/ComboContentAssistRequestorAdapter.java;1;0;3;1;0;0;0;3;38;2;2;2263;38;38;2;1;0;3;3;2279;1;2279;2;1;
/org.eclipse.update.ui.forms/Eclipse Forms/org/eclipse/ui/forms/parts/ILayoutExtension.java;1;0;3;1;0;0;0;3;8;1;3;3096;8;8;1;0;0;3;3;3096;0;3138;3;1;
/org.eclipse.ui.examples.readmetool/Eclipse UI Examples Readme Tool/org/eclipse/ui/examples/readmetool/ReadmeCreationPage.java;1;0;1;1;0;0;0;1;14;0;1;2738;14;14;1;0;0;1;1;2738;0;2738;1;1;
/org.eclipse.jdt.core.tests.model/src/org/eclipse/jdt/core/tests/model/SearchTests.java;3;1;14;1;3;3;3;11;77;2;10;1115;315;315;2;1;0;11;14;2840;1;5676;13;3;
/org.eclipse.swt.examples.paint/src/org/eclipse/swt/examples/paint/PaintView.java;1;0;1;1;0;0;0;1;2;0;1;723;2;2;1;0;0;1;1;723;0;723;1;1;
/org.eclipse.jdt.core.tests.model/workspace/Formatter/test292/A_out.java;1;0;1;1;0;0;0;1;0;0;1;2444;0;0;1;0;0;1;1;2444;0;2444;1;1;
/org.eclipse.ui.workbench/Eclipse UI/org/eclipse/ui/internal/dialogs/WorkbenchPreferenceDialog.java;6;0;16;2;1;1;1;15;210;2;12;1080;509;509;2;3;0;15;16;2279;3;6338;13;6;
/org.eclipse.ui.workbench/Eclipse UI/org/eclipse/ui/internal/commands/AbstractHandlerService.java;1;0;4;1;0;0;0;4;39;1;4;1065;39;39;1;0;0;4;4;1065;0;1222;4;1;
/org.eclipse.ui.ide/src/org/eclipse/ui/model/WorkbenchContentProvider.java;1;0;2;1;0;0;0;2;0;1;2;1511;0;0;1;0;0;2;2;1511;0;1526;2;1;
/org.eclipse.ui.ide/src/org/eclipse/ui/views/markers/internal/DialogMarkerFilter.java;4;1;5;1;2;2;2;3;10;1;3;2208;20;20;1;0;0;3;5;2208;0;6338;5;4;
/org.eclipse.ui.ide/extensions/org/eclipse/ui/actions/GlobalBuildAction.java;6;2;14;2;7;5;7;7;564;1;7;2263;745;745;2;0;2;7;14;5409;2;6338;12;6;
/org.eclipse.ui.workbench/Eclipse UI/org/eclipse/ui/internal/commands/util/Sequence.java;1;0;2;1;0;0;0;2;0;1;2;1077;0;0;1;0;0;2;2;1077;0;1222;2;1;
/org.eclipse.team.ui/src/org/eclipse/team/internal/ui/synchronize/SubscriberParticipantPage.java;2;2;9;2;5;4;5;4;366;1;4;4588;416;416;2;0;1;4;9;5358;1;6337;8;2;
/org.eclipse.update/src/org/eclipse/update/internal/ui/UMWizardPageLaunchHistory.java;1;0;1;1;1;1;1;0;0;0;0;6339;0;0;1;0;0;0;1;6339;0;6339;1;1;
/org.eclipse.jdt.core.tests.model/workspace/Converter/test0297/Test.java;1;0;1;1;0;0;0;1;0;0;1;3714;0;0;1;0;0;1;1;3714;0;3714;1;1;
/org.eclipse.jdt.ui.tests.refactoring/resources/ExtractMethodWorkSpace/ExtractMethodTests/locals_out/A_test516.java;1;0;2;1;0;0;0;2;4;1;2;130;5;5;1;0;0;2;2;130;0;844;2;1;
/org.eclipse.ui.workbench/Eclipse UI/org/eclipse/ui/IEditorPart.java;3;1;5;1;4;4;4;1;14;0;1;2737;28;28;1;0;0;1;5;2737;0;6338;5;3;
/org.eclipse.ui.workbench/Eclipse UI/org/eclipse/example/ExampleApplication.java;1;0;1;1;0;0;0;1;0;0;1;1259;0;0;1;0;0;1;1;1259;0;1259;1;1;
/org.eclipse.jdt.debug.tests/tests/org/eclipse/jdt/debug/tests/eval/NestedTypeFieldValue_65.java;1;0;1;1;0;0;0;1;98;0;1;1274;98;98;1;0;0;1;1;1274;0;1274;1;1;
/org.eclipse.jdt.core.tests.model/workspace/Formatter/test148/A_out.java;1;0;1;1;0;0;0;1;0;0;1;2425;0;0;1;0;0;1;1;2425;0;2425;1;1;
/org.eclipse.jdt.core.tests.model/workspace/Formatter/test234/A_out.java;1;0;1;1;0;0;0;1;0;0;1;2437;0;0;1;0;0;1;1;2437;0;2437;1;1;
/org.eclipse.team.ui/src/org/eclipse/team/ui/synchronize/viewers/ParticipantCompareDialog.java;1;0;1;1;0;0;0;1;0;0;1;4414;0;0;1;0;0;1;1;4414;0;4414;1;1;
/org.eclipse.update.ui/srcnew/org/eclipse/update/internal/ui/wizards/LicensePage2.java;2;0;2;1;0;0;0;2;0;1;2;367;0;0;1;0;0;2;2;367;0;481;2;2;
/org.eclipse.core.runtime/src/org/eclipse/core/internal/preferences/UserPreferences.java;1;0;6;1;0;0;0;6;85;2;5;4351;89;89;2;1;0;6;6;4561;1;4632;5;1;
/org.eclipse.jdt.core.tests.model/workspace/Converter/src/test0346/Test2.java;1;0;1;1;0;0;0;1;0;0;1;3714;0;0;1;0;0;1;1;3714;0;3714;1;1;
/org.eclipse.jdt.core.tests.model/workspace/Formatter/test410/A_in.java;1;0;2;1;0;0;0;2;9;0;1;3458;9;9;2;1;0;2;2;3458;1;3458;1;1;
/org.eclipse.ui.workbench/Eclipse UI/org/eclipse/ui/actions/NewWizardMenu.java;3;0;4;1;0;0;0;4;50;2;3;2279;52;52;2;1;0;4;4;2279;1;2737;3;3;
/org.eclipse.ant.ui/Ant Editor/org/eclipse/ant/internal/ui/editor/OpenDeclarationAction.java;1;0;2;1;1;1;1;1;2;0;1;3855;2;2;1;0;0;1;2;3855;0;5530;2;1;
/org.eclipse.jface/src/org/eclipse/jface/action/ToolBarContributionItem.java;6;2;17;3;3;2;3;14;1040;3;11;3220;1477;1477;3;3;1;14;17;3238;4;6338;13;6;
/org.eclipse.jdt.core/compiler/org/eclipse/jdt/internal/compiler/impl/CompilerOptions.java;4;1;46;2;4;4;4;42;604;3;34;13;2241;2241;3;8;0;42;46;1299;8;5641;38;4;
/org.eclipse.jdt.debug.ui/ui/org/eclipse/jdt/internal/debug/ui/snippeteditor/JavaSnippetEditor.java;5;1;29;2;9;9;9;20;304;2;19;755;1308;1308;2;1;0;20;29;4855;1;6128;28;5;
/org.eclipse.jdt.ui/core refactoring/org/eclipse/jdt/internal/corext/refactoring/structure/ImportRewriteManager.java;3;0;3;1;1;1;1;2;2;1;2;1952;4;4;1;0;0;2;3;1952;0;6340;3;3;
/org.eclipse.pde.ui/sandbox/org/eclipse/pde/internal/ui/editor/standalone/site/SiteSourceContentProvider.java;1;0;2;1;0;0;0;2;0;1;2;2320;0;0;1;0;0;2;2;2320;0;2906;2;1;
/org.eclipse.jdt.debug.ui/ui/org/eclipse/jdt/internal/debug/ui/BreakpointConditionCompletionProcessor.java;4;0;5;1;1;1;1;4;20;1;4;1152;33;33;1;0;0;4;5;1152;0;6336;5;4;
/org.eclipse.jdt.core/formatter/org/eclipse/jdt/internal/formatter/NewCodeFormatter.java;2;0;7;1;0;0;0;7;580;2;5;535;693;693;2;2;0;7;7;535;2;822;5;2;
/org.eclipse.jdt.core.tests.model/workspace/Converter/src/test0425/A.java;1;0;1;1;0;0;0;1;0;0;1;3714;0;0;1;0;0;1;1;3714;0;3714;1;1;
/org.eclipse.ant.tests.core/test support/org/eclipse/ant/tests/core/support/testloggers/TestBuildLogger.java;1;0;1;1;0;0;0;1;6;0;1;2594;6;6;1;0;0;1;1;2594;0;2594;1;1;
/org.eclipse.core.tests.runtime/src/org/eclipse/core/tests/runtime/stream/InputStreamURLConnection.java;1;0;2;1;1;1;1;1;6;0;1;2512;6;6;1;0;0;1;2;2512;0;5149;2;1;
/org.eclipse.jdt.ui/ui/org/eclipse/jdt/ui/actions/ModifyParametersAction.java;4;1;14;2;2;2;2;12;205;3;9;122;372;372;3;3;0;12;14;134;3;6340;11;4;
/org.eclipse.ui.examples.job/src/org/eclipse/ui/examples/jobs/TestJob.java;3;2;6;1;6;5;6;0;30;0;0;5126;61;61;2;0;1;0;6;5799;1;6077;5;3;
/org.eclipse.swt.tests/JUnit Tests/org/eclipse/swt/tests/junit/Test_org_eclipse_swt_custom_TextChangeListener.java;1;0;1;1;0;0;0;1;338;0;1;2104;338;338;1;0;0;1;1;2104;0;2104;1;1;
/org.eclipse.jdt.core/batch/org/eclipse/jdt/internal/compiler/batch/Main.java;4;2;61;2;7;6;7;54;660;3;40;13;2631;2631;3;14;1;54;61;76;15;5872;46;4;
/org.eclipse.ui.intro/src/org/eclipse/ui/intro/internal/presentations/TextIntroPartImplementation.java;1;0;6;1;1;1;1;5;514;1;5;4429;793;793;1;0;0;5;6;4429;0;5115;6;1;
/org.eclipse.jdt.debug/jdi/org/eclipse/jdi/internal/ValueCache.java;1;0;1;1;0;0;0;1;4;0;1;1276;4;4;1;0;0;1;1;1276;0;1276;1;1;
/org.eclipse.releng.tools/src/org/eclipse/releng/tools/ProjectComparePage.java;3;1;7;1;7;7;7;0;75;0;0;5183;98;98;1;0;0;0;7;5183;0;6219;7;3;
/org.eclipse.jdt.core/model/org/eclipse/jdt/core/util/ILocalVariableTableEntry.java;1;0;1;1;0;0;0;1;2;0;1;3560;2;2;1;0;0;1;1;3560;0;3560;1;1;
/org.eclipse.jdt.core.tests.model/src/org/eclipse/jdt/core/tests/model/WorkingCopyOwnerTests.java;4;1;39;1;4;4;4;35;658;12;21;1032;1441;1441;12;14;0;35;39;1032;14;5397;25;4;
/org.eclipse.jdt.core/search/org/eclipse/jdt/internal/core/index/impl/WordEntry.java;1;0;3;1;0;0;0;3;3;1;3;3194;5;5;1;0;0;3;3;3194;0;4060;3;1;
/org.eclipse.core.runtime/src/org/eclipse/core/runtime/jobs/ILockListener.java;1;0;4;1;0;0;0;4;32;1;4;662;34;34;1;0;0;4;4;662;0;1263;4;1;
/org.eclipse.jdt.ui/core extension/org/eclipse/jdt/internal/corext/codemanipulation/ChangeVisibilityEdit.java;1;0;1;1;0;0;0;1;0;0;1;1466;0;0;1;0;0;1;1;1466;0;1466;1;1;
/org.eclipse.jdt.debug.ui/ui/org/eclipse/jdt/internal/debug/core/refactoring/LaunchConfigurationITypeRenameParticipant.java;3;1;9;1;2;2;2;7;32;1;7;3750;115;115;1;0;0;7;9;3750;0;6339;9;3;
/org.eclipse.jdt.ui/ui/org/eclipse/jdt/ui/actions/ExtractInterfaceAction.java;3;0;9;1;1;1;1;8;144;1;8;42;278;278;1;0;0;8;9;42;0;6340;9;3;
/org.eclipse.team.ui/src/org/eclipse/team/internal/ui/target/SiteLazyContentProvider.java;1;0;1;1;0;0;0;1;0;0;1;2495;0;0;1;0;0;1;1;2495;0;2495;1;1;
/org.eclipse.update.core/src/org/eclipse/update/internal/operations/ToggleSiteOperation.java;1;1;7;1;2;2;2;5;4;1;5;825;16;16;1;0;0;5;7;825;0;6336;7;1;
/org.eclipse.ui.workbench/Eclipse UI/org/eclipse/ui/internal/commands/registry/FileRegistry.java;1;0;2;1;0;0;0;2;0;0;1;1396;0;0;2;1;0;2;2;1396;1;1396;1;1;
/org.eclipse.jdt.core.tests.model/workspace/Formatter/test057/A_out.java;1;0;2;1;0;0;0;2;22;1;2;2425;22;22;1;0;0;2;2;2425;0;4173;2;1;
/org.eclipse.jdt.core/search/org/eclipse/jdt/internal/core/search/matching/MatchingNodeSet.java;3;1;21;2;2;2;2;19;544;2;16;77;1098;1098;2;3;0;19;21;77;3;6203;18;3;
/org.eclipse.swt.tests/JUnit Tests/org/eclipse/swt/tests/junit/Test_org_eclipse_swt_accessibility_ACC.java;1;0;1;1;0;0;0;1;0;0;1;2104;0;0;1;0;0;1;1;2104;0;2104;1;1;
/org.eclipse.jdt.core.tests.model/workspace/JavaSearch/src/j4/MM47209.java;1;0;1;1;0;0;0;1;0;0;1;3330;0;0;1;0;0;1;1;3330;0;3330;1;1;
/org.eclipse.jdt.ui.tests.refactoring/resources/ExtractMethodWorkSpace/ExtractMethodTests/locals_out/A_test502.java;1;0;2;1;0;0;0;2;6;1;2;130;7;7;1;0;0;2;2;130;0;844;2;1;
/org.eclipse.pde.ui/src_Forms/org/eclipse/pde/internal/ui/model/plugin/PluginLibraryNode.java;3;1;9;1;6;6;6;3;119;1;3;4438;227;227;1;0;0;3;9;4438;0;6336;9;3;
/org.eclipse.jdt.core.tests.model/workspace/Completion/src/CompletionArraysCloneMethod.java;1;0;1;1;0;0;0;1;0;0;1;1685;0;0;1;0;0;1;1;1685;0;1685;1;1;
/org.eclipse.jdt.core.tests.model/workspace/Converter/src/test0048/Test.java;1;0;1;1;0;0;0;1;0;0;1;3714;0;0;1;0;0;1;1;3714;0;3714;1;1;
/org.eclipse.webdav/src/interface/org/eclipse/webdav/dom/Property.java;1;0;2;1;2;1;2;0;34;0;0;5151;34;34;2;0;1;0;2;5151;1;5151;1;1;
/org.eclipse.ui.workbench/Eclipse UI/org/eclipse/ui/internal/WorkingSet.java;1;0;2;1;0;0;0;2;94;1;2;2737;96;96;1;0;0;2;2;2737;0;3206;2;1;
/org.eclipse.ui.workbench/Eclipse UI/org/eclipse/ui/internal/contexts/RegistryReader.java;1;0;3;1;0;0;0;3;25;1;3;1220;25;25;1;0;0;3;3;1220;0;1356;3;1;
/org.eclipse.ui.workbench/Eclipse UI/org/eclipse/ui/internal/commands/api/older/ICommandManagerListener.java;1;0;2;1;0;0;0;2;0;0;1;2562;0;0;2;1;0;2;2;2562;1;2562;1;1;
/org.eclipse.osgi/defaultAdaptor/src/org/eclipse/osgi/framework/internal/protocol/bundle/Handler.java;3;0;3;1;0;0;0;3;150;1;3;3013;150;150;1;0;0;3;3;3013;0;3620;3;3;
/org.eclipse.ui.workbench/Eclipse UI/org/eclipse/ui/contexts/ws/IWorkbenchWindowContextSupport.java;1;0;1;1;0;0;0;1;0;0;1;3066;0;0;1;0;0;1;1;3066;0;3066;1;1;
/org.eclipse.ui.cheatsheets/src/org/eclipse/ui/cheatsheets/events/ICheatSheetItemListener.java;1;0;2;1;0;0;0;2;0;1;2;4428;0;0;1;0;0;2;2;4428;0;4625;2;1;
/org.eclipse.jdt.ui.tests.refactoring/resources/InlineMethodWorkspace/TestCases/invalid/TestInvalidFieldInitializer2.java;1;0;1;1;0;0;0;1;0;0;1;2281;0;0;1;0;0;1;1;2281;0;2281;1;1;
/org.eclipse.jdt.core.tests.model/workspace/Formatter/test409/A_out.java;1;0;1;1;0;0;0;1;0;0;1;3441;0;0;1;0;0;1;1;3441;0;3441;1;1;
/org.eclipse.core.tests.runtime/src/org/eclipse/core/tests/plugintests/PluginFindTests.java;1;0;1;1;0;0;0;1;0;0;1;3014;0;0;1;0;0;1;1;3014;0;3014;1;1;
/org.eclipse.debug.core/core/org/eclipse/debug/core/model/WatchExpression.java;1;0;2;1;0;0;0;2;0;1;2;1516;0;0;1;0;0;2;2;1516;0;1524;2;1;
/org.eclipse.jdt.core/eval/org/eclipse/jdt/internal/eval/GlobalVariable.java;1;0;1;1;0;0;0;1;2;0;1;3560;2;2;1;0;0;1;1;3560;0;3560;1;1;
/org.eclipse.jdt.debug.tests/tests/org/eclipse/jdt/debug/tests/eval/ArrayAssignmentTests.java;1;0;1;1;0;0;0;1;18;0;1;1274;18;18;1;0;0;1;1;1274;0;1274;1;1;
/org.eclipse.jdt.core.tests.model/workspace/Converter/src/test0284/Test.java;1;0;1;1;0;0;0;1;0;0;1;3714;0;0;1;0;0;1;1;3714;0;3714;1;1;
/org.eclipse.swt/Eclipse SWT Printing/photon/org/eclipse/swt/printing/Printer.java;2;1;7;1;2;2;2;5;15;2;4;0;33;33;2;1;0;5;7;2492;1;6352;6;2;
/org.eclipse.jdt.debug/eval/org/eclipse/jdt/internal/debug/eval/ast/instructions/ThrowInstruction.java;2;0;3;1;0;0;0;3;1;1;3;1340;2;2;1;0;0;3;3;1340;0;1953;3;2;
/org.eclipse.jface.text/src/org/eclipse/jface/internal/text/link/contentassist/JFaceTextMessages2.java;2;0;2;1;1;1;1;1;0;0;1;4214;0;0;1;0;0;1;2;4214;0;5506;2;2;
/org.eclipse.ui.views/src/org/eclipse/ui/views/properties/ComboBoxLabelProvider.java;1;0;1;1;0;0;0;1;0;0;1;3013;0;0;1;0;0;1;1;3013;0;3013;1;1;
/org.eclipse.jface/src/org/eclipse/jface/dialogs/DialogSettings.java;5;0;6;2;1;1;1;5;74;2;4;2608;107;107;2;1;0;5;6;2608;1;6338;5;5;
/org.eclipse.jface.text/src/org/eclipse/jface/text/templates/EnhancedCompletionProposal.java;1;0;2;1;0;0;0;2;0;1;2;4509;0;0;1;0;0;2;2;4509;0;4650;2;1;
/org.eclipse.jdt.ui/ui/org/eclipse/jdt/ui/actions/RemoveFromClasspathAction.java;5;2;7;2;3;2;3;4;25;2;3;592;37;37;2;1;1;4;7;3905;2;6334;5;5;
/org.eclipse.jdt.text.tests/src/org/eclipse/jdt/text/tests/BreakIteratorTest.java;2;1;2;1;2;2;2;0;6;0;0;6072;6;6;1;0;0;0;2;6072;0;6340;2;2;
/org.eclipse.jdt.core.tests.model/workspace/Converter/src/junit/runner/FailureDetailView.java;1;0;1;1;0;0;0;1;0;0;1;3714;0;0;1;0;0;1;1;3714;0;3714;1;1;
/org.eclipse.ui.cheatsheets/src/org/eclipse/ui/internal/cheatsheets/CheatSheetStopWatch.java;1;0;1;1;1;1;1;0;0;0;0;5944;0;0;1;0;0;0;1;5944;0;5944;1;1;
/org.eclipse.pde.ui/src/org/eclipse/pde/internal/ui/view/PluginsContentProvider.java;1;0;3;1;1;1;1;2;6;1;2;3986;8;8;1;0;0;2;3;3986;0;6336;3;1;
/org.eclipse.jdt.ui/ui refactoring/org/eclipse/jdt/internal/ui/refactoring/contentassist/ComboContentAssistSubjectAdapter.java;2;0;2;1;0;0;0;2;0;1;2;3648;0;0;1;0;0;2;2;3648;0;3672;2;2;
/org.eclipse.jdt.ui.tests.refactoring/resources/RenameVirtualMethodInClass/test39/out/A.java;1;0;1;1;1;1;1;0;0;0;0;5524;0;0;1;0;0;0;1;5524;0;5524;1;1;
/org.eclipse.team.cvs.ui/src/org/eclipse/team/internal/ccvs/ui/RemoteAnnotationEditorInput.java;2;1;3;1;2;2;2;1;22;0;1;784;24;24;1;0;0;1;3;784;0;6337;3;2;
/org.eclipse.jdt.junit/src/org/eclipse/jdt/internal/junit/runner/MessageIds.java;1;0;1;1;0;0;0;1;0;0;1;1578;0;0;1;0;0;1;1;1578;0;1578;1;1;
/org.eclipse.jdt.ui.tests.refactoring/resources/ExtractMethodWorkSpace/ExtractMethodTests/locals_in/A_test564.java;1;0;1;1;0;0;0;1;2;0;1;844;2;2;1;0;0;1;1;844;0;844;1;1;
/org.eclipse.ui.ide/src/org/eclipse/ui/views/bookmarkexplorer/BookmarkContentProvider.java;1;0;1;1;0;0;0;1;0;0;1;2208;0;0;1;0;0;1;1;2208;0;2208;1;1;
/org.eclipse.jdt.ui.examples.javafamily/src/org/eclipse/jsp/JavaFamilyExamplePreferencePage.java;1;0;2;1;0;0;0;2;1;1;2;2309;1;1;1;0;0;2;2;2309;0;2344;2;1;
/org.eclipse.jdt.ui.tests.refactoring/resources/MoveMembers/test36/out/B.java;1;0;1;1;0;0;0;1;0;0;1;2093;0;0;1;0;0;1;1;2093;0;2093;1;1;
/org.eclipse.team.webdav/src/org/eclipse/team/internal/target/subscriber/BaseResourceVariantTree.java;1;0;2;1;0;0;0;2;0;1;2;4259;0;0;1;0;0;2;2;4259;0;4349;2;1;
/org.eclipse.jdt.debug.ui/ui/org/eclipse/jdt/internal/debug/ui/propertypages/JavaBreakpointPage.java;5;0;16;1;1;1;1;15;245;7;9;1358;322;322;7;6;0;15;16;1421;6;6336;10;5;
/org.eclipse.jdt.ui/core extension/org/eclipse/jdt/internal/corext/dom/TypeBindingVisitor.java;2;0;2;1;1;1;1;1;4;0;1;1216;6;6;1;0;0;1;2;1216;0;6340;2;2;
/org.eclipse.team.cvs.core/src/org/eclipse/team/internal/ccvs/core/connection/Connection.java;2;1;6;1;3;3;3;3;47;1;3;390;79;79;1;0;0;3;6;390;0;6337;6;2;
/org.eclipse.ui.editors/src/org/eclipse/ui/texteditor/SelectMarkerRulerInfoAction.java;1;1;2;1;2;2;2;0;11;0;0;5126;12;12;1;0;0;0;2;5126;0;6337;2;1;
/org.eclipse.jdt.core.tests.model/workspace/JavaSearch/src/f3/X.java;1;0;1;1;0;0;0;1;0;0;1;3508;0;0;1;0;0;1;1;3508;0;3508;1;1;
/org.eclipse.jdt.core.tests.model/workspace/Formatter/test242/A_out.java;1;0;1;1;0;0;0;1;0;0;1;2437;0;0;1;0;0;1;1;2437;0;2437;1;1;
/org.eclipse.team.ui/src/org/eclipse/team/ui/synchronize/IActionContribution.java;1;0;1;1;0;0;0;1;0;0;1;5039;0;0;1;0;0;1;1;5039;0;5039;1;1;
/org.eclipse.jdt.debug.ui/ui/org/eclipse/jdt/internal/debug/ui/snippeteditor/ScrapbookSourcepathProvider.java;1;0;1;1;1;1;1;0;0;0;0;6104;0;0;1;0;0;0;1;6104;0;6104;1;1;
/org.eclipse.jdt.core.tests.builder/src/org/eclipse/jdt/core/tests/builder/ClasspathTests.java;3;0;5;1;0;0;0;5;20;1;5;557;55;55;1;0;0;5;5;557;0;2075;5;3;
/org.eclipse.team.ftp/src/org/eclipse/team/internal/ftp/subscriber/FTPRemoteSynchronizationCache.java;1;0;1;1;0;0;0;1;0;0;1;3200;0;0;1;0;0;1;1;3200;0;3200;1;1;
/org.eclipse.jdt.debug.ui/ui/org/eclipse/jdt/internal/debug/ui/launcher/SourceElementQualifierProvider.java;3;0;4;1;1;1;1;3;40;1;3;2232;58;58;1;0;0;3;4;2232;0;6336;4;3;
/org.eclipse.webdav/src/client/org/eclipse/webdav/client/Policy.java;1;0;1;1;1;1;1;0;84;0;0;5151;84;84;1;0;0;0;1;5151;0;5151;1;1;
/org.eclipse.osgi/core/framework/org/eclipse/osgi/framework/console/CommandProvider.java;4;1;5;1;3;3;3;2;48;1;2;3013;60;60;1;0;0;2;5;3013;0;6337;5;4;
/org.eclipse.help.tests/src/org/eclipse/help/tests/launching/DisplayHelpResource_IContext_x_y.java;1;1;5;1;3;3;3;2;81;1;2;113;99;99;1;0;0;2;5;113;0;6337;5;1;
/org.eclipse.core.tests.harness/src/org/eclipse/core/tests/harness/Simple.java;1;0;1;1;1;1;1;0;0;0;0;6211;0;0;1;0;0;0;1;6211;0;6211;1;1;
/org.eclipse.pde.ui/src/org/eclipse/pde/internal/ui/editor/StreamDocumentProvider.java;1;0;1;1;0;0;0;1;10;0;1;2754;10;10;1;0;0;1;1;2754;0;2754;1;1;
/org.eclipse.jdt.debug.ui/ui/org/eclipse/jdt/internal/debug/ui/JDIImageDescriptor.java;1;0;1;1;0;0;0;1;48;0;1;2404;48;48;1;0;0;1;1;2404;0;2404;1;1;
/org.eclipse.team.ui/src/org/eclipse/team/internal/ui/sync/MergeResource.java;1;0;1;1;0;0;0;1;0;0;1;4216;0;0;1;0;0;1;1;4216;0;4216;1;1;
/org.eclipse.ui.externaltools/Program Tools Support/org/eclipse/ui/externaltools/internal/program/launchConfigurations/ProgramMainTab.java;3;0;11;2;0;0;0;11;18;2;9;321;65;65;2;2;0;11;11;321;2;3147;9;3;
/org.eclipse.team.ui/src/org/eclipse/team/ui/synchronize/viewers/SynchronizeModelProvider.java;2;0;5;1;0;0;0;5;414;2;4;4213;485;485;2;1;0;5;5;4213;1;4449;4;2;
/org.eclipse.jdt.ui/ui/org/eclipse/jdt/internal/ui/javaeditor/ClassFileEditor.java;5;2;16;1;7;6;7;9;50;1;9;614;159;159;2;0;1;9;16;5126;1;6340;15;5;
/org.eclipse.jdt.ui/ui refactoring/org/eclipse/jdt/internal/ui/refactoring/RefactoringStatusViewer.java;2;0;6;1;0;0;0;6;159;1;6;882;314;314;1;0;0;6;6;882;0;4965;6;2;
/org.eclipse.help.tests/src/org/eclipse/help/tests/servlets/TestTocServlet.java;1;1;3;1;2;2;2;1;60;0;1;2732;80;80;1;0;0;1;3;2732;0;6337;3;1;
/org.eclipse.jface.text/src/org/eclipse/jface/text/templates/DocumentTemplateContext.java;1;0;2;1;0;0;0;2;0;0;1;4258;0;0;2;1;0;2;2;4258;1;4258;1;1;
/org.eclipse.pde.ui/src/org/eclipse/pde/internal/ui/editor/site/BaseNewDialog.java;2;1;3;1;2;2;2;1;14;0;1;3721;20;20;1;0;0;1;3;3721;0;6336;3;2;
/org.eclipse.swt/Eclipse SWT Browser/common/org/eclipse/swt/browser/ProgressListener.java;2;0;5;1;1;1;1;4;56;1;4;1654;101;101;1;0;0;4;5;1654;0;6352;5;2;
/org.eclipse.core.resources/src/org/eclipse/core/internal/indexing/IndexedStoreObject.java;1;0;1;1;1;1;1;0;18;0;0;5146;18;18;1;0;0;0;1;5146;0;5146;1;1;
/org.eclipse.swt/Eclipse SWT/emulated/coolbar/org/eclipse/swt/widgets/CoolBar.java;4;2;13;2;8;6;8;5;214;1;5;269;374;374;2;0;2;5;13;5206;2;6352;11;4;
/org.eclipse.help.base/src/org/eclipse/help/internal/workingset/WorkingSet.java;1;1;4;1;3;3;3;1;55;0;1;1740;77;77;1;0;0;1;4;1740;0;6337;4;1;
/org.eclipse.jdt.core.tests.model/workspace/Formatter/test254/A_out.java;1;0;2;1;0;0;0;2;4;1;2;2442;4;4;1;0;0;2;2;2442;0;3029;2;1;
/org.eclipse.webdav/src/kernel/org/eclipse/webdav/internal/kernel/Locator.java;1;0;2;1;2;1;2;0;18;0;0;5151;18;18;2;0;1;0;2;5151;1;5151;1;1;
/org.eclipse.jdt.core/dom/org/eclipse/jdt/core/dom/NodeEventHandler.java;2;0;5;1;1;1;1;4;110;2;3;4202;142;142;2;1;0;4;5;4275;1;5916;4;2;
/org.eclipse.ui.ide/src/org/eclipse/ui/views/tasklist/MarkCompletedAction.java;1;0;1;1;0;0;0;1;0;0;1;2208;0;0;1;0;0;1;1;2208;0;2208;1;1;
/org.eclipse.ui.ide/src/org/eclipse/ui/internal/ide/model/WorkbenchFolder.java;1;0;1;1;0;0;0;1;0;0;1;2264;0;0;1;0;0;1;1;2264;0;2264;1;1;
/org.eclipse.help.base/src/org/eclipse/help/internal/base/util/HelpProperties.java;1;1;7;1;4;4;4;3;33;1;3;1747;61;61;1;0;0;3;7;1747;0;6337;7;1;
/org.eclipse.pde.ui/src/org/eclipse/pde/internal/ui/editor/feature/FeaturePropertySource.java;1;0;2;1;1;1;1;1;8;0;1;4203;12;12;1;0;0;1;2;4203;0;6336;2;1;
/org.eclipse.compare.examples.xml/src/org/eclipse/compare/examples/xml/CreateNewIdMapAction.java;1;0;2;1;0;0;0;2;2;1;2;1106;2;2;1;0;0;2;2;1106;0;3938;2;1;
/org.eclipse.jdt.core/model/org/eclipse/jdt/internal/core/FailedReconciliationException.java;1;0;1;1;0;0;0;1;0;0;1;438;0;0;1;0;0;1;1;438;0;438;1;1;
/org.eclipse.ui.editors/src/org/eclipse/ui/editors/text/UISynchronizationContext.java;1;0;2;1;1;1;1;1;0;0;1;1933;0;0;1;0;0;1;2;1933;0;5177;2;1;
/org.eclipse.jdt.core.tests.model/workspace/Formatter/test093/A_out.java;1;0;1;1;0;0;0;1;0;0;1;2425;0;0;1;0;0;1;1;2425;0;2425;1;1;
/org.eclipse.core.runtime.compatibility/src-runtime/org/eclipse/core/runtime/IExtensionPoint.java;2;0;3;1;0;0;0;3;1;1;3;3013;1;1;1;0;0;3;3;3013;0;3169;3;2;
/org.eclipse.jdt.core.tests.model/workspace/Converter/src/test0283/Test.java;1;0;1;1;0;0;0;1;0;0;1;3714;0;0;1;0;0;1;1;3714;0;3714;1;1;
/org.eclipse.jface.text/src/org/eclipse/jface/text/information/InformationPresenter.java;3;1;14;2;3;3;3;11;60;2;10;692;264;264;2;1;0;11;14;692;1;6352;13;3;
/org.eclipse.jdt.core.tests.model/workspace/Converter/src/test0117/Test.java;1;0;1;1;0;0;0;1;0;0;1;3714;0;0;1;0;0;1;1;3714;0;3714;1;1;
/org.eclipse.ui.workbench/Eclipse UI/org/eclipse/ui/internal/csm/activities/PluginActivityRegistry.java;1;0;3;1;0;0;0;3;27;1;3;2225;27;27;1;0;0;3;3;2225;0;2405;3;1;
/org.eclipse.jdt.ui/core refactoring/org/eclipse/jdt/internal/corext/refactoring/participants/ScopeStateExpression.java;1;0;4;1;0;0;0;4;39;1;4;825;48;48;1;0;0;4;4;825;0;2682;4;1;
/org.eclipse.jdt.ui.tests.refactoring/resources/RenameStaticMethod/test11/in/B.java;1;0;1;1;0;0;0;1;0;0;1;1535;0;0;1;0;0;1;1;1535;0;1535;1;1;
/org.eclipse.jdt.ui/ui/org/eclipse/jdt/ui/actions/OpenSuperImplementationAction.java;3;0;3;1;1;1;1;2;10;1;2;592;14;14;1;0;0;2;3;592;0;6340;3;3;
/org.eclipse.jdt.ui.tests.refactoring/resources/ExtractMethodWorkSpace/ExtractMethodTests/try_in/A_test455.java;1;0;2;1;0;0;0;2;6;1;2;130;8;8;1;0;0;2;2;130;0;844;2;1;
/org.eclipse.jdt.core/dom/org/eclipse/jdt/core/dom/ASTConverter.java;6;2;51;2;10;9;10;41;594;2;38;69;2263;2263;2;3;1;41;51;1950;4;6125;47;6;
/org.eclipse.jdt.debug.ui/ui/org/eclipse/jdt/internal/debug/ui/JavaUtilCollectionObjectBrowser.java;3;0;4;1;0;0;0;4;7;1;4;861;12;12;1;0;0;4;4;861;0;2647;4;3;
/org.eclipse.jdt.core.tests.model/workspace/Converter/src/test0197/Test.java;1;0;1;1;0;0;0;1;0;0;1;3714;0;0;1;0;0;1;1;3714;0;3714;1;1;
/org.eclipse.update.core/srcnew/org/eclipse/update/internal/search/IUpdateSearchResultCollector.java;1;0;3;1;0;0;0;3;9;2;2;553;9;9;2;1;0;3;3;572;1;572;2;1;
/org.eclipse.jdt.core.tests.compiler/src/org/eclipse/jdt/core/tests/compiler/regression/CastTest.java;3;0;12;1;1;1;1;11;716;2;10;1785;1416;1416;2;1;0;11;12;4910;1;6336;11;3;
/org.eclipse.jdt.core.tests.model/src/org/eclipse/jdt/core/tests/formatter/FormatterRegressionTests.java;4;6;103;2;15;9;15;88;1752;5;50;2428;9570;9570;6;38;6;88;103;5617;44;6077;59;4;
/org.eclipse.core.runtime/src/org/osgi/service/prefs/Preferences.java;1;0;1;1;1;1;1;0;0;0;0;5484;0;0;1;0;0;0;1;5484;0;5484;1;1;
/org.eclipse.jdt.ui/ui/org/eclipse/jdt/ui/actions/AddJavaDocStubAction.java;4;2;11;2;4;3;4;7;46;1;7;592;108;108;2;0;1;7;11;6334;1;6334;10;4;
/org.eclipse.ant.ui/Ant Editor/org/eclipse/ant/internal/ui/editor/utils/ProjectHelperMessages.java;1;0;1;1;1;1;1;0;0;0;0;5372;0;0;1;0;0;0;1;5372;0;5372;1;1;
/org.eclipse.core.tools/src/org/eclipse/core/tools/TreeSelectionProviderDecorator.java;1;0;1;1;1;1;1;0;0;0;0;6302;0;0;1;0;0;0;1;6302;0;6302;1;1;
/org.eclipse.update.ui/src/org/eclipse/update/internal/ui/forms/InstallConfigurationForm.java;1;0;1;1;0;0;0;1;0;0;1;755;0;0;1;0;0;1;1;755;0;755;1;1;
/org.eclipse.sdk.tests-feature/plugins/org.eclipse.perfmsr.ui/src/org/eclipse/perfmsr/ui/UploadWorker.java;2;0;2;1;1;1;1;1;10;0;1;4845;10;10;1;0;0;1;2;4845;0;6342;2;2;
/org.eclipse.swt.examples/src/org/eclipse/swt/examples/controlexample/CLabelTab.java;3;1;4;1;3;3;3;1;4;0;1;1560;11;11;1;0;0;1;4;1560;0;6352;4;3;
/org.eclipse.help.tests/src/org/eclipse/help/tests/standalone/TestEclipse.java;1;1;8;1;2;2;2;6;48;1;6;447;129;129;1;0;0;6;8;447;0;6337;8;1;
/org.eclipse.core.tests.runtime/src/org/eclipse/core/tests/internal/runtime/CipherStreamsTest.java;1;0;1;1;1;1;1;0;159;0;0;5149;159;159;1;0;0;0;1;5149;0;5149;1;1;
/org.eclipse.swt/Eclipse SWT Drag and Drop/gtk/org/eclipse/swt/dnd/FileTransfer.java;3;0;6;1;1;1;1;5;125;2;4;317;232;232;2;1;0;5;6;317;1;6352;5;3;
/org.eclipse.jdt.core.tests.model/workspace/Converter/src/test0070/Test.java;1;0;1;1;0;0;0;1;0;0;1;3714;0;0;1;0;0;1;1;3714;0;3714;1;1;
/org.eclipse.pde.ui/src/org/eclipse/pde/internal/ui/editor/schema/NewCompositorAction.java;2;1;2;1;2;2;2;0;4;0;0;5781;8;8;1;0;0;0;2;5781;0;6336;2;2;
/org.eclipse.core.runtime/src/org/eclipse/core/internal/content/ContentDescription.java;3;1;9;1;7;7;7;2;100;1;2;4574;290;290;1;0;0;2;9;4574;0;5918;9;3;
/org.eclipse.jdt.ui.tests.refactoring/resources/MoveMembers/test29/out/A.java;1;0;1;1;0;0;0;1;0;0;1;1651;0;0;1;0;0;1;1;1651;0;1651;1;1;
/org.eclipse.jdt.core.tests.model/workspace/Completion/src3/test0005/Test.java;1;0;1;1;0;0;0;1;0;0;1;5010;0;0;1;0;0;1;1;5010;0;5010;1;1;
/org.eclipse.jdt.core.tests.model/workspace/Converter/src/test0498/A.java;1;0;1;1;0;0;0;1;0;0;1;3714;0;0;1;0;0;1;1;3714;0;3714;1;1;
/org.eclipse.swt/Eclipse SWT OLE Win32/win32/org/eclipse/swt/ole/win32/OLE.java;1;0;1;1;0;0;0;1;15;0;1;1512;15;15;1;0;0;1;1;1512;0;1512;1;1;
/org.eclipse.ui.workbench/Eclipse UI/org/eclipse/ui/internal/WorkbenchActivityService.java;1;0;5;1;0;0;0;5;152;2;4;2808;166;166;2;1;0;5;5;2808;1;3066;4;1;
/org.eclipse.ui.workbench/Eclipse UI/org/eclipse/ui/internal/ide/Policy.java;1;0;1;1;0;0;0;1;0;0;1;1435;0;0;1;0;0;1;1;1435;0;1435;1;1;
/org.eclipse.jface.text/src/org/eclipse/jface/text/templates/GlobalVariables.java;1;0;2;1;0;0;0;2;0;0;1;4258;0;0;2;1;0;2;2;4258;1;4258;1;1;
/org.eclipse.tomcat/src/org/eclipse/tomcat/internal/TomcatAppServer.java;1;1;12;1;6;6;6;6;147;1;6;347;348;348;1;0;0;6;12;347;0;6337;12;1;
/org.eclipse.jdt.core/search/org/eclipse/jdt/internal/core/search/matching/LocalVariableLocator.java;3;0;12;2;2;1;2;10;153;2;8;2514;215;215;2;2;1;10;12;2529;3;5205;9;3;
/org.eclipse.team.cvs.core/src/org/eclipse/team/internal/ccvs/core/syncinfo/CVSResourceVariantFactory.java;1;0;1;1;0;0;0;1;0;0;1;4208;0;0;1;0;0;1;1;4208;0;4208;1;1;
/org.eclipse.jdt.core.tests.model/workspace/Converter/test0056/Test.java;1;0;1;1;0;0;0;1;0;0;1;3714;0;0;1;0;0;1;1;3714;0;3714;1;1;
/org.eclipse.jface.text/src/org/eclipse/jface/text/IInformationControlExtension2.java;2;1;2;1;2;2;2;0;13;0;0;6340;15;15;1;0;0;0;2;6340;0;6359;2;2;
/org.eclipse.debug.core/core/org/eclipse/debug/internal/core/stringsubstitution/IValueVariable.java;2;0;6;1;0;0;0;6;9;1;6;1121;27;27;1;0;0;6;6;1121;0;2514;6;2;
/org.eclipse.jdt.core.tests.model/workspace/Formatter/test010/A_out.java;1;0;1;1;0;0;0;1;0;0;1;2425;0;0;1;0;0;1;1;2425;0;2425;1;1;
/org.eclipse.jdt.core.tests.model/workspace/Formatter/test251/A_out.java;1;0;1;1;0;0;0;1;0;0;1;2442;0;0;1;0;0;1;1;2442;0;2442;1;1;
/org.eclipse.releng.basebuilder/plugins/org.eclipse.build.tools/org.eclipse.build.tools/src/org/eclipse/releng/generators/TestVersionTracker.java;1;0;1;1;1;1;1;0;0;0;0;5735;0;0;1;0;0;0;1;5735;0;5735;1;1;
/org.eclipse.ui.workbench/Eclipse UI/org/eclipse/ui/internal/registry/Capability.java;1;0;1;1;0;0;0;1;0;0;1;2737;0;0;1;0;0;1;1;2737;0;2737;1;1;
/org.eclipse.jdt.ui.tests.refactoring/resources/Delete/testDeleteWithinCu22/out/A.java;1;0;1;1;0;0;0;1;0;0;1;4913;0;0;1;0;0;1;1;4913;0;4913;1;1;
/org.eclipse.team.ui/src/org/eclipse/team/ui/synchronize/views/SyncInfoLabelProvider.java;1;0;1;1;0;0;0;1;0;0;1;3764;0;0;1;0;0;1;1;3764;0;3764;1;1;
/org.eclipse.ui.workbench/Eclipse UI/org/eclipse/ui/dialogs/ProjectLocationMoveDialog.java;1;0;1;1;0;0;0;1;0;0;1;2737;0;0;1;0;0;1;1;2737;0;2737;1;1;
/org.eclipse.ui.workbench/Eclipse UI/org/eclipse/ui/wizards/datatransfer/ZipFileExportWizard.java;2;0;2;1;0;0;0;2;2;1;2;1080;2;2;1;0;0;2;2;1080;0;2737;2;2;
/org.eclipse.osgi/osgi/src/org/osgi/service/url/URLStreamHandlerSetter.java;2;0;2;1;1;1;1;1;3;0;1;3013;3;3;1;0;0;1;2;3013;0;5536;2;2;
/org.eclipse.jdt.ui/core refactoring/org/eclipse/jdt/internal/corext/refactoring/rename/RefactoringAnalyzeUtil.java;4;0;12;1;1;1;1;11;64;1;11;130;130;130;1;0;0;11;12;130;0;6340;12;4;
/org.eclipse.jdt.ui/core refactoring/org/eclipse/jdt/internal/corext/refactoring/structure/TypeReferenceFinder.java;1;0;1;1;0;0;0;1;0;0;1;1126;0;0;1;0;0;1;1;1126;0;1126;1;1;
/org.eclipse.jdt.ui.tests.refactoring/resources/UseSupertypeWherePossible/testNew3/out/A.java;1;0;1;1;0;0;0;1;2;0;1;1272;2;2;1;0;0;1;1;1272;0;1272;1;1;
/org.eclipse.ui.workbench.texteditor/src/org/eclipse/ui/texteditor/ResourceMarkerAnnotationModel.java;2;0;3;1;0;0;0;3;30;1;3;1346;34;34;1;0;0;3;3;1346;0;2741;3;2;
/org.eclipse.jdt.core.tests.model/workspace/Converter/test0416/A.java;1;0;1;1;0;0;0;1;0;0;1;3714;0;0;1;0;0;1;1;3714;0;3714;1;1;
/org.eclipse.jdt.launching/launching/org/eclipse/jdt/internal/launching/RuntimeClasspathEntry.java;2;1;10;2;2;2;2;8;168;2;7;810;319;319;2;1;0;8;10;3810;1;5625;9;2;
/org.eclipse.swt/Eclipse SWT PI/motif/org/eclipse/swt/internal/motif/XCreateWindowEvent.java;1;0;1;1;0;0;0;1;0;0;1;1450;0;0;1;0;0;1;1;1450;0;1450;1;1;
/org.eclipse.jdt.ui.tests.refactoring/resources/ExtractMethodWorkSpace/ExtractMethodTests/locals_in/A_test506.java;1;0;2;1;0;0;0;2;2;1;2;130;4;4;1;0;0;2;2;130;0;844;2;1;
/org.eclipse.jdt.core.tests.model/workspace/Formatter/test245/A_out.java;1;0;1;1;0;0;0;1;0;0;1;2437;0;0;1;0;0;1;1;2437;0;2437;1;1;
/org.eclipse.swt/Eclipse SWT PI/win32/org/eclipse/swt/internal/ole/win32/FUNCDESC2.java;1;0;1;1;0;0;0;1;8;0;1;2915;8;8;1;0;0;1;1;2915;0;2915;1;1;
/org.eclipse.jdt.core/model/org/eclipse/jdt/core/IMember.java;2;0;6;1;0;0;0;6;14;1;6;1868;24;24;1;0;0;6;6;1868;0;4391;6;2;
/org.eclipse.swt/Eclipse SWT PI/carbon/org/eclipse/swt/internal/carbon/PMRect.java;2;2;4;1;3;2;3;1;16;0;1;2733;20;20;2;0;1;1;4;5534;1;5614;3;2;
/org.eclipse.swt/Eclipse SWT/photon/org/eclipse/swt/widgets/Group.java;4;1;6;1;2;2;2;4;13;1;4;110;30;30;1;0;0;4;6;110;0;6352;6;4;
/org.eclipse.jdt.core.tests.model/src/org/eclipse/jdt/core/tests/model/JavaElementDeltaTests.java;5;1;24;1;6;6;6;18;122;2;16;488;564;564;2;2;0;18;24;1905;2;5889;22;5;
/org.eclipse.swt.graphics.text/Eclipse SWT/win32/org/eclipse/swt/graphics/text/Run.java;1;0;5;1;0;0;0;5;15;1;5;2869;28;28;1;0;0;5;5;2869;0;3132;5;1;
/org.eclipse.ui.workbench/Eclipse UI/org/eclipse/ui/part/MultiEditorInput.java;2;1;2;1;2;2;2;0;4;0;0;5467;6;6;1;0;0;0;2;5467;0;6338;2;2;
/org.eclipse.swt/Eclipse SWT/gtk/org/eclipse/swt/widgets/TableColumn.java;7;1;18;1;2;2;2;16;32;1;16;56;148;148;1;0;0;16;18;56;0;6352;18;7;
/org.eclipse.help.ui/src/org/eclipse/help/ui/internal/search/HelpSearchPage.java;1;0;2;1;0;0;0;2;1;1;2;603;1;1;1;0;0;2;2;603;0;2732;2;1;
/org.eclipse.help/src/org/eclipse/help/IContext.java;1;1;2;1;2;2;2;0;27;0;0;5827;33;33;1;0;0;0;2;5827;0;6337;2;1;
/org.eclipse.jdt.ui/ui/org/eclipse/jdt/internal/ui/text/spelling/SpellCheckIterator.java;2;0;4;1;1;1;1;3;6;1;3;3930;10;10;1;0;0;3;4;3930;0;6340;4;2;
/org.eclipse.team.ui/src/org/eclipse/team/ui/synchronize/views/SyncInfoSetContentProvider.java;1;0;1;1;0;0;0;1;0;0;1;3764;0;0;1;0;0;1;1;3764;0;3764;1;1;
/org.eclipse.swt/Eclipse SWT/gtk1x/org/eclipse/swt/widgets/Composite.java;1;0;1;1;0;0;0;1;0;0;1;2327;0;0;1;0;0;1;1;2327;0;2327;1;1;
/org.eclipse.ui.cheatsheets/src/org/eclipse/ui/cheatsheets/ICheatSheetEvent.java;2;0;5;2;0;0;0;5;58;2;3;4625;95;95;2;2;0;5;5;4625;2;4653;3;2;
/org.eclipse.swt/Eclipse SWT PI/gtk/org/eclipse/swt/internal/gtk/GdkEventFocus.java;3;0;4;1;1;1;1;3;17;1;3;1653;23;23;1;0;0;3;4;1653;0;6352;4;3;
/org.eclipse.update.ui.forms/src/org/eclipse/ui/forms/events/ExpansionAdapter.java;1;0;2;1;0;0;0;2;0;0;1;3095;0;0;2;1;0;2;2;3095;1;3095;1;1;
/org.eclipse.pde.ui/src/org/eclipse/pde/internal/ui/parts/FormBrowser.java;2;0;4;1;1;1;1;3;71;1;3;2853;108;108;1;0;0;3;4;2853;0;6336;4;2;
/org.eclipse.ui.workbench/Eclipse UI/org/eclipse/ui/internal/dialogs/ProjectCapabilitySimpleAddWizard.java;1;0;1;1;0;0;0;1;0;0;1;2737;0;0;1;0;0;1;1;2737;0;2737;1;1;
/org.eclipse.ui.workbench.texteditor/src/org/eclipse/ui/texteditor/IAbstractTextEditorHelpContextIds.java;3;0;6;2;2;1;2;4;28;1;4;436;50;50;2;0;1;4;6;6334;1;6334;5;3;
/org.eclipse.jdt.ui/ui refactoring/org/eclipse/jdt/internal/ui/refactoring/reorg/DeleteAction.java;3;0;14;2;1;1;1;13;145;2;12;1114;263;263;2;1;0;13;14;1668;1;6340;13;3;
/org.eclipse.jdt.core.tests.model/workspace/Formatter/test239/A_out.java;1;0;1;1;0;0;0;1;0;0;1;2437;0;0;1;0;0;1;1;2437;0;2437;1;1;
/org.eclipse.ui.workbench/Eclipse UI/org/eclipse/ui/internal/OpenPreferencesAction.java;1;0;1;1;0;0;0;1;45;0;1;2737;45;45;1;0;0;1;1;2737;0;2737;1;1;
/org.eclipse.swt.graphics.text/org.eclipse.swt/Eclipse SWT Custom Widgets/common/org/eclipse/swt/custom/StyledText.java;1;0;5;1;0;0;0;5;82;2;4;2267;202;202;2;1;0;5;5;2267;1;2644;4;1;
/org.eclipse.ui.ide/src/org/eclipse/ui/internal/ide/dialogs/WelcomeParser.java;2;0;2;1;0;0;0;2;66;1;2;2264;66;66;1;0;0;2;2;2264;0;2718;2;2;
/org.eclipse.core.runtime/src/org/eclipse/core/internal/dependencies/DependencySystem.java;2;0;2;1;0;0;0;2;0;1;2;2105;0;0;1;0;0;2;2;2105;0;3013;2;2;
/org.eclipse.osgi/core/framework/org/eclipse/osgi/framework/eventmgr/ListenerList.java;4;0;4;1;0;0;0;4;247;1;4;3013;249;249;1;0;0;4;4;3013;0;5097;4;4;
/org.eclipse.ui.workbench/Eclipse UI/org/eclipse/ui/internal/EditorWorkbook.java;7;3;36;3;10;7;10;26;3487;3;19;887;7163;7163;3;7;3;26;36;4564;10;5539;26;7;
/org.eclipse.jdt.core.tests.compiler/src/org/eclipse/jdt/core/tests/compiler/regression/AssignmentTest.java;2;0;3;1;0;0;0;3;71;1;3;1785;73;73;1;0;0;3;3;1785;0;2389;3;2;
/org.eclipse.ui.ide/src/org/eclipse/ui/internal/roles/IDERoleManager.java;2;0;2;1;0;0;0;2;0;1;2;2063;0;0;1;0;0;2;2;2063;0;2263;2;2;
/org.eclipse.update.core/src/org/eclipse/update/core/ArchiveReference.java;2;2;5;1;4;3;4;1;6;0;1;890;15;15;2;0;1;1;5;5663;1;6336;4;2;
/org.eclipse.pde.ui/src/org/eclipse/pde/internal/ui/wizards/plugin/PluginContentPage.java;2;1;2;1;2;2;2;0;4;0;0;6147;4;4;1;0;0;0;2;6147;0;6336;2;2;
/org.eclipse.team.ui/src/org/eclipse/team/internal/ui/sync/actions/PasteAction.java;2;0;2;1;0;0;0;2;0;1;2;1876;0;0;1;0;0;2;2;1876;0;2632;2;2;
/org.eclipse.jface.text/src/org/eclipse/jface/text/contentassist/IContextInformationValidatorExtension.java;1;0;4;1;1;1;1;3;6;2;2;2280;10;10;2;1;0;3;4;2280;1;5181;3;1;
/org.eclipse.jdt.debug.ui/ui/org/eclipse/jdt/internal/debug/core/refactoring/JavaBreakpointIJavaProjectRenameParticipant.java;2;1;2;1;2;2;2;0;8;0;0;5621;8;8;1;0;0;0;2;5621;0;6339;2;2;
/org.eclipse.ui.workbench/Eclipse UI/org/eclipse/ui/keys/IKeyManagerListener.java;1;0;2;1;0;0;0;2;0;1;2;1294;0;0;1;0;0;2;2;1294;0;1321;2;1;
/org.eclipse.jdt.ui.tests.refactoring/resources/MoveInstanceMethod/canMove/test22/out/A.java;1;0;1;1;0;0;0;1;0;0;1;1603;0;0;1;0;0;1;1;1603;0;1603;1;1;
/org.eclipse.swt/Eclipse SWT Drag and Drop/win32/org/eclipse/swt/dnd/FileTransfer.java;1;0;1;1;0;0;0;1;88;0;1;307;88;88;1;0;0;1;1;307;0;307;1;1;
/org.eclipse.jdt.core.tests.model/workspace/Converter/src/test0406/A.java;1;0;1;1;0;0;0;1;0;0;1;3714;0;0;1;0;0;1;1;3714;0;3714;1;1;
/org.eclipse.jdt.ui/ui/org/eclipse/jdt/ui/actions/AddDelegateMethodsAction.java;4;1;20;1;4;4;4;16;346;2;14;436;595;595;2;2;0;16;20;576;2;6163;18;4;
/org.eclipse.ui.ide/src/org/eclipse/ui/internal/ide/dialogs/MultiStepWizardDialog.java;1;0;1;1;0;0;0;1;0;0;1;2264;0;0;1;0;0;1;1;2264;0;2264;1;1;
/org.eclipse.pde.ui/src/org/eclipse/pde/internal/ui/editor/manifest/ImportStatusSection.java;2;0;6;1;1;1;1;5;10;1;5;648;27;27;1;0;0;5;6;648;0;5431;6;2;
/org.eclipse.jdt.launching/launching/org/eclipse/jdt/launching/sourcelookup/containers/ClasspathVariableSourceContainer.java;1;0;2;1;0;0;0;2;4;1;2;4971;4;4;1;0;0;2;2;4971;0;5091;2;1;
/org.eclipse.swt/Eclipse SWT/motif/org/eclipse/swt/widgets/ScrollBar.java;4;1;6;1;2;2;2;4;32;1;4;17;61;61;1;0;0;4;6;17;0;6352;6;4;
/org.eclipse.pde.core/src/org/eclipse/pde/core/plugin/IPluginAttribute.java;3;1;5;1;4;4;4;1;24;0;1;4203;34;34;1;0;0;1;5;4203;0;6336;5;3;
/org.eclipse.jface.text/src/org/eclipse/jface/text/contentassist/IContentAssistantExtension.java;3;1;8;1;3;3;3;5;20;1;5;1511;68;68;1;0;0;5;8;1511;0;6356;8;3;
/org.eclipse.ui.workbench.texteditor/src/org/eclipse/ui/texteditor/IWorkbenchActionDefinitionIds.java;2;1;4;1;2;2;2;2;18;1;2;2020;26;26;1;0;0;2;4;2020;0;6340;4;2;
/org.eclipse.core.runtime.compatibility/src-runtime/org/eclipse/core/internal/plugins/PluginRegistry.java;4;1;8;1;3;3;3;5;84;1;5;3013;173;173;1;0;0;5;8;3013;0;6340;8;4;
/org.eclipse.swt.tests/JUnit Tests/org/eclipse/swt/tests/junit/Test_org_eclipse_swt_widgets_Decorations.java;4;0;7;1;1;1;1;6;64;1;6;1909;177;177;1;0;0;6;7;1909;0;6352;7;4;
/org.eclipse.jdt.core.tests.model/workspace/Converter/test0466/Assert.java;1;0;1;1;0;0;0;1;0;0;1;3714;0;0;1;0;0;1;1;3714;0;3714;1;1;
/org.eclipse.jdt.core.tests.model/workspace/Converter/test0255/Test.java;1;0;1;1;0;0;0;1;0;0;1;3714;0;0;1;0;0;1;1;3714;0;3714;1;1;
/org.eclipse.search/new search/org/eclipse/search/ui/ISearchResultPresentation.java;1;0;2;1;0;0;0;2;0;1;2;3474;0;0;1;0;0;2;2;3474;0;3711;2;1;
/org.eclipse.core.tests.resources/src/org/eclipse/core/tests/internal/indexing/BasicFieldTest.java;1;0;2;1;2;1;2;0;48;0;0;5147;48;48;2;0;1;0;2;5147;1;5147;1;1;
/org.eclipse.swt/Eclipse SWT Custom Widgets/common/org/eclipse/swt/custom/CTabFolderListener.java;2;1;5;1;2;2;2;3;14;1;3;1540;36;36;1;0;0;3;5;1540;0;6352;5;2;
/org.eclipse.jdt.debug/jdi interfaces/com/sun/jdi/VMCannotBeModifiedException.java;1;0;1;1;0;0;0;1;0;0;1;4267;0;0;1;0;0;1;1;4267;0;4267;1;1;
/org.eclipse.pde.ui/src/org/eclipse/pde/internal/ui/editor/plugin/OSGiSection.java;1;1;2;1;2;2;2;0;0;0;0;5431;0;0;1;0;0;0;2;5431;0;5561;2;1;
/org.eclipse.jdt.ui.tests.refactoring/resources/ExtractMethodWorkSpace/ExtractMethodTests/expression_in/A_test613.java;1;0;1;1;0;0;0;1;2;0;1;844;2;2;1;0;0;1;1;844;0;844;1;1;
/org.eclipse.ui.tests/Eclipse UI Tests/org/eclipse/ui/tests/keys/Bug43610Test.java;1;0;2;1;0;0;0;2;2;1;2;2513;2;2;1;0;0;2;2;2513;0;2898;2;1;
/org.eclipse.jdt.debug.ui/ui/org/eclipse/jdt/internal/debug/ui/actions/ThreadFilterAction.java;2;0;2;1;0;0;0;2;0;1;2;3112;0;0;1;0;0;2;2;3112;0;3296;2;2;
/org.eclipse.ltk.core.refactoring/src/org/eclipse/ltk/internal/core/refactoring/RefactoringCorePlugin.java;1;1;6;1;4;4;4;2;22;1;2;4845;58;58;1;0;0;2;6;4845;0;5380;6;1;
/org.eclipse.swt.tools/JNI Generation/org/eclipse/swt/tools/internal/StatsGenerator.java;2;2;3;2;3;2;3;0;28;0;0;5338;28;28;2;0;1;0;3;5338;1;5406;2;2;
/org.eclipse.team.webdav/src/org/eclipse/team/internal/ui/target/subscriber/SiteSelectionPage.java;2;0;3;1;1;1;1;2;145;1;2;3494;147;147;1;0;0;2;3;3494;0;6337;3;2;
/org.eclipse.team.webdav/src/org/eclipse/team/internal/core/target/IRemoteTargetResource.java;2;0;3;1;1;1;1;2;49;1;2;2495;51;51;1;0;0;2;3;2495;0;6337;3;2;
/org.eclipse.team.core/src/org/eclipse/team/internal/core/subscribers/caches/ResourceVariantByteStore.java;1;0;4;1;0;0;0;4;111;1;4;4216;113;113;1;0;0;4;4;4216;0;4349;4;1;
/org.eclipse.jdt.core.tests.model/workspace/Formatter/test198/A_in.java;1;0;1;1;0;0;0;1;0;0;1;2424;0;0;1;0;0;1;1;2424;0;2424;1;1;
/org.eclipse.update.core/src/org/eclipse/update/internal/model/SiteLocalParser.java;2;1;11;1;3;3;3;8;174;3;6;890;306;306;3;2;0;8;11;4367;2;6336;9;2;
/org.eclipse.debug.ui/ui/org/eclipse/debug/internal/ui/console/ConsoleMessages.java;2;0;2;1;0;0;0;2;0;1;2;1294;0;0;1;0;0;2;2;1294;0;2060;2;2;
/org.eclipse.jdt.launching/launching/org/eclipse/jdt/internal/launching/JavaAppletLaunchConfigurationDelegate.java;3;1;9;2;2;2;2;7;32;2;6;2497;98;98;2;1;0;7;9;4524;1;5744;8;3;
/org.eclipse.debug.ui/ui/org/eclipse/debug/internal/ui/stringsubstitution/ResourceResolver.java;5;0;7;2;1;1;1;6;18;2;5;2046;44;44;2;1;0;6;7;4900;1;6336;6;5;
/org.eclipse.jdt.core.tests.model/workspace/Formatter/test452/A_out.java;1;0;1;1;0;0;0;1;0;0;1;3743;0;0;1;0;0;1;1;3743;0;3743;1;1;
/org.eclipse.jdt.core.tests.model/workspace/Formatter/test207/A_out.java;1;0;1;1;0;0;0;1;0;0;1;2424;0;0;1;0;0;1;1;2424;0;2424;1;1;
/org.eclipse.team.core/src/org/eclipse/team/core/synchronize/IResourceVariantComparator.java;2;0;3;1;0;0;0;3;61;1;3;4127;61;61;1;0;0;3;3;4127;0;4349;3;2;
/org.eclipse.jdt.ui.tests.refactoring/resources/ExtractTemp/canExtract/A_test78_out.java;1;0;1;1;0;0;0;1;0;0;1;4171;0;0;1;0;0;1;1;4171;0;4171;1;1;
/org.eclipse.ui.workbench/Eclipse UI/org/eclipse/ui/IStorageEditorInput.java;1;0;1;1;0;0;0;1;0;0;1;2737;0;0;1;0;0;1;1;2737;0;2737;1;1;
/org.eclipse.jdt.ui/ui/org/eclipse/jdt/internal/ui/dnd/JdtViewerDropAdapter.java;1;0;1;1;1;1;1;0;2;0;0;6340;2;2;1;0;0;0;1;6340;0;6340;1;1;
/org.eclipse.help/src/org/eclipse/help/internal/search/QueryBuilder.java;1;0;5;1;0;0;0;5;69;1;5;105;98;98;1;0;0;5;5;105;0;2732;5;1;
/org.eclipse.text/src/org/eclipse/text/edits/MoveTargetEdit.java;2;0;4;1;1;1;1;3;74;1;3;1986;109;109;1;0;0;3;4;1986;0;6340;4;2;
/org.eclipse.core.runtime.osgi/src/org/eclipse/core/internal/runtime/Assert.java;1;0;2;1;0;0;0;2;154;1;2;3013;154;154;1;0;0;2;2;3013;0;3030;2;1;
/org.eclipse.jdt.ui/ui refactoring/org/eclipse/jdt/internal/ui/refactoring/nls/PackageSelectionDialogButtonField.java;3;1;3;1;2;2;2;1;14;0;1;4930;16;16;1;0;0;1;3;4930;0;6340;3;3;
/org.eclipse.releng.basebuilder/plugins/org.eclipse.build.tools/src/org/eclipse/releng/generators/TestResultsGenerator.java;2;0;6;1;0;0;0;6;107;1;6;92;180;180;1;0;0;6;6;92;0;5039;6;2;
/org.eclipse.core.runtime/src/org/eclipse/core/internal/locks/Queue.java;1;0;1;1;0;0;0;1;0;0;1;320;0;0;1;0;0;1;1;320;0;320;1;1;
/org.eclipse.ui.intro/src/org/eclipse/ui/intro/internal/model/loader/ModelLoaderUtil.java;1;0;2;1;1;1;1;1;0;0;1;5096;0;0;1;0;0;1;2;5096;0;5115;2;1;
/org.eclipse.pde.core/src/org/eclipse/pde/internal/core/osgi/bundle/BundleFragmentModel.java;1;0;2;1;1;1;1;1;0;0;1;4203;0;0;1;0;0;1;2;4203;0;5445;2;1;
/org.eclipse.webdav/src/kernel/org/eclipse/webdav/internal/kernel/utils/EmptyEnumeration.java;1;0;2;1;2;1;2;0;36;0;0;5151;36;36;2;0;1;0;2;5151;1;5151;1;1;
/org.eclipse.ui.workbench/Eclipse UI/org/eclipse/ui/internal/WorkbenchWindow.java;12;5;170;5;35;23;35;135;4037;7;81;368;12551;12551;7;54;12;135;170;1710;66;6338;104;12;
/org.eclipse.ui.workbench/Eclipse UI/org/eclipse/ui/keys/IKeyFormatter.java;2;0;2;1;0;0;0;2;14;1;2;3236;14;14;1;0;0;2;2;3236;0;3350;2;2;
/org.eclipse.ui.externaltools/Ant Editor/org/eclipse/ui/externaltools/internal/ant/dtd/util/AntDTDUtilMessages.java;1;0;1;1;0;0;0;1;0;0;1;282;0;0;1;0;0;1;1;282;0;282;1;1;
/org.eclipse.team.ui/src/org/eclipse/team/ui/sync/SubscriberPage.java;1;0;1;1;0;0;0;1;0;0;1;2406;0;0;1;0;0;1;1;2406;0;2406;1;1;
/org.eclipse.core.runtime/src/org/eclipse/core/runtime/jobs/IJobChangeListener.java;3;0;12;1;1;1;1;11;150;1;11;688;445;445;1;0;0;11;12;688;0;5150;12;3;
/org.eclipse.jdt.core.tests.model/workspace/Formatter/test169/A_out.java;1;0;2;1;0;0;0;2;4;1;2;2425;4;4;1;0;0;2;2;2425;0;3029;2;1;
/org.eclipse.jdt.core.tests.compiler/src/org/eclipse/jdt/core/tests/compiler/regression/CollisionCase.java;2;1;2;1;2;2;2;0;10;0;0;5273;10;10;1;0;0;0;2;5273;0;6336;2;2;
/org.eclipse.jdt.core/compiler/org/eclipse/jdt/internal/compiler/CompilationResult.java;3;0;4;1;1;1;1;3;34;1;3;24;52;52;1;0;0;3;4;24;0;6095;4;3;
/org.eclipse.team.tests.cvs.core/src/org/eclipse/team/tests/ccvs/ui/unit/AllUIUnitTests.java;2;0;3;1;0;0;0;3;1;1;3;1914;1;1;1;0;0;3;3;1914;0;2632;3;2;
/org.eclipse.jdt.core.tests.model/workspace/Formatter/test132/A_out.java;1;0;1;1;0;0;0;1;0;0;1;2425;0;0;1;0;0;1;1;2425;0;2425;1;1;
/org.eclipse.swt/Eclipse SWT PI/win32/org/eclipse/swt/internal/win32/NOTIFYICONDATAW.java;3;0;5;2;1;1;1;4;8;2;2;4450;16;16;2;2;0;4;5;4450;2;6352;3;3;
/org.eclipse.update.configurator/src/org/eclipse/update/internal/configurator/Configuration.java;1;1;8;1;4;4;4;4;14;2;3;4095;47;47;2;1;0;4;8;4697;1;5616;7;1;
/org.eclipse.jdt.ui.tests.refactoring/resources/ExtractMethodWorkSpace/ExtractMethodTests/return_in/A_test702.java;1;0;1;1;0;0;0;1;4;0;1;844;4;4;1;0;0;1;1;844;0;844;1;1;
/org.eclipse.update.ui/src/org/eclipse/update/internal/ui/forms/DetailsHistory.java;1;0;1;1;0;0;0;1;0;0;1;755;0;0;1;0;0;1;1;755;0;755;1;1;
/org.eclipse.ui.workbench/Eclipse UI/org/eclipse/ui/internal/presentations/TabFolderLayout.java;2;2;9;1;3;2;3;6;96;1;6;4691;228;228;2;0;1;6;9;5232;1;5522;8;2;
/org.eclipse.jdt.core.tests.model/workspace/Formatter/test138/A_in.java;1;0;1;1;0;0;0;1;0;0;1;2425;0;0;1;0;0;1;1;2425;0;2425;1;1;
/org.eclipse.pde.ui/src_Forms/org/eclipse/pde/internal/ui/model/IEditingModel.java;2;1;6;1;4;4;4;2;10;1;2;4438;20;20;1;0;0;2;6;4438;0;6336;6;2;
/org.eclipse.swt.graphics.text/Eclipse SWT PI/gtk/org/eclipse/swt/internal/gtk/PangoItem.java;1;0;1;1;0;0;0;1;0;0;1;4213;0;0;1;0;0;1;1;4213;0;4213;1;1;
/org.eclipse.jdt.ui.tests/ui/org/eclipse/jdt/ui/tests/astrewrite/ASTRewritingMoveCodeTest.java;3;0;30;1;1;1;1;29;865;2;26;85;3294;3294;2;3;0;29;30;85;3;5406;27;3;
/org.eclipse.jdt.ui/ui/org/eclipse/jdt/internal/ui/search/JavaSearchCategory.java;1;0;1;1;0;0;0;1;0;0;1;3488;0;0;1;0;0;1;1;3488;0;3488;1;1;
/org.eclipse.ui.editors/src/org/eclipse/ui/texteditor/MarkerRulerAction.java;2;1;7;1;3;3;3;4;428;1;4;1983;508;508;1;0;0;4;7;1983;0;6337;7;2;
/org.eclipse.ui.views/src/org/eclipse/ui/views/internal/tableview/FiltersAction.java;1;0;2;1;0;0;0;2;0;1;2;267;0;0;1;0;0;2;2;267;0;749;2;1;
/org.eclipse.team.ui/src/org/eclipse/team/internal/ui/synchronize/SyncInfoDiffViewerSyncViewConfiguration.java;1;0;1;1;0;0;0;1;0;0;1;3619;0;0;1;0;0;1;1;3619;0;3619;1;1;
/org.eclipse.jdt.ui/ui/org/eclipse/jdt/internal/ui/text/JavaPartitionScanner.java;1;0;2;1;1;1;1;1;4;0;1;1350;6;6;1;0;0;1;2;1350;0;6340;2;1;
/org.eclipse.team.core/src/org/eclipse/team/core/ProjectSetSerializationContext.java;1;1;5;1;3;3;3;2;56;1;2;4857;90;90;1;0;0;2;5;4857;0;6333;5;1;
/org.eclipse.core.resources/src/org/eclipse/core/resources/IResourceDelta.java;2;1;5;1;3;3;3;2;721;1;2;44;832;832;1;0;0;2;5;44;0;6339;5;2;
/org.eclipse.ui.views/src/org/eclipse/ui/views/navigator/ResourceContentProvider.java;1;0;1;1;0;0;0;1;0;0;1;1079;0;0;1;0;0;1;1;1079;0;1079;1;1;
/org.eclipse.ui.ide/src/org/eclipse/ui/views/tasklist/PasteTaskAction.java;1;0;1;1;0;0;0;1;0;0;1;2208;0;0;1;0;0;1;1;2208;0;2208;1;1;
/org.eclipse.ui.workbench/Eclipse UI/org/eclipse/ui/internal/commands/ConfigurationElementMemento.java;1;0;3;1;0;0;0;3;0;1;3;786;0;0;1;0;0;3;3;786;0;1077;3;1;
/org.eclipse.core.tests.runtime/src/org/eclipse/core/tests/runtime/locks/VerboseJobListener.java;1;0;2;1;0;0;0;2;0;1;2;698;0;0;1;0;0;2;2;698;0;850;2;1;
/org.eclipse.team.ui/src/org/eclipse/team/ui/synchronize/ScopableSubscriberParticipant.java;1;0;1;1;1;1;1;0;0;0;0;5594;0;0;1;0;0;0;1;5594;0;5594;1;1;
/org.eclipse.jdt.ui/ui/org/eclipse/jdt/internal/ui/callhierarchy/CallHierarchyUI.java;3;1;14;1;3;3;3;11;89;3;9;169;281;281;3;2;0;11;14;169;2;6340;12;3;
/org.eclipse.ui.workbench.texteditor/src/org/eclipse/ui/texteditor/TextSelectionNavigationLocation.java;2;1;3;1;2;2;2;1;12;0;1;1051;16;16;1;0;0;1;3;1051;0;6340;3;2;
/org.eclipse.jdt.ui/core refactoring/org/eclipse/jdt/internal/corext/refactoring/code/ConvertAnonymousToNestedRefactoring.java;5;1;32;2;5;5;5;27;662;2;25;48;1129;1129;2;2;0;27;32;546;2;6340;30;5;
/org.eclipse.jdt.core.tests.model/workspace/Formatter/test058/A_in.java;1;0;1;1;0;0;0;1;0;0;1;2425;0;0;1;0;0;1;1;2425;0;2425;1;1;
/org.eclipse.pde.ui/src_Forms/org/eclipse/pde/internal/ui/model/plugin/PluginBaseNode.java;3;1;19;1;5;5;5;14;155;2;11;4438;443;443;2;3;0;14;19;4899;3;6336;16;3;
/org.eclipse.jdt.ui.tests.refactoring/resources/ExtractMethodWorkSpace/ExtractMethodTests/locals_out/A_test508.java;1;0;2;1;0;0;0;2;6;1;2;130;7;7;1;0;0;2;2;130;0;844;2;1;
/org.eclipse.ui.workbench/Eclipse UI/org/eclipse/ui/internal/chris/roles/api/IRoleManager.java;1;0;2;1;0;0;0;2;0;0;1;2207;0;0;2;1;0;2;2;2207;1;2207;1;1;
/org.eclipse.jdt.core.tests.compiler/src/org/eclipse/jdt/core/tests/runtime/StandardVMLauncher.java;2;0;6;1;0;0;0;6;24;2;5;1387;53;53;2;1;0;6;6;1854;1;3560;5;2;
/org.eclipse.ui.views/src/org/eclipse/ui/views/contentoutline/ContentOutlinePage.java;3;2;3;2;3;2;3;0;12;0;0;5339;18;18;2;0;1;0;3;6338;1;6338;2;3;
/org.eclipse.ui.intro/src/org/eclipse/ui/intro/internal/model/AbstractIntroElement.java;1;0;4;1;1;1;1;3;70;2;2;4898;78;78;2;1;0;3;4;4898;1;5115;3;1;
/org.eclipse.jdt.ui.tests.refactoring/resources/ChangeTypeRefactoring/positive/A_testLocalVarName_in.java;1;0;1;1;0;0;0;1;0;0;1;2844;0;0;1;0;0;1;1;2844;0;2844;1;1;
/org.eclipse.ui.workbench/Eclipse UI/org/eclipse/ui/internal/progress/IJobProgressManagerListener.java;2;0;5;1;1;1;1;4;16;1;4;1445;32;32;1;0;0;4;5;1445;0;6338;5;2;
/org.eclipse.ui.workbench/Eclipse UI/org/eclipse/ui/internal/csm/roles/api/IRoleRegistryEvent.java;1;0;2;1;0;0;0;2;0;1;2;2213;0;0;1;0;0;2;2;2213;0;2225;2;1;
/org.eclipse.jdt.ui/ui/org/eclipse/jdt/internal/ui/text/correction/CorrectPackageDeclarationProposal.java;3;0;9;1;1;1;1;8;25;2;7;1034;79;79;2;1;0;8;9;1953;1;6340;8;3;
/org.eclipse.core.runtime/src/org/eclipse/core/runtime/NullProgressMonitor.java;2;1;6;1;2;2;2;4;230;1;4;3013;486;486;1;0;0;4;6;3013;0;6340;6;2;
/org.eclipse.search/search/org/eclipse/search/internal/ui/text/NameSorter.java;1;0;2;1;1;1;1;1;4;0;1;3711;4;4;1;0;0;1;2;3711;0;5438;2;1;
/org.eclipse.ui.workbench/Eclipse UI/org/eclipse/ui/internal/commands/old/IRegistry.java;1;0;2;1;0;0;0;2;14;1;2;1322;14;14;1;0;0;2;2;1322;0;1356;2;1;
/org.eclipse.ui.tests/Eclipse JFace Tests/org/eclipse/jface/tests/preferences/FontPreferenceTestCase.java;1;0;1;1;0;0;0;1;0;0;1;2754;0;0;1;0;0;1;1;2754;0;2754;1;1;
/org.eclipse.core.runtime.osgi/src/org/eclipse/core/internal/registry/IExtensionLinker.java;1;0;1;1;0;0;0;1;0;0;1;3013;0;0;1;0;0;1;1;3013;0;3013;1;1;
/org.eclipse.team.cvs.ui/src/org/eclipse/team/internal/ccvs/ui/operations/CheckoutIntoOperation.java;2;1;16;1;2;2;2;14;394;2;13;664;650;650;2;1;0;14;16;1840;1;6337;15;2;
/org.eclipse.osgi/core/framework/org/eclipse/osgi/framework/eventmgr/EventDispatcher.java;1;0;2;1;1;1;1;1;4;0;1;5097;4;4;1;0;0;1;2;5097;0;5667;2;1;
/org.eclipse.team.cvs.core/src/org/eclipse/team/internal/ccvs/core/resources/FileModificationManager.java;2;0;6;1;1;1;1;5;18;1;5;276;47;47;1;0;0;5;6;276;0;6337;6;2;
/org.eclipse.jdt.ui.tests/test plugin/org/eclipse/jdt/testplugin/util/AccessibilityTestPass.java;1;0;1;1;1;1;1;0;4;0;0;6340;4;4;1;0;0;0;1;6340;0;6340;1;1;
/org.eclipse.jdt.core.tests.model/workspace/Formatter/test114/A_in.java;1;0;1;1;0;0;0;1;0;0;1;2425;0;0;1;0;0;1;1;2425;0;2425;1;1;
/org.eclipse.osgi/defaultAdaptor/src/org/eclipse/osgi/framework/internal/defaultadaptor/DefaultClassLoader.java;5;2;24;1;6;5;6;18;314;2;16;3013;1010;1010;2;2;1;18;24;3233;3;5656;21;5;
/org.eclipse.text/projection/org/eclipse/jface/text/ProjectionTextStore.java;1;0;2;1;1;1;1;1;1;0;1;4516;1;1;1;0;0;1;2;4516;0;5177;2;1;
/org.eclipse.jdt.core/compiler/org/eclipse/jdt/internal/compiler/ast/ImplicitDocTypeReference.java;1;0;1;1;0;0;0;1;0;0;1;3917;0;0;1;0;0;1;1;3917;0;3917;1;1;
/org.eclipse.pde.ui/src_Forms/org/eclipse/pde/internal/ui/neweditor/XMLInputContext.java;1;0;3;1;0;0;0;3;12;1;3;3777;12;12;1;0;0;3;3;3777;0;4313;3;1;
/org.eclipse.core.tests.resources/src/org/eclipse/core/tests/resources/usecase/ConcurrentOperation01.java;1;0;2;1;2;1;2;0;47;0;0;5147;47;47;2;0;1;0;2;5147;1;5147;1;1;
/org.eclipse.core.tests.runtime/src/org/eclipse/core/tests/runtime/locks/IdentityRule.java;1;0;2;1;0;0;0;2;0;1;2;698;0;0;1;0;0;2;2;698;0;850;2;1;
/org.eclipse.ui.workbench/Eclipse UI/org/eclipse/ui/internal/IniFileReader.java;4;0;5;1;1;1;1;4;409;1;4;1317;517;517;1;0;0;4;5;1317;0;5485;5;4;
/org.eclipse.ui.workbench.texteditor/src/org/eclipse/ui/texteditor/quickdiff/ReferenceProviderDescriptor.java;2;2;9;2;8;7;8;1;20;0;1;1644;42;42;2;0;1;1;9;5376;1;6340;8;2;
/org.eclipse.osgi/resolver/src/org/eclipse/core/dependencies/IMatchRule.java;3;1;3;1;2;2;2;1;1;0;1;3013;1;1;1;0;0;1;3;3013;0;5226;3;3;
/org.eclipse.jdt.ui/ui/org/eclipse/jdt/ui/actions/ExtractConstantAction.java;4;0;9;2;2;1;2;7;44;1;7;122;92;92;2;0;1;7;9;6334;1;6334;8;4;
/org.eclipse.update.ui/src/org/eclipse/update/internal/ui/UpdateUI.java;3;1;29;2;3;3;3;26;125;3;20;460;589;589;3;6;0;26;29;772;6;6336;23;3;
/org.eclipse.jface/src/org/eclipse/jface/action/ContributionItem.java;2;0;2;1;0;0;0;2;14;1;2;3220;19;19;1;0;0;2;2;3220;0;3238;2;2;
/org.eclipse.jface.text/src/org/eclipse/jface/text/rules/DefaultDamagerRepairer.java;1;0;3;1;1;1;1;2;10;1;2;2931;17;17;1;0;0;2;3;2931;0;6340;3;1;
/org.eclipse.jdt.ui.tests.refactoring/resources/IntroduceFactory/Bugzilla/59283/proj1/pA/A.java;1;0;1;1;1;1;1;0;0;0;0;5661;0;0;1;0;0;0;1;5661;0;5661;1;1;
/org.eclipse.ui.externaltools/Ant Tools Support/org/eclipse/ui/externaltools/internal/ant/launchConfigurations/TargetOrderDialog.java;1;0;1;1;0;0;0;1;0;0;1;282;0;0;1;0;0;1;1;282;0;282;1;1;
/org.eclipse.ui.workbench/Eclipse UI/org/eclipse/ui/internal/commands/IRegistry.java;1;0;3;1;0;0;0;3;14;2;2;1356;14;14;2;1;0;3;3;1389;1;1389;2;1;
/org.eclipse.jdt.ui/core extension/org/eclipse/jdt/internal/corext/dom/ListRewriter.java;2;0;6;2;0;0;0;6;133;2;5;3580;150;150;2;1;0;6;6;4603;1;4794;5;2;
/org.eclipse.ui.ide/src/org/eclipse/ui/internal/dialogs/SimpleListContentProvider.java;2;0;2;1;0;0;0;2;0;1;2;1526;0;0;1;0;0;2;2;1526;0;2263;2;2;
/org.eclipse.ant.ui/Ant Tools Support/org/eclipse/ant/ui/internal/launchConfigurations/AntConsoleColorProvider.java;1;0;5;1;0;0;0;5;26;1;5;250;52;52;1;0;0;5;5;250;0;1811;5;1;
/org.eclipse.swt.tests/JUnit Tests/org/eclipse/swt/tests/junit/Test_org_eclipse_swt_graphics_PaletteData.java;1;0;1;1;0;0;0;1;90;0;1;2492;90;90;1;0;0;1;1;2492;0;2492;1;1;
/org.eclipse.ant.ui/Ant Tools Support/org/eclipse/ant/internal/ui/views/elements/AntViewElementsMessages.java;1;0;1;1;0;0;0;1;0;0;1;1811;0;0;1;0;0;1;1;1811;0;1811;1;1;
/org.eclipse.ant.tests.core/tests/org/eclipse/ant/tests/core/tests/ProjectTests.java;1;0;3;1;0;0;0;3;40;2;2;1402;53;53;2;1;0;3;3;1402;1;1420;2;1;
/org.eclipse.ui.workbench/Eclipse UI/org/eclipse/ui/internal/activities/IActivityRegistryEvent.java;1;0;2;1;0;0;0;2;0;1;2;2444;0;0;1;0;0;2;2;2444;0;2805;2;1;
/org.eclipse.search/new search/org/eclipse/search/ui/text/IStructureProvider.java;1;0;2;1;0;0;0;2;0;1;2;3474;0;0;1;0;0;2;2;3474;0;3711;2;1;
/org.eclipse.core.runtime.osgi/src/org/eclipse/core/internal/jobs/ImplicitJobs.java;1;0;2;1;0;0;0;2;39;1;2;3013;39;39;1;0;0;2;2;3013;0;3028;2;1;
/org.eclipse.core.tests.resources/src/org/eclipse/core/tests/resources/session/TestBug6995.java;1;0;1;1;1;1;1;0;173;0;0;5147;173;173;1;0;0;0;1;5147;0;5147;1;1;
/org.eclipse.jdt.core.tests.model/workspace/Converter/src/test0508/A.java;1;0;1;1;0;0;0;1;0;0;1;3714;0;0;1;0;0;1;1;3714;0;3714;1;1;
/org.eclipse.pde.ui/src/org/eclipse/pde/internal/ui/editor/build/BuildInputContext.java;3;2;6;2;6;5;6;0;16;0;0;5431;33;33;2;0;1;0;6;5431;1;6336;5;3;
/org.eclipse.ui.ide/src/org/eclipse/ui/internal/ide/Policy.java;1;0;1;1;0;0;0;1;0;0;1;1512;0;0;1;0;0;1;1;1512;0;1512;1;1;
/org.eclipse.ui.tests/Eclipse UI Tests/org/eclipse/ui/tests/dialogs/DeprecatedUIDialogsAuto.java;1;0;1;1;0;0;0;1;9;0;1;2738;9;9;1;0;0;1;1;2738;0;2738;1;1;
/org.eclipse.jdt.ui/ui/org/eclipse/jdt/internal/ui/callhierarchy/ToggleImplementorsAction.java;2;0;2;1;0;0;0;2;0;1;2;218;0;0;1;0;0;2;2;218;0;2893;2;2;
/org.eclipse.osgi/core/framework/org/eclipse/osgi/service/systembundle/EntryLocator.java;1;0;1;1;1;1;1;0;0;0;0;5232;0;0;1;0;0;0;1;5232;0;5232;1;1;
/org.eclipse.jdt.core.tests.model/workspace/Completion/src3/test0006/Test.java;1;0;1;1;0;0;0;1;0;0;1;5010;0;0;1;0;0;1;1;5010;0;5010;1;1;
/org.eclipse.jdt.core.tests.model/workspace/Formatter/test159/A_in.java;1;0;1;1;0;0;0;1;0;0;1;2425;0;0;1;0;0;1;1;2425;0;2425;1;1;
/org.eclipse.swt.tests/JUnit Tests/org/eclipse/swt/tests/junit/Test_org_eclipse_swt_events_FocusEvent.java;1;0;2;1;1;1;1;1;7;0;1;3444;11;11;1;0;0;1;2;3444;0;6352;2;1;
/org.eclipse.jdt.core.tests.model/workspace/Formatter/test447/Format_out.java;1;0;3;1;0;0;0;3;2;1;3;3673;2;2;1;0;0;3;3;3673;0;3742;3;1;
/org.eclipse.jdt.ui.tests.refactoring/resources/PasteSourceReference/test3/out/B.java;1;0;1;1;0;0;0;1;0;0;1;1311;0;0;1;0;0;1;1;1311;0;1311;1;1;
/org.eclipse.core.tests.runtime/src/org/eclipse/core/tests/internal/plugins/ParseHelper.java;1;0;1;1;0;0;0;1;0;0;1;3014;0;0;1;0;0;1;1;3014;0;3014;1;1;
/org.eclipse.jdt.core.tests.model/workspace/Converter/src/junit/extensions/ExceptionTestCase.java;1;0;1;1;0;0;0;1;0;0;1;3714;0;0;1;0;0;1;1;3714;0;3714;1;1;
/org.eclipse.jdt.ui/ui/org/eclipse/jdt/ui/jarpackager/JarPackageData.java;3;2;8;2;6;5;6;2;51;1;2;394;127;127;2;0;1;2;8;6334;1;6334;7;3;
/org.eclipse.update.ui.forms/src/org/eclipse/update/ui/forms/internal/richtext/Locator.java;1;0;2;1;0;0;0;2;0;1;2;2849;0;0;1;0;0;2;2;2849;0;2898;2;1;
/org.eclipse.jdt.ui.tests.refactoring/resources/ChangeTypeRefactoring/positive/A_testInterfaceTypes_in.java;1;0;1;1;0;0;0;1;0;0;1;2844;0;0;1;0;0;1;1;2844;0;2844;1;1;
/org.eclipse.jdt.core.tests.model/workspace/Converter/src/javadoc/testBug55221/b/Test.java;2;0;3;2;0;0;0;3;0;0;1;4639;0;0;3;2;0;3;3;4639;2;4639;1;2;
/org.eclipse.ui.externaltools/Ant Editor/org/eclipse/ui/externaltools/internal/ant/dtd/util/FactoryObject.java;1;0;1;1;0;0;0;1;0;0;1;282;0;0;1;0;0;1;1;282;0;282;1;1;
/org.eclipse.team.cvs.core/src/org/eclipse/team/internal/ccvs/core/client/MTHandler.java;1;0;1;1;0;0;0;1;7;0;1;1672;7;7;1;0;0;1;1;1672;0;1672;1;1;
/org.eclipse.core.tools/src/org/eclipse/core/tools/SelectAllAction.java;1;0;1;1;1;1;1;0;0;0;0;6302;0;0;1;0;0;0;1;6302;0;6302;1;1;
/org.eclipse.jdt.core/search/org/eclipse/jdt/internal/core/search/indexing/InternalSearchDocument.java;1;0;1;1;1;1;1;0;0;0;0;5272;0;0;1;0;0;0;1;5272;0;5272;1;1;
/org.eclipse.jdt.ui/core extension/org/eclipse/jdt/internal/corext/util/CodeFormatterUtil.java;2;1;34;1;2;2;2;32;489;4;21;546;1975;1975;4;11;0;32;34;1593;11;6340;23;2;
/org.eclipse.jdt.junit/src/org/eclipse/jdt/internal/junit/refactoring/LaunchConfigTypeChange.java;2;0;2;1;1;1;1;1;10;0;1;5041;10;10;1;0;0;1;2;5041;0;6340;2;2;
/org.eclipse.ui.ide/src/org/eclipse/ui/internal/dialogs/ZipFileResourceExportOperation.java;2;0;3;1;0;0;0;3;16;1;3;1526;16;16;1;0;0;3;3;1526;0;2263;3;2;
/org.eclipse.pde.ui/src/org/eclipse/pde/internal/ui/editor/site/CheckboxObjectListSection.java;2;0;3;1;0;0;0;3;2;1;3;2229;3;3;1;0;0;3;3;2229;0;2311;3;2;
/org.eclipse.jdt.ui.tests.refactoring/test cases/org/eclipse/jdt/ui/tests/reorg/CopyResourcesToClipboardActionTest.java;2;0;6;1;1;1;1;5;11;2;4;1111;19;19;2;1;0;5;6;1111;1;6340;5;2;
/org.eclipse.pde.core/src/org/eclipse/pde/internal/core/CoreSorter.java;1;0;1;1;0;0;0;1;0;0;1;3490;0;0;1;0;0;1;1;3490;0;3490;1;1;
/org.eclipse.ui.ide/src/org/eclipse/ui/views/markers/internal/ImageFactory.java;1;0;1;1;0;0;0;1;0;0;1;2208;0;0;1;0;0;1;1;2208;0;2208;1;1;
/org.eclipse.jdt.core.tests.model/workspace/Converter/test0194/Test.java;1;0;1;1;0;0;0;1;0;0;1;3714;0;0;1;0;0;1;1;3714;0;3714;1;1;
/org.eclipse.core.tools.resources/src/org/eclipse/core/tools/metadata/MarkersDumpingStrategy_1.java;1;0;1;1;1;1;1;0;0;0;0;6302;0;0;1;0;0;0;1;6302;0;6302;1;1;
/org.eclipse.jdt.ui.tests.refactoring/resources/ChangeSignature/cannotModify/A_testFail1.java;1;0;1;1;0;0;0;1;5;0;1;4045;5;5;1;0;0;1;1;4045;0;4045;1;1;
/org.eclipse.swt/Eclipse SWT Accessibility/gtk/org/eclipse/swt/accessibility/AccessibleType.java;1;0;9;1;0;0;0;9;531;3;6;1104;1126;1126;3;3;0;9;9;1104;3;2281;6;1;
/org.eclipse.jdt.ui.tests.refactoring/resources/ChangeSignature/canModify/A_testAll58_out.java;2;0;3;1;0;0;0;3;10;1;3;2093;12;12;1;0;0;3;3;2093;0;4486;3;2;
/org.eclipse.team.ftp/src/org/eclipse/team/internal/ftp/client/DirectoryEntryParser.java;2;0;5;1;1;1;1;4;30;1;4;3382;39;39;1;0;0;4;5;3382;0;6337;5;2;
/org.eclipse.team.ui/src/org/eclipse/team/internal/ui/sync/actions/ContributedSubscriberAction.java;2;0;5;1;0;0;0;5;306;1;5;566;311;311;1;0;0;5;5;566;0;1477;5;2;
/org.eclipse.ui.workbench.texteditor/src/org/eclipse/ui/texteditor/templates/MessageLine.java;2;1;3;1;2;2;2;1;9;0;1;4627;11;11;1;0;0;1;3;4627;0;6340;3;2;
/org.eclipse.swt.graphics.text/Eclipse SWT/emulated/org/eclipse/swt/graphics/text/TextStyle.java;1;0;3;1;0;0;0;3;42;1;3;2744;68;68;1;0;0;3;3;2744;0;4472;3;1;
/org.eclipse.update.ui/src_webapp/org/eclipse/update/internal/ui/servlets/InstallServlet.java;3;0;5;1;0;0;0;5;119;1;5;717;127;127;1;0;0;5;5;717;0;900;5;3;
/org.eclipse.ant.ui/Ant Tools Support/org/eclipse/ant/ui/internal/preferences/ColorEditor.java;1;0;2;1;0;0;0;2;0;1;2;250;0;0;1;0;0;2;2;250;0;1811;2;1;
/org.eclipse.core.tests.resources/src/org/eclipse/core/tests/internal/resources/SimpleNature.java;2;1;2;1;2;2;2;0;38;0;0;5147;54;54;1;0;0;0;2;5147;0;5489;2;2;
/org.eclipse.jdt.debug.ui/ui/org/eclipse/jdt/internal/debug/ui/actions/DropToFrameAction.java;1;0;1;1;0;0;0;1;6;0;1;1593;6;6;1;0;0;1;1;1593;0;1593;1;1;
/org.eclipse.jdt.ui/core extension/org/eclipse/text/edits/ReplaceEdit.java;1;0;5;1;0;0;0;5;22;2;3;1953;46;46;2;2;0;5;5;1953;2;1985;3;1;
/org.eclipse.core.tests.runtime/src/org/eclipse/core/tests/internal/plugins/SoftPrereqTest_5.java;1;0;1;1;0;0;0;1;0;0;1;3014;0;0;1;0;0;1;1;3014;0;3014;1;1;
/org.eclipse.jdt.core.tests.model/src/org/eclipse/jdt/core/tests/model/ExistenceTests.java;2;0;5;1;0;0;0;5;62;1;5;78;76;76;1;0;0;5;5;78;0;3560;5;2;
/org.eclipse.swt/Eclipse SWT/win32/org/eclipse/swt/widgets/CoolItem.java;4;1;7;1;4;4;4;3;77;1;3;268;130;130;1;0;0;3;7;268;0;6352;7;4;
/org.eclipse.ui.workbench/Eclipse UI/org/eclipse/ui/internal/presentations/StandalonePartTabFolderPresentation.java;2;1;2;1;2;2;2;0;0;0;0;5520;0;0;1;0;0;0;2;5520;0;5539;2;2;
/org.eclipse.ui.presentations.r21/src/org/eclipse/ui/internal/presentations/r21/widgets/R21PaneFolderButtonListener.java;1;0;1;1;1;1;1;0;0;0;0;6075;0;0;1;0;0;0;1;6075;0;6075;1;1;
/org.eclipse.ui.workbench/Eclipse UI/org/eclipse/ui/internal/commands/ws/CommandsView.java;2;0;2;1;1;1;1;1;10;0;1;4896;10;10;1;0;0;1;2;4896;0;6338;2;2;
/org.eclipse.team.tests.core/src/org/eclipse/team/tests/core/TeamTest.java;2;0;3;1;1;1;1;2;62;1;2;2495;123;123;1;0;0;2;3;2495;0;6337;3;2;
/org.eclipse.pde.ui/src/org/eclipse/pde/ui/templates/ChoiceOption.java;2;1;3;1;3;3;3;0;49;0;0;5115;91;91;1;0;0;0;3;5115;0;6336;3;2;
/org.eclipse.team.core/src/org/eclipse/team/core/subscribers/SubscriberChangeEvent.java;2;1;5;1;3;3;3;2;60;1;2;3966;89;89;1;0;0;2;5;3966;0;6336;5;2;
/org.eclipse.jdt.ui.tests.refactoring/resources/PasteSourceReference/test3/in/A.java;1;0;1;1;0;0;0;1;0;0;1;1311;0;0;1;0;0;1;1;1311;0;1311;1;1;
/org.eclipse.jdt.ui/core refactoring/org/eclipse/jdt/internal/corext/refactoring/structure/CompilationUnitRewrite.java;2;1;4;1;4;4;4;0;69;0;0;5534;77;77;1;0;0;0;4;5534;0;6340;4;2;
/org.eclipse.jdt.ui.examples.javafamily/src/org/eclipse/jdt/internal/ui/examples/jspeditor/AnnotationAdapter.java;2;0;4;1;0;0;0;4;6;1;4;1112;11;11;1;0;0;4;4;1112;0;3235;4;2;
/org.eclipse.core.runtime.osgi/src/org/eclipse/core/internal/runtime/Policy.java;1;0;2;1;0;0;0;2;134;1;2;3013;134;134;1;0;0;2;2;3013;0;3030;2;1;
/org.eclipse.team.ui/src/org/eclipse/team/ui/controls/IControlFactory.java;1;0;1;1;0;0;0;1;0;0;1;3200;0;0;1;0;0;1;1;3200;0;3200;1;1;
/org.eclipse.jdt.ui.tests.refactoring/resources/ExtractMethodWorkSpace/ExtractMethodTests/expression_out/A_test618.java;1;0;4;1;0;0;0;4;4;1;4;130;5;5;1;0;0;4;4;130;0;1474;4;1;
/org.eclipse.team.ui/src/org/eclipse/team/internal/ui/synchronize/views/SyncViewerSorter.java;1;0;3;1;0;0;0;3;54;1;3;2535;54;54;1;0;0;3;3;2535;0;4216;3;1;
/org.eclipse.jdt.ui/core refactoring/org/eclipse/jdt/internal/corext/refactoring/nls/NLSHintHelper.java;2;1;2;1;2;2;2;0;2;0;0;5640;2;2;1;0;0;0;2;5640;0;6340;2;2;
/org.eclipse.update.ui.forms/Eclipse Forms/org/eclipse/ui/forms/events/HyperlinkListener.java;1;0;2;1;0;0;0;2;0;1;2;3096;0;0;1;0;0;2;2;3096;0;4157;2;1;
/org.eclipse.ui.workbench/Eclipse UI/org/eclipse/ui/internal/commands/AbstractCommandHandlerService.java;1;0;2;1;0;0;0;2;0;1;2;3131;0;0;1;0;0;2;2;3131;0;4144;2;1;
/org.eclipse.ui.workbench/Eclipse UI/org/eclipse/ui/internal/dialogs/ActionSetSelectionDialog.java;1;0;1;1;0;0;0;1;0;0;1;830;0;0;1;0;0;1;1;830;0;830;1;1;
/org.eclipse.jdt.debug.ui/ui/org/eclipse/jdt/internal/debug/ui/launcher/VMArgumentsBlock.java;3;1;6;1;2;2;2;4;26;1;4;1136;58;58;1;0;0;4;6;1136;0;6336;6;3;
/org.eclipse.jface.text/src/org/eclipse/jface/text/MarginPainter.java;2;1;3;1;2;2;2;1;8;0;1;839;12;12;1;0;0;1;3;839;0;6359;3;2;
/org.eclipse.ui.workbench/Eclipse UI/org/eclipse/ui/internal/presentations/PresentationSerializer.java;2;1;2;1;2;2;2;0;2;0;0;5672;2;2;1;0;0;0;2;5672;0;5736;2;2;
/org.eclipse.swt.tests/JUnit Tests/org/eclipse/swt/tests/junit/Test_org_eclipse_swt_events_PaintListener.java;1;0;1;1;0;0;0;1;16;0;1;2175;16;16;1;0;0;1;1;2175;0;2175;1;1;
/org.eclipse.jdt.core.tests.model/workspace/Formatter/test373/A_in.java;1;0;1;1;0;0;0;1;0;0;1;3130;0;0;1;0;0;1;1;3130;0;3130;1;1;
/org.eclipse.ui.workbench/Eclipse UI/org/eclipse/ui/contexts/IWorkbenchWindowContextSupport.java;2;0;4;1;0;0;0;4;20;1;4;3066;34;34;1;0;0;4;4;3066;0;4144;4;2;
/org.eclipse.core.resources.spysupport/src/org/eclipse/core/internal/dtree/SpySupport.java;1;0;1;1;1;1;1;0;0;0;0;6302;0;0;1;0;0;0;1;6302;0;6302;1;1;
/org.eclipse.jdt.ui.tests.refactoring/resources/Delete/testDeleteWithinCu8/out/A.java;1;0;1;1;0;0;0;1;0;0;1;442;0;0;1;0;0;1;1;442;0;442;1;1;
/org.eclipse.jdt.ui/ui/org/eclipse/jdt/internal/ui/callhierarchy/CallHierarchyContentProvider.java;4;0;15;1;1;1;1;14;45;1;14;155;226;226;1;0;0;14;15;155;0;6340;15;4;
/org.eclipse.ui.forms/src/org/eclipse/ui/forms/widgets/ScrolledForm.java;1;0;5;1;0;0;0;5;18;1;5;4135;34;34;1;0;0;5;5;4135;0;5044;5;1;
/org.eclipse.help/src/org/eclipse/help/internal/standalone/EclipseConnection.java;1;0;2;1;0;0;0;2;88;1;2;1880;88;88;1;0;0;2;2;1880;0;2732;2;1;
/org.eclipse.text/src/org/eclipse/text/edits/MoveSourceEdit.java;2;0;5;1;1;1;1;4;210;1;4;1986;283;283;1;0;0;4;5;1986;0;6340;5;2;
/org.eclipse.update.configurator/src/org/eclipse/update/internal/configurator/BundleManifest.java;2;1;9;1;3;3;3;6;48;3;4;4108;113;113;3;2;0;6;9;4108;2;5799;7;2;
/org.eclipse.jdt.core.tests.model/src/org/eclipse/jdt/core/tests/model/CreateTypeSourceExamplesTests.java;1;0;2;1;1;1;1;1;3;0;1;3560;5;5;1;0;0;1;2;3560;0;5584;2;1;
/org.eclipse.ui.examples.readmetool/Eclipse UI Examples Readme Tool/org/eclipse/ui/examples/readmetool/ReadmeFilePropertyPage2.java;1;0;1;1;0;0;0;1;2;0;1;79;2;2;1;0;0;1;1;79;0;79;1;1;
/org.eclipse.ui.workbench/Eclipse UI/org/eclipse/ui/internal/csm/commands/KeyConfigurationDefinition.java;1;0;3;1;0;0;0;3;32;2;2;2532;32;32;2;1;0;3;3;2532;1;2562;2;1;
/org.eclipse.jdt.core/compiler/org/eclipse/jdt/core/compiler/CharOperation.java;5;1;11;1;2;2;2;9;61;1;9;13;205;205;1;0;0;9;11;13;0;5733;11;5;
/org.eclipse.pde.ui/src/org/eclipse/pde/internal/ui/editor/plugin/ExtensionElementDetails.java;3;2;8;1;8;7;8;0;25;0;0;5431;53;53;2;0;1;0;8;5514;1;6336;7;3;
/org.eclipse.swt/Eclipse SWT PI/win32/org/eclipse/swt/internal/win32/NOTIFYICONDATAA.java;3;0;5;2;1;1;1;4;8;2;2;4450;16;16;2;2;0;4;5;4450;2;6352;3;3;
/org.eclipse.jdt.core.tests.model/workspace/Formatter/test151/A_out.java;1;0;2;1;0;0;0;2;2;1;2;2425;2;2;1;0;0;2;2;2425;0;4173;2;1;
/org.eclipse.core.tests.runtime/src/org/eclipse/core/tests/internal/runtimetests/SampleCPR.java;1;0;1;1;1;1;1;0;19;0;0;5149;19;19;1;0;0;0;1;5149;0;5149;1;1;
/org.eclipse.jdt.ui.tests.refactoring/resources/TypeConstraints/A_testConstraints7.java;1;0;1;1;0;0;0;1;0;0;1;60;0;0;1;0;0;1;1;60;0;60;1;1;
/org.eclipse.update.core/src/org/eclipse/update/core/ISiteFactoryExtension.java;2;1;3;1;2;2;2;1;6;0;1;890;14;14;1;0;0;1;3;890;0;6336;3;2;
/org.eclipse.pde.ui/sandbox/org/eclipse/pde/internal/ui/editor/standalone/site/SiteSourcePage2.java;1;0;2;1;0;0;0;2;0;1;2;2320;0;0;1;0;0;2;2;2320;0;2906;2;1;
/org.eclipse.jface.text/src/org/eclipse/jface/text/contentassist/ContentAssistRequestorAdapter.java;1;0;3;1;0;0;0;3;145;2;2;2263;145;145;2;1;0;3;3;2280;1;2280;2;1;
/org.eclipse.team.core/src/org/eclipse/team/internal/core/subscribers/caches/SynchronizationCache.java;1;0;1;1;0;0;0;1;0;0;1;3966;0;0;1;0;0;1;1;3966;0;3966;1;1;
/org.eclipse.jface/src/org/eclipse/jface/util/DelegatingDragAdapter.java;3;0;3;1;1;1;1;2;6;1;2;179;10;10;1;0;0;2;3;179;0;6338;3;3;
/org.eclipse.ant.ui/Ant Editor/org/eclipse/ant/internal/ui/editor/tools/AntEditorToolsMessages.java;1;0;2;1;0;0;0;2;0;1;2;1811;0;0;1;0;0;2;2;1811;0;3809;2;1;
/org.eclipse.compare/compare/org/eclipse/compare/internal/ResourceCompareInput.java;1;1;7;1;4;4;4;3;66;1;3;662;159;159;1;0;0;3;7;662;0;6354;7;1;
/org.eclipse.jdt.core.tests.model/workspace/Converter15/src/test0023/X.java;1;0;1;1;0;0;0;1;0;0;1;4846;0;0;1;0;0;1;1;4846;0;4846;1;1;
/org.eclipse.update.core/src/org/eclipse/update/internal/operations/UnconfigOperation.java;1;0;10;1;1;1;1;9;4;1;9;825;21;21;1;0;0;9;10;825;0;6336;10;1;
/org.eclipse.jdt.core.tests.compiler/src/org/eclipse/jdt/core/tests/runtime/ProxyConsoleReader.java;1;0;1;1;0;0;0;1;2;0;1;3560;2;2;1;0;0;1;1;3560;0;3560;1;1;
/org.eclipse.team.ui/src/org/eclipse/team/ui/synchronize/ISynchronizeParticipantReference.java;2;1;5;1;3;3;3;2;61;1;2;4785;82;82;1;0;0;2;5;4785;0;6337;5;2;
/org.eclipse.swt/Eclipse SWT PI/win32/org/eclipse/swt/internal/win32/TEXTMETRICA.java;1;0;1;1;0;0;0;1;0;0;1;957;0;0;1;0;0;1;1;957;0;957;1;1;
/org.eclipse.ui.ide/src/org/eclipse/ui/wizards/datatransfer/ExternalProjectImportWizard.java;1;0;1;1;0;0;0;1;0;0;1;1511;0;0;1;0;0;1;1;1511;0;1511;1;1;
/org.eclipse.pde.core/src/org/eclipse/pde/internal/core/SourceLocation.java;1;0;3;1;1;1;1;2;14;1;2;1124;28;28;1;0;0;2;3;1124;0;6336;3;1;
/org.eclipse.ui.externaltools/Ant Editor/org/eclipse/ui/externaltools/internal/ant/editor/outline/IProblemRequestor.java;1;0;1;1;0;0;0;1;0;0;1;282;0;0;1;0;0;1;1;282;0;282;1;1;
/org.eclipse.core.tests.runtime/src/org/eclipse/core/tests/runtime/content/IContentTypeTest.java;2;1;4;1;2;2;2;2;29;1;2;4941;53;53;1;0;0;2;4;4941;0;5159;4;2;
/org.eclipse.jdt.ui/ui/org/eclipse/jdt/internal/ui/wizards/buildpaths/ClasspathContainerSelectionPage.java;2;1;3;1;2;2;2;1;4;0;1;4407;8;8;1;0;0;1;3;4407;0;6340;3;2;
/org.eclipse.jdt.ui/ui/org/eclipse/jdt/internal/ui/text/link/LinkedPositionMessages.java;1;0;1;1;0;0;0;1;0;0;1;3030;0;0;1;0;0;1;1;3030;0;3030;1;1;
/org.eclipse.pde.ui/src_Forms/org/eclipse/pde/internal/ui/neweditor/plugin/PluginInputContext.java;2;2;12;2;4;3;4;8;137;2;7;3777;390;390;2;1;1;8;12;4856;2;5431;10;2;
/org.eclipse.jdt.core.tests.model/workspace/Converter/test0457/A.java;1;0;1;1;0;0;0;1;0;0;1;3714;0;0;1;0;0;1;1;3714;0;3714;1;1;
/org.eclipse.ui.workbench.texteditor/src/org/eclipse/ui/internal/texteditor/EditPosition.java;1;0;1;1;1;1;1;0;2;0;0;6340;2;2;1;0;0;0;1;6340;0;6340;1;1;
/org.eclipse.team.ui/src/org/eclipse/team/ui/synchronize/viewers/AdaptableDiffNode.java;1;0;1;1;0;0;0;1;0;0;1;4118;0;0;1;0;0;1;1;4118;0;4118;1;1;
/org.eclipse.jdt.core/compiler/org/eclipse/jdt/internal/compiler/impl/StringConstant.java;1;0;1;1;0;0;0;1;2;0;1;3560;2;2;1;0;0;1;1;3560;0;3560;1;1;
/org.eclipse.jdt.ui.tests.refactoring/resources/SurroundWithWorkSpace/SurroundWithTests/trycatch_in/TestThrowInCatch.java;1;0;1;1;0;0;0;1;4;0;1;845;4;4;1;0;0;1;1;845;0;845;1;1;
/org.eclipse.jdt.ui/ui/org/eclipse/jdt/ui/actions/UseSupertypeAction.java;3;0;9;1;1;1;1;8;146;1;8;42;279;279;1;0;0;8;9;42;0;6340;9;3;
/org.eclipse.jdt.ui/ui refactoring/org/eclipse/jdt/internal/ui/refactoring/TextEditChangeElement.java;2;0;10;2;0;0;0;10;62;2;8;1033;94;94;2;2;0;10;10;1033;2;4965;8;2;
/org.eclipse.debug.ui/ui/org/eclipse/debug/internal/ui/views/memory/MemoryRenderingViewTabFactory.java;1;0;1;1;1;1;1;0;0;0;0;5254;0;0;1;0;0;0;1;5254;0;5254;1;1;
/org.eclipse.jdt.ui.tests.refactoring/resources/ExtractMethodWorkSpace/ExtractMethodTests/validSelection_out/A_test360.java;1;0;2;1;0;0;0;2;7;1;2;130;13;13;1;0;0;2;2;130;0;844;2;1;
/org.eclipse.ui.workbench/Eclipse UI/org/eclipse/ui/part/IShowInTarget.java;1;0;1;1;0;0;0;1;4;0;1;1;4;4;1;0;0;1;1;1;0;1;1;1;
/org.eclipse.help.ui/src/org/eclipse/help/ui/internal/search/SearchOperation.java;1;0;3;1;0;0;0;3;22;1;3;401;24;24;1;0;0;3;3;401;0;2732;3;1;
/org.eclipse.update.tests.core/src/org/eclipse/update/tests/UpdateTestsPlugin.java;2;1;5;1;2;2;2;3;30;2;2;2521;43;43;2;1;0;3;5;2521;1;6336;4;2;
/org.eclipse.core.tests.resources/src/org/eclipse/core/tests/resources/session/TestSave.java;1;0;1;1;1;1;1;0;81;0;0;5147;81;81;1;0;0;0;1;5147;0;5147;1;1;
/org.eclipse.jdt.ui/core refactoring/org/eclipse/jdt/internal/corext/refactoring/code/CodeRefactoringUtil.java;2;0;2;1;1;1;1;1;2;0;1;4575;4;4;1;0;0;1;2;4575;0;6340;2;2;
/org.eclipse.ui.workbench/Eclipse UI/org/eclipse/ui/internal/progress/AnimatedCanvas.java;1;0;8;1;0;0;0;8;347;2;6;320;477;477;2;2;0;8;8;955;2;1075;6;1;
/org.eclipse.debug.core/core/org/eclipse/debug/core/variables/VariableUtil.java;2;0;6;1;0;0;0;6;41;1;6;562;78;78;1;0;0;6;6;562;0;754;6;2;
/org.eclipse.osgi/core/framework/org/eclipse/osgi/framework/internal/core/ServiceRegistration.java;4;0;5;2;2;1;2;3;24;1;3;3013;54;54;2;0;1;3;5;5109;1;5109;4;4;
/org.eclipse.ui.externaltools/Ant Tools Support/org/eclipse/ui/externaltools/internal/ant/view/AntTargetContentProvider.java;1;0;1;1;0;0;0;1;0;0;1;282;0;0;1;0;0;1;1;282;0;282;1;1;
/org.eclipse.jdt.ui.tests.refactoring/resources/ExtractMethodWorkSpace/ExtractMethodTests/return_out/A_test713.java;1;0;2;1;0;0;0;2;4;1;2;130;5;5;1;0;0;2;2;130;0;844;2;1;
/org.eclipse.jdt.ui.tests/ui/org/eclipse/jdt/ui/tests/core/PrimaryWorkingCopyTest.java;1;0;8;1;1;1;1;7;160;3;4;2058;341;341;3;3;0;7;8;2072;3;5106;5;1;
/org.eclipse.pde.ui/src_Forms/org/eclipse/pde/internal/ui/neweditor/feature/ReferenceForm.java;1;0;2;1;0;0;0;2;0;0;1;4926;0;0;2;1;0;2;2;4926;1;4926;1;1;
/org.eclipse.update.tests.core/src/org/eclipse/update/tests/regularInstall/TestDataEntryInstall.java;2;0;3;1;1;1;1;2;8;1;2;3813;16;16;1;0;0;2;3;3813;0;6336;3;2;
/org.eclipse.jdt.core.tests.model/workspace/Formatter/test195/A_in.java;1;0;1;1;0;0;0;1;0;0;1;2424;0;0;1;0;0;1;1;2424;0;2424;1;1;
/org.eclipse.jdt.ui.tests.refactoring/test cases/org/eclipse/jdt/ui/tests/reorg/PasteActionTest.java;4;0;13;1;1;1;1;12;144;1;12;1111;428;428;1;0;0;12;13;1111;0;6340;13;4;
/org.eclipse.core.filebuffers/src/org/eclipse/core/filebuffers/IAnnotationModelFactory.java;2;2;4;2;4;3;4;0;22;0;0;5382;29;29;2;0;1;0;4;6333;1;6333;3;2;
/org.eclipse.pde.ui/sandbox/org/eclipse/pde/internal/ui/editor/standalone/manifest/ManifestEditorUtil.java;1;0;2;1;0;0;0;2;0;1;2;2320;0;0;1;0;0;2;2;2320;0;2906;2;1;
/org.eclipse.jdt.ui.tests.refactoring/resources/ExtractMethodWorkSpace/ExtractMethodTests/locals_in/A_test510.java;1;0;1;1;0;0;0;1;2;0;1;844;2;2;1;0;0;1;1;844;0;844;1;1;
/org.eclipse.jdt.core/model/org/eclipse/jdt/internal/core/util/AnnotationComponent.java;1;0;1;1;0;0;0;1;0;0;1;4466;0;0;1;0;0;1;1;4466;0;4466;1;1;
/org.eclipse.jdt.core.tests.model/workspace/Converter/test0312/Test.java;1;0;1;1;0;0;0;1;0;0;1;3714;0;0;1;0;0;1;1;3714;0;3714;1;1;
/org.eclipse.ant.tests.ui/Ant Editor Tests/org/eclipse/ant/ui/internal/editor/support/TestTextCompletionProcessor.java;1;0;2;1;0;0;0;2;0;1;2;1274;0;0;1;0;0;2;2;1274;0;1811;2;1;
/org.eclipse.jdt.core.tests.model/workspace/Converter/src/test0027/Test.java;1;0;1;1;0;0;0;1;0;0;1;3714;0;0;1;0;0;1;1;3714;0;3714;1;1;
/org.eclipse.pde.ui/src/org/eclipse/pde/internal/ui/editor/build/BuildContentsSection.java;3;2;15;2;8;7;8;7;528;1;7;1727;1598;1598;2;0;1;7;15;5431;1;6336;14;3;
/org.eclipse.team.ui/src/org/eclipse/team/internal/ui/synchronize/sets/SyncSetInput.java;1;0;3;1;0;0;0;3;89;1;3;2535;89;89;1;0;0;3;3;2535;0;4216;3;1;
/org.eclipse.jdt.ui/ui/org/eclipse/jdt/internal/ui/util/ViewerPane.java;1;0;1;1;1;1;1;0;2;0;0;6340;2;2;1;0;0;0;1;6340;0;6340;1;1;
/org.eclipse.ant.ui/Ant Tools Support/org/eclipse/ant/ui/internal/views/actions/RefreshBuildFilesAction.java;1;0;3;1;0;0;0;3;6;2;2;263;6;6;2;1;0;3;3;263;1;1811;2;1;
/org.eclipse.jdt.ui/ui/org/eclipse/jdt/internal/ui/SharedImages.java;1;0;1;1;1;1;1;0;2;0;0;6340;2;2;1;0;0;0;1;6340;0;6340;1;1;
/org.eclipse.core.filebuffers/src/org/eclipse/core/filebuffers/annotations/IMarkerUpdater.java;1;0;1;1;0;0;0;1;0;0;1;2815;0;0;1;0;0;1;1;2815;0;2815;1;1;
/org.eclipse.swt/Eclipse SWT Custom Widgets/common/org/eclipse/swt/custom/CTabItem2.java;1;0;28;1;0;0;0;28;493;3;21;2780;1952;1952;3;7;0;28;28;4045;7;4232;21;1;
/org.eclipse.ui.workbench/Eclipse UI/org/eclipse/ui/internal/roles/api/secondstage/IMutableRoleRegistry.java;1;0;2;1;0;0;0;2;0;1;2;2199;0;0;1;0;0;2;2;2199;0;2207;2;1;
/org.eclipse.ltk.ui.refactoring/src/org/eclipse/ltk/internal/ui/refactoring/UIPerformChangeOperation.java;1;1;3;1;2;2;2;1;65;0;1;4965;123;123;1;0;0;1;3;4965;0;6162;3;1;
/org.eclipse.jdt.ui.tests.refactoring/resources/ChangeSignature/canModify/A_testAddRecursive1_in.java;2;0;2;1;0;0;0;2;2;1;2;2093;2;2;1;0;0;2;2;2093;0;3216;2;2;
/org.eclipse.debug.ui/ui/org/eclipse/debug/internal/ui/views/variables/IObjectBrowser.java;1;0;2;1;0;0;0;2;0;1;2;2564;0;0;1;0;0;2;2;2564;0;2647;2;1;
/org.eclipse.jdt.core.tests.model/workspace/Converter15/src/test0017/X.java;1;0;1;1;0;0;0;1;0;0;1;4826;0;0;1;0;0;1;1;4826;0;4826;1;1;
/org.eclipse.ant.ui/Ant Editor Content Assist Dev/TaskXMLFileMerger.java;1;0;1;1;0;0;0;1;0;0;1;3809;0;0;1;0;0;1;1;3809;0;3809;1;1;
/org.eclipse.pde.build/src_ant/org/eclipse/pde/internal/build/tasks/AssemblerTask.java;2;2;10;1;3;2;3;7;13;1;7;447;26;26;2;0;1;7;10;6340;1;6340;9;2;
/org.eclipse.core.runtime.osgi/src/org/eclipse/core/runtime/ILog.java;1;0;2;1;0;0;0;2;60;1;2;3013;60;60;1;0;0;2;2;3013;0;3030;2;1;
/org.eclipse.jdt.core.tests.model/workspace/Completion/src/CompletionClassLiteralAfterAnonymousType1.java;1;0;1;1;0;0;0;1;0;0;1;858;0;0;1;0;0;1;1;858;0;858;1;1;
/org.eclipse.jdt.core.tests.model/workspace/Completion/src3/test0009/Test.java;1;0;1;1;0;0;0;1;0;0;1;5082;0;0;1;0;0;1;1;5082;0;5082;1;1;
/org.eclipse.jdt.core.tests.model/workspace/Formatter/test031/A_out.java;1;0;1;1;0;0;0;1;0;0;1;2425;0;0;1;0;0;1;1;2425;0;2425;1;1;
/org.eclipse.swt/Eclipse SWT PI/win32/org/eclipse/swt/internal/win32/NMLVFINDITEM.java;2;0;2;1;1;1;1;1;6;0;1;4201;6;6;1;0;0;1;2;4201;0;6352;2;2;
/org.eclipse.ui.views/src/org/eclipse/ui/views/markers/internal/ActionSelectAll.java;2;0;2;1;0;0;0;2;0;1;2;755;0;0;1;0;0;2;2;755;0;2738;2;2;
/org.eclipse.jdt.core.tests.compiler/src/org/eclipse/jdt/core/tests/compiler/parser/TestAll.java;2;0;5;1;0;0;0;5;100;1;5;989;121;121;1;0;0;5;5;989;0;3560;5;2;
/org.eclipse.jdt.ui.tests.refactoring/resources/PushDown/test23/out/A.java;1;0;1;1;0;0;0;1;1;0;1;1312;1;1;1;0;0;1;1;1312;0;1312;1;1;
/org.eclipse.pde.ui/src/org/eclipse/pde/internal/ui/editor/feature/FeatureEditorContributor.java;2;1;5;1;3;3;3;2;63;1;2;1615;80;80;1;0;0;2;5;1615;0;6336;5;2;
/org.eclipse.swt/Eclipse SWT/motif/org/eclipse/swt/internal/Platform.java;1;0;2;1;0;0;0;2;0;1;2;1955;0;0;1;0;0;2;2;1955;0;1969;2;1;
/org.eclipse.jdt.ui/core extension/org/eclipse/jdt/internal/corext/codemanipulation/CodeGenerationSettings.java;2;0;2;1;1;1;1;1;3;0;1;882;5;5;1;0;0;1;2;882;0;6340;2;2;
/org.eclipse.pde.build/src/org/eclipse/pde/internal/build/ant/ITask.java;2;0;6;1;1;1;1;5;26;1;5;447;135;135;1;0;0;5;6;447;0;5145;6;2;
/org.eclipse.ui.views/src/org/eclipse/ui/views/internal/markers/ActionSelectAll.java;1;0;2;1;0;0;0;2;0;0;1;749;0;0;2;1;0;2;2;749;1;749;1;1;
/org.eclipse.jdt.core/model/org/eclipse/jdt/internal/core/LocalVariable.java;2;1;13;2;2;2;2;11;20;2;10;2420;69;69;2;1;0;11;13;2601;1;5614;12;2;
/org.eclipse.team.cvs.ui/src/org/eclipse/team/internal/ccvs/ui/DateDialog.java;1;0;1;1;0;0;0;1;0;0;1;2522;0;0;1;0;0;1;1;2522;0;2522;1;1;
/org.eclipse.jdt.core.tests.model/workspace/Converter/src/test0279/Test.java;1;0;1;1;0;0;0;1;0;0;1;3714;0;0;1;0;0;1;1;3714;0;3714;1;1;
/org.eclipse.team.cvs.ui/src/org/eclipse/team/internal/ccvs/ui/actions/WorkspaceAction.java;2;1;8;1;2;2;2;6;69;2;5;442;119;119;2;1;0;6;8;2460;1;6337;7;2;
/org.eclipse.ui.workbench/Eclipse UI/org/eclipse/ui/internal/contexts/registry/FileContextRegistry.java;1;0;2;1;0;0;0;2;0;1;2;1422;0;0;1;0;0;2;2;1422;0;1724;2;1;
/org.eclipse.update.configurator/src/org/eclipse/update/internal/configurator/Policy.java;1;0;2;1;0;0;0;2;0;1;2;3270;0;0;1;0;0;2;2;3270;0;3280;2;1;
/org.eclipse.core.tests.resources/src/org/eclipse/core/tests/internal/builders/AllTests.java;1;0;1;1;1;1;1;0;35;0;0;5147;35;35;1;0;0;0;1;5147;0;5147;1;1;
/org.eclipse.jdt.ui.tests.refactoring/resources/RenamePackage/testImportFromMultiRoots4/out/srcPrg/a/b/c/A.java;1;0;2;1;0;0;0;2;13;1;2;3219;13;13;1;0;0;2;2;3219;0;4105;2;1;
/org.eclipse.team.ui/src/org/eclipse/team/internal/ui/synchronize/DropDownParticipantSection.java;1;0;1;1;0;0;0;1;0;0;1;3185;0;0;1;0;0;1;1;3185;0;3185;1;1;
/org.eclipse.ui.forms/src/org/eclipse/ui/forms/widgets/ColumnLayoutData.java;1;0;4;1;0;0;0;4;54;1;4;4068;58;58;1;0;0;4;4;4068;0;5044;4;1;
/org.eclipse.ui.workbench/Eclipse UI/org/eclipse/ui/internal/registry/ViewRegistry.java;5;1;10;2;4;4;4;6;193;2;5;956;354;354;2;1;0;6;10;4717;1;6338;9;5;
/org.eclipse.jdt.core.tests.model/workspace/Converter/src/test0315/Test.java;1;0;1;1;0;0;0;1;0;0;1;3714;0;0;1;0;0;1;1;3714;0;3714;1;1;
/org.eclipse.jdt.ui.tests.refactoring/resources/InlineMethodWorkspace/TestCases/simple_in/TestPrimitiveArray.java;1;0;1;1;0;0;0;1;2;0;1;845;2;2;1;0;0;1;1;845;0;845;1;1;
/org.eclipse.team.cvs.ssh2/src/org/eclipse/team/ccvs/ssh2/PServerSSH2ServerConnection.java;3;0;10;2;0;0;0;10;371;2;9;2956;442;442;2;1;0;10;10;3027;1;4825;9;3;
/org.eclipse.jdt.ui.tests.refactoring/test cases/org/eclipse/jdt/ui/tests/refactoring/PushDownTests.java;3;0;11;1;1;1;1;10;33;2;9;130;143;143;2;1;0;10;11;345;1;6340;10;3;
/org.eclipse.ui.workbench/Eclipse UI/org/eclipse/ui/internal/themes/CascadingMap.java;1;0;1;1;0;0;0;1;0;0;1;4559;0;0;1;0;0;1;1;4559;0;4559;1;1;
/org.eclipse.core.resources.linux/src/org/eclipse/core/resources/refresh/linux/MonitorEvent.java;1;0;3;1;0;0;0;3;53;1;3;3681;53;53;1;0;0;3;3;3681;0;4851;3;1;
/org.eclipse.ui.views/src/org/eclipse/ui/views/internal/markers/bookmarks/BookmarkRegistry.java;1;0;3;1;0;0;0;3;2;2;2;265;2;2;2;1;0;3;3;265;1;728;2;1;
/org.eclipse.team.ftp/src/org/eclipse/team/internal/ftp/ui/subscriber/FTPParticipantViewerAdvisor.java;2;0;5;1;1;1;1;4;7;1;4;4588;10;10;1;0;0;4;5;4588;0;5359;5;2;
/org.eclipse.debug.core/core/org/eclipse/debug/internal/core/sourcelookup/containers/ArchiveSourceContainer.java;1;0;4;1;0;0;0;4;145;1;4;4091;154;154;1;0;0;4;4;4091;0;4949;4;1;
/org.eclipse.jdt.core.tests.model/workspace/Converter/test0408/A.java;1;0;1;1;0;0;0;1;0;0;1;3714;0;0;1;0;0;1;1;3714;0;3714;1;1;
/org.eclipse.jdt.core.tests.compiler/src/org/eclipse/jdt/core/tests/eval/CodeSnippetTest.java;2;0;2;1;0;0;0;2;13;1;2;1786;15;15;1;0;0;2;2;1786;0;3560;2;2;
/org.eclipse.text/projection/org/eclipse/jface/text/Fragment.java;2;0;3;1;1;1;1;2;1;1;2;3648;2;2;1;0;0;2;3;3648;0;5177;3;2;
/org.eclipse.jdt.ui/core refactoring/org/eclipse/jdt/internal/corext/refactoring/typeconstraints/EqualsConstraint.java;1;0;3;1;0;0;0;3;3;1;3;42;3;3;1;0;0;3;3;42;0;64;3;1;
/org.eclipse.jdt.launching/launching/org/eclipse/jdt/internal/launching/VMDefinitionsContainer.java;2;0;7;1;1;1;1;6;53;1;6;712;99;99;1;0;0;6;7;712;0;5581;7;2;
/org.eclipse.jdt.ui.tests.refactoring/resources/Delete/testDeleteWithinCu1/out/A.java;1;0;1;1;0;0;0;1;0;0;1;442;0;0;1;0;0;1;1;442;0;442;1;1;
/org.eclipse.ui.workbench/Eclipse UI/org/eclipse/ui/internal/progress/JobProgressManager.java;1;0;30;1;0;0;0;30;326;3;22;749;1432;1432;3;8;0;30;30;1237;8;2119;22;1;
/org.eclipse.ui.views/src/org/eclipse/ui/views/internal/markers/MarkerContentProvider.java;1;0;2;1;0;0;0;2;0;0;1;265;0;0;2;1;0;2;2;265;1;265;1;1;
/org.eclipse.pde.core/src/org/eclipse/pde/internal/core/plugin/PluginBase.java;3;1;15;1;6;6;6;9;185;2;8;2184;509;509;2;1;0;9;15;4726;1;6336;14;3;
/org.eclipse.swt/Eclipse SWT Printing/gtk1x/org/eclipse/swt/printing/Printer.java;1;0;1;1;0;0;0;1;0;0;1;2327;0;0;1;0;0;1;1;2327;0;2327;1;1;
/org.eclipse.pde.ui/src/org/eclipse/pde/internal/ui/editor/plugin/NewElementAction.java;2;1;4;1;4;4;4;0;14;0;0;5431;20;20;1;0;0;0;4;5431;0;6336;4;2;
/org.eclipse.search.tests/src/org/eclipse/search/core/tests/TestSearchResult.java;1;0;3;1;1;1;1;2;80;1;2;4345;157;157;1;0;0;2;3;4345;0;5652;3;1;
/org.eclipse.ui.workbench/Eclipse UI/org/eclipse/ui/internal/ide/IDEWorkbenchAdviser.java;1;0;1;1;0;0;0;1;0;0;1;1259;0;0;1;0;0;1;1;1259;0;1259;1;1;
/org.eclipse.jdt.core.tests.model/workspace/Formatter/test129/A_out.java;1;0;1;1;0;0;0;1;0;0;1;2425;0;0;1;0;0;1;1;2425;0;2425;1;1;
/org.eclipse.ui.internal.r21presentation/src/org/eclipse/ui/internal/r21presentation/widgets/CTabFolder.java;3;1;6;1;6;6;6;0;33;0;0;5275;58;58;1;0;0;0;6;5275;0;5625;6;3;
/org.eclipse.ui.workbench/Eclipse UI/org/eclipse/ui/part/MultiEditor.java;4;1;8;1;2;2;2;6;93;1;6;1984;233;233;1;0;0;6;8;1984;0;6338;8;4;
/org.eclipse.jdt.ui/ui refactoring/org/eclipse/jdt/internal/ui/refactoring/reorg/ReorgQueries.java;4;1;7;2;2;2;2;5;84;2;4;1114;136;136;2;1;0;5;7;3188;1;6340;6;4;
/org.eclipse.jdt.core.tests.model/workspace/Converter/src/test0104/Test.java;1;0;1;1;0;0;0;1;0;0;1;3714;0;0;1;0;0;1;1;3714;0;3714;1;1;
/org.eclipse.ui.workbench/Eclipse UI/org/eclipse/ui/roles/RoleEvent.java;1;0;3;1;0;0;0;3;35;1;3;2805;35;35;1;0;0;3;3;2805;0;2864;3;1;
/org.eclipse.pde.ui/src/org/eclipse/pde/internal/ui/editor/plugin/DependencyAnalysisSection.java;2;1;5;1;5;5;5;0;40;0;0;5431;84;84;1;0;0;0;5;5431;0;6336;5;2;
/org.eclipse.jdt.debug/model/org/eclipse/jdt/internal/debug/core/model/JDIReferenceType.java;4;3;11;2;4;2;4;7;86;3;5;2176;161;161;3;2;2;7;11;2306;4;6336;7;4;
/org.eclipse.ui.intro/src/org/eclipse/ui/intro/internal/model/IntroInclude.java;1;0;5;1;1;1;1;4;105;1;4;4429;120;120;1;0;0;4;5;4429;0;5115;5;1;
/org.eclipse.ui.console/src/org/eclipse/ui/console/MessageConsole.java;3;1;8;1;2;2;2;6;52;2;5;1988;104;104;2;1;0;6;8;1988;1;6336;7;3;
/org.eclipse.ui.workbench.texteditor/src/org/eclipse/ui/texteditor/IAnnotationListener.java;1;0;1;1;0;0;0;1;0;0;1;2544;0;0;1;0;0;1;1;2544;0;2544;1;1;
/org.eclipse.ui.workbench/Eclipse UI/org/eclipse/ui/internal/decorators/DecoratorManager.java;5;2;15;1;6;5;6;9;75;1;9;1216;255;255;2;0;1;9;15;5779;1;6338;14;5;
/org.eclipse.pde.ui/src/org/eclipse/pde/internal/ui/wizards/plugin/AbstractFieldData.java;3;1;4;1;3;3;3;1;10;0;1;3986;16;16;1;0;0;1;4;3986;0;6336;4;3;
/org.eclipse.ui.workbench/Eclipse UI/org/eclipse/ui/IEditorSite.java;2;0;2;1;1;1;1;1;2;0;1;3816;4;4;1;0;0;1;2;3816;0;6338;2;2;
/org.eclipse.jdt.core.tests.model/workspace/Formatter/test386/A_out.java;1;0;1;1;0;0;0;1;0;0;1;3164;0;0;1;0;0;1;1;3164;0;3164;1;1;
/org.eclipse.jface.text/src/org/eclipse/jface/text/source/IVerticalRulerColumn.java;2;1;2;1;2;2;2;0;12;0;0;6340;14;14;1;0;0;0;2;6340;0;6361;2;2;
/org.eclipse.core.resources/src/org/eclipse/core/internal/resources/ICoreConstants.java;2;1;2;1;2;2;2;0;17;0;0;5146;27;27;1;0;0;0;2;5146;0;5733;2;2;
/org.eclipse.update.core/srcnew/org/eclipse/update/search/UpdateSearchScope.java;2;0;3;1;0;0;0;3;26;1;3;574;26;26;1;0;0;3;3;574;0;825;3;2;
/org.eclipse.jdt.ui.tests.refactoring/resources/MoveMembers/test20/out/B.java;1;0;1;1;0;0;0;1;1;0;1;1522;1;1;1;0;0;1;1;1522;0;1522;1;1;
/org.eclipse.update/src/org/eclipse/update/internal/core/UMSessionManager.java;1;0;1;1;1;1;1;0;0;0;0;6339;0;0;1;0;0;0;1;6339;0;6339;1;1;
/org.eclipse.ui.workbench/Eclipse UI/org/eclipse/ui/internal/commands/PluginCommandRegistry.java;1;0;7;1;0;0;0;7;23;2;5;1400;78;78;2;2;0;7;7;1400;2;2532;5;1;
/org.eclipse.jdt.core.tests.model/workspace/Formatter/test401/A_out.java;1;0;1;1;0;0;0;1;0;0;1;3436;0;0;1;0;0;1;1;3436;0;3436;1;1;
/org.eclipse.jdt.core.tests.model/workspace/Converter/junit/swingui/TestSuitePanel.java;1;0;2;1;0;0;0;2;5;1;2;787;5;5;1;0;0;2;2;787;0;3714;2;1;
/org.eclipse.core.tests.runtime/src/org/eclipse/core/tests/internal/plugins/FragmentResolveTest_4.java;1;0;1;1;0;0;0;1;0;0;1;3014;0;0;1;0;0;1;1;3014;0;3014;1;1;
/org.eclipse.core.tests.runtime/src/org/eclipse/core/tests/internal/plugins/FragmentResolveTest_12.java;1;0;1;1;0;0;0;1;0;0;1;3014;0;0;1;0;0;1;1;3014;0;3014;1;1;
/org.eclipse.jdt.core.tests.model/workspace/Completion/src3/test0026/Test.java;1;0;1;1;1;1;1;0;0;0;0;5222;0;0;1;0;0;0;1;5222;0;5222;1;1;
/org.eclipse.swt/Eclipse SWT Browser/common/org/eclipse/swt/browser/LocationEvent.java;2;0;8;1;1;1;1;7;15;1;7;1654;52;52;1;0;0;7;8;1654;0;6352;8;2;
/org.eclipse.ui.ide/src/org/eclipse/ui/views/markers/internal/Messages.java;1;0;1;1;0;0;0;1;0;0;1;2208;0;0;1;0;0;1;1;2208;0;2208;1;1;
/org.eclipse.swt/Eclipse SWT PI/motif/org/eclipse/swt/internal/motif/XmDropProcCallbackStruct.java;1;0;2;1;0;0;0;2;4;1;2;829;4;4;1;0;0;2;2;829;0;868;2;1;
/org.eclipse.ltk.core.refactoring/src/org/eclipse/ltk/core/refactoring/participants/ProcessorBasedRefactoring.java;2;1;16;1;12;12;12;4;81;1;4;4845;230;230;1;0;0;4;16;4845;0;6340;16;2;
/org.eclipse.jdt.ui.tests.refactoring/resources/PromoteTempToField/canPromote/A_test22_in.java;1;0;1;1;1;1;1;0;0;0;0;5224;0;0;1;0;0;0;1;5224;0;5224;1;1;
/org.eclipse.jdt.core/compiler/org/eclipse/jdt/internal/compiler/ast/ForeachStatement.java;1;0;1;1;0;0;0;1;0;0;1;4403;0;0;1;0;0;1;1;4403;0;4403;1;1;
/org.eclipse.jdt.ui.examples.javafamily/src/org/eclipse/jsp/JspCorePlugin.java;2;0;3;1;0;0;0;3;13;1;3;1033;13;13;1;0;0;3;3;1033;0;1230;3;2;
/org.eclipse.jdt.ui.tests.refactoring/resources/ConvertAnonymousToNested/canConvert/A_test19_out.java;1;0;1;1;0;0;0;1;2;0;1;1005;2;2;1;0;0;1;1;1005;0;1005;1;1;
/org.eclipse.ui.editors/src/org/eclipse/ui/texteditor/TextEditorMessages.java;1;0;1;1;1;1;1;0;17;0;0;6337;17;17;1;0;0;0;1;6337;0;6337;1;1;
/org.eclipse.jdt.ui.tests.refactoring/resources/TypeConstraints/A_testConstraints8.java;1;0;1;1;0;0;0;1;0;0;1;65;0;0;1;0;0;1;1;65;0;65;1;1;
/org.eclipse.swt.graphics.text/Eclipse SWT Custom Widgets/common/org/eclipse/swt/custom/StyledTextBidi.java;1;0;1;1;0;0;0;1;0;0;1;3889;0;0;1;0;0;1;1;3889;0;3889;1;1;
/org.eclipse.pde.ui/src_Forms/org/eclipse/pde/internal/ui/neweditor/site/CategorySection.java;3;1;4;1;2;2;2;2;32;0;1;4832;34;34;2;1;0;2;4;4832;1;5431;3;3;
/org.eclipse.jdt.ui/core extension/org/eclipse/jdt/internal/corext/dom/fragments/IASTFragment.java;1;0;1;1;1;1;1;0;2;0;0;6340;2;2;1;0;0;0;1;6340;0;6340;1;1;
/org.eclipse.jdt.junit/src/org/eclipse/jdt/internal/junit/util/IJUnitStatusConstants.java;1;0;1;1;1;1;1;0;2;0;0;6340;2;2;1;0;0;0;1;6340;0;6340;1;1;
/org.eclipse.text/src/org/eclipse/jface/text/link/ExclusivePositionUpdater.java;2;0;2;1;1;1;1;1;0;0;1;4214;0;0;1;0;0;1;2;4214;0;5177;2;2;
/org.eclipse.ltk.core.refactoring/src/org/eclipse/ltk/internal/core/refactoring/UndoManager.java;1;2;6;1;4;3;4;2;130;1;2;4845;205;205;2;0;1;2;6;5176;1;6340;5;1;
/org.eclipse.ui.views/src/org/eclipse/ui/views/internal/markers/FieldSeverity.java;1;0;2;1;0;0;0;2;0;0;1;749;0;0;2;1;0;2;2;749;1;749;1;1;
/org.eclipse.jdt.ui.tests.refactoring/resources/MoveMembers/test3/out/B.java;1;0;1;1;0;0;0;1;1;0;1;1522;1;1;1;0;0;1;1;1522;0;1522;1;1;
/org.eclipse.swt/Eclipse SWT/common/org/eclipse/swt/events/MouseTrackAdapter.java;1;0;2;1;1;1;1;1;4;0;1;3652;6;6;1;0;0;1;2;3652;0;6352;2;1;
/org.eclipse.swt/Eclipse SWT/gtk/org/eclipse/swt/graphics/Cursor.java;4;1;13;1;3;3;3;10;99;2;8;217;362;362;2;2;0;10;13;217;2;6352;11;4;
/org.eclipse.ui.console/src/org/eclipse/ui/console/IConsoleListener.java;1;0;1;1;0;0;0;1;0;0;1;1988;0;0;1;0;0;1;1;1988;0;1988;1;1;
/org.eclipse.jdt.ui.tests.refactoring/resources/UseSupertypeWherePossible/testNew13/out/Test.java;1;0;1;1;0;0;0;1;2;0;1;1166;2;2;1;0;0;1;1;1166;0;1166;1;1;
/org.eclipse.ui.workbench.texteditor/src/org/eclipse/ui/texteditor/IDocumentProviderExtension3.java;3;0;5;2;2;1;2;3;22;1;3;1237;24;24;2;0;1;3;5;6334;1;6334;4;3;
/org.eclipse.ui.workbench/Eclipse UI/org/eclipse/ui/internal/themes/IThemeElementDefinition.java;1;0;1;1;0;0;0;1;0;0;1;4392;0;0;1;0;0;1;1;4392;0;4392;1;1;
/org.eclipse.team.ui/src/org/eclipse/team/internal/ui/synchronize/views/SyncSetTableContentProvider.java;1;0;3;1;0;0;0;3;76;1;3;2535;76;76;1;0;0;3;3;2535;0;4216;3;1;
/org.eclipse.ui.views/src/org/eclipse/ui/views/internal/markers/tasks/TaskView.java;1;0;6;1;0;0;0;6;408;2;5;265;472;472;2;1;0;6;6;265;1;749;5;1;
/org.eclipse.pde.ui/src/org/eclipse/pde/internal/ui/editor/feature/NewFeaturePluginWizardPage.java;2;1;3;1;2;2;2;1;19;0;1;4203;33;33;1;0;0;1;3;4203;0;6336;3;2;
/org.eclipse.ui.cheatsheets/src/org/eclipse/ui/internal/cheatsheets/data/IParserTags.java;2;1;8;1;5;5;5;3;109;1;3;4428;169;169;1;0;0;3;8;4428;0;5759;8;2;
/org.eclipse.ui.workbench/Eclipse UI/org/eclipse/ui/internal/ActivateEditorAction.java;1;0;1;1;0;0;0;1;20;0;1;2737;20;20;1;0;0;1;1;2737;0;2737;1;1;
/org.eclipse.pde.ui/src_OSGi/org/eclipse/pde/internal/ui/osgi/templates/NewBundleTemplateChoiceWizard.java;2;0;2;1;0;0;0;2;0;1;2;2519;0;0;1;0;0;2;2;2519;0;3986;2;2;
/org.eclipse.jdt.core.tests.model/workspace/Converter/test0443/A.java;1;0;1;1;0;0;0;1;0;0;1;3714;0;0;1;0;0;1;1;3714;0;3714;1;1;
/org.eclipse.jdt.core.tests.model/workspace/Converter/test0217/Test.java;1;0;1;1;0;0;0;1;0;0;1;3714;0;0;1;0;0;1;1;3714;0;3714;1;1;
/org.eclipse.pde.core/src/org/eclipse/pde/internal/core/RequiredPluginsInitializer.java;1;0;3;1;1;1;1;2;6;1;2;2811;10;10;1;0;0;2;3;2811;0;6336;3;1;
/org.eclipse.debug.ui/ui/org/eclipse/debug/ui/variables/SpecificFileResourceComponent.java;1;0;4;1;0;0;0;4;72;3;2;316;72;72;3;2;0;4;4;316;2;550;2;1;
/org.eclipse.sdk.tests-feature/plugins/org.eclipse.perfmsr.ui/src/org/eclipse/perfmsr/ui/PerfMsrUIPlugin.java;2;2;9;1;8;7;8;1;23;0;1;4845;92;92;2;0;1;1;9;6342;1;6342;8;2;
/org.eclipse.jdt.core.tests.model/workspace/Converter/test0213/Test.java;1;0;1;1;0;0;0;1;0;0;1;3714;0;0;1;0;0;1;1;3714;0;3714;1;1;
/org.eclipse.team.ui/src/org/eclipse/team/internal/ui/synchronize/actions/ExpandAllAction.java;1;1;4;1;2;2;2;2;55;1;2;3972;70;70;1;0;0;2;4;3972;0;6337;4;1;
/org.eclipse.team.ui/src/org/eclipse/team/ui/sync/actions/workingsets/WorkingSetDropDownAction.java;1;0;1;1;0;0;0;1;0;0;1;2481;0;0;1;0;0;1;1;2481;0;2481;1;1;
/org.eclipse.jdt.core.tests.model/workspace/Formatter/test419/A_in.java;1;0;1;1;0;0;0;1;0;0;1;3475;0;0;1;0;0;1;1;3475;0;3475;1;1;
/org.eclipse.jdt.core/compiler/org/eclipse/jdt/internal/compiler/ast/IfStatement.java;2;0;12;1;3;1;3;9;35;3;7;953;138;138;3;2;2;9;12;989;4;5352;8;2;
/org.eclipse.jdt.core.tests.model/workspace/Formatter/test163/A_out.java;2;0;2;1;0;0;0;2;28;1;2;2425;28;28;1;0;0;2;2;2425;0;3362;2;2;
/org.eclipse.update.ui/src/org/eclipse/update/internal/ui/model/PreservedConfiguration.java;1;0;1;1;0;0;0;1;0;0;1;825;0;0;1;0;0;1;1;825;0;825;1;1;
/org.eclipse.jdt.core.tests.compiler/src/org/eclipse/jdt/core/tests/eval/TestAll.java;3;0;7;1;1;1;1;6;84;2;5;2004;127;127;2;1;0;6;7;2004;1;5853;6;3;
/org.eclipse.jdt.ui/ui/org/eclipse/jdt/internal/ui/javaeditor/JavaAnnotationIterator.java;3;0;4;1;1;1;1;3;26;1;3;2215;45;45;1;0;0;3;4;2215;0;6340;4;3;
/org.eclipse.team.core/src/org/eclipse/team/internal/core/TeamPlugin.java;2;1;9;1;5;5;5;4;50;1;4;790;143;143;1;0;0;4;9;790;0;6336;9;2;
/org.eclipse.sdk.tests-feature/plugins/org.eclipse.perfmsr.core/src/org/eclipse/perfmsr/core/IPerformanceMonitor.java;2;1;5;1;4;4;4;1;10;0;1;4845;24;24;1;0;0;1;5;4845;0;6342;5;2;
/org.eclipse.ui.workbench/Eclipse UI/org/eclipse/ui/internal/dialogs/IElementFilter.java;1;0;1;1;0;0;0;1;0;0;1;2737;0;0;1;0;0;1;1;2737;0;2737;1;1;
/org.eclipse.compare/compare/org/eclipse/compare/internal/BufferedResourceNode.java;1;1;4;1;2;2;2;2;21;1;2;1289;43;43;1;0;0;2;4;1289;0;6354;4;1;
/org.eclipse.jdt.ui/ui/org/eclipse/jdt/internal/ui/dialogs/TypeSelectionDialog.java;3;1;3;1;3;3;3;0;74;0;0;5651;89;89;1;0;0;0;3;5651;0;6340;3;3;
/org.eclipse.swt/Eclipse SWT/carbon/org/eclipse/swt/graphics/TextStyle.java;1;0;2;1;0;0;0;2;0;1;2;4562;0;0;1;0;0;2;2;4562;0;4873;2;1;
/org.eclipse.jdt.core.tests.model/workspace/Formatter/test467/A_in.java;1;0;1;1;0;0;0;1;0;0;1;3915;0;0;1;0;0;1;1;3915;0;3915;1;1;
/org.eclipse.search/search/org/eclipse/search/internal/ui/text/GotoMarkerAction.java;1;0;3;1;1;1;1;2;7;1;2;2743;12;12;1;0;0;2;3;2743;0;6340;3;1;
/org.eclipse.jdt.ui/core refactoring/org/eclipse/ltk/core/refactoring/participants/RenameParticipant.java;1;0;2;1;0;0;0;2;0;1;2;4624;0;0;1;0;0;2;2;4624;0;4864;2;1;
/org.eclipse.jdt.debug/jdi interfaces/com/sun/jdi/Field.java;1;0;1;1;0;0;0;1;3;0;1;4267;3;3;1;0;0;1;1;4267;0;4267;1;1;
/org.eclipse.jdt.core/compiler/org/eclipse/jdt/internal/compiler/problem/ProblemHandler.java;4;1;4;1;2;2;2;2;13;1;2;3560;21;21;1;0;0;2;4;3560;0;5615;4;4;
/org.eclipse.update.ui/src/org/eclipse/update/internal/ui/properties/SiteBookmarkPropertySource.java;1;0;1;1;0;0;0;1;0;0;1;794;0;0;1;0;0;1;1;794;0;794;1;1;
/org.eclipse.team.cvs.ui/src/org/eclipse/team/internal/ccvs/ui/HistoryDropAdapter.java;2;1;2;1;2;2;2;0;2;0;0;6016;4;4;1;0;0;0;2;6016;0;6337;2;2;
/org.eclipse.sdk.tests-feature/plugins/org.eclipse.perfmsr.ui.client/src/org/eclipse/perfmsr/ui/client/SelectValuesDialog.java;1;1;3;1;3;3;3;0;10;0;0;5443;12;12;1;0;0;0;3;5443;0;5782;3;1;
/org.eclipse.jdt.core.tests.model/workspace/Converter/test0474/A.java;1;0;2;1;0;0;0;2;0;1;2;957;0;0;1;0;0;2;2;957;0;3714;2;1;
/org.eclipse.jdt.core/compiler/org/eclipse/jdt/internal/compiler/codegen/ConstantPool.java;5;1;7;2;2;2;2;5;118;1;5;219;358;358;1;0;0;5;7;219;0;5940;7;5;
/org.eclipse.jdt.core.tests.model/workspace/Formatter/test193/A_in.java;1;0;1;1;0;0;0;1;0;0;1;2424;0;0;1;0;0;1;1;2424;0;2424;1;1;
/org.eclipse.swt/Eclipse SWT/common/org/eclipse/swt/internal/image/FileFormat.java;1;0;1;1;0;0;0;1;2;0;1;364;2;2;1;0;0;1;1;364;0;364;1;1;
/org.eclipse.ui.ide/src/org/eclipse/ui/internal/ide/dialogs/CleanDialog.java;3;1;8;1;7;7;7;1;180;0;1;4651;252;252;1;0;0;1;8;4651;0;6231;8;3;
/org.eclipse.team.ui/src/org/eclipse/team/internal/ui/preferences/TextPreferencePage.java;1;1;5;1;2;2;2;3;402;2;2;987;468;468;2;1;0;3;5;987;1;6337;4;1;
/org.eclipse.jdt.core/search/org/eclipse/jdt/internal/core/search/matching/DeclarationOfReferencedTypesPattern.java;2;0;8;1;1;1;1;7;129;1;7;543;206;206;1;0;0;7;8;543;0;5207;8;2;
/org.eclipse.jdt.ui.tests/test plugin/org/eclipse/jdt/testplugin/test/JavaTestCase.java;1;0;1;1;1;1;1;0;2;0;0;6340;2;2;1;0;0;0;1;6340;0;6340;1;1;
/org.eclipse.webdav/src/client/org/eclipse/webdav/http/client/Response.java;1;0;2;1;2;1;2;0;25;0;0;5151;25;25;2;0;1;0;2;5151;1;5151;1;1;
/org.eclipse.debug.ui/ui/org/eclipse/debug/internal/ui/views/memory/AbstractMemoryRenderer.java;2;1;2;1;2;2;2;0;6;0;0;5254;6;6;1;0;0;0;2;5254;0;5364;2;2;
/org.eclipse.jdt.ui/core refactoring/org/eclipse/jdt/internal/corext/refactoring/reorg/SourceReferenceUtil.java;3;0;3;1;1;1;1;2;18;1;2;1166;25;25;1;0;0;2;3;1166;0;6340;3;3;
/org.eclipse.team.ui/src/org/eclipse/team/internal/ui/sync/actions/OpenWithActionGroup.java;2;0;9;1;0;0;0;9;84;1;9;727;120;120;1;0;0;9;9;727;0;2632;9;2;
/org.eclipse.update.ui/src/org/eclipse/update/internal/ui/wizards/MultiInstallWizard.java;2;0;2;1;0;0;0;2;2;1;2;200;2;2;1;0;0;2;2;200;0;755;2;2;
/org.eclipse.jdt.ui.tests.refactoring/test cases/org/eclipse/jdt/ui/tests/refactoring/extensions/ExtensionPointTests.java;2;0;5;1;1;1;1;4;8;1;4;882;16;16;1;0;0;4;5;882;0;6340;5;2;
/org.eclipse.update.core/srcnew/org/eclipse/update/internal/operations/UpdateUtils.java;1;0;2;1;0;0;0;2;0;1;2;757;0;0;1;0;0;2;2;757;0;825;2;1;
/org.eclipse.jdt.core.tests.model/workspace/Converter/src/test0372/A.java;1;0;1;1;0;0;0;1;0;0;1;3714;0;0;1;0;0;1;1;3714;0;3714;1;1;
/org.eclipse.update.core/src/org/eclipse/update/internal/core/PatchedFeature.java;2;0;2;1;1;1;1;1;4;0;1;4053;4;4;1;0;0;1;2;4053;0;5665;2;2;
/org.eclipse.debug.ui/ui/org/eclipse/debug/internal/ui/sourcelookup/SourceElementLabelProvider.java;1;0;1;1;0;0;0;1;0;0;1;4610;0;0;1;0;0;1;1;4610;0;4610;1;1;
/org.eclipse.text/src/org/eclipse/jface/text/link/LinkedModeManager.java;2;1;2;1;2;2;2;0;6;0;0;5128;6;6;1;0;0;0;2;5128;0;6340;2;2;
/org.eclipse.jdt.ui/core extension/org/eclipse/jdt/internal/corext/util/WorkingCopyUtil.java;3;0;5;1;1;1;1;4;39;1;4;1108;86;86;1;0;0;4;5;1108;0;6340;5;3;
/org.eclipse.jdt.ui/core extension/org/eclipse/text/edits/DeleteEdit.java;1;0;5;1;0;0;0;5;39;2;3;1953;47;47;2;2;0;5;5;1953;2;1985;3;1;
/org.eclipse.ui.workbench/Eclipse UI/org/eclipse/ui/internal/csm/activities/api/ActivityManagerFactory.java;1;0;4;1;0;0;0;4;35;2;2;2225;38;38;2;2;0;4;4;2225;2;2238;2;1;
/org.eclipse.team.ui/src/org/eclipse/team/ui/synchronize/viewers/DiffNodeController.java;1;0;1;1;0;0;0;1;0;0;1;4071;0;0;1;0;0;1;1;4071;0;4071;1;1;
/org.eclipse.update.core/src/org/eclipse/update/core/Category.java;2;1;3;1;2;2;2;1;6;0;1;890;12;12;1;0;0;1;3;890;0;6336;3;2;
/org.eclipse.pde.ui/src/org/eclipse/pde/internal/ui/editor/feature/FeatureSourceOutlinePage.java;1;0;3;1;1;1;1;2;6;1;2;648;10;10;1;0;0;2;3;648;0;5431;3;1;
/org.eclipse.jface/src/org/eclipse/jface/wizard/Wizard.java;1;0;3;1;1;1;1;2;676;1;2;1;680;680;1;0;0;2;3;1;0;5463;3;1;
/org.eclipse.jdt.core.tests.model/workspace/Converter/test0504/A.java;1;0;2;1;0;0;0;2;0;1;2;3006;0;0;1;0;0;2;2;3006;0;3714;2;1;
/org.eclipse.team.core/src/org/eclipse/team/internal/core/target/BaseIdentifierNotInitializedException.java;1;0;1;1;0;0;0;1;0;0;1;2495;0;0;1;0;0;1;1;2495;0;2495;1;1;
/org.eclipse.jdt.ui.tests.refactoring/resources/InlineMethodWorkspace/TestCases/nameconflict_in/TestSwitchStatement.java;1;0;1;1;0;0;0;1;2;0;1;845;2;2;1;0;0;1;1;845;0;845;1;1;
/org.eclipse.swt/Eclipse SWT PI/gtk1x/org/eclipse/swt/internal/gtk/GdkFont.java;1;0;1;1;0;0;0;1;0;0;1;2327;0;0;1;0;0;1;1;2327;0;2327;1;1;
/org.eclipse.ui.workbench/Eclipse UI/org/eclipse/ui/internal/commands/old/IRegistryListener.java;1;0;2;1;0;0;0;2;0;1;2;1322;0;0;1;0;0;2;2;1322;0;1356;2;1;
/org.eclipse.jdt.core.tests.model/workspace/Formatter/test299/A_out.java;1;0;1;1;0;0;0;1;0;0;1;2444;0;0;1;0;0;1;1;2444;0;2444;1;1;
/org.eclipse.ui.workbench/Eclipse UI/org/eclipse/ui/roles/RoleManagerEvent.java;1;0;3;1;0;0;0;3;4;1;3;2805;4;4;1;0;0;3;3;2805;0;2864;3;1;
/org.eclipse.team.core/src/org/eclipse/team/core/subscribers/SyncBytesSubscriberResourceTree.java;1;0;1;1;0;0;0;1;0;0;1;3193;0;0;1;0;0;1;1;3193;0;3193;1;1;
/org.eclipse.pde.ui/src/org/eclipse/pde/internal/ui/wizards/imports/UpdateClasspathOperation.java;1;0;4;1;0;0;0;4;6;1;4;368;10;10;1;0;0;4;4;368;0;3840;4;1;
/org.eclipse.team.cvs.ui/src/org/eclipse/team/internal/ccvs/ui/subscriber/WorkspaceCommitOperation.java;2;1;4;1;4;4;4;0;331;0;0;5490;345;345;1;0;0;0;4;5490;0;6337;4;2;
/org.eclipse.team.cvs.ui/src/org/eclipse/team/internal/ccvs/ui/wizards/NewLocationWizard.java;2;1;4;1;2;2;2;2;42;1;2;4655;86;86;1;0;0;2;4;4655;0;6337;4;2;
/org.eclipse.ui.externaltools/Ant Tools Support/org/eclipse/ui/externaltools/internal/ant/view/AntView.java;2;0;4;1;0;0;0;4;14;1;4;139;31;31;1;0;0;4;4;139;0;282;4;2;
/org.eclipse.core.runtime.osgi/src/org/eclipse/core/internal/registry/EclipseBundleListener.java;1;0;2;1;0;0;0;2;2;1;2;3013;2;2;1;0;0;2;2;3013;0;3030;2;1;
/org.eclipse.jdt.core.tests.model/workspace/Formatter/test275/A_in.java;1;0;1;1;0;0;0;1;0;0;1;2443;0;0;1;0;0;1;1;2443;0;2443;1;1;
/org.eclipse.team.core/src/org/eclipse/team/core/subscribers/RemoteBytesSynchronizer.java;2;0;5;1;0;0;0;5;24;2;4;1954;30;30;2;1;0;5;5;1954;1;4216;4;2;
/org.eclipse.ui.intro/src/org/eclipse/ui/internal/intro/impl/parts/RootPageForm.java;1;1;6;1;6;6;6;0;31;0;0;5115;65;65;1;0;0;0;6;5115;0;5714;6;1;
/org.eclipse.jdt.core.tests.model/workspace/Converter/src/junit/swingui/TestSelector.java;1;0;1;1;0;0;0;1;0;0;1;3714;0;0;1;0;0;1;1;3714;0;3714;1;1;
/org.eclipse.jdt.core.tests.model/workspace/Formatter/test179/A_out.java;1;0;1;1;0;0;0;1;0;0;1;2425;0;0;1;0;0;1;1;2425;0;2425;1;1;
/org.eclipse.jdt.ui/core refactoring/org/eclipse/ltk/core/refactoring/participants/MoveRefactoring.java;1;0;3;1;0;0;0;3;32;1;3;4688;32;32;1;0;0;3;3;4688;0;4864;3;1;
/org.eclipse.pde.ui/sandbox/org/eclipse/pde/internal/ui/editor/standalone/parser/SourceRange.java;1;0;2;1;0;0;0;2;0;1;2;2320;0;0;1;0;0;2;2;2320;0;2931;2;1;
/org.eclipse.ant.ui/Ant Editor/org/eclipse/ant/internal/ui/dtd/util/IMapHolder.java;1;0;1;1;0;0;0;1;0;0;1;1811;0;0;1;0;0;1;1;1811;0;1811;1;1;
/org.eclipse.debug.core/core/org/eclipse/debug/internal/core/memory/IMemoryRenderingFactory.java;1;0;1;1;1;1;1;0;0;0;0;5254;0;0;1;0;0;0;1;5254;0;5254;1;1;
/org.eclipse.jdt.ui/ui/org/eclipse/jdt/internal/ui/filters/NamePatternFilter.java;1;0;2;1;1;1;1;1;11;0;1;147;13;13;1;0;0;1;2;147;0;6340;2;1;
/org.eclipse.pde.core/src/org/eclipse/pde/internal/core/build/IBuildObject.java;1;1;2;1;2;2;2;0;19;0;0;5391;19;19;1;0;0;0;2;5391;0;5780;2;1;
/org.eclipse.jdt.ui.tests.refactoring/resources/ExtractTemp/cannotExtract/A_testFail34.java;1;0;1;1;0;0;0;1;0;0;1;1575;0;0;1;0;0;1;1;1575;0;1575;1;1;
/org.eclipse.jdt.core/model/org/eclipse/jdt/internal/core/builder/NameSet.java;2;0;4;2;1;1;1;3;64;2;2;2724;76;76;2;1;0;3;4;2724;1;5802;3;2;
/org.eclipse.pde.ui/src/org/eclipse/pde/internal/ui/feature/FeatureData.java;1;0;1;1;0;0;0;1;0;0;1;3840;0;0;1;0;0;1;1;3840;0;3840;1;1;
/org.eclipse.jdt.core.tests.model/workspace/Converter/src/javadoc/testBug51508/X.java;1;0;1;1;0;0;0;1;0;0;1;3994;0;0;1;0;0;1;1;3994;0;3994;1;1;
/org.eclipse.jdt.core.tests.model/workspace/Converter/test0410/A.java;1;0;1;1;0;0;0;1;0;0;1;3714;0;0;1;0;0;1;1;3714;0;3714;1;1;
/org.eclipse.ui.workbench/Eclipse UI/org/eclipse/ui/internal/commands/registry/CoreRegistry.java;1;0;4;1;0;0;0;4;4;2;3;1077;5;5;2;1;0;4;4;1077;1;1222;3;1;
/org.eclipse.jdt.ui.tests.refactoring/resources/ExtractMethodWorkSpace/ExtractMethodTests/try_out/A_test454.java;1;0;2;1;0;0;0;2;4;1;2;130;6;6;1;0;0;2;2;130;0;844;2;1;
/org.eclipse.pde.ui/src/org/eclipse/pde/internal/ui/parts/RenameDialog.java;2;0;2;1;0;0;0;2;0;1;2;1011;0;0;1;0;0;2;2;1011;0;3393;2;2;
/org.eclipse.jdt.ui.examples.javafamily/src/org/eclipse/jdt/internal/ui/search2/SearchViewSiteAdapter.java;2;0;5;1;0;0;0;5;4;1;5;1033;13;13;1;0;0;5;5;1033;0;2877;5;2;
/org.eclipse.swt.graphics.text/Eclipse SWT/gtk/org/eclipse/swt/graphics/text/TextStyle.java;1;0;2;1;0;0;0;2;96;1;2;2707;96;96;1;0;0;2;2;2707;0;4213;2;1;
/org.eclipse.team.cvs.ui/src/org/eclipse/team/internal/ccvs/ui/actions/ContentAction.java;1;0;1;1;0;0;0;1;0;0;1;4216;0;0;1;0;0;1;1;4216;0;4216;1;1;
/org.eclipse.jdt.core.tests.model/workspace/Formatter/test426/A_in.java;1;0;1;1;0;0;0;1;0;0;1;3478;0;0;1;0;0;1;1;3478;0;3478;1;1;
/org.eclipse.jdt.core.tests.model/workspace/Converter/test0198/Test.java;1;0;1;1;0;0;0;1;0;0;1;3714;0;0;1;0;0;1;1;3714;0;3714;1;1;
/org.eclipse.sdk.tests-feature/plugins/org.eclipse.perfmsr.ui.client/src/org/eclipse/perfmsr/ui/client/StepGroup.java;1;1;2;1;2;2;2;0;10;0;0;5443;10;10;1;0;0;0;2;5443;0;5513;2;1;
/org.eclipse.ui.workbench.texteditor/src/org/eclipse/ui/texteditor/templates/TemplatePreferencePage.java;3;2;16;2;9;8;9;7;85;3;5;4627;317;317;3;2;1;7;16;4627;3;6359;13;3;
/org.eclipse.releng.tools/src/org/eclipse/releng/tools/TagAndReleaseAction.java;2;1;3;1;3;3;3;0;37;0;0;5183;41;41;1;0;0;0;3;5183;0;6340;3;2;
/org.eclipse.ui.ide/src/org/eclipse/ui/views/navigator/INavigatorHelpContextIds.java;2;0;2;1;0;0;0;2;4;1;2;2208;4;4;1;0;0;2;2;2208;0;3308;2;2;
/org.eclipse.ant.ui/Ant Tools Support/org/eclipse/ant/ui/internal/launchConfigurations/TaskLinkManager.java;1;0;4;1;0;0;0;4;176;1;4;250;305;305;1;0;0;4;4;250;0;1811;4;1;
/org.eclipse.jdt.ui/ui/org/eclipse/jdt/internal/ui/text/link/contentassist/Helper2.java;2;0;2;1;0;0;0;2;0;1;2;1132;0;0;1;0;0;2;2;1132;0;4214;2;2;
/org.eclipse.jdt.core.tests.model/workspace/Converter/src/test0487/A.java;1;0;1;1;0;0;0;1;0;0;1;3714;0;0;1;0;0;1;1;3714;0;3714;1;1;
/org.eclipse.jdt.core/model/org/eclipse/jdt/internal/core/jdom/DOMField.java;3;1;5;1;2;2;2;3;7;1;3;90;27;27;1;0;0;3;5;90;0;5916;5;3;
/org.eclipse.compare.examples.xml/src/org/eclipse/compare/examples/xml/XMLComparePreferencePage.java;1;0;3;1;0;0;0;3;2;1;3;1106;4;4;1;0;0;3;3;1106;0;3938;3;1;
/org.eclipse.jdt.core.tests.model/workspace/Formatter/test115/A_out.java;1;0;1;1;0;0;0;1;0;0;1;2425;0;0;1;0;0;1;1;2425;0;2425;1;1;
/org.eclipse.pde.ui/src/org/eclipse/pde/internal/ui/search/PluginSearchUIOperation.java;2;1;3;1;2;2;2;1;8;0;1;2950;18;18;1;0;0;1;3;2950;0;6336;3;2;
/org.eclipse.ui.workbench.texteditor/src/org/eclipse/ui/texteditor/IDocumentProvider.java;2;2;4;2;3;2;3;1;50;0;1;2059;59;59;2;0;1;1;4;6334;1;6334;3;2;
/org.eclipse.jdt.ui.tests/ui/org/eclipse/jdt/ui/tests/astrewrite/ASTRewritingJavadocTest.java;2;0;6;1;1;1;1;5;56;1;5;3900;149;149;1;0;0;5;6;3900;0;5406;6;2;
/org.eclipse.jdt.core.tests.model/workspace/Converter/test0014/Test.java;1;0;1;1;0;0;0;1;0;0;1;3714;0;0;1;0;0;1;1;3714;0;3714;1;1;
/org.eclipse.jdt.ui/ui/org/eclipse/jdt/internal/ui/javaeditor/JavaDocumentSetupParticipant.java;2;0;2;1;1;1;1;1;20;0;1;4425;20;20;1;0;0;1;2;4425;0;6340;2;2;
/org.eclipse.team.examples.filesystem/src/org/eclipse/team/examples/localhistory/LocalHistoryVariantComparator.java;1;1;2;1;2;2;2;0;2;0;0;6305;2;2;1;0;0;0;2;6305;0;6337;2;1;
/org.eclipse.jdt.ui/core refactoring/org/eclipse/jdt/internal/corext/refactoring/rename/RippleMethodFinder.java;3;1;6;1;4;4;4;2;69;1;2;244;157;157;1;0;0;2;6;244;0;6340;6;3;
/org.eclipse.debug.core/core/org/eclipse/debug/internal/core/sourcelookup/ISourceContainer.java;1;0;6;1;0;0;0;6;26;1;6;3169;57;57;1;0;0;6;6;3169;0;4949;6;1;
/org.eclipse.jdt.launching.macosx/macosx/org/eclipse/jdt/internal/launching/macosx/MacOSXLaunchingPlugin.java;1;0;9;1;0;0;0;9;215;2;8;134;607;607;2;1;0;9;9;134;1;3947;8;1;
/org.eclipse.ui.views/src/org/eclipse/ui/views/internal/markers/FiltersAction.java;1;0;2;1;0;0;0;2;0;0;1;265;0;0;2;1;0;2;2;265;1;265;1;1;
/org.eclipse.jdt.ui.tests.refactoring/resources/PullUp/testField0/out/A.java;1;0;1;1;0;0;0;1;2;0;1;1690;2;2;1;0;0;1;1;1690;0;1690;1;1;
/org.eclipse.ui.workbench/Eclipse UI/org/eclipse/ui/internal/csm/commands/api/IImageBinding.java;1;0;2;1;0;0;0;2;0;1;2;2533;0;0;1;0;0;2;2;2533;0;2562;2;1;
/org.eclipse.jdt.core/batch/org/eclipse/jdt/internal/compiler/batch/FileSystem.java;3;0;5;1;0;0;0;5;50;2;4;259;69;69;2;1;0;5;5;259;1;3608;4;3;
/org.eclipse.core.runtime.osgi/src/org/eclipse/core/internal/registry/IRegistryElement.java;1;0;1;1;0;0;0;1;0;0;1;3013;0;0;1;0;0;1;1;3013;0;3013;1;1;
/org.eclipse.core.filebuffers/src/org/eclipse/core/filebuffers/annotations/ResourceMarkerAnnotationModel.java;1;0;1;1;0;0;0;1;0;0;1;2815;0;0;1;0;0;1;1;2815;0;2815;1;1;
/org.eclipse.jdt.core.tests.model/workspace/Converter/src/test0545/First.java;1;0;1;1;1;1;1;0;0;0;0;5313;0;0;1;0;0;0;1;5313;0;5313;1;1;
/org.eclipse.jdt.core.tests.model/workspace/Formatter/test209/A_out.java;1;0;1;1;0;0;0;1;0;0;1;2424;0;0;1;0;0;1;1;2424;0;2424;1;1;
/org.eclipse.pde.ui/src/org/eclipse/pde/internal/ui/editor/SystemFileEditorInputFactory.java;2;2;4;1;4;3;4;0;4;0;0;5431;6;6;2;0;1;0;4;5431;1;6336;3;2;
/org.eclipse.ui.views/src/org/eclipse/ui/views/framelist/TreeViewerFrameSource.java;1;0;1;1;0;0;0;1;0;0;1;2738;0;0;1;0;0;1;1;2738;0;2738;1;1;
/org.eclipse.team.webdav/src/org/eclipse/team/internal/webdav/ui/subscriber/WebDavExportWizard.java;2;1;7;1;4;4;4;3;101;1;3;3496;141;141;1;0;0;3;7;3496;0;6337;7;2;
/org.eclipse.ui.workbench/Eclipse UI/org/eclipse/ui/internal/roles/CategoryDefinition.java;1;0;2;1;0;0;0;2;0;0;1;2864;0;0;2;1;0;2;2;2864;1;2864;1;1;
/org.eclipse.team.core/src/org/eclipse/team/internal/core/subscribers/SyncInfoTreeChangeEvent.java;2;0;3;1;1;1;1;2;95;1;2;4017;97;97;1;0;0;2;3;4017;0;6336;3;2;
/org.eclipse.update.core/src/org/eclipse/update/internal/configuration/InstallConfiguration.java;1;0;1;1;0;0;0;1;0;0;1;2828;0;0;1;0;0;1;1;2828;0;2828;1;1;
/org.eclipse.update.ui/src/org/eclipse/update/internal/ui/forms/InfoLink.java;1;0;1;1;0;0;0;1;0;0;1;755;0;0;1;0;0;1;1;755;0;755;1;1;
/org.eclipse.jdt.ui.tests.refactoring/resources/RenamePackage/testImportFromMultiRoots1/in/srcTest/tests/AllTests.java;1;0;3;1;0;0;0;3;8;1;3;3219;14;14;1;0;0;3;3;3219;0;4585;3;1;
/org.eclipse.jdt.ui/core extension/org/eclipse/text/edits/RangeMarker.java;1;0;3;1;0;0;0;3;24;2;2;1953;24;24;2;1;0;3;3;1985;1;1985;2;1;
/org.eclipse.osgi/resolver/src/org/eclipse/core/internal/dependencies/ResolutionDelta.java;3;1;4;1;3;3;3;1;57;0;1;3013;75;75;1;0;0;1;4;3013;0;5529;4;3;
/org.eclipse.ui.workbench/Eclipse UI/org/eclipse/ui/contexts/registry/IContextDefinition.java;1;0;3;1;0;0;0;3;2;2;2;1400;2;2;2;1;0;3;3;1400;1;1417;2;1;
/org.eclipse.ui.workbench/Eclipse UI/org/eclipse/ui/internal/commands/ws/SelectAllHandler.java;1;0;1;1;1;1;1;0;0;0;0;5489;0;0;1;0;0;0;1;5489;0;5489;1;1;
/org.eclipse.core.tests.resources/src/org/eclipse/core/tests/resources/ResourceURLTest.java;1;0;3;1;3;1;3;0;179;0;0;5147;179;179;3;0;2;0;3;5147;2;5147;1;1;
/org.eclipse.jdt.debug/model/org/eclipse/jdt/internal/debug/core/model/JDIClassType.java;3;0;4;1;0;0;0;4;49;1;4;670;89;89;1;0;0;4;4;670;0;2269;4;3;
/org.eclipse.ui.workbench/Eclipse UI/org/eclipse/ui/internal/dialogs/NewWizardActivityFilter.java;1;0;1;1;0;0;0;1;0;0;1;5030;0;0;1;0;0;1;1;5030;0;5030;1;1;
/org.eclipse.update.ui.forms/src/org/eclipse/ui/forms/parts/SelectableFormLabel.java;1;0;2;1;0;0;0;2;0;1;2;3038;0;0;1;0;0;2;2;3038;0;3071;2;1;
/org.eclipse.debug.ui/ui/org/eclipse/debug/internal/ui/views/memory/GoToAddressAction.java;1;0;1;1;1;1;1;0;0;0;0;5254;0;0;1;0;0;0;1;5254;0;5254;1;1;
/org.eclipse.jdt.core/compiler/org/eclipse/jdt/internal/compiler/ast/ArrayAllocationExpression.java;2;0;4;1;1;1;1;3;31;1;3;991;40;40;1;0;0;3;4;991;0;5587;4;2;
/org.eclipse.jdt.core.tests.model/workspace/Formatter/test197/A_out.java;1;0;1;1;0;0;0;1;0;0;1;2424;0;0;1;0;0;1;1;2424;0;2424;1;1;
/org.eclipse.ui.intro/src/org/eclipse/ui/intro/internal/util/ImageUtil.java;1;0;4;1;1;1;1;3;229;1;3;4429;233;233;1;0;0;3;4;4429;0;5115;4;1;
/org.eclipse.jdt.core.tests.model/workspace/Formatter/test437/A_in.java;1;0;1;1;0;0;0;1;0;0;1;3498;0;0;1;0;0;1;1;3498;0;3498;1;1;
/org.eclipse.pde.ui/src/org/eclipse/pde/internal/ui/editor/CheckboxTableSection.java;1;0;1;1;1;1;1;0;0;0;0;5431;0;0;1;0;0;0;1;5431;0;5431;1;1;
/org.eclipse.jface.text/src/org/eclipse/jface/text/source/VerticalRuler.java;2;1;10;1;4;4;4;6;42;1;6;1347;119;119;1;0;0;6;10;1347;0;6361;10;2;
/org.eclipse.ant.core/src/org/eclipse/ant/internal/core/AntClasspathEntry.java;1;0;7;1;1;1;1;6;24;1;6;2575;65;65;1;0;0;6;7;2575;0;5879;7;1;
/org.eclipse.ui.externaltools/Program Tools Support/org/eclipse/ui/externaltools/internal/program/launchConfigurations/ProgramTabGroup.java;3;0;6;1;0;0;0;6;4;1;6;265;19;19;1;0;0;6;6;265;0;2120;6;3;
/org.eclipse.ui.workbench/Eclipse UI/org/eclipse/ui/internal/WWinKeyBindingService.java;1;0;2;1;0;0;0;2;2;0;1;774;2;2;2;1;0;2;2;774;1;774;1;1;
/org.eclipse.team.cvs.core/src/org/eclipse/team/internal/ccvs/core/client/FileStructureVisitor.java;1;0;3;1;0;0;0;3;15;1;3;1173;26;26;1;0;0;3;3;1173;0;1843;3;1;
/org.eclipse.team.core/src/org/eclipse/team/core/synchronize/IResourceVariant.java;2;0;3;1;0;0;0;3;72;1;3;4127;72;72;1;0;0;3;3;4127;0;4349;3;2;
/org.eclipse.sdk.tests-feature/plugins/org.eclipse.perfmsr.ui.client/src/org/eclipse/perfmsr/ui/client/Step.java;1;1;2;1;2;2;2;0;10;0;0;5443;10;10;1;0;0;0;2;5443;0;5513;2;1;
/org.eclipse.ui.workbench/Eclipse UI/org/eclipse/ui/ResourceWorkingSetFilter.java;1;0;1;1;0;0;0;1;0;0;1;2737;0;0;1;0;0;1;1;2737;0;2737;1;1;
/org.eclipse.pde.ui/src/org/eclipse/pde/internal/ui/wizards/convert/MigratePluginWizard.java;1;0;2;1;0;0;0;2;0;0;1;3839;0;0;2;1;0;2;2;3839;1;3839;1;1;
/org.eclipse.jdt.core/compiler/org/eclipse/jdt/internal/compiler/codegen/ExceptionLabel.java;2;0;2;1;0;0;0;2;47;1;2;148;49;49;1;0;0;2;2;148;0;3560;2;2;
/org.eclipse.jdt.ui.tests.refactoring/test cases/org/eclipse/jdt/ui/tests/refactoring/infra/SimpleSelectionProvider.java;2;0;2;1;1;1;1;1;4;0;1;1111;4;4;1;0;0;1;2;1111;0;6340;2;2;
/org.eclipse.ui.workbench/Eclipse UI/org/eclipse/ui/internal/EditorList.java;4;1;4;1;2;2;2;2;10;1;2;2620;20;20;1;0;0;2;4;2620;0;6338;4;4;
/org.eclipse.jdt.ui/ui/org/eclipse/jdt/internal/ui/actions/AddBlockCommentAction.java;3;1;5;1;2;2;2;3;226;1;3;1644;238;238;1;0;0;3;5;1644;0;6340;5;3;
/org.eclipse.jdt.text.tests/src/org/eclipse/jdt/ui/text/tests/PairMatcherTest.java;1;1;3;1;2;2;2;1;6;0;1;5082;6;6;1;0;0;1;3;5082;0;5129;3;1;
/org.eclipse.debug.ui/ui/org/eclipse/debug/ui/variables/LaunchConfigurationVariableForm.java;2;0;4;1;0;0;0;4;48;1;4;323;56;56;1;0;0;4;4;323;0;550;4;2;
/org.eclipse.jdt.core.tests.model/src/org/eclipse/jdt/core/tests/model/OverflowingCacheTests.java;2;0;6;1;1;1;1;5;11;1;5;1032;24;24;1;0;0;5;6;1032;0;5185;6;2;
/org.eclipse.jface/src/org/eclipse/jface/action/IAction.java;5;1;6;1;5;5;5;1;22;0;1;1;51;51;1;0;0;1;6;1;0;6338;6;5;
/org.eclipse.team.ui/src/org/eclipse/team/ui/synchronize/subscribers/SubscriberRefreshWizard.java;1;0;6;1;1;1;1;5;4;1;5;4632;12;12;1;0;0;5;6;4632;0;5362;6;1;
/org.eclipse.osgi/defaultAdaptor/src/org/eclipse/osgi/framework/internal/defaultadaptor/DefaultPermissionStorage.java;2;2;5;1;5;4;5;0;20;0;0;5116;29;29;2;0;1;0;5;5116;1;6337;4;2;
/org.eclipse.jdt.core/eval/org/eclipse/jdt/internal/eval/CodeSnippetCodeStream.java;4;1;6;2;2;2;2;4;152;1;4;1059;289;289;1;0;0;4;6;1059;0;5940;6;4;
/org.eclipse.update.ui/src/org/eclipse/update/internal/ui/model/FeatureReferenceAdapter.java;1;0;2;1;0;0;0;2;13;1;2;890;15;15;1;0;0;2;2;890;0;900;2;1;
/org.eclipse.jdt.ui.examples.javafamily/src/org/eclipse/jdt/internal/ui/examples/jspeditor/Jsp2JavaTagHandlerFactory.java;1;0;3;1;1;1;1;2;4;1;2;1172;7;7;1;0;0;2;3;1172;0;5122;3;1;
/org.eclipse.update.ui/src/org/eclipse/update/internal/ui/model/FeatureAdapter.java;1;0;2;1;0;0;0;2;3;1;2;890;6;6;1;0;0;2;2;890;0;900;2;1;
/org.eclipse.jdt.core.tests.model/workspace/Formatter/test082/A_out.java;1;0;1;1;0;0;0;1;0;0;1;2425;0;0;1;0;0;1;1;2425;0;2425;1;1;
/org.eclipse.compare/compare/org/eclipse/compare/ICompareNavigator.java;1;0;2;1;0;0;0;2;2;1;2;1735;2;2;1;0;0;2;2;1735;0;3935;2;1;
/org.eclipse.update.ui/src/org/eclipse/update/internal/ui/properties/ConfigurationPropertyPage.java;1;0;1;1;0;0;0;1;0;0;1;794;0;0;1;0;0;1;1;794;0;794;1;1;
/org.eclipse.debug.core/core/org/eclipse/debug/internal/core/stringsubstitution/IValueVariableListener.java;2;0;2;1;0;0;0;2;0;1;2;2032;0;0;1;0;0;2;2;2032;0;2514;2;2;
/org.eclipse.update.tests.core/src/org/eclipse/update/tests/reconciliation/TestSiteReconciliation.java;1;1;4;1;2;2;2;2;23;1;2;3037;43;43;1;0;0;2;4;3037;0;6336;4;1;
/org.eclipse.pde.ui/src_Forms/org/eclipse/pde/internal/ui/model/bundle/Bundle.java;3;1;7;1;7;7;7;0;54;0;0;5454;87;87;1;0;0;0;7;5454;0;6336;7;3;
/org.eclipse.pde.ui/src/org/eclipse/pde/internal/ui/wizards/exports/BuildOptionsPreferenceNode.java;1;0;2;1;0;0;0;2;0;1;2;1718;0;0;1;0;0;2;2;1718;0;3986;2;1;
/org.eclipse.jdt.core.tests.model/workspace/Converter/src/junit/textui/TestRunner.java;1;0;1;1;0;0;0;1;0;0;1;3714;0;0;1;0;0;1;1;3714;0;3714;1;1;
/org.eclipse.ui.cheatsheets/src/org/eclipse/ui/internal/cheatsheets/data/IPerformWhenItem.java;1;0;1;1;1;1;1;0;0;0;0;5189;0;0;1;0;0;0;1;5189;0;5189;1;1;
/org.eclipse.jdt.core/dom/org/eclipse/jdt/core/dom/PackageDeclaration.java;3;2;13;1;4;3;4;9;112;1;9;3560;327;327;2;0;1;9;13;5268;1;5335;12;3;
/org.eclipse.search/search/org/eclipse/search/internal/ui/OpenSearchDialogAction.java;1;0;1;1;1;1;1;0;2;0;0;6340;2;2;1;0;0;0;1;6340;0;6340;1;1;
/org.eclipse.ltk.core.refactoring/src/org/eclipse/ltk/core/refactoring/ValidationStateChangedEvent.java;1;0;2;1;0;0;0;2;0;1;2;4845;0;0;1;0;0;2;2;4845;0;4864;2;1;
/org.eclipse.jdt.core.tests.model/workspace/Converter/src/test0240/Test.java;1;0;1;1;0;0;0;1;0;0;1;3714;0;0;1;0;0;1;1;3714;0;3714;1;1;
/org.eclipse.ui.workbench/Eclipse UI/org/eclipse/ui/internal/progress/ProgressView.java;3;0;32;1;1;1;1;31;161;3;26;1061;897;897;3;5;0;31;32;1237;5;5896;27;3;
/org.eclipse.jdt.ui.tests.refactoring/resources/ExtractMethodWorkSpace/ExtractMethodTests/try_out/A_test452.java;1;0;2;1;0;0;0;2;4;1;2;130;6;6;1;0;0;2;2;130;0;844;2;1;
/org.eclipse.help.ui/src/org/eclipse/help/ui/internal/HelpContentsAction.java;1;0;2;1;1;1;1;1;2;0;1;2732;2;2;1;0;0;1;2;2732;0;5803;2;1;
/org.eclipse.ui.ide/src/org/eclipse/ui/views/bookmarkexplorer/BookmarkNavigator.java;4;1;5;1;2;2;2;3;6;1;3;2208;16;16;1;0;0;3;5;2208;0;6338;5;4;
/org.eclipse.team.core/src/org/eclipse/team/internal/core/registry/RegistryReader.java;2;1;4;1;2;2;2;2;144;1;2;2806;144;144;1;0;0;2;4;2806;0;5597;4;2;
/org.eclipse.update.ui/src/org/eclipse/update/internal/ui/model/ExtensionRoot.java;2;0;4;1;0;0;0;4;8;1;4;890;12;12;1;0;0;4;4;890;0;2085;4;2;
/org.eclipse.ui.workbench/Eclipse UI/org/eclipse/ui/internal/roles/api/IRoleActivationServiceEvent.java;1;0;2;1;0;0;0;2;0;0;1;2202;0;0;2;1;0;2;2;2202;1;2202;1;1;
/org.eclipse.team.cvs.ui/src/org/eclipse/team/internal/ccvs/ui/subscriber/ChangeLogModelSorter.java;1;1;3;1;3;3;3;0;75;0;0;5487;128;128;1;0;0;0;3;5487;0;5718;3;1;
/org.eclipse.ui.workbench/Eclipse UI/org/eclipse/ui/about/ISystemSummarySection.java;1;0;1;1;1;1;1;0;0;0;0;5483;0;0;1;0;0;0;1;5483;0;5483;1;1;
/org.eclipse.jdt.debug.ui/ui/org/eclipse/jdt/debug/ui/JavaUISourceLocator.java;2;0;3;1;1;1;1;2;22;1;2;1240;29;29;1;0;0;2;3;1240;0;6336;3;2;
/org.eclipse.core.resources/src/org/eclipse/core/internal/events/BuildManager.java;2;2;24;1;7;6;7;17;1276;2;16;1485;1755;1755;2;1;1;17;24;4896;2;6265;22;2;
/org.eclipse.ui.intro/src/org/eclipse/ui/internal/intro/impl/model/IntroExtensionContent.java;1;1;7;1;7;7;7;0;10;0;0;5115;26;26;1;0;0;0;7;5115;0;6251;7;1;
/org.eclipse.jdt.ui/ui/org/eclipse/jdt/internal/ui/wizards/dialogfields/StringDialogField.java;3;1;3;1;2;2;2;1;19;0;1;4930;31;31;1;0;0;1;3;4930;0;6340;3;3;
/org.eclipse.search/search/org/eclipse/search/internal/ui/util/FileTypeEditor.java;1;0;3;1;1;1;1;2;4;1;2;611;8;8;1;0;0;2;3;611;0;6340;3;1;
/org.eclipse.jdt.ui/ui/org/eclipse/jdt/internal/ui/text/link/contentassist/AdditionalInfoController2.java;3;0;3;1;0;0;0;3;2;1;3;1132;2;2;1;0;0;3;3;1132;0;4214;3;3;
/org.eclipse.jdt.ui/core refactoring/org/eclipse/jdt/internal/corext/refactoring/tagging/ITextUpdating.java;3;0;3;1;1;1;1;2;57;1;2;1125;59;59;1;0;0;2;3;1125;0;6340;3;3;
/org.eclipse.pde.build/src/org/eclipse/pde/internal/build/XMLWriter.java;2;1;7;1;2;2;2;5;15;1;5;447;30;30;1;0;0;5;7;447;0;5730;7;2;
/org.eclipse.core.runtime/src/org/eclipse/core/runtime/PlatformHelper.java;1;0;1;1;0;0;0;1;0;0;1;3134;0;0;1;0;0;1;1;3134;0;3134;1;1;
/org.eclipse.jdt.ui.tests.refactoring/resources/ExtractMethodWorkSpace/ExtractMethodTests/locals_in/A_test557.java;1;0;1;1;0;0;0;1;2;0;1;844;2;2;1;0;0;1;1;844;0;844;1;1;
/org.eclipse.ui.ide/src/org/eclipse/ui/views/navigator/NavigatorDragAdapter.java;1;0;1;1;0;0;0;1;0;0;1;2208;0;0;1;0;0;1;1;2208;0;2208;1;1;
/org.eclipse.search/new search/org/eclipse/search2/internal/ui/ThrottlingProgressMonitor.java;2;1;6;1;5;5;5;1;39;0;1;3474;56;56;1;0;0;1;6;3474;0;6340;6;2;
/org.eclipse.ui.workbench/Eclipse UI/org/eclipse/ui/commands/HandlerServiceEvent.java;1;0;2;1;0;0;0;2;0;1;2;1119;0;0;1;0;0;2;2;1119;0;1222;2;1;
/org.eclipse.jdt.ui.tests.refactoring/resources/SurroundWithWorkSpace/SurroundWithTests/trycatch_out/TestNested.java;1;0;1;1;0;0;0;1;6;0;1;845;6;6;1;0;0;1;1;845;0;845;1;1;
/org.eclipse.swt/Eclipse SWT/common/org/eclipse/swt/events/VerifyEvent.java;1;0;1;1;0;0;0;1;21;0;1;2729;21;21;1;0;0;1;1;2729;0;2729;1;1;
/org.eclipse.update.core/src/org/eclipse/update/configuration/LocalSystemInfo.java;2;2;5;1;4;3;4;1;12;0;1;890;30;30;2;0;1;1;5;6336;1;6336;4;2;
/org.eclipse.ui.workbench/Eclipse UI/org/eclipse/ui/internal/commands/old/ActiveConfiguration.java;1;0;2;1;0;0;0;2;0;1;2;1322;0;0;1;0;0;2;2;1322;0;1695;2;1;
/org.eclipse.ui.workbench/Eclipse UI/org/eclipse/ui/internal/commands/registry/ActiveConfiguration.java;1;0;2;1;0;0;0;2;0;1;2;1077;0;0;1;0;0;2;2;1077;0;1222;2;1;
/org.eclipse.ltk.ui.refactoring/src/org/eclipse/ltk/internal/ui/refactoring/RedoRefactoringAction.java;1;1;3;1;3;3;3;0;16;0;0;5162;16;16;1;0;0;0;3;5162;0;5355;3;1;
/org.eclipse.jdt.ui/ui/org/eclipse/jdt/internal/ui/preferences/RefactoringPreferencePage.java;1;0;1;1;0;0;0;1;0;0;1;4965;0;0;1;0;0;1;1;4965;0;4965;1;1;
/org.eclipse.ui.externaltools/Ant Tools Support/org/eclipse/ui/externaltools/internal/ant/view/AntViewMessages.java;1;0;1;1;0;0;0;1;0;0;1;282;0;0;1;0;0;1;1;282;0;282;1;1;
/org.eclipse.jface/src/org/eclipse/jface/dialogs/IDialogBlockedHandler.java;2;1;5;1;5;5;5;0;20;0;0;5363;33;33;1;0;0;0;5;5363;0;6338;5;2;
/org.eclipse.jdt.ui/ui/org/eclipse/jdt/ui/actions/ExtractTempAction.java;3;0;8;1;1;1;1;7;43;1;7;122;84;84;1;0;0;7;8;122;0;6340;8;3;
/org.eclipse.osgi/osgi/src/org/osgi/framework/BundlePermission.java;3;2;5;1;3;2;3;2;156;1;2;3013;193;193;2;0;1;2;5;5207;1;5536;4;3;
/org.eclipse.releng.eclipsebuilder/sdk/tools/ReadFile.java;1;0;4;1;2;1;2;2;26;1;2;4758;44;44;2;0;1;2;4;6218;1;6218;3;1;
/org.eclipse.jdt.ui.tests.refactoring/test cases/org/eclipse/jdt/ui/tests/refactoring/SefTests.java;3;0;9;1;1;1;1;8;19;1;8;130;56;56;1;0;0;8;9;130;0;6340;9;3;
/org.eclipse.ui.workbench/Eclipse UI/org/eclipse/ui/internal/commands/api/older/IActionService.java;1;0;1;1;0;0;0;1;0;0;1;2562;0;0;1;0;0;1;1;2562;0;2562;1;1;
/org.eclipse.jdt.ui.tests.refactoring/resources/ExtractMethodWorkSpace/ExtractMethodTests/parameterName_out/A_test905.java;1;0;1;1;0;0;0;1;0;0;1;2256;0;0;1;0;0;1;1;2256;0;2256;1;1;
/org.eclipse.ant.ui/Ant Editor/org/eclipse/ant/ui/internal/dtd/ISchema.java;1;0;2;1;0;0;0;2;0;1;2;250;0;0;1;0;0;2;2;250;0;1811;2;1;
/org.eclipse.pde.ui/src/org/eclipse/pde/internal/ui/launcher/NewTracingLauncherTab.java;3;1;5;2;2;2;2;3;18;2;2;4791;38;38;2;1;0;3;5;4791;1;6053;4;3;
/org.eclipse.ui.workbench/Eclipse UI/org/eclipse/ui/internal/presentation/PresentationDefinitionReader.java;1;0;2;1;0;0;0;2;0;1;2;4235;0;0;1;0;0;2;2;4235;0;4392;2;1;
/org.eclipse.jdt.ui.tests.refactoring/resources/MoveInstanceMethod/canMove/test20/in/A.java;1;0;1;1;0;0;0;1;0;0;1;1586;0;0;1;0;0;1;1;1586;0;1586;1;1;
/org.eclipse.search/search/org/eclipse/search/internal/ui/text/FileSearchDesription.java;1;0;3;1;0;0;0;3;35;1;3;3458;35;35;1;0;0;3;3;3458;0;3711;3;1;
/org.eclipse.pde.ui/src/org/eclipse/pde/internal/ui/editor/feature/HandlerSection.java;3;1;9;1;6;6;6;3;119;1;3;368;175;175;1;0;0;3;9;368;0;6336;9;3;
/org.eclipse.update.core/src/org/eclipse/update/standalone/DisableCommand.java;1;1;9;1;6;6;6;3;78;2;2;825;115;115;2;1;0;3;9;825;1;6336;8;1;
/org.eclipse.ui.editors/src/org/eclipse/ui/internal/editors/quickdiff/compare/rangedifferencer/DifferencesIterator.java;2;0;2;1;0;0;0;2;0;1;2;1118;0;0;1;0;0;2;2;1118;0;1644;2;2;
/org.eclipse.jdt.ui.tests.refactoring/resources/SurroundWithWorkSpace/SurroundWithTests/trycatch_out/TestWrappedLocal3.java;1;0;1;1;0;0;0;1;9;0;1;845;9;9;1;0;0;1;1;845;0;845;1;1;
/org.eclipse.jdt.ui/ui refactoring/org/eclipse/jdt/internal/ui/refactoring/RenameFieldInputWizardPage.java;1;0;1;1;0;0;0;1;0;0;1;518;0;0;1;0;0;1;1;518;0;518;1;1;
/org.eclipse.ui.workbench/Eclipse UI/org/eclipse/ui/dialogs/WizardImportPage.java;1;0;1;1;0;0;0;1;0;0;1;2737;0;0;1;0;0;1;1;2737;0;2737;1;1;
/org.eclipse.core.tests.runtime/src/org/eclipse/core/tests/internal/plugins/PluginResolveTest_11.java;1;0;1;1;0;0;0;1;0;0;1;3014;0;0;1;0;0;1;1;3014;0;3014;1;1;
/org.eclipse.ui.workbench/Eclipse UI/org/eclipse/ui/internal/registry/NavigatorDescriptor.java;1;0;1;1;0;0;0;1;0;0;1;947;0;0;1;0;0;1;1;947;0;947;1;1;
/org.eclipse.osgi/core/framework/org/eclipse/osgi/framework/internal/core/BundlePermissions.java;5;2;8;1;4;3;4;4;594;1;4;3013;630;630;2;0;1;4;8;5116;1;6337;7;5;
/org.eclipse.jdt.ui.examples.javafamily/src/org/eclipse/jface/text/source/DefaultAnnotationAccess.java;1;0;3;1;0;0;0;3;7;2;2;1150;7;7;2;1;0;3;3;1150;1;1642;2;1;
/org.eclipse.core.tools/src/org/eclipse/core/tools/runtime/VMClassInfo.java;1;0;1;1;1;1;1;0;0;0;0;6302;0;0;1;0;0;0;1;6302;0;6302;1;1;
/org.eclipse.pde.build/src/org/eclipse/pde/internal/build/BuildScriptGeneratorApplication.java;2;0;5;1;0;0;0;5;0;1;5;447;0;0;1;0;0;5;5;447;0;1113;5;2;
/org.eclipse.pde.ui/src_Forms/org/eclipse/pde/internal/ui/model/plugin/PluginExtensionPointNode.java;3;1;8;1;5;5;5;3;36;1;3;4438;95;95;1;0;0;3;8;4438;0;6336;8;3;
/org.eclipse.ui.ide/src/org/eclipse/ui/internal/ide/misc/ProjectCapabilitySelectionGroup.java;1;0;1;1;0;0;0;1;0;0;1;2264;0;0;1;0;0;1;1;2264;0;2264;1;1;
/org.eclipse.jdt.core.tests.model/workspace/Converter/src/test0278/Test.java;1;0;1;1;0;0;0;1;0;0;1;3714;0;0;1;0;0;1;1;3714;0;3714;1;1;
/org.eclipse.jdt.debug.ui/ui/org/eclipse/jdt/internal/debug/ui/jres/AddVMDialog.java;4;0;9;2;0;0;0;9;151;2;8;1039;265;265;2;1;0;9;9;4834;1;4849;8;4;
/org.eclipse.jdt.core/antadapter/org/eclipse/jdt/core/CheckDebugAttributes.java;3;0;5;1;0;0;0;5;10;1;5;1580;20;20;1;0;0;5;5;1580;0;3578;5;3;
/org.eclipse.jdt.ui.tests.refactoring/resources/ExtractMethodWorkSpace/ExtractMethodTests/locals_out/A_test506.java;1;0;2;1;0;0;0;2;4;1;2;130;6;6;1;0;0;2;2;130;0;844;2;1;
/org.eclipse.core.runtime.osgi/src/org/eclipse/core/internal/registry/RegistryWriter.java;1;0;2;1;0;0;0;2;322;1;2;3013;322;322;1;0;0;2;2;3013;0;3030;2;1;
/org.eclipse.jdt.core/dom/org/eclipse/jdt/core/dom/BlockComment.java;2;0;7;1;1;1;1;6;37;1;6;3683;49;49;1;0;0;6;7;3683;0;5272;7;2;
/org.eclipse.jdt.core/dom/org/eclipse/jdt/core/dom/PackageBinding.java;2;0;3;1;0;0;0;3;4;1;3;173;8;8;1;0;0;3;3;173;0;3560;3;2;
/org.eclipse.jdt.core.tests.model/src/org/eclipse/jdt/core/tests/model/JavaSearchTests.java;4;3;47;2;10;6;10;37;821;3;25;543;3102;3102;3;12;4;37;47;2581;16;5938;31;4;
/org.eclipse.jdt.core.tests.model/workspace/Formatter/test033/A_in.java;1;0;1;1;0;0;0;1;0;0;1;2425;0;0;1;0;0;1;1;2425;0;2425;1;1;
/org.eclipse.ui.workbench/Eclipse UI/org/eclipse/ui/internal/layout/GridInfo.java;1;0;1;1;0;0;0;1;0;0;1;5003;0;0;1;0;0;1;1;5003;0;5003;1;1;
/org.eclipse.jdt.core.tests.model/workspace/Converter/src/test0401/A.java;1;0;1;1;0;0;0;1;0;0;1;3714;0;0;1;0;0;1;1;3714;0;3714;1;1;
/org.eclipse.jdt.core.tests.model/workspace/Converter/junit/runner/BaseTestRunner.java;1;0;2;1;0;0;0;2;139;1;2;787;139;139;1;0;0;2;2;787;0;3714;2;1;
/org.eclipse.ui.workbench/Eclipse UI/org/eclipse/ui/IEditorInput.java;2;0;3;1;0;0;0;3;44;1;3;1;52;52;1;0;0;3;3;1;0;2737;3;2;
/org.eclipse.ant.ui/Ant Editor/org/eclipse/ant/internal/ui/editor/templates/XMLContextType.java;1;0;2;1;0;0;0;2;0;1;2;4810;0;0;1;0;0;2;2;4810;0;4916;2;1;
/org.eclipse.ui.tests/Eclipse UI Tests/org/eclipse/ui/tests/TestPlugin.java;3;0;3;1;1;1;1;2;20;1;2;3012;40;40;1;0;0;2;3;3012;0;6338;3;3;
/org.eclipse.jdt.core.tests.model/workspace/Formatter/test328/A_in.java;1;0;1;1;0;0;0;1;0;0;1;2640;0;0;1;0;0;1;1;2640;0;2640;1;1;
/org.eclipse.swt/Eclipse SWT/gtk1x/org/eclipse/swt/graphics/Font.java;1;0;1;1;0;0;0;1;0;0;1;2327;0;0;1;0;0;1;1;2327;0;2327;1;1;
/org.eclipse.swt/Eclipse SWT/gtk/org/eclipse/swt/widgets/TabFolder.java;6;1;17;1;3;3;3;14;29;2;13;269;127;127;2;1;0;14;17;3093;1;6352;16;6;
/org.eclipse.ui.workbench.texteditor/src/org/eclipse/ui/internal/texteditor/IExpansionLayouter.java;1;0;1;1;0;0;0;1;0;0;1;2564;0;0;1;0;0;1;1;2564;0;2564;1;1;
/org.eclipse.core.runtime/src/org/eclipse/core/internal/jobs/ThreadJob.java;2;1;3;1;3;3;3;0;8;0;0;5444;14;14;1;0;0;0;3;5444;0;5536;3;2;
/org.eclipse.team.cvs.core/src/org/eclipse/team/internal/ccvs/core/resources/CVSLocalSyncElement.java;1;0;2;1;0;0;0;2;2;1;2;790;2;2;1;0;0;2;2;790;0;4216;2;1;
/org.eclipse.team.core/src/org/eclipse/team/internal/core/target/ITargetRunnable.java;1;0;1;1;0;0;0;1;0;0;1;2495;0;0;1;0;0;1;1;2495;0;2495;1;1;
/org.eclipse.help.tests/src/org/eclipse/help/tests/base/TestHelpSystem.java;1;1;3;1;2;2;2;1;16;0;1;2732;34;34;1;0;0;1;3;2732;0;6337;3;1;
/org.eclipse.swt.graphics.text/org.eclipse.swt.20031111/Eclipse SWT PI/gtk/org/eclipse/swt/internal/gtk/PangoLayoutRun.java;2;0;2;1;0;0;0;2;0;1;2;2805;0;0;1;0;0;2;2;2805;0;2937;2;2;
/org.eclipse.help.ui/src/org/eclipse/help/ui/browser/LaunchURL.java;1;1;6;1;4;4;4;2;35;1;2;1177;72;72;1;0;0;2;6;1177;0;6337;6;1;
/org.eclipse.debug.ui/ui/org/eclipse/debug/internal/ui/views/memory/MemoryViewTabLabelProvider.java;2;1;2;1;2;2;2;0;18;0;0;5254;18;18;1;0;0;0;2;5254;0;5701;2;2;
/org.eclipse.jdt.core/search/org/eclipse/jdt/core/search/SearchRequestor.java;2;1;6;1;4;4;4;2;68;1;2;3211;126;126;1;0;0;2;6;3211;0;5916;6;2;
/org.eclipse.jdt.ui/core refactoring/org/eclipse/jdt/internal/corext/refactoring/participants/IDeleteData.java;1;0;2;1;0;0;0;2;0;1;2;1668;0;0;1;0;0;2;2;1668;0;4624;2;1;
/org.eclipse.help.ide/src/org/eclipse/help/ui/internal/ide/HelpIdeResources.java;1;1;7;1;3;3;3;4;80;2;3;1778;122;122;2;1;0;4;7;1778;1;6337;6;1;
/org.eclipse.jdt.core.tests.model/workspace/Formatter/test460/A_in.java;1;0;1;1;0;0;0;1;0;0;1;3890;0;0;1;0;0;1;1;3890;0;3890;1;1;
/org.eclipse.pde.ui/src_Forms/org/eclipse/pde/internal/ui/neweditor/schema/SchemaSourceOutlinePage.java;1;0;2;1;0;0;0;2;0;1;2;4856;0;0;1;0;0;2;2;4856;0;4877;2;1;
/org.eclipse.pde.ui/src/org/eclipse/pde/internal/ui/editor/context/UTF8InputContext.java;2;1;3;1;3;3;3;0;10;0;0;5431;12;12;1;0;0;0;3;5431;0;6336;3;2;
/org.eclipse.update.configurator/src/org/eclipse/update/internal/configurator/branding/IBundleGroupConstants.java;1;0;2;1;1;1;1;1;6;0;1;4502;6;6;1;0;0;1;2;4502;0;5465;2;1;
/org.eclipse.ui.workbench/Eclipse UI/org/eclipse/ui/internal/progress/ProgressViewer.java;2;0;8;1;0;0;0;8;58;3;6;4133;128;128;3;2;0;8;8;4350;2;4764;6;2;
/org.eclipse.swt.graphics.text/org.eclipse.swt.20031111/Eclipse SWT/gtk/org/eclipse/swt/graphics/text/TextLayout.java;2;0;2;1;0;0;0;2;0;1;2;2805;0;0;1;0;0;2;2;2805;0;2937;2;2;
/org.eclipse.ui.workbench/Eclipse UI/org/eclipse/ui/internal/commands/registry/old/Context.java;1;0;3;1;0;0;0;3;2;2;2;1222;2;2;2;1;0;3;3;1321;1;1321;2;1;
/org.eclipse.update.ui.win32/src/org/eclipse/welcome/internal/IWebBrowserListener.java;1;0;2;1;0;0;0;2;0;1;2;892;0;0;1;0;0;2;2;892;0;907;2;1;
/org.eclipse.ui.workbench/Eclipse UI/org/eclipse/ui/internal/dialogs/ActivitiesPreferencePage.java;1;1;2;1;2;2;2;0;52;0;0;5636;52;52;1;0;0;0;2;5636;0;5997;2;1;
/org.eclipse.team.cvs.ui/src/org/eclipse/team/internal/ccvs/ui/model/AllRootsElement.java;1;0;1;1;0;0;0;1;2;0;1;990;2;2;1;0;0;1;1;990;0;990;1;1;
/org.eclipse.ui.workbench/Eclipse UI/org/eclipse/ui/internal/commands/registry/old/AbstractRegistry.java;1;0;2;1;0;0;0;2;0;1;2;1222;0;0;1;0;0;2;2;1222;0;1322;2;1;
/org.eclipse.pde.ui/src/org/eclipse/pde/internal/ui/editor/site/SiteFeatureAdapter.java;1;0;2;1;1;1;1;1;10;0;1;3721;10;10;1;0;0;1;2;3721;0;6336;2;1;
/org.eclipse.jdt.ui.tests.refactoring/resources/MoveMembers/test31/out/B.java;1;0;2;1;0;0;0;2;1;1;2;1651;1;1;1;0;0;2;2;1651;0;1683;2;1;
/org.eclipse.text/src/org/eclipse/jface/text/source/IAnnotationAdapter.java;1;0;1;1;0;0;0;1;0;0;1;2815;0;0;1;0;0;1;1;2815;0;2815;1;1;
/org.eclipse.jdt.core.tests.model/workspace/Converter/test0219/Test.java;1;0;1;1;0;0;0;1;0;0;1;3714;0;0;1;0;0;1;1;3714;0;3714;1;1;
/org.eclipse.update.ui.forms/src/org/eclipse/ui/forms/internal/parts/IObjectReference.java;1;0;2;1;0;0;0;2;0;1;2;2898;0;0;1;0;0;2;2;2898;0;3071;2;1;
/org.eclipse.jdt.core.tests.model/src/org/eclipse/jdt/core/tests/model/DeleteTests.java;2;0;10;1;1;1;1;9;523;2;7;1107;716;716;2;2;0;9;10;1107;2;5397;8;2;
/org.eclipse.jdt.debug.jdi.tests/tests/org/eclipse/debug/jdi/tests/MirrorTest.java;1;0;1;1;0;0;0;1;2;0;1;1320;2;2;1;0;0;1;1;1320;0;1320;1;1;
/org.eclipse.jdt.ui.tests.refactoring/resources/Move/testDestination_no_methodToItself/in/A.java;1;0;1;1;0;0;0;1;0;0;1;841;0;0;1;0;0;1;1;841;0;841;1;1;
/org.eclipse.swt/Eclipse SWT PI/motif/org/eclipse/swt/internal/motif/XColor.java;1;0;1;1;0;0;0;1;4;0;1;829;4;4;1;0;0;1;1;829;0;829;1;1;
/org.eclipse.help/src/org/eclipse/help/HelpSystem.java;1;1;7;1;3;3;3;4;78;1;4;1748;146;146;1;0;0;4;7;1748;0;6337;7;1;
/org.eclipse.jdt.ui.tests/examples/org/eclipse/jdt/ui/examples/AddTestMarkersAction.java;2;0;3;1;1;1;1;2;47;1;2;4922;55;55;1;0;0;2;3;4922;0;6340;3;2;
/org.eclipse.jdt.core.tests.model/workspace/Formatter/test067/A_out.java;1;0;1;1;0;0;0;1;0;0;1;2425;0;0;1;0;0;1;1;2425;0;2425;1;1;
/org.eclipse.team.ui/src/org/eclipse/team/internal/ui/synchronize/compare/SyncInfoSetCompareInput.java;1;0;1;1;0;0;0;1;0;0;1;3297;0;0;1;0;0;1;1;3297;0;3297;1;1;
/org.eclipse.jdt.core/model/org/eclipse/jdt/core/ICompilationUnit.java;4;3;31;1;5;3;5;26;418;2;21;818;1042;1042;3;5;2;26;31;5268;7;5871;24;4;
/org.eclipse.jdt.core.tests.model/workspace/Converter/src/javadoc/test103/Test.java;1;0;1;1;0;0;0;1;0;0;1;4390;0;0;1;0;0;1;1;4390;0;4390;1;1;
/org.eclipse.ui.externaltools/Ant Tools Support/org/eclipse/ui/externaltools/internal/ant/launchConfigurations/AntLaunchConfigurationMessages.java;1;0;1;1;0;0;0;1;0;0;1;282;0;0;1;0;0;1;1;282;0;282;1;1;
/org.eclipse.jdt.ui.tests.refactoring/resources/ExtractMethodWorkSpace/ExtractMethodTests/return_in/A_test727.java;1;0;2;1;0;0;0;2;4;1;2;130;8;8;1;0;0;2;2;130;0;844;2;1;
/org.eclipse.jdt.core.tests.model/workspace/Formatter/test374/A_out.java;1;0;2;1;0;0;0;2;1;1;2;3146;1;1;1;0;0;2;2;3146;0;3172;2;1;
/org.eclipse.ui.tests/Eclipse UI Tests/org/eclipse/ui/tests/stress/OpenCloseTestSuite.java;2;0;2;1;1;1;1;1;2;0;1;4872;2;2;1;0;0;1;2;4872;0;6338;2;2;
/org.eclipse.core.tests.resources/src/org/eclipse/core/tests/internal/resources/WorkspaceConcurrencyTest.java;2;1;5;1;3;3;3;2;157;0;1;5085;211;211;2;1;0;2;5;5085;1;5786;4;2;
/org.eclipse.swt/Eclipse SWT/emulated/trayicon/org/eclipse/swt/widgets/TrayIcon.java;3;0;6;2;0;0;0;6;14;3;3;4446;26;26;3;3;0;6;6;4446;3;4519;3;3;
/org.eclipse.jdt.core/compiler/org/eclipse/jdt/internal/compiler/ast/JavadocAllocationExpression.java;4;0;11;2;0;0;0;11;26;2;10;2887;110;110;2;1;0;11;11;2915;1;3917;10;4;
/org.eclipse.core.runtime/src/org/eclipse/core/internal/runtime/AssertionFailedException.java;2;1;5;1;2;2;2;3;70;1;3;3013;144;144;1;0;0;3;5;3013;0;6340;5;2;
/org.eclipse.core.tests.runtime/src/org/eclipse/core/tests/internal/plugin/a/BaseExtension.java;1;1;2;1;2;2;2;0;21;0;0;5149;23;23;1;0;0;0;2;5149;0;5686;2;1;
/org.eclipse.swt.tests/JUnit Tests/org/eclipse/swt/tests/junit/Test_org_eclipse_swt_widgets_CoolBar.java;1;0;1;1;0;0;0;1;64;0;1;2105;64;64;1;0;0;1;1;2105;0;2105;1;1;
/org.eclipse.jdt.ui/ui/org/eclipse/jdt/internal/ui/callhierarchy/CallHierarchyLabelDecorator.java;3;0;4;1;1;1;1;3;5;1;3;236;11;11;1;0;0;3;4;236;0;6340;4;3;
/org.eclipse.ui.cheatsheets/src/org/eclipse/ui/internal/cheatsheets/views/NoopAction.java;2;0;2;1;0;0;0;2;17;1;2;4428;17;17;1;0;0;2;2;4428;0;4626;2;2;
/org.eclipse.jdt.ui/ui/org/eclipse/jdt/internal/ui/search/ReferenceScopeFactory.java;1;1;4;1;2;2;2;2;164;1;2;3940;177;177;1;0;0;2;4;3940;0;5531;4;1;
/org.eclipse.swt.tools/JNI Generation/org/eclipse/swt/tools/internal/JNIGenerator.java;2;0;3;1;0;0;0;3;86;1;3;4175;103;103;1;0;0;3;3;4175;0;4874;3;2;
/org.eclipse.ui.workbench/Eclipse UI/org/eclipse/ui/internal/roles/RoleBuildingUIFactory.java;2;0;2;1;0;0;0;2;0;1;2;2279;0;0;1;0;0;2;2;2279;0;2443;2;2;
/org.eclipse.update.ui/src/org/eclipse/update/internal/ui/wizards/NewSearchWizardPage.java;1;0;1;1;0;0;0;1;0;0;1;755;0;0;1;0;0;1;1;755;0;755;1;1;
/org.eclipse.ui.workbench/Eclipse UI/org/eclipse/ui/internal/skins/NativeStackPresentation.java;2;0;2;2;0;0;0;2;0;0;1;4467;0;0;2;1;0;2;2;4467;1;4467;1;2;
/org.eclipse.jdt.core.tests.model/workspace/Converter/src/test0476/A.java;1;0;1;1;0;0;0;1;0;0;1;3714;0;0;1;0;0;1;1;3714;0;3714;1;1;
/org.eclipse.core.tests.resources/src/org/eclipse/core/tests/internal/localstore/RefreshLocalPerformanceTest.java;1;0;2;1;2;1;2;0;192;0;0;5147;192;192;2;0;1;0;2;5147;1;5147;1;1;
/org.eclipse.jdt.core.tests.model/workspace/Converter/src/test0267/Test.java;1;0;1;1;0;0;0;1;0;0;1;3714;0;0;1;0;0;1;1;3714;0;3714;1;1;
/org.eclipse.ui.workbench/Eclipse UI/org/eclipse/ui/intro/IIntroManager.java;2;2;7;2;6;5;6;1;103;0;1;4991;146;146;2;0;1;1;7;5206;1;5438;6;2;
/org.eclipse.update.ui/src/org/eclipse/update/internal/ui/views/UninstallFeatureAction.java;3;1;14;1;3;3;3;11;49;2;10;825;128;128;2;1;0;11;14;1629;1;6336;13;3;
/org.eclipse.jdt.ui/ui/org/eclipse/jdt/ui/wizards/BuildPathDialogAccess.java;1;3;6;1;6;4;6;0;324;0;0;5129;492;492;3;0;2;0;6;5129;2;6334;4;1;
/org.eclipse.ui.views/src/org/eclipse/ui/views/navigator/CollapseAllAction.java;1;0;1;1;0;0;0;1;0;0;1;2738;0;0;1;0;0;1;1;2738;0;2738;1;1;
/org.eclipse.ui.examples.javaeditor/Template Editor Example/org/eclipse/ui/examples/templateeditor/editors/XMLTagScanner.java;2;0;2;1;1;1;1;1;10;0;1;4644;14;14;1;0;0;1;2;4644;0;6340;2;2;
/org.eclipse.core.runtime.osgi/src/org/eclipse/core/internal/registry/BundleModel.java;1;0;3;1;0;0;0;3;100;2;2;3013;100;100;2;1;0;3;3;3030;1;3030;2;1;
/org.eclipse.jdt.ui.tests.refactoring/resources/DeleteSourceReference/test12/in/A.java;1;0;1;1;0;0;0;1;0;0;1;1652;0;0;1;0;0;1;1;1652;0;1652;1;1;
/org.eclipse.pde.ui/templates_3.0/helloWorld/java/$className$.java;1;0;1;1;0;0;0;1;0;0;1;2786;0;0;1;0;0;1;1;2786;0;2786;1;1;
/org.eclipse.jdt.debug/model/org/eclipse/jdt/internal/debug/core/logicalstructures/LogicalStructuresMessages.java;2;0;2;1;0;0;0;2;11;1;2;2648;11;11;1;0;0;2;2;2648;0;3096;2;2;
/org.eclipse.jdt.core/search/org/eclipse/jdt/internal/core/search/indexing/IndexAllProject.java;4;1;20;2;2;2;2;18;50;2;13;937;151;151;2;5;0;18;20;937;5;6099;15;4;
/org.eclipse.core.runtime/src/org/eclipse/core/runtime/IPluginConverter.java;1;0;2;1;0;0;0;2;0;1;2;3087;0;0;1;0;0;2;2;3087;0;3169;2;1;
/org.eclipse.ui.workbench/Eclipse UI/org/eclipse/ui/internal/CyclePartAction.java;7;2;33;2;4;3;4;29;602;5;25;217;1104;1104;5;4;1;29;33;2562;5;6338;28;7;
/org.eclipse.core.tests.resources/src/org/eclipse/core/tests/resources/regression/PR_1GH2B0N_Test.java;1;1;2;1;2;2;2;0;92;0;0;5147;94;94;1;0;0;0;2;5147;0;5408;2;1;
/org.eclipse.core.tests.runtime/src/org/eclipse/core/tests/plugintests/CmdLineAndStateAndPluginLocalTest.java;1;0;1;1;0;0;0;1;0;0;1;3014;0;0;1;0;0;1;1;3014;0;3014;1;1;
/org.eclipse.team.ui/src/org/eclipse/team/ui/synchronize/SyncChangesViewer.java;1;0;1;1;0;0;0;1;0;0;1;3221;0;0;1;0;0;1;1;3221;0;3221;1;1;
/org.eclipse.team.ui/src/org/eclipse/team/internal/ui/target/DiscardSiteAction.java;2;0;2;1;0;0;0;2;2;1;2;990;2;2;1;0;0;2;2;990;0;2495;2;2;
/org.eclipse.ui.editors/src/org/eclipse/ui/texteditor/ExtendedTextEditor.java;3;3;19;2;6;3;6;13;1134;1;13;2080;2340;2340;3;0;3;13;19;5124;3;5181;16;3;
/org.eclipse.text/src/org/eclipse/jface/text/AbstractDocument.java;3;1;10;1;3;3;3;7;284;1;7;1347;788;788;1;0;0;7;10;1347;0;6298;10;3;
/org.eclipse.team.ui/src/org/eclipse/team/internal/ui/widgets/ILayoutExtension.java;1;0;1;1;0;0;0;1;0;0;1;3176;0;0;1;0;0;1;1;3176;0;3176;1;1;
/org.eclipse.jdt.core/compiler/org/eclipse/jdt/internal/compiler/ast/ParameterizedMessageSend.java;1;0;1;1;0;0;0;1;0;0;1;2729;0;0;1;0;0;1;1;2729;0;2729;1;1;
/org.eclipse.jdt.ui/core refactoring/org/eclipse/ltk/core/refactoring/IRefactoringCoreStatusCodes.java;1;0;3;1;0;0;0;3;6;1;3;4624;6;6;1;0;0;3;3;4624;0;4864;3;1;
/org.eclipse.jdt.ui/ui/org/eclipse/jdt/ui/actions/OpenViewActionGroup.java;4;1;4;1;2;2;2;2;21;1;2;237;43;43;1;0;0;2;4;237;0;6340;4;4;
/org.eclipse.ui.tests/UI Test Utils/org/eclipse/ui/tests/util/EmptyPerspective.java;2;1;3;1;3;3;3;0;7;0;0;5687;11;11;1;0;0;0;3;5687;0;6338;3;2;
/org.eclipse.ui.forms.examples/src/org/eclipse/ui/forms/examples/internal/rcp/SimpleModel.java;1;0;2;1;1;1;1;1;16;0;1;4075;16;16;1;0;0;1;2;4075;0;5781;2;1;
/org.eclipse.text/projection/org/eclipse/jface/text/CoordinatesTranslator.java;1;0;3;1;1;1;1;2;8;1;2;3217;9;9;1;0;0;2;3;3217;0;5177;3;1;
/org.eclipse.ui.workbench/Eclipse UI/org/eclipse/ui/internal/csm/activities/ActivityLabelProvider.java;1;0;2;1;0;0;0;2;0;0;1;2443;0;0;2;1;0;2;2;2443;1;2443;1;1;
/org.eclipse.jdt.core/compiler/org/eclipse/jdt/internal/compiler/env/IBinaryNestedType.java;1;0;1;1;0;0;0;1;2;0;1;3560;2;2;1;0;0;1;1;3560;0;3560;1;1;
/org.eclipse.swt/Eclipse SWT/common/org/eclipse/swt/events/MouseEvent.java;1;0;1;1;0;0;0;1;16;0;1;2729;16;16;1;0;0;1;1;2729;0;2729;1;1;
/org.eclipse.team.ui/src/org/eclipse/team/internal/ui/target/ConfigureTargetWizard.java;2;0;4;1;0;0;0;4;15;1;4;866;23;23;1;0;0;4;4;866;0;2495;4;2;
/org.eclipse.ui.ide/extensions/org/eclipse/ui/actions/OpenWithMenu.java;4;1;4;1;2;2;2;2;12;1;2;2263;16;16;1;0;0;2;4;2263;0;6338;4;4;
/org.eclipse.jdt.core/compiler/org/eclipse/jdt/internal/compiler/ast/LongLiteral.java;2;0;2;1;0;0;0;2;4;1;2;2974;6;6;1;0;0;2;2;2974;0;3560;2;2;
/org.eclipse.jdt.core.tests.model/workspace/Converter/src/test0471/A.java;1;0;1;1;0;0;0;1;0;0;1;3714;0;0;1;0;0;1;1;3714;0;3714;1;1;
/org.eclipse.jdt.ui/ui/org/eclipse/jdt/internal/ui/packageview/ClassPathContainer.java;3;1;8;1;4;4;4;4;75;1;4;730;149;149;1;0;0;4;8;730;0;6340;8;3;
/org.eclipse.ui.views/src/org/eclipse/ui/views/internal/table/FiltersAction.java;1;0;2;1;0;0;0;2;0;0;1;749;0;0;2;1;0;2;2;749;1;749;1;1;
/org.eclipse.team.webdav/src/org/eclipse/team/internal/core/target/DeploymentProviderDescriptor.java;1;0;2;1;1;1;1;1;2;0;1;4633;2;2;1;0;0;1;2;4633;0;6337;2;1;
/org.eclipse.search.tests/src/org/eclipse/search/tests/AllSearchTests.java;1;0;1;1;0;0;0;1;0;0;1;4345;0;0;1;0;0;1;1;4345;0;4345;1;1;
/org.eclipse.ui.workbench.texteditor/src/org/eclipse/ui/internal/texteditor/NextPreviousPulldownActionDelegate.java;2;0;4;1;0;0;0;4;42;1;4;1507;69;69;1;0;0;4;4;1507;0;2741;4;2;
/org.eclipse.sdk.tests-feature/plugins/org.eclipse.perfmsr.ui.client/src/org/eclipse/perfmsr/ui/client/SAXReader.java;1;1;3;1;3;3;3;0;10;0;0;5443;10;10;1;0;0;0;3;5443;0;5661;3;1;
/org.eclipse.osgi/defaultAdaptor/src/org/eclipse/osgi/framework/internal/defaultadaptor/DevClassPathHelper.java;2;1;5;1;3;3;3;2;14;1;2;4564;23;23;1;0;0;2;5;4564;0;5507;5;2;
/org.eclipse.pde.ui/src/org/eclipse/pde/internal/ui/editor/ModelUndoManager.java;2;1;4;1;3;3;3;1;16;0;1;2906;35;35;1;0;0;1;4;2906;0;6336;4;2;
/org.eclipse.ui.tests/Eclipse JFace Tests/org/eclipse/jface/tests/viewers/TestModelContentProvider.java;2;0;2;1;1;1;1;1;5;0;1;5004;7;7;1;0;0;1;2;5004;0;6338;2;2;
/org.eclipse.jdt.ui.tests.refactoring/resources/MoveInnerToTopLevel/test_nonstatic_32/out/Inner.java;2;0;2;1;1;1;1;1;8;0;1;305;10;10;1;0;0;1;2;305;0;5854;2;2;
/org.eclipse.help.base/src/org/eclipse/help/browser/IBrowserFactory.java;1;1;4;1;2;2;2;2;16;1;2;1740;24;24;1;0;0;2;4;1740;0;6337;4;1;
/org.eclipse.ant.ui/Ant Tools Support/org/eclipse/ant/ui/internal/console/TaskLineTracker.java;1;0;2;1;0;0;0;2;0;1;2;250;0;0;1;0;0;2;2;250;0;1811;2;1;
/org.eclipse.jdt.core.tests.model/workspace/Converter/test0026/Test.java;1;0;1;1;0;0;0;1;0;0;1;3714;0;0;1;0;0;1;1;3714;0;3714;1;1;
/org.eclipse.jdt.core.tests.model/workspace/Converter/src/test0234/Test.java;1;0;1;1;0;0;0;1;0;0;1;3714;0;0;1;0;0;1;1;3714;0;3714;1;1;
/org.eclipse.swt/Eclipse SWT/gtk1x/org/eclipse/swt/widgets/Tree.java;2;0;2;1;0;0;0;2;5;1;2;110;5;5;1;0;0;2;2;110;0;2327;2;2;
/org.eclipse.ant.tests.core/test plugin/org/eclipse/ant/tests/core/testplugin/AntTestPropertyValueProvider.java;1;0;1;1;0;0;0;1;0;0;1;1402;0;0;1;0;0;1;1;1402;0;1402;1;1;
/org.eclipse.jdt.core.tests.model/workspace/Formatter/test077/A_out.java;1;0;1;1;0;0;0;1;0;0;1;2425;0;0;1;0;0;1;1;2425;0;2425;1;1;
/org.eclipse.jdt.core/model/org/eclipse/jdt/internal/core/PackageFragment.java;3;1;30;1;4;4;4;26;151;2;25;130;493;493;2;1;0;26;30;818;1;5916;29;3;
/org.eclipse.jdt.core.tests.model/workspace/Converter/test0449/A.java;1;0;1;1;0;0;0;1;0;0;1;3714;0;0;1;0;0;1;1;3714;0;3714;1;1;
/org.eclipse.ui.examples.javaeditor/Eclipse Java Editor Example/org/eclipse/ui/examples/javaeditor/JavaSourceViewerConfiguration.java;2;0;3;1;1;1;1;2;38;1;2;1349;42;42;1;0;0;2;3;1349;0;6340;3;2;
/org.eclipse.jdt.ui.tests.refactoring/resources/RenamePackage/testImportFromMultiRoots4/out/srcTest/p/ATest.java;1;0;2;1;0;0;0;2;14;1;2;3219;14;14;1;0;0;2;2;3219;0;4105;2;1;
/org.eclipse.ant.ui/Ant Tools Support/org/eclipse/ant/internal/ui/launchConfigurations/TargetOrderDialog.java;1;0;7;1;0;0;0;7;95;2;5;1811;124;124;2;2;0;7;7;1841;2;3942;5;1;
/org.eclipse.swt.tools/JNI Generation/org/eclipse/swt/tools/internal/JNIGeneratorApp.java;3;2;8;2;3;2;3;5;84;2;4;4175;161;161;2;1;1;5;8;4270;2;5406;6;3;
/org.eclipse.team.ui/src/org/eclipse/team/ui/synchronize/viewers/CompressedFolderDiffNodeBuilder.java;1;0;1;1;0;0;0;1;0;0;1;3972;0;0;1;0;0;1;1;3972;0;3972;1;1;
/org.eclipse.jdt.core/antadapter/org/eclipse/jdt/internal/antadapter/Messages.java;2;0;3;2;0;0;0;3;2;2;2;536;2;2;2;1;0;3;3;546;1;546;2;2;
/org.eclipse.team.webdav/src/org/eclipse/team/internal/core/target/TargetManager.java;2;0;3;1;1;1;1;2;34;1;2;2495;36;36;1;0;0;2;3;2495;0;6337;3;2;
/org.eclipse.jdt.ui/ui/org/eclipse/jdt/internal/ui/text/FastJavaPartitionScanner.java;2;0;2;1;1;1;1;1;24;0;1;4365;26;26;1;0;0;1;2;4365;0;6340;2;2;
/org.eclipse.jdt.ui/ui/org/eclipse/jdt/internal/ui/wizards/NewProjectCreationWizardPage.java;1;0;1;1;0;0;0;1;0;0;1;3830;0;0;1;0;0;1;1;3830;0;3830;1;1;
/org.eclipse.ui.views/src/org/eclipse/ui/views/markers/internal/FieldResource.java;2;0;2;1;0;0;0;2;0;1;2;755;0;0;1;0;0;2;2;755;0;2738;2;2;
/org.eclipse.jdt.core.tests.model/workspace/Formatter/test018/A_in.java;1;0;1;1;0;0;0;1;0;0;1;2425;0;0;1;0;0;1;1;2425;0;2425;1;1;
/org.eclipse.update.ui/src/org/eclipse/update/internal/ui/properties/SearchObjectPropertyPage.java;1;0;1;1;0;0;0;1;0;0;1;794;0;0;1;0;0;1;1;794;0;794;1;1;
/org.eclipse.update.ui/src/org/eclipse/update/internal/ui/wizards/TableLayoutComposite.java;1;1;2;1;2;2;2;0;6;0;0;6036;6;6;1;0;0;0;2;6036;0;6336;2;1;
/org.eclipse.ltk.core.refactoring/src/org/eclipse/ltk/internal/core/refactoring/UndoDocumentChange.java;1;1;3;1;2;2;2;1;3;0;1;4913;5;5;1;0;0;1;3;4913;0;6340;3;1;
/org.eclipse.jdt.ui/ui/org/eclipse/jdt/internal/ui/text/correction/AddArgumentCorrectionProposal.java;2;1;15;1;2;2;2;13;23;2;12;991;115;115;2;1;0;13;15;1152;1;6340;14;2;
/org.eclipse.swt/Eclipse SWT/gtk/org/eclipse/swt/widgets/ProgressBar.java;5;1;9;1;3;3;3;6;18;1;6;269;65;65;1;0;0;6;9;269;0;6352;9;5;
/org.eclipse.team.cvs.ui/src/org/eclipse/team/internal/ccvs/ui/subscriber/WorkspaceParticipantActionContributions.java;1;0;1;1;0;0;0;1;0;0;1;5039;0;0;1;0;0;1;1;5039;0;5039;1;1;
/org.eclipse.ui.workbench/Eclipse UI/org/eclipse/ui/internal/chris/roles/RoleDefinition.java;1;0;4;1;0;0;0;4;2;2;3;1952;4;4;2;1;0;4;4;2207;1;2207;3;1;
/org.eclipse.pde.ui/src/org/eclipse/pde/internal/ui/editor/feature/RequiredFeaturesWizard.java;2;1;3;1;2;2;2;1;4;0;1;4203;7;7;1;0;0;1;3;4203;0;6336;3;2;
/org.eclipse.jdt.ui/ui/org/eclipse/jdt/internal/ui/javaeditor/selectionactions/StructureSelectPreviousAction.java;3;1;3;1;3;3;3;0;34;0;0;6059;46;46;1;0;0;0;3;6059;0;6340;3;3;
/org.eclipse.swt/Eclipse SWT Drag and Drop/photon/org/eclipse/swt/dnd/DropTarget.java;2;0;2;1;0;0;0;2;5;1;2;0;9;9;1;0;0;2;2;0;0;269;2;2;
/org.eclipse.team.core/src/org/eclipse/team/internal/core/subscribers/caches/SessionSynchronizationCache.java;1;0;1;1;0;0;0;1;0;0;1;3966;0;0;1;0;0;1;1;3966;0;3966;1;1;
/org.eclipse.jdt.ui/core refactoring/org/eclipse/jdt/internal/corext/refactoring/code/flow/BranchFlowInfo.java;1;0;1;1;1;1;1;0;2;0;0;6340;2;2;1;0;0;0;1;6340;0;6340;1;1;
/org.eclipse.ant.ui/Ant Editor/org/eclipse/ant/ui/internal/dtd/util/SortedMap.java;1;0;2;1;0;0;0;2;0;1;2;250;0;0;1;0;0;2;2;250;0;1811;2;1;
/org.eclipse.ltk.ui.refactoring/src/org/eclipse/ltk/ui/refactoring/RefactoringWizardDialog2.java;1;0;3;1;0;0;0;3;14;1;3;4965;14;14;1;0;0;3;3;4965;0;5052;3;1;
/org.eclipse.update.ui.win32/src/org/eclipse/welcome/internal/WelcomeEditorInput.java;1;0;2;1;0;0;0;2;0;1;2;892;0;0;1;0;0;2;2;892;0;907;2;1;
/org.eclipse.jdt.ui/ui refactoring/org/eclipse/jdt/internal/ui/refactoring/ChangeElementContentProvider.java;1;0;14;1;0;0;0;14;59;2;12;130;152;152;2;2;0;14;14;1952;2;4965;12;1;
/org.eclipse.ui.editors/extensions/org/eclipse/ui/internal/SystemSummaryDocumentProvider.java;3;0;3;1;0;0;0;3;15;1;3;29;17;17;1;0;0;3;3;29;0;2741;3;3;
/org.eclipse.core.resources/src/org/eclipse/core/internal/resources/MoveDeleteHook.java;1;0;1;1;1;1;1;0;98;0;0;5146;98;98;1;0;0;0;1;5146;0;5146;1;1;
/org.eclipse.jdt.core/model/org/eclipse/jdt/core/CompletionRequestorAdapter.java;2;0;4;1;0;0;0;4;14;1;4;1806;21;21;1;0;0;4;4;1806;0;5063;4;2;
/org.eclipse.jdt.ui/core refactoring/org/eclipse/jdt/internal/corext/refactoring/participants/xml/FolderExtender.java;1;0;4;1;0;0;0;4;8;1;4;2546;10;10;1;0;0;4;4;2546;0;4941;4;1;
/org.eclipse.update.core/src/org/eclipse/update/core/ISiteContentProvider.java;2;1;3;1;2;2;2;1;6;0;1;890;14;14;1;0;0;1;3;890;0;6336;3;2;
/org.eclipse.update.tests.core/src/org/eclipse/update/tests/api/TestDefaultPackageFeatureAPI.java;1;1;3;1;2;2;2;1;32;0;1;4928;42;42;1;0;0;1;3;4928;0;6336;3;1;
/org.eclipse.jdt.ui/core extension/org/eclipse/jdt/internal/corext/callhierarchy/CallHierarchyMessages.java;2;0;2;1;1;1;1;1;2;0;1;171;2;2;1;0;0;1;2;171;0;6340;2;2;
/org.eclipse.help.webapp/src_servlets/org/eclipse/help/internal/webapp/servlet/SearchServlet.java;1;1;10;1;3;3;3;7;92;1;7;106;301;301;1;0;0;7;10;106;0;6337;10;1;
/org.eclipse.compare/compare/org/eclipse/compare/structuremergeviewer/DiffNode.java;1;0;3;1;1;1;1;2;10;1;2;1289;14;14;1;0;0;2;3;1289;0;5199;3;1;
/org.eclipse.pde.ui/src/org/eclipse/pde/internal/ui/editor/manifest/ManifestFormPage.java;1;0;1;1;1;1;1;0;0;0;0;5431;0;0;1;0;0;0;1;5431;0;5431;1;1;
/org.eclipse.ui.tests/Eclipse UI Tests/org/eclipse/ui/tests/intro/MockIntroPart.java;1;0;2;1;1;1;1;1;15;0;1;4649;15;15;1;0;0;1;2;4649;0;5533;2;1;
/org.eclipse.jdt.core.tests.model/workspace/Converter/src/test0465/A.java;1;0;1;1;0;0;0;1;0;0;1;3714;0;0;1;0;0;1;1;3714;0;3714;1;1;
/org.eclipse.update.core/srcnew/org/eclipse/update/internal/search/IUpdateSearchSite.java;1;0;2;1;0;0;0;2;0;0;1;572;0;0;2;1;0;2;2;572;1;572;1;1;
/org.eclipse.pde.ui/templates/editor/java/$editorClass$.java;1;0;1;1;0;0;0;1;10;0;1;851;10;10;1;0;0;1;1;851;0;851;1;1;
/org.eclipse.jdt.ui.tests.refactoring/resources/DeleteSourceReference/test6/out/A.java;1;0;1;1;0;0;0;1;0;0;1;1652;0;0;1;0;0;1;1;1652;0;1652;1;1;
/org.eclipse.team.cvs.ui/src/org/eclipse/team/internal/ccvs/ui/console/CVSOutputConsole.java;2;1;9;1;3;3;3;6;229;1;6;2178;603;603;1;0;0;6;9;2178;0;6337;9;2;
/org.eclipse.core.runtime.compatibility/src-runtime/org/eclipse/core/internal/plugins/ComputeNodeOrder.java;2;0;2;1;0;0;0;2;0;1;2;3013;0;0;1;0;0;2;2;3013;0;4678;2;2;
/org.eclipse.jdt.ui.tests.refactoring/resources/MoveInnerToTopLevel/test_nonstatic_8/out/Inner.java;2;0;2;1;1;1;1;1;2;0;1;305;4;4;1;0;0;1;2;305;0;5854;2;2;
/org.eclipse.jdt.ui/ui/org/eclipse/jdt/internal/ui/preferences/formatter/OtherSettingsTabPage.java;1;0;7;1;0;0;0;7;58;1;7;3110;88;88;1;0;0;7;7;3110;0;3612;7;1;
/org.eclipse.jdt.ui/ui/org/eclipse/jdt/internal/ui/text/correction/IAssistProcessor.java;1;0;5;1;0;0;0;5;14;1;5;1011;38;38;1;0;0;5;5;1011;0;1232;5;1;
/org.eclipse.jdt.core.tests.model/workspace/Formatter/test482/A_in.java;1;0;1;1;0;0;0;1;0;0;1;4173;0;0;1;0;0;1;1;4173;0;4173;1;1;
/org.eclipse.ui.ide/src/org/eclipse/ui/views/markers/internal/IDeferredTableContentProvider.java;1;0;1;1;0;0;0;1;0;0;1;3214;0;0;1;0;0;1;1;3214;0;3214;1;1;
/org.eclipse.swt/Eclipse SWT PI/carbon/org/eclipse/swt/internal/carbon/CGPoint.java;1;2;3;1;3;2;3;0;16;0;0;5534;20;20;2;0;1;0;3;5534;1;5614;2;1;
/org.eclipse.core.tests.runtime/src/org/eclipse/core/tests/plugintests/CmdLineAndStateAndPluginLocalAndPrimaryFeatureTest.java;1;0;1;1;0;0;0;1;0;0;1;3014;0;0;1;0;0;1;1;3014;0;3014;1;1;
/org.eclipse.swt/Eclipse SWT/photon/org/eclipse/swt/graphics/Image.java;4;1;7;1;3;3;3;4;12;1;4;0;37;37;1;0;0;4;7;0;0;6352;7;4;
/org.eclipse.ui.workbench.texteditor/src/org/eclipse/ui/texteditor/MarkerUpdater.java;1;0;1;1;0;0;0;1;0;0;1;2741;0;0;1;0;0;1;1;2741;0;2741;1;1;
/org.eclipse.jdt.ui.tests/ui/org/eclipse/jdt/ui/tests/callhierarchy/CallHierarchyTestHelper.java;5;1;8;1;3;3;3;5;28;1;5;329;111;111;1;0;0;5;8;329;0;6340;8;5;
/org.eclipse.ui.views/src/org/eclipse/ui/views/bookmarkexplorer/CopyBookmarkAction.java;1;0;1;1;0;0;0;1;0;0;1;2738;0;0;1;0;0;1;1;2738;0;2738;1;1;
/org.eclipse.jdt.debug.tests/tests/org/eclipse/jdt/debug/tests/eval/BooleanOperatorsTests.java;1;0;1;1;0;0;0;1;8;0;1;1274;8;8;1;0;0;1;1;1274;0;1274;1;1;
/org.eclipse.pde.ui/src/org/eclipse/pde/internal/ui/wizards/project/NewFragmentProjectWizard.java;1;0;1;1;0;0;0;1;0;0;1;3840;0;0;1;0;0;1;1;3840;0;3840;1;1;
/org.eclipse.jdt.ui/core refactoring/org/eclipse/jdt/internal/corext/refactoring/structure/ExtractInterfaceRefactoring.java;6;1;43;2;6;6;6;37;543;4;29;218;838;838;4;8;0;37;43;1946;8;6340;35;6;
/org.eclipse.jdt.ui/ui/org/eclipse/jdt/internal/ui/text/JavaAnnotationHover.java;3;1;9;1;2;2;2;7;138;1;7;1706;261;261;1;0;0;7;9;1706;0;6340;9;3;
/org.eclipse.jdt.ui/core refactoring/org/eclipse/jdt/internal/corext/refactoring/participants/xml/CompositeExpression.java;1;0;8;1;0;0;0;8;28;1;8;1033;106;106;1;0;0;8;8;1033;0;4108;8;1;
/org.eclipse.team.ftp/src/org/eclipse/team/internal/ftp/target/FTPSite.java;2;0;4;1;1;1;1;3;16;1;3;866;33;33;1;0;0;3;4;866;0;6337;4;2;
/org.eclipse.jdt.core/compiler/org/eclipse/jdt/internal/compiler/ast/EqualExpression.java;3;0;8;1;0;0;0;8;54;1;8;162;172;172;1;0;0;8;8;162;0;4910;8;3;
/org.eclipse.ui.workbench/Eclipse UI/org/eclipse/ui/internal/progress/AnimateJob.java;1;0;6;1;0;0;0;6;33;1;6;425;70;70;1;0;0;6;6;425;0;1193;6;1;
/org.eclipse.jdt.ui.tests.refactoring/resources/MoveInstanceMethod/canMove/test20/out/A.java;1;0;1;1;0;0;0;1;0;0;1;1586;0;0;1;0;0;1;1;1586;0;1586;1;1;
/org.eclipse.ui.views/src/org/eclipse/ui/views/internal/markers/CopyMarkerAction.java;1;0;2;1;0;0;0;2;0;1;2;265;0;0;1;0;0;2;2;265;0;749;2;1;
/org.eclipse.jdt.core.tests.model/workspace/Converter/src/test0291/Test.java;1;0;1;1;0;0;0;1;0;0;1;3714;0;0;1;0;0;1;1;3714;0;3714;1;1;
/org.eclipse.team.ui/src/org/eclipse/team/internal/ui/sync/actions/SelectAllAction.java;1;0;4;1;0;0;0;4;12;1;4;1181;15;15;1;0;0;4;4;1181;0;2632;4;1;
/org.eclipse.ui.editors/src/org/eclipse/ui/internal/editors/quickdiff/RevertLineAction.java;2;0;3;1;0;0;0;3;1;1;3;1214;1;1;1;0;0;3;3;1214;0;1644;3;2;
/org.eclipse.update.tests.core/src/org/eclipse/update/tests/standalone/TestFeatureUpdate.java;2;0;7;1;1;1;1;6;28;1;6;2491;40;40;1;0;0;6;7;2491;0;6336;7;2;
/org.eclipse.jdt.ui.tests.refactoring/resources/RenameType/test50/in/A.java;1;0;1;1;0;0;0;1;4;0;1;4577;4;4;1;0;0;1;1;4577;0;4577;1;1;
/org.eclipse.jdt.ui.tests.refactoring/resources/ChangeTypeRefactoring/negative/A_testBogusSelection_in.java;1;0;1;1;0;0;0;1;0;0;1;2844;0;0;1;0;0;1;1;2844;0;2844;1;1;
/org.eclipse.jdt.ui.tests.refactoring/resources/ExtractMethodWorkSpace/ExtractMethodTests/locals_in/A_test532.java;1;0;1;1;0;0;0;1;2;0;1;844;2;2;1;0;0;1;1;844;0;844;1;1;
/org.eclipse.core.tests.runtime/src/org/eclipse/core/tests/runtime/locks/OrderedLockTest.java;1;0;2;1;0;0;0;2;0;1;2;698;0;0;1;0;0;2;2;698;0;850;2;1;
/org.eclipse.jdt.core/model/org/eclipse/jdt/internal/core/util/Util.java;5;1;20;2;6;6;6;14;1647;3;12;729;2686;2686;3;2;0;14;20;5055;2;5860;18;5;
/org.eclipse.jdt.debug.tests/tests/org/eclipse/jdt/debug/tests/eval/TestsTypeHierarchy2.java;1;0;1;1;0;0;0;1;26;0;1;1274;26;26;1;0;0;1;1;1274;0;1274;1;1;
/org.eclipse.ui.workbench/Eclipse UI/org/eclipse/ui/internal/commands/registry/old/Persistence.java;1;0;3;1;0;0;0;3;2;2;2;1222;2;2;2;1;0;3;3;1321;1;1321;2;1;
/org.eclipse.ant.ui/Ant Editor/org/eclipse/ant/ui/internal/editor/utils/ProjectHelper.java;1;0;2;1;0;0;0;2;0;1;2;250;0;0;1;0;0;2;2;250;0;1811;2;1;
/org.eclipse.jdt.core/dom/org/eclipse/jdt/core/dom/ArrayCreation.java;3;1;10;1;3;3;3;7;120;1;7;3560;198;198;1;0;0;7;10;3560;0;5335;10;3;
/org.eclipse.swt/Eclipse SWT PI/gtk/org/eclipse/swt/internal/gtk/GtkFixed.java;3;0;3;1;1;1;1;2;17;1;2;1653;21;21;1;0;0;2;3;1653;0;6352;3;3;
/org.eclipse.jdt.ui.tests.refactoring/resources/ChangeTypeRefactoring/positive/A_testFieldUseSubtypesOfList_in.java;1;0;1;1;0;0;0;1;0;0;1;2844;0;0;1;0;0;1;1;2844;0;2844;1;1;
/org.eclipse.ui.workbench/Eclipse UI/org/eclipse/ui/part/TransferDragSourceListener.java;1;0;2;1;0;0;0;2;0;0;1;173;0;0;2;1;0;2;2;173;1;173;1;1;
/org.eclipse.jdt.core/model/org/eclipse/jdt/internal/core/BinaryField.java;1;0;5;1;1;1;1;4;14;1;4;916;37;37;1;0;0;4;5;916;0;5614;5;1;
/org.eclipse.core.tests.runtime/src/org/eclipse/core/tests/internal/plugins/SoftPrereqTest_17.java;1;0;1;1;0;0;0;1;0;0;1;3014;0;0;1;0;0;1;1;3014;0;3014;1;1;
/org.eclipse.jdt.ui/core extension/org/eclipse/jdt/internal/corext/dom/Binding2JavaModel.java;2;0;2;1;0;0;0;2;185;1;2;218;185;185;1;0;0;2;2;218;0;237;2;2;
/org.eclipse.jdt.ui/core extension/org/eclipse/jdt/internal/corext/codemanipulation/AddDelegateMethodsOperation.java;2;0;12;1;1;1;1;11;153;1;11;576;207;207;1;0;0;11;12;576;0;6340;12;2;
/org.eclipse.jdt.ui/ui/org/eclipse/jdt/internal/ui/text/PreferencesAdapter.java;1;0;1;1;1;1;1;0;0;0;0;5272;0;0;1;0;0;0;1;5272;0;5272;1;1;
/org.eclipse.ui.workbench/Eclipse UI/org/eclipse/ui/internal/intro/IIntroConstants.java;1;0;3;1;0;0;0;3;5;1;3;3632;7;7;1;0;0;3;3;3632;0;4825;3;1;
/org.eclipse.pde.ui/src/org/eclipse/pde/internal/ui/launcher/LauncherUtils.java;2;3;52;2;21;17;21;31;484;2;26;1459;1873;1873;3;5;4;31;52;5794;9;6336;43;2;
/org.eclipse.ui.workbench/Eclipse UI/org/eclipse/ui/internal/commands/Match.java;3;0;8;2;1;1;1;7;32;2;6;1634;80;80;2;1;0;7;8;4127;1;6338;7;3;
/org.eclipse.jdt.ui/core refactoring/org/eclipse/jdt/internal/corext/refactoring/reorg/IReorgPolicy.java;4;1;10;1;5;5;5;5;6;1;5;1114;35;35;1;0;0;5;10;1114;0;6340;10;4;
/org.eclipse.ui.workbench/Eclipse UI/org/eclipse/ui/commands/Priority.java;2;0;2;1;1;1;1;1;59;0;1;4929;111;111;1;0;0;1;2;4929;0;5231;2;2;
/org.eclipse.swt/Eclipse SWT/gtk/org/eclipse/swt/graphics/Color.java;2;1;3;1;2;2;2;1;4;0;1;4128;12;12;1;0;0;1;3;4128;0;6352;3;2;
/org.eclipse.team.ui/src/org/eclipse/team/ui/synchronize/SyncInfoCollector.java;1;0;1;1;0;0;0;1;0;0;1;3530;0;0;1;0;0;1;1;3530;0;3530;1;1;
/org.eclipse.help/src/org/eclipse/help/internal/standalone/StandaloneHelp.java;1;0;2;1;0;0;0;2;21;1;2;1880;21;21;1;0;0;2;2;1880;0;2732;2;1;
/org.eclipse.core.tests.resources/src/org/eclipse/core/tests/internal/watson/PhantomElementData.java;1;0;1;1;1;1;1;0;40;0;0;5147;40;40;1;0;0;0;1;5147;0;5147;1;1;
/org.eclipse.jdt.core.tests.model/workspace/Converter/src/test0232/Test.java;1;0;1;1;0;0;0;1;0;0;1;3714;0;0;1;0;0;1;1;3714;0;3714;1;1;
/org.eclipse.jdt.core/compiler/org/eclipse/jdt/internal/compiler/lookup/LocalTypeBinding.java;2;0;4;1;0;0;0;4;11;1;4;24;23;23;1;0;0;4;4;24;0;4064;4;2;
/org.eclipse.jdt.core/model/org/eclipse/jdt/internal/core/BinaryType.java;5;1;31;2;2;2;2;29;101;4;24;259;732;732;4;5;0;29;31;1946;5;5614;26;5;
/org.eclipse.jdt.ui/ui/org/eclipse/jdt/internal/ui/packageview/SelectionTransferDragAdapter.java;2;0;2;1;1;1;1;1;2;0;1;4631;4;4;1;0;0;1;2;4631;0;6340;2;2;
/org.eclipse.jdt.core.tests.model/workspace/Converter/src/test0402/A.java;1;0;1;1;0;0;0;1;0;0;1;3714;0;0;1;0;0;1;1;3714;0;3714;1;1;
/org.eclipse.ui.workbench/Eclipse UI/org/eclipse/ui/model/PendingUpdateAdapter.java;1;0;5;1;0;0;0;5;70;2;4;803;73;73;2;1;0;5;5;954;1;1170;4;1;
/org.eclipse.webdav/src/interface/org/eclipse/webdav/dom/Status.java;1;0;2;1;2;1;2;0;136;0;0;5151;136;136;2;0;1;0;2;5151;1;5151;1;1;
/org.eclipse.core.tests.runtime/src/org/eclipse/core/tests/runtime/model/ConfigurationElementModelTest.java;1;0;1;1;1;1;1;0;146;0;0;5149;146;146;1;0;0;0;1;5149;0;5149;1;1;
/org.eclipse.debug.ui/ui/org/eclipse/debug/internal/ui/views/registers/RegistersView.java;1;0;1;1;0;0;0;1;0;0;1;4348;0;0;1;0;0;1;1;4348;0;4348;1;1;
/org.eclipse.jdt.core.tests.builder/src/org/eclipse/jdt/core/tests/builder/OutputFolderTests.java;2;0;3;1;0;0;0;3;26;1;3;989;33;33;1;0;0;3;3;989;0;3560;3;2;
/org.eclipse.webdav/src/interface/org/eclipse/webdav/ILocatorFactory.java;1;0;2;1;2;1;2;0;100;0;0;5151;100;100;2;0;1;0;2;5151;1;5151;1;1;
/org.eclipse.jdt.core.tests.model/workspace/Formatter/test362/A_in.java;1;0;1;1;0;0;0;1;0;0;1;3088;0;0;1;0;0;1;1;3088;0;3088;1;1;
/org.eclipse.core.runtime/src/org/eclipse/core/internal/dependencies/Element.java;2;0;2;1;0;0;0;2;0;1;2;2105;0;0;1;0;0;2;2;2105;0;3013;2;2;
/org.eclipse.ui.workbench/Eclipse UI/org/eclipse/ui/internal/commands/registry/old/Configuration.java;1;0;3;1;0;0;0;3;2;2;2;1222;2;2;2;1;0;3;3;1321;1;1321;2;1;
/org.eclipse.jdt.core.tests.model/workspace/Formatter/test013/A_in.java;1;0;1;1;0;0;0;1;0;0;1;2425;0;0;1;0;0;1;1;2425;0;2425;1;1;
/org.eclipse.ui.ide/src/org/eclipse/ui/views/bookmarkexplorer/EditBookmarkAction.java;1;0;2;1;0;0;0;2;4;1;2;2208;4;4;1;0;0;2;2;2208;0;2264;2;1;
/org.eclipse.team.tests.cvs.core/src/org/eclipse/team/tests/ccvs/ui/logformatter/CaseEntry.java;1;0;1;1;0;0;0;1;0;0;1;2632;0;0;1;0;0;1;1;2632;0;2632;1;1;
/org.eclipse.jdt.ui/core refactoring/org/eclipse/jdt/internal/corext/refactoring/structure/RefactoringWorkingCopyOwner.java;2;0;2;1;1;1;1;1;2;0;1;1185;2;2;1;0;0;1;2;1185;0;6340;2;2;
/org.eclipse.help.appserver/src/org/eclipse/help/internal/appserver/DevClassPathHelper.java;1;1;3;1;3;3;3;0;21;0;0;5443;25;25;1;0;0;0;3;5443;0;5827;3;1;
/org.eclipse.swt/Eclipse SWT Custom Widgets/common/org/eclipse/swt/custom/DefaultContent.java;2;1;2;1;2;2;2;0;4;0;0;5756;6;6;1;0;0;0;2;5756;0;6352;2;2;
/org.eclipse.ant.ui/Ant Editor/org/eclipse/ant/ui/internal/editor/xml/AntEditorXMLMessages.java;1;0;2;1;0;0;0;2;0;1;2;250;0;0;1;0;0;2;2;250;0;1811;2;1;
/org.eclipse.jdt.core.tests.model/workspace/Formatter/test101/A_out.java;1;0;1;1;0;0;0;1;0;0;1;2425;0;0;1;0;0;1;1;2425;0;2425;1;1;
/org.eclipse.jdt.core.tests.model/workspace/Converter/test0273/Test.java;1;0;1;1;0;0;0;1;0;0;1;3714;0;0;1;0;0;1;1;3714;0;3714;1;1;
/org.eclipse.jdt.core.tests.model/workspace/Formatter/test461/A_in.java;1;0;1;1;0;0;0;1;0;0;1;3900;0;0;1;0;0;1;1;3900;0;3900;1;1;
/org.eclipse.jdt.ui.tests.refactoring/resources/MoveMembers/test33/in/A.java;1;0;1;1;0;0;0;1;0;0;1;1856;0;0;1;0;0;1;1;1856;0;1856;1;1;
/org.eclipse.core.tools.resources/src/org/eclipse/core/tools/metadata/SyncInfoSnapshotDumpingStrategy_3.java;1;0;1;1;1;1;1;0;0;0;0;6302;0;0;1;0;0;0;1;6302;0;6302;1;1;
/org.eclipse.team.ui/src/org/eclipse/team/ui/ITeamUIConstants.java;2;1;5;1;2;2;2;3;19;1;3;2493;22;22;1;0;0;3;5;2493;0;5661;5;2;
/org.eclipse.team.cvs.ui/src/org/eclipse/team/internal/ccvs/ui/subscriber/CVSParticipantAction.java;1;1;2;1;2;2;2;0;63;0;0;5490;63;63;1;0;0;0;2;5490;0;5508;2;1;
/org.eclipse.ui.workbench/Eclipse UI/org/eclipse/ui/internal/Rectangles.java;1;0;1;1;0;0;0;1;0;0;1;3677;0;0;1;0;0;1;1;3677;0;3677;1;1;
/org.eclipse.help.ui/src/org/eclipse/help/ui/internal/StyledLineWrapper.java;1;1;4;1;3;3;3;1;44;0;1;2732;74;74;1;0;0;1;4;2732;0;6337;4;1;
/org.eclipse.ant.ui/Ant Tools Support/org/eclipse/ant/ui/internal/preferences/StatusInfo.java;1;0;3;1;0;0;0;3;4;2;2;266;4;4;2;1;0;3;3;266;1;1811;2;1;
/org.eclipse.debug.ui/ui/org/eclipse/debug/ui/launchVariables/ILaunchVariableComponentManager.java;2;0;2;1;0;0;0;2;0;1;2;569;0;0;1;0;0;2;2;569;0;2120;2;2;
/org.eclipse.swt.tests/JUnit Tests/org/eclipse/swt/tests/junit/Test_org_eclipse_swt_widgets_Text.java;6;0;13;1;1;1;1;12;304;3;10;978;743;743;3;2;0;12;13;2225;2;6352;11;6;
/org.eclipse.team.core/src/org/eclipse/team/core/subscribers/trees/CoreSynchronizerRemoteHandleTree.java;1;0;1;1;0;0;0;1;0;0;1;1427;0;0;1;0;0;1;1;1427;0;1427;1;1;
/org.eclipse.pde.core/src/org/eclipse/pde/core/osgi/bundle/IBundlePluginBase.java;2;1;4;1;3;3;3;1;16;0;1;4203;26;26;1;0;0;1;4;4203;0;5445;4;2;
/org.eclipse.swt/Eclipse SWT AWT/gtk/org/eclipse/swt/internal/awt/SWT_AWT.java;1;0;2;1;0;0;0;2;0;1;2;2992;0;0;1;0;0;2;2;2992;0;3012;2;1;
/org.eclipse.jdt.ui.tests.refactoring/resources/InlineMethodWorkspace/TestCases/receiver_out/TestReceiverWithStatic.java;1;0;1;1;0;0;0;1;4;0;1;845;4;4;1;0;0;1;1;845;0;845;1;1;
/org.eclipse.jdt.ui.tests.refactoring/resources/InlineMethodWorkspace/TestCases/import_out/TestUseInDecl2.java;1;0;2;1;0;0;0;2;2;1;2;788;2;2;1;0;0;2;2;788;0;845;2;1;
/org.eclipse.team.ui/src/org/eclipse/team/internal/ui/sync/pages/TextToolbarManager.java;1;0;1;1;0;0;0;1;0;0;1;2481;0;0;1;0;0;1;1;2481;0;2481;1;1;
/org.eclipse.core.runtime/src/org/eclipse/core/internal/preferences/AbstractScope.java;1;0;3;1;1;1;1;2;8;1;2;4351;10;10;1;0;0;2;3;4351;0;5576;3;1;
/org.eclipse.core.tests.resources/src/org/eclipse/core/tests/resources/IWorkspaceRootTest.java;1;0;2;1;2;1;2;0;268;0;0;5147;268;268;2;0;1;0;2;5147;1;5147;1;1;
/org.eclipse.jdt.core.tests.model/workspace/Converter/junit/swingui/TestSelector.java;1;0;2;1;0;0;0;2;18;1;2;787;18;18;1;0;0;2;2;787;0;3714;2;1;
/org.eclipse.ui.workbench/Eclipse UI/org/eclipse/ui/contexts/activationservice/ContextActivationServiceFactory.java;1;0;2;1;0;0;0;2;0;1;2;3066;0;0;1;0;0;2;2;3066;0;3109;2;1;
/org.eclipse.update.ui/src/org/eclipse/update/internal/ui/model/BookmarkUtil.java;3;1;11;1;2;2;2;9;58;1;9;200;240;240;1;0;0;9;11;200;0;6336;11;3;
/org.eclipse.jdt.core.tests.model/workspace/Formatter/test269/A_in.java;1;0;1;1;0;0;0;1;0;0;1;2442;0;0;1;0;0;1;1;2442;0;2442;1;1;
/org.eclipse.jdt.ui.tests.refactoring/resources/MoveMembers/test36/out/A.java;1;0;1;1;0;0;0;1;0;0;1;2093;0;0;1;0;0;1;1;2093;0;2093;1;1;
/org.eclipse.ltk.ui.refactoring/src/org/eclipse/ltk/internal/ui/refactoring/Assert.java;1;0;2;1;1;1;1;1;2;0;1;4965;2;2;1;0;0;1;2;4965;0;6340;2;1;
/org.eclipse.ui.workbench/Eclipse UI/org/eclipse/ui/internal/commands/ImageBinding.java;2;0;11;1;1;1;1;10;117;2;8;1244;253;253;2;2;0;10;11;1631;2;5231;9;2;
/org.eclipse.jdt.ui.tests.refactoring/resources/MoveInstanceMethod/canMove/test23/out/Second.java;1;0;1;1;0;0;0;1;0;0;1;1603;0;0;1;0;0;1;1;1603;0;1603;1;1;
/org.eclipse.pde.build/src_ant/org/eclipse/pde/internal/build/tasks/FetchTask.java;2;3;10;2;4;2;4;6;149;1;6;447;819;819;3;0;2;6;10;6336;2;6336;8;2;
/org.eclipse.jdt.ui/core refactoring/org/eclipse/jdt/internal/corext/refactoring/participants/Expression.java;1;0;3;1;0;0;0;3;3;1;3;591;3;3;1;0;0;3;3;591;0;1033;3;1;
/org.eclipse.core.tests.harness/src/org/eclipse/core/tests/harness/PerformanceTestResult.java;1;0;1;1;1;1;1;0;48;0;0;5146;48;48;1;0;0;0;1;5146;0;5146;1;1;
/org.eclipse.team.ui/src/org/eclipse/team/internal/ui/sync/actions/NavigateAction.java;1;0;3;1;0;0;0;3;2;1;3;1892;2;2;1;0;0;3;3;1892;0;2632;3;1;
/org.eclipse.team.cvs.core/src/org/eclipse/team/internal/ccvs/core/CVSCompareSubscriber.java;2;1;16;2;4;4;4;12;190;3;9;3676;413;413;3;3;0;12;16;4233;3;6337;13;2;
/org.eclipse.team.ftp/src/org/eclipse/team/internal/ftp/subscriber/FTPSubscriberResourceTree.java;1;0;1;1;0;0;0;1;0;0;1;3200;0;0;1;0;0;1;1;3200;0;3200;1;1;
/org.eclipse.jdt.core.tests.model/workspace/Converter/src/test0383/A.java;1;0;1;1;0;0;0;1;0;0;1;3714;0;0;1;0;0;1;1;3714;0;3714;1;1;
/org.eclipse.jdt.ui.examples.javafamily/src/org/eclipse/jdt/internal/ui/search2/SearchUtil.java;1;0;3;1;0;0;0;3;106;1;3;1033;109;109;1;0;0;3;3;1033;0;2344;3;1;
/org.eclipse.webdav/src/client/org/eclipse/webdav/internal/authentication/Parser.java;1;0;2;1;2;1;2;0;47;0;0;5151;47;47;2;0;1;0;2;5151;1;5151;1;1;
/org.eclipse.ui.workbench/Eclipse UI/org/eclipse/ui/internal/dialogs/AboutDialog.java;2;2;4;1;3;2;3;1;499;0;1;2737;502;502;2;0;1;1;4;5483;1;5907;3;2;
/org.eclipse.jdt.ui/ui/org/eclipse/jdt/internal/ui/text/folding/FoldingMessages.java;1;1;2;1;2;2;2;0;6;0;0;5440;6;6;1;0;0;0;2;5440;0;6340;2;1;
/org.eclipse.jdt.ui/ui/org/eclipse/jdt/internal/ui/callhierarchy/SearchScopeProjectAction.java;2;1;4;1;3;3;3;1;17;0;1;4047;21;21;1;0;0;1;4;4047;0;6340;4;2;
/org.eclipse.jdt.debug.ui/ui/org/eclipse/jdt/internal/debug/core/refactoring/JavaBreakpointTypeChange.java;2;1;6;1;6;6;6;0;194;0;0;5319;236;236;1;0;0;0;6;5319;0;6339;6;2;
/org.eclipse.ant.ui/Ant Editor/org/eclipse/ant/internal/ui/editor/xml/XmlAttribute.java;1;0;2;1;0;0;0;2;0;1;2;1811;0;0;1;0;0;2;2;1811;0;3661;2;1;
/org.eclipse.jface.text/src/org/eclipse/jface/internal/text/link/contentassist/ContentAssistMessages.java;1;0;1;1;1;1;1;0;0;0;0;5506;0;0;1;0;0;0;1;5506;0;5506;1;1;
/org.eclipse.ui.workbench/Eclipse UI/org/eclipse/ui/internal/registry/CapabilityRegistry.java;1;0;1;1;0;0;0;1;0;0;1;2737;0;0;1;0;0;1;1;2737;0;2737;1;1;
/org.eclipse.ant.ui/Ant Editor/org/eclipse/ant/ui/internal/dtd/util/Factory.java;1;0;2;1;0;0;0;2;0;1;2;250;0;0;1;0;0;2;2;250;0;1811;2;1;
/org.eclipse.ui.examples.javaeditor/Eclipse Java Editor Example/org/eclipse/ui/examples/javaeditor/spelling/SpellReconcileStrategy.java;1;0;1;1;0;0;0;1;0;0;1;2565;0;0;1;0;0;1;1;2565;0;2565;1;1;
/org.eclipse.jdt.ui.tests.refactoring/resources/MoveMembers/test4/out/B.java;1;0;1;1;0;0;0;1;1;0;1;1522;1;1;1;0;0;1;1;1522;0;1522;1;1;
/org.eclipse.team.cvs.core/src/org/eclipse/team/internal/ccvs/core/resources/EclipseResource.java;2;0;6;1;1;1;1;5;28;1;5;2100;61;61;1;0;0;5;6;2100;0;6337;6;2;
/org.eclipse.jdt.core/model/org/eclipse/jdt/internal/core/CompilationUnitStructureRequestor.java;3;0;10;1;1;1;1;9;137;3;7;85;323;323;3;2;0;9;10;1868;2;5916;8;3;
/org.eclipse.debug.ui/ui/org/eclipse/debug/internal/ui/views/console/HyperlinkPosition.java;1;0;1;1;0;0;0;1;2;0;1;550;2;2;1;0;0;1;1;550;0;550;1;1;
/org.eclipse.update.ui/srcnew/org/eclipse/update/internal/ui/wizards/NewUpdateSiteDialog.java;2;0;4;1;0;0;0;4;4;1;4;705;5;5;1;0;0;4;4;705;0;825;4;2;
/org.eclipse.jdt.core.tests.model/workspace/Converter/src/test0154/Test.java;1;0;1;1;0;0;0;1;0;0;1;3714;0;0;1;0;0;1;1;3714;0;3714;1;1;
/org.eclipse.ui.externaltools/Ant Runner Support/org/eclipse/ui/externaltools/internal/ant/inputhandler/AntInputHandler.java;1;0;1;1;0;0;0;1;0;0;1;282;0;0;1;0;0;1;1;282;0;282;1;1;
/org.eclipse.pde.ui/src/org/eclipse/pde/internal/ui/editor/text/XMLWhitespaceDetector.java;2;0;2;1;1;1;1;1;4;0;1;3795;4;4;1;0;0;1;2;3795;0;6336;2;2;
/org.eclipse.team.core/src/org/eclipse/team/internal/core/StringMatcher.java;1;0;1;1;0;0;0;1;8;0;1;1445;8;8;1;0;0;1;1;1445;0;1445;1;1;
/org.eclipse.team.ui/src/org/eclipse/team/ui/synchronize/subscribers/SynchronizeViewerAdvisor.java;2;0;4;1;1;1;1;3;2;1;3;4632;4;4;1;0;0;3;4;4632;0;5358;4;2;
/org.eclipse.jdt.ui/core extension/org/eclipse/jdt/internal/corext/dom/BindingIdentifier.java;1;0;1;1;0;0;0;1;0;0;1;1492;0;0;1;0;0;1;1;1492;0;1492;1;1;
/org.eclipse.jdt.core/search/org/eclipse/jdt/internal/core/search/indexing/AddClassFileToIndex.java;2;0;2;1;0;0;0;2;1;1;2;1893;1;1;1;0;0;2;2;1893;0;3211;2;2;
/org.eclipse.jdt.ui.tests.refactoring/resources/ExtractMethodWorkSpace/ExtractMethodTests/return_out/A_test706.java;1;0;2;1;0;0;0;2;6;1;2;130;7;7;1;0;0;2;2;130;0;844;2;1;
/org.eclipse.ui.workbench/Eclipse UI/org/eclipse/ui/internal/chris/roles/PluginRoleRegistry.java;1;0;4;1;0;0;0;4;2;2;3;1952;4;4;2;1;0;4;4;2207;1;2207;3;1;
/org.eclipse.swt/Eclipse SWT/common/org/eclipse/swt/events/PaintEvent.java;1;0;1;1;0;0;0;1;17;0;1;2729;17;17;1;0;0;1;1;2729;0;2729;1;1;
/org.eclipse.swt/Eclipse SWT/photon/org/eclipse/swt/widgets/Text.java;5;1;15;1;2;2;2;13;35;2;12;110;144;144;2;1;0;13;15;956;1;6352;14;5;
/org.eclipse.jdt.debug.ui/ui/org/eclipse/jdt/internal/debug/ui/breakpoints/AddExceptionDialog.java;1;0;1;1;0;0;0;1;1;0;1;3093;1;1;1;0;0;1;1;3093;0;3093;1;1;
/org.eclipse.jdt.ui.tests.refactoring/resources/ExtractInterface/test99/out/I.java;1;0;1;1;0;0;0;1;0;0;1;3710;0;0;1;0;0;1;1;3710;0;3710;1;1;
/org.eclipse.core.tests.resources/src/org/eclipse/core/tests/resources/session/TestBuilderDeltaSerialization.java;1;0;3;1;3;1;3;0;202;0;0;5147;202;202;3;0;2;0;3;5147;2;5147;1;1;
/org.eclipse.jdt.core/search/org/eclipse/jdt/core/search/JavaSearchMatch.java;1;0;3;1;1;1;1;2;8;1;2;4308;8;8;1;0;0;2;3;4308;0;5102;3;1;
/org.eclipse.core.runtime.compatibility/src-model/org/eclipse/core/internal/model/PluginParser.java;3;1;5;1;4;4;4;1;50;0;1;3013;61;61;1;0;0;1;5;3013;0;6340;5;3;
/org.eclipse.jdt.core.tests.model/workspace/Formatter/test206/A_out.java;1;0;1;1;0;0;0;1;0;0;1;2424;0;0;1;0;0;1;1;2424;0;2424;1;1;
/org.eclipse.jdt.ui/ui/org/eclipse/jdt/internal/ui/preferences/JavaPreferencesSettings.java;2;0;3;1;1;1;1;2;5;1;2;882;8;8;1;0;0;2;3;882;0;6340;3;2;
/org.eclipse.ui.workbench/Eclipse UI/org/eclipse/ui/internal/FastViewBar.java;7;2;24;2;8;7;8;16;550;3;9;3677;1384;1384;3;7;1;16;24;4112;8;6103;16;7;
/org.eclipse.jdt.ui/ui/org/eclipse/jdt/internal/ui/viewsupport/JavaUILabelProvider.java;2;0;3;1;1;1;1;2;52;0;1;505;54;54;2;1;0;2;3;505;1;6340;2;2;
/org.eclipse.jdt.ui/ui/org/eclipse/jdt/internal/ui/text/java/MethodCompletionProposal.java;1;1;5;1;5;5;5;0;31;0;0;5505;46;46;1;0;0;0;5;5505;0;5857;5;1;
/org.eclipse.jdt.core.tests.model/src/org/eclipse/jdt/core/tests/model/LocalElementTests.java;1;0;6;1;0;0;0;6;54;3;3;1905;89;89;3;3;0;6;6;1905;3;3560;3;1;
/org.eclipse.update.core/srcnew/org/eclipse/update/internal/search/OptionalFeatureSearchCategory.java;2;0;2;1;0;0;0;2;0;1;2;672;0;0;1;0;0;2;2;672;0;825;2;2;
/org.eclipse.jface.text/src/org/eclipse/jface/text/templates/TemplateVariable.java;1;0;2;1;0;0;0;2;0;0;1;4258;0;0;2;1;0;2;2;4258;1;4258;1;1;
/org.eclipse.ui.workbench/Eclipse UI/org/eclipse/ui/internal/contexts/AbstractContextService.java;1;0;3;1;0;0;0;3;1;2;2;1135;1;1;2;1;0;3;3;1135;1;1220;2;1;
/org.eclipse.jdt.ui/ui/org/eclipse/jdt/internal/ui/text/link/LinkedPosition.java;1;0;4;1;0;0;0;4;139;1;4;2838;147;147;1;0;0;4;4;2838;0;4214;4;1;
/org.eclipse.ui.workbench/Eclipse UI/org/eclipse/ui/internal/QuickStartAction.java;1;0;1;1;0;0;0;1;0;0;1;1066;0;0;1;0;0;1;1;1066;0;1066;1;1;
/org.eclipse.webdav/src/interface/org/eclipse/webdav/internal/utils/URLDecoder.java;1;0;2;1;2;1;2;0;113;0;0;5151;113;113;2;0;1;0;2;5151;1;5151;1;1;
/org.eclipse.ui.workbench/Eclipse UI/org/eclipse/ui/internal/WWinPartService.java;1;0;1;1;0;0;0;1;2;0;1;1080;2;2;1;0;0;1;1;1080;0;1080;1;1;
/org.eclipse.ui.examples.javaeditor/Eclipse Java Editor Example/org/eclipse/ui/examples/javaeditor/java/JavaEditorMessages.java;1;0;1;1;1;1;1;0;2;0;0;6340;2;2;1;0;0;0;1;6340;0;6340;1;1;
/org.eclipse.team.examples.filesystem/src/org/eclipse/team/examples/filesystem/FileSystemPlugin.java;2;1;3;1;2;2;2;1;6;0;1;1708;12;12;1;0;0;1;3;1708;0;6337;3;2;
/org.eclipse.jface.text/src/org/eclipse/jface/text/formatter/IFormattingContext.java;2;1;6;1;2;2;2;4;100;1;4;1998;209;209;1;0;0;4;6;1998;0;6340;6;2;
/org.eclipse.team.core/src/org/eclipse/team/core/synchronize/ISyncInfoSetChangeListener.java;2;1;5;1;3;3;3;2;74;1;2;4045;97;97;1;0;0;2;5;4045;0;6336;5;2;
/org.eclipse.osgi/core/framework/org/eclipse/osgi/framework/security/action/GetProperty.java;3;0;4;1;1;1;1;3;38;1;3;3013;43;43;1;0;0;3;4;3013;0;5107;4;3;
/org.eclipse.swt.tests/JUnit Tests/org/eclipse/swt/tests/junit/Test_org_eclipse_swt_custom_TableCursor.java;1;0;1;1;0;0;0;1;4;0;1;2104;4;4;1;0;0;1;1;2104;0;2104;1;1;
/org.eclipse.jdt.ui/ui/org/eclipse/jdt/internal/ui/callhierarchy/HistoryDropDownAction.java;2;0;4;1;1;1;1;3;22;1;3;155;30;30;1;0;0;3;4;155;0;6340;4;2;
/org.eclipse.jdt.ui/ui/org/eclipse/jdt/ui/actions/FindReadReferencesInProjectAction.java;3;1;8;1;3;3;3;5;11;1;5;1683;32;32;1;0;0;5;8;1683;0;6340;8;3;
/org.eclipse.jdt.ui.tests.refactoring/resources/ExtractMethodWorkSpace/ExtractMethodTests/semicolon_in/A_test401.java;1;0;1;1;0;0;0;1;2;0;1;844;2;2;1;0;0;1;1;844;0;844;1;1;
/org.eclipse.jdt.ui/ui refactoring/org/eclipse/jdt/internal/ui/refactoring/PseudoJavaChangeElement.java;1;0;10;1;0;0;0;10;64;2;8;1033;93;93;2;2;0;10;10;1952;2;4965;8;1;
/org.eclipse.help.tests/src/org/eclipse/help/tests/standalone/TestInfocenter.java;1;1;9;1;2;2;2;7;95;1;7;860;214;214;1;0;0;7;9;860;0;6337;9;1;
/org.eclipse.jdt.ui.examples.javafamily/src/org/eclipse/jface/text/source/DefaultAnnotationHover.java;1;0;3;1;0;0;0;3;17;2;2;1150;17;17;2;1;0;3;3;1150;1;1642;2;1;
/org.eclipse.team.ui/src/org/eclipse/team/ui/synchronize/content/CompressFolderView.java;1;0;1;1;0;0;0;1;0;0;1;3734;0;0;1;0;0;1;1;3734;0;3734;1;1;
/org.eclipse.core.tests.resources/src/org/eclipse/core/tests/internal/watson/DeltaChainFlatteningTest.java;1;0;2;1;2;1;2;0;115;0;0;5147;115;115;2;0;1;0;2;5147;1;5147;1;1;
/org.eclipse.ui.ide/src/org/eclipse/ui/views/markers/internal/TableView.java;4;1;5;1;2;2;2;3;144;1;3;2208;173;173;1;0;0;3;5;2208;0;6338;5;4;
/org.eclipse.jdt.ui/ui/org/eclipse/jdt/internal/ui/compare/JavaAddElementFromHistory.java;4;1;13;1;3;3;3;10;170;1;10;1289;436;436;1;0;0;10;13;1289;0;6340;13;4;
/org.eclipse.jdt.ui/core refactoring/org/eclipse/jdt/internal/corext/refactoring/typeconstraints/RawBindingVariable.java;2;0;3;1;1;1;1;2;8;1;2;42;10;10;1;0;0;2;3;42;0;6340;3;2;
/org.eclipse.ui.workbench/Eclipse UI/org/eclipse/ui/IPerspectiveDescriptor.java;5;1;5;1;2;2;2;3;9;1;3;830;28;28;1;0;0;3;5;830;0;6338;5;5;
/org.eclipse.debug.ui/ui/org/eclipse/debug/internal/ui/preferences/ConsolePreferencePage.java;3;0;4;1;1;1;1;3;17;1;3;3201;43;43;1;0;0;3;4;3201;0;5701;4;3;
/org.eclipse.ui.workbench/Eclipse UI/org/eclipse/ui/internal/roles/ActivityBindingDefinition.java;1;0;3;1;0;0;0;3;80;1;3;2533;96;96;1;0;0;3;3;2533;0;2867;3;1;
/org.eclipse.team.webdav/src/org/eclipse/team/internal/ui/target/TargetWizardPage.java;2;0;3;1;1;1;1;2;20;1;2;2495;22;22;1;0;0;2;3;2495;0;6337;3;2;
/org.eclipse.osgi/core/framework/org/eclipse/osgi/framework/internal/core/BundleHost.java;5;4;28;3;11;8;11;17;290;2;15;3013;626;626;4;2;3;17;28;5106;5;5800;23;5;
/org.eclipse.jdt.core.tests.model/workspace/Converter/junit/runner/SimpleTestCollector.java;1;0;1;1;0;0;0;1;0;0;1;3714;0;0;1;0;0;1;1;3714;0;3714;1;1;
/org.eclipse.swt/Eclipse SWT PI/motif/org/eclipse/swt/internal/Platform.java;1;0;1;1;0;0;0;1;0;0;1;1969;0;0;1;0;0;1;1;1969;0;1969;1;1;
/org.eclipse.debug.core/core/org/eclipse/debug/core/variables/ContextLaunchVariableRegistry.java;1;0;3;1;0;0;0;3;11;1;3;562;11;11;1;0;0;3;3;562;0;737;3;1;
/org.eclipse.ui.workbench/Eclipse UI/org/eclipse/ui/internal/NewWizardShortcutAction.java;1;0;1;1;0;0;0;1;0;0;1;2737;0;0;1;0;0;1;1;2737;0;2737;1;1;
/org.eclipse.team.cvs.ui/src/org/eclipse/team/internal/ccvs/ui/subscriber/WorkspaceSynchronizePage.java;1;0;6;1;0;0;0;6;53;1;6;2590;81;81;1;0;0;6;6;2590;0;4588;6;1;
/org.eclipse.jdt.core.tests.model/workspace/Converter/test0417/A.java;1;0;1;1;0;0;0;1;0;0;1;3714;0;0;1;0;0;1;1;3714;0;3714;1;1;
/org.eclipse.jdt.core.tests.model/workspace/Converter/test0128/Test.java;1;0;1;1;0;0;0;1;0;0;1;3714;0;0;1;0;0;1;1;3714;0;3714;1;1;
/org.eclipse.team.core/src/org/eclipse/team/core/subscribers/BackgroundEventHandler.java;2;0;6;1;0;0;0;6;135;1;6;2104;265;265;1;0;0;6;6;2104;0;4216;6;2;
/org.eclipse.jdt.core.tests.model/workspace/Converter/src/test0091/Test.java;1;0;1;1;0;0;0;1;0;0;1;3714;0;0;1;0;0;1;1;3714;0;3714;1;1;
/org.eclipse.ui.workbench/Eclipse UI/org/eclipse/ui/internal/commands/older/XIPropertyListener.java;1;0;1;1;0;0;0;1;0;0;1;2562;0;0;1;0;0;1;1;2562;0;2562;1;1;
/org.eclipse.ui.ide/src/org/eclipse/ui/views/tasklist/TasksFilter.java;1;0;2;1;0;0;0;2;13;1;2;2208;13;13;1;0;0;2;2;2208;0;2264;2;1;
/org.eclipse.sdk.tests-feature/plugins/org.eclipse.perfmsr.ui.client/src/org/eclipse/perfmsr/ui/client/Element.java;1;1;2;1;2;2;2;0;10;0;0;5443;10;10;1;0;0;0;2;5443;0;5513;2;1;
/org.eclipse.jdt.ui/ui/org/eclipse/jdt/internal/ui/wizards/buildpaths/ClasspathContainerDefaultPage.java;2;0;2;1;1;1;1;1;6;0;1;2332;8;8;1;0;0;1;2;2332;0;6340;2;2;
/org.eclipse.team.ftp/src/org/eclipse/team/internal/ftp/client/LSDirectoryEntryParser.java;2;0;4;1;1;1;1;3;209;1;3;3382;241;241;1;0;0;3;4;3382;0;6337;4;2;
/org.eclipse.jdt.core/model/org/eclipse/jdt/core/util/IClassFileDisassembler.java;1;0;1;1;0;0;0;1;2;0;1;3560;2;2;1;0;0;1;1;3560;0;3560;1;1;
/org.eclipse.debug.ui/ui/org/eclipse/debug/internal/ui/AlwaysNeverDialog.java;3;0;4;1;1;1;1;3;91;1;3;2670;96;96;1;0;0;3;4;2670;0;5407;4;3;
/org.eclipse.core.runtime/src/org/eclipse/core/internal/content/LazyInputStream.java;2;1;2;1;2;2;2;0;2;0;0;6225;2;2;1;0;0;0;2;6225;0;6317;2;2;
/org.eclipse.jdt.ui.tests.refactoring/resources/MoveMembers/test15/out/B.java;1;0;1;1;0;0;0;1;1;0;1;1522;1;1;1;0;0;1;1;1522;0;1522;1;1;
/org.eclipse.ui.views/src/org/eclipse/ui/views/internal/markers/FieldPriority.java;1;0;2;1;0;0;0;2;0;0;1;749;0;0;2;1;0;2;2;749;1;749;1;1;
/org.eclipse.ui.ide/src/org/eclipse/ui/internal/ide/dialogs/ProjectPerspectiveChoiceDialog.java;1;0;1;1;0;0;0;1;0;0;1;2264;0;0;1;0;0;1;1;2264;0;2264;1;1;
/org.eclipse.debug.ui/ui/org/eclipse/debug/ui/IDebugUIConstants.java;5;2;42;2;9;6;9;33;114;2;30;265;468;468;2;3;3;33;42;1953;6;6336;36;5;
/org.eclipse.jdt.ui/ui/org/eclipse/jdt/ui/actions/RefreshAction.java;3;1;4;1;2;2;2;2;23;1;2;592;33;33;1;0;0;2;4;592;0;6340;4;3;
/org.eclipse.help.tests/src/org/eclipse/help/tests/appserver/TestTwoWebApps.java;1;1;3;1;2;2;2;1;54;0;1;2781;104;104;1;0;0;1;3;2781;0;6337;3;1;
/org.eclipse.swt/Eclipse SWT/win32/org/eclipse/swt/widgets/Widget.java;3;1;15;1;3;3;3;12;110;2;11;248;382;382;2;1;0;12;15;248;1;6352;14;3;
/org.eclipse.ui.ide/src/org/eclipse/ui/internal/dialogs/ProjectCapabilitySimpleSelectionPage.java;2;0;4;2;0;0;0;4;45;2;3;1526;45;45;2;1;0;4;4;1537;1;2263;3;2;
/org.eclipse.swt/Eclipse SWT PI/gtk/org/eclipse/swt/internal/accessibility/gtk/AtkTextIface.java;4;0;4;1;1;1;1;3;40;1;3;1214;59;59;1;0;0;3;4;1214;0;6352;4;4;
/org.eclipse.update.core/src/org/eclipse/update/internal/api/search/IUpdateSearchQuery.java;1;0;2;1;0;0;0;2;0;1;2;3270;0;0;1;0;0;2;2;3270;0;4928;2;1;
/org.eclipse.jdt.core.tests.model/workspace/Formatter/test113/A_out.java;1;0;1;1;0;0;0;1;0;0;1;2425;0;0;1;0;0;1;1;2425;0;2425;1;1;
/org.eclipse.team.cvs.ui/src/org/eclipse/team/internal/ccvs/ui/EditorsDialog.java;1;0;1;1;0;0;0;1;7;0;1;2381;7;7;1;0;0;1;1;2381;0;2381;1;1;
/org.eclipse.swt/Eclipse SWT/photon/org/eclipse/swt/widgets/Canvas.java;2;0;3;2;0;0;0;3;13;2;2;1525;17;17;2;1;0;3;3;1525;1;1540;2;2;
/org.eclipse.pde.ui/src/org/eclipse/pde/internal/ui/launcher/JUnitPluginLaunchShortcut.java;1;0;1;1;0;0;0;1;0;0;1;1343;0;0;1;0;0;1;1;1343;0;1343;1;1;
/org.eclipse.core.runtime/src/org/eclipse/core/runtime/model/PluginRegistryModel.java;2;0;2;1;0;0;0;2;170;1;2;2105;170;170;1;0;0;2;2;2105;0;3013;2;2;
/org.eclipse.swt/Eclipse SWT Mozilla/common/org/eclipse/swt/internal/mozilla/nsILocalFile.java;1;0;2;1;0;0;0;2;34;1;2;1654;34;34;1;0;0;2;2;1654;0;2568;2;1;
/org.eclipse.jdt.ui/ui refactoring/org/eclipse/jdt/internal/ui/refactoring/RenameRefactoringWizard.java;2;0;4;1;0;0;0;4;13;1;4;155;22;22;1;0;0;4;4;155;0;1126;4;2;
/org.eclipse.jdt.ui/ui refactoring/org/eclipse/jdt/internal/ui/refactoring/nls/NLSSubstitutionContentProvider.java;3;0;3;1;1;1;1;2;4;1;2;42;6;6;1;0;0;2;3;42;0;5186;3;3;
/org.eclipse.ui.workbench/Eclipse UI/org/eclipse/ui/internal/commands/IKeyBindingDefinition.java;1;0;1;1;0;0;0;1;0;0;1;1422;0;0;1;0;0;1;1;1422;0;1422;1;1;
/org.eclipse.update.ui.forms/Eclipse Forms/org/eclipse/ui/forms/internal/parts/Paragraph.java;1;0;2;1;0;0;0;2;0;1;2;3096;0;0;1;0;0;2;2;3096;0;3138;2;1;
/org.eclipse.compare.examples/src/org/eclipse/compare/examples/structurecreator/TextMergeViewerCreator.java;1;0;1;1;0;0;0;1;2;0;1;3938;2;2;1;0;0;1;1;3938;0;3938;1;1;
/org.eclipse.jdt.core.tests.model/workspace/Formatter/test291/A_out.java;1;0;1;1;0;0;0;1;0;0;1;2444;0;0;1;0;0;1;1;2444;0;2444;1;1;
/org.eclipse.debug.ui/ui/org/eclipse/debug/internal/ui/sourcelookup/browsers/DirectorySourceContainerDialog.java;1;0;2;1;1;1;1;1;5;0;1;3770;5;5;1;0;0;1;2;3770;0;6244;2;1;
/org.eclipse.jdt.ui.tests.refactoring/test cases/org/eclipse/jdt/ui/tests/refactoring/ChangeSignatureTests.java;4;1;32;1;6;6;6;26;89;2;24;130;837;837;2;2;0;26;32;1095;2;6340;30;4;
/org.eclipse.jdt.core.tests.model/workspace/Formatter/test473/A_in.java;1;0;1;1;0;0;0;1;0;0;1;3977;0;0;1;0;0;1;1;3977;0;3977;1;1;
/org.eclipse.jdt.core.tests.compiler/src/org/eclipse/jdt/core/tests/eval/SimpleVariableTest.java;1;0;2;1;0;0;0;2;7;1;2;241;9;9;1;0;0;2;2;241;0;3560;2;1;
/org.eclipse.update.core/src/org/eclipse/update/internal/api/search/IUpdateSiteAdapter.java;1;0;2;1;0;0;0;2;0;1;2;3270;0;0;1;0;0;2;2;3270;0;4928;2;1;
/org.eclipse.jdt.core.tests.model/workspace/Formatter/test280/A_in.java;1;0;1;1;0;0;0;1;0;0;1;2443;0;0;1;0;0;1;1;2443;0;2443;1;1;
/org.eclipse.ui.externaltools/External Tools Base/org/eclipse/ui/externaltools/internal/variable/ResourceNameExpander.java;1;0;1;1;0;0;0;1;0;0;1;321;0;0;1;0;0;1;1;321;0;321;1;1;
/org.eclipse.jdt.ui.examples.javafamily/src/org/eclipse/jsp/AddJspFileToIndex.java;1;0;4;1;0;0;0;4;2;1;4;1033;3;3;1;0;0;4;4;1033;0;3235;4;1;
/org.eclipse.ui.workbench/Eclipse UI/org/eclipse/ui/internal/progress/IElementCollector.java;1;0;2;1;2;1;2;0;0;0;0;5208;0;0;2;0;1;0;2;5208;1;5208;1;1;
/org.eclipse.core.resources/src/org/eclipse/core/internal/resources/WorkspaceTreeReader_2.java;1;0;1;1;1;1;1;0;117;0;0;5146;117;117;1;0;0;0;1;5146;0;5146;1;1;
/org.eclipse.ui.ide/src/org/eclipse/ui/views/markers/internal/ActionTaskProperties.java;3;1;3;1;2;2;2;1;4;0;1;2208;6;6;1;0;0;1;3;2208;0;6338;3;3;
/org.eclipse.ui.workbench/Eclipse UI/org/eclipse/ui/internal/WorkbenchWindowActivityService.java;1;0;7;1;0;0;0;7;232;2;5;2800;286;286;2;2;0;7;7;2808;2;3066;5;1;
/org.eclipse.jdt.ui.tests.refactoring/resources/MoveMembers/test35/in/B.java;1;0;1;1;0;0;0;1;0;0;1;1856;0;0;1;0;0;1;1;1856;0;1856;1;1;
/org.eclipse.ui.views/src/org/eclipse/ui/views/markers/internal/Messages.java;2;0;2;1;0;0;0;2;0;1;2;755;0;0;1;0;0;2;2;755;0;2738;2;2;
/org.eclipse.jdt.core.tests.model/workspace/Formatter/test253/A_in.java;1;0;1;1;0;0;0;1;0;0;1;2442;0;0;1;0;0;1;1;2442;0;2442;1;1;
/org.eclipse.ui.forms/src/org/eclipse/ui/forms/editor/PageForm.java;1;0;5;1;0;0;0;5;11;1;5;4288;18;18;1;0;0;5;5;4288;0;4975;5;1;
/org.eclipse.ui.workbench/Eclipse UI/org/eclipse/ui/internal/csm/activities/service/ActivityService.java;1;0;2;1;0;0;0;2;0;1;2;2370;0;0;1;0;0;2;2;2370;0;2444;2;1;
/org.eclipse.jdt.debug.ui/ui/org/eclipse/jdt/internal/debug/ui/actions/ToggleBreakpointAdapter.java;2;1;9;1;5;5;5;4;592;3;2;4471;664;664;3;2;0;4;9;4492;2;6106;7;2;
/org.eclipse.ui.workbench.texteditor/src/org/eclipse/ui/texteditor/SmartEnterAction.java;2;0;5;1;1;1;1;4;16;1;4;436;29;29;1;0;0;4;5;436;0;5177;5;2;
/org.eclipse.ui.workbench/Eclipse UI/org/eclipse/ui/internal/CoolBarLayout.java;2;0;2;1;0;0;0;2;60;1;2;368;60;60;1;0;0;2;2;368;0;3220;2;2;
/org.eclipse.update.ui.forms/Eclipse Forms/org/eclipse/ui/forms/widgets/FormEntry.java;1;0;4;1;0;0;0;4;170;1;4;3138;172;172;1;0;0;4;4;3138;0;4157;4;1;
/org.eclipse.team.ui/src/org/eclipse/team/internal/ui/synchronize/actions/PinParticipantAction.java;1;1;3;1;3;3;3;0;62;0;0;5534;81;81;1;0;0;0;3;5534;0;5823;3;1;
/org.eclipse.update.ui/src/org/eclipse/update/internal/ui/views/DetailsView.java;1;0;1;1;0;0;0;1;0;0;1;755;0;0;1;0;0;1;1;755;0;755;1;1;
/org.eclipse.pde.ui/src/org/eclipse/pde/internal/ui/wizards/imports/TargetEnvironmentPreferenceNode.java;1;0;1;1;0;0;0;1;0;0;1;3986;0;0;1;0;0;1;1;3986;0;3986;1;1;
/org.eclipse.ui.presentations.r21/src/org/eclipse/ui/internal/presentations/R21BasicStackPresentation.java;2;2;4;2;4;3;4;0;56;0;0;6075;81;81;2;0;1;0;4;6225;1;6225;3;2;
/org.eclipse.compare/compare/org/eclipse/compare/internal/patch/Patcher.java;1;0;5;1;0;0;0;5;29;1;5;659;55;55;1;0;0;5;5;659;0;3938;5;1;
/org.eclipse.update/src/org/eclipse/update/internal/core/UpdateManagerPlugin.java;1;0;1;1;1;1;1;0;0;0;0;6339;0;0;1;0;0;0;1;6339;0;6339;1;1;
/org.eclipse.team.ui/src/org/eclipse/team/ui/synchronize/SynchronizeDialog.java;2;0;3;1;1;1;1;2;14;1;2;4632;14;14;1;0;0;2;3;4632;0;5358;3;2;
/org.eclipse.jdt.core.tests.model/workspace/Formatter/test329/A_out.java;1;0;1;1;0;0;0;1;0;0;1;2640;0;0;1;0;0;1;1;2640;0;2640;1;1;
/org.eclipse.ui.workbench/Eclipse UI/org/eclipse/ui/keys/NaturalKey.java;3;1;6;1;2;2;2;4;17;2;3;1341;51;51;2;1;0;4;6;2202;1;6338;5;3;
/org.eclipse.jdt.ui/core extension/org/eclipse/jdt/internal/corext/codemanipulation/ImportRewrite.java;3;1;10;1;3;3;3;7;33;2;6;1952;118;118;2;1;0;7;10;1952;1;6340;9;3;
/org.eclipse.swt/Eclipse SWT/gtk/org/eclipse/swt/widgets/Tracker.java;5;1;21;1;6;6;6;15;454;2;13;110;1070;1070;2;2;0;15;21;634;2;6352;19;5;
/org.eclipse.swt/Eclipse SWT/motif/org/eclipse/swt/graphics/Font.java;4;1;6;1;2;2;2;4;127;2;3;475;187;187;2;1;0;4;6;522;1;6352;5;4;
/org.eclipse.team.cvs.core/src/org/eclipse/team/internal/ccvs/core/CVSAnnotateBlock.java;1;0;2;1;0;0;0;2;20;1;2;784;20;20;1;0;0;2;2;784;0;1707;2;1;
/org.eclipse.jdt.core/dom/org/eclipse/jdt/core/dom/VariableDeclarationExpression.java;4;2;18;1;6;4;6;12;160;2;11;3560;378;378;2;1;2;12;18;4489;3;5781;15;4;
/org.eclipse.team.cvs.ui/src/org/eclipse/team/internal/ccvs/ui/actions/CompareWithRevisionAction.java;2;1;8;2;4;4;4;4;38;2;3;4449;91;91;2;1;0;4;8;4449;1;6337;7;2;
/org.eclipse.team.ui/src/org/eclipse/team/internal/ui/sync/views/SyncSetInputFromSubscriber.java;1;0;5;1;0;0;0;5;240;1;5;488;278;278;1;0;0;5;5;488;0;1354;5;1;
/org.eclipse.jdt.ui.tests.refactoring/resources/InlineMethodWorkspace/TestCases/argument_out/TestParameterNameUnused2.java;1;0;1;1;0;0;0;1;4;0;1;845;4;4;1;0;0;1;1;845;0;845;1;1;
/org.eclipse.swt/Eclipse SWT Custom Widgets/common/org/eclipse/swt/custom/StyledText.java;8;3;69;2;13;10;13;56;16500;7;38;1;36597;36597;7;18;3;56;69;4628;21;6352;48;8;
/org.eclipse.ant.ui/Ant Tools Support/org/eclipse/ant/ui/internal/preferences/AntEditorPreferencePage.java;1;0;9;1;0;0;0;9;147;2;6;250;254;254;2;3;0;9;9;266;3;1811;6;1;
/org.eclipse.core.runtime.compatibility/src-runtime/org/eclipse/core/runtime/IPluginRegistry.java;2;0;4;1;0;0;0;4;18;1;4;3013;20;20;1;0;0;4;4;3013;0;3169;4;2;
/org.eclipse.swt/Eclipse SWT/carbon/org/eclipse/swt/graphics/Image.java;3;1;9;1;5;5;5;4;12;1;4;332;46;46;1;0;0;4;9;332;0;6352;9;3;
/org.eclipse.jdt.core.tests.model/workspace/Converter/test0493/A.java;1;0;2;1;0;0;0;2;0;1;2;1950;0;0;1;0;0;2;2;1950;0;3714;2;1;
/org.eclipse.swt/Eclipse SWT Mozilla/common/org/eclipse/swt/internal/mozilla/nsIInterfaceRequestor.java;1;0;1;1;0;0;0;1;0;0;1;1654;0;0;1;0;0;1;1;1654;0;1654;1;1;
/org.eclipse.osgi/resolver/src/org/eclipse/osgi/internal/resolver/BundleDescriptionImpl.java;5;2;18;2;7;6;7;11;57;2;10;3013;192;192;2;1;1;11;18;4513;2;5603;16;5;
/org.eclipse.ui.editors/src/org/eclipse/ui/editors/text/ForwardingDocumentProvider.java;2;2;3;1;3;2;3;0;44;0;0;5847;44;44;2;0;1;0;3;6334;1;6334;2;2;
/org.eclipse.jdt.core.tests.model/workspace/Formatter/test377/A_out.java;1;0;2;1;0;0;0;2;1;1;2;3146;1;1;1;0;0;2;2;3146;0;3172;2;1;
/org.eclipse.pde.ui/src_Forms/org/eclipse/pde/internal/ui/model/plugin/PluginImportNode.java;3;1;8;1;6;6;6;2;65;1;2;4438;150;150;1;0;0;2;8;4438;0;6336;8;3;
/org.eclipse.jdt.core/compiler/org/eclipse/jdt/internal/compiler/lookup/PackageBinding.java;3;0;4;1;1;1;1;3;35;1;3;24;46;46;1;0;0;3;4;24;0;5254;4;3;
/org.eclipse.ant.ui/Ant Tools Support/org/eclipse/ant/internal/ui/views/actions/EditLaunchConfigurationAction.java;1;0;4;1;0;0;0;4;15;1;4;1811;19;19;1;0;0;4;4;1811;0;4030;4;1;
/org.eclipse.ui.examples.job/src/org/eclipse/ui/examples/jobs/views/SlowElementAdapter.java;3;1;3;1;3;3;3;0;12;0;0;5126;14;14;1;0;0;0;3;5126;0;5800;3;3;
/org.eclipse.team.cvs.ui/src/org/eclipse/team/internal/ccvs/ui/BranchPromptDialog.java;2;0;3;1;0;0;0;3;7;1;3;990;15;15;1;0;0;3;3;990;0;2381;3;2;
/org.eclipse.update.ui/srcnew/org/eclipse/update/internal/ui/wizards/EditSiteDialog.java;3;0;5;2;0;0;0;5;18;2;4;489;20;20;2;1;0;5;5;617;1;825;4;3;
/org.eclipse.jdt.core.tests.model/workspace/Converter/src/junit/runner/Version.java;1;0;1;1;0;0;0;1;0;0;1;3714;0;0;1;0;0;1;1;3714;0;3714;1;1;
/org.eclipse.jdt.ui/ui/org/eclipse/jdt/internal/ui/text/spelling/ChangeCaseProposal.java;2;0;2;1;1;1;1;1;2;0;1;3930;2;2;1;0;0;1;2;3930;0;6340;2;2;
/org.eclipse.swt/Eclipse SWT Drag and Drop/emulated/org/eclipse/swt/dnd/Clipboard.java;1;0;4;1;0;0;0;4;81;1;4;0;116;116;1;0;0;4;4;0;0;3032;4;1;
/org.eclipse.jdt.core.tests.model/workspace/Converter/src/test0523/A.java;1;0;1;1;0;0;0;1;0;0;1;3714;0;0;1;0;0;1;1;3714;0;3714;1;1;
/org.eclipse.pde.ui/src_Forms/org/eclipse/pde/internal/ui/newparts/SharedPartWithButtons.java;2;1;3;1;2;2;2;1;5;0;1;3795;5;5;1;0;0;1;3;3795;0;5431;3;2;
/org.eclipse.debug.ui/ui/org/eclipse/debug/internal/ui/actions/ToggleMethodBreakpointObjectActionDelegate.java;1;0;2;1;0;0;0;2;1;0;1;4492;1;1;2;1;0;2;2;4492;1;4492;1;1;
/org.eclipse.ui.examples.readmetool/Eclipse UI Examples Readme Tool/org/eclipse/ui/examples/readmetool/ReadmeFilePropertyPage.java;1;0;1;1;0;0;0;1;2;0;1;79;2;2;1;0;0;1;1;79;0;79;1;1;
/org.eclipse.team.ui/src/org/eclipse/team/internal/ui/synchronize/IPageValidator.java;1;0;2;1;1;1;1;1;2;0;1;4649;2;2;1;0;0;1;2;4649;0;6337;2;1;
/org.eclipse.jdt.core.tests.model/workspace/JavaSearch/src/e6/A.java;1;0;1;1;0;0;0;1;0;0;1;1238;0;0;1;0;0;1;1;1238;0;1238;1;1;
/org.eclipse.core.resources/src/org/eclipse/core/internal/indexing/IndexNode.java;2;0;3;1;1;1;1;2;171;0;1;178;205;205;2;1;0;2;3;178;1;5146;2;2;
/org.eclipse.pde.ui/src/org/eclipse/pde/internal/ui/util/SharedLabelProvider.java;3;1;4;1;2;2;2;2;10;1;2;2244;24;24;1;0;0;2;4;2244;0;6336;4;3;
/org.eclipse.ui.tests/Eclipse UI Tests/org/eclipse/ui/tests/dynamicplugins/DynamicUtils.java;1;0;2;1;1;1;1;1;34;0;1;4969;34;34;1;0;0;1;2;4969;0;6081;2;1;
/org.eclipse.ui.ide/extensions/org/eclipse/ui/IMarkerActionFilter.java;3;1;3;1;2;2;2;1;2;0;1;2263;4;4;1;0;0;1;3;2263;0;6338;3;3;
/org.eclipse.jdt.core.tests.model/workspace/Converter/src/test0039/Test.java;1;0;1;1;0;0;0;1;0;0;1;3714;0;0;1;0;0;1;1;3714;0;3714;1;1;
/org.eclipse.help/src/org/eclipse/help/internal/search/ISearchHitCollector.java;1;0;1;1;0;0;0;1;0;0;1;2732;0;0;1;0;0;1;1;2732;0;2732;1;1;
/org.eclipse.jdt.ui.tests.refactoring/resources/Delete/testDeleteWithinCu12/out/A.java;1;0;1;1;0;0;0;1;0;0;1;442;0;0;1;0;0;1;1;442;0;442;1;1;
/org.eclipse.help/src/org/eclipse/help/internal/workingset/AdaptableTocsArray.java;1;0;2;1;0;0;0;2;2;1;2;401;2;2;1;0;0;2;2;401;0;2732;2;1;
/org.eclipse.pde.ui/src_Forms/org/eclipse/pde/internal/ui/neweditor/schema/EnumerationRestrictionPage.java;1;0;2;1;0;0;0;2;0;1;2;4856;0;0;1;0;0;2;2;4856;0;4879;2;1;
/org.eclipse.jface/src/org/eclipse/jface/dialogs/MessageDialog.java;3;2;10;2;7;6;7;3;858;1;3;1;1713;1713;2;0;1;3;10;5615;1;6340;9;3;
/org.eclipse.jdt.ui.tests.refactoring/resources/ExtractInterface/testConditional2/out/I.java;1;0;1;1;0;0;0;1;0;0;1;3902;0;0;1;0;0;1;1;3902;0;3902;1;1;
/org.eclipse.update.core/srcnew/org/eclipse/update/search/IUpdateSearchSite.java;2;0;2;1;0;0;0;2;0;1;2;574;0;0;1;0;0;2;2;574;0;825;2;2;
/org.eclipse.jdt.core.tests.model/workspace/Converter/src/junit/extensions/RepeatedTest.java;1;0;1;1;0;0;0;1;0;0;1;3714;0;0;1;0;0;1;1;3714;0;3714;1;1;
/org.eclipse.jdt.ui.tests.refactoring/resources/MultiMove/test1/in/p1/B.java;1;0;1;1;0;0;0;1;0;0;1;1111;0;0;1;0;0;1;1;1111;0;1111;1;1;
/org.eclipse.jdt.ui.tests.refactoring/resources/PullUp/test24/in/A.java;1;0;1;1;0;0;0;1;16;0;1;1738;16;16;1;0;0;1;1;1738;0;1738;1;1;
/org.eclipse.core.tests.runtime/src/org/eclipse/core/tests/runtime/ProgressMonitorWrapperTest.java;1;0;1;1;1;1;1;0;72;0;0;5149;72;72;1;0;0;0;1;5149;0;5149;1;1;
/org.eclipse.pde.core/src_OSGi/org/eclipse/pde/internal/core/bundle/BundleModel.java;1;0;2;1;0;0;0;2;0;1;2;2193;0;0;1;0;0;2;2;2193;0;2229;2;1;
/org.eclipse.sdk.tests-feature/plugins/org.eclipse.perfmsr.ui/src/org/eclipse/perfmsr/ui/StepDialog.java;2;1;4;1;3;3;3;1;188;0;1;4845;206;206;1;0;0;1;4;4845;0;6342;4;2;
/org.eclipse.swt/Eclipse SWT Browser/mozilla/org/eclipse/swt/browser/PromptService.java;2;0;4;1;1;1;1;3;368;2;2;4853;374;374;2;1;0;3;4;4874;1;6352;3;2;
/org.eclipse.update.ui.forms/Eclipse Forms/org/eclipse/ui/forms/widgets/FormUtil.java;1;0;8;1;0;0;0;8;22;1;8;3138;44;44;1;0;0;8;8;3138;0;4157;8;1;
/org.eclipse.text/src/org/eclipse/jface/text/source/IAnnotationModel.java;2;1;4;1;3;3;3;1;124;0;1;2243;151;151;1;0;0;1;4;2243;0;6321;4;2;
/org.eclipse.webdav/src/kernel/org/eclipse/webdav/internal/kernel/InvalidPropertyNameException.java;1;0;2;1;2;1;2;0;35;0;0;5151;35;35;2;0;1;0;2;5151;1;5151;1;1;
/org.eclipse.ui.tests/Eclipse UI Tests/org/eclipse/ui/tests/api/ViewUtils.java;1;0;1;1;1;1;1;0;0;0;0;5590;0;0;1;0;0;0;1;5590;0;5590;1;1;
/org.eclipse.ant.ui/Ant Editor/org/eclipse/ant/internal/ui/editor/AntAutoIndentStrategy.java;1;1;6;1;5;5;5;1;208;0;1;4655;332;332;1;0;0;1;6;4655;0;6149;6;1;
/org.eclipse.jface.text/src/org/eclipse/jface/text/ITextViewerExtension5.java;2;2;7;2;4;3;4;3;65;1;3;4689;88;88;2;0;1;3;7;6340;1;6340;6;2;
/org.eclipse.jdt.ui/ui/org/eclipse/jdt/internal/ui/text/java/JavaStringAutoIndentStrategy.java;3;2;14;1;3;2;3;11;137;2;8;583;396;396;2;3;1;11;14;1582;4;6340;10;3;
/org.eclipse.ui.workbench/Eclipse UI/org/eclipse/ui/internal/ActionPresentation.java;3;0;3;1;0;0;0;3;52;1;3;3220;103;103;1;0;0;3;3;3220;0;3310;3;3;
/org.eclipse.ui.workbench/Eclipse UI/org/eclipse/ui/internal/commands/ContextAndHandlerManager.java;1;0;12;1;0;0;0;12;471;3;7;1065;1036;1036;3;5;0;12;12;1220;5;1710;7;1;
/org.eclipse.team.core/src/org/eclipse/team/core/ITeamStatus.java;2;1;5;1;2;2;2;3;39;1;3;4043;52;52;1;0;0;3;5;4043;0;6336;5;2;
/org.eclipse.ui.ide/extensions/org/eclipse/ui/ResourceWorkingSetFilter.java;1;0;1;1;0;0;0;1;0;0;1;2263;0;0;1;0;0;1;1;2263;0;2263;1;1;
/org.eclipse.jdt.ui/core refactoring/org/eclipse/ltk/core/refactoring/participants/ParticipantDescriptor.java;1;0;4;1;0;0;0;4;1;1;4;4624;2;2;1;0;0;4;4;4624;0;4864;4;1;
/org.eclipse.jdt.ui/ui/org/eclipse/jdt/internal/ui/reorg/MockWorkbenchSite.java;1;0;1;1;0;0;0;1;0;0;1;1111;0;0;1;0;0;1;1;1111;0;1111;1;1;
/org.eclipse.jdt.ui/ui/org/eclipse/jdt/internal/ui/filters/JavaFileFilter.java;1;0;1;1;1;1;1;0;2;0;0;6340;2;2;1;0;0;0;1;6340;0;6340;1;1;
/org.eclipse.jdt.ui/ui/org/eclipse/jdt/internal/ui/text/java/hover/BestMatchHover.java;2;1;5;1;2;2;2;3;41;1;3;692;91;91;1;0;0;3;5;692;0;6340;5;2;
/org.eclipse.jdt.core.tests.model/workspace/Converter/junit/runner/Version.java;1;0;2;1;0;0;0;2;26;1;2;787;26;26;1;0;0;2;2;787;0;3714;2;1;
/org.eclipse.jdt.ui/ui/org/eclipse/jdt/internal/ui/wizards/buildpaths/SourceAttachmentDialog.java;2;1;3;1;2;2;2;1;112;0;1;4407;119;119;1;0;0;1;3;4407;0;6340;3;2;
/org.eclipse.update.core/src/org/eclipse/update/internal/standalone/StandaloneUpdateApplication.java;2;0;9;1;0;0;0;9;47;2;8;828;77;77;2;1;0;9;9;2022;1;4928;8;2;
/org.eclipse.osgi/osgi/src/org/eclipse/osgi/service/resolver/PlatformAdmin.java;4;0;8;1;1;1;1;7;41;1;7;3013;140;140;1;0;0;7;8;3013;0;5117;8;4;
/org.eclipse.core.runtime/src/org/eclipse/core/internal/dependencies/ElementChange.java;2;0;2;1;0;0;0;2;0;1;2;2105;0;0;1;0;0;2;2;2105;0;3013;2;2;
/org.eclipse.jdt.junit/src/org/eclipse/jdt/internal/junit/ui/OpenEditorAtLineAction.java;3;1;5;1;3;3;3;2;54;1;2;416;112;112;1;0;0;2;5;416;0;6340;5;3;
/org.eclipse.team.cvs.core/src/org/eclipse/team/internal/ccvs/core/syncinfo/DeferredResourceChangeHandler.java;2;1;8;1;4;4;4;4;35;1;4;2104;109;109;1;0;0;4;8;2104;0;6337;8;2;
/org.eclipse.jdt.core.tests.model/workspace/Formatter/test290/A_in.java;1;0;1;1;0;0;0;1;0;0;1;2444;0;0;1;0;0;1;1;2444;0;2444;1;1;
/org.eclipse.pde.ui/src/org/eclipse/pde/internal/ui/editor/plugin/rows/ExtensionAttributeRow.java;2;1;4;1;4;4;4;0;10;0;0;5431;20;20;1;0;0;0;4;5431;0;6336;4;2;
/org.eclipse.jdt.ui.tests.refactoring/resources/ChangeSignature/canModify/A_testException03_in.java;1;0;1;1;0;0;0;1;0;0;1;4045;0;0;1;0;0;1;1;4045;0;4045;1;1;
/org.eclipse.jdt.core.tests.model/workspace/Formatter/test005/A_in.java;1;0;2;1;0;0;0;2;2;1;2;2425;2;2;1;0;0;2;2;2425;0;2462;2;1;
/org.eclipse.jdt.ui.tests/ui/org/eclipse/jdt/ui/tests/astrewrite/ASTRewritingTest.java;3;1;14;1;3;3;3;11;41;1;11;803;137;137;1;0;0;11;14;803;0;6340;14;3;
/org.eclipse.team.ui/src/org/eclipse/team/ui/TeamOperation.java;2;2;8;1;5;4;5;3;34;1;3;4518;126;126;2;0;1;3;8;5272;1;6333;7;2;
/org.eclipse.jdt.core.tests.model/workspace/Converter/src/junit/swingui/AboutDialog.java;1;0;1;1;0;0;0;1;0;0;1;3714;0;0;1;0;0;1;1;3714;0;3714;1;1;
/org.eclipse.jdt.ui.tests.refactoring/test cases/org/eclipse/jdt/ui/tests/nls/AllTests.java;3;1;5;1;3;3;3;2;16;1;2;1951;22;22;1;0;0;2;5;1951;0;6340;5;3;
/org.eclipse.ui.workbench/Eclipse UI/org/eclipse/ui/commands/IActionService.java;1;0;12;1;0;0;0;12;57;2;9;689;125;125;2;3;0;12;12;767;3;3258;9;1;
/org.eclipse.ant.ui/Ant Editor/org/eclipse/ant/ui/internal/dtd/schema/Model.java;1;0;2;1;0;0;0;2;0;1;2;250;0;0;1;0;0;2;2;250;0;1811;2;1;
/org.eclipse.team.cvs.ui/src/org/eclipse/team/internal/ccvs/ui/repo/RemoteViewPart.java;2;0;4;1;1;1;1;3;4;1;3;990;11;11;1;0;0;3;4;990;0;6337;4;2;
/org.eclipse.update.core/src/org/eclipse/update/internal/api/search/IUpdateSearchFilter.java;1;0;2;1;0;0;0;2;0;1;2;3270;0;0;1;0;0;2;2;3270;0;4928;2;1;
/org.eclipse.jdt.core/codeassist/org/eclipse/jdt/internal/codeassist/complete/CompletionOnQualifiedNameReference.java;3;0;3;1;0;0;0;3;20;1;3;991;31;31;1;0;0;3;3;991;0;3560;3;3;
/org.eclipse.jdt.ui.tests.refactoring/resources/DeleteSourceReference/test6/in/A.java;1;0;1;1;0;0;0;1;0;0;1;1652;0;0;1;0;0;1;1;1652;0;1652;1;1;
/org.eclipse.jdt.core/model/org/eclipse/jdt/core/jdom/IDOMMember.java;2;0;3;1;1;1;1;2;3;1;2;3560;7;7;1;0;0;2;3;3560;0;5584;3;2;
/org.eclipse.core.resources/src/org/eclipse/core/internal/resources/MarkerReader.java;1;0;1;1;1;1;1;0;61;0;0;5146;61;61;1;0;0;0;1;5146;0;5146;1;1;
/org.eclipse.jdt.ui/core refactoring/org/eclipse/jdt/internal/corext/refactoring/changes/DeleteFileChange.java;3;0;6;1;1;1;1;5;38;1;5;443;59;59;1;0;0;5;6;443;0;6340;6;3;
/org.eclipse.core.resources/src/org/eclipse/core/internal/utils/AssertionFailedException.java;1;0;2;1;1;1;1;1;23;0;1;3036;28;28;1;0;0;1;2;3036;0;5146;2;1;
/org.eclipse.pde.ui/src_Forms/org/eclipse/pde/internal/ui/neweditor/schema/TypeRestrictionDialog.java;1;0;2;1;0;0;0;2;0;1;2;4856;0;0;1;0;0;2;2;4856;0;4879;2;1;
/org.eclipse.jdt.core/compiler/org/eclipse/jdt/internal/compiler/ast/NameReference.java;1;0;1;1;0;0;0;1;2;0;1;3560;2;2;1;0;0;1;1;3560;0;3560;1;1;
/org.eclipse.jdt.ui/core refactoring/org/eclipse/jdt/internal/corext/refactoring/participants/xml/IPropertyTester.java;1;0;5;1;0;0;0;5;68;1;5;1033;72;72;1;0;0;5;5;1033;0;4108;5;1;
/org.eclipse.pde.ui/src_Forms/org/eclipse/pde/internal/ui/neweditor/schema/DescriptionSection.java;2;0;4;1;1;1;1;3;5;2;2;4856;9;9;2;1;0;3;4;4856;1;5431;3;2;
/org.eclipse.ui.workbench/Eclipse UI/org/eclipse/ui/activities/service/ICompoundActivityService.java;1;0;2;1;0;0;0;2;0;1;2;2896;0;0;1;0;0;2;2;2896;0;3066;2;1;
/org.eclipse.team.ui/src/org/eclipse/team/internal/ui/sync/views/SyncSetContentProvider.java;2;0;11;1;0;0;0;11;175;2;10;488;391;391;2;1;0;11;11;1477;1;2632;10;2;
/org.eclipse.jdt.core.tests.model/workspace/Converter15/src/test0005/X.java;1;0;1;1;0;0;0;1;0;0;1;4628;0;0;1;0;0;1;1;4628;0;4628;1;1;
/org.eclipse.jface/src/org/eclipse/jface/resource/ImageDescriptor.java;2;0;2;1;1;1;1;1;63;0;1;4050;65;65;1;0;0;1;2;4050;0;6338;2;2;
/org.eclipse.debug.ui/ui/org/eclipse/debug/ui/DebugUITools.java;4;2;31;2;9;8;9;22;131;3;17;618;726;726;3;5;1;22;31;1738;6;6335;25;4;
/org.eclipse.ui.tests/Eclipse UI Tests/org/eclipse/ui/tests/api/IWorkingSetTest.java;1;0;1;1;0;0;0;1;4;0;1;3091;4;4;1;0;0;1;1;3091;0;3091;1;1;
/org.eclipse.ui.workbench/Eclipse UI/org/eclipse/ui/internal/progress/FinishedJobs.java;4;3;19;2;19;13;19;0;354;0;0;5122;720;720;3;0;6;0;19;5122;6;6360;13;4;
/org.eclipse.ui.workbench/Eclipse UI/org/eclipse/ui/roles/IRoleListener.java;1;0;5;1;0;0;0;5;18;1;5;1952;36;36;1;0;0;5;5;1952;0;2864;5;1;
/org.eclipse.compare/compare/org/eclipse/compare/internal/BinaryCompareViewer.java;1;1;4;1;2;2;2;2;16;1;2;1289;27;27;1;0;0;2;4;1289;0;6354;4;1;
/org.eclipse.jdt.core/model/org/eclipse/jdt/internal/core/ElementCache.java;1;0;2;1;0;0;0;2;5;1;2;878;7;7;1;0;0;2;2;878;0;3560;2;1;
/org.eclipse.help.tests/src/org/eclipse/help/tests/base/TestContexts.java;1;1;3;1;2;2;2;1;26;0;1;2732;50;50;1;0;0;1;3;2732;0;6337;3;1;
/org.eclipse.update.tests.core/src/org/eclipse/update/tests/regularInstall/TestExecutableInstall.java;2;0;5;1;1;1;1;4;4;1;4;2048;16;16;1;0;0;4;5;2048;0;6336;5;2;
/org.eclipse.jdt.ui.tests.refactoring/resources/ExtractMethodWorkSpace/ExtractMethodTests/duplicates_out/A_test953.java;1;0;1;1;0;0;0;1;0;0;1;1219;0;0;1;0;0;1;1;1219;0;1219;1;1;
/org.eclipse.ui.workbench/Eclipse UI/org/eclipse/ui/internal/presentations/NativePresentationFactory.java;2;1;3;1;3;3;3;0;31;0;0;5144;35;35;1;0;0;0;3;5144;0;5520;3;2;
/org.eclipse.core.tests.runtime/src/org/eclipse/core/tests/runtime/IAdapterManagerTest.java;2;1;6;1;2;2;2;4;76;2;3;3812;121;121;2;1;0;4;6;4128;1;5987;5;2;
/org.eclipse.ant.ui/Ant Tools Support/org/eclipse/ant/ui/internal/console/BuildFailedTracker.java;1;0;2;1;0;0;0;2;0;1;2;558;0;0;1;0;0;2;2;558;0;1811;2;1;
/org.eclipse.core.tests.resources/src/org/eclipse/core/tests/internal/indexing/StandAlonePageStoreTest.java;1;0;1;1;1;1;1;0;4;0;0;5147;4;4;1;0;0;0;1;5147;0;5147;1;1;
/org.eclipse.swt/Eclipse SWT/win32/org/eclipse/swt/widgets/Tray.java;1;0;2;1;0;0;0;2;17;0;1;4517;17;17;2;1;0;2;2;4517;1;4517;1;1;
/org.eclipse.pde.core/src_OSGi/org/eclipse/pde/internal/core/osgi/bundle/BundlePluginBase.java;2;0;8;1;0;0;0;8;198;2;7;2485;277;277;2;1;0;8;8;2537;1;4203;7;2;
/org.eclipse.team.core/src/org/eclipse/team/core/IProjectSetSerializer.java;2;1;4;1;3;3;3;1;4;0;1;4968;10;10;1;0;0;1;4;4968;0;6336;4;2;
/org.eclipse.ui.forms/src/org/eclipse/ui/forms/widgets/Twistie.java;1;0;6;1;1;1;1;5;19;1;5;4068;37;37;1;0;0;5;6;4068;0;6336;6;1;
/org.eclipse.jface.text/src/org/eclipse/jface/text/link/LinkedUIControl.java;2;0;12;1;2;1;2;10;159;1;10;4214;330;330;2;0;1;10;12;5127;1;5127;11;2;
/org.eclipse.swt/Eclipse SWT Custom Widgets/common/org/eclipse/swt/custom/CCombo.java;4;2;21;1;7;6;7;14;87;2;12;1;373;373;2;2;1;14;21;954;3;6352;18;4;
/org.eclipse.jdt.ui/core refactoring/org/eclipse/jdt/internal/corext/refactoring/participants/xml/PackageFragmentExtender.java;1;0;4;1;0;0;0;4;11;1;4;2891;13;13;1;0;0;4;4;2891;0;4941;4;1;
/org.eclipse.swt/Eclipse SWT/photon/org/eclipse/swt/widgets/Scale.java;3;1;4;1;2;2;2;2;22;1;2;32;34;34;1;0;0;2;4;32;0;6352;4;3;
/org.eclipse.core.tests.resources/src/org/eclipse/core/tests/internal/localstore/CaseSensitivityTest.java;1;0;3;1;3;1;3;0;1283;0;0;5147;1283;1283;3;0;2;0;3;5147;2;5147;1;1;
/org.eclipse.jdt.ui.tests.refactoring/resources/ChangeTypeRefactoring/positive/A_testMultiCU_in.java;1;0;1;1;0;0;0;1;0;0;1;2844;0;0;1;0;0;1;1;2844;0;2844;1;1;
/org.eclipse.jdt.ui/core refactoring/org/eclipse/ltk/core/refactoring/Change.java;1;0;3;1;0;0;0;3;6;1;3;4575;6;6;1;0;0;3;3;4575;0;4864;3;1;
/org.eclipse.jdt.ui.tests.refactoring/resources/MoveMembers/test29/in/B.java;1;0;1;1;0;0;0;1;0;0;1;1651;0;0;1;0;0;1;1;1651;0;1651;1;1;
/org.eclipse.core.tests.resources/src/org/eclipse/core/tests/resources/session/TestInterestingProjectPersistence.java;1;0;2;1;2;1;2;0;261;0;0;5147;261;261;2;0;1;0;2;5147;1;5147;1;1;
/org.eclipse.jdt.core.tests.model/workspace/Converter/src/test0253/Test.java;1;0;1;1;0;0;0;1;0;0;1;3714;0;0;1;0;0;1;1;3714;0;3714;1;1;
/org.eclipse.jdt.debug.tests/tests/org/eclipse/jdt/debug/tests/eval/NestedTypeFieldValue_145.java;1;0;1;1;0;0;0;1;84;0;1;1274;84;84;1;0;0;1;1;1274;0;1274;1;1;
/org.eclipse.jdt.ui/core refactoring/org/eclipse/jdt/internal/corext/refactoring/rename/RenameResourceProcessor.java;2;1;18;1;4;4;4;14;38;2;13;1125;172;172;2;1;0;14;18;1125;1;6340;17;2;
/org.eclipse.ui.workbench/Eclipse UI/org/eclipse/ui/internal/misc/ResourceAndContainerGroup.java;1;0;1;1;0;0;0;1;0;0;1;2737;0;0;1;0;0;1;1;2737;0;2737;1;1;
/org.eclipse.jdt.ui/core extension/org/eclipse/jdt/internal/corext/Assert.java;1;0;1;1;1;1;1;0;2;0;0;6340;2;2;1;0;0;0;1;6340;0;6340;1;1;
/org.eclipse.team.cvs.ssh2/src/org/eclipse/team/internal/ccvs/ssh2/JSchSession.java;3;1;9;1;7;7;7;2;78;1;2;4825;136;136;1;0;0;2;9;4825;0;6215;9;3;
/org.eclipse.jdt.core.tests.model/workspace/Converter/src/javadoc/test107/TestB1.java;1;0;1;1;0;0;0;1;0;0;1;4390;0;0;1;0;0;1;1;4390;0;4390;1;1;
/org.eclipse.jdt.ui.tests.refactoring/resources/ExtractMethodWorkSpace/ExtractMethodTests/locals_in/A_test505.java;1;0;1;1;0;0;0;1;2;0;1;844;2;2;1;0;0;1;1;844;0;844;1;1;
/org.eclipse.jdt.core.tests.model/workspace/Formatter/test313/A_in.java;1;0;1;1;0;0;0;1;0;0;1;2444;0;0;1;0;0;1;1;2444;0;2444;1;1;
/org.eclipse.jdt.core.tests.model/workspace/Formatter/test033/A_out.java;1;0;1;1;0;0;0;1;0;0;1;2425;0;0;1;0;0;1;1;2425;0;2425;1;1;
/org.eclipse.swt/Eclipse SWT Drag and Drop/motif/org/eclipse/swt/dnd/ByteArrayTransfer.java;1;0;1;1;0;0;0;1;30;0;1;328;30;30;1;0;0;1;1;328;0;328;1;1;
/org.eclipse.team.ui/src/org/eclipse/team/internal/ui/synchronize/RefreshUserNotificationPolicy.java;2;2;21;2;11;10;11;10;68;2;8;4518;229;229;2;2;1;10;21;4602;3;6337;18;2;
/org.eclipse.webdav/src/client/org/eclipse/webdav/client/WebDAVFactory.java;1;0;1;1;1;1;1;0;11;0;0;5151;11;11;1;0;0;0;1;5151;0;5151;1;1;
/org.eclipse.jdt.debug.ui/ui/org/eclipse/jdt/internal/debug/ui/launcher/AddVMDialog.java;3;0;4;1;0;0;0;4;25;2;3;163;30;30;2;1;0;4;4;163;1;1039;3;3;
/org.eclipse.pde.ui/src/org/eclipse/pde/internal/ui/editor/PDEMultiPageContentOutline.java;2;1;4;1;3;3;3;1;60;0;1;648;76;76;1;0;0;1;4;648;0;6336;4;2;
/org.eclipse.ui.workbench/Eclipse UI/org/eclipse/ui/internal/AboutAction.java;1;0;1;1;0;0;0;1;0;0;1;2737;0;0;1;0;0;1;1;2737;0;2737;1;1;
/org.eclipse.core.resources/src/org/eclipse/core/internal/events/ResourceDeltaFactory.java;2;0;3;1;1;1;1;2;316;1;2;1744;330;330;1;0;0;2;3;1744;0;5146;3;2;
/org.eclipse.pde.ui/src/org/eclipse/pde/ui/IExtensionWizard.java;2;1;4;1;4;4;4;0;56;0;0;5115;72;72;1;0;0;0;4;5115;0;6336;4;2;
/org.eclipse.jdt.debug.ui/ui/org/eclipse/jdt/debug/ui/AbstractJavaVariablesContentProvider.java;2;0;5;2;0;0;0;5;111;2;4;670;143;143;2;1;0;5;5;670;1;861;4;2;
/org.eclipse.ui.workbench/Eclipse UI/org/eclipse/ui/internal/PartDragDrop.java;1;0;1;1;0;0;0;1;0;0;1;4015;0;0;1;0;0;1;1;4015;0;4015;1;1;
/org.eclipse.ui.workbench/Eclipse UI/org/eclipse/ui/internal/csm/roles/AbstractMutableRoleRegistry.java;1;0;3;1;0;0;0;3;2;1;3;2213;2;2;1;0;0;3;3;2213;0;2371;3;1;
/org.eclipse.update.core/src/org/eclipse/update/internal/model/InstallConfigurationModel.java;2;1;11;1;3;3;3;8;34;2;7;890;96;96;2;1;0;8;11;4371;1;6336;10;2;
/org.eclipse.team.ui/src/org/eclipse/team/internal/ui/synchronize/SubscriberRefreshSchedule.java;2;2;8;2;8;7;8;0;10;0;0;5362;37;37;2;0;1;0;8;5362;1;6337;7;2;
/org.eclipse.ant.ui/Ant Editor/org/eclipse/ant/internal/ui/editor/outline/FilterSubtargetsAction.java;2;0;2;2;0;0;0;2;0;0;1;1915;0;0;2;1;0;2;2;1915;1;1915;1;2;
/org.eclipse.jdt.ui.tests.refactoring/resources/ExtractMethodWorkSpace/ExtractMethodTests/duplicates_in/A_test963.java;1;0;1;1;1;1;1;0;0;0;0;5681;0;0;1;0;0;0;1;5681;0;5681;1;1;
/org.eclipse.jdt.core.tests.model/workspace/Converter/src/test0189/Test.java;1;0;1;1;0;0;0;1;0;0;1;3714;0;0;1;0;0;1;1;3714;0;3714;1;1;
/org.eclipse.pde.ui/src/org/eclipse/pde/internal/ui/editor/context/InputContext.java;2;2;12;2;12;10;12;0;52;0;0;5431;134;134;2;0;2;0;12;5442;2;6336;10;2;
/org.eclipse.jdt.core/model/org/eclipse/jdt/core/util/ClassFileBytesDisassembler.java;1;0;1;1;0;0;0;1;2;0;1;3560;2;2;1;0;0;1;1;3560;0;3560;1;1;
/org.eclipse.ui.ide/src/org/eclipse/ui/internal/misc/ContainerSelectionGroup.java;2;0;4;1;0;0;0;4;7;1;4;1526;13;13;1;0;0;4;4;1526;0;2263;4;2;
/org.eclipse.team.cvs.ui/src/org/eclipse/team/internal/ccvs/ui/subscriber/SyncResourceSetDetailsDialog.java;2;0;5;1;0;0;0;5;173;1;5;709;207;207;1;0;0;5;5;709;0;1132;5;2;
/org.eclipse.team.webdav/src/org/eclipse/team/internal/ui/target/subscriber/SiteCreationPage.java;2;0;3;1;1;1;1;2;41;1;2;3494;43;43;1;0;0;2;3;3494;0;6337;3;2;
/org.eclipse.ui.externaltools/Program Tools Support/org/eclipse/ui/externaltools/internal/program/launchConfigurations/ProgramBuilderTabGroup.java;3;0;6;1;1;1;1;5;4;1;5;327;16;16;1;0;0;5;6;327;0;6336;6;3;
/org.eclipse.ui.workbench/Eclipse UI/org/eclipse/ui/IWorkbenchPart2.java;2;1;6;1;6;6;6;0;8;0;0;5471;30;30;1;0;0;0;6;5471;0;6101;6;2;
/org.eclipse.jface/src/org/eclipse/jface/preference/BooleanPropertyAction.java;2;0;2;1;1;1;1;1;19;0;1;536;19;19;1;0;0;1;2;536;0;5463;2;2;
/org.eclipse.jdt.ui.tests.refactoring/resources/IntroduceParameter/simple/out/NewInstanceImport.java;1;0;1;1;0;0;0;1;0;0;1;2281;0;0;1;0;0;1;1;2281;0;2281;1;1;
/org.eclipse.team.ui/src/org/eclipse/team/ui/synchronize/SubscriberParticipant.java;2;2;14;2;14;13;14;0;329;0;0;5362;729;729;2;0;1;0;14;5362;1;6337;13;2;
/org.eclipse.ui.externaltools/Ant Tools Support/org/eclipse/ui/externaltools/internal/ant/view/actions/AddBuildFileAction.java;2;0;2;1;0;0;0;2;2;1;2;139;2;2;1;0;0;2;2;139;0;282;2;2;
/org.eclipse.team.ui/src/org/eclipse/team/internal/ui/synchronize/SyncChangesTableViewer.java;1;0;1;1;0;0;0;1;0;0;1;3221;0;0;1;0;0;1;1;3221;0;3221;1;1;
/org.eclipse.swt/Eclipse SWT PI/win32/org/eclipse/swt/internal/win32/COMBOBOXINFO.java;1;0;1;1;0;0;0;1;0;0;1;2028;0;0;1;0;0;1;1;2028;0;2028;1;1;
/org.eclipse.jdt.ui/ui refactoring/org/eclipse/jdt/internal/ui/refactoring/actions/RefactoringErrorDialogUtil.java;2;0;5;1;0;0;0;5;22;1;5;1572;50;50;1;0;0;5;5;1572;0;5083;5;2;
/org.eclipse.jdt.ui/core refactoring/org/eclipse/jdt/internal/corext/refactoring/code/PromoteTempToFieldRefactoring.java;5;1;31;2;5;5;5;26;79;2;24;122;366;366;2;2;0;26;31;546;2;6340;29;5;
/org.eclipse.jdt.ui.examples.javafamily/src/org/eclipse/jdt/internal/ui/examples/jspeditor/Jsp2JavaTagHandler.java;2;0;5;1;1;1;1;4;75;1;4;1172;157;157;1;0;0;4;5;1172;0;5122;5;2;
/org.eclipse.swt.tests/JUnit Tests/org/eclipse/swt/tests/junit/Test_org_eclipse_swt_events_ShellAdapter.java;1;0;2;1;1;1;1;1;16;0;1;3443;20;20;1;0;0;1;2;3443;0;6352;2;1;
/org.eclipse.ltk.core.refactoring/src/org/eclipse/ltk/internal/core/refactoring/DelegatingValidationStateChange.java;1;0;2;1;0;0;0;2;0;1;2;4845;0;0;1;0;0;2;2;4845;0;4864;2;1;
/org.eclipse.jdt.ui/core extension/org/eclipse/jdt/internal/corext/dom/ASTRewriteClear.java;2;0;7;1;1;1;1;6;8;1;6;85;29;29;1;0;0;6;7;85;0;6340;7;2;
/org.eclipse.jdt.core.tests.model/workspace/Converter/src/test0541/B.java;1;0;1;1;0;0;0;1;0;0;1;4872;0;0;1;0;0;1;1;4872;0;4872;1;1;
/org.eclipse.jdt.core/compiler/org/eclipse/jdt/internal/compiler/lookup/ProblemPackageBinding.java;1;0;1;1;0;0;0;1;2;0;1;3560;2;2;1;0;0;1;1;3560;0;3560;1;1;
/org.eclipse.jdt.core.tests.model/src/org/eclipse/jdt/core/tests/model/InclusionPatternsTests.java;1;2;8;1;7;6;7;1;68;0;1;4887;243;243;2;0;1;1;8;6094;1;6261;7;1;
/org.eclipse.swt.tests/JUnit Tests/org/eclipse/swt/tests/junit/Test_org_eclipse_swt_events_MenuListener.java;1;0;1;1;0;0;0;1;16;0;1;2175;16;16;1;0;0;1;1;2175;0;2175;1;1;
/org.eclipse.text/src/org/eclipse/jface/text/DocumentPartitioningChangedEvent.java;2;1;5;1;2;2;2;3;20;2;2;1510;44;44;2;1;0;3;5;2218;1;6340;4;2;
/org.eclipse.jdt.ui/ui/org/eclipse/jdt/internal/ui/typehierarchy/FocusOnTypeAction.java;1;0;1;1;1;1;1;0;2;0;0;6340;2;2;1;0;0;0;1;6340;0;6340;1;1;
/org.eclipse.jdt.core.tests.compiler/src/org/eclipse/jdt/core/tests/compiler/parser/SourceImport.java;2;0;2;1;0;0;0;2;3;1;2;85;5;5;1;0;0;2;2;85;0;3560;2;2;
/org.eclipse.jdt.core/codeassist/org/eclipse/jdt/internal/codeassist/ISearchRequestor.java;1;0;1;1;0;0;0;1;2;0;1;3560;2;2;1;0;0;1;1;3560;0;3560;1;1;
/org.eclipse.ui.ide/src/org/eclipse/ui/wizards/datatransfer/FileSystemExportWizard.java;2;0;4;1;0;0;0;4;31;1;4;1511;46;46;1;0;0;4;4;1511;0;2280;4;2;
/org.eclipse.update.core/src/org/eclipse/update/core/IInstallHandlerEntry.java;2;1;3;1;2;2;2;1;6;0;1;890;14;14;1;0;0;1;3;890;0;6336;3;2;
/org.eclipse.debug.ui/ui/org/eclipse/debug/internal/ui/sourcelookup/UpAction.java;1;0;1;1;0;0;0;1;0;0;1;3770;0;0;1;0;0;1;1;3770;0;3770;1;1;
/org.eclipse.swt/Eclipse SWT PI/win32/org/eclipse/swt/internal/win32/TEXTMETRICW.java;1;0;1;1;0;0;0;1;0;0;1;957;0;0;1;0;0;1;1;957;0;957;1;1;
/org.eclipse.ui.workbench/Eclipse UI/org/eclipse/ui/contexts/IWorkbenchContextSupport.java;4;1;16;1;2;2;2;14;131;2;12;3066;388;388;2;2;0;14;16;3129;2;6338;14;4;
/org.eclipse.jdt.ui/ui/org/eclipse/jdt/internal/ui/preferences/formatter/ProfileManager.java;2;0;11;1;1;1;1;10;103;2;9;3103;379;379;2;1;0;10;11;3103;1;6120;10;2;
/org.eclipse.ui.workbench/Eclipse UI/org/eclipse/ui/keys/AlphabeticModifierKeyComparator.java;2;0;2;1;0;0;0;2;0;1;2;3214;0;0;1;0;0;2;2;3214;0;3310;2;2;
/org.eclipse.ui.examples.javaeditor/Eclipse Java Editor Example/org/eclipse/ui/examples/javaeditor/JavaPartitionScanner.java;2;0;2;1;1;1;1;1;2;0;1;1581;2;2;1;0;0;1;2;1581;0;6340;2;2;
/org.eclipse.ui.workbench/Eclipse UI/org/eclipse/ui/IWorkbenchPropertyPage.java;2;1;2;1;2;2;2;0;8;0;0;5483;10;10;1;0;0;0;2;5483;0;6338;2;2;
/org.eclipse.team.ui/src/org/eclipse/team/internal/ui/synchronize/views/LogicalViewProvider.java;1;0;1;1;0;0;0;1;0;0;1;3796;0;0;1;0;0;1;1;3796;0;3796;1;1;
/org.eclipse.jdt.ui.tests.refactoring/resources/MoveInnerToTopLevel/test_nonstatic_6/out/Inner.java;1;0;1;1;0;0;0;1;1;0;1;305;1;1;1;0;0;1;1;305;0;305;1;1;
/org.eclipse.jdt.ui.tests.refactoring/resources/IntroduceFactory/positive/StaticContext_in.java;1;0;2;1;1;1;1;1;2;0;1;2862;2;2;1;0;0;1;2;2862;0;5659;2;1;
/org.eclipse.pde.core/src/org/eclipse/pde/internal/core/WorkspaceResourceHelper.java;1;0;3;1;1;1;1;2;6;1;2;645;10;10;1;0;0;2;3;645;0;5703;3;1;
/org.eclipse.jdt.debug/eval/org/eclipse/jdt/internal/debug/eval/ast/instructions/SendMessage.java;2;0;2;1;0;0;0;2;3;1;2;1240;5;5;1;0;0;2;2;1240;0;1276;2;2;
/org.eclipse.jdt.core.tests.model/workspace/Converter/test0121/Test.java;1;0;1;1;0;0;0;1;0;0;1;3714;0;0;1;0;0;1;1;3714;0;3714;1;1;
/org.eclipse.jdt.ui/core extension/org/eclipse/jdt/internal/corext/dom/TypeRules.java;3;1;6;1;2;2;2;4;82;1;4;955;115;115;1;0;0;4;6;955;0;6340;6;3;
/org.eclipse.jdt.core.tests.compiler/src/org/eclipse/jdt/core/tests/eval/DebugEvaluationTest.java;3;0;10;1;1;1;1;9;387;2;8;1387;442;442;2;1;0;9;10;1792;1;5853;9;3;
/org.eclipse.ui.workbench/Eclipse UI/org/eclipse/ui/internal/activities/ActivityActivityBindingDefinition.java;3;0;6;1;1;1;1;5;18;1;5;2896;32;32;1;0;0;5;6;2896;0;5760;6;3;
/org.eclipse.team.ui/src/org/eclipse/team/internal/ui/synchronize/actions/ToolItemActionContributionItem.java;2;0;3;1;0;0;0;3;851;1;3;2535;851;851;1;0;0;3;3;2535;0;2641;3;2;
/org.eclipse.jdt.core/compiler/org/eclipse/jdt/internal/compiler/AbstractSyntaxTreeVisitorAdapter.java;3;0;8;1;0;0;0;8;227;1;8;148;356;356;1;0;0;8;8;148;0;2974;8;3;
/org.eclipse.jdt.core/search/org/eclipse/jdt/internal/core/search/matching/MethodReferencePattern.java;2;0;4;1;0;0;0;4;20;1;4;86;24;24;1;0;0;4;4;86;0;1115;4;2;
/org.eclipse.jdt.core/search/org/eclipse/jdt/internal/core/search/matching/ConstructorPattern.java;2;3;19;1;4;2;4;15;174;2;14;1115;693;693;3;1;2;15;19;5207;3;5335;16;2;
/org.eclipse.jdt.launching/launching/org/eclipse/jdt/internal/launching/Standard11xVMRunner.java;3;1;4;1;2;2;2;2;4;1;2;3812;12;12;1;0;0;2;4;3812;0;6336;4;3;
/org.eclipse.webdav/src/kernel/org/eclipse/webdav/internal/kernel/ElementHelper.java;1;0;2;1;2;1;2;0;31;0;0;5151;31;31;2;0;1;0;2;5151;1;5151;1;1;
/org.eclipse.jdt.ui/core refactoring/org/eclipse/jdt/internal/corext/refactoring/util/QualifiedNameFinder.java;3;1;10;1;4;4;4;6;33;2;5;1217;99;99;2;1;0;6;10;1953;1;6340;9;3;
/org.eclipse.jdt.ui.tests.refactoring/resources/StructureSelectionAction/A_testZeroLength2.java;1;0;1;1;1;1;1;0;0;0;0;6144;0;0;1;0;0;0;1;6144;0;6144;1;1;
/org.eclipse.jdt.ui.tests.refactoring/resources/ExtractMethodWorkSpace/ExtractMethodTests/return_out/A_test728.java;1;0;2;1;0;0;0;2;6;1;2;130;7;7;1;0;0;2;2;130;0;844;2;1;
/org.eclipse.jdt.debug.tests/tests/org/eclipse/jdt/debug/tests/AbstractDebugTest.java;4;2;16;1;4;3;4;12;66;2;11;217;229;229;2;1;1;12;16;3613;2;6337;14;4;
/org.eclipse.core.runtime/src/org/eclipse/core/internal/plugins/RegistryResolver.java;1;0;1;1;0;0;0;1;0;0;1;3013;0;0;1;0;0;1;1;3013;0;3013;1;1;
/org.eclipse.swt/Eclipse SWT PI/photon/org/eclipse/swt/internal/Platform.java;1;0;1;1;0;0;0;1;0;0;1;1969;0;0;1;0;0;1;1;1969;0;1969;1;1;
/org.eclipse.ui.workbench/Eclipse UI/org/eclipse/ui/internal/csm/activities/api/IActivityManagerListener.java;1;0;3;1;0;0;0;3;18;2;2;2225;18;18;2;1;0;3;3;2238;1;2238;2;1;
/org.eclipse.team.cvs.ui/src/org/eclipse/team/internal/ccvs/ui/actions/CompareWithTagAction.java;2;1;17;1;8;8;8;9;54;1;9;1133;270;270;1;0;0;9;17;1133;0;6337;17;2;
/org.eclipse.help.ide/src/org/eclipse/help/ui/internal/search/ResultTableContentProvider.java;1;0;1;1;1;1;1;0;0;0;0;5216;0;0;1;0;0;0;1;5216;0;5216;1;1;
/org.eclipse.ui.workbench/Eclipse UI/org/eclipse/ui/internal/registry/EditorDescriptor.java;5;1;11;2;3;3;3;8;193;2;7;2737;319;319;2;1;0;8;11;3061;1;6338;10;5;
/org.eclipse.core.runtime/src/org/eclipse/core/internal/registry/FlushableExtension.java;2;1;3;1;3;3;3;0;12;0;0;5681;27;27;1;0;0;0;3;5681;0;6041;3;2;
/org.eclipse.jdt.debug.ui/ui/org/eclipse/jdt/internal/debug/ui/launcher/LocalJavaApplicationTabGroup.java;3;0;4;1;1;1;1;3;4;1;3;2606;13;13;1;0;0;3;4;2606;0;6336;4;3;
/org.eclipse.debug.ui/ui/org/eclipse/debug/ui/launchVariables/IVariableExpander.java;1;0;2;1;0;0;0;2;0;1;2;550;0;0;1;0;0;2;2;550;0;562;2;1;
/org.eclipse.ant.ui/Ant Editor/org/eclipse/ant/internal/ui/editor/model/AntTargetNode.java;1;0;8;1;0;0;0;8;19;2;6;3661;79;79;2;2;0;8;8;3661;2;4587;6;1;
/org.eclipse.swt/Eclipse SWT PI/gtk/org/eclipse/swt/internal/accessibility/gtk/ATK.java;4;1;12;1;2;2;2;10;100;1;10;1214;163;163;1;0;0;10;12;1214;0;6352;12;4;
/org.eclipse.ui.workbench/Eclipse UI/org/eclipse/ui/internal/progress/ProgressMonitorJobsDialog.java;2;2;24;1;15;13;15;9;275;1;9;2425;722;722;2;0;2;9;24;6077;2;6269;22;2;
/org.eclipse.ui.workbench/Eclipse UI/org/eclipse/ui/internal/presentations/UpdatingActionContributionItem.java;1;0;1;1;1;1;1;0;0;0;0;5173;0;0;1;0;0;0;1;5173;0;5173;1;1;
/org.eclipse.jdt.core.tests.model/workspace/Resolve/src/ResolveDuplicateMethodDeclaration.java;1;0;1;1;1;1;1;0;0;0;0;6222;0;0;1;0;0;0;1;6222;0;6222;1;1;
/org.eclipse.ui.workbench/Eclipse UI/org/eclipse/ui/IPageLayout.java;6;2;12;2;6;5;6;6;49;1;6;520;223;223;2;0;1;6;12;6338;1;6338;11;6;
/org.eclipse.jdt.ui.tests.refactoring/resources/ExtractMethodWorkSpace/ExtractMethodTests/locals_in/A_test503.java;1;0;1;1;0;0;0;1;2;0;1;844;2;2;1;0;0;1;1;844;0;844;1;1;
/org.eclipse.ua.tests/src/org/eclipse/ui/tests/cheatsheets/actions/NoopAction.java;1;0;1;1;1;1;1;0;0;0;0;6081;0;0;1;0;0;0;1;6081;0;6081;1;1;
/org.eclipse.jdt.core.tests.model/workspace/Converter/src/test0313/Test.java;1;0;1;1;0;0;0;1;0;0;1;3714;0;0;1;0;0;1;1;3714;0;3714;1;1;
/org.eclipse.ui.examples.javaeditor/Eclipse Java Editor Example/org/eclipse/ui/examples/javaeditor/spelling/SpellCheckReconciler.java;1;0;1;1;0;0;0;1;0;0;1;2565;0;0;1;0;0;1;1;2565;0;2565;1;1;
/org.eclipse.osgi/resolver/src/org/eclipse/core/dependencies/IDependency.java;3;1;3;1;2;2;2;1;9;0;1;3013;9;9;1;0;0;1;3;3013;0;5226;3;3;
/org.eclipse.team.ui/src/org/eclipse/team/ui/synchronize/actions/ToggleViewLayoutAction.java;1;0;1;1;0;0;0;1;0;0;1;2535;0;0;1;0;0;1;1;2535;0;2535;1;1;
/org.eclipse.swt.graphics.text/Eclipse SWT/emulated/org/eclipse/swt/graphics/text/TextLayout.java;2;0;12;1;0;0;0;12;2131;1;12;2744;5589;5589;1;0;0;12;12;2744;0;4472;12;2;
/org.eclipse.jdt.core/compiler/org/eclipse/jdt/internal/compiler/impl/LongConstant.java;2;0;3;1;1;1;1;2;6;1;2;1111;14;14;1;0;0;2;3;1111;0;5587;3;2;
/org.eclipse.swt/Eclipse SWT PI/gtk/org/eclipse/swt/internal/gtk/GtkAdjustment.java;2;0;2;1;1;1;1;1;17;0;1;1653;19;19;1;0;0;1;2;1653;0;6352;2;2;
/org.eclipse.jdt.core.tests.model/workspace/Converter/src/test0522/A.java;1;0;1;1;0;0;0;1;0;0;1;3714;0;0;1;0;0;1;1;3714;0;3714;1;1;
/org.eclipse.debug.ui/ui/org/eclipse/debug/ui/ILaunchConfigurationTabGroup.java;1;0;2;1;0;0;0;2;45;1;2;1742;49;49;1;0;0;2;2;1742;0;2712;2;1;
/org.eclipse.jdt.ui/core refactoring/org/eclipse/ltk/core/refactoring/participants/IProcessorBasedRefactoring.java;1;0;2;1;0;0;0;2;0;1;2;4624;0;0;1;0;0;2;2;4624;0;4654;2;1;
/org.eclipse.core.runtime.osgi/src/org/eclipse/core/runtime/jobs/JobChangeAdapter.java;1;0;2;1;0;0;0;2;9;1;2;3013;9;9;1;0;0;2;2;3013;0;3030;2;1;
/org.eclipse.osgi/core/adaptor/org/eclipse/osgi/framework/adaptor/core/AbstractFrameworkAdaptor.java;3;0;4;1;0;0;0;4;3;1;4;3013;5;5;1;0;0;4;4;3013;0;4336;4;3;
/org.eclipse.update.ui.forms/Eclipse Forms/org/eclipse/ui/forms/widgets/RichText.java;1;0;4;1;0;0;0;4;12;1;4;3138;13;13;1;0;0;4;4;3138;0;4157;4;1;
/org.eclipse.jdt.core/compiler/org/eclipse/jdt/internal/compiler/lookup/UpdatedMethodBinding.java;2;0;2;1;0;0;0;2;2;1;2;530;2;2;1;0;0;2;2;530;0;3560;2;2;
/org.eclipse.pde.ui/src/org/eclipse/pde/internal/ui/wizards/extension/NewExtensionPointMainPage.java;2;1;6;1;4;4;4;2;54;1;2;648;82;82;1;0;0;2;6;648;0;6336;6;2;
/org.eclipse.core.runtime/src/org/eclipse/core/internal/preferences/EclipsePreferences.java;2;3;44;2;20;14;20;24;1454;2;18;4351;3158;3158;3;6;6;24;44;5103;12;5876;32;2;
/org.eclipse.ui.workbench/Eclipse UI/org/eclipse/ui/internal/roles/SwapActivityHelper.java;2;0;3;1;0;0;0;3;7;2;2;2279;7;7;2;1;0;3;3;2279;1;2443;2;2;
/org.eclipse.ui.workbench/Eclipse UI/org/eclipse/ui/internal/activities/ws/ActivityCategoryContentProvider.java;2;0;2;1;1;1;1;1;2;0;1;3458;2;2;1;0;0;1;2;3458;0;6338;2;2;
/org.eclipse.swt/Eclipse SWT PI/carbon/org/eclipse/swt/internal/carbon/OS.java;4;2;59;2;13;11;13;46;35;2;41;82;325;325;2;5;2;46;59;94;7;6130;52;4;
/org.eclipse.ui.externaltools/Ant Tools Support/org/eclipse/ui/externaltools/internal/ant/preferences/AntPropertiesLabelProvider.java;1;0;1;1;0;0;0;1;0;0;1;282;0;0;1;0;0;1;1;282;0;282;1;1;
/org.eclipse.core.resources/src/org/eclipse/core/internal/properties/IVisitor.java;1;0;1;1;1;1;1;0;72;0;0;5146;72;72;1;0;0;0;1;5146;0;5146;1;1;
/org.eclipse.jdt.core/search/org/eclipse/jdt/internal/core/search/indexing/IndexManager.java;4;3;32;1;11;8;11;21;191;2;18;91;837;837;3;3;3;21;32;5726;6;6217;26;4;
/org.eclipse.pde.ui/sandbox/org/eclipse/pde/internal/ui/editor/standalone/site/SiteFirstPage.java;1;0;2;1;0;0;0;2;0;1;2;2320;0;0;1;0;0;2;2;2320;0;2906;2;1;
/org.eclipse.jdt.ui/ui/org/eclipse/jdt/internal/ui/infoviews/CopyToClipboardAction.java;1;0;2;1;1;1;1;1;2;0;1;1415;2;2;1;0;0;1;2;1415;0;6340;2;1;
/org.eclipse.pde.build/src/org/eclipse/pde/internal/build/site/BuildTimeSite.java;2;2;21;1;9;8;9;12;146;1;12;447;385;385;2;0;1;12;21;5530;1;6218;20;2;
/org.eclipse.swt/Eclipse SWT PI/gtk1x/org/eclipse/swt/internal/gtk/GtkStyle.java;1;0;1;1;0;0;0;1;0;0;1;2327;0;0;1;0;0;1;1;2327;0;2327;1;1;
/org.eclipse.ui.workbench/Eclipse UI/org/eclipse/ui/wizards/datatransfer/FileSystemStructureProvider.java;1;0;1;1;0;0;0;1;0;0;1;2737;0;0;1;0;0;1;1;2737;0;2737;1;1;
/org.eclipse.osgi/core/framework/org/eclipse/osgi/framework/internal/core/StartLevelFactory.java;3;0;3;1;1;1;1;2;61;1;2;3013;61;61;1;0;0;2;3;3013;0;5116;3;3;
/org.eclipse.jdt.core.tests.model/workspace/Converter/src/junit/swingui/TestTreeModel.java;1;0;1;1;0;0;0;1;0;0;1;3714;0;0;1;0;0;1;1;3714;0;3714;1;1;
/org.eclipse.jdt.ui.tests.refactoring/resources/InlineMethodWorkspace/TestCases/simple_out/TestInitializer.java;1;0;1;1;0;0;0;1;2;0;1;845;2;2;1;0;0;1;1;845;0;845;1;1;
/org.eclipse.search/search/org/eclipse/search/internal/ui/text/TextSearchActionGroup.java;2;0;3;1;1;1;1;2;41;1;2;2888;70;70;1;0;0;2;3;2888;0;6340;3;2;
/org.eclipse.jdt.core.tests.model/workspace/Converter/test0333/Test.java;1;0;1;1;0;0;0;1;0;0;1;3714;0;0;1;0;0;1;1;3714;0;3714;1;1;
/org.eclipse.jdt.core.tests.model/workspace/Converter/src/junit/swingui/TestRunner.java;1;0;1;1;0;0;0;1;0;0;1;3714;0;0;1;0;0;1;1;3714;0;3714;1;1;
/org.eclipse.jdt.ui/ui refactoring/org/eclipse/jdt/internal/ui/refactoring/reorg/ReorgUserInputPage.java;5;1;12;1;4;4;4;8;36;1;8;1114;89;89;1;0;0;8;12;1114;0;6340;12;5;
/org.eclipse.pde.core/src/org/eclipse/pde/internal/core/schema/EditableSchema.java;2;1;3;1;2;2;2;1;4;0;1;4203;10;10;1;0;0;1;3;4203;0;6336;3;2;
/org.eclipse.ui.editors/src/org/eclipse/ui/editors/text/IEncodingActionsConstants.java;1;1;2;1;2;2;2;0;7;0;0;5918;11;11;1;0;0;0;2;5918;0;6334;2;1;
/org.eclipse.ltk.core.refactoring/src/org/eclipse/ltk/internal/core/refactoring/Changes.java;1;0;2;1;1;1;1;1;6;0;1;4845;6;6;1;0;0;1;2;4845;0;6260;2;1;
/org.eclipse.jdt.core.tests.model/workspace/Formatter/test187/A_out.java;1;0;3;1;0;0;0;3;23;2;2;2425;23;23;2;1;0;3;3;3029;1;3029;2;1;
/org.eclipse.swt/Eclipse SWT PI/carbon/org/eclipse/swt/internal/carbon/HICommand.java;1;2;3;1;3;2;3;0;16;0;0;5534;20;20;2;0;1;0;3;5534;1;5614;2;1;
/org.eclipse.team.tests.cvs.core/src/org/eclipse/team/tests/ccvs/core/subscriber/TestOverrideAndUpdate.java;2;0;4;1;0;0;0;4;2;1;4;2206;4;4;1;0;0;4;4;2206;0;4450;4;2;
/org.eclipse.ui.editors/src/org/eclipse/ui/texteditor/ChainedPreferenceStore.java;2;1;3;1;3;3;3;0;167;0;0;5507;171;171;1;0;0;0;3;5507;0;6334;3;2;
/org.eclipse.core.resources/src/org/eclipse/core/internal/resources/ProjectInfo.java;2;1;3;1;2;2;2;1;152;0;1;4340;183;183;1;0;0;1;3;4340;0;5520;3;2;
/org.eclipse.osgi/resolver/src/org/eclipse/osgi/internal/resolver/BundleDeltaImpl.java;3;1;5;1;4;4;4;1;24;0;1;3013;44;44;1;0;0;1;5;3013;0;6337;5;3;
/org.eclipse.jdt.ui/ui refactoring/org/eclipse/jdt/internal/ui/refactoring/JavaStatusContextViewer.java;4;1;11;1;2;2;2;9;20;1;9;882;95;95;1;0;0;9;11;882;0;6340;11;4;
/org.eclipse.jdt.ui/core refactoring/org/eclipse/jdt/internal/corext/refactoring/participants/xml/EvaluationContext.java;1;0;2;1;0;0;0;2;0;1;2;4091;0;0;1;0;0;2;2;4091;0;4108;2;1;
/org.eclipse.jdt.ui/ui/org/eclipse/jdt/internal/ui/text/AbstractJavaScanner.java;2;1;3;1;2;2;2;1;90;0;1;4128;102;102;1;0;0;1;3;4128;0;6340;3;2;
/org.eclipse.sdk.tests-feature/plugins/org.eclipse.perfmsr.ui/src/org/eclipse/perfmsr/ui/actions/SnapShot.java;2;1;4;1;3;3;3;1;12;0;1;4845;28;28;1;0;0;1;4;4845;0;6342;4;2;
/org.eclipse.swt/Eclipse SWT PI/motif/org/eclipse/swt/internal/motif/XmAnyCallbackStruct.java;1;0;1;1;0;0;0;1;4;0;1;825;4;4;1;0;0;1;1;825;0;825;1;1;
/org.eclipse.jdt.core.tests.model/workspace/Converter/test0186/Test.java;1;0;1;1;0;0;0;1;0;0;1;3714;0;0;1;0;0;1;1;3714;0;3714;1;1;
/org.eclipse.update.ui.forms/src/org/eclipse/update/ui/forms/internal/richtext/TextModel.java;1;0;2;1;0;0;0;2;0;0;1;2849;0;0;2;1;0;2;2;2849;1;2849;1;1;
/org.eclipse.webdav/src/interface/org/eclipse/webdav/dom/LockInfo.java;1;0;2;1;2;1;2;0;231;0;0;5151;231;231;2;0;1;0;2;5151;1;5151;1;1;
/org.eclipse.search/search/org/eclipse/search/ui/IContextMenuConstants.java;1;0;1;1;1;1;1;0;2;0;0;6340;2;2;1;0;0;0;1;6340;0;6340;1;1;
/org.eclipse.debug.ui/ui/org/eclipse/debug/ui/variables/WorkingSetExpander.java;2;0;6;1;0;0;0;6;75;3;4;316;136;136;3;2;0;6;6;316;2;550;4;2;
/org.eclipse.jdt.debug.ui/ui/org/eclipse/jdt/internal/debug/ui/launcher/VMPreferencePage.java;3;0;3;1;0;0;0;3;9;1;3;121;10;10;1;0;0;3;3;121;0;1036;3;3;
/org.eclipse.jdt.core.tests.model/workspace/Converter/test0372/A.java;1;0;1;1;0;0;0;1;0;0;1;3714;0;0;1;0;0;1;1;3714;0;3714;1;1;
/org.eclipse.jdt.ui.tests.refactoring/resources/MoveMembers/test19/out/B.java;1;0;1;1;0;0;0;1;1;0;1;1522;1;1;1;0;0;1;1;1522;0;1522;1;1;
/org.eclipse.jdt.core/compiler/org/eclipse/jdt/internal/compiler/ast/MemberValuePair.java;1;0;1;1;0;0;0;1;0;0;1;4495;0;0;1;0;0;1;1;4495;0;4495;1;1;
/org.eclipse.swt/Eclipse SWT/photon/org/eclipse/swt/widgets/Scrollable.java;1;1;2;1;2;2;2;0;4;0;0;5606;8;8;1;0;0;0;2;5606;0;6352;2;1;
/org.eclipse.ant.ui/Ant Tools Support/org/eclipse/ant/internal/ui/launchConfigurations/RemoteAntProcessFactory.java;1;0;2;1;1;1;1;1;6;0;1;1879;6;6;1;0;0;1;2;1879;0;6219;2;1;
/org.eclipse.search/search/org/eclipse/search/internal/ui/text/RegExContentAssistProcessor.java;2;1;3;1;3;3;3;0;54;0;0;5506;56;56;1;0;0;0;3;5506;0;6340;3;2;
/org.eclipse.ant.ui/Ant Editor/org/eclipse/ant/internal/ui/editor/xml/IAntEditorConstants.java;1;0;3;1;0;0;0;3;3;1;3;1811;3;3;1;0;0;3;3;1811;0;3661;3;1;
/org.eclipse.webdav/src/interface/org/eclipse/webdav/dom/BaselineControl.java;1;0;2;1;2;1;2;0;71;0;0;5151;71;71;2;0;1;0;2;5151;1;5151;1;1;
/org.eclipse.jdt.core.tests.model/workspace/Converter/test0339/Test.java;1;0;1;1;0;0;0;1;0;0;1;3714;0;0;1;0;0;1;1;3714;0;3714;1;1;
/org.eclipse.jdt.ui.tests.refactoring/resources/MoveMembers/test26/in/A.java;1;0;1;1;0;0;0;1;0;0;1;347;0;0;1;0;0;1;1;347;0;347;1;1;
/org.eclipse.debug.ui/ui/org/eclipse/debug/internal/ui/actions/RunToLineAction.java;1;0;3;1;0;0;0;3;4;2;2;4425;4;4;2;1;0;3;3;4425;1;4471;2;1;
/org.eclipse.jdt.core.tests.model/workspace/Converter/junit/runner/LoadingTestCollector.java;1;0;2;1;0;0;0;2;9;1;2;787;9;9;1;0;0;2;2;787;0;3714;2;1;
/org.eclipse.jdt.core/dom/org/eclipse/jdt/core/dom/VariableDeclarationFragment.java;4;1;9;1;2;2;2;7;130;1;7;3560;168;168;1;0;0;7;9;3560;0;5272;9;4;
/org.eclipse.webdav/src/client/org/eclipse/webdav/internal/authentication/HexConverter.java;1;0;2;1;2;1;2;0;8;0;0;5151;8;8;2;0;1;0;2;5151;1;5151;1;1;
/org.eclipse.ant.ui/Ant Editor/org/eclipse/ant/ui/internal/dtd/schema/Nfm.java;1;0;2;1;0;0;0;2;0;1;2;250;0;0;1;0;0;2;2;250;0;1811;2;1;
/org.eclipse.jdt.debug.tests/tests/org/eclipse/jdt/debug/tests/eval/NestedTypeFieldValue_626.java;1;0;1;1;0;0;0;1;62;0;1;1274;62;62;1;0;0;1;1;1274;0;1274;1;1;
/org.eclipse.jface.text/src/org/eclipse/jface/text/source/AnnotationPainter.java;4;1;48;1;16;16;16;32;281;2;28;1347;2233;2233;2;4;0;32;48;2544;4;6361;44;4;
/org.eclipse.ui.workbench/Eclipse UI/org/eclipse/ui/contexts/registry/IContextRegistryEvent.java;1;0;2;1;0;0;0;2;0;1;2;1400;0;0;1;0;0;2;2;1400;0;1417;2;1;
/org.eclipse.ui.externaltools/Ant Tools Support/org/eclipse/ui/externaltools/internal/ant/launchConfigurations/AntTargetsTab.java;2;0;3;1;0;0;0;3;6;1;3;125;11;11;1;0;0;3;3;125;0;282;3;2;
/org.eclipse.ltk.core.refactoring/src/org/eclipse/ltk/core/refactoring/DocumentChange.java;1;1;6;1;3;3;3;3;5;1;3;4845;17;17;1;0;0;3;6;4845;0;6338;6;1;
/org.eclipse.ui.workbench/Eclipse UI/org/eclipse/ui/internal/commands/old/AbstractMutableRegistry.java;1;0;4;1;0;0;0;4;15;1;4;1322;28;28;1;0;0;4;4;1322;0;1695;4;1;
/org.eclipse.jdt.ui.tests.refactoring/resources/DeleteSourceReference/test0/out/A.java;1;0;1;1;0;0;0;1;0;0;1;1652;0;0;1;0;0;1;1;1652;0;1652;1;1;
/org.eclipse.ant.ui/Ant Editor/org/eclipse/ant/ui/internal/editor/text/AntEditorPartitionScanner.java;1;0;3;1;0;0;0;3;4;1;3;250;4;4;1;0;0;3;3;250;0;1811;3;1;
/org.eclipse.update.core/src/org/eclipse/update/internal/standalone/AddSiteCommand.java;1;0;2;1;0;0;0;2;0;1;2;4718;0;0;1;0;0;2;2;4718;0;4928;2;1;
/org.eclipse.team.tests.cvs.core/src/org/eclipse/team/tests/ccvs/ui/old/CaseEntry.java;1;0;2;1;0;0;0;2;0;1;2;2632;0;0;1;0;0;2;2;2632;0;4216;2;1;
/org.eclipse.jdt.debug.tests/tests/org/eclipse/jdt/debug/tests/core/LaunchTests.java;3;0;5;2;1;1;1;4;94;1;4;4194;118;118;1;0;0;4;5;4194;0;6337;5;3;
/org.eclipse.jdt.junit/src/org/eclipse/jdt/internal/junit/ui/TestRunnerViewPart.java;5;2;43;2;15;14;15;28;174;3;23;185;1177;1177;3;5;1;28;43;418;6;6340;37;5;
/org.eclipse.ui.workbench/Eclipse UI/org/eclipse/ui/wizards/datatransfer/WizardFileSystemExportPage1.java;1;0;1;1;0;0;0;1;0;0;1;2737;0;0;1;0;0;1;1;2737;0;2737;1;1;
/org.eclipse.jdt.ui.tests/leaks/org/eclipse/jdt/ui/tests/leaks/JavaLeakTest.java;3;0;5;1;1;1;1;4;56;1;4;3124;142;142;1;0;0;4;5;3124;0;6340;5;3;
/org.eclipse.jdt.ui.tests.refactoring/resources/ExtractMethodWorkSpace/ExtractMethodTests/locals_in/A_test559.java;1;0;1;1;0;0;0;1;2;0;1;844;2;2;1;0;0;1;1;844;0;844;1;1;
/org.eclipse.update.configurator/src/org/eclipse/update/configurator/PlatformConfigurationFactory.java;2;0;2;1;0;0;0;2;0;1;2;3014;0;0;1;0;0;2;2;3014;0;3243;2;2;
/org.eclipse.update.ui.forms/Eclipse Forms/org/eclipse/ui/forms/FormWizardPage.java;1;0;2;1;0;0;0;2;0;1;2;3176;0;0;1;0;0;2;2;3176;0;4157;2;1;
/org.eclipse.jdt.ui.tests.refactoring/resources/ExtractInterface/test63/in/A.java;1;0;1;1;0;0;0;1;2;0;1;1272;2;2;1;0;0;1;1;1272;0;1272;1;1;
/org.eclipse.jdt.core.tests.model/workspace/JavaSearch/src/j4/CT47209.java;1;0;1;1;0;0;0;1;0;0;1;3330;0;0;1;0;0;1;1;3330;0;3330;1;1;
/org.eclipse.ui.forms/src/org/eclipse/ui/forms/SectionPart.java;1;0;9;1;1;1;1;8;142;2;7;4068;262;262;2;1;0;8;9;4284;1;6336;8;1;
/org.eclipse.pde.ui/src_Forms/org/eclipse/pde/internal/ui/neweditor/plugin/ExtensionPointsPage.java;2;0;10;1;1;1;1;9;30;1;9;3777;74;74;1;0;0;9;10;3777;0;5431;10;2;
/org.eclipse.jface/src/org/eclipse/jface/action/ContextResolver.java;1;0;2;1;0;0;0;2;0;1;2;535;0;0;1;0;0;2;2;535;0;2161;2;1;
/org.eclipse.debug.ui/ui/org/eclipse/debug/internal/ui/actions/TextViewerGotoLineAction.java;2;0;4;1;0;0;0;4;5;2;3;1239;8;8;2;1;0;4;4;1239;1;2060;3;2;
/org.eclipse.core.tests.runtime/src/org/eclipse/core/tests/internal/plugins/ExtensiveLibraryTest.java;1;0;1;1;0;0;0;1;0;0;1;3014;0;0;1;0;0;1;1;3014;0;3014;1;1;
/org.eclipse.jdt.core.tests.model/workspace/Formatter/test334/A_in.java;1;0;1;1;0;0;0;1;0;0;1;2728;0;0;1;0;0;1;1;2728;0;2728;1;1;
/org.eclipse.ant.ui/Ant Editor/org/eclipse/ant/ui/internal/editor/tools/AntEditorToolsMessages.java;1;0;2;1;0;0;0;2;0;1;2;250;0;0;1;0;0;2;2;250;0;1811;2;1;
/org.eclipse.webdav/src/client/org/eclipse/webdav/http/client/ISocketFactory.java;1;0;1;1;1;1;1;0;6;0;0;5151;6;6;1;0;0;0;1;5151;0;5151;1;1;
/org.eclipse.ui.workbench/Eclipse UI/org/eclipse/ui/commands/IContextBindingDefinition.java;1;0;4;1;0;0;0;4;2;2;3;1389;2;2;2;1;0;4;4;1417;1;1417;3;1;
/org.eclipse.ui.forms/src/org/eclipse/ui/internal/forms/widgets/BulletParagraph.java;1;0;2;1;1;1;1;1;6;0;1;5044;6;6;1;0;0;1;2;5044;0;6336;2;1;
/org.eclipse.ant.ui/Ant Tools Support/org/eclipse/ant/internal/ui/launchConfigurations/AntLaunchShortcut.java;3;1;14;1;7;7;7;7;125;1;7;1811;351;351;1;0;0;7;14;1811;0;6336;14;3;
/org.eclipse.pde.ui/src_Forms/org/eclipse/pde/internal/ui/neweditor/schema/GrammarSection.java;2;1;4;1;2;2;2;2;4;1;2;4856;8;8;1;0;0;2;4;4856;0;5431;4;2;
/org.eclipse.ui.ide/src/org/eclipse/ui/internal/dialogs/CreateProjectStep.java;2;0;3;1;0;0;0;3;6;1;3;1526;6;6;1;0;0;3;3;1526;0;2263;3;2;
/org.eclipse.ui.workbench/Eclipse UI/org/eclipse/ui/internal/model/WorkbenchStatus.java;1;0;1;1;0;0;0;1;0;0;1;2737;0;0;1;0;0;1;1;2737;0;2737;1;1;
/org.eclipse.jdt.core.tests.model/workspace/Converter/src/test0474/A.java;1;0;1;1;0;0;0;1;0;0;1;3714;0;0;1;0;0;1;1;3714;0;3714;1;1;
/org.eclipse.team.ui/src/org/eclipse/team/ui/synchronize/subscribers/IRefreshSubscriberListener.java;1;1;4;1;2;2;2;2;3;1;2;4632;5;5;1;0;0;2;4;4632;0;5362;4;1;
/org.eclipse.ui.views/src/org/eclipse/ui/views/bookmarkexplorer/BookmarkContentProvider.java;1;0;1;1;0;0;0;1;0;0;1;2738;0;0;1;0;0;1;1;2738;0;2738;1;1;
/org.eclipse.jdt.debug.tests/tests/org/eclipse/jdt/debug/tests/eval/NestedTypeFieldValue_616.java;1;0;1;1;0;0;0;1;60;0;1;1274;60;60;1;0;0;1;1;1274;0;1274;1;1;
/org.eclipse.jdt.core.tests.model/workspace/Formatter/test476/A_out.java;1;0;1;1;0;0;0;1;0;0;1;3996;0;0;1;0;0;1;1;3996;0;3996;1;1;
/org.eclipse.jdt.core.tests.model/workspace/Formatter/test123/A_out.java;1;0;1;1;0;0;0;1;0;0;1;2425;0;0;1;0;0;1;1;2425;0;2425;1;1;
/org.eclipse.swt.tests/JUnit Tests/org/eclipse/swt/tests/junit/Test_org_eclipse_swt_events_VerifyListener.java;1;0;1;1;0;0;0;1;16;0;1;2175;16;16;1;0;0;1;1;2175;0;2175;1;1;
/org.eclipse.jdt.core.tests.model/workspace/Formatter/test380/A_in.java;1;0;1;1;0;0;0;1;0;0;1;3148;0;0;1;0;0;1;1;3148;0;3148;1;1;
/org.eclipse.jdt.core.tests.model/workspace/TypeHierarchy/src/p9/X.java;1;0;1;1;0;0;0;1;0;0;1;3474;0;0;1;0;0;1;1;3474;0;3474;1;1;
/org.eclipse.team.ui/src/org/eclipse/team/ui/sync/actions/ToggleViewAction.java;1;0;1;1;0;0;0;1;0;0;1;2433;0;0;1;0;0;1;1;2433;0;2433;1;1;
/org.eclipse.jdt.core.tests.model/workspace/Converter/test0106/Test.java;1;0;1;1;0;0;0;1;0;0;1;3714;0;0;1;0;0;1;1;3714;0;3714;1;1;
/org.eclipse.jdt.core.tests.model/workspace/Formatter/test187/A_in.java;1;0;2;1;0;0;0;2;3;1;2;2425;3;3;1;0;0;2;2;2425;0;3031;2;1;
/org.eclipse.core.tests.runtime/src/org/eclipse/core/tests/internal/plugins/BasicXMLTest.java;2;0;2;1;0;0;0;2;46;1;2;880;46;46;1;0;0;2;2;880;0;3014;2;2;
/org.eclipse.swt/Eclipse SWT Custom Widgets/common/org/eclipse/swt/custom/CTabItem.java;4;3;48;1;23;14;23;25;788;3;18;268;2637;2637;3;7;9;25;48;4130;16;6352;32;4;
/org.eclipse.update.ui/src/org/eclipse/update/internal/ui/forms/SiteForm.java;1;0;1;1;0;0;0;1;0;0;1;755;0;0;1;0;0;1;1;755;0;755;1;1;
/org.eclipse.jdt.core.tests.model/workspace/Converter/src/test0259/Test.java;1;0;1;1;0;0;0;1;0;0;1;3714;0;0;1;0;0;1;1;3714;0;3714;1;1;
/org.eclipse.search/new search/org/eclipse/search2/internal/ui/basic/views/ShowNextResultAction.java;2;0;3;1;1;1;1;2;8;1;2;3474;10;10;1;0;0;2;3;3474;0;6340;3;2;
/org.eclipse.ui.externaltools/Ant Editor/org/eclipse/ui/externaltools/internal/ant/editor/outline/IDocumentModelListener.java;1;0;1;1;0;0;0;1;0;0;1;282;0;0;1;0;0;1;1;282;0;282;1;1;
/org.eclipse.swt/Eclipse SWT Mozilla/common/org/eclipse/swt/internal/mozilla/nsIDOMWindowInternal.java;1;0;4;1;0;0;0;4;130;1;4;1654;256;256;1;0;0;4;4;1654;0;3787;4;1;
/org.eclipse.compare.examples.xml/src/org/eclipse/compare/examples/xml/GeneralMatching.java;1;0;4;1;0;0;0;4;417;1;4;1106;419;419;1;0;0;4;4;1106;0;4711;4;1;
/org.eclipse.team.cvs.ui/src/org/eclipse/team/internal/ccvs/ui/HistoryFilterDialog.java;1;0;1;1;0;0;0;1;4;0;1;2381;4;4;1;0;0;1;1;2381;0;2381;1;1;
/org.eclipse.jdt.ui/ui/org/eclipse/jdt/internal/ui/text/correction/ReplaceCorrectionProposal.java;3;0;8;1;1;1;1;7;12;2;6;1953;47;47;2;1;0;7;8;1953;1;6340;7;3;
/org.eclipse.jface.text/src/org/eclipse/jface/text/source/IAnnotationHover.java;2;1;2;1;2;2;2;0;20;0;0;6340;22;22;1;0;0;0;2;6340;0;6361;2;2;
/org.eclipse.core.runtime/src/org/eclipse/core/internal/dependencies/ResolutionVisitor.java;2;0;2;1;0;0;0;2;0;1;2;2105;0;0;1;0;0;2;2;2105;0;3013;2;2;
/org.eclipse.swt/Eclipse SWT Drag and Drop/motif/org/eclipse/swt/dnd/TreeDragUnderEffect.java;3;1;3;1;2;2;2;1;91;0;1;804;97;97;1;0;0;1;3;804;0;6352;3;3;
/org.eclipse.osgi/osgi/src/org/eclipse/osgi/service/resolver/VersionConstraint.java;5;1;9;1;4;4;4;5;67;1;5;3013;152;152;1;0;0;5;9;3013;0;5536;9;5;
/org.eclipse.pde.core/src/org/eclipse/pde/core/bundle/IBundleModel.java;1;0;2;1;0;0;0;2;0;1;2;2184;0;0;1;0;0;2;2;2184;0;2193;2;1;
/org.eclipse.pde.build/src/org/eclipse/pde/internal/build/ant/Condition.java;2;1;7;1;2;2;2;5;128;1;5;447;653;653;1;0;0;5;7;447;0;6340;7;2;
/org.eclipse.jdt.ui/ui/org/eclipse/jdt/internal/ui/wizards/buildpaths/UserLibraryMarkerResolutionGenerator.java;2;1;4;1;3;3;3;1;33;0;1;4407;63;63;1;0;0;1;4;4407;0;5438;4;2;
/org.eclipse.ltk.ui.refactoring/src/org/eclipse/ltk/internal/ui/refactoring/ChangePreviewViewerDescriptor.java;1;0;3;1;1;1;1;2;8;1;2;4965;10;10;1;0;0;2;3;4965;0;6340;3;1;
/org.eclipse.jdt.core.tests.model/workspace/Converter/test0145/Test.java;1;0;1;1;0;0;0;1;0;0;1;3714;0;0;1;0;0;1;1;3714;0;3714;1;1;
/org.eclipse.ui.workbench/Eclipse UI/org/eclipse/ui/internal/commands/ws/HandlerProxy.java;3;1;4;1;3;3;3;1;51;0;1;4968;72;72;1;0;0;1;4;4968;0;6338;4;3;
/org.eclipse.core.resources.spysupport/src/org/eclipse/core/internal/resources/SpySupport.java;1;1;2;1;2;2;2;0;4;0;0;6302;4;4;1;0;0;0;2;6302;0;6340;2;1;
/org.eclipse.ui.views/src/org/eclipse/ui/views/tasklist/GotoTaskAction.java;1;0;1;1;0;0;0;1;0;0;1;2738;0;0;1;0;0;1;1;2738;0;2738;1;1;
/org.eclipse.ui.ide/src/org/eclipse/ui/views/tasklist/TaskPropertiesDialog.java;4;1;4;1;3;3;3;1;104;0;1;2208;108;108;1;0;0;1;4;2208;0;6338;4;4;
/org.eclipse.team.ui/src/org/eclipse/team/ui/synchronize/views/CompressedFolderDiffNodeBuilder.java;1;0;1;1;0;0;0;1;0;0;1;3832;0;0;1;0;0;1;1;3832;0;3832;1;1;
/org.eclipse.jdt.core.tests.model/workspace/TypeHierarchy2/lib53095/p53095/X53095.java;2;0;2;1;0;0;0;2;0;1;2;4493;0;0;1;0;0;2;2;4493;0;4606;2;2;
/org.eclipse.jdt.ui/ui/org/eclipse/jdt/internal/ui/text/folding/JavaFoldingStructureProviderDescriptor.java;1;1;2;1;2;2;2;0;6;0;0;5440;6;6;1;0;0;0;2;5440;0;6340;2;1;
/org.eclipse.jdt.core.tests.model/workspace/Converter/test0327/Test.java;1;0;1;1;0;0;0;1;0;0;1;3714;0;0;1;0;0;1;1;3714;0;3714;1;1;
/org.eclipse.debug.core/core/org/eclipse/debug/core/sourcelookup/AbstractSourceLookupParticipant.java;2;0;2;1;1;1;1;1;5;0;1;4949;5;5;1;0;0;1;2;4949;0;5672;2;2;
/org.eclipse.ui.internal.r21presentation/src/org/eclipse/ui/internal/r21presentation/widgets/R21PaneFolder.java;3;1;6;1;6;6;6;0;15;0;0;5444;27;27;1;0;0;0;6;5444;0;5942;6;3;
/org.eclipse.jdt.ui.tests.refactoring/resources/ExtractMethodWorkSpace/ExtractMethodTests/locals_out/A_test552.java;1;0;1;1;0;0;0;1;4;0;1;844;4;4;1;0;0;1;1;844;0;844;1;1;
/org.eclipse.team.ui/src/org/eclipse/team/ui/synchronize/subscriber/SubscriberParticipant.java;1;0;10;1;0;0;0;10;280;2;9;4047;494;494;2;1;0;10;10;4240;1;4632;9;1;
/org.eclipse.ui.workbench/Eclipse UI/org/eclipse/ui/internal/WorkingSetFactory.java;1;0;1;1;0;0;0;1;9;0;1;3206;9;9;1;0;0;1;1;3206;0;3206;1;1;
/org.eclipse.jdt.core.tests.model/workspace/Formatter/test471/A_in.java;1;0;1;1;0;0;0;1;0;0;1;3977;0;0;1;0;0;1;1;3977;0;3977;1;1;
/org.eclipse.ui.editors/src/org/eclipse/ui/editors/text/TextEditorActionContributor.java;2;0;2;1;1;1;1;1;9;0;1;2741;16;16;1;0;0;1;2;2741;0;6334;2;2;
/org.eclipse.update.core/src/org/eclipse/update/internal/core/UpdateManagerLogWriter.java;2;1;7;1;3;3;3;4;103;1;4;890;189;189;1;0;0;4;7;890;0;6336;7;2;
/org.eclipse.jdt.ui.tests.refactoring/resources/RenameStaticMethod/test10/out/B.java;1;0;1;1;0;0;0;1;0;0;1;1347;0;0;1;0;0;1;1;1347;0;1347;1;1;
/org.eclipse.pde.ui/sandbox/org/eclipse/pde/internal/ui/editor/standalone/manifest/PluginSourceLabelProvider.java;1;0;2;1;0;0;0;2;0;1;2;2320;0;0;1;0;0;2;2;2320;0;2906;2;1;
/org.eclipse.jdt.core.tests.model/workspace/Converter/src/test0112/Test.java;1;0;1;1;0;0;0;1;0;0;1;3714;0;0;1;0;0;1;1;3714;0;3714;1;1;
/org.eclipse.ant.ui/Ant Editor/org/eclipse/ant/ui/internal/editor/text/AnnotationAccess.java;1;0;3;1;0;0;0;3;24;1;3;250;24;24;1;0;0;3;3;250;0;1811;3;1;
/org.eclipse.debug.core/core/org/eclipse/debug/core/sourcelookup/containers/LocalFileStorage.java;1;0;1;1;0;0;0;1;0;0;1;4949;0;0;1;0;0;1;1;4949;0;4949;1;1;
/org.eclipse.team.cvs.core/src/org/eclipse/team/internal/ccvs/core/CVSMergeSubscriber.java;2;0;31;2;1;1;1;30;264;3;25;520;1317;1317;3;5;0;30;31;4233;5;6337;26;2;
/org.eclipse.ui.workbench.texteditor/src/org/eclipse/ui/texteditor/templates/TextEditorTemplateMessages.java;2;1;2;1;2;2;2;0;2;0;0;5304;2;2;1;0;0;0;2;5304;0;6340;2;2;
/org.eclipse.swt/Eclipse SWT/carbon/org/eclipse/swt/graphics/GCData.java;2;0;6;1;0;0;0;6;4;1;6;332;13;13;1;0;0;6;6;332;0;2332;6;2;
/org.eclipse.jdt.core.tests.model/workspace/Converter/test0030/Test.java;1;0;1;1;0;0;0;1;0;0;1;3714;0;0;1;0;0;1;1;3714;0;3714;1;1;
/org.eclipse.ui.tests/Eclipse UI Tests/org/eclipse/ui/tests/keys/Bug43597Test.java;2;0;3;1;0;0;0;3;30;1;3;2266;34;34;1;0;0;3;3;2266;0;2351;3;2;
/org.eclipse.jdt.core.tests.model/workspace/Converter15/src/test0001/Test.java;1;0;1;1;0;0;0;1;0;0;1;4601;0;0;1;0;0;1;1;4601;0;4601;1;1;
/org.eclipse.core.tests.runtime/src/org/eclipse/core/tests/runtime/jobs/RuleHierarchy.java;2;0;3;1;0;0;0;3;29;1;3;2962;29;29;1;0;0;3;3;2962;0;3408;3;2;
/org.eclipse.core.tests.runtime/src/org/eclipse/core/tests/internal/plugins/JarPluginPathTest.java;1;0;1;1;0;0;0;1;0;0;1;3014;0;0;1;0;0;1;1;3014;0;3014;1;1;
/org.eclipse.jdt.core.tests.model/workspace/Formatter/test432/A_out.java;1;0;2;1;0;0;0;2;1;1;2;3495;1;1;1;0;0;2;2;3495;0;3743;2;1;
/org.eclipse.jdt.core.tests.model/workspace/Converter/test0487/A.java;1;0;2;1;0;0;0;2;0;1;2;1289;0;0;1;0;0;2;2;1289;0;3714;2;1;
/org.eclipse.ui.externaltools/Ant Editor/org/eclipse/ui/externaltools/internal/ant/editor/text/XMLReconcilingStrategy.java;1;0;2;1;0;0;0;2;4;1;2;178;4;4;1;0;0;2;2;178;0;282;2;1;
/org.eclipse.jdt.debug.jdi.tests/tests/org/eclipse/debug/jdi/tests/program/TestClass4.java;1;0;1;1;1;1;1;0;3;0;0;6339;3;3;1;0;0;0;1;6339;0;6339;1;1;
/org.eclipse.pde.core/src/org/eclipse/pde/internal/core/plugin/Plugin.java;3;2;11;1;5;4;5;6;38;1;6;2295;102;102;2;0;1;6;11;5799;1;6336;10;3;
/org.eclipse.ui.workbench.texteditor/src/org/eclipse/ui/texteditor/MarkerAnnotation.java;2;0;3;1;0;0;0;3;42;1;3;1705;53;53;1;0;0;3;3;1705;0;2741;3;2;
/org.eclipse.ant.ui/Ant Tools Support/org/eclipse/ant/ui/internal/views/actions/RemoveProjectAction.java;1;0;3;1;0;0;0;3;10;2;2;263;10;10;2;1;0;3;3;263;1;1811;2;1;
/org.eclipse.jdt.core.tests.model/workspace/Converter/src/test0361/X.java;1;0;1;1;0;0;0;1;0;0;1;3714;0;0;1;0;0;1;1;3714;0;3714;1;1;
/org.eclipse.compare/compare/org/eclipse/compare/rangedifferencer/LinkedRangeDifference.java;1;0;2;1;0;0;0;2;2;1;2;257;4;4;1;0;0;2;2;257;0;3938;2;1;
/org.eclipse.ui.externaltools/External Tools Base/org/eclipse/ui/externaltools/internal/ui/MessageLine.java;1;0;1;1;0;0;0;1;0;0;1;282;0;0;1;0;0;1;1;282;0;282;1;1;
/org.eclipse.jdt.core.tests.model/workspace/Converter/src/test0030/Test.java;1;0;1;1;0;0;0;1;0;0;1;3714;0;0;1;0;0;1;1;3714;0;3714;1;1;
/org.eclipse.ui.externaltools/Ant Editor/org/eclipse/ui/externaltools/internal/ant/dtd/schema/NfmNode.java;1;0;1;1;0;0;0;1;0;0;1;282;0;0;1;0;0;1;1;282;0;282;1;1;
/org.eclipse.jdt.core/dom/org/eclipse/jdt/core/internal/dom/rewrite/ASTRewriteFormatter.java;2;0;3;2;0;0;0;3;4;2;2;4711;4;4;2;1;0;3;3;4711;1;4802;2;2;
/org.eclipse.update.ui.forms/src/org/eclipse/ui/forms/parts/TraversableLabel.java;1;0;2;1;0;0;0;2;0;1;2;3071;0;0;1;0;0;2;2;3071;0;3096;2;1;
/org.eclipse.pde.ui/src/org/eclipse/pde/ui/templates/IFieldData.java;2;1;6;1;2;2;2;4;97;1;4;2519;120;120;1;0;0;4;6;2519;0;5152;6;2;
/org.eclipse.jdt.debug.ui/ui/org/eclipse/jdt/internal/debug/ui/snippeteditor/ShowInPackageViewAction.java;3;0;4;1;1;1;1;3;15;1;3;1500;31;31;1;0;0;3;4;1500;0;6336;4;3;
/org.eclipse.core.runtime.compatibility/src-model/org/eclipse/core/runtime/model/PluginPrerequisiteModel.java;3;2;6;1;4;3;4;2;25;1;2;3013;34;34;2;0;1;2;6;5117;1;6340;5;3;
/org.eclipse.jdt.core/compiler/org/eclipse/jdt/internal/compiler/ast/AstNode.java;3;0;16;1;0;0;0;16;73;6;10;49;184;184;6;6;0;16;16;1292;6;2974;10;3;
/org.eclipse.ui.views/src/org/eclipse/ui/views/framelist/IFrameListHelpContextIds.java;1;0;1;1;0;0;0;1;0;0;1;2738;0;0;1;0;0;1;1;2738;0;2738;1;1;
/org.eclipse.jdt.ui/core refactoring/org/eclipse/jdt/internal/corext/refactoring/participants/xml/MemberPropertyTester.java;1;0;4;1;0;0;0;4;18;1;4;1125;20;20;1;0;0;4;4;1125;0;2546;4;1;
/org.eclipse.core.runtime.osgi/src/org/eclipse/core/internal/runtime/Log.java;1;0;2;1;0;0;0;2;1;1;2;3013;1;1;1;0;0;2;2;3013;0;3030;2;1;
/org.eclipse.jdt.ui.tests.refactoring/resources/ExtractMethodWorkSpace/ExtractMethodTests/expression_out/A_test619.java;1;0;4;1;0;0;0;4;4;1;4;130;5;5;1;0;0;4;4;130;0;1474;4;1;
/org.eclipse.jdt.ui.tests/ui/org/eclipse/jdt/ui/tests/core/TypeInfoTest.java;2;1;6;1;2;2;2;4;60;1;4;803;94;94;1;0;0;4;6;803;0;6340;6;2;
/org.eclipse.ui.views/src/org/eclipse/ui/views/navigator/SortAndFilterActionGroup.java;1;0;1;1;0;0;0;1;0;0;1;2738;0;0;1;0;0;1;1;2738;0;2738;1;1;
/org.eclipse.ui.externaltools/External Tools Base/org/eclipse/ui/externaltools/internal/variables/RefreshScopeVariableRegistry.java;1;0;6;1;0;0;0;6;32;3;4;317;38;38;3;2;0;6;6;317;2;728;4;1;
/org.eclipse.jdt.ui.tests.refactoring/resources/ExtractTemp/cannotExtract/A_testFail32.java;1;0;1;1;0;0;0;1;0;0;1;1569;0;0;1;0;0;1;1;1569;0;1569;1;1;
/org.eclipse.jdt.ui.tests.refactoring/resources/SurroundWithWorkSpace/SurroundWithTests/trycatch_in/TestExpression.java;1;0;1;1;0;0;0;1;5;0;1;845;5;5;1;0;0;1;1;845;0;845;1;1;
/org.eclipse.jdt.ui/ui/org/eclipse/jdt/internal/ui/search/OccurrencesInFileLabelProvider.java;3;1;3;1;2;2;2;1;4;0;1;3759;10;10;1;0;0;1;3;3759;0;6340;3;3;
/org.eclipse.team.cvs.ui/src/org/eclipse/team/internal/ccvs/ui/subscriber/CVSSynchronizeWizard.java;2;1;4;1;4;4;4;0;60;0;0;5532;72;72;1;0;0;0;4;5532;0;5940;4;2;
/org.eclipse.ui.workbench/Eclipse UI/org/eclipse/ui/internal/progress/UIJob.java;1;0;1;1;0;0;0;1;0;0;1;533;0;0;1;0;0;1;1;533;0;533;1;1;
/org.eclipse.pde.core/src/org/eclipse/pde/internal/core/plugin/PluginReference.java;2;1;3;1;2;2;2;1;6;0;1;4203;12;12;1;0;0;1;3;4203;0;6336;3;2;
/org.eclipse.releng.basebuilder/plugins/org.eclipse.build.tools/src/org/eclipse/releng/generators/VersionTrackerTask.java;1;0;2;1;0;0;0;2;10;1;2;3253;10;10;1;0;0;2;2;3253;0;3597;2;1;
/org.eclipse.jdt.core.tests.model/workspace/Converter/test0447/A.java;1;0;1;1;0;0;0;1;0;0;1;3714;0;0;1;0;0;1;1;3714;0;3714;1;1;
/org.eclipse.team.tests.core/src/org/eclipse/team/tests/ui/synchronize/TestPage.java;2;2;3;2;3;2;3;0;120;0;0;5314;120;120;2;0;1;0;3;5358;1;5358;2;2;
/org.eclipse.jdt.ui/core refactoring/org/eclipse/jdt/internal/corext/refactoring/changes/DeleteFolderChange.java;3;1;5;1;2;2;2;3;14;1;3;443;38;38;1;0;0;3;5;443;0;6340;5;3;
/org.eclipse.ui.workbench/Eclipse UI/org/eclipse/ui/internal/commands/api/ICommandEvent.java;1;0;2;1;0;0;0;2;2;0;1;2562;2;2;2;1;0;2;2;2562;1;2562;1;1;
/org.eclipse.jdt.ui/ui/org/eclipse/jdt/internal/ui/text/correction/NewCUCompletionUsingWizardProposal.java;1;0;4;1;1;1;1;3;9;1;3;957;19;19;1;0;0;3;4;957;0;5549;4;1;
/org.eclipse.jface.text/src/org/eclipse/jface/text/source/IVerticalRulerInfoExtension.java;3;1;5;1;3;3;3;2;21;1;2;1118;47;47;1;0;0;2;5;1118;0;6361;5;3;
/org.eclipse.team.webdav/src/org/eclipse/team/internal/core/target/DeploymentProvider.java;2;1;3;1;2;2;2;1;4;0;1;4633;5;5;1;0;0;1;3;4633;0;6337;3;2;
/org.eclipse.jdt.core.tests.model/workspace/Converter/src/test0337/Test.java;1;0;1;1;0;0;0;1;0;0;1;3714;0;0;1;0;0;1;1;3714;0;3714;1;1;
/org.eclipse.jdt.core.tests.model/workspace/Converter/src/test0265/Test.java;1;0;1;1;0;0;0;1;0;0;1;3714;0;0;1;0;0;1;1;3714;0;3714;1;1;
/org.eclipse.ui.workbench/Eclipse UI/org/eclipse/ui/internal/csm/roles/ExtensionRoleRegistry.java;1;0;5;1;0;0;0;5;46;4;2;2405;46;46;4;3;0;5;5;2405;3;2444;2;1;
/org.eclipse.jdt.ui.tests.refactoring/resources/ExtractMethodWorkSpace/ExtractMethodTests/return_out/A_test727.java;1;0;2;1;0;0;0;2;6;1;2;130;10;10;1;0;0;2;2;130;0;844;2;1;
/org.eclipse.jdt.ui/core extension/org/eclipse/jdt/internal/corext/util/JdtFlags.java;4;1;10;1;3;3;3;7;76;2;6;238;190;190;2;1;0;7;10;1130;1;6340;9;4;
/org.eclipse.help.tests/src/org/eclipse/help/tests/webapp/TestDynamicTopics.java;1;1;4;1;2;2;2;2;69;1;2;1010;89;89;1;0;0;2;4;1010;0;6337;4;1;
/org.eclipse.jdt.ui/ui/org/eclipse/jdt/internal/ui/wizards/buildpaths/JARFileSelectionDialog.java;1;0;2;1;1;1;1;1;4;0;1;1350;6;6;1;0;0;1;2;1350;0;6340;2;1;
/org.eclipse.ui.editors/src/org/eclipse/ui/internal/editors/quickdiff/restore/RevertBlockAction.java;1;0;2;1;0;0;0;2;0;1;2;1118;0;0;1;0;0;2;2;1118;0;1214;2;1;
/org.eclipse.jface.text/src/org/eclipse/jface/text/formatter/FormattingContextProperties.java;3;1;7;1;4;4;4;3;40;1;3;1998;116;116;1;0;0;3;7;1998;0;6357;7;3;
/org.eclipse.ui.workbench/Eclipse UI/org/eclipse/ui/model/WorkbenchPartLabelProvider.java;2;0;2;1;0;0;0;2;78;1;2;1527;78;78;1;0;0;2;2;1527;0;2737;2;2;
/org.eclipse.ui.ide/src/org/eclipse/ui/internal/ProblemImageProvider.java;2;0;2;1;0;0;0;2;0;1;2;1520;0;0;1;0;0;2;2;1520;0;2263;2;2;
/org.eclipse.ui.workbench/Eclipse UI/org/eclipse/ui/internal/commands/api/IActionServiceEvent.java;1;0;2;1;0;0;0;2;2;0;1;2562;2;2;2;1;0;2;2;2562;1;2562;1;1;
/org.eclipse.ui.ide/src/org/eclipse/ui/wizards/newresource/BasicNewFolderResourceWizard.java;1;0;1;1;0;0;0;1;0;0;1;1511;0;0;1;0;0;1;1;1511;0;1511;1;1;
/org.eclipse.jdt.launching/launching/org/eclipse/jdt/launching/IJavaLaunchConfigurationConstants.java;2;0;4;1;1;1;1;3;36;1;3;1871;53;53;1;0;0;3;4;1871;0;6336;4;2;
/org.eclipse.ui.workbench.texteditor/src/org/eclipse/ui/internal/texteditor/quickdiff/compare/rangedifferencer/IRangeComparator.java;1;1;3;1;2;2;2;1;2;0;1;1644;4;4;1;0;0;1;3;1644;0;6340;3;1;
/org.eclipse.core.variables/src/org/eclipse/core/variables/IValueVariableInitializer.java;1;0;1;1;0;0;0;1;0;0;1;2514;0;0;1;0;0;1;1;2514;0;2514;1;1;
/org.eclipse.jdt.core.tests.compiler/src/org/eclipse/jdt/core/tests/compiler/parser/InnerTypeCompletionTest.java;2;0;2;1;0;0;0;2;16;1;2;991;18;18;1;0;0;2;2;991;0;3560;2;2;
/org.eclipse.help.tests/src/org/eclipse/help/tests/launching/DisplayHelpResource_contextID_x_y.java;1;0;1;1;0;0;0;1;0;0;1;2732;0;0;1;0;0;1;1;2732;0;2732;1;1;
/org.eclipse.pde.ui/srcnew/org/eclipse/pde/internal/ui/editor/manifest/SynchronizedSystemFileDocumentProvider.java;1;0;1;1;0;0;0;1;0;0;1;2320;0;0;1;0;0;1;1;2320;0;2320;1;1;
/org.eclipse.jdt.core.tests.builder/src/org/eclipse/jdt/core/tests/builder/BasicBuildTests.java;2;0;2;1;0;0;0;2;4;1;2;1387;6;6;1;0;0;2;2;1387;0;3560;2;2;
/org.eclipse.jdt.debug.ui/ui/org/eclipse/jdt/internal/debug/ui/ZipEntryStorageEditorInput.java;2;0;2;1;1;1;1;1;7;0;1;5081;11;11;1;0;0;1;2;5081;0;5316;2;2;
/org.eclipse.debug.ui/ui/org/eclipse/debug/internal/ui/preferences/MultipleInputDialog.java;3;0;5;1;1;1;1;4;163;2;3;1196;165;165;2;1;0;4;5;1222;1;5205;4;3;
/org.eclipse.jdt.core.tests.model/workspace/Formatter/test010/A_in.java;1;0;1;1;0;0;0;1;0;0;1;2425;0;0;1;0;0;1;1;2425;0;2425;1;1;
/org.eclipse.ui.ide/src/org/eclipse/ui/wizards/datatransfer/ZipFileExporter.java;1;0;1;1;0;0;0;1;0;0;1;1511;0;0;1;0;0;1;1;1511;0;1511;1;1;
/org.eclipse.jdt.core.tests.model/workspace/Converter/src/test0006/Test.java;1;0;1;1;0;0;0;1;0;0;1;3714;0;0;1;0;0;1;1;3714;0;3714;1;1;
/org.eclipse.core.tests.runtime/src/org/eclipse/core/tests/runtime/PluginVersionIdentifierTest.java;1;0;1;1;1;1;1;0;179;0;0;5149;179;179;1;0;0;0;1;5149;0;5149;1;1;
/org.eclipse.ui.ide/src/org/eclipse/ui/internal/ide/dialogs/MessageDialogWithToggle.java;2;0;2;1;1;1;1;1;0;0;1;2264;0;0;1;0;0;1;2;2264;0;5386;2;2;
/org.eclipse.core.runtime/src/org/eclipse/core/internal/registry/RegistryCacheReader.java;4;2;22;2;11;9;11;11;707;2;10;3049;1401;1401;2;1;2;11;22;3164;3;6157;19;4;
/org.eclipse.jdt.core.tests.model/workspace/Formatter/test355/A_in.java;1;0;1;1;0;0;0;1;0;0;1;3086;0;0;1;0;0;1;1;3086;0;3086;1;1;
/org.eclipse.ui.examples.job/org/eclipse/ui/examples/jobs/views/SlowElementAdapter.java;1;0;2;1;2;1;2;0;0;0;0;5125;0;0;2;0;1;0;2;5125;1;5125;1;1;
/org.eclipse.swt/Eclipse SWT/gtk/org/eclipse/swt/widgets/MessageBox.java;3;1;5;1;2;2;2;3;20;2;2;2824;33;33;2;1;0;3;5;4128;1;6352;4;3;
/org.eclipse.jdt.core.tests.model/workspace/TypeHierarchy/src/q1/X.java;1;0;1;1;0;0;0;1;0;0;1;3471;0;0;1;0;0;1;1;3471;0;3471;1;1;
/org.eclipse.ui.workbench/Eclipse UI/org/eclipse/ui/part/ISetSelectionTarget.java;1;0;1;1;0;0;0;1;4;0;1;1;4;4;1;0;0;1;1;1;0;1;1;1;
/org.eclipse.update.ui.forms/Eclipse Forms/org/eclipse/ui/forms/internal/widgets/TextSegment.java;1;0;2;1;0;0;0;2;0;1;2;3138;0;0;1;0;0;2;2;3138;0;4157;2;1;
/org.eclipse.core.tests.resources/src/org/eclipse/core/tests/internal/indexing/IntegratedFieldTest.java;1;0;2;1;2;1;2;0;8;0;0;5147;8;8;2;0;1;0;2;5147;1;5147;1;1;
/org.eclipse.team.ui/src/org/eclipse/team/ui/synchronize/ISynchronizeModelChangeListener.java;1;1;3;1;2;2;2;1;2;0;1;4632;3;3;1;0;0;1;3;4632;0;6337;3;1;
/org.eclipse.swt.tests/JUnit Tests/org/eclipse/swt/tests/junit/Test_org_eclipse_swt_graphics_DeviceData.java;1;0;1;1;0;0;0;1;2;0;1;2175;2;2;1;0;0;1;1;2175;0;2175;1;1;
/org.eclipse.jdt.ui.tests.refactoring/resources/DeleteSourceReference/test5/out/A.java;1;0;1;1;0;0;0;1;0;0;1;1652;0;0;1;0;0;1;1;1652;0;1652;1;1;
/org.eclipse.team.cvs.ui/src/org/eclipse/team/internal/ccvs/ui/repo/RepositoryRoot.java;2;1;14;1;3;3;3;11;115;2;10;68;228;228;2;1;0;11;14;68;1;6337;13;2;
/org.eclipse.pde.ui/src_OSGi/org/eclipse/pde/internal/ui/wizards/bundles/PluginToBundleWizardPage.java;1;0;2;1;0;0;0;2;0;1;2;2184;0;0;1;0;0;2;2;2184;0;2244;2;1;
/org.eclipse.jdt.ui.tests.refactoring/resources/SurroundWithWorkSpace/SurroundWithTests/trycatch_out/TestInitializerThrowsException.java;1;0;1;1;0;0;0;1;6;0;1;845;6;6;1;0;0;1;1;845;0;845;1;1;
/org.eclipse.ui.workbench/Eclipse UI/org/eclipse/ui/activities/IActivityManagerListener.java;3;1;7;1;2;2;2;5;21;2;4;2240;42;42;2;1;0;5;7;2800;1;6338;6;3;
/org.eclipse.ui.workbench/Eclipse UI/org/eclipse/ui/internal/keys/OutOfOrderListener.java;2;0;5;1;1;1;1;4;15;1;4;3010;48;48;1;0;0;4;5;3010;0;6338;5;2;
/org.eclipse.jdt.ui/ui/org/eclipse/jdt/internal/ui/wizards/NewClassCreationWizard.java;2;1;6;1;2;2;2;4;25;2;3;4064;57;57;2;1;0;4;6;4064;1;6340;5;2;
/org.eclipse.jdt.debug.tests/tests/org/eclipse/jdt/debug/tests/core/PatternBreakpointTests.java;1;0;1;1;0;0;0;1;2;0;1;2483;2;2;1;0;0;1;1;2483;0;2483;1;1;
/org.eclipse.update.ui.win32/src/org/eclipse/welcome/internal/portal/WelcomePortalEditorInput.java;1;0;1;1;0;0;0;1;0;0;1;907;0;0;1;0;0;1;1;907;0;907;1;1;
/org.eclipse.ui.ide/src/org/eclipse/ui/internal/ide/dialogs/SimpleListContentProvider.java;1;0;1;1;0;0;0;1;0;0;1;2264;0;0;1;0;0;1;1;2264;0;2264;1;1;
/org.eclipse.ui.ide/src/org/eclipse/ui/IMarkerResolutionGenerator2.java;2;0;2;1;0;0;0;2;0;1;2;1511;0;0;1;0;0;2;2;1511;0;2263;2;2;
/org.eclipse.ant.ui/Ant Tools Support/org/eclipse/ant/internal/ui/preferences/PropertyFileFilter.java;1;0;1;1;0;0;0;1;0;0;1;1811;0;0;1;0;0;1;1;1811;0;1811;1;1;
/org.eclipse.team.ui/src/org/eclipse/team/ui/synchronize/content/TeamOperationInput.java;1;0;1;1;0;0;0;1;0;0;1;3754;0;0;1;0;0;1;1;3754;0;3754;1;1;
/org.eclipse.update.core/src/org/eclipse/update/core/IIncludedFeatureReference.java;4;1;5;1;2;2;2;3;6;1;3;0;26;26;1;0;0;3;5;0;0;6336;5;4;
/org.eclipse.jdt.ui.tests.refactoring/resources/InlineMethodWorkspace/TestCases/nameconflict_in/TestSameType.java;1;0;1;1;0;0;0;1;2;0;1;845;2;2;1;0;0;1;1;845;0;845;1;1;
/org.eclipse.ui.examples.job/src/org/eclipse/ui/examples/jobs/actions/JobAction.java;2;1;2;1;2;2;2;0;10;0;0;5126;10;10;1;0;0;0;2;5126;0;5800;2;2;
/org.eclipse.jdt.ui.tests.refactoring/resources/InlineMethodWorkspace/TestCases/call_in/TestParenthesis.java;1;0;1;1;0;0;0;1;2;0;1;845;2;2;1;0;0;1;1;845;0;845;1;1;
/org.eclipse.text/src/org/eclipse/jface/text/link/LinkedEnvironment.java;2;2;5;1;3;2;3;2;149;1;2;4214;166;166;2;0;1;2;5;5127;1;5127;4;2;
/org.eclipse.ui.ide/src/org/eclipse/ui/internal/AboutAction.java;1;0;2;1;0;0;0;2;0;0;1;1671;0;0;2;1;0;2;2;1671;1;1671;1;1;
/org.eclipse.team.tests.cvs.core/src/org/eclipse/team/tests/ccvs/core/provider/ResourceDeltaTest.java;2;0;4;1;1;1;1;3;22;1;3;276;48;48;1;0;0;3;4;276;0;6337;4;2;
/org.eclipse.ui.externaltools/External Tools Base/org/eclipse/ui/externaltools/internal/variables/BuildTypeResolver.java;2;0;4;1;0;0;0;4;8;1;4;2082;16;16;1;0;0;4;4;2082;0;2515;4;2;
/org.eclipse.ui.workbench/Eclipse UI/org/eclipse/ui/internal/contexts/registry/IMutableRegistry.java;1;0;2;1;0;0;0;2;0;0;1;1396;0;0;2;1;0;2;2;1396;1;1396;1;1;
/org.eclipse.ui.workbench/Eclipse UI/org/eclipse/ui/IActionBars2.java;2;0;2;1;0;0;0;2;4;1;2;3220;4;4;1;0;0;2;2;3220;0;3239;2;2;
/org.eclipse.jdt.core.tests.model/workspace/Converter/src/test0187/Test.java;1;0;1;1;0;0;0;1;0;0;1;3714;0;0;1;0;0;1;1;3714;0;3714;1;1;
/org.eclipse.jdt.core.tests.model/workspace/Converter/src/test0480/A.java;1;0;1;1;0;0;0;1;0;0;1;3714;0;0;1;0;0;1;1;3714;0;3714;1;1;
/org.eclipse.jdt.ui.tests.refactoring/resources/ConvertAnonymousToNested/canConvert/A_test22_in.java;1;0;1;1;0;0;0;1;0;0;1;3195;0;0;1;0;0;1;1;3195;0;3195;1;1;
/org.eclipse.ui.ide/extensions/org/eclipse/ui/IMarkerHelpRegistry.java;1;0;1;1;0;0;0;1;0;0;1;2263;0;0;1;0;0;1;1;2263;0;2263;1;1;
/org.eclipse.core.resources/src/org/eclipse/core/internal/resources/MarkerDelta.java;2;1;5;1;2;2;2;3;388;1;3;180;492;492;1;0;0;3;5;180;0;5146;5;2;
/org.eclipse.team.cvs.core/src/org/eclipse/team/internal/ccvs/core/syncinfo/CVSBaseSynchronizationCache.java;2;0;4;1;0;0;0;4;66;2;3;3193;74;74;2;1;0;4;4;4233;1;4233;3;2;
/org.eclipse.jdt.core.tests.model/workspace/Resolve/src/ResolveDuplicateTypeDeclaration5.java;1;0;1;1;1;1;1;0;0;0;0;6222;0;0;1;0;0;0;1;6222;0;6222;1;1;
/org.eclipse.ui.tests/Eclipse UI Tests/org/eclipse/ui/tests/keys/Bug43321Test.java;5;0;19;1;1;1;1;18;93;3;16;2266;263;263;3;2;0;18;19;2308;2;6338;17;5;
/org.eclipse.update.ui/src/org/eclipse/update/internal/ui/views/ReplaceVersionAction.java;3;0;7;2;1;1;1;6;13;2;5;1242;30;30;2;1;0;6;7;1242;1;6336;6;3;
/org.eclipse.update.core/src/org/eclipse/update/search/IQueryUpdateSiteAdapter.java;2;0;6;2;1;1;1;5;16;2;4;825;27;27;2;1;0;5;6;825;1;5423;5;2;
/org.eclipse.ant.ui/Ant Editor/org/eclipse/ant/internal/ui/editor/tools/TaskXMLFileMerger.java;1;0;3;1;0;0;0;3;5;1;3;1811;5;5;1;0;0;3;3;1811;0;3809;3;1;
/org.eclipse.osgi/eclipseAdaptor/src/org/eclipse/core/runtime/adaptor/PluginParser.java;4;3;33;2;15;10;15;18;602;2;17;3132;1212;1212;3;1;5;18;33;5275;6;6133;27;4;
/org.eclipse.debug.ui/ui/org/eclipse/debug/ui/launchVariables/components/ResourceComponent.java;2;0;3;2;0;0;0;3;2;2;2;562;2;2;2;1;0;3;3;642;1;642;2;2;
/org.eclipse.jface/src/org/eclipse/jface/progress/IPendingPlaceholder.java;1;0;3;1;0;0;0;3;20;1;3;861;20;20;1;0;0;3;3;861;0;993;3;1;
/org.eclipse.jdt.ui/ui/org/eclipse/jdt/internal/ui/text/comment/ICommentAttributes.java;3;0;5;1;1;1;1;4;33;1;4;2097;45;45;1;0;0;4;5;2097;0;6340;5;3;
/org.eclipse.update.core/src/org/eclipse/update/internal/api/operations/IUpdateModelChangedListener.java;1;0;2;1;0;0;0;2;0;1;2;3270;0;0;1;0;0;2;2;3270;0;4928;2;1;
/org.eclipse.jdt.ui.tests.refactoring/resources/ExtractMethodWorkSpace/ExtractMethodTests/locals_out/A_test526.java;1;0;1;1;0;0;0;1;6;0;1;844;6;6;1;0;0;1;1;844;0;844;1;1;
/org.eclipse.help.tests/src/org/eclipse/help/tests/servlets/TestTopicServlet.java;1;1;3;1;2;2;2;1;61;0;1;2732;81;81;1;0;0;1;3;2732;0;6337;3;1;
/org.eclipse.pde.ui/src/org/eclipse/pde/internal/ui/editor/plugin/rows/ChoiceAttributeRow.java;2;1;3;1;3;3;3;0;10;0;0;5431;14;14;1;0;0;0;3;5431;0;6336;3;2;
/org.eclipse.sdk.tests-feature/plugins/org.eclipse.perfmsr.ui/src/org/eclipse/perfmsr/ui/actions/AddComment.java;2;1;4;1;3;3;3;1;14;0;1;4845;30;30;1;0;0;1;4;4845;0;6342;4;2;
/org.eclipse.ui.workbench/Eclipse UI/org/eclipse/ui/internal/commands/util/KeySupport.java;1;0;2;1;0;0;0;2;0;1;2;1077;0;0;1;0;0;2;2;1077;0;1222;2;1;
/org.eclipse.update.ui/src/org/eclipse/update/internal/ui/pages/LocalSitePage.java;1;0;1;1;0;0;0;1;0;0;1;755;0;0;1;0;0;1;1;755;0;755;1;1;
/org.eclipse.search/search/org/eclipse/search/internal/ui/GotoMarkerAction.java;1;0;1;1;1;1;1;0;2;0;0;6340;2;2;1;0;0;0;1;6340;0;6340;1;1;
/org.eclipse.team.ui/src/org/eclipse/team/ui/synchronize/actions/AutomergableFilter.java;1;0;1;1;0;0;0;1;0;0;1;2535;0;0;1;0;0;1;1;2535;0;2535;1;1;
/org.eclipse.jdt.ui.examples.javafamily/src/org/eclipse/jface/text/source/IAnnotationExtension.java;1;0;3;1;0;0;0;3;9;2;2;1150;9;9;2;1;0;3;3;1150;1;1642;2;1;
/org.eclipse.swt.graphics.text/Examples/examples/Main.java;1;0;3;1;0;0;0;3;84;1;3;2707;84;84;1;0;0;3;3;2707;0;2937;3;1;
/org.eclipse.debug.ui/ui/org/eclipse/debug/ui/variables/IVariableComponentContainer.java;1;0;2;1;0;0;0;2;0;1;2;322;0;0;1;0;0;2;2;322;0;550;2;1;
/org.eclipse.ui.examples.javaeditor/Template Editor Example/org/eclipse/ui/examples/templateeditor/editors/XMLScanner.java;2;0;2;1;1;1;1;1;10;0;1;4644;12;12;1;0;0;1;2;4644;0;6340;2;2;
/org.eclipse.ui.workbench/Eclipse UI/org/eclipse/ui/internal/csm/roles/api/IActivityBinding.java;1;0;5;1;0;0;0;5;12;4;2;2213;12;12;4;3;0;5;5;2225;3;2225;2;1;
/org.eclipse.ui.cheatsheets/src/org/eclipse/ui/cheatsheets/IAbstractItem.java;2;0;3;1;0;0;0;3;2;1;3;4428;2;2;1;0;0;3;3;4428;0;4625;3;2;
/org.eclipse.ui.cheatsheets/src/org/eclipse/ui/cheatsheets/ISubItem.java;1;0;2;1;0;0;0;2;0;1;2;4428;0;0;1;0;0;2;2;4428;0;4625;2;1;
/org.eclipse.jdt.core.tests.model/workspace/Formatter/test327/A_in.java;1;0;1;1;0;0;0;1;0;0;1;2565;0;0;1;0;0;1;1;2565;0;2565;1;1;
/org.eclipse.jdt.ui/core extension/org/eclipse/jdt/internal/corext/ValidateEditException.java;1;0;1;1;1;1;1;0;2;0;0;6340;2;2;1;0;0;0;1;6340;0;6340;1;1;
/org.eclipse.jdt.core.tests.model/workspace/Converter15/src/test0013/X.java;1;0;1;1;0;0;0;1;0;0;1;4667;0;0;1;0;0;1;1;4667;0;4667;1;1;
/org.eclipse.jdt.core.tests.model/workspace/Formatter/test082/A_in.java;1;0;1;1;0;0;0;1;0;0;1;2425;0;0;1;0;0;1;1;2425;0;2425;1;1;
/org.eclipse.ui.workbench/Eclipse UI/org/eclipse/ui/internal/activities/ws/ActivityCategoryLabelProvider.java;2;0;4;1;1;1;1;3;10;2;2;3458;12;12;2;1;0;3;4;4651;1;6338;3;2;
/org.eclipse.core.tests.runtime/src/org/eclipse/core/tests/internal/plugins/PluginResolveTest_28.java;1;0;1;1;0;0;0;1;0;0;1;3014;0;0;1;0;0;1;1;3014;0;3014;1;1;
/org.eclipse.help/src/org/eclipse/help/internal/util/HelpProperties.java;1;0;2;1;0;0;0;2;2;1;2;1938;2;2;1;0;0;2;2;1938;0;2732;2;1;
/org.eclipse.jdt.ui/ui/org/eclipse/jdt/internal/ui/filters/NonSharedProjectFilter.java;1;0;1;1;1;1;1;0;2;0;0;6340;2;2;1;0;0;0;1;6340;0;6340;1;1;
/org.eclipse.pde.ui/src/org/eclipse/pde/internal/ui/editor/feature/FeatureReferencePage.java;2;2;5;1;4;3;4;1;96;0;1;4203;108;108;2;0;1;1;5;5431;1;6336;4;2;
/org.eclipse.jdt.core.tests.model/src/org/eclipse/jdt/core/tests/model/ExclusionPatternsTests.java;1;1;9;1;2;2;2;7;44;1;7;100;156;156;1;0;0;7;9;100;0;5751;9;1;
/org.eclipse.ui.views/src/org/eclipse/ui/views/internal/markers/DialogProblemFilter.java;1;0;2;1;0;0;0;2;0;0;1;749;0;0;2;1;0;2;2;749;1;749;1;1;
/org.eclipse.jdt.core/compiler/org/eclipse/jdt/internal/compiler/codegen/MethodNameAndTypeCache.java;2;0;2;1;1;1;1;1;2;0;1;3560;4;4;1;0;0;1;2;3560;0;5916;2;2;
/org.eclipse.jdt.ui/core extension/org/eclipse/jdt/internal/corext/codemanipulation/IRequestQuery.java;1;0;1;1;1;1;1;0;2;0;0;6340;2;2;1;0;0;0;1;6340;0;6340;1;1;
/org.eclipse.jdt.ui.tests.refactoring/resources/ExtractMethodWorkSpace/ExtractMethodTests/destination_out/A_test1050.java;1;0;1;1;1;1;1;0;0;0;0;5353;0;0;1;0;0;0;1;5353;0;5353;1;1;
/org.eclipse.jdt.ui/ui/org/eclipse/jdt/internal/ui/javaeditor/filebuffers/JavaStorageDocumentProvider.java;2;0;3;1;0;0;0;3;2;1;3;1592;2;2;1;0;0;3;3;1592;0;4425;3;2;
/org.eclipse.jdt.core.tests.model/workspace/Converter/test0520/A.java;1;0;2;1;0;0;0;2;0;1;2;3612;0;0;1;0;0;2;2;3612;0;3714;2;1;
/org.eclipse.jdt.core.tests.model/workspace/Formatter/test228/A_out.java;1;0;1;1;0;0;0;1;0;0;1;2426;0;0;1;0;0;1;1;2426;0;2426;1;1;
/org.eclipse.ltk.core.refactoring/src/org/eclipse/ltk/core/refactoring/participants/RenameArguments.java;1;1;4;1;2;2;2;2;3;1;2;4845;7;7;1;0;0;2;4;4845;0;5184;4;1;
/org.eclipse.jdt.ui/core refactoring/org/eclipse/jdt/internal/corext/refactoring/structure/VisibilityChecker.java;2;0;2;1;0;0;0;2;6;1;2;218;6;6;1;0;0;2;2;218;0;1166;2;2;
/org.eclipse.osgi/osgi/src/org/eclipse/osgi/service/pluginconversion/IPluginInfo.java;1;0;2;1;0;0;0;2;0;0;1;3132;0;0;2;1;0;2;2;3132;1;3132;1;1;
/org.eclipse.core.tests.runtime/src/org/eclipse/core/tests/runtime/content/IContentTypeManagerTest.java;3;2;33;2;29;23;29;4;590;2;3;4574;1861;1861;2;1;6;4;33;4685;7;6317;26;3;
/org.eclipse.ui.workbench/Eclipse UI/org/eclipse/ui/internal/IWindowTrim.java;2;0;2;1;0;0;0;2;42;1;2;3677;42;42;1;0;0;2;2;3677;0;4015;2;2;
/org.eclipse.ui.workbench/Eclipse UI/org/eclipse/ui/internal/layout/CellLayout.java;1;0;1;1;0;0;0;1;0;0;1;5003;0;0;1;0;0;1;1;5003;0;5003;1;1;
/org.eclipse.jdt.debug.tests/tests/org/eclipse/jdt/debug/tests/core/StepIntoSelectionTests.java;3;0;3;1;1;1;1;2;36;1;2;631;40;40;1;0;0;2;3;631;0;6337;3;3;
/org.eclipse.jdt.ui.tests.refactoring/resources/DeleteSourceReferenceEdit/A_testField3_in.java;1;0;1;1;0;0;0;1;0;0;1;1652;0;0;1;0;0;1;1;1652;0;1652;1;1;
/org.eclipse.jdt.core/model/org/eclipse/jdt/internal/core/util/FieldInfo.java;2;0;2;1;1;1;1;1;8;0;1;3560;10;10;1;0;0;1;2;3560;0;5916;2;2;
/org.eclipse.jdt.core.tests.model/workspace/Formatter/test261/A_out.java;1;0;1;1;0;0;0;1;0;0;1;2442;0;0;1;0;0;1;1;2442;0;2442;1;1;
/org.eclipse.ant.ui/Ant Tools Support/org/eclipse/ant/ui/internal/preferences/AntEditorPreferenceConstants.java;1;0;3;1;0;0;0;3;100;1;3;250;100;100;1;0;0;3;3;250;0;1811;3;1;
/org.eclipse.jdt.ui/ui/org/eclipse/jdt/internal/ui/text/JavaBreakIterator.java;2;1;3;1;3;3;3;0;8;0;0;6072;11;11;1;0;0;0;3;6072;0;6340;3;2;
/org.eclipse.jdt.core/search/org/eclipse/jdt/internal/core/search/indexing/SourceIndexerRequestor.java;4;0;7;2;1;1;1;6;54;2;5;85;107;107;2;1;0;6;7;85;1;5592;6;4;
/org.eclipse.jdt.ui/ui refactoring/org/eclipse/jdt/internal/ui/refactoring/ComparePreviewer.java;2;0;3;1;0;0;0;3;44;1;3;4575;63;63;1;0;0;3;3;4575;0;4965;3;2;
/org.eclipse.jdt.core.tests.model/workspace/Converter/test0211/Test.java;1;0;1;1;0;0;0;1;0;0;1;3714;0;0;1;0;0;1;1;3714;0;3714;1;1;
/org.eclipse.pde.ui/src_Forms/org/eclipse/pde/internal/ui/neweditor/feature/InfoSection.java;2;1;3;1;2;2;2;1;7;0;1;4926;7;7;1;0;0;1;3;4926;0;5431;3;2;
/org.eclipse.webdav/src/kernel/org/eclipse/webdav/internal/kernel/WebDAVPreconditionFailures.java;1;0;1;1;1;1;1;0;138;0;0;5151;138;138;1;0;0;0;1;5151;0;5151;1;1;
/org.eclipse.swt/Eclipse SWT PI/gtk1x/org/eclipse/swt/internal/gtk/GtkCTreeRow.java;1;0;1;1;0;0;0;1;0;0;1;2327;0;0;1;0;0;1;1;2327;0;2327;1;1;
/org.eclipse.jdt.ui.tests.refactoring/resources/ChangeTypeRefactoring/negative/A_testUpdateNotPossible_in.java;1;0;1;1;0;0;0;1;0;0;1;2844;0;0;1;0;0;1;1;2844;0;2844;1;1;
/org.eclipse.jdt.ui.tests.refactoring/resources/SurroundWithWorkSpace/SurroundWithTests/trycatch_in/TestWrappedLocal1.java;1;0;1;1;0;0;0;1;5;0;1;845;5;5;1;0;0;1;1;845;0;845;1;1;
/org.eclipse.jdt.core.tests.model/workspace/Formatter/test027/A_out.java;1;0;2;1;0;0;0;2;4;1;2;2425;4;4;1;0;0;2;2;2425;0;3086;2;1;
/org.eclipse.jdt.ui/ui refactoring/org/eclipse/jdt/internal/ui/refactoring/participants/RenameInputWizardPage2.java;1;0;2;1;0;0;0;2;0;1;2;591;0;0;1;0;0;2;2;591;0;1047;2;1;
/org.eclipse.ui.workbench/Eclipse UI/org/eclipse/ui/commands/internal/ActionService.java;1;0;2;1;0;0;0;2;0;0;1;767;0;0;2;1;0;2;2;767;1;767;1;1;
/org.eclipse.ui.views/src/org/eclipse/ui/views/markers/internal/FieldFolder.java;2;0;2;1;0;0;0;2;0;1;2;755;0;0;1;0;0;2;2;755;0;2738;2;2;
/org.eclipse.core.tests.runtime/src/org/eclipse/core/tests/internal/plugins/PluginResolveTest_21.java;1;0;1;1;0;0;0;1;0;0;1;3014;0;0;1;0;0;1;1;3014;0;3014;1;1;
/org.eclipse.jdt.ui.tests.refactoring/resources/IntroduceParameter/simple/out/ConstantString.java;1;0;1;1;0;0;0;1;0;0;1;2281;0;0;1;0;0;1;1;2281;0;2281;1;1;
/org.eclipse.jdt.core.tests.model/workspace/Converter/src/javadoc/testBug51617/Test.java;1;0;1;1;1;1;1;0;0;0;0;5608;0;0;1;0;0;0;1;5608;0;5608;1;1;
/org.eclipse.ui.workbench/Eclipse UI/org/eclipse/ui/commands/ICommandManagerEvent.java;1;0;6;1;0;0;0;6;61;2;5;1222;74;74;2;1;0;6;6;2562;1;2824;5;1;
/org.eclipse.osgi/core/adaptor/org/eclipse/osgi/framework/util/ManifestElement.java;2;0;2;1;0;0;0;2;0;1;2;3013;0;0;1;0;0;2;2;3013;0;3216;2;2;
/org.eclipse.ui.forms/src/org/eclipse/ui/forms/FormWizardDialog.java;1;0;3;1;0;0;0;3;1;1;3;4068;1;1;1;0;0;3;3;4068;0;5044;3;1;
/org.eclipse.ant.ui/Ant Tools Support/org/eclipse/ant/internal/ui/preferences/AntTypesPage.java;1;0;8;1;0;0;0;8;58;2;6;1811;102;102;2;2;0;8;8;1860;2;2991;6;1;
/org.eclipse.jdt.ui.tests.refactoring/resources/ChangeSignature/canModify/A_testAll55_out.java;2;0;2;1;0;0;0;2;2;1;2;170;4;4;1;0;0;2;2;170;0;2093;2;2;
/org.eclipse.jdt.ui/core extension/org/eclipse/text/edits/Updater.java;1;0;4;1;0;0;0;4;14;2;3;1953;20;20;2;1;0;4;4;1953;1;1987;3;1;
/org.eclipse.search/new search/org/eclipse/search2/internal/ui/RemoveAllSearchesAction.java;2;0;4;1;1;1;1;3;8;1;3;3474;12;12;1;0;0;3;4;3474;0;6340;4;2;
/org.eclipse.pde.ui/src/org/eclipse/pde/internal/ui/editor/site/BuiltFeaturesWizard.java;2;1;3;1;2;2;2;1;4;0;1;3721;9;9;1;0;0;1;3;3721;0;6336;3;2;
/org.eclipse.ui.workbench/Eclipse UI/org/eclipse/ui/internal/util/ImageSupport.java;4;0;5;1;1;1;1;4;18;1;4;1722;40;40;1;0;0;4;5;1722;0;6338;5;4;
/org.eclipse.update.core/src/org/eclipse/update/internal/configuration/SiteLocalParser.java;1;0;1;1;0;0;0;1;0;0;1;2828;0;0;1;0;0;1;1;2828;0;2828;1;1;
/org.eclipse.swt.tests/JUnit Tests/org/eclipse/swt/tests/junit/Test_org_eclipse_swt_layout_FormAttachment.java;2;0;3;1;1;1;1;2;36;1;2;2176;40;40;1;0;0;2;3;2176;0;6352;3;2;
/org.eclipse.update.ui/src/org/eclipse/update/internal/ui/forms/DiscoveryFolderForm.java;1;0;1;1;0;0;0;1;0;0;1;755;0;0;1;0;0;1;1;755;0;755;1;1;
/org.eclipse.pde.runtime/src/org/eclipse/pde/internal/runtime/registry/ConfigurationElementPropertySource.java;2;0;4;1;1;1;1;3;72;1;3;924;149;149;1;0;0;3;4;924;0;6336;4;2;
/org.eclipse.ui.workbench/Eclipse UI/org/eclipse/ui/internal/dialogs/PreferenceErrorDialog.java;4;2;5;2;4;3;4;1;8;0;1;2737;16;16;2;0;1;1;5;5591;1;6338;4;4;
/org.eclipse.ui.workbench/Eclipse UI/org/eclipse/ui/internal/commands/registry/old/Category.java;1;0;3;1;0;0;0;3;2;2;2;1222;2;2;2;1;0;3;3;1321;1;1321;2;1;
/org.eclipse.jdt.core.tests.compiler/src/org/eclipse/jdt/core/tests/compiler/regression/AbstractRegressionTest.java;6;1;30;2;4;4;4;26;613;2;22;241;1269;1269;2;4;0;26;30;1844;4;5500;26;6;
/org.eclipse.core.runtime.osgi/src/org/eclipse/core/internal/jobs/OrderedLock.java;1;0;2;1;0;0;0;2;26;1;2;3013;26;26;1;0;0;2;2;3013;0;3028;2;1;
/org.eclipse.jdt.ui/core extension/org/eclipse/jdt/internal/corext/template/ContextTypeRegistry.java;1;0;1;1;0;0;0;1;0;0;1;4258;0;0;1;0;0;1;1;4258;0;4258;1;1;
/org.eclipse.jdt.ui.tests.refactoring/resources/ChangeTypeRefactoring/positive/A_testMultiCU_out.java;1;0;1;1;0;0;0;1;0;0;1;2844;0;0;1;0;0;1;1;2844;0;2844;1;1;
/org.eclipse.swt/Eclipse SWT/gtk/org/eclipse/swt/graphics/FontMetrics.java;2;0;2;1;1;1;1;1;10;0;1;4451;14;14;1;0;0;1;2;4451;0;6352;2;2;
/org.eclipse.jdt.ui.tests.refactoring/resources/ChangeTypeRefactoring/positive/A_testReturnType_in.java;1;0;1;1;0;0;0;1;0;0;1;2844;0;0;1;0;0;1;1;2844;0;2844;1;1;
/org.eclipse.ant.ui/Ant Tools Support/org/eclipse/ant/internal/ui/preferences/AntPropertiesPage.java;1;0;4;1;1;1;1;3;4;1;3;1811;10;10;1;0;0;3;4;1811;0;6336;4;1;
/org.eclipse.webdav/src/client/org/eclipse/webdav/client/RequestBodyWriter.java;1;0;2;1;1;1;1;1;4;0;1;2549;6;6;1;0;0;1;2;2549;0;5151;2;1;
/org.eclipse.search/new search/org/eclipse/search/ui/text/RemoveAllEvent.java;2;1;4;1;3;3;3;1;14;0;1;3711;19;19;1;0;0;1;4;3711;0;6340;4;2;
/org.eclipse.jdt.ui/ui/org/eclipse/jdt/internal/ui/browsing/PackagesViewHierarchicalContentProvider.java;1;2;5;1;4;3;4;1;22;0;1;274;44;44;2;0;1;1;5;6097;1;6340;4;1;
/org.eclipse.team.ui/src/org/eclipse/team/ui/synchronize/viewers/SyncInfoDiffNodeSorter.java;1;0;1;1;0;0;0;1;0;0;1;3972;0;0;1;0;0;1;1;3972;0;3972;1;1;
/org.eclipse.jdt.ui/core extension/org/eclipse/jdt/internal/corext/codemanipulation/AbstractCodeBlock.java;1;0;1;1;0;0;0;1;0;0;1;159;0;0;1;0;0;1;1;159;0;159;1;1;
/org.eclipse.jdt.ui/ui/org/eclipse/jdt/internal/ui/wizards/buildpaths/VariableCreationDialog.java;2;0;2;1;1;1;1;1;10;0;1;4868;12;12;1;0;0;1;2;4868;0;6340;2;2;
/org.eclipse.pde.core/src/org/eclipse/pde/internal/core/bundle/Bundle.java;2;1;4;1;2;2;2;2;98;1;2;2184;108;108;1;0;0;2;4;2184;0;6336;4;2;
/org.eclipse.pde.ui/src_Forms/org/eclipse/pde/internal/ui/neweditor/XMLOutlinePage.java;2;0;4;1;1;1;1;3;156;1;3;3812;165;165;1;0;0;3;4;3812;0;5298;4;2;
/org.eclipse.ant.tests.ui/Ant Editor Tests/org/eclipse/ant/tests/ui/editor/formatter/XmlFormatterTest.java;1;0;1;1;1;1;1;0;0;0;0;5739;0;0;1;0;0;0;1;5739;0;5739;1;1;
/org.eclipse.ui.externaltools/Ant Editor/org/eclipse/ui/externaltools/internal/ant/editor/AntEditorException.java;1;0;2;1;0;0;0;2;0;1;2;178;0;0;1;0;0;2;2;178;0;282;2;1;
/org.eclipse.update.ui/src/org/eclipse/update/internal/ui/model/ConfiguredSiteAdapter.java;1;0;1;1;0;0;0;1;4;0;1;1281;4;4;1;0;0;1;1;1281;0;1281;1;1;
/org.eclipse.pde.ui/src_Forms/org/eclipse/pde/internal/ui/neweditor/context/InputContextManager.java;2;1;7;1;2;2;2;5;47;1;5;4243;96;96;1;0;0;5;7;4243;0;5431;7;2;
/org.eclipse.swt/Eclipse SWT/photon/org/eclipse/swt/widgets/FileDialog.java;3;1;4;2;2;2;2;2;19;0;1;2663;27;27;2;1;0;2;4;2663;1;6352;3;3;
/org.eclipse.swt/Eclipse SWT/gtk1x/org/eclipse/swt/widgets/Shell.java;1;0;1;1;0;0;0;1;0;0;1;2327;0;0;1;0;0;1;1;2327;0;2327;1;1;
/org.eclipse.core.runtime/src/org/eclipse/core/internal/registry/IHost.java;2;0;2;1;0;0;0;2;0;1;2;2105;0;0;1;0;0;2;2;2105;0;3013;2;2;
/org.eclipse.jdt.core.tests.model/workspace/Converter/src/test0073/Test.java;1;0;1;1;0;0;0;1;0;0;1;3714;0;0;1;0;0;1;1;3714;0;3714;1;1;
/org.eclipse.jdt.ui/core refactoring/org/eclipse/jdt/internal/corext/refactoring/participants/xml/IScope.java;1;0;2;1;0;0;0;2;0;1;2;2253;0;0;1;0;0;2;2;2253;0;2682;2;1;
/org.eclipse.pde.core/src/org/eclipse/pde/internal/core/plugin/PluginExtensionPoint.java;3;1;7;1;4;4;4;3;24;1;3;2184;68;68;1;0;0;3;7;2184;0;6336;7;3;
/org.eclipse.jdt.ui/ui refactoring/org/eclipse/jdt/internal/ui/refactoring/reorg/RenameMethodWizard.java;2;0;4;1;1;1;1;3;10;2;2;1125;19;19;2;1;0;3;4;1125;1;6340;3;2;
/org.eclipse.team.cvs.core/src/org/eclipse/team/internal/ccvs/core/ICVSRemoteFolder.java;1;0;1;1;0;0;0;1;3;0;1;1891;3;3;1;0;0;1;1;1891;0;1891;1;1;
/org.eclipse.ltk.core.refactoring/src/org/eclipse/ltk/internal/core/refactoring/NotCancelableProgressMonitor.java;1;0;1;1;1;1;1;0;0;0;0;5269;0;0;1;0;0;0;1;5269;0;5269;1;1;
/org.eclipse.jdt.ui.tests.refactoring/resources/ChangeSignature/canModify/A_testException01_out.java;1;0;1;1;0;0;0;1;0;0;1;2562;0;0;1;0;0;1;1;2562;0;2562;1;1;
/org.eclipse.core.filebuffers/src/org/eclipse/core/internal/filebuffers/ResourceFileBuffer.java;3;2;13;2;5;4;5;8;33;3;6;2224;106;106;3;2;1;8;13;2304;3;6340;10;3;
/org.eclipse.jdt.ui.tests.refactoring/resources/DeleteSourceReference/test15/out/A.java;1;0;1;1;0;0;0;1;0;0;1;1652;0;0;1;0;0;1;1;1652;0;1652;1;1;
/org.eclipse.jdt.ui.tests/ui/org/eclipse/jdt/ui/tests/quickfix/QuickFixTest.java;4;1;22;2;5;5;5;17;96;2;16;299;384;384;2;1;0;17;22;1230;1;6340;21;4;
/org.eclipse.team.cvs.ui/src/org/eclipse/team/internal/ccvs/ui/merge/MergeEditorInput.java;1;0;1;1;0;0;0;1;0;0;1;4217;0;0;1;0;0;1;1;4217;0;4217;1;1;
/org.eclipse.team.cvs.ui/src/org/eclipse/team/internal/ccvs/ui/model/CVSFolderElement.java;2;0;2;1;0;0;0;2;5;1;2;66;7;7;1;0;0;2;2;66;0;990;2;2;
/org.eclipse.pde.ui/src/org/eclipse/pde/internal/ui/wizards/WizardCollectionElement.java;2;1;2;1;2;2;2;0;6;0;0;5783;10;10;1;0;0;0;2;5783;0;6336;2;2;
/org.eclipse.team.ui/src/org/eclipse/team/internal/ui/synchronize/actions/WorkingSetFilterActionGroup.java;2;1;11;1;2;2;2;9;150;2;8;2535;351;351;2;1;0;9;11;2648;1;5596;10;2;
/org.eclipse.jdt.core/model/org/eclipse/jdt/core/IField.java;3;0;5;1;0;0;0;5;68;1;5;1787;85;85;1;0;0;5;5;1787;0;5022;5;3;
/org.eclipse.jdt.core.tests.model/workspace/Converter/test0274/Test.java;1;0;1;1;0;0;0;1;0;0;1;3714;0;0;1;0;0;1;1;3714;0;3714;1;1;
/org.eclipse.team.cvs.ui/src/org/eclipse/team/internal/ccvs/ui/repo/RepositoryEncodingPropertyPage.java;2;2;7;2;6;5;6;1;12;0;1;4851;28;28;2;0;1;1;7;5358;1;6015;6;2;
/org.eclipse.ui.workbench/Eclipse UI/org/eclipse/ui/internal/PerspectiveSwitcher.java;5;2;14;2;14;10;14;0;339;0;0;5737;1136;1136;2;0;4;0;14;5737;4;6271;10;5;
/org.eclipse.core.tests.resources/src/org/eclipse/core/tests/internal/watson/IPathConstants.java;1;0;1;1;1;1;1;0;5;0;0;5147;5;5;1;0;0;0;1;5147;0;5147;1;1;
/org.eclipse.help.base/src/org/eclipse/help/internal/standalone/EclipseController.java;1;1;7;1;4;4;4;3;241;1;3;1740;372;372;1;0;0;3;7;1740;0;6337;7;1;
/org.eclipse.jdt.ui.tests/ui/org/eclipse/jdt/ui/tests/astrewrite/ASTRewritingStatementsTest.java;2;0;21;1;1;1;1;20;1569;3;18;345;4252;4252;3;2;0;20;21;1803;2;5406;19;2;
/org.eclipse.team.ui/src/org/eclipse/team/ui/synchronize/MutableSyncInfoSet.java;1;0;1;1;0;0;0;1;0;0;1;3530;0;0;1;0;0;1;1;3530;0;3530;1;1;
/org.eclipse.jdt.ui/ui/org/eclipse/jdt/internal/ui/filters/LibraryFilter.java;1;0;1;1;1;1;1;0;2;0;0;6340;2;2;1;0;0;0;1;6340;0;6340;1;1;
/org.eclipse.pde.core/src/org/eclipse/pde/core/IWritable.java;2;1;4;1;3;3;3;1;42;0;1;4203;54;54;1;0;0;1;4;4203;0;6336;4;2;
/org.eclipse.ui.examples.job/org/eclipse/ui/examples/jobs/views/JobsView.java;1;0;2;1;2;1;2;0;0;0;0;5125;0;0;2;0;1;0;2;5125;1;5125;1;1;
/org.eclipse.team.webdav/src/org/eclipse/team/internal/webdav/subscriber/WebDavDeploymentProvider.java;2;1;5;1;2;2;2;3;351;1;3;3496;363;363;1;0;0;3;5;3496;0;6337;5;2;
/org.eclipse.jdt.ui/ui/org/eclipse/jdt/internal/ui/reorg/TypedSourceTransfer.java;1;0;2;1;0;0;0;2;4;1;2;490;4;4;1;0;0;2;2;490;0;1112;2;1;
/org.eclipse.ui.externaltools/Ant Editor/org/eclipse/ui/externaltools/internal/ant/editor/outline/AntOutlineMessages.java;1;0;1;1;0;0;0;1;0;0;1;282;0;0;1;0;0;1;1;282;0;282;1;1;
/org.eclipse.jdt.core.tests.model/workspace/Formatter/test136/A_in.java;1;0;1;1;0;0;0;1;0;0;1;2425;0;0;1;0;0;1;1;2425;0;2425;1;1;
/org.eclipse.jdt.ui.tests.refactoring/resources/Move/testDestination_yes_methodToOtherType/in/A.java;1;0;1;1;0;0;0;1;0;0;1;1008;0;0;1;0;0;1;1;1008;0;1008;1;1;
/org.eclipse.core.runtime.osgi/src/org/eclipse/core/internal/runtime/Cipher.java;1;0;2;1;0;0;0;2;190;1;2;3013;190;190;1;0;0;2;2;3013;0;3030;2;1;
/org.eclipse.ltk.ui.refactoring/src/org/eclipse/ltk/internal/ui/refactoring/UndoRefactoringAction.java;1;1;3;1;3;3;3;0;15;0;0;5162;15;15;1;0;0;0;3;5162;0;5355;3;1;
/org.eclipse.swt/Eclipse SWT PI/carbon/org/eclipse/swt/internal/carbon/EventRecord.java;1;2;3;1;3;2;3;0;16;0;0;5534;20;20;2;0;1;0;3;5534;1;5614;2;1;
/org.eclipse.ui.workbench/Eclipse UI/org/eclipse/ui/internal/presentations/PartPaneSystemContribution.java;2;0;2;1;0;0;0;2;0;1;2;4504;0;0;1;0;0;2;2;4504;0;4680;2;2;
/org.eclipse.help.ui/src/org/eclipse/help/ui/internal/HelpUIResources.java;1;1;7;1;3;3;3;4;181;1;4;1781;301;301;1;0;0;4;7;1781;0;6337;7;1;
/org.eclipse.jdt.core.tests.model/workspace/Formatter/test223/A_in.java;1;0;1;1;0;0;0;1;0;0;1;2426;0;0;1;0;0;1;1;2426;0;2426;1;1;
/org.eclipse.jdt.core.tests.model/workspace/Converter/src/p3/B.java;1;0;1;1;0;0;0;1;0;0;1;3714;0;0;1;0;0;1;1;3714;0;3714;1;1;
/org.eclipse.jdt.ui.examples.javafamily/src/org/eclipse/jdt/internal/ui/examples/jspeditor/Jsp2JavaReconcileStep.java;3;1;5;1;2;2;2;3;4;1;3;1629;9;9;1;0;0;3;5;1629;0;5177;5;3;
/org.eclipse.search/search/org/eclipse/search/internal/ui/SearchMessages.java;1;0;1;1;1;1;1;0;2;0;0;6340;2;2;1;0;0;0;1;6340;0;6340;1;1;
/org.eclipse.team.cvs.ui/src/org/eclipse/team/internal/ccvs/ui/subscriber/CVSSynchronizeViewCompareConfiguration.java;2;0;3;1;0;0;0;3;94;1;3;3749;94;94;1;0;0;3;3;3749;0;4244;3;2;
/org.eclipse.ui.workbench/Eclipse UI/org/eclipse/ui/internal/themes/ITabThemeDescriptor.java;2;0;2;1;0;0;0;2;0;1;2;3684;0;0;1;0;0;2;2;3684;0;4471;2;2;
/org.eclipse.compare/compare/org/eclipse/compare/internal/BaseCompareAction.java;1;0;1;1;0;0;0;1;0;0;1;1731;0;0;1;0;0;1;1;1731;0;1731;1;1;
/org.eclipse.text.tests/src/org/eclipse/text/tests/TextEditTests.java;1;1;3;1;2;2;2;1;12;0;1;5082;14;14;1;0;0;1;3;5082;0;6340;3;1;
/org.eclipse.jdt.debug.ui/ui/org/eclipse/jdt/internal/debug/ui/actions/ExcludeExceptionLocationAction.java;1;0;1;1;0;0;0;1;6;0;1;1593;6;6;1;0;0;1;1;1593;0;1593;1;1;
/org.eclipse.team.webdav/src/org/eclipse/team/internal/ui/target/subscriber/TeamSubscriberNonblockingContext.java;2;0;4;1;0;0;0;4;27;1;4;3494;29;29;1;0;0;4;4;3494;0;4720;4;2;
/org.eclipse.jdt.core/model/org/eclipse/jdt/core/ToolFactory.java;4;0;20;1;0;0;0;20;56;1;20;69;227;227;1;0;0;20;20;69;0;4929;20;4;
/org.eclipse.ui.workbench/Eclipse UI/org/eclipse/ui/internal/ide/IDEWorkbenchMessages.java;1;0;1;1;0;0;0;1;0;0;1;1259;0;0;1;0;0;1;1;1259;0;1259;1;1;
/org.eclipse.help/src/org/eclipse/help/internal/search/QueryTooComplexException.java;1;0;2;1;0;0;0;2;0;1;2;1930;0;0;1;0;0;2;2;1930;0;2732;2;1;
/org.eclipse.help/src/org/eclipse/help/internal/workingset/AdaptableHelpResource.java;1;0;1;1;0;0;0;1;0;0;1;2732;0;0;1;0;0;1;1;2732;0;2732;1;1;
/org.eclipse.pde.ui/src/org/eclipse/pde/internal/ui/editor/text/XMLPartitionScanner.java;3;1;4;1;2;2;2;2;19;1;2;3795;31;31;1;0;0;2;4;3795;0;6336;4;3;
/org.eclipse.ui.ide/src/org/eclipse/ui/internal/ide/DialogUtil.java;3;1;3;1;2;2;2;1;7;0;1;1526;9;9;1;0;0;1;3;1526;0;6338;3;3;
/org.eclipse.core.tests.resources/src/org/eclipse/core/tests/resources/NatureTest.java;2;1;3;1;3;3;3;0;258;0;0;5147;337;337;1;0;0;0;3;5147;0;6249;3;2;
/org.eclipse.core.tests.runtime/src/org/eclipse/core/tests/internal/runtimetests/SampleD.java;1;0;1;1;1;1;1;0;19;0;0;5149;19;19;1;0;0;0;1;5149;0;5149;1;1;
/org.eclipse.jdt.ui/ui refactoring/org/eclipse/jdt/internal/ui/refactoring/UserInterfaceDescriptor.java;1;0;2;1;0;0;0;2;0;1;2;1709;0;0;1;0;0;2;2;1709;0;4507;2;1;
/org.eclipse.debug.core/core/org/eclipse/debug/core/IProcessFactory.java;3;1;5;1;2;2;2;3;30;1;3;1879;39;39;1;0;0;3;5;1879;0;6336;5;3;
/org.eclipse.core.tools.resources/src/org/eclipse/core/tools/resources/ResourceView.java;1;0;1;1;1;1;1;0;0;0;0;6302;0;0;1;0;0;0;1;6302;0;6302;1;1;
/org.eclipse.jdt.ui/core refactoring/org/eclipse/jdt/internal/corext/refactoring/code/TargetProvider.java;4;1;10;1;4;4;4;6;45;1;6;218;100;100;1;0;0;6;10;218;0;6340;10;4;
/org.eclipse.pde.ui/src_Forms/org/eclipse/pde/internal/ui/neweditor/feature/DataSection.java;2;0;3;1;1;1;1;2;93;0;1;4926;93;93;2;1;0;2;3;4926;1;5431;2;2;
/org.eclipse.jdt.ui.tests.refactoring/resources/RenameType/test61/out/A.java;1;0;1;1;0;0;0;1;0;0;1;4913;0;0;1;0;0;1;1;4913;0;4913;1;1;
/org.eclipse.jdt.core/search/org/eclipse/jdt/internal/core/search/matching/PackageDeclarationPattern.java;3;3;15;1;4;2;4;11;37;1;11;786;166;166;3;0;2;11;15;5207;2;5335;13;3;
/org.eclipse.ui.externaltools/Ant Tools Support/org/eclipse/ui/externaltools/internal/ant/preferences/AntRuntimePreferencePage.java;1;0;2;1;0;0;0;2;9;1;2;33;9;9;1;0;0;2;2;33;0;282;2;1;
/org.eclipse.jface.text/src/org/eclipse/jface/internal/text/link/contentassist/HTML2TextReader.java;3;1;4;1;3;3;3;1;6;0;1;4214;10;10;1;0;0;1;4;4214;0;6340;4;3;
/org.eclipse.jdt.ui/core refactoring/org/eclipse/jdt/internal/corext/refactoring/code/flow/GenericConditionalFlowInfo.java;1;0;1;1;1;1;1;0;2;0;0;6340;2;2;1;0;0;0;1;6340;0;6340;1;1;
/org.eclipse.ui.editors/src/org/eclipse/ui/internal/editors/text/SharedTextColors.java;2;0;3;1;1;1;1;2;2;1;2;1644;2;2;1;0;0;2;3;1644;0;6340;3;2;
/org.eclipse.ui.externaltools/Ant Tools Support/org/eclipse/ui/externaltools/internal/ant/preferences/AntClasspathLabelProvider.java;1;0;2;1;0;0;0;2;4;1;2;253;4;4;1;0;0;2;2;253;0;298;2;1;
/org.eclipse.jdt.text.tests/src/org/eclipse/jdt/text/tests/JavaBreakIteratorTest.java;2;1;2;1;2;2;2;0;6;0;0;6072;6;6;1;0;0;0;2;6072;0;6340;2;2;
/org.eclipse.jdt.core.tests.model/workspace/Formatter/test437/A_out.java;1;0;1;1;0;0;0;1;0;0;1;3498;0;0;1;0;0;1;1;3498;0;3498;1;1;
/org.eclipse.search/search/org/eclipse/search/internal/ui/RemoveAllSearchesAction.java;1;0;1;1;1;1;1;0;2;0;0;6340;2;2;1;0;0;0;1;6340;0;6340;1;1;
/org.eclipse.core.runtime/src/org/eclipse/core/internal/jobs/Semaphore.java;3;0;9;1;1;1;1;8;112;1;8;351;296;296;1;0;0;8;9;351;0;5150;9;3;
/org.eclipse.pde.ui/src/org/eclipse/pde/internal/ui/wizards/project/FragmentContentPage.java;2;0;3;1;0;0;0;3;8;1;3;3440;8;8;1;0;0;3;3;3440;0;3840;3;2;
/org.eclipse.jdt.ui/core refactoring/org/eclipse/jdt/internal/corext/refactoring/participants/IMoveProcessor.java;1;0;2;1;0;0;0;2;0;1;2;825;0;0;1;0;0;2;2;825;0;4624;2;1;
/org.eclipse.core.tests.resources/src/org/eclipse/core/tests/resources/usecase/ConcurrencyPerformanceTest.java;1;3;4;1;4;2;4;0;55;0;0;5147;56;56;3;0;2;0;4;5147;2;5686;2;1;
/org.eclipse.ui.workbench/Eclipse UI/org/eclipse/ui/activities/IIdentifier.java;3;1;6;1;2;2;2;4;70;2;3;2989;122;122;2;1;0;4;6;2989;1;6338;5;3;
/org.eclipse.ltk.ui.refactoring/src/org/eclipse/ltk/ui/refactoring/IRefactoringWizardDialog.java;1;0;2;1;0;0;0;2;0;1;2;4988;0;0;1;0;0;2;2;4988;0;5052;2;1;
/org.eclipse.pde.ui/src/org/eclipse/pde/internal/ui/editor/plugin/BundleSourcePage.java;1;1;4;1;4;4;4;0;10;0;0;5431;14;14;1;0;0;0;4;5431;0;6336;4;1;
/org.eclipse.jdt.core.tests.model/workspace/Formatter/test049/A_in.java;1;0;1;1;0;0;0;1;0;0;1;2425;0;0;1;0;0;1;1;2425;0;2425;1;1;
/org.eclipse.jface.text/src/org/eclipse/jface/text/contentassist/ICompletionProposalExtension3.java;3;2;7;2;4;3;4;3;63;1;3;787;126;126;2;0;1;3;7;6353;1;6353;6;3;
/org.eclipse.jdt.core.tests.model/workspace/Formatter/test042/A_in.java;1;0;1;1;0;0;0;1;0;0;1;2425;0;0;1;0;0;1;1;2425;0;2425;1;1;
/org.eclipse.team.ui/src/org/eclipse/team/ui/synchronize/actions/SyncInfoDirectionFilter.java;1;0;1;1;0;0;0;1;0;0;1;2535;0;0;1;0;0;1;1;2535;0;2535;1;1;
/org.eclipse.swt/Eclipse SWT/emulated/tabfolder/org/eclipse/swt/widgets/TabItem.java;3;1;4;1;2;2;2;2;12;1;2;269;20;20;1;0;0;2;4;269;0;6352;4;3;
/org.eclipse.jdt.ui/core refactoring/org/eclipse/jdt/internal/corext/refactoring/changes/UndoDocumentChange.java;1;0;6;1;0;0;0;6;45;1;6;3646;83;83;1;0;0;6;6;3646;0;4624;6;1;
/org.eclipse.swt/Eclipse SWT Mozilla/common/org/eclipse/swt/internal/mozilla/nsIDocumentLoaderFactory.java;1;0;1;1;0;0;0;1;0;0;1;2663;0;0;1;0;0;1;1;2663;0;2663;1;1;
/org.eclipse.ant.ui/Ant Tools Support/org/eclipse/ant/ui/internal/preferences/StatusDialog.java;1;0;3;1;0;0;0;3;1;2;2;266;1;1;2;1;0;3;3;266;1;1811;2;1;
/org.eclipse.ui.ide/src/org/eclipse/ui/views/markers/internal/TableSorter.java;3;1;3;1;2;2;2;1;2;0;1;2208;4;4;1;0;0;1;3;2208;0;6338;3;3;
/org.eclipse.ui.intro/src/org/eclipse/ui/intro/internal/parts/PageForm.java;1;0;7;1;1;1;1;6;297;1;6;4429;336;336;1;0;0;6;7;4429;0;5115;7;1;
/org.eclipse.ui.workbench/Eclipse UI/org/eclipse/ui/internal/commands/registry/old/PreferenceRegistry.java;1;0;2;1;0;0;0;2;0;1;2;1222;0;0;1;0;0;2;2;1222;0;1322;2;1;
/org.eclipse.jdt.ui/core refactoring/org/eclipse/jdt/internal/corext/refactoring/code/TempAssignmentFinder.java;1;0;1;1;1;1;1;0;2;0;0;6340;2;2;1;0;0;0;1;6340;0;6340;1;1;
/org.eclipse.jdt.core/model/org/eclipse/jdt/core/ISourceRange.java;1;0;1;1;0;0;0;1;2;0;1;3560;2;2;1;0;0;1;1;3560;0;3560;1;1;
/org.eclipse.ui.intro/src/org/eclipse/ui/intro/internal/model/IntroHomePage.java;1;0;7;1;1;1;1;6;220;1;6;4429;291;291;1;0;0;6;7;4429;0;5115;7;1;
/org.eclipse.ui.workbench/Eclipse UI/org/eclipse/ui/internal/commands/api/IAction.java;1;0;2;1;0;0;0;2;2;0;1;2562;2;2;2;1;0;2;2;2562;1;2562;1;1;
/org.eclipse.jdt.core.tests.model/workspace/Converter/test0377/A.java;1;0;1;1;0;0;0;1;0;0;1;3714;0;0;1;0;0;1;1;3714;0;3714;1;1;
/org.eclipse.jdt.ui.tests.refactoring/resources/TypeConstraints/A_testConstraints2.java;1;0;1;1;0;0;0;1;0;0;1;53;0;0;1;0;0;1;1;53;0;53;1;1;
/org.eclipse.jdt.core.tests.model/workspace/Converter/test0099/Test.java;1;0;1;1;0;0;0;1;0;0;1;3714;0;0;1;0;0;1;1;3714;0;3714;1;1;
/org.eclipse.jdt.ui/core refactoring/org/eclipse/ltk/core/refactoring/participants/MoveProcessor.java;1;0;3;1;0;0;0;3;35;1;3;4688;35;35;1;0;0;3;3;4688;0;4864;3;1;
/org.eclipse.jdt.core.tests.model/workspace/Formatter/test400/A_in.java;1;0;1;1;0;0;0;1;0;0;1;3436;0;0;1;0;0;1;1;3436;0;3436;1;1;
/org.eclipse.jdt.ui/ui refactoring/org/eclipse/jdt/internal/ui/refactoring/nls/SourceContainerDialog.java;3;1;3;1;2;2;2;1;90;0;1;4930;92;92;1;0;0;1;3;4930;0;6340;3;3;
/org.eclipse.pde.ui/src/org/eclipse/pde/internal/ui/preferences/BuildOptionsPreferencePage.java;1;1;6;1;2;2;2;4;71;1;4;1718;114;114;1;0;0;4;6;1718;0;6336;6;1;
/org.eclipse.jdt.ui/core refactoring/org/eclipse/jdt/internal/corext/refactoring/participants/xml/CountExpression.java;1;0;4;1;0;0;0;4;19;1;4;2682;27;27;1;0;0;4;4;2682;0;4108;4;1;
/org.eclipse.update.core/src/org/eclipse/update/operations/IReplaceFeatureVersionOperation.java;1;2;6;1;3;2;3;3;11;1;3;1242;17;17;2;0;1;3;6;6336;1;6336;5;1;
/org.eclipse.jdt.ui/ui/org/eclipse/jdt/ui/IWorkingCopyManager.java;2;0;2;1;1;1;1;1;2;0;1;4824;4;4;1;0;0;1;2;4824;0;6340;2;2;
/org.eclipse.jdt.core/eval/org/eclipse/jdt/internal/eval/EvaluationConstants.java;2;0;2;1;0;0;0;2;4;1;2;662;6;6;1;0;0;2;2;662;0;3560;2;2;
/org.eclipse.update.ui.forms/src/org/eclipse/update/ui/forms/internal/engine/FormEngine.java;1;0;3;1;0;0;0;3;17;1;3;492;32;32;1;0;0;3;3;492;0;925;3;1;
/org.eclipse.debug.core/core/org/eclipse/debug/core/sourcelookup/ISourceContainer.java;1;0;1;1;0;0;0;1;0;0;1;4949;0;0;1;0;0;1;1;4949;0;4949;1;1;
/org.eclipse.team.webdav/src/org/eclipse/team/internal/core/target/TargetSubscriberResource.java;1;0;1;1;0;0;0;1;0;0;1;3477;0;0;1;0;0;1;1;3477;0;3477;1;1;
/org.eclipse.ant.tests.ui/test support/org/eclipse/ant/tests/ui/support/tasks/AntTestTask.java;1;0;1;1;0;0;0;1;0;0;1;4097;0;0;1;0;0;1;1;4097;0;4097;1;1;
/org.eclipse.team.tests.cvs.core/src/org/eclipse/team/tests/ccvs/ui/HeadlessCVSRunnableContext.java;2;0;4;1;0;0;0;4;12;1;4;2632;22;22;1;0;0;4;4;2632;0;4466;4;2;
/org.eclipse.jdt.ui.tests.refactoring/resources/ChangeTypeRefactoring/positive/A_testFieldWithAccess2.java;1;0;1;1;0;0;0;1;0;0;1;2844;0;0;1;0;0;1;1;2844;0;2844;1;1;
/org.eclipse.debug.core/core/org/eclipse/debug/internal/core/memory/IMemoryRendering.java;1;0;1;1;1;1;1;0;0;0;0;5254;0;0;1;0;0;0;1;5254;0;5254;1;1;
/org.eclipse.ui.ide/src/org/eclipse/ui/internal/ide/IPreferenceConstants.java;2;0;2;2;0;0;0;2;0;0;1;1654;0;0;2;1;0;2;2;1654;1;1654;1;2;
/org.eclipse.debug.ui/ui/org/eclipse/debug/ui/launchVariables/ResourceNameExpander.java;1;0;2;1;0;0;0;2;0;1;2;550;0;0;1;0;0;2;2;550;0;562;2;1;
/org.eclipse.jdt.core.tests.model/workspace/Formatter/test111/A_in.java;1;0;1;1;0;0;0;1;0;0;1;2425;0;0;1;0;0;1;1;2425;0;2425;1;1;
/org.eclipse.team.tests.cvs.core/src/org/eclipse/team/tests/ccvs/ui/CheckoutOperationTests.java;1;0;1;1;0;0;0;1;0;0;1;2632;0;0;1;0;0;1;1;2632;0;2632;1;1;
/org.eclipse.ui.ide/src/org/eclipse/ui/internal/ide/WorkbenchActionBuilder.java;8;2;49;2;14;11;14;35;633;2;31;2264;2617;2617;2;4;3;35;49;3109;7;6338;42;8;
/org.eclipse.team.cvs.ssh/src/org/eclipse/team/internal/ccvs/ssh/SSHPlugin.java;1;0;1;1;0;0;0;1;8;0;1;866;8;8;1;0;0;1;1;866;0;866;1;1;
/org.eclipse.search.tests/src/org/eclipse/search/core/tests/NullQuery.java;1;0;1;1;0;0;0;1;0;0;1;4345;0;0;1;0;0;1;1;4345;0;4345;1;1;
/org.eclipse.core.runtime/src/org/eclipse/core/internal/plugins/PluginPrerequisite.java;1;0;1;1;0;0;0;1;0;0;1;3013;0;0;1;0;0;1;1;3013;0;3013;1;1;
/org.eclipse.jdt.ui/ui/org/eclipse/jdt/internal/ui/actions/SelectionConverter.java;4;0;6;1;1;1;1;5;71;1;5;363;107;107;1;0;0;5;6;363;0;6340;6;4;
/org.eclipse.jdt.ui/core extension/org/eclipse/jdt/internal/corext/template/Template.java;1;0;1;1;0;0;0;1;0;0;1;4258;0;0;1;0;0;1;1;4258;0;4258;1;1;
/org.eclipse.ui.workbench/Eclipse UI/org/eclipse/ui/WorkbenchPartConstants.java;2;1;2;1;2;2;2;0;0;0;0;5541;0;0;1;0;0;0;2;5541;0;5555;2;2;
/org.eclipse.jdt.launching.j9/j9/org/eclipse/jdt/internal/launching/j9/J9VMInstall.java;1;0;1;1;0;0;0;1;6;0;1;3569;6;6;1;0;0;1;1;3569;0;3569;1;1;
/org.eclipse.jdt.ui/ui refactoring/org/eclipse/jdt/internal/ui/refactoring/nls/search/NLSSorter.java;1;0;1;1;0;0;0;1;0;0;1;4943;0;0;1;0;0;1;1;4943;0;4943;1;1;
/org.eclipse.update.core/src/org/eclipse/update/internal/core/ErrorRecoveryLog.java;3;0;12;1;2;1;2;10;149;1;10;890;232;232;2;0;1;10;12;5664;1;5664;11;3;
/org.eclipse.jface/src/org/eclipse/jface/viewers/CellEditor.java;3;2;3;2;3;2;3;0;24;0;0;5339;28;28;2;0;1;0;3;6338;1;6338;2;3;
/org.eclipse.ui.workbench/Eclipse UI/org/eclipse/ui/internal/commands/CommandServiceEvent.java;1;0;4;1;0;0;0;4;10;2;3;2562;14;14;2;1;0;4;4;2562;1;4144;3;1;
/org.eclipse.jdt.core.tests.model/workspace/Converter/src/test0188/Test.java;1;0;1;1;0;0;0;1;0;0;1;3714;0;0;1;0;0;1;1;3714;0;3714;1;1;
/org.eclipse.ui.views/extensions/org/eclipse/ui/actions/AddTaskAction.java;2;0;4;1;0;0;0;4;6;2;3;520;8;8;2;1;0;4;4;749;1;2738;3;2;
/org.eclipse.ui.views/src/org/eclipse/ui/views/internal/markers/ActionRevealMarker.java;1;0;2;1;0;0;0;2;0;0;1;749;0;0;2;1;0;2;2;749;1;749;1;1;
/org.eclipse.jface.text/src/org/eclipse/jface/text/source/JFaceTextMessages.java;1;1;3;1;2;2;2;1;17;0;1;1702;21;21;1;0;0;1;3;1702;0;6340;3;1;
/org.eclipse.ui.workbench/Eclipse UI/org/eclipse/ui/internal/themes/RGBContrastFactory.java;1;0;1;1;1;1;1;0;0;0;0;5919;0;0;1;0;0;0;1;5919;0;5919;1;1;
/org.eclipse.jdt.ui/ui/org/eclipse/jdt/ui/IContextMenuConstants.java;1;0;1;1;1;1;1;0;2;0;0;6340;2;2;1;0;0;0;1;6340;0;6340;1;1;
/org.eclipse.jdt.debug.ui/ui/org/eclipse/jdt/internal/debug/ui/actions/StepIntoSelectionHandler.java;4;0;6;1;1;1;1;5;234;1;5;174;258;258;1;0;0;5;6;174;0;6336;6;4;
/org.eclipse.jdt.ui/ui/org/eclipse/jdt/internal/ui/preferences/AnnotationsConfigurationBlock.java;1;2;3;1;3;2;3;0;19;0;0;5481;19;19;2;0;1;0;3;5481;1;5501;2;1;
/org.eclipse.jface.text/src/org/eclipse/jface/text/contentassist/IContextInformationPresenter.java;1;2;3;1;3;2;3;0;12;0;0;6340;14;14;2;0;1;0;3;6353;1;6353;2;1;
/org.eclipse.team.ftp/src/org/eclipse/team/internal/ftp/ui/FTPConfigurationWizard.java;2;1;5;1;2;2;2;3;17;1;3;917;34;34;1;0;0;3;5;917;0;6337;5;2;
/org.eclipse.team.cvs.ui/src/org/eclipse/team/internal/ccvs/ui/PasswordManagementPreferencePage.java;2;1;5;1;3;3;3;2;204;1;2;5071;216;216;1;0;0;2;5;5071;0;6337;5;2;
/org.eclipse.pde.ui/src/org/eclipse/pde/internal/ui/editor/feature/ReferenceWizardPage.java;3;1;6;1;3;3;3;3;27;1;3;2229;54;54;1;0;0;3;6;2229;0;6336;6;3;
/org.eclipse.ui.ide/src/org/eclipse/ui/wizards/datatransfer/FileSystemStructureProvider.java;1;0;1;1;0;0;0;1;0;0;1;1511;0;0;1;0;0;1;1;1511;0;1511;1;1;
/org.eclipse.ui.workbench/Eclipse UI/org/eclipse/ui/actions/OpenFileAction.java;1;0;1;1;0;0;0;1;0;0;1;2737;0;0;1;0;0;1;1;2737;0;2737;1;1;
/org.eclipse.ui.workbench/Eclipse UI/org/eclipse/ui/internal/commands/XCaptureListener.java;1;0;2;1;0;0;0;2;0;1;2;1695;0;0;1;0;0;2;2;1695;0;1721;2;1;
/org.eclipse.jdt.ui.tests.refactoring/resources/ExtractMethodWorkSpace/ExtractMethodTests/expression_in/A_test605.java;1;0;1;1;0;0;0;1;2;0;1;844;2;2;1;0;0;1;1;844;0;844;1;1;
/org.eclipse.jdt.debug.tests/tests/org/eclipse/jdt/debug/tests/eval/TestsNestedTypes1.java;1;0;1;1;0;0;0;1;50;0;1;1274;50;50;1;0;0;1;1;1274;0;1274;1;1;
/org.eclipse.jdt.ui.tests.refactoring/test cases/org/eclipse/jdt/ui/tests/refactoring/AllChangeTests.java;1;0;1;1;1;1;1;0;2;0;0;6340;2;2;1;0;0;0;1;6340;0;6340;1;1;
/org.eclipse.ui.forms/src/org/eclipse/ui/forms/internal/widgets/Paragraph.java;1;0;5;1;0;0;0;5;31;1;5;4068;64;64;1;0;0;5;5;4068;0;5044;5;1;
/org.eclipse.core.runtime.compatibility/src-runtime/org/eclipse/core/internal/compatibility/PluginActivator.java;4;1;11;2;3;3;3;8;94;1;8;3135;137;137;1;0;0;8;11;3135;0;5916;11;4;
/org.eclipse.jdt.ui/ui/org/eclipse/jdt/internal/ui/text/JavaCompositeReconcilingStrategy.java;2;1;7;1;2;2;2;5;10;1;5;3930;32;32;1;0;0;5;7;3930;0;6340;7;2;
/org.eclipse.jdt.ui/core refactoring/org/eclipse/ltk/core/refactoring/participants/SharableParticipants.java;1;0;3;1;0;0;0;3;5;1;3;4624;5;5;1;0;0;3;3;4624;0;4864;3;1;
/org.eclipse.debug.ui/ui/org/eclipse/debug/internal/ui/sourcelookup/browsers/ExternalArchiveSourceContainerBrowser.java;1;0;4;1;0;0;0;4;6;1;4;4652;16;16;1;0;0;4;4;4652;0;4970;4;1;
/org.eclipse.jdt.ui/ui/org/eclipse/jdt/internal/ui/viewsupport/SelectionListenerWithASTManager.java;2;1;17;2;4;4;4;13;176;2;10;2886;433;433;2;3;0;13;17;2886;3;6340;14;2;
/org.eclipse.pde.ui/src_OSGi/org/eclipse/pde/internal/ui/osgi/wizards/PluginToBundleAction.java;2;0;5;1;0;0;0;5;169;1;5;2244;217;217;1;0;0;5;5;2244;0;3839;5;2;
/org.eclipse.jdt.launching/launching/org/eclipse/jdt/internal/launching/PackageFragmentRootSourceContainerTypeDelegate.java;1;0;5;1;0;0;0;5;38;2;4;4109;56;56;2;1;0;5;5;4949;1;4971;4;1;
/org.eclipse.ui.workbench/Eclipse UI/org/eclipse/ui/internal/presentations/SystemMenuFastViewOrientation.java;1;0;2;1;1;1;1;1;2;0;1;4857;2;2;1;0;0;1;2;4857;0;5173;2;1;
/org.eclipse.swt.tests/JUnit Tests/org/eclipse/swt/tests/junit/Test_org_eclipse_swt_graphics_RGB.java;1;0;1;1;0;0;0;1;3;0;1;2175;3;3;1;0;0;1;1;2175;0;2175;1;1;
/org.eclipse.swt/Eclipse SWT Mozilla/common/org/eclipse/swt/internal/mozilla/nsIURI.java;1;0;2;1;0;0;0;2;54;1;2;1654;54;54;1;0;0;2;2;1654;0;2568;2;1;
/org.eclipse.jdt.ui/ui/org/eclipse/jdt/internal/ui/filters/NonJavaElementFilter.java;1;0;1;1;1;1;1;0;2;0;0;6340;2;2;1;0;0;0;1;6340;0;6340;1;1;
/org.eclipse.team.tests.cvs.core/src/org/eclipse/team/tests/ccvs/ui/old/SyncTests.java;1;0;2;1;0;0;0;2;0;1;2;2632;0;0;1;0;0;2;2;2632;0;4216;2;1;
/org.eclipse.pde.core/src_OSGi/org/eclipse/pde/core/osgi/bundle/IBundlePluginModel.java;2;0;2;1;0;0;0;2;0;1;2;2485;0;0;1;0;0;2;2;2485;0;4203;2;2;
/org.eclipse.jdt.core.tests.compiler/src/org/eclipse/jdt/core/tests/runtime/RuntimeConstants.java;1;0;1;1;0;0;0;1;2;0;1;3560;2;2;1;0;0;1;1;3560;0;3560;1;1;
/org.eclipse.core.tests.resources/src/org/eclipse/core/tests/resources/usecase/IFolderTest.java;1;0;2;1;2;1;2;0;486;0;0;5147;486;486;2;0;1;0;2;5147;1;5147;1;1;
/org.eclipse.ant.ui/Ant Editor/org/eclipse/ant/ui/internal/editor/outline/DocumentModelChangeEvent.java;1;0;2;1;0;0;0;2;0;1;2;250;0;0;1;0;0;2;2;250;0;1811;2;1;
/org.eclipse.jdt.ui.tests.refactoring/resources/MoveMembers/test22/out/B.java;1;0;2;1;0;0;0;2;2;1;2;1522;3;3;1;0;0;2;2;1522;0;1856;2;1;
/org.eclipse.jdt.ui/core extension/org/eclipse/text/edits/PerformEditException.java;1;0;2;1;0;0;0;2;0;1;2;1953;0;0;1;0;0;2;2;1953;0;1972;2;1;
/org.eclipse.webdav/src/kernel/org/eclipse/webdav/internal/kernel/LockToken.java;1;0;1;1;1;1;1;0;32;0;0;5151;32;32;1;0;0;0;1;5151;0;5151;1;1;
/org.eclipse.ui.workbench/Eclipse UI/org/eclipse/ui/internal/commands/AbstractContextService.java;1;0;2;1;0;0;0;2;0;1;2;956;0;0;1;0;0;2;2;956;0;1119;2;1;
/org.eclipse.jdt.debug.ui/ui/org/eclipse/jdt/internal/debug/ui/launcher/VMContentProvider.java;1;0;1;1;0;0;0;1;0;0;1;1036;0;0;1;0;0;1;1;1036;0;1036;1;1;
/org.eclipse.jdt.core/compiler/org/eclipse/jdt/internal/compiler/problem/AbortType.java;2;0;2;1;1;1;1;1;5;0;1;3560;7;7;1;0;0;1;2;3560;0;5615;2;2;
/org.eclipse.ui.tutorials.rcp.part3/src/org/eclipse/ui/tutorials/rcp/part3/actions/AboutAction.java;1;0;1;1;1;1;1;0;0;0;0;5118;0;0;1;0;0;0;1;5118;0;5118;1;1;
/org.eclipse.search/search/org/eclipse/search/internal/ui/SearchManager.java;2;0;6;1;1;1;1;5;102;1;5;1346;138;138;1;0;0;5;6;1346;0;6340;6;2;
/org.eclipse.jdt.ui.tests.refactoring/resources/ChangeSignature/canModify/A_testAll55_in.java;1;0;1;1;0;0;0;1;2;0;1;170;2;2;1;0;0;1;1;170;0;170;1;1;
/org.eclipse.pde.ui/src/org/eclipse/pde/internal/ui/editor/manifest/ManifestSourceOutlinePageLabelProvider.java;1;0;4;1;1;1;1;3;112;1;3;2320;126;126;1;0;0;3;4;2320;0;5431;4;1;
/org.eclipse.core.resources/src/org/eclipse/core/internal/dtree/DataTreeNode.java;1;0;2;1;2;1;2;0;612;0;0;5146;612;612;2;0;1;0;2;5146;1;5146;1;1;
/org.eclipse.jdt.core.tests.model/workspace/Formatter/test192/A_in.java;1;0;1;1;0;0;0;1;0;0;1;2425;0;0;1;0;0;1;1;2425;0;2425;1;1;
/org.eclipse.pde.ui/templates/editor/java/XMLConfiguration.java;1;0;1;1;0;0;0;1;10;0;1;851;10;10;1;0;0;1;1;851;0;851;1;1;
/org.eclipse.update.core/src/org/eclipse/update/internal/core/SessionDelta.java;3;1;10;1;2;2;2;8;13;2;7;890;37;37;2;1;0;8;10;4331;1;5518;9;3;
/org.eclipse.core.runtime/src/org/eclipse/core/runtime/OperationCanceledException.java;2;0;5;1;1;1;1;4;60;1;4;3013;127;127;1;0;0;4;5;3013;0;5117;5;2;
/org.eclipse.jdt.core.tests.model/workspace/Formatter/test402/A_out.java;1;0;1;1;0;0;0;1;0;0;1;3436;0;0;1;0;0;1;1;3436;0;3436;1;1;
/org.eclipse.ui.workbench/Eclipse UI/org/eclipse/ui/internal/presentations/SystemMenuMaximize.java;3;0;3;1;1;1;1;2;44;1;2;4680;46;46;1;0;0;2;3;4680;0;5173;3;3;
/org.eclipse.debug.ui/ui/org/eclipse/debug/internal/ui/views/console/ProcessConsolePage.java;3;1;14;2;5;5;5;9;37;2;7;1415;217;217;2;2;0;9;14;1415;2;6336;12;3;
/org.eclipse.core.runtime.osgi/src/org/eclipse/core/internal/runtime/PlatformActivator.java;1;0;2;1;0;0;0;2;64;1;2;3013;64;64;1;0;0;2;2;3013;0;3030;2;1;
/org.eclipse.pde.ui/src/org/eclipse/pde/internal/ui/editor/feature/ReferenceForm.java;1;0;3;1;1;1;1;2;2;1;2;368;4;4;1;0;0;2;3;368;0;5431;3;1;
/org.eclipse.team.cvs.ui/src/org/eclipse/team/internal/ccvs/ui/wizards/KSubstWizardDirtyFilesPage.java;1;0;1;1;0;0;0;1;2;0;1;2381;2;2;1;0;0;1;1;2381;0;2381;1;1;
/org.eclipse.osgi/defaultAdaptor/src/org/eclipse/osgi/framework/internal/reliablefile/ReliableFileOutputStream.java;5;1;7;1;4;4;4;3;220;1;3;3013;282;282;1;0;0;3;7;3013;0;5856;7;5;
/org.eclipse.jdt.core.tests.model/workspace/Converter/src/test0413/A.java;1;0;1;1;0;0;0;1;0;0;1;3714;0;0;1;0;0;1;1;3714;0;3714;1;1;
/org.eclipse.ui.views/src/org/eclipse/ui/views/internal/markers/tasks/Messages.java;1;0;3;1;0;0;0;3;41;1;3;265;41;41;1;0;0;3;3;265;0;749;3;1;
/org.eclipse.jdt.core.tests.model/workspace/Converter/src/test0348/Test2.java;1;0;1;1;0;0;0;1;0;0;1;3714;0;0;1;0;0;1;1;3714;0;3714;1;1;
/org.eclipse.jdt.launching/launching/org/eclipse/jdt/internal/launching/StandardVM.java;2;0;2;1;1;1;1;1;4;0;1;3812;8;8;1;0;0;1;2;3812;0;6336;2;2;
/org.eclipse.pde.ui/src/org/eclipse/pde/internal/ui/editor/site/BuildControlSection.java;1;0;3;1;0;0;0;3;14;1;3;368;25;25;1;0;0;3;3;368;0;2311;3;1;
/org.eclipse.jdt.core.tests.model/workspace/Formatter/test424/A_in.java;1;0;1;1;0;0;0;1;0;0;1;3478;0;0;1;0;0;1;1;3478;0;3478;1;1;
/org.eclipse.ui.workbench/Eclipse UI/org/eclipse/ui/dialogs/WizardExportResourcesPage.java;1;0;1;1;0;0;0;1;0;0;1;2737;0;0;1;0;0;1;1;2737;0;2737;1;1;
/org.eclipse.ui.cheatsheets/src/org/eclipse/ui/internal/cheatsheets/data/RepeatedSubItem.java;1;1;3;1;3;3;3;0;4;0;0;5189;5;5;1;0;0;0;3;5189;0;5620;3;1;
/org.eclipse.jdt.core.tests.model/workspace/Converter/src/javadoc/test010/Test.java;1;0;1;1;0;0;0;1;0;0;1;3813;0;0;1;0;0;1;1;3813;0;3813;1;1;
/org.eclipse.ui.workbench/Eclipse UI/org/eclipse/ui/internal/roles/AbstractRoleRegistry.java;1;0;5;1;0;0;0;5;47;1;5;2444;55;55;1;0;0;5;5;2444;0;2864;5;1;
/org.eclipse.ui.workbench/Eclipse UI/org/eclipse/ui/commands/IKeyConfigurationEvent.java;1;0;4;1;0;0;0;4;41;2;3;1435;41;41;2;1;0;4;4;2562;1;2824;3;1;
/org.eclipse.core.resources/src/org/eclipse/core/internal/indexing/ObjectStorePage.java;1;0;1;1;1;1;1;0;13;0;0;5146;13;13;1;0;0;0;1;5146;0;5146;1;1;
/org.eclipse.jface.text/src/org/eclipse/jface/text/contentassist/ContentAssistSubjectControlAdapter.java;1;2;4;1;4;3;4;0;48;0;0;5199;50;50;2;0;1;0;4;6353;1;6353;3;1;
/org.eclipse.swt/Eclipse SWT/photon/org/eclipse/swt/widgets/Shell.java;5;1;11;1;3;3;3;8;86;2;7;269;192;192;2;1;0;8;11;3474;1;6352;10;5;
/org.eclipse.jdt.ui.tests/ui/org/eclipse/jdt/ui/tests/wizardapi/NewJavaProjectWizardTest.java;1;0;1;1;1;1;1;0;2;0;0;6340;2;2;1;0;0;0;1;6340;0;6340;1;1;
/org.eclipse.jdt.ui/core refactoring/org/eclipse/jdt/internal/corext/refactoring/Checks.java;4;2;17;1;6;5;6;11;38;1;11;133;188;188;2;0;1;11;17;6034;1;6340;16;4;
/org.eclipse.jdt.core.tests.model/workspace/Converter/test0505/A.java;1;0;2;1;0;0;0;2;0;1;2;3006;0;0;1;0;0;2;2;3006;0;3714;2;1;
/org.eclipse.update.ui.forms/src/org/eclipse/ui/forms/HyperlinkGroup.java;1;0;5;1;0;0;0;5;30;2;3;3051;47;47;2;2;0;5;5;3051;2;3095;3;1;
/org.eclipse.pde.ui/templates/view/java/$className$.java;1;0;5;1;0;0;0;5;18;1;5;851;26;26;1;0;0;5;5;851;0;4072;5;1;
/org.eclipse.pde.ui/src_OSGi/org/eclipse/pde/internal/ui/osgi/templates/DefaultBundleTemplateWizard.java;2;0;2;1;0;0;0;2;0;1;2;2501;0;0;1;0;0;2;2;2501;0;3986;2;2;
/org.eclipse.update.core/src/org/eclipse/update/internal/api/search/IUpdateSearchResultCollector.java;1;0;2;1;0;0;0;2;0;1;2;3270;0;0;1;0;0;2;2;3270;0;4928;2;1;
/org.eclipse.jdt.ui.tests.refactoring/resources/ExtractMethodWorkSpace/ExtractMethodTests/expression_out/A_test613.java;1;0;4;1;0;0;0;4;4;1;4;130;5;5;1;0;0;4;4;130;0;1474;4;1;
/org.eclipse.ui.ide/src/org/eclipse/ui/internal/AboutItem.java;2;0;2;1;0;0;0;2;0;1;2;1775;0;0;1;0;0;2;2;1775;0;2263;2;2;
/org.eclipse.ui.workbench/Eclipse UI/org/eclipse/ui/internal/activities/service/ActivityService.java;1;0;2;1;0;0;0;2;0;1;2;2444;0;0;1;0;0;2;2;2444;0;2491;2;1;
/org.eclipse.core.runtime/src/org/eclipse/core/internal/dependencies/IElementSetVisitor.java;2;0;2;1;0;0;0;2;0;1;2;2105;0;0;1;0;0;2;2;2105;0;3013;2;2;
/org.eclipse.core.resources/src/org/eclipse/core/internal/resources/LinkDescription.java;1;0;1;1;1;1;1;0;105;0;0;5146;105;105;1;0;0;0;1;5146;0;5146;1;1;
/org.eclipse.update.ui/srcnew/org/eclipse/update/internal/ui/wizards/UnifiedBannerPage.java;2;0;5;1;0;0;0;5;12;1;5;488;24;24;1;0;0;5;5;488;0;825;5;2;
/org.eclipse.tomcat/src/org/eclipse/tomcat/internal/TomcatPlugin.java;2;1;8;1;3;3;3;5;54;1;5;347;157;157;1;0;0;5;8;347;0;6337;8;2;
/org.eclipse.pde.core/src/org/eclipse/pde/internal/core/build/BuildModel.java;2;0;4;1;1;1;1;3;112;1;3;2936;134;134;1;0;0;3;4;2936;0;6336;4;2;
/org.eclipse.team.cvs.ui/src/org/eclipse/team/internal/ccvs/ui/RemoteAnnotationStorage.java;2;1;3;1;2;2;2;1;58;0;1;784;60;60;1;0;0;1;3;784;0;6337;3;2;
/org.eclipse.jdt.core.tests.model/workspace/Converter/src/test0114/Test.java;1;0;1;1;0;0;0;1;0;0;1;3714;0;0;1;0;0;1;1;3714;0;3714;1;1;
/org.eclipse.jdt.debug.ui/ui/org/eclipse/jdt/internal/debug/ui/launcher/RuntimeClasspathEntryLabelProvider.java;4;0;13;1;1;1;1;12;276;2;11;2177;387;387;2;1;0;12;13;4973;1;6336;12;4;
/org.eclipse.core.tests.runtime/src/org/eclipse/core/tests/runtime/locks/TestJob.java;1;0;2;1;0;0;0;2;0;1;2;698;0;0;1;0;0;2;2;698;0;850;2;1;
/org.eclipse.jdt.core.tests.model/workspace/Converter/src/javadoc/testBug51660/Test.java;1;2;3;1;3;2;3;0;25;0;0;5869;48;48;2;0;1;0;3;5869;1;5894;2;1;
/org.eclipse.jface.text/src/org/eclipse/jface/text/IRewriteTarget.java;2;1;2;1;2;2;2;0;23;0;0;6340;25;25;1;0;0;0;2;6340;0;6359;2;2;
/org.eclipse.team.ui/src/org/eclipse/team/internal/ui/actions/JobRunnableContext.java;2;1;9;2;2;2;2;7;132;2;6;4071;333;333;2;1;0;7;9;4449;1;6337;8;2;
/org.eclipse.pde.ui/src/org/eclipse/pde/internal/ui/editor/GenericSourcePage.java;2;1;2;1;2;2;2;0;19;0;0;5431;19;19;1;0;0;0;2;5431;0;5780;2;2;
/org.eclipse.help.webapp/src_servlets/org/eclipse/help/internal/webapp/servlet/LiveHelpServlet.java;1;1;6;1;4;4;4;2;32;1;2;2732;68;68;1;0;0;2;6;2732;0;6337;6;1;
/org.eclipse.jdt.ui/ui refactoring/org/eclipse/jdt/internal/ui/refactoring/PromoteTempWizard.java;4;1;8;1;3;3;3;5;199;1;5;518;231;231;1;0;0;5;8;518;0;6340;8;4;
/org.eclipse.jdt.core.tests.model/workspace/Converter/src/test0512/A.java;1;0;1;1;0;0;0;1;0;0;1;3714;0;0;1;0;0;1;1;3714;0;3714;1;1;
/org.eclipse.jdt.core.tests.model/workspace/Formatter/test114/A_out.java;1;0;1;1;0;0;0;1;0;0;1;2425;0;0;1;0;0;1;1;2425;0;2425;1;1;
/org.eclipse.team.tests.cvs.core/src/org/eclipse/team/tests/ccvs/ui/PerformanceTimer.java;1;0;1;1;0;0;0;1;0;0;1;2632;0;0;1;0;0;1;1;2632;0;2632;1;1;
/org.eclipse.team.cvs.ui/src/org/eclipse/team/internal/ccvs/ui/subscriber/ChangeLogContentProvider.java;1;0;1;1;0;0;0;1;0;0;1;3530;0;0;1;0;0;1;1;3530;0;3530;1;1;
/org.eclipse.jdt.ui/ui/org/eclipse/jdt/internal/ui/search/ISearchParticipant.java;1;0;1;1;0;0;0;1;0;0;1;3488;0;0;1;0;0;1;1;3488;0;3488;1;1;
/org.eclipse.jdt.core/batch/org/eclipse/jdt/internal/compiler/batch/FileFinder.java;2;0;2;1;0;0;0;2;14;1;2;1785;16;16;1;0;0;2;2;1785;0;3560;2;2;
/org.eclipse.swt/Eclipse SWT/common/org/eclipse/swt/widgets/Item.java;2;1;2;1;2;2;2;0;4;0;0;5208;5;5;1;0;0;0;2;5208;0;6352;2;2;
/org.eclipse.jdt.ui.tests.refactoring/resources/InlineMethodWorkspace/TestCases/argument_in/TestParameterNameUnused2.java;1;0;1;1;0;0;0;1;2;0;1;845;2;2;1;0;0;1;1;845;0;845;1;1;
/org.eclipse.ui.workbench/Eclipse UI/org/eclipse/ui/dialogs/WizardExportPage.java;1;0;1;1;0;0;0;1;0;0;1;2737;0;0;1;0;0;1;1;2737;0;2737;1;1;
/org.eclipse.debug.ui/ui/org/eclipse/debug/internal/ui/launchConfigurations/WorkingSetComparator.java;1;0;2;1;0;0;0;2;40;1;2;2088;40;40;1;0;0;2;2;2088;0;2731;2;1;
/org.eclipse.debug.ui/ui/org/eclipse/debug/internal/ui/sourcelookup/EditSourceLookupPathAction.java;1;0;6;1;1;1;1;5;105;2;3;3770;116;116;2;2;0;5;6;4627;2;5183;4;1;
/org.eclipse.team.examples.filesystem/src/org/eclipse/team/examples/filesystem/ui/ConfigurationWizard.java;1;0;1;1;0;0;0;1;8;0;1;1708;8;8;1;0;0;1;1;1708;0;1708;1;1;
/org.eclipse.ui.views/src/org/eclipse/ui/views/tasklist/CopyTaskAction.java;1;0;1;1;0;0;0;1;0;0;1;2738;0;0;1;0;0;1;1;2738;0;2738;1;1;
/org.eclipse.swt/Eclipse SWT/carbon/org/eclipse/swt/graphics/FontMetrics.java;2;0;2;1;1;1;1;1;10;0;1;4534;14;14;1;0;0;1;2;4534;0;6352;2;2;
/org.eclipse.releng.basebuilder/plugins/org.eclipse.build.tools/org.eclipse.build.tools/src/org/eclipse/releng/generators/FileCounter.java;1;0;1;1;1;1;1;0;0;0;0;5735;0;0;1;0;0;0;1;5735;0;5735;1;1;
/org.eclipse.core.tests.runtime/src/org/eclipse/core/tests/internal/plugins/SoftPrereqTest_10.java;1;0;1;1;0;0;0;1;0;0;1;3014;0;0;1;0;0;1;1;3014;0;3014;1;1;
/org.eclipse.debug.ui/ui/org/eclipse/debug/internal/ui/actions/AssignValueAction.java;2;0;2;1;0;0;0;2;3;1;2;4333;3;3;1;0;0;2;2;4333;0;4435;2;2;
/org.eclipse.jdt.core.tests.model/workspace/Formatter/test119/A_out.java;1;0;2;1;0;0;0;2;3;1;2;2425;3;3;1;0;0;2;2;2425;0;3513;2;1;
/org.eclipse.jdt.ui.tests.refactoring/resources/IntroduceParameter/invalid/NoExpression1.java;1;0;1;1;1;1;1;0;0;0;0;5916;0;0;1;0;0;0;1;5916;0;5916;1;1;
/org.eclipse.ui.externaltools/External Tools Base/org/eclipse/ui/externaltools/internal/launchConfigurations/ExternalToolsMainTab.java;3;1;34;2;3;3;3;31;240;3;26;33;948;948;3;5;0;31;34;321;5;5694;29;3;
/org.eclipse.jdt.debug/model/org/eclipse/jdt/debug/core/IJavaDebugTarget.java;4;0;6;1;1;1;1;5;23;1;5;363;62;62;1;0;0;5;6;363;0;6336;6;4;
/org.eclipse.jdt.ui/ui/org/eclipse/jdt/internal/ui/text/correction/TaskMarkerProposal.java;3;0;11;1;1;1;1;10;61;2;9;1368;180;180;2;1;0;10;11;1953;1;6340;10;3;
/org.eclipse.jdt.debug.ui/ui/org/eclipse/jdt/internal/debug/ui/JDISourceViewer.java;4;1;5;1;3;3;3;2;249;1;2;1240;270;270;1;0;0;2;5;1240;0;6336;5;4;
/org.eclipse.jdt.core/model/org/eclipse/jdt/core/IJavaProject.java;4;0;23;1;1;1;1;22;183;5;15;191;553;553;5;7;0;22;23;1821;7;5503;16;4;
/org.eclipse.core.variables/src/org/eclipse/core/variables/IStringVariableManager.java;4;0;5;1;1;1;1;4;9;1;4;2514;25;25;1;0;0;4;5;2514;0;6336;5;4;
/org.eclipse.jdt.core/dom/org/eclipse/jdt/core/dom/PrimitiveType.java;3;0;6;1;1;1;1;5;64;1;5;3560;76;76;1;0;0;5;6;3560;0;5272;6;3;
/org.eclipse.jdt.ui/core extension/org/eclipse/jdt/internal/corext/textmanipulation/GroupDescription.java;2;0;6;1;0;0;0;6;25;1;6;1062;40;40;1;0;0;6;6;1062;0;3545;6;2;
/org.eclipse.ui.workbench/Eclipse UI/org/eclipse/ui/commands/IGestureConfigurationHandle.java;1;0;2;1;0;0;0;2;0;1;2;1321;0;0;1;0;0;2;2;1321;0;1340;2;1;
/org.eclipse.ui.workbench/Eclipse UI/org/eclipse/ui/application/WorkbenchAdviser.java;3;0;6;1;0;0;0;6;502;2;5;1259;580;580;2;1;0;6;6;2878;1;2901;5;3;
/org.eclipse.update.core/src/org/eclipse/update/core/model/URLEntryModel.java;2;1;5;1;4;4;4;1;7;0;1;890;23;23;1;0;0;1;5;890;0;6336;5;2;
/org.eclipse.text/src/org/eclipse/text/edits/TextEditMessages.java;2;0;2;1;1;1;1;1;2;0;1;1986;2;2;1;0;0;1;2;1986;0;6340;2;2;
/org.eclipse.search/search/org/eclipse/search/internal/ui/text/ResourcenameSorter.java;2;0;2;1;1;1;1;1;3;0;1;3711;5;5;1;0;0;1;2;3711;0;6340;2;2;
/org.eclipse.swt/Eclipse SWT Custom Widgets/common/org/eclipse/swt/custom/CTabFolderListListener.java;1;0;3;1;0;0;0;3;23;1;3;2641;23;23;1;0;0;3;3;2641;0;4232;3;1;
/org.eclipse.swt.graphics.text/Eclipse SWT Custom Widgets/common/org/eclipse/swt/custom/PrintRenderer.java;1;0;3;1;0;0;0;3;8;1;3;3889;10;10;1;0;0;3;3;3889;0;3940;3;1;
/org.eclipse.swt/Eclipse SWT PI/win32/org/eclipse/swt/internal/win32/SCRIPT_ANALYSIS.java;2;0;2;1;1;1;1;1;4;0;1;4563;4;4;1;0;0;1;2;4563;0;6352;2;2;
/org.eclipse.ant.ui/Ant Tools Support/org/eclipse/ant/internal/ui/preferences/AbstractAntEditorPreferencePage.java;1;1;3;1;3;3;3;0;24;0;0;5705;27;27;1;0;0;0;3;5705;0;5739;3;1;
/org.eclipse.jdt.ui/core refactoring/org/eclipse/jdt/internal/corext/refactoring/reorg/INewNameQueries.java;2;0;3;1;1;1;1;2;8;1;2;808;10;10;1;0;0;2;3;808;0;6340;3;2;
/org.eclipse.help.webapp/src_servlets/org/eclipse/help/internal/webapp/servlet/FramesetFilter.java;1;1;4;1;3;3;3;1;23;0;1;2732;49;49;1;0;0;1;4;2732;0;6337;4;1;
/org.eclipse.ui.workbench/Eclipse UI/org/eclipse/ui/internal/dialogs/InstallCapabilityStep.java;1;0;1;1;0;0;0;1;0;0;1;2737;0;0;1;0;0;1;1;2737;0;2737;1;1;
/org.eclipse.jdt.core.tests.model/workspace/Converter/src/test0054/Test.java;1;0;1;1;0;0;0;1;0;0;1;3714;0;0;1;0;0;1;1;3714;0;3714;1;1;
/org.eclipse.ant.ui/Ant Editor/org/eclipse/ant/ui/internal/editor/text/TagRule.java;1;0;2;1;0;0;0;2;0;1;2;250;0;0;1;0;0;2;2;250;0;1811;2;1;
/org.eclipse.jdt.ui/core refactoring/org/eclipse/jdt/internal/corext/refactoring/changes/AbstractDeleteChange.java;3;0;6;1;1;1;1;5;37;2;4;596;69;69;2;1;0;5;6;596;1;6340;5;3;
/org.eclipse.help.ui.win32/src/org/eclipse/help/ui/internal/browser/win32/HelpControlSite.java;1;0;1;1;0;0;0;1;0;0;1;1710;0;0;1;0;0;1;1;1710;0;1710;1;1;
/org.eclipse.text/src/org/eclipse/jface/text/DefaultPositionUpdater.java;1;0;2;1;1;1;1;1;21;0;1;4516;28;28;1;0;0;1;2;4516;0;6298;2;1;
/org.eclipse.ui.ide/src/org/eclipse/ui/ICapabilityInstallWizard.java;2;0;2;1;0;0;0;2;0;1;2;1511;0;0;1;0;0;2;2;1511;0;2263;2;2;
/org.eclipse.ui.workbench/Eclipse UI/org/eclipse/ui/contexts/IContextDefinition.java;1;0;4;1;0;0;0;4;2;2;3;1388;2;2;2;1;0;4;4;1417;1;1417;3;1;
/org.eclipse.update.core/src/org/eclipse/update/internal/operations/FeatureStatus.java;1;0;1;1;0;0;0;1;0;0;1;4219;0;0;1;0;0;1;1;4219;0;4219;1;1;
/org.eclipse.debug.ui/ui/org/eclipse/debug/internal/ui/actions/ToggleWatchpointObjectActionDelegate.java;1;0;2;1;0;0;0;2;1;0;1;4492;1;1;2;1;0;2;2;4492;1;4492;1;1;
/org.eclipse.jdt.ui/core refactoring/org/eclipse/jdt/internal/corext/refactoring/rename/RenameTempRefactoring.java;5;1;25;1;4;4;4;21;115;3;19;122;247;247;3;2;0;21;25;1952;2;6340;23;5;
/org.eclipse.core.tests.runtime/src/org/eclipse/core/tests/internal/preferences/EclipsePreferencesTest.java;1;1;19;1;10;10;10;9;98;2;8;4351;545;545;2;1;0;9;19;4443;1;5923;18;1;
/org.eclipse.jface/src/org/eclipse/jface/resource/FileImageDescriptor.java;3;1;5;1;3;3;3;2;15;1;2;3700;48;48;1;0;0;2;5;3700;0;6338;5;3;
/org.eclipse.jdt.ui.tests.refactoring/resources/ExtractMethodWorkSpace/ExtractMethodTests/return_in/A_test719.java;1;0;1;1;0;0;0;1;4;0;1;844;4;4;1;0;0;1;1;844;0;844;1;1;
/org.eclipse.jdt.core.tests.model/workspace/Converter/src/test0557/A.java;1;0;1;1;1;1;1;0;0;0;0;5731;0;0;1;0;0;0;1;5731;0;5731;1;1;
/org.eclipse.jdt.core.tests.model/workspace/Formatter/test478/A_in.java;1;0;1;1;0;0;0;1;0;0;1;4173;0;0;1;0;0;1;1;4173;0;4173;1;1;
/org.eclipse.jdt.junit/src/org/eclipse/jdt/internal/junit/ui/RerunAction.java;2;0;2;1;1;1;1;1;13;0;1;4807;15;15;1;0;0;1;2;4807;0;6340;2;2;
/org.eclipse.ui.workbench/Eclipse UI/org/eclipse/ui/internal/dnd/TestDropLocation.java;1;0;1;1;0;0;0;1;0;0;1;4979;0;0;1;0;0;1;1;4979;0;4979;1;1;
/org.eclipse.ui.workbench/Eclipse UI/org/eclipse/ui/internal/presentation/CascadingGradientRegistry.java;1;0;3;1;0;0;0;3;2;1;3;4263;2;2;1;0;0;3;3;4263;0;4392;3;1;
/org.eclipse.ant.ui/Ant Editor/org/eclipse/ant/internal/ui/editor/AntEditorSaxDefaultHandler.java;1;0;7;1;0;0;0;7;275;2;6;1811;338;338;2;1;0;7;7;2460;1;3690;6;1;
/org.eclipse.osgi/console/src/org/eclipse/osgi/framework/internal/core/FrameworkCommandProvider.java;5;1;13;1;5;5;5;8;2787;2;7;3013;3676;3676;2;1;0;8;13;4311;1;6337;12;5;
/org.eclipse.search/search/org/eclipse/search/ui/ISearchResultViewEntry.java;2;1;3;1;3;3;3;0;5;0;0;6116;10;10;1;0;0;0;3;6116;0;6340;3;2;
/org.eclipse.pde.ui/src/org/eclipse/pde/internal/ui/editor/site/PropertySection.java;1;0;3;1;0;0;0;3;11;1;3;368;20;20;1;0;0;3;3;368;0;2311;3;1;
/org.eclipse.jdt.core.tests.model/workspace/Converter/src/test0506/A.java;1;0;1;1;0;0;0;1;0;0;1;3714;0;0;1;0;0;1;1;3714;0;3714;1;1;
/org.eclipse.core.runtime/src/org/eclipse/core/runtime/IProgressMonitorWithBlocking.java;3;1;7;1;2;2;2;5;96;1;5;2159;210;210;1;0;0;5;7;2159;0;5310;7;3;
/org.eclipse.ui.workbench/Eclipse UI/org/eclipse/ui/internal/csm/commands/IKeySequenceBindingDefinition.java;1;0;2;1;0;0;0;2;0;1;2;2532;0;0;1;0;0;2;2;2532;0;2562;2;1;
/org.eclipse.jdt.core.tests.compiler/src/org/eclipse/jdt/core/tests/compiler/regression/AnnotationTestMixed.java;2;0;7;1;0;0;0;7;344;2;6;2397;460;460;2;1;0;7;7;2580;1;2887;6;2;
/org.eclipse.jdt.debug.ui/ui/org/eclipse/jdt/internal/debug/ui/MethodActionFilter.java;1;0;1;1;0;0;0;1;4;0;1;2380;4;4;1;0;0;1;1;2380;0;2380;1;1;
/org.eclipse.pde.ui/src/org/eclipse/pde/internal/ui/editor/plugin/rows/ReferenceAttributeRow.java;2;1;5;1;5;5;5;0;10;0;0;5431;16;16;1;0;0;0;5;5431;0;6336;5;2;
/org.eclipse.ui.externaltools/Ant Editor/org/eclipse/ui/externaltools/internal/ant/editor/TaskDescriptionProvider.java;1;0;1;1;0;0;0;1;0;0;1;282;0;0;1;0;0;1;1;282;0;282;1;1;
/org.eclipse.jdt.ui/ui/org/eclipse/jdt/internal/ui/javaeditor/EditorHighlightingSynchronizer.java;2;1;3;1;3;3;3;0;8;0;0;5247;14;14;1;0;0;0;3;5247;0;6340;3;2;
/org.eclipse.jdt.ui.tests.refactoring/resources/IntroduceFactory/positive/Names_in.java;1;0;2;1;1;1;1;1;2;0;1;2862;2;2;1;0;0;1;2;2862;0;5659;2;1;
/org.eclipse.jdt.ui/ui/org/eclipse/jdt/internal/ui/JavaWorkbenchAdapter.java;2;0;2;1;1;1;1;1;6;0;1;450;8;8;1;0;0;1;2;450;0;6340;2;2;
/org.eclipse.jdt.core/dom/org/eclipse/jdt/core/dom/TryStatement.java;3;1;8;1;2;2;2;6;125;1;6;3560;166;166;1;0;0;6;8;3560;0;5272;8;3;
/org.eclipse.ui.tests/Eclipse UI Tests/org/eclipse/ui/tests/navigator/LightweightDecoratorTestCase.java;3;0;4;1;1;1;1;3;73;1;3;1216;94;94;1;0;0;3;4;1216;0;6338;4;3;
/org.eclipse.core.tests.runtime/src/org/eclipse/core/tests/internal/plugins/PluginResolveTest_12.java;1;0;1;1;0;0;0;1;0;0;1;3014;0;0;1;0;0;1;1;3014;0;3014;1;1;
/org.eclipse.pde.core/srcnew/org/eclipse/pde/internal/core/plugin/XEDocumentScanner.java;1;0;1;1;0;0;0;1;0;0;1;2906;0;0;1;0;0;1;1;2906;0;2906;1;1;
/org.eclipse.jdt.ui.tests.refactoring/resources/ExtractMethodWorkSpace/ExtractMethodTests/duplicates_in/A_test958.java;1;1;2;1;2;2;2;0;2;0;0;5650;2;2;1;0;0;0;2;5650;0;5681;2;1;
/org.eclipse.pde.junit.runtime/src/org/eclipse/pde/internal/junit/runtime/RemotePluginTestRunner.java;1;0;3;1;1;1;1;2;23;1;2;1453;33;33;1;0;0;2;3;1453;0;6039;3;1;
/org.eclipse.jdt.core.tests.model/workspace/Converter/src/test0335/ExceptionTestCaseTest.java;1;0;1;1;0;0;0;1;0;0;1;3714;0;0;1;0;0;1;1;3714;0;3714;1;1;
/org.eclipse.jdt.ui/core extension/org/eclipse/jdt/internal/corext/codemanipulation/SortMembersOperation.java;2;1;5;1;2;2;2;3;27;1;3;3708;66;66;1;0;0;3;5;3708;0;6340;5;2;
/org.eclipse.swt.examples/src/org/eclipse/swt/examples/javaviewer/JavaViewer.java;2;0;2;1;1;1;1;1;16;0;1;4548;20;20;1;0;0;1;2;4548;0;6352;2;2;
/org.eclipse.jdt.ui/core refactoring/org/eclipse/ltk/core/refactoring/ChangeContext.java;1;0;2;1;0;0;0;2;0;1;2;4575;0;0;1;0;0;2;2;4575;0;4864;2;1;
/org.eclipse.team.tests.cvs.core/src/org/eclipse/team/tests/ccvs/ui/logformatter/ArgumentParser.java;1;0;1;1;0;0;0;1;0;0;1;2632;0;0;1;0;0;1;1;2632;0;2632;1;1;
/org.eclipse.pde.core/src_OSGi/org/eclipse/pde/core/osgi/bundle/IBundle.java;2;0;8;1;0;0;0;8;94;1;8;2229;109;109;1;0;0;8;8;2229;0;4203;8;2;
/org.eclipse.jdt.core.tests.model/workspace/Converter/src/test0045/Test.java;1;0;1;1;0;0;0;1;0;0;1;3714;0;0;1;0;0;1;1;3714;0;3714;1;1;
/org.eclipse.jdt.ui.tests.refactoring/resources/ExtractMethodWorkSpace/ExtractMethodTests/locals_out/A_test534.java;1;0;1;1;0;0;0;1;4;0;1;844;4;4;1;0;0;1;1;844;0;844;1;1;
/org.eclipse.osgi/eclipseAdaptor/src/org/eclipse/core/runtime/adaptor/EclipseElementFactory.java;4;1;10;1;3;3;3;7;15;1;7;3013;50;50;1;0;0;7;10;3013;0;6133;10;4;
/org.eclipse.jdt.ui/core refactoring/org/eclipse/jdt/internal/corext/refactoring/changes/RenameCompilationUnitChange.java;2;0;6;1;1;1;1;5;6;1;5;3708;22;22;1;0;0;5;6;3708;0;6340;6;2;
/org.eclipse.ui.ide/src/org/eclipse/ui/internal/ide/actions/BuildCleanAction.java;1;0;2;1;1;1;1;1;25;0;1;4651;25;25;1;0;0;1;2;4651;0;5183;2;1;
/org.eclipse.osgi.tests/src/org/eclipse/osgi/tests/services/datalocation/BasicLocationTests.java;1;0;1;1;1;1;1;0;0;0;0;6220;0;0;1;0;0;0;1;6220;0;6220;1;1;
/org.eclipse.ui.ide/src/org/eclipse/ui/internal/dialogs/NewWizardSelectionPage.java;2;0;3;1;0;0;0;3;6;1;3;1526;6;6;1;0;0;3;3;1526;0;2263;3;2;
/org.eclipse.jdt.debug.ui/ui/org/eclipse/jdt/internal/debug/ui/JavaDebugHover.java;4;1;12;1;4;4;4;8;146;1;8;82;286;286;1;0;0;8;12;82;0;6336;12;4;
/org.eclipse.jdt.core.tests.model/workspace/Formatter/test032/A_out.java;1;0;1;1;0;0;0;1;0;0;1;2425;0;0;1;0;0;1;1;2425;0;2425;1;1;
/org.eclipse.team.ftp/src/org/eclipse/team/internal/ftp/client/IFTPRunnableContext.java;2;0;3;1;1;1;1;2;54;1;2;3221;56;56;1;0;0;2;3;3221;0;6337;3;2;
/org.eclipse.search/search/org/eclipse/search/internal/ui/SearchResultLabelProvider.java;1;0;1;1;1;1;1;0;2;0;0;6340;2;2;1;0;0;0;1;6340;0;6340;1;1;
/org.eclipse.pde.ui/src/org/eclipse/pde/internal/ui/wizards/PluginSelectionDialog.java;2;1;3;1;2;2;2;1;8;0;1;3393;12;12;1;0;0;1;3;3393;0;6336;3;2;
/org.eclipse.update.ui.forms/src/org/eclipse/update/ui/forms/richtext/HTTPAction.java;1;0;2;1;0;0;0;2;0;0;1;2849;0;0;2;1;0;2;2;2849;1;2849;1;1;
/org.eclipse.jdt.ui/ui/org/eclipse/jdt/internal/ui/search/ParentSorter.java;1;1;3;1;2;2;2;1;6;0;1;3711;10;10;1;0;0;1;3;3711;0;5462;3;1;
/org.eclipse.jdt.ui.tests.refactoring/resources/ChangeTypeRefactoring/positive/A_testLocalVarType_in.java;1;0;1;1;0;0;0;1;0;0;1;2844;0;0;1;0;0;1;1;2844;0;2844;1;1;
/org.eclipse.core.runtime.compatibility/src-runtime/org/eclipse/core/internal/plugins/ConfigurationElement.java;2;0;3;1;0;0;0;3;9;1;3;3013;9;9;1;0;0;3;3;3013;0;3169;3;2;
/org.eclipse.jdt.ui.tests.refactoring/resources/IntroduceFactory/Bugzilla/58293/ImplicitSuperCtorCall.java;1;1;2;1;2;2;2;0;2;0;0;5177;2;2;1;0;0;0;2;5177;0;5659;2;1;
/org.eclipse.debug.ui/ui/org/eclipse/debug/ui/launchVariables/LaunchVariableContextManager.java;2;0;2;1;0;0;0;2;0;1;2;771;0;0;1;0;0;2;2;771;0;2120;2;2;
/org.eclipse.jdt.core.tests.model/workspace/TypeResolve/src/p5/A.java;1;0;1;1;0;0;0;1;0;0;1;3452;0;0;1;0;0;1;1;3452;0;3452;1;1;
/org.eclipse.jdt.ui/core refactoring/org/eclipse/jdt/internal/corext/refactoring/participants/xml/ExpressionParser.java;1;0;3;1;0;0;0;3;15;1;3;1033;15;15;1;0;0;3;3;1033;0;4091;3;1;
/org.eclipse.update.ui/src/org/eclipse/update/internal/ui/views/MultiPageView.java;1;0;1;1;0;0;0;1;0;0;1;755;0;0;1;0;0;1;1;755;0;755;1;1;
/org.eclipse.team.ui/src/org/eclipse/team/ui/synchronize/viewers/ISynchronizeModelChangeListener.java;1;0;5;1;0;0;0;5;29;2;4;4213;36;36;2;1;0;5;5;4213;1;4632;4;1;
/org.eclipse.debug.ui/ui/org/eclipse/debug/internal/ui/actions/OpenProfileConfigurations.java;1;0;1;1;0;0;0;1;0;0;1;472;0;0;1;0;0;1;1;472;0;472;1;1;
/org.eclipse.team.cvs.ssh2/src/org/eclipse/team/ccvs/ssh2/PServerSSH2Method.java;3;0;5;1;0;0;0;5;36;1;5;2956;40;40;1;0;0;5;5;2956;0;4825;5;3;
/org.eclipse.jdt.debug.ui/ui/org/eclipse/jdt/internal/debug/ui/launcher/CompileErrorPromptStatusHandler.java;3;0;6;2;1;1;1;5;44;2;3;4631;59;59;2;2;0;5;6;4631;2;5135;4;3;
/org.eclipse.ui.forms/src/org/eclipse/ui/forms/internal/widgets/WidgetTest.java;1;0;6;1;0;0;0;6;20;2;5;4068;33;33;2;1;0;6;6;4147;1;4975;5;1;
/org.eclipse.ui.workbench/Eclipse UI/org/eclipse/ui/internal/skins/Presentation.java;1;0;3;1;0;0;0;3;33;1;3;4328;33;33;1;0;0;3;3;4328;0;4460;3;1;
/org.eclipse.jdt.ui.tests.refactoring/resources/ExtractMethodWorkSpace/ExtractMethodTests/locals_out/A_test533.java;1;0;1;1;0;0;0;1;4;0;1;844;4;4;1;0;0;1;1;844;0;844;1;1;
/org.eclipse.ui.workbench.texteditor/src/org/eclipse/ui/internal/texteditor/quickdiff/ReferenceSelectionAction.java;2;1;3;1;2;2;2;1;7;0;1;1644;13;13;1;0;0;1;3;1644;0;6340;3;2;
/org.eclipse.jdt.core.tests.model/workspace/Converter/test0185/Test.java;1;0;1;1;0;0;0;1;0;0;1;3714;0;0;1;0;0;1;1;3714;0;3714;1;1;
/org.eclipse.swt/Eclipse SWT/carbon/org/eclipse/swt/graphics/Device.java;3;1;5;1;3;3;3;2;64;1;2;179;97;97;1;0;0;2;5;179;0;6352;5;3;
/org.eclipse.ui.ide/src/org/eclipse/ui/actions/OpenResourceAction.java;2;0;3;1;0;0;0;3;12;1;3;1511;12;12;1;0;0;3;3;1511;0;2263;3;2;
/org.eclipse.jdt.core.tests.model/workspace/Converter/src/test0403/A.java;1;0;1;1;0;0;0;1;0;0;1;3714;0;0;1;0;0;1;1;3714;0;3714;1;1;
/org.eclipse.core.tests.resources/src/org/eclipse/core/tests/resources/session/TestSnapSaveSnap.java;1;0;1;1;1;1;1;0;121;0;0;5147;121;121;1;0;0;0;1;5147;0;5147;1;1;
/org.eclipse.ui.ide/src/org/eclipse/ui/dialogs/FileSelectionDialog.java;2;0;4;1;0;0;0;4;36;1;4;1526;43;43;1;0;0;4;4;1526;0;2263;4;2;
/org.eclipse.ui.workbench/Eclipse UI/org/eclipse/ui/internal/commands/old/Sequence.java;1;0;2;1;0;0;0;2;0;1;2;1322;0;0;1;0;0;2;2;1322;0;1695;2;1;
/org.eclipse.team.cvs.ui/src/org/eclipse/team/internal/ccvs/ui/wizards/StandardWizardMainPage.java;1;0;1;1;0;0;0;1;0;0;1;2533;0;0;1;0;0;1;1;2533;0;2533;1;1;
/org.eclipse.jdt.ui.tests.refactoring/resources/IntroduceFactory/Bugzilla/46374/QualifiedName.java;1;0;2;1;1;1;1;1;2;0;1;2846;2;2;1;0;0;1;2;2846;0;5659;2;1;
/org.eclipse.jdt.core.tests.model/src/org/eclipse/jdt/core/tests/dom/RunConverterTests.java;3;0;3;1;1;1;1;2;8;1;2;3560;15;15;1;0;0;2;3;3560;0;5528;3;3;
/org.eclipse.ui.workbench.texteditor/src/org/eclipse/ui/internal/texteditor/PreviousPulldownActionDelegate.java;2;0;2;1;0;0;0;2;0;1;2;1539;0;0;1;0;0;2;2;1539;0;2741;2;2;
/org.eclipse.ui.workbench/Eclipse UI/org/eclipse/ui/internal/commands/old/Configuration.java;1;0;2;1;0;0;0;2;0;1;2;1322;0;0;1;0;0;2;2;1322;0;1695;2;1;
/org.eclipse.pde.ui/src_Forms/org/eclipse/pde/internal/ui/neweditor/StructuredViewerSection.java;2;1;5;1;2;2;2;3;7;1;3;3795;12;12;1;0;0;3;5;3795;0;5431;5;2;
/org.eclipse.ui.workbench/Eclipse UI/org/eclipse/ui/internal/csm/commands/api/ICategoryEvent.java;1;0;2;1;0;0;0;2;0;1;2;2532;0;0;1;0;0;2;2;2532;0;2562;2;1;
/org.eclipse.ui.ide/src/org/eclipse/ui/views/tasklist/TaskPropertiesAction.java;1;0;1;1;0;0;0;1;0;0;1;2208;0;0;1;0;0;1;1;2208;0;2208;1;1;
/org.eclipse.jdt.ui/core refactoring/org/eclipse/jdt/internal/corext/refactoring/structure/MemberCheckUtil.java;3;1;5;1;2;2;2;3;18;1;3;882;46;46;1;0;0;3;5;882;0;6340;5;3;
/org.eclipse.jdt.ui/core refactoring/org/eclipse/jdt/internal/corext/refactoring/nls/AccessorClassInfo.java;2;1;6;1;6;6;6;0;18;0;0;5186;65;65;1;0;0;0;6;5186;0;6340;6;2;
/org.eclipse.ui.ide/extensions/org/eclipse/ui/dialogs/ContainerSelectionDialog.java;1;0;1;1;0;0;0;1;0;0;1;2263;0;0;1;0;0;1;1;2263;0;2263;1;1;
/org.eclipse.jdt.ui.tests.refactoring/resources/ExtractMethodWorkSpace/ExtractMethodTests/duplicates_out/A_test962.java;1;1;2;1;2;2;2;0;2;0;0;5650;2;2;1;0;0;0;2;5650;0;5681;2;1;
/org.eclipse.ant.tests.ui/Ant Editor Tests/org/eclipse/ant/tests/ui/editor/support/TestProblemRequestor.java;1;0;2;1;0;0;0;2;0;0;1;1811;0;0;2;1;0;2;2;1811;1;1811;1;1;
/org.eclipse.ui.examples.job/org/eclipse/ui/examples/jobs/views/LazyTreeView.java;1;0;2;1;2;1;2;0;0;0;0;5125;0;0;2;0;1;0;2;5125;1;5125;1;1;
/org.eclipse.jdt.ui/core refactoring/org/eclipse/jdt/internal/corext/refactoring/participants/xml/TypeExtender.java;1;0;3;1;0;0;0;3;12;1;3;2204;12;12;1;0;0;3;3;2204;0;4091;3;1;
/org.eclipse.jdt.junit/src/org/eclipse/jdt/internal/junit/util/JUnitStubUtility.java;2;1;3;1;2;2;2;1;7;0;1;3424;11;11;1;0;0;1;3;3424;0;6340;3;2;
/org.eclipse.jdt.core.tests.model/workspace/Converter15/src/test0002/X.java;1;0;1;1;0;0;0;1;0;0;1;4601;0;0;1;0;0;1;1;4601;0;4601;1;1;
/org.eclipse.pde.ui/src/org/eclipse/pde/internal/ui/parts/IFormEntryListener.java;2;1;3;1;3;3;3;0;10;0;0;5431;16;16;1;0;0;0;3;5431;0;6336;3;2;
/org.eclipse.update.core/srcnew/org/eclipse/update/internal/search/UpdateMap.java;2;0;3;1;0;0;0;3;2;2;2;630;2;2;2;1;0;3;3;630;1;825;2;2;
/org.eclipse.jdt.core.tests.model/workspace/Converter/src/test0521/A.java;1;0;1;1;0;0;0;1;0;0;1;3714;0;0;1;0;0;1;1;3714;0;3714;1;1;
/org.eclipse.jdt.core/search/org/eclipse/jdt/internal/core/search/JavaWorkspaceScope.java;2;0;4;1;1;1;1;3;6;1;3;1893;12;12;1;0;0;3;4;1893;0;5728;4;2;
/org.eclipse.jdt.ui/ui/org/eclipse/jdt/internal/ui/util/PixelConverter.java;1;0;1;1;1;1;1;0;2;0;0;6340;2;2;1;0;0;0;1;6340;0;6340;1;1;
/org.eclipse.ui.workbench/Eclipse UI/org/eclipse/ui/internal/registry/NavigatorRegistry.java;1;0;1;1;0;0;0;1;0;0;1;947;0;0;1;0;0;1;1;947;0;947;1;1;
/org.eclipse.team.core/src/org/eclipse/team/core/subscribers/ISubscriberManager2.java;2;0;2;2;0;0;0;2;0;0;1;2460;0;0;2;1;0;2;2;2460;1;2460;1;2;
/org.eclipse.debug.core/core/org/eclipse/debug/core/variables/ILaunchVariable.java;2;0;3;1;0;0;0;3;7;1;3;569;7;7;1;0;0;3;3;569;0;2120;3;2;
/org.eclipse.jdt.core/model/org/eclipse/jdt/core/eval/IEvaluationContext.java;2;0;6;1;0;0;0;6;66;2;5;991;74;74;2;1;0;6;6;991;1;4843;5;2;
/org.eclipse.ui.workbench/Eclipse UI/org/eclipse/ui/internal/registry/NavigatorContentDescriptor.java;1;0;1;1;0;0;0;1;0;0;1;1014;0;0;1;0;0;1;1;1014;0;1014;1;1;
/org.eclipse.jdt.ui/ui/org/eclipse/jdt/internal/ui/reorg/CutSourceReferencesToClipboardAction.java;2;0;4;1;0;0;0;4;368;2;3;457;631;631;2;1;0;4;4;1111;1;1111;3;2;
/org.eclipse.jdt.core.tests.model/workspace/Formatter/test225/A_out.java;1;0;1;1;0;0;0;1;0;0;1;2426;0;0;1;0;0;1;1;2426;0;2426;1;1;
/org.eclipse.swt/Eclipse SWT PI/carbon/org/eclipse/swt/internal/carbon/GDevice.java;1;2;3;1;3;2;3;0;16;0;0;5534;20;20;2;0;1;0;3;5534;1;5614;2;1;
/org.eclipse.swt.examples/src/org/eclipse/swt/examples/controlexample/CoolBarTab.java;3;0;7;1;1;1;1;6;9;1;6;1560;36;36;1;0;0;6;7;1560;0;6352;7;3;
/org.eclipse.ui.cheatsheets/src/org/eclipse/ui/cheatsheets/events/ICheatSheetViewListener.java;1;0;2;1;0;0;0;2;0;1;2;4428;0;0;1;0;0;2;2;4428;0;4625;2;1;
/org.eclipse.ui.tests/Eclipse UI Tests/org/eclipse/ui/tests/dialogs/DeprecatedUIPreferences.java;2;0;2;1;0;0;0;2;5;1;2;2007;7;7;1;0;0;2;2;2007;0;2738;2;2;
/org.eclipse.jdt.ui.tests.refactoring/resources/IntroduceFactory/Bugzilla/58293/ImplicitSuperCtorCall_out.java;1;1;2;1;2;2;2;0;2;0;0;5177;2;2;1;0;0;0;2;5177;0;5659;2;1;
/org.eclipse.swt/Eclipse SWT Mozilla/common/org/eclipse/swt/internal/mozilla/nsIRequest.java;1;0;1;1;0;0;0;1;0;0;1;2663;0;0;1;0;0;1;1;2663;0;2663;1;1;
/org.eclipse.jdt.ui.tests/ui/org/eclipse/jdt/ui/tests/core/HierarchicalASTVisitorTest.java;4;1;4;1;2;2;2;2;70;1;2;803;90;90;1;0;0;2;4;803;0;6340;4;4;
/org.eclipse.jdt.ui.tests.refactoring/resources/ChangeTypeRefactoring/positive/A_testParameterTypeWithOverride_in.java;1;0;1;1;0;0;0;1;0;0;1;2844;0;0;1;0;0;1;1;2844;0;2844;1;1;
/org.eclipse.ui.workbench/Eclipse UI/org/eclipse/ui/actions/GlobalBuildAction.java;1;0;1;1;0;0;0;1;0;0;1;2737;0;0;1;0;0;1;1;2737;0;2737;1;1;
/org.eclipse.team.ui/src/org/eclipse/team/internal/ui/sync/compare/SyncInfoCompareInput.java;2;0;18;2;0;0;0;18;104;2;17;488;421;421;2;1;0;18;18;2025;1;2632;17;2;
/org.eclipse.ui.views/src/org/eclipse/ui/views/internal/markers/problems/ProblemFiltersDialog.java;1;0;3;1;0;0;0;3;2;1;3;265;2;2;1;0;0;3;3;265;0;749;3;1;
/org.eclipse.ant.ui/Ant Editor/org/eclipse/ant/ui/internal/dtd/ParseError.java;1;0;2;1;0;0;0;2;0;1;2;250;0;0;1;0;0;2;2;250;0;1811;2;1;
/org.eclipse.ui.workbench/Eclipse UI/org/eclipse/ui/internal/contexts/ws/WorkbenchPartSiteContextSupport.java;2;0;4;1;0;0;0;4;13;1;4;3066;23;23;1;0;0;4;4;3066;0;4144;4;2;
/org.eclipse.jdt.ui.tests.refactoring/resources/MoveInnerToTopLevel/test_nonstatic_9/out/Inner.java;2;0;2;1;1;1;1;1;2;0;1;305;4;4;1;0;0;1;2;305;0;5854;2;2;
/org.eclipse.jdt.ui.examples.javafamily/src/org/eclipse/jsp/launching/TomcatTab.java;3;0;7;1;1;1;1;6;167;2;5;1373;281;281;2;1;0;6;7;1384;1;5923;6;3;
/org.eclipse.ui.workbench/Eclipse UI/org/eclipse/ui/internal/csm/commands/CategoryEvent.java;1;0;2;1;0;0;0;2;0;1;2;2549;0;0;1;0;0;2;2;2549;0;2562;2;1;
/org.eclipse.jdt.ui.examples.javafamily/src/org/eclipse/jsp/launching/LaunchingMessages.java;3;0;3;1;0;0;0;3;3;1;3;1355;4;4;1;0;0;3;3;1355;0;2344;3;3;
/org.eclipse.update.ui.forms/Eclipse Forms/org/eclipse/ui/forms/HyperlinkGroup.java;1;0;5;1;0;0;0;5;79;2;4;3096;133;133;2;1;0;5;5;3133;1;4157;4;1;
/org.eclipse.pde.ui/src_Forms/org/eclipse/pde/internal/ui/neweditor/build/BuildEditorContributor.java;2;1;2;1;2;2;2;0;0;0;0;5391;0;0;1;0;0;0;2;5391;0;5431;2;2;
/org.eclipse.pde.core/src/org/eclipse/pde/internal/core/bundle/BundleModel.java;2;1;5;1;3;3;3;2;65;1;2;2184;89;89;1;0;0;2;5;2184;0;6336;5;2;
/org.eclipse.team.core/src/org/eclipse/team/core/subscribers/RemoteSynchronizer.java;2;0;3;1;0;0;0;3;4;1;3;1954;4;4;1;0;0;3;3;1954;0;4216;3;2;
/org.eclipse.ui.views/src/org/eclipse/ui/views/internal/markers/ActionMarkerProperties.java;1;0;2;1;0;0;0;2;0;0;1;749;0;0;2;1;0;2;2;749;1;749;1;1;
/org.eclipse.ui.workbench/Eclipse UI/org/eclipse/ui/IEditorDescriptor.java;1;0;1;1;0;0;0;1;80;0;1;2737;80;80;1;0;0;1;1;2737;0;2737;1;1;
/org.eclipse.team.ui/src/org/eclipse/team/internal/ui/preferences/TeamPreferencePage.java;2;0;5;1;1;1;1;4;124;2;3;987;135;135;2;1;0;4;5;987;1;6337;4;2;
/org.eclipse.jdt.ui/ui/org/eclipse/jdt/internal/ui/compare/ResizableDialog.java;2;0;2;1;1;1;1;1;2;0;1;1289;4;4;1;0;0;1;2;1289;0;6340;2;2;
/org.eclipse.team.core/src/org/eclipse/team/internal/registry/TeamProviderRegistry.java;1;0;1;1;0;0;0;1;0;0;1;2777;0;0;1;0;0;1;1;2777;0;2777;1;1;
/org.eclipse.swt/Eclipse SWT Custom Widgets/common/org/eclipse/swt/custom/CTabFolderMinMaxAdapter.java;1;0;2;1;0;0;0;2;35;1;2;3812;35;35;1;0;0;2;2;3812;0;4232;2;1;
/org.eclipse.jdt.ui/ui/org/eclipse/jdt/internal/ui/text/template/preferences/TemplateVariableProposal.java;2;1;4;1;2;2;2;2;10;1;2;4258;15;15;1;0;0;2;4;4258;0;6340;4;2;
/org.eclipse.help.ide/src/org/eclipse/help/ui/internal/search/SearchQueryData.java;1;1;9;1;3;3;3;6;187;4;3;1738;319;319;4;3;0;6;9;1738;3;6337;6;1;
/org.eclipse.ui.externaltools/Ant Tools Support/org/eclipse/ui/externaltools/internal/ant/preferences/AddPropertyDialog.java;1;0;1;1;0;0;0;1;0;0;1;282;0;0;1;0;0;1;1;282;0;282;1;1;
/org.eclipse.ui.workbench/Eclipse UI/org/eclipse/ui/internal/roles/RolePreferencePage.java;1;0;6;1;0;0;0;6;123;2;5;1952;197;197;2;1;0;6;6;1952;1;2281;5;1;
/org.eclipse.ui.externaltools/Ant Editor/org/eclipse/ui/externaltools/internal/ant/editor/AntEditorMessages.java;1;0;1;1;0;0;0;1;0;0;1;282;0;0;1;0;0;1;1;282;0;282;1;1;
/org.eclipse.swt.tests/JUnit Tests/org/eclipse/swt/tests/junit/Test_org_eclipse_swt_events_TraverseEvent.java;1;0;2;1;1;1;1;1;7;0;1;3444;11;11;1;0;0;1;2;3444;0;6352;2;1;
/org.eclipse.jface/src/org/eclipse/jface/window/WindowManager.java;4;0;4;2;2;1;2;2;10;1;2;2736;20;20;2;0;1;2;4;6338;1;6338;3;4;
/org.eclipse.update.tests.core/src/org/eclipse/update/tests/uivalues/TestUILabel.java;2;0;3;1;1;1;1;2;4;1;2;3813;8;8;1;0;0;2;3;3813;0;6336;3;2;
/org.eclipse.jdt.core.tests.model/src/org/eclipse/jdt/core/tests/rewrite/modifying/ASTRewritingModifyingCopyTest.java;2;0;2;1;1;1;1;1;7;0;1;4711;7;7;1;0;0;1;2;4711;0;5853;2;2;
/org.eclipse.jdt.core.tests.model/workspace/Formatter/test252/A_in.java;1;0;1;1;0;0;0;1;0;0;1;2442;0;0;1;0;0;1;1;2442;0;2442;1;1;
/org.eclipse.jdt.core.tests.model/workspace/Formatter/test180/A_in.java;1;0;1;1;0;0;0;1;0;0;1;2425;0;0;1;0;0;1;1;2425;0;2425;1;1;
/org.eclipse.swt.tests/JUnit Tests/org/eclipse/swt/tests/junit/Test_org_eclipse_swt_accessibility_AccessibleTextAdapter.java;1;0;1;1;0;0;0;1;0;0;1;3373;0;0;1;0;0;1;1;3373;0;3373;1;1;
/org.eclipse.platform/src/org/eclipse/core/launcher/Main.java;3;1;46;1;12;12;12;34;2581;3;27;1714;5054;5054;3;7;0;34;46;3331;7;6339;39;3;
/org.eclipse.jdt.ui.tests/examples/org/eclipse/jdt/ui/examples/MyProjectCreationWizard.java;2;1;3;1;2;2;2;1;68;0;1;815;77;77;1;0;0;1;3;815;0;6340;3;2;
/org.eclipse.debug.ui/ui/org/eclipse/debug/internal/ui/views/launch/SourceNotFoundEditor.java;1;0;1;1;0;0;0;1;4;0;1;2447;4;4;1;0;0;1;1;2447;0;2447;1;1;
/org.eclipse.swt/Eclipse SWT Drag and Drop/win32/org/eclipse/swt/dnd/TransferData.java;2;1;3;1;2;2;2;1;9;0;1;391;20;20;1;0;0;1;3;391;0;6352;3;2;
/org.eclipse.osgi/core/framework/org/eclipse/osgi/framework/internal/core/StartLevel.java;3;0;3;1;1;1;1;2;372;1;2;3013;372;372;1;0;0;2;3;3013;0;5116;3;3;
/org.eclipse.core.tools.resources/src/org/eclipse/core/tools/metadata/MarkersDumpingStrategy_3.java;1;0;1;1;1;1;1;0;0;0;0;6302;0;0;1;0;0;0;1;6302;0;6302;1;1;
/org.eclipse.jdt.core/model/org/eclipse/jdt/internal/core/util/CommentRecorderScanner.java;2;0;2;1;0;0;0;2;5;1;2;3861;5;5;1;0;0;2;2;3861;0;4443;2;2;
/org.eclipse.debug.ui/ui/org/eclipse/debug/internal/ui/console/ConsoleView.java;2;0;8;2;0;0;0;8;116;2;6;1294;158;158;2;2;0;8;8;1317;2;2060;6;2;
/org.eclipse.jdt.core.tests.model/workspace/Formatter/test092/A_out.java;1;0;1;1;0;0;0;1;0;0;1;2425;0;0;1;0;0;1;1;2425;0;2425;1;1;
/org.eclipse.ui.workbench/Eclipse UI/org/eclipse/ui/internal/dialogs/WorkbenchWizardElement.java;5;1;12;2;2;2;2;10;415;2;9;2737;651;651;2;1;0;10;12;3061;1;6338;11;5;
/org.eclipse.team.cvs.ssh2/src/org/eclipse/team/ccvs/ssh2/KeyboardInteractiveDialog.java;2;0;3;1;0;0;0;3;2;1;3;2956;2;2;1;0;0;3;3;2956;0;3113;3;2;
/org.eclipse.jdt.core/model/org/eclipse/jdt/internal/core/DefaultCompilationUnitOwner.java;1;0;2;1;0;0;0;2;3;0;1;818;3;3;2;1;0;2;2;818;1;818;1;1;
/org.eclipse.pde.ui/src_Forms/org/eclipse/pde/internal/ui/neweditor/runtime/LibraryTypeSection.java;2;0;3;1;0;0;0;3;2;1;3;4406;2;2;1;0;0;3;3;4406;0;4906;3;2;
/org.eclipse.team.tests.cvs.core/src/org/eclipse/team/tests/ccvs/ui/old/LoggingTestRunner.java;1;0;2;1;0;0;0;2;0;1;2;2632;0;0;1;0;0;2;2;2632;0;4216;2;1;
/org.eclipse.update.ui/src/org/eclipse/update/internal/ui/security/JarVerificationPage.java;3;1;9;1;2;2;2;7;58;1;7;635;163;163;1;0;0;7;9;635;0;6336;9;3;
/org.eclipse.jdt.debug.ui/ui/org/eclipse/jdt/internal/debug/core/refactoring/LaunchConfigurationIJavaProjectRenameParticipant.java;3;1;8;1;2;2;2;6;27;1;6;3750;83;83;1;0;0;6;8;3750;0;6339;8;3;
/org.eclipse.ui.examples.javaeditor/Template Editor Example/org/eclipse/ui/examples/templateeditor/editors/XMLConfiguration.java;2;0;2;1;1;1;1;1;10;0;1;4644;10;10;1;0;0;1;2;4644;0;6340;2;2;
/org.eclipse.jdt.ui.examples.javafamily/coresearch-experiment/org/eclipse/search/internal/core/IndexManager.java;2;0;3;1;0;0;0;3;2;1;3;1380;2;2;1;0;0;3;3;1380;0;3214;3;2;
/org.eclipse.swt/Eclipse SWT/photon/org/eclipse/swt/internal/Converter.java;2;0;2;1;0;0;0;2;2;1;2;0;4;4;1;0;0;2;2;0;0;269;2;2;
/org.eclipse.ui.workbench/Eclipse UI/org/eclipse/ui/internal/chris/roles/api/secondstage/IRoleRegistryListener.java;1;0;2;1;0;0;0;2;0;0;1;2207;0;0;2;1;0;2;2;2207;1;2207;1;1;
/org.eclipse.update.configurator/src/org/eclipse/update/internal/configurator/ConfigurationParser.java;2;2;16;1;10;9;10;6;95;1;6;4095;202;202;2;0;1;6;16;5492;1;6149;15;2;
/org.eclipse.osgi/osgi/src/org/osgi/framework/ServicePermission.java;2;0;2;1;1;1;1;1;3;0;1;3013;3;3;1;0;0;1;2;3013;0;5536;2;2;
/org.eclipse.swt/Eclipse SWT AWT/motif/org/eclipse/swt/internal/awt/SWT_AWT.java;1;0;5;1;0;0;0;5;204;2;4;1650;220;220;2;1;0;5;5;1650;1;3013;4;1;
/org.eclipse.jdt.ui.examples.projects/examples/org/eclipse/jdt/internal/ui/exampleprojects/ExampleProjectMessages.java;1;0;1;1;1;1;1;0;2;0;0;6340;2;2;1;0;0;0;1;6340;0;6340;1;1;
/org.eclipse.ui.workbench.texteditor/src/org/eclipse/ui/texteditor/MarkAction.java;1;1;2;1;2;2;2;0;6;0;0;5123;8;8;1;0;0;0;2;5123;0;6340;2;1;
/org.eclipse.jdt.core.tests.model/workspace/Formatter/test232/A_in.java;1;0;1;1;0;0;0;1;0;0;1;2437;0;0;1;0;0;1;1;2437;0;2437;1;1;
/org.eclipse.pde.ui/src_Forms/org/eclipse/pde/internal/ui/neweditor/build/BuildSourcePage.java;2;2;4;1;4;3;4;0;106;0;0;5344;106;106;2;0;1;0;4;5370;1;5431;3;2;
/org.eclipse.ui.externaltools/External Tools Base/org/eclipse/ui/externaltools/internal/variable/FilePromptExpander.java;2;0;3;1;0;0;0;3;72;1;3;245;72;72;1;0;0;3;3;245;0;321;3;2;
/org.eclipse.debug.core/core/org/eclipse/debug/core/ILaunchConfigurationType.java;2;1;6;1;2;2;2;4;27;1;4;463;83;83;1;0;0;4;6;463;0;5134;6;2;
/org.eclipse.jdt.ui/core refactoring/org/eclipse/jdt/internal/corext/refactoring/typeconstraints/ConstraintVariableFactory.java;2;0;3;1;1;1;1;2;2;1;2;3710;4;4;1;0;0;2;3;3710;0;6340;3;2;
/org.eclipse.swt/Eclipse SWT/gtk/org/eclipse/swt/widgets/MenuItem.java;5;1;13;2;3;3;3;10;46;3;8;55;95;95;3;2;0;10;13;4128;2;6352;11;5;
/org.eclipse.jdt.ui.tests.refactoring/resources/PasteSourceReference/test2/in/B.java;1;0;1;1;0;0;0;1;0;0;1;1311;0;0;1;0;0;1;1;1311;0;1311;1;1;
/org.eclipse.jdt.ui.tests.refactoring/resources/RenameStaticMethod/test11/in/A.java;1;0;1;1;0;0;0;1;0;0;1;1535;0;0;1;0;0;1;1;1535;0;1535;1;1;
/org.eclipse.jface.text/src/org/eclipse/jface/text/contentassist/IContextInformationPresenterExtension.java;1;0;4;1;1;1;1;3;6;2;2;2280;9;9;2;1;0;3;4;2280;1;5181;3;1;
/org.eclipse.jdt.ui/core extension/org/eclipse/jdt/internal/corext/util/AllTypesCache.java;6;1;24;2;7;7;7;17;373;2;15;1336;1133;1133;2;2;0;17;24;1703;2;6340;22;6;
/org.eclipse.core.variables/src/org/eclipse/core/variables/IValueVariableListener.java;3;0;3;1;1;1;1;2;4;1;2;2514;6;6;1;0;0;2;3;2514;0;6336;3;3;
/org.eclipse.text/src/org/eclipse/jface/text/IRepairableDocument.java;2;1;4;1;3;3;3;1;20;0;1;2305;36;36;1;0;0;1;4;2305;0;6340;4;2;
/org.eclipse.team.ui/src/org/eclipse/team/internal/ui/sync/views/SyncTreeViewer.java;2;0;6;1;0;0;0;6;46;1;6;1158;80;80;1;0;0;6;6;1158;0;2632;6;2;
/org.eclipse.jdt.ui.tests.refactoring/resources/RenameTemp/canRename/A_test51_in.java;1;0;1;1;0;0;0;1;0;0;1;3218;0;0;1;0;0;1;1;3218;0;3218;1;1;
/org.eclipse.jdt.core/compiler/org/eclipse/jdt/internal/compiler/ast/PostfixExpression.java;2;0;3;1;0;0;0;3;10;1;3;991;16;16;1;0;0;3;3;991;0;3560;3;2;
/org.eclipse.core.tests.runtime/src/org/eclipse/core/tests/runtime/jobs/BlockingMonitor.java;1;0;1;1;1;1;1;0;0;0;0;5530;0;0;1;0;0;0;1;5530;0;5530;1;1;
/org.eclipse.swt/Eclipse SWT PI/carbon/org/eclipse/swt/internal/carbon/ControlButtonContentInfo.java;1;2;3;1;3;2;3;0;16;0;0;5534;20;20;2;0;1;0;3;5534;1;5614;2;1;
/org.eclipse.ui.workbench/Eclipse UI/org/eclipse/ui/internal/TrimLayout.java;5;0;5;2;0;0;0;5;810;2;4;3677;831;831;2;1;0;5;5;4015;1;5000;4;5;
/org.eclipse.ui.workbench/Eclipse UI/org/eclipse/ui/ContextManager.java;1;0;3;1;0;0;0;3;2;1;3;535;2;2;1;0;0;3;3;535;0;776;3;1;
/org.eclipse.ui.workbench/Eclipse UI/org/eclipse/ui/internal/contexts/SimpleContextService.java;1;0;3;1;0;0;0;3;28;2;2;1135;28;28;2;1;0;3;3;1135;1;1220;2;1;
/org.eclipse.update.ui/src/org/eclipse/update/internal/ui/wizards/NewUpdatesWizard.java;2;0;2;1;0;0;0;2;9;1;2;550;9;9;1;0;0;2;2;550;0;755;2;2;
/org.eclipse.jdt.core.tests.model/workspace/Formatter/test218/A_out.java;1;0;1;1;0;0;0;1;0;0;1;2426;0;0;1;0;0;1;1;2426;0;2426;1;1;
/org.eclipse.help.base/src/org/eclipse/help/internal/search/ISearchQuery.java;1;1;3;1;2;2;2;1;18;0;1;1740;34;34;1;0;0;1;3;1740;0;6337;3;1;
/org.eclipse.ui.ide/src/org/eclipse/ui/internal/ide/dialogs/RemoveCapabilityWizard.java;1;0;1;1;0;0;0;1;0;0;1;2264;0;0;1;0;0;1;1;2264;0;2264;1;1;
/org.eclipse.update.core/src/org/eclipse/update/standalone/EnableCommand.java;1;1;9;1;6;6;6;3;76;2;2;825;114;114;2;1;0;3;9;825;1;6336;8;1;
/org.eclipse.update.core/src/org/eclipse/update/core/model/InstalledSiteParser.java;1;0;1;1;0;0;0;1;0;0;1;2634;0;0;1;0;0;1;1;2634;0;2634;1;1;
/org.eclipse.debug.ui/ui/org/eclipse/debug/internal/ui/stringsubstitution/FilePrompt.java;2;1;3;1;2;2;2;1;3;0;1;2120;5;5;1;0;0;1;3;2120;0;6339;3;2;
/org.eclipse.ant.ui/Ant Tools Support/org/eclipse/ant/internal/ui/model/AntUIModelMessages.java;1;0;1;1;0;0;0;1;0;0;1;1811;0;0;1;0;0;1;1;1811;0;1811;1;1;
/org.eclipse.jdt.ui/ui/org/eclipse/jdt/internal/ui/text/java/AnonymousTypeCompletionProposal.java;2;0;10;1;1;1;1;9;177;2;8;576;217;217;2;1;0;9;10;576;1;6340;9;2;
/org.eclipse.pde.build/src/org/eclipse/pde/internal/build/BuildScriptGenerator.java;2;1;14;1;6;6;6;8;234;1;8;447;1320;1320;1;0;0;8;14;447;0;6336;14;2;
/org.eclipse.debug.core/core/org/eclipse/debug/core/model/IIndexedValue.java;2;1;4;1;2;2;2;2;12;1;2;2564;28;28;1;0;0;2;4;2564;0;6336;4;2;
/org.eclipse.jdt.ui.tests.refactoring/resources/ChangeTypeRefactoring/positive/A_testFieldWithAccess_out.java;1;0;1;1;0;0;0;1;0;0;1;2844;0;0;1;0;0;1;1;2844;0;2844;1;1;
/org.eclipse.jdt.debug.tests/test plugin/org/eclipse/jdt/debug/testplugin/SimpleVariableInitializer.java;1;0;2;1;0;0;0;2;0;1;2;850;0;0;1;0;0;2;2;850;0;2120;2;1;
/org.eclipse.jdt.core/compiler/org/eclipse/jdt/internal/compiler/ast/CharLiteral.java;2;0;3;1;0;0;0;3;4;1;3;992;8;8;1;0;0;3;3;992;0;3560;3;2;
/org.eclipse.debug.ui/ui/org/eclipse/debug/ui/variables/AbstractVariableComponent.java;2;0;6;1;0;0;0;6;139;4;3;316;140;140;4;3;0;6;6;316;3;550;3;2;
/org.eclipse.releng.basebuilder/plugins/org.eclipse.build.tools/src/org/eclipse/releng/FileTimeFilter.java;1;0;1;1;0;0;0;1;0;0;1;993;0;0;1;0;0;1;1;993;0;993;1;1;
/org.eclipse.jdt.ui.tests.refactoring/resources/DeleteSourceReference/test2/out/A.java;1;0;1;1;0;0;0;1;0;0;1;1652;0;0;1;0;0;1;1;1652;0;1652;1;1;
/org.eclipse.swt/Eclipse SWT Custom Widgets/common/org/eclipse/swt/custom/AnimatedProgress.java;2;1;2;1;2;2;2;0;22;0;0;5222;26;26;1;0;0;0;2;5222;0;6352;2;2;
/org.eclipse.pde.ui/src/org/eclipse/pde/internal/ui/parts/FormEntry.java;3;1;4;1;4;4;4;0;8;0;0;5431;15;15;1;0;0;0;4;5431;0;5782;4;3;
/org.eclipse.jdt.ui/ui/org/eclipse/jdt/internal/ui/browsing/ExcludingDecoratingLabelProvider.java;1;0;1;1;1;1;1;0;2;0;0;6340;2;2;1;0;0;0;1;6340;0;6340;1;1;
/org.eclipse.jdt.debug.ui/ui/org/eclipse/jdt/internal/debug/ui/actions/AddExternalFolderAction.java;1;0;1;1;0;0;0;1;15;0;1;2691;15;15;1;0;0;1;1;2691;0;2691;1;1;
/org.eclipse.swt/Eclipse SWT/gtk1x/org/eclipse/swt/graphics/DeviceData.java;1;0;1;1;0;0;0;1;0;0;1;2327;0;0;1;0;0;1;1;2327;0;2327;1;1;
/org.eclipse.jdt.junit/src/org/eclipse/jdt/internal/junit/ui/TabFolderLayout.java;1;0;1;1;1;1;1;0;2;0;0;6340;2;2;1;0;0;0;1;6340;0;6340;1;1;
/org.eclipse.core.tests.runtime/src/org/eclipse/core/tests/internal/plugins/PlatformURLPerformanceTest.java;1;0;1;1;0;0;0;1;0;0;1;3014;0;0;1;0;0;1;1;3014;0;3014;1;1;
/org.eclipse.ui.forms/src/org/eclipse/ui/forms/internal/widgets/FormUtil.java;1;0;6;1;0;0;0;6;42;1;6;4260;125;125;1;0;0;6;6;4260;0;5044;6;1;
/org.eclipse.ui.ide/src/org/eclipse/ui/internal/model/WorkbenchWorkspace.java;2;0;3;1;0;0;0;3;4;1;3;1511;4;4;1;0;0;3;3;1511;0;2263;3;2;
/org.eclipse.ui.tests/Eclipse UI Tests/org/eclipse/ui/tests/zoom/CloseEditorTest.java;2;0;2;1;1;1;1;1;11;0;1;4567;13;13;1;0;0;1;2;4567;0;6338;2;2;
/org.eclipse.ui.externaltools/External Tools Base/org/eclipse/ui/externaltools/internal/variable/IVariableExpander.java;1;0;1;1;0;0;0;1;0;0;1;321;0;0;1;0;0;1;1;321;0;321;1;1;
/org.eclipse.jdt.core/model/org/eclipse/jdt/internal/core/util/ToStringSorter.java;1;0;1;1;0;0;0;1;2;0;1;3560;2;2;1;0;0;1;1;3560;0;3560;1;1;
/org.eclipse.jdt.ui/ui/org/eclipse/jdt/internal/ui/search/ExceptionOccurrencesLabelProvider.java;3;1;3;1;2;2;2;1;4;0;1;3764;6;6;1;0;0;1;3;3764;0;6340;3;3;
/org.eclipse.ui.tests/Eclipse UI Tests/org/eclipse/ui/tests/navigator/DecoratorTestCase.java;2;0;2;1;0;0;0;2;9;1;2;1216;17;17;1;0;0;2;2;1216;0;3091;2;2;
/org.eclipse.jdt.core.tests.model/workspace/Converter/test0209/Test.java;1;0;1;1;0;0;0;1;0;0;1;3714;0;0;1;0;0;1;1;3714;0;3714;1;1;
/org.eclipse.ant.ui/Ant Tools Support/org/eclipse/ant/internal/ui/launchConfigurations/AntProcess.java;1;0;3;1;0;0;0;3;6;1;3;1811;11;11;1;0;0;3;3;1811;0;4498;3;1;
/org.eclipse.ui.workbench/Eclipse UI/org/eclipse/ui/roles/IRoleActivationServiceEvent.java;1;0;2;1;0;0;0;2;0;1;2;1952;0;0;1;0;0;2;2;1952;0;2202;2;1;
/org.eclipse.ui.workbench/Eclipse UI/org/eclipse/ui/internal/commands/registry/AbstractMutableRegistry.java;1;0;5;1;0;0;0;5;80;2;4;1077;90;90;2;1;0;5;5;1396;1;1396;4;1;
/org.eclipse.team.cvs.ui/src/org/eclipse/team/internal/ccvs/ui/subscriber/SafeUpdateAction.java;2;0;12;1;0;0;0;12;63;1;12;1137;243;243;1;0;0;12;12;1137;0;4450;12;2;
/org.eclipse.jdt.core.tests.model/workspace/Completion/src3/test0022/Test.java;1;0;1;1;1;1;1;0;0;0;0;5206;0;0;1;0;0;0;1;5206;0;5206;1;1;
/org.eclipse.jdt.core.tests.model/workspace/Formatter/test071/A_out.java;1;0;1;1;0;0;0;1;0;0;1;2425;0;0;1;0;0;1;1;2425;0;2425;1;1;
/org.eclipse.jdt.core.tests.model/workspace/Formatter/test340/A_out.java;1;0;1;1;0;0;0;1;0;0;1;2863;0;0;1;0;0;1;1;2863;0;2863;1;1;
/org.eclipse.pde.core/src/org/eclipse/pde/core/plugin/IPluginParent.java;3;1;4;1;3;3;3;1;60;0;1;4203;68;68;1;0;0;1;4;4203;0;6336;4;3;
/org.eclipse.debug.core/core/org/eclipse/debug/core/model/IBreakpoint.java;2;0;2;1;1;1;1;1;4;0;1;3964;6;6;1;0;0;1;2;3964;0;6336;2;2;
/org.eclipse.jdt.core/compiler/org/eclipse/jdt/internal/compiler/ast/ParameterizedAllocationExpression.java;1;0;1;1;0;0;0;1;0;0;1;2729;0;0;1;0;0;1;1;2729;0;2729;1;1;
/org.eclipse.debug.ui/ui/org/eclipse/debug/internal/ui/sourcelookup/MultipleSourceSelectionDialog.java;1;0;2;1;0;0;0;2;0;1;2;3770;0;0;1;0;0;2;2;3770;0;4609;2;1;
/org.eclipse.jdt.ui.tests.refactoring/resources/MoveInnerToTopLevel/test_nonstatic_38/in/A.java;1;0;1;1;0;0;0;1;0;0;1;1314;0;0;1;0;0;1;1;1314;0;1314;1;1;
/org.eclipse.jdt.core.tests.model/workspace/Formatter/test106/A_out.java;1;0;1;1;0;0;0;1;0;0;1;2425;0;0;1;0;0;1;1;2425;0;2425;1;1;
/org.eclipse.core.resources/src/org/eclipse/core/internal/indexing/PageStoreException.java;1;0;1;1;1;1;1;0;9;0;0;5146;9;9;1;0;0;0;1;5146;0;5146;1;1;
/org.eclipse.jdt.ui.tests.refactoring/resources/StructureSelectionAction/A_testZeroLength1.java;1;0;1;1;1;1;1;0;0;0;0;6144;0;0;1;0;0;0;1;6144;0;6144;1;1;
/org.eclipse.ui.workbench/Eclipse UI/org/eclipse/ui/internal/commands/api/older/NotDefinedException.java;1;0;2;1;0;0;0;2;0;0;1;2562;0;0;2;1;0;2;2;2562;1;2562;1;1;
/org.eclipse.update.ui/srcnew/org/eclipse/update/internal/ui/properties/FeatureEnvironmentPropertyPage.java;1;0;3;1;0;0;0;3;12;2;2;299;12;12;2;1;0;3;3;392;1;392;2;1;
/org.eclipse.jface.text/src/org/eclipse/jface/text/contentassist/ContentAssistant.java;3;3;29;2;8;5;8;21;329;2;18;679;1287;1287;3;3;3;21;29;6353;6;6353;23;3;
/org.eclipse.update.core/src/org/eclipse/update/internal/api/search/EnvironmentFilter.java;1;0;2;1;0;0;0;2;0;1;2;3270;0;0;1;0;0;2;2;3270;0;4928;2;1;
/org.eclipse.jdt.ui.tests.refactoring/resources/InlineMethodWorkspace/TestCases/cast_in/TestNotCastableOverloaded.java;1;0;1;1;0;0;0;1;0;0;1;955;0;0;1;0;0;1;1;955;0;955;1;1;
/org.eclipse.ui.workbench/Eclipse UI/org/eclipse/ui/internal/dialogs/NewWizardCollectionSorter2.java;2;0;2;1;0;0;0;2;0;1;2;3061;0;0;1;0;0;2;2;3061;0;4063;2;2;
/org.eclipse.ui.workbench/Eclipse UI/org/eclipse/ui/internal/progress/WorkbenchSiteProgressService.java;2;1;23;1;8;8;8;15;229;2;11;2842;960;960;2;4;0;15;23;4346;4;5898;19;2;
/org.eclipse.update.core/src/org/eclipse/update/internal/search/UpdatePolicy.java;3;1;10;1;2;2;2;8;32;2;7;963;73;73;2;1;0;8;10;963;1;6336;9;3;
/org.eclipse.jdt.debug/eval/org/eclipse/jdt/internal/debug/eval/ast/engine/SourceBasedSourceGenerator.java;2;1;2;1;2;2;2;0;43;0;0;6044;47;47;1;0;0;0;2;6044;0;6336;2;2;
/org.eclipse.swt/Eclipse SWT PI/gtk/org/eclipse/swt/internal/gtk/PangoItem.java;2;0;2;1;1;1;1;1;2;0;1;4563;2;2;1;0;0;1;2;4563;0;6352;2;2;
/org.eclipse.jdt.ui.tests/test plugin/org/eclipse/jdt/testplugin/TestOptionsSetup.java;1;1;2;1;2;2;2;0;6;0;0;6083;6;6;1;0;0;0;2;6083;0;6096;2;1;
/org.eclipse.debug.ui/ui/org/eclipse/debug/internal/ui/preferences/ProcessPropertyPage.java;3;0;3;1;0;0;0;3;15;1;3;110;30;30;1;0;0;3;3;110;0;146;3;3;
/org.eclipse.ui.tests/Eclipse UI Tests/org/eclipse/ui/tests/commands/CommandsTestSuite.java;3;1;3;1;2;2;2;1;16;0;1;4896;26;26;1;0;0;1;3;4896;0;6338;3;3;
/org.eclipse.swt.opengl.examples/src/org/eclipse/swt/opengl/examples/ColorSelectionGroup.java;1;0;1;1;0;0;0;1;0;0;1;1175;0;0;1;0;0;1;1;1175;0;1175;1;1;
/org.eclipse.jdt.ui.tests.refactoring/resources/ExtractMethodWorkSpace/ExtractMethodTests/expression_out/A_test616.java;1;0;4;1;0;0;0;4;4;1;4;130;5;5;1;0;0;4;4;130;0;1474;4;1;
/org.eclipse.jdt.ui.tests.refactoring/test cases/org/eclipse/jdt/ui/tests/refactoring/PullUpTests.java;4;1;15;1;2;2;2;13;56;2;12;130;308;308;2;1;0;13;15;345;1;6340;14;4;
/org.eclipse.ui.workbench/Eclipse UI/org/eclipse/ui/internal/commands/api/ICommandServiceListener.java;1;0;2;1;0;0;0;2;2;0;1;2562;2;2;2;1;0;2;2;2562;1;2562;1;1;
/org.eclipse.ui.workbench/Eclipse UI/org/eclipse/ui/internal/RectangleAnimation.java;1;2;8;1;4;3;4;4;149;1;4;4209;221;221;2;0;1;4;8;6013;1;6013;7;1;
/org.eclipse.team.ui/src/org/eclipse/team/internal/ui/actions/TeamOperation.java;1;0;2;1;0;0;0;2;0;1;2;4450;0;0;1;0;0;2;2;4450;0;4466;2;1;
/org.eclipse.jdt.debug.ui/ui/org/eclipse/jdt/internal/debug/ui/launcher/ZipContentProvider.java;1;0;1;1;0;0;0;1;0;0;1;1510;0;0;1;0;0;1;1;1510;0;1510;1;1;
/org.eclipse.ui.tests/Eclipse UI Tests/org/eclipse/ui/tests/api/ListElementPropertyTester.java;1;0;1;1;1;1;1;0;0;0;0;5437;0;0;1;0;0;0;1;5437;0;5437;1;1;
/org.eclipse.pde.build/src/org/eclipse/pde/internal/build/site/BuildTimeSiteContentProvider.java;2;0;7;1;1;1;1;6;64;1;6;447;80;80;1;0;0;6;7;447;0;5145;7;2;
/org.eclipse.team.core/src/org/eclipse/team/internal/core/IMemento.java;2;0;3;1;1;1;1;2;169;1;2;3966;169;169;1;0;0;2;3;3966;0;5754;3;2;
/org.eclipse.team.ui/src/org/eclipse/team/ui/sync/actions/OpenInCompareAction.java;1;0;1;1;0;0;0;1;0;0;1;2425;0;0;1;0;0;1;1;2425;0;2425;1;1;
/org.eclipse.jdt.ui/ui/org/eclipse/jdt/internal/ui/preferences/OptionsConfigurationBlock.java;4;1;25;3;5;5;5;20;93;2;17;1134;387;387;2;3;0;20;25;4183;3;6340;22;4;
/org.eclipse.ui.forms/src/org/eclipse/ui/internal/forms/widgets/ImageSegment.java;1;0;2;1;1;1;1;1;4;0;1;5044;4;4;1;0;0;1;2;5044;0;6336;2;1;
/org.eclipse.jdt.ui/core extension/org/eclipse/jdt/internal/corext/template/TemplateBuffer.java;1;0;1;1;0;0;0;1;0;0;1;4258;0;0;1;0;0;1;1;4258;0;4258;1;1;
/org.eclipse.debug.ui/ui/org/eclipse/debug/internal/ui/stringsubstitution/ResourceSelector.java;2;0;2;1;0;0;0;2;2;1;2;2099;2;2;1;0;0;2;2;2099;0;2514;2;2;
/org.eclipse.jdt.core/compiler/org/eclipse/jdt/internal/compiler/classfmt/ClassFileConstants.java;2;0;6;1;0;0;0;6;21;2;5;530;31;31;2;1;0;6;6;530;1;4254;5;2;
/org.eclipse.ui.workbench/Eclipse UI/org/eclipse/ui/internal/Semaphore.java;2;0;2;1;0;0;0;2;88;1;2;1524;90;90;1;0;0;2;2;1524;0;2519;2;2;
/org.eclipse.ui.workbench/Eclipse UI/org/eclipse/ui/internal/commands/api/ICommandDefinition.java;1;0;4;1;0;0;0;4;0;2;3;1724;0;0;2;1;0;4;4;2515;1;2532;3;1;
/org.eclipse.jdt.core.tests.model/workspace/TypeHierarchy/src/p48459/p1/Z48459.java;1;0;1;1;0;0;0;1;0;0;1;3490;0;0;1;0;0;1;1;3490;0;3490;1;1;
/org.eclipse.jface.text/src/org/eclipse/jface/contentassist/SubjectControlContextInformationValidator.java;1;2;4;1;4;3;4;0;8;0;0;5199;14;14;2;0;1;0;4;6340;1;6356;3;1;
/org.eclipse.ant.core/src_ant/org/eclipse/ant/internal/core/ant/ProgressBuildListener.java;1;0;1;1;0;0;0;1;14;0;1;2988;14;14;1;0;0;1;1;2988;0;2988;1;1;
/org.eclipse.core.tests.runtime/src/org/eclipse/core/tests/internal/registrycache/LazyRegistryCacheTest.java;4;2;5;1;4;3;4;1;7;0;1;4045;13;13;2;0;1;1;5;5532;1;5681;4;4;
/org.eclipse.ui.ide/src/org/eclipse/ui/internal/ide/model/ResourceFactory.java;4;1;5;1;2;2;2;3;2;1;3;2264;8;8;1;0;0;3;5;2264;0;6338;5;4;
/org.eclipse.team.ui/src/org/eclipse/team/ui/synchronize/viewers/SynchronizeModelElementLabelProvider.java;1;0;5;1;0;0;0;5;204;2;4;4213;211;211;2;1;0;5;5;4213;1;4588;4;1;
/org.eclipse.jdt.core.tests.model/workspace/Converter/examples.oneofeach/ASTPosterChild.java;1;0;1;1;0;0;0;1;0;0;1;3714;0;0;1;0;0;1;1;3714;0;3714;1;1;
/org.eclipse.ui.workbench/Eclipse UI/org/eclipse/ui/internal/actions/OpenWorkspaceFileAction.java;1;0;1;1;0;0;0;1;0;0;1;2737;0;0;1;0;0;1;1;2737;0;2737;1;1;
/org.eclipse.core.runtime/src/org/eclipse/core/runtime/IRegistryChangeEvent.java;3;0;7;1;2;1;2;5;57;1;5;3134;114;114;2;0;1;5;7;5117;1;5117;6;3;
/org.eclipse.jdt.core/compiler/org/eclipse/jdt/internal/compiler/lookup/SyntheticAccessMethodBinding.java;3;0;4;1;0;0;0;4;48;2;3;24;62;62;2;1;0;4;4;24;1;3560;3;3;
/org.eclipse.ui.tests/Eclipse UI Tests/org/eclipse/ui/tests/navigator/NavigatorTestSuite.java;2;0;2;1;1;1;1;1;3;0;1;4238;5;5;1;0;0;1;2;4238;0;6338;2;2;
/org.eclipse.debug.core/core/org/eclipse/debug/internal/core/memory/IMemoryRenderingListener.java;1;0;1;1;1;1;1;0;0;0;0;5254;0;0;1;0;0;0;1;5254;0;5254;1;1;
/org.eclipse.jdt.ui.tests.refactoring/resources/PasteSourceReference/test3/out/A.java;1;0;1;1;0;0;0;1;0;0;1;1311;0;0;1;0;0;1;1;1311;0;1311;1;1;
/org.eclipse.jdt.core.tests.model/workspace/Formatter/test200/A_in.java;1;0;1;1;0;0;0;1;0;0;1;2424;0;0;1;0;0;1;1;2424;0;2424;1;1;
/org.eclipse.ui.intro/src/org/eclipse/ui/intro/config/IIntroURL.java;2;1;5;1;5;5;5;0;39;0;0;5277;70;70;1;0;0;0;5;5277;0;6343;5;2;
/org.eclipse.pde.core/src/org/eclipse/pde/internal/core/schema/SchemaComplexType.java;3;1;4;1;2;2;2;2;8;1;2;4203;22;22;1;0;0;2;4;4203;0;6336;4;3;
/org.eclipse.core.resources/src/org/eclipse/core/internal/resources/MarkerReader_3.java;2;0;2;1;1;1;1;1;209;0;1;1744;211;211;1;0;0;1;2;1744;0;5146;2;2;
/org.eclipse.pde.ui/src/org/eclipse/pde/internal/ui/search/UnusedImportsDialog.java;2;1;2;1;2;2;2;0;4;0;0;5782;6;6;1;0;0;0;2;5782;0;6336;2;2;
/org.eclipse.ant.ui/Ant Runner Support/org/eclipse/ant/internal/ui/antsupport/inputhandler/AntInputHandler.java;1;1;6;1;3;3;3;3;9;2;2;1811;21;21;2;1;0;3;6;1811;1;6336;5;1;
/org.eclipse.jdt.core.tests.model/workspace/Formatter/test256/A_in.java;1;0;1;1;0;0;0;1;0;0;1;2442;0;0;1;0;0;1;1;2442;0;2442;1;1;
/org.eclipse.ui.workbench/Eclipse UI/org/eclipse/ui/commands/ICommandActivationServiceListener.java;1;0;2;1;0;0;0;2;0;0;1;1222;0;0;2;1;0;2;2;1222;1;1222;1;1;
/org.eclipse.osgi/core/adaptor/org/eclipse/osgi/framework/adaptor/ServiceRegistry.java;4;1;6;1;4;4;4;2;8;1;2;3013;20;20;1;0;0;2;6;3013;0;6337;6;4;
/org.eclipse.jdt.core.tests.model/workspace/Formatter/test051/A_in.java;1;0;1;1;0;0;0;1;0;0;1;2425;0;0;1;0;0;1;1;2425;0;2425;1;1;
/org.eclipse.jdt.ui.tests.refactoring/resources/Delete/testDeleteWithinCu17/in/A.java;1;0;1;1;0;0;0;1;0;0;1;442;0;0;1;0;0;1;1;442;0;442;1;1;
/org.eclipse.osgi/core/framework/org/eclipse/osgi/framework/internal/protocol/ContentHandlerFactory.java;5;1;7;1;3;3;3;4;106;1;4;3013;127;127;1;0;0;4;7;3013;0;6337;7;5;
/org.eclipse.core.tests.runtime/src/org/eclipse/core/tests/internal/plugin/c/PluginClass.java;1;0;1;1;1;1;1;0;19;0;0;5149;19;19;1;0;0;0;1;5149;0;5149;1;1;
/org.eclipse.jdt.core.tests.model/workspace/Formatter/test277/A_out.java;1;0;1;1;0;0;0;1;0;0;1;2443;0;0;1;0;0;1;1;2443;0;2443;1;1;
/org.eclipse.jdt.core/model/org/eclipse/jdt/core/Flags.java;4;0;7;1;0;0;0;7;57;1;7;85;101;101;1;0;0;7;7;85;0;4851;7;4;
/org.eclipse.jdt.core.tests.model/workspace/Converter/src/test0438/D.java;1;0;1;1;0;0;0;1;0;0;1;3714;0;0;1;0;0;1;1;3714;0;3714;1;1;
/org.eclipse.jdt.ui.tests.refactoring/resources/Copy/test_method_yes_itself/out/A.java;1;0;1;1;0;0;0;1;2;0;1;685;2;2;1;0;0;1;1;685;0;685;1;1;
/org.eclipse.sdk.tests-feature/plugins/org.eclipse.perfmsr.ui.client/src/org/eclipse/perfmsr/ui/client/ScenarioDescriptor.java;1;0;1;1;1;1;1;0;0;0;0;5803;0;0;1;0;0;0;1;5803;0;5803;1;1;
/org.eclipse.jdt.core.tests.model/workspace/Converter/src/junit/runner/TestCaseClassLoader.java;1;0;1;1;0;0;0;1;0;0;1;3714;0;0;1;0;0;1;1;3714;0;3714;1;1;
/org.eclipse.pde.ui/src/org/eclipse/pde/internal/ui/wizards/extension/ExtensionEditorSelectionPage.java;2;2;4;2;4;3;4;0;26;0;0;5514;29;29;2;0;1;0;4;5780;1;5804;3;2;
/org.eclipse.ui.workbench/Eclipse UI/org/eclipse/ui/internal/csm/activities/api/IActivityEvent.java;1;0;3;1;0;0;0;3;22;2;2;2225;22;22;2;1;0;3;3;2238;1;2238;2;1;
/org.eclipse.jdt.ui.tests.refactoring/resources/ChangeTypeRefactoring/positive/A_testParameterType_out.java;1;0;1;1;0;0;0;1;0;0;1;2844;0;0;1;0;0;1;1;2844;0;2844;1;1;
/org.eclipse.debug.ui/ui/org/eclipse/debug/ui/sourcelookup/WorkingSetSourceContainer.java;1;0;2;1;1;1;1;1;7;0;1;4970;7;7;1;0;0;1;2;4970;0;6151;2;1;
/org.eclipse.jdt.core.tests.compiler/src/org/eclipse/jdt/core/tests/compiler/regression/AnnotationTestForField.java;1;0;3;1;0;0;0;3;4;1;3;2397;4;4;1;0;0;3;3;2397;0;2887;3;1;
/org.eclipse.jdt.ui/core extension/org/eclipse/jdt/internal/corext/util/Resources.java;2;1;2;1;2;2;2;0;4;0;0;5377;6;6;1;0;0;0;2;5377;0;6340;2;2;
/org.eclipse.jdt.core.tests.model/workspace/Formatter/test498/A_in.java;1;0;1;1;1;1;1;0;0;0;0;5624;0;0;1;0;0;0;1;5624;0;5624;1;1;
/org.eclipse.ant.ui/Ant Editor/org/eclipse/ant/internal/ui/dtd/util/Factory.java;1;0;1;1;0;0;0;1;0;0;1;1811;0;0;1;0;0;1;1;1811;0;1811;1;1;
/org.eclipse.update.ui.win32/src/org/eclipse/welcome/internal/webbrowser/IWebBrowserListener.java;1;0;1;1;0;0;0;1;0;0;1;907;0;0;1;0;0;1;1;907;0;907;1;1;
/org.eclipse.jdt.core.tests.model/workspace/Resolve/src/ResolveMethodDeclarationInAnonymous3.java;1;0;1;1;0;0;0;1;0;0;1;3303;0;0;1;0;0;1;1;3303;0;3303;1;1;
/org.eclipse.swt/Eclipse SWT Mozilla/common/org/eclipse/swt/internal/mozilla/nsIControllers.java;1;0;2;1;0;0;0;2;28;1;2;1654;28;28;1;0;0;2;2;1654;0;2568;2;1;
/org.eclipse.debug.ui/ui/org/eclipse/debug/internal/ui/sourcelookup/LookupSourceAction.java;1;0;2;1;0;0;0;2;2;1;2;4629;2;2;1;0;0;2;2;4629;0;4949;2;1;
/org.eclipse.jdt.core.tests.model/workspace/Formatter/test338/A_out.java;1;0;1;1;0;0;0;1;0;0;1;2863;0;0;1;0;0;1;1;2863;0;2863;1;1;
/org.eclipse.jdt.core.tests.model/workspace/Formatter/test401/A_in.java;1;0;1;1;0;0;0;1;0;0;1;3436;0;0;1;0;0;1;1;3436;0;3436;1;1;
/org.eclipse.jdt.core.tests.model/workspace/Converter/src/javadoc/test107/TestD2.java;1;0;1;1;0;0;0;1;0;0;1;4390;0;0;1;0;0;1;1;4390;0;4390;1;1;
/org.eclipse.jdt.core.tests.model/workspace/Formatter/test337/A_in.java;1;0;3;1;0;0;0;3;0;2;2;2743;0;0;2;1;0;3;3;2759;1;2759;2;1;
/org.eclipse.core.resources/src/org/eclipse/core/internal/resources/ResourceTree.java;2;1;10;1;3;3;3;7;2091;1;7;178;2808;2808;1;0;0;7;10;178;0;5895;10;2;
/org.eclipse.update.core/src/org/eclipse/update/internal/core/FeatureContentConsumer.java;1;0;1;1;0;0;0;1;4;0;1;890;4;4;1;0;0;1;1;890;0;890;1;1;
/org.eclipse.pde.ui/sandbox/org/eclipse/pde/internal/ui/editor/standalone/site/SiteSourceLabelProvider.java;1;0;2;1;0;0;0;2;0;1;2;2320;0;0;1;0;0;2;2;2320;0;2906;2;1;
/org.eclipse.jdt.ui.tests.refactoring/resources/ChangeSignature/canModify/A_testAdd30_out.java;1;0;1;1;0;0;0;1;2;0;1;2093;2;2;1;0;0;1;1;2093;0;2093;1;1;
/org.eclipse.team.ui/src/org/eclipse/team/internal/ui/sync/actions/SyncViewerActionGroup.java;1;0;4;1;0;0;0;4;81;1;4;488;95;95;1;0;0;4;4;488;0;2632;4;1;
/org.eclipse.jdt.core/model/org/eclipse/jdt/internal/core/builder/JavaBuilder.java;3;1;21;1;4;4;4;17;34;2;15;13;164;164;2;2;0;17;21;2046;2;5800;19;3;
/org.eclipse.jdt.core/model/org/eclipse/jdt/core/util/IConstantPoolEntry.java;1;0;1;1;0;0;0;1;2;0;1;3560;2;2;1;0;0;1;1;3560;0;3560;1;1;
/org.eclipse.jdt.core.tests.model/workspace/Formatter/test144/A_out.java;1;0;1;1;0;0;0;1;0;0;1;2425;0;0;1;0;0;1;1;2425;0;2425;1;1;
/org.eclipse.pde.ui/src_OSGi/org/eclipse/pde/internal/ui/osgi/templates/AbstractNewBundleTemplateWizard.java;3;0;15;1;0;0;0;15;65;1;15;2501;133;133;1;0;0;15;15;2501;0;3986;15;3;
/org.eclipse.ui.ide/extensions/org/eclipse/ui/actions/BuildAction.java;4;0;4;1;1;1;1;3;69;1;3;2263;73;73;1;0;0;3;4;2263;0;6338;4;4;
/org.eclipse.jdt.ui.tests.refactoring/resources/ExtractMethodWorkSpace/ExtractMethodTests/expression_out/A_test617.java;1;0;4;1;0;0;0;4;4;1;4;130;5;5;1;0;0;4;4;130;0;1474;4;1;
/org.eclipse.team.ui/src/org/eclipse/team/ui/synchronize/content/SyncInfoSetTreeContentProvider.java;1;0;1;1;0;0;0;1;0;0;1;3748;0;0;1;0;0;1;1;3748;0;3748;1;1;
/org.eclipse.jdt.ui/core refactoring/org/eclipse/jdt/internal/corext/refactoring/util/CodeAnalyzer.java;2;0;3;1;1;1;1;2;4;1;2;882;8;8;1;0;0;2;3;882;0;6340;3;2;
/org.eclipse.pde.ui/src/org/eclipse/pde/internal/ui/editor/manifest/DependenciesForm.java;1;0;2;1;1;1;1;1;6;0;1;4203;6;6;1;0;0;1;2;4203;0;5431;2;1;
/org.eclipse.ltk.core.refactoring/src/org/eclipse/ltk/core/refactoring/participants/ParticipantManager.java;1;1;7;1;5;5;5;2;66;1;2;4845;193;193;1;0;0;2;7;4845;0;5264;7;1;
/org.eclipse.core.tests.runtime/src/org/eclipse/core/tests/internal/registrycache/LazyCacheTests.java;1;0;3;1;0;0;0;3;140;1;3;208;142;142;1;0;0;3;3;208;0;3014;3;1;
/org.eclipse.jdt.ui.tests.refactoring/resources/PullUp/test24/out/A.java;2;0;2;1;0;0;0;2;16;1;2;1690;20;20;1;0;0;2;2;1690;0;1738;2;2;
/org.eclipse.jdt.text.tests/src/org/eclipse/jdt/ui/text/tests/JavaPartitionerTest.java;1;1;3;1;2;2;2;1;7;0;1;5082;7;7;1;0;0;1;3;5082;0;5129;3;1;
/org.eclipse.jdt.ui.tests.refactoring/resources/ChangeTypeRefactoring/positive/A_testImport_in.java;1;0;1;1;0;0;0;1;0;0;1;2844;0;0;1;0;0;1;1;2844;0;2844;1;1;
/org.eclipse.core.runtime/src/org/eclipse/core/runtime/IPreferenceCustomization.java;1;1;2;1;2;2;2;0;0;0;0;5299;0;0;1;0;0;0;2;5299;0;5333;2;1;
/org.eclipse.ui.workbench/Eclipse UI/org/eclipse/ui/internal/csm/activities/ActivityEvent.java;1;0;4;1;0;0;0;4;44;2;3;2225;48;48;2;1;0;4;4;2441;1;2441;3;1;
/org.eclipse.ui.ide/src/org/eclipse/ui/internal/ide/IDEExceptionHandler.java;4;0;5;1;1;1;1;4;13;1;4;1512;18;18;1;0;0;4;5;1512;0;6338;5;4;
/org.eclipse.jdt.core.tests.model/workspace/Converter/src/test0511/A.java;1;0;1;1;0;0;0;1;0;0;1;3714;0;0;1;0;0;1;1;3714;0;3714;1;1;
/org.eclipse.ui.ide/src/org/eclipse/ui/actions/RefreshAction.java;2;0;3;1;0;0;0;3;18;1;3;1511;18;18;1;0;0;3;3;1511;0;2263;3;2;
/org.eclipse.team.ui/src/org/eclipse/team/ui/synchronize/viewers/StructuredViewerAdvisor.java;2;0;9;2;0;0;0;9;322;2;8;4118;937;937;2;1;0;9;9;4585;1;4632;8;2;
/org.eclipse.jface.text/src/org/eclipse/jface/text/rules/PatternRule.java;1;0;2;1;1;1;1;1;38;0;1;4190;40;40;1;0;0;1;2;4190;0;6340;2;1;
/org.eclipse.jdt.ui.tests.refactoring/test cases/org/eclipse/jdt/ui/tests/refactoring/RenameTests.java;2;0;2;1;1;1;1;1;2;0;1;1216;2;2;1;0;0;1;2;1216;0;6340;2;2;
/org.eclipse.team.ui/src/org/eclipse/team/internal/ui/synchronize/TreeViewerAdvisor.java;2;2;6;2;6;4;6;0;124;0;0;5362;131;131;2;0;2;0;6;5362;2;6337;4;2;
/org.eclipse.jdt.core.tests.model/workspace/Formatter/test307/A_out.java;1;0;1;1;0;0;0;1;0;0;1;2442;0;0;1;0;0;1;1;2442;0;2442;1;1;
/org.eclipse.ui.workbench/Eclipse UI/org/eclipse/ui/internal/DropDownEditorWorkbook2.java;2;0;2;1;0;0;0;2;0;1;2;2620;0;0;1;0;0;2;2;2620;0;4015;2;2;
/org.eclipse.pde.ui/src/org/eclipse/pde/internal/ui/editor/manifest/ManifestPropertySheet.java;2;0;3;1;1;1;1;2;2;1;2;3235;3;3;1;0;0;2;3;3235;0;5431;3;2;
/org.eclipse.jdt.debug.ui/ui/org/eclipse/jdt/internal/debug/core/refactoring/RefractoringMessages.java;2;0;2;1;0;0;0;2;0;1;2;3774;0;0;1;0;0;2;2;3774;0;4030;2;2;
/org.eclipse.jface.text/src/org/eclipse/jface/text/rules/WhitespaceRule.java;1;0;1;1;1;1;1;0;2;0;0;6340;2;2;1;0;0;0;1;6340;0;6340;1;1;
/org.eclipse.jdt.core.tests.model/workspace/Converter/src/test0454/A.java;1;0;1;1;0;0;0;1;0;0;1;3714;0;0;1;0;0;1;1;3714;0;3714;1;1;
/org.eclipse.ui.views/src/org/eclipse/ui/views/bookmarkexplorer/EditBookmarkAction.java;1;0;1;1;0;0;0;1;0;0;1;2738;0;0;1;0;0;1;1;2738;0;2738;1;1;
/org.eclipse.ui.ide/src/org/eclipse/ui/internal/ide/ProblemImageProvider.java;1;0;1;1;0;0;0;1;0;0;1;2264;0;0;1;0;0;1;1;2264;0;2264;1;1;
/org.eclipse.jdt.core.tests.model/workspace/Converter/src/test0122/Test.java;1;0;1;1;0;0;0;1;0;0;1;3714;0;0;1;0;0;1;1;3714;0;3714;1;1;
/org.eclipse.ant.ui/Ant Tools Support/org/eclipse/ant/internal/ui/preferences/AntClasspathBlock2.java;1;0;9;1;0;0;0;9;155;3;7;2182;307;307;3;2;0;9;9;2182;2;2550;7;1;
/org.eclipse.core.runtime.osgi/src/org/eclipse/core/internal/registry/ConfigurationProperty.java;1;0;2;1;0;0;0;2;67;1;2;3013;67;67;1;0;0;2;2;3013;0;3030;2;1;
/org.eclipse.swt/Eclipse SWT Drag and Drop/photon/org/eclipse/swt/dnd/TextTransfer.java;1;0;1;1;0;0;0;1;4;0;1;2364;4;4;1;0;0;1;1;2364;0;2364;1;1;
/org.eclipse.update.configurator/src/org/eclipse/update/internal/configurator/ConfigurationActivator.java;2;1;49;2;15;15;15;34;142;3;26;3292;1084;1084;3;8;0;34;49;4108;8;6325;41;2;
/org.eclipse.ui.ide/src/org/eclipse/ui/views/navigator/ResourceNavigatorRenameAction.java;1;0;1;1;0;0;0;1;0;0;1;2208;0;0;1;0;0;1;1;2208;0;2208;1;1;
/org.eclipse.jdt.ui/ui/org/eclipse/jdt/ui/wizards/NewTypeWizardPage.java;6;2;41;2;8;7;8;33;89;2;30;218;754;754;2;3;1;33;41;950;4;6334;37;6;
/org.eclipse.update.ui/src/org/eclipse/update/internal/ui/wizards/NewSiteBookmarkWizardPage.java;1;0;1;1;0;0;0;1;0;0;1;755;0;0;1;0;0;1;1;755;0;755;1;1;
/org.eclipse.ui.ide/src/org/eclipse/ui/internal/ide/dialogs/MultiStepCapabilityWizard.java;1;0;1;1;0;0;0;1;0;0;1;2264;0;0;1;0;0;1;1;2264;0;2264;1;1;
/org.eclipse.pde.ui/src/org/eclipse/pde/internal/ui/editor/plugin/rows/ResourceAttributeRow.java;2;1;4;1;4;4;4;0;10;0;0;5431;20;20;1;0;0;0;4;5431;0;6336;4;2;
/org.eclipse.jdt.ui.tests.refactoring/resources/ExtractTemp/canExtract/A_test74_in.java;1;0;1;1;0;0;0;1;0;0;1;1569;0;0;1;0;0;1;1;1569;0;1569;1;1;
/org.eclipse.jdt.ui.tests.refactoring/resources/Paste/testPastingTypedResources1/in/A.java;1;0;1;1;0;0;0;1;0;0;1;1646;0;0;1;0;0;1;1;1646;0;1646;1;1;
/org.eclipse.core.tests.resources/src/org/eclipse/core/tests/resources/ResourceVisitorVerifier.java;1;0;1;1;1;1;1;0;101;0;0;5147;101;101;1;0;0;0;1;5147;0;5147;1;1;
/org.eclipse.pde.ui/src/org/eclipse/pde/internal/ui/editor/plugin/PackageLabelProvider.java;2;1;3;1;3;3;3;0;6;0;0;5431;6;6;1;0;0;0;3;5431;0;5880;3;2;
/org.eclipse.jdt.ui/core refactoring/org/eclipse/jdt/internal/corext/refactoring/rename/RenameMethodRefactoring.java;2;0;3;1;0;0;0;3;79;1;3;122;113;113;1;0;0;3;3;122;0;1125;3;2;
/org.eclipse.core.expressions/src/org/eclipse/core/internal/expressions/WithExpression.java;1;0;3;1;1;1;1;2;8;1;2;4108;10;10;1;0;0;2;3;4108;0;6340;3;1;
/org.eclipse.ltk.ui.refactoring/src/org/eclipse/ltk/internal/ui/refactoring/util/Strings.java;1;0;2;1;0;0;0;2;407;1;2;4965;407;407;1;0;0;2;2;4965;0;5083;2;1;
/org.eclipse.ui.workbench/Eclipse UI/org/eclipse/ui/commands/internal/AbstractContextService.java;1;0;3;1;0;0;0;3;2;2;2;772;2;2;2;1;0;3;3;772;1;956;2;1;
/org.eclipse.jdt.ui/ui/org/eclipse/jdt/internal/ui/text/spelling/engine/ISpellCheckPreferenceKeys.java;2;0;2;1;1;1;1;1;2;0;1;3930;2;2;1;0;0;1;2;3930;0;6340;2;2;
/org.eclipse.jdt.core.tests.compiler/src/org/eclipse/jdt/core/tests/compiler/regression/ExpectedProblem.java;1;0;1;1;0;0;0;1;0;0;1;1129;0;0;1;0;0;1;1;1129;0;1129;1;1;
/org.eclipse.jface/src/org/eclipse/jface/resource/URLImageDescriptor.java;3;1;3;1;2;2;2;1;14;0;1;4050;20;20;1;0;0;1;3;4050;0;6338;3;3;
/org.eclipse.ui.workbench/Eclipse UI/org/eclipse/ui/internal/commands/KeySequenceBindingDefinition.java;3;0;10;1;1;1;1;9;118;1;9;2562;214;214;1;0;0;9;10;2562;0;6338;10;3;
/org.eclipse.jdt.ui.tests.refactoring/resources/ExtractMethodWorkSpace/ExtractMethodTests/locals_in/A_test513.java;1;0;1;1;0;0;0;1;5;0;1;844;5;5;1;0;0;1;1;844;0;844;1;1;
/org.eclipse.releng.tools/src/org/eclipse/releng/tools/MapFileCompareEditorInput.java;2;1;2;1;2;2;2;0;13;0;0;5183;13;13;1;0;0;0;2;5183;0;5274;2;2;
/org.eclipse.debug.ui/ui/org/eclipse/debug/internal/ui/views/console/ConsoleViewEventHandler.java;1;0;1;1;0;0;0;1;0;0;1;1414;0;0;1;0;0;1;1;1414;0;1414;1;1;
/org.eclipse.team.cvs.core/src/org/eclipse/team/internal/ccvs/core/CVSStatus.java;2;1;5;1;2;2;2;3;2;1;3;940;7;7;1;0;0;3;5;940;0;6337;5;2;
/org.eclipse.ui.workbench/Eclipse UI/org/eclipse/ui/dialogs/ContainerSelectionDialog.java;2;0;3;1;0;0;0;3;205;1;3;107;215;215;1;0;0;3;3;107;0;2737;3;2;
/org.eclipse.jdt.ui.tests.refactoring/resources/ChangeTypeRefactoring/positive/A_testParameterType_in.java;1;0;1;1;0;0;0;1;0;0;1;2844;0;0;1;0;0;1;1;2844;0;2844;1;1;
/org.eclipse.pde.ui/src/org/eclipse/pde/internal/ui/codegen/StructuredJavaCodeGenerator.java;1;0;1;1;1;1;1;0;0;0;0;5431;0;0;1;0;0;0;1;5431;0;5431;1;1;
/org.eclipse.pde.ui/src_Forms/org/eclipse/pde/internal/ui/newparts/CheckboxTablePart.java;2;0;2;1;1;1;1;1;0;0;1;3795;0;0;1;0;0;1;2;3795;0;5431;2;2;
/org.eclipse.jface/src/org/eclipse/jface/preference/FieldEditor.java;2;2;4;2;3;2;3;1;18;0;1;1;28;28;2;0;1;1;4;6338;1;6338;3;2;
/org.eclipse.ui.workbench/Eclipse UI/org/eclipse/ui/contexts/activationservice/ICompoundContextActiviationService.java;1;0;2;1;0;0;0;2;0;1;2;3066;0;0;1;0;0;2;2;3066;0;3109;2;1;
/org.eclipse.debug.ui/ui/org/eclipse/debug/internal/ui/sourcelookup/browsers/ProjectSourceContainerDialog.java;1;0;1;1;0;0;0;1;0;0;1;3770;0;0;1;0;0;1;1;3770;0;3770;1;1;
/org.eclipse.team.ui/src/org/eclipse/team/ui/synchronize/subscriber/DirectionFilterActionGroup.java;1;0;4;1;0;0;0;4;176;1;4;3972;200;200;1;0;0;4;4;3972;0;4632;4;1;
/org.eclipse.jdt.ui.tests.refactoring/resources/InlineMethodWorkspace/TestCases/argument_in/TestLocalReferenceUnused.java;1;0;1;1;0;0;0;1;2;0;1;845;2;2;1;0;0;1;1;845;0;845;1;1;
/org.eclipse.pde.ui/src/org/eclipse/pde/internal/ui/wizards/plugin/NewPluginProjectWizard.java;3;2;14;1;10;9;10;4;180;1;4;3840;307;307;2;0;1;4;14;5204;1;6336;13;3;
/org.eclipse.ui.workbench/Eclipse UI/org/eclipse/ui/activities/IActivationService.java;1;0;2;1;0;0;0;2;0;1;2;2728;0;0;1;0;0;2;2;2728;0;2800;2;1;
/org.eclipse.jdt.core.tests.model/workspace/Formatter/test429/A_out.java;1;0;1;1;0;0;0;1;0;0;1;3478;0;0;1;0;0;1;1;3478;0;3478;1;1;
/org.eclipse.jdt.ui.tests.refactoring/resources/ExtractMethodWorkSpace/ExtractMethodTests/try_out/A_test458.java;1;0;2;1;0;0;0;2;4;1;2;130;5;5;1;0;0;2;2;130;0;844;2;1;
/org.eclipse.jdt.ui.tests.refactoring/resources/IntroduceFactory/Bugzilla/46189B/TestClass_out.java;1;0;2;1;1;1;1;1;2;0;1;2846;2;2;1;0;0;1;2;2846;0;5659;2;1;
/org.eclipse.webdav/src/kernel/org/eclipse/webdav/internal/kernel/utils/EnumerationConverter.java;1;0;2;1;2;1;2;0;46;0;0;5151;46;46;2;0;1;0;2;5151;1;5151;1;1;
/org.eclipse.text/src/org/eclipse/jface/text/DefaultLineTracker.java;1;0;1;1;1;1;1;0;18;0;0;6299;18;18;1;0;0;0;1;6299;0;6299;1;1;
/org.eclipse.ui.examples.job/src/org/eclipse/ui/examples/jobs/actions/SuspendJobManagerAction.java;2;1;4;1;4;4;4;0;15;0;0;5408;23;23;1;0;0;0;4;5408;0;5925;4;2;
/org.eclipse.jdt.core.tests.model/workspace/Converter/src/test0326/A.java;1;0;1;1;0;0;0;1;0;0;1;3714;0;0;1;0;0;1;1;3714;0;3714;1;1;
/org.eclipse.ui.workbench/Eclipse UI/org/eclipse/ui/part/DelegatingDragAdapter.java;1;0;2;1;0;0;0;2;0;0;1;173;0;0;2;1;0;2;2;173;1;173;1;1;
/org.eclipse.team.core/src/org/eclipse/team/core/subscribers/helpers/RefreshOperation.java;1;0;1;1;0;0;0;1;0;0;1;3240;0;0;1;0;0;1;1;3240;0;3240;1;1;
/org.eclipse.jface.text/src/org/eclipse/jface/text/formatter/IContentFormatterExtension.java;3;1;4;1;3;3;3;1;76;0;1;1511;102;102;1;0;0;1;4;1511;0;6357;4;3;
/org.eclipse.jdt.ui/ui/org/eclipse/jdt/internal/ui/text/comment/MultiCommentRegion.java;3;0;12;1;1;1;1;11;209;1;11;2097;386;386;1;0;0;11;12;2097;0;6340;12;3;
/org.eclipse.jdt.ui/core refactoring/org/eclipse/jdt/internal/corext/refactoring/changes/TextChange.java;3;0;20;1;0;0;0;20;573;2;18;130;1613;1613;2;2;0;20;20;1946;2;4624;18;3;
/org.eclipse.jdt.ui.tests.refactoring/resources/ExtractMethodWorkSpace/ExtractMethodTests/locals_in/A_test540.java;1;0;1;1;0;0;0;1;2;0;1;844;2;2;1;0;0;1;1;844;0;844;1;1;
/org.eclipse.jdt.core.tests.model/workspace/Converter/src/test0510/A.java;1;0;1;1;0;0;0;1;0;0;1;3714;0;0;1;0;0;1;1;3714;0;3714;1;1;
/org.eclipse.jdt.core/formatter/org/eclipse/jdt/internal/formatter/CodeFormatterParser.java;4;0;12;2;0;0;0;12;19;2;11;822;46;46;2;1;0;12;12;937;1;3611;11;4;
/org.eclipse.ui.workbench/Eclipse UI/org/eclipse/ui/internal/dialogs/ActionSetContentProvider.java;1;0;1;1;0;0;0;1;0;0;1;830;0;0;1;0;0;1;1;830;0;830;1;1;
/org.eclipse.team.webdav/src/org/eclipse/team/internal/target/subscriber/BaseResourceVariantByteStore.java;1;0;2;1;0;0;0;2;0;1;2;4259;0;0;1;0;0;2;2;4259;0;4349;2;1;
/org.eclipse.core.tools/src/org/eclipse/core/tools/DeepSize.java;1;0;1;1;1;1;1;0;0;0;0;6302;0;0;1;0;0;0;1;6302;0;6302;1;1;
/org.eclipse.jdt.core.tests.model/workspace/Converter/src/test0552/Test.java;1;0;1;1;1;1;1;0;0;0;0;5635;0;0;1;0;0;0;1;5635;0;5635;1;1;
/org.eclipse.swt/Eclipse SWT PI/gtk1x/org/eclipse/swt/internal/gtk/GdkEventExpose.java;1;0;1;1;0;0;0;1;0;0;1;2327;0;0;1;0;0;1;1;2327;0;2327;1;1;
/org.eclipse.debug.ui/ui/org/eclipse/debug/internal/ui/preferences/VariableViewsPreferencePage.java;2;0;2;1;0;0;0;2;26;1;2;689;26;26;1;0;0;2;2;689;0;996;2;2;
/org.eclipse.swt/Eclipse SWT Mozilla/common/org/eclipse/swt/internal/mozilla/nsIServiceManager.java;1;0;2;1;0;0;0;2;11;1;2;1654;11;11;1;0;0;2;2;1654;0;2568;2;1;
/org.eclipse.jdt.core.tests.model/workspace/Converter/src/javadoc/test104/TestD1.java;1;0;1;1;0;0;0;1;0;0;1;4390;0;0;1;0;0;1;1;4390;0;4390;1;1;
/org.eclipse.team.ui/src/org/eclipse/team/internal/ui/synchronize/views/DefaultLogicalView.java;1;0;1;1;0;0;0;1;0;0;1;3796;0;0;1;0;0;1;1;3796;0;3796;1;1;
/org.eclipse.jdt.ui/core extension/org/eclipse/jdt/internal/corext/dom/fragments/ASTMatchingFragmentFinder.java;2;1;3;1;3;3;3;0;6;0;0;5656;9;9;1;0;0;0;3;5656;0;6340;3;2;
/org.eclipse.jdt.ui/core refactoring/org/eclipse/jdt/internal/corext/refactoring/nls/changes/DeleteFileChange.java;3;1;7;1;4;4;4;3;32;1;3;3708;86;86;1;0;0;3;7;3708;0;6340;7;3;
/org.eclipse.pde.core/src/org/eclipse/pde/internal/core/schema/IncludedSchemaDescriptor.java;3;1;5;1;3;3;3;2;32;1;2;4203;49;49;1;0;0;2;5;4203;0;6336;5;3;
/org.eclipse.jdt.ui.tests.refactoring/resources/ExtractMethodWorkSpace/ExtractMethodTests/expression_out/A_test607.java;1;0;2;1;0;0;0;2;0;1;2;1465;0;0;1;0;0;2;2;1465;0;1474;2;1;
/org.eclipse.core.tests.runtime/src/org/eclipse/core/tests/internal/plugins/PluginResolveTest_2.java;1;0;1;1;0;0;0;1;0;0;1;3014;0;0;1;0;0;1;1;3014;0;3014;1;1;
/org.eclipse.jdt.core/dom/org/eclipse/jdt/core/dom/AnonymousClassDeclaration.java;3;0;6;1;1;1;1;5;61;1;5;3560;73;73;1;0;0;5;6;3560;0;5272;6;3;
/org.eclipse.pde.ui/src_samples/org/eclipse/pde/ui/internal/samples/SampleEditor.java;3;2;6;1;5;4;5;1;54;0;1;4523;107;107;2;0;1;1;6;5797;1;6336;5;3;
/org.eclipse.swt/Eclipse SWT PI/motif/org/eclipse/swt/internal/motif/XPropertyEvent.java;1;0;1;1;0;0;0;1;0;0;1;1450;0;0;1;0;0;1;1;1450;0;1450;1;1;
/org.eclipse.jdt.ui.tests.refactoring/resources/ExtractMethodWorkSpace/ExtractMethodTests/expression_out/A_test604.java;1;0;3;1;0;0;0;3;4;1;3;844;4;4;1;0;0;3;3;844;0;1474;3;1;
/org.eclipse.compare/compare/org/eclipse/compare/internal/TimeoutContext.java;1;0;2;1;1;1;1;1;1;0;1;1289;1;1;1;0;0;1;2;1289;0;5920;2;1;
/org.eclipse.jdt.core/codeassist/org/eclipse/jdt/internal/codeassist/complete/CompletionOnMessageSend.java;2;0;3;1;0;0;0;3;20;1;3;13;32;32;1;0;0;3;3;13;0;3560;3;2;
/org.eclipse.pde.runtime/src/org/eclipse/pde/internal/runtime/logview/OpenLogDialog.java;2;1;3;1;3;3;3;0;373;0;0;5872;379;379;1;0;0;0;3;5872;0;6336;3;2;
/org.eclipse.jdt.ui.examples.javafamily/src/org/eclipse/jdt/internal/ui/search2/SearchViewActionGroup.java;1;0;1;1;0;0;0;1;0;0;1;1033;0;0;1;0;0;1;1;1033;0;1033;1;1;
/org.eclipse.help/src/org/eclipse/help/IToc.java;1;1;5;1;3;3;3;2;25;1;2;1177;43;43;1;0;0;2;5;1177;0;6337;5;1;
/org.eclipse.core.resources/src/org/eclipse/core/internal/events/ILifecycleListener.java;1;0;1;1;1;1;1;0;4;0;0;5146;4;4;1;0;0;0;1;5146;0;5146;1;1;
/org.eclipse.debug.ui/ui/org/eclipse/debug/internal/ui/sourcelookup/SourceContainerWorkbenchAdapter.java;1;0;4;1;0;0;0;4;9;1;4;4627;26;26;1;0;0;4;4;4627;0;4949;4;1;
/org.eclipse.jdt.core.tests.model/workspace/Converter/test0127/Test.java;1;0;1;1;0;0;0;1;0;0;1;3714;0;0;1;0;0;1;1;3714;0;3714;1;1;
/org.eclipse.jdt.core.tests.model/workspace/Formatter/test423/A_out.java;1;0;1;1;0;0;0;1;0;0;1;3478;0;0;1;0;0;1;1;3478;0;3478;1;1;
/org.eclipse.jdt.ui/ui/org/eclipse/jdt/ui/text/spelling/engine/IPhoneticHashProvider.java;1;0;2;1;0;0;0;2;0;1;2;3829;0;0;1;0;0;2;2;3829;0;3930;2;1;
/org.eclipse.ui.workbench/Eclipse UI/org/eclipse/ui/commands/IKeyConfigurationListener.java;3;1;6;1;2;2;2;4;20;2;3;1435;52;52;2;1;0;4;6;2562;1;6338;5;3;
/org.eclipse.jdt.core.tests.model/workspace/Converter/test0060/Test.java;1;0;1;1;0;0;0;1;0;0;1;3714;0;0;1;0;0;1;1;3714;0;3714;1;1;
/org.eclipse.jdt.core.tests.model/workspace/Formatter/test377/A_in.java;1;0;2;1;0;0;0;2;1;1;2;3146;1;1;1;0;0;2;2;3146;0;3172;2;1;
/org.eclipse.pde.ui/templates/popupMenus/java/$actionClass$.java;1;0;1;1;0;0;0;1;10;0;1;851;10;10;1;0;0;1;1;851;0;851;1;1;
/org.eclipse.jdt.ui/ui/org/eclipse/jdt/internal/ui/preferences/MembersOrderPreferenceCache.java;2;0;2;1;1;1;1;1;110;0;1;3708;112;112;1;0;0;1;2;3708;0;6340;2;2;
/org.eclipse.jdt.ui/core extension/org/eclipse/jdt/internal/corext/template/TemplatePosition.java;1;0;1;1;0;0;0;1;0;0;1;4258;0;0;1;0;0;1;1;4258;0;4258;1;1;
/org.eclipse.jdt.ui.tests.refactoring/resources/IntroduceFactory/positive/MultiUnit1B_FFF_out.java;1;0;2;1;1;1;1;1;2;0;1;2862;2;2;1;0;0;1;2;2862;0;5659;2;1;
/org.eclipse.jdt.ui.tests.refactoring/resources/Delete/testDeleteWithinCu10/in/A.java;1;0;1;1;0;0;0;1;0;0;1;442;0;0;1;0;0;1;1;442;0;442;1;1;
/org.eclipse.jdt.ui.tests.refactoring/resources/DeleteSourceReference/test4/in/A.java;1;0;1;1;0;0;0;1;0;0;1;1652;0;0;1;0;0;1;1;1652;0;1652;1;1;
/org.eclipse.jdt.core.tests.model/workspace/Formatter/test289/A_in.java;1;0;1;1;0;0;0;1;0;0;1;2444;0;0;1;0;0;1;1;2444;0;2444;1;1;
/org.eclipse.ui.ide/src/org/eclipse/ui/views/markers/internal/TableContentProvider.java;4;1;10;1;4;4;4;6;405;1;6;2208;559;559;1;0;0;6;10;2208;0;6338;10;4;
/org.eclipse.jdt.ui/ui refactoring/org/eclipse/jdt/internal/ui/refactoring/reorg/ReorgMoveWizard.java;4;2;15;1;6;5;6;9;75;1;9;1114;245;245;2;0;1;9;15;6013;1;6340;14;4;
/org.eclipse.ui.externaltools/Ant Tools Support/org/eclipse/ui/externaltools/internal/ant/view/AntProjectContentProvider.java;1;0;1;1;0;0;0;1;0;0;1;282;0;0;1;0;0;1;1;282;0;282;1;1;
/org.eclipse.jdt.ui.tests.refactoring/resources/ExtractInterface/test98/in/Bar.java;1;0;1;1;0;0;0;1;0;0;1;1571;0;0;1;0;0;1;1;1571;0;1571;1;1;
/org.eclipse.ui.workbench/Eclipse UI/org/eclipse/ui/internal/dialogs/PreferenceImportExportWizard.java;4;1;6;1;3;3;3;3;243;1;3;3636;468;468;1;0;0;3;6;3636;0;6338;6;4;
/org.eclipse.ui.workbench/Eclipse UI/org/eclipse/ui/internal/roles/api/IContextBinding.java;1;0;2;1;0;0;0;2;0;0;1;2202;0;0;2;1;0;2;2;2202;1;2202;1;1;
/org.eclipse.search/new search/org/eclipse/search/ui/SearchResultEvent.java;3;1;9;1;4;4;4;5;46;2;4;3474;113;113;2;1;0;5;9;4842;1;6340;8;3;
/org.eclipse.swt.tests/JUnit Tests/org/eclipse/swt/tests/junit/Test_org_eclipse_swt_widgets_TreeItem.java;2;0;3;1;0;0;0;3;60;1;3;2123;85;85;1;0;0;3;3;2123;0;2824;3;2;
/org.eclipse.search/new search/org/eclipse/search2/internal/ui/ExtensionService.java;1;0;2;1;0;0;0;2;0;1;2;3474;0;0;1;0;0;2;2;3474;0;4461;2;1;
/org.eclipse.jdt.core/model/org/eclipse/jdt/core/NamingConventions.java;3;0;6;1;0;0;0;6;142;1;6;27;225;225;1;0;0;6;6;27;0;3560;6;3;
/org.eclipse.ui.workbench/Eclipse UI/org/eclipse/ui/activities/NotDefinedException.java;3;1;7;1;2;2;2;5;19;1;5;2532;54;54;1;0;0;5;7;2532;0;6338;7;3;
/org.eclipse.swt/Eclipse SWT/gtk/org/eclipse/swt/graphics/Font.java;4;0;6;2;1;1;1;5;12;3;3;1243;20;20;3;2;0;5;6;4128;2;6352;4;4;
/org.eclipse.team.ui/src/org/eclipse/team/ui/sync/SyncInfoSet.java;2;0;4;1;0;0;0;4;4;2;3;1132;6;6;2;1;0;4;4;1132;1;2632;3;2;
/org.eclipse.jdt.core.tests.model/workspace/Formatter/test403/A_out.java;1;0;1;1;0;0;0;1;0;0;1;3438;0;0;1;0;0;1;1;3438;0;3438;1;1;
/org.eclipse.swt/Eclipse SWT PI/gtk/org/eclipse/swt/internal/gtk/GdkEventVisibility.java;2;1;2;1;2;2;2;0;2;0;0;6107;2;2;1;0;0;0;2;6107;0;6352;2;2;
/org.eclipse.swt/Eclipse SWT/win32/org/eclipse/swt/widgets/Composite.java;7;2;28;2;5;4;5;23;157;2;21;33;462;462;2;2;1;23;28;4174;3;6352;25;7;
/org.eclipse.ui.externaltools/Ant Tools Support/org/eclipse/ui/externaltools/internal/ant/view/AntViewLabelProvider.java;1;0;2;1;0;0;0;2;25;1;2;138;25;25;1;0;0;2;2;138;0;282;2;1;
/org.eclipse.jdt.core.tests.model/workspace/Converter/test0205/Test.java;1;0;1;1;0;0;0;1;0;0;1;3714;0;0;1;0;0;1;1;3714;0;3714;1;1;
/org.eclipse.core.runtime/src/org/eclipse/core/internal/plugins/RegistryDependencySystemHelper.java;2;0;2;1;0;0;0;2;0;1;2;2105;0;0;1;0;0;2;2;2105;0;3013;2;2;
/org.eclipse.jdt.ui/core refactoring/org/eclipse/jdt/internal/corext/refactoring/util/RefactoringFileBuffers.java;1;0;2;1;1;1;1;1;4;0;1;4692;4;4;1;0;0;1;2;4692;0;6260;2;1;
/org.eclipse.ant.ui/Ant Editor/org/eclipse/ant/internal/ui/editor/text/XMLTextHover.java;2;1;14;1;4;4;4;10;137;2;9;1811;327;327;2;1;0;10;14;4052;1;5520;13;2;
/org.eclipse.jdt.ui/ui/org/eclipse/jdt/internal/ui/search/JavaSearchResultCollector.java;2;1;6;1;2;2;2;4;32;1;4;1350;46;46;1;0;0;4;6;1350;0;6340;6;2;
/org.eclipse.ant.ui/Ant Tools Support/org/eclipse/ui/ant/internal/views/actions/RemoveAllAction.java;1;0;2;1;0;0;0;2;0;1;2;250;0;0;1;0;0;2;2;250;0;263;2;1;
/org.eclipse.ui.workbench/Eclipse UI/org/eclipse/ui/progress/IDeferredWorkbenchAdapter.java;2;2;8;1;5;4;5;3;11;2;2;1061;30;30;2;1;1;3;8;1983;2;6338;6;2;
/org.eclipse.sdk.tests-feature/plugins/org.eclipse.perfmsr.ui.client/src/org/eclipse/perfmsr/ui/client/VariationsPreferencePage.java;1;1;3;1;3;3;3;0;10;0;0;5443;12;12;1;0;0;0;3;5443;0;6150;3;1;
/org.eclipse.jdt.ui/ui/org/eclipse/jdt/internal/ui/text/DocumentCharacterIterator.java;2;1;2;1;2;2;2;0;8;0;0;6072;8;8;1;0;0;0;2;6072;0;6340;2;2;
/org.eclipse.pde.core/srcnew/org/eclipse/pde/internal/core/plugin/IDocumentModelListener.java;1;0;1;1;1;1;1;0;0;0;0;5431;0;0;1;0;0;0;1;5431;0;5431;1;1;
/org.eclipse.text/src/org/eclipse/jface/text/templates/TemplateContextType.java;3;1;3;1;3;3;3;0;28;0;0;5177;30;30;1;0;0;0;3;5177;0;6340;3;3;
/org.eclipse.pde.core/src/org/eclipse/pde/internal/core/site/Site.java;2;1;3;1;2;2;2;1;26;0;1;4203;35;35;1;0;0;1;3;4203;0;6336;3;2;
/org.eclipse.jdt.ui/ui/org/eclipse/jdt/internal/ui/text/javadoc/JavaDocScanner.java;6;1;11;1;4;4;4;7;46;1;7;1336;125;125;1;0;0;7;11;1336;0;6340;11;6;
/org.eclipse.debug.ui/ui/org/eclipse/debug/internal/ui/sourcelookup/SourceLookupUIUtils.java;2;0;5;1;2;1;2;3;14;1;3;3770;20;20;2;0;1;3;5;5475;1;5475;4;2;
/org.eclipse.ui.cheatsheets/src/org/eclipse/ui/internal/cheatsheets/views/CoreItem.java;2;2;22;2;13;12;13;9;351;2;7;4428;1603;1603;2;2;1;9;22;4625;3;6321;19;2;
/org.eclipse.jdt.core/model/org/eclipse/jdt/internal/core/jdom/DOMImport.java;2;1;4;1;2;2;2;2;25;1;2;3560;41;41;1;0;0;2;4;3560;0;5916;4;2;
/org.eclipse.ant.ui/Ant Tools Support/org/eclipse/ui/ant/internal/views/actions/EditorImageDescriptor.java;1;0;2;1;0;0;0;2;0;1;2;250;0;0;1;0;0;2;2;250;0;263;2;1;
/org.eclipse.pde.ui/src/org/eclipse/pde/internal/ui/launcher/PluginPathDialog.java;1;0;1;1;1;1;1;0;0;0;0;6047;0;0;1;0;0;0;1;6047;0;6047;1;1;
/org.eclipse.ui.workbench/Eclipse UI/org/eclipse/ui/wizards/datatransfer/MinimizedFileSystemElement.java;1;0;1;1;0;0;0;1;0;0;1;2737;0;0;1;0;0;1;1;2737;0;2737;1;1;
/org.eclipse.ui.tests/Eclipse UI Tests/org/eclipse/ui/tests/dialogs/UIPreferencesAuto.java;2;0;2;1;0;0;0;2;5;1;2;2007;7;7;1;0;0;2;2;2007;0;2738;2;2;
/org.eclipse.jdt.ui.tests.refactoring/test cases/org/eclipse/jdt/ui/tests/refactoring/infra/MockSelectionProvider.java;1;0;1;1;0;0;0;1;0;0;1;469;0;0;1;0;0;1;1;469;0;469;1;1;
/org.eclipse.jdt.ui.tests.refactoring/resources/Copy/test_inner_type_yes_cu/out/A.java;1;0;1;1;0;0;0;1;0;0;1;1009;0;0;1;0;0;1;1;1009;0;1009;1;1;
/org.eclipse.core.resources.win32/src/org/eclipse/core/internal/resources/refresh/win32/Convert.java;1;0;2;1;0;0;0;2;22;1;2;3695;22;22;1;0;0;2;2;3695;0;4925;2;1;
/org.eclipse.ui.externaltools/Ant Tools Support/org/eclipse/ui/externaltools/internal/ant/preferences/AntClasspathBlock.java;1;0;2;1;0;0;0;2;4;1;2;245;4;4;1;0;0;2;2;245;0;282;2;1;
/org.eclipse.update.ui.win32/src/org/eclipse/welcome/internal/portal/WelcomePortalForm.java;1;0;3;1;0;0;0;3;38;2;2;912;38;38;2;1;0;3;3;925;1;925;2;1;
/org.eclipse.debug.core/core/org/eclipse/debug/core/variables/SimpleLaunchVariable.java;2;0;5;1;0;0;0;5;14;2;4;550;30;30;2;1;0;5;5;845;1;845;4;2;
/org.eclipse.jdt.ui/core refactoring/org/eclipse/jdt/internal/corext/refactoring/participants/NatureExpression.java;1;0;5;1;0;0;0;5;11;1;5;825;22;22;1;0;0;5;5;825;0;2682;5;1;
/org.eclipse.help/src/org/eclipse/help/internal/toc/Link.java;1;1;4;1;3;3;3;1;12;0;1;3513;25;25;1;0;0;1;4;3513;0;6337;4;1;
/org.eclipse.jdt.ui/ui/org/eclipse/jdt/internal/ui/text/spelling/WordIgnoreProposal.java;2;0;2;1;1;1;1;1;2;0;1;3930;2;2;1;0;0;1;2;3930;0;6340;2;2;
/org.eclipse.ui.ide/src/org/eclipse/ui/internal/ide/dialogs/ProjectCapabilityPropertyPage.java;1;0;1;1;0;0;0;1;0;0;1;2264;0;0;1;0;0;1;1;2264;0;2264;1;1;
/org.eclipse.swt.tests/JUnit Tests/org/eclipse/swt/tests/junit/Test_org_eclipse_swt_widgets_Tree.java;4;0;9;1;1;1;1;8;206;1;8;2123;403;403;1;0;0;8;9;2123;0;6352;9;4;
/org.eclipse.team.core/src/org/eclipse/team/internal/core/subscribers/SyncInfoStatistics.java;1;0;3;1;1;1;1;2;107;1;2;3550;111;111;1;0;0;2;3;3550;0;6336;3;1;
/org.eclipse.ui.workbench/Eclipse UI/org/eclipse/ui/internal/commands/api/IKeyConfigurationDefinition.java;1;0;4;1;0;0;0;4;0;2;3;1724;0;0;2;1;0;4;4;2515;1;2532;3;1;
/org.eclipse.ui.externaltools/Ant Editor/org/eclipse/ui/externaltools/internal/ant/dtd/util/IKeyHolder.java;1;0;1;1;0;0;0;1;0;0;1;282;0;0;1;0;0;1;1;282;0;282;1;1;
/org.eclipse.team.ui/src/org/eclipse/team/ui/sync/ISynchronizeTargetManager.java;1;0;1;1;0;0;0;1;0;0;1;2378;0;0;1;0;0;1;1;2378;0;2378;1;1;
/org.eclipse.jdt.ui/core refactoring/org/eclipse/ltk/core/refactoring/UndoTextFileChange.java;1;0;2;1;0;0;0;2;0;1;2;4624;0;0;1;0;0;2;2;4624;0;4864;2;1;
/org.eclipse.update.tests.core/src/org/eclipse/update/tests/parser/TestNewSiteParse.java;1;0;1;1;0;0;0;1;0;0;1;2688;0;0;1;0;0;1;1;2688;0;2688;1;1;
/org.eclipse.jdt.ui/ui/org/eclipse/jdt/internal/ui/text/java/hover/JavaProblemHover.java;1;0;1;1;0;0;0;1;0;0;1;1705;0;0;1;0;0;1;1;1705;0;1705;1;1;
/org.eclipse.jdt.core.tests.model/src/org/eclipse/jdt/core/tests/model/FactoryTests.java;2;0;4;1;0;0;0;4;20;1;4;78;26;26;1;0;0;4;4;78;0;3560;4;2;
/org.eclipse.team.ui/src/org/eclipse/team/ui/sync/ISynchronizeViewNode.java;1;0;2;1;0;0;0;2;0;1;2;1477;0;0;1;0;0;2;2;1477;0;2632;2;1;
/org.eclipse.ui.workbench/Eclipse UI/org/eclipse/ui/wizards/datatransfer/WizardFileSystemImportPage1.java;2;0;2;1;0;0;0;2;2;1;2;1080;2;2;1;0;0;2;2;1080;0;2737;2;2;
/org.eclipse.core.tests.runtime/src/org/eclipse/core/tests/internal/plugins/ExtensiveFragmentTest.java;1;0;1;1;0;0;0;1;0;0;1;3014;0;0;1;0;0;1;1;3014;0;3014;1;1;
/org.eclipse.swt/Eclipse SWT Mozilla/common/org/eclipse/swt/internal/mozilla/nsIProperties.java;1;0;2;1;0;0;0;2;4;1;2;1654;4;4;1;0;0;2;2;1654;0;2568;2;1;
/org.eclipse.jdt.debug.ui/ui/org/eclipse/jdt/internal/debug/core/refactoring/LaunchConfigurationProjectNameChange.java;3;0;10;1;1;1;1;9;56;2;8;3750;104;104;2;1;0;9;10;4498;1;5515;9;3;
/org.eclipse.jdt.core/compiler/org/eclipse/jdt/internal/compiler/lookup/Binding.java;1;0;1;1;0;0;0;1;2;0;1;3560;2;2;1;0;0;1;1;3560;0;3560;1;1;
/org.eclipse.ui.ide/src/org/eclipse/ui/views/markers/internal/MarkerType.java;1;0;1;1;0;0;0;1;0;0;1;2208;0;0;1;0;0;1;1;2208;0;2208;1;1;
/org.eclipse.ui.workbench/Eclipse UI/org/eclipse/ui/internal/commands/api/XICommand.java;1;0;4;1;0;0;0;4;0;2;3;1724;0;0;2;1;0;4;4;2515;1;2532;3;1;
/org.eclipse.jdt.ui/ui/org/eclipse/jdt/internal/ui/wizards/dialogfields/IListAdapter.java;1;0;1;1;1;1;1;0;2;0;0;6340;2;2;1;0;0;0;1;6340;0;6340;1;1;
/org.eclipse.osgi/core/adaptor/org/eclipse/osgi/framework/util/Tokenizer.java;4;1;5;1;2;2;2;3;296;1;3;3013;310;310;1;0;0;3;5;3013;0;6337;5;4;
/org.eclipse.jdt.core/dom/org/eclipse/jdt/core/dom/EmptyStatement.java;3;0;6;1;1;1;1;5;36;1;5;3560;48;48;1;0;0;5;6;3560;0;5272;6;3;
/org.eclipse.debug.ui/ui/org/eclipse/debug/internal/ui/actions/IToggleBreakpointsTarget.java;1;0;3;1;0;0;0;3;47;2;2;4471;47;47;2;1;0;3;3;4492;1;4492;2;1;
/org.eclipse.team.webdav/src/org/eclipse/team/internal/target/subscriber/ITeamOperations.java;2;0;3;1;0;0;0;3;304;1;3;3494;304;304;1;0;0;3;3;3494;0;4349;3;2;
/org.eclipse.jdt.ui/ui/org/eclipse/jdt/internal/ui/javaeditor/IClassFileEditorInput.java;1;0;1;1;1;1;1;0;2;0;0;6340;2;2;1;0;0;0;1;6340;0;6340;1;1;
/org.eclipse.pde.ui/sandbox/org/eclipse/pde/internal/ui/editor/standalone/feature/FeatureSourceContentProvider.java;1;0;2;1;0;0;0;2;0;1;2;2320;0;0;1;0;0;2;2;2320;0;2906;2;1;
/org.eclipse.pde.runtime/src/org/eclipse/pde/internal/runtime/registry/TogglePropertiesAction.java;2;1;5;1;2;2;2;3;18;1;3;4256;30;30;1;0;0;3;5;4256;0;6336;5;2;
/org.eclipse.jdt.ui/ui/org/eclipse/jdt/internal/ui/reorg/CopySourceReferencesToClipboardAction.java;1;0;2;1;0;0;0;2;4;1;2;490;4;4;1;0;0;2;2;490;0;1111;2;1;
/org.eclipse.jdt.core.tests.model/workspace/Formatter/test196/A_out.java;1;0;1;1;0;0;0;1;0;0;1;2424;0;0;1;0;0;1;1;2424;0;2424;1;1;
/org.eclipse.sdk.tests-feature/plugins/org.eclipse.perfmsr.ui/src/org/eclipse/perfmsr/ui/ForgivingFieldEditor.java;2;0;2;1;1;1;1;1;10;0;1;4845;10;10;1;0;0;1;2;4845;0;6342;2;2;
/org.eclipse.ui.workbench.texteditor/src/org/eclipse/ui/internal/texteditor/quickdiff/QuickDiffExtensionsRegistry.java;1;1;3;1;3;3;3;0;7;0;0;5360;13;13;1;0;0;0;3;5360;0;6340;3;1;
/org.eclipse.team.ui/src/org/eclipse/team/ui/synchronize/actions/SyncViewerShowPreferencesAction.java;1;0;1;1;0;0;0;1;0;0;1;2535;0;0;1;0;0;1;1;2535;0;2535;1;1;
/org.eclipse.jdt.ui/ui/org/eclipse/jdt/internal/ui/preferences/OverlayPreferenceStore.java;2;1;3;1;2;2;2;1;34;0;1;1336;42;42;1;0;0;1;3;1336;0;6340;3;2;
/org.eclipse.ant.ui/Ant Editor/org/eclipse/ant/internal/ui/editor/model/AntPropertyNode.java;1;1;10;1;2;2;2;8;29;2;6;3661;108;108;2;2;0;8;10;3717;2;5920;8;1;
/org.eclipse.help.base/src/org/eclipse/help/internal/workingset/AdaptableToc.java;1;1;4;1;3;3;3;1;13;0;1;1740;21;21;1;0;0;1;4;1740;0;6337;4;1;
/org.eclipse.help.tests/src/org/eclipse/help/tests/webapp/TestSearch.java;1;1;3;1;2;2;2;1;179;0;1;2732;199;199;1;0;0;1;3;2732;0;6337;3;1;
/org.eclipse.ui.workbench/Eclipse UI/org/eclipse/ui/internal/commands/CommandManagerEvent.java;1;0;10;1;0;0;0;10;78;3;7;1222;120;120;3;3;0;10;10;2562;3;2823;7;1;
/org.eclipse.jdt.ui.tests.refactoring/resources/ExtractMethodWorkSpace/ExtractMethodTests/validSelection_out/A_test363.java;1;0;1;1;0;0;0;1;1;0;1;130;1;1;1;0;0;1;1;130;0;130;1;1;
/org.eclipse.jdt.core.tests.model/workspace/Converter/test0247/Test.java;1;0;1;1;0;0;0;1;0;0;1;3714;0;0;1;0;0;1;1;3714;0;3714;1;1;
/org.eclipse.text/src/org/eclipse/jface/text/ChildDocumentManager.java;3;0;6;1;1;1;1;5;65;1;5;1347;85;85;1;0;0;5;6;1347;0;5177;6;3;
/org.eclipse.ui.workbench/Eclipse UI/org/eclipse/ui/internal/commands/CommandEvent.java;1;0;8;1;0;0;0;8;64;2;7;1222;92;92;2;1;0;8;8;2562;1;2823;7;1;
/org.eclipse.jdt.ui.tests.refactoring/resources/ChangeTypeRefactoring/positive/A_testLocalVarUse_out.java;1;0;1;1;0;0;0;1;0;0;1;2844;0;0;1;0;0;1;1;2844;0;2844;1;1;
/org.eclipse.jdt.ui/ui refactoring/org/eclipse/jdt/internal/ui/refactoring/SourceContextViewer.java;1;0;4;1;0;0;0;4;103;1;4;882;126;126;1;0;0;4;4;882;0;3536;4;1;
/org.eclipse.pde.ui/sandbox/org/eclipse/pde/internal/ui/editor/standalone/PDEEditorPage.java;1;0;2;1;0;0;0;2;0;1;2;2320;0;0;1;0;0;2;2;2320;0;2906;2;1;
/org.eclipse.ui.workbench/Eclipse UI/org/eclipse/ui/internal/chris/roles/ContextBindingDefinition.java;1;0;4;1;0;0;0;4;2;2;3;1961;4;4;2;1;0;4;4;2207;1;2207;3;1;
/org.eclipse.ui.workbench/Eclipse UI/org/eclipse/ui/internal/commands/api/XPropertyEvent.java;1;0;6;1;0;0;0;6;2;2;5;1724;3;3;2;1;0;6;6;2515;1;2532;5;1;
/org.eclipse.swt/Eclipse SWT Drag and Drop/gtk/org/eclipse/swt/dnd/TreeDragUnderEffect.java;4;1;6;1;2;2;2;4;63;1;4;728;117;117;1;0;0;4;6;728;0;6352;6;4;
/org.eclipse.ui.workbench/Eclipse UI/org/eclipse/ui/internal/roles/RoleManagerEvent.java;1;0;2;1;0;0;0;2;0;1;2;2444;0;0;1;0;0;2;2;2444;0;2805;2;1;
/org.eclipse.debug.core/core/org/eclipse/debug/internal/core/sourcelookup/containers/ProjectSourceContainer.java;1;0;5;1;0;0;0;5;48;1;5;3678;79;79;1;0;0;5;5;3678;0;4949;5;1;
/org.eclipse.jdt.ui.examples.javafamily/src/org/eclipse/jdt/internal/ui/search2/JavaSearchPage2.java;2;0;5;1;1;1;1;4;7;1;4;1033;19;19;1;0;0;4;5;1033;0;5549;5;2;
/org.eclipse.jdt.ui.tests.refactoring/resources/IntroduceFactory/Bugzilla/48504/p1/A.java;1;1;2;1;2;2;2;0;2;0;0;5629;2;2;1;0;0;0;2;5629;0;5659;2;1;
/org.eclipse.jdt.debug.ui/ui/org/eclipse/jdt/internal/debug/ui/classpath/RuntimeClasspathViewer.java;3;1;6;1;2;2;2;4;37;1;4;2691;95;95;1;0;0;4;6;2691;0;6336;6;3;
/org.eclipse.ui.forms.examples/src/org/eclipse/ui/forms/examples/internal/rcp/PageWithSubPages.java;1;0;4;1;1;1;1;3;21;1;3;4075;25;25;1;0;0;3;4;4075;0;5781;4;1;
/org.eclipse.jdt.ui/ui/org/eclipse/jdt/ui/actions/NavigateActionGroup.java;1;0;1;1;1;1;1;0;2;0;0;6340;2;2;1;0;0;0;1;6340;0;6340;1;1;
/org.eclipse.jdt.ui.tests.refactoring/resources/DeleteSourceReference/test18/out/A.java;1;0;1;1;0;0;0;1;0;0;1;1652;0;0;1;0;0;1;1;1652;0;1652;1;1;
/org.eclipse.pde.ui/templates_3.0/editor/java/XMLConfiguration.java;1;0;1;1;0;0;0;1;0;0;1;2786;0;0;1;0;0;1;1;2786;0;2786;1;1;
/org.eclipse.update.tests.core/src/org/eclipse/update/tests/standalone/TestFeatureInstall.java;2;0;7;1;1;1;1;6;75;1;6;2463;87;87;1;0;0;6;7;2463;0;6336;7;2;
/org.eclipse.ui.cheatsheets/src/org/eclipse/ui/internal/cheatsheets/actions/CheatSheetHelpMenuAction.java;1;0;1;1;1;1;1;0;0;0;0;5738;0;0;1;0;0;0;1;5738;0;5738;1;1;
/org.eclipse.core.tests.runtime/src/org/eclipse/core/tests/runtime/content/LazyInputStreamTest.java;2;1;2;2;2;2;2;0;40;0;0;6225;79;79;1;0;0;0;2;6225;0;6317;2;2;
/org.eclipse.update.ui.forms/Eclipse Forms/org/eclipse/ui/forms/parts/SectionPart.java;1;0;3;1;0;0;0;3;1;2;2;3096;1;1;2;1;0;3;3;3096;1;3138;2;1;
/org.eclipse.swt.tests/JUnit Tests/org/eclipse/swt/tests/junit/Test_org_eclipse_swt_ole_win32_OleAutomation.java;1;0;1;1;0;0;0;1;0;0;1;2176;0;0;1;0;0;1;1;2176;0;2176;1;1;
/org.eclipse.swt.tests/JUnit Tests/org/eclipse/swt/tests/junit/Test_org_eclipse_swt_events_FocusListener.java;1;0;1;1;0;0;0;1;16;0;1;2175;16;16;1;0;0;1;1;2175;0;2175;1;1;
/org.eclipse.pde.ui/src/org/eclipse/pde/internal/ui/editor/PDEFormPage.java;3;1;8;1;7;7;7;1;315;0;1;3186;384;384;1;0;0;1;8;3186;0;6336;8;3;
/org.eclipse.ui.cheatsheets/src/org/eclipse/ui/internal/cheatsheets/views/CheatSheetManager.java;2;1;14;2;6;6;6;8;203;4;5;4428;599;599;4;3;0;8;14;4625;3;5976;11;2;
/org.eclipse.ltk.ui.refactoring/src/org/eclipse/ltk/ui/refactoring/TextContextViewer.java;1;0;2;1;0;0;0;2;0;1;2;4965;0;0;1;0;0;2;2;4965;0;5052;2;1;
/org.eclipse.ui.workbench/Eclipse UI/org/eclipse/ui/commands/internal/AbstractActionService.java;1;0;3;1;0;0;0;3;2;2;2;772;2;2;2;1;0;3;3;772;1;956;2;1;
/org.eclipse.team.core/src/org/eclipse/team/core/subscribers/SelectionSyncInfoSet.java;1;0;1;1;0;0;0;1;0;0;1;3882;0;0;1;0;0;1;1;3882;0;3882;1;1;
/org.eclipse.ui.tests/Eclipse UI Tests/org/eclipse/ui/tests/keys/Bug42035Test.java;3;0;6;1;1;1;1;5;10;1;5;2334;22;22;1;0;0;5;6;2334;0;6338;6;3;
/org.eclipse.update.core/src/org/eclipse/update/internal/core/Volume.java;2;1;3;1;2;2;2;1;6;0;1;890;13;13;1;0;0;1;3;890;0;6336;3;2;
/org.eclipse.jdt.core/model/org/eclipse/jdt/core/util/IInnerClassesAttributeEntry.java;1;0;1;1;0;0;0;1;2;0;1;3560;2;2;1;0;0;1;1;3560;0;3560;1;1;
/org.eclipse.jdt.core.tests.model/workspace/Formatter/test472/A_out.java;1;0;1;1;0;0;0;1;0;0;1;3977;0;0;1;0;0;1;1;3977;0;3977;1;1;
/org.eclipse.jdt.core.tests.model/workspace/Formatter/test452/A_in.java;1;0;1;1;0;0;0;1;0;0;1;3743;0;0;1;0;0;1;1;3743;0;3743;1;1;
/org.eclipse.jdt.core.tests.model/workspace/Converter/src/test0304/Test.java;1;0;1;1;0;0;0;1;0;0;1;3714;0;0;1;0;0;1;1;3714;0;3714;1;1;
/org.eclipse.update.tests.core/src/org/eclipse/update/tests/standalone/AllStandaloneTests.java;2;0;6;1;1;1;1;5;5;2;4;2463;14;14;2;1;0;5;6;2521;1;6336;5;2;
/org.eclipse.webdav/src/interface/org/eclipse/webdav/dom/Assert.java;1;0;1;1;1;1;1;0;67;0;0;5151;67;67;1;0;0;0;1;5151;0;5151;1;1;
/org.eclipse.jdt.ui/ui/org/eclipse/jdt/internal/ui/search/SearchPatternData.java;1;0;3;1;0;0;0;3;98;1;3;3488;98;98;1;0;0;3;3;3488;0;4625;3;1;
/org.eclipse.jdt.core.tests.model/workspace/Formatter/test186/A_in.java;1;0;1;1;0;0;0;1;0;0;1;2425;0;0;1;0;0;1;1;2425;0;2425;1;1;
/org.eclipse.jdt.core.tests.model/workspace/Converter/src/test0261/Test.java;1;0;1;1;0;0;0;1;0;0;1;3714;0;0;1;0;0;1;1;3714;0;3714;1;1;
/org.eclipse.core.tests.runtime/src/org/eclipse/core/tests/runtime/jobs/JobTest.java;2;1;24;1;4;4;4;20;1203;2;18;2160;3079;3079;2;2;0;20;24;2310;2;5738;22;2;
/org.eclipse.pde.ui/src/org/eclipse/pde/internal/ui/editor/plugin/ExtensionPointsPage.java;2;1;4;1;4;4;4;0;10;0;0;5431;19;19;1;0;0;0;4;5431;0;6366;4;2;
/org.eclipse.ui.views/src/org/eclipse/ui/views/markers/internal/BookmarkFilter.java;2;0;2;1;0;0;0;2;0;1;2;755;0;0;1;0;0;2;2;755;0;2738;2;2;
/org.eclipse.jdt.core.tests.model/workspace/Formatter/test262/A_in.java;1;0;1;1;0;0;0;1;0;0;1;2442;0;0;1;0;0;1;1;2442;0;2442;1;1;
/org.eclipse.core.runtime/src/org/eclipse/core/runtime/IPlatformRunnable.java;3;1;6;1;3;3;3;3;8;1;3;3197;21;21;1;0;0;3;6;3197;0;6340;6;3;
/org.eclipse.core.resources/src/org/eclipse/core/internal/utils/KeyedHashSet.java;2;1;3;1;3;3;3;0;10;0;0;5445;12;12;1;0;0;0;3;5445;0;6340;3;2;
/org.eclipse.jdt.ui/ui/org/eclipse/jdt/internal/ui/javaeditor/DocumentAdapter.java;2;0;5;1;1;1;1;4;284;2;3;1350;399;399;2;1;0;4;5;1582;1;6340;4;2;
/org.eclipse.jdt.ui/core refactoring/org/eclipse/jdt/internal/corext/refactoring/typeconstraints/NullContext.java;2;0;2;1;1;1;1;1;2;0;1;3710;2;2;1;0;0;1;2;3710;0;6340;2;2;
/org.eclipse.ui.externaltools/Ant Tools Support/org/eclipse/ui/externaltools/internal/ant/preferences/AntEditorPreferencePage.java;2;0;6;1;0;0;0;6;236;2;5;33;344;344;2;1;0;6;6;178;1;282;5;2;
/org.eclipse.jdt.ui/ui/org/eclipse/jdt/internal/ui/text/template/TemplateInformationControlCreator.java;2;0;2;1;0;0;0;2;0;1;2;787;0;0;1;0;0;2;2;787;0;4258;2;2;
/org.eclipse.core.tests.runtime/src/org/eclipse/core/tests/internal/plugins/FragmentResolveTest_2.java;1;0;1;1;0;0;0;1;0;0;1;3014;0;0;1;0;0;1;1;3014;0;3014;1;1;
/org.eclipse.jdt.core.tests.model/workspace/Converter/src/test0273/Test.java;1;0;1;1;0;0;0;1;0;0;1;3714;0;0;1;0;0;1;1;3714;0;3714;1;1;
/org.eclipse.jdt.ui/core refactoring/org/eclipse/jdt/internal/corext/refactoring/participants/DeleteExtensionManager.java;1;0;6;1;0;0;0;6;18;1;6;1125;33;33;1;0;0;6;6;1125;0;4624;6;1;
/org.eclipse.osgi/core/framework/org/eclipse/osgi/framework/eventmgr/ElementList.java;1;0;2;1;1;1;1;1;0;0;1;5097;0;0;1;0;0;1;2;5097;0;5646;2;1;
/org.eclipse.jdt.ui/ui/org/eclipse/jdt/internal/ui/search/JavaSearchResultLabelProvider.java;4;1;6;1;3;3;3;3;27;1;3;3266;55;55;1;0;0;3;6;3266;0;6340;6;4;
/org.eclipse.jdt.launching/launching/org/eclipse/jdt/internal/launching/JavaSourceLookupDirector.java;1;0;7;1;0;0;0;7;29;2;6;4109;70;70;2;1;0;7;7;4949;1;4971;6;1;
/org.eclipse.text/src/org/eclipse/jface/text/link/LinkedPosition.java;2;1;4;1;3;3;3;1;25;0;1;4214;45;45;1;0;0;1;4;4214;0;6340;4;2;
/org.eclipse.ui.workbench/Eclipse UI/org/eclipse/ui/internal/csm/activities/ExtensionActivityRegistry.java;1;0;5;1;0;0;0;5;48;4;2;2405;48;48;4;3;0;5;5;2405;3;2444;2;1;
/org.eclipse.jdt.core.tests.model/workspace/Formatter/test334/A_out.java;1;0;1;1;0;0;0;1;0;0;1;2728;0;0;1;0;0;1;1;2728;0;2728;1;1;
/org.eclipse.jdt.core/formatter/org/eclipse/jdt/internal/formatter/align/AlignmentException.java;3;0;5;1;1;1;1;4;4;1;4;535;13;13;1;0;0;4;5;535;0;6352;5;3;
/org.eclipse.swt.tests/JUnit Tests/org/eclipse/swt/tests/junit/Test_org_eclipse_swt_custom_ExtendedModifyListener.java;1;0;1;1;0;0;0;1;20;0;1;2104;20;20;1;0;0;1;1;2104;0;2104;1;1;
/org.eclipse.jdt.debug.ui/ui/org/eclipse/jdt/internal/debug/ui/actions/OpenVariableTypeAction.java;1;0;1;1;0;0;0;1;3;0;1;2497;3;3;1;0;0;1;1;2497;0;2497;1;1;
/org.eclipse.jdt.ui/ui refactoring/org/eclipse/jdt/internal/ui/refactoring/DefaultChangeElement.java;1;0;5;1;0;0;0;5;20;1;5;1033;42;42;1;0;0;5;5;1033;0;4965;5;1;
/org.eclipse.help.ide/src/org/eclipse/help/ui/internal/workingset/HelpWorkingSetTreeContentProvider.java;1;1;3;1;2;2;2;1;76;0;1;1738;117;117;1;0;0;1;3;1738;0;6337;3;1;
/org.eclipse.debug.core/core/org/eclipse/debug/internal/core/memory/IExtendedMemoryBlockRetrieval.java;1;0;1;1;1;1;1;0;0;0;0;5254;0;0;1;0;0;0;1;5254;0;5254;1;1;
/org.eclipse.ui.workbench/Eclipse UI/org/eclipse/ui/themes/IColorFactory.java;1;0;2;1;1;1;1;1;4;0;1;4423;4;4;1;0;0;1;2;4423;0;5247;2;1;
/org.eclipse.pde.ui/src/org/eclipse/pde/internal/ui/editor/SystemFileMarkerAnnotationModel.java;1;0;1;1;0;0;0;1;4;0;1;1307;4;4;1;0;0;1;1;1307;0;1307;1;1;
/org.eclipse.ui.workbench/Eclipse UI/org/eclipse/ui/internal/roles/api/IRoleActivationServiceListener.java;1;0;2;1;0;0;0;2;0;0;1;2202;0;0;2;1;0;2;2;2202;1;2202;1;1;
/org.eclipse.jdt.ui/ui/org/eclipse/jdt/internal/ui/wizards/buildpaths/NewContainerDialog.java;2;1;2;1;2;2;2;0;7;0;0;5132;9;9;1;0;0;0;2;5132;0;6340;2;2;
/org.eclipse.jdt.ui.tests.refactoring/resources/InlineMethodWorkspace/TestCases/receiver_out/TestNameImplicitReceiver.java;1;0;1;1;0;0;0;1;2;0;1;845;2;2;1;0;0;1;1;845;0;845;1;1;
/org.eclipse.sdk.tests-feature/plugins/org.eclipse.perfmsr.ui.client/src/org/eclipse/perfmsr/ui/client/Messages.java;1;1;2;1;2;2;2;0;10;0;0;5443;10;10;1;0;0;0;2;5443;0;5513;2;1;
/org.eclipse.ui.workbench/Eclipse UI/org/eclipse/ui/internal/decorators/LightweightDecoratorManager.java;2;0;5;1;0;0;0;5;35;1;5;1333;71;71;1;0;0;5;5;1333;0;4587;5;2;
/org.eclipse.pde.build/src/org/eclipse/pde/internal/build/FetchScriptGeneratorApplication.java;2;0;5;1;0;0;0;5;0;1;5;447;0;0;1;0;0;5;5;447;0;1113;5;2;
/org.eclipse.jdt.ui/core extension/org/eclipse/jdt/internal/corext/template/java/JavaContext.java;5;1;16;1;3;3;3;13;170;2;11;860;308;308;2;2;0;13;16;4258;2;6340;14;5;
/org.eclipse.ui.workbench/Eclipse UI/org/eclipse/ui/internal/commands/keys/SpecialKey.java;1;0;3;1;0;0;0;3;11;1;3;1264;21;21;1;0;0;3;3;1264;0;1294;3;1;
/org.eclipse.platform/src-intro/org/eclipse/platform/internal/CheatSheetStandbyContent.java;2;2;7;1;7;6;7;0;84;0;0;5129;104;104;2;0;1;0;7;5799;1;6264;6;2;
/org.eclipse.jdt.core.tests.model/workspace/Formatter/test085/A_in.java;1;0;1;1;0;0;0;1;0;0;1;2425;0;0;1;0;0;1;1;2425;0;2425;1;1;
/org.eclipse.core.runtime/src/org/eclipse/core/runtime/IPluginDescriptor.java;5;2;19;1;10;8;10;9;632;1;9;54;1041;1041;2;0;2;9;19;5117;2;6340;17;5;
/org.eclipse.jdt.core.tests.model/workspace/Converter/test0423/A.java;1;0;1;1;0;0;0;1;0;0;1;3714;0;0;1;0;0;1;1;3714;0;3714;1;1;
/org.eclipse.jdt.core.tests.model/workspace/Converter/test0359/A.java;1;0;1;1;0;0;0;1;0;0;1;3714;0;0;1;0;0;1;1;3714;0;3714;1;1;
/org.eclipse.jdt.ui.tests/ui/org/eclipse/jdt/ui/tests/search/SearchTest.java;1;1;8;1;4;4;4;4;28;1;4;3940;84;84;1;0;0;4;8;3940;0;5676;8;1;
/org.eclipse.core.tests.resources/src/org/eclipse/core/tests/resources/perf/BenchElementTree.java;1;0;3;1;3;1;3;0;863;0;0;5147;863;863;3;0;2;0;3;5147;2;5147;1;1;
/org.eclipse.ui.workbench/Eclipse UI/org/eclipse/ui/activities/WorkbenchActivityHelper.java;5;1;20;2;5;5;5;15;80;2;12;3066;457;457;2;3;0;15;20;3109;3;6338;17;5;
/org.eclipse.ui.externaltools/Ant Editor/org/eclipse/ui/externaltools/internal/ant/editor/PlantyActionContributor.java;1;0;1;1;0;0;0;1;0;0;1;178;0;0;1;0;0;1;1;178;0;178;1;1;
/org.eclipse.ui.workbench/Eclipse UI/org/eclipse/ui/commands/internal/IContextServiceObserver.java;1;0;2;1;0;0;0;2;0;0;1;767;0;0;2;1;0;2;2;767;1;767;1;1;
/org.eclipse.jdt.ui/core extension/org/eclipse/jdt/internal/corext/callhierarchy/CallSearchResultCollector.java;3;0;4;1;1;1;1;3;6;1;3;169;10;10;1;0;0;3;4;169;0;6340;4;3;
/org.eclipse.team.ui/src/org/eclipse/team/internal/ui/synchronize/RefreshUserNotificationPolicyInModalDialog.java;1;2;17;1;10;8;10;7;47;1;7;4518;186;186;2;0;2;7;17;5359;2;6337;15;1;
/org.eclipse.jdt.ui.tests/test plugin/org/eclipse/jdt/testplugin/util/DialogCheck.java;2;1;2;1;2;2;2;0;9;0;0;5422;11;11;1;0;0;0;2;5422;0;6340;2;2;
/org.eclipse.ant.ui/Ant Tools Support/org/eclipse/ant/internal/ui/launchConfigurations/EditAntHomeEntryAction.java;1;0;3;1;0;0;0;3;4;1;3;4332;6;6;1;0;0;3;3;4332;0;4974;3;1;
/org.eclipse.jdt.core.tests.model/workspace/Converter/src/test0120/Test.java;1;0;1;1;0;0;0;1;0;0;1;3714;0;0;1;0;0;1;1;3714;0;3714;1;1;
/org.eclipse.jdt.debug.tests/tests/org/eclipse/jdt/debug/tests/core/BreakpointLocationVerificationTests.java;2;0;8;1;1;1;1;7;34;2;6;2248;121;121;2;1;0;7;8;2248;1;5356;7;2;
/org.eclipse.update.core/src/org/eclipse/update/core/model/SiteModel.java;4;1;7;1;3;3;3;4;8;1;4;0;30;30;1;0;0;4;7;0;0;6336;7;4;
/org.eclipse.jdt.core.tests.model/workspace/Converter/test0469/A.java;1;0;1;1;0;0;0;1;0;0;1;1255;0;0;1;0;0;1;1;1255;0;1255;1;1;
/org.eclipse.search/search/org/eclipse/search/internal/core/text/TextSearchEngine.java;2;1;4;1;3;3;3;1;7;0;1;2888;22;22;1;0;0;1;4;2888;0;6340;4;2;
/org.eclipse.jdt.core/codeassist/org/eclipse/jdt/internal/codeassist/complete/CompletionOnFieldName.java;2;0;3;1;0;0;0;3;22;1;3;991;29;29;1;0;0;3;3;991;0;3560;3;2;
/org.eclipse.ui.workbench/Eclipse UI/org/eclipse/ui/internal/activities/Category.java;4;0;7;1;1;1;1;6;53;1;6;2867;126;126;1;0;0;6;7;2867;0;6338;7;4;
/org.eclipse.jdt.ui/ui/org/eclipse/jdt/ui/text/spelling/ChangeCaseProposal.java;1;0;2;1;0;0;0;2;0;1;2;3829;0;0;1;0;0;2;2;3829;0;3930;2;1;
/org.eclipse.ui.views/src/org/eclipse/ui/views/internal/markers/ActionMarkCompleted.java;1;0;2;1;0;0;0;2;0;0;1;749;0;0;2;1;0;2;2;749;1;749;1;1;
/org.eclipse.jdt.junit/src/org/eclipse/jdt/internal/junit/ui/CompareResultsAction.java;3;1;5;1;2;2;2;3;4;1;3;3417;9;9;1;0;0;3;5;3417;0;6340;5;3;
/org.eclipse.jdt.ui/ui/org/eclipse/jdt/internal/ui/text/spelling/engine/DefaultPhoneticDistanceAlgorithm.java;2;0;2;1;1;1;1;1;2;0;1;3930;2;2;1;0;0;1;2;3930;0;6340;2;2;
/org.eclipse.swt/Eclipse SWT PI/carbon/org/eclipse/swt/internal/carbon/ATSTrapezoid.java;1;2;3;1;3;2;3;0;16;0;0;5534;20;20;2;0;1;0;3;5534;1;5614;2;1;
/org.eclipse.jdt.ui.tests.refactoring/resources/ExtractTemp/canExtract/A_test73_out.java;1;0;1;1;0;0;0;1;0;0;1;1569;0;0;1;0;0;1;1;1569;0;1569;1;1;
/org.eclipse.debug.ui/ui/org/eclipse/debug/internal/ui/views/launch/LaunchViewerPresentation.java;1;0;2;1;0;0;0;2;0;1;2;2184;0;0;1;0;0;2;2;2184;0;2210;2;1;
/org.eclipse.ui.ide/src/org/eclipse/ui/internal/dialogs/ResourceTreeAndListGroup.java;2;0;2;1;0;0;0;2;0;1;2;1526;0;0;1;0;0;2;2;1526;0;2263;2;2;
/org.eclipse.ui.editors/src/org/eclipse/ui/texteditor/SelectMarkerRulerAction.java;2;1;8;1;3;3;3;5;46;1;5;1347;128;128;1;0;0;5;8;1347;0;6337;8;2;
/org.eclipse.ui.workbench/Eclipse UI/org/eclipse/ui/internal/csm/roles/api/IRole.java;1;0;3;1;0;0;0;3;102;1;3;2213;132;132;1;0;0;3;3;2213;0;2240;3;1;
/org.eclipse.ui.views/src/org/eclipse/ui/views/navigator/ResourceSorter.java;1;0;1;1;0;0;0;1;0;0;1;2738;0;0;1;0;0;1;1;2738;0;2738;1;1;
/org.eclipse.jdt.ui/ui/org/eclipse/jdt/internal/ui/actions/SelectAllAction.java;1;0;1;1;1;1;1;0;2;0;0;6340;2;2;1;0;0;0;1;6340;0;6340;1;1;
/org.eclipse.ui.workbench/Eclipse UI/org/eclipse/ui/internal/about/AboutData.java;1;0;1;1;1;1;1;0;0;0;0;5483;0;0;1;0;0;0;1;5483;0;5483;1;1;
/org.eclipse.core.runtime.osgi/src/org/eclipse/core/runtime/registry/IExtensionPoint.java;2;0;4;2;0;0;0;4;24;3;2;3013;24;24;3;2;0;4;4;3030;2;3030;2;2;
/org.eclipse.jdt.ui.tests.refactoring/resources/MoveMembers/test31/in/A.java;1;0;1;1;0;0;0;1;0;0;1;1651;0;0;1;0;0;1;1;1651;0;1651;1;1;
/org.eclipse.jdt.core.tests.model/workspace/Converter/src/test0351/Test2.java;1;0;1;1;0;0;0;1;0;0;1;3714;0;0;1;0;0;1;1;3714;0;3714;1;1;
/org.eclipse.ant.ui/Ant Editor/org/eclipse/ant/ui/internal/editor/derived/HTML2TextReader.java;1;0;3;1;0;0;0;3;2;1;3;250;2;2;1;0;0;3;3;250;0;1811;3;1;
/org.eclipse.swt.tests/JUnit Tests/org/eclipse/swt/tests/junit/Test_org_eclipse_swt_widgets_Tracker.java;1;0;1;1;0;0;0;1;20;0;1;2123;20;20;1;0;0;1;1;2123;0;2123;1;1;
/org.eclipse.debug.ui/ui/org/eclipse/debug/ui/launchVariables/RefreshTab.java;3;0;13;1;0;0;0;13;667;5;8;728;733;733;5;5;0;13;13;2068;5;2120;8;3;
/org.eclipse.jdt.ui/core extension/org/eclipse/text/edits/UndoMemento.java;1;0;4;1;0;0;0;4;81;2;3;1953;85;85;2;1;0;4;4;1985;1;1985;3;1;
/org.eclipse.jdt.ui/core extension/org/eclipse/jdt/internal/corext/textmanipulation/AbstractTransferEdit.java;1;0;7;1;0;0;0;7;65;2;6;949;137;137;2;1;0;7;7;1946;1;1946;6;1;
/org.eclipse.update.ui.forms/Eclipse Forms/org/eclipse/ui/forms/events/HyperlinkEvent.java;1;0;2;1;0;0;0;2;0;1;2;3096;0;0;1;0;0;2;2;3096;0;4157;2;1;
/org.eclipse.pde.ui/src_Forms/org/eclipse/pde/internal/ui/neweditor/feature/SynchronizeVersionsWizard.java;2;0;2;1;1;1;1;1;0;0;1;4926;0;0;1;0;0;1;2;4926;0;5431;2;2;
/org.eclipse.pde.core/src/org/eclipse/pde/internal/core/PDECore.java;3;1;23;1;7;7;7;16;525;2;15;571;1098;1098;2;1;0;16;23;2292;1;6336;22;3;
/org.eclipse.team.tests.cvs.core/src/org/eclipse/team/tests/ccvs/ui/logformatter/Util.java;1;0;1;1;0;0;0;1;0;0;1;2632;0;0;1;0;0;1;1;2632;0;2632;1;1;
/org.eclipse.ant.tests.core/tests/org/eclipse/ant/tests/core/tests/TaskTests.java;1;0;7;1;1;1;1;6;29;1;6;807;94;94;1;0;0;6;7;807;0;6336;7;1;
/org.eclipse.core.tests.runtime/src/org/eclipse/core/tests/internal/plugins/PluginResolveTest_22.java;1;0;1;1;0;0;0;1;0;0;1;3014;0;0;1;0;0;1;1;3014;0;3014;1;1;
/org.eclipse.jdt.ui.tests.refactoring/resources/ExtractInterface/test95/out/A.java;1;0;1;1;0;0;0;1;0;0;1;1153;0;0;1;0;0;1;1;1153;0;1153;1;1;
/org.eclipse.jdt.core/search/org/eclipse/jdt/internal/core/search/matching/MultipleSearchPattern.java;1;0;2;1;0;0;0;2;8;1;2;786;8;8;1;0;0;2;2;786;0;1115;2;1;
/org.eclipse.jdt.core/search/org/eclipse/jdt/internal/core/search/matching/ConstructorLocator.java;4;0;10;2;1;1;1;9;44;2;7;1986;87;87;2;2;0;9;10;1986;2;5207;8;4;
/org.eclipse.jdt.ui/core refactoring/org/eclipse/jdt/internal/corext/refactoring/typeconstraints/ITypeConstraintFactory.java;1;0;1;1;0;0;0;1;0;0;1;3902;0;0;1;0;0;1;1;3902;0;3902;1;1;
/org.eclipse.ui.views/src/org/eclipse/ui/views/internal/markers/tasks/TaskPropertiesDialog.java;1;0;2;1;0;0;0;2;0;1;2;265;0;0;1;0;0;2;2;265;0;749;2;1;
/org.eclipse.swt/Eclipse SWT Browser/motif/org/eclipse/swt/browser/AppFileLocProvider.java;2;1;5;1;2;2;2;3;49;1;3;2124;89;89;1;0;0;3;5;2124;0;6352;5;2;
/org.eclipse.jdt.core.tests.model/src/org/eclipse/jdt/core/tests/model/ThreadSafetyTests.java;1;0;5;1;0;0;0;5;7;1;5;100;16;16;1;0;0;5;5;100;0;4992;5;1;
/org.eclipse.ui.workbench/Eclipse UI/org/eclipse/ui/internal/commands/older/KeyConfigurationEvent.java;1;0;2;1;0;0;0;2;4;0;1;2562;4;4;2;1;0;2;2;2562;1;2562;1;1;
/org.eclipse.team.cvs.core/src/org/eclipse/team/internal/ccvs/core/client/listeners/RDiffSummaryListener.java;1;0;2;1;0;0;0;2;144;1;2;2497;144;144;1;0;0;2;2;2497;0;2529;2;1;
/org.eclipse.swt/Eclipse SWT PI/carbon/org/eclipse/swt/internal/carbon/DataBrowserListViewHeaderDesc.java;1;2;3;1;3;2;3;0;16;0;0;5534;20;20;2;0;1;0;3;5534;1;5614;2;1;
/org.eclipse.help.ide/src/org/eclipse/help/ui/internal/workingset/HelpWorkingSetPage.java;1;1;10;1;3;3;3;7;347;4;4;1738;503;503;4;3;0;7;10;1738;3;6337;7;1;
/org.eclipse.jdt.ui/core extension/org/eclipse/jdt/internal/corext/textmanipulation/TextEditException.java;2;0;3;1;0;0;0;3;5;1;3;1576;5;5;1;0;0;3;3;1576;0;1875;3;2;
/org.eclipse.ant.ui/Ant Tools Support/org/eclipse/ant/internal/ui/datatransfer/DataTransferMessages.java;1;0;1;1;0;0;0;1;0;0;1;4809;0;0;1;0;0;1;1;4809;0;4809;1;1;
/org.eclipse.team.ui/src/org/eclipse/team/internal/ui/synchronize/actions/ShowSynchronizeParticipantAction.java;1;1;6;1;2;2;2;4;41;1;4;2535;70;70;1;0;0;4;6;2535;0;6337;6;1;
/org.eclipse.jdt.ui.tests.refactoring/resources/MoveInnerToTopLevel/test_nonstatic_16/out/Inner.java;2;0;2;1;1;1;1;1;2;0;1;305;4;4;1;0;0;1;2;305;0;5854;2;2;
/org.eclipse.jdt.ui.tests.refactoring/resources/MoveMembers/test1/out/A.java;1;0;1;1;1;1;1;0;7;0;0;5676;7;7;1;0;0;0;1;5676;0;5676;1;1;
/org.eclipse.team.ui/src/org/eclipse/team/internal/ui/sync/actions/SyncViewerComparisonCriteria.java;1;0;7;1;0;0;0;7;124;1;7;488;144;144;1;0;0;7;7;488;0;2632;7;1;
/org.eclipse.jdt.ui.tests.refactoring/test cases/org/eclipse/jdt/ui/tests/xml/A_TypeExtender2.java;1;0;5;1;0;0;0;5;13;1;5;2204;19;19;1;0;0;5;5;2204;0;4108;5;1;
/org.eclipse.ui.externaltools/Ant Editor/org/eclipse/ui/externaltools/internal/ant/editor/text/AntEditorTagScanner.java;1;0;2;1;0;0;0;2;0;1;2;178;0;0;1;0;0;2;2;178;0;282;2;1;
/org.eclipse.pde.ui/src/org/eclipse/pde/internal/ui/editor/site/FeatureSection.java;3;2;14;2;9;7;9;5;738;1;5;2311;940;940;2;0;2;5;14;5682;2;6336;12;3;
/org.eclipse.jdt.core.tests.model/workspace/Formatter/test336/A_in.java;1;0;1;1;0;0;0;1;0;0;1;2742;0;0;1;0;0;1;1;2742;0;2742;1;1;
/org.eclipse.team.webdav/src/org/eclipse/team/internal/core/target/SyncBytesComparisonCriteria.java;1;0;1;1;0;0;0;1;0;0;1;3477;0;0;1;0;0;1;1;3477;0;3477;1;1;
/org.eclipse.core.resources/src/org/eclipse/core/internal/dtree/NodeComparison.java;1;0;1;1;1;1;1;0;164;0;0;5146;164;164;1;0;0;0;1;5146;0;5146;1;1;
/org.eclipse.jdt.ui.tests/test plugin/org/eclipse/jdt/testplugin/test/HelloWorld.java;1;0;1;1;1;1;1;0;2;0;0;6340;2;2;1;0;0;0;1;6340;0;6340;1;1;
/org.eclipse.jdt.ui/ui refactoring/org/eclipse/jdt/internal/ui/refactoring/nls/search/NLSSearchOperation.java;3;1;5;1;2;2;2;3;10;1;3;2862;23;23;1;0;0;3;5;2862;0;6340;5;3;
/org.eclipse.jdt.core/compiler/org/eclipse/jdt/internal/compiler/lookup/BinaryTypeBinding.java;4;2;13;2;4;3;4;9;49;1;9;24;126;126;2;0;1;9;13;5871;1;5888;12;4;
/org.eclipse.jface.text/src/org/eclipse/jface/text/formatter/MultiPassContentFormatter.java;4;1;7;1;4;4;4;3;101;1;3;4365;148;148;1;0;0;3;7;4365;0;6357;7;4;
/org.eclipse.jdt.ui.tests.refactoring/resources/ExtractMethodWorkSpace/ExtractMethodTests/locals_out/A_test517.java;1;0;2;1;0;0;0;2;9;1;2;130;10;10;1;0;0;2;2;130;0;844;2;1;
/org.eclipse.ui.workbench/Eclipse UI/org/eclipse/ui/internal/commands/api/older/NotActiveException.java;1;0;2;1;0;0;0;2;0;0;1;2562;0;0;2;1;0;2;2;2562;1;2562;1;1;
/org.eclipse.ui.workbench/Eclipse UI/org/eclipse/ui/activities/IActivityActivityBinding.java;2;1;5;1;2;2;2;3;12;1;3;2896;23;23;1;0;0;3;5;2896;0;5760;5;2;
/org.eclipse.pde.ui/src/org/eclipse/pde/internal/ui/PDEPerspective.java;2;1;6;1;2;2;2;4;134;1;4;999;182;182;1;0;0;4;6;999;0;6336;6;2;
/org.eclipse.ui.workbench/Eclipse UI/org/eclipse/ui/internal/registry/ICategory.java;1;0;1;1;0;0;0;1;0;0;1;2737;0;0;1;0;0;1;1;2737;0;2737;1;1;
/org.eclipse.swt/Eclipse SWT PI/motif/org/eclipse/swt/internal/motif/XmDragProcCallback.java;1;0;1;1;0;0;0;1;21;0;1;829;21;21;1;0;0;1;1;829;0;829;1;1;
/org.eclipse.help.webapp/src_servlets/org/eclipse/help/internal/webapp/data/LinksData.java;1;1;5;1;3;3;3;2;15;1;2;2105;47;47;1;0;0;2;5;2105;0;6337;5;1;
/org.eclipse.help.ui.win32/src/org/eclipse/help/ui/internal/browser/win32/IEHost.java;1;0;5;1;0;0;0;5;53;1;5;1157;109;109;1;0;0;5;5;1157;0;2898;5;1;
/org.eclipse.jdt.core.tests.model/workspace/Converter/test0058/Test.java;1;0;1;1;0;0;0;1;0;0;1;3714;0;0;1;0;0;1;1;3714;0;3714;1;1;
/org.eclipse.jdt.ui/core refactoring/org/eclipse/jdt/internal/corext/refactoring/SearchResultCollector.java;2;0;2;1;1;1;1;1;7;0;1;1576;7;7;1;0;0;1;2;1576;0;5375;2;2;
/org.eclipse.ui.workbench/Eclipse UI/org/eclipse/ui/internal/AboutItem.java;1;0;1;1;0;0;0;1;0;0;1;2737;0;0;1;0;0;1;1;2737;0;2737;1;1;
/org.eclipse.update.ui/src/org/eclipse/update/internal/ui/ConfigurationManagerAction.java;3;2;7;1;4;3;4;3;27;1;3;825;64;64;2;0;1;3;7;5783;1;5783;6;3;
/org.eclipse.jdt.core.tests.model/workspace/Converter/src/test0129/Test.java;1;0;1;1;0;0;0;1;0;0;1;3714;0;0;1;0;0;1;1;3714;0;3714;1;1;
/org.eclipse.jdt.core.tests.model/workspace/Converter/src/javadoc/testBug48489/TestE.java;1;0;1;1;0;0;0;1;0;0;1;3890;0;0;1;0;0;1;1;3890;0;3890;1;1;
/org.eclipse.update.ui.forms/Eclipse Forms/org/eclipse/ui/forms/MasterDetailsPage.java;1;0;3;1;0;0;0;3;1;2;2;3749;1;1;2;1;0;3;3;3749;1;3812;2;1;
/org.eclipse.team.ui/src/org/eclipse/team/internal/ui/synchronize/SyncInfoSetSynchronizePage.java;2;1;4;1;4;4;4;0;38;0;0;5362;77;77;1;0;0;0;4;5362;0;5596;4;2;
/org.eclipse.ui.workbench/Eclipse UI/org/eclipse/ui/internal/actions/PinEditorContributionItem.java;2;0;2;1;0;0;0;2;82;1;2;1774;82;82;1;0;0;2;2;1774;0;2737;2;2;
/org.eclipse.text/projection/org/eclipse/jface/text/projection/ChildDocument.java;2;1;8;1;2;2;2;6;69;3;3;4623;131;131;3;3;0;6;8;4689;3;6301;5;2;
/org.eclipse.pde.runtime/src/org/eclipse/pde/internal/runtime/registry/PluginPropertySource.java;2;1;5;1;2;2;2;3;126;1;3;924;285;285;1;0;0;3;5;924;0;6336;5;2;
/org.eclipse.jdt.ui.tests.refactoring/resources/PasteSourceReference/test4/in/A.java;1;0;1;1;0;0;0;1;0;0;1;1311;0;0;1;0;0;1;1;1311;0;1311;1;1;
/org.eclipse.update.ui/src/org/eclipse/update/internal/ui/model/SimpleFeatureAdapter.java;1;0;1;1;0;0;0;1;5;0;1;890;5;5;1;0;0;1;1;890;0;890;1;1;
/org.eclipse.ui.workbench/Eclipse UI/org/eclipse/ui/actions/AddBookmarkAction.java;1;0;2;1;0;0;0;2;4;1;2;1941;4;4;1;0;0;2;2;1941;0;2737;2;1;
/org.eclipse.pde.ui/src/org/eclipse/pde/internal/ui/editor/build/BuildEditor.java;3;2;8;2;8;7;8;0;6;0;0;5431;23;23;2;0;1;0;8;5431;1;6336;7;3;
/org.eclipse.jdt.junit/src/org/eclipse/jdt/internal/junit/ui/JUnitProgressBar.java;2;0;6;1;1;1;1;5;20;1;5;1099;59;59;1;0;0;5;6;1099;0;6340;6;2;
/org.eclipse.update.ui.win32/src/org/eclipse/update/internal/ui/win32/views/WebBrowser.java;1;0;1;1;0;0;0;1;0;0;1;889;0;0;1;0;0;1;1;889;0;889;1;1;
/org.eclipse.team.cvs.ui/src/org/eclipse/team/internal/ccvs/ui/subscriber/SynchronizeViewActionDelagate.java;1;0;3;1;0;0;0;3;37;1;3;2463;37;37;1;0;0;3;3;2463;0;4216;3;1;
/org.eclipse.ui.workbench.texteditor/src/org/eclipse/ui/texteditor/ITextEditorExtension3.java;3;0;7;2;2;1;2;5;7;2;4;677;26;26;2;1;1;5;7;677;2;6334;5;3;
/org.eclipse.ui.intro/src/org/eclipse/ui/intro/internal/model/AbstractIntroPage.java;1;0;11;1;1;1;1;10;371;2;9;4429;599;599;2;1;0;10;11;4898;1;5115;10;1;
/org.eclipse.team.webdav/src/org/eclipse/team/internal/ui/target/subscriber/DepolymentProviderContentProvider.java;2;0;3;1;0;0;0;3;78;1;3;3494;78;78;1;0;0;3;3;3494;0;4311;3;2;
/org.eclipse.team.cvs.ssh2/src/org/eclipse/team/ccvs/ssh2/Policy.java;2;0;2;1;0;0;0;2;0;1;2;3113;0;0;1;0;0;2;2;3113;0;4825;2;2;
/org.eclipse.jdt.core/model/org/eclipse/jdt/internal/core/builder/ClasspathMultiDirectory.java;2;0;5;2;0;0;0;5;14;2;4;446;28;28;2;1;0;5;5;4887;1;4887;4;2;
/org.eclipse.pde.ui/src/org/eclipse/pde/internal/ui/editor/schema/SchemaDocPage.java;2;2;6;1;5;4;5;1;102;0;1;368;149;149;2;0;1;1;6;5431;1;6336;5;2;
/org.eclipse.jdt.ui/ui/org/eclipse/jdt/ui/actions/WorkingSetFindAction.java;2;0;2;1;1;1;1;1;2;0;1;592;4;4;1;0;0;1;2;592;0;6340;2;2;
/org.eclipse.core.runtime.compatibility/src-runtime/org/eclipse/core/internal/plugins/Library.java;2;1;3;1;2;2;2;1;6;0;1;3013;8;8;1;0;0;1;3;3013;0;6340;3;2;
/org.eclipse.debug.ui/ui/org/eclipse/debug/internal/ui/sourcelookup/SourceLookupPanel.java;3;3;10;1;9;7;9;1;27;0;1;4970;88;88;3;0;2;1;10;5532;2;6174;8;3;
/org.eclipse.ui.workbench/Eclipse UI/org/eclipse/ui/internal/chris/roles/api/IRoleActivationServiceListener.java;1;0;2;1;0;0;0;2;0;0;1;2207;0;0;2;1;0;2;2;2207;1;2207;1;1;
/org.eclipse.swt.tests/JUnit Tests/org/eclipse/swt/tests/junit/Test_org_eclipse_swt_dnd_DragSourceListener.java;1;0;1;1;0;0;0;1;32;0;1;2176;32;32;1;0;0;1;1;2176;0;2176;1;1;
/org.eclipse.jdt.core/model/org/eclipse/jdt/internal/core/JavaProjectElementInfo.java;2;0;7;1;1;1;1;6;176;1;6;132;191;191;1;0;0;6;7;132;0;5728;7;2;
/org.eclipse.debug.core/core/org/eclipse/debug/internal/core/stringsubstitution/IContextVariable.java;1;0;3;1;0;0;0;3;6;1;3;1121;6;6;1;0;0;3;3;1121;0;2140;3;1;
/org.eclipse.ui.workbench/Eclipse UI/org/eclipse/ui/internal/LinkedResourceDecorator.java;1;0;1;1;0;0;0;1;0;0;1;2737;0;0;1;0;0;1;1;2737;0;2737;1;1;
/org.eclipse.ltk.core.refactoring/src/org/eclipse/ltk/core/refactoring/participants/RefactoringProcessor.java;1;2;11;1;8;7;8;3;186;1;3;4845;272;272;2;0;1;3;11;5264;1;6351;10;1;
/org.eclipse.jdt.ui.tests.refactoring/test cases/org/eclipse/jdt/ui/tests/refactoring/RenameTypeTests.java;4;1;14;2;2;2;2;12;43;2;11;130;204;204;2;1;0;12;14;4575;1;6340;13;4;
/org.eclipse.ltk.core.refactoring.tests/src/org/eclipse/ltk/core/refactoring/tests/RefactoringCoreTestPlugin.java;1;0;2;1;1;1;1;1;6;0;1;4845;6;6;1;0;0;1;2;4845;0;5380;2;1;
/org.eclipse.jdt.core.tests.model/workspace/Formatter/test260/A_in.java;1;0;1;1;0;0;0;1;0;0;1;2442;0;0;1;0;0;1;1;2442;0;2442;1;1;
/org.eclipse.jdt.core/dom/org/eclipse/jdt/core/dom/ArrayType.java;4;1;9;1;2;2;2;7;78;1;7;1114;112;112;1;0;0;7;9;1114;0;5272;9;4;
/org.eclipse.team.cvs.ui/src/org/eclipse/team/internal/ccvs/ui/wizards/ICVSWizard.java;2;0;3;1;1;1;1;2;27;1;2;4585;37;37;1;0;0;2;3;4585;0;6337;3;2;
/org.eclipse.jdt.core/model/org/eclipse/jdt/internal/core/CompilationUnit.java;5;2;83;2;9;7;9;74;887;3;58;78;2341;2341;3;16;2;74;83;878;18;6078;65;5;
/org.eclipse.jdt.text.tests/src/org/eclipse/jdt/ui/text/tests/StringsTest.java;1;1;3;1;2;2;2;1;1;0;1;5082;1;1;1;0;0;1;3;5082;0;5129;3;1;
/org.eclipse.jdt.ui.tests.refactoring/resources/ExtractMethodWorkSpace/ExtractMethodTests/error_in/A_test801.java;1;0;4;1;0;0;0;4;2;1;4;130;4;4;1;0;0;4;4;130;0;1474;4;1;
/org.eclipse.jdt.debug/model/org/eclipse/jdt/internal/debug/core/model/JDIPlaceholderVariable.java;3;0;5;1;0;0;0;5;31;1;5;749;54;54;1;0;0;5;5;749;0;2647;5;3;
/org.eclipse.update.ui.forms/src/org/eclipse/update/ui/forms/internal/NoTabsWorkbook.java;1;0;1;1;0;0;0;1;4;0;1;907;4;4;1;0;0;1;1;907;0;907;1;1;
/org.eclipse.ui.workbench/Eclipse UI/org/eclipse/ui/internal/commands/PreferenceCommandRegistry.java;3;1;14;1;3;3;3;11;311;2;10;1400;607;607;2;1;0;11;14;1400;1;6338;13;3;
/org.eclipse.update.ui.win32/src/org/eclipse/welcome/internal/BrowserControlSite.java;1;0;2;1;0;0;0;2;0;1;2;889;0;0;1;0;0;2;2;889;0;907;2;1;
/org.eclipse.core.runtime/src/org/eclipse/core/runtime/jobs/ISchedulingRule.java;3;0;13;2;1;1;1;12;122;2;11;629;363;363;2;1;0;12;13;5083;1;5150;12;3;
/org.eclipse.jdt.core.tests.model/workspace/Converter/test0196/Test.java;1;0;1;1;0;0;0;1;0;0;1;3714;0;0;1;0;0;1;1;3714;0;3714;1;1;
/org.eclipse.ui.workbench/Eclipse UI/org/eclipse/ui/internal/dialogs/PropertyPageContributorManager.java;3;0;4;1;1;1;1;3;29;1;3;2737;58;58;1;0;0;3;4;2737;0;6338;4;3;
/org.eclipse.jdt.core.tests.compiler/src/org/eclipse/jdt/core/tests/runtime/NullConsoleReader.java;1;0;1;1;0;0;0;1;2;0;1;3560;2;2;1;0;0;1;1;3560;0;3560;1;1;
/org.eclipse.jdt.core.tests.model/workspace/Converter/test0123/Test.java;1;0;1;1;0;0;0;1;0;0;1;3714;0;0;1;0;0;1;1;3714;0;3714;1;1;
/org.eclipse.team.cvs.core/src/org/eclipse/team/internal/ccvs/core/util/KnownRepositories.java;2;0;5;1;1;1;1;4;223;1;4;2458;234;234;1;0;0;4;5;2458;0;6337;5;2;
/org.eclipse.jdt.ui.tests.refactoring/resources/MoveMembers/test32/in/B.java;1;0;1;1;0;0;0;1;0;0;1;1683;0;0;1;0;0;1;1;1683;0;1683;1;1;
/org.eclipse.debug.ui/ui/org/eclipse/debug/internal/ui/actions/ProfileToolbarAction.java;1;0;1;1;0;0;0;1;0;0;1;472;0;0;1;0;0;1;1;472;0;472;1;1;
/org.eclipse.jdt.ui/ui/org/eclipse/jdt/internal/ui/text/java/hover/JavaEditorTextHoverDescriptorComparator.java;1;0;2;1;0;0;0;2;0;1;2;3595;0;0;1;0;0;2;2;3595;0;3743;2;1;
/org.eclipse.jdt.debug/eval/org/eclipse/jdt/internal/debug/eval/ast/instructions/ReturnInstruction.java;1;0;1;1;0;0;0;1;3;0;1;2497;3;3;1;0;0;1;1;2497;0;2497;1;1;
/org.eclipse.team.core/src/org/eclipse/team/core/ISaveContext.java;1;0;1;1;0;0;0;1;0;0;1;2487;0;0;1;0;0;1;1;2487;0;2487;1;1;
/org.eclipse.jdt.debug.tests/console tests/org/eclipse/jdt/debug/tests/console/TestMessageConsoleActionDelegate.java;2;0;4;1;0;0;0;4;26;2;3;3259;40;40;2;1;0;4;4;3259;1;4496;3;2;
/org.eclipse.update.core/src/org/eclipse/update/core/Feature.java;2;2;12;1;4;3;4;8;377;2;7;965;578;578;2;1;1;8;12;2027;2;5664;10;2;
/org.eclipse.team.ui/src/org/eclipse/team/internal/ui/synchronize/sets/SyncInfoSetDelegator.java;1;0;1;1;0;0;0;1;0;0;1;3518;0;0;1;0;0;1;1;3518;0;3518;1;1;
/org.eclipse.pde.core/src/org/eclipse/pde/core/plugin/IBundleModelProvider.java;2;1;3;1;2;2;2;1;12;0;1;4203;12;12;1;0;0;1;3;4203;0;5211;3;2;
/org.eclipse.core.runtime.osgi/src/org/eclipse/core/runtime/MultiStatus.java;1;0;1;1;0;0;0;1;0;0;1;3013;0;0;1;0;0;1;1;3013;0;3013;1;1;
/org.eclipse.team.ui/src/org/eclipse/team/ui/sync/actions/OpenWithActionGroup.java;1;0;1;1;0;0;0;1;0;0;1;2425;0;0;1;0;0;1;1;2425;0;2425;1;1;
/org.eclipse.pde.ui/src/org/eclipse/pde/internal/ui/IPDEUIConstants.java;3;1;5;1;4;4;4;1;26;0;1;3795;40;40;1;0;0;1;5;3795;0;6336;5;3;
/org.eclipse.swt/Eclipse SWT PI/gtk1x/org/eclipse/swt/internal/gtk/GdkRectangle.java;1;0;1;1;0;0;0;1;0;0;1;2327;0;0;1;0;0;1;1;2327;0;2327;1;1;
/org.eclipse.ui.forms/src/org/eclipse/ui/forms/widgets/FormToolkit.java;1;0;18;1;0;0;0;18;197;2;14;4068;373;373;2;4;0;18;18;4147;4;5060;14;1;
/org.eclipse.ui.workbench.texteditor/src/org/eclipse/ui/texteditor/AbstractMarkerAnnotationModel.java;2;0;3;1;0;0;0;3;18;1;3;1335;24;24;1;0;0;3;3;1335;0;2741;3;2;
/org.eclipse.swt/Eclipse SWT Browser/mozilla/org/eclipse/swt/browser/InputStream.java;1;0;1;1;0;0;0;1;0;0;1;2663;0;0;1;0;0;1;1;2663;0;2663;1;1;
/org.eclipse.jdt.core.tests.model/workspace/Formatter/test268/A_in.java;1;0;1;1;0;0;0;1;0;0;1;2442;0;0;1;0;0;1;1;2442;0;2442;1;1;
/org.eclipse.core.resources/src/org/eclipse/core/internal/watson/ElementTreeReader.java;1;0;2;1;2;1;2;0;177;0;0;5146;177;177;2;0;1;0;2;5146;1;5146;1;1;
/org.eclipse.swt/Eclipse SWT/photon/org/eclipse/swt/widgets/MenuItem.java;3;1;8;1;4;4;4;4;11;1;4;269;33;33;1;0;0;4;8;269;0;6352;8;3;
/org.eclipse.jdt.core.tests.model/workspace/Converter/test0082/Test.java;1;0;1;1;0;0;0;1;0;0;1;3714;0;0;1;0;0;1;1;3714;0;3714;1;1;
/org.eclipse.ui.ide/src/org/eclipse/ui/internal/ide/actions/BuildLastAction.java;1;0;2;1;1;1;1;1;0;0;1;4651;0;0;1;0;0;1;2;4651;0;5183;2;1;
/org.eclipse.jdt.ui/ui refactoring/org/eclipse/jdt/internal/ui/refactoring/RefactoringSaveHelper.java;3;0;5;1;1;1;1;4;17;1;4;1309;37;37;1;0;0;4;5;1309;0;6340;5;3;
/org.eclipse.search/new search/org/eclipse/search2/internal/ui/text/Highlighter.java;1;1;2;1;2;2;2;0;47;0;0;5500;47;47;1;0;0;0;2;5500;0;6074;2;1;
/org.eclipse.swt/Eclipse SWT PI/motif/org/eclipse/swt/internal/motif/XModifierKeymap.java;1;0;1;1;0;0;0;1;0;0;1;1912;0;0;1;0;0;1;1;1912;0;1912;1;1;
/org.eclipse.ui.ide/src/org/eclipse/ui/internal/ide/ChooseWorkspaceData.java;5;2;9;2;5;4;5;4;76;1;4;4434;134;134;2;0;1;4;9;5898;1;6166;8;5;
/org.eclipse.update.ui/src/org/eclipse/update/internal/ui/views/ConfigurationView.java;4;2;33;2;12;10;12;21;1531;2;18;749;2327;2327;2;3;2;21;33;749;5;6336;28;4;
/org.eclipse.jdt.core.tests.model/workspace/Formatter/test422/A_in.java;1;0;1;1;0;0;0;1;0;0;1;3475;0;0;1;0;0;1;1;3475;0;3475;1;1;
/org.eclipse.jdt.ui/ui/org/eclipse/jdt/internal/ui/infoviews/GotoInputAction.java;1;0;2;1;1;1;1;1;2;0;1;1415;2;2;1;0;0;1;2;1415;0;6340;2;1;
/org.eclipse.ui.externaltools/Ant Editor/org/eclipse/ui/externaltools/internal/ant/dtd/IDfm.java;1;0;1;1;0;0;0;1;0;0;1;282;0;0;1;0;0;1;1;282;0;282;1;1;
/org.eclipse.jdt.core/dom/org/eclipse/jdt/core/dom/LineComment.java;2;0;6;1;1;1;1;5;37;1;5;3683;47;47;1;0;0;5;6;3683;0;5272;6;2;
/org.eclipse.swt/Eclipse SWT/carbon/org/eclipse/swt/widgets/ToolItem.java;3;2;19;2;5;4;5;14;116;2;13;268;254;254;2;1;1;14;19;1579;2;6352;17;3;
/org.eclipse.jdt.core.tests.model/workspace/Formatter/test381/A_out.java;2;0;2;1;0;0;0;2;12;1;2;3148;12;12;1;0;0;2;2;3148;0;3362;2;2;
/org.eclipse.jdt.ui/ui/org/eclipse/jdt/internal/ui/text/comment/Java2HTMLEntityReader.java;2;0;2;1;1;1;1;1;2;0;1;3573;2;2;1;0;0;1;2;3573;0;6340;2;2;
/org.eclipse.jface.text/src/org/eclipse/jface/text/source/OverviewRuler.java;4;2;26;2;8;7;8;18;139;3;14;849;651;651;3;4;1;18;26;1682;5;6361;21;4;
/org.eclipse.ui.workbench/Eclipse UI/org/eclipse/ui/internal/NavigationHistoryAction.java;3;0;5;1;1;1;1;4;137;1;4;2737;236;236;1;0;0;4;5;2737;0;6338;5;3;
/org.eclipse.jdt.core/compiler/org/eclipse/jdt/internal/compiler/ast/ContinueStatement.java;2;0;4;1;0;0;0;4;10;1;4;148;18;18;1;0;0;4;4;148;0;3560;4;2;
/org.eclipse.team.ui/src/org/eclipse/team/ui/sync/actions/CompoundSyncInfoFilter.java;1;0;1;1;0;0;0;1;0;0;1;2405;0;0;1;0;0;1;1;2405;0;2405;1;1;
/org.eclipse.ui.workbench/Eclipse UI/org/eclipse/ui/internal/commands/ActionAndContextManager.java;1;0;2;1;0;0;0;2;0;1;2;956;0;0;1;0;0;2;2;956;0;1065;2;1;
/org.eclipse.ltk.core.refactoring/src/org/eclipse/ltk/internal/core/refactoring/AssertionFailedException.java;1;1;3;1;2;2;2;1;5;0;1;4845;7;7;1;0;0;1;3;4845;0;6340;3;1;
/org.eclipse.help.tests/src/org/eclipse/help/tests/base/TestHTMLDocParser.java;1;1;3;1;2;2;2;1;89;0;1;2781;113;113;1;0;0;1;3;2781;0;6337;3;1;
/org.eclipse.jdt.ui/ui/org/eclipse/jdt/internal/ui/text/template/contentassist/MultiVariableGuess.java;2;0;2;1;1;1;1;1;2;0;1;4927;2;2;1;0;0;1;2;4927;0;6340;2;2;
/org.eclipse.jdt.ui.tests.refactoring/resources/ExtractMethodWorkSpace/ExtractMethodTests/locals_out/A_test560.java;1;0;1;1;0;0;0;1;4;0;1;844;4;4;1;0;0;1;1;844;0;844;1;1;
/org.eclipse.jdt.junit/src/org/eclipse/jdt/internal/junit/launcher/ResourceExtender.java;2;0;2;1;1;1;1;1;10;0;1;4576;10;10;1;0;0;1;2;4576;0;6340;2;2;
/org.eclipse.update.tests.core/src/org/eclipse/update/tests/standalone/TestFeatureEnable.java;2;1;9;1;3;3;3;6;13;1;6;2463;37;37;1;0;0;6;9;2463;0;6336;9;2;
/org.eclipse.osgi/osgi/src/org/osgi/framework/FrameworkEvent.java;3;1;4;1;2;2;2;2;16;1;2;3013;33;33;1;0;0;2;4;3013;0;5536;4;3;
/org.eclipse.jdt.core.tests.compiler/src/org/eclipse/jdt/core/tests/compiler/regression/InMemoryNameEnvironment.java;1;0;1;1;0;0;0;1;2;0;1;3560;2;2;1;0;0;1;1;3560;0;3560;1;1;
/org.eclipse.core.tests.runtime/src/org/eclipse/core/tests/internal/runtimetests/SampleFFR.java;1;0;1;1;1;1;1;0;19;0;0;5149;19;19;1;0;0;0;1;5149;0;5149;1;1;
/org.eclipse.debug.ui/ui/org/eclipse/debug/internal/ui/preferences/SimpleLaunchVariablePreferencePage.java;3;0;5;1;0;0;0;5;57;2;4;1480;67;67;2;1;0;5;5;1480;1;2120;4;3;
/org.eclipse.ui.ide/src/org/eclipse/ui/internal/dialogs/MessageDialogWithToggle.java;2;0;3;1;0;0;0;3;5;1;3;1760;5;5;1;0;0;3;3;1760;0;2263;3;2;
/org.eclipse.swt/Eclipse SWT PI/motif/org/eclipse/swt/internal/motif/XmDropProcCallback.java;1;0;1;1;0;0;0;1;0;0;1;829;0;0;1;0;0;1;1;829;0;829;1;1;
/org.eclipse.jdt.core.tests.model/workspace/Converter/src/test0105/Test.java;1;0;1;1;0;0;0;1;0;0;1;3714;0;0;1;0;0;1;1;3714;0;3714;1;1;
/org.eclipse.ui.workbench/Eclipse UI/org/eclipse/ui/internal/commands/GestureBinding.java;1;0;2;1;0;0;0;2;158;1;2;1322;158;158;1;0;0;2;2;1322;0;1340;2;1;
/org.eclipse.jdt.core.tests.model/workspace/Formatter/test399/A_out.java;1;0;1;1;0;0;0;1;0;0;1;3436;0;0;1;0;0;1;1;3436;0;3436;1;1;
/org.eclipse.debug.ui/ui/org/eclipse/debug/ui/console/IConsoleLineTracker.java;2;0;3;1;0;0;0;3;6;1;3;2119;14;14;1;0;0;3;3;2119;0;2149;3;2;
/org.eclipse.jdt.core.tests.compiler/src/org/eclipse/jdt/core/tests/compiler/parser/NameReferenceCompletionTest.java;2;0;2;1;0;0;0;2;2;1;2;991;4;4;1;0;0;2;2;991;0;3560;2;2;
/org.eclipse.ui.forms/src/org/eclipse/ui/forms/internal/widgets/ImageSegment.java;1;0;4;1;0;0;0;4;25;1;4;4068;29;29;1;0;0;4;4;4068;0;5044;4;1;
/org.eclipse.jdt.core/search/org/eclipse/jdt/internal/core/index/impl/EntryResult.java;1;0;2;1;0;0;0;2;3;1;2;3218;3;3;1;0;0;2;2;3218;0;3385;2;1;
/org.eclipse.jdt.ui.tests.refactoring/resources/ChangeTypeRefactoring/negative/A_testObjectReturnType_in.java;1;0;1;1;1;1;1;0;0;0;0;5359;0;0;1;0;0;0;1;5359;0;5359;1;1;
/org.eclipse.help.ui.win32/src/org/eclipse/help/ui/internal/browser/win32/IEFactory.java;1;0;1;1;0;0;0;1;0;0;1;2898;0;0;1;0;0;1;1;2898;0;2898;1;1;
/org.eclipse.ant.tests.ui/Ant Editor Tests/org/eclipse/ant/tests/ui/editor/support/TestLocationProvider.java;1;0;5;1;1;1;1;4;10;2;3;1811;21;21;2;1;0;4;5;1811;1;6336;4;1;
/org.eclipse.ui.externaltools/External Tools Base/org/eclipse/ui/externaltools/internal/ui/ExternalToolsPreferencePage.java;2;0;2;2;1;1;1;1;39;0;1;33;50;50;1;0;0;1;2;33;0;6106;2;2;
/org.eclipse.jdt.debug.ui/ui/org/eclipse/jdt/internal/debug/core/refactoring/JavaBreakpointIPackageFragmentRenameParticipant.java;2;1;2;1;2;2;2;0;8;0;0;5621;8;8;1;0;0;0;2;5621;0;6339;2;2;
/org.eclipse.jdt.core.tests.model/workspace/Formatter/test351/A_out.java;2;0;2;1;0;0;0;2;12;1;2;3029;12;12;1;0;0;2;2;3029;0;3362;2;2;
/org.eclipse.core.runtime/src/org/eclipse/core/internal/plugins/ExtensionLinker.java;2;0;2;1;0;0;0;2;0;1;2;2105;0;0;1;0;0;2;2;2105;0;3013;2;2;
/org.eclipse.pde.core/src/org/eclipse/pde/internal/core/IModelProviderEvent.java;1;0;1;1;0;0;0;1;0;0;1;2229;0;0;1;0;0;1;1;2229;0;2229;1;1;
/org.eclipse.jdt.ui/ui/org/eclipse/jdt/internal/ui/search/FiltersDialog.java;2;1;2;1;2;2;2;0;10;0;0;6143;10;10;1;0;0;0;2;6143;0;6340;2;2;
/org.eclipse.update.ui/srcnew/org/eclipse/update/internal/ui/wizards/FeatureHierarchyElement2.java;1;0;2;1;0;0;0;2;0;1;2;367;0;0;1;0;0;2;2;367;0;460;2;1;
/org.eclipse.ui.workbench/Eclipse UI/org/eclipse/ui/internal/misc/TestPageListener.java;1;0;1;1;0;0;0;1;1;0;1;2737;1;1;1;0;0;1;1;2737;0;2737;1;1;
/org.eclipse.ui.externaltools/Ant Editor/org/eclipse/ui/externaltools/internal/ant/editor/outline/AntModel.java;1;0;1;1;0;0;0;1;0;0;1;282;0;0;1;0;0;1;1;282;0;282;1;1;
/org.eclipse.ui.presentations.r21/src/org/eclipse/ui/internal/presentations/r21/widgets/ViewForm.java;1;1;2;1;2;2;2;0;2;0;0;6075;2;2;1;0;0;0;2;6075;0;6338;2;1;
/org.eclipse.jface.text/src/org/eclipse/jface/text/source/ILineDiffer.java;3;1;5;1;3;3;3;2;46;1;2;1118;57;57;1;0;0;2;5;1118;0;6353;5;3;
/org.eclipse.jdt.core.tests.model/workspace/Converter/test0034/Test.java;1;0;1;1;0;0;0;1;0;0;1;3714;0;0;1;0;0;1;1;3714;0;3714;1;1;
/org.eclipse.swt/Eclipse SWT/carbon/org/eclipse/swt/widgets/Group.java;4;1;7;1;3;3;3;4;17;1;4;18;46;46;1;0;0;4;7;18;0;6352;7;4;
/org.eclipse.jdt.ui/ui/org/eclipse/jdt/internal/ui/preferences/ImportOrganizePreferencePage.java;2;0;4;1;1;1;1;3;43;1;3;1350;52;52;1;0;0;3;4;1350;0;6340;4;2;
/org.eclipse.ui.editors/src/org/eclipse/ui/internal/editors/quickdiff/providers/LastSaveReferenceProvider.java;1;0;2;1;0;0;0;2;0;1;2;1118;0;0;1;0;0;2;2;1118;0;1214;2;1;
/org.eclipse.swt/Eclipse SWT/win32/org/eclipse/swt/graphics/TextStyle.java;1;0;2;1;0;0;0;2;0;1;2;4565;0;0;1;0;0;2;2;4565;0;4873;2;1;
/org.eclipse.update.core/srcnew/org/eclipse/update/operations/IRevertConfigurationOperation.java;1;0;2;1;0;0;0;2;0;1;2;602;0;0;1;0;0;2;2;602;0;825;2;1;
/org.eclipse.jdt.ui/core refactoring/org/eclipse/jdt/internal/corext/refactoring/reorg/ICreateTargetQueries.java;1;0;1;1;1;1;1;0;0;0;0;5896;0;0;1;0;0;0;1;5896;0;5896;1;1;
/org.eclipse.jdt.core/model/org/eclipse/jdt/internal/core/util/LocalVariableTableEntry.java;1;0;1;1;0;0;0;1;2;0;1;3560;2;2;1;0;0;1;1;3560;0;3560;1;1;
/org.eclipse.ui.editors/src/org/eclipse/ui/texteditor/AbstractDecoratedTextEditorPreferenceConstants.java;3;2;6;1;6;5;6;0;45;0;0;5127;80;80;2;0;1;0;6;6334;1;6334;5;3;
/org.eclipse.ui.workbench/Eclipse UI/org/eclipse/ui/internal/dialogs/SavePerspectiveDialog.java;4;1;6;1;2;2;2;4;22;1;4;2208;33;33;1;0;0;4;6;2208;0;6338;6;4;
/org.eclipse.jdt.ui/core refactoring/org/eclipse/jdt/internal/corext/refactoring/participants/RenameProcessor.java;1;0;7;1;0;0;0;7;22;1;7;591;72;72;1;0;0;7;7;591;0;4624;7;1;
/org.eclipse.pde.ui/src/org/eclipse/pde/internal/ui/view/PluginsLabelProvider.java;2;1;3;1;2;2;2;1;6;0;1;2751;11;11;1;0;0;1;3;2751;0;6336;3;2;
/org.eclipse.jdt.ui/core extension/org/eclipse/jdt/internal/corext/dom/ListRewrite.java;1;0;4;1;1;1;1;3;41;1;3;4794;72;72;1;0;0;3;4;4794;0;5406;4;1;
/org.eclipse.jdt.ui/core extension/org/eclipse/jdt/internal/corext/template/java/JavaDocContextType.java;4;1;5;1;2;2;2;3;32;1;3;3090;52;52;1;0;0;3;5;3090;0;6340;5;4;
/org.eclipse.jdt.core.tests.model/workspace/Converter/src/test0151/Test.java;1;0;1;1;0;0;0;1;0;0;1;3714;0;0;1;0;0;1;1;3714;0;3714;1;1;
/org.eclipse.jdt.debug.tests/tests/org/eclipse/jdt/debug/tests/eval/QualifiedStaticFieldValueTests2.java;1;0;1;1;0;0;0;1;18;0;1;1274;18;18;1;0;0;1;1;1274;0;1274;1;1;
/org.eclipse.ui.ide/extensions/org/eclipse/ui/actions/CreateFolderAction.java;1;0;2;1;0;0;0;2;2;1;2;2263;2;2;1;0;0;2;2;2263;0;2611;2;1;
/org.eclipse.ui.workbench/Eclipse UI/org/eclipse/ui/commands/IImageBindingDefinition.java;1;0;4;1;0;0;0;4;2;2;3;1389;2;2;2;1;0;4;4;1417;1;1417;3;1;
/org.eclipse.ui.workbench/Eclipse UI/org/eclipse/ui/internal/skins/AbstractPresentationFactory.java;2;0;7;1;0;0;0;7;16;3;5;4328;31;31;3;2;0;7;7;4328;2;4469;5;2;
/org.eclipse.jdt.core.tests.compiler/src/org/eclipse/jdt/core/tests/compiler/parser/CompletionParserTest2.java;3;1;12;1;3;3;3;9;142;1;9;991;928;928;1;0;0;9;12;991;0;5733;12;3;
/org.eclipse.jdt.core.tests.model/workspace/JavaSearch/src/e9/A.java;1;0;1;1;0;0;0;1;0;0;1;3439;0;0;1;0;0;1;1;3439;0;3439;1;1;
/org.eclipse.jdt.core.tests.model/workspace/Converter/src/test0009/Test.java;1;0;1;1;0;0;0;1;0;0;1;3714;0;0;1;0;0;1;1;3714;0;3714;1;1;
/org.eclipse.ant.ui/Ant Tools Support/org/eclipse/ant/internal/ui/preferences/AddCustomDialog.java;2;0;10;2;1;1;1;9;39;2;7;1811;103;103;2;2;0;9;10;1856;2;5581;8;2;
/org.eclipse.jdt.debug.tests/tests/org/eclipse/jdt/debug/tests/eval/NestedTypeFieldValue_506.java;1;0;1;1;0;0;0;1;74;0;1;1274;74;74;1;0;0;1;1;1274;0;1274;1;1;
/org.eclipse.search.tests/src/org/eclipse/search/tests/filesearch/SearchResultPageTest.java;1;1;7;1;5;5;5;2;32;1;2;4647;90;90;1;0;0;2;7;4647;0;6124;7;1;
/org.eclipse.osgi/osgi/src/org/osgi/util/tracker/ServiceTrackerCustomizer.java;2;0;2;1;1;1;1;1;5;0;1;5079;5;5;1;0;0;1;2;5079;0;5536;2;2;
/org.eclipse.ui.ide/extensions/org/eclipse/ui/actions/MoveProjectAction.java;4;1;4;1;2;2;2;2;24;1;2;2263;28;28;1;0;0;2;4;2263;0;6338;4;4;
/org.eclipse.jdt.ui.tests.refactoring/resources/DeleteSourceReferenceEdit/A_test0_out.java;1;0;1;1;0;0;0;1;0;0;1;1652;0;0;1;0;0;1;1;1652;0;1652;1;1;
/org.eclipse.jdt.core.tests.model/workspace/Formatter/test288/A_out.java;1;0;1;1;0;0;0;1;0;0;1;2443;0;0;1;0;0;1;1;2443;0;2443;1;1;
/org.eclipse.update.core/src/org/eclipse/update/internal/operations/ConfigOperation.java;1;0;9;1;1;1;1;8;4;1;8;825;22;22;1;0;0;8;9;825;0;6336;9;1;
/org.eclipse.ui.workbench/Eclipse UI/org/eclipse/ui/internal/misc/OverlayIcon.java;1;0;1;1;0;0;0;1;0;0;1;2737;0;0;1;0;0;1;1;2737;0;2737;1;1;
/org.eclipse.jdt.core.tests.model/workspace/Formatter/test445/A_in.java;1;0;1;1;0;0;0;1;0;0;1;3513;0;0;1;0;0;1;1;3513;0;3513;1;1;
/org.eclipse.core.runtime.compatibility/src-runtime/org/eclipse/core/internal/url/PlatformURLHandlerFactory.java;4;1;5;1;2;2;2;3;52;1;3;3013;74;74;1;0;0;3;5;3013;0;5254;5;4;
/org.eclipse.ui.workbench/Eclipse UI/org/eclipse/ui/internal/layout/LayoutUtil.java;1;1;2;1;2;2;2;0;9;0;0;5452;9;9;1;0;0;0;2;5452;0;5786;2;1;
/org.eclipse.debug.core/core/org/eclipse/debug/internal/core/variables/WorkspaceExpander.java;2;0;2;1;0;0;0;2;0;1;2;737;0;0;1;0;0;2;2;737;0;2120;2;2;
/org.eclipse.swt/Eclipse SWT PI/photon/org/eclipse/swt/internal/photon/PgMap_t.java;1;0;1;1;0;0;0;1;1;0;1;808;1;1;1;0;0;1;1;808;0;808;1;1;
/org.eclipse.team.ui/src/org/eclipse/team/internal/ui/sync/views/TeamSynchronizingPerspective.java;1;0;5;1;0;0;0;5;62;1;5;1297;72;72;1;0;0;5;5;1297;0;2632;5;1;
/org.eclipse.debug.core/core/org/eclipse/debug/core/model/Breakpoint.java;2;1;5;1;2;2;2;3;16;1;3;2740;35;35;1;0;0;3;5;2740;0;6336;5;2;
/org.eclipse.jdt.ui.tests/ui/org/eclipse/jdt/ui/tests/core/JavaElementLabelsTest.java;2;0;3;1;1;1;1;2;66;1;2;3167;68;68;1;0;0;2;3;3167;0;6340;3;2;
/org.eclipse.compare.examples.xml/src/org/eclipse/compare/examples/xml/ui/StatusUtil.java;1;0;2;1;0;0;0;2;2;1;2;1106;2;2;1;0;0;2;2;1106;0;3938;2;1;
/org.eclipse.ui.workbench/Eclipse UI/org/eclipse/ui/part/PageSite.java;3;0;4;1;1;1;1;3;41;1;3;2862;51;51;1;0;0;3;4;2862;0;6338;4;3;
/org.eclipse.ui.ide/src/org/eclipse/ui/views/markers/internal/DialogProblemFilter.java;1;0;1;1;0;0;0;1;0;0;1;2208;0;0;1;0;0;1;1;2208;0;2208;1;1;
/org.eclipse.jdt.core.tests.model/workspace/Resolve/src/ResolveLocalClass4.java;1;0;1;1;0;0;0;1;0;0;1;1968;0;0;1;0;0;1;1;1968;0;1968;1;1;
/org.eclipse.jdt.ui/core refactoring/org/eclipse/jdt/internal/corext/refactoring/util/TextChangeManager.java;4;0;5;1;1;1;1;4;15;1;4;1577;25;25;1;0;0;4;5;1577;0;6340;5;4;
/org.eclipse.ui.tests/Eclipse UI Tests/org/eclipse/ui/tests/api/IPerspectiveListenerTest.java;1;0;1;1;0;0;0;1;8;0;1;3091;8;8;1;0;0;1;1;3091;0;3091;1;1;
/org.eclipse.jdt.core.tests.model/workspace/Converter/p1/A.java;1;0;1;1;0;0;0;1;0;0;1;3714;0;0;1;0;0;1;1;3714;0;3714;1;1;
/org.eclipse.ui.tests/Eclipse UI Tests/org/eclipse/ui/tests/dnd/DragDropPerspectiveFactory.java;1;0;1;1;0;0;0;1;0;0;1;5007;0;0;1;0;0;1;1;5007;0;5007;1;1;
/org.eclipse.pde.ui/src_Forms/org/eclipse/pde/internal/ui/model/build/BuildEntry.java;3;1;8;1;8;8;8;0;46;0;0;5298;145;145;1;0;0;0;8;5298;0;6336;8;3;
/org.eclipse.swt.tests/JUnit Tests/org/eclipse/swt/tests/junit/Test_org_eclipse_swt_widgets_Composite.java;2;0;2;1;0;0;0;2;22;1;2;2105;37;37;1;0;0;2;2;2105;0;2144;2;2;
/org.eclipse.update.ui/srcnew/org/eclipse/update/internal/ui/wizards/UnifiedReviewPage.java;3;0;27;3;0;0;0;27;205;5;16;329;874;874;5;11;0;27;27;749;11;825;16;3;
/org.eclipse.jdt.ui.tests.refactoring/resources/MoveInnerToTopLevel/test20/out/A1.java;1;0;1;1;0;0;0;1;2;0;1;305;2;2;1;0;0;1;1;305;0;305;1;1;
/org.eclipse.core.resources/src/org/eclipse/core/internal/resources/SaveManager.java;2;1;15;1;3;3;3;12;2892;2;11;230;3169;3169;2;1;0;12;15;230;1;5254;14;2;
/org.eclipse.jdt.ui.tests.refactoring/resources/ExtractMethodWorkSpace/ExtractMethodTests/semicolon_in/A_test404.java;1;0;1;1;0;0;0;1;2;0;1;844;2;2;1;0;0;1;1;844;0;844;1;1;
/org.eclipse.team.tests.cvs.core/src/org/eclipse/team/tests/ccvs/ui/old/ICriteria.java;1;0;2;1;0;0;0;2;0;1;2;2632;0;0;1;0;0;2;2;2632;0;4216;2;1;
/org.eclipse.core.filebuffers.tests/src/org/eclipse/core/filebuffers/tests/FilebuffersTestPlugin.java;1;0;2;1;1;1;1;1;2;0;1;5082;2;2;1;0;0;1;2;5082;0;6340;2;1;
/org.eclipse.pde.ui/src/org/eclipse/pde/internal/ui/editor/build/AddLibraryDialog.java;2;1;7;1;5;5;5;2;137;1;2;1749;166;166;1;0;0;2;7;1749;0;6336;7;2;
/org.eclipse.update.configurator/src/org/eclipse/update/configurator/migration/PluginParser.java;3;0;4;1;0;0;0;4;5;1;4;3014;7;7;1;0;0;4;4;3014;0;3087;4;3;
/org.eclipse.text/src/org/eclipse/jface/text/templates/ContextType.java;2;1;10;1;2;2;2;8;110;2;6;4259;324;324;2;2;0;8;10;4382;2;5177;8;2;
/org.eclipse.jdt.core.tests.model/workspace/Formatter/test140/A_in.java;1;0;2;1;0;0;0;2;3;1;2;2425;3;3;1;0;0;2;2;2425;0;2442;2;1;
/org.eclipse.jdt.core/model/org/eclipse/jdt/internal/core/ReconcileWorkingCopyOperation.java;3;0;14;1;1;1;1;13;63;2;12;818;149;149;2;1;0;13;14;818;1;6078;13;3;
/org.eclipse.pde.core/src/org/eclipse/pde/internal/core/isite/ISiteBuild.java;2;1;4;1;3;3;3;1;10;0;1;4203;17;17;1;0;0;1;4;4203;0;6336;4;2;
/org.eclipse.jdt.core.tests.model/workspace/Formatter/test459/A_in.java;1;0;1;1;0;0;0;1;0;0;1;3890;0;0;1;0;0;1;1;3890;0;3890;1;1;
/org.eclipse.core.tests.harness/src/org/eclipse/core/tests/harness/DeltaDebugListener.java;2;0;2;1;1;1;1;1;97;0;1;5057;99;99;1;0;0;1;2;5057;0;5146;2;2;
/org.eclipse.ui.ide/extensions/org/eclipse/ui/actions/AddTaskAction.java;1;0;2;1;0;0;0;2;2;1;2;2263;2;2;1;0;0;2;2;2263;0;2611;2;1;
/org.eclipse.ant.ui/Ant Tools Support/org/eclipse/ant/ui/internal/preferences/MinimizedFileSystemElement.java;1;0;2;1;0;0;0;2;0;1;2;250;0;0;1;0;0;2;2;250;0;1811;2;1;
/org.eclipse.jdt.core/dom/org/eclipse/jdt/core/dom/AbstractTypeDeclaration.java;1;1;6;1;2;2;2;4;179;1;4;4054;260;260;1;0;0;4;6;4054;0;5268;6;1;
/org.eclipse.help/src/org/eclipse/help/internal/model/ILinkElement.java;1;0;2;1;1;1;1;1;9;0;1;3513;9;9;1;0;0;1;2;3513;0;5827;2;1;
/org.eclipse.jdt.debug.ui/ui/org/eclipse/jdt/internal/debug/ui/actions/OpenReceivingTypeHierarchyAction.java;1;0;1;1;0;0;0;1;3;0;1;1275;3;3;1;0;0;1;1;1275;0;1275;1;1;
/org.eclipse.ui.workbench/Eclipse UI/org/eclipse/ui/internal/contexts/ws/WorkbenchPageContextSupport.java;2;0;6;1;0;0;0;6;25;1;6;3066;55;55;1;0;0;6;6;3066;0;4144;6;2;
/org.eclipse.jdt.core.tests.model/workspace/Formatter/test442/A_in.java;1;0;1;1;0;0;0;1;0;0;1;3513;0;0;1;0;0;1;1;3513;0;3513;1;1;
/org.eclipse.ui.workbench.texteditor/src/org/eclipse/ui/texteditor/IUpdate.java;1;0;1;1;1;1;1;0;2;0;0;6340;2;2;1;0;0;0;1;6340;0;6340;1;1;
/org.eclipse.ui.views/src/org/eclipse/ui/views/internal/markers/FieldCreationTime.java;1;0;2;1;0;0;0;2;0;0;1;749;0;0;2;1;0;2;2;749;1;749;1;1;
/org.eclipse.jdt.core.tests.model/workspace/Converter/NO_WORKING.java;1;0;1;1;0;0;0;1;0;0;1;3714;0;0;1;0;0;1;1;3714;0;3714;1;1;
/org.eclipse.jdt.ui/core refactoring/org/eclipse/jdt/internal/corext/refactoring/rename/RenameRefactoring.java;2;0;16;1;0;0;0;16;110;2;14;1125;295;295;2;2;0;16;16;1125;2;4654;14;2;
/org.eclipse.jdt.ui.tests.refactoring/resources/PasteSourceReference/test1/out/B.java;1;0;1;1;0;0;0;1;0;0;1;1311;0;0;1;0;0;1;1;1311;0;1311;1;1;
/org.eclipse.ui.workbench/Eclipse UI/org/eclipse/ui/internal/dialogs/ExportWizard.java;1;0;1;1;0;0;0;1;12;0;1;2737;12;12;1;0;0;1;1;2737;0;2737;1;1;
/org.eclipse.ui.ide/src/org/eclipse/ui/views/navigator/ResourceSorter.java;1;0;1;1;0;0;0;1;0;0;1;2208;0;0;1;0;0;1;1;2208;0;2208;1;1;
/org.eclipse.core.tests.runtime/src/org/eclipse/core/tests/internal/plugins/PluginResolveTest_23.java;1;0;1;1;0;0;0;1;0;0;1;3014;0;0;1;0;0;1;1;3014;0;3014;1;1;
/org.eclipse.jdt.ui.tests.refactoring/resources/RenamePackage/testImportFromMultiRoots5/in/srcPrg/p/p/A.java;1;0;1;1;0;0;0;1;0;0;1;4105;0;0;1;0;0;1;1;4105;0;4105;1;1;
/org.eclipse.ui.tests/Eclipse JFace Tests/org/eclipse/jface/tests/viewers/AllTests.java;6;1;7;2;2;2;2;5;5;2;4;2754;19;19;2;1;0;5;7;4565;1;6338;6;6;
/org.eclipse.ui.editors/src/org/eclipse/ui/texteditor/AnnotationTypeLookup.java;4;1;8;2;4;4;4;4;5;2;3;3217;17;17;2;1;0;4;8;3675;1;6334;7;4;
/org.eclipse.osgi/core/framework/org/eclipse/osgi/framework/internal/core/BundleFragment.java;4;2;16;1;5;4;5;11;219;1;11;3013;435;435;2;0;1;11;16;5116;1;6337;15;4;
/org.eclipse.swt.tools/JNI Generation/org/eclipse/swt/tools/internal/JNIGeneratorAppUI.java;3;0;4;1;0;0;0;4;212;2;3;4175;215;215;2;1;0;4;4;4270;1;4563;3;3;
/org.eclipse.jdt.core.tests.compiler/src/org/eclipse/jdt/core/tests/util/CompilerTestSetup.java;2;0;3;1;0;0;0;3;6;1;3;2389;8;8;1;0;0;3;3;2389;0;4369;3;2;
/org.eclipse.help/src/org/eclipse/help/internal/protocols/HelpURL.java;1;0;3;1;0;0;0;3;72;1;3;105;76;76;1;0;0;3;3;105;0;1010;3;1;
/org.eclipse.jdt.core.tests.model/workspace/Formatter/test350/A_in.java;1;0;1;1;0;0;0;1;0;0;1;3029;0;0;1;0;0;1;1;3029;0;3029;1;1;
/org.eclipse.jdt.debug.ui/ui/org/eclipse/jdt/internal/debug/ui/actions/StepIntoSelectionActionDelegate.java;4;1;11;2;4;4;4;7;249;1;7;3700;366;366;1;0;0;7;11;3700;0;6336;11;4;
/org.eclipse.jdt.ui.tests.refactoring/test cases/org/eclipse/jdt/ui/tests/refactoring/RenamePackageTests.java;5;1;15;1;2;2;2;13;281;1;13;130;431;431;1;0;0;13;15;130;0;6340;15;5;
/org.eclipse.update.core/src/org/eclipse/update/core/model/FeatureReferenceModel.java;2;1;6;1;4;4;4;2;8;1;2;890;32;32;1;0;0;2;6;890;0;6336;6;2;
/org.eclipse.jdt.ui.tests.refactoring/resources/DeleteSourceReferenceEdit/A_testField1_in.java;1;0;1;1;0;0;0;1;0;0;1;1652;0;0;1;0;0;1;1;1652;0;1652;1;1;
/org.eclipse.ui.workbench.texteditor/src/org/eclipse/ui/texteditor/link/EditorLinkedModeUI.java;2;1;2;1;2;2;2;0;2;0;0;5177;2;2;1;0;0;0;2;5177;0;6340;2;2;
/org.eclipse.jdt.ui.tests.refactoring/resources/MoveInstanceMethod/canMove/test23/in/A.java;1;0;1;1;0;0;0;1;0;0;1;1603;0;0;1;0;0;1;1;1603;0;1603;1;1;
/org.eclipse.ant.ui/Ant Tools Support/org/eclipse/ant/internal/ui/preferences/DialogSettingsHelper.java;1;0;1;1;0;0;0;1;0;0;1;4978;0;0;1;0;0;1;1;4978;0;4978;1;1;
/org.eclipse.jdt.core.tests.model/workspace/Formatter/test048/A_out.java;1;0;1;1;0;0;0;1;0;0;1;2425;0;0;1;0;0;1;1;2425;0;2425;1;1;
/org.eclipse.core.tests.runtime/src/org/eclipse/core/tests/internal/plugins/PluginResolveTest_17.java;1;0;1;1;0;0;0;1;0;0;1;3014;0;0;1;0;0;1;1;3014;0;3014;1;1;
/org.eclipse.ui.workbench/Eclipse UI/org/eclipse/ui/actions/NewWizardAction.java;4;2;8;2;3;2;3;5;62;1;5;2737;114;114;2;0;1;5;8;6338;1;6338;7;4;
/org.eclipse.pde.core/srcnew/org/eclipse/pde/internal/core/plugin/XEErrorReporter.java;1;0;1;1;0;0;0;1;0;0;1;2906;0;0;1;0;0;1;1;2906;0;2906;1;1;
/org.eclipse.swt.opengl.examples/src/org/eclipse/swt/opengl/examples/LightTab.java;1;0;1;1;0;0;0;1;0;0;1;1175;0;0;1;0;0;1;1;1175;0;1175;1;1;
/org.eclipse.ui.workbench/Eclipse UI/org/eclipse/ui/internal/contexts/IContextRegistryEvent.java;1;0;1;1;0;0;0;1;0;0;1;1422;0;0;1;0;0;1;1;1422;0;1422;1;1;
/org.eclipse.pde.ui/src_Forms/org/eclipse/pde/internal/ui/neweditor/plugin/PackageSelectionDialog2.java;1;0;2;1;1;1;1;1;0;0;1;5042;0;0;1;0;0;1;2;5042;0;5171;2;1;
/org.eclipse.jdt.ui/ui/org/eclipse/jdt/ui/wizards/NewJavaProjectWizardPage.java;2;0;3;1;1;1;1;2;4;1;2;762;9;9;1;0;0;2;3;762;0;6340;3;2;
/org.eclipse.jdt.ui.tests.refactoring/test cases/org/eclipse/jdt/ui/tests/xml/B_TypeExtender.java;1;0;5;1;0;0;0;5;11;1;5;2204;17;17;1;0;0;5;5;2204;0;4108;5;1;
/org.eclipse.pde.ui/srcnew/org/eclipse/pde/internal/ui/editor/manifest/NotifyingReconciler.java;1;0;1;1;0;0;0;1;0;0;1;2320;0;0;1;0;0;1;1;2320;0;2320;1;1;
/org.eclipse.jdt.ui/ui/org/eclipse/jdt/internal/ui/search/SearchParticipantRecord.java;1;0;1;1;1;1;1;0;0;0;0;5590;0;0;1;0;0;0;1;5590;0;5590;1;1;
/org.eclipse.pde.core/src/org/eclipse/pde/internal/core/schema/FileSchemaDescriptor.java;3;1;3;1;2;2;2;1;4;0;1;4912;10;10;1;0;0;1;3;4912;0;6336;3;3;
/org.eclipse.team.ftp/src/org/eclipse/team/internal/ftp/subscriber/FTPSubscriber.java;2;0;6;1;1;1;1;5;64;1;5;3200;103;103;1;0;0;5;6;3200;0;6337;6;2;
/org.eclipse.ui.workbench/Eclipse UI/org/eclipse/ui/IPartListener2.java;2;1;3;1;3;3;3;0;32;0;0;5483;52;52;1;0;0;0;3;5483;0;6338;3;2;
/org.eclipse.ui.externaltools/External Tools Base/org/eclipse/ui/externaltools/internal/ui/FileSelectionDialog.java;2;1;4;1;2;2;2;2;349;1;2;1240;359;359;1;0;0;2;4;1240;0;6336;4;2;
/org.eclipse.ui.ide/src/org/eclipse/ui/views/markers/internal/ProblemFilter.java;2;0;2;1;0;0;0;2;24;1;2;2208;24;24;1;0;0;2;2;2208;0;3214;2;2;
/org.eclipse.jdt.debug/model/org/eclipse/jdt/internal/debug/core/breakpoints/JavaMethodBreakpoint.java;5;0;8;1;1;1;1;7;30;1;7;363;102;102;1;0;0;7;8;363;0;6336;8;5;
/org.eclipse.jdt.core.tests.model/workspace/Formatter/test155/A_out.java;1;0;1;1;0;0;0;1;0;0;1;2425;0;0;1;0;0;1;1;2425;0;2425;1;1;
/org.eclipse.jdt.ui.tests.refactoring/resources/InlineMethodWorkspace/TestCases/receiver_out/TestNoImplicitReceiver.java;1;0;1;1;0;0;0;1;2;0;1;845;2;2;1;0;0;1;1;845;0;845;1;1;
/org.eclipse.core.tests.runtime/src/org/eclipse/core/tests/internal/plugins/ConflictResolveTest_1.java;1;0;1;1;0;0;0;1;0;0;1;3014;0;0;1;0;0;1;1;3014;0;3014;1;1;
/org.eclipse.jdt.core.tests.model/workspace/Formatter/test259/A_in.java;1;0;1;1;0;0;0;1;0;0;1;2442;0;0;1;0;0;1;1;2442;0;2442;1;1;
/org.eclipse.pde.ui/src_Forms/org/eclipse/pde/internal/ui/neweditor/UTF8InputContext.java;1;0;4;1;0;0;0;4;7;1;4;3777;8;8;1;0;0;4;4;3777;0;4313;4;1;
/org.eclipse.jdt.ui.tests.refactoring/resources/ExtractMethodWorkSpace/ExtractMethodTests/return_in/A_test713.java;1;0;1;1;0;0;0;1;2;0;1;844;2;2;1;0;0;1;1;844;0;844;1;1;
/org.eclipse.help.tests/src/org/eclipse/help/tests/launching/DisplayHelpResource_externalHref.java;1;1;3;1;2;2;2;1;57;0;1;2732;65;65;1;0;0;1;3;2732;0;6337;3;1;
/org.eclipse.jdt.ui.tests.refactoring/resources/ConvertAnonymousToNested/canConvert/A_test25_out.java;1;0;1;1;0;0;0;1;0;0;1;3195;0;0;1;0;0;1;1;3195;0;3195;1;1;
/org.eclipse.team.cvs.ui/src/org/eclipse/team/internal/ccvs/ui/repo/RefreshRemoteProjectSelectionPage.java;1;0;1;1;0;0;0;1;1;0;1;2381;1;1;1;0;0;1;1;2381;0;2381;1;1;
/org.eclipse.ant.ui/Ant Tools Support/org/eclipse/ant/internal/ui/model/ImageDescriptorRegistry.java;1;0;3;1;1;1;1;2;4;1;2;1811;6;6;1;0;0;2;3;1811;0;6336;3;1;
/org.eclipse.jdt.ui/ui/org/eclipse/jdt/internal/ui/viewsupport/DecoratingJavaLabelProvider.java;2;0;5;1;1;1;1;4;102;1;4;435;148;148;1;0;0;4;5;435;0;6340;5;2;
/org.eclipse.jdt.core.tests.model/src/org/eclipse/jdt/core/tests/model/ReconcilerTests.java;6;6;25;2;8;3;8;17;223;2;16;241;753;753;6;1;5;17;25;5608;6;5913;19;6;
/org.eclipse.ui.workbench/Eclipse UI/org/eclipse/ui/internal/commands/KeyConfigurationDefinitionHandle.java;1;0;2;1;0;0;0;2;0;0;1;1389;0;0;2;1;0;2;2;1389;1;1389;1;1;
/org.eclipse.jdt.debug.ui/ui/org/eclipse/jdt/internal/debug/ui/actions/PrimitiveOptionsDialog.java;1;0;1;1;0;0;0;1;14;0;1;4410;14;14;1;0;0;1;1;4410;0;4410;1;1;
/org.eclipse.jdt.debug.tests/tests/org/eclipse/jdt/debug/tests/core/WatchExpressionTests.java;1;0;2;1;0;0;0;2;48;1;2;1794;65;65;1;0;0;2;2;1794;0;1859;2;1;
/org.eclipse.swt/Eclipse SWT/gtk1x/org/eclipse/swt/widgets/ProgressBar.java;1;0;1;1;0;0;0;1;0;0;1;2327;0;0;1;0;0;1;1;2327;0;2327;1;1;
/org.eclipse.ui.workbench/Eclipse UI/org/eclipse/ui/internal/contexts/ProxyContextManager.java;3;1;5;1;2;2;2;3;7;1;3;3066;20;20;1;0;0;3;5;3066;0;6338;5;3;
/org.eclipse.pde.ui/src/org/eclipse/pde/ui/templates/TemplateOption.java;2;1;4;1;4;4;4;0;90;0;0;5115;170;170;1;0;0;0;4;5115;0;6336;4;2;
/org.eclipse.swt/Eclipse SWT Browser/motif/org/eclipse/swt/browser/Browser.java;2;1;39;1;9;9;9;30;1044;4;24;1654;3132;3132;4;6;0;30;39;2459;6;6352;33;2;
/org.eclipse.ui.workbench/Eclipse UI/org/eclipse/ui/internal/presentation/IPresentationDefinition.java;1;0;2;1;0;0;0;2;0;1;2;4237;0;0;1;0;0;2;2;4237;0;4392;2;1;
/org.eclipse.jdt.ui.tests.refactoring/test cases/org/eclipse/jdt/ui/tests/refactoring/TestMoveParticipantShared.java;1;0;1;1;0;0;0;1;0;0;1;4913;0;0;1;0;0;1;1;4913;0;4913;1;1;
/org.eclipse.jdt.core/compiler/org/eclipse/jdt/internal/compiler/ast/TypeParameter.java;1;0;1;1;0;0;0;1;0;0;1;2728;0;0;1;0;0;1;1;2728;0;2728;1;1;
/org.eclipse.ui.workbench/Eclipse UI/org/eclipse/ui/internal/csm/activities/ObjectActivityManager.java;1;0;2;1;0;0;0;2;0;0;1;2443;0;0;2;1;0;2;2;2443;1;2443;1;1;
/org.eclipse.jdt.core.tests.model/workspace/Formatter/test048/A_in.java;1;0;1;1;0;0;0;1;0;0;1;2425;0;0;1;0;0;1;1;2425;0;2425;1;1;
/org.eclipse.search/search/org/eclipse/search/internal/ui/SortDropDownAction.java;1;0;2;1;1;1;1;1;2;0;1;1346;4;4;1;0;0;1;2;1346;0;6340;2;1;
/org.eclipse.core.tests.resources/src/org/eclipse/core/tests/internal/localstore/BlobStoreTest.java;1;2;3;1;3;2;3;0;451;0;0;5147;498;498;2;0;1;0;3;5147;1;6127;2;1;
/org.eclipse.ui.views/src/org/eclipse/ui/views/tasklist/ITaskListHelpContextIds.java;1;0;1;1;0;0;0;1;0;0;1;2738;0;0;1;0;0;1;1;2738;0;2738;1;1;
/org.eclipse.jdt.core/model/org/eclipse/jdt/internal/core/BufferFactoryWrapper.java;2;0;8;2;1;1;1;7;40;2;6;825;68;68;2;1;0;7;8;1048;1;5179;7;2;
/org.eclipse.ui.ide/src/org/eclipse/ui/internal/ide/dialogs/InternalBase64Encoder.java;1;0;1;1;0;0;0;1;0;0;1;2264;0;0;1;0;0;1;1;2264;0;2264;1;1;
/org.eclipse.debug.ui/ui/org/eclipse/debug/ui/launchVariables/components/SpecificFileResourceComponent.java;1;0;2;1;0;0;0;2;0;1;2;562;0;0;1;0;0;2;2;562;0;647;2;1;
/org.eclipse.core.tools.resources/src/org/eclipse/core/tools/metadata/DumperFactory.java;1;0;1;1;1;1;1;0;0;0;0;6302;0;0;1;0;0;0;1;6302;0;6302;1;1;
/org.eclipse.ui.ide/src/org/eclipse/ui/actions/CopyProjectOperation.java;2;0;3;1;0;0;0;3;14;1;3;1511;14;14;1;0;0;3;3;1511;0;2263;3;2;
/org.eclipse.core.resources/src/org/eclipse/core/internal/watson/IElementContentVisitor.java;1;0;1;1;1;1;1;0;26;0;0;5146;26;26;1;0;0;0;1;5146;0;5146;1;1;
/org.eclipse.core.tools/src/org/eclipse/core/tools/TableSelectionProviderDecorator.java;1;0;1;1;1;1;1;0;0;0;0;6302;0;0;1;0;0;0;1;6302;0;6302;1;1;
/org.eclipse.jdt.ui/ui/org/eclipse/jdt/internal/ui/javaeditor/CompilationUnitEditor.java;5;3;82;2;20;16;20;62;328;4;50;500;2218;2218;4;12;4;62;82;4644;16;6340;66;5;
/org.eclipse.osgi/core/framework/org/eclipse/osgi/framework/internal/core/Constants.java;4;1;11;1;3;3;3;8;130;1;8;3013;335;335;1;0;0;8;11;3013;0;5891;11;4;
/org.eclipse.ui.ide/src/org/eclipse/ui/internal/ide/IDEApplication.java;5;1;24;1;8;8;8;16;307;2;15;1512;709;709;2;1;0;16;24;2785;1;6338;23;5;
/org.eclipse.debug.core/core/org/eclipse/debug/internal/core/memory/MemoryBlockManager.java;2;1;3;1;3;3;3;0;32;0;0;5254;59;59;1;0;0;0;3;5254;0;5475;3;2;
/org.eclipse.ant.tests.ui/Ant Editor Tests/org/eclipse/ui/externaltools/internal/ant/editor/test/AntEditorContentOutlineTests.java;1;0;4;1;0;0;0;4;98;1;4;178;108;108;1;0;0;4;4;178;0;1274;4;1;
/org.eclipse.pde.ui/src_Forms/org/eclipse/pde/internal/ui/neweditor/build/RuntimeInfoSection.java;2;2;9;1;7;6;7;2;372;1;2;4406;519;519;2;0;1;2;9;5415;1;5431;8;2;
/org.eclipse.jface.text/src/org/eclipse/jface/contentassist/ISubjectControlContextInformationValidator.java;1;2;4;1;4;3;4;0;12;0;0;5199;20;20;2;0;1;0;4;6340;1;6356;3;1;
/org.eclipse.compare/compare/org/eclipse/compare/IViewerCreator.java;1;0;1;1;0;0;0;1;2;0;1;3935;2;2;1;0;0;1;1;3935;0;3935;1;1;
/org.eclipse.jdt.core.tests.model/workspace/Formatter/test454/A_in.java;1;0;1;1;0;0;0;1;0;0;1;3788;0;0;1;0;0;1;1;3788;0;3788;1;1;
/org.eclipse.core.resources.win32/src/org/eclipse/core/internal/resources/refresh/win32/Win32Natives.java;1;0;2;1;0;0;0;2;17;1;2;3695;17;17;1;0;0;2;2;3695;0;4925;2;1;
/org.eclipse.debug.ui/ui/org/eclipse/debug/internal/ui/actions/AbstractListenerActionDelegate.java;1;0;1;1;0;0;0;1;4;0;1;307;4;4;1;0;0;1;1;307;0;307;1;1;
/org.eclipse.team.webdav/src/org/eclipse/team/internal/target/subscriber/TargetSubscriberResource.java;2;0;3;1;0;0;0;3;22;1;3;3514;22;22;1;0;0;3;3;3514;0;4349;3;2;
/org.eclipse.swt.tests/JUnit Tests/org/eclipse/swt/tests/junit/Test_org_eclipse_swt_custom_StyledTextContent.java;1;0;1;1;0;0;0;1;41;0;1;2104;41;41;1;0;0;1;1;2104;0;2104;1;1;
/org.eclipse.core.tests.runtime/src/org/eclipse/core/tests/internal/plugins/SoftPrereqTest_22.java;1;0;1;1;0;0;0;1;0;0;1;3014;0;0;1;0;0;1;1;3014;0;3014;1;1;
/org.eclipse.pde.core/src/org/eclipse/pde/internal/core/schema/SchemaObject.java;2;1;3;1;2;2;2;1;14;0;1;4203;25;25;1;0;0;1;3;4203;0;6336;3;2;
/org.eclipse.help.ide/src/org/eclipse/help/ui/internal/ide/OpenHelpSearchPageAction.java;1;2;4;1;3;2;3;1;16;0;1;1778;22;22;2;0;1;1;4;6337;1;6337;3;1;
/org.eclipse.team.ui/src/org/eclipse/team/internal/ui/sync/pages/StatusLineContributionGroup.java;1;0;1;1;0;0;0;1;0;0;1;2517;0;0;1;0;0;1;1;2517;0;2517;1;1;
/org.eclipse.swt/Eclipse SWT Mozilla/common/org/eclipse/swt/internal/mozilla/nsISupportsWeakReference.java;1;0;1;1;0;0;0;1;0;0;1;1654;0;0;1;0;0;1;1;1654;0;1654;1;1;
/org.eclipse.jdt.ui/core refactoring/org/eclipse/ltk/core/refactoring/participants/ISharableParticipant.java;1;0;2;1;0;0;0;2;0;1;2;4624;0;0;1;0;0;2;2;4624;0;4864;2;1;
/org.eclipse.jdt.ui/ui/org/eclipse/jdt/internal/ui/preferences/formatter/GeneralSettingsTabPage.java;1;0;2;1;0;0;0;2;0;0;1;3103;0;0;2;1;0;2;2;3103;1;3103;1;1;
/org.eclipse.jdt.ui/ui/org/eclipse/jdt/internal/ui/reorg/PasteResourcesFromClipboardAction.java;2;0;7;1;0;0;0;7;6;1;7;130;18;18;1;0;0;7;7;130;0;1111;7;2;
/org.eclipse.core.tests.resources/src/org/eclipse/core/tests/internal/resources/TestNature.java;1;0;2;1;2;1;2;0;67;0;0;5147;67;67;2;0;1;0;2;5147;1;5147;1;1;
/org.eclipse.jdt.ui.tests.refactoring/resources/SurroundWithWorkSpace/SurroundWithTests/trycatch_in/TestWrappedLocal2.java;1;0;1;1;0;0;0;1;5;0;1;845;5;5;1;0;0;1;1;845;0;845;1;1;
/org.eclipse.jdt.ui/ui/org/eclipse/jdt/ui/actions/FindDeclarationsInHierarchyAction.java;2;0;3;1;1;1;1;2;14;1;2;3266;21;21;1;0;0;2;3;3266;0;6340;3;2;
/org.eclipse.jdt.ui/ui/org/eclipse/jdt/internal/ui/text/javadoc/JavaDocAutoIndentStrategy.java;5;2;16;1;4;3;4;12;162;1;12;583;271;271;2;0;1;12;16;5270;1;6340;15;5;
/org.eclipse.jdt.core/compiler/org/eclipse/jdt/internal/compiler/problem/AbortCompilation.java;2;0;3;1;1;1;1;2;46;1;2;1127;50;50;1;0;0;2;3;1127;0;5615;3;2;
/org.eclipse.jdt.ui.tests.refactoring/test cases/org/eclipse/jdt/ui/tests/nls/NLSSubstitutionTest.java;2;1;3;1;3;3;3;0;26;0;0;5186;36;36;1;0;0;0;3;5186;0;6340;3;2;
/org.eclipse.jdt.debug.ui/ui/org/eclipse/jdt/internal/debug/ui/display/JavaInspectExpression.java;2;0;3;1;0;0;0;3;48;1;3;1595;83;83;1;0;0;3;3;1595;0;1813;3;2;
/org.eclipse.ui.workbench/Eclipse UI/org/eclipse/ui/commands/IActiveContextService.java;1;0;2;1;0;0;0;2;0;1;2;689;0;0;1;0;0;2;2;689;0;767;2;1;
/org.eclipse.ui.intro/src/org/eclipse/ui/internal/intro/impl/model/IntroURL.java;2;2;23;1;23;20;23;0;113;0;0;5115;751;751;2;0;3;0;23;5314;3;6266;20;2;
/org.eclipse.ui.ide/src/org/eclipse/ui/dialogs/WizardNewProjectReferencePage.java;2;0;4;1;0;0;0;4;6;1;4;1511;10;10;1;0;0;4;4;1511;0;2263;4;2;
/org.eclipse.ui.workbench/Eclipse UI/org/eclipse/ui/internal/contexts/ContextHandle.java;1;0;3;1;0;0;0;3;9;1;3;1294;9;9;1;0;0;3;3;1294;0;1417;3;1;
/org.eclipse.jdt.core.tests.model/workspace/Converter/test0006/Test.java;1;0;1;1;0;0;0;1;0;0;1;3714;0;0;1;0;0;1;1;3714;0;3714;1;1;
/org.eclipse.jdt.core.tests.model/workspace/Formatter/test063/A_out.java;1;0;1;1;0;0;0;1;0;0;1;2425;0;0;1;0;0;1;1;2425;0;2425;1;1;
/org.eclipse.ui.workbench/Eclipse UI/org/eclipse/ui/internal/roles/RoleParser.java;2;0;5;1;0;0;0;5;134;2;4;1959;137;137;2;1;0;5;5;2005;1;2443;4;2;
/org.eclipse.jface/src/org/eclipse/jface/preference/StringButtonFieldEditor.java;2;1;3;1;2;2;2;1;244;0;1;392;254;254;1;0;0;1;3;392;0;6338;3;2;
/org.eclipse.ant.ui/Ant Editor/org/eclipse/ant/internal/ui/dtd/AntDTDMessages.java;1;0;1;1;0;0;0;1;0;0;1;1811;0;0;1;0;0;1;1;1811;0;1811;1;1;
/org.eclipse.team.core/src/org/eclipse/team/core/subscribers/TeamProvider.java;2;0;10;1;0;0;0;10;221;1;10;649;279;279;1;0;0;10;10;649;0;1852;10;2;
/org.eclipse.swt/Eclipse SWT PI/win32/org/eclipse/swt/internal/win32/MONITORINFO.java;2;0;2;1;0;0;0;2;4;1;2;13;4;4;1;0;0;2;2;13;0;2915;2;2;
/org.eclipse.jdt.core.tests.compiler/src/org/eclipse/jdt/core/tests/compiler/regression/JavadocTest.java;3;1;14;3;4;4;4;10;625;2;9;2887;751;751;2;1;0;10;14;4711;1;6100;13;3;
/org.eclipse.debug.ui/ui/org/eclipse/debug/ui/IObjectBrowser.java;2;0;4;1;0;0;0;4;4;1;4;861;6;6;1;0;0;4;4;861;0;2564;4;2;
/org.eclipse.ui.intro/src/org/eclipse/ui/internal/intro/impl/html/IIntroHTMLConstants.java;3;1;5;1;5;5;5;0;3;0;0;5115;8;8;1;0;0;0;5;5115;0;6154;5;3;
/org.eclipse.ui.workbench/Eclipse UI/org/eclipse/ui/commands/CommandHandlerServiceFactory.java;1;0;2;1;0;0;0;2;0;1;2;3131;0;0;1;0;0;2;2;3131;0;4144;2;1;
/org.eclipse.jdt.debug.ui/ui/org/eclipse/jdt/internal/debug/ui/classpath/ClasspathEntry.java;3;1;8;1;2;2;2;6;36;2;5;2691;73;73;2;1;0;6;8;4973;1;6336;7;3;
/org.eclipse.jdt.ui/ui/org/eclipse/jdt/internal/ui/text/AbstractInformationControl.java;3;1;23;2;2;2;2;21;334;3;16;506;1116;1116;3;5;0;21;23;4485;5;6340;18;3;
/org.eclipse.swt.tests/JUnit Tests/org/eclipse/swt/tests/junit/Test_org_eclipse_swt_ole_win32_OleParameterDescription.java;1;0;1;1;0;0;0;1;0;0;1;2176;0;0;1;0;0;1;1;2176;0;2176;1;1;
/org.eclipse.pde.core/src/org/eclipse/pde/internal/core/ifeature/IFeatureInstallHandler.java;2;1;3;1;2;2;2;1;6;0;1;4203;15;15;1;0;0;1;3;4203;0;6336;3;2;
/org.eclipse.jdt.core/compiler/org/eclipse/jdt/internal/compiler/ast/ExtendedStringLiteral.java;2;0;3;1;0;0;0;3;5;1;3;991;11;11;1;0;0;3;3;991;0;3560;3;2;
/org.eclipse.team.tests.cvs.core/src/org/eclipse/team/tests/ccvs/ui/sync/SyncViewTests.java;2;0;5;1;0;0;0;5;79;2;4;1217;92;92;2;1;0;5;5;1217;1;1417;4;2;
/org.eclipse.team.core/src/org/eclipse/team/internal/core/target/LocationMapping.java;1;0;1;1;0;0;0;1;0;0;1;2495;0;0;1;0;0;1;1;2495;0;2495;1;1;
/org.eclipse.ui.views/src/org/eclipse/ui/views/markers/internal/DialogTaskProperties.java;2;0;2;1;0;0;0;2;0;1;2;755;0;0;1;0;0;2;2;755;0;2738;2;2;
/org.eclipse.debug.ui/ui/org/eclipse/debug/internal/ui/actions/ExecutionAction.java;1;0;1;1;0;0;0;1;1;0;1;1788;1;1;1;0;0;1;1;1788;0;1788;1;1;
/org.eclipse.ui.workbench/Eclipse UI/org/eclipse/ui/internal/commands/old/CaptureEvent.java;1;0;2;1;0;0;0;2;0;1;2;1322;0;0;1;0;0;2;2;1322;0;1507;2;1;
/org.eclipse.jdt.core.tests.model/workspace/Converter/src/test0464/A.java;1;0;1;1;0;0;0;1;0;0;1;3714;0;0;1;0;0;1;1;3714;0;3714;1;1;
/org.eclipse.jdt.core.tests.model/workspace/Resolve/src/ResolveDuplicateMethodDeclaration3.java;1;0;1;1;1;1;1;0;0;0;0;6222;0;0;1;0;0;0;1;6222;0;6222;1;1;
/org.eclipse.ant.ui/Ant Runner Support/org/eclipse/ant/internal/ui/antsupport/logger/NullBuildLogger.java;1;0;4;1;1;1;1;3;4;2;2;1811;8;8;2;1;0;3;4;1811;1;6336;3;1;
/org.eclipse.jdt.debug.ui/ui/org/eclipse/jdt/internal/debug/ui/breakpoints/BreakpointMessages.java;2;0;2;2;0;0;0;2;11;0;1;3093;11;11;2;1;0;2;2;3093;1;3093;1;2;
/org.eclipse.jdt.ui/ui/org/eclipse/jdt/ui/actions/FindDeclarationsInProjectAction.java;3;1;12;1;4;4;4;8;20;1;8;1624;72;72;1;0;0;8;12;1624;0;6340;12;3;
/org.eclipse.jdt.ui.tests/ui/org/eclipse/jdt/ui/tests/quickfix/ContributedQuickFixTest.java;2;1;4;1;3;3;3;1;3;0;1;4996;7;7;1;0;0;1;4;4996;0;6340;4;2;
/org.eclipse.jdt.ui/ui refactoring/org/eclipse/jdt/internal/ui/refactoring/reorg/RenamePackageWizard.java;2;0;4;1;1;1;1;3;8;2;2;1125;17;17;2;1;0;3;4;1125;1;6340;3;2;
/org.eclipse.ui.editors/extensions/org/eclipse/ui/internal/SystemSummaryEditor.java;1;0;1;1;0;0;0;1;0;0;1;2741;0;0;1;0;0;1;1;2741;0;2741;1;1;
/org.eclipse.team.ui/src/org/eclipse/team/ui/synchronize/viewers/DiffNodeControllerCompressedFolders.java;1;0;1;1;0;0;0;1;0;0;1;4071;0;0;1;0;0;1;1;4071;0;4071;1;1;
/org.eclipse.jdt.ui.tests.refactoring/resources/ExtractMethodWorkSpace/ExtractMethodTests/locals_out/A_test541.java;1;0;1;1;0;0;0;1;6;0;1;844;6;6;1;0;0;1;1;844;0;844;1;1;
/org.eclipse.jdt.core.tests.model/workspace/Formatter/test063/A_in.java;1;0;1;1;0;0;0;1;0;0;1;2425;0;0;1;0;0;1;1;2425;0;2425;1;1;
/org.eclipse.jdt.core.tests.model/workspace/Formatter/test191/A_out.java;1;0;2;1;0;0;0;2;3;1;2;2425;3;3;1;0;0;2;2;2425;0;3029;2;1;
/org.eclipse.core.resources/src/org/eclipse/core/internal/refresh/AutorefreshMessages.java;1;0;2;1;0;0;0;2;0;1;2;3681;0;0;1;0;0;2;2;3681;0;3697;2;1;
/org.eclipse.ui.workbench/Eclipse UI/org/eclipse/ui/internal/commands/registry/old/Command.java;1;0;3;1;0;0;0;3;2;2;2;1222;2;2;2;1;0;3;3;1321;1;1321;2;1;
/org.eclipse.jdt.ui.tests.refactoring/resources/ChangeTypeRefactoring/positive/A_testParameterTypeWithOverriding_out.java;1;0;1;1;0;0;0;1;0;0;1;2844;0;0;1;0;0;1;1;2844;0;2844;1;1;
/org.eclipse.pde.core/srcnew/org/eclipse/pde/internal/core/plugin/PluginDocumentModelFactory.java;1;0;1;1;0;0;0;1;0;0;1;2906;0;0;1;0;0;1;1;2906;0;2906;1;1;
/org.eclipse.team.ui/src/org/eclipse/team/internal/ui/sync/views/SyncTableViewer.java;1;0;3;1;0;0;0;3;12;1;3;1158;12;12;1;0;0;3;3;1158;0;2632;3;1;
/org.eclipse.jdt.core.tests.model/workspace/Formatter/test097/A_in.java;1;0;1;1;0;0;0;1;0;0;1;2425;0;0;1;0;0;1;1;2425;0;2425;1;1;
/org.eclipse.swt/Eclipse SWT PI/win32/org/eclipse/swt/internal/ole/win32/FORMATETC.java;1;0;1;1;0;0;0;1;4;0;1;2915;4;4;1;0;0;1;1;2915;0;2915;1;1;
/org.eclipse.swt.tests/JUnit Tests/org/eclipse/swt/tests/junit/Test_org_eclipse_swt_events_DisposeEvent.java;1;0;2;1;1;1;1;1;7;0;1;3444;11;11;1;0;0;1;2;3444;0;6352;2;1;
/org.eclipse.ui.workbench/Eclipse UI/org/eclipse/ui/internal/commands/XPoint.java;1;0;2;1;0;0;0;2;0;1;2;1695;0;0;1;0;0;2;2;1695;0;1721;2;1;
/org.eclipse.swt/Eclipse SWT/carbon/org/eclipse/swt/widgets/Canvas.java;4;1;8;2;2;2;2;6;17;2;5;1525;49;49;2;1;0;6;8;1525;1;6352;7;4;
/org.eclipse.jdt.ui.tests.refactoring/resources/MoveMembers/test12/out/B.java;1;0;1;1;0;0;0;1;1;0;1;1522;1;1;1;0;0;1;1;1522;0;1522;1;1;
/org.eclipse.osgi/eclipseAdaptor/src/org/eclipse/core/runtime/adaptor/EclipseBundleData.java;5;2;43;2;12;10;12;31;100;3;25;3013;1005;1005;3;6;2;31;43;4697;8;6145;35;5;
/org.eclipse.jdt.launching/launching/org/eclipse/jdt/internal/launching/StandardVMRunner.java;4;0;13;2;0;0;0;13;50;2;12;1455;143;143;2;1;0;13;13;2695;1;4853;12;4;
/org.eclipse.jdt.core/model/org/eclipse/jdt/core/util/ClassFormatException.java;2;0;6;1;0;0;0;6;10;1;6;132;20;20;1;0;0;6;6;132;0;4843;6;2;
/org.eclipse.ui.workbench/Eclipse UI/org/eclipse/ui/internal/misc/ProjectCapabilitySelectionGroup.java;1;0;1;1;0;0;0;1;0;0;1;2737;0;0;1;0;0;1;1;2737;0;2737;1;1;
/org.eclipse.jdt.ui/ui/org/eclipse/jdt/internal/ui/callhierarchy/SelectWorkingSetAction.java;2;2;4;1;3;2;3;1;11;0;1;4047;13;13;2;0;1;1;4;5263;1;6340;3;2;
/org.eclipse.team.cvs.ui/src/org/eclipse/team/internal/ccvs/ui/model/IDeferredWorkbenchAdapter.java;1;0;1;1;0;0;0;1;0;0;1;961;0;0;1;0;0;1;1;961;0;961;1;1;
/org.eclipse.jdt.core/compiler/org/eclipse/jdt/internal/compiler/codegen/CaseLabel.java;1;0;1;1;0;0;0;1;2;0;1;3560;2;2;1;0;0;1;1;3560;0;3560;1;1;
/org.eclipse.debug.core/core/org/eclipse/debug/core/model/IFilteredStep.java;2;0;2;1;1;1;1;1;4;0;1;3613;5;5;1;0;0;1;2;3613;0;6336;2;2;
/org.eclipse.swt/Eclipse SWT/emulated/trayicon/org/eclipse/swt/widgets/TrayItem.java;2;0;2;1;0;0;0;2;0;1;2;4519;0;0;1;0;0;2;2;4519;0;4557;2;2;
/org.eclipse.osgi/osgi/src/org/eclipse/osgi/service/environment/DebugOptions.java;2;0;3;1;0;0;0;3;10;1;3;3013;10;10;1;0;0;3;3;3013;0;3147;3;2;
/org.eclipse.help.ui/src/org/eclipse/help/ui/internal/HyperlinkAdapter.java;1;1;2;1;2;2;2;0;25;0;0;5827;41;41;1;0;0;0;2;5827;0;6337;2;1;
/org.eclipse.pde.ui/src_Forms/org/eclipse/pde/internal/ui/neweditor/plugin/ManifestSourcePage.java;2;2;7;1;4;3;4;3;54;1;3;4438;77;77;2;0;1;3;7;5341;1;5431;6;2;
/org.eclipse.core.resources/src/org/eclipse/core/internal/watson/ElementSubtree.java;1;0;2;1;2;1;2;0;121;0;0;5146;121;121;2;0;1;0;2;5146;1;5146;1;1;
/org.eclipse.jdt.core/dom/org/eclipse/jdt/core/dom/CharacterLiteral.java;4;0;8;1;1;1;1;7;67;1;7;1059;89;89;1;0;0;7;8;1059;0;5272;8;4;
/org.eclipse.jdt.ui/ui/org/eclipse/jdt/internal/ui/util/CoreUtility.java;2;1;2;1;2;2;2;0;8;0;0;5377;10;10;1;0;0;0;2;5377;0;6340;2;2;
/org.eclipse.jdt.ui.tests.refactoring/resources/DeleteSourceReferenceEdit/A_test1_out.java;1;0;1;1;0;0;0;1;0;0;1;1652;0;0;1;0;0;1;1;1652;0;1652;1;1;
/org.eclipse.jdt.launching/launching/org/eclipse/jdt/internal/launching/StandardVMType.java;4;1;14;1;3;3;3;11;28;1;11;685;126;126;1;0;0;11;14;685;0;5468;14;4;
/org.eclipse.osgi/eclipseAdaptor/src/org/eclipse/osgi/framework/stats/StatsManager.java;4;1;9;1;5;5;5;4;89;1;4;3013;171;171;1;0;0;4;9;3013;0;6337;9;4;
/org.eclipse.swt/Eclipse SWT PI/photon/org/eclipse/swt/internal/photon/PtFileSelectionInfo_t.java;1;0;1;1;0;0;0;1;3;0;1;921;3;3;1;0;0;1;1;921;0;921;1;1;
/org.eclipse.ui.workbench/Eclipse UI/org/eclipse/ui/commands/internal/Util.java;1;0;2;1;0;0;0;2;0;1;2;786;0;0;1;0;0;2;2;786;0;956;2;1;
/org.eclipse.jdt.ui/ui/org/eclipse/jdt/internal/ui/search/OccurrenceMatch.java;2;0;2;1;0;0;0;2;0;1;2;3711;0;0;1;0;0;2;2;3711;0;4888;2;2;
/org.eclipse.ui.cheatsheets/src/org/eclipse/ui/internal/cheatsheets/registry/CheatSheetCollectionElement.java;2;0;3;1;1;1;1;2;17;1;2;4428;20;20;1;0;0;2;3;4428;0;5759;3;2;
/org.eclipse.core.tests.resources/src/org/eclipse/core/tests/internal/indexing/IntegratedPageStoreTest.java;1;0;2;1;2;1;2;0;8;0;0;5147;8;8;2;0;1;0;2;5147;1;5147;1;1;
/org.eclipse.swt.tests/JUnit Tests/org/eclipse/swt/tests/junit/Test_org_eclipse_swt_events_MenuAdapter.java;1;0;1;1;0;0;0;1;16;0;1;2175;16;16;1;0;0;1;1;2175;0;2175;1;1;
/org.eclipse.jdt.ui/ui/org/eclipse/jdt/internal/ui/text/comment/MultiCommentLine.java;3;0;11;1;1;1;1;10;140;2;9;1589;535;535;2;1;0;10;11;4362;1;6340;10;3;
/org.eclipse.debug.ui/ui/org/eclipse/debug/internal/ui/actions/DebugContextManager.java;2;1;8;1;3;3;3;5;36;2;4;4238;67;67;2;1;0;5;8;4238;1;6082;7;2;
/org.eclipse.jdt.ui.tests.refactoring/resources/ExtractMethodWorkSpace/ExtractMethodTests/try_in/A_test450.java;1;0;1;1;0;0;0;1;2;0;1;844;2;2;1;0;0;1;1;844;0;844;1;1;
/org.eclipse.jdt.core/model/org/eclipse/jdt/internal/core/util/CodeAttribute.java;3;0;3;1;0;0;0;3;4;1;3;1114;9;9;1;0;0;3;3;1114;0;3560;3;3;
/org.eclipse.jdt.debug.ui/ui/org/eclipse/jdt/internal/debug/ui/propertypages/JavaExceptionBreakpointPage.java;2;0;2;1;0;0;0;2;2;1;2;1358;2;2;1;0;0;2;2;1358;0;2497;2;2;
/org.eclipse.jdt.ui.tests.refactoring/resources/ExtractInterface/test64/out/Inter.java;1;0;1;1;0;0;0;1;2;0;1;1166;2;2;1;0;0;1;1;1166;0;1166;1;1;
/org.eclipse.jdt.ui/ui/org/eclipse/jdt/internal/ui/text/link/LinkedPositionManager.java;3;0;8;1;0;0;0;8;172;1;8;583;334;334;1;0;0;8;8;583;0;3030;8;3;
/org.eclipse.jdt.debug/jdi/org/eclipse/jdi/internal/connect/SocketRawLaunchingConnectorImpl.java;1;0;2;1;0;0;0;2;9;1;2;1141;16;16;1;0;0;2;2;1141;0;1222;2;1;
/org.eclipse.jdt.core/compiler/org/eclipse/jdt/internal/compiler/util/HashtableOfLong.java;2;0;2;1;0;0;0;2;2;1;2;3560;4;4;1;0;0;2;2;3560;0;4110;2;2;
/org.eclipse.swt.examples/src/org/eclipse/swt/examples/imageanalyzer/ImageAnalyzer.java;2;0;5;1;1;1;1;4;22;1;4;2565;60;60;1;0;0;4;5;2565;0;6352;5;2;
/org.eclipse.debug.ui/ui/org/eclipse/debug/ui/launchVariables/ResourceExpander.java;1;0;2;1;0;0;0;2;0;1;2;550;0;0;1;0;0;2;2;550;0;562;2;1;
/org.eclipse.core.runtime/src/org/eclipse/core/internal/runtime/CompatibilityHelper.java;3;2;10;1;6;4;6;4;48;2;3;3166;156;156;2;1;2;4;10;3166;3;5574;7;3;
/org.eclipse.webdav/src/interface/org/eclipse/webdav/IServerFactory.java;1;1;2;1;2;2;2;0;8;0;0;5151;12;12;1;0;0;0;2;5151;0;5252;2;1;
/org.eclipse.ui.workbench/Eclipse UI/org/eclipse/ui/internal/csm/activities/ActivityActivationService.java;1;0;2;1;0;0;0;2;0;1;2;2225;0;0;1;0;0;2;2;2225;0;2310;2;1;
/org.eclipse.jdt.debug.ui/ui/org/eclipse/jdt/internal/debug/ui/actions/BreakpointMethodLocator.java;1;0;1;1;0;0;0;1;0;0;1;1744;0;0;1;0;0;1;1;1744;0;1744;1;1;
/org.eclipse.jdt.ui/ui/org/eclipse/jdt/ui/JavaElementContentProvider.java;2;0;3;1;1;1;1;2;57;1;2;1386;64;64;1;0;0;2;3;1386;0;6340;3;2;
/org.eclipse.jdt.core/compiler/org/eclipse/jdt/internal/compiler/ast/ParameterizedSingleTypeReference.java;1;0;1;1;0;0;0;1;0;0;1;4386;0;0;1;0;0;1;1;4386;0;4386;1;1;
/org.eclipse.jdt.core.tests.model/workspace/Converter/test0384/A.java;1;0;1;1;0;0;0;1;0;0;1;3714;0;0;1;0;0;1;1;3714;0;3714;1;1;
/org.eclipse.team.core/src/org/eclipse/team/core/subscribers/RefreshAllRegisteredSubscribersJob.java;1;0;4;1;0;0;0;4;14;1;4;1015;26;26;1;0;0;4;4;1015;0;1117;4;1;
/org.eclipse.jdt.launching/launching/org/eclipse/jdt/internal/launching/StandardVMDebugger.java;5;1;15;2;3;3;3;12;23;2;11;1372;124;124;2;1;0;12;15;2695;1;5581;14;5;
/org.eclipse.core.resources/src/org/eclipse/core/internal/indexing/PageStore.java;2;1;4;1;2;2;2;2;321;1;2;179;328;328;1;0;0;2;4;179;0;5507;4;2;
/org.eclipse.jdt.ui.tests.refactoring/test cases/org/eclipse/jdt/ui/tests/refactoring/extensions/AllTests.java;2;0;2;1;1;1;1;1;2;0;1;882;2;2;1;0;0;1;2;882;0;6340;2;2;
/org.eclipse.ui.workbench/Eclipse UI/org/eclipse/ui/commands/old/PropertyEvent.java;1;0;2;1;0;0;0;2;0;0;1;1222;0;0;2;1;0;2;2;1222;1;1222;1;1;
/org.eclipse.jdt.ui.tests.refactoring/resources/ExtractMethodWorkSpace/ExtractMethodTests/initializer_in/A_test1001.java;1;0;1;1;0;0;0;1;0;0;1;3310;0;0;1;0;0;1;1;3310;0;3310;1;1;
/org.eclipse.jdt.ui/core refactoring/org/eclipse/ltk/internal/refactoring/ui/ChangeExceptionHandler.java;1;0;2;1;0;0;0;2;0;1;2;3930;0;0;1;0;0;2;2;3930;0;4510;2;1;
/org.eclipse.jdt.ui/core refactoring/org/eclipse/jdt/internal/corext/refactoring/structure/IMemberActionInfo.java;1;0;1;1;1;1;1;0;2;0;0;6340;2;2;1;0;0;0;1;6340;0;6340;1;1;
/org.eclipse.compare/compare/org/eclipse/compare/BufferedContent.java;1;0;2;1;0;0;0;2;2;1;2;1289;3;3;1;0;0;2;2;1289;0;3935;2;1;
/org.eclipse.jdt.core.tests.model/workspace/Converter/test0204/Test.java;1;0;1;1;0;0;0;1;0;0;1;3714;0;0;1;0;0;1;1;3714;0;3714;1;1;
/org.eclipse.jdt.core.tests.model/workspace/Converter/test0503/A.java;2;0;2;1;0;0;0;2;0;1;2;2943;0;0;1;0;0;2;2;2943;0;3714;2;2;
/org.eclipse.jdt.core.tests.model/workspace/Formatter/test368/A_in.java;1;0;1;1;0;0;0;1;0;0;1;3130;0;0;1;0;0;1;1;3130;0;3130;1;1;
/org.eclipse.team.ui/src/org/eclipse/team/ui/synchronize/presentation/SyncInfoDiffNode.java;1;0;1;1;0;0;0;1;0;0;1;4077;0;0;1;0;0;1;1;4077;0;4077;1;1;
/org.eclipse.ui.ide/src/org/eclipse/ui/internal/registry/CapabilityRegistryReader.java;2;0;7;2;0;0;0;7;13;2;6;1526;26;26;2;1;0;7;7;1536;1;2263;6;2;
/org.eclipse.jdt.core/eval/org/eclipse/jdt/internal/eval/CodeSnippetThisReference.java;2;0;3;1;0;0;0;3;129;1;3;991;145;145;1;0;0;3;3;991;0;3560;3;2;
/org.eclipse.pde.ui/src/org/eclipse/pde/internal/ui/wizards/exports/PluginExportWizardPage.java;3;1;12;1;3;3;3;9;40;1;9;94;170;170;1;0;0;9;12;94;0;6336;12;3;
/org.eclipse.jdt.ui/core refactoring/org/eclipse/jdt/internal/corext/refactoring/sef/EncapsulatePostfixAccess.java;1;0;1;1;0;0;0;1;0;0;1;1492;0;0;1;0;0;1;1;1492;0;1492;1;1;
/org.eclipse.ui.tests/Eclipse UI Tests/org/eclipse/ui/tests/themes/JFaceThemeTest.java;1;0;2;1;0;0;0;2;10;1;2;5025;10;10;1;0;0;2;2;5025;0;5035;2;1;
/org.eclipse.debug.core/core/org/eclipse/debug/internal/core/stringsubstitution/StringVariable.java;2;0;3;1;0;0;0;3;8;1;3;2032;8;8;1;0;0;3;3;2032;0;2514;3;2;
/org.eclipse.ui.workbench/Eclipse UI/org/eclipse/ui/internal/commands/old/SequenceBinding.java;1;0;2;1;0;0;0;2;0;1;2;1322;0;0;1;0;0;2;2;1322;0;1695;2;1;
/org.eclipse.jdt.core.tests.model/workspace/Formatter/test058/A_out.java;1;0;3;1;0;0;0;3;41;1;3;2425;61;61;1;0;0;3;3;2425;0;4173;3;1;
/org.eclipse.team.ui/src/org/eclipse/team/internal/ui/synchronize/SubscriberPageConfiguration.java;1;0;1;1;0;0;0;1;0;0;1;5082;0;0;1;0;0;1;1;5082;0;5082;1;1;
/org.eclipse.jdt.core/model/org/eclipse/jdt/internal/core/util/VerificationTypeInfo.java;1;0;1;1;0;0;0;1;0;0;1;3791;0;0;1;0;0;1;1;3791;0;3791;1;1;
/org.eclipse.pde.ui/src/org/eclipse/pde/internal/ui/editor/DefaultPageDialog.java;1;0;1;1;1;1;1;0;0;0;0;5431;0;0;1;0;0;0;1;5431;0;5431;1;1;
/org.eclipse.ui.workbench/Eclipse UI/org/eclipse/ui/internal/commands/CategoryHandle.java;1;0;4;1;0;0;0;4;0;1;4;1321;0;0;1;0;0;4;4;1321;0;1417;4;1;
/org.eclipse.ui.examples.job/src/org/eclipse/ui/examples/jobs/ProgressExamplesPlugin.java;3;1;3;1;3;3;3;0;51;0;0;5126;62;62;1;0;0;0;3;5126;0;5922;3;3;
/org.eclipse.pde.core/src/org/eclipse/pde/internal/core/ExternalJavaSearchClasspathContainer.java;2;1;2;1;2;2;2;0;4;0;0;5760;4;4;1;0;0;0;2;5760;0;6336;2;2;
/org.eclipse.jdt.core.tests.model/workspace/Converter/test0252/Test.java;1;0;1;1;0;0;0;1;0;0;1;3714;0;0;1;0;0;1;1;3714;0;3714;1;1;
/org.eclipse.update.ui/src/org/eclipse/update/internal/ui/security/BannerPage.java;1;0;1;1;0;0;0;1;0;0;1;635;0;0;1;0;0;1;1;635;0;635;1;1;
/org.eclipse.pde.ui/src/org/eclipse/pde/internal/ui/editor/manifest/ManifestExtensionsPage.java;1;0;1;1;1;1;1;0;0;0;0;5431;0;0;1;0;0;0;1;5431;0;5431;1;1;
/org.eclipse.update.ui/srcnew/org/eclipse/update/internal/ui/UnifiedWizardAction.java;2;0;5;1;0;0;0;5;10;2;4;329;13;13;2;1;0;5;5;824;1;824;4;2;
/org.eclipse.jdt.debug/model/org/eclipse/jdt/internal/debug/core/breakpoints/JavaExceptionBreakpoint.java;3;0;3;1;0;0;0;3;32;1;3;363;40;40;1;0;0;3;3;363;0;2740;3;3;
/org.eclipse.jdt.core.tests.model/workspace/Converter/src/javadoc/testBug50898/G.java;1;0;1;1;0;0;0;1;0;0;1;3899;0;0;1;0;0;1;1;3899;0;3899;1;1;
/org.eclipse.ui.workbench/Eclipse UI/org/eclipse/ui/internal/EditorPluginAction.java;5;2;5;2;3;2;3;2;14;1;2;45;32;32;2;0;1;2;5;5310;1;6338;4;5;
/org.eclipse.core.runtime/src/org/eclipse/core/runtime/IAdaptable.java;2;1;5;1;2;2;2;3;90;1;3;3013;184;184;1;0;0;3;5;3013;0;6340;5;2;
/org.eclipse.jface.text/src/org/eclipse/jface/text/ITextListener.java;3;1;3;1;2;2;2;1;26;0;1;3081;32;32;1;0;0;1;3;3081;0;6359;3;3;
/org.eclipse.jdt.core.tests.model/workspace/Converter/Hello.java;1;0;1;1;0;0;0;1;0;0;1;3714;0;0;1;0;0;1;1;3714;0;3714;1;1;
/org.eclipse.team.cvs.core/src/org/eclipse/team/internal/ccvs/core/client/listeners/LogListener.java;2;1;6;1;3;3;3;3;113;1;3;866;132;132;1;0;0;3;6;866;0;6337;6;2;
/org.eclipse.jdt.ui.tests.refactoring/resources/RenamePrivateMethod/testFail2/in/A.java;1;0;1;1;1;1;1;0;3;0;0;5524;3;3;1;0;0;0;1;5524;0;5524;1;1;
/org.eclipse.jdt.ui.tests.refactoring/resources/MoveInstanceMethod/canMove/test22/in/Second.java;1;0;1;1;0;0;0;1;0;0;1;1603;0;0;1;0;0;1;1;1603;0;1603;1;1;
/org.eclipse.debug.ui/ui/org/eclipse/debug/ui/variables/FilePromptExpander.java;1;0;3;1;0;0;0;3;36;2;2;316;36;36;2;1;0;3;3;316;1;550;2;1;
/org.eclipse.swt/Eclipse SWT/carbon2/org/eclipse/swt/widgets/Tree.java;1;0;5;1;0;0;0;5;33;2;4;94;88;88;2;1;0;5;5;137;1;231;4;1;
/org.eclipse.pde.core/src/org/eclipse/pde/core/build/IBuild.java;2;1;3;1;2;2;2;1;70;0;1;4203;80;80;1;0;0;1;3;4203;0;6336;3;2;
/org.eclipse.pde.ui/src/org/eclipse/pde/internal/ui/editor/build/SrcSection.java;2;1;12;1;6;6;6;6;160;1;6;1727;454;454;1;0;0;6;12;1727;0;6336;12;2;
/org.eclipse.ui.workbench/Eclipse UI/org/eclipse/ui/internal/commands/registry/old/SequenceBinding.java;1;0;3;1;0;0;0;3;2;2;2;1222;2;2;2;1;0;3;3;1321;1;1321;2;1;
/org.eclipse.jdt.ui/ui/org/eclipse/jdt/internal/ui/preferences/ImportOrganizeInputDialog.java;1;0;2;1;1;1;1;1;3;0;1;1350;5;5;1;0;0;1;2;1350;0;6340;2;1;
/org.eclipse.pde.ui/src/org/eclipse/pde/internal/ui/editor/schema/SchemaEditor.java;2;2;7;1;6;5;6;1;262;0;1;5042;281;281;2;0;1;1;7;5431;1;6336;6;2;
/org.eclipse.pde.ui/src/org/eclipse/pde/internal/ui/editor/plugin/ManifestEditor.java;3;4;19;2;19;15;19;0;60;0;0;5431;395;395;4;0;4;0;19;5431;4;6336;15;3;
/org.eclipse.jdt.core.tests.model/workspace/Formatter/test345/A_out.java;1;0;1;1;0;0;0;1;0;0;1;2865;0;0;1;0;0;1;1;2865;0;2865;1;1;
/org.eclipse.core.resources/src/org/eclipse/core/internal/dtree/DataTreeLookup.java;1;0;2;1;2;1;2;0;75;0;0;5146;75;75;2;0;1;0;2;5146;1;5146;1;1;
/org.eclipse.jdt.ui.tests.refactoring/resources/ChangeSignature/canModify/A_testImport04_out.java;1;0;1;1;0;0;0;1;0;0;1;3820;0;0;1;0;0;1;1;3820;0;3820;1;1;
/org.eclipse.jdt.core.tests.model/workspace/Formatter/test041/A_in.java;1;0;1;1;0;0;0;1;0;0;1;2425;0;0;1;0;0;1;1;2425;0;2425;1;1;
/org.eclipse.jdt.ui.tests.refactoring/test cases/org/eclipse/jdt/ui/tests/refactoring/infra/TestExceptionHandler.java;1;0;2;1;0;0;0;2;4;1;2;3930;4;4;1;0;0;2;2;3930;0;4575;2;1;
/org.eclipse.jdt.ui/ui/org/eclipse/jdt/internal/ui/callhierarchy/SearchUtil.java;2;0;2;1;1;1;1;1;2;0;1;4047;2;2;1;0;0;1;2;4047;0;6340;2;2;
/org.eclipse.jdt.ui/ui refactoring/org/eclipse/jdt/internal/ui/refactoring/ExtractConstantWizard.java;3;0;6;1;1;1;1;5;198;1;5;518;217;217;1;0;0;5;6;518;0;6340;6;3;
/org.eclipse.pde.core/src/org/eclipse/pde/internal/core/PDERegistryCacheReader.java;1;0;3;1;0;0;0;3;11;1;3;368;16;16;1;0;0;3;3;368;0;4897;3;1;
/org.eclipse.jdt.core/model/org/eclipse/jdt/core/util/IAnnotationComponentValue.java;2;0;2;1;0;0;0;2;102;1;2;4447;102;102;1;0;0;2;2;4447;0;4843;2;2;
/org.eclipse.jdt.core.tests.model/workspace/Converter/test0451/A.java;1;0;1;1;0;0;0;1;0;0;1;3714;0;0;1;0;0;1;1;3714;0;3714;1;1;
/org.eclipse.ui.workbench/Eclipse UI/org/eclipse/ui/internal/DefaultContributorResourceAdapter.java;1;0;1;1;0;0;0;1;0;0;1;2737;0;0;1;0;0;1;1;2737;0;2737;1;1;
/org.eclipse.ui.workbench/Eclipse UI/org/eclipse/ui/internal/registry/WorkingSetRegistry.java;3;0;4;1;1;1;1;3;4;1;3;2737;10;10;1;0;0;3;4;2737;0;6338;4;3;
/org.eclipse.ant.ui/Ant Editor/org/eclipse/ant/internal/ui/editor/AntTemplates.java;1;0;2;1;0;0;0;2;0;1;2;4550;0;0;1;0;0;2;2;4550;0;4810;2;1;
/org.eclipse.jdt.ui.tests.refactoring/resources/ChangeSignature/canModify/A_testAll56_in.java;1;0;1;1;0;0;0;1;0;0;1;720;0;0;1;0;0;1;1;720;0;720;1;1;
/org.eclipse.pde.core/src/org/eclipse/pde/internal/core/isite/ISiteBuildFeature.java;1;0;2;1;1;1;1;1;6;0;1;4203;7;7;1;0;0;1;2;4203;0;6336;2;1;
/org.eclipse.jdt.junit/src/org/eclipse/jdt/internal/junit/util/SWTUtil.java;2;0;2;1;1;1;1;1;8;0;1;4821;10;10;1;0;0;1;2;4821;0;6340;2;2;
/org.eclipse.jdt.core.tests.model/workspace/Formatter/test384/A_in.java;1;0;1;1;0;0;0;1;0;0;1;3164;0;0;1;0;0;1;1;3164;0;3164;1;1;
/org.eclipse.ui.console/src/org/eclipse/ui/console/IConsoleConstants.java;2;0;3;2;0;0;0;3;10;2;2;1988;10;10;2;1;0;3;3;2108;1;2108;2;2;
/org.eclipse.jdt.core.tests.model/workspace/JavaSearch/src/r7/B.java;1;0;1;1;0;0;0;1;0;0;1;543;0;0;1;0;0;1;1;543;0;543;1;1;
/org.eclipse.team.cvs.core/src/org/eclipse/team/internal/ccvs/core/CVSSubscriberFactory.java;2;0;4;1;0;0;0;4;63;1;4;684;65;65;1;0;0;4;4;684;0;2632;4;2;
/org.eclipse.jdt.ui.tests.refactoring/resources/SurroundWithWorkSpace/SurroundWithTests/trycatch_out/TestDeclarationInitializer.java;1;0;2;1;0;0;0;2;5;1;2;155;5;5;1;0;0;2;2;155;0;845;2;1;
/org.eclipse.pde.ui/src_Forms/org/eclipse/pde/internal/ui/model/plugin/PluginModel.java;2;1;4;1;2;2;2;2;14;1;2;4438;28;28;1;0;0;2;4;4438;0;6336;4;2;
/org.eclipse.update.ui.forms/Eclipse Forms/org/eclipse/ui/forms/widgets/ToggleHyperlink.java;1;0;2;1;0;0;0;2;0;1;2;3138;0;0;1;0;0;2;2;3138;0;4157;2;1;
/org.eclipse.jdt.core.tests.model/workspace/TypeHierarchy/lib48459/p48459/p2/Y48459.java;1;0;1;1;0;0;0;1;0;0;1;3490;0;0;1;0;0;1;1;3490;0;3490;1;1;
/org.eclipse.pde.ui/src/org/eclipse/pde/internal/ui/build/BuildFeatureAction.java;2;2;10;2;8;6;8;2;50;1;2;3840;111;111;2;0;2;2;10;5189;2;6336;8;2;
/org.eclipse.jdt.core.tests.model/workspace/Formatter/test415/A_in.java;1;0;1;1;0;0;0;1;0;0;1;3460;0;0;1;0;0;1;1;3460;0;3460;1;1;
/org.eclipse.team.webdav/src/org/eclipse/team/internal/webdav/ui/WebDavConfigurationWizard.java;2;1;4;1;2;2;2;2;15;1;2;917;25;25;1;0;0;2;4;917;0;6337;4;2;
/org.eclipse.swt.examples/src/org/eclipse/swt/examples/controlexample/TabFolderTab.java;2;1;4;1;2;2;2;2;13;1;2;2773;23;23;1;0;0;2;4;2773;0;6352;4;2;
/org.eclipse.update.tests.core/src/org/eclipse/update/tests/implementation/SiteFTP.java;2;1;3;1;2;2;2;1;7;0;1;1546;16;16;1;0;0;1;3;1546;0;6336;3;2;
/org.eclipse.team.ftp/src/org/eclipse/team/internal/ftp/deployment/GetOperation.java;1;0;1;1;0;0;0;1;0;0;1;3221;0;0;1;0;0;1;1;3221;0;3221;1;1;
/org.eclipse.jdt.core.tests.model/workspace/Converter/test0366/A.java;1;0;1;1;0;0;0;1;0;0;1;3714;0;0;1;0;0;1;1;3714;0;3714;1;1;
/org.eclipse.debug.core/core/org/eclipse/debug/core/sourcelookup/containers/WorkspaceSourceContainer.java;1;0;4;1;1;1;1;3;13;0;1;4949;20;20;3;2;0;3;4;4949;2;5109;2;1;
/org.eclipse.ui.views/src/org/eclipse/ui/views/internal/markers/tasks/TaskRegistry.java;1;0;3;1;0;0;0;3;2;2;2;265;2;2;2;1;0;3;3;265;1;728;2;1;
/org.eclipse.jdt.core.tests.model/workspace/Formatter/test466/A_in.java;1;0;1;1;0;0;0;1;0;0;1;3915;0;0;1;0;0;1;1;3915;0;3915;1;1;
/org.eclipse.pde.core/src/org/eclipse/pde/core/osgi/bundle/IBundleFragment.java;2;1;4;1;3;3;3;1;16;0;1;4203;27;27;1;0;0;1;4;4203;0;5445;4;2;
/org.eclipse.jdt.core/search/org/eclipse/jdt/internal/core/search/indexing/SaveIndex.java;2;0;6;1;0;0;0;6;10;1;6;937;23;23;1;0;0;6;6;937;0;5055;6;2;
/org.eclipse.compare/compare/org/eclipse/compare/internal/ViewerSwitchingCancelled.java;1;1;2;1;2;2;2;0;4;0;0;6000;6;6;1;0;0;0;2;6000;0;6354;2;1;
/org.eclipse.jdt.ui.tests.refactoring/resources/ExtractMethodWorkSpace/ExtractMethodTests/locals_out/A_test522.java;1;0;1;1;0;0;0;1;6;0;1;844;6;6;1;0;0;1;1;844;0;844;1;1;
/org.eclipse.jdt.ui/ui/org/eclipse/jdt/internal/ui/callhierarchy/CallHierarchy.java;1;0;2;1;0;0;0;2;0;1;2;155;0;0;1;0;0;2;2;155;0;169;2;1;
/org.eclipse.team.ui/src/org/eclipse/team/ui/sync/PseudoConflictFilter.java;2;0;3;1;0;0;0;3;27;1;3;709;27;27;1;0;0;3;3;709;0;2632;3;2;
/org.eclipse.ui.workbench/Eclipse UI/org/eclipse/ui/activities/service/IActivityServiceListener.java;1;0;3;1;0;0;0;3;2;1;3;2896;2;2;1;0;0;3;3;2896;0;3066;3;1;
/org.eclipse.jdt.core.tests.model/workspace/Converter/src/test0420/A.java;1;0;1;1;0;0;0;1;0;0;1;3714;0;0;1;0;0;1;1;3714;0;3714;1;1;
/org.eclipse.ui.editors/src/org/eclipse/ui/texteditor/MarkerAnnotationPreferences.java;3;4;20;1;10;7;10;10;272;1;10;2073;819;819;4;0;3;10;20;5501;3;6335;17;3;
/org.eclipse.ui.workbench/Eclipse UI/org/eclipse/ui/internal/csm/commands/ICommandRegistryListener.java;1;0;2;1;0;0;0;2;0;1;2;2515;0;0;1;0;0;2;2;2515;0;2562;2;1;
/org.eclipse.core.tools.resources/src/org/eclipse/core/tools/resources/EventsView.java;1;0;1;1;1;1;1;0;0;0;0;6302;0;0;1;0;0;0;1;6302;0;6302;1;1;
/org.eclipse.jdt.core.tests.model/workspace/Converter/src/test0256/Test.java;1;0;1;1;0;0;0;1;0;0;1;3714;0;0;1;0;0;1;1;3714;0;3714;1;1;
/org.eclipse.ui.workbench/Eclipse UI/org/eclipse/ui/internal/MultiEditorInnerPane.java;2;1;2;1;2;2;2;0;2;0;0;5539;4;4;1;0;0;0;2;5539;0;6338;2;2;
/org.eclipse.team.examples.filesystem/src/org/eclipse/team/examples/filesystem/deployment/DeployAction.java;2;0;3;1;0;0;0;3;48;1;3;2806;48;48;1;0;0;3;3;2806;0;4633;3;2;
/org.eclipse.jdt.core.tests.model/workspace/Formatter/test450/A_in.java;1;0;1;1;0;0;0;1;0;0;1;3651;0;0;1;0;0;1;1;3651;0;3651;1;1;
/org.eclipse.ui.workbench/Eclipse UI/org/eclipse/ui/internal/ide/IDEExceptionHandler.java;1;0;1;1;0;0;0;1;0;0;1;1435;0;0;1;0;0;1;1;1435;0;1435;1;1;
/org.eclipse.core.expressions/src/org/eclipse/core/internal/expressions/ExpressionStatus.java;1;0;3;1;0;0;0;3;8;1;3;4108;13;13;1;0;0;3;3;4108;0;4932;3;1;
/org.eclipse.releng.tools/src/org/eclipse/releng/tools/ReplaceLocalFromMap.java;2;1;3;1;3;3;3;0;109;0;0;5183;113;113;1;0;0;0;3;5183;0;6340;3;2;
/org.eclipse.swt/Eclipse SWT Program/motif/org/eclipse/swt/program/Program.java;4;2;13;1;4;3;4;9;1125;2;7;868;1248;1248;2;2;1;9;13;3093;3;6352;10;4;
/org.eclipse.jdt.core.tests.compiler/src/org/eclipse/jdt/core/tests/runtime/J9VMLauncher.java;3;0;3;1;0;0;0;3;2;1;3;1113;6;6;1;0;0;3;3;1113;0;3560;3;3;
/org.eclipse.update.ui/src/org/eclipse/update/internal/ui/parts/MyComputerContentProvider.java;3;0;4;1;0;0;0;4;6;1;4;825;8;8;1;0;0;4;4;825;0;2085;4;3;
/org.eclipse.jdt.ui/ui/org/eclipse/jdt/internal/ui/text/correction/RenameNodeCompletionProposal.java;2;0;6;1;1;1;1;5;8;1;5;3401;29;29;1;0;0;5;6;3401;0;6340;6;2;
/org.eclipse.jdt.ui.tests.refactoring/resources/InlineMethodWorkspace/TestCases/controlStatement_out/TestForTwo.java;2;0;2;1;0;0;0;2;9;1;2;845;13;13;1;0;0;2;2;845;0;1810;2;2;
/org.eclipse.ui.ide/extensions/org/eclipse/ui/actions/CreateFileAction.java;1;0;2;1;0;0;0;2;2;1;2;2263;2;2;1;0;0;2;2;2263;0;2611;2;1;
/org.eclipse.ui.externaltools/Ant Editor/org/eclipse/ui/externaltools/internal/ant/editor/utils/AntEditorUtilsMessages.java;1;0;1;1;0;0;0;1;0;0;1;282;0;0;1;0;0;1;1;282;0;282;1;1;
/org.eclipse.swt.tests/JUnit Tests/org/eclipse/swt/tests/junit/Test_org_eclipse_swt_custom_TableTreeEditor.java;1;0;1;1;0;0;0;1;25;0;1;2104;25;25;1;0;0;1;1;2104;0;2104;1;1;
/org.eclipse.core.tests.runtime/src/org/eclipse/core/tests/internal/plugins/PluginXmlTest.java;1;0;1;1;0;0;0;1;0;0;1;3014;0;0;1;0;0;1;1;3014;0;3014;1;1;
/org.eclipse.ui.workbench/Eclipse UI/org/eclipse/ui/IWorkbenchWindow.java;3;1;9;1;2;2;2;7;290;1;7;772;350;350;1;0;0;7;9;772;0;6338;9;3;
/org.eclipse.ui.intro/src/org/eclipse/ui/internal/intro/impl/model/IntroHomePage.java;1;1;8;1;8;8;8;0;77;0;0;5115;218;218;1;0;0;0;8;5115;0;5964;8;1;
/org.eclipse.jdt.ui.tests.refactoring/resources/SurroundWithWorkSpace/SurroundWithTests/trycatch_in/TestExpressionStatement.java;1;0;1;1;0;0;0;1;0;0;1;2276;0;0;1;0;0;1;1;2276;0;2276;1;1;
/org.eclipse.update.ui/src/org/eclipse/update/internal/ui/views/IPreviewTask.java;2;1;3;1;2;2;2;1;6;0;1;825;10;10;1;0;0;1;3;825;0;6336;3;2;
/org.eclipse.debug.ui/ui/org/eclipse/debug/internal/ui/views/memory/SetColumnSizeDefaultAction.java;1;0;1;1;1;1;1;0;0;0;0;5254;0;0;1;0;0;0;1;5254;0;5254;1;1;
/org.eclipse.ui.ide/src/org/eclipse/ui/internal/ide/dialogs/SystemSummaryDialog.java;5;1;7;1;2;2;2;5;30;2;4;2264;55;55;2;1;0;5;7;3027;1;5483;6;5;
/org.eclipse.ui.workbench/Eclipse UI/org/eclipse/ui/internal/contexts/registry/IContextRegistry.java;1;0;2;1;0;0;0;2;0;1;2;1422;0;0;1;0;0;2;2;1422;0;1724;2;1;
/org.eclipse.jdt.ui/core refactoring/org/eclipse/jdt/internal/corext/refactoring/changes/DeleteSourceManipulationChange.java;3;1;8;1;2;2;2;6;60;1;6;443;180;180;1;0;0;6;8;443;0;6340;8;3;
/org.eclipse.help/src/org/eclipse/help/internal/context/IStyledContext.java;1;1;2;1;2;2;2;0;6;0;0;5404;6;6;1;0;0;0;2;5404;0;6337;2;1;
/org.eclipse.ui.workbench/Eclipse UI/org/eclipse/ui/internal/csm/roles/IRoleRegistryEvent.java;1;0;3;1;0;0;0;3;18;1;3;2225;18;18;1;0;0;3;3;2225;0;2444;3;1;
/org.eclipse.core.tools.resources/src/org/eclipse/core/tools/metadata/DumpContentsView.java;1;0;1;1;1;1;1;0;0;0;0;6302;0;0;1;0;0;0;1;6302;0;6302;1;1;
/org.eclipse.ui.tests/Eclipse UI Tests/org/eclipse/ui/tests/performance/PerspectiveSwitchTest.java;2;1;2;1;2;2;2;0;2;0;0;5641;2;2;1;0;0;0;2;5641;0;6338;2;2;
/org.eclipse.jface.text/src/org/eclipse/jface/text/contentassist/ContentAssistSubjectAdapter.java;2;1;5;1;3;3;3;2;6;1;2;2281;10;10;1;0;0;2;5;2281;0;5199;5;2;
/org.eclipse.jdt.ui.tests.refactoring/resources/ExtractMethodWorkSpace/ExtractMethodTests/locals_in/A_test512.java;1;0;1;1;0;0;0;1;4;0;1;844;4;4;1;0;0;1;1;844;0;844;1;1;
/org.eclipse.ant.core/src_ant/org/eclipse/ant/internal/core/ant/DemuxInputStreamSetter.java;1;0;1;1;0;0;0;1;0;0;1;3744;0;0;1;0;0;1;1;3744;0;3744;1;1;
/org.eclipse.ui.forms/src/org/eclipse/ui/forms/HyperlinkSettings.java;1;0;4;1;1;1;1;3;119;1;3;4068;130;130;1;0;0;3;4;4068;0;6336;4;1;
/org.eclipse.ui.ide/src/org/eclipse/ui/model/WorkbenchLabelProvider.java;1;0;2;1;0;0;0;2;0;1;2;1511;0;0;1;0;0;2;2;1511;0;1526;2;1;
/org.eclipse.help/src/org/eclipse/help/internal/browser/BrowserManager.java;1;0;4;1;0;0;0;4;63;1;4;460;85;85;1;0;0;4;4;460;0;2732;4;1;
/org.eclipse.jdt.core.tests.model/workspace/Converter/test0434/A.java;1;0;1;1;0;0;0;1;0;0;1;3714;0;0;1;0;0;1;1;3714;0;3714;1;1;
/org.eclipse.jdt.core.tests.model/workspace/JavaSearch/src/j4/TC47209.java;1;0;1;1;0;0;0;1;0;0;1;3330;0;0;1;0;0;1;1;3330;0;3330;1;1;
/org.eclipse.swt/Eclipse SWT PI/carbon/org/eclipse/swt/internal/carbon/MenuTrackingData.java;1;2;3;1;3;2;3;0;16;0;0;5534;20;20;2;0;1;0;3;5534;1;5614;2;1;
/org.eclipse.ui.workbench/Eclipse UI/org/eclipse/ui/wizards/datatransfer/ZipFileStructureProvider.java;1;0;1;1;0;0;0;1;0;0;1;2737;0;0;1;0;0;1;1;2737;0;2737;1;1;
/org.eclipse.debug.core/core/org/eclipse/debug/core/variables/ISimpleLaunchVariable.java;2;0;8;1;0;0;0;8;32;1;8;550;66;66;1;0;0;8;8;550;0;2120;8;2;
/org.eclipse.compare/compare/org/eclipse/compare/structuremergeviewer/IStructureComparator.java;1;0;1;1;0;0;0;1;2;0;1;3938;2;2;1;0;0;1;1;3938;0;3938;1;1;
/org.eclipse.jdt.ui/core extension/org/eclipse/jdt/internal/corext/dom/SelectionAnalyzer.java;3;1;5;1;2;2;2;3;14;2;2;1952;23;23;2;1;0;3;5;1952;1;6340;4;3;
/org.eclipse.pde.core/src/org/eclipse/pde/internal/core/NewWorkspaceModelManager.java;1;0;1;1;0;0;0;1;0;0;1;4203;0;0;1;0;0;1;1;4203;0;4203;1;1;
/org.eclipse.ui.workbench/Eclipse UI/org/eclipse/ui/internal/commands/older/XICommand.java;1;0;1;1;0;0;0;1;4;0;1;2562;4;4;1;0;0;1;1;2562;0;2562;1;1;
/org.eclipse.ui.ide/src/org/eclipse/ui/internal/ide/dialogs/WizardNewProjectCapabilityPage.java;1;0;1;1;0;0;0;1;0;0;1;2264;0;0;1;0;0;1;1;2264;0;2264;1;1;
/org.eclipse.pde.ui/src_Forms/org/eclipse/pde/internal/ui/neweditor/BuildSourcePage.java;2;2;4;1;4;3;4;0;32;0;0;5298;52;52;2;0;1;0;4;5341;1;5341;3;2;
/org.eclipse.help.ide/src/org/eclipse/help/ui/internal/ide/HelpIdePlugin.java;1;1;8;1;4;4;4;4;40;1;4;1778;132;132;1;0;0;4;8;1778;0;6337;8;1;
/org.eclipse.help.base/src/org/eclipse/help/internal/base/DefaultHelpSupport.java;1;0;7;1;0;0;0;7;105;5;2;1747;121;121;5;5;0;7;7;1766;5;1766;2;1;
/org.eclipse.ant.ui/Ant Editor/org/eclipse/ant/internal/ui/editor/outline/AntModel.java;1;5;83;1;25;16;25;58;577;4;40;1811;3180;3180;5;18;9;58;83;5920;27;6080;56;1;
/org.eclipse.jdt.ui/core refactoring/org/eclipse/jdt/internal/corext/refactoring/base/FileContext.java;1;0;1;1;0;0;0;1;0;0;1;882;0;0;1;0;0;1;1;882;0;882;1;1;
/org.eclipse.jdt.core.tests.model/workspace/Formatter/test168/A_out.java;1;0;1;1;0;0;0;1;0;0;1;2425;0;0;1;0;0;1;1;2425;0;2425;1;1;
/org.eclipse.ui.forms/src/org/eclipse/ui/forms/editor/MultiPageKeyBindingEditorSite.java;1;0;2;1;0;0;0;2;0;1;2;4068;0;0;1;0;0;2;2;4068;0;4470;2;1;
/org.eclipse.jdt.ui.tests.refactoring/resources/UseSupertypeWherePossible/testNew1/in/A.java;1;0;1;1;0;0;0;1;3;0;1;1272;3;3;1;0;0;1;1;1272;0;1272;1;1;
/org.eclipse.jdt.ui/ui/org/eclipse/jdt/internal/ui/javaeditor/BasicJavaEditorActionContributor.java;3;1;13;1;6;6;6;7;118;1;7;591;308;308;1;0;0;7;13;591;0;6340;13;3;
/org.eclipse.swt/Eclipse SWT/win32/org/eclipse/swt/widgets/Text.java;6;2;44;2;5;4;5;39;305;3;30;110;961;961;3;9;1;39;44;955;10;6352;34;6;
/org.eclipse.debug.ui/ui/org/eclipse/debug/internal/ui/views/console/ConsoleDocumentProvider.java;3;1;6;1;2;2;2;4;20;1;4;1708;64;64;1;0;0;4;6;1708;0;6336;6;3;
/org.eclipse.team.core/src/org/eclipse/team/core/subscribers/TeamDelta.java;1;0;4;1;0;0;0;4;98;1;4;649;110;110;1;0;0;4;4;649;0;4216;4;1;
/org.eclipse.update.ui/srcnew/org/eclipse/update/internal/ui/wizards/RevertConfigurationWizardPage.java;3;0;12;2;0;0;0;12;227;3;7;542;540;540;3;5;0;12;12;542;5;825;7;3;
/org.eclipse.swt/Eclipse SWT/gtk/org/eclipse/swt/widgets/Sash.java;5;2;15;1;5;4;5;10;92;2;9;91;301;301;2;1;1;10;15;106;2;6352;13;5;
/org.eclipse.jdt.core.tests.model/workspace/Converter/src/test0093/Test.java;1;0;1;1;0;0;0;1;0;0;1;3714;0;0;1;0;0;1;1;3714;0;3714;1;1;
/org.eclipse.jdt.ui.tests.refactoring/resources/RenamePackage/testImportFromMultiRoots1/out/srcTest/tests/AllTests.java;1;0;3;1;0;0;0;3;9;1;3;3219;13;13;1;0;0;3;3;3219;0;4585;3;1;
/org.eclipse.pde.ui/src/org/eclipse/pde/internal/ui/editor/PDEMultiPageEditor.java;2;0;7;1;1;1;1;6;13;1;6;1994;29;29;1;0;0;6;7;1994;0;5431;7;2;
/org.eclipse.jdt.ui.tests.refactoring/resources/RenamePackage/testImportFromMultiRoots7/out/srcPrj/com/packt/DingsDa.java;1;0;1;1;0;0;0;1;0;0;1;4105;0;0;1;0;0;1;1;4105;0;4105;1;1;
/org.eclipse.ui.intro/src/org/eclipse/ui/internal/intro/impl/model/loader/SharedConfigExtensionsManager.java;1;2;3;1;3;2;3;0;31;0;0;5305;31;31;2;0;1;0;3;5314;1;5314;2;1;
/org.eclipse.ui.workbench/Eclipse UI/org/eclipse/ui/internal/dialogs/ProjectCapabilityPropertyPage.java;2;0;2;1;0;0;0;2;2;1;2;79;2;2;1;0;0;2;2;79;0;2737;2;2;
/org.eclipse.ui.workbench/Eclipse UI/org/eclipse/ui/internal/progress/TaskInfoWithProgress.java;1;0;1;1;0;0;0;1;0;0;1;320;0;0;1;0;0;1;1;320;0;320;1;1;
/org.eclipse.debug.ui/ui/org/eclipse/debug/ui/launchVariables/expanders/ProjectNameExpander.java;1;0;2;1;0;0;0;2;0;1;2;562;0;0;1;0;0;2;2;562;0;737;2;1;
/org.eclipse.team.ui/src/org/eclipse/team/internal/ui/synchronize/WorkbenchAction.java;1;1;2;1;2;2;2;0;2;0;0;5338;2;2;1;0;0;0;2;5338;0;6337;2;1;
/org.eclipse.ui.tests/Eclipse UI Tests/org/eclipse/ui/tests/performance/EditorSwitchTest.java;3;2;3;2;3;2;3;0;4;0;0;5917;5;5;2;0;1;0;3;5917;1;6338;2;3;
/org.eclipse.webdav/src/interface/org/eclipse/webdav/dom/PropStat.java;1;0;2;1;2;1;2;0;216;0;0;5151;216;216;2;0;1;0;2;5151;1;5151;1;1;
/org.eclipse.jdt.ui/ui refactoring/org/eclipse/jdt/internal/ui/refactoring/reorg/RenameInputWizardPage.java;3;0;9;1;1;1;1;8;128;1;8;1126;292;292;1;0;0;8;9;1126;0;6340;9;3;
/org.eclipse.debug.core/core/org/eclipse/debug/internal/core/sourcelookup/containers/DirectorySourceContainer.java;1;0;9;1;0;0;0;9;73;2;6;3678;95;95;2;3;0;9;9;3678;3;4949;6;1;
/org.eclipse.pde.ui/src/org/eclipse/pde/internal/ui/build/BuildSiteAction.java;1;1;6;1;3;3;3;3;40;1;3;3840;62;62;1;0;0;3;6;3840;0;6336;6;1;
/org.eclipse.team.ui/src/org/eclipse/team/ui/synchronize/subscribers/SubscriberActionProvider.java;1;0;1;1;0;0;0;1;0;0;1;5036;0;0;1;0;0;1;1;5036;0;5036;1;1;
/org.eclipse.ant.tests.ui/Ant Editor Tests/org/eclipse/ui/externaltools/internal/ant/editor/test/EnclosingTargetSearchingHandlerTest.java;1;0;5;1;0;0;0;5;180;2;4;178;188;188;2;1;0;5;5;724;1;1274;4;1;
/org.eclipse.jdt.core.tests.model/workspace/Resolve/src/ResolveMethodDeclarationInAnonymous2.java;1;0;1;1;0;0;0;1;0;0;1;2638;0;0;1;0;0;1;1;2638;0;2638;1;1;
/org.eclipse.jdt.core.tests.model/workspace/Formatter/test276/A_out.java;1;0;1;1;0;0;0;1;0;0;1;2443;0;0;1;0;0;1;1;2443;0;2443;1;1;
/org.eclipse.pde.ui/src/org/eclipse/pde/internal/ui/wizards/exports/PluginExportJob.java;2;2;11;2;8;6;8;3;183;2;2;2571;222;222;2;1;2;3;11;5044;3;6336;8;2;
/org.eclipse.jdt.ui.tests.refactoring/resources/ExtractMethodWorkSpace/ExtractMethodTests/locals_out/A_test568.java;1;0;2;1;0;0;0;2;6;1;2;130;7;7;1;0;0;2;2;130;0;844;2;1;
/org.eclipse.jdt.core.tests.model/workspace/Converter/src/test0195/Test.java;1;0;1;1;0;0;0;1;0;0;1;3714;0;0;1;0;0;1;1;3714;0;3714;1;1;
/org.eclipse.ui.workbench/Eclipse UI/org/eclipse/ui/internal/ShowViewMenu.java;7;1;14;2;3;3;3;11;61;2;8;1949;152;152;2;3;0;11;14;2279;3;6338;11;7;
/org.eclipse.jdt.ui.tests.refactoring/resources/DeleteSourceReference/test1/in/A.java;1;0;1;1;0;0;0;1;0;0;1;1652;0;0;1;0;0;1;1;1652;0;1652;1;1;
/org.eclipse.team.ui/src/org/eclipse/team/ui/synchronize/ParticipantPageSaveablePart.java;2;2;11;2;11;9;11;0;471;0;0;5192;617;617;2;0;2;0;11;5358;2;6337;9;2;
/org.eclipse.jdt.core/codeassist/org/eclipse/jdt/internal/codeassist/complete/CompletionOnQualifiedExceptionReference.java;2;0;2;1;0;0;0;2;13;1;2;991;15;15;1;0;0;2;2;991;0;3560;2;2;
/org.eclipse.core.runtime/src/org/eclipse/core/runtime/IPlatform.java;5;2;33;2;6;4;6;27;820;3;22;3049;1815;1815;3;5;2;27;33;3164;7;5536;26;5;
/org.eclipse.swt.tests/JUnit Tests/org/eclipse/swt/tests/junit/Test_org_eclipse_swt_events_KeyListener.java;1;0;1;1;0;0;0;1;16;0;1;2175;16;16;1;0;0;1;1;2175;0;2175;1;1;
/org.eclipse.jdt.core.tests.model/workspace/Formatter/test070/A_in.java;1;0;1;1;0;0;0;1;0;0;1;2425;0;0;1;0;0;1;1;2425;0;2425;1;1;
/org.eclipse.sdk.tests-feature/plugins/org.eclipse.perfmsr.core/src/org/eclipse/perfmsr/core/PerfMsrCorePlugin.java;2;2;7;2;6;5;6;1;10;0;1;4845;35;35;2;0;1;1;7;5638;1;6342;6;2;
/org.eclipse.text/src/org/eclipse/jface/text/IDocumentListener.java;2;1;2;1;2;2;2;0;2;0;0;6296;4;4;1;0;0;0;2;6296;0;6340;2;2;
/org.eclipse.ant.tests.core/tests/org/eclipse/ant/tests/core/tests/FrameworkTests.java;1;1;5;1;2;2;2;3;56;1;3;1796;78;78;1;0;0;3;5;1796;0;6336;5;1;
/org.eclipse.team.ui/src/org/eclipse/team/internal/ui/jobs/ViewFeedbackManager.java;1;0;1;1;0;0;0;1;0;0;1;2007;0;0;1;0;0;1;1;2007;0;2007;1;1;
/org.eclipse.jdt.core/dom/org/eclipse/jdt/core/dom/ParameterizedType.java;4;2;16;1;5;4;5;11;162;2;10;2867;457;457;2;1;1;11;16;4900;2;6336;14;4;
/org.eclipse.ui.workbench/Eclipse UI/org/eclipse/ui/internal/contexts/ContextBinding.java;2;0;2;1;1;1;1;1;0;0;1;4969;0;0;1;0;0;1;2;4969;0;5273;2;2;
/org.eclipse.jdt.launching/launching/org/eclipse/jdt/internal/launching/DefaultProjectClasspathEntry.java;3;1;9;1;4;4;4;5;41;2;4;3810;115;115;2;1;0;5;9;3810;1;5922;8;3;
/org.eclipse.jdt.core/model/org/eclipse/jdt/internal/core/MemberElementInfo.java;2;0;2;1;1;1;1;1;2;0;1;3560;4;4;1;0;0;1;2;3560;0;5916;2;2;
/org.eclipse.jdt.core.tests.model/workspace/Converter/src/test0528/A.java;1;0;1;1;0;0;0;1;0;0;1;3714;0;0;1;0;0;1;1;3714;0;3714;1;1;
/org.eclipse.jdt.core.tests.model/workspace/Converter/test0048/Test.java;1;0;1;1;0;0;0;1;0;0;1;3714;0;0;1;0;0;1;1;3714;0;3714;1;1;
/org.eclipse.jdt.core/dom/org/eclipse/jdt/core/dom/CastExpression.java;3;1;8;1;2;2;2;6;110;1;6;3560;158;158;1;0;0;6;8;3560;0;5272;8;3;
/org.eclipse.compare/compare/org/eclipse/compare/NavigationAction.java;1;0;3;1;1;1;1;2;31;1;2;1735;35;35;1;0;0;2;3;1735;0;5199;3;1;
/org.eclipse.ant.ui/Ant Editor/org/eclipse/ant/internal/ui/editor/model/IAntModelConstants.java;1;0;1;1;0;0;0;1;0;0;1;4224;0;0;1;0;0;1;1;4224;0;4224;1;1;
/org.eclipse.ui.ide/src/org/eclipse/ui/internal/ide/AboutInfo.java;1;1;2;1;2;2;2;0;2;0;0;6102;2;2;1;0;0;0;2;6102;0;6338;2;1;
/org.eclipse.ui.ide/src/org/eclipse/ui/model/WorkbenchViewerSorter.java;1;0;2;1;0;0;0;2;0;1;2;1511;0;0;1;0;0;2;2;1511;0;1526;2;1;
/org.eclipse.team.cvs.core/src/org/eclipse/team/internal/ccvs/core/resources/RemoteFolderTreeBuilder.java;2;1;9;1;3;3;3;6;172;1;6;350;253;253;1;0;0;6;9;350;0;6337;9;2;
/org.eclipse.jdt.ui.tests.refactoring/resources/IntroduceFactory/positive/DontMoveArgs2_in.java;1;0;2;1;1;1;1;1;2;0;1;2846;2;2;1;0;0;1;2;2846;0;5659;2;1;
/org.eclipse.jdt.ui.tests.refactoring/resources/IntroduceFactory/positive/DifferentArgs1.java;1;0;2;1;1;1;1;1;2;0;1;2862;2;2;1;0;0;1;2;2862;0;5659;2;1;
/org.eclipse.jdt.launching/launching/org/eclipse/jdt/internal/launching/JavaSourceLookupUtil.java;1;1;3;1;2;2;2;1;42;0;1;5091;44;44;1;0;0;1;3;5091;0;5883;3;1;
/org.eclipse.swt/Eclipse SWT Drag and Drop/gtk/org/eclipse/swt/dnd/TransferData.java;2;1;3;1;2;2;2;1;10;0;1;4128;18;18;1;0;0;1;3;4128;0;6352;3;2;
/org.eclipse.debug.ui/ui/org/eclipse/debug/internal/ui/views/memory/IFixedLengthOutputRenderer.java;1;0;1;1;1;1;1;0;0;0;0;5254;0;0;1;0;0;0;1;5254;0;5254;1;1;
/org.eclipse.jdt.core/model/org/eclipse/jdt/internal/core/SearchableEnvironmentRequestor.java;2;0;2;1;0;0;0;2;5;1;2;1892;7;7;1;0;0;2;2;1892;0;3560;2;2;
/org.eclipse.ui.workbench/Eclipse UI/org/eclipse/ui/commands/IGestureStroke.java;1;0;5;1;0;0;0;5;14;2;3;1239;20;20;2;2;0;5;5;1239;2;1294;3;1;
/org.eclipse.ui.workbench/Eclipse UI/org/eclipse/ui/internal/csm/commands/AbstractCommandRegistry.java;1;0;4;1;0;0;0;4;35;2;3;2515;45;45;2;1;0;4;4;2556;1;2556;3;1;
/org.eclipse.swt.tools/JNI Generation/org/eclipse/swt/tools/internal/MethodData.java;1;0;1;1;0;0;0;1;0;0;1;4175;0;0;1;0;0;1;1;4175;0;4175;1;1;
/org.eclipse.ui.workbench/Eclipse UI/org/eclipse/ui/commands/ICommandDelegateServiceEvent.java;1;0;2;1;0;0;0;2;0;1;2;1321;0;0;1;0;0;2;2;1321;0;1419;2;1;
/org.eclipse.jdt.debug.tests/tests/org/eclipse/jdt/debug/tests/core/LaunchDelegateTests.java;1;0;1;1;0;0;0;1;0;0;1;4371;0;0;1;0;0;1;1;4371;0;4371;1;1;
/org.eclipse.jdt.ui/core extension/org/eclipse/text/edits/TextEdit.java;1;0;4;1;0;0;0;4;110;2;3;1953;197;197;2;1;0;4;4;1985;1;1985;3;1;
/org.eclipse.swt/Eclipse SWT PI/gtk/org/eclipse/swt/internal/gtk/AtkActionIface.java;1;0;2;1;0;0;0;2;0;1;2;1102;0;0;1;0;0;2;2;1102;0;1214;2;1;
/org.eclipse.core.runtime.osgi/src/org/eclipse/core/runtime/registry/IExecutableExtension.java;1;0;2;1;0;0;0;2;174;1;2;3013;174;174;1;0;0;2;2;3013;0;3030;2;1;
/org.eclipse.jdt.ui.tests.refactoring/resources/ExtractMethodWorkSpace/ExtractMethodTests/try_in/A_test456.java;1;0;2;1;0;0;0;2;2;1;2;130;4;4;1;0;0;2;2;130;0;844;2;1;
/org.eclipse.jdt.ui.tests.refactoring/resources/ExtractMethodWorkSpace/ExtractMethodTests/semicolon_in/A_test407.java;1;0;1;1;0;0;0;1;2;0;1;844;2;2;1;0;0;1;1;844;0;844;1;1;
/org.eclipse.ui.workbench/Eclipse UI/org/eclipse/ui/internal/contexts/AbstractMutableContextRegistry.java;1;0;6;1;0;0;0;6;3;2;4;1400;6;6;2;2;0;6;6;1400;2;2425;4;1;
/org.eclipse.core.boot/src/org/eclipse/core/boot/BootLoader.java;1;0;2;1;0;0;0;2;1;1;2;2967;1;1;1;0;0;2;2;2967;0;3013;2;1;
/org.eclipse.swt/Eclipse SWT PI/win32/org/eclipse/swt/internal/win32/SCRIPT_PROPERTIES.java;2;0;2;1;1;1;1;1;4;0;1;4764;4;4;1;0;0;1;2;4764;0;6352;2;2;
/org.eclipse.jdt.core.tests.model/workspace/Converter/src/test0018/Test.java;1;0;1;1;0;0;0;1;0;0;1;3714;0;0;1;0;0;1;1;3714;0;3714;1;1;
/org.eclipse.team.ui/src/org/eclipse/team/internal/ui/wizards/ImportProjectSetMainPage.java;1;1;5;1;2;2;2;3;214;2;2;987;219;219;2;1;0;3;5;987;1;6337;4;1;
/org.eclipse.ui.workbench/Eclipse UI/org/eclipse/ui/part/EditorActionBarContributor.java;2;0;2;1;0;0;0;2;27;1;2;3220;31;31;1;0;0;2;2;3220;0;3239;2;2;
/org.eclipse.jdt.core.tests.model/workspace/Formatter/test454/A_out.java;1;0;1;1;0;0;0;1;0;0;1;3788;0;0;1;0;0;1;1;3788;0;3788;1;1;
/org.eclipse.help.ui/src/org/eclipse/help/ui/internal/browser/embedded/EmbeddedBrowser.java;1;2;18;1;12;11;12;6;251;2;4;4457;707;707;2;2;1;6;18;4502;3;5995;15;1;
/org.eclipse.jdt.ui/core refactoring/org/eclipse/jdt/internal/corext/refactoring/code/ExtractTempRefactoring.java;6;4;49;2;17;14;17;32;119;3;27;48;715;715;4;5;3;32;49;5909;8;6340;41;6;
/org.eclipse.ui.internal.r21presentation/src/org/eclipse/ui/internal/r21presentation/R21PresentationMessages.java;1;0;1;1;1;1;1;0;0;0;0;5874;0;0;1;0;0;0;1;5874;0;5874;1;1;
/org.eclipse.team.core/src/org/eclipse/team/internal/core/InfiniteSubProgressMonitor.java;1;0;2;1;0;0;0;2;12;0;1;1840;12;12;2;1;0;2;2;1840;1;1840;1;1;
/org.eclipse.core.runtime.compatibility/src-model/org/eclipse/core/runtime/model/PluginFragmentModel.java;3;2;6;1;4;3;4;2;18;1;2;3013;27;27;2;0;1;2;6;5117;1;6340;5;3;
/org.eclipse.update.ui/src/org/eclipse/update/internal/ui/model/MissingFeature.java;1;0;1;1;0;0;0;1;8;0;1;890;8;8;1;0;0;1;1;890;0;890;1;1;
/org.eclipse.debug.core/core/org/eclipse/debug/internal/core/stringsubstitution/StringVariableManager.java;3;0;9;1;0;0;0;9;71;2;8;2032;214;214;2;1;0;9;9;2462;1;2514;8;3;
/org.eclipse.jdt.core.tests.model/workspace/Converter/src/test0166/Test.java;1;0;3;1;2;1;2;1;2;0;1;3714;2;2;2;0;1;1;3;5382;1;5382;2;1;
/org.eclipse.jdt.core.tests.model/workspace/Converter/src/javadoc/test008/Test.java;1;0;1;1;0;0;0;1;0;0;1;3813;0;0;1;0;0;1;1;3813;0;3813;1;1;
/org.eclipse.ui.workbench/Eclipse UI/org/eclipse/ui/contexts/activationservice/IMutableContextActivationService.java;1;0;2;1;0;0;0;2;0;1;2;3066;0;0;1;0;0;2;2;3066;0;3109;2;1;
/org.eclipse.team.cvs.ui/src/org/eclipse/team/internal/ccvs/ui/wizards/GenerateDiffFileWizard.java;2;0;2;1;0;0;0;2;38;1;2;882;42;42;1;0;0;2;2;882;0;2747;2;2;
/org.eclipse.core.tests.runtime/src/org/eclipse/core/tests/internal/plugins/RegressionResolveTest_7.java;1;0;1;1;0;0;0;1;0;0;1;3014;0;0;1;0;0;1;1;3014;0;3014;1;1;
/org.eclipse.ui.workbench/Eclipse UI/org/eclipse/ui/commands/Gesture.java;1;0;2;1;0;0;0;2;41;1;2;1321;41;41;1;0;0;2;2;1321;0;1340;2;1;
/org.eclipse.update.ui/src/org/eclipse/update/internal/ui/model/IConfiguredFeatureAdapter.java;1;0;1;1;0;0;0;1;2;0;1;715;2;2;1;0;0;1;1;715;0;715;1;1;
/org.eclipse.jdt.core/compiler/org/eclipse/jdt/internal/compiler/ast/OR_OR_Expression.java;2;0;6;1;0;0;0;6;338;2;5;693;359;359;2;1;0;6;6;3062;1;3560;5;2;
/org.eclipse.jdt.ui.tests.refactoring/resources/InlineMethodWorkspace/TestCases/argument_in/TestTwoReads.java;1;0;1;1;0;0;0;1;2;0;1;845;2;2;1;0;0;1;1;845;0;845;1;1;
/org.eclipse.jdt.core/compiler/org/eclipse/jdt/internal/compiler/ast/NumberLiteral.java;2;0;2;1;0;0;0;2;34;1;2;991;36;36;1;0;0;2;2;991;0;3560;2;2;
/org.eclipse.ui.workbench/Eclipse UI/org/eclipse/ui/internal/commands/registry/CommandRegistryEvent.java;1;0;4;1;0;0;0;4;14;2;3;1396;14;14;2;1;0;4;4;1396;1;1724;3;1;
/org.eclipse.jdt.core.tests.model/workspace/Formatter/test161/A_in.java;1;0;1;1;0;0;0;1;0;0;1;2425;0;0;1;0;0;1;1;2425;0;2425;1;1;
/org.eclipse.team.core/src/org/eclipse/team/core/synchronize/SyncInfoFilter.java;2;0;5;1;1;1;1;4;72;1;4;4045;100;100;1;0;0;4;5;4045;0;6336;5;2;
/org.eclipse.ui.workbench/Eclipse UI/org/eclipse/ui/internal/commands/CommandManagerFactory.java;3;1;3;1;2;2;2;1;4;0;1;4927;5;5;1;0;0;1;3;4927;0;6338;3;3;
/org.eclipse.ui.examples.javaeditor/Eclipse Java Editor Example/org/eclipse/ui/examples/javaeditor/spelling/SpellEvent.java;1;0;1;1;0;0;0;1;0;0;1;2565;0;0;1;0;0;1;1;2565;0;2565;1;1;
/org.eclipse.core.boot/src/org/eclipse/core/internal/boot/URLContentFilter.java;1;0;1;1;0;0;0;1;0;0;1;3013;0;0;1;0;0;1;1;3013;0;3013;1;1;
/org.eclipse.ui.ide/src/org/eclipse/ui/internal/registry/CapabilityRegistry.java;2;0;4;1;0;0;0;4;31;2;3;1526;31;31;2;1;0;4;4;1536;1;2263;3;2;
/org.eclipse.help/src/org/eclipse/help/internal/toc/Anchor.java;1;1;5;1;3;3;3;2;20;1;2;631;47;47;1;0;0;2;5;631;0;6337;5;1;
/org.eclipse.jdt.ui/ui/org/eclipse/jdt/internal/ui/javaeditor/ClassFileEditorActionContributor.java;1;0;1;1;1;1;1;0;2;0;0;6340;2;2;1;0;0;0;1;6340;0;6340;1;1;
/org.eclipse.ui.workbench/Eclipse UI/org/eclipse/ui/internal/contexts/registry/FileRegistry.java;1;0;2;1;0;0;0;2;0;0;1;1396;0;0;2;1;0;2;2;1396;1;1396;1;1;
/org.eclipse.jdt.debug.ui/ui/org/eclipse/jdt/internal/debug/ui/propertypages/ExceptionFilterEditor.java;3;2;8;2;4;3;4;4;9;1;4;1358;23;23;2;0;1;4;8;5439;1;5898;7;3;
/org.eclipse.ui.cheatsheets/src/org/eclipse/ui/internal/cheatsheets/views/SubItemCompositeHolder.java;2;0;4;1;1;1;1;3;34;1;3;4428;58;58;1;0;0;3;4;4428;0;5596;4;2;
/org.eclipse.debug.ui/ui/org/eclipse/debug/internal/ui/actions/RetargetRunToLineAction.java;1;0;2;1;0;0;0;2;4;1;2;4471;4;4;1;0;0;2;2;4471;0;4496;2;1;
/org.eclipse.jdt.ui/ui/org/eclipse/jdt/internal/ui/search/NewSearchResultCollector.java;2;2;11;1;7;5;7;4;62;1;4;3488;171;171;2;0;2;4;11;5178;2;5433;9;2;
/org.eclipse.help.webapp/src_servlets/org/eclipse/help/internal/webapp/data/TocData.java;1;1;21;1;6;6;6;15;174;2;12;152;683;683;2;3;0;15;21;620;3;6337;18;1;
/org.eclipse.ui.workbench/Eclipse UI/org/eclipse/ui/internal/dialogs/NewWizard.java;5;0;11;2;1;1;1;10;99;1;10;1950;280;280;1;0;0;10;11;1950;0;6338;11;5;
/org.eclipse.jdt.debug.jdi.tests/tests/org/eclipse/debug/jdi/tests/EventRequestManagerTest.java;2;0;2;1;1;1;1;1;3;0;1;1317;5;5;1;0;0;1;2;1317;0;6339;2;2;
/org.eclipse.jdt.core/compiler/org/eclipse/jdt/internal/compiler/lookup/FieldBinding.java;3;0;6;1;1;1;1;5;8;1;5;13;19;19;1;0;0;5;6;13;0;5105;6;3;
/org.eclipse.swt/Eclipse SWT Accessibility/common/org/eclipse/swt/accessibility/AccessibleTextListener.java;1;0;1;1;0;0;0;1;0;0;1;2244;0;0;1;0;0;1;1;2244;0;2244;1;1;
/org.eclipse.jdt.ui/core refactoring/org/eclipse/jdt/internal/corext/refactoring/participants/xml/AdaptExpression.java;1;0;4;1;0;0;0;4;19;1;4;2682;26;26;1;0;0;4;4;2682;0;4108;4;1;
/org.eclipse.ui.workbench/Eclipse UI/org/eclipse/ui/commands/IActivityBinding.java;1;0;3;1;0;0;0;3;4;1;3;2569;4;4;1;0;0;3;3;2569;0;3128;3;1;
/org.eclipse.jdt.core/dom/org/eclipse/jdt/internal/core/dom/rewrite/ListRewriteEvent.java;3;1;3;1;2;2;2;1;62;0;1;4802;66;66;1;0;0;1;3;4802;0;6336;3;3;
/org.eclipse.ui.workbench/Eclipse UI/org/eclipse/ui/activities/ActivityManagerEvent.java;4;1;11;1;3;3;3;8;148;1;8;2805;263;263;1;0;0;8;11;2805;0;6338;11;4;
/org.eclipse.jdt.ui/ui/org/eclipse/jdt/internal/ui/javaeditor/TogglePresentationAction.java;1;0;2;1;1;1;1;1;10;0;1;1520;12;12;1;0;0;1;2;1520;0;6340;2;1;
/org.eclipse.debug.ui/ui/org/eclipse/debug/internal/ui/actions/ExpressionInformationControlAdapter.java;2;0;9;1;1;1;1;8;126;2;7;3828;216;216;2;1;0;8;9;3828;1;5133;8;2;
/org.eclipse.ui.tests/Eclipse UI Tests/org/eclipse/ui/tests/api/IWorkbenchTest.java;1;0;5;1;0;0;0;5;17;2;3;1540;35;35;2;2;0;5;5;1540;2;1740;3;1;
/org.eclipse.jdt.core/dom/org/eclipse/jdt/core/dom/DOMScanner.java;3;0;4;2;0;0;0;4;8;3;2;3762;8;8;3;2;0;4;4;3762;2;3861;2;3;
/org.eclipse.jdt.core.tests.model/workspace/Converter/test0200/Test.java;1;0;1;1;0;0;0;1;0;0;1;3714;0;0;1;0;0;1;1;3714;0;3714;1;1;
/org.eclipse.ui.workbench/Eclipse UI/org/eclipse/ui/internal/commands/Command.java;4;1;46;1;6;6;6;40;734;5;29;535;3231;3231;5;11;0;40;46;1389;11;6338;35;4;
/org.eclipse.ui.workbench/Eclipse UI/org/eclipse/ui/internal/commands/registry/old/IRegistry.java;1;0;3;1;0;0;0;3;28;1;3;1222;28;28;1;0;0;3;3;1222;0;1322;3;1;
/org.eclipse.team.ui/src/org/eclipse/team/ui/TeamUI.java;2;1;9;1;2;2;2;7;24;1;7;917;93;93;1;0;0;7;9;917;0;6337;9;2;
/org.eclipse.jdt.core/model/org/eclipse/jdt/internal/core/builder/ImageBuilderInternalException.java;2;0;2;1;1;1;1;1;12;0;1;3560;14;14;1;0;0;1;2;3560;0;5338;2;2;
/org.eclipse.jdt.ui.tests.refactoring/resources/MoveInnerToTopLevel/test_nonstatic_38/out/Inner.java;2;0;2;1;0;0;0;2;8;1;2;1314;8;8;1;0;0;2;2;1314;0;2563;2;2;
/org.eclipse.jdt.core/model/org/eclipse/jdt/internal/core/UserLibraryClasspathContainerInitializer.java;1;1;2;1;2;2;2;0;7;0;0;5199;9;9;1;0;0;0;2;5199;0;5225;2;1;
/org.eclipse.jdt.ui.tests.refactoring/resources/IntroduceFactory/positive/MultiUnit1B_in.java;1;0;2;1;1;1;1;1;2;0;1;2862;2;2;1;0;0;1;2;2862;0;5659;2;1;
/org.eclipse.ui.workbench/Eclipse UI/org/eclipse/ui/internal/commands/CommandManager.java;3;0;76;2;0;0;0;76;1633;6;42;1222;6783;6783;6;34;0;76;76;2556;34;4927;42;3;
/org.eclipse.ui.tests/Eclipse UI Tests/org/eclipse/ui/tests/dynamicplugins/TestInstallUtil.java;1;0;3;1;1;1;1;2;37;1;2;4825;40;40;1;0;0;2;3;4825;0;6081;3;1;
/org.eclipse.jdt.core.tests.model/workspace/Converter/src/javadoc/test016/TestB1.java;1;0;2;1;0;0;0;2;0;1;2;4311;0;0;1;0;0;2;2;4311;0;4390;2;1;
/org.eclipse.jdt.core/compiler/org/eclipse/jdt/internal/compiler/ast/FalseLiteral.java;2;0;2;1;0;0;0;2;4;1;2;2974;6;6;1;0;0;2;2;2974;0;3560;2;2;
/org.eclipse.jdt.core/model/org/eclipse/jdt/internal/core/Util.java;3;0;12;1;0;0;0;12;81;1;12;13;352;352;1;0;0;12;12;13;0;3194;12;3;
/org.eclipse.pde.core/src/org/eclipse/pde/internal/core/isite/ISiteFeature.java;2;1;4;1;2;2;2;2;19;1;2;2311;43;43;1;0;0;2;4;2311;0;6336;4;2;
/org.eclipse.ui.externaltools/Ant Editor/org/eclipse/ui/externaltools/internal/ant/dtd/util/Factory.java;1;0;1;1;0;0;0;1;0;0;1;282;0;0;1;0;0;1;1;282;0;282;1;1;
/org.eclipse.jface/src/org/eclipse/jface/action/IContributionItem.java;3;0;3;1;0;0;0;3;19;1;3;173;33;33;1;0;0;3;3;173;0;3238;3;3;
/org.eclipse.debug.ui/ui/org/eclipse/debug/internal/ui/console/ConsoleDropDownAction.java;2;0;3;1;0;0;0;3;2;1;3;1317;2;2;1;0;0;3;3;1317;0;2060;3;2;
/org.eclipse.jdt.debug.tests/tests/org/eclipse/jdt/debug/tests/eval/Tests.java;2;0;2;2;0;0;0;2;12;0;1;1274;12;12;2;1;0;2;2;1274;1;1274;1;2;
/org.eclipse.debug.ui/ui/org/eclipse/debug/internal/ui/actions/ReevaluateWatchExpressionAction.java;1;0;3;1;0;0;0;3;20;1;3;1516;24;24;1;0;0;3;3;1516;0;1846;3;1;
/org.eclipse.swt/Eclipse SWT/win32/org/eclipse/swt/widgets/MessageBox.java;4;1;8;1;2;2;2;6;20;1;6;217;69;69;1;0;0;6;8;217;0;6352;8;4;
/org.eclipse.team.ui/src/org/eclipse/team/ui/synchronize/subscriber/GlobalRefreshResourceSelectionPage.java;2;0;5;2;0;0;0;5;173;2;4;4518;181;181;2;1;0;5;5;4558;1;4632;4;2;
/org.eclipse.jdt.launching/launching/org/eclipse/jdt/launching/sourcelookup/JavaSourceLocator.java;4;1;8;1;3;3;3;5;32;2;4;2449;95;95;2;1;0;5;8;4351;1;6336;7;4;
/org.eclipse.ui.workbench/Eclipse UI/org/eclipse/ui/internal/activities/IActivityDefinition.java;1;0;3;1;0;0;0;3;6;1;3;2444;6;6;1;0;0;3;3;2444;0;3066;3;1;
/org.eclipse.help.ide/src/org/eclipse/help/ui/internal/workingset/HelpWorkingSetElementLabelProvider.java;1;1;3;1;2;2;2;1;47;0;1;1738;87;87;1;0;0;1;3;1738;0;6337;3;1;
/org.eclipse.jdt.ui/ui/org/eclipse/jdt/internal/ui/search/GotoMarkerAction.java;3;1;4;1;3;3;3;1;32;0;1;2742;42;42;1;0;0;1;4;2742;0;6340;4;3;
/org.eclipse.pde.core/src_OSGi/org/eclipse/pde/internal/core/osgi/bundle/BundlePluginModelBase.java;2;0;14;1;0;0;0;14;157;2;12;2247;302;302;2;2;0;14;14;2296;2;4203;12;2;
/org.eclipse.osgi/osgi/src/org/osgi/framework/ServiceEvent.java;2;0;2;1;1;1;1;1;3;0;1;3013;3;3;1;0;0;1;2;3013;0;5536;2;2;
/org.eclipse.debug.ui/ui/org/eclipse/debug/internal/ui/views/memory/CopyViewTabToClipboardContextAction.java;1;0;1;1;1;1;1;0;0;0;0;5254;0;0;1;0;0;0;1;5254;0;5254;1;1;
/org.eclipse.pde.ui/templates/editor/java/XMLDocumentProvider.java;1;0;1;1;0;0;0;1;10;0;1;851;10;10;1;0;0;1;1;851;0;851;1;1;
/org.eclipse.jdt.ui/ui refactoring/org/eclipse/jdt/internal/ui/refactoring/nls/search/NLSSearchResultLabelProvider.java;3;1;3;1;2;2;2;1;3;0;1;4965;6;6;1;0;0;1;3;4965;0;6340;3;3;
/org.eclipse.ant.ui/Ant Editor/org/eclipse/ant/internal/ui/editor/outline/ILocationProvider.java;1;0;2;1;0;0;0;2;0;1;2;1811;0;0;1;0;0;2;2;1811;0;4198;2;1;
/org.eclipse.debug.ui/ui/org/eclipse/debug/internal/ui/views/memory/ViewTabCursorManager.java;2;1;5;1;5;5;5;0;9;0;0;5254;21;21;1;0;0;0;5;5254;0;6147;5;2;
/org.eclipse.swt.tests/JUnit Tests/org/eclipse/swt/tests/junit/Test_org_eclipse_swt_dnd_Transfer.java;1;0;1;1;0;0;0;1;38;0;1;2176;38;38;1;0;0;1;1;2176;0;2176;1;1;
/org.eclipse.jdt.core.tests.model/workspace/Converter/src/test0334/Test.java;1;0;1;1;0;0;0;1;0;0;1;3714;0;0;1;0;0;1;1;3714;0;3714;1;1;
/org.eclipse.jdt.core.tests.model/workspace/Converter/test0081/Test.java;1;0;1;1;0;0;0;1;0;0;1;3714;0;0;1;0;0;1;1;3714;0;3714;1;1;
/org.eclipse.jdt.ui.tests.refactoring/resources/ExtractMethodWorkSpace/ExtractMethodTests/wiki_in/A_test2003.java;1;0;2;1;0;0;0;2;4;1;2;130;5;5;1;0;0;2;2;130;0;844;2;1;
/org.eclipse.jdt.core/dom/org/eclipse/jdt/core/dom/MemberValuePair.java;2;2;12;1;4;3;4;8;183;1;8;4054;337;337;2;0;1;8;12;5268;1;5335;11;2;
/org.eclipse.core.tests.runtime/src/org/eclipse/core/tests/internal/plugins/PluginResolveTest_14.java;1;0;1;1;0;0;0;1;0;0;1;3014;0;0;1;0;0;1;1;3014;0;3014;1;1;
/org.eclipse.update.ui.forms/src/org/eclipse/ui/forms/parts/FormEntry.java;1;0;2;1;0;0;0;2;0;1;2;3071;0;0;1;0;0;2;2;3071;0;3096;2;1;
/org.eclipse.ui.ide/src/org/eclipse/ui/internal/dialogs/AboutDialog.java;2;0;4;1;0;0;0;4;26;2;3;1671;37;37;2;1;0;4;4;1671;1;2263;3;2;
/org.eclipse.jdt.core/compiler/org/eclipse/jdt/internal/compiler/codegen/FloatCache.java;1;0;1;1;0;0;0;1;2;0;1;3560;2;2;1;0;0;1;1;3560;0;3560;1;1;
/org.eclipse.swt/Eclipse SWT Custom Widgets/common/org/eclipse/swt/custom/StyleRange.java;2;0;3;1;1;1;1;2;4;1;2;4612;8;8;1;0;0;2;3;4612;0;6352;3;2;
/org.eclipse.pde.ui/src_Forms/org/eclipse/pde/internal/ui/neweditor/schema/NewAttributeAction.java;2;0;2;1;1;1;1;1;0;0;1;4856;0;0;1;0;0;1;2;4856;0;5431;2;2;
/org.eclipse.ant.ui/Ant Editor/org/eclipse/ant/ui/internal/dtd/schema/Atom.java;1;0;2;1;0;0;0;2;0;1;2;250;0;0;1;0;0;2;2;250;0;1811;2;1;
/org.eclipse.text/projection/org/eclipse/jface/text/FragmentUpdater.java;1;0;2;1;1;1;1;1;1;0;1;4516;1;1;1;0;0;1;2;4516;0;5177;2;1;
/org.eclipse.update.core/src/org/eclipse/update/internal/search/UpdateSearchCategory.java;3;0;3;1;0;0;0;3;2;1;3;825;2;2;1;0;0;3;3;825;0;955;3;3;
/org.eclipse.team.cvs.core/src/org/eclipse/team/internal/ccvs/core/ICVSRepositoryLocation.java;2;0;5;1;1;1;1;4;23;1;4;3113;56;56;1;0;0;4;5;3113;0;6337;5;2;
/org.eclipse.jdt.launching/launching/org/eclipse/jdt/internal/launching/JavaSourceLookupParticipant.java;1;0;5;1;0;0;0;5;90;2;4;4109;102;102;2;1;0;5;5;4949;1;4971;4;1;
/org.eclipse.swt/Eclipse SWT/carbon/org/eclipse/swt/widgets/MessageBox.java;4;1;5;1;3;3;3;2;38;1;2;394;71;71;1;0;0;2;5;394;0;6352;5;4;
/org.eclipse.team.ui/src/org/eclipse/team/internal/ui/synchronize/actions/ToggleViewLayoutAction.java;1;0;3;1;0;0;0;3;50;1;3;2561;50;50;1;0;0;3;3;2561;0;4216;3;1;
/org.eclipse.swt/Eclipse SWT/carbon/org/eclipse/swt/graphics/Color.java;1;1;2;1;2;2;2;0;4;0;0;5606;8;8;1;0;0;0;2;5606;0;6352;2;1;
/org.eclipse.ui.workbench/Eclipse UI/org/eclipse/ui/internal/commands/older/KeySequenceBindingMachine.java;1;0;2;1;0;0;0;2;0;0;1;2564;0;0;2;1;0;2;2;2564;1;2564;1;1;
/org.eclipse.jdt.core.tests.model/workspace/Formatter/test269/A_out.java;1;0;2;1;0;0;0;2;4;1;2;2442;4;4;1;0;0;2;2;2442;0;3029;2;1;
/org.eclipse.jdt.ui/ui/org/eclipse/jdt/internal/ui/compare/JavaParseTreeBuilder.java;2;0;2;1;1;1;1;1;5;0;1;187;7;7;1;0;0;1;2;187;0;6340;2;2;
/org.eclipse.pde.ui/src_Forms/org/eclipse/pde/internal/ui/neweditor/schema/SchemaDocPage.java;2;0;2;1;1;1;1;1;0;0;1;4856;0;0;1;0;0;1;2;4856;0;5431;2;2;
/org.eclipse.ui.cheatsheets/src/org/eclipse/ui/internal/cheatsheets/actions/CheatSheetMenuAction.java;1;0;2;1;1;1;1;1;77;0;1;5094;77;77;1;0;0;1;2;5094;0;5735;2;1;
/org.eclipse.swt/Eclipse SWT/carbon/org/eclipse/swt/graphics/FontData.java;3;1;5;1;3;3;3;2;42;1;2;174;58;58;1;0;0;2;5;174;0;6352;5;3;
/org.eclipse.debug.core/core/org/eclipse/debug/internal/core/sourcelookup/ISourcePathComputer.java;1;0;5;1;0;0;0;5;32;2;4;3169;61;61;2;1;0;5;5;3169;1;4949;4;1;
/org.eclipse.jdt.ui/core refactoring/org/eclipse/jdt/internal/corext/refactoring/nls/SimpleLineReader.java;3;1;3;1;2;2;2;1;87;0;1;4930;89;89;1;0;0;1;3;4930;0;6340;3;3;
/org.eclipse.core.resources/src/org/eclipse/core/resources/IPathVariableChangeEvent.java;1;0;1;1;1;1;1;0;4;0;0;5146;4;4;1;0;0;0;1;5146;0;5146;1;1;
/org.eclipse.jdt.ui/ui/org/eclipse/jdt/internal/ui/text/template/contentassist/TemplateContentAssistMessages.java;2;1;2;1;2;2;2;0;2;0;0;5264;2;2;1;0;0;0;2;5264;0;6340;2;2;
/org.eclipse.core.tests.runtime/src/org/eclipse/core/tests/runtime/jobs/RepeatingJob.java;2;0;2;1;1;1;1;1;8;0;1;4353;8;8;1;0;0;1;2;4353;0;5149;2;2;
/org.eclipse.ui.workbench/Eclipse UI/org/eclipse/ui/internal/commands/GestureConfiguration.java;1;0;2;1;0;0;0;2;113;1;2;1321;113;113;1;0;0;2;2;1321;0;1340;2;1;
/org.eclipse.core.tests.runtime/src/org/eclipse/core/tests/runtime/jobs/AllTests.java;2;0;7;1;1;1;1;6;4;1;6;850;11;11;1;0;0;6;7;850;0;5149;7;2;
/org.eclipse.compare/compare/org/eclipse/compare/rangedifferencer/RangeDifference.java;1;0;1;1;0;0;0;1;2;0;1;3938;2;2;1;0;0;1;1;3938;0;3938;1;1;
/org.eclipse.ui.workbench/Eclipse UI/org/eclipse/ui/internal/progress/PendingUpdateAdapter.java;4;0;7;1;1;1;1;6;15;1;6;1170;38;38;1;0;0;6;7;1170;0;6338;7;4;
/org.eclipse.debug.ui/ui/org/eclipse/debug/internal/ui/actions/DisableWatchExpressionAction.java;1;0;1;1;0;0;0;1;0;0;1;1516;0;0;1;0;0;1;1;1516;0;1516;1;1;
/org.eclipse.swt.tests/JUnit Tests/org/eclipse/swt/tests/junit/Test_org_eclipse_swt_graphics_Device.java;1;0;1;1;0;0;0;1;72;0;1;2175;72;72;1;0;0;1;1;2175;0;2175;1;1;
/org.eclipse.help/src/org/eclipse/help/internal/search/QueryWordsToken.java;1;0;1;1;0;0;0;1;0;0;1;2732;0;0;1;0;0;1;1;2732;0;2732;1;1;
/org.eclipse.compare/compare/org/eclipse/compare/structuremergeviewer/ICompareInputChangeListener.java;1;0;1;1;0;0;0;1;2;0;1;3938;2;2;1;0;0;1;1;3938;0;3938;1;1;
/org.eclipse.core.tests.runtime/src/org/eclipse/core/tests/runtime/stream/Handler.java;1;0;2;1;1;1;1;1;5;0;1;2512;5;5;1;0;0;1;2;2512;0;5149;2;1;
/org.eclipse.team.ui/src/org/eclipse/team/internal/ui/registry/SynchronizeParticipantRegistry.java;1;1;4;1;2;2;2;2;54;1;2;2493;57;57;1;0;0;2;4;2493;0;6337;4;1;
/org.eclipse.jdt.ui/ui/org/eclipse/jdt/internal/ui/text/java/hover/JavaTypeHover.java;1;1;3;1;2;2;2;1;10;0;1;1705;20;20;1;0;0;1;3;1705;0;6340;3;1;
/org.eclipse.pde.core/src/org/eclipse/pde/core/IModelChangedEvent.java;2;1;5;1;4;4;4;1;62;0;1;4834;127;127;1;0;0;1;5;4834;0;6336;5;2;
/org.eclipse.ui.tests/Eclipse RCP Tests/org/eclipse/ui/rcp/tests/RcpTestSuite.java;1;0;1;1;0;0;0;1;0;0;1;4930;0;0;1;0;0;1;1;4930;0;4930;1;1;
/org.eclipse.jdt.core.tests.model/workspace/Converter/test0390/A.java;1;0;1;1;0;0;0;1;0;0;1;3714;0;0;1;0;0;1;1;3714;0;3714;1;1;
/org.eclipse.team.cvs.ui/src/org/eclipse/team/internal/ccvs/ui/sync/AddSyncAction.java;2;0;2;1;0;0;0;2;2;1;2;866;2;2;1;0;0;2;2;866;0;4217;2;2;
/org.eclipse.jdt.text.tests/src/org/eclipse/jdt/text/tests/JavaPartitionerExtensionTest.java;1;1;2;1;2;2;2;0;20;0;0;5129;20;20;1;0;0;0;2;5129;0;6340;2;1;
/org.eclipse.ant.ui/Ant Tools Support/org/eclipse/ant/internal/ui/preferences/GlobalClasspathEntriesSelectionDialog.java;1;0;2;1;0;0;0;2;0;1;2;2550;0;0;1;0;0;2;2;2550;0;4632;2;1;
/org.eclipse.ui.workbench/Eclipse UI/org/eclipse/ui/internal/commands/KeyPreferencePage.java;1;0;9;1;0;0;0;9;98;2;8;516;166;166;2;1;0;9;9;1077;1;1222;8;1;
/org.eclipse.jdt.debug.jdi.tests/tests/org/eclipse/debug/jdi/tests/MethodTest.java;1;0;1;1;0;0;0;1;22;0;1;4264;22;22;1;0;0;1;1;4264;0;4264;1;1;
/org.eclipse.jdt.ui.tests.refactoring/resources/ExtractMethodWorkSpace/ExtractMethodTests/locals_in/A_test519.java;1;0;1;1;0;0;0;1;2;0;1;844;2;2;1;0;0;1;1;844;0;844;1;1;
/org.eclipse.jdt.ui/ui/org/eclipse/jdt/internal/ui/text/JavaWordIterator.java;2;1;2;1;2;2;2;0;8;0;0;6072;8;8;1;0;0;0;2;6072;0;6340;2;2;
/org.eclipse.jdt.core.tests.model/workspace/Formatter/test122/A_in.java;1;0;1;1;0;0;0;1;0;0;1;2425;0;0;1;0;0;1;1;2425;0;2425;1;1;
/org.eclipse.ui.workbench/Eclipse UI/org/eclipse/ui/IPathEditorInput.java;2;0;2;1;0;0;0;2;41;1;2;1634;41;41;1;0;0;2;2;1634;0;2737;2;2;
/org.eclipse.ui.views/extensions/org/eclipse/ui/internal/ViewsPlugin.java;1;0;1;1;0;0;0;1;0;0;1;2738;0;0;1;0;0;1;1;2738;0;2738;1;1;
/org.eclipse.ui.tests/Eclipse UI Tests/org/eclipse/ui/tests/activities/StaticTest.java;3;1;3;1;2;2;2;1;10;0;1;4853;12;12;1;0;0;1;3;4853;0;6338;3;3;
/org.eclipse.jdt.ui/core refactoring/org/eclipse/jdt/internal/corext/refactoring/reorg/OverwriteHelper.java;3;1;6;1;2;2;2;4;44;1;4;1114;69;69;1;0;0;4;6;1114;0;6340;6;3;
/org.eclipse.text/src/org/eclipse/jface/text/source/IAnnotationMap.java;2;2;4;2;4;3;4;0;20;0;0;5382;22;22;2;0;1;0;4;6298;1;6340;3;2;
/org.eclipse.jdt.core/compiler/org/eclipse/jdt/internal/compiler/ast/AnnotationArgument.java;2;0;4;1;0;0;0;4;3;1;4;2397;5;5;1;0;0;4;4;2397;0;2580;4;2;
/org.eclipse.jdt.debug/model/org/eclipse/jdt/internal/debug/core/model/JDIValue.java;2;0;3;1;0;0;0;3;6;1;3;1276;11;11;1;0;0;3;3;1276;0;2564;3;2;
/org.eclipse.ui.ide/src/org/eclipse/ui/views/markers/internal/FieldFolder.java;4;2;5;2;3;2;3;2;37;1;2;2208;75;75;2;0;1;2;5;6338;1;6338;4;4;
/org.eclipse.ui.views/src/org/eclipse/ui/views/navigator/INavigatorContentProvider.java;1;0;1;1;0;0;0;1;0;0;1;1014;0;0;1;0;0;1;1;1014;0;1014;1;1;
/org.eclipse.jdt.core.tests.model/workspace/Formatter/test200/A_out.java;1;0;1;1;0;0;0;1;0;0;1;2424;0;0;1;0;0;1;1;2424;0;2424;1;1;
/org.eclipse.core.tools/src/org/eclipse/core/tools/CollapseAllAction.java;1;0;1;1;1;1;1;0;0;0;0;6302;0;0;1;0;0;0;1;6302;0;6302;1;1;
/org.eclipse.ui.examples.javaeditor/Eclipse Java Editor Example/org/eclipse/ui/examples/javaeditor/spelling/ISpellEventListener.java;1;0;1;1;0;0;0;1;0;0;1;2565;0;0;1;0;0;1;1;2565;0;2565;1;1;
/org.eclipse.ui.workbench/Eclipse UI/org/eclipse/ui/internal/commands/ws/WorkbenchWindowCommandSupport.java;1;0;4;1;0;0;0;4;25;1;4;3129;35;35;1;0;0;4;4;3129;0;4144;4;1;
/org.eclipse.core.tests.resources/src/org/eclipse/core/tests/internal/indexing/IntegratedTestEnvironment.java;1;0;1;1;1;1;1;0;8;0;0;5147;8;8;1;0;0;0;1;5147;0;5147;1;1;
/org.eclipse.swt/Eclipse SWT PI/win32/org/eclipse/swt/internal/ole/win32/DISPPARAMS.java;1;0;1;1;0;0;0;1;7;0;1;2915;7;7;1;0;0;1;1;2915;0;2915;1;1;
/org.eclipse.swt.tests/JUnit Tests/org/eclipse/swt/tests/junit/browser/Browser3.java;1;0;7;1;0;0;0;7;21;2;4;2866;58;58;2;3;0;7;7;2866;3;3166;4;1;
/org.eclipse.sdk.tests-feature/plugins/org.eclipse.perfmsr.ui.client/src/org/eclipse/perfmsr/ui/client/Variations.java;1;1;2;1;2;2;2;0;10;0;0;5443;10;10;1;0;0;0;2;5443;0;5513;2;1;
/org.eclipse.jdt.ui/ui/org/eclipse/jdt/ui/actions/FindReferencesAction.java;3;1;5;1;2;2;2;3;8;1;3;592;20;20;1;0;0;3;5;592;0;6340;5;3;
/org.eclipse.update.ui/src/org/eclipse/update/internal/ui/parts/VolumeLabelProvider.java;2;0;3;1;0;0;0;3;17;1;3;890;23;23;1;0;0;3;3;890;0;2085;3;2;
/org.eclipse.jdt.core/model/org/eclipse/jdt/core/util/IAnnotationComponent.java;2;0;2;1;0;0;0;2;42;1;2;4447;42;42;1;0;0;2;2;4447;0;4843;2;2;
/org.eclipse.ui.workbench/Eclipse UI/org/eclipse/ui/internal/commands/KeySequenceBindingMachine.java;4;1;15;1;2;2;2;13;169;1;13;2564;606;606;1;0;0;13;15;2564;0;6338;15;4;
/org.eclipse.ui.workbench/Eclipse UI/org/eclipse/ui/internal/decorators/FullImageDecoratorRunnable.java;1;0;1;1;0;0;0;1;0;0;1;4237;0;0;1;0;0;1;1;4237;0;4237;1;1;
/org.eclipse.ui.workbench/Eclipse UI/org/eclipse/ui/contexts/ICompoundContextActivationService.java;2;0;3;1;0;0;0;3;3;1;3;3109;3;3;1;0;0;3;3;3109;0;4144;3;2;
/org.eclipse.pde.ui/src_Forms/org/eclipse/pde/internal/ui/neweditor/InputContext.java;1;0;5;1;0;0;0;5;16;1;5;3755;24;24;1;0;0;5;5;3755;0;4243;5;1;
/org.eclipse.ui.ide/extensions/org/eclipse/ui/dialogs/WizardResourceImportPage.java;3;1;3;1;2;2;2;1;3;0;1;2263;5;5;1;0;0;1;3;2263;0;6338;3;3;
/org.eclipse.jdt.ui/ui refactoring/org/eclipse/jdt/internal/ui/refactoring/actions/ListDialog.java;1;0;1;1;1;1;1;0;2;0;0;6340;2;2;1;0;0;0;1;6340;0;6340;1;1;
/org.eclipse.ui.ide/src/org/eclipse/ui/wizards/datatransfer/FileSystemImportWizard.java;2;0;3;1;0;0;0;3;15;1;3;1511;17;17;1;0;0;3;3;1511;0;2280;3;2;
/org.eclipse.update.ui.forms/src/org/eclipse/update/ui/forms/internal/AbstractSectionForm.java;1;0;2;1;0;0;0;2;18;1;2;837;28;28;1;0;0;2;2;837;0;1617;2;1;
/org.eclipse.jdt.core.tests.model/workspace/Converter/src/junit/swingui/CounterPanel.java;1;0;1;1;0;0;0;1;0;0;1;3714;0;0;1;0;0;1;1;3714;0;3714;1;1;
/org.eclipse.help.base/src/org/eclipse/help/internal/search/WordTokenStream.java;1;1;4;1;2;2;2;2;16;1;2;1740;24;24;1;0;0;2;4;1740;0;6337;4;1;
/org.eclipse.jdt.core.tests.model/workspace/Converter/src/test0220/Test.java;1;0;1;1;0;0;0;1;0;0;1;3714;0;0;1;0;0;1;1;3714;0;3714;1;1;
/org.eclipse.jface.text/projection/org/eclipse/jface/text/source/projection/ProjectionSupport.java;3;2;16;1;12;11;12;4;131;1;4;4516;377;377;2;0;1;4;16;5127;1;6362;15;3;
/org.eclipse.jdt.ui.tests.refactoring/resources/ChangeTypeRefactoring/negative/A_testPrimitive_in.java;1;0;1;1;0;0;0;1;0;0;1;2844;0;0;1;0;0;1;1;2844;0;2844;1;1;
/org.eclipse.ui.workbench/Eclipse UI/org/eclipse/ui/actions/CreateFileAction.java;1;0;1;1;0;0;0;1;0;0;1;2737;0;0;1;0;0;1;1;2737;0;2737;1;1;
/org.eclipse.jface/src/org/eclipse/jface/action/SubMenuManager.java;4;0;4;1;1;1;1;3;167;1;3;3220;225;225;1;0;0;3;4;3220;0;6338;4;4;
/org.eclipse.debug.ui/ui/org/eclipse/debug/internal/ui/sourcelookup/EditContainerAction.java;2;0;2;1;0;0;0;2;10;1;2;4970;10;10;1;0;0;2;2;4970;0;4998;2;2;
/org.eclipse.core.resources/src/org/eclipse/core/internal/dtree/DataTreeWriter.java;1;0;1;1;1;1;1;0;273;0;0;5146;273;273;1;0;0;0;1;5146;0;5146;1;1;
/org.eclipse.core.resources/src/org/eclipse/core/internal/dtree/TestHelper.java;1;0;1;1;1;1;1;0;16;0;0;5146;16;16;1;0;0;0;1;5146;0;5146;1;1;
/org.eclipse.team.ui/src/org/eclipse/team/internal/ui/widgets/ToggleControl.java;1;0;1;1;0;0;0;1;0;0;1;3171;0;0;1;0;0;1;1;3171;0;3171;1;1;
/org.eclipse.ui.externaltools/External Tools Base/org/eclipse/ui/externaltools/internal/launchConfigurations/IgnoreWhiteSpaceComparator.java;1;0;1;1;0;0;0;1;0;0;1;2226;0;0;1;0;0;1;1;2226;0;2226;1;1;
/org.eclipse.jdt.core.tests.model/workspace/Converter/src/test0343/Test.java;1;0;1;1;0;0;0;1;0;0;1;3714;0;0;1;0;0;1;1;3714;0;3714;1;1;
/org.eclipse.team.tests.cvs.core/src/org/eclipse/team/tests/ccvs/ui/logformatter/TaskEntry.java;1;0;1;1;0;0;0;1;0;0;1;2632;0;0;1;0;0;1;1;2632;0;2632;1;1;
/org.eclipse.update.configurator/src/org/eclipse/update/internal/configurator/Parser.java;1;0;2;1;0;0;0;2;0;1;2;3243;0;0;1;0;0;2;2;3243;0;3265;2;1;
/org.eclipse.jdt.debug.tests/tests/org/eclipse/jdt/debug/tests/eval/generator/TestGenerator.java;2;0;4;2;0;0;0;4;150;3;2;1274;155;155;3;2;0;4;4;1274;2;1813;2;2;
/org.eclipse.ui.views/src/org/eclipse/ui/views/internal/markers/FieldMessage.java;1;0;2;1;0;0;0;2;0;0;1;749;0;0;2;1;0;2;2;749;1;749;1;1;
/org.eclipse.jdt.core.tests.model/workspace/Converter/src/test0460/A.java;1;0;1;1;0;0;0;1;0;0;1;3714;0;0;1;0;0;1;1;3714;0;3714;1;1;
/org.eclipse.jdt.core/compiler/org/eclipse/jdt/internal/compiler/problem/DefaultProblemFactory.java;3;0;8;1;1;1;1;7;76;1;7;13;110;110;1;0;0;7;8;13;0;5306;8;3;
/org.eclipse.text/src/org/eclipse/jface/text/templates/DocumentTemplateContext.java;3;1;8;1;3;3;3;5;41;2;4;4259;56;56;2;1;0;5;8;4382;1;6340;7;3;
/org.eclipse.pde.ui/src_Forms/org/eclipse/pde/internal/ui/neweditor/context/BuildInputContext.java;1;0;2;1;0;0;0;2;0;1;2;4354;0;0;1;0;0;2;2;4354;0;4406;2;1;
/org.eclipse.ui.ide/src/org/eclipse/ui/internal/ide/update/InstallWizardAction.java;1;1;2;1;2;2;2;0;12;0;0;5789;12;12;1;0;0;0;2;5789;0;5799;2;1;
/org.eclipse.swt/Eclipse SWT/emulated/treetable/org/eclipse/swt/widgets/SelectableItem.java;4;0;4;1;1;1;1;3;17;1;3;270;29;29;1;0;0;3;4;270;0;6352;4;4;
/org.eclipse.ant.ui/Ant Tools Support/org/eclipse/ant/internal/ui/launchConfigurations/RemoteAntBuildListener.java;3;0;7;1;0;0;0;7;58;1;7;1811;102;102;1;0;0;7;7;1811;0;3260;7;3;
/org.eclipse.jdt.ui.tests.refactoring/resources/ExtractMethodWorkSpace/ExtractMethodTests/locals_in/A_test522.java;1;0;1;1;0;0;0;1;4;0;1;844;4;4;1;0;0;1;1;844;0;844;1;1;
/org.eclipse.team.cvs.ssh2/src/org/eclipse/team/internal/ccvs/ssh2/PServerSSH2Method.java;1;0;1;1;0;0;0;1;0;0;1;4825;0;0;1;0;0;1;1;4825;0;4825;1;1;
/org.eclipse.ui.workbench/Eclipse UI/org/eclipse/ui/internal/progress/IAnimationProcessor.java;2;0;2;1;1;1;1;1;6;0;1;4427;6;6;1;0;0;1;2;4427;0;6145;2;2;
/org.eclipse.jdt.core.tests.model/workspace/Formatter/test409/A_in.java;1;0;1;1;0;0;0;1;0;0;1;3441;0;0;1;0;0;1;1;3441;0;3441;1;1;
/org.eclipse.swt/Eclipse SWT/photon/org/eclipse/swt/graphics/Cursor.java;2;1;3;1;2;2;2;1;93;0;1;246;126;126;1;0;0;1;3;246;0;6352;3;2;
/org.eclipse.swt/Eclipse SWT PI/carbon/org/eclipse/swt/internal/carbon/Cursor.java;1;2;3;1;3;2;3;0;16;0;0;5534;20;20;2;0;1;0;3;5534;1;5614;2;1;
/org.eclipse.pde.ui/src_Forms/org/eclipse/pde/internal/ui/neweditor/feature/FeatureInputContext.java;2;0;2;1;1;1;1;1;0;0;1;4926;0;0;1;0;0;1;2;4926;0;5431;2;2;
/org.eclipse.compare/compare/org/eclipse/compare/structuremergeviewer/Differencer.java;1;0;2;1;0;0;0;2;4;1;2;1289;6;6;1;0;0;2;2;1289;0;3938;2;1;
/org.eclipse.update.ui.forms/Eclipse Forms/org/eclipse/ui/forms/widgets/ScrolledRichText.java;1;0;2;1;0;0;0;2;0;1;2;3733;0;0;1;0;0;2;2;3733;0;4157;2;1;
/org.eclipse.jdt.core.tests.model/workspace/Converter/src/test0356/X.java;1;0;1;1;0;0;0;1;0;0;1;3714;0;0;1;0;0;1;1;3714;0;3714;1;1;
/org.eclipse.ui.workbench/Eclipse UI/org/eclipse/ui/internal/contexts/ContextManager.java;1;0;26;1;0;0;0;26;125;4;17;1220;884;884;4;9;0;26;26;1396;9;2425;17;1;
/org.eclipse.ui.workbench/Eclipse UI/org/eclipse/ui/internal/activities/Identifier.java;2;0;3;1;0;0;0;3;41;2;2;2989;42;42;2;1;0;3;3;2989;1;3170;2;2;
/org.eclipse.pde.ui/src/org/eclipse/pde/internal/ui/wizards/extension/NewExtensionWizard.java;3;1;6;1;4;4;4;2;42;1;2;4608;91;91;1;0;0;2;6;4608;0;6336;6;3;
/org.eclipse.team.tests.cvs.core/src/org/eclipse/team/tests/ccvs/core/provider/ConcurrencyTests.java;2;1;7;1;2;2;2;5;17;2;4;1891;39;39;2;1;0;5;7;1891;1;6337;6;2;
/org.eclipse.jdt.core.tests.model/workspace/Formatter/test289/A_out.java;1;0;1;1;0;0;0;1;0;0;1;2444;0;0;1;0;0;1;1;2444;0;2444;1;1;
/org.eclipse.ui.forms/src/org/eclipse/ui/internal/forms/widgets/WrappedPageBook.java;1;0;1;1;0;0;0;1;0;0;1;5044;0;0;1;0;0;1;1;5044;0;5044;1;1;
/org.eclipse.jdt.ui/ui/org/eclipse/jdt/ui/text/spelling/engine/SpellEvent.java;1;0;2;1;0;0;0;2;0;1;2;3829;0;0;1;0;0;2;2;3829;0;3930;2;1;
/org.eclipse.debug.core/core/org/eclipse/debug/internal/core/sourcelookup/AbstractSourceLookupParticipant.java;1;0;3;1;0;0;0;3;44;1;3;4109;44;44;1;0;0;3;3;4109;0;4949;3;1;
/org.eclipse.ui.editors/src/org/eclipse/ui/editors/text/IFoldingCommandIds.java;2;2;4;1;4;3;4;0;8;0;0;5360;16;16;2;0;1;0;4;6334;1;6334;3;2;
/org.eclipse.ant.ui/Ant Editor/org/eclipse/ant/internal/ui/editor/outline/AntModelOld.java;1;0;2;1;0;0;0;2;0;0;1;3660;0;0;2;1;0;2;2;3660;1;3660;1;1;
/org.eclipse.core.runtime.osgi/src/org/eclipse/core/runtime/CoreException.java;1;0;2;1;0;0;0;2;104;1;2;3013;104;104;1;0;0;2;2;3013;0;3030;2;1;
/org.eclipse.ui.intro/src/org/eclipse/ui/intro/internal/util/DialogUtil.java;1;1;3;1;2;2;2;1;273;0;1;4429;273;273;1;0;0;1;3;4429;0;5115;3;1;
/org.eclipse.jdt.core.tests.compiler/src/org/eclipse/jdt/core/tests/runtime/SideCarVMLauncher.java;2;0;3;1;0;0;0;3;7;1;3;1387;9;9;1;0;0;3;3;1387;0;3560;3;2;
/org.eclipse.debug.core/core/org/eclipse/debug/internal/core/sourcelookup/SourceLookupUtils.java;1;0;6;1;0;0;0;6;158;2;4;3678;307;307;2;2;0;6;6;4109;2;4949;4;1;
/org.eclipse.jdt.core.tests.model/workspace/Converter/src/test0271/Test.java;1;0;1;1;0;0;0;1;0;0;1;3714;0;0;1;0;0;1;1;3714;0;3714;1;1;
/org.eclipse.jdt.ui.tests.refactoring/test cases/org/eclipse/jdt/ui/tests/refactoring/TestDeleteParticipantShared.java;2;0;2;1;1;1;1;1;8;0;1;4913;8;8;1;0;0;1;2;4913;0;6340;2;2;
/org.eclipse.debug.ui/ui/org/eclipse/debug/internal/ui/DefaultLabelProvider.java;3;1;15;2;2;2;2;13;46;2;11;474;188;188;2;2;0;13;15;2592;2;5871;13;3;
/org.eclipse.pde.core/src/org/eclipse/pde/internal/core/osgi/bundle/FragmentUtil.java;1;0;4;1;1;1;1;3;33;2;2;4203;33;33;2;1;0;3;4;4726;1;5445;3;1;
/org.eclipse.jdt.debug.ui/ui/org/eclipse/jdt/internal/debug/ui/NoLineNumberAttributesStatusHandler.java;4;0;4;1;1;1;1;3;24;1;3;2497;35;35;1;0;0;3;4;2497;0;6336;4;4;
/org.eclipse.ui.workbench/Eclipse UI/org/eclipse/ui/dialogs/WizardResourceImportPage.java;2;0;2;1;0;0;0;2;2;1;2;1;2;2;1;0;0;2;2;1;0;2737;2;2;
/org.eclipse.jdt.ui/ui/org/eclipse/jdt/internal/ui/JavaUIMessages.java;1;0;1;1;1;1;1;0;2;0;0;6340;2;2;1;0;0;0;1;6340;0;6340;1;1;
/org.eclipse.jdt.ui/ui/org/eclipse/jdt/internal/ui/IResourceLocator.java;1;0;1;1;1;1;1;0;2;0;0;6340;2;2;1;0;0;0;1;6340;0;6340;1;1;
/org.eclipse.jdt.core.tests.model/workspace/Converter/src/test0388/A.java;1;0;1;1;0;0;0;1;0;0;1;3714;0;0;1;0;0;1;1;3714;0;3714;1;1;
/org.eclipse.pde.ui/src_OSGi/org/eclipse/pde/internal/ui/osgi/wizards/project/BundleProjectStructurePage.java;2;0;6;1;0;0;0;6;6;2;5;2498;12;12;2;1;0;6;6;2498;1;3986;5;2;
/org.eclipse.jdt.core.tests.model/workspace/Formatter/test197/A_in.java;1;0;1;1;0;0;0;1;0;0;1;2424;0;0;1;0;0;1;1;2424;0;2424;1;1;
/org.eclipse.ui.workbench/Eclipse UI/org/eclipse/ui/internal/ProblemImageProvider.java;1;0;1;1;0;0;0;1;0;0;1;2737;0;0;1;0;0;1;1;2737;0;2737;1;1;
/org.eclipse.help/src/org/eclipse/help/ILiveHelpAction.java;1;1;3;1;2;2;2;1;17;0;1;2732;25;25;1;0;0;1;3;2732;0;6337;3;1;
/org.eclipse.jdt.ui/core refactoring/org/eclipse/ltk/core/refactoring/TextFileChange.java;1;0;2;1;0;0;0;2;0;1;2;4624;0;0;1;0;0;2;2;4624;0;4864;2;1;
/org.eclipse.debug.ui/ui/org/eclipse/debug/internal/ui/views/memory/HexRendering.java;1;0;1;1;1;1;1;0;0;0;0;5254;0;0;1;0;0;0;1;5254;0;5254;1;1;
/org.eclipse.team.core/src/org/eclipse/team/core/subscribers/helpers/SynchronizationCache.java;1;0;1;1;0;0;0;1;0;0;1;3240;0;0;1;0;0;1;1;3240;0;3240;1;1;
/org.eclipse.swt/Eclipse SWT PI/gtk/org/eclipse/swt/internal/accessibility/gtk/GObjectClass.java;4;0;4;1;1;1;1;3;17;1;3;1214;33;33;1;0;0;3;4;1214;0;6352;4;4;
/org.eclipse.ui.workbench/Eclipse UI/org/eclipse/ui/internal/contexts/registry/PluginContextRegistry.java;1;0;3;1;0;0;0;3;2;1;3;1422;2;2;1;0;0;3;3;1422;0;1724;3;1;
/org.eclipse.ui.workbench/Eclipse UI/org/eclipse/ui/actions/BackgroundAction.java;1;0;1;1;0;0;0;1;0;0;1;532;0;0;1;0;0;1;1;532;0;532;1;1;
/org.eclipse.jdt.core.tests.model/workspace/Converter/test0008/Test.java;1;0;1;1;0;0;0;1;0;0;1;3714;0;0;1;0;0;1;1;3714;0;3714;1;1;
/org.eclipse.update.core/src/org/eclipse/update/internal/model/BundleManifest.java;2;1;7;1;2;2;2;5;17;2;4;4108;43;43;2;1;0;5;7;4108;1;5799;6;2;
/org.eclipse.jdt.ui/ui/org/eclipse/jdt/internal/ui/typehierarchy/SuperTypeHierarchyViewer.java;2;0;3;1;1;1;1;2;10;1;2;505;14;14;1;0;0;2;3;505;0;6340;3;2;
/org.eclipse.ui.tests/UI Test Utils/org/eclipse/ui/tests/util/DialogCheck.java;2;0;2;1;0;0;0;2;18;1;2;847;32;32;1;0;0;2;2;847;0;1983;2;2;
/org.eclipse.jdt.core.tests.model/workspace/Converter/src/javadoc/testBug54776/Test.java;1;0;1;1;0;0;0;1;0;0;1;4561;0;0;1;0;0;1;1;4561;0;4561;1;1;
/org.eclipse.jdt.core/eval/org/eclipse/jdt/internal/eval/CodeSnippetSkeleton.java;4;0;4;1;1;1;1;3;4;1;3;71;11;11;1;0;0;3;4;71;0;5916;4;4;
/org.eclipse.ui.workbench/Eclipse UI/org/eclipse/ui/internal/commands/CommandDelegateServiceEvent.java;1;0;4;1;0;0;0;4;11;2;3;1321;11;11;2;1;0;4;4;1401;1;1419;3;1;
/org.eclipse.jdt.ui.tests.refactoring/resources/MoveMembers/test37/out/B.java;1;0;1;1;0;0;0;1;0;0;1;2093;0;0;1;0;0;1;1;2093;0;2093;1;1;
/org.eclipse.ant.ui/Ant Editor/org/eclipse/ant/ui/internal/editor/outline/IProblemRequestor.java;1;0;2;1;0;0;0;2;0;1;2;250;0;0;1;0;0;2;2;250;0;1811;2;1;
/org.eclipse.team.core/src/org/eclipse/team/core/subscribers/ISubscriberManager.java;2;0;4;2;0;0;0;4;0;2;3;1852;0;0;2;1;0;4;4;2460;1;2632;3;2;
/org.eclipse.jdt.core.tests.model/workspace/Converter/src/test0442/A.java;1;0;1;1;0;0;0;1;0;0;1;3714;0;0;1;0;0;1;1;3714;0;3714;1;1;
/org.eclipse.jdt.core.tests.model/workspace/Converter/test0326/A.java;1;0;1;1;0;0;0;1;0;0;1;3714;0;0;1;0;0;1;1;3714;0;3714;1;1;
/org.eclipse.debug.ui/ui/org/eclipse/debug/ui/variables/WorkspaceExpander.java;1;0;4;1;0;0;0;4;47;3;2;316;47;47;3;2;0;4;4;316;2;550;2;1;
/org.eclipse.debug.core/core/org/eclipse/debug/internal/core/sourcelookup/containers/ExternalArchiveSourceContainer.java;1;0;2;1;0;0;0;2;0;1;2;4652;0;0;1;0;0;2;2;4652;0;4949;2;1;
/org.eclipse.jdt.debug.ui/ui/org/eclipse/jdt/internal/debug/ui/JavaWatchExpression.java;3;0;5;1;0;0;0;5;131;1;5;367;201;201;1;0;0;5;5;367;0;1847;5;3;
/org.eclipse.pde.ui/src/org/eclipse/pde/internal/ui/wizards/plugin/ContentPage.java;3;3;12;1;10;7;10;2;457;1;2;3986;611;611;3;0;3;2;12;6147;3;6336;9;3;
/org.eclipse.update.tests.core/src/org/eclipse/update/tests/standalone/TestFeatureDisable.java;2;1;9;1;3;3;3;6;14;1;6;2463;38;38;1;0;0;6;9;2463;0;6336;9;2;
/org.eclipse.swt/Eclipse SWT/photon/org/eclipse/swt/widgets/Button.java;3;1;8;1;2;2;2;6;90;1;6;269;112;112;1;0;0;6;8;269;0;6352;8;3;
/org.eclipse.swt/Eclipse SWT/gtk/org/eclipse/swt/graphics/TextStyle.java;2;0;3;2;0;0;0;3;2;2;2;4563;2;2;2;1;0;3;3;4563;1;4873;2;2;
/org.eclipse.swt/Eclipse SWT Browser/common/org/eclipse/swt/browser/VisibilityWindowAdapter.java;2;0;5;1;1;1;1;4;31;2;3;3166;54;54;2;1;0;4;5;3166;1;6352;4;2;
/org.eclipse.jdt.ui/ui/org/eclipse/jdt/internal/ui/callhierarchy/ICallHierarchyViewPart.java;2;0;2;1;1;1;1;1;2;0;1;237;2;2;1;0;0;1;2;237;0;6340;2;2;
/org.eclipse.swt/Eclipse SWT PI/win32/org/eclipse/swt/internal/win32/NMRGINFO.java;2;0;2;1;0;0;0;2;2;1;2;2554;2;2;1;0;0;2;2;2554;0;2915;2;2;
/org.eclipse.pde.ui/src/org/eclipse/pde/internal/ui/editor/manifest/RequiresSection.java;2;0;4;1;1;1;1;3;4;1;3;368;9;9;1;0;0;3;4;368;0;5431;4;2;
/org.eclipse.jdt.ui/ui/org/eclipse/jdt/internal/ui/javadocexport/JavadocTreeWizardPage.java;1;0;11;1;1;1;1;10;166;2;9;661;503;503;2;1;0;10;11;4407;1;6141;10;1;
/org.eclipse.swt/Eclipse SWT Drag and Drop/photon/org/eclipse/swt/dnd/TransferData.java;1;1;2;1;2;2;2;0;8;0;0;5606;12;12;1;0;0;0;2;5606;0;6352;2;1;
/org.eclipse.sdk.tests-feature/plugins/org.eclipse.perfmsr.ui.client/src/org/eclipse/perfmsr/ui/client/LogFileParser.java;1;1;5;1;5;5;5;0;54;0;0;5443;119;119;1;0;0;0;5;5443;0;6359;5;1;
/org.eclipse.team.cvs.ui/src/org/eclipse/team/internal/ccvs/ui/actions/OpenRemoteFileAction.java;2;1;2;1;2;2;2;0;14;0;0;5683;16;16;1;0;0;0;2;5683;0;6337;2;2;
/org.eclipse.ant.tests.ui/Ant Editor Tests/org/eclipse/ant/tests/ui/editor/support/TestEditor.java;1;0;2;1;0;0;0;2;0;0;1;1811;0;0;2;1;0;2;2;1811;1;1811;1;1;
/org.eclipse.compare/compare/org/eclipse/compare/CompareUI.java;1;1;4;1;2;2;2;2;26;1;2;1737;61;61;1;0;0;2;4;1737;0;5199;4;1;
/org.eclipse.ant.ui/Ant Tools Support/org/eclipse/ant/ui/internal/preferences/AntPreferencePage.java;1;0;8;1;0;0;0;8;17;3;5;250;41;41;3;3;0;8;8;1403;3;1811;5;1;
/org.eclipse.core.resources/src/org/eclipse/core/resources/IEncodedStorage.java;2;1;6;1;2;2;2;4;11;1;4;3960;36;36;1;0;0;4;6;3960;0;5168;6;2;
/org.eclipse.search/search/org/eclipse/search/internal/ui/util/PixelConverter.java;1;0;2;1;1;1;1;1;2;0;1;1947;2;2;1;0;0;1;2;1947;0;6340;2;1;
/org.eclipse.ant.tests.ui/Ant Editor Tests/org/eclipse/ant/ui/internal/editor/test/TaskDescriptionProviderTest.java;1;0;3;1;0;0;0;3;17;1;3;1274;17;17;1;0;0;3;3;1274;0;1811;3;1;
/org.eclipse.update.core/srcnew/org/eclipse/update/internal/operations/Operation.java;1;0;3;1;0;0;0;3;8;1;3;569;8;8;1;0;0;3;3;569;0;825;3;1;
/org.eclipse.jdt.ui/core extension/org/eclipse/jdt/internal/corext/callhierarchy/CallHierarchyVisitor.java;2;0;2;1;1;1;1;1;2;0;1;289;2;2;1;0;0;1;2;289;0;6340;2;2;
/org.eclipse.pde.ui/src/org/eclipse/pde/internal/ui/search/DependencyExtentAction.java;2;1;4;1;2;2;2;2;15;1;2;2950;32;32;1;0;0;2;4;2950;0;6336;4;2;
/org.eclipse.ui.workbench/Eclipse UI/org/eclipse/ui/internal/chris/roles/Persistence.java;1;0;5;1;0;0;0;5;68;2;4;1952;76;76;2;1;0;5;5;2207;1;2207;4;1;
/org.eclipse.jdt.ui/ui/org/eclipse/jdt/internal/ui/text/java/hover/SourceViewerInformationControl.java;3;1;12;1;3;3;3;9;209;1;9;693;295;295;1;0;0;9;12;693;0;6340;12;3;
/org.eclipse.ui.workbench/Eclipse UI/org/eclipse/ui/internal/activities/ActivityRegistryEvent.java;1;0;4;1;0;0;0;4;7;2;3;2444;8;8;2;1;0;4;4;2800;1;2989;3;1;
/org.eclipse.jdt.debug.ui/ui/org/eclipse/jdt/internal/debug/ui/actions/PrimitiveOptionsAction.java;2;0;2;1;0;0;0;2;4;1;2;232;6;6;1;0;0;2;2;232;0;1240;2;2;
/org.eclipse.jdt.core.tests.model/workspace/Converter/test0325/Test.java;1;0;1;1;0;0;0;1;0;0;1;3714;0;0;1;0;0;1;1;3714;0;3714;1;1;
/org.eclipse.update.ui.forms/src/org/eclipse/update/ui/forms/internal/engine/TextModel.java;2;0;3;1;0;0;0;3;26;1;3;480;37;37;1;0;0;3;3;480;0;2431;3;2;
/org.eclipse.jdt.core.tests.model/workspace/Formatter/test304/A_in.java;1;0;1;1;0;0;0;1;0;0;1;2442;0;0;1;0;0;1;1;2442;0;2442;1;1;
/org.eclipse.jdt.core.tests.model/workspace/Formatter/test447/Format_in.java;1;0;3;1;0;0;0;3;2;1;3;3673;2;2;1;0;0;3;3;3673;0;3742;3;1;
/org.eclipse.jdt.core.tests.model/workspace/Converter/test0119/Test.java;1;0;1;1;0;0;0;1;0;0;1;3714;0;0;1;0;0;1;1;3714;0;3714;1;1;
/org.eclipse.ui.ide/src/org/eclipse/ui/views/tasklist/MarkerType.java;1;0;1;1;0;0;0;1;0;0;1;2208;0;0;1;0;0;1;1;2208;0;2208;1;1;
/org.eclipse.team.ui/src/org/eclipse/team/internal/ui/synchronize/views/SyncTreeViewer.java;1;0;3;1;0;0;0;3;267;1;3;2535;267;267;1;0;0;3;3;2535;0;4216;3;1;
/org.eclipse.webdav/src/kernel/org/eclipse/webdav/internal/kernel/utils/EnumerationFilter.java;1;0;2;1;2;1;2;0;25;0;0;5151;25;25;2;0;1;0;2;5151;1;5151;1;1;
/org.eclipse.jdt.ui.tests.refactoring/resources/MoveInstanceMethod/canMove/test18/out/Rectangle.java;1;0;1;1;0;0;0;1;0;0;1;1570;0;0;1;0;0;1;1;1570;0;1570;1;1;
/org.eclipse.jdt.debug.tests/testprograms/org/eclipse/debug/tests/targets/Source_$_Lookup.java;1;0;1;1;0;0;0;1;0;0;1;811;0;0;1;0;0;1;1;811;0;811;1;1;
/org.eclipse.update.ui.win32/src/org/eclipse/welcome/internal/portal/WelcomePortalEditorInputFactory.java;1;0;1;1;0;0;0;1;0;0;1;907;0;0;1;0;0;1;1;907;0;907;1;1;
/org.eclipse.ui.workbench/Eclipse UI/org/eclipse/ui/internal/progress/CondensedProgressContentProvider.java;1;0;1;1;0;0;0;1;0;0;1;3537;0;0;1;0;0;1;1;3537;0;3537;1;1;
/org.eclipse.jdt.core.tests.model/workspace/Converter/src/test0266/Test.java;1;0;1;1;0;0;0;1;0;0;1;3714;0;0;1;0;0;1;1;3714;0;3714;1;1;
/org.eclipse.jdt.core/compiler/org/eclipse/jdt/internal/compiler/ast/Reference.java;1;0;1;1;0;0;0;1;2;0;1;3560;2;2;1;0;0;1;1;3560;0;3560;1;1;
/org.eclipse.ui.workbench/Eclipse UI/org/eclipse/ui/internal/activities/ws/SwapActivityHelper.java;2;0;5;1;0;0;0;5;99;1;5;3066;155;155;1;0;0;5;5;3066;0;4651;5;2;
/org.eclipse.jdt.ui.tests.refactoring/resources/RenamePackage/testImportFromMultiRoots3/in/srcTest/p/p/Ref.java;1;0;2;1;0;0;0;2;6;1;2;3219;6;6;1;0;0;2;2;3219;0;4105;2;1;
/org.eclipse.swt/Eclipse SWT/gtk/org/eclipse/swt/widgets/Tray.java;1;0;2;1;0;0;0;2;0;0;1;4519;0;0;2;1;0;2;2;4519;1;4519;1;1;
/org.eclipse.jdt.ui.tests.refactoring/test cases/org/eclipse/jdt/ui/tests/actions/PasteSourceReferenceActionTests.java;1;0;1;1;0;0;0;1;0;0;1;1111;0;0;1;0;0;1;1;1111;0;1111;1;1;
/org.eclipse.jdt.ui/core refactoring/org/eclipse/ltk/internal/refactoring/core/BufferValidationState.java;1;0;3;1;0;0;0;3;9;1;3;3930;9;9;1;0;0;3;3;3930;0;4510;3;1;
/org.eclipse.jdt.debug/jdi interfaces/com/sun/jdi/connect/TransportTimeoutException.java;1;0;1;1;0;0;0;1;0;0;1;4267;0;0;1;0;0;1;1;4267;0;4267;1;1;
/org.eclipse.jdt.core.tests.model/workspace/Converter/test0033/Test.java;1;0;1;1;0;0;0;1;0;0;1;3714;0;0;1;0;0;1;1;3714;0;3714;1;1;
/org.eclipse.jdt.core/model/org/eclipse/jdt/internal/core/XMLWriter.java;3;0;3;1;1;1;1;2;4;1;2;2381;6;6;1;0;0;2;3;2381;0;5124;3;3;
/org.eclipse.osgi/core/framework/org/eclipse/osgi/framework/internal/core/PackageSource.java;4;1;5;1;2;2;2;3;10;1;3;3013;28;28;1;0;0;3;5;3013;0;6337;5;4;
/org.eclipse.team.ui/src/org/eclipse/team/internal/ui/synchronize/HierarchicalModelProvider.java;2;1;11;1;6;6;6;5;231;1;5;4414;326;326;1;0;0;5;11;4414;0;6337;11;2;
/org.eclipse.team.ui/src/org/eclipse/team/internal/ui/synchronize/SynchronizeModelElement.java;2;1;8;1;4;4;4;4;23;2;3;4588;77;77;2;1;0;4;8;4628;1;6337;7;2;
/org.eclipse.jdt.core.tests.model/workspace/Formatter/test404/A_out.java;1;0;1;1;0;0;0;1;0;0;1;3438;0;0;1;0;0;1;1;3438;0;3438;1;1;
/org.eclipse.update.tests.core/src/org/eclipse/update/tests/nestedfeatures/TestInstall.java;2;1;7;1;3;3;3;4;158;1;4;2048;201;201;1;0;0;4;7;2048;0;6336;7;2;
/org.eclipse.pde.runtime/src/org/eclipse/pde/internal/runtime/logview/SessionDataSection.java;2;0;6;2;0;0;0;6;62;2;5;985;72;72;2;1;0;6;6;993;1;3754;5;2;
/org.eclipse.jdt.core.tests.model/workspace/Converter/test0367/A.java;1;0;1;1;0;0;0;1;0;0;1;3714;0;0;1;0;0;1;1;3714;0;3714;1;1;
/org.eclipse.core.resources/src/org/eclipse/core/internal/watson/ElementTree.java;2;0;5;1;2;1;2;3;1548;2;2;178;1608;1608;2;1;1;3;5;178;2;5146;3;2;
/org.eclipse.debug.ui/ui/org/eclipse/debug/internal/ui/sourcelookup/browsers/WorkingSetSourceContainerBrowser.java;1;0;5;1;0;0;0;5;9;1;5;3770;22;22;1;0;0;5;5;3770;0;4970;5;1;
/org.eclipse.ui.workbench/Eclipse UI/org/eclipse/ui/internal/commands/CommandServiceForParts.java;1;0;2;1;0;0;0;2;0;1;2;618;0;0;1;0;0;2;2;618;0;689;2;1;
/org.eclipse.debug.core/core/org/eclipse/debug/internal/core/sourcelookup/containers/AbstractSourceContainer.java;1;0;6;1;0;0;0;6;35;2;5;3678;61;61;2;1;0;6;6;3678;1;4949;5;1;
/org.eclipse.ui.workbench/Eclipse UI/org/eclipse/ui/internal/handles/api/IHandleEvent.java;1;0;2;1;0;0;0;2;0;1;2;1507;0;0;1;0;0;2;2;1507;0;1724;2;1;
/org.eclipse.core.runtime/src/org/eclipse/core/internal/runtime/ListenerList.java;1;0;2;1;2;1;2;0;2;0;0;5686;2;2;2;0;1;0;2;5686;1;5686;1;1;
/org.eclipse.team.ui/src/org/eclipse/team/internal/ui/synchronize/sets/ISyncSetChangedListener.java;1;0;3;1;0;0;0;3;22;1;3;2535;22;22;1;0;0;3;3;2535;0;4216;3;1;
/org.eclipse.jdt.ui/core refactoring/org/eclipse/jdt/internal/corext/refactoring/reorg2/DeleteChangeCreator.java;1;0;2;1;0;0;0;2;0;1;2;802;0;0;1;0;0;2;2;802;0;1114;2;1;
/org.eclipse.jdt.ui.tests/test plugin/org/eclipse/jdt/testplugin/util/VerifyDialog.java;2;1;2;1;2;2;2;0;3;0;0;5422;5;5;1;0;0;0;2;5422;0;6340;2;2;
/org.eclipse.ui.workbench/Eclipse UI/org/eclipse/ui/wizards/datatransfer/WizardExternalProjectImportPage.java;1;0;1;1;0;0;0;1;0;0;1;2737;0;0;1;0;0;1;1;2737;0;2737;1;1;
/org.eclipse.ui.workbench/Eclipse UI/org/eclipse/ui/internal/csm/activities/IActivityActivationServiceListener.java;1;0;2;1;0;0;0;2;0;1;2;2225;0;0;1;0;0;2;2;2225;0;2310;2;1;
/org.eclipse.jdt.core.tests.model/workspace/Converter/test0098/Test.java;1;0;1;1;0;0;0;1;0;0;1;3714;0;0;1;0;0;1;1;3714;0;3714;1;1;
/org.eclipse.core.runtime.osgi/src/org/eclipse/core/internal/jobs/LockManager.java;1;0;2;1;0;0;0;2;7;1;2;3013;7;7;1;0;0;2;2;3013;0;3028;2;1;
/org.eclipse.jdt.core.tests.model/workspace/Formatter/test369/A_out.java;2;0;3;1;0;0;0;3;12;1;3;3130;13;13;1;0;0;3;3;3130;0;3362;3;2;
/org.eclipse.jdt.ui.examples.javafamily/src/org/eclipse/jface/text/source/translation/TagHandlerFactory.java;1;0;1;1;1;1;1;0;0;0;0;5122;0;0;1;0;0;0;1;5122;0;5122;1;1;
/org.eclipse.jdt.text.tests/src/org/eclipse/jdt/ui/text/tests/JavaColoringTest.java;1;1;3;1;2;2;2;1;6;0;1;5082;6;6;1;0;0;1;3;5082;0;5129;3;1;
/org.eclipse.jdt.ui.tests.refactoring/resources/Copy/test_import_container_yes_type_in_different_cu/out/A.java;1;0;1;1;0;0;0;1;0;0;1;685;0;0;1;0;0;1;1;685;0;685;1;1;
/org.eclipse.jdt.core/dom/org/eclipse/jdt/core/dom/Expression.java;2;0;2;1;0;0;0;2;2;1;2;3560;4;4;1;0;0;2;2;3560;0;4202;2;2;
/org.eclipse.jdt.debug.tests/tests/org/eclipse/jdt/debug/tests/core/DefaultSourceContainerTests.java;1;0;3;1;0;0;0;3;16;1;3;3679;20;20;1;0;0;3;3;3679;0;4949;3;1;
/org.eclipse.pde.ui/src/org/eclipse/pde/internal/ui/wizards/tools/ConvertedProjectWizard.java;2;1;3;1;2;2;2;1;4;0;1;3840;6;6;1;0;0;1;3;3840;0;6336;3;2;
/org.eclipse.search/new search/org/eclipse/search2/internal/ui/basic/views/RemoveAllMatchesAction.java;2;1;2;1;2;2;2;0;2;0;0;5128;2;2;1;0;0;0;2;5128;0;6340;2;2;
/org.eclipse.jdt.ui.tests.refactoring/resources/IntroduceParameter/simple/out/ConstantExpression2.java;1;0;1;1;0;0;0;1;0;0;1;2281;0;0;1;0;0;1;1;2281;0;2281;1;1;
/org.eclipse.jdt.debug.tests/tests/org/eclipse/jdt/debug/tests/eval/ArrayAllocationTests.java;1;0;1;1;0;0;0;1;18;0;1;1274;18;18;1;0;0;1;1;1274;0;1274;1;1;
/org.eclipse.ui.workbench/Eclipse UI/org/eclipse/ui/internal/about/ConfigurationLogErrorLogSection.java;1;1;2;1;2;2;2;0;2;0;0;5483;2;2;1;0;0;0;2;5483;0;6338;2;1;
/org.eclipse.swt/Eclipse SWT PI/win32/org/eclipse/swt/internal/win32/INPUT.java;2;0;2;1;1;1;1;1;4;0;1;4632;4;4;1;0;0;1;2;4632;0;6352;2;2;
/org.eclipse.ui.ide/src/org/eclipse/ui/internal/ide/dialogs/IDEWorkbenchPreferencePage.java;6;2;17;2;6;5;6;11;568;2;10;2264;1091;1091;2;1;1;11;17;4928;2;6338;15;6;
/org.eclipse.core.tests.runtime/src/org/eclipse/core/tests/internal/runtime/LogSerializationTest.java;3;0;3;1;1;1;1;2;402;1;2;3814;409;409;1;0;0;2;3;3814;0;5149;3;3;
/org.eclipse.pde.core/src/org/eclipse/pde/internal/core/PlatformConfigurationUtils.java;1;0;3;1;1;1;1;2;9;1;2;4058;13;13;1;0;0;2;3;4058;0;6336;3;1;
/org.eclipse.ui.workbench/Eclipse UI/org/eclipse/ui/internal/skins/IPresentablePart.java;2;0;4;1;0;0;0;4;40;2;3;4328;54;54;2;1;0;4;4;4328;1;4469;3;2;
/org.eclipse.jdt.ui/ui/org/eclipse/jdt/internal/ui/text/java/JavaFormattingStrategy.java;4;0;12;1;1;1;1;11;132;2;10;546;579;579;2;1;0;11;12;546;1;6340;11;4;
/org.eclipse.jdt.core/compiler/org/eclipse/jdt/internal/compiler/ast/ParameterizedConstructorDeclaration.java;1;0;1;1;0;0;0;1;0;0;1;2733;0;0;1;0;0;1;1;2733;0;2733;1;1;
/org.eclipse.jdt.core.tests.model/workspace/Formatter/test068/A_in.java;1;0;1;1;0;0;0;1;0;0;1;2425;0;0;1;0;0;1;1;2425;0;2425;1;1;
/org.eclipse.team.cvs.ui/src/org/eclipse/team/internal/ccvs/ui/subscriber/CVSSubscriberOperation.java;2;1;8;1;3;3;3;5;29;1;5;4450;48;48;1;0;0;5;8;4450;0;6337;8;2;
/org.eclipse.debug.ui/ui/org/eclipse/debug/ui/actions/RunToLineActionDelegate.java;2;1;4;1;3;3;3;1;56;0;1;4496;64;64;1;0;0;1;4;4496;0;5336;4;2;
/org.eclipse.pde.ui/src/org/eclipse/pde/internal/ui/wizards/plugin/PluginClassCodeGenerator.java;2;2;8;1;6;5;6;2;580;1;2;3840;1281;1281;2;0;1;2;8;5975;1;6336;7;2;
/org.eclipse.jface.text/src/org/eclipse/jface/text/ITextViewer.java;2;2;7;2;4;3;4;3;222;1;3;4627;262;262;2;0;1;3;7;6340;1;6340;6;2;
/org.eclipse.jdt.core.tests.model/workspace/Converter15/src/test0030/A.java;1;0;1;1;1;1;1;0;0;0;0;6273;0;0;1;0;0;0;1;6273;0;6273;1;1;
/org.eclipse.team.ui/src/org/eclipse/team/internal/ui/synchronize/SynchronizeModelProvider.java;2;3;39;2;21;16;21;18;448;4;10;4414;1593;1593;4;8;5;18;39;4602;13;6337;26;2;
/org.eclipse.ui.ide/src/org/eclipse/ui/internal/ide/actions/ProjectPropertyDialogAction.java;1;0;1;1;0;0;0;1;0;0;1;2264;0;0;1;0;0;1;1;2264;0;2264;1;1;
/org.eclipse.jdt.core/dom/org/eclipse/jdt/core/dom/ChildPropertyDescriptor.java;2;0;2;1;1;1;1;1;4;0;1;4202;4;4;1;0;0;1;2;4202;0;5871;2;2;
/org.eclipse.jdt.ui/core extension/org/eclipse/jdt/internal/corext/javadoc/JavaDocCommentReader.java;2;0;2;1;1;1;1;1;10;0;1;2547;12;12;1;0;0;1;2;2547;0;6340;2;2;
/org.eclipse.ant.ui/Ant Editor/org/eclipse/ant/ui/internal/dtd/schema/Dfm.java;1;0;3;1;0;0;0;3;10;1;3;250;10;10;1;0;0;3;3;250;0;1811;3;1;
/org.eclipse.ui.workbench/Eclipse UI/org/eclipse/ui/internal/chris/roles/AbstractRoleRegistry.java;1;0;4;1;0;0;0;4;6;2;3;1952;12;12;2;1;0;4;4;2207;1;2207;3;1;
/org.eclipse.pde.ui/src/org/eclipse/pde/internal/ui/wizards/templates/NewPluginTemplateChoiceWizard.java;1;0;3;1;1;1;1;2;6;1;2;2831;16;16;1;0;0;2;3;2831;0;6336;3;1;
/org.eclipse.ui.views/src/org/eclipse/ui/views/bookmarkexplorer/BookmarkLabelProvider.java;1;0;1;1;0;0;0;1;0;0;1;2738;0;0;1;0;0;1;1;2738;0;2738;1;1;
/org.eclipse.text/src/org/eclipse/jface/text/Position.java;2;1;5;1;2;2;2;3;41;1;3;1353;55;55;1;0;0;3;5;1353;0;6298;5;2;
/org.eclipse.jface.text/src/org/eclipse/jface/text/source/IAnnotationModel.java;2;0;3;1;1;1;1;2;4;1;2;1353;8;8;1;0;0;2;3;1353;0;5382;3;2;
/org.eclipse.jdt.ui.tests.refactoring/resources/Delete/testDeleteWithinCu1/in/A.java;1;0;1;1;0;0;0;1;0;0;1;442;0;0;1;0;0;1;1;442;0;442;1;1;
/org.eclipse.pde.ui/templates_3.0/editor/java/XMLPartitionScanner.java;1;0;1;1;0;0;0;1;0;0;1;2786;0;0;1;0;0;1;1;2786;0;2786;1;1;
/org.eclipse.jdt.ui.tests.refactoring/resources/InlineMethodWorkspace/TestCases/cast_out/TestNotCastableOverloaded.java;1;0;1;1;0;0;0;1;0;0;1;955;0;0;1;0;0;1;1;955;0;955;1;1;
/org.eclipse.jdt.debug/jdi/org/eclipse/jdi/internal/connect/SocketLaunchingConnectorImpl.java;2;0;3;1;0;0;0;3;9;1;3;1141;18;18;1;0;0;3;3;1141;0;1470;3;2;
/org.eclipse.ui.editors/src/org/eclipse/ui/internal/editors/quickdiff/restore/RevertSelectionAction.java;1;0;2;1;0;0;0;2;0;1;2;1118;0;0;1;0;0;2;2;1118;0;1214;2;1;
/org.eclipse.ui.workbench.texteditor/src/org/eclipse/ui/internal/texteditor/GotoLastEditPositionAction.java;2;0;2;1;1;1;1;1;102;0;1;2741;104;104;1;0;0;1;2;2741;0;6340;2;2;
/org.eclipse.core.tests.resources/src/org/eclipse/core/tests/internal/watson/DeltaFlatteningTest.java;1;0;2;1;2;1;2;0;154;0;0;5147;154;154;2;0;1;0;2;5147;1;5147;1;1;
/org.eclipse.jdt.ui.tests/ui/org/eclipse/jdt/ui/tests/text/InclusivePositionUpdaterTest.java;1;0;2;1;0;0;0;2;0;1;2;3030;0;0;1;0;0;2;2;3030;0;4210;2;1;
/org.eclipse.team.webdav/src/org/eclipse/team/internal/core/target/RegistryReader.java;2;1;2;1;2;2;2;0;4;0;0;5597;4;4;1;0;0;0;2;5597;0;6337;2;2;
/org.eclipse.team.cvs.core/src/org/eclipse/team/internal/ccvs/core/client/PruneFolderVisitor.java;1;0;1;1;0;0;0;1;20;0;1;790;20;20;1;0;0;1;1;790;0;790;1;1;
/org.eclipse.jface/src/org/eclipse/jface/preference/FontFieldEditor.java;3;2;4;2;3;2;3;1;22;0;1;4265;28;28;2;0;1;1;4;6338;1;6338;3;3;
/org.eclipse.core.runtime/src/org/eclipse/core/internal/plugins/PluginParser.java;1;0;3;1;0;0;0;3;195;1;3;2444;240;240;1;0;0;3;3;2444;0;3013;3;1;
/org.eclipse.pde.core/src/org/eclipse/pde/internal/core/RegistryLoader.java;1;0;4;1;0;0;0;4;53;1;4;1469;91;91;1;0;0;4;4;1469;0;4726;4;1;
/org.eclipse.ui.workbench/Eclipse UI/org/eclipse/ui/internal/commands/ICommandRegistry.java;3;1;7;1;2;2;2;5;72;1;5;1422;82;82;1;0;0;5;7;1422;0;6338;7;3;
/org.eclipse.swt.examples/src/org/eclipse/swt/examples/controlexample/LabelTab.java;1;0;1;1;0;0;0;1;2;0;1;1560;2;2;1;0;0;1;1;1560;0;1560;1;1;
/org.eclipse.jdt.core.tests.model/workspace/Converter/test0438_a/W.java;1;0;1;1;0;0;0;1;0;0;1;3714;0;0;1;0;0;1;1;3714;0;3714;1;1;
/org.eclipse.update.ui/src/org/eclipse/update/internal/ui/NewUpdatesAction.java;2;0;2;2;0;0;0;2;2;0;1;749;2;2;2;1;0;2;2;749;1;749;1;2;
/org.eclipse.core.runtime/src/org/eclipse/core/runtime/jobs/Job.java;3;2;45;2;5;4;5;40;896;2;33;320;2796;2796;2;7;1;40;45;1115;8;6018;37;3;
/org.eclipse.team.cvs.ui/src/org/eclipse/team/internal/ccvs/ui/actions/CommitAction.java;2;0;6;1;1;1;1;5;143;1;5;790;162;162;1;0;0;5;6;790;0;6337;6;2;
/org.eclipse.ui.forms/src/org/eclipse/ui/forms/internal/widgets/BulletParagraph.java;1;0;6;1;0;0;0;6;23;2;5;4068;42;42;2;1;0;6;6;4140;1;5044;5;1;
/org.eclipse.jface/src/org/eclipse/jface/preference/IPreferenceStore.java;2;1;2;1;2;2;2;0;2;0;0;5463;4;4;1;0;0;0;2;5463;0;6338;2;2;
/org.eclipse.jdt.core.tests.compiler/src/org/eclipse/jdt/core/tests/compiler/parser/ClassLiteralAccessCompletionTest.java;1;0;1;1;0;0;0;1;2;0;1;3560;2;2;1;0;0;1;1;3560;0;3560;1;1;
/org.eclipse.jdt.ui/ui/org/eclipse/jdt/internal/ui/javaeditor/JavaDocumentFactory.java;2;0;2;1;1;1;1;1;20;0;1;4425;20;20;1;0;0;1;2;4425;0;6340;2;2;
/org.eclipse.team.core/src/org/eclipse/team/internal/registry/RegistryReader.java;1;0;1;1;0;0;0;1;0;0;1;2777;0;0;1;0;0;1;1;2777;0;2777;1;1;
/org.eclipse.team.webdav/src/org/eclipse/team/internal/webdav/ui/subscriber/WebDavSynchronizeWizard.java;2;1;4;1;4;4;4;0;45;0;0;5534;55;55;1;0;0;0;4;5534;0;5940;4;2;
/org.eclipse.ui.workbench/Eclipse UI/org/eclipse/ui/internal/contexts/IRegistry.java;1;0;3;1;0;0;0;3;2;1;3;1356;2;2;1;0;0;3;3;1356;0;1396;3;1;
/org.eclipse.core.tests.runtime/src/org/eclipse/core/tests/internal/plugins/GetPluginPathTest.java;1;0;1;1;0;0;0;1;0;0;1;3014;0;0;1;0;0;1;1;3014;0;3014;1;1;
/org.eclipse.debug.ui/ui/org/eclipse/debug/internal/ui/views/launch/LaunchViewDecoratingLabelProvider.java;1;0;2;1;0;0;0;2;0;1;2;2387;0;0;1;0;0;2;2;2387;0;3495;2;1;
/org.eclipse.help.ui/src/org/eclipse/help/ui/internal/WorkbenchHelpPlugin.java;1;0;4;1;0;0;0;4;37;1;4;2330;46;46;1;0;0;4;4;2330;0;2732;4;1;
/org.eclipse.update.ui/src/org/eclipse/update/internal/ui/views/ConfigurationPreviewForm.java;3;0;7;2;0;0;0;7;37;2;6;825;60;60;2;1;0;7;7;998;1;4156;6;3;
/org.eclipse.jdt.ui/core refactoring/org/eclipse/jdt/internal/corext/refactoring/util/AbstractExceptionAnalyzer.java;1;0;1;1;1;1;1;0;2;0;0;6340;2;2;1;0;0;0;1;6340;0;6340;1;1;
/org.eclipse.team.tests.cvs.core/src/org/eclipse/team/tests/ccvs/ui/logformatter/Result.java;1;0;1;1;0;0;0;1;0;0;1;2632;0;0;1;0;0;1;1;2632;0;2632;1;1;
/org.eclipse.team.ui/src/org/eclipse/team/internal/ui/synchronize/actions/RemoveFromViewAction.java;1;0;2;1;2;1;2;0;107;0;0;5590;107;107;2;0;1;0;2;5590;1;5590;1;1;
/org.eclipse.pde.build/src/org/eclipse/pde/internal/build/AssemblyInformation.java;2;1;12;1;3;3;3;9;43;1;9;447;154;154;1;0;0;9;12;447;0;6272;12;2;
/org.eclipse.jdt.ui/ui/org/eclipse/jdt/internal/ui/javadocexport/JavadocWizard.java;4;2;20;2;9;8;9;11;134;1;11;917;746;746;2;0;1;11;20;5911;1;6340;19;4;
/org.eclipse.update.core/src/org/eclipse/update/standalone/StandaloneUpdateApplication.java;1;1;6;1;2;2;2;4;47;2;3;825;90;90;2;1;0;4;6;825;1;5670;5;1;
/org.eclipse.update.ui/src/org/eclipse/update/internal/ui/model/UpdateModel.java;2;1;8;1;2;2;2;6;97;1;6;705;130;130;1;0;0;6;8;705;0;6336;8;2;
/org.eclipse.jdt.core.tests.model/workspace/Converter/src/javadoc/test017/TestB2.java;1;0;2;1;0;0;0;2;0;1;2;4311;0;0;1;0;0;2;2;4311;0;4390;2;1;
/org.eclipse.osgi/supplement/src/org/eclipse/osgi/service/urlconversion/URLConverter.java;2;0;3;1;1;1;1;2;10;1;2;3620;12;12;1;0;0;2;3;3620;0;5117;3;2;
/org.eclipse.update/src/org/eclipse/update/internal/ui/UMWizardPageInstallable.java;1;0;1;1;1;1;1;0;0;0;0;6339;0;0;1;0;0;0;1;6339;0;6339;1;1;
/org.eclipse.ui.ide/src/org/eclipse/ui/dialogs/ContainerGenerator.java;2;0;3;1;0;0;0;3;10;1;3;1511;10;10;1;0;0;3;3;1511;0;2263;3;2;
/org.eclipse.ui.ide/src/org/eclipse/ui/actions/ReadOnlyStateChecker.java;2;0;3;1;0;0;0;3;4;1;3;1511;4;4;1;0;0;3;3;1511;0;2263;3;2;
/org.eclipse.jface.text/src/org/eclipse/jface/text/templates/persistence/TemplatePersistenceMessages.java;1;1;2;1;2;2;2;0;2;0;0;5262;2;2;1;0;0;0;2;5262;0;6340;2;1;
/org.eclipse.core.resources/src/org/eclipse/core/internal/indexing/StoredObject.java;1;0;1;1;1;1;1;0;25;0;0;5146;25;25;1;0;0;0;1;5146;0;5146;1;1;
/org.eclipse.jdt.core.tests.model/workspace/Converter/test0387/A.java;1;0;1;1;0;0;0;1;0;0;1;3714;0;0;1;0;0;1;1;3714;0;3714;1;1;
/org.eclipse.swt/Eclipse SWT PI/gtk/org/eclipse/swt/internal/accessibility/gtk/GInterfaceInfo.java;4;0;5;1;1;1;1;4;11;1;4;1214;21;21;1;0;0;4;5;1214;0;6352;5;4;
/org.eclipse.jdt.core/codeassist/org/eclipse/jdt/internal/codeassist/select/SelectionOnLocalName.java;2;0;3;1;0;0;0;3;22;1;3;991;29;29;1;0;0;3;3;991;0;3560;3;2;
/org.eclipse.jdt.core.tests.model/workspace/Converter/src/junit/swingui/TestHierarchyRunView.java;1;0;1;1;0;0;0;1;0;0;1;3714;0;0;1;0;0;1;1;3714;0;3714;1;1;
/org.eclipse.ui.workbench/Eclipse UI/org/eclipse/ui/internal/WorkbenchActionBuilder.java;5;0;11;1;0;0;0;11;196;1;11;553;361;361;1;0;0;11;11;553;0;2737;11;5;
/org.eclipse.ui.workbench/Eclipse UI/org/eclipse/ui/commands/ICommandRegistryEvent.java;1;0;4;1;0;0;0;4;0;2;3;1389;0;0;2;1;0;4;4;1417;1;1417;3;1;
/org.eclipse.ant.ui/Ant Tools Support/org/eclipse/ant/internal/ui/launchConfigurations/IAntLaunchConfigurationConstants.java;3;0;8;2;1;1;1;7;8;2;5;1811;27;27;2;2;0;7;8;2147;2;6336;6;3;
/org.eclipse.jdt.junit/src/org/eclipse/jdt/internal/junit/ui/TestHierarchyTab.java;2;1;3;1;3;3;3;0;6;0;0;5633;8;8;1;0;0;0;3;5633;0;6340;3;2;
/org.eclipse.jdt.ui.tests.refactoring/resources/ExtractMethodWorkSpace/ExtractMethodTests/expression_in/A_test620.java;1;0;1;1;0;0;0;1;2;0;1;844;2;2;1;0;0;1;1;844;0;844;1;1;
/org.eclipse.jdt.debug.ui/ui/org/eclipse/jdt/internal/debug/ui/MessageLine.java;2;0;2;1;1;1;1;1;4;0;1;3516;4;4;1;0;0;1;2;3516;0;6336;2;2;
/org.eclipse.ui.workbench/Eclipse UI/org/eclipse/ui/IWorkbenchPartSite.java;4;1;13;2;2;2;2;11;14;2;10;1;71;71;2;1;0;11;13;2862;1;6338;12;4;
/org.eclipse.ui.workbench/Eclipse UI/org/eclipse/ui/keys/IKeyManager.java;1;0;2;1;0;0;0;2;0;1;2;1294;0;0;1;0;0;2;2;1294;0;1321;2;1;
/org.eclipse.jdt.core.tests.compiler/src/org/eclipse/jdt/core/tests/compiler/parser/SourceInitializer.java;1;0;1;1;0;0;0;1;2;0;1;3560;2;2;1;0;0;1;1;3560;0;3560;1;1;
/org.eclipse.ui.workbench/Eclipse UI/org/eclipse/ui/internal/commands/older/CommandManagerEvent.java;1;0;2;1;0;0;0;2;4;0;1;2562;4;4;2;1;0;2;2;2562;1;2562;1;1;
/org.eclipse.ua.tests/src/org/eclipse/ui/tests/cheatsheets/views/CheatSheetViewerTestView.java;1;0;1;1;1;1;1;0;0;0;0;6081;0;0;1;0;0;0;1;6081;0;6081;1;1;
/org.eclipse.jdt.core.tests.model/workspace/Converter/src/test0215/Test.java;1;0;1;1;0;0;0;1;0;0;1;3714;0;0;1;0;0;1;1;3714;0;3714;1;1;
/org.eclipse.ui.workbench/Eclipse UI/org/eclipse/ui/IThemePreview.java;1;0;2;1;0;0;0;2;0;1;2;4603;0;0;1;0;0;2;2;4603;0;5025;2;1;
/org.eclipse.jdt.ui/core refactoring/org/eclipse/jdt/internal/corext/refactoring/changes/WorkspaceTracker.java;2;1;2;1;2;2;2;0;2;0;0;5269;2;2;1;0;0;0;2;5269;0;6340;2;2;
/org.eclipse.jdt.ui/ui/org/eclipse/jdt/internal/ui/viewsupport/AppearanceAwareLabelProvider.java;1;0;1;1;1;1;1;0;2;0;0;6340;2;2;1;0;0;0;1;6340;0;6340;1;1;
/org.eclipse.team.ui/src/org/eclipse/team/internal/ui/synchronize/WorkbenchPartSynchronizePageSite.java;2;1;5;1;4;4;4;1;86;0;1;5036;110;110;1;0;0;1;5;5036;0;5508;5;2;
/org.eclipse.ui.ide/extensions/org/eclipse/ui/IFileEditorInput.java;1;0;1;1;0;0;0;1;0;0;1;2263;0;0;1;0;0;1;1;2263;0;2263;1;1;
/org.eclipse.ui.workbench/Eclipse UI/org/eclipse/ui/internal/misc/StatusUtil.java;3;1;3;1;3;3;3;0;11;0;0;5449;19;19;1;0;0;0;3;5449;0;6338;3;3;
/org.eclipse.ui.workbench/Eclipse UI/org/eclipse/ui/contexts/IContextEvent.java;1;0;6;1;0;0;0;6;4;1;6;1137;6;6;1;0;0;6;6;1137;0;2425;6;1;
/org.eclipse.ui.workbench/Eclipse UI/org/eclipse/ui/wizards/datatransfer/PopulateRootOperation.java;1;0;1;1;0;0;0;1;0;0;1;2737;0;0;1;0;0;1;1;2737;0;2737;1;1;
/org.eclipse.jdt.core.tests.model/workspace/Converter/src/test0363/A.java;1;0;1;1;0;0;0;1;0;0;1;3714;0;0;1;0;0;1;1;3714;0;3714;1;1;
/org.eclipse.ui.forms.examples/src/org/eclipse/ui/forms/examples/internal/rcp/SimpleFormEditor.java;1;0;2;1;1;1;1;1;4;0;1;4075;4;4;1;0;0;1;2;4075;0;5578;2;1;
/org.eclipse.team.ui/src/org/eclipse/team/ui/synchronize/ISynchronizeManager.java;2;1;9;1;3;3;3;6;90;1;6;2535;183;183;1;0;0;6;9;2535;0;6337;9;2;
/org.eclipse.jdt.core.tests.model/workspace/Converter/test0096/Test.java;1;0;1;1;0;0;0;1;0;0;1;3714;0;0;1;0;0;1;1;3714;0;3714;1;1;
/org.eclipse.jdt.core.tests.model/workspace/Resolve/src/ResolveDuplicateMethodDeclaration9.java;1;0;1;1;1;1;1;0;0;0;0;6222;0;0;1;0;0;0;1;6222;0;6222;1;1;
/org.eclipse.team.cvs.ui/src/org/eclipse/team/internal/ccvs/ui/RemoteRevisionQuickDiffProvider.java;2;1;15;1;9;9;9;6;308;1;6;1686;735;735;1;0;0;6;15;1686;0;6337;15;2;
/org.eclipse.ui.workbench/Eclipse UI/org/eclipse/ui/internal/registry/PerspectiveExtensionReader.java;2;1;3;1;2;2;2;1;32;0;1;4609;54;54;1;0;0;1;3;4609;0;6338;3;2;
/org.eclipse.jdt.core.tests.model/workspace/Formatter/test111/A_out.java;1;0;1;1;0;0;0;1;0;0;1;2425;0;0;1;0;0;1;1;2425;0;2425;1;1;
/org.eclipse.ui.workbench/Eclipse UI/org/eclipse/ui/internal/ide/IDEWorkbenchPlugin.java;1;0;1;1;0;0;0;1;0;0;1;1259;0;0;1;0;0;1;1;1259;0;1259;1;1;
/org.eclipse.ui.ide/src/org/eclipse/ui/internal/dialogs/WelcomeEditorInputFactory.java;2;0;5;1;0;0;0;5;17;1;5;1526;26;26;1;0;0;5;5;1526;0;2263;5;2;
/org.eclipse.ui.externaltools/Ant Editor/org/eclipse/ui/externaltools/internal/ant/editor/text/AnnotationAccess.java;1;0;1;1;0;0;0;1;0;0;1;282;0;0;1;0;0;1;1;282;0;282;1;1;
/org.eclipse.jdt.debug.ui/ui/org/eclipse/jdt/internal/debug/ui/launcher/JavaApplicationLaunchShortcut.java;4;1;13;2;4;4;4;9;99;2;8;648;307;307;2;1;0;9;13;3806;1;6336;12;4;
/org.eclipse.jface/src/org/eclipse/jface/preference/ColorFieldEditor.java;2;1;3;1;2;2;2;1;22;0;1;4015;39;39;1;0;0;1;3;4015;0;6340;3;2;
/org.eclipse.sdk.tests-feature/plugins/org.eclipse.perfmsr.ui/src/org/eclipse/perfmsr/ui/actions/Upload.java;2;1;3;1;2;2;2;1;12;0;1;4845;22;22;1;0;0;1;3;4845;0;6342;3;2;
/org.eclipse.core.tests.resources/src/org/eclipse/core/tests/resources/session/TestBug12575.java;1;0;2;1;2;1;2;0;13;0;0;5147;13;13;2;0;1;0;2;5147;1;5147;1;1;
/org.eclipse.ui.examples.javaeditor/Eclipse Java Editor Example/org/eclipse/ui/examples/javaeditor/JavaEditorExamplePlugin.java;2;0;2;1;1;1;1;1;20;0;1;1581;20;20;1;0;0;1;2;1581;0;6340;2;2;
/org.eclipse.jdt.ui.tests.refactoring/resources/InlineMethodWorkspace/TestCases/argument_out/TestLocalReferencePrefix.java;1;0;2;1;0;0;0;2;2;1;2;597;2;2;1;0;0;2;2;597;0;845;2;1;
/org.eclipse.jdt.ui/ui/org/eclipse/jdt/internal/ui/text/spelling/engine/ISpellEventListener.java;2;0;2;1;1;1;1;1;2;0;1;3930;2;2;1;0;0;1;2;3930;0;6340;2;2;
/org.eclipse.debug.ui/ui/org/eclipse/debug/internal/ui/preferences/DebugActionGroupsPreferencePage.java;1;0;1;1;0;0;0;1;0;0;1;5086;0;0;1;0;0;1;1;5086;0;5086;1;1;
/org.eclipse.jdt.debug/model/org/eclipse/jdt/debug/core/IJavaClassType.java;2;0;3;1;0;0;0;3;29;1;3;670;60;60;1;0;0;3;3;670;0;2269;3;2;
/org.eclipse.jdt.ui.tests.refactoring/resources/Delete/testDeleteWithinCu13/in/A.java;1;0;1;1;0;0;0;1;0;0;1;442;0;0;1;0;0;1;1;442;0;442;1;1;
/org.eclipse.pde.core/src/org/eclipse/pde/internal/core/build/BuildEntry.java;3;1;6;1;3;3;3;3;83;1;3;2184;166;166;1;0;0;3;6;2184;0;6336;6;3;
/org.eclipse.core.runtime.osgi/src/org/eclipse/core/runtime/registry/IRegistryChangeListener.java;1;0;2;1;0;0;0;2;2;1;2;3013;2;2;1;0;0;2;2;3013;0;3030;2;1;
/org.eclipse.jdt.ui/ui/org/eclipse/jdt/internal/ui/preferences/formatter/RenameProfileDialog.java;1;0;6;1;0;0;0;6;23;1;6;3110;62;62;1;0;0;6;6;3110;0;4790;6;1;
/org.eclipse.jdt.core.tests.model/workspace/Formatter/test110/A_in.java;1;0;1;1;0;0;0;1;0;0;1;2425;0;0;1;0;0;1;1;2425;0;2425;1;1;
/org.eclipse.ui.workbench/Eclipse UI/org/eclipse/ui/internal/PerspectiveBarManager.java;6;1;15;1;12;12;12;3;332;1;3;3256;1069;1069;1;0;0;3;15;3256;0;6338;15;6;
/org.eclipse.pde.build/src/org/eclipse/pde/internal/build/AbstractScriptGenerator.java;2;2;18;2;7;6;7;11;169;2;10;447;989;989;2;1;1;11;18;5036;2;6316;16;2;
/org.eclipse.jdt.ui/core extension/org/eclipse/jdt/internal/corext/dom/NodeRewriteEvent.java;1;0;5;1;1;1;1;4;38;1;4;2505;47;47;1;0;0;4;5;2505;0;5406;5;1;
/org.eclipse.ui.workbench/Eclipse UI/org/eclipse/ui/internal/dialogs/WizardStep.java;1;0;1;1;0;0;0;1;0;0;1;2737;0;0;1;0;0;1;1;2737;0;2737;1;1;
/org.eclipse.jface.text.tests/src/org/eclipse/jface/text/tests/TextUtilitiesTest.java;1;0;1;1;0;0;0;1;0;0;1;5082;0;0;1;0;0;1;1;5082;0;5082;1;1;
/org.eclipse.core.runtime/src/org/eclipse/core/internal/runtime/PlatformMetaAreaLock.java;4;1;7;1;2;2;2;5;96;1;5;2332;202;202;1;0;0;5;7;2332;0;5898;7;4;
/org.eclipse.ui.workbench/Eclipse UI/org/eclipse/ui/internal/progress/ProgressServiceJob.java;1;0;1;1;0;0;0;1;0;0;1;320;0;0;1;0;0;1;1;320;0;320;1;1;
/org.eclipse.debug.ui/ui/org/eclipse/debug/internal/ui/actions/LaunchablePropertyTester.java;1;0;1;1;1;1;1;0;0;0;0;5496;0;0;1;0;0;0;1;5496;0;5496;1;1;
/org.eclipse.jdt.ui/ui/org/eclipse/jdt/internal/ui/search/ElementQuerySpecification.java;1;0;4;1;2;1;2;2;2;1;2;4625;4;4;2;0;1;2;4;5396;1;5396;3;1;
/org.eclipse.debug.ui/ui/org/eclipse/debug/ui/launchVariables/IVariableComponentContainer.java;2;0;2;1;0;0;0;2;0;1;2;550;0;0;1;0;0;2;2;550;0;2120;2;2;
/org.eclipse.jdt.core.tests.model/workspace/Converter/p2/A.java;1;0;1;1;0;0;0;1;0;0;1;3714;0;0;1;0;0;1;1;3714;0;3714;1;1;
/org.eclipse.jdt.ui/ui/org/eclipse/jdt/internal/ui/typehierarchy/HierarchyViewerSorter.java;2;0;2;1;1;1;1;1;81;0;1;3741;83;83;1;0;0;1;2;3741;0;6340;2;2;
/org.eclipse.jdt.core/eval/org/eclipse/jdt/internal/eval/CodeSnippetFieldReference.java;3;0;7;1;0;0;0;7;154;1;7;41;207;207;1;0;0;7;7;41;0;3560;7;3;
/org.eclipse.jdt.ui/ui refactoring/org/eclipse/jdt/internal/ui/refactoring/ExtractConstantInputPage.java;1;0;1;1;0;0;0;1;0;0;1;518;0;0;1;0;0;1;1;518;0;518;1;1;
/org.eclipse.team.ui/src/org/eclipse/team/ui/synchronize/viewers/DiffTreeViewerConfiguration.java;1;0;1;1;0;0;0;1;0;0;1;3972;0;0;1;0;0;1;1;3972;0;3972;1;1;
/org.eclipse.ui.workbench/Eclipse UI/org/eclipse/ui/internal/csm/activities/workbench/IActivityActivationService.java;1;0;2;1;0;0;0;2;0;1;2;2310;0;0;1;0;0;2;2;2310;0;2371;2;1;
/org.eclipse.debug.ui/ui/org/eclipse/debug/ui/launchVariables/FilePromptExpander.java;1;0;2;1;0;0;0;2;0;1;2;550;0;0;1;0;0;2;2;550;0;562;2;1;
/org.eclipse.jdt.ui/ui refactoring/org/eclipse/jdt/internal/ui/refactoring/MoveInstanceMethodWizard.java;3;0;8;1;1;1;1;7;217;1;7;518;363;363;1;0;0;7;8;518;0;6340;8;3;
/org.eclipse.compare/compare/org/eclipse/compare/ResourceNode.java;1;0;5;1;0;0;0;5;17;1;5;1289;35;35;1;0;0;5;5;1289;0;3954;5;1;
/org.eclipse.team.cvs.core/src/org/eclipse/team/internal/ccvs/core/util/SyncFileChangeListener.java;2;1;12;1;3;3;3;9;73;2;8;276;293;293;2;1;0;9;12;2101;1;6337;11;2;
/org.eclipse.jdt.core/codeassist/org/eclipse/jdt/internal/codeassist/complete/CompletionOnLocalName.java;2;0;3;1;0;0;0;3;24;1;3;991;31;31;1;0;0;3;3;991;0;3560;3;2;
/org.eclipse.core.tests.resources/src/org/eclipse/core/tests/internal/resources/AllTests.java;2;1;4;1;2;2;2;2;38;1;2;4351;45;45;1;0;0;2;4;4351;0;5988;4;2;
/org.eclipse.help/src/org/eclipse/help/internal/context/ContextsNode.java;1;1;3;1;3;3;3;0;18;0;0;5590;35;35;1;0;0;0;3;5590;0;6337;3;1;
/org.eclipse.jdt.ui/core refactoring/org/eclipse/jdt/internal/corext/refactoring/rename/MethodOccurenceCollector.java;4;1;6;1;3;3;3;3;49;1;3;1576;69;69;1;0;0;3;6;1576;0;6340;6;4;
/org.eclipse.ui.views/src/org/eclipse/ui/views/internal/markers/MarkerUtil.java;1;0;2;1;0;0;0;2;0;1;2;265;0;0;1;0;0;2;2;265;0;749;2;1;
/org.eclipse.jdt.core.tests.model/workspace/Formatter/test443/A_in.java;1;0;1;1;0;0;0;1;0;0;1;3513;0;0;1;0;0;1;1;3513;0;3513;1;1;
/org.eclipse.jface.text/src/org/eclipse/jface/text/contentassist/IContentAssistProcessorExtension.java;1;0;4;1;1;1;1;3;14;1;3;2263;22;22;1;0;0;3;4;2263;0;5181;4;1;
/org.eclipse.help/src/org/eclipse/help/internal/browser/StreamConsumer.java;1;0;1;1;0;0;0;1;0;0;1;2732;0;0;1;0;0;1;1;2732;0;2732;1;1;
/org.eclipse.team.webdav/src/org/eclipse/team/internal/ui/target/PutSyncAction.java;2;0;2;1;0;0;0;2;0;1;2;2495;0;0;1;0;0;2;2;2495;0;4216;2;2;
/org.eclipse.jdt.debug.tests/tests/org/eclipse/jdt/debug/tests/eval/NestedTypeFieldValue_179.java;1;0;1;1;0;0;0;1;74;0;1;1274;74;74;1;0;0;1;1;1274;0;1274;1;1;
/org.eclipse.core.resources/src/org/eclipse/core/internal/indexing/IndexedStore.java;1;0;1;1;1;1;1;0;73;0;0;5146;73;73;1;0;0;0;1;5146;0;5146;1;1;
/org.eclipse.pde.core/src/org/eclipse/pde/internal/core/plugin/ExternalPluginModelBase.java;3;1;7;1;3;3;3;4;24;1;4;3278;74;74;1;0;0;4;7;3278;0;6336;7;3;
/org.eclipse.jdt.core/compiler/org/eclipse/jdt/internal/compiler/lookup/MemberTypeBinding.java;1;0;1;1;0;0;0;1;2;0;1;3560;2;2;1;0;0;1;1;3560;0;3560;1;1;
/org.eclipse.team.cvs.ui/src/org/eclipse/team/internal/ccvs/ui/CVSProjectSetSerializer.java;2;1;5;1;3;3;3;2;23;1;2;4655;43;43;1;0;0;2;5;4655;0;6337;5;2;
/org.eclipse.jdt.core.tests.model/workspace/Converter/src/test0374/A.java;1;0;1;1;0;0;0;1;0;0;1;3714;0;0;1;0;0;1;1;3714;0;3714;1;1;
/org.eclipse.jdt.ui.tests.refactoring/resources/MoveMembers/test37/in/B.java;1;0;1;1;0;0;0;1;0;0;1;2093;0;0;1;0;0;1;1;2093;0;2093;1;1;
/org.eclipse.jdt.debug.tests/tests/org/eclipse/jdt/debug/tests/eval/NestedTypeFieldValue_714.java;1;0;1;1;0;0;0;1;60;0;1;1274;60;60;1;0;0;1;1;1274;0;1274;1;1;
/org.eclipse.jdt.core.tests.model/workspace/AttachSourceTests/src/A.java;1;0;1;1;0;0;0;1;0;0;1;3453;0;0;1;0;0;1;1;3453;0;3453;1;1;
/org.eclipse.pde.core/src/org/eclipse/pde/internal/core/schema/ChoiceRestriction.java;2;1;3;1;2;2;2;1;12;0;1;4203;18;18;1;0;0;1;3;4203;0;6336;3;2;
/org.eclipse.team.ui/src/org/eclipse/team/ui/sync/actions/SyncInfoChangeTypeFilter.java;1;0;1;1;0;0;0;1;0;0;1;2378;0;0;1;0;0;1;1;2378;0;2378;1;1;
/org.eclipse.jdt.ui.tests.refactoring/resources/RenamePackage/testImportFromMultiRoots7/in/srcPrj.ref/pack/man/StarImporter.java;1;0;1;1;0;0;0;1;0;0;1;4105;0;0;1;0;0;1;1;4105;0;4105;1;1;
/org.eclipse.jdt.core.tests.model/workspace/Converter/src/test0518/A.java;1;0;2;1;0;0;0;2;6;1;2;3714;6;6;1;0;0;2;2;3714;0;3886;2;1;
/org.eclipse.jdt.ui/ui/org/eclipse/jdt/internal/ui/callhierarchy/ToggleCallModeAction.java;2;0;3;1;1;1;1;2;2;1;2;155;4;4;1;0;0;2;3;155;0;6340;3;2;
/org.eclipse.jdt.ui.tests.refactoring/resources/MoveMembers/test1/in/A.java;1;0;1;1;1;1;1;0;11;0;0;5676;11;11;1;0;0;0;1;5676;0;5676;1;1;
/org.eclipse.ui.workbench/Eclipse UI/org/eclipse/ui/commands/internal/Capture.java;1;0;2;1;0;0;0;2;0;1;2;786;0;0;1;0;0;2;2;786;0;956;2;1;
/org.eclipse.jdt.ui/ui refactoring/org/eclipse/jdt/internal/ui/refactoring/TypeContentAssistProcessor.java;1;0;2;1;0;0;0;2;0;1;2;3189;0;0;1;0;0;2;2;3189;0;3648;2;1;
/org.eclipse.pde/src/org/eclipse/pde/internal/builders/PluginErrorReporter.java;1;0;3;1;1;1;1;2;6;1;2;2906;16;16;1;0;0;2;3;2906;0;6336;3;1;
/org.eclipse.jdt.ui/ui/org/eclipse/jdt/internal/ui/text/template/preferences/TemplateVariableProcessor.java;3;1;4;1;2;2;2;2;8;1;2;4258;18;18;1;0;0;2;4;4258;0;6340;4;3;
/org.eclipse.jdt.ui/ui/org/eclipse/jdt/ui/IJavaElementSearchConstants.java;1;0;1;1;1;1;1;0;2;0;0;6340;2;2;1;0;0;0;1;6340;0;6340;1;1;
/org.eclipse.jdt.ui.tests.refactoring/resources/InlineMethodWorkspace/TestCases/nameconflict_out/TestBlocks.java;1;0;1;1;0;0;0;1;2;0;1;845;2;2;1;0;0;1;1;845;0;845;1;1;
/org.eclipse.jdt.junit/src/org/eclipse/jdt/internal/junit/ui/CopyTraceAction.java;2;1;2;1;2;2;2;0;4;0;0;5633;6;6;1;0;0;0;2;5633;0;6340;2;2;
/org.eclipse.core.resources/src/org/eclipse/core/internal/resources/WorkspaceDescriptionReader.java;2;0;3;1;1;1;1;2;271;1;2;1477;277;277;1;0;0;2;3;1477;0;5146;3;2;
/org.eclipse.swt/Eclipse SWT/motif/org/eclipse/swt/widgets/Canvas.java;5;0;8;2;1;1;1;7;27;2;6;350;83;83;2;1;0;7;8;1525;1;6352;7;5;
/org.eclipse.debug.ui/ui/org/eclipse/debug/internal/ui/views/variables/VariablesViewContentProvider.java;3;0;20;1;1;1;1;19;76;2;15;534;486;486;2;4;0;19;20;670;4;5806;16;3;
/org.eclipse.team.ui/src/org/eclipse/team/internal/ui/synchronize/compare/SyncInfoDiffNode.java;1;0;3;1;0;0;0;3;77;1;3;2535;77;77;1;0;0;3;3;2535;0;4216;3;1;
/org.eclipse.team.ui/src/org/eclipse/team/internal/ui/target/PutSyncAction.java;1;0;1;1;0;0;0;1;0;0;1;2495;0;0;1;0;0;1;1;2495;0;2495;1;1;
/org.eclipse.pde.ui/src/org/eclipse/pde/internal/ui/editor/site/FeatureForm.java;1;0;1;1;0;0;0;1;0;0;1;2311;0;0;1;0;0;1;1;2311;0;2311;1;1;
/org.eclipse.jdt.debug/eval/org/eclipse/jdt/internal/debug/eval/ast/instructions/ArrayAccess.java;2;0;3;1;0;0;0;3;16;1;3;1240;21;21;1;0;0;3;3;1240;0;2564;3;2;
/org.eclipse.ui.externaltools/Ant Editor/org/eclipse/ui/externaltools/internal/ant/editor/text/NotifyingReconciler.java;1;0;1;1;0;0;0;1;0;0;1;282;0;0;1;0;0;1;1;282;0;282;1;1;
/org.eclipse.swt/Eclipse SWT Browser/common/org/eclipse/swt/browser/VisibilityWindowEvent.java;1;0;2;1;0;0;0;2;0;0;1;3166;0;0;2;1;0;2;2;3166;1;3166;1;1;
/org.eclipse.jdt.ui/ui/org/eclipse/jdt/internal/ui/search/SortingLabelProvider.java;2;2;7;1;7;6;7;0;33;0;0;5106;51;51;2;0;1;0;7;5123;1;6340;6;2;
/org.eclipse.jdt.core.tests.builder/src/org/eclipse/jdt/core/tests/builder/Problem.java;1;0;1;1;0;0;0;1;2;0;1;3560;2;2;1;0;0;1;1;3560;0;3560;1;1;
/org.eclipse.jdt.debug.ui/ui/org/eclipse/jdt/internal/debug/ui/classpath/IClasspathEntry.java;3;0;3;1;1;1;1;2;7;1;2;2691;11;11;1;0;0;2;3;2691;0;6336;3;3;
/org.eclipse.pde.ui/src_OSGi/org/eclipse/pde/internal/ui/osgi/templates/BundleTemplateSelectionPage.java;2;0;2;1;0;0;0;2;0;1;2;2519;0;0;1;0;0;2;2;2519;0;3986;2;2;
/org.eclipse.jdt.debug.ui/ui/org/eclipse/jdt/internal/debug/ui/sourcelookup/WorkbenchAdapter.java;1;0;2;1;0;0;0;2;8;1;2;4609;8;8;1;0;0;2;2;4609;0;4971;2;1;
/org.eclipse.jdt.ui.tests.refactoring/test cases/org/eclipse/jdt/ui/tests/xml/A.java;1;0;2;1;0;0;0;2;0;1;2;2204;0;0;1;0;0;2;2;2204;0;4108;2;1;
/org.eclipse.jdt.core.tests.model/workspace/Converter/src/test0072/Test.java;1;0;1;1;0;0;0;1;0;0;1;3714;0;0;1;0;0;1;1;3714;0;3714;1;1;
/org.eclipse.jdt.core/dom/org/eclipse/jdt/core/dom/ChildListPropertyDescriptor.java;2;0;2;1;1;1;1;1;2;0;1;4202;2;2;1;0;0;1;2;4202;0;5871;2;2;
/org.eclipse.jdt.core.tests.model/workspace/Formatter/test322/A_in.java;1;0;1;1;0;0;0;1;0;0;1;2462;0;0;1;0;0;1;1;2462;0;2462;1;1;
/org.eclipse.team.tests.cvs.core/src/org/eclipse/team/tests/ccvs/ui/old/RootEntry.java;1;0;2;1;0;0;0;2;0;1;2;2632;0;0;1;0;0;2;2;2632;0;4216;2;1;
/org.eclipse.jdt.ui/core refactoring/org/eclipse/jdt/internal/corext/refactoring/participants/xml/ElementHandler.java;1;0;2;1;0;0;0;2;0;1;2;4091;0;0;1;0;0;2;2;4091;0;4108;2;1;
/org.eclipse.releng.tools/src/org/eclipse/releng/tools/TagMap.java;1;1;2;1;2;2;2;0;4;0;0;5183;4;4;1;0;0;0;2;5183;0;6340;2;1;
/org.eclipse.jdt.debug.ui/ui/org/eclipse/jdt/internal/debug/ui/JavaHotCodeReplaceListener.java;2;0;3;2;0;0;0;3;10;2;2;1857;16;16;2;1;0;3;3;2064;1;2064;2;2;
/org.eclipse.jdt.debug.ui/ui/org/eclipse/jdt/internal/debug/ui/snippeteditor/SnippetDocumentSetupParticipant.java;1;0;1;1;0;0;0;1;0;0;1;5067;0;0;1;0;0;1;1;5067;0;5067;1;1;
/org.eclipse.swt.examples/src/org/eclipse/swt/examples/controlexample/TableTab.java;2;1;10;1;2;2;2;8;117;2;7;1560;249;249;2;1;0;8;10;2863;1;6352;9;2;
/org.eclipse.jdt.ui.examples.javafamily/src/org/eclipse/jdt/internal/ui/examples/jspeditor/JSPSourceViewerConfiguration.java;1;0;2;1;0;0;0;2;0;1;2;1045;0;0;1;0;0;2;2;1045;0;1071;2;1;
/org.eclipse.osgi/resolver/src/org/eclipse/osgi/internal/resolver/ResolverImpl.java;4;2;14;1;7;6;7;7;59;1;7;3013;212;212;2;0;1;7;14;5529;1;5529;13;4;
/org.eclipse.team.ui/src/org/eclipse/team/internal/ui/jobs/JobsLabelProvider.java;1;0;2;1;0;0;0;2;4;1;2;1081;4;4;1;0;0;2;2;1081;0;1369;2;1;
/org.eclipse.jdt.ui/ui/org/eclipse/jdt/internal/ui/compare/JavaMergeViewer.java;3;1;3;1;2;2;2;1;23;0;1;1289;26;26;1;0;0;1;3;1289;0;6340;3;3;
/org.eclipse.search/search/org/eclipse/search/internal/ui/util/ListContentProvider.java;1;0;1;1;1;1;1;0;2;0;0;6340;2;2;1;0;0;0;1;6340;0;6340;1;1;
/org.eclipse.jdt.ui.examples.javafamily/src/org/eclipse/jdt/internal/ui/examples/jspeditor/JspReconcilingStrategy.java;3;0;9;1;1;1;1;8;130;2;7;1071;385;385;2;1;0;8;9;1150;1;5177;8;3;
/org.eclipse.swt/Eclipse SWT Drag and Drop/photon/org/eclipse/swt/dnd/Transfer.java;1;1;2;1;2;2;2;0;4;0;0;5606;6;6;1;0;0;0;2;5606;0;6352;2;1;
/org.eclipse.update.ui/srcnew/org/eclipse/update/internal/ui/wizards/ResizableWizardDialog.java;2;0;2;1;0;0;0;2;0;1;2;755;0;0;1;0;0;2;2;755;0;825;2;2;
/org.eclipse.jdt.core.tests.model/workspace/Converter/test0513/A.java;1;0;2;1;0;0;0;2;0;1;2;3426;0;0;1;0;0;2;2;3426;0;3714;2;1;
/org.eclipse.jdt.core.tests.model/workspace/Converter/test0134/Test.java;1;0;1;1;0;0;0;1;0;0;1;3714;0;0;1;0;0;1;1;3714;0;3714;1;1;
/org.eclipse.jdt.ui/ui/org/eclipse/jdt/internal/ui/search/ISearchUIParticipant.java;1;0;2;1;0;0;0;2;0;1;2;4625;0;0;1;0;0;2;2;4625;0;5075;2;1;
/org.eclipse.team.ui/src/org/eclipse/team/internal/ui/synchronize/HierarchicalModelManager.java;2;1;3;1;2;2;2;1;75;0;1;5065;79;79;1;0;0;1;3;5065;0;5497;3;2;
/org.eclipse.update.ui/srcnew/org/eclipse/update/internal/ui/views/ShowFeatureStatusAction.java;2;0;3;1;0;0;0;3;120;1;3;339;120;120;1;0;0;3;3;339;0;413;3;2;
/org.eclipse.ltk.core.refactoring/src/org/eclipse/ltk/core/refactoring/UndoDocumentChange.java;1;0;3;1;0;0;0;3;2;1;3;4845;2;2;1;0;0;3;3;4845;0;4913;3;1;
/org.eclipse.update.configurator/src/org/eclipse/update/configurator/Policy.java;2;0;2;1;0;0;0;2;0;1;2;3014;0;0;1;0;0;2;2;3014;0;3270;2;2;
/org.eclipse.ui.workbench/Eclipse UI/org/eclipse/ui/internal/misc/WizardStepGroup.java;1;0;1;1;0;0;0;1;0;0;1;2737;0;0;1;0;0;1;1;2737;0;2737;1;1;
/org.eclipse.jdt.core/model/org/eclipse/jdt/internal/core/UserLibrary.java;1;1;2;1;2;2;2;0;11;0;0;5199;11;11;1;0;0;0;2;5199;0;5713;2;1;
/org.eclipse.core.resources/src/org/eclipse/core/internal/indexing/ObjectPage.java;1;0;1;1;1;1;1;0;97;0;0;5146;97;97;1;0;0;0;1;5146;0;5146;1;1;
/org.eclipse.ui.views/src/org/eclipse/ui/views/internal/markers/FieldLineNumber.java;1;0;2;1;0;0;0;2;0;0;1;749;0;0;2;1;0;2;2;749;1;749;1;1;
/org.eclipse.search/search/org/eclipse/search/internal/ui/SearchResultViewer.java;2;0;8;1;1;1;1;7;55;1;7;611;121;121;1;0;0;7;8;611;0;5885;8;2;
/org.eclipse.jdt.ui/ui/org/eclipse/jdt/internal/ui/text/spelling/engine/LocaleSensitiveSpellDictionary.java;2;0;2;1;1;1;1;1;2;0;1;3930;2;2;1;0;0;1;2;3930;0;6340;2;2;
/org.eclipse.tomcat/src/org/eclipse/tomcat/internal/PortTrackingServerSocketFactory.java;1;0;1;1;0;0;0;1;0;0;1;379;0;0;1;0;0;1;1;379;0;379;1;1;
/org.eclipse.ant.ui/Ant Editor/org/eclipse/ant/ui/internal/dtd/schema/SchemaFactory.java;1;0;5;1;0;0;0;5;21;2;4;250;29;29;2;1;0;5;5;1436;1;1811;4;1;
/org.eclipse.ui.workbench/Eclipse UI/org/eclipse/ui/internal/BaseSaveAction.java;1;0;1;1;0;0;0;1;53;0;1;2737;53;53;1;0;0;1;1;2737;0;2737;1;1;
/org.eclipse.update.ui/src/org/eclipse/update/internal/ui/parts/SWTUtil.java;2;1;5;1;2;2;2;3;54;2;2;890;87;87;2;1;0;3;5;890;1;6336;4;2;
/org.eclipse.jdt.core/model/org/eclipse/jdt/internal/core/BinaryMember.java;2;0;8;1;0;0;0;8;30;1;8;761;82;82;1;0;0;8;8;761;0;3560;8;2;
/org.eclipse.swt/Eclipse SWT PI/gtk/org/eclipse/swt/internal/gtk/GdkEventExpose.java;3;0;4;1;1;1;1;3;17;1;3;1653;25;25;1;0;0;3;4;1653;0;6352;4;3;
/org.eclipse.team.core/src/org/eclipse/team/internal/core/subscribers/caches/ResourceVariantTreeSubscriber.java;1;0;3;1;0;0;0;3;34;2;2;4259;34;34;2;1;0;3;3;4259;1;4349;2;1;
/org.eclipse.jdt.ui.tests/test plugin/org/eclipse/jdt/testplugin/util/FailureDialog.java;1;0;1;1;1;1;1;0;2;0;0;6340;2;2;1;0;0;0;1;6340;0;6340;1;1;
/org.eclipse.core.tests.runtime/src/org/eclipse/core/tests/internal/plugins/PluginResolveTest_24.java;1;0;1;1;0;0;0;1;0;0;1;3014;0;0;1;0;0;1;1;3014;0;3014;1;1;
/org.eclipse.ui.editors/src/org/eclipse/ui/editors/text/DefaultEncodingSupport.java;1;1;2;1;2;2;2;0;15;0;0;5918;20;20;1;0;0;0;2;5918;0;6334;2;1;
/org.eclipse.ui.externaltools/Ant Editor/org/eclipse/ui/externaltools/internal/ant/editor/PlantyException.java;1;0;1;1;0;0;0;1;0;0;1;178;0;0;1;0;0;1;1;178;0;178;1;1;
/org.eclipse.jdt.core.tests.model/workspace/Formatter/test120/A_out.java;1;0;1;1;0;0;0;1;0;0;1;2425;0;0;1;0;0;1;1;2425;0;2425;1;1;
/org.eclipse.debug.core/core/org/eclipse/debug/internal/core/sourcelookup/containers/ArchiveSourceContainerType.java;2;0;6;1;1;1;1;5;20;3;3;4091;41;41;3;2;0;5;6;4949;2;5672;4;2;
/org.eclipse.pde.ui/src/org/eclipse/pde/internal/ui/editor/feature/FeatureChildPropertySource.java;2;1;4;1;2;2;2;2;36;1;2;368;56;56;1;0;0;2;4;368;0;6336;4;2;
/org.eclipse.jdt.ui.tests.refactoring/resources/Delete/testDeleteWithinCu5/in/A.java;1;0;1;1;0;0;0;1;0;0;1;442;0;0;1;0;0;1;1;442;0;442;1;1;
/org.eclipse.jdt.core.tests.compiler/src/org/eclipse/jdt/core/tests/runtime/TargetInterface.java;1;0;1;1;0;0;0;1;2;0;1;3560;2;2;1;0;0;1;1;3560;0;3560;1;1;
/org.eclipse.ui.workbench/Eclipse UI/org/eclipse/ui/dialogs/ElementTreeSelectionDialog.java;1;0;2;1;2;1;2;0;48;0;0;5464;48;48;2;0;1;0;2;5464;1;5464;1;1;
/org.eclipse.ui.workbench/Eclipse UI/org/eclipse/ui/handlers/HandlerProxy.java;2;0;4;1;0;0;0;4;73;1;4;4650;77;77;1;0;0;4;4;4650;0;4968;4;2;
/org.eclipse.team.cvs.core/src/org/eclipse/team/internal/ccvs/core/client/Diff.java;1;0;2;1;0;0;0;2;4;1;2;1843;5;5;1;0;0;2;2;1843;0;2529;2;1;
/org.eclipse.jdt.ui.tests.refactoring/resources/RenameNonPrivateField/test17/in/A.java;1;0;1;1;1;1;1;0;0;0;0;6118;0;0;1;0;0;0;1;6118;0;6118;1;1;
/org.eclipse.jdt.core.tests.model/workspace/Formatter/test347/A_out.java;1;0;2;1;0;0;0;2;7;0;1;3029;7;7;2;1;0;2;2;3029;1;3029;1;1;
/org.eclipse.ant.ui/Ant Tools Support/org/eclipse/ant/internal/ui/preferences/AntEditorPreferencePage.java;2;3;18;1;9;6;9;9;636;2;8;1811;2047;2047;3;1;3;9;18;5920;4;5920;14;2;
/org.eclipse.sdk.tests-feature/plugins/org.eclipse.perfmsr.ui.client/src/org/eclipse/perfmsr/ui/client/StepsPreferencePage.java;1;1;3;1;3;3;3;0;10;0;0;5443;12;12;1;0;0;0;3;5443;0;6150;3;1;
/org.eclipse.jdt.ui.tests.refactoring/resources/InlineMethodWorkspace/TestCases/simple_in/TestFieldInitializer2.java;1;0;1;1;0;0;0;1;0;0;1;2281;0;0;1;0;0;1;1;2281;0;2281;1;1;
/org.eclipse.swt.tests/JUnit Tests/org/eclipse/swt/tests/junit/Test_org_eclipse_swt_layout_FormLayout.java;1;0;1;1;0;0;0;1;0;0;1;2176;0;0;1;0;0;1;1;2176;0;2176;1;1;
/org.eclipse.pde.ui/src/org/eclipse/pde/internal/ui/wizards/site/NewSiteProjectWizard.java;3;1;10;1;9;9;9;1;562;0;1;3840;670;670;1;0;0;1;10;3840;0;6336;10;3;
/org.eclipse.ant.ui/Ant Editor/org/eclipse/ant/internal/ui/editor/AntEditorException.java;1;0;2;1;0;0;0;2;0;1;2;1811;0;0;1;0;0;2;2;1811;0;4473;2;1;
/org.eclipse.ui.forms/src/org/eclipse/ui/forms/IManagedForm.java;1;0;11;1;1;1;1;10;152;2;9;4068;212;212;2;1;0;10;11;4284;1;6336;10;1;
/org.eclipse.jdt.debug.ui/ui/org/eclipse/jdt/internal/debug/ui/actions/EvaluateAction.java;5;0;12;2;1;1;1;11;31;2;10;1240;110;110;2;1;0;11;12;3948;1;6336;11;5;
/org.eclipse.update.core/src/org/eclipse/update/core/model/URLEntry.java;1;0;1;1;0;0;0;1;0;0;1;2634;0;0;1;0;0;1;1;2634;0;2634;1;1;
/org.eclipse.jdt.core.tests.model/workspace/Converter/src/test0034/Test.java;1;0;1;1;0;0;0;1;0;0;1;3714;0;0;1;0;0;1;1;3714;0;3714;1;1;
/org.eclipse.jdt.ui/core extension/org/eclipse/text/edits/TextEditProcessor.java;1;0;3;1;0;0;0;3;74;2;2;1972;74;74;2;1;0;3;3;1985;1;1985;2;1;
/org.eclipse.jdt.ui.examples.javafamily/src/org/eclipse/jface/text/source/TagHandlerFactory.java;1;0;2;1;0;0;0;2;0;1;2;1172;0;0;1;0;0;2;2;1172;0;1642;2;1;
/org.eclipse.jface.text/src/org/eclipse/jface/text/rules/IWhitespaceDetector.java;1;1;2;1;2;2;2;0;2;0;0;5123;3;3;1;0;0;0;2;5123;0;6340;2;1;
/org.eclipse.releng.basebuilder/plugins/org.eclipse.build.tools/org.eclipse.build.tools/src/org/eclipse/releng/generators/TestResultsGenerator.java;1;0;1;1;1;1;1;0;0;0;0;5735;0;0;1;0;0;0;1;5735;0;5735;1;1;
/org.eclipse.jdt.ui/core refactoring/org/eclipse/jdt/internal/corext/refactoring/participants/ITextUpdating.java;1;0;2;1;0;0;0;2;0;1;2;591;0;0;1;0;0;2;2;591;0;1125;2;1;
/org.eclipse.jdt.core.tests.model/workspace/Formatter/test083/A_out.java;1;0;1;1;0;0;0;1;0;0;1;2425;0;0;1;0;0;1;1;2425;0;2425;1;1;
/org.eclipse.jdt.core.tests.model/workspace/Formatter/test104/A_out.java;1;0;1;1;0;0;0;1;0;0;1;2425;0;0;1;0;0;1;1;2425;0;2425;1;1;
/org.eclipse.swt/Eclipse SWT Mozilla/common/org/eclipse/swt/internal/mozilla/nsID.java;1;0;1;1;0;0;0;1;0;0;1;1654;0;0;1;0;0;1;1;1654;0;1654;1;1;
/org.eclipse.swt.tests/JUnit Tests/org/eclipse/swt/tests/junit/SwtTestCase.java;3;0;6;1;0;0;0;6;70;1;6;2144;120;120;1;0;0;6;6;2144;0;3092;6;3;
/org.eclipse.pde.ui/src_Forms/org/eclipse/pde/internal/ui/neweditor/feature/PluginSection.java;2;1;4;1;2;2;2;2;91;0;1;4926;107;107;2;1;0;2;4;4926;1;5431;3;2;
/org.eclipse.jdt.core/model/org/eclipse/jdt/internal/core/CreateImportOperation.java;3;1;6;1;2;2;2;4;6;1;4;1804;16;16;1;0;0;4;6;1804;0;5916;6;3;
/org.eclipse.ui.externaltools/Ant Editor/org/eclipse/ui/externaltools/internal/ant/editor/derived/LineBreakingReader.java;1;0;1;1;0;0;0;1;0;0;1;282;0;0;1;0;0;1;1;282;0;282;1;1;
/org.eclipse.ui.internal.r21presentation/src/org/eclipse/ui/internal/r21presentation/R21Colors.java;1;0;1;1;1;1;1;0;0;0;0;5381;0;0;1;0;0;0;1;5381;0;5381;1;1;
/org.eclipse.pde.ui/src/org/eclipse/pde/internal/ui/editor/text/TextUtil.java;2;1;2;1;2;2;2;0;4;0;0;5800;6;6;1;0;0;0;2;5800;0;6336;2;2;
/org.eclipse.ui.workbench/Eclipse UI/org/eclipse/ui/internal/SwitchToWindowMenu.java;1;0;1;1;0;0;0;1;6;0;1;2737;6;6;1;0;0;1;1;2737;0;2737;1;1;
/org.eclipse.debug.core/core/org/eclipse/debug/core/sourcelookup/ISourceContainerTypeDelegate.java;1;0;2;1;1;1;1;1;6;0;1;4949;6;6;1;0;0;1;2;4949;0;5109;2;1;
/org.eclipse.team.cvs.ui/src/org/eclipse/team/internal/ccvs/ui/model/BatchSimilarSchedulingRule.java;2;0;3;1;0;0;0;3;3;1;3;1064;3;3;1;0;0;3;3;1064;0;1984;3;2;
/org.eclipse.ui.externaltools/Ant Tools Support/org/eclipse/ui/externaltools/internal/ant/view/elements/ProjectNode.java;2;0;4;1;0;0;0;4;8;1;4;139;18;18;1;0;0;4;4;139;0;282;4;2;
/org.eclipse.jdt.ui/core refactoring/org/eclipse/jdt/internal/corext/refactoring/participants/xml/ResourcePropertyTester.java;1;0;6;1;0;0;0;6;29;1;6;1033;59;59;1;0;0;6;6;1033;0;2546;6;1;
/org.eclipse.ui.workbench/Eclipse UI/org/eclipse/ui/internal/commands/registry/CategoryDefinitionHandle.java;1;0;2;1;0;0;0;2;0;0;1;1396;0;0;2;1;0;2;2;1396;1;1396;1;1;
/org.eclipse.jface/src/org/eclipse/jface/preference/ScaleFieldEditor.java;1;0;1;1;0;0;0;1;0;0;1;2781;0;0;1;0;0;1;1;2781;0;2781;1;1;
/org.eclipse.ant.ui/Ant Editor/org/eclipse/ant/internal/ui/editor/text/XMLAnnotationHover.java;1;0;3;1;1;1;1;2;8;1;2;1811;14;14;1;0;0;2;3;1811;0;5581;3;1;
/org.eclipse.ui.workbench/Eclipse UI/org/eclipse/ui/commands/ICommandDefinition.java;1;0;5;1;0;0;0;5;30;3;3;1389;30;30;3;2;0;5;5;1417;2;1417;3;1;
/org.eclipse.team.ui/src/org/eclipse/team/ui/synchronize/views/DecoratingColorLabelProvider.java;1;0;1;1;0;0;0;1;0;0;1;3825;0;0;1;0;0;1;1;3825;0;3825;1;1;
/org.eclipse.jdt.ui/core refactoring/org/eclipse/jdt/internal/corext/refactoring/changes/CopyResourceChange.java;2;1;4;1;2;2;2;2;11;1;2;3930;24;24;1;0;0;2;4;3930;0;6340;4;2;
/org.eclipse.core.boot/src/org/eclipse/core/internal/boot/PlatformURLHandlerFactoryProxy.java;1;0;1;1;0;0;0;1;0;0;1;3013;0;0;1;0;0;1;1;3013;0;3013;1;1;
/org.eclipse.update.tests.core/src/org/eclipse/update/tests/api/TestDefaultExecutableFeatureAPI.java;2;1;4;1;2;2;2;2;33;1;2;3813;45;45;1;0;0;2;4;3813;0;6336;4;2;
/org.eclipse.jdt.ui/core extension/org/eclipse/jdt/internal/corext/callhierarchy/CalleeAnalyzerVisitor.java;4;0;10;2;1;1;1;9;57;2;8;169;169;169;2;1;0;9;10;169;1;6340;9;4;
/org.eclipse.ui.ide/src/org/eclipse/ui/internal/model/WorkbenchProject.java;2;0;8;2;0;0;0;8;17;2;7;1511;27;27;2;1;0;8;8;1536;1;2263;7;2;
/org.eclipse.jdt.ui.tests.refactoring/resources/ExtractMethodWorkSpace/ExtractMethodTests/locals_out/A_test514.java;1;0;2;1;0;0;0;2;7;1;2;130;8;8;1;0;0;2;2;130;0;844;2;1;
/org.eclipse.ui.intro/src/org/eclipse/ui/internal/intro/impl/util/StringUtil.java;1;1;3;1;3;3;3;0;40;0;0;5140;42;42;1;0;0;0;3;5140;0;5539;3;1;
/org.eclipse.core.tests.resources/src/org/eclipse/core/tests/internal/builders/BrokenBuilder.java;1;0;1;1;1;1;1;0;5;0;0;5147;5;5;1;0;0;0;1;5147;0;5147;1;1;
/org.eclipse.ui.workbench/Eclipse UI/org/eclipse/ui/dialogs/TypeFilteringDialog.java;1;0;4;1;2;1;2;2;466;1;2;394;477;477;2;0;1;2;4;5464;1;5464;3;1;
/org.eclipse.core.resources/src/org/eclipse/core/internal/watson/ElementDelta.java;1;0;1;1;1;1;1;0;234;0;0;5146;234;234;1;0;0;0;1;5146;0;5146;1;1;
/org.eclipse.ui.workbench/Eclipse UI/org/eclipse/ui/internal/csm/commands/api/IKeyConfigurationEvent.java;1;0;3;1;0;0;0;3;5;1;3;2532;5;5;1;0;0;3;3;2532;0;2562;3;1;
/org.eclipse.jdt.ui.tests.refactoring/resources/ChangeTypeRefactoring/positive/A_testParameterNameWithOverride_in.java;1;0;1;1;0;0;0;1;0;0;1;2844;0;0;1;0;0;1;1;2844;0;2844;1;1;
/org.eclipse.team.ui/src/org/eclipse/team/ui/synchronize/subscribers/GlobalRefreshResourceSelectionPage.java;2;0;5;2;2;1;2;3;52;1;3;4632;131;131;2;0;1;3;5;5358;1;5358;4;2;
/org.eclipse.ui.ide/src/org/eclipse/ui/views/framelist/FrameList.java;1;0;1;1;0;0;0;1;0;0;1;2208;0;0;1;0;0;1;1;2208;0;2208;1;1;
/org.eclipse.jdt.ui/ui refactoring/org/eclipse/jdt/internal/ui/refactoring/code/ExtractMethodInputPage.java;4;2;15;1;4;3;4;11;80;1;11;130;225;225;2;0;1;11;15;5353;1;6340;14;4;
/org.eclipse.jdt.debug/model/org/eclipse/jdt/debug/core/IJavaFieldVariable.java;2;0;4;1;0;0;0;4;26;2;3;2269;46;46;2;1;0;4;4;2306;1;2306;3;2;
/org.eclipse.jdt.core.tests.model/workspace/Completion/src3/test0015/Test.java;1;0;1;1;1;1;1;0;0;0;0;5181;0;0;1;0;0;0;1;5181;0;5181;1;1;
/org.eclipse.swt/Eclipse SWT Browser/common/org/eclipse/swt/browser/TitleListener.java;2;0;3;1;1;1;1;2;7;1;2;3698;13;13;1;0;0;2;3;3698;0;6352;3;2;
/org.eclipse.jdt.ui.tests/ui/org/eclipse/jdt/ui/tests/packageview/ContentProviderTests2.java;2;1;2;1;2;2;2;0;3;0;0;5422;5;5;1;0;0;0;2;5422;0;6340;2;2;
/org.eclipse.update.ui/src/org/eclipse/update/internal/ui/parts/MyComputerLabelProvider.java;3;0;3;1;0;0;0;3;19;1;3;825;19;19;1;0;0;3;3;825;0;2085;3;3;
/org.eclipse.update.ui/src/org/eclipse/update/internal/ui/GoToWebsiteAction.java;3;0;3;1;0;0;0;3;8;1;3;825;8;8;1;0;0;3;3;825;0;3010;3;3;
/org.eclipse.core.filebuffers/src/org/eclipse/core/filebuffers/annotations/MarkerUtilities.java;1;0;1;1;0;0;0;1;0;0;1;2815;0;0;1;0;0;1;1;2815;0;2815;1;1;
/org.eclipse.ui.views/src/org/eclipse/ui/views/internal/tableview/TableView.java;1;0;2;1;0;0;0;2;0;1;2;267;0;0;1;0;0;2;2;267;0;749;2;1;
/org.eclipse.ui.workbench/Eclipse UI/org/eclipse/ui/internal/decorators/DecoratorOverlayIcon.java;1;0;1;1;0;0;0;1;17;0;1;1333;17;17;1;0;0;1;1;1333;0;1333;1;1;
/org.eclipse.jdt.core.tests.model/workspace/Converter/src/test0517/A.java;1;0;2;1;0;0;0;2;5;1;2;3714;5;5;1;0;0;2;2;3714;0;3886;2;1;
/org.eclipse.jdt.debug.ui/ui/org/eclipse/jdt/internal/debug/ui/actions/MoveUpAction.java;1;0;2;1;0;0;0;2;16;1;2;1496;18;18;1;0;0;2;2;1496;0;2691;2;1;
/org.eclipse.ui.workbench/Eclipse UI/org/eclipse/ui/commands/AbstractHandler.java;2;1;7;1;2;2;2;5;27;3;3;4088;73;73;3;2;0;5;7;4952;2;5444;5;2;
/org.eclipse.sdk.tests-feature/plugins/org.eclipse.perfmsr.core/src/org/eclipse/perfmsr/core/TimerXML.java;2;0;2;1;1;1;1;1;10;0;1;4845;10;10;1;0;0;1;2;4845;0;6342;2;2;
/org.eclipse.jdt.ui.tests/ui/org/eclipse/jdt/ui/tests/dialogs/PreferencesTest.java;1;0;1;1;1;1;1;0;2;0;0;6340;2;2;1;0;0;0;1;6340;0;6340;1;1;
/org.eclipse.team.cvs.ui/src/org/eclipse/team/internal/ccvs/ui/actions/ShowResourceInHistoryAction.java;2;1;3;1;2;2;2;1;7;0;1;1133;11;11;1;0;0;1;3;1133;0;6337;3;2;
/org.eclipse.jdt.ui.tests.refactoring/test cases/org/eclipse/jdt/ui/tests/refactoring/AllRefactoringTests.java;4;0;11;1;1;1;1;10;4;2;8;824;22;22;2;2;0;10;11;844;2;6340;9;4;
/org.eclipse.pde.ui/src/org/eclipse/pde/internal/ui/feature/NewFeatureProjectWizard.java;2;0;5;2;0;0;0;5;223;2;4;2751;239;239;2;1;0;5;5;3791;1;3840;4;2;
/org.eclipse.jdt.core.tests.model/workspace/Formatter/test239/A_in.java;1;0;1;1;0;0;0;1;0;0;1;2437;0;0;1;0;0;1;1;2437;0;2437;1;1;
/org.eclipse.help.base/src/org/eclipse/help/internal/base/util/IErrorUtil.java;1;1;4;1;2;2;2;2;8;1;2;1747;18;18;1;0;0;2;4;1747;0;6337;4;1;
/org.eclipse.jdt.ui.tests.refactoring/resources/MoveMembers/test28/out/A.java;1;0;1;1;0;0;0;1;0;0;1;1522;0;0;1;0;0;1;1;1522;0;1522;1;1;
/org.eclipse.update.core/src/org/eclipse/update/internal/core/SiteFile.java;3;2;11;1;3;2;3;8;35;1;8;890;119;119;2;0;1;8;11;5664;1;5664;10;3;
/org.eclipse.search/search/org/eclipse/search/ui/ISearchPageContainer.java;2;1;7;1;2;2;2;5;32;2;4;1519;78;78;2;1;0;5;7;2888;1;6340;6;2;
/org.eclipse.jdt.core.tests.model/workspace/Formatter/test201/A_in.java;1;0;1;1;0;0;0;1;0;0;1;2424;0;0;1;0;0;1;1;2424;0;2424;1;1;
/org.eclipse.jdt.core.tests.model/workspace/Formatter/test201/A_out.java;1;0;1;1;0;0;0;1;0;0;1;2424;0;0;1;0;0;1;1;2424;0;2424;1;1;
/org.eclipse.ui.ide/src/org/eclipse/ui/views/bookmarkexplorer/MarkerUtil.java;1;0;1;1;0;0;0;1;0;0;1;2208;0;0;1;0;0;1;1;2208;0;2208;1;1;
/org.eclipse.ui.ide/src/org/eclipse/ui/internal/ide/dialogs/BuildOrderPreferencePage.java;1;0;1;1;0;0;0;1;0;0;1;2264;0;0;1;0;0;1;1;2264;0;2264;1;1;
/org.eclipse.compare.examples.xml/src/org/eclipse/compare/examples/xml/XMLChildren.java;1;0;3;1;0;0;0;3;9;1;3;1106;11;11;1;0;0;3;3;1106;0;3938;3;1;
/org.eclipse.ui.workbench/Eclipse UI/org/eclipse/ui/IWorkingSetManager.java;2;1;3;1;2;2;2;1;34;0;1;3206;42;42;1;0;0;1;3;3206;0;6338;3;2;
/org.eclipse.jdt.core.tests.model/workspace/Converter/src/test0077/Test.java;1;0;1;1;0;0;0;1;0;0;1;3714;0;0;1;0;0;1;1;3714;0;3714;1;1;
/org.eclipse.ui.ide/src/org/eclipse/ui/internal/ide/registry/CapabilityRegistryReader.java;2;0;2;1;0;0;0;2;3;1;2;2264;3;3;1;0;0;2;2;2264;0;2804;2;2;
/org.eclipse.ant.ui/Ant Tools Support/org/eclipse/ant/internal/ui/views/elements/RootNode.java;1;0;1;1;0;0;0;1;0;0;1;1811;0;0;1;0;0;1;1;1811;0;1811;1;1;
/org.eclipse.jdt.core.tests.model/workspace/JavaSearch/src/j6/Bug54962.java;1;0;1;1;1;1;1;0;0;0;0;5713;0;0;1;0;0;0;1;5713;0;5713;1;1;
/org.eclipse.swt.tests/JUnit Tests/org/eclipse/swt/tests/junit/Test_org_eclipse_swt_events_TreeListener.java;1;0;1;1;0;0;0;1;16;0;1;2175;16;16;1;0;0;1;1;2175;0;2175;1;1;
/org.eclipse.ltk.core.refactoring.tests/src/org/eclipse/ltk/core/refactoring/tests/participants/FailingParticipantTests.java;1;1;2;1;2;2;2;0;2;0;0;6072;2;2;1;0;0;0;2;6072;0;6340;2;1;
/org.eclipse.jdt.ui/ui refactoring/org/eclipse/jdt/internal/ui/refactoring/actions/MoveStaticMembersAction.java;3;1;13;1;2;2;2;11;132;1;11;42;271;271;1;0;0;11;13;42;0;6340;13;3;
/org.eclipse.jdt.core.tests.model/workspace/Formatter/test193/A_out.java;2;0;2;1;0;0;0;2;6;1;2;2424;6;6;1;0;0;2;2;2424;0;3362;2;2;
/org.eclipse.jface.text.tests/src/org/eclipse/jface/text/tests/TextHoverPopupTest.java;1;0;2;1;1;1;1;1;6;0;1;5082;6;6;1;0;0;1;2;5082;0;5104;2;1;
/org.eclipse.jdt.ui/ui/org/eclipse/jdt/internal/ui/dnd/BasicSelectionTransferDragAdapter.java;2;1;2;1;2;2;2;0;4;0;0;5682;6;6;1;0;0;0;2;5682;0;6340;2;2;
/org.eclipse.jdt.core.tests.model/workspace/Formatter/test474/A_out.java;1;0;1;1;0;0;0;1;0;0;1;3977;0;0;1;0;0;1;1;3977;0;3977;1;1;
/org.eclipse.core.runtime/src/org/eclipse/core/runtime/content/IContentType.java;2;1;10;1;6;6;6;4;145;1;4;4574;249;249;1;0;0;4;10;4574;0;6012;10;2;
/org.eclipse.jdt.core.tests.model/workspace/Formatter/test222/A_in.java;1;0;1;1;0;0;0;1;0;0;1;2426;0;0;1;0;0;1;1;2426;0;2426;1;1;
/org.eclipse.jdt.ui/core refactoring/org/eclipse/jdt/internal/corext/refactoring/participants/ISharableParticipant.java;1;0;3;1;0;0;0;3;2;1;3;825;2;2;1;0;0;3;3;825;0;4624;3;1;
/org.eclipse.jdt.core.tests.model/workspace/Formatter/test006/A_in.java;1;0;2;1;0;0;0;2;2;1;2;2425;2;2;1;0;0;2;2;2425;0;2462;2;1;
/org.eclipse.jdt.ui/ui/org/eclipse/jdt/internal/ui/text/IJavaPartitions.java;2;0;2;1;1;1;1;1;7;0;1;1582;9;9;1;0;0;1;2;1582;0;6340;2;2;
/org.eclipse.jdt.core.tests.model/workspace/Formatter/test188/A_out.java;1;0;2;1;0;0;0;2;4;1;2;2425;4;4;1;0;0;2;2;2425;0;3029;2;1;
/org.eclipse.ant.ui/Ant Tools Support/org/eclipse/ant/internal/ui/preferences/AntPropertiesLabelProvider.java;1;0;2;1;0;0;0;2;0;1;2;1811;0;0;1;0;0;2;2;1811;0;1935;2;1;
/org.eclipse.swt/Eclipse SWT PI/carbon/org/eclipse/swt/internal/carbon/DataBrowserCallbacks.java;1;2;3;1;3;2;3;0;16;0;0;5534;20;20;2;0;1;0;3;5534;1;5614;2;1;
/org.eclipse.team.ui/src/org/eclipse/team/ui/synchronize/views/SyncInfoLabelDecorator.java;1;0;1;1;0;0;0;1;0;0;1;3825;0;0;1;0;0;1;1;3825;0;3825;1;1;
/org.eclipse.pde.core/src_OSGi/org/eclipse/pde/core/bundle/IBundleModel.java;1;0;2;1;0;0;0;2;0;1;2;2193;0;0;1;0;0;2;2;2193;0;2229;2;1;
/org.eclipse.team.ui/src/org/eclipse/team/internal/ui/sync/views/SyncSetFilter.java;1;0;1;1;0;0;0;1;0;0;1;488;0;0;1;0;0;1;1;488;0;488;1;1;
/org.eclipse.swt/Eclipse SWT OLE Win32/win32/org/eclipse/swt/ole/win32/OleClientSite.java;1;0;2;1;0;0;0;2;161;1;2;707;178;178;1;0;0;2;2;707;0;1496;2;1;
/org.eclipse.jdt.core/compiler/org/eclipse/jdt/internal/compiler/ast/NormalAnnotation.java;1;0;1;1;0;0;0;1;0;0;1;4494;0;0;1;0;0;1;1;4494;0;4494;1;1;
/org.eclipse.ui.ide/src/org/eclipse/ui/actions/CloseResourceAction.java;2;0;6;1;0;0;0;6;15;1;6;1511;25;25;1;0;0;6;6;1511;0;2263;6;2;
/org.eclipse.jdt.core/compiler/org/eclipse/jdt/internal/compiler/ClassFile.java;5;2;20;2;5;4;5;15;1096;1;15;219;1398;1398;2;0;1;15;20;5940;1;5940;19;5;
/org.eclipse.jdt.core.tests.model/src/org/eclipse/jdt/core/tests/model/SuiteOfTestCases.java;1;0;2;1;0;0;0;2;2;1;2;1170;4;4;1;0;0;2;2;1170;0;3560;2;1;
/org.eclipse.debug.ui/ui/org/eclipse/debug/internal/ui/stringsubstitution/ContainerResolver.java;2;0;2;1;0;0;0;2;4;1;2;2046;4;4;1;0;0;2;2;2046;0;4900;2;2;
/org.eclipse.swt/Eclipse SWT Browser/motif/org/eclipse/swt/internal/mozilla/XPCOMObject.java;1;0;1;1;0;0;0;1;0;0;1;2124;0;0;1;0;0;1;1;2124;0;2124;1;1;
/org.eclipse.jdt.ui/core refactoring/org/eclipse/jdt/internal/corext/refactoring/changes/RenamePackageChange.java;2;0;7;1;1;1;1;6;42;1;6;3708;57;57;1;0;0;6;7;3708;0;6340;7;2;
/org.eclipse.ui.workbench/Eclipse UI/org/eclipse/ui/contexts/ContextServiceEvent.java;1;0;2;1;0;0;0;2;0;1;2;1119;0;0;1;0;0;2;2;1119;0;1137;2;1;
/org.eclipse.ui.views/src/org/eclipse/ui/views/internal/markers/problems/ProblemViewConstants.java;1;0;2;1;0;0;0;2;0;1;2;265;0;0;1;0;0;2;2;265;0;728;2;1;
/org.eclipse.core.tools.resources/src/org/eclipse/core/tools/metadata/AbstractDumper.java;1;0;1;1;1;1;1;0;0;0;0;6302;0;0;1;0;0;0;1;6302;0;6302;1;1;
/org.eclipse.jdt.ui/ui/org/eclipse/jdt/ui/actions/IntroduceFactoryAction.java;2;1;7;1;3;3;3;4;102;1;4;2846;118;118;1;0;0;4;7;2846;0;6340;7;2;
/org.eclipse.osgi.tests/src/org/eclipse/osgi/tests/services/resolver/StateCycleTest.java;1;0;1;1;1;1;1;0;0;0;0;5993;0;0;1;0;0;0;1;5993;0;5993;1;1;
/org.eclipse.ui.workbench/Eclipse UI/org/eclipse/ui/internal/dialogs/CreateProjectWizard.java;1;0;1;1;0;0;0;1;0;0;1;2737;0;0;1;0;0;1;1;2737;0;2737;1;1;
/org.eclipse.core.runtime/src/org/eclipse/core/runtime/content/IContentTypeManager.java;3;2;16;2;11;9;11;5;107;1;5;4574;312;312;2;0;2;5;16;5736;2;6339;14;3;
/org.eclipse.jdt.ui/ui/org/eclipse/jdt/ui/actions/FindWriteReferencesInWorkingSetAction.java;2;0;2;1;1;1;1;1;9;0;1;3266;11;11;1;0;0;1;2;3266;0;6340;2;2;
/org.eclipse.ant.core/src/org/eclipse/ant/internal/core/AntPropertyValueProvider.java;1;0;4;1;1;1;1;3;9;1;3;1402;15;15;1;0;0;3;4;1402;0;6077;4;1;
/org.eclipse.ui.workbench/Eclipse UI/org/eclipse/ui/internal/CoolItemToolBarManager.java;2;0;3;1;0;0;0;3;23;1;3;2307;24;24;1;0;0;3;3;2307;0;3220;3;2;
/org.eclipse.swt.tests/JUnit Tests/org/eclipse/swt/tests/junit/browser/Browser1.java;2;1;9;1;2;2;2;7;10;2;5;2763;33;33;2;2;0;7;9;2763;2;6352;7;2;
/org.eclipse.jdt.core.tests.compiler/src/org/eclipse/jdt/core/tests/compiler/parser/AllocationExpressionCompletionTest.java;1;0;1;1;0;0;0;1;2;0;1;3560;2;2;1;0;0;1;1;3560;0;3560;1;1;
/org.eclipse.ant.ui/Ant Tools Support/org/eclipse/ant/ui/internal/preferences/OverlayPreferenceStore.java;1;0;3;1;0;0;0;3;6;1;3;250;6;6;1;0;0;3;3;250;0;1811;3;1;
/org.eclipse.team.webdav/src/org/eclipse/team/internal/core/target/TargetProvider.java;2;0;3;1;1;1;1;2;12;1;2;2495;14;14;1;0;0;2;3;2495;0;6337;3;2;
/org.eclipse.ant.ui/Ant Runner Support/org/eclipse/ant/ui/internal/antsupport/logger/AntProcessBuildLogger.java;1;0;9;1;0;0;0;9;83;2;7;250;197;197;2;2;0;9;9;1456;2;1811;7;1;
/org.eclipse.ui.workbench/Eclipse UI/org/eclipse/ui/internal/layout/SizeCache.java;1;1;3;1;2;2;2;1;175;0;1;5003;194;194;1;0;0;1;3;5003;0;5452;3;1;
/org.eclipse.ui.presentations.r21/src/org/eclipse/ui/internal/presentations/r21/widgets/R21PaneFolder.java;2;1;3;1;3;3;3;0;61;0;0;6075;80;80;1;0;0;0;3;6075;0;6225;3;2;
/org.eclipse.jdt.ui.tests.refactoring/resources/PullUp/test12/out/A.java;1;0;1;1;0;0;0;1;2;0;1;1690;2;2;1;0;0;1;1;1690;0;1690;1;1;
/org.eclipse.ui.editors/src/org/eclipse/ui/internal/editors/quickdiff/ReferenceSelectionAction.java;2;0;4;1;0;0;0;4;31;1;4;1118;46;46;1;0;0;4;4;1118;0;1644;4;2;
/org.eclipse.jdt.core.tests.model/workspace/Converter/src/test0242/Test.java;1;0;1;1;0;0;0;1;0;0;1;3714;0;0;1;0;0;1;1;3714;0;3714;1;1;
/org.eclipse.ui.intro/src/org/eclipse/ui/intro/internal/parts/RootPageForm.java;1;0;6;1;1;1;1;5;453;1;5;4429;544;544;1;0;0;5;6;4429;0;5115;6;1;
/org.eclipse.jdt.ui/ui refactoring/org/eclipse/jdt/internal/ui/refactoring/nls/PackageSelectionStringButtonAdapter.java;3;1;5;1;4;4;4;1;14;0;1;4930;22;22;1;0;0;1;5;4930;0;6340;5;3;
/org.eclipse.jdt.ui/ui/org/eclipse/jdt/ui/actions/FindDeclarationsAction.java;2;1;5;1;2;2;2;3;16;1;3;3266;29;29;1;0;0;3;5;3266;0;6340;5;2;
/org.eclipse.core.tests.runtime/src/org/eclipse/core/tests/runtime/jobs/TestRunnable.java;2;0;4;1;1;1;1;3;14;1;3;850;35;35;1;0;0;3;4;850;0;5149;4;2;
/org.eclipse.pde.core/src/org/eclipse/pde/internal/core/plugin/ExtensionsParser.java;2;1;4;1;3;3;3;1;10;0;1;4726;23;23;1;0;0;1;4;4726;0;6336;4;2;
/org.eclipse.ui.forms/src/org/eclipse/ui/internal/forms/widgets/HyperlinkSegment.java;1;1;3;1;2;2;2;1;4;0;1;5044;6;6;1;0;0;1;3;5044;0;6336;3;1;
/org.eclipse.jdt.core/dom/org/eclipse/jdt/core/dom/IDocElement.java;2;0;4;2;0;0;0;4;4;3;2;3683;6;6;3;2;0;4;4;3683;2;3748;2;2;
/org.eclipse.jdt.ui.tests.refactoring/resources/ExtractInterface/test99/out/A.java;1;0;1;1;0;0;0;1;0;0;1;3710;0;0;1;0;0;1;1;3710;0;3710;1;1;
/org.eclipse.jdt.ui.tests.refactoring/resources/ExtractMethodWorkSpace/ExtractMethodTests/expression_out/A_test606.java;1;0;3;1;0;0;0;3;4;1;3;844;4;4;1;0;0;3;3;844;0;1474;3;1;
/org.eclipse.jdt.core.tests.model/workspace/Converter/src/test0084/Test.java;1;0;1;1;0;0;0;1;0;0;1;3714;0;0;1;0;0;1;1;3714;0;3714;1;1;
/org.eclipse.debug.ui/ui/org/eclipse/debug/internal/ui/launchVariables/SpecificFileResourceComponent.java;2;0;3;1;0;0;0;3;5;1;3;647;5;5;1;0;0;3;3;647;0;773;3;2;
/org.eclipse.update.core/src/org/eclipse/update/internal/core/SiteFileContentProvider.java;1;0;1;1;0;0;0;1;17;0;1;890;17;17;1;0;0;1;1;890;0;890;1;1;
/org.eclipse.jdt.debug/model/org/eclipse/jdt/debug/core/IJavaExceptionBreakpoint.java;1;0;1;1;0;0;0;1;2;0;1;7;2;2;1;0;0;1;1;7;0;7;1;1;
/org.eclipse.pde.ui/src/org/eclipse/pde/internal/ui/editor/plugin/ManifestEditorContributor.java;2;1;3;1;3;3;3;0;10;0;0;5431;12;12;1;0;0;0;3;5431;0;6336;3;2;
/org.eclipse.swt.tests/JUnit Tests/org/eclipse/swt/tests/junit/Test_org_eclipse_swt_widgets_Shell.java;4;0;7;1;1;1;1;6;253;1;6;2123;379;379;1;0;0;6;7;2123;0;6352;7;4;
/org.eclipse.team.examples.filesystem/src/org/eclipse/team/examples/filesystem/ui/DisconnectAction.java;1;0;1;1;0;0;0;1;2;0;1;1708;2;2;1;0;0;1;1;1708;0;1708;1;1;
/org.eclipse.ui.editors/src/org/eclipse/ui/texteditor/ResourceMarkerAnnotationModel.java;2;0;4;1;1;1;1;3;152;1;3;1983;161;161;1;0;0;3;4;1983;0;6337;4;2;
/org.eclipse.jdt.core.tests.model/workspace/Converter/src/test0295/Test.java;1;0;1;1;0;0;0;1;0;0;1;3714;0;0;1;0;0;1;1;3714;0;3714;1;1;
/org.eclipse.debug.ui/ui/org/eclipse/debug/internal/ui/launchConfigurations/DebugModePromptStatusHandler.java;3;1;9;1;8;8;8;1;12;0;1;4638;63;63;1;0;0;1;9;4638;0;5871;9;3;
/org.eclipse.team.ui/src/org/eclipse/team/ui/synchronize/viewers/SyncInfoSetContentProvider.java;1;0;1;1;0;0;0;1;0;0;1;3972;0;0;1;0;0;1;1;3972;0;3972;1;1;
/org.eclipse.team.webdav/src/org/eclipse/team/internal/core/target/AuthenticatedSite.java;1;0;1;1;0;0;0;1;0;0;1;2495;0;0;1;0;0;1;1;2495;0;2495;1;1;
/org.eclipse.jdt.ui/ui/org/eclipse/jdt/internal/ui/workingsets/WorkingSetMenuContributionItem.java;1;0;2;1;1;1;1;1;30;0;1;4817;32;32;1;0;0;1;2;4817;0;6340;2;1;
/org.eclipse.swt/Eclipse SWT/win32/org/eclipse/swt/widgets/Tree.java;7;1;32;2;7;7;7;25;228;2;23;43;865;865;2;2;0;25;32;1214;2;6352;30;7;
/org.eclipse.jdt.core.tests.model/workspace/Formatter/test195/A_out.java;2;0;2;1;0;0;0;2;10;1;2;2424;10;10;1;0;0;2;2;2424;0;3362;2;2;
/org.eclipse.pde.ui/src/org/eclipse/pde/internal/ui/editor/plugin/JavaAttributeValue.java;1;1;2;1;2;2;2;0;4;0;0;5431;4;4;1;0;0;0;2;5431;0;6336;2;1;
/org.eclipse.ui.workbench/Eclipse UI/org/eclipse/ui/internal/UISynchronizer.java;1;0;2;1;0;0;0;2;55;1;2;1524;72;72;1;0;0;2;2;1524;0;2179;2;1;
/org.eclipse.pde.ui/src/org/eclipse/pde/internal/ui/editor/site/ObjectListSection.java;2;0;3;1;0;0;0;3;2;1;3;2229;3;3;1;0;0;3;3;2229;0;2311;3;2;
/org.eclipse.jdt.ui/core refactoring/org/eclipse/ltk/internal/refactoring/core/RefactoringCoreMesssages.java;1;0;2;1;0;0;0;2;0;1;2;3708;0;0;1;0;0;2;2;3708;0;3930;2;1;
/org.eclipse.jdt.ui/core refactoring/org/eclipse/jdt/internal/corext/refactoring/changes/MovePackageChange.java;2;1;4;1;2;2;2;2;8;1;2;3930;16;16;1;0;0;2;4;3930;0;6340;4;2;
/org.eclipse.jdt.core.tests.model/workspace/Formatter/test240/A_out.java;1;0;1;1;0;0;0;1;0;0;1;2437;0;0;1;0;0;1;1;2437;0;2437;1;1;
/org.eclipse.jdt.core.tests.model/workspace/Converter/src/test0565/A.java;1;0;1;1;1;1;1;0;0;0;0;6078;0;0;1;0;0;0;1;6078;0;6078;1;1;
/org.eclipse.core.runtime/src/org/eclipse/core/runtime/preferences/DefaultScope.java;2;1;4;1;2;2;2;2;8;1;2;4351;12;12;1;0;0;2;4;4351;0;6261;4;2;
/org.eclipse.swt.opengl.examples/src/org/eclipse/swt/opengl/examples/TextureTab.java;1;0;1;1;0;0;0;1;0;0;1;1175;0;0;1;0;0;1;1;1175;0;1175;1;1;
/org.eclipse.jdt.ui.tests.refactoring/resources/IntroduceFactory/negative/NestedClass_in.java;1;0;2;1;1;1;1;1;2;0;1;2846;2;2;1;0;0;1;2;2846;0;5659;2;1;
/org.eclipse.ui.workbench/Eclipse UI/org/eclipse/ui/wizards/newresource/BasicNewFileResourceWizard.java;1;0;1;1;0;0;0;1;0;0;1;2737;0;0;1;0;0;1;1;2737;0;2737;1;1;
/org.eclipse.jdt.ui/ui/org/eclipse/jdt/internal/ui/actions/NewWizardsActionGroup.java;2;0;2;1;1;1;1;1;2;0;1;4847;4;4;1;0;0;1;2;4847;0;6340;2;2;
/org.eclipse.ui.editors/src/org/eclipse/ui/internal/editors/quickdiff/compare/rangedifferencer/LinkedRangeDifference.java;2;0;2;1;0;0;0;2;0;1;2;1118;0;0;1;0;0;2;2;1118;0;1644;2;2;
/org.eclipse.jdt.ui/core refactoring/org/eclipse/jdt/internal/corext/refactoring/rename/RenameStaticMethodRefactoring.java;2;0;5;1;0;0;0;5;28;1;5;122;46;46;1;0;0;5;5;122;0;1125;5;2;
/org.eclipse.core.tests.runtime/src/org/eclipse/core/tests/plugintests/CmdLineAndPluginLocalAndPrimaryFeatureTest.java;1;0;1;1;0;0;0;1;0;0;1;3014;0;0;1;0;0;1;1;3014;0;3014;1;1;
/org.eclipse.pde.ui/src/org/eclipse/pde/internal/ui/search/PluginSearchActionGroup.java;1;1;2;1;2;2;2;0;4;0;0;5431;8;8;1;0;0;0;2;5431;0;6336;2;1;
/org.eclipse.core.expressions/src/org/eclipse/core/internal/expressions/Property.java;1;1;4;1;2;2;2;2;13;1;2;4108;17;17;1;0;0;2;4;4108;0;6340;4;1;
/org.eclipse.team.cvs.ui/src/org/eclipse/team/internal/ccvs/ui/subscriber/CompareParticipant.java;2;2;26;2;13;11;13;13;85;1;13;4137;439;439;2;0;2;13;26;5731;2;6337;24;2;
/org.eclipse.jdt.ui.tests/test plugin/org/eclipse/jdt/testplugin/util/IDialogTestPass.java;1;0;1;1;1;1;1;0;2;0;0;6340;2;2;1;0;0;0;1;6340;0;6340;1;1;
/org.eclipse.jdt.core.tests.model/workspace/Formatter/test435/A_in.java;1;0;1;1;0;0;0;1;0;0;1;3495;0;0;1;0;0;1;1;3495;0;3495;1;1;
/org.eclipse.help/src/org/eclipse/help/internal/browser/DefaultBrowser.java;1;0;1;1;0;0;0;1;0;0;1;460;0;0;1;0;0;1;1;460;0;460;1;1;
/org.eclipse.ui.tests/Eclipse UI Tests/org/eclipse/ui/tests/navigator/NullImageDecorator.java;3;1;3;1;2;2;2;1;10;0;1;4238;20;20;1;0;0;1;3;4238;0;6338;3;3;
/org.eclipse.core.tests.harness/src/org/eclipse/core/tests/harness/PerformanceTimer.java;1;0;1;1;1;1;1;0;80;0;0;5146;80;80;1;0;0;0;1;5146;0;5146;1;1;
/org.eclipse.ant.ui/Ant Tools Support/org/eclipse/ant/ui/internal/launchConfigurations/RemoteAntBuildListener.java;1;0;7;1;0;0;0;7;126;2;5;1456;154;154;2;2;0;7;7;1456;2;1811;5;1;
/org.eclipse.jdt.ui.tests/ui/org/eclipse/jdt/ui/tests/browsing/PackagesViewDeltaTests.java;2;1;2;1;2;2;2;0;39;0;0;5422;41;41;1;0;0;0;2;5422;0;6340;2;2;
/org.eclipse.team.cvs.core/src/org/eclipse/team/internal/ccvs/core/subscribers/CVSMergeSyncInfo.java;1;0;1;1;0;0;0;1;0;0;1;1427;0;0;1;0;0;1;1;1427;0;1427;1;1;
/org.eclipse.core.runtime/src/org/eclipse/core/boot/IPlatformRunnable.java;3;2;9;1;4;3;4;5;86;2;4;3049;150;150;2;1;1;5;9;3197;2;5541;7;3;
/org.eclipse.jdt.ui/ui/org/eclipse/jdt/internal/ui/LogicalPackageAdapterFactory.java;1;0;1;1;1;1;1;0;2;0;0;6340;2;2;1;0;0;0;1;6340;0;6340;1;1;
/org.eclipse.jface.text/src/org/eclipse/jface/text/templates/TemplateBuffer.java;1;0;2;1;0;0;0;2;0;0;1;4258;0;0;2;1;0;2;2;4258;1;4258;1;1;
/org.eclipse.team.core/src/org/eclipse/team/core/subscribers/utils/SessionSynchronizationCache.java;1;0;1;1;0;0;0;1;0;0;1;3678;0;0;1;0;0;1;1;3678;0;3678;1;1;
/org.eclipse.jdt.ui/core refactoring/org/eclipse/jdt/internal/corext/refactoring/code/flow/ReturnFlowInfo.java;1;0;1;1;1;1;1;0;2;0;0;6340;2;2;1;0;0;0;1;6340;0;6340;1;1;
/org.eclipse.jdt.ui.tests/ui/org/eclipse/jdt/ui/tests/browsing/MockPluginView.java;1;0;1;1;1;1;1;0;2;0;0;6340;2;2;1;0;0;0;1;6340;0;6340;1;1;
/org.eclipse.core.resources/src/org/eclipse/core/internal/events/ResourceDelta.java;2;2;6;1;3;2;3;3;960;1;3;1477;1089;1089;2;0;1;3;6;5146;1;5688;5;2;
/org.eclipse.ui.views/src/org/eclipse/ui/views/internal/markers/problems/ProblemPropertiesAction.java;1;0;2;1;0;0;0;2;0;1;2;265;0;0;1;0;0;2;2;265;0;749;2;1;
/org.eclipse.jdt.ui/core extension/org/eclipse/jdt/internal/corext/template/java/CodeTemplates.java;2;1;13;2;3;3;3;10;18;2;7;4258;68;68;2;3;0;10;13;4258;3;6340;10;2;
/org.eclipse.jdt.ui/core refactoring/org/eclipse/ltk/core/refactoring/participants/IConditionChecker.java;1;0;2;1;0;0;0;2;0;1;2;4654;0;0;1;0;0;2;2;4654;0;4864;2;1;
/org.eclipse.jdt.ui/ui/org/eclipse/jdt/internal/ui/filters/ImportDeclarationFilter.java;1;0;1;1;1;1;1;0;2;0;0;6340;2;2;1;0;0;0;1;6340;0;6340;1;1;
/org.eclipse.ui.cheatsheets/src/org/eclipse/ui/internal/cheatsheets/data/AbstractItem.java;2;0;4;2;1;1;1;3;38;2;2;4428;38;38;2;1;0;3;4;4625;1;5189;3;2;
/org.eclipse.jdt.ui.tests.refactoring/resources/ExtractMethodWorkSpace/ExtractMethodTests/return_in/A_test706.java;1;0;1;1;0;0;0;1;4;0;1;844;4;4;1;0;0;1;1;844;0;844;1;1;
/org.eclipse.core.runtime/src/org/eclipse/core/internal/registry/ExtensionPoint.java;5;3;15;2;8;6;8;7;191;2;6;3049;379;379;3;1;2;7;15;5637;3;5760;12;5;
/org.eclipse.jdt.core.tests.model/workspace/Converter/test0439/C.java;1;0;1;1;0;0;0;1;0;0;1;3714;0;0;1;0;0;1;1;3714;0;3714;1;1;
/org.eclipse.core.runtime/src/org/eclipse/core/internal/registry/PluginRegistryWrapper.java;2;0;3;2;0;0;0;3;5;2;2;2426;5;5;2;1;0;3;3;2426;1;3013;2;2;
/org.eclipse.ui.ide/src/org/eclipse/ui/wizards/datatransfer/ZipFileExportWizard.java;2;0;3;1;0;0;0;3;15;1;3;1511;17;17;1;0;0;3;3;1511;0;2280;3;2;
/org.eclipse.osgi/defaultAdaptor/src/org/eclipse/osgi/framework/adaptor/core/BundleEntry.java;3;1;7;1;4;4;4;3;13;1;3;4336;49;49;1;0;0;3;7;4336;0;5507;7;3;
/org.eclipse.jdt.ui/core refactoring/org/eclipse/jdt/internal/corext/refactoring/util/StatementAnalyzer.java;2;0;4;1;1;1;1;3;6;1;3;882;16;16;1;0;0;3;4;882;0;6340;4;2;
/org.eclipse.jdt.core.tests.model/workspace/Converter/test0178/Test.java;1;0;1;1;0;0;0;1;0;0;1;3714;0;0;1;0;0;1;1;3714;0;3714;1;1;
/org.eclipse.core.expressions/src/org/eclipse/core/internal/expressions/Assert.java;1;0;2;1;1;1;1;1;2;0;1;4108;2;2;1;0;0;1;2;4108;0;6340;2;1;
/org.eclipse.pde.ui/src_Forms/org/eclipse/pde/internal/ui/neweditor/plugin/NewRuntimeLibraryDialog.java;2;0;2;1;1;1;1;1;0;0;1;4959;0;0;1;0;0;1;2;4959;0;5431;2;2;
/org.eclipse.ant.ui/Ant Editor/org/eclipse/ant/internal/ui/editor/templates/AntVariableResolver.java;1;0;2;1;1;1;1;1;4;0;1;4810;4;4;1;0;0;1;2;4810;0;6336;2;1;
/org.eclipse.jdt.ui.tests.refactoring/test cases/org/eclipse/jdt/ui/tests/refactoring/SelectionAnalyzerTestSetup.java;1;0;1;1;0;0;0;1;0;0;1;1111;0;0;1;0;0;1;1;1111;0;1111;1;1;
/org.eclipse.ui.examples.javaeditor/Eclipse Java Editor Example/org/eclipse/ui/examples/javaeditor/JavaTextHover.java;1;0;1;1;1;1;1;0;2;0;0;6340;2;2;1;0;0;0;1;6340;0;6340;1;1;
/org.eclipse.update.ui/src/org/eclipse/update/internal/ui/pages/UnknownObjectPage.java;1;0;1;1;0;0;0;1;0;0;1;755;0;0;1;0;0;1;1;755;0;755;1;1;
/org.eclipse.core.filebuffers/src/org/eclipse/core/internal/filebuffers/ResourceTextFileBuffer.java;3;2;10;1;6;5;6;4;176;1;4;2224;395;395;2;0;1;4;10;5918;1;6340;9;3;
/org.eclipse.jdt.core.tests.model/workspace/Converter/test0260/Test.java;1;0;1;1;0;0;0;1;0;0;1;3714;0;0;1;0;0;1;1;3714;0;3714;1;1;
/org.eclipse.ui.workbench/Eclipse UI/org/eclipse/ui/internal/presentations/StateContribution.java;1;0;2;1;0;0;0;2;0;1;2;4473;0;0;1;0;0;2;2;4473;0;4504;2;1;
/org.eclipse.team.tests.cvs.core/src/org/eclipse/team/tests/ccvs/ui/FakeSelectionProvider.java;1;0;1;1;0;0;0;1;0;0;1;2632;0;0;1;0;0;1;1;2632;0;2632;1;1;
/org.eclipse.update.core/src/org/eclipse/update/internal/api/search/BaseFilter.java;1;0;2;1;0;0;0;2;0;1;2;3270;0;0;1;0;0;2;2;3270;0;4928;2;1;
/org.eclipse.releng.tools/src/org/eclipse/releng/tools/MapFileComparePage.java;2;1;2;1;2;2;2;0;3;0;0;5183;3;3;1;0;0;0;2;5183;0;5274;2;2;
/org.eclipse.jdt.ui/core extension/org/eclipse/jdt/internal/corext/textmanipulation/TextBufferEditor.java;2;0;10;1;1;1;1;9;229;2;8;1576;393;393;2;1;0;9;10;1869;1;6340;9;2;
/org.eclipse.sdk.tests-feature/plugins/org.eclipse.perfmsr.ui.client/src/org/eclipse/perfmsr/ui/client/SelectLogFilesActionDelegate.java;1;1;2;1;2;2;2;0;10;0;0;5443;10;10;1;0;0;0;2;5443;0;5513;2;1;
/org.eclipse.jdt.ui/ui/org/eclipse/jdt/internal/ui/reorg/ReorgExceptionHandler.java;1;0;1;1;0;0;0;1;0;0;1;1111;0;0;1;0;0;1;1;1111;0;1111;1;1;
/org.eclipse.ui.views/src/org/eclipse/ui/views/internal/markers/MarkerPropertiesAction.java;1;0;2;1;0;0;0;2;0;1;2;265;0;0;1;0;0;2;2;265;0;749;2;1;
/org.eclipse.team.cvs.core/src/org/eclipse/team/internal/ccvs/core/subscribers/CVSMergeSubscriber.java;1;0;1;1;0;0;0;1;0;0;1;1427;0;0;1;0;0;1;1;1427;0;1427;1;1;
/org.eclipse.team.core/src/org/eclipse/team/core/subscribers/SyncInfoSetCollector.java;1;0;1;1;0;0;0;1;0;0;1;3550;0;0;1;0;0;1;1;3550;0;3550;1;1;
/org.eclipse.jdt.debug.ui/ui/org/eclipse/jdt/internal/debug/ui/StatusDialog.java;2;0;2;1;1;1;1;1;4;0;1;3516;4;4;1;0;0;1;2;3516;0;6336;2;2;
/org.eclipse.swt/Eclipse SWT/gtk1x/org/eclipse/swt/widgets/WidgetTable.java;1;0;1;1;0;0;0;1;0;0;1;2327;0;0;1;0;0;1;1;2327;0;2327;1;1;
/org.eclipse.ui.workbench/Eclipse UI/org/eclipse/ui/internal/csm/roles/IRoleActivityBindingDefinition.java;1;0;2;1;0;0;0;2;0;1;2;2412;0;0;1;0;0;2;2;2412;0;2444;2;1;
/org.eclipse.compare.examples.xml/src/org/eclipse/compare/examples/xml/XMLCompareEditMappingDialog.java;1;0;3;1;0;0;0;3;96;1;3;1106;98;98;1;0;0;3;3;1106;0;3938;3;1;
/org.eclipse.pde.ui/src_Forms/org/eclipse/pde/internal/ui/model/build/BuildModelFactory.java;2;1;3;1;3;3;3;0;10;0;0;5298;14;14;1;0;0;0;3;5298;0;6336;3;2;
/org.eclipse.ui.workbench/Eclipse UI/org/eclipse/ui/application/IActionBarConfigurer.java;4;2;9;1;3;2;3;6;119;1;6;2309;239;239;2;0;1;6;9;5565;1;6338;8;4;
/org.eclipse.ui.workbench/Eclipse UI/org/eclipse/ui/SubActionBars.java;5;1;7;1;3;3;3;4;6;1;4;179;27;27;1;0;0;4;7;179;0;6338;7;5;
/org.eclipse.ui.workbench/Eclipse UI/org/eclipse/ui/internal/dialogs/PerspectivesPreferencePage.java;3;2;7;1;5;4;5;2;87;1;2;2737;238;238;2;0;1;2;7;5336;1;6338;6;3;
/org.eclipse.jdt.core/compiler/org/eclipse/jdt/internal/compiler/env/NameEnvironmentAnswer.java;2;0;2;1;1;1;1;1;12;0;1;3560;14;14;1;0;0;1;2;3560;0;5916;2;2;
/org.eclipse.jdt.core.tests.model/workspace/Converter/src/javadoc/testBug55223/TestA.java;1;0;1;1;0;0;0;1;0;0;1;4679;0;0;1;0;0;1;1;4679;0;4679;1;1;
/org.eclipse.swt/Eclipse SWT/gtk1x/org/eclipse/swt/widgets/Control.java;1;0;1;1;0;0;0;1;0;0;1;2327;0;0;1;0;0;1;1;2327;0;2327;1;1;
/org.eclipse.core.resources/src/org/eclipse/core/internal/utils/Assert.java;1;0;2;1;1;1;1;1;153;0;1;3036;163;163;1;0;0;1;2;3036;0;5146;2;1;
/org.eclipse.ui.tests/Eclipse UI Tests/org/eclipse/ui/tests/api/MockEditorPart.java;3;1;4;1;3;3;3;1;8;0;1;2738;21;21;1;0;0;1;4;2738;0;6338;4;3;
/org.eclipse.jdt.core.tests.model/workspace/Converter/src/junit/swingui/StatusLine.java;1;0;1;1;0;0;0;1;0;0;1;3714;0;0;1;0;0;1;1;3714;0;3714;1;1;
/org.eclipse.ui.examples.javaeditor/Eclipse Java Editor Example/org/eclipse/ui/examples/javaeditor/java/JavaAutoIndentStrategy.java;2;0;2;1;1;1;1;1;9;0;1;1589;11;11;1;0;0;1;2;1589;0;6340;2;2;
/org.eclipse.jdt.core.tests.model/workspace/Converter/test0445/A.java;1;0;1;1;0;0;0;1;0;0;1;3714;0;0;1;0;0;1;1;3714;0;3714;1;1;
/org.eclipse.jdt.core.tests.model/workspace/Formatter/test022/A_in.java;1;0;1;1;0;0;0;1;0;0;1;2425;0;0;1;0;0;1;1;2425;0;2425;1;1;
/org.eclipse.jdt.core.tests.model/workspace/Converter/src/junit/runner/ClassPathTestCollector.java;1;0;1;1;0;0;0;1;0;0;1;3714;0;0;1;0;0;1;1;3714;0;3714;1;1;
/org.eclipse.jdt.ui.tests.refactoring/resources/Delete/testDeleteWithinCu11/in/A.java;1;0;1;1;0;0;0;1;0;0;1;442;0;0;1;0;0;1;1;442;0;442;1;1;
/org.eclipse.core.tests.harness/src/org/eclipse/core/tests/harness/EclipseWorkspaceTest.java;2;2;16;1;7;6;7;9;1605;1;9;93;1875;1875;2;0;1;9;16;5146;1;5998;15;2;
/org.eclipse.jdt.core.tests.model/workspace/Converter/test0319/Test.java;1;0;1;1;0;0;0;1;0;0;1;3714;0;0;1;0;0;1;1;3714;0;3714;1;1;
/org.eclipse.ui.forms/src/org/eclipse/ui/forms/widgets/AbstractHyperlink.java;1;0;5;1;1;1;1;4;44;1;4;4068;64;64;1;0;0;4;5;4068;0;5872;5;1;
/org.eclipse.jface/src/org/eclipse/jface/window/ApplicationWindow.java;7;2;15;2;4;3;4;11;125;2;10;851;351;351;2;1;1;11;15;3238;2;6338;13;7;
/org.eclipse.pde.ui/src/org/eclipse/pde/internal/ui/parts/ModifiedTextCellEditor.java;2;1;2;1;2;2;2;0;4;0;0;5782;6;6;1;0;0;0;2;5782;0;6336;2;2;
/org.eclipse.jdt.ui/ui/org/eclipse/jdt/internal/ui/preferences/TodoTaskInputDialog.java;1;0;1;1;1;1;1;0;2;0;0;6340;2;2;1;0;0;0;1;6340;0;6340;1;1;
/org.eclipse.ui.workbench/Eclipse UI/org/eclipse/ui/internal/FastViewPane.java;7;3;34;3;10;8;10;24;302;3;18;3677;1372;1372;3;6;2;24;34;4560;8;6230;26;7;
/org.eclipse.jdt.ui/ui/org/eclipse/jdt/internal/ui/actions/FindExceptionOccurrences.java;2;1;3;1;2;2;2;1;4;0;1;3759;6;6;1;0;0;1;3;3759;0;6340;3;2;
/org.eclipse.debug.ui/ui/org/eclipse/debug/internal/ui/launchVariables/ResourceComponent.java;3;0;8;2;0;0;0;8;18;3;6;647;29;29;3;2;0;8;8;771;2;2120;6;3;
/org.eclipse.jdt.core/compiler/org/eclipse/jdt/internal/compiler/ast/JavadocArraySingleTypeReference.java;3;0;5;1;0;0;0;5;10;1;5;2887;22;22;1;0;0;5;5;2887;0;3560;5;3;
/org.eclipse.ui.intro/src/org/eclipse/ui/intro/internal/model/IntroModelRoot.java;1;0;11;1;1;1;1;10;926;2;9;4429;1266;1266;2;1;0;10;11;4948;1;5115;10;1;
/org.eclipse.pde.ui/src/org/eclipse/pde/internal/ui/editor/text/TagRule.java;1;0;1;1;0;0;0;1;0;0;1;3795;0;0;1;0;0;1;1;3795;0;3795;1;1;
/org.eclipse.ui.ide/src/org/eclipse/ui/views/framelist/FrameAction.java;1;0;1;1;0;0;0;1;0;0;1;2208;0;0;1;0;0;1;1;2208;0;2208;1;1;
/org.eclipse.jdt.core.tests.model/workspace/Formatter/test075/A_in.java;1;0;1;1;0;0;0;1;0;0;1;2425;0;0;1;0;0;1;1;2425;0;2425;1;1;
/org.eclipse.jdt.core/compiler/org/eclipse/jdt/internal/compiler/ast/JavadocMessageSend.java;4;1;11;1;2;2;2;9;74;1;9;2887;154;154;1;0;0;9;11;2887;0;6126;11;4;
/org.eclipse.jdt.core.tests.model/workspace/Converter/test0175/Test.java;1;0;1;1;0;0;0;1;0;0;1;3714;0;0;1;0;0;1;1;3714;0;3714;1;1;
/org.eclipse.debug.ui/ui/org/eclipse/debug/internal/ui/actions/DebugContextualLaunchAction.java;1;0;1;1;1;1;1;0;0;0;0;5496;0;0;1;0;0;0;1;5496;0;5496;1;1;
/org.eclipse.pde.core/src/org/eclipse/pde/internal/core/site/WorkspaceSiteBuildModel.java;3;2;6;1;4;3;4;2;12;1;2;2501;30;30;2;0;1;2;6;5799;1;6336;5;3;
/org.eclipse.jdt.ui/core refactoring/org/eclipse/jdt/internal/corext/refactoring/rename/RenameSourceFolderProcessor.java;2;1;16;1;4;4;4;12;23;1;12;1125;123;123;1;0;0;12;16;1125;0;6340;16;2;
/org.eclipse.ui.workbench/Eclipse UI/org/eclipse/ui/wizards/datatransfer/Base64Encoder.java;1;0;1;1;0;0;0;1;0;0;1;2737;0;0;1;0;0;1;1;2737;0;2737;1;1;
/org.eclipse.team.ui/src/org/eclipse/team/internal/ui/sync/views/SynchronizeView.java;2;0;18;2;0;0;0;18;888;3;14;1297;1383;1383;3;4;0;18;18;2118;4;2632;14;2;
/org.eclipse.jdt.ui.tests.refactoring/resources/ConvertAnonymousToNested/canConvert/A_test12_out.java;1;0;1;1;0;0;0;1;2;0;1;1005;2;2;1;0;0;1;1;1005;0;1005;1;1;
/org.eclipse.jdt.core/compiler/org/eclipse/jdt/internal/compiler/parser/ParserBasicInformation.java;3;0;8;2;0;0;0;8;50;2;7;764;203;203;2;1;0;8;8;858;1;3560;7;3;
/org.eclipse.ui.workbench/Eclipse UI/org/eclipse/ui/internal/skins/PresentationUtil.java;2;0;3;1;0;0;0;3;9;1;3;4438;13;13;1;0;0;3;3;4438;0;4469;3;2;
/org.eclipse.jdt.ui/ui/org/eclipse/jdt/internal/ui/search/SearchParticipantsExtensionPoint.java;2;1;2;1;2;2;2;0;10;0;0;5590;10;10;1;0;0;0;2;5590;0;6340;2;2;
/org.eclipse.ui.ide/src/org/eclipse/ui/actions/TextActionHandler.java;2;0;4;1;0;0;0;4;13;1;4;1511;23;23;1;0;0;4;4;1511;0;2263;4;2;
/org.eclipse.update.ui/src/org/eclipse/update/internal/ui/wizards/DuplicateConflictsDialog.java;3;0;3;1;0;0;0;3;240;1;3;755;251;251;1;0;0;3;3;755;0;900;3;3;
/org.eclipse.jdt.core.tests.model/workspace/Converter/src/test0132/Test.java;1;0;1;1;0;0;0;1;0;0;1;3714;0;0;1;0;0;1;1;3714;0;3714;1;1;
/org.eclipse.jdt.ui/core extension/org/eclipse/text/edits/EditMessages.java;1;0;2;1;0;0;0;2;0;1;2;1953;0;0;1;0;0;2;2;1953;0;1972;2;1;
/org.eclipse.ant.ui/Remote Ant Support/org/eclipse/ant/ui/internal/antsupport/logger/RemoteAntBuildLogger.java;1;0;8;1;0;0;0;8;110;2;6;1452;196;196;2;2;0;8;8;1452;2;1811;6;1;
/org.eclipse.jdt.ui/ui/org/eclipse/jdt/internal/ui/callhierarchy/SelectionProviderMediator.java;3;0;3;1;1;1;1;2;18;1;2;155;18;18;1;0;0;2;3;155;0;6029;3;3;
/org.eclipse.swt/Eclipse SWT PI/gtk1x/org/eclipse/swt/internal/gtk/GdkEventKey.java;1;0;1;1;0;0;0;1;0;0;1;2327;0;0;1;0;0;1;1;2327;0;2327;1;1;
/org.eclipse.jdt.core.tests.model/workspace/Converter/junit/textui/ResultPrinter.java;1;0;2;1;0;0;0;2;0;1;2;787;0;0;1;0;0;2;2;787;0;3714;2;1;
/org.eclipse.ui.workbench/Eclipse UI/org/eclipse/ui/internal/csm/roles/IActivityBindingDefinition.java;1;0;3;1;0;0;0;3;28;1;3;2225;28;28;1;0;0;3;3;2225;0;2412;3;1;
/org.eclipse.jdt.ui/ui refactoring/org/eclipse/jdt/internal/ui/refactoring/actions/RefactoringActions.java;2;0;2;1;1;1;1;1;2;0;1;3251;2;2;1;0;0;1;2;3251;0;6340;2;2;
/org.eclipse.ui.cheatsheets/src/org/eclipse/ui/internal/cheatsheets/registry/CheatSheetRegistryReader.java;2;1;11;2;5;5;5;6;81;2;5;4428;268;268;2;1;0;6;11;4625;1;5759;10;2;
/org.eclipse.pde.ui/src/org/eclipse/pde/internal/ui/launcher/JUnitMainTab.java;1;0;1;1;0;0;0;1;0;0;1;1343;0;0;1;0;0;1;1;1343;0;1343;1;1;
/org.eclipse.jdt.ui/core refactoring/org/eclipse/jdt/internal/corext/refactoring/nls/NLSHolder.java;3;1;7;1;4;4;4;3;167;1;3;346;394;394;1;0;0;3;7;346;0;5640;7;3;
/org.eclipse.ui.externaltools/External Tools Base/org/eclipse/ui/externaltools/internal/registry/ExternalToolVariableRegistry.java;1;0;1;1;0;0;0;1;0;0;1;321;0;0;1;0;0;1;1;321;0;321;1;1;
/org.eclipse.core.resources/src/org/eclipse/core/internal/localstore/FileSystemStore.java;3;0;6;1;1;1;1;5;694;1;5;93;729;729;1;0;0;5;6;93;0;5146;6;3;
/org.eclipse.osgi/defaultAdaptor/src/org/eclipse/osgi/framework/adaptor/core/AdaptorElementFactory.java;2;0;2;1;1;1;1;1;4;0;1;4336;4;4;1;0;0;1;2;4336;0;5117;2;2;
/org.eclipse.jdt.core.tests.model/workspace/Converter/test0413/A.java;1;0;1;1;0;0;0;1;0;0;1;3714;0;0;1;0;0;1;1;3714;0;3714;1;1;
/org.eclipse.pde.ui/src_OSGi/org/eclipse/pde/internal/ui/osgi/wizards/project/NewBundleProjectWizard.java;2;0;4;1;0;0;0;4;15;2;3;2498;17;17;2;1;0;4;4;2498;1;3986;3;2;
/org.eclipse.text/src/org/eclipse/text/edits/MultiTextEdit.java;2;1;7;1;3;3;3;4;43;1;4;1986;133;133;1;0;0;4;7;1986;0;6340;7;2;
/org.eclipse.ui.ide/src/org/eclipse/ui/internal/dialogs/WorkbenchWizardElement.java;2;0;5;1;0;0;0;5;4;1;5;1526;9;9;1;0;0;5;5;1526;0;2263;5;2;
/org.eclipse.ui.tutorials.rcp.part2/src/org/eclipse/ui/tutorials/rcp/part2/RcpApplication.java;1;0;1;1;1;1;1;0;0;0;0;5118;0;0;1;0;0;0;1;5118;0;5118;1;1;
/org.eclipse.jdt.ui/ui/org/eclipse/jdt/internal/ui/viewsupport/IProblemChangedListener.java;1;0;1;1;1;1;1;0;2;0;0;6340;2;2;1;0;0;0;1;6340;0;6340;1;1;
/org.eclipse.ui.workbench/Eclipse UI/org/eclipse/ui/internal/commands/SimpleActionService.java;1;0;2;1;0;0;0;2;0;1;2;956;0;0;1;0;0;2;2;956;0;1065;2;1;
/org.eclipse.swt/Eclipse SWT PI/common_j2se/org/eclipse/swt/internal/Library.java;5;2;65;1;16;15;16;49;16;2;48;215;150;150;2;1;1;49;65;943;2;6364;63;5;
/org.eclipse.debug.core/core/org/eclipse/debug/internal/core/variables/ContextLaunchVariableRegistry.java;2;0;3;1;0;0;0;3;17;1;3;737;17;17;1;0;0;3;3;737;0;2120;3;2;
/org.eclipse.jdt.core/compiler/org/eclipse/jdt/internal/compiler/lookup/ReferenceBinding.java;3;1;8;1;2;2;2;6;190;2;5;80;220;220;2;1;0;6;8;4513;1;5871;7;3;
/org.eclipse.ui.workbench/Eclipse UI/org/eclipse/ui/internal/contexts/Persistence.java;3;1;20;1;3;3;3;17;265;3;14;1220;656;656;3;3;0;17;20;1396;3;6338;17;3;
/org.eclipse.pde.ui/src_Forms/org/eclipse/pde/internal/ui/neweditor/feature/OpenReferenceAction.java;2;0;2;1;1;1;1;1;0;0;1;4926;0;0;1;0;0;1;2;4926;0;5431;2;2;
/org.eclipse.osgi/core/framework/org/eclipse/osgi/framework/internal/core/StartLevelManager.java;4;2;7;1;7;6;7;0;249;0;0;5116;368;368;2;0;1;0;7;5116;1;6228;6;4;
/org.eclipse.ui.ide/src/org/eclipse/ui/internal/model/WorkbenchStatus.java;2;0;2;1;0;0;0;2;0;1;2;1511;0;0;1;0;0;2;2;1511;0;2263;2;2;
/org.eclipse.jdt.core.tests.model/workspace/Completion/src3/test0014/Test.java;1;0;1;1;1;1;1;0;0;0;0;5181;0;0;1;0;0;0;1;5181;0;5181;1;1;
/org.eclipse.update.ui/src/org/eclipse/update/internal/ui/model/UIModelObject.java;1;0;1;1;0;0;0;1;4;0;1;890;4;4;1;0;0;1;1;890;0;890;1;1;
/org.eclipse.jdt.core.tests.model/workspace/Formatter/test157/A_in.java;1;0;1;1;0;0;0;1;0;0;1;2425;0;0;1;0;0;1;1;2425;0;2425;1;1;
/org.eclipse.pde.core/src/org/eclipse/pde/internal/core/plugin/WorkspacePluginModelBase.java;3;1;5;1;2;2;2;3;12;1;3;837;31;31;1;0;0;3;5;837;0;6336;5;3;
/org.eclipse.pde/src/org/eclipse/pde/internal/builders/ExtensionPointSchemaBuilder.java;3;1;15;1;3;3;3;12;109;1;12;964;350;350;1;0;0;12;15;964;0;6336;15;3;
/org.eclipse.jdt.debug.tests/tests/org/eclipse/jdt/debug/tests/core/WorkingDirectoryTests.java;1;0;1;1;0;0;0;1;2;0;1;2931;2;2;1;0;0;1;1;2931;0;2931;1;1;
/org.eclipse.help.webapp/src_servlets/org/eclipse/help/internal/webapp/data/BookmarksData.java;1;1;8;1;3;3;3;5;48;1;5;106;165;165;1;0;0;5;8;106;0;6337;8;1;
/org.eclipse.ui.workbench/Eclipse UI/org/eclipse/ui/internal/layout/CellLayoutUtil.java;1;0;1;1;0;0;0;1;0;0;1;5003;0;0;1;0;0;1;1;5003;0;5003;1;1;
/org.eclipse.team.ui/src/org/eclipse/team/internal/ui/registry/SynchronizeParticipantDescriptor.java;2;1;9;1;3;3;3;6;122;1;6;2604;243;243;1;0;0;6;9;2604;0;6337;9;2;
/org.eclipse.ui.views/src/org/eclipse/ui/views/internal/markers/BookmarkFilter.java;1;0;2;1;0;0;0;2;0;0;1;749;0;0;2;1;0;2;2;749;1;749;1;1;
/org.eclipse.swt/Eclipse SWT/carbon/org/eclipse/swt/widgets/Scrollable.java;4;1;9;1;4;4;4;5;14;1;5;2;43;43;1;0;0;5;9;2;0;6352;9;4;
/org.eclipse.ui.workbench/Eclipse UI/org/eclipse/ui/commands/ICommandServiceListener.java;1;0;3;1;0;0;0;3;16;1;3;2569;16;16;1;0;0;3;3;2569;0;4144;3;1;
/org.eclipse.jdt.debug.ui/ui/org/eclipse/jdt/internal/debug/ui/CoreResourcesIContainerObjectBrowser.java;3;0;4;1;0;0;0;4;7;1;4;861;12;12;1;0;0;4;4;861;0;2647;4;3;
/org.eclipse.ui.workbench/Eclipse UI/org/eclipse/ui/internal/dialogs/MultiStepWizard.java;1;0;1;1;0;0;0;1;0;0;1;2737;0;0;1;0;0;1;1;2737;0;2737;1;1;
/org.eclipse.jdt.core.tests.model/src/org/eclipse/jdt/core/tests/rewrite/describing/ASTRewritingTrackingTest.java;5;1;6;1;4;4;4;2;70;1;2;4711;111;111;1;0;0;2;6;4711;0;6336;6;5;
/org.eclipse.jdt.core.tests.model/workspace/Formatter/test212/A_out.java;1;0;1;1;0;0;0;1;0;0;1;2425;0;0;1;0;0;1;1;2425;0;2425;1;1;
/org.eclipse.team.tests.cvs.core/src/org/eclipse/team/tests/ccvs/ui/LoggingTestRunner.java;1;0;1;1;0;0;0;1;0;0;1;2632;0;0;1;0;0;1;1;2632;0;2632;1;1;
/org.eclipse.jdt.ui.tests.refactoring/resources/MoveInstanceMethod/canMove/test24/in/B.java;1;0;1;1;0;0;0;1;0;0;1;1627;0;0;1;0;0;1;1;1627;0;1627;1;1;
/org.eclipse.update.ui/srcnew/org/eclipse/update/internal/ui/properties/ConfiguredSitePropertyPage.java;1;0;2;1;0;0;0;2;0;1;2;755;0;0;1;0;0;2;2;755;0;825;2;1;
/org.eclipse.jdt.core.tests.model/workspace/Formatter/test447/A_in.java;1;0;2;1;0;0;0;2;0;1;2;3611;0;0;1;0;0;2;2;3611;0;3673;2;1;
/org.eclipse.ui.workbench/Eclipse UI/org/eclipse/ui/part/IShowInTargetList.java;1;0;1;1;0;0;0;1;4;0;1;1;4;4;1;0;0;1;1;1;0;1;1;1;
/org.eclipse.ui.tests/Eclipse UI Tests/org/eclipse/ui/tests/api/ListView.java;1;0;1;1;0;0;0;1;20;0;1;3166;20;20;1;0;0;1;1;3166;0;3166;1;1;
/org.eclipse.ui.workbench/Eclipse UI/org/eclipse/ui/internal/SaveAction.java;3;0;4;1;1;1;1;3;26;1;3;2737;51;51;1;0;0;3;4;2737;0;6338;4;3;
/org.eclipse.osgi/core/framework/org/eclipse/osgi/framework/internal/core/BundleLoaderProxy.java;6;2;20;1;6;5;6;14;58;1;14;3013;256;256;2;0;1;14;20;5116;1;5668;19;6;
/org.eclipse.update.core/src/org/eclipse/update/internal/api/operations/IOperation.java;1;0;2;1;0;0;0;2;0;1;2;3270;0;0;1;0;0;2;2;3270;0;4928;2;1;
/org.eclipse.jdt.ui/ui/org/eclipse/jdt/internal/ui/text/JavaHeuristicScanner.java;2;0;8;1;1;1;1;7;106;3;5;1968;153;153;3;2;0;7;8;1968;2;6340;6;2;
/org.eclipse.ant.ui/Ant Editor/org/eclipse/ant/internal/ui/editor/text/NonRuleBasedDamagerRepairer.java;1;0;2;1;0;0;0;2;0;1;2;1811;0;0;1;0;0;2;2;1811;0;2252;2;1;
/org.eclipse.ui.views/src/org/eclipse/ui/views/tasklist/MarkerTypesModel.java;1;0;1;1;0;0;0;1;0;0;1;2738;0;0;1;0;0;1;1;2738;0;2738;1;1;
/org.eclipse.ant.ui/Ant Tools Support/org/eclipse/ant/internal/ui/model/AntUIPlugin.java;3;1;16;2;5;5;5;11;28;2;10;1811;121;121;2;1;0;11;16;1915;1;5700;15;3;
/org.eclipse.ui.tests/Eclipse UI Tests/org/eclipse/ui/tests/navigator/DecoratorEnablementTestCase.java;1;0;1;1;0;0;0;1;0;0;1;4238;0;0;1;0;0;1;1;4238;0;4238;1;1;
/org.eclipse.jdt.ui/core extension/org/eclipse/text/edits/TextEditMessages.java;1;0;2;1;0;0;0;2;0;1;2;1972;0;0;1;0;0;2;2;1972;0;1987;2;1;
/org.eclipse.core.tests.resources/src/org/eclipse/core/tests/internal/localstore/RefreshLocalTest.java;2;0;5;1;3;1;3;2;521;1;2;449;534;534;3;0;2;2;5;5147;2;5147;3;2;
/org.eclipse.debug.ui/ui/org/eclipse/debug/internal/ui/views/console/ConsoleDocument.java;2;0;2;1;0;0;0;2;9;1;2;550;11;11;1;0;0;2;2;550;0;1708;2;2;
/org.eclipse.ui.workbench/Eclipse UI/org/eclipse/ui/internal/contexts/registry/IContextRegistryEvent.java;1;0;2;1;0;0;0;2;0;1;2;1422;0;0;1;0;0;2;2;1422;0;1724;2;1;
/org.eclipse.jdt.core.tests.model/workspace/Formatter/test162/A_out.java;2;0;2;1;0;0;0;2;30;1;2;2425;30;30;1;0;0;2;2;2425;0;3362;2;2;
/org.eclipse.jdt.ui.tests.refactoring/resources/MoveInstanceMethod/canMove/test16/out/B.java;1;0;1;1;0;0;0;1;0;0;1;1570;0;0;1;0;0;1;1;1570;0;1570;1;1;
/org.eclipse.swt/Eclipse SWT/photon/org/eclipse/swt/widgets/FontDialog.java;4;1;8;2;2;2;2;6;44;3;3;166;98;98;3;3;0;6;8;166;3;6352;5;4;
/org.eclipse.ui.workbench/Eclipse UI/org/eclipse/ui/internal/commands/registry/Persistence.java;1;0;9;1;0;0;0;9;860;2;8;1077;1002;1002;2;1;0;9;9;1396;1;1724;8;1;
/org.eclipse.osgi/resolver/src/org/eclipse/core/internal/dependencies/SatisfactionVisitor.java;4;1;4;1;3;3;3;1;19;0;1;3013;29;29;1;0;0;1;4;3013;0;5408;4;4;
/org.eclipse.jdt.core.tests.model/workspace/Formatter/test392/A_in.java;1;0;1;1;0;0;0;1;0;0;1;3175;0;0;1;0;0;1;1;3175;0;3175;1;1;
/org.eclipse.jdt.core.tests.model/workspace/Formatter/test360/A_out.java;1;0;1;1;0;0;0;1;0;0;1;3087;0;0;1;0;0;1;1;3087;0;3087;1;1;
/org.eclipse.jdt.ui/ui/org/eclipse/jdt/internal/ui/text/correction/ContributedProcessorDescriptor.java;3;0;9;1;1;1;1;8;47;1;8;1218;144;144;1;0;0;8;9;1218;0;6340;9;3;
/org.eclipse.debug.ui/ui/org/eclipse/debug/ui/actions/PopupInformationControl.java;4;0;13;2;1;1;1;12;212;2;10;3828;728;728;2;2;0;12;13;3828;2;5133;11;4;
/org.eclipse.ltk.core.refactoring/src/org/eclipse/ltk/core/refactoring/IUndoManager.java;1;1;9;1;6;6;6;3;14;1;3;4845;59;59;1;0;0;3;9;4845;0;6338;9;1;
/org.eclipse.webdav/src/kernel/org/eclipse/webdav/internal/kernel/ConditionTerm.java;1;0;2;1;2;1;2;0;26;0;0;5151;26;26;2;0;1;0;2;5151;1;5151;1;1;
/org.eclipse.pde.ui/src/org/eclipse/pde/internal/ui/preferences/BuildOptionsPreferenceNode.java;2;1;3;1;2;2;2;1;10;0;1;3986;14;14;1;0;0;1;3;3986;0;6336;3;2;
/org.eclipse.ui.workbench/Eclipse UI/org/eclipse/ui/internal/csm/roles/api/RoleNotDefinedException.java;1;0;3;1;0;0;0;3;2;2;2;2225;2;2;2;1;0;3;3;2238;1;2238;2;1;
/org.eclipse.jdt.ui/ui/org/eclipse/jdt/ui/actions/WriteReferencesSearchGroup.java;3;1;5;1;2;2;2;3;11;1;3;1350;24;24;1;0;0;3;5;1350;0;6340;5;3;
/org.eclipse.ui.examples.job/src/org/eclipse/ui/examples/jobs/actions/DebugJobManagerAction.java;1;0;1;1;1;1;1;0;0;0;0;5925;0;0;1;0;0;0;1;5925;0;5925;1;1;
/org.eclipse.text/src/org/eclipse/jface/text/templates/Template.java;2;1;5;1;2;2;2;3;103;2;2;4259;110;110;2;1;0;3;5;4627;1;6340;4;2;
/org.eclipse.ui.views/src/org/eclipse/ui/views/markers/BookmarkView.java;2;0;2;1;0;0;0;2;11;1;2;755;11;11;1;0;0;2;2;755;0;2738;2;2;
/org.eclipse.debug.ui/ui/org/eclipse/debug/internal/ui/actions/CopyToClipboardActionDelegate.java;2;0;2;1;0;0;0;2;84;1;2;2555;86;86;1;0;0;2;2;2555;0;2594;2;2;
/org.eclipse.ui.externaltools/Ant Editor/org/eclipse/ui/externaltools/internal/ant/editor/text/IXMLAnnotation.java;1;0;1;1;0;0;0;1;0;0;1;282;0;0;1;0;0;1;1;282;0;282;1;1;
/org.eclipse.team.ui/src/org/eclipse/team/internal/ui/sync/views/SyncFolder.java;1;0;1;1;0;0;0;1;0;0;1;550;0;0;1;0;0;1;1;550;0;550;1;1;
/org.eclipse.jdt.core.tests.model/workspace/JavaSearch/src/j1/JavadocValidRef.java;1;0;1;1;0;0;0;1;0;0;1;3081;0;0;1;0;0;1;1;3081;0;3081;1;1;
/org.eclipse.osgi/core/adaptor/org/eclipse/osgi/framework/adaptor/EventPublisher.java;4;1;4;1;2;2;2;2;4;1;2;3013;9;9;1;0;0;2;4;3013;0;6337;4;4;
/org.eclipse.ui.workbench/Eclipse UI/org/eclipse/ui/commands/AbstractHandlerService.java;1;0;2;1;0;0;0;2;0;1;2;1119;0;0;1;0;0;2;2;1119;0;1135;2;1;
/org.eclipse.search/search/org/eclipse/search/internal/ui/text/ReplaceDialog2.java;2;2;14;1;10;9;10;4;1102;1;4;4045;1446;1446;2;0;1;4;14;6238;1;6340;13;2;
/org.eclipse.jdt.ui.tests.refactoring/resources/TypeConstraints/A_testConstraints0.java;1;0;1;1;0;0;0;1;0;0;1;53;0;0;1;0;0;1;1;53;0;53;1;1;
/org.eclipse.swt/Eclipse SWT/photon/org/eclipse/swt/widgets/Control.java;7;1;26;1;5;5;5;21;75;2;20;0;302;302;2;1;0;21;26;823;1;6352;25;7;
/org.eclipse.jdt.core.tests.model/workspace/Formatter/test358/A_out.java;1;0;1;1;0;0;0;1;0;0;1;3087;0;0;1;0;0;1;1;3087;0;3087;1;1;
/org.eclipse.team.ui/src/org/eclipse/team/internal/ui/sync/ITeamNode.java;1;0;1;1;0;0;0;1;0;0;1;4216;0;0;1;0;0;1;1;4216;0;4216;1;1;
/org.eclipse.ui.ide/src/org/eclipse/ui/actions/NewExampleAction.java;2;0;4;1;0;0;0;4;19;1;4;1511;26;26;1;0;0;4;4;1511;0;2263;4;2;
/org.eclipse.ui.tests/Eclipse JFace Tests/org/eclipse/jface/tests/images/ImageRegistryTest.java;1;1;4;1;4;4;4;0;26;0;0;5613;37;37;1;0;0;0;4;5613;0;5685;4;1;
/org.eclipse.swt/Eclipse SWT PI/gtk/org/eclipse/swt/internal/gtk/GTypeQuery.java;1;0;2;1;0;0;0;2;0;1;2;1102;0;0;1;0;0;2;2;1102;0;1214;2;1;
/org.eclipse.core.runtime/src/org/eclipse/core/runtime/MultiStatus.java;3;0;6;1;1;1;1;5;280;1;5;1335;800;800;1;0;0;5;6;1335;0;5117;6;3;
/org.eclipse.ui.examples.javaeditor/Template Editor Example/org/eclipse/ui/examples/templateeditor/editors/ColorManager.java;2;0;2;1;1;1;1;1;10;0;1;4644;10;10;1;0;0;1;2;4644;0;6340;2;2;
/org.eclipse.ant.ui/Ant Editor/org/eclipse/ant/internal/ui/editor/text/AntEditorPartitionScanner.java;1;1;4;1;2;2;2;2;21;1;2;1811;39;39;1;0;0;2;4;1811;0;6027;4;1;
/org.eclipse.jdt.ui/core extension/org/eclipse/jdt/internal/corext/dom/TokenScanner.java;2;0;11;1;1;1;1;10;161;1;10;116;484;484;1;0;0;10;11;116;0;6340;11;2;
/org.eclipse.jdt.ui/core refactoring/org/eclipse/jdt/internal/corext/refactoring/typeconstraints/DefinesConstraint.java;1;0;3;1;0;0;0;3;3;1;3;42;3;3;1;0;0;3;3;42;0;64;3;1;
/org.eclipse.ui.externaltools/Ant Editor/org/eclipse/ui/externaltools/internal/ant/editor/text/PartiallySynchronizedDocument.java;1;0;1;1;0;0;0;1;0;0;1;282;0;0;1;0;0;1;1;282;0;282;1;1;
/org.eclipse.ui.ide/src/org/eclipse/ui/internal/dialogs/MultiStepConfigureWizardPage.java;2;0;3;1;0;0;0;3;12;1;3;1526;12;12;1;0;0;3;3;1526;0;2263;3;2;
/org.eclipse.jdt.ui.tests.refactoring/resources/ExtractMethodWorkSpace/ExtractMethodTests/return_in/A_test705.java;1;0;1;1;0;0;0;1;4;0;1;844;4;4;1;0;0;1;1;844;0;844;1;1;
/org.eclipse.jdt.core.tests.model/workspace/Converter/test0394/A.java;1;0;1;1;0;0;0;1;0;0;1;3714;0;0;1;0;0;1;1;3714;0;3714;1;1;
/org.eclipse.ui.cheatsheets/src/org/eclipse/ui/internal/cheatsheets/actions/CheatSheetMenu.java;2;1;6;2;2;2;2;4;32;2;3;4428;72;72;2;1;0;4;6;4625;1;5791;5;2;
/org.eclipse.core.resources/src/org/eclipse/core/internal/dtree/AbstractDataTree.java;1;0;2;1;2;1;2;0;590;0;0;5146;590;590;2;0;1;0;2;5146;1;5146;1;1;
/org.eclipse.jdt.ui.tests.refactoring/resources/DeleteSourceReferenceEdit/A_testField2_in.java;1;0;1;1;0;0;0;1;0;0;1;1652;0;0;1;0;0;1;1;1652;0;1652;1;1;
/org.eclipse.pde.build/src/org/eclipse/pde/internal/build/AbstractApplication.java;2;0;5;1;0;0;0;5;0;1;5;447;0;0;1;0;0;5;5;447;0;1113;5;2;
/org.eclipse.ui.workbench/Eclipse UI/org/eclipse/ui/internal/dialogs/NewWizardNewPage.java;5;1;22;1;5;5;5;17;665;3;14;2737;2223;2223;3;3;0;17;22;4512;3;6338;19;5;
/org.eclipse.search.tests/src/org/eclipse/search/core/tests/LongQuery.java;1;0;1;1;0;0;0;1;0;0;1;4345;0;0;1;0;0;1;1;4345;0;4345;1;1;
/org.eclipse.team.cvs.ui/src/org/eclipse/team/internal/ccvs/ui/operations/CheckoutOperation.java;2;0;10;1;1;1;1;9;65;1;9;276;166;166;1;0;0;9;10;276;0;6337;10;2;
/org.eclipse.jdt.core/compiler/org/eclipse/jdt/internal/compiler/ast/ParameterizedMethodDeclaration.java;1;0;1;1;0;0;0;1;0;0;1;2733;0;0;1;0;0;1;1;2733;0;2733;1;1;
/org.eclipse.jdt.ui/ui/org/eclipse/jdt/ui/actions/SortMembersAction.java;4;1;11;1;4;4;4;7;33;1;7;592;99;99;1;0;0;7;11;592;0;6340;11;4;
/org.eclipse.jdt.ui/ui/org/eclipse/jdt/internal/ui/text/java/ProposalInfo.java;1;0;1;1;1;1;1;0;2;0;0;6340;2;2;1;0;0;0;1;6340;0;6340;1;1;
/org.eclipse.pde.ui/src/org/eclipse/pde/internal/ui/wizards/exports/BaseExportWizardPage.java;3;1;17;1;5;5;5;12;474;1;12;1614;1163;1163;1;0;0;12;17;1614;0;6336;17;3;
/org.eclipse.search/search/org/eclipse/search/internal/ui/SearchPreferencePage.java;2;1;4;1;3;3;3;1;206;0;1;2543;227;227;1;0;0;1;4;2543;0;6340;4;2;
/org.eclipse.update.scheduler/src/org/eclipse/update/internal/scheduler/AutomaticUpdatesJob.java;3;1;23;2;4;4;4;19;72;2;16;979;285;285;2;3;0;19;23;979;3;6336;20;3;
/org.eclipse.core.filebuffers/src/org/eclipse/core/internal/filebuffers/IElementStateListener2.java;1;0;2;1;0;0;0;2;0;1;2;1522;0;0;1;0;0;2;2;1522;0;1574;2;1;
/org.eclipse.ui.workbench/Eclipse UI/org/eclipse/ui/internal/presentation/ColorUtils.java;1;0;2;1;0;0;0;2;0;1;2;4237;0;0;1;0;0;2;2;4237;0;4392;2;1;
/org.eclipse.ant.ui/Ant Tools Support/org/eclipse/ant/ui/internal/launchConfigurations/AntClasspathTab.java;1;0;10;1;0;0;0;10;33;2;8;250;112;112;2;2;0;10;10;262;2;1811;8;1;
/org.eclipse.search/search/org/eclipse/search/internal/ui/text/FileTreeContentProvider.java;2;0;5;1;1;1;1;4;94;1;4;3711;108;108;1;0;0;4;5;3711;0;6340;5;2;
/org.eclipse.core.runtime/src/org/eclipse/core/runtime/IProductProvider.java;1;0;3;1;1;1;1;2;4;1;2;4035;6;6;1;0;0;2;3;4035;0;5117;3;1;
/org.eclipse.ui.workbench/Eclipse UI/org/eclipse/ui/progress/DeferredTreeContentManager.java;2;3;30;2;10;7;10;20;279;3;16;1061;1023;1023;3;4;3;20;30;1074;7;6338;23;2;
/org.eclipse.jdt.ui.tests.refactoring/resources/ChangeTypeRefactoring/positive/A_testParameterDeclWithOverride_out.java;1;0;1;1;0;0;0;1;0;0;1;2844;0;0;1;0;0;1;1;2844;0;2844;1;1;
/org.eclipse.core.runtime/src/org/eclipse/core/runtime/model/URLModel.java;1;0;1;1;0;0;0;1;0;0;1;3013;0;0;1;0;0;1;1;3013;0;3013;1;1;
/org.eclipse.swt/Eclipse SWT PI/gtk/org/eclipse/swt/internal/gtk/GdkGCValues.java;3;0;4;1;1;1;1;3;17;1;3;1653;31;31;1;0;0;3;4;1653;0;6352;4;3;
/org.eclipse.ui.intro/src/org/eclipse/ui/internal/intro/impl/model/viewer/IntroModelLabelProvider.java;1;2;7;1;7;6;7;0;24;0;0;5115;55;55;2;0;1;0;7;5314;1;5700;6;1;
/org.eclipse.jdt.core.tests.model/workspace/Converter/src/test0191/Test.java;1;0;1;1;0;0;0;1;0;0;1;3714;0;0;1;0;0;1;1;3714;0;3714;1;1;
/org.eclipse.jdt.core.tests.model/workspace/Formatter/test141/A_out.java;1;0;1;1;0;0;0;1;0;0;1;2425;0;0;1;0;0;1;1;2425;0;2425;1;1;
/org.eclipse.team.tests.cvs.core/src/org/eclipse/team/tests/ccvs/core/subscriber/CVSCompareSubscriberTest.java;1;0;3;1;1;1;1;2;105;1;2;4168;107;107;1;0;0;2;3;4168;0;6337;3;1;
/org.eclipse.ui.workbench/Eclipse UI/org/eclipse/ui/internal/Workbench.java;8;2;180;4;16;15;16;164;1603;8;97;516;11089;11089;8;67;1;164;180;2780;68;6338;112;8;
/org.eclipse.jdt.core.tests.model/workspace/Converter/src/test0440/A.java;1;0;1;1;0;0;0;1;0;0;1;3714;0;0;1;0;0;1;1;3714;0;3714;1;1;
/org.eclipse.jdt.launching/launching/org/eclipse/jdt/launching/sourcelookup/IJavaSourceLocation.java;2;0;2;1;1;1;1;1;8;0;1;5063;12;12;1;0;0;1;2;5063;0;6336;2;2;
/org.eclipse.jdt.core.tests.model/workspace/Converter/src/javadoc/testBug63044/Test.java;1;0;1;1;1;1;1;0;0;0;0;5853;0;0;1;0;0;0;1;5853;0;5853;1;1;
/org.eclipse.ui.views/src/org/eclipse/ui/views/internal/markers/LineNumber.java;1;0;2;1;0;0;0;2;0;1;2;265;0;0;1;0;0;2;2;265;0;749;2;1;
/org.eclipse.swt/Eclipse SWT PI/win32/org/eclipse/swt/internal/win32/OSVERSIONINFO.java;2;0;2;1;0;0;0;2;8;1;2;957;9;9;1;0;0;2;2;957;0;2915;2;2;
/org.eclipse.jdt.debug/model/org/eclipse/jdt/internal/debug/core/logicalstructures/CompositeStructureType.java;1;0;1;1;0;0;0;1;0;0;1;2709;0;0;1;0;0;1;1;2709;0;2709;1;1;
/org.eclipse.jdt.core.tests.model/workspace/Formatter/test249/A_in.java;1;0;1;1;0;0;0;1;0;0;1;2442;0;0;1;0;0;1;1;2442;0;2442;1;1;
/org.eclipse.jdt.core/compiler/org/eclipse/jdt/internal/compiler/impl/ITypeRequestor.java;1;0;1;1;0;0;0;1;2;0;1;3560;2;2;1;0;0;1;1;3560;0;3560;1;1;
/org.eclipse.jdt.core.tests.model/workspace/Converter/src/test0013/Test.java;1;0;1;1;0;0;0;1;0;0;1;3714;0;0;1;0;0;1;1;3714;0;3714;1;1;
/org.eclipse.pde.ui/src_Forms/org/eclipse/pde/internal/ui/neweditor/plugin/ReferenceAttributeRow.java;1;0;2;1;0;0;0;2;0;1;2;3834;0;0;1;0;0;2;2;3834;0;4354;2;1;
/org.eclipse.osgi/core/framework/org/eclipse/osgi/framework/internal/core/KeyedElement.java;4;1;4;1;2;2;2;2;6;1;2;3013;14;14;1;0;0;2;4;3013;0;6337;4;4;
/org.eclipse.ui.workbench/Eclipse UI/org/eclipse/ui/internal/EditorsLabelProvider.java;3;0;3;1;0;0;0;3;39;1;3;2620;39;39;1;0;0;3;3;2620;0;4521;3;3;
/org.eclipse.jdt.ui.tests.refactoring/resources/ExtractInterface/testConditional2/out/A.java;1;0;1;1;0;0;0;1;0;0;1;3902;0;0;1;0;0;1;1;3902;0;3902;1;1;
/org.eclipse.ui.workbench/Eclipse UI/org/eclipse/ui/internal/roles/api/IRoleRegistryEvent.java;1;0;2;1;0;0;0;2;0;1;2;1952;0;0;1;0;0;2;2;1952;0;2199;2;1;
/org.eclipse.jdt.ui/ui/org/eclipse/jdt/internal/ui/preferences/ZipTreeNode.java;1;0;2;1;0;0;0;2;333;1;2;1242;333;333;1;0;0;2;2;1242;0;1652;2;1;
/org.eclipse.ui.workbench/Eclipse UI/org/eclipse/ui/internal/PartSashContainer.java;6;1;22;1;11;11;11;11;223;3;9;3828;1108;1108;3;2;0;11;22;4807;2;6338;20;6;
/org.eclipse.ui.workbench/Eclipse UI/org/eclipse/ui/internal/contexts/AbstractContextRegistry.java;1;0;7;1;0;0;0;7;52;2;5;1400;86;86;2;2;0;7;7;1400;2;3066;5;1;
/org.eclipse.team.ui/src/org/eclipse/team/ui/synchronize/subscriber/SubscriberParticipantPage.java;2;0;9;2;0;0;0;9;309;2;7;4047;389;389;2;2;0;9;9;4240;2;4585;7;2;
/org.eclipse.ui.workbench/Eclipse UI/org/eclipse/ui/internal/dialogs/MessageDialogWithToggle.java;1;0;1;1;0;0;0;1;0;0;1;2737;0;0;1;0;0;1;1;2737;0;2737;1;1;
/org.eclipse.team.cvs.ui/src/org/eclipse/team/internal/ccvs/ui/subscriber/SubscriberUpdateMergeAction.java;1;0;1;1;0;0;0;1;0;0;1;688;0;0;1;0;0;1;1;688;0;688;1;1;
/org.eclipse.ui.ide/extensions/org/eclipse/ui/actions/OpenResourceAction.java;1;0;1;1;0;0;0;1;0;0;1;2263;0;0;1;0;0;1;1;2263;0;2263;1;1;
/org.eclipse.jdt.ui.tests.refactoring/resources/DeleteSourceReference/test2/in/A.java;1;0;1;1;0;0;0;1;0;0;1;1652;0;0;1;0;0;1;1;1652;0;1652;1;1;
/org.eclipse.osgi/defaultAdaptor/src/org/eclipse/osgi/framework/internal/defaultadaptor/BundleEntry.java;3;0;5;1;0;0;0;5;66;1;5;3013;139;139;1;0;0;5;5;3013;0;4336;5;3;
/org.eclipse.swt/Eclipse SWT/photon/org/eclipse/swt/widgets/Widget.java;3;1;12;1;2;2;2;10;114;2;9;249;432;432;2;1;0;10;12;2208;1;6352;11;3;
/org.eclipse.jdt.ui/ui/org/eclipse/jdt/internal/ui/preferences/CompilerPreferencePage.java;1;0;1;1;1;1;1;0;2;0;0;6340;2;2;1;0;0;0;1;6340;0;6340;1;1;
/org.eclipse.team.webdav/src/org/eclipse/team/internal/ui/target/subscriber/DeploymentWizard.java;2;2;10;1;5;4;5;5;160;1;5;3805;261;261;2;0;1;5;10;5358;1;6337;9;2;
/org.eclipse.jdt.ui.tests.refactoring/resources/ExtractMethodWorkSpace/ExtractMethodTests/expression_out/A_test620.java;1;0;4;1;0;0;0;4;4;1;4;130;5;5;1;0;0;4;4;130;0;1474;4;1;
/org.eclipse.pde.core/src_OSGi/org/eclipse/pde/internal/core/osgi/bundle/BundleModel.java;2;0;8;1;0;0;0;8;102;2;7;2229;140;140;2;1;0;8;8;2537;1;4203;7;2;
/org.eclipse.webdav/src/kernel/org/eclipse/webdav/internal/kernel/Precondition.java;1;0;2;1;2;1;2;0;46;0;0;5151;46;46;2;0;1;0;2;5151;1;5151;1;1;
/org.eclipse.team.ui/src/org/eclipse/team/internal/ui/jobs/RefreshEvent.java;1;0;1;1;0;0;0;1;0;0;1;3228;0;0;1;0;0;1;1;3228;0;3228;1;1;
/org.eclipse.jdt.ui/ui/org/eclipse/jdt/ui/search/IQueryParticipant.java;4;2;8;2;7;4;7;1;41;0;1;5075;69;69;2;0;3;1;8;5176;3;6334;5;4;
/org.eclipse.jdt.ui.tests.refactoring/resources/ExtractInterface/test98/out/Bar.java;1;0;1;1;0;0;0;1;0;0;1;1571;0;0;1;0;0;1;1;1571;0;1571;1;1;
/org.eclipse.pde.ui/src/org/eclipse/pde/internal/ui/editor/schema/TypeRestrictionDialog.java;2;1;3;1;2;2;2;1;6;0;1;648;13;13;1;0;0;1;3;648;0;6336;3;2;
/org.eclipse.jdt.core.tests.model/workspace/Formatter/test277/A_in.java;1;0;1;1;0;0;0;1;0;0;1;2443;0;0;1;0;0;1;1;2443;0;2443;1;1;
/org.eclipse.ui.intro/src/org/eclipse/ui/intro/internal/model/IntroHTML.java;1;0;6;1;1;1;1;5;168;1;5;4429;218;218;1;0;0;5;6;4429;0;5115;6;1;
/org.eclipse.ui.workbench/Eclipse UI/org/eclipse/ui/contexts/IMutableContextManager.java;3;0;9;1;1;1;1;8;28;3;5;3066;38;38;3;3;0;8;9;4949;3;5273;6;3;
/org.eclipse.jdt.core.tests.model/workspace/Converter/test0349/Test2.java;1;0;1;1;0;0;0;1;0;0;1;3714;0;0;1;0;0;1;1;3714;0;3714;1;1;
/org.eclipse.ltk.ui.refactoring/src/org/eclipse/ltk/ui/refactoring/RefactoringStatusDialog.java;1;0;2;1;0;0;0;2;0;1;2;4965;0;0;1;0;0;2;2;4965;0;4988;2;1;
/org.eclipse.releng.basebuilder/plugins/org.eclipse.build.tools/org.eclipse.build.tools/src/org/eclipse/releng/CompileErrorCheck.java;1;0;1;1;1;1;1;0;0;0;0;5735;0;0;1;0;0;0;1;5735;0;5735;1;1;
/org.eclipse.swt/Eclipse SWT PI/win32/org/eclipse/swt/internal/win32/NOTIFYICONDATA.java;3;0;3;2;1;1;1;2;28;0;1;4450;34;34;2;1;0;2;3;4450;1;6352;2;3;
/org.eclipse.jdt.ui/ui refactoring/org/eclipse/jdt/internal/ui/refactoring/ExtractTempWizard.java;4;1;7;1;2;2;2;5;143;1;5;518;182;182;1;0;0;5;7;518;0;6340;7;4;
/org.eclipse.pde.ui/src/org/eclipse/pde/internal/ui/wizards/templates/PerspectiveExtensionsTemplate.java;3;1;4;1;2;2;2;2;118;1;2;2184;127;127;1;0;0;2;4;2184;0;6336;4;3;
/org.eclipse.team.core/src/org/eclipse/team/internal/core/DefaultProjectSetCapability.java;1;0;2;1;0;0;0;2;26;1;2;4857;26;26;1;0;0;2;2;4857;0;4968;2;1;
/org.eclipse.swt/Eclipse SWT/emulated/treetable/org/eclipse/swt/widgets/Tree.java;5;1;10;1;7;7;7;3;19;1;3;269;86;86;1;0;0;3;10;269;0;6352;10;5;
/org.eclipse.jdt.ui/ui/org/eclipse/jdt/internal/ui/javaeditor/ClassFileMarkerRulerAction.java;1;0;1;1;1;1;1;0;2;0;0;6340;2;2;1;0;0;0;1;6340;0;6340;1;1;
/org.eclipse.jdt.ui/core extension/org/eclipse/jdt/internal/corext/dom/ListRewriteEvent.java;1;0;9;1;1;1;1;8;150;1;8;2505;348;348;1;0;0;8;9;2505;0;5406;9;1;
/org.eclipse.ui.workbench/Eclipse UI/org/eclipse/ui/internal/dialogs/ResourceTreeAndListGroup.java;1;0;1;1;0;0;0;1;0;0;1;2737;0;0;1;0;0;1;1;2737;0;2737;1;1;
/org.eclipse.jdt.ui/core refactoring/org/eclipse/jdt/internal/corext/refactoring/participants/xml/SystemTestExpression.java;1;0;2;1;0;0;0;2;0;1;2;4091;0;0;1;0;0;2;2;4091;0;4108;2;1;
/org.eclipse.ui.workbench/Eclipse UI/org/eclipse/ui/internal/gestures/Point.java;1;0;3;1;0;0;0;3;18;1;3;1721;32;32;1;0;0;3;3;1721;0;2824;3;1;
/org.eclipse.jdt.ui.tests.refactoring/test cases/org/eclipse/jdt/ui/tests/refactoring/ExtractConstantTests.java;4;0;12;1;1;1;1;11;32;1;11;130;99;99;1;0;0;11;12;130;0;6340;12;4;
/org.eclipse.pde.ui/srcnew/org/eclipse/pde/internal/ui/editor/manifest/XMLOutlinePage.java;1;0;1;1;0;0;0;1;0;0;1;2320;0;0;1;0;0;1;1;2320;0;2320;1;1;
/org.eclipse.jdt.ui.tests.refactoring/resources/ChangeTypeRefactoring/positive/A_testParameterName_in.java;1;0;1;1;0;0;0;1;0;0;1;2844;0;0;1;0;0;1;1;2844;0;2844;1;1;
/org.eclipse.swt.graphics.text/Examples/examples/PreDefinedLayouts.java;1;0;3;1;0;0;0;3;72;1;3;2937;92;92;1;0;0;3;3;2937;0;3172;3;1;
/org.eclipse.pde.ui/src/org/eclipse/pde/internal/ui/build/BuildSiteOperation.java;1;0;2;1;0;0;0;2;0;1;2;3840;0;0;1;0;0;2;2;3840;0;5044;2;1;
/org.eclipse.jdt.core/codeassist/org/eclipse/jdt/internal/codeassist/complete/CompletionOnMethodTypeParameter.java;1;0;1;1;0;0;0;1;0;0;1;4964;0;0;1;0;0;1;1;4964;0;4964;1;1;
/org.eclipse.swt/Eclipse SWT PI/gtk1x/org/eclipse/swt/internal/gtk/GtkCheckMenuItem.java;1;0;1;1;0;0;0;1;0;0;1;2327;0;0;1;0;0;1;1;2327;0;2327;1;1;
/org.eclipse.team.ui/src/org/eclipse/team/internal/ui/sync/views/SyncViewerSorter.java;2;0;7;1;0;0;0;7;40;1;7;488;93;93;1;0;0;7;7;488;0;2632;7;2;
/org.eclipse.jdt.core/compiler/org/eclipse/jdt/internal/compiler/lookup/ProblemBinding.java;1;0;1;1;0;0;0;1;2;0;1;3560;2;2;1;0;0;1;1;3560;0;3560;1;1;
/org.eclipse.swt/Eclipse SWT/win32/org/eclipse/swt/graphics/Color.java;1;1;2;1;2;2;2;0;5;0;0;5597;9;9;1;0;0;0;2;5597;0;6352;2;1;
/org.eclipse.jdt.core/model/org/eclipse/jdt/internal/core/builder/ClasspathLocation.java;3;0;4;2;0;0;0;4;4;2;3;1892;10;10;2;1;0;4;4;1892;1;4887;3;3;
/org.eclipse.ui.intro/src/org/eclipse/ui/intro/internal/model/viewer/IntroModelLabelProvider.java;1;0;5;1;1;1;1;4;179;1;4;4429;219;219;1;0;0;4;5;4429;0;5115;5;1;
/org.eclipse.ui.ide/extensions/org/eclipse/ui/dialogs/WizardNewProjectCreationPage.java;1;0;1;1;0;0;0;1;0;0;1;2263;0;0;1;0;0;1;1;2263;0;2263;1;1;
/org.eclipse.jdt.debug.ui/ui/org/eclipse/jdt/internal/debug/core/refactoring/JavaMethodBreakpointIMethodRenameParticipant.java;3;0;3;1;1;1;1;2;35;1;2;4895;50;50;1;0;0;2;3;4895;0;6339;3;3;
/org.eclipse.jface.text/src/org/eclipse/jface/text/presentation/IPresentationReconcilerExtension.java;3;1;3;1;2;2;2;1;20;0;1;1511;24;24;1;0;0;1;3;1511;0;6352;3;3;
/org.eclipse.jface.text/src/org/eclipse/jface/internal/text/link/contentassist/Helper2.java;2;0;2;1;1;1;1;1;2;0;1;4214;2;2;1;0;0;1;2;4214;0;6340;2;2;
/org.eclipse.team.webdav/src/org/eclipse/team/internal/ui/target/DiscardSiteAction.java;2;0;4;1;1;1;1;3;101;1;3;2495;116;116;1;0;0;3;4;2495;0;6337;4;2;
/org.eclipse.ui.workbench/Eclipse UI/org/eclipse/ui/internal/roles/ActivityBinding.java;1;0;4;1;0;0;0;4;23;1;4;2444;31;31;1;0;0;4;4;2444;0;2867;4;1;
/org.eclipse.jface.text/src/org/eclipse/jface/text/IEventConsumer.java;2;1;3;1;2;2;2;1;21;0;1;2262;25;25;1;0;0;1;3;2262;0;6359;3;2;
/org.eclipse.pde.ui/src/org/eclipse/pde/internal/ui/wizards/convert/MigratePluginWizardPage.java;1;0;2;1;0;0;0;2;5;0;1;3839;5;5;2;1;0;2;2;3839;1;3839;1;1;
/org.eclipse.jface.text/src/org/eclipse/jface/text/reconciler/MonoReconciler.java;2;2;4;1;3;2;3;1;19;0;1;1511;23;23;2;0;1;1;4;6353;1;6353;3;2;
/org.eclipse.jdt.core/model/org/eclipse/jdt/internal/core/CompilationUnitProblemFinder.java;4;1;17;1;2;2;2;15;69;1;15;130;160;160;1;0;0;15;17;130;0;5916;17;4;
/org.eclipse.jdt.ui/ui/org/eclipse/jdt/ui/actions/OpenJavaPerspectiveAction.java;1;0;1;1;1;1;1;0;2;0;0;6340;2;2;1;0;0;0;1;6340;0;6340;1;1;
/org.eclipse.jdt.ui/ui/org/eclipse/jdt/internal/ui/filters/OutputFolderFilter.java;2;1;3;1;2;2;2;1;4;0;1;2909;6;6;1;0;0;1;3;2909;0;6340;3;2;
/org.eclipse.team.ui/src/org/eclipse/team/internal/ui/sync/views/StatisticsPanel.java;1;0;6;1;0;0;0;6;162;2;5;1896;322;322;2;1;0;6;6;1956;1;2632;5;1;
/org.eclipse.debug.core/core/org/eclipse/debug/internal/core/BreakpointManager.java;4;2;12;2;6;5;6;6;84;1;6;243;196;196;2;0;1;6;12;5475;1;5621;11;4;
/org.eclipse.jdt.ui/ui/org/eclipse/jdt/internal/ui/javadocexport/JavadocWriter.java;2;0;4;1;1;1;1;3;47;1;3;2452;97;97;1;0;0;3;4;2452;0;6340;4;2;
/org.eclipse.ui.workbench/Eclipse UI/org/eclipse/ui/internal/csm/roles/api/IRoleEvent.java;1;0;4;1;0;0;0;4;21;2;3;2213;23;23;2;1;0;4;4;2238;1;2238;3;1;
/org.eclipse.jdt.core.tests.model/workspace/Formatter/test375/A_out.java;1;0;2;1;0;0;0;2;1;1;2;3146;1;1;1;0;0;2;2;3146;0;3172;2;1;
/org.eclipse.ui.workbench.texteditor/src/org/eclipse/ui/internal/texteditor/AnnotationExpandHover.java;3;1;7;1;4;4;4;3;281;1;3;2544;419;419;1;0;0;3;7;2544;0;6340;7;3;
/org.eclipse.swt/Eclipse SWT Accessibility/common/org/eclipse/swt/accessibility/AccessibleTextAdapter.java;1;0;1;1;0;0;0;1;0;0;1;2244;0;0;1;0;0;1;1;2244;0;2244;1;1;
/org.eclipse.jdt.core/compiler/org/eclipse/jdt/internal/compiler/lookup/WildcardBinding.java;1;0;1;1;0;0;0;1;0;0;1;4759;0;0;1;0;0;1;1;4759;0;4759;1;1;
/org.eclipse.search.tests/src/org/eclipse/search/tests/SearchTestPlugin.java;1;1;3;1;2;2;2;1;14;0;1;4345;15;15;1;0;0;1;3;4345;0;5815;3;1;
/org.eclipse.ui.externaltools/External Tools Base/org/eclipse/ui/externaltools/internal/launchConfigurations/WorkingSetComparator.java;2;1;5;1;2;2;2;3;44;1;3;367;61;61;1;0;0;3;5;367;0;6336;5;2;
/org.eclipse.jdt.ui.tests.refactoring/resources/InlineMethodWorkspace/TestCases/argument_out/TestParameterNameUnused1.java;1;0;1;1;0;0;0;1;4;0;1;845;4;4;1;0;0;1;1;845;0;845;1;1;
/org.eclipse.text/src/org/eclipse/text/edits/TreeIterationInfo.java;2;0;2;1;1;1;1;1;2;0;1;1986;2;2;1;0;0;1;2;1986;0;6340;2;2;
/org.eclipse.jdt.core/model/org/eclipse/jdt/internal/compiler/IDocumentElementRequestor.java;2;0;2;1;1;1;1;1;2;0;1;4461;2;2;1;0;0;1;2;4461;0;5916;2;2;
/org.eclipse.ui.ide/src/org/eclipse/ui/wizards/datatransfer/SelectFilesOperation.java;1;0;1;1;0;0;0;1;0;0;1;1511;0;0;1;0;0;1;1;1511;0;1511;1;1;
/org.eclipse.ui.ide/src/org/eclipse/ui/views/framelist/ForwardAction.java;3;0;4;1;1;1;1;3;4;1;3;2208;9;9;1;0;0;3;4;2208;0;6338;4;3;
/org.eclipse.core.runtime/src/org/eclipse/core/runtime/registry/IExtension.java;4;0;6;2;0;0;0;6;167;2;5;2105;341;341;2;1;0;6;6;3164;1;3164;5;4;
/org.eclipse.jdt.core.tests.model/src/org/eclipse/jdt/core/tests/dom/ASTConverterJavadocTest.java;4;2;33;2;10;9;10;23;954;3;20;3762;4919;4919;3;3;1;23;33;4639;4;6100;29;4;
/org.eclipse.jdt.core.tests.model/workspace/Formatter/test049/A_out.java;1;0;1;1;0;0;0;1;0;0;1;2425;0;0;1;0;0;1;1;2425;0;2425;1;1;
/org.eclipse.jdt.core.tests.model/workspace/Converter/test0310/Test.java;1;0;1;1;0;0;0;1;0;0;1;3714;0;0;1;0;0;1;1;3714;0;3714;1;1;
/org.eclipse.jdt.ui/ui/org/eclipse/jdt/ui/text/spelling/engine/PersistentSpellDictionary.java;1;0;2;1;0;0;0;2;0;1;2;3829;0;0;1;0;0;2;2;3829;0;3930;2;1;
/org.eclipse.jdt.debug/eval/org/eclipse/jdt/internal/debug/eval/ast/instructions/Cast.java;1;0;1;1;0;0;0;1;5;0;1;1240;5;5;1;0;0;1;1;1240;0;1240;1;1;
/org.eclipse.ui.workbench/Eclipse UI/org/eclipse/ui/internal/csm/roles/api/IRoleRegistryListener.java;1;0;2;1;0;0;0;2;0;1;2;2213;0;0;1;0;0;2;2;2213;0;2225;2;1;
/org.eclipse.jdt.ui/ui/org/eclipse/jdt/internal/ui/text/link/LinkedEnvironment.java;1;0;8;1;0;0;0;8;580;2;7;2838;852;852;2;1;0;8;8;3166;1;4214;7;1;
/org.eclipse.team.cvs.core/src/org/eclipse/team/internal/ccvs/core/client/listeners/CompareDiffListener.java;2;0;4;1;1;1;1;3;118;1;3;2478;139;139;1;0;0;3;4;2478;0;6337;4;2;
/org.eclipse.webdav/src/client/org/eclipse/webdav/client/PropertyStatus.java;1;0;2;1;2;1;2;0;98;0;0;5151;98;98;2;0;1;0;2;5151;1;5151;1;1;
/org.eclipse.ui.ide/src/org/eclipse/ui/internal/ide/model/WorkbenchRootResource.java;3;1;4;1;2;2;2;2;4;1;2;2264;7;7;1;0;0;2;4;2264;0;6338;4;3;
/org.eclipse.pde.ui/src/org/eclipse/pde/internal/ui/editor/manifest/XMLOutlinePageContentProvider.java;1;0;3;1;1;1;1;2;2;1;2;2320;2;2;1;0;0;2;3;2320;0;5431;3;1;
/org.eclipse.ui.ide/src/org/eclipse/ui/internal/ide/IDEWorkbenchAdviser.java;4;0;30;2;0;0;0;30;225;4;21;1512;857;857;4;9;0;30;30;2785;9;2901;21;4;
/org.eclipse.jdt.core/compiler/org/eclipse/jdt/internal/compiler/parser/RecoveredStatement.java;3;0;4;1;0;0;0;4;4;1;4;991;12;12;1;0;0;4;4;991;0;3560;4;3;
/org.eclipse.core.tests.resources/src/org/eclipse/core/tests/resources/MarkerTest.java;1;2;5;1;4;3;4;1;3383;0;1;5058;3494;3494;2;0;1;1;5;5147;1;5686;4;1;
/org.eclipse.ui.ide/src/org/eclipse/ui/views/markers/internal/ActionDeleteCompleted.java;6;1;8;1;2;2;2;6;30;2;5;2208;41;41;2;1;0;6;8;3260;1;6338;7;6;
/org.eclipse.ui.workbench/Eclipse UI/org/eclipse/ui/internal/dialogs/DecoratorsPreferencePage.java;2;0;3;1;0;0;0;3;28;1;3;1216;37;37;1;0;0;3;3;1216;0;2737;3;2;
/org.eclipse.jface.text/src/org/eclipse/jface/text/DefaultInformationControl.java;2;1;11;1;3;3;3;8;166;1;8;1347;275;275;1;0;0;8;11;1347;0;6359;11;2;
/org.eclipse.jdt.debug.ui/ui/org/eclipse/jdt/internal/debug/ui/launcher/IClasspathViewer.java;2;0;3;1;1;1;1;2;86;1;2;2691;105;105;1;0;0;2;3;2691;0;6339;3;2;
/org.eclipse.jdt.ui/core refactoring/org/eclipse/jdt/internal/corext/refactoring/participants/xml/TestExpression.java;1;0;8;1;0;0;0;8;139;1;8;2204;186;186;1;0;0;8;8;2204;0;4108;8;1;
/org.eclipse.jdt.core.tests.model/workspace/Encoding/src2/testUTF8BOM/Test.java;1;0;1;1;1;1;1;0;0;0;0;6218;0;0;1;0;0;0;1;6218;0;6218;1;1;
/org.eclipse.jface.text/src/org/eclipse/jface/text/source/VisualAnnotationModel.java;2;1;6;1;2;2;2;4;49;1;4;1334;71;71;1;0;0;4;6;1334;0;6361;6;2;
/org.eclipse.jdt.core.tests.model/workspace/Converter/src/test0142/Test.java;1;0;1;1;0;0;0;1;0;0;1;3714;0;0;1;0;0;1;1;3714;0;3714;1;1;
/org.eclipse.ui.ide/src/org/eclipse/ui/internal/ide/StatusUtil.java;4;1;4;1;3;3;3;1;10;0;1;1512;17;17;1;0;0;1;4;1512;0;6338;4;4;
/org.eclipse.jdt.core.tests.model/workspace/Converter/src/test0082/Test.java;1;0;1;1;0;0;0;1;0;0;1;3714;0;0;1;0;0;1;1;3714;0;3714;1;1;
/org.eclipse.jdt.ui/ui/org/eclipse/jdt/ui/text/spelling/engine/DefaultSpellChecker.java;1;0;2;1;0;0;0;2;0;1;2;3829;0;0;1;0;0;2;2;3829;0;3930;2;1;
/org.eclipse.jdt.ui/ui/org/eclipse/jdt/internal/ui/preferences/SourceAttachmentPropertyPage.java;3;1;4;1;3;3;3;1;37;0;1;597;77;77;1;0;0;1;4;597;0;6340;4;3;
/org.eclipse.core.tests.runtime/src/org/eclipse/core/tests/internal/plugins/PluginResolveTest_1.java;1;0;1;1;0;0;0;1;0;0;1;3014;0;0;1;0;0;1;1;3014;0;3014;1;1;
/org.eclipse.jdt.debug/model/org/eclipse/jdt/internal/debug/core/breakpoints/JavaClassPrepareBreakpoint.java;2;0;2;1;0;0;0;2;15;1;2;4525;15;15;1;0;0;2;2;4525;0;4855;2;2;
/org.eclipse.sdk.tests-feature/plugins/org.eclipse.perfmsr.ui.client/src/org/eclipse/perfmsr/ui/client/ClientUIPlugin.java;1;1;4;1;4;4;4;0;57;0;0;5443;68;68;1;0;0;0;4;5443;0;5803;4;1;
/org.eclipse.team.core/src/org/eclipse/team/core/subscribers/TeamSubscriberFactory.java;1;0;3;1;0;0;0;3;64;1;3;770;64;64;1;0;0;3;3;770;0;2632;3;1;
/org.eclipse.jdt.core.tests.model/workspace/Converter/test0105/Test.java;1;0;1;1;0;0;0;1;0;0;1;3714;0;0;1;0;0;1;1;3714;0;3714;1;1;
/org.eclipse.jdt.core.tests.model/workspace/Converter/src/javadoc/testBug55221/a/Test.java;2;0;3;2;0;0;0;3;0;0;1;4639;0;0;3;2;0;3;3;4639;2;4639;1;2;
/org.eclipse.jdt.ui.tests.refactoring/resources/Delete/testDeleteWithinCu2/out/A.java;1;0;1;1;0;0;0;1;0;0;1;442;0;0;1;0;0;1;1;442;0;442;1;1;
/org.eclipse.team.tests.core/src/org/eclipse/team/tests/core/AllTargetTests.java;1;0;1;1;0;0;0;1;0;0;1;2495;0;0;1;0;0;1;1;2495;0;2495;1;1;
/org.eclipse.jdt.ui.tests.refactoring/resources/RenameVirtualMethodInClass/test38/in/A.java;1;0;1;1;1;1;1;0;0;0;0;5453;0;0;1;0;0;0;1;5453;0;5453;1;1;
/org.eclipse.pde.ui/srcnew/org/eclipse/pde/internal/ui/editor/manifest/SynchronizedStorageDocumentProvider.java;1;0;1;1;0;0;0;1;0;0;1;2320;0;0;1;0;0;1;1;2320;0;2320;1;1;
/org.eclipse.osgi/osgi/src/org/osgi/framework/Constants.java;5;2;17;1;6;5;6;11;322;2;10;3013;723;723;2;1;1;11;17;4494;2;5590;15;5;
/org.eclipse.update.core/src/org/eclipse/update/internal/core/SiteFilePackedPluginContentConsumer.java;2;0;3;1;2;1;2;1;19;0;1;4332;19;19;2;0;1;1;3;5664;1;5664;2;2;
/org.eclipse.jdt.ui/core refactoring/org/eclipse/jdt/internal/corext/refactoring/reorg/IReorgQueries.java;3;1;3;1;2;2;2;1;6;0;1;1114;10;10;1;0;0;1;3;1114;0;6340;3;3;
/org.eclipse.jdt.core.tests.model/workspace/Converter/src/test0134/Test.java;1;0;1;1;0;0;0;1;0;0;1;3714;0;0;1;0;0;1;1;3714;0;3714;1;1;
/org.eclipse.jdt.ui/ui/org/eclipse/jdt/internal/ui/browsing/JavaBrowsingPart.java;6;1;17;2;3;3;3;14;89;3;12;644;301;301;3;2;0;14;17;1386;2;6340;15;6;
/org.eclipse.team.core/src/org/eclipse/team/core/TeamStatus.java;2;1;4;1;2;2;2;2;49;1;2;4043;59;59;1;0;0;2;4;4043;0;6336;4;2;
/org.eclipse.jdt.ui.tests.refactoring/resources/InlineMethodWorkspace/TestCases/cast_out/TestNoCast.java;1;0;2;1;1;1;1;1;2;0;1;1671;2;2;1;0;0;1;2;1671;0;5750;2;1;
/org.eclipse.pde.runtime/src/org/eclipse/pde/internal/runtime/logview/EventPropertiesDialog.java;1;0;2;1;0;0;0;2;0;1;2;3621;0;0;1;0;0;2;2;3621;0;3630;2;1;
/org.eclipse.swt/Eclipse SWT Custom Widgets/common/org/eclipse/swt/custom/SashForm.java;4;1;9;1;2;2;2;7;51;2;6;125;161;161;2;1;0;7;9;2462;1;6352;8;4;
/org.eclipse.jdt.core.tests.model/src/org/eclipse/jdt/core/tests/rewrite/describing/StringAsserts.java;1;0;1;1;0;0;0;1;0;0;1;4711;0;0;1;0;0;1;1;4711;0;4711;1;1;
/org.eclipse.core.runtime.osgi/src/org/eclipse/core/internal/boot/PlatformURLConnection.java;1;0;2;1;0;0;0;2;43;1;2;3013;43;43;1;0;0;2;2;3013;0;3028;2;1;
/org.eclipse.pde.ui/src/org/eclipse/pde/internal/ui/codegen/PluginClassCodeGenerator.java;2;2;5;1;5;4;5;0;272;0;0;5431;284;284;2;0;1;0;5;5962;1;5962;4;2;
/org.eclipse.ui.externaltools/Ant Editor/org/eclipse/ui/externaltools/internal/ant/editor/text/AnnotationType.java;1;0;1;1;0;0;0;1;0;0;1;282;0;0;1;0;0;1;1;282;0;282;1;1;
/org.eclipse.ant.ui/Ant Editor/org/eclipse/ant/ui/internal/editor/text/AntEditorTagScanner.java;1;0;3;1;0;0;0;3;4;1;3;250;4;4;1;0;0;3;3;250;0;1811;3;1;
/org.eclipse.jdt.ui.tests.refactoring/resources/ChangeSignature/canModify/A_testAdd31_out.java;1;0;1;1;0;0;0;1;8;0;1;2093;8;8;1;0;0;1;1;2093;0;2093;1;1;
/org.eclipse.jdt.core.tests.model/workspace/JavaSearch/src/e7/A.java;1;0;1;1;0;0;0;1;0;0;1;1704;0;0;1;0;0;1;1;1704;0;1704;1;1;
/org.eclipse.core.tests.runtime/src/org/eclipse/core/tests/internal/plugins/ConflictResolveTest_2.java;1;0;1;1;0;0;0;1;0;0;1;3014;0;0;1;0;0;1;1;3014;0;3014;1;1;
/org.eclipse.jdt.debug.tests/testprograms/FooPropertyPrinter.java;1;0;2;1;0;0;0;2;1;1;2;2332;2;2;1;0;0;2;2;2332;0;2379;2;1;
/org.eclipse.core.tests.runtime/src/org/eclipse/core/tests/internal/plugin/b/api/ApiClass.java;1;0;1;1;1;1;1;0;11;0;0;5149;11;11;1;0;0;0;1;5149;0;5149;1;1;
/org.eclipse.ui.cheatsheets/src/org/eclipse/ui/internal/cheatsheets/data/ConditionalSubItem.java;1;1;2;1;2;2;2;0;25;0;0;5189;25;25;1;0;0;0;2;5189;0;5620;2;1;
/org.eclipse.jdt.ui/ui/org/eclipse/jdt/internal/ui/search/PatternQuerySpecification.java;1;0;3;1;1;1;1;2;2;1;2;4625;2;2;1;0;0;2;3;4625;0;5398;3;1;
/org.eclipse.pde.ui/src_Forms/org/eclipse/pde/internal/ui/neweditor/plugin/BundleSourcePage.java;2;2;4;1;4;3;4;0;44;0;0;5344;69;69;2;0;1;0;4;5425;1;5425;3;2;
/org.eclipse.ui.ide/src/org/eclipse/ui/actions/WorkspaceAction.java;2;0;5;1;0;0;0;5;21;1;5;1511;25;25;1;0;0;5;5;1511;0;2263;5;2;
/org.eclipse.jdt.core/compiler/org/eclipse/jdt/internal/compiler/ast/AbstractVariableDeclaration.java;2;0;4;1;0;0;0;4;53;1;4;13;89;89;1;0;0;4;4;13;0;3560;4;2;
/org.eclipse.jdt.debug.tests/tests/org/eclipse/jdt/debug/tests/core/SourceLookupTests.java;2;0;6;1;1;1;1;5;161;1;5;584;193;193;1;0;0;5;6;584;0;6337;6;2;
/org.eclipse.update.ui.forms/Eclipse Forms/org/eclipse/ui/forms/HyperlinkSettings.java;1;0;6;1;0;0;0;6;4;2;5;3096;11;11;2;1;0;6;6;3096;1;4157;5;1;
/org.eclipse.jdt.core.tests.model/workspace/Converter/src/test0414/B.java;1;0;1;1;0;0;0;1;0;0;1;3714;0;0;1;0;0;1;1;3714;0;3714;1;1;
/org.eclipse.debug.ui/ui/org/eclipse/debug/internal/ui/actions/RelaunchActionDelegate.java;1;0;1;1;0;0;0;1;9;0;1;1738;9;9;1;0;0;1;1;1738;0;1738;1;1;
/org.eclipse.team.core/src/org/eclipse/team/core/subscribers/ISyncTreeSubscriberFactory.java;1;0;1;1;0;0;0;1;0;0;1;649;0;0;1;0;0;1;1;649;0;649;1;1;
/org.eclipse.jdt.ui/ui/org/eclipse/jdt/ui/text/spelling/AddWordProposal.java;1;0;2;1;0;0;0;2;0;1;2;3829;0;0;1;0;0;2;2;3829;0;3930;2;1;
/org.eclipse.core.runtime/src/org/eclipse/core/internal/runtime/AdapterFactoryProxy.java;2;1;6;1;2;2;2;4;16;2;2;4128;48;48;2;2;0;4;6;4128;2;5615;4;2;
/org.eclipse.jdt.core/model/org/eclipse/jdt/internal/core/BinaryMethod.java;4;2;17;1;5;3;5;12;108;2;11;88;254;254;2;1;2;12;17;1951;3;6220;14;4;
/org.eclipse.help.base/src/org/eclipse/help/internal/workingset/AdaptableHelpResource.java;1;1;3;1;2;2;2;1;29;0;1;1740;35;35;1;0;0;1;3;1740;0;6337;3;1;
/org.eclipse.jdt.core/formatter/org/eclipse/jdt/internal/formatter/DefaultCodeFormatterOptions.java;4;1;42;2;4;4;4;38;3128;5;28;2180;6393;6393;5;10;0;38;42;2196;10;6077;32;4;
/org.eclipse.ui.workbench/Eclipse UI/org/eclipse/ui/commands/IKeyConfigurationDefinition.java;1;0;4;1;0;0;0;4;2;2;3;1389;2;2;2;1;0;4;4;1417;1;1417;3;1;
/org.eclipse.team.webdav/src/org/eclipse/team/ui/target/DeploymentProviderLabelProvider.java;1;0;1;1;0;0;0;1;0;0;1;3461;0;0;1;0;0;1;1;3461;0;3461;1;1;
/org.eclipse.core.runtime/src/org/eclipse/core/internal/plugins/ExtensionWrapper.java;2;0;3;1;0;0;0;3;4;1;3;2105;4;4;1;0;0;3;3;2105;0;3013;3;2;
/org.eclipse.swt/Eclipse SWT PI/photon/org/eclipse/swt/internal/photon/PgAlpha_t.java;1;0;1;1;0;0;0;1;1;0;1;808;1;1;1;0;0;1;1;808;0;808;1;1;
/org.eclipse.jdt.core/model/org/eclipse/jdt/core/util/IOpcodeMnemonics.java;1;0;1;1;0;0;0;1;2;0;1;3560;2;2;1;0;0;1;1;3560;0;3560;1;1;
/org.eclipse.jdt.core.tests.model/workspace/Converter/src/test0359/A.java;1;0;1;1;0;0;0;1;0;0;1;3714;0;0;1;0;0;1;1;3714;0;3714;1;1;
/org.eclipse.jdt.core.tests.model/workspace/Formatter/test474/A_in.java;1;0;1;1;0;0;0;1;0;0;1;3977;0;0;1;0;0;1;1;3977;0;3977;1;1;
/org.eclipse.jdt.debug.ui/ui/org/eclipse/jdt/internal/debug/ui/JavaVariableActionFilter.java;3;0;3;1;1;1;1;2;39;1;2;2497;45;45;1;0;0;2;3;2497;0;6336;3;3;
/org.eclipse.update.ui.win32/src/org/eclipse/welcome/internal/portal/WelcomeTitleArea.java;1;0;1;1;0;0;0;1;0;0;1;907;0;0;1;0;0;1;1;907;0;907;1;1;
/org.eclipse.update.ui.forms/src/org/eclipse/update/ui/forms/richtext/IRichTextHyperlink.java;1;0;3;1;0;0;0;3;23;2;2;2849;23;23;2;1;0;3;3;2849;1;2898;2;1;
/org.eclipse.jdt.core/model/org/eclipse/jdt/internal/core/util/ConstantValueAttribute.java;1;0;1;1;0;0;0;1;2;0;1;3560;2;2;1;0;0;1;1;3560;0;3560;1;1;
/org.eclipse.jdt.debug/model/org/eclipse/jdt/internal/debug/core/breakpoints/JavaLineBreakpoint.java;4;5;17;3;7;3;7;10;206;3;8;347;256;256;5;2;4;10;17;6125;6;6336;11;4;
/org.eclipse.update.ui/src/org/eclipse/update/internal/ui/wizards/InstallDeltaWizardPage.java;2;1;7;1;2;2;2;5;29;2;4;755;67;67;2;1;0;5;7;755;1;5518;6;2;
/org.eclipse.team.ui/src/org/eclipse/team/ui/synchronize/viewers/SynchronizeCompareInput.java;1;0;7;1;0;0;0;7;196;2;5;4213;376;376;2;2;0;7;7;4213;2;4632;5;1;
/org.eclipse.core.tests.runtime/src/org/eclipse/core/tests/internal/osgi/AbstractStateTest.java;3;1;5;1;3;3;3;2;24;1;2;4430;43;43;1;0;0;2;5;4430;0;5339;5;3;
/org.eclipse.core.runtime/src/org/eclipse/core/internal/plugins/IModel.java;1;0;1;1;0;0;0;1;0;0;1;3013;0;0;1;0;0;1;1;3013;0;3013;1;1;
/org.eclipse.ui.views/src/org/eclipse/ui/views/internal/markers/bookmarks/Messages.java;1;0;3;1;0;0;0;3;41;1;3;265;41;41;1;0;0;3;3;265;0;749;3;1;
/org.eclipse.core.tests.resources/src/org/eclipse/core/tests/resources/usecase/Snapshot3Test.java;1;0;2;1;2;1;2;0;103;0;0;5147;103;103;2;0;1;0;2;5147;1;5147;1;1;
/org.eclipse.jdt.core.tests.model/workspace/Converter/test0184/Test.java;1;0;1;1;0;0;0;1;0;0;1;3714;0;0;1;0;0;1;1;3714;0;3714;1;1;
/org.eclipse.ant.ui/Ant Editor/org/eclipse/ant/internal/ui/editor/EnclosingTargetSearchingHandler.java;1;0;6;1;0;0;0;6;107;2;5;1811;135;135;2;1;0;6;6;2460;1;3690;5;1;
/org.eclipse.team.core/src/org/eclipse/team/internal/core/target/Site.java;1;0;1;1;0;0;0;1;0;0;1;2495;0;0;1;0;0;1;1;2495;0;2495;1;1;
/org.eclipse.jdt.core/model/org/eclipse/jdt/internal/core/hierarchy/RegionBasedHierarchyBuilder.java;3;0;10;1;0;0;0;10;165;1;10;61;302;302;1;0;0;10;10;61;0;3606;10;3;
/org.eclipse.ui.workbench/Eclipse UI/org/eclipse/ui/internal/roles/AbstractCategoryRegistry.java;1;0;2;1;0;0;0;2;0;0;1;2864;0;0;2;1;0;2;2;2864;1;2864;1;1;
/org.eclipse.jdt.core/compiler/org/eclipse/jdt/internal/compiler/lookup/SubstitutedMethodBinding.java;1;0;1;1;0;0;0;1;0;0;1;4242;0;0;1;0;0;1;1;4242;0;4242;1;1;
/org.eclipse.jdt.ui/ui/org/eclipse/jdt/internal/ui/preferences/NewJavaProjectPreferencePage.java;2;1;5;1;2;2;2;3;28;1;3;1350;41;41;1;0;0;3;5;1350;0;6340;5;2;
/org.eclipse.jdt.ui/ui/org/eclipse/jdt/ui/actions/ShowInNavigatorViewAction.java;2;0;2;1;1;1;1;1;10;0;1;592;12;12;1;0;0;1;2;592;0;6340;2;2;
/org.eclipse.test/src/org/eclipse/test/EclipseTestRunner.java;2;2;7;1;6;5;6;1;32;0;1;632;118;118;2;0;1;1;7;5590;1;6297;6;2;
/org.eclipse.team.cvs.ui/src/org/eclipse/team/internal/ccvs/ui/CVSAddResolutionGenerator.java;1;0;1;1;0;0;0;1;0;0;1;2040;0;0;1;0;0;1;1;2040;0;2040;1;1;
/org.eclipse.ui.cheatsheets/src/org/eclipse/ui/internal/cheatsheets/data/IActionItem.java;1;0;1;1;1;1;1;0;0;0;0;5189;0;0;1;0;0;0;1;5189;0;5189;1;1;
/org.eclipse.swt.graphics.text/Eclipse SWT/win32/org/eclipse/swt/graphics/text/TextStyle.java;1;0;9;1;0;0;0;9;99;2;8;2744;269;269;2;1;0;9;9;4471;1;4830;8;1;
/org.eclipse.jdt.ui/ui/org/eclipse/jdt/internal/ui/text/spelling/SpellCheckEngine.java;3;1;4;1;2;2;2;2;25;1;2;3930;29;29;1;0;0;2;4;3930;0;6340;4;3;
/org.eclipse.jdt.core.tests.model/workspace/Converter/test0492/A.java;1;0;2;1;0;0;0;2;0;1;2;1908;0;0;1;0;0;2;2;1908;0;3714;2;1;
/org.eclipse.jdt.ui/core refactoring/org/eclipse/jdt/internal/corext/refactoring/rename/RefactoringScanner.java;3;0;4;1;1;1;1;3;160;1;3;1125;166;166;1;0;0;3;4;1125;0;6340;4;3;
/org.eclipse.jdt.ui.tests.refactoring/resources/MoveMembers/test33/in/B.java;1;0;1;1;0;0;0;1;0;0;1;1856;0;0;1;0;0;1;1;1856;0;1856;1;1;
/org.eclipse.jdt.core.tests.model/workspace/Converter/src/test0016/Test.java;1;0;1;1;0;0;0;1;0;0;1;3714;0;0;1;0;0;1;1;3714;0;3714;1;1;
/org.eclipse.jdt.debug/model/org/eclipse/jdt/internal/debug/core/model/JDINullValue.java;1;0;1;1;0;0;0;1;3;0;1;2497;3;3;1;0;0;1;1;2497;0;2497;1;1;
/org.eclipse.jface.text/src/org/eclipse/jface/text/source/ITranslator.java;1;0;4;1;1;1;1;3;6;1;3;1629;10;10;1;0;0;3;4;1629;0;5122;4;1;
/org.eclipse.pde.ui/src/org/eclipse/pde/internal/ui/editor/site/SiteUndoManager.java;2;1;6;1;3;3;3;3;42;1;3;1961;113;113;1;0;0;3;6;1961;0;6336;6;2;
/org.eclipse.jdt.debug.ui/ui/org/eclipse/jdt/internal/debug/core/refactoring/JDTDebugRefactoringUtil.java;2;2;3;1;3;2;3;0;8;0;0;5515;12;12;2;0;1;0;3;5515;1;6339;2;2;
/org.eclipse.jdt.core.tests.model/src/org/eclipse/jdt/core/tests/model/WorkingCopyTests.java;4;1;19;1;2;2;2;17;236;2;16;100;631;631;2;1;0;17;19;1166;1;5621;18;4;
/org.eclipse.swt/Eclipse SWT/motif/org/eclipse/swt/widgets/WidgetTable.java;2;0;2;1;0;0;0;2;6;1;2;868;6;6;1;0;0;2;2;868;0;1193;2;2;
/org.eclipse.jdt.ui/ui refactoring/org/eclipse/jdt/internal/ui/refactoring/RefactoringExecutionHelper.java;3;1;17;1;5;5;5;12;178;1;12;456;395;395;1;0;0;12;17;456;0;6340;17;3;
/org.eclipse.update.ui.forms/Eclipse Forms/org/eclipse/ui/forms/widgets/AbstractHyperlink.java;1;0;5;1;0;0;0;5;137;2;4;3138;143;143;2;1;0;5;5;3978;1;4157;4;1;
/org.eclipse.swt/Eclipse SWT Browser/mozilla/org/eclipse/swt/browser/Browser.java;2;1;50;1;11;11;11;39;499;3;30;1654;2973;2973;3;9;0;39;50;2459;9;6352;41;2;
/org.eclipse.ui.externaltools/Ant Tools Support/org/eclipse/ui/externaltools/internal/ant/preferences/AntPropertiesPage.java;1;0;1;1;0;0;0;1;0;0;1;282;0;0;1;0;0;1;1;282;0;282;1;1;
/org.eclipse.core.tests.resources/src/org/eclipse/core/tests/resources/regression/IFolderTest.java;1;0;2;1;2;1;2;0;14;0;0;5147;14;14;2;0;1;0;2;5147;1;5147;1;1;
/org.eclipse.team.webdav/src/org/eclipse/team/internal/ui/target/PutAction.java;2;0;2;1;0;0;0;2;0;1;2;2495;0;0;1;0;0;2;2;2495;0;4216;2;2;
/org.eclipse.team.cvs.ui/src/org/eclipse/team/internal/ccvs/ui/wizards/GenerateDiffFileOperation.java;1;0;2;1;0;0;0;2;18;1;2;882;31;31;1;0;0;2;2;882;0;1080;2;1;
/org.eclipse.jdt.core/compiler/org/eclipse/jdt/internal/compiler/lookup/Substitution.java;1;0;1;1;0;0;0;1;0;0;1;5089;0;0;1;0;0;1;1;5089;0;5089;1;1;
/org.eclipse.pde.ui/src/org/eclipse/pde/internal/ui/wizards/feature/PatchPluginListPage.java;3;2;5;2;5;4;5;0;22;0;0;5563;35;35;2;0;1;0;5;5780;1;6336;4;3;
/org.eclipse.ui.workbench/Eclipse UI/org/eclipse/ui/IDecoratorManager.java;3;0;3;2;2;1;2;1;5;0;1;3879;9;9;2;0;1;1;3;6338;1;6338;2;3;
/org.eclipse.jdt.ui.tests.refactoring/resources/IntroduceFactory/Bugzilla/45942/TestClass_out.java;1;0;2;1;1;1;1;1;2;0;1;2846;2;2;1;0;0;1;2;2846;0;5659;2;1;
/org.eclipse.jdt.ui/ui/org/eclipse/jdt/internal/ui/text/correction/ConstructorFromSuperclassProposal.java;3;1;18;2;3;3;3;15;94;1;15;218;211;211;1;0;0;15;18;218;0;6340;18;3;
/org.eclipse.osgi/osgi/src/org/eclipse/osgi/service/resolver/BundleDescription.java;4;2;15;1;8;7;8;7;24;1;7;3013;140;140;2;0;1;7;15;5536;1;5603;14;4;
/org.eclipse.team.ui/src/org/eclipse/team/internal/ui/actions/ProgressDialogRunnableContext.java;2;0;4;1;1;1;1;3;125;1;3;4071;224;224;1;0;0;3;4;4071;0;6337;4;2;
/org.eclipse.jdt.core.tests.model/workspace/Converter/test0256/Test.java;1;0;1;1;0;0;0;1;0;0;1;3714;0;0;1;0;0;1;1;3714;0;3714;1;1;
/org.eclipse.ui.ide/src/org/eclipse/ui/views/navigator/ResourceNavigatorAction.java;1;0;1;1;0;0;0;1;0;0;1;2208;0;0;1;0;0;1;1;2208;0;2208;1;1;
/org.eclipse.jdt.ui.tests.refactoring/resources/ExtractMethodWorkSpace/ExtractMethodTests/expression_in/A_test617.java;1;0;1;1;0;0;0;1;2;0;1;844;2;2;1;0;0;1;1;844;0;844;1;1;
/org.eclipse.team.ui/src/org/eclipse/team/ui/synchronize/ISynchronizeScope.java;2;2;3;1;3;2;3;0;65;0;0;5594;74;74;2;0;1;0;3;5594;1;6305;2;2;
/org.eclipse.swt/Eclipse SWT PI/gtk/org/eclipse/swt/internal/gtk/XClientMessageEvent.java;3;0;3;1;1;1;1;2;8;1;2;4445;12;12;1;0;0;2;3;4445;0;6352;3;3;
/org.eclipse.ui.ide/src/org/eclipse/ui/internal/ide/dialogs/ResourceInfoPage.java;4;2;7;1;5;4;5;2;239;1;2;2264;368;368;2;0;1;2;7;5267;1;6338;6;4;
/org.eclipse.team.cvs.core/src/org/eclipse/team/internal/ccvs/core/syncinfo/CVSDescendantResourceVariantByteStore.java;2;1;4;1;2;2;2;2;14;1;2;4259;24;24;1;0;0;2;4;4259;0;6337;4;2;
/org.eclipse.ui.workbench/Eclipse UI/org/eclipse/ui/internal/BrandingProperties.java;1;1;2;1;2;2;2;0;72;0;0;5485;72;72;1;0;0;0;2;5485;0;6012;2;1;
/org.eclipse.ui.ide/src/org/eclipse/ui/internal/model/StandardPropertiesAdapterFactory.java;1;0;2;1;0;0;0;2;0;1;2;2208;0;0;1;0;0;2;2;2208;0;2263;2;1;
/org.eclipse.update.ui/srcnew/org/eclipse/update/internal/ui/parts/MyComputerLabelProvider.java;2;0;2;1;0;0;0;2;0;1;2;745;0;0;1;0;0;2;2;745;0;825;2;2;
/org.eclipse.ui.ide/src/org/eclipse/ui/internal/ide/model/PropertyParser.java;5;1;6;1;2;2;2;4;34;1;4;2892;69;69;1;0;0;4;6;2892;0;6338;6;5;
/org.eclipse.swt/Eclipse SWT PI/gtk/org/eclipse/swt/internal/gtk/GdkEventWindowState.java;4;0;5;1;1;1;1;4;17;1;4;1097;23;23;1;0;0;4;5;1097;0;6352;5;4;
/org.eclipse.jdt.core/codeassist/org/eclipse/jdt/internal/codeassist/complete/CompletionOnParameterizedQualifiedTypeReference.java;1;0;1;1;0;0;0;1;0;0;1;4964;0;0;1;0;0;1;1;4964;0;4964;1;1;
/org.eclipse.swt/Eclipse SWT PI/gtk/org/eclipse/swt/internal/gtk/GtkFileSelection.java;3;0;3;1;1;1;1;2;40;1;2;1653;59;59;1;0;0;2;3;1653;0;6352;3;3;
/org.eclipse.jdt.core.tests.model/workspace/Formatter/test344/A_in.java;1;0;1;1;0;0;0;1;0;0;1;2865;0;0;1;0;0;1;1;2865;0;2865;1;1;
/org.eclipse.swt/Eclipse SWT PI/motif/org/eclipse/swt/internal/motif/XmTextBlockRec.java;1;0;1;1;0;0;0;1;6;0;1;825;6;6;1;0;0;1;1;825;0;825;1;1;
/org.eclipse.jdt.ui/core refactoring/org/eclipse/jdt/internal/corext/refactoring/changes/MoveCompilationUnitChange.java;3;1;6;1;2;2;2;4;27;2;3;596;69;69;2;1;0;4;6;596;1;6340;5;3;
/org.eclipse.ltk.core.refactoring/src/org/eclipse/ltk/internal/core/refactoring/ParticipantDescriptor.java;1;1;3;1;2;2;2;1;8;0;1;4913;12;12;1;0;0;1;3;4913;0;6340;3;1;
/org.eclipse.jdt.core.tests.model/workspace/Formatter/test416/A_in.java;1;0;1;1;0;0;0;1;0;0;1;3460;0;0;1;0;0;1;1;3460;0;3460;1;1;
/org.eclipse.team.tests.cvs.core/src/org/eclipse/team/tests/ccvs/ui/benchmark/WorkflowTests.java;1;0;2;1;0;0;0;2;7;1;2;1417;7;7;1;0;0;2;2;1417;0;2632;2;1;
/org.eclipse.ui.workbench/Eclipse UI/org/eclipse/ui/internal/commands/util/CaptureEvent.java;1;0;2;1;0;0;0;2;0;1;2;1077;0;0;1;0;0;2;2;1077;0;1222;2;1;
/org.eclipse.swt/Eclipse SWT Drag and Drop/photon/org/eclipse/swt/dnd/DragSource.java;2;0;2;1;0;0;0;2;4;1;2;0;8;8;1;0;0;2;2;0;0;269;2;2;
/org.eclipse.team.ui/src/org/eclipse/team/internal/ui/sync/views/SyncInfoWorkingSetFilter.java;1;0;1;1;0;0;0;1;0;0;1;1276;0;0;1;0;0;1;1;1276;0;1276;1;1;
/org.eclipse.jdt.ui.tests.refactoring/resources/InlineMethodWorkspace/TestCases/controlStatement_out/TestForAssignmentOne.java;1;0;1;1;0;0;0;1;2;0;1;845;2;2;1;0;0;1;1;845;0;845;1;1;
/org.eclipse.jdt.core.tests.model/workspace/Converter/src/test0331/Test.java;1;0;1;1;0;0;0;1;0;0;1;3714;0;0;1;0;0;1;1;3714;0;3714;1;1;
/org.eclipse.osgi/defaultAdaptor/src/org/eclipse/osgi/framework/adaptor/core/BundleURLConnection.java;2;1;7;1;4;4;4;3;73;1;3;4336;126;126;1;0;0;3;7;4336;0;5689;7;2;
/org.eclipse.jdt.core.tests.model/workspace/Converter/src/test0203/Test.java;1;0;1;1;0;0;0;1;0;0;1;3714;0;0;1;0;0;1;1;3714;0;3714;1;1;
/org.eclipse.ant.ui/Remote Ant Support/org/eclipse/ant/ui/internal/antsupport/logger/MessageIds.java;1;0;2;1;0;0;0;2;0;1;2;1452;0;0;1;0;0;2;2;1452;0;1811;2;1;
/org.eclipse.jdt.ui.tests.refactoring/resources/ConvertAnonymousToNested/canConvert/A_test24_in.java;1;0;1;1;0;0;0;1;0;0;1;3195;0;0;1;0;0;1;1;3195;0;3195;1;1;
/org.eclipse.jdt.debug.tests/testprograms/org/eclipse/debug/tests/targets/ClassOne.java;1;0;1;1;0;0;0;1;0;0;1;584;0;0;1;0;0;1;1;584;0;584;1;1;
/org.eclipse.core.tests.harness/src/org/eclipse/core/tests/harness/SessionTestApplication.java;1;0;1;1;1;1;1;0;67;0;0;5146;67;67;1;0;0;0;1;5146;0;5146;1;1;
/org.eclipse.update.core/src/org/eclipse/update/internal/core/OtherResponse.java;2;1;3;1;2;2;2;1;4;0;1;3090;6;6;1;0;0;1;3;3090;0;6336;3;2;
/org.eclipse.jdt.core/model/org/eclipse/jdt/internal/core/Assert.java;2;0;3;1;0;0;0;3;4;1;3;1308;8;8;1;0;0;3;3;1308;0;3560;3;2;
/org.eclipse.jdt.debug/eval/org/eclipse/jdt/internal/debug/eval/ast/instructions/InstanceOfOperator.java;2;0;2;1;0;0;0;2;3;1;2;1240;5;5;1;0;0;2;2;1240;0;1276;2;2;
/org.eclipse.team.webdav/src/org/eclipse/team/internal/target/subscriber/TargetOperation.java;2;0;5;1;1;1;1;4;149;1;4;3494;160;160;1;0;0;4;5;3494;0;6337;5;2;
/org.eclipse.jdt.debug.ui/ui/org/eclipse/jdt/internal/debug/ui/actions/RunToLineActionDelegate.java;3;0;6;1;0;0;0;6;73;1;6;127;150;150;1;0;0;6;6;127;0;4471;6;3;
/org.eclipse.jdt.core.tests.model/workspace/Converter/test0212/Test.java;1;0;1;1;0;0;0;1;0;0;1;3714;0;0;1;0;0;1;1;3714;0;3714;1;1;
/org.eclipse.jdt.ui.tests.refactoring/resources/SurroundWithWorkSpace/SurroundWithTests/trycatch_in/TestExceptionOrder.java;1;0;1;1;0;0;0;1;4;0;1;845;4;4;1;0;0;1;1;845;0;845;1;1;
/org.eclipse.jdt.debug.jdi.tests/tests/org/eclipse/debug/jdi/tests/AbstractJDITest.java;1;0;2;1;0;0;0;2;78;1;2;1223;81;81;1;0;0;2;2;1223;0;4264;2;1;
/org.eclipse.team.cvs.ui/src/org/eclipse/team/internal/ccvs/ui/CVSFilePropertiesPage.java;2;0;3;1;0;0;0;3;14;1;3;276;18;18;1;0;0;3;3;276;0;2381;3;2;
/org.eclipse.jdt.ui.tests.refactoring/resources/IntroduceParameter/invalid/PartName1.java;1;0;1;1;0;0;0;1;0;0;1;2281;0;0;1;0;0;1;1;2281;0;2281;1;1;
/org.eclipse.team.cvs.ui/src/org/eclipse/team/internal/ccvs/ui/repo/RemoteProjectsView.java;2;0;2;1;0;0;0;2;5;1;2;790;6;6;1;0;0;2;2;790;0;848;2;2;
/org.eclipse.ui.forms/src/org/eclipse/ui/forms/editor/FormEditor.java;1;1;15;1;5;5;5;10;144;1;10;4068;433;433;1;0;0;10;15;4068;0;6336;15;1;
/org.eclipse.ui.workbench/Eclipse UI/org/eclipse/ui/actions/PerspectiveMenu.java;6;0;17;2;2;1;2;15;59;2;11;1;214;214;2;4;1;15;17;1952;5;6338;12;6;
/org.eclipse.jdt.core.tests.model/workspace/Formatter/test117/A_out.java;1;0;1;1;0;0;0;1;0;0;1;2425;0;0;1;0;0;1;1;2425;0;2425;1;1;
/org.eclipse.jdt.core.tests.model/workspace/Formatter/test357/A_out.java;1;0;1;1;0;0;0;1;0;0;1;3087;0;0;1;0;0;1;1;3087;0;3087;1;1;
/org.eclipse.jdt.ui.tests.refactoring/resources/TypeConstraints/A_testConstraints10.java;1;0;2;1;0;0;0;2;6;0;1;65;6;6;2;1;0;2;2;65;1;65;1;1;
/org.eclipse.team.core/src/org/eclipse/team/core/synchronize/ISyncInfoSetChangeEvent.java;2;1;5;1;3;3;3;2;68;1;2;4045;82;82;1;0;0;2;5;4045;0;6336;5;2;
/org.eclipse.ui.workbench/Eclipse UI/org/eclipse/ui/internal/commands/api/older/IKeyConfiguration.java;1;0;2;1;0;0;0;2;0;0;1;2562;0;0;2;1;0;2;2;2562;1;2562;1;1;
/org.eclipse.jdt.core.tests.model/workspace/Converter/src/javadoc/testBug51363/X.java;1;0;2;1;0;0;0;2;0;1;2;3940;0;0;1;0;0;2;2;3940;0;3994;2;1;
/org.eclipse.ui.ide/src/org/eclipse/ui/dialogs/ProjectLocationSelectionDialog.java;2;0;3;1;0;0;0;3;28;1;3;1511;28;28;1;0;0;3;3;1511;0;2263;3;2;
/org.eclipse.text/src/org/eclipse/jface/text/templates/TemplateVariableResolver.java;2;1;7;1;2;2;2;5;48;1;5;4382;124;124;1;0;0;5;7;4382;0;6340;7;2;
/org.eclipse.jdt.ui/core refactoring/org/eclipse/jdt/internal/corext/refactoring/participants/xml/DefaultVariable.java;1;0;3;1;0;0;0;3;50;1;3;2682;50;50;1;0;0;3;3;2682;0;4108;3;1;
/org.eclipse.core.filebuffers/src/org/eclipse/core/internal/filebuffers/ExtensionsRegistry.java;2;1;10;1;8;8;8;2;177;1;2;1522;605;605;1;0;0;2;10;1522;0;6340;10;2;
/org.eclipse.pde.core/src/org/eclipse/pde/internal/core/schema/SchemaSimpleType.java;2;1;3;1;2;2;2;1;6;0;1;4203;14;14;1;0;0;1;3;4203;0;6336;3;2;
/org.eclipse.search/new search/org/eclipse/search2/internal/ui/text/MatchEvent.java;1;0;2;1;0;0;0;2;0;1;2;3474;0;0;1;0;0;2;2;3474;0;3711;2;1;
/org.eclipse.ui.workbench.texteditor/src/org/eclipse/ui/texteditor/IEditorStatusLine.java;1;0;1;1;1;1;1;0;4;0;0;6340;4;4;1;0;0;0;1;6340;0;6340;1;1;
/org.eclipse.core.tests.runtime/src/org/eclipse/core/tests/internal/plugins/PluginResolveTest.java;1;0;1;1;0;0;0;1;0;0;1;3014;0;0;1;0;0;1;1;3014;0;3014;1;1;
/org.eclipse.jdt.ui.tests.refactoring/resources/ChangeTypeRefactoring/positive/A_testMultiCUClass2.java;1;0;1;1;0;0;0;1;0;0;1;2844;0;0;1;0;0;1;1;2844;0;2844;1;1;
/org.eclipse.update.ui.win32/src/org/eclipse/welcome/internal/webbrowser/BrowserControlSite.java;1;0;1;1;0;0;0;1;0;0;1;907;0;0;1;0;0;1;1;907;0;907;1;1;
/org.eclipse.team.webdav/src/org/eclipse/team/internal/webdav/ui/subscriber/WebDavSynchronizeParticipant.java;2;2;11;2;5;4;5;6;53;1;6;3499;173;173;2;0;1;6;11;5358;1;6337;10;2;
/org.eclipse.ui.workbench.texteditor/src/org/eclipse/ui/texteditor/FindNextAction.java;3;2;9;2;5;3;5;4;95;1;4;1589;154;154;2;0;2;4;9;5123;2;6334;7;3;
/org.eclipse.pde.build/src/org/eclipse/pde/internal/build/builder/ModelBuildScriptGenerator.java;2;1;32;1;15;15;15;17;305;2;16;447;915;915;2;1;0;17;32;1219;1;6316;31;2;
/org.eclipse.ui.workbench/Eclipse UI/org/eclipse/ui/internal/roles/Category.java;1;0;2;1;0;0;0;2;0;0;1;2864;0;0;2;1;0;2;2;2864;1;2864;1;1;
/org.eclipse.ui.ide/src/org/eclipse/ui/internal/ide/model/XMLTopLevelElementContentDescriber.java;1;1;3;1;3;3;3;0;13;0;0;5112;13;13;1;0;0;0;3;5112;0;5206;3;1;
/org.eclipse.jdt.ui/ui/org/eclipse/jdt/internal/ui/javaeditor/EditorUtility.java;3;1;11;1;2;2;2;9;88;2;7;599;255;255;2;2;0;9;11;612;2;6340;9;3;
/org.eclipse.ant.ui/Ant Editor/org/eclipse/ant/internal/ui/dtd/schema/Attribute.java;1;0;1;1;0;0;0;1;0;0;1;1811;0;0;1;0;0;1;1;1811;0;1811;1;1;
/org.eclipse.help.base/src/org/eclipse/help/internal/search/LazyProgressMonitor.java;1;1;3;1;2;2;2;1;14;0;1;1740;20;20;1;0;0;1;3;1740;0;6337;3;1;
/org.eclipse.jdt.core.tests.model/workspace/Formatter/test366/A_out.java;1;0;1;1;0;0;0;1;0;0;1;3128;0;0;1;0;0;1;1;3128;0;3128;1;1;
/org.eclipse.update.ui/srcnew/org/eclipse/update/internal/ui/wizards/BannerPage2.java;1;0;2;1;0;0;0;2;0;1;2;367;0;0;1;0;0;2;2;367;0;488;2;1;
/org.eclipse.jdt.ui.tests.refactoring/resources/MoveMembers/test40/in/A.java;1;0;1;1;0;0;0;1;0;0;1;4630;0;0;1;0;0;1;1;4630;0;4630;1;1;
/org.eclipse.jdt.core.tests.model/workspace/Converter/junit/swingui/FailureRunView.java;1;0;2;1;0;0;0;2;36;1;2;787;36;36;1;0;0;2;2;787;0;3714;2;1;
/org.eclipse.jdt.ui.tests.refactoring/resources/DeleteSourceReference/test17/in/A.java;1;0;1;1;0;0;0;1;0;0;1;1652;0;0;1;0;0;1;1;1652;0;1652;1;1;
/org.eclipse.ltk.core.refactoring/src/org/eclipse/ltk/core/refactoring/participants/MoveParticipant.java;1;1;4;1;2;2;2;2;19;1;2;4845;42;42;1;0;0;2;4;4845;0;6340;4;1;
/org.eclipse.osgi/eclipseAdaptor/src/org/eclipse/core/runtime/adaptor/BasicFileManager.java;1;0;3;1;0;0;0;3;10;1;3;4338;10;10;1;0;0;3;3;4338;0;4672;3;1;
/org.eclipse.jdt.core.tests.model/workspace/Converter/test0383/A.java;1;0;1;1;0;0;0;1;0;0;1;3714;0;0;1;0;0;1;1;3714;0;3714;1;1;
/org.eclipse.team.core/src/org/eclipse/team/internal/core/subscribers/SyncSetChangedEvent.java;2;0;4;1;1;1;1;3;104;1;3;3550;136;136;1;0;0;3;4;3550;0;6336;4;2;
/org.eclipse.osgi/defaultAdaptor/src/org/eclipse/osgi/framework/adaptor/core/ServiceRegistryImpl.java;2;1;3;1;2;2;2;1;127;0;1;4336;144;144;1;0;0;1;3;4336;0;5518;3;2;
/org.eclipse.core.resources/src/org/eclipse/core/resources/IFileState.java;2;0;4;1;1;1;1;3;135;1;3;44;151;151;1;0;0;3;4;44;0;5146;4;2;
/org.eclipse.ui.workbench/Eclipse UI/org/eclipse/ui/presentations/IPartMenu.java;1;0;2;1;1;1;1;1;2;0;1;4691;2;2;1;0;0;1;2;4691;0;6038;2;1;
/org.eclipse.ui.externaltools/Ant Editor/org/eclipse/ui/externaltools/internal/ant/editor/AntEditor.java;1;0;4;1;0;0;0;4;2;2;3;178;4;4;2;1;0;4;4;178;1;282;3;1;
/org.eclipse.ui.intro/src/org/eclipse/ui/internal/intro/impl/model/IntroModelRoot.java;2;2;22;1;22;19;22;0;172;0;0;5115;634;634;2;0;3;0;22;5533;3;6251;19;2;
/org.eclipse.pde.ui/src/org/eclipse/pde/internal/ui/editor/text/XMLScanner.java;3;1;4;1;2;2;2;2;27;1;2;3795;33;33;1;0;0;2;4;3795;0;6336;4;3;
/org.eclipse.jdt.core.tests.model/src/org/eclipse/jdt/core/tests/model/CompletionTests2.java;3;0;3;1;0;0;0;3;10;1;3;1387;14;14;1;0;0;3;3;1387;0;3560;3;3;
/org.eclipse.update.ui.win32/src/org/eclipse/welcome/internal/webbrowser/WebBrowserEditorInput.java;1;0;1;1;0;0;0;1;0;0;1;907;0;0;1;0;0;1;1;907;0;907;1;1;
/org.eclipse.jdt.ui.examples.javafamily/src/org/eclipse/jsp/launching/TomcatSourceLocator.java;1;0;2;1;0;0;0;2;0;1;2;1387;0;0;1;0;0;2;2;1387;0;5091;2;1;
/org.eclipse.jdt.ui/ui refactoring/org/eclipse/jdt/internal/ui/refactoring/MoveInnerToTopWizard.java;4;0;9;1;1;1;1;8;98;1;8;518;207;207;1;0;0;8;9;518;0;6340;9;4;
/org.eclipse.jdt.ui.tests.refactoring/test cases/org/eclipse/jdt/ui/tests/xml/I_TypeExtender.java;1;0;5;1;0;0;0;5;11;1;5;2204;17;17;1;0;0;5;5;2204;0;4108;5;1;
/org.eclipse.debug.core/core/org/eclipse/debug/core/model/IStepFilters.java;1;0;2;1;1;1;1;1;3;0;1;3613;3;3;1;0;0;1;2;3613;0;5108;2;1;
/org.eclipse.core.runtime/src/org/eclipse/core/internal/dependencies/IDependencySystem.java;2;0;2;1;0;0;0;2;0;1;2;2105;0;0;1;0;0;2;2;2105;0;3013;2;2;
/org.eclipse.ui.workbench/Eclipse UI/org/eclipse/ui/internal/commands/CommandDefinitionHandle.java;1;0;2;1;0;0;0;2;0;0;1;1389;0;0;2;1;0;2;2;1389;1;1389;1;1;
/org.eclipse.jdt.ui.tests.refactoring/resources/PullUp/testEnablement3/in/A.java;1;0;1;1;0;0;0;1;0;0;1;1312;0;0;1;0;0;1;1;1312;0;1312;1;1;
/org.eclipse.update.core/src/org/eclipse/update/core/IURLEntry.java;3;1;4;1;2;2;2;2;6;1;2;0;18;18;1;0;0;2;4;0;0;6336;4;3;
/org.eclipse.ui.workbench/Eclipse UI/org/eclipse/ui/internal/dialogs/MultiStepWizardDialog.java;1;0;1;1;0;0;0;1;0;0;1;2737;0;0;1;0;0;1;1;2737;0;2737;1;1;
/org.eclipse.osgi/core/framework/org/eclipse/osgi/framework/internal/core/StartLevelImpl.java;7;2;13;1;4;3;4;9;1120;1;9;3013;2141;2141;2;0;1;9;13;5116;1;6337;12;7;
/org.eclipse.core.tests.runtime/src/org/eclipse/core/tests/internal/runtimetests/SampleLFB.java;1;0;1;1;1;1;1;0;21;0;0;5149;21;21;1;0;0;0;1;5149;0;5149;1;1;
/org.eclipse.jdt.debug/model/org/eclipse/jdt/internal/debug/core/model/JDIDebugElement.java;4;0;6;2;0;0;0;6;28;2;5;363;65;65;2;1;0;6;6;4425;1;4425;5;4;
/org.eclipse.jdt.core.tests.model/workspace/Converter/test0475/A.java;1;0;2;1;0;0;0;2;0;1;2;957;0;0;1;0;0;2;2;957;0;3714;2;1;
/org.eclipse.update.core/src/org/eclipse/update/internal/core/MultiDownloadMonitor.java;1;0;2;1;0;0;0;2;0;1;2;965;0;0;1;0;0;2;2;965;0;3012;2;1;
/org.eclipse.jface/src/org/eclipse/jface/dialogs/IInputValidator.java;1;0;1;1;1;1;1;0;10;0;0;5468;10;10;1;0;0;0;1;5468;0;5468;1;1;
/org.eclipse.pde.ui/src_OSGi/org/eclipse/pde/internal/ui/osgi/templates/HelloWorldNewBundleWizard.java;2;0;2;1;0;0;0;2;0;1;2;2501;0;0;1;0;0;2;2;2501;0;3986;2;2;
/org.eclipse.ui.ide/src/org/eclipse/ui/internal/ide/FeatureSelectionDialog.java;3;1;6;1;4;4;4;2;28;1;2;2264;49;49;1;0;0;2;6;2264;0;6338;6;3;
/org.eclipse.ui.views/src/org/eclipse/ui/views/internal/markers/ActionDeleteCompleted.java;1;0;2;1;0;0;0;2;0;0;1;749;0;0;2;1;0;2;2;749;1;749;1;1;
/org.eclipse.update.ui.forms/src/org/eclipse/ui/forms/parts/HTMLTableLayout.java;1;0;3;1;0;0;0;3;16;1;3;3038;16;16;1;0;0;3;3;3038;0;3096;3;1;
/org.eclipse.jdt.core.tests.model/workspace/Formatter/test166/A_out.java;1;0;1;1;0;0;0;1;0;0;1;2425;0;0;1;0;0;1;1;2425;0;2425;1;1;
/org.eclipse.jdt.ui/ui/org/eclipse/jdt/internal/ui/wizards/JavaProjectWizardSecondPage.java;2;2;12;1;5;4;5;7;23;1;7;3830;104;104;2;0;1;7;12;5910;1;6340;11;2;
/org.eclipse.jdt.ui/ui/org/eclipse/jdt/internal/ui/reorg/SimpleSelectionProvider.java;1;0;1;1;0;0;0;1;0;0;1;1111;0;0;1;0;0;1;1;1111;0;1111;1;1;
/org.eclipse.ui.workbench/Eclipse UI/org/eclipse/ui/internal/presentations/SystemMenuMove.java;2;0;3;1;1;1;1;2;82;1;2;4680;84;84;1;0;0;2;3;4680;0;5173;3;2;
/org.eclipse.ui.workbench/Eclipse UI/org/eclipse/ui/IActionFilter.java;3;2;4;2;3;2;3;1;8;0;1;1;17;17;2;0;1;1;4;6338;1;6338;3;3;
/org.eclipse.ui.workbench/Eclipse UI/org/eclipse/ui/internal/commands/api/IActionService.java;1;0;2;1;0;0;0;2;2;0;1;2562;2;2;2;1;0;2;2;2562;1;2562;1;1;
/org.eclipse.ui.tests/Eclipse JFace Tests/org/eclipse/jface/tests/viewers/AbstractTreeViewerTest.java;3;0;4;1;0;0;0;4;16;1;4;1389;33;33;1;0;0;4;4;1389;0;2738;4;3;
/org.eclipse.jdt.core.tests.model/workspace/Formatter/test020/A_in.java;1;0;1;1;0;0;0;1;0;0;1;2425;0;0;1;0;0;1;1;2425;0;2425;1;1;
/org.eclipse.ui.workbench/Eclipse UI/org/eclipse/ui/keys/KeySupport.java;2;0;7;1;0;0;0;7;573;1;7;1376;870;870;1;0;0;7;7;1376;0;3214;7;2;
/org.eclipse.ui.workbench/Eclipse UI/org/eclipse/ui/internal/dialogs/WelcomeEditorCopyAction.java;1;0;1;1;0;0;0;1;0;0;1;2737;0;0;1;0;0;1;1;2737;0;2737;1;1;
/org.eclipse.ui.tests/Eclipse UI Tests/org/eclipse/ui/tests/keys/Bug43168Test.java;2;0;5;1;0;0;0;5;8;1;5;2280;19;19;1;0;0;5;5;2280;0;3052;5;2;
/org.eclipse.debug.ui/ui/org/eclipse/debug/internal/ui/ResourceExtender.java;4;1;6;1;5;5;5;1;65;0;1;4501;165;165;1;0;0;1;6;4501;0;6339;6;4;
/org.eclipse.ui.workbench/Eclipse UI/org/eclipse/ui/internal/activities/ActivityBinding.java;1;0;2;1;0;0;0;2;0;1;2;2867;0;0;1;0;0;2;2;2867;0;2896;2;1;
/org.eclipse.jdt.core/compiler/org/eclipse/jdt/internal/compiler/SourceElementRequestorAdapter.java;3;0;4;1;0;0;0;4;25;1;4;85;32;32;1;0;0;4;4;85;0;4461;4;3;
/org.eclipse.osgi/resolver/src/org/eclipse/osgi/internal/resolver/StateImpl.java;4;2;20;1;10;9;10;10;68;1;10;3013;374;374;2;0;1;10;20;5341;1;5877;19;4;
/org.eclipse.releng.tools/src/org/eclipse/releng/tools/MapProjectSelectionPage.java;2;1;3;1;3;3;3;0;10;0;0;5274;14;14;1;0;0;0;3;5274;0;6340;3;2;
/org.eclipse.jdt.debug.ui/ui/org/eclipse/jdt/internal/debug/ui/actions/DisplayAction.java;3;0;5;1;1;1;1;4;302;2;3;307;334;334;2;1;0;4;5;3828;1;6336;4;3;
/org.eclipse.jdt.core.tests.model/workspace/Completion/src3/test0021/Test.java;1;0;1;1;1;1;1;0;0;0;0;5206;0;0;1;0;0;0;1;5206;0;5206;1;1;
/org.eclipse.ui.workbench/Eclipse UI/org/eclipse/ui/internal/commands/older/Command.java;1;0;4;1;0;0;0;4;24;0;1;2562;24;24;4;3;0;4;4;2562;3;2562;1;1;
/org.eclipse.team.core/src/org/eclipse/team/internal/core/registry/DeploymentProviderRegistry.java;2;0;3;1;0;0;0;3;56;1;3;2806;56;56;1;0;0;3;3;2806;0;4633;3;2;
/org.eclipse.ui.workbench/Eclipse UI/org/eclipse/ui/internal/IntroAction.java;2;1;7;1;4;4;4;3;28;1;3;3632;51;51;1;0;0;3;7;3632;0;6338;7;2;
/org.eclipse.debug.ui/ui/org/eclipse/debug/internal/ui/preferences/DebugActionGroupsContentProvider.java;2;0;2;1;0;0;0;2;15;1;2;788;15;15;1;0;0;2;2;788;0;5086;2;2;
/org.eclipse.update.core/src/org/eclipse/update/core/model/ContentEntry.java;1;0;1;1;0;0;0;1;0;0;1;2634;0;0;1;0;0;1;1;2634;0;2634;1;1;
/org.eclipse.ui.workbench/Eclipse UI/org/eclipse/ui/internal/PerspectiveBarNewMenu.java;1;0;1;1;0;0;0;1;0;0;1;3806;0;0;1;0;0;1;1;3806;0;3806;1;1;
/org.eclipse.ui.externaltools/Ant Editor/org/eclipse/ui/externaltools/internal/ant/dtd/util/SortedMap.java;1;0;1;1;0;0;0;1;0;0;1;282;0;0;1;0;0;1;1;282;0;282;1;1;
/org.eclipse.jdt.ui/core refactoring/org/eclipse/jdt/internal/corext/refactoring/util/ASTCreator.java;1;0;2;1;0;0;0;2;0;1;2;4507;0;0;1;0;0;2;2;4507;0;4690;2;1;
/org.eclipse.jdt.ui.tests.refactoring/test cases/org/eclipse/jdt/ui/tests/refactoring/infra/MockWorkbenchSite.java;2;0;4;1;1;1;1;3;33;1;3;469;47;47;1;0;0;3;4;469;0;6340;4;2;
/org.eclipse.jdt.ui.tests/ui/org/eclipse/jdt/ui/tests/astrewrite/SourceModifierTest.java;1;0;3;1;1;1;1;2;5;1;2;3611;5;5;1;0;0;2;3;3611;0;5406;3;1;
/org.eclipse.pde.core/src/org/eclipse/pde/internal/core/site/SiteDescription.java;2;1;3;1;2;2;2;1;10;0;1;4203;23;23;1;0;0;1;3;4203;0;6336;3;2;
/org.eclipse.swt.opengl/win32/org/eclipse/swt/opengl/internal/win32/WGL.java;1;0;1;1;0;0;0;1;0;0;1;1175;0;0;1;0;0;1;1;1175;0;1175;1;1;
/org.eclipse.ui.cheatsheets/src/org/eclipse/ui/internal/cheatsheets/actions/CheatSheetCategoryBasedSelectionAction.java;2;0;5;2;1;1;1;4;19;2;3;4428;27;27;2;1;0;4;5;4625;1;5363;4;2;
/org.eclipse.jdt.debug.ui/ui/org/eclipse/jdt/internal/debug/ui/actions/VariableFilterAction.java;1;0;1;1;0;0;0;1;0;0;1;3296;0;0;1;0;0;1;1;3296;0;3296;1;1;
/org.eclipse.team.cvs.ui/src/org/eclipse/team/internal/ccvs/ui/AlternateUserValidationDialog.java;1;0;1;1;0;0;0;1;8;0;1;2381;8;8;1;0;0;1;1;2381;0;2381;1;1;
/org.eclipse.debug.ui/ui/org/eclipse/debug/internal/ui/actions/AutoManageViewsAction.java;1;1;2;1;2;2;2;0;0;0;0;5366;0;0;1;0;0;0;2;5366;0;5515;2;1;
/org.eclipse.debug.ui/ui/org/eclipse/debug/internal/ui/views/expression/PopupInformationControl.java;3;2;11;2;11;10;11;0;25;0;0;5133;59;59;2;0;1;0;11;6223;1;6223;10;3;
/org.eclipse.team.ui/src/org/eclipse/team/internal/ui/synchronize/ConfigureSynchronizeScheduleComposite.java;2;1;4;1;3;3;3;1;32;0;1;4649;35;35;1;0;0;1;4;4649;0;6337;4;2;
/org.eclipse.swt.tests/JUnit Tests/org/eclipse/swt/tests/junit/Test_org_eclipse_swt_widgets_CoolItem.java;1;0;1;1;0;0;0;1;107;0;1;2105;107;107;1;0;0;1;1;2105;0;2105;1;1;
/org.eclipse.osgi/defaultAdaptor/src/org/eclipse/osgi/framework/internal/reliablefile/ReliableFileInputStream.java;5;1;6;1;3;3;3;3;144;1;3;3013;260;260;1;0;0;3;6;3013;0;5856;6;5;
/org.eclipse.ant.ui/Ant Editor/org/eclipse/ant/internal/ui/editor/outline/OutlinePreparingHandler.java;1;0;7;1;0;0;0;7;80;1;7;1811;189;189;1;0;0;7;7;1811;0;3661;7;1;
/org.eclipse.ui.workbench/Eclipse UI/org/eclipse/ui/internal/csm/activities/api/IActivity.java;1;0;4;1;0;0;0;4;131;3;2;2225;154;154;3;2;0;4;4;2225;2;2240;2;1;
/org.eclipse.jdt.core.tests.model/workspace/Converter/test0404/A.java;1;0;1;1;0;0;0;1;0;0;1;3714;0;0;1;0;0;1;1;3714;0;3714;1;1;
/org.eclipse.jdt.ui/ui/org/eclipse/jdt/internal/ui/text/java/IProblemRequestorExtension.java;2;0;2;1;1;1;1;1;16;0;1;3930;18;18;1;0;0;1;2;3930;0;6340;2;2;
/org.eclipse.jdt.core/search/org/eclipse/jdt/internal/core/search/JavaSearchDocument.java;3;1;9;2;2;2;2;7;43;2;5;3211;113;113;2;2;0;7;9;3240;2;5266;7;3;
/org.eclipse.update.ui.forms/Eclipse Forms/org/eclipse/ui/forms/IDetailsPageProvider.java;1;0;2;1;0;0;0;2;0;1;2;3834;0;0;1;0;0;2;2;3834;0;4157;2;1;
/org.eclipse.ui.tests/Eclipse UI Tests/org/eclipse/ui/tests/api/MockWorkbenchPart.java;3;1;5;1;4;4;4;1;156;0;1;3166;215;215;1;0;0;1;5;3166;0;6338;5;3;
/org.eclipse.jdt.ui.tests.refactoring/resources/IntroduceFactory/positive/DontMoveArgs1.java;1;0;2;1;1;1;1;1;2;0;1;2846;2;2;1;0;0;1;2;2846;0;5659;2;1;
/org.eclipse.jdt.ui/ui/org/eclipse/jdt/ui/refactoring/IRefactoringProcessorIds.java;2;1;4;1;3;3;3;1;103;0;1;4976;141;141;1;0;0;1;4;4976;0;6363;4;2;
/org.eclipse.debug.ui/ui/org/eclipse/debug/ui/variables/ProjectExpander.java;1;0;4;1;0;0;0;4;70;3;2;316;70;70;3;2;0;4;4;316;2;550;2;1;
/org.eclipse.jdt.ui/core refactoring/org/eclipse/jdt/internal/corext/refactoring/code/InlineTempRefactoring.java;4;1;18;1;3;3;3;15;92;2;14;122;206;206;2;1;0;15;18;1953;1;6340;17;4;
/org.eclipse.team.cvs.ui/src/org/eclipse/team/internal/ccvs/ui/CVSPreferencesPage.java;2;1;8;1;3;3;3;5;26;1;5;885;75;75;1;0;0;5;8;885;0;6337;8;2;
/org.eclipse.jdt.ui.tests.refactoring/resources/IntroduceFactory/positive/Names_FFF.java;1;0;2;1;1;1;1;1;2;0;1;2862;2;2;1;0;0;1;2;2862;0;5659;2;1;
/org.eclipse.jdt.core.tests.model/workspace/Converter/test0174/Test.java;1;0;1;1;0;0;0;1;0;0;1;3714;0;0;1;0;0;1;1;3714;0;3714;1;1;
/org.eclipse.jdt.ui.tests.refactoring/test cases/org/eclipse/jdt/ui/tests/nls/CellEditorTester.java;1;0;1;1;1;1;1;0;2;0;0;6340;2;2;1;0;0;0;1;6340;0;6340;1;1;
/org.eclipse.jdt.core.tests.model/workspace/Formatter/test247/A_in.java;1;0;1;1;0;0;0;1;0;0;1;2442;0;0;1;0;0;1;1;2442;0;2442;1;1;
/org.eclipse.ui.ide/src/org/eclipse/ui/views/navigator/ShowInNavigatorAction.java;1;0;1;1;0;0;0;1;0;0;1;2208;0;0;1;0;0;1;1;2208;0;2208;1;1;
/org.eclipse.team.core/src/org/eclipse/team/core/subscribers/IComparisonCriteria.java;1;0;1;1;0;0;0;1;0;0;1;3550;0;0;1;0;0;1;1;3550;0;3550;1;1;
/org.eclipse.debug.ui/ui/org/eclipse/debug/internal/ui/actions/ToggleStepFiltersActionDelegate.java;2;0;5;1;0;0;0;5;23;1;5;3613;45;45;1;0;0;5;5;3613;0;4497;5;2;
/org.eclipse.help/src/org/eclipse/help/internal/util/FastStack.java;1;1;2;1;2;2;2;0;15;0;0;5827;21;21;1;0;0;0;2;5827;0;6337;2;1;
/org.eclipse.pde.ui/src/org/eclipse/pde/internal/ui/editor/manifest/ManifestPropertySource.java;2;0;2;1;1;1;1;1;2;0;1;2184;2;2;1;0;0;1;2;2184;0;5431;2;2;
/org.eclipse.swt.tests/JUnit Tests/org/eclipse/swt/tests/junit/Test_org_eclipse_swt_ole_win32_OleControlSite.java;1;0;1;1;0;0;0;1;0;0;1;2176;0;0;1;0;0;1;1;2176;0;2176;1;1;
/org.eclipse.jdt.ui.tests.refactoring/resources/ChangeSignature/canModify/A_testAll61_in.java;1;0;1;1;1;1;1;0;0;0;0;5674;0;0;1;0;0;0;1;5674;0;5674;1;1;
/org.eclipse.jdt.core/dom/org/eclipse/jdt/core/dom/IVariableBinding.java;3;0;4;1;1;1;1;3;15;1;3;3560;23;23;1;0;0;3;4;3560;0;5784;4;3;
/org.eclipse.ui.workbench.texteditor/src/org/eclipse/ui/texteditor/MarkerAnnotationPreferences.java;2;0;6;1;0;0;0;6;33;1;6;1503;121;121;1;0;0;6;6;1503;0;2741;6;2;
/org.eclipse.jdt.ui/ui/org/eclipse/jdt/internal/ui/text/correction/CorrectMainTypeNameProposal.java;3;1;9;1;3;3;3;6;17;1;6;377;62;62;1;0;0;6;9;377;0;6340;9;3;
/org.eclipse.ui.views/src/org/eclipse/ui/views/markers/internal/ActionCopyMarker.java;2;0;2;1;0;0;0;2;0;1;2;755;0;0;1;0;0;2;2;755;0;2738;2;2;
/org.eclipse.jdt.ui.examples.javafamily/src/org/eclipse/text/reconcilerpipe/AbstractReconcilePipeParticipant.java;1;0;3;1;0;0;0;3;21;1;3;1071;21;21;1;0;0;3;3;1071;0;1629;3;1;
/org.eclipse.jdt.core.tests.compiler/src/org/eclipse/jdt/core/tests/compiler/parser/DualParseSyntaxErrorTest.java;4;0;11;1;0;0;0;11;28;2;10;1043;61;61;2;1;0;11;11;1057;1;4731;10;4;
/org.eclipse.jdt.core.tests.model/workspace/Converter/src/test0108/Test.java;1;0;1;1;0;0;0;1;0;0;1;3714;0;0;1;0;0;1;1;3714;0;3714;1;1;
/org.eclipse.core.runtime.osgi/src/org/eclipse/core/runtime/OperationCanceledException.java;1;0;2;1;0;0;0;2;24;1;2;3013;24;24;1;0;0;2;2;3013;0;3030;2;1;
/org.eclipse.swt.graphics.text/org.eclipse.swt/Eclipse SWT Custom Widgets/common/org/eclipse/swt/custom/StyledTextBidi.java;1;0;1;1;0;0;0;1;0;0;1;2267;0;0;1;0;0;1;1;2267;0;2267;1;1;
/org.eclipse.core.tools/src/org/eclipse/core/tools/ITreeNodeVisitor.java;1;0;1;1;1;1;1;0;0;0;0;6302;0;0;1;0;0;0;1;6302;0;6302;1;1;
/org.eclipse.jdt.core.tests.model/workspace/Formatter/test031/A_in.java;1;0;1;1;0;0;0;1;0;0;1;2425;0;0;1;0;0;1;1;2425;0;2425;1;1;
/org.eclipse.ant.ui/Ant Tools Support/org/eclipse/ant/ui/internal/preferences/AntClasspathLabelProvider.java;1;0;5;1;0;0;0;5;52;1;5;250;83;83;1;0;0;5;5;250;0;1811;5;1;
/org.eclipse.core.expressions.tests/src/org/eclipse/core/internal/expressions/tests/Adapter.java;1;0;1;1;0;0;0;1;0;0;1;4507;0;0;1;0;0;1;1;4507;0;4507;1;1;
/org.eclipse.jdt.ui.tests.refactoring/resources/PromoteTempToField/canPromote/A_test18_out.java;1;0;1;1;0;0;0;1;23;0;1;1134;23;23;1;0;0;1;1;1134;0;1134;1;1;
/org.eclipse.jdt.ui/core refactoring/org/eclipse/jdt/internal/corext/refactoring/nls/NLSSourceModifier.java;2;3;9;1;9;7;9;0;373;0;0;5186;544;544;3;0;2;0;9;5375;2;6340;7;2;
/org.eclipse.ui.tests/Eclipse UI Tests/org/eclipse/ui/tests/navigator/ResourceNavigatorTest.java;1;0;1;1;0;0;0;1;3;0;1;3091;3;3;1;0;0;1;1;3091;0;3091;1;1;
/org.eclipse.jdt.ui/ui/org/eclipse/jdt/internal/ui/preferences/BuildPathsPropertyPage.java;2;1;9;1;2;2;2;7;50;1;7;597;116;116;1;0;0;7;9;597;0;6340;9;2;
/org.eclipse.jdt.core.tests.model/workspace/Formatter/test321/A_in.java;1;0;1;1;0;0;0;1;0;0;1;2462;0;0;1;0;0;1;1;2462;0;2462;1;1;
/org.eclipse.jdt.core.tests.model/workspace/Completion/src/CompletionStaticMethod1.java;1;0;1;1;0;0;0;1;0;0;1;3040;0;0;1;0;0;1;1;3040;0;3040;1;1;
/org.eclipse.jdt.ui/ui/org/eclipse/jdt/internal/ui/filters/FilterDescriptor.java;3;1;7;1;3;3;3;4;52;1;4;346;137;137;1;0;0;4;7;346;0;6340;7;3;
/org.eclipse.jdt.core.tests.model/workspace/Converter15/src/test0011/X.java;1;0;1;1;0;0;0;1;0;0;1;4651;0;0;1;0;0;1;1;4651;0;4651;1;1;
/org.eclipse.team.ui/src/org/eclipse/team/ui/synchronize/subscriber/SubscriberPageDiffTreeViewerConfiguration.java;1;0;4;1;0;0;0;4;135;2;3;4047;137;137;2;1;0;4;4;4240;1;4240;3;1;
/org.eclipse.swt/Eclipse SWT PI/motif_gtk/org/eclipse/swt/internal/gtk/GTK.java;1;0;1;1;0;0;0;1;0;0;1;2124;0;0;1;0;0;1;1;2124;0;2124;1;1;
/org.eclipse.team.cvs.core/src/org/eclipse/team/internal/ccvs/core/resources/RemoteFolder.java;2;0;14;1;1;1;1;13;429;1;13;790;787;787;1;0;0;13;14;790;0;6337;14;2;
/org.eclipse.pde.core/src/org/eclipse/pde/core/osgi/bundle/IBundle.java;1;0;4;1;0;0;0;4;8;1;4;4203;11;11;1;0;0;4;4;4203;0;4726;4;1;
/org.eclipse.ui.ide/src/org/eclipse/ui/internal/misc/WizardStepGroup.java;2;0;3;1;0;0;0;3;4;1;3;1526;4;4;1;0;0;3;3;1526;0;2263;3;2;
/org.eclipse.ui.ide/src/org/eclipse/ui/IImportWizard.java;2;0;2;1;0;0;0;2;0;1;2;1511;0;0;1;0;0;2;2;1511;0;2263;2;2;
/org.eclipse.debug.ui/ui/org/eclipse/debug/internal/ui/console/ConsoleWorkbenchPart.java;2;0;3;1;0;0;0;3;4;1;3;1294;4;4;1;0;0;3;3;1294;0;2060;3;2;
/org.eclipse.ui.workbench/Eclipse UI/org/eclipse/ui/themes/IThemeManager.java;2;1;5;1;2;2;2;3;65;1;3;4428;83;83;1;0;0;3;5;4428;0;6340;5;2;
/org.eclipse.ui.ide/src/org/eclipse/ui/part/FileEditorInputFactory.java;2;0;2;1;0;0;0;2;0;1;2;1511;0;0;1;0;0;2;2;1511;0;2263;2;2;
/org.eclipse.core.runtime.compatibility/src-runtime/org/eclipse/core/internal/plugins/PluginStopper.java;4;0;6;1;0;0;0;6;14;1;6;3013;30;30;1;0;0;6;6;3013;0;4678;6;4;
/org.eclipse.core.boot/src/org/eclipse/core/internal/boot/PlatformURLHandlerFactory.java;1;0;1;1;0;0;0;1;0;0;1;3013;0;0;1;0;0;1;1;3013;0;3013;1;1;
/org.eclipse.jdt.ui.tests/ui/org/eclipse/jdt/ui/tests/search/SearchLeakTest.java;3;0;4;1;1;1;1;3;10;1;3;4367;18;18;1;0;0;3;4;4367;0;5422;4;3;
/org.eclipse.swt/Eclipse SWT/win32/org/eclipse/swt/internal/Converter.java;1;0;1;1;0;0;0;1;0;0;1;249;0;0;1;0;0;1;1;249;0;249;1;1;
/org.eclipse.ui.tests/Eclipse UI Tests/org/eclipse/ui/tests/zoom/ActivateTest.java;2;0;2;1;1;1;1;1;9;0;1;4567;11;11;1;0;0;1;2;4567;0;6338;2;2;
/org.eclipse.ui.workbench.texteditor/src/org/eclipse/ui/texteditor/ExtendedTextEditorPreferenceConstants.java;3;0;3;1;0;0;0;3;3;1;3;1644;3;3;1;0;0;3;3;1644;0;2741;3;3;
/org.eclipse.pde.ui/src_Forms/org/eclipse/pde/internal/ui/neweditor/context/InputContext.java;2;1;20;2;5;5;5;15;65;3;12;4243;349;349;3;3;0;15;20;4933;3;5431;17;2;
/org.eclipse.pde.ui/src/org/eclipse/pde/ui/templates/TemplateField.java;2;1;4;1;4;4;4;0;44;0;0;5115;107;107;1;0;0;0;4;5115;0;6336;4;2;
/org.eclipse.team.cvs.ui/src/org/eclipse/team/internal/ccvs/ui/subscriber/CVSSynchronizeViewPage.java;2;0;9;2;0;0;0;9;136;2;8;2590;303;303;2;1;0;9;9;4585;1;4585;8;2;
/org.eclipse.jdt.ui/core refactoring/org/eclipse/jdt/internal/corext/refactoring/typeconstraints/TypeBindings.java;3;1;7;1;2;2;2;5;10;2;4;42;38;38;2;1;0;5;7;50;1;6340;6;3;
/org.eclipse.swt/Eclipse SWT AWT/emulated/org/eclipse/swt/awt/SWT_AWT.java;3;1;8;1;6;6;6;2;41;1;2;3013;64;64;1;0;0;2;8;3013;0;6352;8;3;
/org.eclipse.pde.core/src/org/eclipse/pde/internal/core/site/IdentifiableObject.java;2;1;3;1;2;2;2;1;8;0;1;4203;14;14;1;0;0;1;3;4203;0;6336;3;2;
/org.eclipse.update.ui.forms/Eclipse Forms/org/eclipse/ui/forms/events/HyperlinkAdapter.java;1;0;2;1;0;0;0;2;0;1;2;3096;0;0;1;0;0;2;2;3096;0;4157;2;1;
/org.eclipse.jdt.debug.tests/tests/org/eclipse/jdt/debug/tests/core/ClasspathProviderTests.java;2;0;2;1;0;0;0;2;54;1;2;112;63;63;1;0;0;2;2;112;0;1262;2;2;
/org.eclipse.pde.ui/sandbox/org/eclipse/pde/internal/ui/editor/standalone/text/IReconcilingParticipant.java;1;0;2;1;0;0;0;2;0;1;2;2320;0;0;1;0;0;2;2;2320;0;2906;2;1;
/org.eclipse.swt.tests/JUnit Tests/org/eclipse/swt/tests/junit/Test_org_eclipse_swt_graphics_FontData.java;2;0;4;1;1;1;1;3;11;1;3;2175;21;21;1;0;0;3;4;2175;0;6352;4;2;
/org.eclipse.debug.ui/ui/org/eclipse/debug/internal/ui/sourcelookup/ISourceLocationBrowser.java;1;0;2;1;0;0;0;2;3;1;2;3171;3;3;1;0;0;2;2;3171;0;3770;2;1;
/org.eclipse.ui.workbench/Eclipse UI/org/eclipse/ui/commands/CommandException.java;3;1;3;1;2;2;2;1;22;0;1;4088;26;26;1;0;0;1;3;4088;0;6338;3;3;
/org.eclipse.text/src/org/eclipse/jface/text/ISynchronizable.java;2;1;3;1;3;3;3;0;37;0;0;5382;39;39;1;0;0;0;3;5382;0;6340;3;2;
/org.eclipse.ui.ide/src/org/eclipse/ui/internal/ide/dialogs/IDEEditorsPreferencePage.java;4;0;5;2;2;1;2;3;4;1;3;2793;7;7;2;0;1;3;5;6338;1;6338;4;4;
/org.eclipse.jdt.ui/ui/org/eclipse/jdt/ui/text/spelling/engine/DefaultPhoneticDistanceAlgorithm.java;1;0;2;1;0;0;0;2;0;1;2;3829;0;0;1;0;0;2;2;3829;0;3930;2;1;
/org.eclipse.jdt.ui/ui/org/eclipse/jdt/internal/ui/wizards/buildpaths/CPVariableElement.java;1;0;1;1;1;1;1;0;2;0;0;6340;2;2;1;0;0;0;1;6340;0;6340;1;1;
/org.eclipse.jdt.core/compiler/org/eclipse/jdt/internal/compiler/parser/TerminalTokens.java;3;0;8;2;0;0;0;8;234;2;7;764;870;870;2;1;0;8;8;858;1;3560;7;3;
/org.eclipse.ui.workbench.texteditor/src/org/eclipse/ui/internal/texteditor/quickdiff/RestoreAction.java;2;0;3;1;1;1;1;2;6;1;2;1644;11;11;1;0;0;2;3;1644;0;6340;3;2;
/org.eclipse.jdt.debug.ui/ui/org/eclipse/jdt/internal/debug/ui/sourcelookup/ClasspathContainerSourceContainerBrowser.java;1;1;9;1;2;2;2;7;59;2;6;4167;147;147;2;1;0;7;9;4970;1;5579;8;1;
/org.eclipse.ui.workbench/Eclipse UI/org/eclipse/ui/PlatformUI.java;4;2;11;2;5;3;5;6;125;2;5;2737;207;207;2;1;2;6;11;2785;3;6338;8;4;
/org.eclipse.jdt.core.tests.model/workspace/Converter/src/test0406_a/A.java;1;0;1;1;0;0;0;1;0;0;1;3714;0;0;1;0;0;1;1;3714;0;3714;1;1;
/org.eclipse.core.tests.runtime/src/org/eclipse/core/tests/internal/runtimetests/SampleLPR.java;1;0;1;1;1;1;1;0;21;0;0;5149;21;21;1;0;0;0;1;5149;0;5149;1;1;
/org.eclipse.jdt.ui.tests.refactoring/resources/ExtractMethodWorkSpace/ExtractMethodTests/return_out/A_test705.java;1;0;2;1;0;0;0;2;6;1;2;130;7;7;1;0;0;2;2;130;0;844;2;1;
/org.eclipse.ui.forms/src/org/eclipse/ui/forms/widgets/ToggleHyperlink.java;1;0;2;1;0;0;0;2;152;1;2;4068;152;152;1;0;0;2;2;4068;0;4154;2;1;
/org.eclipse.team.ui/src/org/eclipse/team/internal/ui/synchronize/actions/StatusLineContributionGroup.java;2;2;17;2;8;7;8;9;116;1;9;2535;624;624;2;0;1;9;17;5358;1;6337;16;2;
/org.eclipse.jdt.core.tests.model/workspace/Formatter/test186/A_out.java;1;0;1;1;0;0;0;1;0;0;1;2425;0;0;1;0;0;1;1;2425;0;2425;1;1;
/org.eclipse.jdt.core.tests.model/workspace/Formatter/test043/A_in.java;1;0;1;1;0;0;0;1;0;0;1;2425;0;0;1;0;0;1;1;2425;0;2425;1;1;
/org.eclipse.jdt.core.tests.model/workspace/Formatter/test019/A_2_out.java;1;0;1;1;0;0;0;1;0;0;1;2425;0;0;1;0;0;1;1;2425;0;2425;1;1;
/org.eclipse.jdt.ui.tests.refactoring/resources/ExtractMethodWorkSpace/ExtractMethodTests/locals_out/A_test567.java;1;0;2;1;0;0;0;2;4;1;2;130;5;5;1;0;0;2;2;130;0;844;2;1;
/org.eclipse.jdt.ui.tests.refactoring/resources/MoveMembers/test5/out/A.java;1;0;1;1;0;0;0;1;4;0;1;1522;4;4;1;0;0;1;1;1522;0;1522;1;1;
/org.eclipse.update.core/src/org/eclipse/update/configuration/IActivity.java;1;0;1;1;0;0;0;1;4;0;1;890;4;4;1;0;0;1;1;890;0;890;1;1;
/org.eclipse.jdt.ui.tests.refactoring/resources/ExtractMethodWorkSpace/ExtractMethodTests/locals_in/A_test536.java;1;0;1;1;0;0;0;1;4;0;1;844;4;4;1;0;0;1;1;844;0;844;1;1;
/org.eclipse.pde.core/src/org/eclipse/pde/internal/core/ifeature/IFeatureURLElement.java;2;1;3;1;2;2;2;1;4;0;1;4203;11;11;1;0;0;1;3;4203;0;6336;3;2;
/org.eclipse.core.runtime/src/org/eclipse/core/internal/content/BinarySignatureDescriber.java;1;1;3;1;3;3;3;0;12;0;0;5195;12;12;1;0;0;0;3;5195;0;5231;3;1;
/org.eclipse.ui.workbench/Eclipse UI/org/eclipse/ui/internal/commands/SequenceBinding.java;1;0;4;1;0;0;0;4;57;1;4;607;57;57;1;0;0;4;4;607;0;1077;4;1;
/org.eclipse.ui.forms/src/org/eclipse/ui/forms/FormWizardPage.java;1;0;6;1;0;0;0;6;6;1;6;4068;13;13;1;0;0;6;6;4068;0;5044;6;1;
/org.eclipse.jdt.ui/ui/org/eclipse/jdt/ui/ITypeHierarchyViewPart.java;2;0;3;2;2;1;2;1;6;0;1;4823;12;12;2;0;1;1;3;6334;1;6334;2;2;
/org.eclipse.swt.tests/JUnit Tests/org/eclipse/swt/tests/junit/Test_org_eclipse_swt_printing_PrinterData.java;1;0;1;1;0;0;0;1;3;0;1;2175;3;3;1;0;0;1;1;2175;0;2175;1;1;
/org.eclipse.ant.ui/Ant Editor/org/eclipse/ant/internal/ui/editor/model/AntProjectNode.java;1;1;12;1;2;2;2;10;18;2;9;3661;84;84;2;1;0;10;12;4587;1;6018;11;1;
/org.eclipse.jdt.ui/core extension/org/eclipse/jdt/internal/corext/template/java/JavaTemplateMessages.java;2;1;2;1;2;2;2;0;2;0;0;5264;4;4;1;0;0;0;2;5264;0;6340;2;2;
/org.eclipse.jdt.ui/core refactoring/org/eclipse/jdt/internal/corext/refactoring/base/JavaSourceContext.java;2;0;2;1;0;0;0;2;10;1;2;218;10;10;1;0;0;2;2;218;0;882;2;2;
/org.eclipse.ui.externaltools/External Tools Base/org/eclipse/ui/externaltools/internal/model/ImageDescriptorRegistry.java;1;0;1;1;0;0;0;1;4;0;1;3569;4;4;1;0;0;1;1;3569;0;3569;1;1;
/org.eclipse.debug.ui/ui/org/eclipse/debug/ui/variables/ExpandVariableContext.java;1;0;4;1;0;0;0;4;100;3;2;316;100;100;3;2;0;4;4;316;2;550;2;1;
/org.eclipse.pde.core/src/org/eclipse/pde/core/plugin/IExtensions.java;3;1;9;1;5;5;5;4;48;1;4;2184;95;95;1;0;0;4;9;2184;0;6336;9;3;
/org.eclipse.swt/Eclipse SWT PI/gtk/org/eclipse/swt/internal/gtk/GdkEventCrossing.java;3;0;4;1;1;1;1;3;17;1;3;1653;25;25;1;0;0;3;4;1653;0;6352;4;3;
/org.eclipse.ui.forms/src/org/eclipse/ui/forms/PageForm.java;1;0;2;1;0;0;0;2;0;0;1;4284;0;0;2;1;0;2;2;4284;1;4284;1;1;
/org.eclipse.core.tests.harness/src/org/eclipse/core/tests/harness/TestProgressMonitor.java;2;1;2;1;2;2;2;0;87;0;0;5146;95;95;1;0;0;0;2;5146;0;5613;2;2;
/org.eclipse.help.base/src/org/eclipse/help/internal/search/QueryWordsToken.java;1;1;5;1;3;3;3;2;16;1;2;1740;36;36;1;0;0;2;5;1740;0;6337;5;1;
/org.eclipse.jdt.ui.tests.refactoring/resources/ExtractTemp/canExtract/A_test72_out.java;1;0;1;1;0;0;0;1;0;0;1;1569;0;0;1;0;0;1;1;1569;0;1569;1;1;
/org.eclipse.core.filebuffers/src/org/eclipse/core/internal/filebuffers/TextFileBuffer.java;2;0;6;1;0;0;0;6;322;1;6;1522;359;359;1;0;0;6;6;1522;0;2224;6;2;
/org.eclipse.core.runtime.compatibility/src-runtime/org/eclipse/core/runtime/Platform.java;2;0;4;1;0;0;0;4;836;1;4;3013;840;840;1;0;0;4;4;3013;0;3169;4;2;
/org.eclipse.ant.ui/Ant Tools Support/org/eclipse/ant/internal/ui/preferences/AbstractClasspathEntry.java;1;0;5;1;0;0;0;5;27;2;4;2288;51;51;2;1;0;5;5;2569;1;4097;4;1;
/org.eclipse.pde.ui/src/org/eclipse/pde/internal/ui/preferences/BuildPropertiesPreferencePage.java;1;0;4;1;0;0;0;4;19;1;4;1111;22;22;1;0;0;4;4;1111;0;1718;4;1;
/org.eclipse.swt.tests/JUnit Tests/org/eclipse/swt/tests/junit/Test_org_eclipse_swt_graphics_Drawable.java;1;0;1;1;0;0;0;1;25;0;1;2175;25;25;1;0;0;1;1;2175;0;2175;1;1;
/org.eclipse.ant.ui/Ant Tools Support/org/eclipse/ant/internal/ui/views/AntViewMessages.java;1;0;1;1;0;0;0;1;0;0;1;1811;0;0;1;0;0;1;1;1811;0;1811;1;1;
/org.eclipse.jdt.ui/ui refactoring/org/eclipse/jdt/internal/ui/refactoring/ExtractInterfaceInputPage.java;1;0;1;1;0;0;0;1;0;0;1;518;0;0;1;0;0;1;1;518;0;518;1;1;
/org.eclipse.ant.ui/Ant Tools Support/org/eclipse/ant/ui/internal/preferences/PropertyFileFilter.java;1;0;2;1;0;0;0;2;0;1;2;1537;0;0;1;0;0;2;2;1537;0;1811;2;1;
/org.eclipse.core.tests.resources/src/org/eclipse/core/tests/resources/usecase/SignaledBuilder.java;2;0;3;1;2;1;2;1;61;0;1;2226;74;74;2;0;1;1;3;5147;1;5147;2;2;
/org.eclipse.jdt.core.tests.model/workspace/Converter/test0069/Test.java;1;0;1;1;0;0;0;1;0;0;1;3714;0;0;1;0;0;1;1;3714;0;3714;1;1;
/org.eclipse.jdt.ui.tests/ui/org/eclipse/jdt/ui/tests/core/TextEditTests.java;1;0;6;1;1;1;1;5;364;1;5;1972;612;612;1;0;0;5;6;1972;0;5272;6;1;
/org.eclipse.ui.workbench/Eclipse UI/org/eclipse/ui/internal/commands/registry/CategoryDefinition.java;1;0;8;1;0;0;0;8;64;2;6;1396;152;152;2;2;0;8;8;1396;2;1724;6;1;
/org.eclipse.ui.workbench/Eclipse UI/org/eclipse/ui/internal/csm/roles/IMutableRoleRegistry.java;1;0;2;1;0;0;0;2;0;1;2;2225;0;0;1;0;0;2;2;2225;0;2371;2;1;
/org.eclipse.osgi/resolver/src/org/eclipse/osgi/internal/resolver/Eclipse30SelectionPolicy.java;4;1;4;1;3;3;3;1;40;0;1;3013;63;63;1;0;0;1;4;3013;0;5408;4;4;
/org.eclipse.webdav/src/kernel/org/eclipse/webdav/internal/kernel/QualifiedNameImpl.java;1;0;2;1;2;1;2;0;148;0;0;5151;148;148;2;0;1;0;2;5151;1;5151;1;1;
/org.eclipse.ui.workbench/Eclipse UI/org/eclipse/ui/internal/csm/roles/IRoleActivationServiceListener.java;1;0;2;1;0;0;0;2;0;1;2;2213;0;0;1;0;0;2;2;2213;0;2225;2;1;
/org.eclipse.jdt.ui.tests/ui/org/eclipse/jdt/ui/tests/text/JavaDocTagsTest.java;1;0;2;1;0;0;0;2;0;1;2;2547;0;0;1;0;0;2;2;2547;0;3937;2;1;
/org.eclipse.search/search/org/eclipse/search/internal/ui/SearchResultViewEntry.java;1;0;1;1;1;1;1;0;2;0;0;6340;2;2;1;0;0;0;1;6340;0;6340;1;1;
/org.eclipse.ant.tests.ui/Ant Editor Tests/org/eclipse/ant/ui/internal/editor/test/EnclosingTargetSearchingHandlerTest.java;1;0;4;1;0;0;0;4;69;1;4;1274;76;76;1;0;0;4;4;1274;0;1811;4;1;
/org.eclipse.team.cvs.ui/src/org/eclipse/team/internal/ccvs/ui/actions/OpenLogEntryAction.java;2;1;2;1;2;2;2;0;4;0;0;5683;6;6;1;0;0;0;2;5683;0;6337;2;2;
/org.eclipse.team.examples.filesystem/src/org/eclipse/team/examples/filesystem/ui/ProjectSetSerializer.java;1;0;1;1;1;1;1;0;0;0;0;5822;0;0;1;0;0;0;1;5822;0;5822;1;1;
/org.eclipse.ui.workbench/Eclipse UI/org/eclipse/ui/internal/roles/IActivityListener.java;2;0;3;1;0;0;0;3;2;1;3;2060;2;2;1;0;0;3;3;2060;0;2443;3;2;
/org.eclipse.pde.core/src/org/eclipse/pde/core/IWorkspaceModelManager.java;2;0;3;1;0;0;0;3;1;1;3;2229;1;1;1;0;0;3;3;2229;0;4203;3;2;
/org.eclipse.debug.ui/ui/org/eclipse/debug/ui/launchVariables/VariableUtil.java;1;0;2;1;0;0;0;2;0;1;2;550;0;0;1;0;0;2;2;550;0;562;2;1;
/org.eclipse.osgi/console/src/org/eclipse/osgi/framework/internal/core/FrameworkConsole.java;3;1;6;1;3;3;3;3;78;1;3;3013;171;171;1;0;0;3;6;3013;0;6337;6;3;
/org.eclipse.team.cvs.core/src/org/eclipse/team/internal/ccvs/core/CVSInSyncInfo.java;1;0;1;1;0;0;0;1;0;0;1;4173;0;0;1;0;0;1;1;4173;0;4173;1;1;
/org.eclipse.core.expressions/src/org/eclipse/core/internal/expressions/SystemTestExpression.java;1;0;2;1;1;1;1;1;8;0;1;4108;8;8;1;0;0;1;2;4108;0;6340;2;1;
/org.eclipse.jdt.core.tests.model/workspace/Converter/src/test0430/A.java;1;0;1;1;0;0;0;1;0;0;1;3714;0;0;1;0;0;1;1;3714;0;3714;1;1;
/org.eclipse.core.tools/src/org/eclipse/core/tools/SpyView.java;1;0;1;1;1;1;1;0;0;0;0;6302;0;0;1;0;0;0;1;6302;0;6302;1;1;
/org.eclipse.jdt.junit/src/org/eclipse/jdt/internal/junit/ui/JUnitMessages.java;1;0;1;1;1;1;1;0;4;0;0;6340;4;4;1;0;0;0;1;6340;0;6340;1;1;
/org.eclipse.jdt.debug.tests/tests/org/eclipse/jdt/debug/tests/eval/StaticFieldValueTests2.java;1;0;1;1;0;0;0;1;18;0;1;1274;18;18;1;0;0;1;1;1274;0;1274;1;1;
/org.eclipse.jdt.ui/ui/org/eclipse/jdt/ui/ISharedImages.java;2;2;3;2;3;2;3;0;158;0;0;5168;170;170;2;0;1;0;3;6334;1;6334;2;2;
/org.eclipse.swt/Eclipse SWT Browser/common/org/eclipse/swt/browser/CloseWindowListener.java;2;0;7;1;1;1;1;6;27;2;5;2899;52;52;2;1;0;6;7;2899;1;6352;6;2;
/org.eclipse.jdt.ui/core refactoring/org/eclipse/jdt/internal/corext/refactoring/typeconstraints/ExpressionVariable.java;2;0;5;1;1;1;1;4;78;1;4;42;145;145;1;0;0;4;5;42;0;6340;5;2;
/org.eclipse.jdt.core.tests.model/workspace/Converter/src/javadoc/testBug50898/Test.java;1;0;1;1;0;0;0;1;0;0;1;3899;0;0;1;0;0;1;1;3899;0;3899;1;1;
/org.eclipse.text.tests/src/org/eclipse/text/tests/EclipseTextTestSuite.java;1;1;3;1;3;3;3;0;3;0;0;5129;5;5;1;0;0;0;3;5129;0;6340;3;1;
/org.eclipse.team.ui/src/org/eclipse/team/internal/ui/sync/views/ChangeFiltersContentProvider.java;1;0;3;1;0;0;0;3;57;1;3;488;57;57;1;0;0;3;3;488;0;1354;3;1;
/org.eclipse.swt/Eclipse SWT Custom Widgets/common/org/eclipse/swt/custom/ViewForm.java;4;2;17;1;10;9;10;7;439;1;7;125;1152;1152;2;0;1;7;17;5358;1;6352;16;4;
/org.eclipse.team.ui/src/org/eclipse/team/internal/ui/synchronize/SubscriberRefreshWizard.java;2;1;4;1;4;4;4;0;2;0;0;5362;4;4;1;0;0;0;4;5362;0;5596;4;2;
/org.eclipse.jdt.core.tests.model/workspace/Converter/src/test0360/X.java;1;0;1;1;0;0;0;1;0;0;1;3714;0;0;1;0;0;1;1;3714;0;3714;1;1;
/org.eclipse.debug.ui/ui/org/eclipse/debug/internal/ui/sourcelookup/containers/WorkingSetSourceContainer.java;1;0;6;1;0;0;0;6;24;2;4;3770;44;44;2;2;0;6;6;4109;2;4970;4;1;
/org.eclipse.jdt.ui/core refactoring/org/eclipse/jdt/internal/corext/refactoring/surround/LocalDeclarationAnalyzer.java;1;0;1;1;1;1;1;0;2;0;0;6340;2;2;1;0;0;0;1;6340;0;6340;1;1;
/org.eclipse.ui.ide/src/org/eclipse/ui/internal/ide/dialogs/ZipFileResourceExporter.java;1;0;1;1;0;0;0;1;0;0;1;2264;0;0;1;0;0;1;1;2264;0;2264;1;1;
/org.eclipse.jdt.ui.tests.refactoring/resources/MoveMembers/test28/in/B.java;1;0;1;1;0;0;0;1;0;0;1;1522;0;0;1;0;0;1;1;1522;0;1522;1;1;
/org.eclipse.update.core/src/org/eclipse/update/core/model/IncludedFeatureReferenceModel.java;3;1;5;1;3;3;3;2;78;1;2;0;102;102;1;0;0;2;5;0;0;6336;5;3;
/org.eclipse.ant.core/src_ant/org/eclipse/ant/internal/core/ant/NullInputHandler.java;1;0;1;1;1;1;1;0;0;0;0;5626;0;0;1;0;0;0;1;5626;0;5626;1;1;
/org.eclipse.help/src/org/eclipse/help/internal/search/ISearchQuery.java;1;0;1;1;0;0;0;1;0;0;1;2732;0;0;1;0;0;1;1;2732;0;2732;1;1;
/org.eclipse.releng.tools/src/org/eclipse/releng/tools/RepositorySelectionDialog.java;1;1;2;1;2;2;2;0;4;0;0;5183;4;4;1;0;0;0;2;5183;0;6340;2;1;
/org.eclipse.pde.core/src/org/eclipse/pde/internal/core/SearchablePluginsManager.java;3;2;9;2;7;5;7;2;203;1;2;3435;241;241;2;0;2;2;9;5760;2;6336;7;3;
/org.eclipse.jdt.ui/core refactoring/org/eclipse/jdt/internal/corext/refactoring/participants/xml/ITypeExtender.java;1;0;4;1;0;0;0;4;7;1;4;2204;9;9;1;0;0;4;4;2204;0;4091;4;1;
/org.eclipse.jface.text/projection/org/eclipse/jface/text/source/projection/IProjectionListener.java;2;1;3;1;3;3;3;0;5;0;0;5127;7;7;1;0;0;0;3;5127;0;6362;3;2;
/org.eclipse.core.resources/src/org/eclipse/core/internal/resources/MarkerTypeDefinition.java;2;1;2;1;2;2;2;0;148;0;0;5146;157;157;1;0;0;0;2;5146;0;5597;2;2;
/org.eclipse.core.tests.runtime/src/org/eclipse/core/tests/internal/plugins/PluginResolveTest_4.java;1;0;1;1;0;0;0;1;0;0;1;3014;0;0;1;0;0;1;1;3014;0;3014;1;1;
/org.eclipse.jface.text/src/org/eclipse/jface/text/DefaultTextDoubleClickStrategy.java;2;1;3;1;2;2;2;1;16;0;1;1347;20;20;1;0;0;1;3;1347;0;6359;3;2;
/org.eclipse.jdt.debug.tests/tests/org/eclipse/jdt/debug/tests/core/LaunchModeTests.java;5;1;11;1;2;2;2;9;64;1;9;463;185;185;1;0;0;9;11;463;0;6337;11;5;
/org.eclipse.jdt.core.tests.model/workspace/Converter/src/javadoc/test019/TestB2.java;1;0;2;1;0;0;0;2;0;1;2;4311;0;0;1;0;0;2;2;4311;0;4390;2;1;
/org.eclipse.jface/src/org/eclipse/jface/action/IContributionManagerOverrides.java;4;1;4;1;3;3;3;1;31;0;1;2610;40;40;1;0;0;1;4;2610;0;6338;4;4;
/org.eclipse.jdt.ui/core refactoring/org/eclipse/jdt/internal/corext/refactoring/code/InvocationAnalyzer.java;1;0;2;1;0;0;0;2;8;1;2;882;8;8;1;0;0;2;2;882;0;2281;2;1;
/org.eclipse.jdt.ui/core extension/org/eclipse/jdt/internal/corext/textmanipulation/ISourceModifier.java;1;0;2;1;0;0;0;2;0;1;2;1607;0;0;1;0;0;2;2;1607;0;1953;2;1;
/org.eclipse.jdt.ui/ui/org/eclipse/jdt/ui/actions/ReferencesSearchGroup.java;3;1;5;1;2;2;2;3;11;1;3;1350;24;24;1;0;0;3;5;1350;0;6340;5;3;
/org.eclipse.jdt.core.tests.model/workspace/Converter15/src/test0025/X.java;1;0;1;1;0;0;0;1;0;0;1;4849;0;0;1;0;0;1;1;4849;0;4849;1;1;
/org.eclipse.ui.workbench/Eclipse UI/org/eclipse/ui/internal/roles/api/IRoleActivationService.java;1;0;2;1;0;0;0;2;0;0;1;2202;0;0;2;1;0;2;2;2202;1;2202;1;1;
/org.eclipse.swt/Eclipse SWT PI/gtk/org/eclipse/swt/internal/accessibility/gtk/AtkObjectFactoryClass.java;4;0;4;1;1;1;1;3;17;1;3;1214;25;25;1;0;0;3;4;1214;0;6352;4;4;
/org.eclipse.jdt.core.tests.model/workspace/Formatter/test353/A_out.java;2;0;2;1;0;0;0;2;4;1;2;3029;4;4;1;0;0;2;2;3029;0;3362;2;2;
/org.eclipse.jdt.debug.ui/ui/org/eclipse/jdt/internal/debug/ui/sourcelookup/ClasspathVariableSourceContainerBrowser.java;1;1;8;1;2;2;2;6;30;2;5;4167;61;61;2;1;0;6;8;4970;1;5579;7;1;
/org.eclipse.pde.ui/src/org/eclipse/pde/internal/ui/editor/manifest/DetailExtensionPointSection.java;1;0;3;1;1;1;1;2;7;1;2;648;9;9;1;0;0;2;3;648;0;5431;3;1;
/org.eclipse.team.ui/src/org/eclipse/team/internal/ui/TeamWizardPage.java;1;0;1;1;0;0;0;1;0;0;1;993;0;0;1;0;0;1;1;993;0;993;1;1;
/org.eclipse.jdt.core.tests.model/workspace/Completion/src3/test0013/Test.java;1;0;1;1;1;1;1;0;0;0;0;5181;0;0;1;0;0;0;1;5181;0;5181;1;1;
/org.eclipse.jdt.launching.j9/j9/org/eclipse/jdt/internal/launching/j9/J9VMRunner.java;3;0;4;1;0;0;0;4;33;1;4;1455;46;46;1;0;0;4;4;1455;0;4626;4;3;
/org.eclipse.swt/Eclipse SWT PI/gtk/org/eclipse/swt/internal/gtk/XVisibilityEvent.java;2;1;2;1;2;2;2;0;4;0;0;6152;4;4;1;0;0;0;2;6152;0;6352;2;2;
/org.eclipse.jdt.ui.examples.javafamily/src/org/eclipse/jsp/RenameTypeParticipant.java;4;0;16;2;1;1;1;15;26;2;12;1033;109;109;2;3;0;15;16;1033;3;5607;13;4;
/org.eclipse.pde.core/src/org/eclipse/pde/internal/core/IMissingPluginConfirmation.java;1;0;1;1;0;0;0;1;0;0;1;2925;0;0;1;0;0;1;1;2925;0;2925;1;1;
/org.eclipse.swt/Eclipse SWT PI/gtk1x/org/eclipse/swt/internal/gtk/GtkStyleClass.java;1;0;1;1;0;0;0;1;0;0;1;2327;0;0;1;0;0;1;1;2327;0;2327;1;1;
/org.eclipse.debug.ui/ui/org/eclipse/debug/internal/ui/stringsubstitution/StringVariableLabelProvider.java;2;0;3;1;0;0;0;3;9;1;3;2088;11;11;1;0;0;3;3;2088;0;2514;3;2;
/org.eclipse.pde.ui/sandbox/org/eclipse/pde/internal/ui/editor/standalone/feature/FeatureEditorUtil.java;1;0;2;1;0;0;0;2;0;1;2;2320;0;0;1;0;0;2;2;2320;0;2906;2;1;
/org.eclipse.sdk.tests-feature/plugins/org.eclipse.perfmsr.ui.client/src/org/eclipse/perfmsr/ui/client/Helper.java;1;1;2;1;2;2;2;0;10;0;0;5443;10;10;1;0;0;0;2;5443;0;5513;2;1;
/org.eclipse.swt/Eclipse SWT Custom Widgets/common/org/eclipse/swt/custom/TableEditor.java;2;0;3;1;0;0;0;3;119;2;2;923;122;122;2;1;0;3;3;923;1;1677;2;2;
/org.eclipse.team.ui/src/org/eclipse/team/ui/synchronize/RefreshSchedule.java;1;0;1;1;0;0;0;1;0;0;1;3468;0;0;1;0;0;1;1;3468;0;3468;1;1;
/org.eclipse.ui.workbench/Eclipse UI/org/eclipse/ui/internal/csm/roles/PluginRoleRegistry.java;1;0;5;1;0;0;0;5;37;2;4;2213;38;38;2;1;0;5;5;2370;1;2405;4;1;
/org.eclipse.ui.ide/src/org/eclipse/ui/internal/model/WorkbenchResource.java;2;0;2;1;0;0;0;2;0;1;2;1511;0;0;1;0;0;2;2;1511;0;2263;2;2;
/org.eclipse.ui.workbench/Eclipse UI/org/eclipse/ui/internal/commands/registry/ICommandRegistryListener.java;1;0;2;1;0;0;0;2;0;1;2;1422;0;0;1;0;0;2;2;1422;0;1724;2;1;
/org.eclipse.jdt.core.tests.model/workspace/Formatter/test029/A_out.java;1;0;2;1;0;0;0;2;3;1;2;2425;3;3;1;0;0;2;2;2425;0;3086;2;1;
/org.eclipse.pde.runtime/src/org/eclipse/pde/internal/runtime/registry/PropertiesAction.java;2;0;2;1;0;0;0;2;10;1;2;924;10;10;1;0;0;2;2;924;0;3933;2;2;
/org.eclipse.jdt.core.tests.model/workspace/Converter/src/javadoc/test018b/TestB1.java;1;0;2;1;0;0;0;2;0;1;2;4311;0;0;1;0;0;2;2;4311;0;4390;2;1;
/org.eclipse.ltk.core.refactoring/src/org/eclipse/ltk/internal/core/refactoring/Assert.java;1;0;2;1;1;1;1;1;2;0;1;4845;2;2;1;0;0;1;2;4845;0;6340;2;1;
/org.eclipse.pde.ui/src/org/eclipse/pde/internal/ui/editor/plugin/BodyTextSection.java;3;1;6;1;6;6;6;0;18;0;0;5431;43;43;1;0;0;0;6;5431;0;6336;6;3;
/org.eclipse.jdt.core/search/org/eclipse/jdt/internal/core/index/impl/IndexSummary.java;1;0;3;1;0;0;0;3;2;1;3;3194;3;3;1;0;0;3;3;3194;0;4060;3;1;
/org.eclipse.ui.workbench/Eclipse UI/org/eclipse/ui/internal/dialogs/ActionSetLabelProvider.java;1;0;1;1;0;0;0;1;0;0;1;830;0;0;1;0;0;1;1;830;0;830;1;1;
/org.eclipse.jdt.core/model/org/eclipse/jdt/internal/core/builder/ClasspathJar.java;3;0;6;1;0;0;0;6;100;2;5;1301;144;144;2;1;0;6;6;3578;1;3578;5;3;
/org.eclipse.jdt.core.tests.model/workspace/Converter/src/test0384/A.java;1;0;1;1;0;0;0;1;0;0;1;3714;0;0;1;0;0;1;1;3714;0;3714;1;1;
/org.eclipse.team.ui/src/org/eclipse/team/internal/ui/sync/actions/SyncViewerChangeFilters.java;2;0;8;2;0;0;0;8;224;2;7;488;356;356;2;1;0;8;8;1181;1;2632;7;2;
/org.eclipse.pde.ui/src/org/eclipse/pde/internal/ui/editor/feature/DataSection.java;3;1;10;1;4;4;4;6;88;1;6;2229;165;165;1;0;0;6;10;2229;0;6336;10;3;
/org.eclipse.jdt.core/compiler/org/eclipse/jdt/internal/compiler/codegen/Label.java;3;2;9;2;3;2;3;6;15;1;6;173;55;55;2;0;1;6;9;5339;1;5615;8;3;
/org.eclipse.ant.ui/Ant Tools Support/org/eclipse/ant/ui/internal/preferences/AntPage.java;1;0;4;1;0;0;0;4;6;1;4;250;12;12;1;0;0;4;4;250;0;1811;4;1;
/org.eclipse.ant.ui/Ant Tools Support/org/eclipse/ant/internal/ui/launchConfigurations/RunAntStatusHandler.java;2;1;4;1;2;2;2;2;4;1;2;1811;9;9;1;0;0;2;4;1811;0;6336;4;2;
/org.eclipse.update.core/srcnew/org/eclipse/update/internal/operations/PendingOperation.java;1;0;9;1;0;0;0;9;52;2;8;367;150;150;2;1;0;9;9;433;1;646;8;1;
/org.eclipse.ui.console/src/org/eclipse/ui/internal/console/MessageConsoleViewer.java;1;0;2;1;0;0;0;2;24;1;2;1988;24;24;1;0;0;2;2;1988;0;2024;2;1;
/org.eclipse.jdt.core/model/org/eclipse/jdt/internal/core/MoveResourceElementsOperation.java;1;0;2;1;0;0;0;2;2;1;2;3194;3;3;1;0;0;2;2;3194;0;3560;2;1;
/org.eclipse.jdt.core.tests.model/workspace/Formatter/test149/A_out.java;1;0;1;1;0;0;0;1;0;0;1;2425;0;0;1;0;0;1;1;2425;0;2425;1;1;
/org.eclipse.jdt.core/model/org/eclipse/jdt/internal/core/JarPackageFragmentRootInfo.java;1;0;1;1;0;0;0;1;2;0;1;3560;2;2;1;0;0;1;1;3560;0;3560;1;1;
/org.eclipse.jdt.ui/core refactoring/org/eclipse/jdt/internal/corext/refactoring/nls/KeyValuePair.java;3;1;3;1;2;2;2;1;52;0;1;4930;56;56;1;0;0;1;3;4930;0;6340;3;3;
/org.eclipse.team.ui/src/org/eclipse/team/internal/ui/sync/TypedBufferedContent.java;1;0;1;1;0;0;0;1;0;0;1;4216;0;0;1;0;0;1;1;4216;0;4216;1;1;
/org.eclipse.ui.workbench/Eclipse UI/org/eclipse/ui/internal/commands/registry/IRegistryListener.java;1;0;2;1;0;0;0;2;0;1;2;1097;0;0;1;0;0;2;2;1097;0;1222;2;1;
/org.eclipse.jdt.core.tests.model/workspace/Formatter/test285/A_out.java;1;0;1;1;0;0;0;1;0;0;1;2443;0;0;1;0;0;1;1;2443;0;2443;1;1;
/org.eclipse.jdt.core.tests.model/workspace/Formatter/test267/A_in.java;1;0;1;1;0;0;0;1;0;0;1;2442;0;0;1;0;0;1;1;2442;0;2442;1;1;
/org.eclipse.team.cvs.ui/src/org/eclipse/team/internal/ccvs/ui/console/ConsolePreferencesPage.java;1;0;2;1;1;1;1;1;4;0;1;4609;4;4;1;0;0;1;2;4609;0;6337;2;1;
/org.eclipse.team.cvs.ui/src/org/eclipse/team/internal/ccvs/ui/subscriber/CVSParticipantActionContribution.java;1;0;1;1;0;0;0;1;0;0;1;5070;0;0;1;0;0;1;1;5070;0;5070;1;1;
/org.eclipse.jdt.ui.tests.refactoring/resources/MoveInstanceMethod/canMove/test18/out/Shape.java;1;0;1;1;0;0;0;1;0;0;1;1570;0;0;1;0;0;1;1;1570;0;1570;1;1;
/org.eclipse.core.tests.resources/src/org/eclipse/core/tests/resources/session/TestSaveCreateProject.java;1;0;1;1;1;1;1;0;81;0;0;5147;81;81;1;0;0;0;1;5147;0;5147;1;1;
/org.eclipse.jdt.ui.tests.refactoring/resources/InlineMethodWorkspace/TestCases/cast_in/TestOverloadedPrimitives.java;1;0;1;1;0;0;0;1;0;0;1;955;0;0;1;0;0;1;1;955;0;955;1;1;
/org.eclipse.pde.ui/src/org/eclipse/pde/internal/ui/editor/manifest/JarsSection.java;2;0;7;1;0;0;0;7;147;2;6;626;332;332;2;1;0;7;7;626;1;1727;6;2;
/org.eclipse.text/src/org/eclipse/text/edits/TextEditGroup.java;2;1;3;1;2;2;2;1;2;0;1;3648;4;4;1;0;0;1;3;3648;0;6340;3;2;
/org.eclipse.pde.ui/src_OSGi/org/eclipse/pde/internal/ui/osgi/wizards/PluginToBundleWizard.java;2;0;4;1;0;0;0;4;7;1;4;2244;9;9;1;0;0;4;4;2244;0;3839;4;2;
/org.eclipse.sdk.tests-feature/plugins/org.eclipse.perfmsr.ui.client/src/org/eclipse/perfmsr/ui/client/SelectLogFilesDialog.java;1;1;2;1;2;2;2;0;10;0;0;5443;10;10;1;0;0;0;2;5443;0;5513;2;1;
/org.eclipse.jdt.core.tests.model/workspace/Converter/src/test0015/Test.java;1;0;1;1;0;0;0;1;0;0;1;3714;0;0;1;0;0;1;1;3714;0;3714;1;1;
/org.eclipse.jdt.core/model/org/eclipse/jdt/core/ILocalVariable.java;2;0;7;1;0;0;0;7;10;2;6;2420;32;32;2;1;0;7;7;2420;1;5022;6;2;
/org.eclipse.jdt.ui/core refactoring/org/eclipse/jdt/internal/corext/refactoring/typeconstraints/DeclaringTypeVariable.java;2;0;4;1;1;1;1;3;19;1;3;42;29;29;1;0;0;3;4;42;0;6340;4;2;
/org.eclipse.jdt.ui.tests.refactoring/resources/ExtractMethodWorkSpace/ExtractMethodTests/locals_in/A_test511.java;1;0;1;1;0;0;0;1;2;0;1;844;2;2;1;0;0;1;1;844;0;844;1;1;
/org.eclipse.ui.cheatsheets/src/org/eclipse/ui/internal/cheatsheets/data/PerformWhen.java;1;1;2;1;2;2;2;0;20;0;0;5189;20;20;1;0;0;0;2;5189;0;5507;2;1;
/org.eclipse.team.cvs.ssh2/src/org/eclipse/team/internal/ccvs/ssh2/CVSSSH2Plugin.java;1;0;2;1;0;0;0;2;2;0;1;4825;2;2;2;1;0;2;2;4825;1;4825;1;1;
/org.eclipse.update.ui/src/org/eclipse/update/internal/ui/views/InstallationHistoryAction.java;3;1;10;1;2;2;2;8;138;1;8;825;185;185;1;0;0;8;10;825;0;6336;10;3;
/org.eclipse.ui.workbench/Eclipse UI/org/eclipse/ui/internal/roles/ui/RoleLabelProvider.java;2;0;7;1;0;0;0;7;69;1;7;2444;107;107;1;0;0;7;7;2444;0;2864;7;2;
/org.eclipse.ui.editors/src/org/eclipse/ui/texteditor/AnnotationPreferenceLookup.java;2;2;6;1;3;2;3;3;23;2;2;3217;29;29;2;1;1;3;6;3537;2;6334;4;2;
/org.eclipse.osgi/osgi/src/org/eclipse/osgi/service/environment/EnvironmentInfo.java;2;0;3;1;0;0;0;3;10;1;3;3013;10;10;1;0;0;3;3;3013;0;3147;3;2;
/org.eclipse.jdt.debug.ui/ui/org/eclipse/jdt/internal/debug/ui/actions/ShowQualifiedAction.java;1;0;1;1;0;0;0;1;6;0;1;3296;6;6;1;0;0;1;1;3296;0;3296;1;1;
/org.eclipse.ui.forms/src/org/eclipse/ui/forms/widgets/Section.java;1;1;8;1;2;2;2;6;147;1;6;4068;401;401;1;0;0;6;8;4068;0;6336;8;1;
/org.eclipse.osgi/osgi/src/org/eclipse/osgi/service/pluginconversion/IPluginConverter.java;1;0;2;1;0;0;0;2;0;0;1;3132;0;0;2;1;0;2;2;3132;1;3132;1;1;
/org.eclipse.update.core/src/org/eclipse/update/internal/api/search/IQueryUpdateSiteAdapter.java;1;0;2;1;0;0;0;2;0;1;2;3270;0;0;1;0;0;2;2;3270;0;4928;2;1;
/org.eclipse.ltk.ui.refactoring/src/org/eclipse/ltk/internal/ui/refactoring/ChangeElementLabelProvider.java;1;1;4;1;2;2;2;2;10;1;2;4965;20;20;1;0;0;2;4;4965;0;6340;4;1;
/org.eclipse.jdt.core.tests.model/workspace/Converter/test0216/Test.java;1;0;1;1;0;0;0;1;0;0;1;3714;0;0;1;0;0;1;1;3714;0;3714;1;1;
/org.eclipse.jdt.core/model/org/eclipse/jdt/internal/core/hierarchy/IndexBasedHierarchyBuilder.java;5;1;33;1;2;2;2;31;98;3;27;131;581;581;3;4;0;31;33;2116;4;5208;29;5;
/org.eclipse.ui.views/src/org/eclipse/ui/views/internal/markers/Util.java;1;0;3;1;0;0;0;3;66;2;2;728;66;66;2;1;0;3;3;749;1;749;2;1;
/org.eclipse.ui.workbench/Eclipse UI/org/eclipse/ui/dialogs/ListDialog.java;1;0;2;1;2;1;2;0;84;0;0;5464;84;84;2;0;1;0;2;5464;1;5464;1;1;
/org.eclipse.jdt.core.tests.model/workspace/Resolve/src/ResolveLocalClass3.java;1;0;1;1;0;0;0;1;0;0;1;1968;0;0;1;0;0;1;1;1968;0;1968;1;1;
/org.eclipse.jdt.ui.tests.refactoring/resources/InlineMethodWorkspace/TestCases/argument_in/TestParameterNameUnused3.java;1;0;1;1;0;0;0;1;2;0;1;845;2;2;1;0;0;1;1;845;0;845;1;1;
/org.eclipse.ui.workbench/Eclipse UI/org/eclipse/ui/internal/commands/ActivityBinding.java;1;0;4;1;0;0;0;4;23;2;3;2562;25;25;2;1;0;4;4;2562;1;3128;3;1;
/org.eclipse.team.cvs.core/src/org/eclipse/team/internal/ccvs/core/connection/CVSAuthenticationException.java;2;0;2;1;1;1;1;1;23;0;1;3634;25;25;1;0;0;1;2;3634;0;6337;2;2;
/org.eclipse.ui.externaltools/External Tools Base/org/eclipse/ui/externaltools/internal/model/IExternalToolsHelpContextIds.java;2;0;7;1;0;0;0;7;27;1;7;33;53;53;1;0;0;7;7;33;0;1861;7;2;
/org.eclipse.jdt.core/compiler/org/eclipse/jdt/internal/compiler/flow/SwitchFlowContext.java;2;0;5;1;0;0;0;5;4;1;5;485;12;12;1;0;0;5;5;485;0;3560;5;2;
/org.eclipse.core.tests.runtime/src/org/eclipse/core/tests/runtime/content/AllTests.java;2;1;7;1;6;6;6;1;4;0;1;5062;11;11;1;0;0;1;7;5062;0;6225;7;2;
/org.eclipse.ui.workbench/Eclipse UI/org/eclipse/ui/internal/themes/ColorUtils.java;1;0;5;1;1;1;1;4;97;2;2;4392;182;182;2;2;0;4;5;4392;2;5209;3;1;
/org.eclipse.update/src/org/eclipse/update/internal/ui/UMApplicationUserInterfaceProperties.java;1;0;1;1;1;1;1;0;0;0;0;6339;0;0;1;0;0;0;1;6339;0;6339;1;1;
/org.eclipse.swt/Eclipse SWT/motif/org/eclipse/swt/graphics/Device.java;4;1;6;1;2;2;2;4;183;1;4;0;211;211;1;0;0;4;6;0;0;6352;6;4;
/org.eclipse.ui.editors/src/org/eclipse/ui/texteditor/ImageUtilities.java;2;1;4;1;3;3;3;1;60;0;1;3217;74;74;1;0;0;1;4;3217;0;6337;4;2;
/org.eclipse.jdt.core.tests.model/workspace/Converter/test0002/Test.java;1;0;1;1;0;0;0;1;0;0;1;3714;0;0;1;0;0;1;1;3714;0;3714;1;1;
/org.eclipse.team.cvs.core/src/org/eclipse/team/internal/ccvs/core/syncinfo/BaserevInfo.java;1;0;1;1;0;0;0;1;5;0;1;2493;5;5;1;0;0;1;1;2493;0;2493;1;1;
/org.eclipse.jdt.core.tests.model/workspace/Converter/src/test0390/A.java;1;0;1;1;0;0;0;1;0;0;1;3714;0;0;1;0;0;1;1;3714;0;3714;1;1;
/org.eclipse.ui.workbench/Eclipse UI/org/eclipse/ui/internal/EditorManager.java;10;2;23;1;12;11;12;11;406;2;10;445;1380;1380;2;1;1;11;23;4969;2;6338;21;10;
/org.eclipse.ant.ui/Ant Tools Support/org/eclipse/ant/ui/internal/views/actions/AntViewActionMessages.java;1;0;2;1;0;0;0;2;0;1;2;263;0;0;1;0;0;2;2;263;0;1811;2;1;
/org.eclipse.debug.ui/ui/org/eclipse/debug/internal/ui/launchVariables/WorkingSetExpander.java;2;0;2;1;0;0;0;2;0;1;2;771;0;0;1;0;0;2;2;771;0;2077;2;2;
/org.eclipse.jdt.ui/ui refactoring/org/eclipse/jdt/internal/ui/refactoring/ConvertAnonymousToNestedWizard.java;4;0;7;1;1;1;1;6;104;1;6;518;150;150;1;0;0;6;7;518;0;6340;7;4;
/org.eclipse.ui.forms.examples/src/org/eclipse/ui/forms/examples/internal/rcp/OpenSimpleFormEditorAction.java;1;0;2;1;1;1;1;1;10;0;1;4075;10;10;1;0;0;1;2;4075;0;5781;2;1;
/org.eclipse.jdt.ui.tests.refactoring/resources/ExtractMethodWorkSpace/ExtractMethodTests/invalidSelection/A_test194.java;1;0;1;1;1;1;1;0;0;0;0;5650;0;0;1;0;0;0;1;5650;0;5650;1;1;
/org.eclipse.ui.externaltools/Ant Editor/org/eclipse/ui/externaltools/internal/ant/editor/xml/XmlAttribute.java;1;0;1;1;0;0;0;1;0;0;1;282;0;0;1;0;0;1;1;282;0;282;1;1;
/org.eclipse.ltk.ui.refactoring/src/org/eclipse/ltk/internal/ui/refactoring/PreviewWizardPage.java;2;1;11;1;7;7;7;4;60;1;4;4965;140;140;1;0;0;4;11;4965;0;6340;11;2;
/org.eclipse.jdt.core/model/org/eclipse/jdt/internal/core/util/InnerClassesAttribute.java;1;0;2;1;0;0;0;2;10;1;2;3560;12;12;1;0;0;2;2;3560;0;4060;2;1;
/org.eclipse.jdt.ui.tests.refactoring/resources/InlineMethodWorkspace/TestCases/argument_out/TestTwoReads.java;1;0;1;1;0;0;0;1;4;0;1;845;4;4;1;0;0;1;1;845;0;845;1;1;
/org.eclipse.update.ui/srcnew/org/eclipse/update/internal/ui/wizards/UnifiedInstallWizard.java;3;0;24;2;0;0;0;24;374;3;17;329;972;972;3;7;0;24;24;471;7;825;17;3;
/org.eclipse.jdt.core.tests.model/workspace/Formatter/test488/A_in.java;1;0;1;1;1;1;1;0;0;0;0;5188;0;0;1;0;0;0;1;5188;0;5188;1;1;
/org.eclipse.jdt.ui/ui/org/eclipse/jdt/internal/ui/text/java/MethodStubCompletionProposal.java;1;0;7;1;1;1;1;6;6;2;5;582;22;22;2;1;0;6;7;1569;1;5483;6;1;
/org.eclipse.jdt.ui/core refactoring/org/eclipse/jdt/internal/corext/refactoring/participants/ParticipantDescriptor.java;1;0;7;1;0;0;0;7;60;1;7;825;132;132;1;0;0;7;7;825;0;4624;7;1;
/org.eclipse.jdt.core.tests.model/workspace/Converter/src/test0499/A.java;1;0;1;1;0;0;0;1;0;0;1;3714;0;0;1;0;0;1;1;3714;0;3714;1;1;
/org.eclipse.team.core/src/org/eclipse/team/core/variants/IResourceVariant.java;2;1;3;1;2;2;2;1;8;0;1;4349;10;10;1;0;0;1;3;4349;0;6336;3;2;
/org.eclipse.ui.cheatsheets/src/org/eclipse/ui/internal/cheatsheets/actions/CheatSheetSelectionAction.java;2;0;5;2;1;1;1;4;19;2;3;4428;27;27;2;1;0;4;5;4625;1;5363;4;2;
/org.eclipse.jdt.ui/ui refactoring/org/eclipse/jdt/internal/ui/refactoring/sef/SelfEncapsulateFieldInputPage.java;3;0;7;1;1;1;1;6;45;1;6;1309;58;58;1;0;0;6;7;1309;0;6340;7;3;
/org.eclipse.swt/Eclipse SWT Custom Widgets/common/org/eclipse/swt/custom/PopupList.java;4;1;5;1;2;2;2;3;22;1;3;217;48;48;1;0;0;3;5;217;0;6352;5;4;
/org.eclipse.text/src/org/eclipse/jface/text/IDocumentPartitioningListener.java;2;1;2;1;2;2;2;0;33;0;0;5105;35;35;1;0;0;0;2;5105;0;6296;2;2;
/org.eclipse.ui.workbench/Eclipse UI/org/eclipse/ui/internal/about/AboutFeaturesButtonManager.java;1;0;1;1;1;1;1;0;0;0;0;5483;0;0;1;0;0;0;1;5483;0;5483;1;1;
/org.eclipse.jdt.ui/ui/org/eclipse/jdt/internal/ui/compare/JavaReplaceWithEditionAction.java;5;0;12;1;1;1;1;11;71;1;11;1289;207;207;1;0;0;11;12;1289;0;6340;12;5;
/org.eclipse.ant.ui/Ant Tools Support/org/eclipse/ant/internal/ui/launchConfigurations/AntClasspathProvider.java;2;0;9;1;0;0;0;9;56;2;8;1811;114;114;2;1;0;9;9;3612;1;4520;8;2;
/org.eclipse.pde.ui/src/org/eclipse/pde/internal/ui/wizards/templates/HelloWorldTemplate.java;3;3;9;1;5;3;5;4;74;1;4;835;134;134;3;0;2;4;9;5204;2;6336;7;3;
/org.eclipse.pde.ui/src_Forms/org/eclipse/pde/internal/ui/neweditor/schema/NewElementAction.java;2;0;2;1;1;1;1;1;0;0;1;4856;0;0;1;0;0;1;2;4856;0;5431;2;2;
/org.eclipse.swt.graphics.text/Eclipse SWT PI/win32/org/eclipse/swt/internal/win32/SCRIPT_ANALYSIS.java;1;0;1;1;0;0;0;1;0;0;1;2985;0;0;1;0;0;1;1;2985;0;2985;1;1;
/org.eclipse.ui.workbench/Eclipse UI/org/eclipse/ui/internal/commands/ws/WorkbenchCommandSupport.java;4;3;44;2;15;13;15;29;597;4;21;3129;2229;2229;4;8;2;29;44;4925;10;6338;34;4;
/org.eclipse.jdt.ui/ui/org/eclipse/jdt/internal/ui/browsing/LogicalPackagesProvider.java;1;1;3;1;2;2;2;1;38;0;1;274;44;44;1;0;0;1;3;274;0;6340;3;1;
/org.eclipse.ui.views/src/org/eclipse/ui/views/bookmarkexplorer/PasteBookmarkAction.java;1;0;1;1;0;0;0;1;0;0;1;2738;0;0;1;0;0;1;1;2738;0;2738;1;1;
/org.eclipse.pde.ui/src_Forms/org/eclipse/pde/internal/ui/neweditor/plugin/PackageSelectionDialog.java;2;1;3;1;2;2;2;1;227;0;1;4974;227;227;1;0;0;1;3;4974;0;5431;3;2;
/org.eclipse.pde.ui/sandbox/org/eclipse/pde/internal/ui/editor/standalone/parser/XEErrorHandler.java;1;0;2;1;0;0;0;2;0;1;2;2320;0;0;1;0;0;2;2;2320;0;2931;2;1;
/org.eclipse.team.cvs.ui/src/org/eclipse/team/internal/ccvs/ui/jobs/BatchSimilarSchedulingRule.java;1;0;3;1;0;0;0;3;30;1;3;977;30;30;1;0;0;3;3;977;0;1064;3;1;
/org.eclipse.ui.workbench/Eclipse UI/org/eclipse/ui/internal/WorkbenchPartReference.java;4;1;6;1;5;5;5;1;260;0;1;3819;412;412;1;0;0;1;6;3819;0;6338;6;4;
/org.eclipse.team.ui/src/org/eclipse/team/internal/ui/wizards/TeamWizardPage.java;1;0;2;1;0;0;0;2;107;0;1;987;107;107;2;1;0;2;2;987;1;987;1;1;
/org.eclipse.jdt.core.tests.model/workspace/Converter/src/test0426/A.java;1;0;1;1;0;0;0;1;0;0;1;3714;0;0;1;0;0;1;1;3714;0;3714;1;1;
/org.eclipse.ui.workbench/Eclipse UI/org/eclipse/ui/internal/model/WorkbenchAdapterBuilder.java;1;0;1;1;0;0;0;1;0;0;1;2737;0;0;1;0;0;1;1;2737;0;2737;1;1;
/org.eclipse.team.cvs.ui/src/org/eclipse/team/internal/ccvs/ui/model/DeferredWorkbenchContentProvider.java;1;0;1;1;0;0;0;1;0;0;1;961;0;0;1;0;0;1;1;961;0;961;1;1;
/org.eclipse.jdt.ui.tests.refactoring/resources/MoveInnerToTopLevel/test_nonstatic_14/out/Inner.java;2;0;2;1;1;1;1;1;2;0;1;305;4;4;1;0;0;1;2;305;0;5854;2;2;
/org.eclipse.jdt.core.tests.model/workspace/Converter/test0092/Test.java;1;0;1;1;0;0;0;1;0;0;1;3714;0;0;1;0;0;1;1;3714;0;3714;1;1;
/org.eclipse.jdt.core/dom/org/eclipse/jdt/core/dom/DefaultASTVisitor.java;1;0;1;1;0;0;0;1;0;0;1;4311;0;0;1;0;0;1;1;4311;0;4311;1;1;
/org.eclipse.pde.ui/src_Forms/org/eclipse/pde/internal/ui/neweditor/site/SiteInputContextManager.java;2;0;3;1;1;1;1;2;6;1;2;4832;6;6;1;0;0;2;3;4832;0;5431;3;2;
/org.eclipse.ui.workbench/Eclipse UI/org/eclipse/ui/internal/csm/commands/IActivityBindingDefinition.java;1;0;2;1;0;0;0;2;0;1;2;2533;0;0;1;0;0;2;2;2533;0;2562;2;1;
/org.eclipse.ant.ui/Ant Tools Support/org/eclipse/ant/internal/ui/views/actions/RunTargetAction.java;1;0;3;1;0;0;0;3;24;1;3;1811;28;28;1;0;0;3;3;1811;0;4030;3;1;
/org.eclipse.ui.ide/src/org/eclipse/ui/internal/NewWizardDropDownAction.java;2;0;6;1;0;0;0;6;36;1;6;1520;59;59;1;0;0;6;6;1520;0;2263;6;2;
/org.eclipse.osgi/osgi/src/org/eclipse/osgi/service/resolver/PackageSpecification.java;3;2;6;2;3;2;3;3;14;1;3;3013;29;29;2;0;1;3;6;6337;1;6337;5;3;
/org.eclipse.update.ui/srcnew/org/eclipse/update/internal/ui/AddBookmarksAction.java;2;0;2;1;0;0;0;2;0;1;2;768;0;0;1;0;0;2;2;768;0;825;2;2;
/org.eclipse.jdt.ui.tests.refactoring/test cases/org/eclipse/jdt/ui/tests/refactoring/AllTests.java;4;0;4;1;1;1;1;3;2;1;3;824;8;8;1;0;0;3;4;824;0;6340;4;4;
/org.eclipse.jdt.ui.examples.javafamily/src/org/eclipse/jsp/JspTypeQuery.java;1;0;6;1;0;0;0;6;14;1;6;1033;25;25;1;0;0;6;6;1033;0;3235;6;1;
/org.eclipse.jdt.ui/ui/org/eclipse/jdt/ui/text/java/IJavaCompletionProposal.java;1;0;1;1;1;1;1;0;3;0;0;6322;3;3;1;0;0;0;1;6322;0;6322;1;1;
/org.eclipse.jdt.ui/ui/org/eclipse/jdt/internal/ui/text/correction/ChangeMethodSignatureProposal.java;3;1;27;1;6;6;6;21;161;2;19;299;631;631;2;2;0;21;27;299;2;6340;25;3;
/org.eclipse.jdt.ui/core extension/org/eclipse/jdt/internal/corext/template/TemplateTranslator.java;2;0;2;1;0;0;0;2;4;1;2;1336;4;4;1;0;0;2;2;1336;0;4258;2;2;
/org.eclipse.ui.editors/src/org/eclipse/ui/texteditor/MarkerAnnotation.java;3;2;14;1;7;5;7;7;300;1;7;1983;685;685;2;0;2;7;14;5331;2;6335;12;3;
/org.eclipse.jdt.core/compiler/org/eclipse/jdt/internal/compiler/problem/ProblemReporter.java;6;2;61;3;8;7;8;53;486;3;43;13;3254;3254;3;10;1;53;61;1299;11;6100;50;6;
/org.eclipse.jface.text/src/org/eclipse/jface/text/rules/IToken.java;2;1;2;1;2;2;2;0;2;0;0;6340;4;4;1;0;0;0;2;6340;0;6358;2;2;
/org.eclipse.swt.tests/JUnit Tests/org/eclipse/swt/tests/junit/Test_org_eclipse_swt_ole_win32_OlePropertyDescription.java;1;0;1;1;0;0;0;1;0;0;1;2176;0;0;1;0;0;1;1;2176;0;2176;1;1;
/org.eclipse.team.core/src/org/eclipse/team/internal/core/subscribers/SyncSetInputFromSyncSet.java;1;1;4;1;2;2;2;2;117;1;2;3550;144;144;1;0;0;2;4;3550;0;6336;4;1;
/org.eclipse.ui.ide/src/org/eclipse/ui/actions/NewWizardMenu.java;2;0;7;1;0;0;0;7;29;1;7;1511;41;41;1;0;0;7;7;1511;0;2263;7;2;
/org.eclipse.jdt.ui.tests.refactoring/resources/IntroduceFactory/positive/names_in.java;1;0;2;1;0;0;0;2;0;1;2;2846;0;0;1;0;0;2;2;2846;0;2862;2;1;
/org.eclipse.jdt.launching.macosx/macosx/org/eclipse/jdt/internal/ui/macbundler/ResourceInfo.java;1;0;1;1;0;0;0;1;0;0;1;3622;0;0;1;0;0;1;1;3622;0;3622;1;1;
/org.eclipse.team.webdav/src/org/eclipse/team/core/target/BatchingLock.java;1;0;1;1;0;0;0;1;0;0;1;3379;0;0;1;0;0;1;1;3379;0;3379;1;1;
/org.eclipse.update.core/src/org/eclipse/update/internal/security/KeyStores.java;2;1;4;1;2;2;2;2;7;1;2;890;15;15;1;0;0;2;4;890;0;6336;4;2;
/org.eclipse.jdt.core.tests.model/workspace/Formatter/test071/A_in.java;1;0;1;1;0;0;0;1;0;0;1;2425;0;0;1;0;0;1;1;2425;0;2425;1;1;
/org.eclipse.ui.forms/src/org/eclipse/ui/forms/widgets/ILayoutExtension.java;1;0;4;1;0;0;0;4;58;1;4;4068;74;74;1;0;0;4;4;4068;0;5044;4;1;
/org.eclipse.team.tests.cvs.core/src/org/eclipse/team/tests/ccvs/ui/old/EmptyPerspective.java;1;0;2;1;0;0;0;2;0;1;2;2632;0;0;1;0;0;2;2;2632;0;4216;2;1;
/org.eclipse.text/src/org/eclipse/jface/text/FindReplaceOperationCode.java;2;1;3;1;2;2;2;1;4;0;1;2121;4;4;1;0;0;1;3;2121;0;5177;3;2;
/org.eclipse.update/src/org/eclipse/update/internal/ui/UMApplicationUserInterface.java;1;0;1;1;1;1;1;0;0;0;0;6339;0;0;1;0;0;0;1;6339;0;6339;1;1;
/org.eclipse.jdt.debug.ui/ui/org/eclipse/jdt/internal/debug/ui/launcher/RuntimeClasspathViewer.java;1;0;4;1;0;0;0;4;41;2;3;2071;81;81;2;1;0;4;4;2691;1;3203;3;1;
/org.eclipse.jdt.ui/core extension/org/eclipse/jdt/internal/corext/dom/ASTNodes.java;4;2;38;2;5;4;5;33;182;4;27;155;1188;1188;4;6;1;33;38;2841;7;5656;31;4;
/org.eclipse.help.ide/src/org/eclipse/help/ui/internal/ide/IHelpIdeConstants.java;1;1;5;1;3;3;3;2;24;1;2;1778;46;46;1;0;0;2;5;1778;0;6337;5;1;
/org.eclipse.swt.tests/JUnit Tests/org/eclipse/swt/tests/junit/Test_org_eclipse_swt_widgets_Widget.java;5;0;7;1;1;1;1;6;70;2;5;2123;98;98;2;1;0;6;7;2157;1;6352;6;5;
/org.eclipse.core.resources/src/org/eclipse/core/internal/events/EventStats.java;2;0;2;1;1;1;1;1;50;0;1;1477;60;60;1;0;0;1;2;1477;0;5146;2;2;
/org.eclipse.swt/Eclipse SWT Drag and Drop/motif/org/eclipse/swt/dnd/FileTransfer.java;1;0;1;1;0;0;0;1;67;0;1;328;67;67;1;0;0;1;1;328;0;328;1;1;
/org.eclipse.pde.ui/src/org/eclipse/pde/internal/ui/editor/build/BuildPropertiesEditor.java;1;0;9;1;1;1;1;8;255;2;7;1727;521;521;2;1;0;8;9;1749;1;5431;8;1;
/org.eclipse.jdt.core.tests.compiler/src/org/eclipse/jdt/core/tests/compiler/regression/ForeachStatementTest.java;1;0;1;1;0;0;0;1;0;0;1;4404;0;0;1;0;0;1;1;4404;0;4404;1;1;
/org.eclipse.jdt.ui.tests.refactoring/resources/RenamePackage/test6/out/p1/A.java;1;0;1;1;1;1;1;0;0;0;0;6118;0;0;1;0;0;0;1;6118;0;6118;1;1;
/org.eclipse.jdt.ui.tests.refactoring/resources/MoveInstanceMethod/canMove/test21/out/Second.java;1;0;1;1;0;0;0;1;0;0;1;1603;0;0;1;0;0;1;1;1603;0;1603;1;1;
/org.eclipse.jdt.ui.tests.refactoring/resources/MoveInnerToTopLevel/test_nonstatic_23/out/Inner.java;2;0;2;1;1;1;1;1;2;0;1;305;4;4;1;0;0;1;2;305;0;5854;2;2;
/org.eclipse.ui.workbench/Eclipse UI/org/eclipse/ui/internal/chris/roles/api/secondstage/IMutableRoleRegistry.java;1;0;2;1;0;0;0;2;0;0;1;2207;0;0;2;1;0;2;2;2207;1;2207;1;1;
/org.eclipse.ui.workbench/Eclipse UI/org/eclipse/ui/internal/IWorkbenchThemeConstants.java;1;0;3;1;1;1;1;2;6;1;2;4560;9;9;1;0;0;2;3;4560;0;5465;3;1;
/org.eclipse.ltk.core.refactoring/src/org/eclipse/ltk/core/refactoring/IValidationCheckResultQuery.java;1;1;2;1;2;2;2;0;7;0;0;5176;7;7;1;0;0;0;2;5176;0;5184;2;1;
/org.eclipse.swt.examples/src/org/eclipse/swt/examples/controlexample/TableTreeTab.java;2;1;7;1;2;2;2;5;157;1;5;1560;209;209;1;0;0;5;7;1560;0;6352;7;2;
/org.eclipse.jdt.core.tests.model/workspace/Formatter/test108/A_in.java;1;0;1;1;0;0;0;1;0;0;1;2425;0;0;1;0;0;1;1;2425;0;2425;1;1;
/org.eclipse.update.core/src/org/eclipse/update/internal/configuration/ConfigurationActivity.java;1;0;1;1;0;0;0;1;0;0;1;2828;0;0;1;0;0;1;1;2828;0;2828;1;1;
/org.eclipse.ui.workbench/Eclipse UI/org/eclipse/ui/contexts/IContextBinding.java;2;0;2;1;1;1;1;1;0;0;1;4969;0;0;1;0;0;1;2;4969;0;5273;2;2;
/org.eclipse.core.runtime/src/org/eclipse/core/runtime/model/LibraryModel.java;1;0;1;1;0;0;0;1;0;0;1;3013;0;0;1;0;0;1;1;3013;0;3013;1;1;
/org.eclipse.ui.externaltools/Ant Tools Support/org/eclipse/ui/externaltools/internal/ant/view/actions/SearchForBuildFilesAction.java;2;0;2;1;0;0;0;2;2;1;2;139;2;2;1;0;0;2;2;139;0;282;2;2;
/org.eclipse.swt/Eclipse SWT/carbon/org/eclipse/swt/widgets/ToolBar.java;3;1;6;1;3;3;3;3;8;1;3;110;25;25;1;0;0;3;6;110;0;6352;6;3;
/org.eclipse.jdt.core/dom/org/eclipse/jdt/core/dom/IPackageBinding.java;1;0;1;1;0;0;0;1;2;0;1;3560;2;2;1;0;0;1;1;3560;0;3560;1;1;
/org.eclipse.jdt.launching/launching/org/eclipse/jdt/launching/IRuntimeClasspathEntry.java;3;1;9;1;2;2;2;7;56;1;7;810;117;117;1;0;0;7;9;810;0;6336;9;3;
/org.eclipse.ui.editors/src/org/eclipse/ui/texteditor/DefaultAnnotation.java;2;0;6;1;0;0;0;6;334;1;6;2708;432;432;1;0;0;6;6;2708;0;3654;6;2;
/org.eclipse.core.expressions/src/org/eclipse/core/expressions/Expression.java;1;1;5;1;3;3;3;2;8;1;2;4108;16;16;1;0;0;2;5;4108;0;6340;5;1;
/org.eclipse.ui.workbench.texteditor/src/org/eclipse/ui/texteditor/FindReplaceAction.java;1;1;3;1;2;2;2;1;4;0;1;1346;8;8;1;0;0;1;3;1346;0;6340;3;1;
/org.eclipse.swt.opengl/common/org/eclipse/swt/opengl/GLYPHMETRICSFLOAT.java;1;0;1;1;0;0;0;1;0;0;1;1175;0;0;1;0;0;1;1;1175;0;1175;1;1;
/org.eclipse.ui.workbench/Eclipse UI/org/eclipse/ui/internal/commands/registry/CommandDefinitionHandle.java;1;0;2;1;0;0;0;2;0;0;1;1396;0;0;2;1;0;2;2;1396;1;1396;1;1;
/org.eclipse.core.tests.runtime/src/org/eclipse/core/tests/internal/plugins/FragmentResolveTest_1.java;1;0;1;1;0;0;0;1;0;0;1;3014;0;0;1;0;0;1;1;3014;0;3014;1;1;
/org.eclipse.ui.workbench/Eclipse UI/org/eclipse/ui/commands/KeySequence.java;1;0;5;1;0;0;0;5;152;4;2;1321;152;152;4;3;0;5;5;1336;3;1336;2;1;
/org.eclipse.ui.workbench/Eclipse UI/org/eclipse/ui/internal/contexts/ws/WorkbenchContextActivationService.java;1;0;4;1;0;0;0;4;8;1;4;3109;14;14;1;0;0;4;4;3109;0;3172;4;1;
/org.eclipse.team.webdav/src/org/eclipse/team/internal/ui/target/ImportTargetSiteMainPage.java;2;0;2;1;0;0;0;2;0;1;2;2495;0;0;1;0;0;2;2;2495;0;4216;2;2;
/org.eclipse.jface.text/src/org/eclipse/jface/text/contentassist/IContentAssistListener.java;1;1;3;1;2;2;2;1;3;0;1;4816;6;6;1;0;0;1;3;4816;0;6353;3;1;
/org.eclipse.jdt.ui.tests.refactoring/resources/MoveMembers/test34/in/B.java;1;0;1;1;0;0;0;1;0;0;1;1856;0;0;1;0;0;1;1;1856;0;1856;1;1;
/org.eclipse.team.cvs.core/src/org/eclipse/team/internal/ccvs/core/util/ProjectDescriptionManager.java;1;0;1;1;0;0;0;1;0;0;1;2143;0;0;1;0;0;1;1;2143;0;2143;1;1;
/org.eclipse.core.runtime/src/org/eclipse/core/internal/content/ContentTypeManager.java;3;3;28;2;23;18;23;5;337;1;5;4574;1119;1119;3;0;5;5;28;5247;5;6339;23;3;
/org.eclipse.ltk.ui.refactoring/src/org/eclipse/ltk/internal/ui/refactoring/RefactoringStatusViewer.java;1;1;4;1;2;2;2;2;5;1;2;4965;10;10;1;0;0;2;4;4965;0;6340;4;1;
/org.eclipse.jdt.core.tests.model/src/org/eclipse/jdt/core/tests/dom/ASTNodesCollectorVisitor.java;2;0;6;1;1;1;1;5;302;1;5;3560;392;392;1;0;0;5;6;3560;0;5272;6;2;
/org.eclipse.jdt.ui.tests.refactoring/resources/ExtractMethodWorkSpace/ExtractMethodTests/locals_in/A_test551.java;1;0;1;1;0;0;0;1;2;0;1;844;2;2;1;0;0;1;1;844;0;844;1;1;
/org.eclipse.jdt.core.tests.model/workspace/Converter/test0187/Test.java;1;0;1;1;0;0;0;1;0;0;1;3714;0;0;1;0;0;1;1;3714;0;3714;1;1;
/org.eclipse.jdt.core.tests.model/workspace/Converter/src/test0223/Test.java;1;0;1;1;0;0;0;1;0;0;1;3714;0;0;1;0;0;1;1;3714;0;3714;1;1;
/org.eclipse.jdt.ui/ui/org/eclipse/jdt/internal/ui/wizards/NewSnippetFileCreationWizard.java;2;0;2;1;0;0;0;2;2;1;2;1238;2;2;1;0;0;2;2;1238;0;4920;2;2;
/org.eclipse.jface.text/src/org/eclipse/jface/contentassist/IControlContentAssistant.java;1;1;2;1;2;2;2;0;0;0;0;5181;0;0;1;0;0;0;2;5181;0;5199;2;1;
/org.eclipse.swt.tests/JUnit Tests/org/eclipse/swt/tests/junit/Test_org_eclipse_swt_widgets_Monitor.java;1;0;3;1;0;0;0;3;25;1;3;1242;27;27;1;0;0;3;3;1242;0;2123;3;1;
/org.eclipse.ui.ide/extensions/org/eclipse/ui/dialogs/WizardNewProjectReferencePage.java;1;0;2;1;0;0;0;2;4;1;2;2263;4;4;1;0;0;2;2;2263;0;2611;2;1;
/org.eclipse.ui.workbench/Eclipse UI/org/eclipse/ui/progress/IProgressService.java;2;2;21;2;14;11;14;7;71;2;6;2760;288;288;2;1;3;7;21;2760;4;6338;17;2;
/org.eclipse.jdt.core/dom/org/eclipse/jdt/core/dom/IBinding.java;3;0;8;1;1;1;1;7;12;1;7;2729;52;52;1;0;0;7;8;2729;0;5871;8;3;
/org.eclipse.ui.presentations.r21/src/org/eclipse/ui/internal/presentations/r21/widgets/CTabFolder.java;1;1;2;1;2;2;2;0;2;0;0;6075;2;2;1;0;0;0;2;6075;0;6338;2;1;
/org.eclipse.swt/Eclipse SWT/carbon/org/eclipse/swt/widgets/TabItem.java;3;1;5;1;2;2;2;3;12;1;3;268;33;33;1;0;0;3;5;268;0;6352;5;3;
/org.eclipse.jdt.ui.tests.refactoring/resources/ExtractMethodWorkSpace/ExtractMethodTests/return_in/A_test726.java;1;0;2;1;0;0;0;2;2;1;2;130;4;4;1;0;0;2;2;130;0;844;2;1;
/org.eclipse.jdt.core/model/org/eclipse/jdt/internal/core/DeltaProcessingState.java;2;2;21;2;6;5;6;15;454;4;11;1130;1049;1049;4;4;1;15;21;2267;5;5728;16;2;
/org.eclipse.jdt.core.tests.compiler/src/org/eclipse/jdt/core/tests/compiler/parser/AbstractSelectionTest.java;3;0;6;1;0;0;0;6;16;1;6;69;45;45;1;0;0;6;6;69;0;3560;6;3;
/org.eclipse.jdt.ui/core refactoring/org/eclipse/jdt/internal/corext/refactoring/reorg/ReadOnlyResourceFinder.java;3;0;5;1;1;1;1;4;9;1;4;1114;22;22;1;0;0;4;5;1114;0;6340;5;3;
/org.eclipse.jdt.ui/ui refactoring/org/eclipse/jdt/internal/ui/refactoring/reorg/RenameRefactoringWizard.java;2;0;8;1;1;1;1;7;16;1;7;1126;54;54;1;0;0;7;8;1126;0;6340;8;2;
/org.eclipse.osgi/osgi/src/org/eclipse/osgi/service/resolver/StateDelta.java;3;1;4;1;2;2;2;2;10;1;2;3013;20;20;1;0;0;2;4;3013;0;6337;4;3;
/org.eclipse.ui.workbench/Eclipse UI/org/eclipse/ui/keys/IKeyBinding.java;1;0;2;1;0;0;0;2;0;1;2;1294;0;0;1;0;0;2;2;1294;0;1321;2;1;
/org.eclipse.osgi/defaultAdaptor/src/org/eclipse/osgi/framework/adaptor/core/ReferenceInputStream.java;2;0;2;1;1;1;1;1;2;0;1;4336;2;2;1;0;0;1;2;4336;0;5117;2;2;
/org.eclipse.jdt.debug.tests/tests/org/eclipse/jdt/debug/tests/eval/NestedTypeFieldValue_354.java;1;0;1;1;0;0;0;1;74;0;1;1274;74;74;1;0;0;1;1;1274;0;1274;1;1;
/org.eclipse.jdt.core.tests.model/workspace/Converter/junit/framework/TestFailure.java;1;0;2;1;0;0;0;2;18;1;2;787;18;18;1;0;0;2;2;787;0;3714;2;1;
/org.eclipse.jdt.debug.ui/ui/org/eclipse/jdt/internal/debug/ui/actions/AbstractAddStepFilterAction.java;1;0;1;1;0;0;0;1;6;0;1;1592;6;6;1;0;0;1;1;1592;0;1592;1;1;
/org.eclipse.jdt.core/dom/org/eclipse/jdt/core/dom/FieldDeclaration.java;5;1;17;1;4;4;4;13;188;1;13;1114;340;340;1;0;0;13;17;1114;0;5781;17;5;
/org.eclipse.core.tests.runtime/src/org/eclipse/core/tests/runtime/jobs/BeginEndRuleTest.java;2;1;25;1;6;6;6;19;441;2;15;1985;2116;2116;2;4;0;19;25;2159;4;6220;21;2;
/org.eclipse.jdt.core.tests.model/workspace/Converter/src/test0247/Test.java;1;0;1;1;0;0;0;1;0;0;1;3714;0;0;1;0;0;1;1;3714;0;3714;1;1;
/org.eclipse.update.core/srcnew/org/eclipse/update/standalone/ScriptedCommand.java;1;0;2;1;0;0;0;2;0;1;2;671;0;0;1;0;0;2;2;671;0;825;2;1;
/org.eclipse.team.ui/src/org/eclipse/team/internal/ui/sync/sets/SubscriberInput.java;2;0;7;1;0;0;0;7;218;1;7;1289;264;264;1;0;0;7;7;1289;0;2632;7;2;
/org.eclipse.jdt.core.tests.model/workspace/Converter/src/javadoc/testBug51226/X6.java;1;0;1;1;0;0;0;1;0;0;1;3899;0;0;1;0;0;1;1;3899;0;3899;1;1;
/org.eclipse.ui.workbench.texteditor/src/org/eclipse/ui/texteditor/templates/TemplateProposal.java;2;0;6;1;0;0;0;6;17;2;4;4258;33;33;2;2;0;6;6;4258;2;4382;4;2;
/org.eclipse.jdt.ui/ui/org/eclipse/jdt/internal/ui/callhierarchy/TreeRoot.java;2;0;4;1;1;1;1;3;3;1;3;155;7;7;1;0;0;3;4;155;0;6340;4;2;
/org.eclipse.ui.forms/src/org/eclipse/ui/forms/events/ExpansionEvent.java;1;0;5;1;1;1;1;4;36;1;4;4068;46;46;1;0;0;4;5;4068;0;6336;5;1;
/org.eclipse.core.resources/src/org/eclipse/core/internal/indexing/IndexAnchor.java;1;0;1;1;1;1;1;0;17;0;0;5146;17;17;1;0;0;0;1;5146;0;5146;1;1;
/org.eclipse.help.base/src/org/eclipse/help/internal/search/SearchIndex.java;1;2;22;1;7;6;7;15;226;2;13;1740;742;742;2;2;1;15;22;1740;3;6337;19;1;
/org.eclipse.jdt.ui/ui refactoring/org/eclipse/jdt/internal/ui/refactoring/AbstractDescriptor.java;1;0;7;1;0;0;0;7;34;1;7;1033;75;75;1;0;0;7;7;1033;0;4965;7;1;
/org.eclipse.swt.tests/JUnit Tests/org/eclipse/swt/tests/junit/Test_org_eclipse_swt_custom_TableEditor.java;1;0;1;1;0;0;0;1;26;0;1;2104;26;26;1;0;0;1;1;2104;0;2104;1;1;
/org.eclipse.ui.workbench/Eclipse UI/org/eclipse/ui/keys/XemacsKeyFormatter.java;2;0;4;1;0;0;0;4;4;2;3;3214;8;8;2;1;0;4;4;3214;1;3310;3;2;
/org.eclipse.update.core/src/org/eclipse/update/internal/core/FeaturePackagedContentProvider.java;3;1;5;1;2;2;2;3;21;1;3;890;35;35;1;0;0;3;5;890;0;6336;5;3;
/org.eclipse.jdt.ui/ui/org/eclipse/jdt/internal/ui/wizards/buildpaths/BuildPathsBlock.java;3;1;12;1;3;3;3;9;59;1;9;1336;216;216;1;0;0;9;12;1336;0;6340;12;3;
/org.eclipse.team.ui/src/org/eclipse/team/ui/synchronize/subscriber/SubscriberRefreshSchedule.java;1;0;6;1;0;0;0;6;195;1;6;4047;209;209;1;0;0;6;6;4047;0;4632;6;1;
/org.eclipse.ui.workbench/Eclipse UI/org/eclipse/ui/roles/ICategoryManagerListener.java;1;0;2;1;0;0;0;2;0;0;1;2864;0;0;2;1;0;2;2;2864;1;2864;1;1;
/org.eclipse.jdt.core.tests.model/workspace/Converter/src/test0186/Test.java;1;0;1;1;0;0;0;1;0;0;1;3714;0;0;1;0;0;1;1;3714;0;3714;1;1;
/org.eclipse.ui.ide/src/org/eclipse/ui/internal/ide/dialogs/ResourceWorkingSetPage.java;1;0;2;1;0;0;0;2;3;1;2;2264;3;3;1;0;0;2;2;2264;0;2611;2;1;
/org.eclipse.ltk.ui.refactoring/src/org/eclipse/ltk/internal/ui/refactoring/RefactoringPreferences.java;1;0;2;1;1;1;1;1;0;0;1;4965;0;0;1;0;0;1;2;4965;0;5190;2;1;
/org.eclipse.core.tests.resources/src/org/eclipse/core/tests/internal/indexing/BasicPageStoreTest.java;1;0;2;1;2;1;2;0;89;0;0;5147;89;89;2;0;1;0;2;5147;1;5147;1;1;
/org.eclipse.jdt.ui.tests.refactoring/resources/ChangeSignature/canModify/A_testAll57_in.java;1;0;1;1;0;0;0;1;0;0;1;1095;0;0;1;0;0;1;1;1095;0;1095;1;1;
/org.eclipse.ui.workbench/Eclipse UI/org/eclipse/ui/internal/csm/roles/api/IRoleManagerEvent.java;1;0;4;1;0;0;0;4;22;2;3;2213;24;24;2;1;0;4;4;2238;1;2238;3;1;
/org.eclipse.ui.examples.job/src/org/eclipse/ui/examples/jobs/BusyShowWhileDialog.java;2;1;3;1;3;3;3;0;9;0;0;5126;14;14;1;0;0;0;3;5126;0;5800;3;2;
/org.eclipse.ui.workbench/Eclipse UI/org/eclipse/ui/internal/progress/ProgressMonitorFocusJobDialog.java;1;2;24;1;14;11;14;10;752;2;7;4891;1415;1415;2;3;3;10;24;4891;6;6243;18;1;
/org.eclipse.jdt.core.tests.model/workspace/Formatter/test202/A_in.java;1;0;1;1;0;0;0;1;0;0;1;2424;0;0;1;0;0;1;1;2424;0;2424;1;1;
/org.eclipse.jdt.core/model/org/eclipse/jdt/internal/core/eval/EvaluationContextWrapper.java;3;0;8;1;0;0;0;8;78;2;7;13;169;169;2;1;0;8;8;2095;1;3606;7;3;
/org.eclipse.swt/Eclipse SWT/gtk/org/eclipse/swt/widgets/List.java;7;2;33;2;7;5;7;26;138;2;20;110;678;678;2;6;2;26;33;1238;8;6352;25;7;
/org.eclipse.pde.ui/src_Forms/org/eclipse/pde/internal/ui/neweditor/feature/NewFeaturePluginWizardPage.java;2;0;2;1;1;1;1;1;0;0;1;4926;0;0;1;0;0;1;2;4926;0;5431;2;2;
/org.eclipse.ui.intro/src/org/eclipse/ui/internal/intro/impl/model/AbstractIntroElement.java;1;1;9;1;9;9;9;0;28;0;0;5115;110;110;1;0;0;0;9;5115;0;6251;9;1;
/org.eclipse.pde.ui/templates/multiPageEditor/java/$contributorClassName$.java;1;0;1;1;0;0;0;1;10;0;1;851;10;10;1;0;0;1;1;851;0;851;1;1;
/org.eclipse.jdt.core.tests.model/workspace/Converter/src/test0561/A.java;1;0;1;1;1;1;1;0;0;0;0;6078;0;0;1;0;0;0;1;6078;0;6078;1;1;
/org.eclipse.ui.examples.javaeditor/Eclipse Java Editor Example/org/eclipse/ui/examples/javaeditor/java/JavaPartitionScanner.java;2;0;2;1;0;0;0;2;4;1;2;1349;4;4;1;0;0;2;2;1349;0;1581;2;2;
/org.eclipse.team.cvs.ui/src/org/eclipse/team/internal/ccvs/ui/model/CVSRepositoryRootElement.java;2;0;4;1;1;1;1;3;5;1;3;916;12;12;1;0;0;3;4;916;0;6337;4;2;
/org.eclipse.jdt.ui/ui/org/eclipse/jdt/internal/ui/actions/QuickAccessAction2.java;1;0;2;1;0;0;0;2;0;1;2;4864;0;0;1;0;0;2;2;4864;0;5052;2;1;
/org.eclipse.ui.ide/src/org/eclipse/ui/internal/ide/model/WorkbenchStatus.java;1;0;2;1;0;0;0;2;1;1;2;2264;1;1;1;0;0;2;2;2264;0;2616;2;1;
/org.eclipse.ui.ide/src/org/eclipse/ui/ide/IDE.java;6;2;29;2;7;5;7;22;259;2;17;1511;1067;1067;2;5;2;22;29;1561;7;6338;22;6;
/org.eclipse.jdt.ui.tests.refactoring/resources/ChangeTypeRefactoring/positive/A_testLocalVarCast_in.java;1;0;1;1;0;0;0;1;0;0;1;2844;0;0;1;0;0;1;1;2844;0;2844;1;1;
/org.eclipse.osgi/eclipseAdaptor/src/org/eclipse/core/runtime/adaptor/testsupport/SimplePlatformAdmin.java;2;0;2;1;1;1;1;1;2;0;1;4239;2;2;1;0;0;1;2;4239;0;5117;2;2;
/org.eclipse.jdt.ui/core refactoring/org/eclipse/jdt/internal/corext/refactoring/rename/RenameTypeProcessor.java;4;1;39;2;11;11;11;28;83;3;24;1125;461;461;3;4;0;28;39;1125;4;6340;35;4;
/org.eclipse.jdt.ui/ui/org/eclipse/jdt/internal/ui/JavaPlugin.java;8;2;50;2;16;13;16;34;137;2;28;174;825;825;2;6;3;34;50;1581;9;6340;41;8;
/org.eclipse.osgi.tests/src/org/eclipse/osgi/tests/services/resolver/StateComparisonTest.java;1;0;1;1;1;1;1;0;0;0;0;5993;0;0;1;0;0;0;1;5993;0;5993;1;1;
/org.eclipse.jdt.ui.examples.javafamily/coresearch-experiment/org/eclipse/search/internal/core/Util.java;1;0;2;1;0;0;0;2;0;1;2;1380;0;0;1;0;0;2;2;1380;0;3214;2;1;
/org.eclipse.ui.views/src/org/eclipse/ui/views/internal/markers/ProblemFilter.java;1;0;2;1;0;0;0;2;0;0;1;749;0;0;2;1;0;2;2;749;1;749;1;1;
/org.eclipse.ui.workbench/Eclipse UI/org/eclipse/ui/activities/support/IPluginContribution.java;2;0;2;2;0;0;0;2;0;0;1;3061;0;0;2;1;0;2;2;3061;1;3061;1;2;
/org.eclipse.pde.ui/src/org/eclipse/pde/internal/ui/wizards/imports/FeatureImportWizard.java;2;1;3;1;2;2;2;1;74;0;1;3091;90;90;1;0;0;1;3;3091;0;6336;3;2;
/org.eclipse.jdt.debug.ui/ui/org/eclipse/jdt/internal/debug/ui/monitors/MonitorManager.java;4;1;6;1;2;2;2;4;4;1;4;1844;18;18;1;0;0;4;6;1844;0;6336;6;4;
/org.eclipse.team.cvs.ui/src/org/eclipse/team/internal/ccvs/ui/actions/IgnoreAction.java;2;1;3;1;2;2;2;1;23;0;1;4699;27;27;1;0;0;1;3;4699;0;6337;3;2;
/org.eclipse.ui.workbench/Eclipse UI/org/eclipse/ui/model/IWorkbenchAdapter.java;4;0;5;2;2;1;2;3;22;1;3;2737;58;58;2;0;1;3;5;6338;1;6338;4;4;
/org.eclipse.jdt.core.tests.model/workspace/Converter/src/test0200/Test.java;1;0;1;1;0;0;0;1;0;0;1;3714;0;0;1;0;0;1;1;3714;0;3714;1;1;
/org.eclipse.jdt.ui/ui refactoring/org/eclipse/jdt/internal/ui/refactoring/MoveInstanceMethodInputPage.java;2;0;3;1;0;0;0;3;3;1;3;218;6;6;1;0;0;3;3;218;0;518;3;2;
/org.eclipse.jdt.core.tests.model/workspace/Converter/test0156/Test.java;1;0;1;1;0;0;0;1;0;0;1;3714;0;0;1;0;0;1;1;3714;0;3714;1;1;
/org.eclipse.update.core/src/org/eclipse/update/internal/operations/JobTargetSites.java;2;0;6;1;1;1;1;5;21;1;5;825;45;45;1;0;0;5;6;825;0;6147;6;2;
/org.eclipse.ui.editors/src/org/eclipse/ui/texteditor/SimpleMarkerAnnotation.java;2;1;2;1;2;2;2;0;7;0;0;5333;7;7;1;0;0;0;2;5333;0;6337;2;2;
/org.eclipse.ant.tests.ui/test plugin/org/eclipse/ant/tests/ui/testplugin/AntUITests.java;2;0;19;2;1;1;1;18;49;2;13;1388;229;229;2;5;0;18;19;1746;5;5739;14;2;
/org.eclipse.update.core/src/org/eclipse/update/internal/api/search/IUpdateSearchSite.java;1;0;2;1;0;0;0;2;0;1;2;3270;0;0;1;0;0;2;2;3270;0;4928;2;1;
/org.eclipse.ui.tests/Eclipse UI Tests/org/eclipse/ui/tests/api/IEditorPartTest.java;3;1;3;1;2;2;2;1;4;0;1;2738;9;9;1;0;0;1;3;2738;0;6338;3;3;
/org.eclipse.ui.tests/Eclipse UI Tests/org/eclipse/ui/tests/dnd/EditorDragSource.java;1;0;1;1;0;0;0;1;0;0;1;5007;0;0;1;0;0;1;1;5007;0;5007;1;1;
/org.eclipse.debug.core/core/org/eclipse/debug/core/Launch.java;3;1;4;1;2;2;2;2;76;1;2;4168;124;124;1;0;0;2;4;4168;0;6336;4;3;
/org.eclipse.jdt.core/dom/org/eclipse/jdt/internal/core/dom/rewrite/RewriteEventStore.java;3;1;4;1;2;2;2;2;222;1;2;4802;264;264;1;0;0;2;4;4802;0;6336;4;3;
/org.eclipse.jdt.debug/jdi/org/eclipse/jdi/internal/event/VMDisconnectEventImpl.java;1;0;1;1;0;0;0;1;3;0;1;2497;3;3;1;0;0;1;1;2497;0;2497;1;1;
/org.eclipse.jdt.ui/ui/org/eclipse/jdt/ui/actions/FindWriteReferencesInHierarchyAction.java;2;0;2;1;1;1;1;1;5;0;1;3266;7;7;1;0;0;1;2;3266;0;6340;2;2;
/org.eclipse.ui.views/src/org/eclipse/ui/views/markers/internal/ActionOpenMarker.java;2;0;2;1;0;0;0;2;0;1;2;755;0;0;1;0;0;2;2;755;0;2738;2;2;
/org.eclipse.jdt.ui.tests.refactoring/resources/ExtractMethodWorkSpace/ExtractMethodTests/locals_in/A_test507.java;1;0;1;1;0;0;0;1;2;0;1;844;2;2;1;0;0;1;1;844;0;844;1;1;
/org.eclipse.pde.ui/src/org/eclipse/pde/internal/ui/wizards/extension/NewSchemaFileWizard.java;2;1;4;1;4;4;4;0;22;0;0;5191;34;34;1;0;0;0;4;5191;0;6336;4;2;
/org.eclipse.team.tests.cvs.core/src/org/eclipse/team/tests/ccvs/core/subscriber/TestMergeUpdateOperation.java;2;0;2;1;1;1;1;1;4;0;1;4450;4;4;1;0;0;1;2;4450;0;6337;2;2;
/org.eclipse.jdt.ui.tests.refactoring/resources/SurroundWithWorkSpace/SurroundWithTests/trycatch_in/TestThenStatement.java;1;0;1;1;0;0;0;1;0;0;1;1206;0;0;1;0;0;1;1;1206;0;1206;1;1;
/org.eclipse.jdt.ui.tests.refactoring/resources/TypeConstraints/A_testNumber0.java;1;0;1;1;0;0;0;1;0;0;1;53;0;0;1;0;0;1;1;53;0;53;1;1;
/org.eclipse.ant.ui/Ant Tools Support/org/eclipse/ant/internal/ui/console/BuildFailedTracker.java;3;0;11;1;1;1;1;10;40;3;8;1811;98;98;3;2;0;10;11;2161;2;5638;9;3;
/org.eclipse.jdt.core.tests.model/workspace/Converter/src/junit/runner/BaseTestRunner.java;1;0;1;1;0;0;0;1;0;0;1;3714;0;0;1;0;0;1;1;3714;0;3714;1;1;
/org.eclipse.ltk.core.refactoring/src/org/eclipse/ltk/internal/core/refactoring/RefactoringCoreMessages.java;1;0;2;1;1;1;1;1;2;0;1;4845;2;2;1;0;0;1;2;4845;0;6340;2;1;
/org.eclipse.core.tests.resources/src/org/eclipse/core/tests/resources/session/Test1GALH44.java;1;0;1;1;1;1;1;0;120;0;0;5147;120;120;1;0;0;0;1;5147;0;5147;1;1;
/org.eclipse.jdt.junit/src/org/eclipse/jdt/internal/junit/refactoring/ProjectRenameParticipant.java;2;1;3;1;2;2;2;1;10;0;1;5041;14;14;1;0;0;1;3;5041;0;6340;3;2;
/org.eclipse.ui.views/src/org/eclipse/ui/views/tasklist/TaskAction.java;1;0;1;1;0;0;0;1;0;0;1;2738;0;0;1;0;0;1;1;2738;0;2738;1;1;
/org.eclipse.ui.workbench/Eclipse UI/org/eclipse/ui/themes/ITheme.java;1;0;7;1;1;1;1;6;97;2;5;4428;163;163;2;1;0;6;7;4559;1;5247;6;1;
/org.eclipse.core.runtime/src/org/eclipse/core/runtime/jobs/IJobStatus.java;1;0;1;1;1;1;1;0;0;0;0;5310;0;0;1;0;0;0;1;5310;0;5310;1;1;
/org.eclipse.debug.core/core/org/eclipse/debug/internal/core/LogicalStructureManager.java;3;1;5;1;2;2;2;3;30;2;2;2647;39;39;2;1;0;3;5;2661;1;6336;4;3;
/org.eclipse.jdt.core.tests.model/workspace/Formatter/test007/A_out.java;1;0;1;1;0;0;0;1;0;0;1;2425;0;0;1;0;0;1;1;2425;0;2425;1;1;
/org.eclipse.jdt.core.tests.model/workspace/Converter/src/test0490/A.java;1;0;1;1;0;0;0;1;0;0;1;3714;0;0;1;0;0;1;1;3714;0;3714;1;1;
/org.eclipse.jdt.ui/ui/org/eclipse/jdt/internal/ui/viewsupport/TreeHierarchyLayoutProblemsDecorator.java;1;0;1;1;1;1;1;0;2;0;0;6340;2;2;1;0;0;0;1;6340;0;6340;1;1;
/org.eclipse.ui.workbench/Eclipse UI/org/eclipse/ui/internal/contexts/activationservice/CompoundContextActivationService.java;1;0;2;1;0;0;0;2;0;1;2;3066;0;0;1;0;0;2;2;3066;0;3109;2;1;
/org.eclipse.debug.core/core/org/eclipse/debug/internal/core/sourcelookup/SourcePathComputer.java;1;0;2;1;0;0;0;2;1;1;2;3678;1;1;1;0;0;2;2;3678;0;4949;2;1;
/org.eclipse.core.resources/src/org/eclipse/core/internal/resources/MarkerSet.java;2;0;3;1;1;1;1;2;361;1;2;1744;380;380;1;0;0;2;3;1744;0;5146;3;2;
/org.eclipse.jdt.ui/ui/org/eclipse/jdt/internal/ui/javaeditor/GotoAnnotationAction.java;1;0;3;1;1;1;1;2;2;1;2;1520;4;4;1;0;0;2;3;1520;0;6340;3;1;
/org.eclipse.team.webdav/src/org/eclipse/team/internal/ui/target/ExportTargetSiteMainPage.java;2;0;2;1;0;0;0;2;0;1;2;2495;0;0;1;0;0;2;2;2495;0;4216;2;2;
/org.eclipse.jdt.ui/ui/org/eclipse/jdt/internal/ui/preferences/formatter/AlreadyExistsDialog.java;1;0;4;1;0;0;0;4;22;1;4;3145;26;26;1;0;0;4;4;3145;0;3943;4;1;
/org.eclipse.ui.workbench/Eclipse UI/org/eclipse/ui/internal/commands/Sequence.java;1;0;4;1;0;0;0;4;4;1;4;607;4;4;1;0;0;4;4;607;0;1077;4;1;
/org.eclipse.help/src/org/eclipse/help/internal/toc/ITocNode.java;1;1;4;1;2;2;2;2;21;1;2;3513;43;43;1;0;0;2;4;3513;0;6337;4;1;
/org.eclipse.jdt.ui/ui/org/eclipse/jdt/internal/ui/callhierarchy/OpenCallHierarchyActionDelegate.java;1;0;3;1;0;0;0;3;5;1;3;155;5;5;1;0;0;3;3;155;0;237;3;1;
/org.eclipse.ui.workbench.texteditor/src/org/eclipse/ui/texteditor/templates/TemplateMessages.java;1;0;2;1;1;1;1;1;0;0;1;4627;0;0;1;0;0;1;2;4627;0;5304;2;1;
/org.eclipse.ui.workbench/Eclipse UI/org/eclipse/ui/internal/roles/RoleManager.java;2;0;30;1;0;0;0;30;666;5;17;1938;2225;2225;5;13;0;30;30;1949;13;2864;17;2;
/org.eclipse.swt/Eclipse SWT/carbon/org/eclipse/swt/widgets/Composite.java;4;1;14;1;3;3;3;11;54;1;11;17;231;231;1;0;0;11;14;17;0;6352;14;4;
/org.eclipse.pde.ui/src/org/eclipse/pde/internal/ui/wizards/templates/PerspectiveExtensionsNewWizard.java;3;1;5;1;4;4;4;1;12;0;1;3986;31;31;1;0;0;1;5;3986;0;6336;5;3;
/org.eclipse.jface.text/src/org/eclipse/jface/contentassist/ComboContentAssistSubjectAdapter.java;1;2;5;1;5;4;5;0;28;0;0;5181;50;50;2;0;1;0;5;6340;1;6356;4;1;
/org.eclipse.swt/Eclipse SWT PI/gtk/org/eclipse/swt/internal/gtk/XCrossingEvent.java;1;0;1;1;1;1;1;0;0;0;0;6362;0;0;1;0;0;0;1;6362;0;6362;1;1;
/org.eclipse.jdt.ui/core extension/org/eclipse/jdt/internal/corext/callhierarchy/Implementors.java;2;0;4;1;1;1;1;3;8;2;2;155;10;10;2;1;0;3;4;169;1;6340;3;2;
/org.eclipse.ui.workbench/Eclipse UI/org/eclipse/ui/part/WorkbenchPart.java;6;2;26;2;13;10;13;13;400;2;11;2737;899;899;2;2;3;13;26;2842;5;6338;21;6;
/org.eclipse.osgi/core/framework/org/eclipse/osgi/framework/console/CommandInterpreter.java;4;2;6;1;4;3;4;2;115;1;2;3013;124;124;2;0;1;2;6;5116;1;6337;5;4;
/org.eclipse.swt/Eclipse SWT PI/carbon/org/eclipse/swt/internal/Platform.java;1;0;1;1;0;0;0;1;0;0;1;1969;0;0;1;0;0;1;1;1969;0;1969;1;1;
/org.eclipse.debug.core/core/org/eclipse/debug/internal/core/variables/LaunchVariableManager.java;2;0;7;1;0;0;0;7;42;2;5;754;89;89;2;2;0;7;7;754;2;2120;5;2;
/org.eclipse.team.core/src/org/eclipse/team/internal/core/subscribers/caches/PersistantResourceVariantTree.java;2;0;3;1;0;0;0;3;160;1;3;4194;160;160;1;0;0;3;3;4194;0;4233;3;2;
/org.eclipse.jdt.core.tests.model/workspace/Converter/src/test0342/Test.java;1;0;1;1;0;0;0;1;0;0;1;3714;0;0;1;0;0;1;1;3714;0;3714;1;1;
/org.eclipse.jdt.ui.tests.refactoring/resources/UseSupertypeWherePossible/test63/in/A.java;1;0;1;1;0;0;0;1;2;0;1;1272;2;2;1;0;0;1;1;1272;0;1272;1;1;
/org.eclipse.osgi/core/adaptor/org/eclipse/osgi/framework/util/SecureAction.java;3;1;6;1;3;3;3;3;58;1;3;4471;99;99;1;0;0;3;6;4471;0;6337;6;3;
/org.eclipse.jdt.core/formatter/org/eclipse/jdt/internal/formatter/CodeFormatterVisitor.java;4;1;110;2;8;8;8;102;855;5;66;822;5675;5675;5;36;0;102;110;3164;36;5916;74;4;
/org.eclipse.jdt.core.tests.model/workspace/Converter/test0478/A.java;1;0;2;1;0;0;0;2;0;1;2;1289;0;0;1;0;0;2;2;1289;0;3714;2;1;
/org.eclipse.team.cvs.core/src/org/eclipse/team/internal/ccvs/core/ICVSRemoteResource.java;1;0;2;1;1;1;1;1;21;0;1;4216;23;23;1;0;0;1;2;4216;0;6337;2;1;
/org.eclipse.jdt.ui/ui refactoring/org/eclipse/jdt/internal/ui/refactoring/RefactoringSavePreferences.java;2;0;2;1;1;1;1;1;2;0;1;4965;2;2;1;0;0;1;2;4965;0;6340;2;2;
/org.eclipse.osgi/core/framework/org/eclipse/osgi/framework/launcher/Launcher.java;4;1;5;1;3;3;3;2;112;1;2;3013;224;224;1;0;0;2;5;3013;0;6337;5;4;
/org.eclipse.jdt.core.tests.model/workspace/Formatter/test328/A_out.java;1;0;2;1;0;0;0;2;6;1;2;2640;6;6;1;0;0;2;2;2640;0;2893;2;1;
/org.eclipse.jdt.ui/ui/org/eclipse/jdt/internal/ui/browsing/LexicalSortingAction.java;1;0;2;1;0;0;0;2;2;1;2;1350;2;2;1;0;0;2;2;1350;0;4486;2;1;
/org.eclipse.jdt.core/compiler/org/eclipse/jdt/internal/compiler/codegen/AttributeNamesConstants.java;1;0;1;1;0;0;0;1;2;0;1;3560;2;2;1;0;0;1;1;3560;0;3560;1;1;
/org.eclipse.jdt.ui/ui/org/eclipse/jdt/internal/ui/JavaUIException.java;1;0;1;1;1;1;1;0;2;0;0;6340;2;2;1;0;0;0;1;6340;0;6340;1;1;
/org.eclipse.pde.ui/src/org/eclipse/pde/internal/ui/editor/build/BuildForm.java;2;0;12;1;1;1;1;11;165;2;9;1727;467;467;2;2;0;11;12;1750;2;5431;10;2;
/org.eclipse.core.resources/src/org/eclipse/core/internal/events/PathVariableChangeEvent.java;1;0;1;1;1;1;1;0;8;0;0;5146;8;8;1;0;0;0;1;5146;0;5146;1;1;
/org.eclipse.ui.ide/src/org/eclipse/ui/actions/OpenWithMenu.java;2;0;9;1;0;0;0;9;46;1;9;1511;104;104;1;0;0;9;9;1511;0;2263;9;2;
/org.eclipse.update.ui/src/org/eclipse/update/internal/ui/forms/CategoryForm.java;1;0;1;1;0;0;0;1;0;0;1;755;0;0;1;0;0;1;1;755;0;755;1;1;
/org.eclipse.core.tests.resources/src/org/eclipse/core/tests/internal/builders/TestBuilder.java;2;0;3;1;2;1;2;1;193;0;1;4897;212;212;2;0;1;1;3;5147;1;5147;2;2;
/org.eclipse.swt.tools/Native Stats/org/eclipse/swt/tools/internal/NativeStats.java;2;0;2;2;2;1;2;0;0;0;0;5338;0;0;2;0;1;0;2;5338;1;5338;1;2;
/org.eclipse.jdt.ui/ui/org/eclipse/jdt/internal/ui/text/correction/ASTResolving.java;4;2;25;2;7;6;7;18;181;2;17;218;713;713;2;1;1;18;25;955;2;6340;23;4;
/org.eclipse.jdt.debug.ui/ui/org/eclipse/jdt/internal/debug/ui/classpath/ClasspathMessages.java;1;0;2;1;0;0;0;2;4;1;2;2691;6;6;1;0;0;2;2;2691;0;4473;2;1;
/org.eclipse.swt/Eclipse SWT Accessibility/common/org/eclipse/swt/accessibility/ACC.java;2;1;5;1;2;2;2;3;6;1;3;2244;16;16;1;0;0;3;5;2244;0;6352;5;2;
/org.eclipse.swt.examples/src/org/eclipse/swt/examples/controlexample/DialogTab.java;3;1;5;1;2;2;2;3;11;1;3;88;39;39;1;0;0;3;5;88;0;6352;5;3;
/org.eclipse.update.configurator/src/org/eclipse/update/configurator/PlatformConfiguration.java;2;0;5;1;0;0;0;5;241;1;5;3014;252;252;1;0;0;5;5;3014;0;3243;5;2;
/org.eclipse.jdt.ui.tests.refactoring/resources/ExtractTemp/canExtract/A_test66_in.java;1;0;1;1;0;0;0;1;0;0;1;87;0;0;1;0;0;1;1;87;0;87;1;1;
/org.eclipse.team.ui/src/org/eclipse/team/ui/synchronize/presentation/DiffNodeControllerHierarchical.java;1;0;1;1;0;0;0;1;0;0;1;4077;0;0;1;0;0;1;1;4077;0;4077;1;1;
/org.eclipse.jdt.ui/ui refactoring/org/eclipse/jdt/internal/ui/refactoring/PullUpTreeViewer.java;2;0;2;1;1;1;1;1;12;0;1;4575;14;14;1;0;0;1;2;4575;0;6340;2;2;
/org.eclipse.jdt.ui.tests.refactoring/resources/RenamePackage/testImportFromMultiRoots2/out/srcTest/tests/AllTests.java;2;0;3;1;0;0;0;3;12;1;3;3219;13;13;1;0;0;3;3;3219;0;4307;3;2;
/org.eclipse.jdt.ui/core refactoring/org/eclipse/jdt/internal/corext/refactoring/tagging/ITextUpdating2.java;1;0;3;1;0;0;0;3;4;1;3;4513;4;4;1;0;0;3;3;4513;0;4585;3;1;
/org.eclipse.update.core/src/org/eclipse/update/core/IUpdateConstants.java;1;1;2;1;2;2;2;0;6;0;0;5423;10;10;1;0;0;0;2;5423;0;6336;2;1;
/org.eclipse.pde.ui/src/org/eclipse/pde/internal/ui/editor/schema/SchemaObjectPropertySource.java;2;1;2;1;2;2;2;0;4;0;0;5781;6;6;1;0;0;0;2;5781;0;6336;2;2;
/org.eclipse.team.webdav/src/org/eclipse/team/ui/target/subscriber/TeamSubscriberNonblockingContext.java;1;0;1;1;0;0;0;1;0;0;1;3379;0;0;1;0;0;1;1;3379;0;3379;1;1;
/org.eclipse.team.core/src/org/eclipse/team/core/sync/SyncInfo.java;1;0;1;1;0;0;0;1;0;0;1;431;0;0;1;0;0;1;1;431;0;431;1;1;
/org.eclipse.jdt.ui.tests.refactoring/resources/ChangeSignature/canModify/A_testInStatic02_out.java;1;0;1;1;0;0;0;1;0;0;1;3216;0;0;1;0;0;1;1;3216;0;3216;1;1;
/org.eclipse.pde.ui/src/org/eclipse/pde/internal/ui/editor/manifest/NewDependencyWizard.java;1;0;1;1;0;0;0;1;0;0;1;3393;0;0;1;0;0;1;1;3393;0;3393;1;1;
/org.eclipse.jdt.ui/ui/org/eclipse/jdt/internal/ui/jarpackager/CheckboxTreeAndListGroup.java;2;1;4;1;2;2;2;2;22;1;2;4047;29;29;1;0;0;2;4;4047;0;6340;4;2;
/org.eclipse.search/search/org/eclipse/search/internal/ui/OpenFileSearchPageAction.java;2;1;2;1;2;2;2;0;9;0;0;6116;11;11;1;0;0;0;2;6116;0;6340;2;2;
/org.eclipse.pde.ui/src/org/eclipse/pde/internal/ui/search/DependencyExtentLabelProvider.java;3;1;4;1;2;2;2;2;6;1;2;2184;16;16;1;0;0;2;4;2184;0;6336;4;3;
/org.eclipse.ui.ide/extensions/org/eclipse/ui/actions/MoveResourceAction.java;1;0;1;1;0;0;0;1;0;0;1;2263;0;0;1;0;0;1;1;2263;0;2263;1;1;
/org.eclipse.jdt.ui.tests.refactoring/resources/Delete/testDeleteWithinCu21/out/A.java;1;0;1;1;0;0;0;1;0;0;1;1186;0;0;1;0;0;1;1;1186;0;1186;1;1;
/org.eclipse.jdt.core.tests.model/workspace/Converter/test0262/Test.java;1;0;1;1;0;0;0;1;0;0;1;3714;0;0;1;0;0;1;1;3714;0;3714;1;1;
/org.eclipse.team.tests.cvs.core/src/org/eclipse/team/tests/ccvs/ui/old/DummyPromptCondition.java;1;0;2;1;0;0;0;2;0;1;2;2632;0;0;1;0;0;2;2;2632;0;4216;2;1;
/org.eclipse.jdt.core.tests.model/workspace/Formatter/test076/A_in.java;1;0;1;1;0;0;0;1;0;0;1;2425;0;0;1;0;0;1;1;2425;0;2425;1;1;
/org.eclipse.ui.ide/src/org/eclipse/ui/internal/ide/misc/ContainerSelectionGroup.java;2;0;2;1;0;0;0;2;2;1;2;2264;2;2;1;0;0;2;2;2264;0;2496;2;2;
/org.eclipse.core.tools.resources/src/org/eclipse/core/tools/metadata/IDumper.java;1;0;1;1;1;1;1;0;0;0;0;6302;0;0;1;0;0;0;1;6302;0;6302;1;1;
/org.eclipse.ui.ide/src/org/eclipse/ui/actions/ImportResourcesAction.java;2;0;11;1;0;0;0;11;76;2;10;1511;123;123;2;1;0;11;11;1632;1;2263;10;2;
/org.eclipse.jdt.ui.tests.refactoring/resources/ExtractMethodWorkSpace/ExtractMethodTests/initializer_out/A_test1002.java;1;0;1;1;0;0;0;1;0;0;1;3310;0;0;1;0;0;1;1;3310;0;3310;1;1;
/org.eclipse.jdt.core/model/org/eclipse/jdt/internal/core/util/SignatureAttribute.java;1;0;1;1;0;0;0;1;0;0;1;3791;0;0;1;0;0;1;1;3791;0;3791;1;1;
/org.eclipse.swt/Eclipse SWT/photon/org/eclipse/swt/widgets/Display.java;7;2;29;3;8;7;8;21;366;2;19;0;730;730;2;2;1;21;29;2588;3;6352;26;7;
/org.eclipse.jdt.core/compiler/org/eclipse/jdt/internal/compiler/flow/FinallyFlowContext.java;1;0;3;1;0;0;0;3;4;1;3;992;8;8;1;0;0;3;3;992;0;3557;3;1;
/org.eclipse.jdt.ui.tests.refactoring/resources/ExtractMethodWorkSpace/ExtractMethodTests/duplicates_out/A_test963.java;1;0;1;1;1;1;1;0;0;0;0;5681;0;0;1;0;0;0;1;5681;0;5681;1;1;
/org.eclipse.ui.workbench/Eclipse UI/org/eclipse/ui/internal/activities/CategoryActivityBinding.java;4;0;5;1;1;1;1;4;4;1;4;2896;8;8;1;0;0;4;5;2896;0;6338;5;4;
/org.eclipse.swt/Eclipse SWT Mozilla/common/org/eclipse/swt/internal/mozilla/nsIDocShell.java;1;0;1;1;0;0;0;1;0;0;1;2663;0;0;1;0;0;1;1;2663;0;2663;1;1;
/org.eclipse.jdt.ui/ui/org/eclipse/jdt/ui/actions/GenerateActionGroup.java;6;1;16;1;3;3;3;13;144;2;12;170;353;353;2;1;0;13;16;3706;1;6340;15;6;
/org.eclipse.ui.intro/src/org/eclipse/ui/internal/intro/impl/util/Log.java;1;1;2;1;2;2;2;0;2;0;0;5140;2;2;1;0;0;0;2;5140;0;5314;2;1;
/org.eclipse.compare/compare/org/eclipse/compare/internal/MergeViewerContentProvider.java;1;1;3;1;2;2;2;1;35;0;1;3253;42;42;1;0;0;1;3;3253;0;6354;3;1;
/org.eclipse.core.tests.resources/src/org/eclipse/core/tests/resources/session/TestCloseNoSave.java;1;0;1;1;1;1;1;0;95;0;0;5147;95;95;1;0;0;0;1;5147;0;5147;1;1;
/org.eclipse.jface.text/src/org/eclipse/jface/text/IWidgetTokenOwnerExtension.java;2;1;3;1;2;2;2;1;20;0;1;1213;30;30;1;0;0;1;3;1213;0;6359;3;2;
/org.eclipse.jdt.core.tests.model/workspace/Converter/junit/textui/TestRunner.java;1;0;2;1;0;0;0;2;204;1;2;787;204;204;1;0;0;2;2;787;0;3714;2;1;
/org.eclipse.jdt.ui/ui/org/eclipse/jdt/internal/ui/callhierarchy/MethodReferencesSearchCollector.java;1;0;2;1;0;0;0;2;0;1;2;155;0;0;1;0;0;2;2;155;0;169;2;1;
/org.eclipse.ui.workbench/Eclipse UI/org/eclipse/ui/internal/IWorkbenchGraphicConstants.java;5;1;12;1;2;2;2;10;88;2;9;2737;225;225;2;1;0;10;12;4235;1;6338;11;5;
/org.eclipse.jdt.core/compiler/org/eclipse/jdt/internal/compiler/ast/FieldReference.java;2;0;11;1;0;0;0;11;13;2;10;41;75;75;2;1;0;11;11;1329;1;3560;10;2;
/org.eclipse.jdt.ui/ui/org/eclipse/jdt/internal/ui/JavaElementContainmentAdapter.java;2;0;2;1;1;1;1;1;2;0;1;1205;3;3;1;0;0;1;2;1205;0;6340;2;2;
/org.eclipse.jdt.core.tests.model/workspace/Converter/src/test0202/Test.java;1;0;1;1;0;0;0;1;0;0;1;3714;0;0;1;0;0;1;1;3714;0;3714;1;1;
/org.eclipse.team.cvs.ui/src/org/eclipse/team/internal/ccvs/ui/actions/UpdateAction.java;2;1;4;1;2;2;2;2;44;1;2;1133;62;62;1;0;0;2;4;1133;0;6337;4;2;
/org.eclipse.core.runtime.compatibility/src-runtime/org/eclipse/core/runtime/IPluginEvent.java;2;0;3;1;0;0;0;3;3;1;3;3013;3;3;1;0;0;3;3;3013;0;3169;3;2;
/org.eclipse.jdt.core.tests.compiler/src/org/eclipse/jdt/core/tests/compiler/parser/DietCompletionTest.java;2;0;2;1;0;0;0;2;6;1;2;991;8;8;1;0;0;2;2;991;0;3560;2;2;
/org.eclipse.core.tests.resources/src/org/eclipse/core/tests/resources/regression/Bug_32076.java;1;0;3;1;3;1;3;0;89;0;0;5147;89;89;3;0;2;0;3;5147;2;5147;1;1;
/org.eclipse.team.cvs.core/src/org/eclipse/team/internal/ccvs/core/client/ModifiedFileSender.java;1;0;1;1;0;0;0;1;5;0;1;1843;5;5;1;0;0;1;1;1843;0;1843;1;1;
/org.eclipse.pde.core/src/org/eclipse/pde/internal/core/EclipseHomeInitializer.java;1;1;6;1;2;2;2;4;68;1;4;2833;136;136;1;0;0;4;6;2833;0;6336;6;1;
/org.eclipse.team.examples.filesystem/src/org/eclipse/team/examples/localhistory/LocalHistorySubscriber.java;2;1;3;1;3;3;3;0;54;0;0;6305;56;56;1;0;0;0;3;6305;0;6337;3;2;
/org.eclipse.jdt.core.tests.model/workspace/Formatter/test281/A_out.java;1;0;1;1;0;0;0;1;0;0;1;2443;0;0;1;0;0;1;1;2443;0;2443;1;1;
/org.eclipse.ui.workbench/Eclipse UI/org/eclipse/ui/internal/commands/registry/IRegistry.java;1;0;5;1;0;0;0;5;115;2;4;1077;196;196;2;1;0;5;5;1396;1;1396;4;1;
/org.eclipse.ui.externaltools/Ant Editor/org/eclipse/ui/externaltools/internal/ant/editor/AntEditorCompletionProcessor.java;1;0;4;1;0;0;0;4;26;2;3;178;33;33;2;1;0;4;4;178;1;282;3;1;
/org.eclipse.jdt.core.tests.model/workspace/Converter/test0097/Test.java;1;0;1;1;0;0;0;1;0;0;1;3714;0;0;1;0;0;1;1;3714;0;3714;1;1;
/org.eclipse.jdt.ui/core refactoring/org/eclipse/ltk/core/refactoring/ValidationStateChangedEvent.java;1;0;3;1;0;0;0;3;1;1;3;4510;1;1;1;0;0;3;3;4510;0;4864;3;1;
/org.eclipse.ui.workbench/Eclipse UI/org/eclipse/ui/keys/ModifierKey.java;3;1;14;2;2;2;2;12;88;2;9;1294;331;331;2;3;0;12;14;2202;3;6338;11;3;
/org.eclipse.jdt.ui/ui/org/eclipse/jdt/internal/ui/preferences/formatter/WhiteSpaceTabPage.java;2;0;15;1;1;1;1;14;1047;2;13;3103;2588;2588;2;1;0;14;15;3103;1;6340;14;2;
/org.eclipse.jdt.ui/ui/org/eclipse/jdt/internal/ui/JavaElementProperties.java;1;0;1;1;1;1;1;0;2;0;0;6340;2;2;1;0;0;0;1;6340;0;6340;1;1;
/org.eclipse.jdt.ui.tests.refactoring/resources/InlineMethodWorkspace/TestCases/nameconflict_out/TestFieldInType.java;1;0;1;1;0;0;0;1;2;0;1;845;2;2;1;0;0;1;1;845;0;845;1;1;
/org.eclipse.ui.ide/src/org/eclipse/ui/internal/dialogs/WizardNewProjectCapabilityPage.java;2;0;4;2;0;0;0;4;23;2;3;1526;23;23;2;1;0;4;4;1537;1;2263;3;2;
/org.eclipse.jdt.ui/ui/org/eclipse/jdt/internal/ui/search/PostfixLabelProvider.java;1;2;12;1;8;6;8;4;36;2;3;4107;145;145;2;1;2;4;12;4625;3;5676;9;1;
/org.eclipse.jdt.debug/jdi/org/eclipse/jdi/internal/event/ClassPrepareEventImpl.java;3;0;3;1;1;1;1;2;4;1;2;791;10;10;1;0;0;2;3;791;0;6336;3;3;
/org.eclipse.team.webdav/src/org/eclipse/team/internal/webdav/ui/subscriber/WebDavOverrideGetAction.java;2;1;4;1;2;2;2;2;32;1;2;3499;39;39;1;0;0;2;4;3499;0;6337;4;2;
/org.eclipse.ant.ui/Ant Tools Support/org/eclipse/ant/internal/ui/launchConfigurations/AntLaunchShortcutWithDialog.java;2;1;2;1;2;2;2;0;4;0;0;5447;4;4;1;0;0;0;2;5447;0;5486;2;2;
/org.eclipse.core.runtime.osgi/src/org/eclipse/core/runtime/IAdaptable.java;1;0;2;1;0;0;0;2;22;1;2;3013;22;22;1;0;0;2;2;3013;0;3030;2;1;
/org.eclipse.pde.core/src/org/eclipse/pde/internal/core/isite/ISiteBuildObject.java;1;0;2;1;1;1;1;1;4;0;1;4203;8;8;1;0;0;1;2;4203;0;6336;2;1;
/org.eclipse.jdt.core.tests.model/workspace/Converter/src/test0398/A.java;1;0;1;1;0;0;0;1;0;0;1;3714;0;0;1;0;0;1;1;3714;0;3714;1;1;
/org.eclipse.jdt.ui.tests.refactoring/resources/ChangeSignature/canModify/A_testImport05_out.java;1;0;2;1;1;1;1;1;1;0;1;3940;1;1;1;0;0;1;2;3940;0;5434;2;1;
/org.eclipse.ui.workbench/Eclipse UI/org/eclipse/ui/internal/contexts/api/IContextRegistryEvent.java;1;0;2;1;0;0;0;2;0;1;2;1724;0;0;1;0;0;2;2;1724;0;2425;2;1;
/org.eclipse.jdt.ui.tests.refactoring/test cases/org/eclipse/jdt/ui/tests/refactoring/infra/DebugUtils.java;2;0;2;1;1;1;1;1;2;0;1;344;2;2;1;0;0;1;2;344;0;6340;2;2;
/org.eclipse.ui.ide/src/org/eclipse/ui/views/markers/internal/DefaultMarkerResourceAdapter.java;1;0;1;1;0;0;0;1;0;0;1;2208;0;0;1;0;0;1;1;2208;0;2208;1;1;
/org.eclipse.jdt.debug/model/org/eclipse/jdt/internal/debug/core/breakpoints/JavaBreakpoint.java;4;0;10;1;0;0;0;10;23;1;10;363;110;110;1;0;0;10;10;363;0;4525;10;4;
/org.eclipse.jdt.ui/ui/org/eclipse/jdt/internal/ui/text/correction/MarkerResolutionProposal.java;2;0;4;1;1;1;1;3;11;1;3;1152;25;25;1;0;0;3;4;1152;0;6340;4;2;
/org.eclipse.osgi/resolver/src/org/eclipse/osgi/internal/resolver/ReadOnlyState.java;3;1;6;1;4;4;4;2;86;1;2;3770;134;134;1;0;0;2;6;3770;0;5521;6;3;
/org.eclipse.team.cvs.ui/src/org/eclipse/team/internal/ccvs/ui/OverlayIconCache.java;1;0;1;1;0;0;0;1;1;0;1;1955;1;1;1;0;0;1;1;1955;0;1955;1;1;
/org.eclipse.jdt.core.tests.model/workspace/Resolve/src/ResolveDuplicateMethodDelcaration.java;1;1;2;1;2;2;2;0;0;0;0;6095;0;0;1;0;0;0;2;6095;0;6222;2;1;
/org.eclipse.jdt.ui/ui/org/eclipse/jdt/internal/ui/javaeditor/IJavaEditorActionConstants.java;2;0;3;1;1;1;1;2;15;1;2;500;27;27;1;0;0;2;3;500;0;6340;3;2;
/org.eclipse.ua.tests/src/org/eclipse/ui/examples/cheatsheets/pattern/dialogs/PatternSelectionDialog.java;1;0;1;1;1;1;1;0;0;0;0;6081;0;0;1;0;0;0;1;6081;0;6081;1;1;
/org.eclipse.update.ui/srcnew/org/eclipse/update/internal/ui/wizards/UnifiedTargetPage.java;3;0;9;2;0;0;0;9;241;3;6;478;402;402;3;3;0;9;9;478;3;825;6;3;
/org.eclipse.ui.workbench/Eclipse UI/org/eclipse/ui/internal/commands/Category.java;3;1;18;1;2;2;2;16;228;2;14;607;557;557;2;2;0;16;18;1629;2;6338;16;3;
/org.eclipse.jface/src/org/eclipse/jface/action/MenuManager.java;8;1;15;1;3;3;3;12;1206;1;12;379;1350;1350;1;0;0;12;15;379;0;6338;15;8;
/org.eclipse.jdt.core.tests.model/workspace/Formatter/test097/A_out.java;1;0;1;1;0;0;0;1;0;0;1;2425;0;0;1;0;0;1;1;2425;0;2425;1;1;
/org.eclipse.jdt.junit/src/org/eclipse/jdt/internal/junit/ui/ProgressImages.java;1;0;1;1;1;1;1;0;2;0;0;6340;2;2;1;0;0;0;1;6340;0;6340;1;1;
/org.eclipse.debug.core/core/org/eclipse/debug/internal/core/ProcessMonitorJob.java;2;0;6;1;0;0;0;6;8;1;6;978;23;23;1;0;0;6;6;978;0;1932;6;2;
/org.eclipse.search/new search/org/eclipse/search2/internal/ui/CancelSearchAction.java;2;1;4;1;2;2;2;2;5;1;2;4059;11;11;1;0;0;2;4;4059;0;6340;4;2;
/org.eclipse.jdt.ui.tests.refactoring/resources/PromoteTempToField/canPromote/A_test19_out.java;1;0;1;1;0;0;0;1;0;0;1;3576;0;0;1;0;0;1;1;3576;0;3576;1;1;
/org.eclipse.core.tools/src/org/eclipse/core/tools/TreeTextOperationTarget.java;1;0;1;1;1;1;1;0;0;0;0;6302;0;0;1;0;0;0;1;6302;0;6302;1;1;
/org.eclipse.jdt.core.tests.model/workspace/Converter15/src/test0003/X.java;1;0;1;1;0;0;0;1;0;0;1;4601;0;0;1;0;0;1;1;4601;0;4601;1;1;
/org.eclipse.ui.workbench/Eclipse UI/org/eclipse/ui/internal/presentations/SystemMenuCloseOthers.java;1;1;2;1;2;2;2;0;4;0;0;5522;4;4;1;0;0;0;2;5522;0;5539;2;1;
/org.eclipse.jdt.core.tests.model/workspace/Formatter/test151/A_in.java;1;0;1;1;0;0;0;1;0;0;1;2425;0;0;1;0;0;1;1;2425;0;2425;1;1;
/org.eclipse.osgi/defaultAdaptor/src/org/eclipse/osgi/framework/internal/protocol/reference/Handler.java;4;1;5;1;3;3;3;2;61;1;2;3013;97;97;1;0;0;2;5;3013;0;6337;5;4;
/org.eclipse.jdt.core.tests.model/workspace/Converter/test0223/Test.java;1;0;1;1;0;0;0;1;0;0;1;3714;0;0;1;0;0;1;1;3714;0;3714;1;1;
/org.eclipse.core.runtime/src/org/eclipse/core/internal/jobs/JobManager.java;3;2;88;1;20;17;20;68;1508;3;58;320;5400;5400;3;10;3;68;88;1133;13;6361;75;3;
/org.eclipse.swt/Eclipse SWT Custom Widgets/common/org/eclipse/swt/custom/CLabel.java;4;2;10;1;6;5;6;4;78;2;3;125;117;117;2;1;1;4;10;3713;2;6352;8;4;
/org.eclipse.ui.externaltools/Ant Editor/org/eclipse/ui/externaltools/internal/ant/editor/PlantySourceViewerConfiguration.java;1;0;1;1;0;0;0;1;0;0;1;178;0;0;1;0;0;1;1;178;0;178;1;1;
/org.eclipse.core.tests.runtime/src/org/eclipse/core/tests/internal/plugins/ActivationTest_NoRef.java;1;0;1;1;0;0;0;1;0;0;1;3014;0;0;1;0;0;1;1;3014;0;3014;1;1;
/org.eclipse.jdt.ui/core extension/org/eclipse/text/edits/MoveTargetEdit.java;1;0;4;1;0;0;0;4;110;2;3;1953;112;112;2;1;0;4;4;1985;1;1985;3;1;
/org.eclipse.jdt.ui.tests.refactoring/resources/InlineMethodWorkspace/TestCases/simple_out/TestEmptyBody.java;1;0;1;1;0;0;0;1;2;0;1;845;2;2;1;0;0;1;1;845;0;845;1;1;
/org.eclipse.jdt.ui/core refactoring/org/eclipse/jdt/internal/corext/refactoring/participants/MoveParticipant.java;1;0;2;1;0;0;0;2;0;1;2;825;0;0;1;0;0;2;2;825;0;4624;2;1;
/org.eclipse.ui.workbench/Eclipse UI/org/eclipse/ui/internal/model/WorkbenchMarker.java;1;0;1;1;0;0;0;1;0;0;1;2737;0;0;1;0;0;1;1;2737;0;2737;1;1;
/org.eclipse.text/src/org/eclipse/text/edits/CopySourceEdit.java;2;0;4;1;1;1;1;3;186;1;3;1986;371;371;1;0;0;3;4;1986;0;6340;4;2;
/org.eclipse.pde.ui/src_Forms/org/eclipse/pde/internal/ui/neweditor/plugin/AlertSection.java;2;0;6;1;1;1;1;5;6;1;5;4243;14;14;1;0;0;5;6;4243;0;5431;6;2;
/org.eclipse.jdt.ui.tests.refactoring/resources/ExtractMethodWorkSpace/ExtractMethodTests/duplicates_out/A_test956.java;1;0;1;1;0;0;0;1;0;0;1;1442;0;0;1;0;0;1;1;1442;0;1442;1;1;
/org.eclipse.jdt.core/model/org/eclipse/jdt/internal/core/TypeVector.java;1;0;1;1;0;0;0;1;2;0;1;3560;2;2;1;0;0;1;1;3560;0;3560;1;1;
/org.eclipse.jdt.core/compiler/org/eclipse/jdt/internal/compiler/parser/NLSLine.java;1;0;1;1;0;0;0;1;2;0;1;3560;2;2;1;0;0;1;1;3560;0;3560;1;1;
/org.eclipse.debug.core/core/org/eclipse/debug/internal/core/memory/MemoryByte.java;1;0;1;1;1;1;1;0;0;0;0;5254;0;0;1;0;0;0;1;5254;0;5254;1;1;
/org.eclipse.jdt.core.tests.model/workspace/Converter/src/test0092/Test.java;1;0;1;1;0;0;0;1;0;0;1;3714;0;0;1;0;0;1;1;3714;0;3714;1;1;
/org.eclipse.core.runtime/src/org/eclipse/core/internal/plugins/Utils.java;2;0;2;1;0;0;0;2;0;1;2;2105;0;0;1;0;0;2;2;2105;0;3013;2;2;
/org.eclipse.jdt.core/compiler/org/eclipse/jdt/internal/compiler/codegen/IntegerCache.java;1;0;1;1;0;0;0;1;2;0;1;3560;2;2;1;0;0;1;1;3560;0;3560;1;1;
/org.eclipse.team.cvs.core/src/org/eclipse/team/internal/ccvs/core/client/TagFileSender.java;1;0;1;1;0;0;0;1;5;0;1;1843;5;5;1;0;0;1;1;1843;0;1843;1;1;
/org.eclipse.jdt.ui.examples.javafamily/src/org/eclipse/jsp/launching/TomcatClasspathProvider.java;1;0;4;1;0;0;0;4;58;2;3;1384;84;84;2;1;0;4;4;1384;1;5091;3;1;
/org.eclipse.jdt.core.tests.compiler/src/org/eclipse/jdt/core/tests/junit/extension/TestResult.java;1;0;1;1;0;0;0;1;2;0;1;3560;2;2;1;0;0;1;1;3560;0;3560;1;1;
/org.eclipse.team.ui/src/org/eclipse/team/ui/synchronize/WorkingSetScope.java;2;2;5;1;5;4;5;0;181;0;0;5594;237;237;2;0;1;0;5;5594;1;6305;4;2;
/org.eclipse.ui.workbench/Eclipse UI/org/eclipse/ui/internal/ide/NewConfigurationInfo.java;1;0;1;1;0;0;0;1;0;0;1;1259;0;0;1;0;0;1;1;1259;0;1259;1;1;
/org.eclipse.jdt.core/compiler/org/eclipse/jdt/internal/compiler/ast/CaseStatement.java;2;0;7;1;0;0;0;7;32;1;7;148;65;65;1;0;0;7;7;148;0;4064;7;2;
/org.eclipse.ant.ui/Ant Tools Support/org/eclipse/ant/ui/internal/preferences/AntClasspathBlock.java;1;0;12;1;0;0;0;12;146;2;10;250;324;324;2;2;0;12;12;264;2;1811;10;1;
/org.eclipse.jdt.debug.ui/ui/org/eclipse/jdt/internal/debug/core/refactoring/JavaWatchpointIFieldRenameParticipant.java;3;0;6;1;1;1;1;5;35;1;5;4519;75;75;1;0;0;5;6;4519;0;6339;6;3;
/org.eclipse.ui.workbench/Eclipse UI/org/eclipse/ui/dialogs/YesNoCancelListSelectionDialog.java;1;0;1;1;1;1;1;0;153;0;0;5464;153;153;1;0;0;0;1;5464;0;5464;1;1;
/org.eclipse.jdt.ui/ui/org/eclipse/jdt/internal/ui/filters/NonPublicFilter.java;1;0;2;1;1;1;1;1;2;0;1;2273;2;2;1;0;0;1;2;2273;0;6340;2;1;
/org.eclipse.update.core/srcnew/org/eclipse/update/internal/operations/FeatureUnconfigOperation.java;1;0;3;1;0;0;0;3;2;2;2;433;2;2;2;1;0;3;3;433;1;442;2;1;
/org.eclipse.ui.workbench/Eclipse UI/org/eclipse/ui/internal/csm/roles/RoleActivityBindingDefinition.java;1;0;3;1;0;0;0;3;4;2;2;2412;4;4;2;1;0;3;3;2412;1;2444;2;1;
/org.eclipse.jdt.core/batch/org/eclipse/jdt/internal/compiler/batch/ClasspathJar.java;2;0;4;1;0;0;0;4;24;2;3;1298;36;36;2;1;0;4;4;1298;1;3560;3;2;
/org.eclipse.ui.workbench/Eclipse UI/org/eclipse/ui/internal/EditorsContentProvider.java;2;0;2;1;0;0;0;2;0;1;2;2620;0;0;1;0;0;2;2;2620;0;4521;2;2;
/org.eclipse.team.webdav/src/org/eclipse/team/internal/core/target/UrlUtil.java;1;0;1;1;0;0;0;1;0;0;1;2495;0;0;1;0;0;1;1;2495;0;2495;1;1;
/org.eclipse.jdt.debug/model/org/eclipse/jdt/internal/debug/core/breakpoints/JavaTargetPatternBreakpoint.java;3;0;3;1;0;0;0;3;7;1;3;363;11;11;1;0;0;3;3;363;0;2740;3;3;
/org.eclipse.debug.ui/ui/org/eclipse/debug/internal/ui/views/memory/AbstractTableViewTabLabelProvider.java;2;1;2;1;2;2;2;0;12;0;0;5254;12;12;1;0;0;0;2;5254;0;5364;2;2;
/org.eclipse.team.cvs.core/src/org/eclipse/team/internal/ccvs/core/CVSMergeSyncInfo.java;2;0;8;1;1;1;1;7;22;1;7;884;68;68;1;0;0;7;8;884;0;5874;8;2;
/org.eclipse.ltk.core.refactoring/src/org/eclipse/ltk/core/refactoring/participants/IConditionChecker.java;1;1;3;1;2;2;2;1;4;0;1;4845;7;7;1;0;0;1;3;4845;0;5184;3;1;
/org.eclipse.jdt.ui.tests.refactoring/resources/MoveMembers/test38/in/B.java;1;0;1;1;0;0;0;1;0;0;1;2093;0;0;1;0;0;1;1;2093;0;2093;1;1;
/org.eclipse.ui.externaltools/External Tools Base/org/eclipse/ui/externaltools/internal/dialog/ExternalToolVariableForm.java;2;0;4;1;0;0;0;4;11;1;4;244;28;28;1;0;0;4;4;244;0;321;4;2;
/org.eclipse.ui.cheatsheets/src/org/eclipse/ui/cheatsheets/AbstractItemExtensionElement.java;2;0;7;2;0;0;0;7;112;2;5;4625;187;187;2;2;0;7;7;4625;2;5094;5;2;
/org.eclipse.swt/Eclipse SWT PI/win32/org/eclipse/swt/internal/win32/LOGFONTW.java;1;0;1;1;0;0;0;1;0;0;1;957;0;0;1;0;0;1;1;957;0;957;1;1;
/org.eclipse.jdt.ui/ui/org/eclipse/jdt/internal/ui/javaeditor/ChainedPreferenceStore.java;1;1;2;1;2;2;2;0;0;0;0;5177;0;0;1;0;0;0;2;5177;0;5272;2;1;
/org.eclipse.jdt.ui.tests.refactoring/resources/UseSupertypeWherePossible/testNew38/out/A.java;1;0;1;1;0;0;0;1;0;0;1;1315;0;0;1;0;0;1;1;1315;0;1315;1;1;
/org.eclipse.jdt.text.tests/src/org/eclipse/jdt/text/tests/comments/JavaDocTestCase.java;1;1;2;1;2;2;2;0;6;0;0;5129;6;6;1;0;0;0;2;5129;0;6340;2;1;
/org.eclipse.pde.ui/src/org/eclipse/pde/internal/ui/wizards/tools/ConvertedProjectsPage.java;2;1;5;1;3;3;3;2;28;1;2;3840;46;46;1;0;0;2;5;3840;0;6336;5;2;
/org.eclipse.ui.workbench/Eclipse UI/org/eclipse/ui/internal/DetachedPlaceHolder.java;4;0;4;2;1;1;1;3;203;2;2;4015;215;215;2;1;0;3;4;4015;1;6338;3;4;
/org.eclipse.core.runtime/src/org/eclipse/core/runtime/SubProgressMonitor.java;3;1;7;1;2;2;2;5;338;1;5;1369;692;692;1;0;0;5;7;1369;0;6340;7;3;
/org.eclipse.jdt.core.tests.model/workspace/Converter/src/javadoc/test107/TestB2.java;1;0;1;1;0;0;0;1;0;0;1;4390;0;0;1;0;0;1;1;4390;0;4390;1;1;
/org.eclipse.ui.console/src/org/eclipse/ui/console/MessageConsoleStream.java;2;0;4;1;0;0;0;4;9;1;4;1990;16;16;1;0;0;4;4;1990;0;3569;4;2;
/org.eclipse.swt.examples/src/org/eclipse/swt/examples/controlexample/Tab.java;2;1;12;1;3;3;3;9;287;3;6;1560;725;725;3;3;0;9;12;2767;3;6352;9;2;
/org.eclipse.pde.ui/src/org/eclipse/pde/internal/ui/editor/feature/InfoFormPage.java;2;2;5;1;4;3;4;1;71;0;1;4203;83;83;2;0;1;1;5;5431;1;6336;4;2;
/org.eclipse.core.runtime/src/org/eclipse/core/internal/runtime/AuthorizationDatabase.java;3;1;8;1;5;5;5;3;672;1;3;3013;1372;1372;1;0;0;3;8;3013;0;6340;8;3;
/org.eclipse.jdt.ui/ui/org/eclipse/jdt/ui/text/spelling/engine/RankedWordProposal.java;1;0;2;1;0;0;0;2;0;1;2;3829;0;0;1;0;0;2;2;3829;0;3930;2;1;
/org.eclipse.ui.tests/Eclipse UI Tests/org/eclipse/ui/tests/popups/ObjectContributionTest.java;2;1;3;1;3;3;3;0;2;0;0;5225;2;2;1;0;0;0;3;5225;0;5535;3;2;
/org.eclipse.jdt.launching/launching/org/eclipse/jdt/launching/sourcelookup/containers/JavaSourcePathComputer.java;1;0;1;1;0;0;0;1;0;0;1;5091;0;0;1;0;0;1;1;5091;0;5091;1;1;
/org.eclipse.debug.core/core/org/eclipse/debug/core/ILogicalStructureType.java;3;0;3;1;1;1;1;2;4;1;2;2663;6;6;1;0;0;2;3;2663;0;6336;3;3;
/org.eclipse.jdt.core/compiler/org/eclipse/jdt/internal/compiler/flow/UnconditionalFlowInfo.java;3;0;7;1;1;1;1;6;17;2;5;25;50;50;2;1;0;6;7;25;1;5587;6;3;
/org.eclipse.swt/Eclipse SWT/emulated/trayicon/org/eclipse/swt/widgets/Tray.java;2;0;2;2;0;0;0;2;0;0;1;4519;0;0;2;1;0;2;2;4519;1;4519;1;2;
/org.eclipse.ui.examples.javaeditor/Eclipse Java Editor Example/org/eclipse/ui/examples/javaeditor/PresentationAction.java;1;0;1;1;1;1;1;0;2;0;0;6340;2;2;1;0;0;0;1;6340;0;6340;1;1;
/org.eclipse.jdt.ui/ui/org/eclipse/jdt/internal/ui/callhierarchy/HistoryListAction.java;3;0;5;1;1;1;1;4;24;1;4;217;31;31;1;0;0;4;5;217;0;6340;5;3;
/org.eclipse.jdt.ui/core refactoring/org/eclipse/jdt/internal/corext/refactoring/rename/RenameCompilationUnitRefactoring.java;2;0;3;1;0;0;0;3;64;1;3;122;84;84;1;0;0;3;3;122;0;1125;3;2;
/org.eclipse.jdt.ui/core extension/org/eclipse/jdt/internal/corext/util/IFileTypeInfo.java;2;0;4;1;1;1;1;3;21;1;3;2836;38;38;1;0;0;3;4;2836;0;6340;4;2;
/org.eclipse.jdt.core.tests.model/workspace/Formatter/test347/A_in.java;1;0;1;1;0;0;0;1;0;0;1;3029;0;0;1;0;0;1;1;3029;0;3029;1;1;
/org.eclipse.team.cvs.ui/src/org/eclipse/team/internal/ccvs/ui/wizards/RepositorySelectionPage.java;2;1;6;1;2;2;2;4;23;1;4;1958;47;47;1;0;0;4;6;1958;0;6337;6;2;
/org.eclipse.debug.ui/ui/org/eclipse/debug/internal/ui/sourcelookup/RestoreDefaultAction.java;2;0;6;1;1;1;1;5;15;1;5;3770;50;50;1;0;0;5;6;3770;0;5790;6;2;
/org.eclipse.jdt.ui.tests.refactoring/resources/ExtractMethodWorkSpace/ExtractMethodTests/semicolon_in/A_test402.java;1;0;1;1;0;0;0;1;4;0;1;844;4;4;1;0;0;1;1;844;0;844;1;1;
/org.eclipse.jdt.ui.tests.refactoring/resources/ChangeTypeRefactoring/negative/A_testArray_in.java;1;0;1;1;0;0;0;1;0;0;1;2844;0;0;1;0;0;1;1;2844;0;2844;1;1;
/org.eclipse.swt/Eclipse SWT Mozilla/common/org/eclipse/swt/internal/mozilla/nsIInputStreamChannel.java;1;0;1;1;0;0;0;1;0;0;1;2663;0;0;1;0;0;1;1;2663;0;2663;1;1;
/org.eclipse.jdt.core/compiler/org/eclipse/jdt/internal/compiler/ast/DefaultCaseStatement.java;1;0;2;1;0;0;0;2;2;1;2;148;2;2;1;0;0;2;2;148;0;157;2;1;
/org.eclipse.pde.ui/src_Forms/org/eclipse/pde/internal/ui/neweditor/plugin/RequiresSection.java;2;2;17;1;4;3;4;13;195;2;12;4265;438;438;2;1;1;13;17;4570;2;5431;15;2;
/org.eclipse.ui.ide/src/org/eclipse/ui/internal/ide/dialogs/CreateProjectStep.java;1;0;1;1;0;0;0;1;0;0;1;2264;0;0;1;0;0;1;1;2264;0;2264;1;1;
/org.eclipse.sdk.tests-feature/plugins/org.eclipse.perfmsr.ui/src/org/eclipse/perfmsr/ui/EarlyStartup.java;1;2;3;1;3;2;3;0;12;0;0;6323;12;12;2;0;1;0;3;6342;1;6342;2;1;
/org.eclipse.ui.workbench/Eclipse UI/org/eclipse/ui/internal/commands/util/old/SequenceUtil.java;1;0;2;1;0;0;0;2;0;0;1;1321;0;0;2;1;0;2;2;1321;1;1321;1;1;
/org.eclipse.jdt.core.tests.model/workspace/Formatter/test389/A_out.java;1;0;1;1;0;0;0;1;0;0;1;3172;0;0;1;0;0;1;1;3172;0;3172;1;1;
/org.eclipse.pde.core/src/org/eclipse/pde/internal/core/plugin/AttributeChangedEvent.java;3;1;4;1;2;2;2;2;4;1;2;4203;12;12;1;0;0;2;4;4203;0;6336;4;3;
/org.eclipse.ant.ui/Ant Editor/org/eclipse/ant/internal/ui/dtd/schema/SchemaFactory.java;1;0;2;1;0;0;0;2;6;1;2;1811;6;6;1;0;0;2;2;1811;0;2331;2;1;
/org.eclipse.jdt.ui.tests.refactoring/resources/ChangeTypeRefactoring/positive/A_testFieldWithAccess_in.java;1;0;1;1;0;0;0;1;0;0;1;2844;0;0;1;0;0;1;1;2844;0;2844;1;1;
/org.eclipse.jdt.ui.tests.refactoring/resources/ExtractMethodWorkSpace/ExtractMethodTests/nested_in/A_test652.java;1;0;1;1;0;0;0;1;2;0;1;844;2;2;1;0;0;1;1;844;0;844;1;1;
/org.eclipse.swt/Eclipse SWT PI/gtk/org/eclipse/swt/internal/gtk/XFocusChangeEvent.java;2;1;2;1;2;2;2;0;4;0;0;6245;4;4;1;0;0;0;2;6245;0;6352;2;2;
/org.eclipse.ui.workbench/Eclipse UI/org/eclipse/ui/internal/roles/RoleContentProvider.java;2;0;5;1;0;0;0;5;11;2;4;1952;22;22;2;1;0;5;5;2443;1;2443;4;2;
/org.eclipse.pde.ui/src_Forms/org/eclipse/pde/internal/ui/neweditor/feature/FeatureMatchSection.java;2;0;3;1;1;1;1;2;43;0;1;4926;43;43;2;1;0;2;3;4926;1;5431;2;2;
/org.eclipse.pde.ui/src/org/eclipse/pde/internal/ui/wizards/exports/FeatureExportWizardPage.java;3;1;8;1;3;3;3;5;44;1;5;1615;128;128;1;0;0;5;8;1615;0;6336;8;3;
/org.eclipse.team.ui/src/org/eclipse/team/internal/ui/sync/UnchangedTeamContainer.java;1;0;1;1;0;0;0;1;0;0;1;4216;0;0;1;0;0;1;1;4216;0;4216;1;1;
/org.eclipse.update/src/org/eclipse/update/internal/ui/UMWizardTreeItem.java;1;0;1;1;1;1;1;0;0;0;0;6339;0;0;1;0;0;0;1;6339;0;6339;1;1;
/org.eclipse.team.ui/src/org/eclipse/team/internal/ui/sync/views/SyncViewerLabelProvider.java;2;0;5;1;0;0;0;5;109;1;5;488;262;262;1;0;0;5;5;488;0;2632;5;2;
/org.eclipse.jdt.ui/ui refactoring/org/eclipse/jdt/internal/ui/refactoring/RefactoringMessages.java;1;0;1;1;1;1;1;0;2;0;0;6340;2;2;1;0;0;0;1;6340;0;6340;1;1;
/org.eclipse.team.ui/src/org/eclipse/team/internal/ui/dialogs/DialogArea.java;2;0;7;1;1;1;1;6;203;2;5;987;260;260;2;1;0;6;7;987;1;6337;6;2;
/org.eclipse.pde.ui/src/org/eclipse/pde/internal/ui/editor/text/IReconcilingParticipant.java;1;1;2;1;2;2;2;0;10;0;0;5431;10;10;1;0;0;0;2;5431;0;6336;2;1;
/org.eclipse.ant.tests.ui/Ant Editor Tests/org/eclipse/ui/externaltools/internal/ant/dtd/test/dumper.java;1;0;2;1;0;0;0;2;12;1;2;283;12;12;1;0;0;2;2;283;0;1274;2;1;
/org.eclipse.jdt.core.tests.model/src/org/eclipse/jdt/core/tests/model/CopyMoveElementsTests.java;2;0;5;1;1;1;1;4;8;1;4;1114;19;19;1;0;0;4;5;1114;0;5397;5;2;
/org.eclipse.jdt.core.tests.model/workspace/Converter/test0428/A.java;1;0;1;1;0;0;0;1;0;0;1;3714;0;0;1;0;0;1;1;3714;0;3714;1;1;
/org.eclipse.jdt.core.tests.compiler/src/org/eclipse/jdt/core/tests/compiler/regression/ClassFileComparatorTest.java;2;0;2;1;0;0;0;2;2;1;2;1417;4;4;1;0;0;2;2;1417;0;3560;2;2;
/org.eclipse.jdt.core/search/org/eclipse/jdt/core/search/SearchMatch.java;2;3;14;1;12;10;12;2;159;1;2;3211;411;411;3;0;2;2;14;5200;2;5912;12;2;
/org.eclipse.ant.ui/Ant Runner Support/org/eclipse/ant/ui/internal/antsupport/logger/NullBuildLogger.java;1;0;2;1;0;0;0;2;0;1;2;250;0;0;1;0;0;2;2;250;0;1811;2;1;
/org.eclipse.ui.workbench.texteditor/src/org/eclipse/ui/texteditor/IAnnotationExtension.java;2;0;2;1;0;0;0;2;2;1;2;1629;2;2;1;0;0;2;2;1629;0;3217;2;2;
/org.eclipse.ui.ide/src/org/eclipse/ui/views/navigator/ResourceSelectionUtil.java;1;0;1;1;0;0;0;1;0;0;1;2208;0;0;1;0;0;1;1;2208;0;2208;1;1;
/org.eclipse.update.ui/srcnew/org/eclipse/update/internal/ui/wizards/NewSiteBookmarkWizardPage2.java;2;0;2;1;0;0;0;2;0;1;2;367;0;0;1;0;0;2;2;367;0;478;2;2;
/org.eclipse.update.ui.forms/Eclipse Forms/org/eclipse/ui/forms/widgets/ColumnLayout.java;1;0;9;1;0;0;0;9;178;2;7;3661;345;345;2;2;0;9;9;3681;2;4157;7;1;
/org.eclipse.core.tools.resources/src/org/eclipse/core/tools/metadata/PropertiesDumper.java;1;0;1;1;1;1;1;0;0;0;0;6302;0;0;1;0;0;0;1;6302;0;6302;1;1;
/org.eclipse.jdt.ui.tests.refactoring/resources/IntroduceFactory/Bugzilla/46189/TestClass_out.java;1;0;2;1;1;1;1;1;2;0;1;2846;2;2;1;0;0;1;2;2846;0;5659;2;1;
/org.eclipse.tomcat/src/org/eclipse/tomcat/internal/SocketUtil.java;1;1;3;1;2;2;2;1;77;0;1;379;83;83;1;0;0;1;3;379;0;6337;3;1;
/org.eclipse.core.tests.resources/src/org/eclipse/core/tests/internal/indexing/TestObject.java;1;0;1;1;1;1;1;0;11;0;0;5147;11;11;1;0;0;0;1;5147;0;5147;1;1;
/org.eclipse.debug.ui/ui/org/eclipse/debug/internal/ui/actions/StatusDialog.java;2;0;2;1;0;0;0;2;10;1;2;1516;10;10;1;0;0;2;2;1516;0;1539;2;2;
/org.eclipse.jdt.ui/ui/org/eclipse/jdt/internal/ui/search/JavaSearchQuery.java;4;4;26;2;17;10;17;9;174;2;8;3711;577;577;4;1;7;9;26;5396;8;6340;18;4;
/org.eclipse.jdt.debug.ui/ui/org/eclipse/jdt/internal/debug/ui/actions/ArchiveFilter.java;2;0;3;1;0;0;0;3;10;2;2;1191;14;14;2;1;0;3;3;1191;1;1499;2;2;
/org.eclipse.ltk.ui.refactoring/src/org/eclipse/ltk/internal/ui/refactoring/FinishResult.java;1;0;1;1;1;1;1;0;0;0;0;5230;0;0;1;0;0;0;1;5230;0;5230;1;1;
/org.eclipse.core.tools/src/org/eclipse/core/tools/CopyTextSelectionAction.java;1;0;1;1;1;1;1;0;0;0;0;6302;0;0;1;0;0;0;1;6302;0;6302;1;1;
/org.eclipse.jdt.core/compiler/org/eclipse/jdt/internal/compiler/ast/AnnotationArrayQualifiedTypeReference.java;1;0;3;1;0;0;0;3;4;1;3;2397;4;4;1;0;0;3;3;2397;0;2887;3;1;
/org.eclipse.core.runtime/src/org/eclipse/core/internal/dependencies/Dependency.java;2;0;2;1;0;0;0;2;0;1;2;2105;0;0;1;0;0;2;2;2105;0;3013;2;2;
/org.eclipse.jdt.ui/core refactoring/org/eclipse/jdt/internal/corext/refactoring/rename/RenameAnalyzeUtil.java;4;1;20;1;7;7;7;13;165;2;11;882;323;323;2;2;0;13;20;1952;2;6340;18;4;
/org.eclipse.ui.workbench/Eclipse UI/org/eclipse/ui/internal/themes/CascadingColorRegistry.java;1;0;2;1;0;0;0;2;11;1;2;4392;11;11;1;0;0;2;2;4392;0;4802;2;1;
/org.eclipse.jdt.core.tests.model/workspace/JavaSearch/src/j4/TT47209.java;1;0;1;1;0;0;0;1;0;0;1;3330;0;0;1;0;0;1;1;3330;0;3330;1;1;
/org.eclipse.ui.workbench/Eclipse UI/org/eclipse/ui/commands/GestureStroke.java;1;0;3;1;0;0;0;3;75;2;2;1321;75;75;2;1;0;3;3;1339;1;1339;2;1;
/org.eclipse.ui.examples.job/org/eclipse/ui/examples/jobs/UITestJob.java;1;0;2;1;2;1;2;0;0;0;0;5125;0;0;2;0;1;0;2;5125;1;5125;1;1;
/org.eclipse.update.core/src/org/eclipse/update/core/model/ContentEntryModel.java;1;1;3;1;3;3;3;0;8;0;0;5388;18;18;1;0;0;0;3;5388;0;6336;3;1;
/org.eclipse.update.ui/src/org/eclipse/update/internal/ui/security/UpdateManagerAuthenticator.java;3;2;8;1;4;3;4;4;264;1;4;890;314;314;2;0;1;4;8;5561;1;6336;7;3;
/org.eclipse.jdt.ui/ui/org/eclipse/jdt/internal/ui/search/SortAction.java;1;0;3;1;1;1;1;2;7;1;2;3711;9;9;1;0;0;2;3;3711;0;5438;3;1;
/org.eclipse.update.ui.forms/Eclipse Forms/org/eclipse/ui/forms/internal/parts/ParagraphSegment.java;1;0;2;1;0;0;0;2;0;1;2;3096;0;0;1;0;0;2;2;3096;0;3138;2;1;
/org.eclipse.core.runtime.osgi/src/org/eclipse/core/internal/jobs/Semaphore.java;1;0;1;1;0;0;0;1;0;0;1;3013;0;0;1;0;0;1;1;3013;0;3013;1;1;
/org.eclipse.ui.workbench/Eclipse UI/org/eclipse/ui/internal/progress/ProgressTreeContentProvider.java;2;1;4;1;2;2;2;2;100;1;2;3560;117;117;1;0;0;2;4;3560;0;5916;4;2;
/org.eclipse.jdt.ui/ui/org/eclipse/jdt/internal/ui/preferences/PreferenceMessages.java;2;0;2;1;1;1;1;1;0;0;1;5075;0;0;1;0;0;1;2;5075;0;5481;2;2;
/org.eclipse.core.tests.runtime/src/org/eclipse/core/tests/internal/plugins/PluginResolveTest_5.java;1;0;1;1;0;0;0;1;0;0;1;3014;0;0;1;0;0;1;1;3014;0;3014;1;1;
/org.eclipse.jdt.core.tests.model/workspace/Converter/src/test0526/A.java;1;0;1;1;0;0;0;1;0;0;1;3714;0;0;1;0;0;1;1;3714;0;3714;1;1;
/org.eclipse.ui.workbench/Eclipse UI/org/eclipse/ui/commands/internal/CaptureListener.java;1;0;2;1;0;0;0;2;0;1;2;786;0;0;1;0;0;2;2;786;0;956;2;1;
/org.eclipse.jdt.ui.tests.refactoring/resources/IntroduceFactory/positive/MultiUnit1C_FFF_out.java;1;0;2;1;1;1;1;1;2;0;1;2862;2;2;1;0;0;1;2;2862;0;5659;2;1;
/org.eclipse.ui.externaltools/Ant Tools Support/org/eclipse/ui/externaltools/internal/ant/preferences/MinimizedFileSystemElement.java;1;0;1;1;0;0;0;1;0;0;1;282;0;0;1;0;0;1;1;282;0;282;1;1;
/org.eclipse.update.ui/src/org/eclipse/update/internal/ui/security/JarVerificationService.java;3;1;6;1;2;2;2;4;29;1;4;778;48;48;1;0;0;4;6;778;0;6336;6;3;
/org.eclipse.ui.workbench/Eclipse UI/org/eclipse/ui/internal/ActionExpression.java;3;1;5;1;2;2;2;3;136;1;3;2737;173;173;1;0;0;3;5;2737;0;6338;5;3;
/org.eclipse.jdt.core.tests.model/workspace/Formatter/test166/A_in.java;1;0;1;1;0;0;0;1;0;0;1;2425;0;0;1;0;0;1;1;2425;0;2425;1;1;
/org.eclipse.swt.tests/JUnit Tests/org/eclipse/swt/tests/junit/Test_org_eclipse_swt_custom_VerifyKeyListener.java;1;0;1;1;0;0;0;1;19;0;1;2104;19;19;1;0;0;1;1;2104;0;2104;1;1;
/org.eclipse.ui.ide/src/org/eclipse/ui/dialogs/WizardExportResourcesPage.java;2;0;5;1;0;0;0;5;15;1;5;1511;29;29;1;0;0;5;5;1511;0;2263;5;2;
/org.eclipse.ui.intro/src/org/eclipse/ui/internal/intro/impl/model/AbstractTextElement.java;1;1;5;1;5;5;5;0;17;0;0;5115;37;37;1;0;0;0;5;5115;0;6251;5;1;
/org.eclipse.ui.ide/src/org/eclipse/ui/internal/ide/dialogs/ProjectCapabilitySimpleSelectionPage.java;1;0;1;1;0;0;0;1;0;0;1;2264;0;0;1;0;0;1;1;2264;0;2264;1;1;
/org.eclipse.team.ui/src/org/eclipse/team/internal/ui/synchronize/views/ITreeViewerAccessor.java;1;0;1;1;0;0;0;1;0;0;1;3796;0;0;1;0;0;1;1;3796;0;3796;1;1;
/org.eclipse.swt/Eclipse SWT PI/win32/org/eclipse/swt/internal/ole/win32/DVTARGETDEVICE.java;1;0;1;1;0;0;0;1;4;0;1;2915;4;4;1;0;0;1;1;2915;0;2915;1;1;
/org.eclipse.update.ui/src/org/eclipse/update/internal/ui/forms/SearchForm.java;1;0;1;1;0;0;0;1;0;0;1;755;0;0;1;0;0;1;1;755;0;755;1;1;
/org.eclipse.debug.ui/ui/org/eclipse/debug/internal/ui/preferences/DebugActionGroupsActionContentProvider.java;1;0;1;1;0;0;0;1;0;0;1;5086;0;0;1;0;0;1;1;5086;0;5086;1;1;
/org.eclipse.jdt.ui/ui/org/eclipse/jdt/internal/ui/text/javadoc/IJavaDocTagConstants.java;3;0;5;1;1;1;1;4;6;1;4;3829;15;15;1;0;0;4;5;3829;0;6340;5;3;
/org.eclipse.ui.workbench/Eclipse UI/org/eclipse/ui/internal/csm/roles/IRoleRegistry.java;1;0;5;1;0;0;0;5;32;2;4;2225;34;34;2;1;0;5;5;2370;1;2444;4;1;
/org.eclipse.core.runtime/src/org/eclipse/core/internal/jobs/JobListeners.java;3;2;20;1;7;6;7;13;292;2;12;629;1062;1062;2;1;1;13;20;885;2;5738;18;3;
/org.eclipse.update.ui/src/org/eclipse/update/internal/ui/security/UserValidationDialog.java;4;1;6;1;2;2;2;4;129;1;4;890;157;157;1;0;0;4;6;890;0;6336;6;4;
/org.eclipse.update.core/src/org/eclipse/update/internal/api/operations/IFeatureOperation.java;1;0;3;1;0;0;0;3;10;1;3;3270;10;10;1;0;0;3;3;3270;0;4928;3;1;
/org.eclipse.team.webdav/src/org/eclipse/team/ui/subscriber/TeamBlockingRunnableContext.java;1;0;1;1;0;0;0;1;0;0;1;3373;0;0;1;0;0;1;1;3373;0;3373;1;1;
/org.eclipse.core.runtime/src/org/eclipse/core/internal/plugins/ExtensionResolver.java;2;0;2;1;0;0;0;2;0;1;2;2105;0;0;1;0;0;2;2;2105;0;3013;2;2;
/org.eclipse.ui.workbench/Eclipse UI/org/eclipse/ui/internal/commands/XNotActiveException.java;1;0;2;1;0;0;0;2;0;1;2;1695;0;0;1;0;0;2;2;1695;0;1724;2;1;
/org.eclipse.jdt.ui/core refactoring/org/eclipse/ltk/core/refactoring/participants/ValidateEditChecker.java;1;0;3;1;0;0;0;3;11;1;3;4654;11;11;1;0;0;3;3;4654;0;4864;3;1;
/org.eclipse.pde.build/src/org/eclipse/pde/internal/build/site/QualifierReplacer.java;1;2;6;1;6;4;6;0;13;0;0;5536;36;36;2;0;2;0;6;5785;2;5817;4;1;
/org.eclipse.core.tools.resources/src/org/eclipse/core/tools/metadata/MarkersSnapshotDumper.java;1;0;1;1;1;1;1;0;0;0;0;6302;0;0;1;0;0;0;1;6302;0;6302;1;1;
/org.eclipse.jdt.core.tests.model/workspace/Converter/src/test0053/Test.java;1;0;1;1;0;0;0;1;0;0;1;3714;0;0;1;0;0;1;1;3714;0;3714;1;1;
/org.eclipse.pde.ui/src/org/eclipse/pde/internal/ui/editor/feature/SynchronizeVersionsWizardPage.java;3;1;7;1;3;3;3;4;27;1;4;2229;64;64;1;0;0;4;7;2229;0;6336;7;3;
/org.eclipse.jdt.ui.tests.refactoring/resources/ExtractMethodWorkSpace/ExtractMethodTests/semicolon_out/A_test400.java;1;0;2;1;0;0;0;2;4;1;2;130;5;5;1;0;0;2;2;130;0;844;2;1;
/org.eclipse.ui.workbench/Eclipse UI/org/eclipse/ui/internal/commands/api/older/ICommandManager.java;1;0;2;1;0;0;0;2;0;0;1;2562;0;0;2;1;0;2;2;2562;1;2562;1;1;
/org.eclipse.jdt.core.tests.model/workspace/JavaSearch/src/j1/AnnSearched.java;1;0;2;1;0;0;0;2;0;1;2;2661;0;0;1;0;0;2;2;2661;0;3081;2;1;
/org.eclipse.jdt.ui/core refactoring/org/eclipse/jdt/internal/corext/refactoring/participants/PropertyExpression.java;1;0;3;1;0;0;0;3;2;1;3;591;2;2;1;0;0;3;3;591;0;1033;3;1;
/org.eclipse.swt/Eclipse SWT/gtk/org/eclipse/swt/widgets/Composite.java;7;1;32;2;8;8;8;24;84;3;22;269;454;454;3;2;0;24;32;4128;2;6352;30;7;
/org.eclipse.debug.core/core/org/eclipse/debug/internal/core/stringsubstitution/IStringVariableResolver.java;1;0;2;1;0;0;0;2;0;1;2;1118;0;0;1;0;0;2;2;1118;0;2032;2;1;
/org.eclipse.search/search/org/eclipse/search/internal/ui/text/FilePresentationFactory.java;1;0;3;1;0;0;0;3;40;1;3;3458;40;40;1;0;0;3;3;3458;0;3711;3;1;
/org.eclipse.jdt.ui/ui/org/eclipse/jdt/internal/ui/MarkerAdapterFactory.java;1;0;1;1;1;1;1;0;2;0;0;6340;2;2;1;0;0;0;1;6340;0;6340;1;1;
/org.eclipse.ui.views/src/org/eclipse/ui/views/internal/markers/MarkerRegistry.java;1;0;5;1;0;0;0;5;262;2;3;265;268;268;2;2;0;5;5;265;2;749;3;1;
/org.eclipse.ui.workbench/Eclipse UI/org/eclipse/ui/commands/internal/AbstractRegistry.java;1;0;2;1;0;0;0;2;0;1;2;786;0;0;1;0;0;2;2;786;0;956;2;1;
/org.eclipse.swt.opengl/common/org/eclipse/swt/opengl/GL.java;1;0;1;1;0;0;0;1;0;0;1;1175;0;0;1;0;0;1;1;1175;0;1175;1;1;
/org.eclipse.update.core/srcnew/org/eclipse/update/internal/operations/UpdateManager.java;2;0;12;2;0;0;0;12;78;2;11;367;152;152;2;1;0;12;12;617;1;757;11;2;
/org.eclipse.core.resources/src/org/eclipse/core/internal/resources/InternalWorkspaceJob.java;2;0;8;1;1;1;1;7;55;1;7;1133;87;87;1;0;0;7;8;1133;0;5146;8;2;
/org.eclipse.jdt.ui.tests.refactoring/resources/IntroduceFactory/positive/MultipleCallers_in.java;1;0;2;1;1;1;1;1;2;0;1;2862;2;2;1;0;0;1;2;2862;0;5659;2;1;
/org.eclipse.jdt.ui.tests.refactoring/resources/Delete/testDeleteWithinCu22/in/A.java;1;0;1;1;0;0;0;1;0;0;1;4913;0;0;1;0;0;1;1;4913;0;4913;1;1;
/org.eclipse.core.tests.resources/src/org/eclipse/core/tests/resources/IFolderTest.java;2;0;3;1;1;1;1;2;618;1;2;1436;632;632;1;0;0;2;3;1436;0;5147;3;2;
/org.eclipse.jdt.ui/ui/org/eclipse/jdt/internal/ui/typehierarchy/TraditionalHierarchyViewer.java;3;1;7;2;3;3;3;4;79;1;4;505;191;191;1;0;0;4;7;505;0;6340;7;3;
/org.eclipse.ui.workbench/Eclipse UI/org/eclipse/ui/internal/commands/StatusLineContributionItem.java;1;0;4;1;0;0;0;4;0;1;4;956;0;0;1;0;0;4;4;956;0;1722;4;1;
/org.eclipse.update.ui.forms/Eclipse Forms/org/eclipse/ui/forms/IPartSelectionListener.java;1;0;3;1;0;0;0;3;20;2;2;3174;20;20;2;1;0;3;3;3174;1;4157;2;1;
/org.eclipse.swt/Eclipse SWT OLE Win32/win32/org/eclipse/swt/ole/win32/OleControlSite.java;1;0;1;1;0;0;0;1;12;0;1;2649;12;12;1;0;0;1;1;2649;0;2649;1;1;
/org.eclipse.ui.workbench/Eclipse UI/org/eclipse/ui/internal/csm/roles/api/IActivityBindingDefinition.java;1;0;2;1;0;0;0;2;0;1;2;2213;0;0;1;0;0;2;2;2213;0;2225;2;1;
/org.eclipse.swt.tests/JUnit Tests/org/eclipse/swt/tests/junit/Test_org_eclipse_swt_layout_GridLayout.java;2;0;2;1;0;0;0;2;19;1;2;2144;26;26;1;0;0;2;2;2144;0;2176;2;2;
/org.eclipse.help.webapp/src_servlets/org/eclipse/help/internal/webapp/servlet/TocServlet.java;2;1;7;1;3;3;3;4;81;1;4;1313;159;159;1;0;0;4;7;1313;0;6337;7;2;
/org.eclipse.team.ui/src/org/eclipse/team/internal/ui/wizards/ExportProjectSetMainPage.java;1;1;5;1;2;2;2;3;200;2;2;987;205;205;2;1;0;3;5;987;1;6337;4;1;
/org.eclipse.jdt.ui/ui/org/eclipse/jdt/internal/ui/callhierarchy/CallHierarchyFiltersActionGroup.java;2;0;5;1;1;1;1;4;5;1;4;169;12;12;1;0;0;4;5;169;0;6340;5;2;
/org.eclipse.ui.workbench/Eclipse UI/org/eclipse/ui/internal/BundleGroupProperties.java;1;1;3;1;3;3;3;0;148;0;0;5485;156;156;1;0;0;0;3;5485;0;6102;3;1;
/org.eclipse.swt.tests/JUnit Tests/org/eclipse/swt/tests/junit/Test_org_eclipse_swt_ole_win32_OleEvent.java;1;0;1;1;0;0;0;1;0;0;1;2176;0;0;1;0;0;1;1;2176;0;2176;1;1;
/org.eclipse.jdt.ui.tests.refactoring/resources/ExtractMethodWorkSpace/ExtractMethodTests/nested_in/A_test651.java;1;0;1;1;0;0;0;1;2;0;1;844;2;2;1;0;0;1;1;844;0;844;1;1;
/org.eclipse.ui.tests/Eclipse JFace Tests/org/eclipse/jface/tests/viewers/CheckboxTreeViewerTest.java;1;0;1;1;0;0;0;1;2;0;1;2754;2;2;1;0;0;1;1;2754;0;2754;1;1;
/org.eclipse.jdt.core/compiler/org/eclipse/jdt/internal/compiler/env/IDependent.java;1;0;1;1;0;0;0;1;2;0;1;3560;2;2;1;0;0;1;1;3560;0;3560;1;1;
/org.eclipse.jdt.debug.tests/tests/org/eclipse/jdt/debug/tests/eval/NestedTypeFieldValue_690.java;1;0;1;1;0;0;0;1;60;0;1;1274;60;60;1;0;0;1;1;1274;0;1274;1;1;
/org.eclipse.team.cvs.ui/src/org/eclipse/team/internal/ccvs/ui/model/DeferredElementCollector.java;1;0;1;1;0;0;0;1;0;0;1;961;0;0;1;0;0;1;1;961;0;961;1;1;
/org.eclipse.ui.ide/src/org/eclipse/ui/internal/ide/dialogs/CreateProjectWizard.java;1;0;1;1;0;0;0;1;0;0;1;2264;0;0;1;0;0;1;1;2264;0;2264;1;1;
/org.eclipse.jdt.core.tests.model/workspace/Converter/junit/swingui/TestHierarchyRunView.java;1;0;2;1;0;0;0;2;7;1;2;787;7;7;1;0;0;2;2;787;0;3714;2;1;
/org.eclipse.swt.opengl.examples/src/org/eclipse/swt/opengl/examples/OutlineTextTab.java;1;0;1;1;0;0;0;1;0;0;1;1175;0;0;1;0;0;1;1;1175;0;1175;1;1;
/org.eclipse.pde.ui/src/org/eclipse/pde/internal/ui/feature/SiteData.java;1;0;1;1;0;0;0;1;0;0;1;3840;0;0;1;0;0;1;1;3840;0;3840;1;1;
/org.eclipse.ui.examples.rcp.browser/src/org/eclipse/ui/examples/rcp/browser/BrowserView.java;1;1;6;1;2;2;2;4;36;1;4;3532;54;54;1;0;0;4;6;3532;0;6341;6;1;
/org.eclipse.jdt.core/model/org/eclipse/jdt/core/IOpenable.java;3;0;5;1;0;0;0;5;8;1;5;2583;18;18;1;0;0;5;5;2583;0;5093;5;3;
/org.eclipse.jdt.ui/ui/org/eclipse/jdt/internal/ui/text/correction/AbstractMethodCompletionProposal.java;2;1;3;1;3;3;3;0;39;0;0;5530;41;41;1;0;0;0;3;5530;0;6340;3;2;
/org.eclipse.ui.workbench/Eclipse UI/org/eclipse/ui/internal/contexts/AbstractMutableRegistry.java;1;0;3;1;0;0;0;3;6;1;3;1356;6;6;1;0;0;3;3;1356;0;1396;3;1;
/org.eclipse.jdt.core.tests.model/workspace/Converter/src/test0545/Test.java;1;0;1;1;1;1;1;0;0;0;0;5313;0;0;1;0;0;0;1;5313;0;5313;1;1;
/org.eclipse.update.ui.forms/Eclipse Forms/org/eclipse/ui/forms/parts/RichText.java;1;0;5;1;0;0;0;5;5;3;3;3096;7;7;3;2;0;5;5;3133;2;3133;3;1;
/org.eclipse.swt.tests/JUnit Tests/org/eclipse/swt/tests/junit/Test_org_eclipse_swt_browser_VisibilityListener.java;1;0;3;1;0;0;0;3;16;2;2;2862;16;16;2;1;0;3;3;2862;1;3166;2;1;
/org.eclipse.core.expressions/src/org/eclipse/core/internal/expressions/StandardElementHandler.java;1;0;3;1;1;1;1;2;8;1;2;4108;10;10;1;0;0;2;3;4108;0;6340;3;1;
/org.eclipse.debug.ui/ui/org/eclipse/debug/ui/console/IConsoleLineTrackerExtension.java;2;0;2;1;0;0;0;2;2;1;2;2149;2;2;1;0;0;2;2;2149;0;2224;2;2;
/org.eclipse.jdt.ui.tests.refactoring/resources/InlineConstant/canInline/test14/out/GrueziWohl.java;1;0;1;1;0;0;0;1;2;0;1;1446;2;2;1;0;0;1;1;1446;0;1446;1;1;
/org.eclipse.ui.views/src/org/eclipse/ui/views/navigator/GotoResourceDialog.java;1;0;1;1;0;0;0;1;0;0;1;2738;0;0;1;0;0;1;1;2738;0;2738;1;1;
/org.eclipse.ui.workbench.texteditor/src/org/eclipse/ui/texteditor/quickdiff/IQuickDiffProviderImplementation.java;2;0;2;1;1;1;1;1;0;0;1;1644;0;0;1;0;0;1;2;1644;0;5181;2;2;
/org.eclipse.ui.workbench/Eclipse UI/org/eclipse/ui/internal/progress/ProgressService.java;1;0;1;1;0;0;0;1;0;0;1;320;0;0;1;0;0;1;1;320;0;320;1;1;
/org.eclipse.debug.ui/ui/org/eclipse/debug/internal/ui/actions/SkipAllBreakpointsAction.java;3;0;4;2;0;0;0;4;62;2;3;4235;76;76;2;1;0;4;4;4452;1;4870;3;3;
/org.eclipse.jdt.ui/ui/org/eclipse/jdt/internal/ui/wizards/buildpaths/UserLibraryWizardPage.java;1;1;5;1;4;4;4;1;60;0;1;4407;89;89;1;0;0;1;5;4407;0;6138;5;1;
/org.eclipse.osgi/resolver/src/org/eclipse/core/internal/dependencies/IElementSetVisitor.java;3;1;3;1;2;2;2;1;9;0;1;3013;16;16;1;0;0;1;3;3013;0;5226;3;3;
/org.eclipse.team.cvs.ui/src/org/eclipse/team/internal/ccvs/ui/subscriber/CVSMergeSynchronizeParticipant.java;1;0;1;1;0;0;0;1;0;0;1;2463;0;0;1;0;0;1;1;2463;0;2463;1;1;
/org.eclipse.jdt.ui/core refactoring/org/eclipse/ltk/core/refactoring/CheckConditionsOperation.java;1;0;3;1;0;0;0;3;22;1;3;4575;22;22;1;0;0;3;3;4575;0;4864;3;1;
/org.eclipse.team.ftp/src/org/eclipse/team/internal/ftp/subscriber/FTPPutOperation.java;2;0;4;1;1;1;1;3;126;1;3;3494;130;130;1;0;0;3;4;3494;0;6337;4;2;
/org.eclipse.ui.workbench/Eclipse UI/org/eclipse/ui/internal/commands/older/CommandManager.java;1;0;4;1;0;0;0;4;101;0;1;2562;101;101;4;3;0;4;4;2562;3;2562;1;1;
/org.eclipse.team.ui/src/org/eclipse/team/internal/ui/sync/views/AndSyncSetFilter.java;1;0;1;1;0;0;0;1;0;0;1;488;0;0;1;0;0;1;1;488;0;488;1;1;
/org.eclipse.jdt.ui.tests.refactoring/resources/ExtractMethodWorkSpace/ExtractMethodTests/semicolon_in/A_test400.java;1;0;1;1;0;0;0;1;2;0;1;844;2;2;1;0;0;1;1;844;0;844;1;1;
/org.eclipse.pde.ui/templates_3.0/editor/java/XMLDoubleClickStrategy.java;1;0;1;1;0;0;0;1;0;0;1;2786;0;0;1;0;0;1;1;2786;0;2786;1;1;
/org.eclipse.team.cvs.core/src/org/eclipse/team/internal/ccvs/core/resources/CVSEntryLineTag.java;2;1;4;1;2;2;2;2;34;1;2;4999;71;71;1;0;0;2;4;4999;0;6337;4;2;
/org.eclipse.jdt.core.tests.model/workspace/Converter/src/test0209/Test.java;1;0;1;1;0;0;0;1;0;0;1;3714;0;0;1;0;0;1;1;3714;0;3714;1;1;
/org.eclipse.ant.ui/Ant Tools Support/org/eclipse/ant/ui/internal/preferences/AddPropertyDialog.java;1;0;3;1;0;0;0;3;2;1;3;250;2;2;1;0;0;3;3;250;0;1811;3;1;
/org.eclipse.ui.tests/Eclipse JFace Tests/org/eclipse/jface/tests/preferences/DeprecatedFontPreferenceTestCase.java;1;0;1;1;0;0;0;1;0;0;1;2754;0;0;1;0;0;1;1;2754;0;2754;1;1;
/org.eclipse.jdt.core.tests.model/workspace/Converter/test0296/Test.java;1;0;1;1;0;0;0;1;0;0;1;3714;0;0;1;0;0;1;1;3714;0;3714;1;1;
/org.eclipse.jdt.core/dom/org/eclipse/jdt/core/dom/MethodRef.java;2;1;9;1;2;2;2;7;109;1;7;3683;158;158;1;0;0;7;9;3683;0;5272;9;2;
/org.eclipse.pde.ui/src/org/eclipse/pde/internal/ui/util/ArraySorter.java;1;0;1;1;0;0;0;1;0;0;1;1962;0;0;1;0;0;1;1;1962;0;1962;1;1;
/org.eclipse.ui.workbench/Eclipse UI/org/eclipse/ui/dialogs/ProjectLocationSelectionDialog.java;1;0;1;1;0;0;0;1;0;0;1;2737;0;0;1;0;0;1;1;2737;0;2737;1;1;
/org.eclipse.team.tests.cvs.core/src/org/eclipse/team/tests/ccvs/ui/logformatter/RootEntry.java;1;0;1;1;0;0;0;1;0;0;1;2632;0;0;1;0;0;1;1;2632;0;2632;1;1;
/org.eclipse.pde.core/src/org/eclipse/pde/internal/core/feature/FeatureURLElement.java;2;1;3;1;2;2;2;1;20;0;1;4203;34;34;1;0;0;1;3;4203;0;6336;3;2;
/org.eclipse.jdt.core/search/org/eclipse/jdt/internal/core/search/indexing/RemoveFolderFromIndex.java;2;0;12;2;1;1;1;11;18;2;8;937;49;49;2;3;0;11;12;3211;3;5659;9;2;
/org.eclipse.ui.workbench/Eclipse UI/org/eclipse/ui/internal/commands/api/older/ICommandEvent.java;1;0;2;1;0;0;0;2;0;0;1;2562;0;0;2;1;0;2;2;2562;1;2562;1;1;
/org.eclipse.help.ui/src/org/eclipse/help/ui/internal/HyperlinkHandler.java;1;1;2;1;2;2;2;0;87;0;0;5827;103;103;1;0;0;0;2;5827;0;6337;2;1;
/org.eclipse.ui.workbench/Eclipse UI/org/eclipse/ui/progress/WorkbenchJob.java;2;1;6;1;3;3;3;3;17;2;2;2984;47;47;2;1;0;3;6;2984;1;6338;5;2;
/org.eclipse.ui.workbench/Eclipse UI/org/eclipse/ui/internal/actions/RoleConfigurationAction.java;2;0;2;1;0;0;0;2;0;1;2;2279;0;0;1;0;0;2;2;2279;0;2443;2;2;
/org.eclipse.core.tests.resources/src/org/eclipse/core/tests/resources/IResourceChangeListenerTest.java;2;3;13;1;7;5;7;6;2018;1;6;2057;3313;3313;3;0;2;6;13;5147;2;5533;11;2;
/org.eclipse.jdt.core/dom/org/eclipse/jdt/core/dom/TypeLiteral.java;4;1;9;1;2;2;2;7;75;1;7;1127;107;107;1;0;0;7;9;1127;0;5272;9;4;
/org.eclipse.jdt.core.tests.model/workspace/Formatter/test444/A_in.java;1;0;1;1;0;0;0;1;0;0;1;3513;0;0;1;0;0;1;1;3513;0;3513;1;1;
/org.eclipse.debug.ui/ui/org/eclipse/debug/internal/ui/actions/RetargetAction.java;1;0;3;1;0;0;0;3;40;1;3;4471;56;56;1;0;0;3;3;4471;0;4650;3;1;
/org.eclipse.jdt.core.tests.model/workspace/Converter/src/test0341/A.java;1;0;1;1;0;0;0;1;0;0;1;3714;0;0;1;0;0;1;1;3714;0;3714;1;1;
/org.eclipse.ui.workbench/Eclipse UI/org/eclipse/ui/progress/IProgressConstants.java;2;2;6;1;6;5;6;0;12;0;0;5464;31;31;2;0;1;0;6;6335;1;6335;5;2;
/org.eclipse.ui.views/src/org/eclipse/ui/views/internal/markers/problems/ProblemView.java;1;0;5;1;0;0;0;5;220;2;4;265;256;256;2;1;0;5;5;265;1;749;4;1;
/org.eclipse.ui.workbench/Eclipse UI/org/eclipse/ui/wizards/datatransfer/WizardZipFileExportPage1.java;1;0;1;1;0;0;0;1;0;0;1;2737;0;0;1;0;0;1;1;2737;0;2737;1;1;
/org.eclipse.team.webdav/src/org/eclipse/team/ui/target/subscriber/ITeamRunnableContext.java;1;0;1;1;0;0;0;1;0;0;1;3379;0;0;1;0;0;1;1;3379;0;3379;1;1;
/org.eclipse.help.ide/src/org/eclipse/help/ui/internal/util/SWTUtil.java;1;0;2;1;0;0;0;2;89;1;2;1738;89;89;1;0;0;2;2;1738;0;1782;2;1;
/org.eclipse.jdt.ui.tests.refactoring/resources/ExtractMethodWorkSpace/ExtractMethodTests/parameterName_in/A_test903.java;1;0;1;1;0;0;0;1;2;0;1;844;2;2;1;0;0;1;1;844;0;844;1;1;
/org.eclipse.debug.core/core/org/eclipse/debug/internal/core/variables/SimpleLaunchVariable.java;2;0;6;1;0;0;0;6;61;2;5;848;150;150;2;1;0;6;6;848;1;2120;5;2;
/org.eclipse.releng.tools/src/org/eclipse/releng/tools/CompareLocalToMap.java;3;1;7;1;7;7;7;0;7;0;0;5183;20;20;1;0;0;0;7;5183;0;6340;7;3;
/org.eclipse.jdt.junit/src/org/eclipse/jdt/internal/junit/ui/ITestRunView.java;1;0;4;1;1;1;1;3;14;1;3;185;25;25;1;0;0;3;4;185;0;5633;4;1;
/org.eclipse.jdt.ui/core extension/org/eclipse/jdt/internal/corext/userlibrary/UserLibraryClasspathContainer.java;1;1;4;1;2;2;2;2;17;1;2;4407;30;30;1;0;0;2;4;4407;0;5226;4;1;
/org.eclipse.ui.ide/src/org/eclipse/ui/INewWizard.java;2;0;2;1;0;0;0;2;0;1;2;1511;0;0;1;0;0;2;2;1511;0;2263;2;2;
/org.eclipse.jdt.ui/ui/org/eclipse/jdt/internal/ui/text/java/ProposalContextInformation.java;1;0;1;1;1;1;1;0;2;0;0;6340;2;2;1;0;0;0;1;6340;0;6340;1;1;
/org.eclipse.pde.ui/src/org/eclipse/pde/internal/ui/search/UnusedDependenciesOperation.java;2;1;4;1;2;2;2;2;24;1;2;2950;42;42;1;0;0;2;4;2950;0;6336;4;2;
/org.eclipse.ui.workbench.texteditor/src/org/eclipse/ui/texteditor/DeleteLineTarget.java;2;1;4;1;4;4;4;0;25;0;0;5110;37;37;1;0;0;0;4;5110;0;6340;4;2;
/org.eclipse.ui.workbench/Eclipse UI/org/eclipse/ui/instrumentation/WorkbenchInstrumentationManager.java;1;0;2;1;0;0;0;2;0;1;2;1634;0;0;1;0;0;2;2;1634;0;1686;2;1;
/org.eclipse.update.ui/srcnew/org/eclipse/update/internal/ui/properties/ConfigurationActivitiesPropertyPage.java;1;0;2;1;0;0;0;2;0;1;2;755;0;0;1;0;0;2;2;755;0;825;2;1;
/org.eclipse.team.cvs.ui/src/org/eclipse/team/internal/ccvs/ui/repo/RefreshTagsAction.java;2;0;2;1;1;1;1;1;44;0;1;5039;46;46;1;0;0;1;2;5039;0;6337;2;2;
/org.eclipse.core.expressions/src/org/eclipse/core/internal/expressions/IterateExpression.java;1;1;3;1;2;2;2;1;10;0;1;4108;12;12;1;0;0;1;3;4108;0;6340;3;1;
/org.eclipse.team.ui/src/org/eclipse/team/internal/ui/target/SiteSelectionPage.java;2;0;2;1;0;0;0;2;2;1;2;2381;2;2;1;0;0;2;2;2381;0;2495;2;2;
/org.eclipse.jdt.ui/ui refactoring/org/eclipse/jdt/internal/ui/refactoring/nls/search/NLSSearchPage.java;5;1;13;1;5;5;5;8;56;1;8;1309;258;258;1;0;0;8;13;1309;0;6340;13;5;
/org.eclipse.jdt.core.tests.model/workspace/Converter/src/javadoc/testBug53276/TestA.java;1;0;1;1;0;0;0;1;0;0;1;4311;0;0;1;0;0;1;1;4311;0;4311;1;1;
/org.eclipse.jdt.core/compiler/org/eclipse/jdt/internal/compiler/ast/JavadocArgumentExpression.java;3;0;6;1;0;0;0;6;20;1;6;2887;33;33;1;0;0;6;6;2887;0;3806;6;3;
/org.eclipse.jdt.ui/core refactoring/org/eclipse/jdt/internal/corext/refactoring/changes/UndoCompilationUnitChange.java;1;0;6;1;1;1;1;5;133;1;5;3646;182;182;1;0;0;5;6;3646;0;5162;6;1;
/org.eclipse.jdt.ui/core extension/org/eclipse/jdt/internal/corext/javadoc/SingleCharReader.java;1;0;1;1;1;1;1;0;2;0;0;6340;2;2;1;0;0;0;1;6340;0;6340;1;1;
/org.eclipse.ui.workbench/Eclipse UI/org/eclipse/ui/internal/roles/RecentActivityManager.java;2;0;3;1;0;0;0;3;254;1;3;2060;254;254;1;0;0;3;3;2060;0;2443;3;2;
/org.eclipse.jdt.core/search/org/eclipse/jdt/internal/core/search/matching/JavaSearchNameEnvironment2.java;1;0;1;1;0;0;0;1;0;0;1;91;0;0;1;0;0;1;1;91;0;91;1;1;
/org.eclipse.jdt.core.tests.model/workspace/Converter/src/test0457/A.java;1;0;1;1;0;0;0;1;0;0;1;3714;0;0;1;0;0;1;1;3714;0;3714;1;1;
/org.eclipse.swt/Eclipse SWT Accessibility/common/org/eclipse/swt/accessibility/AccessibleControlListener.java;1;0;1;1;0;0;0;1;2;0;1;1539;2;2;1;0;0;1;1;1539;0;1539;1;1;
/org.eclipse.core.runtime/src/org/eclipse/core/internal/preferences/DefaultPreferences.java;1;5;16;1;16;11;16;0;93;0;0;5299;261;261;5;0;5;0;16;5309;5;6261;11;1;
/org.eclipse.team.cvs.ui/src/org/eclipse/team/internal/ccvs/ui/wizards/KSubstWizardCommitCommentPage.java;2;1;3;1;2;2;2;1;10;0;1;2381;13;13;1;0;0;1;3;2381;0;6337;3;2;
/org.eclipse.jdt.core/compiler/org/eclipse/jdt/internal/compiler/ast/AnnotationQualifiedTypeReference.java;1;0;3;1;0;0;0;3;4;1;3;2397;4;4;1;0;0;3;3;2397;0;2887;3;1;
/org.eclipse.update.core/src/org/eclipse/update/core/IContentConsumer.java;2;1;4;1;3;3;3;1;6;0;1;890;17;17;1;0;0;1;4;890;0;6336;4;2;
/org.eclipse.core.resources/src/org/eclipse/core/internal/indexing/ObjectStoreException.java;1;0;1;1;1;1;1;0;47;0;0;5146;47;47;1;0;0;0;1;5146;0;5146;1;1;
/org.eclipse.pde.ui/src/org/eclipse/pde/internal/ui/wizards/templates/TemplateSelectionPage.java;3;1;6;1;3;3;3;3;24;1;3;2519;62;62;1;0;0;3;6;2519;0;6336;6;3;
/org.eclipse.jdt.core.tests.model/workspace/Formatter/test015/A_out.java;1;0;1;1;0;0;0;1;0;0;1;2425;0;0;1;0;0;1;1;2425;0;2425;1;1;
/org.eclipse.ui.workbench/Eclipse UI/org/eclipse/ui/internal/commands/old/Point.java;1;0;3;1;0;0;0;3;6;1;3;1322;6;6;1;0;0;3;3;1322;0;1507;3;1;
/org.eclipse.update.core/srcnew/org/eclipse/update/operations/IOperationListener.java;1;0;4;1;0;0;0;4;4;1;4;569;6;6;1;0;0;4;4;569;0;825;4;1;
/org.eclipse.team.ui/src/org/eclipse/team/internal/ui/synchronize/ModelViewController.java;1;0;1;1;0;0;0;1;0;0;1;5061;0;0;1;0;0;1;1;5061;0;5061;1;1;
/org.eclipse.ui.workbench/Eclipse UI/org/eclipse/ui/internal/dialogs/FakePerspectiveActionSet.java;1;0;1;1;0;0;0;1;0;0;1;830;0;0;1;0;0;1;1;830;0;830;1;1;
/org.eclipse.swt/Eclipse SWT/gtk/org/eclipse/swt/graphics/Device.java;6;1;10;2;3;3;3;7;26;2;6;0;69;69;2;1;0;7;10;4128;1;6352;9;6;
/org.eclipse.jdt.ui/ui/org/eclipse/jdt/internal/ui/wizards/dialogfields/ListDialogField.java;4;1;5;1;2;2;2;3;40;1;3;1446;110;110;1;0;0;3;5;1446;0;6340;5;4;
/org.eclipse.ui.workbench/Eclipse UI/org/eclipse/ui/wizards/datatransfer/IDataTransferHelpContextIds.java;1;0;1;1;0;0;0;1;0;0;1;2737;0;0;1;0;0;1;1;2737;0;2737;1;1;
/org.eclipse.core.runtime/src/org/eclipse/core/runtime/model/Factory.java;1;0;1;1;0;0;0;1;0;0;1;3013;0;0;1;0;0;1;1;3013;0;3013;1;1;
/org.eclipse.jdt.core/dom/org/eclipse/jdt/core/dom/ASTVisitor.java;3;0;8;1;1;1;1;7;1915;1;7;1395;2553;2553;1;0;0;7;8;1395;0;5268;8;3;
/org.eclipse.debug.ui/ui/org/eclipse/debug/ui/variables/ResourceNameExpander.java;1;0;4;1;0;0;0;4;37;3;2;316;37;37;3;2;0;4;4;316;2;550;2;1;
/org.eclipse.team.ui/src/org/eclipse/team/ui/synchronize/viewers/IBusyWorkbenchAdapter.java;1;0;1;1;0;0;0;1;0;0;1;4055;0;0;1;0;0;1;1;4055;0;4055;1;1;
/org.eclipse.search/new search/org/eclipse/search2/internal/ui/basic/views/TableViewerNavigator.java;2;1;4;1;4;4;4;0;10;0;0;5106;13;13;1;0;0;0;4;5106;0;6340;4;2;
/org.eclipse.help/src/org/eclipse/help/internal/search/SearchManager.java;1;0;2;1;0;0;0;2;3;1;2;1930;3;3;1;0;0;2;2;1930;0;2732;2;1;
/org.eclipse.swt/Eclipse SWT/carbon/org/eclipse/swt/widgets/ScrollBar.java;5;1;14;1;3;3;3;11;32;1;11;19;147;147;1;0;0;11;14;19;0;6352;14;5;
/org.eclipse.jdt.ui/ui/org/eclipse/jdt/ui/actions/ExtractMethodAction.java;3;0;9;1;1;1;1;8;39;1;8;122;90;90;1;0;0;8;9;122;0;6340;9;3;
/org.eclipse.ui.ide/src/org/eclipse/ui/internal/ide/misc/ResourceAndContainerGroup.java;3;1;3;1;2;2;2;1;22;0;1;2264;26;26;1;0;0;1;3;2264;0;6338;3;3;
/org.eclipse.ui.workbench/Eclipse UI/org/eclipse/ui/internal/presentations/PaneFolderButtonListener.java;1;0;1;1;1;1;1;0;0;0;0;5263;0;0;1;0;0;0;1;5263;0;5263;1;1;
/org.eclipse.team.cvs.core/src/org/eclipse/team/internal/ccvs/core/CVSTeamProvider.java;2;1;28;1;8;8;8;20;348;2;19;865;1408;1408;2;1;0;20;28;865;1;6337;27;2;
/org.eclipse.jdt.debug/model/org/eclipse/jdt/internal/debug/core/model/JDIArrayPartition.java;2;0;2;1;0;0;0;2;5;1;2;2497;5;5;1;0;0;2;2;2497;0;2564;2;2;
/org.eclipse.core.runtime.osgi/src/org/eclipse/core/internal/registry/RegistryDelta.java;1;0;1;1;0;0;0;1;0;0;1;3013;0;0;1;0;0;1;1;3013;0;3013;1;1;
/org.eclipse.debug.core/core/org/eclipse/debug/core/model/ILaunchConfigurationDelegate2.java;1;0;4;1;1;1;1;3;56;1;3;4371;68;68;1;0;0;3;4;4371;0;5108;4;1;
/org.eclipse.ltk.core.refactoring/src/org/eclipse/ltk/core/refactoring/FileStatusContext.java;1;2;5;1;4;3;4;1;5;0;1;4965;10;10;2;0;1;1;5;6338;1;6352;4;1;
/org.eclipse.update.ui.forms/Eclipse Forms/org/eclipse/ui/forms/parts/Twistie.java;1;0;2;1;0;0;0;2;0;1;2;3096;0;0;1;0;0;2;2;3096;0;3138;2;1;
/org.eclipse.pde.ui/sandbox/org/eclipse/pde/internal/ui/editor/standalone/parser/XEParserConfiguration.java;1;0;2;1;0;0;0;2;0;1;2;2320;0;0;1;0;0;2;2;2320;0;2931;2;1;
/org.eclipse.jdt.core.tests.model/workspace/Formatter/test190/A_out.java;1;0;2;1;0;0;0;2;3;1;2;2425;3;3;1;0;0;2;2;2425;0;3029;2;1;
/org.eclipse.help/src/org/eclipse/help/internal/standalone/EclipseLifeCycleListener.java;1;0;3;1;0;0;0;3;17;1;3;1697;17;17;1;0;0;3;3;1697;0;2732;3;1;
/org.eclipse.search/new search/org/eclipse/search2/internal/ui/basic/views/TreeViewerNavigator.java;2;1;4;1;4;4;4;0;209;0;0;5106;226;226;1;0;0;0;4;5106;0;6162;4;2;
/org.eclipse.jdt.ui/ui/org/eclipse/jdt/internal/ui/text/correction/ImplementInterfaceProposal.java;1;1;2;1;2;2;2;0;15;0;0;5377;15;15;1;0;0;0;2;5377;0;5406;2;1;
/org.eclipse.ant.ui/Ant Tools Support/org/eclipse/ant/ui/internal/views/AntTargetContentProvider.java;1;0;2;1;0;0;0;2;0;1;2;250;0;0;1;0;0;2;2;250;0;1811;2;1;
/org.eclipse.ui.externaltools/Ant Tools Support/org/eclipse/ui/externaltools/internal/ant/launchConfigurations/RunAntStatusHandler.java;1;0;1;1;0;0;0;1;0;0;1;282;0;0;1;0;0;1;1;282;0;282;1;1;
/org.eclipse.core.runtime/src/org/eclipse/core/runtime/jobs/IProgressListener.java;1;0;1;1;0;0;0;1;0;0;1;320;0;0;1;0;0;1;1;320;0;320;1;1;
/org.eclipse.swt/Eclipse SWT Mozilla/common/org/eclipse/swt/internal/mozilla/nsIFile.java;1;0;2;1;0;0;0;2;106;1;2;1654;106;106;1;0;0;2;2;1654;0;2568;2;1;
/org.eclipse.update/src/org/eclipse/update/internal/ui/UMDialog.java;1;0;1;1;1;1;1;0;0;0;0;6339;0;0;1;0;0;0;1;6339;0;6339;1;1;
/org.eclipse.ui.views/src/org/eclipse/ui/views/internal/table/Messages.java;1;0;2;1;0;0;0;2;0;0;1;749;0;0;2;1;0;2;2;749;1;749;1;1;
/org.eclipse.ui.workbench/Eclipse UI/org/eclipse/ui/internal/activities/service/CompoundActivityService.java;1;0;2;1;0;0;0;2;0;1;2;2896;0;0;1;0;0;2;2;2896;0;3066;2;1;
/org.eclipse.jdt.ui/ui/org/eclipse/jdt/ui/actions/DeclarationsSearchGroup.java;2;0;5;1;1;1;1;4;18;1;4;1350;44;44;1;0;0;4;5;1350;0;6340;5;2;
/org.eclipse.ltk.ui.refactoring/src/org/eclipse/ltk/internal/ui/refactoring/UndoManagerAction.java;1;2;8;1;8;7;8;0;92;0;0;5162;114;114;2;0;1;0;8;5176;1;6340;7;1;
/org.eclipse.jface/src/org/eclipse/jface/action/SubStatusLineManager.java;1;0;1;1;0;0;0;1;28;0;1;553;28;28;1;0;0;1;1;553;0;553;1;1;
/org.eclipse.ui.workbench.texteditor/src/org/eclipse/ui/texteditor/MoveLinesAction.java;3;1;9;1;2;2;2;7;517;1;7;436;683;683;1;0;0;7;9;436;0;6340;9;3;
/org.eclipse.core.tests.resources/src/org/eclipse/core/tests/internal/watson/ElementTreeTest.java;1;0;2;1;2;1;2;0;1857;0;0;5147;1857;1857;2;0;1;0;2;5147;1;5147;1;1;
/org.eclipse.update.ui/src/org/eclipse/update/internal/ui/views/RevertConfigurationAction.java;3;0;6;1;1;1;1;5;13;1;5;825;29;29;1;0;0;5;6;825;0;6336;6;3;
/org.eclipse.ui.workbench/Eclipse UI/org/eclipse/ui/internal/roles/api/IMutableRoleRegistry.java;1;0;2;1;0;0;0;2;0;1;2;1952;0;0;1;0;0;2;2;1952;0;2199;2;1;
/org.eclipse.jdt.core.tests.model/workspace/Converter/src/test0314/Test.java;1;0;1;1;0;0;0;1;0;0;1;3714;0;0;1;0;0;1;1;3714;0;3714;1;1;
/org.eclipse.pde.ui/src_Forms/org/eclipse/pde/internal/ui/neweditor/schema/ElementSectionDropAdapter.java;2;0;2;1;1;1;1;1;0;0;1;4856;0;0;1;0;0;1;2;4856;0;5431;2;2;
/org.eclipse.ui.workbench/Eclipse UI/org/eclipse/ui/internal/contexts/ContextActivationServiceEvent.java;1;0;7;1;0;0;0;7;11;2;6;1220;25;25;2;1;0;7;7;1401;1;3109;6;1;
/org.eclipse.update.ui.forms/Eclipse Forms/org/eclipse/ui/forms/widgets/TableWrapLayout.java;1;0;5;1;0;0;0;5;244;2;4;3138;250;250;2;1;0;5;5;4024;1;4157;4;1;
/org.eclipse.jdt.core.tests.model/workspace/Converter/test0001/Test.java;1;0;1;1;0;0;0;1;0;0;1;3714;0;0;1;0;0;1;1;3714;0;3714;1;1;
/org.eclipse.ui.workbench/Eclipse UI/org/eclipse/ui/internal/commands/util/Capture.java;1;0;2;1;0;0;0;2;0;1;2;1077;0;0;1;0;0;2;2;1077;0;1222;2;1;
/org.eclipse.team.cvs.ui/src/org/eclipse/team/internal/ccvs/ui/model/RemoteVersionModule.java;1;0;1;1;0;0;0;1;2;0;1;990;2;2;1;0;0;1;1;990;0;990;1;1;
/org.eclipse.team.cvs.ui/src/org/eclipse/team/internal/ccvs/ui/wizards/ConfigurationWizardMainPage.java;2;1;10;1;6;6;6;4;165;1;4;1080;338;338;1;0;0;4;10;1080;0;6337;10;2;
/org.eclipse.team.core/src/org/eclipse/team/core/subscribers/FilteredSyncInfoCollector.java;2;0;4;1;1;1;1;3;162;1;3;3712;167;167;1;0;0;3;4;3712;0;5362;4;2;
/org.eclipse.ui.views/src/org/eclipse/ui/views/properties/PropertySheetViewer.java;3;1;4;1;3;3;3;1;423;0;1;2517;505;505;1;0;0;1;4;2517;0;6338;4;3;
/org.eclipse.pde.ui/src/org/eclipse/pde/internal/ui/editor/site/BuildPage.java;1;0;1;1;0;0;0;1;0;0;1;2311;0;0;1;0;0;1;1;2311;0;2311;1;1;
/org.eclipse.core.runtime/src/org/eclipse/core/internal/content/XMLRootElementContentDescriber.java;1;1;3;1;3;3;3;0;34;0;0;5194;34;34;1;0;0;0;3;5194;0;5231;3;1;
/org.eclipse.pde.ui/src/org/eclipse/pde/internal/ui/editor/SourceOutlinePage.java;2;1;5;1;5;5;5;0;42;0;0;5431;74;74;1;0;0;0;5;5431;0;6336;5;2;
/org.eclipse.jdt.core.tests.model/workspace/Converter/src/test0035/Test.java;1;0;1;1;0;0;0;1;0;0;1;3714;0;0;1;0;0;1;1;3714;0;3714;1;1;
/org.eclipse.core.tests.resources/src/org/eclipse/core/tests/resources/session/SampleSessionTest.java;1;0;2;1;2;1;2;0;52;0;0;5147;52;52;2;0;1;0;2;5147;1;5147;1;1;
/org.eclipse.debug.ui/ui/org/eclipse/debug/internal/ui/sourcelookup/browsers/FolderSourceContainerDialog.java;1;0;1;1;0;0;0;1;0;0;1;3770;0;0;1;0;0;1;1;3770;0;3770;1;1;
/org.eclipse.jdt.core/model/org/eclipse/jdt/internal/core/SourceRange.java;1;0;2;1;0;0;0;2;4;1;2;2420;6;6;1;0;0;2;2;2420;0;3560;2;1;
/org.eclipse.swt/Eclipse SWT Mozilla/carbon/org/eclipse/swt/internal/mozilla/GRE.java;1;0;2;1;0;0;0;2;0;1;2;1676;0;0;1;0;0;2;2;1676;0;4176;2;1;
/org.eclipse.help.ui/src/org/eclipse/help/ui/internal/OpenHelpSearchPageAction.java;1;0;1;1;0;0;0;1;0;0;1;2732;0;0;1;0;0;1;1;2732;0;2732;1;1;
/org.eclipse.jdt.ui.tests.refactoring/resources/ChangeTypeRefactoring/positive/A_testMultiCUClass1.java;1;0;1;1;0;0;0;1;0;0;1;2844;0;0;1;0;0;1;1;2844;0;2844;1;1;
/org.eclipse.team.tests.cvs.core/src/org/eclipse/team/tests/ccvs/ui/LoggingTestResult.java;1;0;1;1;0;0;0;1;0;0;1;2632;0;0;1;0;0;1;1;2632;0;2632;1;1;
/org.eclipse.jdt.core.tests.model/workspace/Formatter/test053/A_in.java;1;0;1;1;0;0;0;1;0;0;1;2425;0;0;1;0;0;1;1;2425;0;2425;1;1;
/org.eclipse.jdt.core.tests.model/workspace/Formatter/test310/A_out.java;1;0;2;1;0;0;0;2;7;1;2;2442;7;7;1;0;0;2;2;2442;0;3029;2;1;
/org.eclipse.debug.ui/ui/org/eclipse/debug/internal/ui/StringMatcher.java;1;0;1;1;0;0;0;1;792;0;1;3969;792;792;1;0;0;1;1;3969;0;3969;1;1;
/org.eclipse.jdt.ui/core refactoring/org/eclipse/jdt/internal/corext/refactoring/participants/ResourceProcessors.java;2;0;3;1;1;1;1;2;30;1;2;1668;38;38;1;0;0;2;3;1668;0;6340;3;2;
/org.eclipse.update.ui/src/org/eclipse/update/internal/ui/forms/RevertSection.java;2;0;2;2;0;0;0;2;2;0;1;749;2;2;2;1;0;2;2;749;1;749;1;2;
/org.eclipse.swt/Eclipse SWT PI/gtk/org/eclipse/swt/internal/accessibility/gtk/AtkSelectionIface.java;4;0;4;1;1;1;1;3;17;1;3;1214;35;35;1;0;0;3;4;1214;0;6352;4;4;
/org.eclipse.pde.ui/src_Forms/org/eclipse/pde/internal/ui/neweditor/build/AddLibraryDialog.java;2;1;3;1;2;2;2;1;7;0;1;4406;7;7;1;0;0;1;3;4406;0;5431;3;2;
/org.eclipse.ui.workbench/Eclipse UI/org/eclipse/ui/internal/ShowFastViewContribution.java;2;1;2;1;2;2;2;0;42;0;0;5626;44;44;1;0;0;0;2;5626;0;6338;2;2;
/org.eclipse.ui.workbench/Eclipse UI/org/eclipse/ui/internal/decorators/DecorationScheduler.java;3;1;29;2;3;3;3;26;261;2;22;697;788;788;2;4;0;26;29;1156;4;6338;25;3;
/org.eclipse.jdt.core.tests.model/workspace/Formatter/test230/A_out.java;1;0;1;1;0;0;0;1;0;0;1;2437;0;0;1;0;0;1;1;2437;0;2437;1;1;
/org.eclipse.swt/Eclipse SWT PI/gtk/org/eclipse/swt/internal/gtk/AtkTextIface.java;1;0;2;1;0;0;0;2;0;1;2;1102;0;0;1;0;0;2;2;1102;0;1214;2;1;
/org.eclipse.team.cvs.core/src/org/eclipse/team/internal/ccvs/core/client/listeners/StatusListener.java;2;0;2;1;1;1;1;1;16;0;1;4953;18;18;1;0;0;1;2;4953;0;6337;2;2;
/org.eclipse.ui.workbench/Eclipse UI/org/eclipse/ui/contexts/IContextRegistryEvent.java;1;0;4;1;0;0;0;4;0;2;3;1388;0;0;2;1;0;4;4;1417;1;1417;3;1;
/org.eclipse.team.ui/src/org/eclipse/team/ui/synchronize/viewers/SyncInfoSetCheckboxCompareInput.java;1;0;1;1;0;0;0;1;0;0;1;3972;0;0;1;0;0;1;1;3972;0;3972;1;1;
/org.eclipse.jdt.core.tests.model/workspace/Formatter/test089/A_out.java;1;0;1;1;0;0;0;1;0;0;1;2425;0;0;1;0;0;1;1;2425;0;2425;1;1;
/org.eclipse.pde.ui/src_Forms/org/eclipse/pde/internal/ui/neweditor/plugin/ExtensionsSection.java;2;1;19;2;2;2;2;17;833;2;13;3812;1402;1402;2;4;0;17;19;4354;4;5431;15;2;
/org.eclipse.jface.text/src/org/eclipse/jface/text/source/VerticalRulerEvent.java;2;2;3;1;3;2;3;0;6;0;0;5177;8;8;2;0;1;0;3;5177;1;6340;2;2;
/org.eclipse.ui.workbench/Eclipse UI/org/eclipse/ui/internal/AbstractTableInformationControl.java;2;0;2;1;0;0;0;2;0;1;2;2620;0;0;1;0;0;2;2;2620;0;4521;2;2;
/org.eclipse.ui.cheatsheets/src/org/eclipse/ui/cheatsheets/LaunchCheatSheetAction.java;2;0;5;2;0;0;0;5;83;2;4;4428;107;107;2;1;0;5;5;4625;1;4662;4;2;
/org.eclipse.jdt.core.tests.model/workspace/Formatter/test105/A_in.java;1;0;1;1;0;0;0;1;0;0;1;2425;0;0;1;0;0;1;1;2425;0;2425;1;1;
/org.eclipse.releng.tools/src/org/eclipse/releng/tools/ReleaseWizard.java;3;1;5;1;5;5;5;0;39;0;0;5183;83;83;1;0;0;0;5;5183;0;5661;5;3;
/org.eclipse.team.cvs.core/src/org/eclipse/team/internal/ccvs/core/util/AddDeleteMoveListener.java;1;0;3;1;0;0;0;3;196;1;3;866;204;204;1;0;0;3;3;866;0;2061;3;1;
/org.eclipse.help/src/org/eclipse/help/internal/standalone/Eclipse.java;1;0;2;1;0;0;0;2;44;1;2;1880;44;44;1;0;0;2;2;1880;0;2732;2;1;
/org.eclipse.jdt.ui/ui/org/eclipse/jdt/internal/ui/filters/EmptyInnerPackageFilter.java;1;0;1;1;1;1;1;0;2;0;0;6340;2;2;1;0;0;0;1;6340;0;6340;1;1;
/org.eclipse.jdt.ui.tests.refactoring/resources/ExtractMethodWorkSpace/ExtractMethodTests/try_out/A_test462.java;1;0;1;1;0;0;0;1;1;0;1;130;1;1;1;0;0;1;1;130;0;130;1;1;
/org.eclipse.core.runtime/src/org/eclipse/core/internal/runtime/Cipher.java;3;1;7;1;4;4;4;3;302;1;3;3013;623;623;1;0;0;3;7;3013;0;6340;7;3;
/org.eclipse.core.tests.runtime/src/org/eclipse/core/tests/internal/plugins/PluginResolveTest_31.java;1;0;1;1;0;0;0;1;0;0;1;3014;0;0;1;0;0;1;1;3014;0;3014;1;1;
/org.eclipse.ua.tests/src/org/eclipse/ui/tests/cheatsheets/parameters/GatherDataDialog.java;1;0;1;1;1;1;1;0;0;0;0;6081;0;0;1;0;0;0;1;6081;0;6081;1;1;
/org.eclipse.ui.workbench/Eclipse UI/org/eclipse/ui/internal/IPreferenceConstants.java;7;1;20;1;5;5;5;15;70;1;15;1859;300;300;1;0;0;15;20;1859;0;6338;20;7;
/org.eclipse.swt.opengl.examples/src/org/eclipse/swt/opengl/examples/FogTab.java;1;0;1;1;0;0;0;1;0;0;1;1175;0;0;1;0;0;1;1;1175;0;1175;1;1;
/org.eclipse.jdt.core.tests.model/workspace/Converter/src/test0183/Test.java;1;0;1;1;0;0;0;1;0;0;1;3714;0;0;1;0;0;1;1;3714;0;3714;1;1;
/org.eclipse.ui.views/src/org/eclipse/ui/views/internal/markers/DialogMarkerFilter.java;1;0;2;1;0;0;0;2;0;0;1;749;0;0;2;1;0;2;2;749;1;749;1;1;
/org.eclipse.jdt.core.tests.model/workspace/Converter/src/test0492/A.java;1;0;1;1;0;0;0;1;0;0;1;3714;0;0;1;0;0;1;1;3714;0;3714;1;1;
/org.eclipse.jdt.ui.tests.refactoring/resources/TypeConstraints/A_testConstraints12.java;1;0;1;1;0;0;0;1;0;0;1;65;0;0;1;0;0;1;1;65;0;65;1;1;
/org.eclipse.jdt.core.tests.model/workspace/Converter/src/junit/swingui/DefaultFailureDetailView.java;1;0;1;1;0;0;0;1;0;0;1;3714;0;0;1;0;0;1;1;3714;0;3714;1;1;
/org.eclipse.core.resources/src/org/eclipse/core/resources/team/IResourceTree.java;1;0;3;1;1;1;1;2;76;1;2;4994;84;84;1;0;0;2;3;4994;0;5146;3;1;
/org.eclipse.core.tests.resources/src/org/eclipse/core/tests/internal/dtree/AllTests.java;1;0;1;1;1;1;1;0;19;0;0;5147;19;19;1;0;0;0;1;5147;0;5147;1;1;
/org.eclipse.osgi/core/framework/org/eclipse/osgi/service/debug/DebugOptions.java;2;1;4;1;3;3;3;1;4;0;1;3147;11;11;1;0;0;1;4;3147;0;6337;4;2;
/org.eclipse.team.core/src/org/eclipse/team/core/subscribers/ContentComparisonCriteria.java;2;0;7;1;0;0;0;7;148;1;7;649;245;245;1;0;0;7;7;649;0;4216;7;2;
/org.eclipse.jdt.core/compiler/org/eclipse/jdt/internal/compiler/lookup/ClassScope.java;5;1;15;2;3;3;3;12;128;2;11;1059;293;293;2;1;0;12;15;4989;1;5871;14;5;
/org.eclipse.ui.workbench/Eclipse UI/org/eclipse/ui/dialogs/WizardNewProjectCreationPage.java;2;0;4;1;0;0;0;4;696;1;4;39;734;734;1;0;0;4;4;39;0;2737;4;2;
/org.eclipse.ui.ide/extensions/org/eclipse/ui/dialogs/WizardExportResourcesPage.java;1;0;2;1;0;0;0;2;4;1;2;2263;4;4;1;0;0;2;2;2263;0;2611;2;1;
/org.eclipse.jdt.ui/ui/org/eclipse/jdt/internal/ui/compare/JavaHistoryEditorAction.java;1;0;2;1;0;0;0;2;1;1;2;1289;1;1;1;0;0;2;2;1289;0;1730;2;1;
/org.eclipse.ui.tests/Eclipse UI Tests/org/eclipse/ui/tests/themes/ThemeTest.java;1;0;1;1;0;0;0;1;0;0;1;5025;0;0;1;0;0;1;1;5025;0;5025;1;1;
/org.eclipse.jdt.ui/ui/org/eclipse/jdt/internal/ui/text/spelling/engine/DefaultSpellChecker.java;3;1;5;1;2;2;2;3;80;2;2;3930;107;107;2;1;0;3;5;4365;1;6340;4;3;
/org.eclipse.core.runtime/src/org/eclipse/core/runtime/preferences/AbstractPreferenceInitializer.java;1;0;1;1;1;1;1;0;0;0;0;5360;0;0;1;0;0;0;1;5360;0;5360;1;1;
/org.eclipse.update.ui/src/org/eclipse/update/internal/ui/views/RenameDialog.java;1;0;1;1;0;0;0;1;0;0;1;755;0;0;1;0;0;1;1;755;0;755;1;1;
/org.eclipse.jdt.ui.tests.refactoring/resources/ExtractTemp/canExtract/A_test80_in.java;1;0;1;1;1;1;1;0;0;0;0;5909;0;0;1;0;0;0;1;5909;0;5909;1;1;
/org.eclipse.help.ide/src/org/eclipse/help/ui/internal/OpenHelpSearchPageAction.java;1;0;3;1;0;0;0;3;65;2;2;1738;65;65;2;1;0;3;3;1738;1;1778;2;1;
/org.eclipse.team.cvs.ui/src/org/eclipse/team/internal/ccvs/ui/wizards/ConfigurationWizardAutoconnectPage.java;2;0;3;1;1;1;1;2;11;1;2;2381;15;15;1;0;0;2;3;2381;0;6337;3;2;
/org.eclipse.jdt.ui.tests.refactoring/test cases/org/eclipse/jdt/ui/tests/refactoring/RenamePrivateFieldTests.java;4;1;12;2;2;2;2;10;37;2;9;130;158;158;2;1;0;10;12;4507;1;6340;11;4;
/org.eclipse.jdt.core/dom/org/eclipse/jdt/core/dom/TextElement.java;2;0;8;1;1;1;1;7;64;1;7;3683;94;94;1;0;0;7;8;3683;0;5272;8;2;
/org.eclipse.jdt.core/search/org/eclipse/jdt/core/search/TypeDeclarationMatch.java;2;1;7;1;3;3;3;4;23;1;4;3913;59;59;1;0;0;4;7;3913;0;5242;7;2;
/org.eclipse.core.runtime/src/org/eclipse/core/internal/plugins/Eclipse21SelectionPolicy.java;2;0;2;1;0;0;0;2;0;1;2;2105;0;0;1;0;0;2;2;2105;0;3013;2;2;
/org.eclipse.debug.core/core/org/eclipse/debug/internal/core/stringsubstitution/ValueVariable.java;2;0;2;1;0;0;0;2;0;1;2;2032;0;0;1;0;0;2;2;2032;0;2514;2;2;
/org.eclipse.debug.core/core/org/eclipse/debug/core/variables/ContextLaunchVariable.java;2;0;3;1;0;0;0;3;2;1;3;562;2;2;1;0;0;3;3;562;0;737;3;2;
/org.eclipse.jdt.ui/core refactoring/org/eclipse/jdt/internal/corext/refactoring/participants/xml/NotExpression.java;1;0;7;1;0;0;0;7;11;1;7;1033;36;36;1;0;0;7;7;1033;0;4108;7;1;
/org.eclipse.team.cvs.ui/src/org/eclipse/team/internal/ccvs/ui/wizards/SharingWizardTagPage.java;1;0;3;1;0;0;0;3;146;1;3;4519;146;146;1;0;0;3;3;4519;0;4869;3;1;
/org.eclipse.pde.ui/src_Forms/org/eclipse/pde/internal/ui/neweditor/schema/ElementSectionDragAdapter.java;2;0;2;1;1;1;1;1;0;0;1;4856;0;0;1;0;0;1;2;4856;0;5431;2;2;
/org.eclipse.core.resources/src/org/eclipse/core/resources/IPathVariableManager.java;1;0;2;1;1;1;1;1;6;0;1;4994;10;10;1;0;0;1;2;4994;0;5146;2;1;
/org.eclipse.jdt.ui/ui/org/eclipse/jdt/internal/ui/typehierarchy/ShowQualifiedTypeNamesAction.java;1;0;1;1;1;1;1;0;2;0;0;6340;2;2;1;0;0;0;1;6340;0;6340;1;1;
/org.eclipse.jdt.ui.tests.refactoring/resources/MoveInstanceMethod/canMove/test24/out/A.java;1;0;1;1;0;0;0;1;0;0;1;1627;0;0;1;0;0;1;1;1627;0;1627;1;1;
/org.eclipse.jdt.core.tests.model/workspace/Completion/src/z1/z2/qla0/Qla3.java;1;0;1;1;0;0;0;1;0;0;1;3253;0;0;1;0;0;1;1;3253;0;3253;1;1;
/org.eclipse.ui.examples.javaeditor/Eclipse Java Editor Example/org/eclipse/ui/examples/javaeditor/javadoc/JavaDocCompletionProcessor.java;1;0;1;1;1;1;1;0;2;0;0;6340;2;2;1;0;0;0;1;6340;0;6340;1;1;
/org.eclipse.help/src/org/eclipse/help/internal/workingset/WorkingSet.java;1;0;1;1;0;0;0;1;0;0;1;2732;0;0;1;0;0;1;1;2732;0;2732;1;1;
/org.eclipse.jdt.ui/ui/org/eclipse/jdt/internal/ui/actions/AddTaskAction.java;2;0;2;1;1;1;1;1;4;0;1;592;6;6;1;0;0;1;2;592;0;6340;2;2;
/org.eclipse.core.tests.resources/src/org/eclipse/core/tests/resources/regression/Bug_6708.java;1;0;2;1;2;1;2;0;78;0;0;5147;78;78;2;0;1;0;2;5147;1;5147;1;1;
/org.eclipse.ant.ui/Ant Tools Support/org/eclipse/ant/ui/internal/views/AntViewMessages.java;1;0;3;1;0;0;0;3;2;1;3;250;2;2;1;0;0;3;3;250;0;1811;3;1;
/org.eclipse.core.expressions.tests/src/org/eclipse/core/internal/expressions/tests/A.java;1;0;2;1;1;1;1;1;2;0;1;4108;2;2;1;0;0;1;2;4108;0;6340;2;1;
/org.eclipse.ui.workbench/Eclipse UI/org/eclipse/ui/internal/commands/api/ICategoryDefinition.java;1;0;4;1;0;0;0;4;0;2;3;1724;0;0;2;1;0;4;4;2515;1;2532;3;1;
/org.eclipse.team.ui/src/org/eclipse/team/internal/ui/sync/views/SyncContainer.java;1;0;1;1;0;0;0;1;0;0;1;488;0;0;1;0;0;1;1;488;0;488;1;1;
/org.eclipse.jdt.ui.tests.refactoring/resources/SurroundWithWorkSpace/SurroundWithTests/trycatch_out/TestWrappedLocal1.java;1;0;1;1;0;0;0;1;7;0;1;845;7;7;1;0;0;1;1;845;0;845;1;1;
/org.eclipse.team.cvs.ui/src/org/eclipse/team/internal/ccvs/ui/operations/CheckoutToRemoteFolderOperation.java;2;1;5;1;2;2;2;3;35;1;3;3276;42;42;1;0;0;3;5;3276;0;6337;5;2;
/org.eclipse.ui.ide/src/org/eclipse/ui/wizards/newresource/BasicNewFileResourceWizard.java;2;0;3;1;0;0;0;3;6;1;3;1511;10;10;1;0;0;3;3;1511;0;1659;3;2;
/org.eclipse.jdt.ui/ui/org/eclipse/jdt/internal/ui/text/correction/LinkedCorrectionProposal.java;4;2;22;2;7;6;7;15;219;2;14;1152;691;691;2;1;1;15;22;1152;2;5833;20;4;
/org.eclipse.pde.core/src/org/eclipse/pde/internal/core/build/WorkspaceBuildModel.java;3;1;5;1;3;3;3;2;4;1;2;2501;16;16;1;0;0;2;5;2501;0;6336;5;3;
/org.eclipse.ui.ide/extensions/org/eclipse/ui/actions/AddBookmarkAction.java;1;0;2;1;0;0;0;2;2;1;2;2263;2;2;1;0;0;2;2;2263;0;2611;2;1;
/org.eclipse.jdt.debug.ui/ui/org/eclipse/jdt/internal/debug/core/refactoring/JavaWatchpointFieldNameChange.java;3;0;9;1;1;1;1;8;55;2;6;4519;130;130;2;2;0;8;9;4519;2;6339;7;3;
/org.eclipse.swt.tests/JUnit Tests/org/eclipse/swt/tests/junit/Test_org_eclipse_swt_widgets_ScrollBar.java;3;0;4;1;0;0;0;4;462;2;3;2123;667;667;2;1;0;4;4;2644;1;3198;3;3;
/org.eclipse.jdt.ui/ui/org/eclipse/jdt/internal/ui/wizards/OpenProjectWizardAction.java;2;0;2;1;1;1;1;1;2;0;1;3830;4;4;1;0;0;1;2;3830;0;6340;2;2;
/org.eclipse.ui.workbench/Eclipse UI/org/eclipse/ui/internal/csm/roles/PreferenceRoleRegistry.java;1;0;2;1;0;0;0;2;0;1;2;2213;0;0;1;0;0;2;2;2213;0;2371;2;1;
/org.eclipse.debug.ui/ui/org/eclipse/debug/internal/ui/views/memory/IMemoryView.java;1;0;1;1;1;1;1;0;0;0;0;5254;0;0;1;0;0;0;1;5254;0;5254;1;1;
/org.eclipse.jdt.core.tests.model/workspace/Converter/test0498/A.java;1;0;2;1;0;0;0;2;0;1;2;1956;0;0;1;0;0;2;2;1956;0;3714;2;1;
/org.eclipse.ui.workbench/Eclipse UI/org/eclipse/ui/internal/commands/registry/FileCommandRegistry.java;1;0;2;1;0;0;0;2;0;1;2;1422;0;0;1;0;0;2;2;1422;0;1724;2;1;
/org.eclipse.pde.ui/src_Forms/org/eclipse/pde/internal/ui/neweditor/schema/SchemaSourcePage.java;2;1;3;1;2;2;2;1;16;0;1;4856;16;16;1;0;0;1;3;4856;0;5431;3;2;
/org.eclipse.jdt.ui.tests.refactoring/resources/ExtractMethodWorkSpace/ExtractMethodTests/locals_in/A_test566.java;1;0;1;1;0;0;0;1;4;0;1;844;4;4;1;0;0;1;1;844;0;844;1;1;
/org.eclipse.jdt.core.tests.model/workspace/Converter/test0180/Test.java;1;0;1;1;0;0;0;1;0;0;1;3714;0;0;1;0;0;1;1;3714;0;3714;1;1;
/org.eclipse.ui.views/src/org/eclipse/ui/views/internal/markers/MarkerSorter.java;1;0;2;1;0;0;0;2;0;0;1;265;0;0;2;1;0;2;2;265;1;265;1;1;
/org.eclipse.ui.workbench/Eclipse UI/org/eclipse/ui/actions/ScrubLocalAction.java;1;0;1;1;0;0;0;1;0;0;1;2737;0;0;1;0;0;1;1;2737;0;2737;1;1;
/org.eclipse.team.ui/src/org/eclipse/team/ui/sync/actions/SyncInfoSet.java;1;0;1;1;0;0;0;1;0;0;1;2405;0;0;1;0;0;1;1;2405;0;2405;1;1;
/org.eclipse.pde.ui/src/org/eclipse/pde/internal/ui/editor/plugin/JavaAttributeWizardPage.java;2;1;3;1;3;3;3;0;20;0;0;5431;26;26;1;0;0;0;3;5431;0;6336;3;2;
/org.eclipse.debug.ui/ui/org/eclipse/debug/internal/ui/actions/ToggleDetailPaneAction.java;1;0;2;1;0;0;0;2;8;1;2;689;8;8;1;0;0;2;2;689;0;808;2;1;
/org.eclipse.jdt.ui.tests.refactoring/resources/IntroduceFactory/positive/DifferentArgs_in.java;1;0;2;1;1;1;1;1;2;0;1;2862;2;2;1;0;0;1;2;2862;0;5659;2;1;
/org.eclipse.jdt.core.tests.model/workspace/Converter/test0362/Test.java;1;0;1;1;0;0;0;1;0;0;1;3714;0;0;1;0;0;1;1;3714;0;3714;1;1;
/org.eclipse.jdt.core.tests.model/workspace/Converter/src/javadoc/testBug55221/d/Test.java;2;0;3;2;0;0;0;3;0;0;1;4639;0;0;3;2;0;3;3;4639;2;4639;1;2;
/org.eclipse.ui.views/src/org/eclipse/ui/views/tasklist/FiltersDialog.java;2;0;2;1;0;0;0;2;100;1;2;1675;100;100;1;0;0;2;2;1675;0;2738;2;2;
/org.eclipse.ui.workbench/Eclipse UI/org/eclipse/ui/internal/presentations/SystemMenuSize.java;2;0;2;1;1;1;1;1;12;0;1;4680;12;12;1;0;0;1;2;4680;0;5173;2;2;
/org.eclipse.core.tools/src/org/eclipse/core/tools/ErrorUtil.java;1;0;1;1;1;1;1;0;0;0;0;6302;0;0;1;0;0;0;1;6302;0;6302;1;1;
/org.eclipse.jdt.core.tests.model/workspace/Converter/src/junit/runner/StandardTestSuiteLoader.java;1;0;1;1;0;0;0;1;0;0;1;3714;0;0;1;0;0;1;1;3714;0;3714;1;1;
/org.eclipse.ui.ide/src/org/eclipse/ui/internal/misc/OverlayIcon.java;2;0;2;1;0;0;0;2;0;1;2;1775;0;0;1;0;0;2;2;1775;0;2263;2;2;
/org.eclipse.ui.views/src/org/eclipse/ui/views/framelist/IFrameSource.java;1;0;1;1;0;0;0;1;0;0;1;2738;0;0;1;0;0;1;1;2738;0;2738;1;1;
/org.eclipse.jdt.core.tests.model/workspace/Converter/src/test0450/A.java;1;0;1;1;0;0;0;1;0;0;1;3714;0;0;1;0;0;1;1;3714;0;3714;1;1;
/org.eclipse.swt/Eclipse SWT Drag and Drop/emulated/org/eclipse/swt/dnd/Transfer.java;1;1;2;1;2;2;2;0;4;0;0;5606;6;6;1;0;0;0;2;5606;0;6352;2;1;
/org.eclipse.ant.ui/Ant Editor/org/eclipse/ant/internal/ui/editor/outline/ToggleLinkWithEditorAction.java;1;0;1;1;0;0;0;1;0;0;1;4607;0;0;1;0;0;1;1;4607;0;4607;1;1;
/org.eclipse.jdt.ui.tests.refactoring/resources/ChangeTypeRefactoring/positive/A_testReturnTypeWithCall_in.java;1;0;1;1;0;0;0;1;0;0;1;2844;0;0;1;0;0;1;1;2844;0;2844;1;1;
/org.eclipse.compare/compare/org/eclipse/compare/IContentChangeListener.java;1;0;1;1;0;0;0;1;2;0;1;3935;2;2;1;0;0;1;1;3935;0;3935;1;1;
/org.eclipse.team.cvs.ssh2/src/org/eclipse/team/internal/ccvs/ssh2/CVSSSH2PreferencePage.java;3;2;12;1;8;7;8;4;208;2;3;4825;338;338;2;1;1;4;12;4825;2;6145;10;3;
/org.eclipse.swt/Eclipse SWT/win32/org/eclipse/swt/widgets/ToolItem.java;2;0;6;1;1;1;1;5;46;1;5;207;66;66;1;0;0;5;6;207;0;6352;6;2;
/org.eclipse.swt/Eclipse SWT AWT/win32/org/eclipse/swt/awt/SWT_AWT.java;3;2;17;2;10;7;10;7;57;2;5;3013;279;279;2;2;3;7;17;3013;5;6296;12;3;
/org.eclipse.pde.ui/src/org/eclipse/pde/internal/ui/wizards/imports/PluginImportWizardFirstPage.java;2;1;19;1;4;4;4;15;736;4;12;368;1081;1081;4;3;0;15;19;731;3;6336;16;2;
/org.eclipse.jdt.ui.tests.refactoring/resources/ExtractMethodWorkSpace/ExtractMethodTests/branch_in/A_test752.java;1;0;2;1;0;0;0;2;4;1;2;844;4;4;1;0;0;2;2;844;0;2256;2;1;
/org.eclipse.ui.workbench.texteditor/src/org/eclipse/ui/texteditor/IAnnotationService.java;1;0;1;1;0;0;0;1;0;0;1;2544;0;0;1;0;0;1;1;2544;0;2544;1;1;
/org.eclipse.help.ui/src/org/eclipse/help/ui/internal/workingset/HelpWorkingSetTreeContentProvider.java;1;0;1;1;0;0;0;1;0;0;1;2732;0;0;1;0;0;1;1;2732;0;2732;1;1;
/org.eclipse.jdt.core.tests.model/workspace/Formatter/test341/A_out.java;1;0;1;1;0;0;0;1;0;0;1;2865;0;0;1;0;0;1;1;2865;0;2865;1;1;
/org.eclipse.swt/Eclipse SWT PI/gtk1x/org/eclipse/swt/internal/gtk/GtkRequisition.java;1;0;1;1;0;0;0;1;0;0;1;2327;0;0;1;0;0;1;1;2327;0;2327;1;1;
/org.eclipse.update.ui/srcnew/org/eclipse/update/internal/ui/views/SaveConfigurationAction.java;2;0;3;1;0;0;0;3;10;1;3;339;10;10;1;0;0;3;3;339;0;825;3;2;
/org.eclipse.jdt.core/dom/org/eclipse/jdt/core/internal/dom/rewrite/RewriteRuntimeException.java;1;0;2;1;0;0;0;2;0;1;2;4711;0;0;1;0;0;2;2;4711;0;4802;2;1;
/org.eclipse.ui.workbench/Eclipse UI/org/eclipse/ui/internal/progress/BooleanJobCompletionListener.java;1;0;1;1;0;0;0;1;0;0;1;532;0;0;1;0;0;1;1;532;0;532;1;1;
/org.eclipse.text/src/org/eclipse/jface/text/BadPositionCategoryException.java;1;0;1;1;1;1;1;0;4;0;0;6298;4;4;1;0;0;0;1;6298;0;6298;1;1;
/org.eclipse.swt/Eclipse SWT/common/org/eclipse/swt/internal/image/WinICOFileFormat.java;2;1;4;1;2;2;2;2;38;0;1;4245;69;69;2;1;0;2;4;4245;1;6352;3;2;
/org.eclipse.jdt.core.tests.model/workspace/Converter/src/test0152/Test.java;1;0;1;1;0;0;0;1;0;0;1;3714;0;0;1;0;0;1;1;3714;0;3714;1;1;
/org.eclipse.core.resources/src/org/eclipse/core/internal/watson/IDeltaFilter.java;1;0;2;1;2;1;2;0;22;0;0;5146;22;22;2;0;1;0;2;5146;1;5146;1;1;
/org.eclipse.jdt.core.tests.model/workspace/Converter/test0509/A.java;1;0;2;1;0;0;0;2;0;1;2;3009;0;0;1;0;0;2;2;3009;0;3714;2;1;
/org.eclipse.update.core/src/org/eclipse/update/core/FeatureContentProvider.java;3;2;15;2;5;4;5;10;1479;4;7;890;1614;1614;4;3;1;10;15;3089;4;6336;11;3;
/org.eclipse.ui.workbench/Eclipse UI/org/eclipse/ui/internal/PartListenerList2.java;2;1;2;1;2;2;2;0;48;0;0;5339;50;50;1;0;0;0;2;5339;0;6338;2;2;
/org.eclipse.ui.workbench/Eclipse UI/org/eclipse/ui/internal/commands/KeyBindingNode.java;1;0;18;1;0;0;0;18;363;2;13;1374;1325;1325;2;5;0;18;18;1400;5;2562;13;1;
/org.eclipse.ant.ui/Ant Tools Support/org/eclipse/ant/internal/ui/preferences/GlobalClasspathEntries.java;1;0;7;1;1;1;1;6;43;1;6;2182;87;87;1;0;0;6;7;2182;0;6336;7;1;
/org.eclipse.jdt.core.tests.model/workspace/Formatter/test056/A_in.java;1;0;1;1;0;0;0;1;0;0;1;2425;0;0;1;0;0;1;1;2425;0;2425;1;1;
/org.eclipse.ui.externaltools/Ant Editor/org/eclipse/ui/externaltools/internal/ant/dtd/util/IValueHolder.java;1;0;1;1;0;0;0;1;0;0;1;282;0;0;1;0;0;1;1;282;0;282;1;1;
/org.eclipse.jdt.ui/core refactoring/org/eclipse/jdt/internal/corext/refactoring/rename/RenameVirtualMethodProcessor.java;4;1;15;2;3;3;3;12;50;2;11;1125;158;158;2;1;0;12;15;1667;1;6340;14;4;
/org.eclipse.jdt.ui/core refactoring/org/eclipse/jdt/internal/corext/refactoring/participants/xml/ExpressionConverter.java;1;0;2;1;0;0;0;2;0;1;2;4091;0;0;1;0;0;2;2;4091;0;4108;2;1;
/org.eclipse.jdt.debug.ui/ui/org/eclipse/jdt/internal/debug/ui/WatchExpressionDialog.java;1;0;1;1;0;0;0;1;0;0;1;1516;0;0;1;0;0;1;1;1516;0;1516;1;1;
/org.eclipse.ui.ide/src/org/eclipse/ui/dialogs/ProjectLocationMoveDialog.java;2;0;3;1;0;0;0;3;18;1;3;1511;18;18;1;0;0;3;3;1511;0;2263;3;2;
/org.eclipse.osgi/core/adaptor/org/eclipse/osgi/framework/adaptor/BundleWatcher.java;2;1;4;1;3;3;3;1;7;0;1;5085;14;14;1;0;0;1;4;5085;0;6337;4;2;
/org.eclipse.jdt.ui.tests.refactoring/test cases/org/eclipse/jdt/ui/tests/actions/SourceReferenceTestUtil.java;1;0;3;1;0;0;0;3;2;1;3;457;6;6;1;0;0;3;3;457;0;1111;3;1;
/org.eclipse.update.core/src/org/eclipse/update/internal/core/ContentConsumer.java;1;0;1;1;0;0;0;1;2;0;1;890;2;2;1;0;0;1;1;890;0;890;1;1;
/org.eclipse.core.resources/src/org/eclipse/core/internal/dtree/NoDataDeltaNode.java;1;0;2;1;2;1;2;0;200;0;0;5146;200;200;2;0;1;0;2;5146;1;5146;1;1;
/org.eclipse.jdt.ui/ui/org/eclipse/jdt/internal/ui/text/JavaPresentationReconciler.java;1;0;1;1;1;1;1;0;0;0;0;5272;0;0;1;0;0;0;1;5272;0;5272;1;1;
/org.eclipse.ui.externaltools/Ant Tools Support/org/eclipse/ui/externaltools/internal/ant/view/elements/AntViewElementsMessages.java;1;0;1;1;0;0;0;1;0;0;1;282;0;0;1;0;0;1;1;282;0;282;1;1;
/org.eclipse.ui.views/src/org/eclipse/ui/views/markers/internal/DialogMarkerProperties.java;2;0;2;1;0;0;0;2;0;1;2;755;0;0;1;0;0;2;2;755;0;2738;2;2;
/org.eclipse.jdt.ui/core refactoring/org/eclipse/ltk/refactoring/core/IDynamicValidationStateChange.java;1;0;3;1;0;0;0;3;10;1;3;3708;10;10;1;0;0;3;3;3708;0;4510;3;1;
/org.eclipse.debug.ui/ui/org/eclipse/debug/internal/ui/launchVariables/SpecificFolderResourceComponent.java;2;0;3;1;0;0;0;3;5;1;3;647;5;5;1;0;0;3;3;647;0;773;3;2;
/org.eclipse.ui.cheatsheets/src/org/eclipse/ui/internal/cheatsheets/data/ItemWithSubItems.java;1;0;2;1;1;1;1;1;0;0;1;4662;0;0;1;0;0;1;2;4662;0;5189;2;1;
/org.eclipse.jdt.ui.tests/ui/org/eclipse/jdt/ui/tests/text/ExclusivePositionUpdaterTest.java;1;0;2;1;0;0;0;2;0;1;2;3030;0;0;1;0;0;2;2;3030;0;4210;2;1;
/org.eclipse.ui.cheatsheets/src/org/eclipse/ui/internal/cheatsheets/dialogs/CheatSheetSelectionDialog.java;2;0;4;1;1;1;1;3;17;1;3;4428;22;22;1;0;0;3;4;4428;0;5759;4;2;
/org.eclipse.team.cvs.ui/src/org/eclipse/team/internal/ccvs/ui/model/GroupedByVersionCategory.java;1;0;1;1;0;0;0;1;2;0;1;990;2;2;1;0;0;1;1;990;0;990;1;1;
/org.eclipse.pde.ui/src_Forms/org/eclipse/pde/internal/ui/neweditor/PDEMultiPageContentOutline.java;2;1;5;1;3;3;3;2;13;1;2;3795;17;17;1;0;0;2;5;3795;0;5431;5;2;
/org.eclipse.jdt.ui.tests.refactoring/resources/ExtractMethodWorkSpace/ExtractMethodTests/locals_out/A_test500.java;1;0;2;1;0;0;0;2;4;1;2;130;5;5;1;0;0;2;2;130;0;844;2;1;
/org.eclipse.jdt.core.tests.model/workspace/Formatter/test379/A_out.java;1;0;2;1;0;0;0;2;1;1;2;3146;1;1;1;0;0;2;2;3146;0;3172;2;1;
/org.eclipse.ui.forms.examples/src/org/eclipse/ui/forms/examples/internal/rcp/NamedObject.java;1;0;2;1;1;1;1;1;19;0;1;4075;19;19;1;0;0;1;2;4075;0;5781;2;1;
/org.eclipse.ui.externaltools/Ant Editor/org/eclipse/ui/externaltools/internal/ant/editor/text/IAntEditorColorConstants.java;1;0;2;1;0;0;0;2;12;1;2;178;12;12;1;0;0;2;2;178;0;282;2;1;
/org.eclipse.ui.intro/src/org/eclipse/ui/internal/intro/impl/swt/PageWidgetFactory.java;1;5;11;1;11;7;11;0;118;0;0;5726;206;206;5;0;4;0;11;5760;4;6284;7;1;
/org.eclipse.ui.editors/src/org/eclipse/ui/texteditor/DefaultMarkerAnnotationAccess.java;3;1;13;1;4;4;4;9;270;2;8;1983;594;594;2;1;0;9;13;3086;1;6334;12;3;
/org.eclipse.jdt.debug.tests/tests/org/eclipse/jdt/debug/tests/eval/NestedTypeFieldValue_155.java;1;0;1;1;0;0;0;1;102;0;1;1274;102;102;1;0;0;1;1;1274;0;1274;1;1;
/org.eclipse.jdt.core/model/org/eclipse/jdt/core/util/IStackMapFrame.java;1;0;1;1;0;0;0;1;0;0;1;3791;0;0;1;0;0;1;1;3791;0;3791;1;1;
/org.eclipse.team.ui/src/org/eclipse/team/internal/ui/sync/actions/SyncViewerSubscriberListActions.java;2;0;9;1;0;0;0;9;138;1;9;519;193;193;1;0;0;9;9;519;0;2632;9;2;
/org.eclipse.update.core/src/org/eclipse/update/internal/core/SiteFilePluginContentConsumer.java;3;0;6;1;2;1;2;4;48;1;4;890;98;98;2;0;1;4;6;5664;1;5664;5;3;
/org.eclipse.ui.editors/src/org/eclipse/ui/internal/editors/quickdiff/RevertSelectionAction.java;2;0;3;1;0;0;0;3;1;1;3;1214;1;1;1;0;0;3;3;1214;0;1644;3;2;
/org.eclipse.jdt.debug.ui/ui/org/eclipse/jdt/internal/debug/ui/actions/AbstractManageBreakpointActionDelegate.java;3;0;8;2;0;0;0;8;58;2;6;1739;136;136;2;2;0;8;8;1739;2;4494;6;3;
/org.eclipse.jdt.debug.tests/tests/org/eclipse/jdt/debug/tests/eval/ArrayValueTests.java;1;0;1;1;0;0;0;1;36;0;1;1274;36;36;1;0;0;1;1;1274;0;1274;1;1;
/org.eclipse.jdt.core/model/org/eclipse/jdt/internal/core/util/CodeSnippetParsingUtil.java;1;0;6;1;0;0;0;6;71;2;5;3611;168;168;2;1;0;6;6;3861;1;3886;5;1;
/org.eclipse.swt.examples/src/org/eclipse/swt/examples/texteditor/TextEditor.java;1;0;1;1;0;0;0;1;2;0;1;723;2;2;1;0;0;1;1;723;0;723;1;1;
/org.eclipse.help/src/org/eclipse/help/internal/browser/MozillaBrowserAdapter.java;1;0;1;1;0;0;0;1;0;0;1;2732;0;0;1;0;0;1;1;2732;0;2732;1;1;
/org.eclipse.jdt.core.tests.model/workspace/Formatter/test128/A_in.java;1;0;1;1;0;0;0;1;0;0;1;2425;0;0;1;0;0;1;1;2425;0;2425;1;1;
/org.eclipse.pde.ui/src_Forms/org/eclipse/pde/internal/ui/neweditor/schema/ReferencePropertySource.java;1;0;2;1;0;0;0;2;0;1;2;4856;0;0;1;0;0;2;2;4856;0;4879;2;1;
/org.eclipse.core.tests.resources/src/org/eclipse/core/tests/internal/localstore/SafeFileInputOutputStreamTest.java;1;0;2;1;2;1;2;0;320;0;0;5147;320;320;2;0;1;0;2;5147;1;5147;1;1;
/org.eclipse.swt.tests/JUnit Tests/org/eclipse/swt/tests/junit/Test_org_eclipse_swt_widgets_ProgressBar.java;1;0;1;1;0;0;0;1;234;0;1;2123;234;234;1;0;0;1;1;2123;0;2123;1;1;
/org.eclipse.jdt.ui.tests.refactoring/resources/Copy/test_method_yes_cu_with_main_type/in/C.java;1;0;1;1;0;0;0;1;0;0;1;685;0;0;1;0;0;1;1;685;0;685;1;1;
/org.eclipse.ui.workbench/Eclipse UI/org/eclipse/ui/internal/dialogs/ResourceSorter.java;1;0;1;1;0;0;0;1;0;0;1;2737;0;0;1;0;0;1;1;2737;0;2737;1;1;
/org.eclipse.ant.ui/Ant Tools Support/org/eclipse/ant/ui/internal/model/AntUtil.java;1;0;12;1;0;0;0;12;87;2;11;250;230;230;2;1;0;12;12;1537;1;1811;11;1;
/org.eclipse.help.webapp/src_servlets/org/eclipse/help/internal/webapp/servlet/FilterHTMLHeadOutputStream.java;1;1;2;1;2;2;2;0;31;0;0;5827;37;37;1;0;0;0;2;5827;0;6337;2;1;
/org.eclipse.jdt.core.tests.model/workspace/Converter/src/test0412/A.java;1;0;1;1;0;0;0;1;0;0;1;3714;0;0;1;0;0;1;1;3714;0;3714;1;1;
/org.eclipse.core.runtime/src/org/eclipse/core/runtime/content/IContentDescriber.java;2;1;8;1;4;4;4;4;33;1;4;4574;115;115;1;0;0;4;8;4574;0;5619;8;2;
/org.eclipse.jdt.core/search/org/eclipse/jdt/internal/core/search/matching/DeclarationOfAccessedFieldsPattern.java;3;0;9;1;1;1;1;8;94;1;8;91;196;196;1;0;0;8;9;91;0;5207;9;3;
/org.eclipse.team.tests.cvs.core/src/org/eclipse/team/tests/ccvs/ui/DummyPromptCondition.java;1;0;2;1;0;0;0;2;2;1;2;990;2;2;1;0;0;2;2;990;0;2632;2;1;
/org.eclipse.jdt.ui/ui/org/eclipse/jdt/internal/ui/text/link/LinkedUIPainter.java;1;0;6;1;0;0;0;6;462;1;6;2838;635;635;1;0;0;6;6;2838;0;4214;6;1;
/org.eclipse.jdt.ui.tests.refactoring/resources/RenamePackage/testImportFromMultiRoots2/out/srcPrg/q/A.java;1;0;2;1;0;0;0;2;5;1;2;3219;5;5;1;0;0;2;2;3219;0;4105;2;1;
/org.eclipse.jdt.debug.ui/ui/org/eclipse/jdt/debug/ui/IJavaVariablesContentProvider.java;1;0;3;1;0;0;0;3;5;1;3;670;5;5;1;0;0;3;3;670;0;861;3;1;
/org.eclipse.jdt.core.tests.model/workspace/Converter/test0201/Test.java;1;0;1;1;0;0;0;1;0;0;1;3714;0;0;1;0;0;1;1;3714;0;3714;1;1;
/org.eclipse.jdt.ui/core extension/org/eclipse/jdt/internal/corext/template/SimpleTemplateVariable.java;1;0;1;1;0;0;0;1;0;0;1;4258;0;0;1;0;0;1;1;4258;0;4258;1;1;
/org.eclipse.jdt.ui/core refactoring/org/eclipse/jdt/internal/corext/refactoring/reorg/CopyRefactoring2.java;1;0;2;1;0;0;0;2;0;1;2;1114;0;0;1;0;0;2;2;1114;0;1126;2;1;
/org.eclipse.ant.ui/Ant Tools Support/org/eclipse/ant/ui/internal/launchConfigurations/AntMainTab.java;3;0;11;2;0;0;0;11;11;2;9;250;38;38;2;2;0;11;11;321;2;1811;9;3;
/org.eclipse.swt/Eclipse SWT Mozilla/common/org/eclipse/swt/internal/mozilla/nsIWebProgress.java;1;0;2;1;0;0;0;2;4;1;2;1654;4;4;1;0;0;2;2;1654;0;2568;2;1;
/org.eclipse.jdt.ui/ui/org/eclipse/jdt/internal/ui/search/NameSorter.java;1;1;3;1;2;2;2;1;4;0;1;3711;8;8;1;0;0;1;3;3711;0;5438;3;1;
/org.eclipse.jdt.core.tests.model/src/org/eclipse/jdt/core/tests/model/CodeCorrectionTests.java;2;1;5;1;3;3;3;2;49;1;2;2722;60;60;1;0;0;2;5;2722;0;5853;5;2;
/org.eclipse.ui.workbench/Eclipse UI/org/eclipse/ui/internal/WorkbenchActivitiesCommandsAndRoles.java;3;0;21;2;0;0;0;21;795;4;11;2492;1822;1822;4;10;0;21;21;2562;10;3109;11;3;
/org.eclipse.ui.workbench/Eclipse UI/org/eclipse/ui/internal/EditorActionBars.java;4;1;10;2;2;2;2;8;626;2;7;3220;974;974;2;1;0;8;10;3963;1;6338;9;4;
/org.eclipse.pde.core/src/org/eclipse/pde/internal/core/search/PluginSearchScope.java;1;0;5;1;2;1;2;3;15;1;3;368;30;30;2;0;1;3;5;6336;1;6336;4;1;
/org.eclipse.team.ui/src/org/eclipse/team/internal/ui/synchronize/actions/RemoveSynchronizeParticipantAction.java;2;1;6;1;4;4;4;2;81;1;2;3972;149;149;1;0;0;2;6;3972;0;6337;6;2;
/org.eclipse.jdt.ui.tests.refactoring/test cases/org/eclipse/jdt/ui/tests/refactoring/infra/MockClipboard.java;2;0;3;1;1;1;1;2;2;0;1;1311;3;3;2;1;0;2;3;1311;1;6340;2;2;
/org.eclipse.jdt.core.tests.model/workspace/Converter/src/test0336/SorterTest.java;1;0;1;1;0;0;0;1;0;0;1;3714;0;0;1;0;0;1;1;3714;0;3714;1;1;
/org.eclipse.swt/Eclipse SWT Mozilla/common/org/eclipse/swt/internal/mozilla/nsILoadGroup.java;1;0;1;1;0;0;0;1;0;0;1;2663;0;0;1;0;0;1;1;2663;0;2663;1;1;
/org.eclipse.compare.examples.xml/src/org/eclipse/compare/examples/xml/AttributesImpl.java;1;0;2;1;0;0;0;2;2;1;2;1106;2;2;1;0;0;2;2;1106;0;3938;2;1;
/org.eclipse.jdt.core/dom/org/eclipse/jdt/core/dom/TagElement.java;4;1;13;1;2;2;2;11;84;1;11;3683;247;247;1;0;0;11;13;3683;0;5871;13;4;
/org.eclipse.update.configurator/src/org/eclipse/update/internal/configurator/UpdateURLHandler.java;1;1;2;1;2;2;2;0;0;0;0;5431;0;0;1;0;0;0;2;5431;0;5448;2;1;
/org.eclipse.jdt.core.tests.model/workspace/Formatter/test022/A_out.java;1;0;1;1;0;0;0;1;0;0;1;2425;0;0;1;0;0;1;1;2425;0;2425;1;1;
/org.eclipse.jdt.core.tests.model/workspace/Converter/src/test0052/Test.java;1;0;1;1;0;0;0;1;0;0;1;3714;0;0;1;0;0;1;1;3714;0;3714;1;1;
/org.eclipse.swt.graphics.text/Eclipse SWT/emulated/org/eclipse/swt/graphics/text/LogicalAttributes.java;2;0;2;1;0;0;0;2;0;1;2;3890;0;0;1;0;0;2;2;3890;0;4194;2;2;
/org.eclipse.compare.examples.xml/src/org/eclipse/compare/examples/xml/ui/MessageLine.java;1;0;2;1;0;0;0;2;2;1;2;1106;2;2;1;0;0;2;2;1106;0;3938;2;1;
/org.eclipse.jdt.ui/core refactoring/org/eclipse/jdt/internal/corext/refactoring/base/IChangeExceptionHandler.java;1;0;2;1;0;0;0;2;2;1;2;3930;2;2;1;0;0;2;2;3930;0;4575;2;1;
/org.eclipse.ant.tests.ui/Ant Editor Tests/org/eclipse/ant/tests/ui/editor/CodeCompletionTest.java;1;2;35;1;7;6;7;28;430;4;18;1811;1347;1347;4;10;1;28;35;4604;11;6019;24;1;
/org.eclipse.jdt.ui/ui/org/eclipse/jdt/internal/ui/typehierarchy/SubTypeHierarchyViewer.java;2;0;3;1;1;1;1;2;20;1;2;505;24;24;1;0;0;2;3;505;0;6340;3;2;
/org.eclipse.jdt.core/model/org/eclipse/jdt/internal/core/SourceRefElementInfo.java;1;0;1;1;0;0;0;1;2;0;1;3560;2;2;1;0;0;1;1;3560;0;3560;1;1;
/org.eclipse.jdt.core.tests.model/workspace/Converter/test0129/Test.java;1;0;1;1;0;0;0;1;0;0;1;3714;0;0;1;0;0;1;1;3714;0;3714;1;1;
/org.eclipse.ui.forms/src/org/eclipse/ui/forms/events/IFormEntryListener.java;1;0;3;1;0;0;0;3;4;1;3;4068;4;4;1;0;0;3;3;4068;0;4260;3;1;
/org.eclipse.update.ui.win32/src/org/eclipse/welcome/internal/portal/IPortalSection.java;1;0;2;1;0;0;0;2;0;1;2;912;0;0;1;0;0;2;2;912;0;925;2;1;
/org.eclipse.jdt.core/model/org/eclipse/jdt/core/eval/IGlobalVariable.java;2;0;2;1;0;0;0;2;2;1;2;3560;4;4;1;0;0;2;2;3560;0;3976;2;2;
/org.eclipse.core.resources/src/org/eclipse/core/internal/events/NodeIDMap.java;1;0;1;1;1;1;1;0;472;0;0;5146;472;472;1;0;0;0;1;5146;0;5146;1;1;
/org.eclipse.ui.forms/src/org/eclipse/ui/internal/forms/widgets/Paragraph.java;1;0;2;1;1;1;1;1;4;0;1;5044;4;4;1;0;0;1;2;5044;0;6336;2;1;
/org.eclipse.core.tests.runtime/src/org/eclipse/core/tests/internal/plugins/SoftPrereqTest_6.java;1;0;1;1;0;0;0;1;0;0;1;3014;0;0;1;0;0;1;1;3014;0;3014;1;1;
/org.eclipse.jdt.ui.tests.refactoring/resources/ExtractMethodWorkSpace/ExtractMethodTests/locals_in/A_test504.java;1;0;1;1;0;0;0;1;2;0;1;844;2;2;1;0;0;1;1;844;0;844;1;1;
/org.eclipse.jdt.core.tests.model/workspace/Converter/test0078/Test.java;1;0;1;1;0;0;0;1;0;0;1;3714;0;0;1;0;0;1;1;3714;0;3714;1;1;
/org.eclipse.team.ftp/src/org/eclipse/team/internal/ftp/deployment/BatchingLock.java;1;0;1;1;0;0;0;1;0;0;1;3244;0;0;1;0;0;1;1;3244;0;3244;1;1;
/org.eclipse.help.ui.win32/src/org/eclipse/help/ui/internal/browser/win32/IEBrowserAdapter.java;1;0;5;1;0;0;0;5;49;2;4;1156;86;86;2;1;0;5;5;1156;1;2898;4;1;
/org.eclipse.jdt.ui.tests.refactoring/resources/InlineMethodWorkspace/TestCases/receiver_out/TestExpressionTwoImplicitReceiver.java;1;0;1;1;0;0;0;1;4;0;1;845;4;4;1;0;0;1;1;845;0;845;1;1;
/org.eclipse.jdt.debug.tests/tests/org/eclipse/jdt/debug/tests/eval/TestsArrays.java;1;0;1;1;0;0;0;1;16;0;1;1274;16;16;1;0;0;1;1;1274;0;1274;1;1;
/org.eclipse.ltk.core.refactoring.tests/src/org/eclipse/ltk/core/refactoring/tests/participants/ElementRenameProcessor.java;1;0;1;1;1;1;1;0;0;0;0;6072;0;0;1;0;0;0;1;6072;0;6072;1;1;
/org.eclipse.jdt.core.tests.model/workspace/Converter/test0365/A.java;1;0;1;1;0;0;0;1;0;0;1;3714;0;0;1;0;0;1;1;3714;0;3714;1;1;
/org.eclipse.jdt.ui/core refactoring/org/eclipse/jdt/internal/corext/refactoring/ExceptionInfo.java;3;0;3;1;1;1;1;2;8;1;2;2562;10;10;1;0;0;2;3;2562;0;6340;3;3;
/org.eclipse.jdt.ui.examples.javafamily/src/org/eclipse/jdt/internal/ui/search2/JavaSearchResultCollector.java;1;0;2;1;0;0;0;2;5;1;2;1033;5;5;1;0;0;2;2;1033;0;1255;2;1;
/org.eclipse.pde.ui/src_Forms/org/eclipse/pde/internal/ui/model/plugin/PluginDocumentNodeFactory.java;3;1;9;1;3;3;3;6;45;1;6;4438;106;106;1;0;0;6;9;4438;0;6336;9;3;
/org.eclipse.debug.core/core/org/eclipse/debug/internal/core/RuntimeProcess.java;2;0;4;1;0;0;0;4;48;1;4;978;78;78;1;0;0;4;4;978;0;1932;4;2;
/org.eclipse.jdt.core/dom/org/eclipse/jdt/core/dom/QualifiedName.java;4;1;12;1;2;2;2;10;109;1;10;1114;172;172;1;0;0;10;12;1114;0;5272;12;4;
/org.eclipse.team.cvs.core/src/org/eclipse/team/internal/ccvs/core/syncinfo/SyncBytesSubscriberResourceTree.java;1;0;1;1;0;0;0;1;0;0;1;3430;0;0;1;0;0;1;1;3430;0;3430;1;1;
/org.eclipse.ui.ide/src/org/eclipse/ui/internal/model/WorkbenchFile.java;2;0;6;2;0;0;0;6;6;2;5;1511;14;14;2;1;0;6;6;1536;1;2263;5;2;
/org.eclipse.update.core/src/org/eclipse/update/core/Site.java;3;2;8;1;5;4;5;3;20;1;3;0;71;71;2;0;1;3;8;5664;1;6336;7;3;
/org.eclipse.update.core/src/org/eclipse/update/core/model/Site.java;1;0;1;1;0;0;0;1;0;0;1;2634;0;0;1;0;0;1;1;2634;0;2634;1;1;
/org.eclipse.jdt.ui.tests.refactoring/resources/TypeConstraints/A_testConstraints13.java;1;0;1;1;0;0;0;1;0;0;1;65;0;0;1;0;0;1;1;65;0;65;1;1;
/org.eclipse.jdt.ui.tests.refactoring/resources/PushDown/test22/out/A.java;1;0;1;1;0;0;0;1;1;0;1;1312;1;1;1;0;0;1;1;1312;0;1312;1;1;
/org.eclipse.update.tests.core/src/org/eclipse/update/tests/regularInstall/TestGetFeature.java;1;0;2;1;1;1;1;1;4;0;1;4928;8;8;1;0;0;1;2;4928;0;6336;2;1;
/org.eclipse.jdt.ui/core refactoring/org/eclipse/ltk/core/refactoring/participants/CheckConditionsContext.java;1;0;3;1;0;0;0;3;23;1;3;4654;23;23;1;0;0;3;3;4654;0;4864;3;1;
/org.eclipse.pde.ui/src/org/eclipse/pde/internal/ui/codegen/AttributeClassCodeGenerator.java;1;0;4;1;1;1;1;3;25;1;3;651;44;44;1;0;0;3;4;651;0;5431;4;1;
/org.eclipse.ui.ide/src/org/eclipse/ui/internal/ide/LinkedResourceDecorator.java;3;1;3;1;2;2;2;1;8;0;1;2264;10;10;1;0;0;1;3;2264;0;6338;3;3;
/org.eclipse.ui.workbench/Eclipse UI/org/eclipse/ui/activities/service/IActivityService.java;1;0;3;1;0;0;0;3;6;1;3;2896;6;6;1;0;0;3;3;2896;0;3066;3;1;
/org.eclipse.jdt.ui.tests.refactoring/resources/ExtractMethodWorkSpace/ExtractMethodTests/validSelection_in/A_test360.java;1;0;2;1;0;0;0;2;4;1;2;130;8;8;1;0;0;2;2;130;0;844;2;1;
/org.eclipse.debug.ui/ui/org/eclipse/debug/internal/ui/InstructionPointerAnnotation.java;2;0;8;2;0;0;0;8;65;2;6;1157;180;180;2;2;0;8;8;2947;2;3596;6;2;
/org.eclipse.core.runtime.osgi/src/org/eclipse/core/runtime/jobs/LockListener.java;1;0;2;1;0;0;0;2;6;1;2;3013;6;6;1;0;0;2;2;3013;0;3030;2;1;
/org.eclipse.pde.core/src/org/eclipse/pde/internal/core/search/PluginSearchOperation.java;2;1;5;1;2;2;2;3;15;1;3;368;24;24;1;0;0;3;5;368;0;6336;5;2;
/org.eclipse.jdt.ui.tests.refactoring/resources/ExtractMethodWorkSpace/ExtractMethodTests/locals_out/A_test524.java;1;0;2;1;0;0;0;2;6;1;2;130;8;8;1;0;0;2;2;130;0;844;2;1;
/org.eclipse.swt.tests/JUnit Tests/org/eclipse/swt/tests/junit/Test_org_eclipse_swt_browser_TitleListener.java;2;0;2;1;1;1;1;1;4;0;1;3712;4;4;1;0;0;1;2;3712;0;6352;2;2;
/org.eclipse.ui.tutorials.rcp.part1/src/org/eclipse/ui/tutorials/rcp/part1/RcpPerspective.java;1;0;1;1;1;1;1;0;0;0;0;5118;0;0;1;0;0;0;1;5118;0;5118;1;1;
/org.eclipse.jdt.ui/core refactoring/org/eclipse/jdt/internal/corext/refactoring/participants/xml/FileExtender.java;1;0;4;1;0;0;0;4;11;1;4;2546;13;13;1;0;0;4;4;2546;0;4941;4;1;
/org.eclipse.jdt.ui.tests.refactoring/resources/MoveMembers/test33/out/B.java;1;0;1;1;0;0;0;1;0;0;1;1856;0;0;1;0;0;1;1;1856;0;1856;1;1;
/org.eclipse.ui.workbench/Eclipse UI/org/eclipse/ui/internal/commands/IContextBindingDefinition.java;1;0;2;1;0;0;0;2;34;1;2;1422;34;34;1;0;0;2;2;1422;0;3128;2;1;
/org.eclipse.jdt.core/compiler/org/eclipse/jdt/internal/compiler/ast/AnonymousLocalTypeDeclaration.java;1;0;4;1;0;0;0;4;11;1;4;62;16;16;1;0;0;4;4;62;0;2974;4;1;
/org.eclipse.pde.ui/src/org/eclipse/pde/internal/ui/editor/manifest/ExtensionPointSection.java;1;0;2;1;1;1;1;1;3;0;1;1111;3;3;1;0;0;1;2;1111;0;5431;2;1;
/org.eclipse.jdt.core/model/org/eclipse/jdt/core/IImportContainer.java;1;0;1;1;0;0;0;1;2;0;1;3560;2;2;1;0;0;1;1;3560;0;3560;1;1;
/org.eclipse.jdt.core/model/org/eclipse/jdt/internal/core/IPathRequestor.java;1;0;2;1;0;0;0;2;2;1;2;2097;4;4;1;0;0;2;2;2097;0;3560;2;1;
/org.eclipse.swt/Eclipse SWT/carbon2/org/eclipse/swt/widgets/TableColumn.java;1;0;1;1;0;0;0;1;0;0;1;231;0;0;1;0;0;1;1;231;0;231;1;1;
/org.eclipse.ui.workbench/Eclipse UI/org/eclipse/ui/internal/commands/old/ImageBindingElement.java;1;0;1;1;0;0;0;1;0;0;1;1321;0;0;1;0;0;1;1;1321;0;1321;1;1;
/org.eclipse.webdav/src/client/org/eclipse/webdav/client/URLTable.java;1;0;2;1;2;1;2;0;101;0;0;5151;101;101;2;0;1;0;2;5151;1;5151;1;1;
/org.eclipse.jdt.ui.tests/ui/org/eclipse/jdt/ui/tests/astrewrite/ASTRewritingCollapseTest.java;2;1;8;1;3;3;3;5;20;1;5;3611;74;74;1;0;0;5;8;3611;0;6096;8;2;
/org.eclipse.jdt.ui.tests.refactoring/resources/Paste/testPastingTypedResources0/in/A.java;1;0;1;1;0;0;0;1;0;0;1;1646;0;0;1;0;0;1;1;1646;0;1646;1;1;
/org.eclipse.jdt.ui/ui/org/eclipse/jdt/internal/ui/workingsets/EditWorkingSetAction.java;1;0;2;1;1;1;1;1;3;0;1;1350;5;5;1;0;0;1;2;1350;0;6340;2;1;
/org.eclipse.jdt.core/model/org/eclipse/jdt/internal/core/builder/BatchImageBuilder.java;4;0;15;2;1;1;1;14;48;2;11;223;147;147;2;3;0;14;15;223;3;5464;12;4;
/org.eclipse.jface.text/src/org/eclipse/jface/text/IPainter.java;2;1;2;1;2;2;2;0;60;0;0;6340;62;62;1;0;0;0;2;6340;0;6359;2;2;
/org.eclipse.core.boot/src/org/eclipse/core/internal/boot/OSGiBootLoader.java;2;0;2;1;0;0;0;2;0;1;2;3013;0;0;1;0;0;2;2;3013;0;3593;2;2;
/org.eclipse.compare/compare/org/eclipse/compare/HistoryItem.java;1;1;6;1;2;2;2;4;14;1;4;2898;40;40;1;0;0;4;6;2898;0;6009;6;1;
/org.eclipse.swt.examples/src/org/eclipse/swt/examples/controlexample/TreeTab.java;2;1;5;1;2;2;2;3;146;1;3;1560;224;224;1;0;0;3;5;1560;0;6352;5;2;
/org.eclipse.update.core/srcnew/org/eclipse/update/operations/IUpdateModelChangedListener.java;1;0;2;1;0;0;0;2;0;1;2;757;0;0;1;0;0;2;2;757;0;825;2;1;
/org.eclipse.ui.workbench/Eclipse UI/org/eclipse/ui/commands/IHandler.java;2;1;12;1;2;2;2;10;86;3;8;1065;275;275;3;2;0;10;12;4955;2;5444;10;2;
/org.eclipse.jdt.core.tests.model/workspace/Converter/src/test0290/Test.java;1;0;1;1;0;0;0;1;0;0;1;3714;0;0;1;0;0;1;1;3714;0;3714;1;1;
/org.eclipse.ui.ide/extensions/org/eclipse/ui/actions/WorkspaceAction.java;4;1;8;1;2;2;2;6;588;2;5;2263;629;629;2;1;0;6;8;4365;1;6338;7;4;
/org.eclipse.ui.workbench/Eclipse UI/org/eclipse/ui/part/PageBookView.java;3;1;7;1;5;5;5;2;134;1;2;4131;169;169;1;0;0;2;7;4131;0;6338;7;3;
/org.eclipse.jdt.core.tests.model/workspace/Formatter/test333/A_in.java;1;0;1;1;0;0;0;1;0;0;1;2689;0;0;1;0;0;1;1;2689;0;2689;1;1;
/org.eclipse.help.base/src/org/eclipse/help/internal/search/SearchHit.java;1;1;3;1;2;2;2;1;18;0;1;1740;24;24;1;0;0;1;3;1740;0;6337;3;1;
/org.eclipse.pde.build/src/org/eclipse/pde/internal/build/site/PluginRegistryConverter.java;2;1;5;1;3;3;3;2;96;1;2;4175;161;161;1;0;0;2;5;4175;0;6228;5;2;
/org.eclipse.ui.workbench/Eclipse UI/org/eclipse/ui/internal/csm/commands/KeyConfigurationEvent.java;1;0;3;1;0;0;0;3;8;2;2;2549;8;8;2;1;0;3;3;2549;1;2562;2;1;
/org.eclipse.pde.runtime/src/org/eclipse/pde/internal/runtime/registry/RegistryBrowserContentProvider.java;2;0;10;1;1;1;1;9;290;1;9;924;620;620;1;0;0;9;10;924;0;6336;10;2;
/org.eclipse.ui.workbench/Eclipse UI/org/eclipse/ui/roles/RoleNotDefinedException.java;1;0;2;1;0;0;0;2;0;1;2;2240;0;0;1;0;0;2;2;2240;0;2532;2;1;
/org.eclipse.jdt.core/compiler/org/eclipse/jdt/internal/compiler/codegen/ObjectCache.java;2;0;2;1;1;1;1;1;2;0;1;3560;4;4;1;0;0;1;2;3560;0;5916;2;2;
/org.eclipse.jdt.core/formatter/org/eclipse/jdt/internal/formatter/BinaryExpressionFragmentBuilder.java;3;3;16;1;4;2;4;12;181;2;11;535;579;579;3;1;2;12;16;5617;3;5635;13;3;
/org.eclipse.team.ui/src/org/eclipse/team/internal/ui/sync/sets/SyncSetInputFromSubscriber.java;1;0;4;1;0;0;0;4;47;1;4;1289;60;60;1;0;0;4;4;1289;0;2632;4;1;
/org.eclipse.ui.workbench/Eclipse UI/org/eclipse/ui/commands/internal/Persistence.java;1;0;2;1;0;0;0;2;0;1;2;786;0;0;1;0;0;2;2;786;0;956;2;1;
/org.eclipse.jdt.core/compiler/org/eclipse/jdt/internal/compiler/problem/ShouldNotImplement.java;2;0;2;1;0;0;0;2;8;1;2;1395;10;10;1;0;0;2;2;1395;0;3560;2;2;
/org.eclipse.jdt.core.tests.model/workspace/Converter/src/test0543/A.java;1;0;1;1;1;1;1;0;0;0;0;5313;0;0;1;0;0;0;1;5313;0;5313;1;1;
/org.eclipse.ui.ide/src/org/eclipse/ui/internal/dialogs/ProjectCapabilityPropertyPage.java;2;0;4;2;0;0;0;4;37;2;3;1526;37;37;2;1;0;4;4;1537;1;2263;3;2;
/org.eclipse.jdt.debug.ui/ui/org/eclipse/jdt/internal/debug/ui/launchConfigurations/ClasspathLabelProvider.java;1;0;3;1;0;0;0;3;13;0;1;2685;13;13;3;2;0;3;3;2685;2;2685;1;1;
/org.eclipse.swt/Eclipse SWT/gtk/org/eclipse/swt/graphics/Image.java;5;1;12;1;3;3;3;9;71;2;8;0;199;199;2;1;0;9;12;4248;1;6352;11;5;
/org.eclipse.jdt.ui/ui/org/eclipse/jdt/internal/ui/jarpackager/JarPackageWizard.java;2;0;3;1;1;1;1;2;21;1;2;394;28;28;1;0;0;2;3;394;0;6340;3;2;
/org.eclipse.jdt.ui/ui/org/eclipse/jdt/internal/ui/text/correction/SimilarElement.java;1;0;1;1;1;1;1;0;2;0;0;6340;2;2;1;0;0;0;1;6340;0;6340;1;1;
/org.eclipse.jdt.ui.tests.refactoring/resources/IntroduceFactory/positive/instanceContext_in.java;1;0;2;1;0;0;0;2;0;1;2;2846;0;0;1;0;0;2;2;2846;0;2862;2;1;
/org.eclipse.swt.opengl/common/org/eclipse/swt/opengl/GLU.java;1;0;1;1;0;0;0;1;0;0;1;1175;0;0;1;0;0;1;1;1175;0;1175;1;1;
/org.eclipse.jdt.ui/ui/org/eclipse/jdt/internal/ui/text/comment/ITextMeasurement.java;2;0;2;1;0;0;0;2;35;1;2;4365;35;35;1;0;0;2;2;4365;0;4420;2;2;
/org.eclipse.jdt.core.tests.compiler/src/org/eclipse/jdt/core/tests/compiler/parser/ExplicitConstructorInvocationSelectionTest.java;1;0;1;1;0;0;0;1;2;0;1;3560;2;2;1;0;0;1;1;3560;0;3560;1;1;
/org.eclipse.jdt.ui/ui refactoring/org/eclipse/jdt/internal/ui/refactoring/nls/PackageFragmentSelection.java;3;1;3;1;2;2;2;1;16;0;1;4930;22;22;1;0;0;1;3;4930;0;6340;3;3;
/org.eclipse.jdt.core.tests.model/workspace/Converter/src/test0062/Test.java;1;0;1;1;0;0;0;1;0;0;1;3714;0;0;1;0;0;1;1;3714;0;3714;1;1;
/org.eclipse.jdt.core.tests.model/workspace/Converter/src/test0180/Test.java;1;0;1;1;0;0;0;1;0;0;1;3714;0;0;1;0;0;1;1;3714;0;3714;1;1;
/org.eclipse.core.runtime/src/org/eclipse/core/runtime/ILogListener.java;2;1;6;1;2;2;2;4;66;1;4;3013;140;140;1;0;0;4;6;3013;0;6340;6;2;
/org.eclipse.ui.intro/src/org/eclipse/ui/intro/internal/util/Util.java;1;0;7;1;2;1;4;3;373;3;3;4429;689;689;3;0;3;5;7;5096;3;5110;4;1;
/org.eclipse.jdt.ui/ui/org/eclipse/jdt/internal/ui/JavaPluginImages.java;5;2;20;2;9;7;9;11;54;1;11;236;217;217;2;0;2;11;20;5199;2;6340;18;5;
/org.eclipse.jdt.core.tests.model/workspace/Formatter/test179/A_in.java;1;0;1;1;0;0;0;1;0;0;1;2425;0;0;1;0;0;1;1;2425;0;2425;1;1;
/org.eclipse.jdt.ui/core refactoring/org/eclipse/jdt/internal/corext/refactoring/structure/ReferenceFinderUtil.java;4;1;6;1;4;4;4;2;52;1;2;328;108;108;1;0;0;2;6;328;0;6340;6;4;
/org.eclipse.jdt.core.tests.model/workspace/Converter/test0490/B.java;1;0;2;1;0;0;0;2;0;1;2;1590;0;0;1;0;0;2;2;1590;0;3714;2;1;
/org.eclipse.team.ftp/src/org/eclipse/team/internal/ftp/deployment/SyncByteConverter.java;1;0;1;1;0;0;0;1;0;0;1;3221;0;0;1;0;0;1;1;3221;0;3221;1;1;
/org.eclipse.jface.text/src/org/eclipse/jface/text/rules/DefaultPartitioner.java;4;1;9;1;7;7;7;2;115;1;2;1521;287;287;1;0;0;2;9;1521;0;6358;9;4;
/org.eclipse.ui.examples.propertysheet/Eclipse UI Examples PropertySheet/org/eclipse/ui/examples/propertysheet/Address.java;1;0;1;1;0;0;0;1;2;0;1;2754;2;2;1;0;0;1;1;2754;0;2754;1;1;
/org.eclipse.update.configurator/src/org/eclipse/update/internal/configurator/ProductProvider.java;1;0;2;1;1;1;1;1;2;0;1;4138;2;2;1;0;0;1;2;4138;0;5519;2;1;
/org.eclipse.core.tools/src/org/eclipse/core/tools/BaseTextView.java;1;0;1;1;1;1;1;0;0;0;0;6302;0;0;1;0;0;0;1;6302;0;6302;1;1;
/org.eclipse.jdt.core.tests.model/workspace/Formatter/test203/A_in.java;1;0;1;1;0;0;0;1;0;0;1;2424;0;0;1;0;0;1;1;2424;0;2424;1;1;
/org.eclipse.pde.ui/src/org/eclipse/pde/internal/ui/wizards/imports/ShowTargetPlatformAction.java;2;1;3;1;3;3;3;0;16;0;0;5408;17;17;1;0;0;0;3;5408;0;5780;3;2;
/org.eclipse.jdt.debug.tests/tests/org/eclipse/jdt/debug/tests/eval/ByteAssignmentOperatorsTests.java;1;0;1;1;0;0;0;1;130;0;1;1274;130;130;1;0;0;1;1;1274;0;1274;1;1;
/org.eclipse.ui.workbench/Eclipse UI/org/eclipse/ui/internal/commands/ws/ICommandService.java;2;0;2;1;1;1;1;1;6;0;1;4953;6;6;1;0;0;1;2;4953;0;6338;2;2;
/org.eclipse.swt.tests/JUnit Tests/org/eclipse/swt/tests/junit/browser/Browser6.java;2;0;2;1;1;1;1;1;6;0;1;3712;6;6;1;0;0;1;2;3712;0;6352;2;2;
/org.eclipse.pde.runtime/src/org/eclipse/pde/internal/runtime/registry/PluginObjectAdapter.java;1;0;1;1;0;0;0;1;2;0;1;924;2;2;1;0;0;1;1;924;0;924;1;1;
/org.eclipse.ui.views/src/org/eclipse/ui/views/internal/markers/FieldDone.java;1;0;2;1;0;0;0;2;0;0;1;749;0;0;2;1;0;2;2;749;1;749;1;1;
/org.eclipse.ui.externaltools/Ant Editor/org/eclipse/ui/externaltools/internal/ant/editor/derived/HTML2TextReader.java;1;0;1;1;0;0;0;1;0;0;1;282;0;0;1;0;0;1;1;282;0;282;1;1;
/org.eclipse.osgi/eclipseAdaptor/src/org/eclipse/core/runtime/adaptor/Semaphore.java;4;2;5;2;4;3;4;1;7;0;1;3013;14;14;2;0;1;1;5;5113;1;6337;4;4;
/org.eclipse.team.core/src/org/eclipse/team/core/subscribers/helpers/SynchronizationCacheRefreshOperation.java;1;0;1;1;0;0;0;1;0;0;1;3461;0;0;1;0;0;1;1;3461;0;3461;1;1;
/org.eclipse.jdt.core/model/org/eclipse/jdt/internal/core/util/HandleFactory.java;4;1;23;1;3;3;3;20;291;2;19;1904;649;649;2;1;0;20;23;2097;1;5728;22;4;
/org.eclipse.ui.ide/src/org/eclipse/ui/wizards/datatransfer/IDataTransferHelpContextIds.java;1;0;1;1;0;0;0;1;0;0;1;1511;0;0;1;0;0;1;1;1511;0;1511;1;1;
/org.eclipse.pde.core/src/org/eclipse/pde/internal/core/build/Build.java;3;1;5;1;3;3;3;2;6;1;2;4203;17;17;1;0;0;2;5;4203;0;6336;5;3;
/org.eclipse.core.tests.resources/src/org/eclipse/core/tests/resources/AllTests.java;3;1;4;1;2;2;2;2;32;1;2;4340;55;55;1;0;0;2;4;4340;0;5988;4;3;
/org.eclipse.ui.forms/src/org/eclipse/ui/forms/events/ExpansionListener.java;1;0;4;1;0;0;0;4;23;1;4;4068;24;24;1;0;0;4;4;4068;0;5044;4;1;
/org.eclipse.jdt.ui.tests.refactoring/resources/RenamePackage/testImportFromMultiRoots2/out/srcTest/tests/QualifiedTests.java;1;0;2;1;0;0;0;2;15;1;2;3219;15;15;1;0;0;2;2;3219;0;4105;2;1;
/org.eclipse.jdt.ui/core refactoring/org/eclipse/jdt/internal/corext/refactoring/rename/RenameCompilationUnitProcessor.java;3;1;19;2;4;4;4;15;38;2;14;1125;198;198;2;1;0;15;19;4575;1;6340;18;3;
/org.eclipse.pde.core/src/org/eclipse/pde/core/plugin/IFragmentModel.java;2;1;3;1;3;3;3;0;12;0;0;5115;24;24;1;0;0;0;3;5115;0;6336;3;2;
/org.eclipse.pde.ui/src/org/eclipse/pde/internal/ui/editor/plugin/DependenciesPage.java;3;1;6;1;6;6;6;0;40;0;0;5431;74;74;1;0;0;0;6;5431;0;6366;6;3;
/org.eclipse.pde.core/src_OSGi/org/eclipse/pde/internal/core/bundle/BundleObject.java;1;0;2;1;0;0;0;2;0;1;2;2193;0;0;1;0;0;2;2;2193;0;2229;2;1;
/org.eclipse.team.core/src/org/eclipse/team/core/synchronize/IRemoteResource.java;1;0;1;1;0;0;0;1;0;0;1;4048;0;0;1;0;0;1;1;4048;0;4048;1;1;
/org.eclipse.ui.ide/src/org/eclipse/ui/actions/GlobalBuildAction.java;2;0;9;1;0;0;0;9;91;2;8;1511;175;175;2;1;0;9;9;1632;1;2263;8;2;
/org.eclipse.swt/Eclipse SWT PI/win32/org/eclipse/swt/internal/win32/NMTTDISPINFOW.java;1;0;1;1;0;0;0;1;0;0;1;957;0;0;1;0;0;1;1;957;0;957;1;1;
/org.eclipse.jdt.core.tests.model/workspace/Formatter/test443/A_out.java;1;0;1;1;0;0;0;1;0;0;1;3513;0;0;1;0;0;1;1;3513;0;3513;1;1;
/org.eclipse.ui.ide/src/org/eclipse/ui/internal/misc/ResourceAndContainerGroup.java;2;0;3;1;0;0;0;3;14;1;3;1526;14;14;1;0;0;3;3;1526;0;2263;3;2;
/org.eclipse.update.core/srcnew/org/eclipse/update/internal/operations/FeatureConfigOperation.java;1;0;3;1;0;0;0;3;2;2;2;433;2;2;2;1;0;3;3;433;1;442;2;1;
/org.eclipse.team.cvs.ui/src/org/eclipse/team/internal/ccvs/ui/subscriber/SafeUpdateOperation.java;2;1;7;1;5;5;5;2;43;1;2;4450;88;88;1;0;0;2;7;4450;0;6337;7;2;
/org.eclipse.jdt.core.tests.model/workspace/Converter/test0202/Test.java;1;0;1;1;0;0;0;1;0;0;1;3714;0;0;1;0;0;1;1;3714;0;3714;1;1;
/org.eclipse.jdt.core.tests.compiler/src/org/eclipse/jdt/core/tests/compiler/regression/Compliance_1_3.java;6;1;25;2;6;6;6;19;503;3;16;530;1453;1453;3;3;0;19;25;1840;3;6126;22;6;
/org.eclipse.jdt.ui/core refactoring/org/eclipse/jdt/internal/corext/refactoring/nls/PropertyFileDocumentModel.java;4;1;8;1;8;8;8;0;211;0;0;5375;341;341;1;0;0;0;8;5375;0;6340;8;4;
/org.eclipse.ui.workbench/Eclipse UI/org/eclipse/ui/internal/progress/GroupInfo.java;2;1;6;1;2;2;2;4;111;1;4;3678;188;188;1;0;0;4;6;3678;0;6338;6;2;
/org.eclipse.ui.workbench.texteditor/src/org/eclipse/ui/internal/texteditor/quickdiff/RevertSelectionAction.java;2;0;4;1;1;1;1;3;6;1;3;1644;14;14;1;0;0;3;4;1644;0;6340;4;2;
/org.eclipse.team.core/src/org/eclipse/team/internal/core/subscribers/caches/SessionResourceVariantByteStore.java;1;0;4;1;0;0;0;4;142;1;4;4216;282;282;1;0;0;4;4;4216;0;4349;4;1;
/org.eclipse.ui.ide/src/org/eclipse/ui/internal/dialogs/WorkbenchWizardSelectionPage.java;2;0;4;1;0;0;0;4;4;1;4;1526;8;8;1;0;0;4;4;1526;0;2263;4;2;
/org.eclipse.ui.workbench/Eclipse UI/org/eclipse/ui/internal/presentations/SystemMenuCloseOtherEditors.java;3;1;4;1;3;3;3;1;39;0;1;4680;41;41;1;0;0;1;4;4680;0;5522;4;3;
/org.eclipse.team.ui/src/org/eclipse/team/ui/synchronize/viewers/SynchronizeModelAction.java;1;0;2;1;0;0;0;2;0;1;2;4588;0;0;1;0;0;2;2;4588;0;4632;2;1;
/org.eclipse.core.tests.runtime/src/org/eclipse/core/tests/runtime/CoreExceptionTest.java;1;0;1;1;1;1;1;0;61;0;0;5149;61;61;1;0;0;0;1;5149;0;5149;1;1;
/org.eclipse.team.ui/src/org/eclipse/team/internal/ui/sync/views/CompressedFolderContentProvider.java;2;0;6;1;0;0;0;6;24;2;5;1171;46;46;2;1;0;6;6;1171;1;2632;5;2;
/org.eclipse.update.core/src/org/eclipse/update/internal/core/HttpResponse.java;3;1;10;1;2;2;2;8;80;2;7;890;180;180;2;1;0;8;10;3110;1;6336;9;3;
/org.eclipse.ui.workbench/Eclipse UI/org/eclipse/ui/commands/IWorkbenchCommandSupport.java;4;1;18;1;3;3;3;15;147;2;14;3129;456;456;2;1;0;15;18;3129;1;6338;17;4;
/org.eclipse.pde.build/src/org/eclipse/pde/internal/build/builder/DevClassPathHelper.java;2;1;4;1;2;2;2;2;79;1;2;4740;97;97;1;0;0;2;4;4740;0;5754;4;2;
/org.eclipse.ui.workbench/Eclipse UI/org/eclipse/ui/actions/CopyResourceAction.java;2;0;2;1;0;0;0;2;2;1;2;1872;2;2;1;0;0;2;2;1872;0;2737;2;2;
/org.eclipse.ui.intro/src/org/eclipse/ui/intro/internal/model/IntroURLParser.java;1;0;3;1;1;1;1;2;258;1;2;4429;258;258;1;0;0;2;3;4429;0;5115;3;1;
/org.eclipse.ui.forms/src/org/eclipse/ui/forms/events/IHyperlinkListener.java;1;0;2;1;1;1;1;1;6;0;1;5044;6;6;1;0;0;1;2;5044;0;6336;2;1;
/org.eclipse.text/src/org/eclipse/jface/text/templates/TemplatePosition.java;1;0;2;1;0;0;0;2;0;1;2;4259;0;0;1;0;0;2;2;4259;0;4382;2;1;
/org.eclipse.jdt.ui/core refactoring/org/eclipse/ltk/core/refactoring/RefactoringStatusContext.java;1;0;2;1;0;0;0;2;0;1;2;4575;0;0;1;0;0;2;2;4575;0;4864;2;1;
/org.eclipse.jdt.ui/core refactoring/org/eclipse/jdt/internal/corext/refactoring/participants/ProcessorDescriptor.java;1;0;9;1;0;0;0;9;27;1;9;825;124;124;1;0;0;9;9;825;0;4624;9;1;
/org.eclipse.jdt.core.tests.model/workspace/Converter/src/junit/runner/SimpleTestCollector.java;1;0;1;1;0;0;0;1;0;0;1;3714;0;0;1;0;0;1;1;3714;0;3714;1;1;
/org.eclipse.jdt.ui/core refactoring/org/eclipse/ltk/core/refactoring/participants/RefactoringProcessor.java;1;0;5;1;0;0;0;5;37;1;5;4624;54;54;1;0;0;5;5;4624;0;4864;5;1;
/org.eclipse.jdt.ui/ui refactoring/org/eclipse/jdt/internal/ui/refactoring/PushDownInputPage.java;1;0;2;1;0;0;0;2;6;1;2;361;6;6;1;0;0;2;2;361;0;518;2;1;
/org.eclipse.jdt.ui/ui refactoring/org/eclipse/jdt/internal/ui/refactoring/ParameterEditDialog.java;3;1;8;1;2;2;2;6;56;2;5;1309;167;167;2;1;0;6;8;3247;1;6340;7;3;
/org.eclipse.jdt.core/search/org/eclipse/jdt/internal/core/index/MemoryIndex.java;2;0;4;1;1;1;1;3;106;1;3;3843;117;117;1;0;0;3;4;3843;0;5272;4;2;
/org.eclipse.jdt.ui/ui/org/eclipse/jdt/internal/ui/viewsupport/JavaElementLabels.java;3;1;10;1;2;2;2;8;29;1;8;1171;153;153;1;0;0;8;10;1171;0;6340;10;3;
/org.eclipse.ui.workbench/Eclipse UI/org/eclipse/ui/internal/ActionSetActionBars.java;6;1;9;2;2;2;2;7;527;2;6;3220;762;762;2;1;0;7;9;3368;1;6338;8;6;
/org.eclipse.jdt.core.tests.model/workspace/Formatter/test052/A_out.java;1;0;1;1;0;0;0;1;0;0;1;2425;0;0;1;0;0;1;1;2425;0;2425;1;1;
/org.eclipse.team.cvs.ui/src/org/eclipse/team/internal/ccvs/ui/wizards/CheckoutAsLocationSelectionPage.java;2;1;7;1;2;2;2;5;316;1;5;276;380;380;1;0;0;5;7;276;0;6337;7;2;
/org.eclipse.jdt.ui.tests.refactoring/resources/ChangeTypeRefactoring/negative/A_testOverriddenBinaryMethod_in.java;1;0;1;1;0;0;0;1;0;0;1;2844;0;0;1;0;0;1;1;2844;0;2844;1;1;
/org.eclipse.compare/compare/org/eclipse/compare/CompareConfiguration.java;1;0;3;1;1;1;1;2;6;1;2;3806;13;13;1;0;0;2;3;3806;0;6322;3;1;
/org.eclipse.pde.ui/src_Forms/org/eclipse/pde/internal/ui/neweditor/text/ReconcilingStrategy.java;1;0;2;1;1;1;1;1;0;0;1;4438;0;0;1;0;0;1;2;4438;0;5431;2;1;
/org.eclipse.ui.workbench/Eclipse UI/org/eclipse/ui/internal/activities/ObjectContributionRecord.java;1;0;5;1;0;0;0;5;142;2;4;2444;145;145;2;1;0;5;5;3008;1;3008;4;1;
/org.eclipse.ui.workbench/Eclipse UI/org/eclipse/ui/IKeyBindingService.java;3;1;5;1;2;2;2;3;69;1;3;776;131;131;1;0;0;3;5;776;0;6338;5;3;
/org.eclipse.webdav/src/client/org/eclipse/webdav/client/DAVClient.java;1;0;2;1;2;1;2;0;22;0;0;5151;22;22;2;0;1;0;2;5151;1;5151;1;1;
/org.eclipse.help/src/org/eclipse/help/internal/workingset/AdaptableTopic.java;1;0;1;1;0;0;0;1;0;0;1;2732;0;0;1;0;0;1;1;2732;0;2732;1;1;
/org.eclipse.ui.workbench.texteditor/src/org/eclipse/ui/texteditor/quickdiff/IQuickDiffReferenceProvider.java;2;1;6;1;3;3;3;3;29;1;3;1644;51;51;1;0;0;3;6;1644;0;6340;6;2;
/org.eclipse.help.ide/src/org/eclipse/help/ui/internal/search/HelpSearchResult.java;1;1;3;1;3;3;3;0;15;0;0;5216;21;21;1;0;0;0;3;5216;0;5827;3;1;
/org.eclipse.ui.workbench/Eclipse UI/org/eclipse/ui/internal/PluginActionSetBuilder.java;7;1;8;1;2;2;2;6;165;1;6;830;382;382;1;0;0;6;8;830;0;6338;8;7;
/org.eclipse.jdt.core.tests.model/workspace/Converter/src/test0358/A.java;1;0;1;1;0;0;0;1;0;0;1;3714;0;0;1;0;0;1;1;3714;0;3714;1;1;
/org.eclipse.core.tests.resources/src/org/eclipse/core/tests/internal/watson/TestDeltaFilter.java;1;0;1;1;1;1;1;0;29;0;0;5147;29;29;1;0;0;0;1;5147;0;5147;1;1;
/org.eclipse.jdt.debug.jdi.tests/tests/org/eclipse/debug/jdi/tests/PrimitiveValueTest.java;1;0;1;1;0;0;0;1;48;0;1;1318;48;48;1;0;0;1;1;1318;0;1318;1;1;
/org.eclipse.ui.tests/UI Test Utils/org/eclipse/ui/tests/util/PerspectiveWithFastView.java;2;1;2;1;2;2;2;0;2;0;0;6226;2;2;1;0;0;0;2;6226;0;6338;2;2;
/org.eclipse.ui.ide/src/org/eclipse/ui/internal/ide/dialogs/IDEPerspectivesPreferencePage.java;3;2;5;2;3;2;3;2;59;1;2;2793;64;64;2;0;1;2;5;6338;1;6338;4;3;
/org.eclipse.pde.core/src/org/eclipse/pde/core/osgi/bundle/IBundlePlugin.java;2;1;4;1;3;3;3;1;16;0;1;4203;25;25;1;0;0;1;4;4203;0;5445;4;2;
/org.eclipse.core.runtime/src/org/eclipse/core/internal/runtime/PreferenceExporter.java;1;0;1;1;0;0;0;1;0;0;1;3013;0;0;1;0;0;1;1;3013;0;3013;1;1;
/org.eclipse.ant.ui/Ant Editor/org/eclipse/ant/internal/ui/editor/text/XMLMarkerAnnotation.java;1;0;4;1;1;1;1;3;64;1;3;1811;114;114;1;0;0;3;4;1811;0;5581;4;1;
/org.eclipse.jdt.core/search/org/eclipse/jdt/core/search/SearchPattern.java;3;3;15;1;9;6;9;6;153;1;6;3211;690;690;3;0;3;6;15;5207;3;5457;12;3;
/org.eclipse.ui.workbench/Eclipse UI/org/eclipse/ui/activities/IActivityListener.java;3;1;7;1;2;2;2;5;22;2;4;2240;42;42;2;1;0;5;7;2800;1;6338;6;3;
/org.eclipse.jdt.ui/ui/org/eclipse/jdt/internal/ui/wizards/buildpaths/BuildPathBasePage.java;2;0;3;1;1;1;1;2;38;1;2;3404;42;42;1;0;0;2;3;3404;0;6340;3;2;
/org.eclipse.jdt.core.tests.model/workspace/Converter/src/test0310/Test.java;1;0;1;1;0;0;0;1;0;0;1;3714;0;0;1;0;0;1;1;3714;0;3714;1;1;
/org.eclipse.ui.workbench/Eclipse UI/org/eclipse/ui/internal/BooleanModel.java;2;0;2;1;0;0;0;2;61;1;2;3803;61;61;1;0;0;2;2;3803;0;4015;2;2;
/org.eclipse.ui.workbench/Eclipse UI/org/eclipse/ui/internal/WorkbenchActivityHelper.java;3;0;16;3;0;0;0;16;368;3;11;2443;727;727;3;5;0;16;16;2800;5;3061;11;3;
/org.eclipse.ui.workbench/Eclipse UI/org/eclipse/ui/internal/progress/ErrorNotificationDialog.java;1;1;10;1;6;6;6;4;299;2;3;3477;662;662;2;1;0;4;10;4069;1;5595;9;1;
/org.eclipse.core.runtime/src/org/eclipse/core/runtime/jobs/MultiRule.java;3;1;12;1;3;3;3;9;202;1;9;1415;496;496;1;0;0;9;12;1415;0;5896;12;3;
/org.eclipse.jdt.ui.tests.refactoring/resources/ExtractMethodWorkSpace/ExtractMethodTests/locals_in/A_test502.java;1;0;1;1;0;0;0;1;4;0;1;844;4;4;1;0;0;1;1;844;0;844;1;1;
/org.eclipse.update.ui/src/org/eclipse/update/internal/ui/WebInstallHandler.java;1;0;3;1;0;0;0;3;4;2;2;710;4;4;2;1;0;3;3;710;1;824;2;1;
/org.eclipse.jdt.ui/ui refactoring/org/eclipse/jdt/internal/ui/refactoring/reorg/TypedSource.java;1;0;3;1;0;0;0;3;128;1;3;1112;193;193;1;0;0;3;3;1112;0;1670;3;1;
/org.eclipse.core.tests.resources/src/org/eclipse/core/tests/internal/utils/QueueTest.java;1;0;3;1;3;1;3;0;222;0;0;5147;222;222;3;0;2;0;3;5147;2;5147;1;1;
/org.eclipse.help.tests/src/org/eclipse/help/tests/AllHelpUITests.java;1;1;2;1;2;2;2;0;16;0;0;5827;32;32;1;0;0;0;2;5827;0;6337;2;1;
/org.eclipse.core.runtime.compatibility/src-model/org/eclipse/core/internal/model/RegistryResolver.java;3;1;4;1;3;3;3;1;48;0;1;3013;58;58;1;0;0;1;4;3013;0;6340;4;3;
/org.eclipse.ui.ide/extensions/org/eclipse/ui/part/FileInPlaceEditorInput.java;1;0;1;1;0;0;0;1;0;0;1;2263;0;0;1;0;0;1;1;2263;0;2263;1;1;
/org.eclipse.pde.junit.runtime/src/org/eclipse/pde/internal/junit/runtime/CoreTestApplication.java;1;0;2;1;1;1;1;1;4;0;1;1453;4;4;1;0;0;1;2;1453;0;6039;2;1;
/org.eclipse.update.configurator/src/org/eclipse/update/internal/configurator/PlatformConfiguration.java;2;2;61;1;21;17;21;40;1305;3;35;3243;3091;3091;3;5;4;40;61;4803;9;6325;52;2;
/org.eclipse.swt.tests/JUnit Tests/org/eclipse/swt/tests/junit/Test_org_eclipse_swt_widgets_Control.java;5;0;9;1;1;1;1;8;132;2;7;1242;219;219;2;1;0;8;9;1242;1;6352;8;5;
/org.eclipse.update.core/srcnew/org/eclipse/update/search/UpdateSearchRequest.java;2;0;7;1;0;0;0;7;160;3;4;574;226;226;3;3;0;7;7;574;3;825;4;2;
/org.eclipse.update.ui.forms/src/org/eclipse/update/ui/forms/internal/SectionForm.java;1;0;2;1;0;0;0;2;14;1;2;624;16;16;1;0;0;2;2;624;0;1725;2;1;
/org.eclipse.ant.ui/Ant Editor/org/eclipse/ant/internal/ui/editor/templates/AntTemplateVariableTextHover.java;1;0;1;1;1;1;1;0;0;0;0;5301;0;0;1;0;0;0;1;5301;0;5301;1;1;
/org.eclipse.jdt.debug.ui/ui/org/eclipse/jdt/internal/debug/ui/jres/JREMessages.java;2;0;2;1;0;0;0;2;11;1;2;1035;11;11;1;0;0;2;2;1035;0;1435;2;2;
/org.eclipse.pde.ui/src/org/eclipse/pde/internal/ui/editor/build/BuildOutlinePage.java;2;1;3;1;2;2;2;1;131;0;1;1727;137;137;1;0;0;1;3;1727;0;6336;3;2;
/org.eclipse.pde.ui/src/org/eclipse/pde/internal/ui/wizards/convert/MigrationAction.java;1;0;2;1;0;0;0;2;0;0;1;3839;0;0;2;1;0;2;2;3839;1;3839;1;1;
/org.eclipse.jdt.core.tests.model/workspace/Formatter/test175/A_in.java;1;0;1;1;0;0;0;1;0;0;1;2425;0;0;1;0;0;1;1;2425;0;2425;1;1;
/org.eclipse.jface.text.tests/src/org/eclipse/jface/text/tests/rules/DefaultPartitionerZeroLengthTest.java;3;1;4;1;3;3;3;1;37;0;1;5083;60;60;1;0;0;1;4;5083;0;6340;4;3;
/org.eclipse.ant.ui/Ant Editor/org/eclipse/ant/internal/ui/editor/derived/LineBreakingReader.java;1;1;3;1;2;2;2;1;5;0;1;1811;9;9;1;0;0;1;3;1811;0;6336;3;1;
/org.eclipse.jdt.core.tests.model/workspace/Converter/test0120/Test.java;1;0;1;1;0;0;0;1;0;0;1;3714;0;0;1;0;0;1;1;3714;0;3714;1;1;
/org.eclipse.jdt.core.tests.compiler/src/org/eclipse/jdt/core/tests/compiler/parser/GenericsCompletionParserTest.java;1;0;1;1;0;0;0;1;0;0;1;4964;0;0;1;0;0;1;1;4964;0;4964;1;1;
/org.eclipse.ui.workbench/Eclipse UI/org/eclipse/ui/commands/ICommandRegistryListener.java;1;0;4;1;0;0;0;4;0;2;3;1389;0;0;2;1;0;4;4;1417;1;1417;3;1;
/org.eclipse.pde.core/src/org/eclipse/pde/internal/core/osgi/bundle/BundleFragment.java;1;1;5;1;2;2;2;3;37;1;3;4203;67;67;1;0;0;3;5;4203;0;5445;5;1;
/org.eclipse.jdt.core/compiler/org/eclipse/jdt/internal/compiler/ast/OperatorExpression.java;3;0;5;1;0;0;0;5;2248;2;4;991;2294;2294;2;1;0;5;5;991;1;3560;4;3;
/org.eclipse.ltk.core.refactoring.tests/src/org/eclipse/ltk/core/refactoring/tests/participants/FailingParticipant.java;1;0;1;1;1;1;1;0;0;0;0;6072;0;0;1;0;0;0;1;6072;0;6072;1;1;
/org.eclipse.swt/Eclipse SWT OLE Win32/win32/org/eclipse/swt/ole/win32/OleFrame.java;1;0;1;1;0;0;0;1;5;0;1;2969;5;5;1;0;0;1;1;2969;0;2969;1;1;
/org.eclipse.help/src/org/eclipse/help/internal/context/Contexts.java;1;1;2;1;2;2;2;0;6;0;0;5827;10;10;1;0;0;0;2;5827;0;6337;2;1;
/org.eclipse.pde.ui/src_Forms/org/eclipse/pde/internal/ui/newparts/IFormEntryListener.java;2;0;3;1;1;1;1;2;4;1;2;4260;4;4;1;0;0;2;3;4260;0;5431;3;2;
/org.eclipse.jdt.ui/ui/org/eclipse/jdt/internal/ui/wizards/NewWizardMessages.java;1;0;1;1;1;1;1;0;2;0;0;6340;2;2;1;0;0;0;1;6340;0;6340;1;1;
/org.eclipse.debug.ui/ui/org/eclipse/debug/ui/variables/IVariableConstants.java;2;0;5;1;0;0;0;5;132;3;3;316;142;142;3;2;0;5;5;316;2;550;3;2;
/org.eclipse.ui.intro/src/org/eclipse/ui/internal/intro/impl/swt/PageContentForm.java;1;1;6;1;6;6;6;0;20;0;0;5714;63;63;1;0;0;0;6;5714;0;6280;6;1;
/org.eclipse.core.runtime.compatibility/src-model/org/eclipse/core/runtime/model/PluginDescriptorModel.java;3;2;6;1;4;3;4;2;14;1;2;3013;23;23;2;0;1;2;6;5117;1;6340;5;3;
/org.eclipse.core.tools.resources/src/org/eclipse/core/tools/metadata/MarkersSnapshotDumpingStrategy_1.java;1;0;1;1;1;1;1;0;0;0;0;6302;0;0;1;0;0;0;1;6302;0;6302;1;1;
/org.eclipse.jdt.core/eval/org/eclipse/jdt/internal/eval/CodeSnippetClassFile.java;4;0;8;1;1;1;1;7;68;1;7;530;128;128;1;0;0;7;8;530;0;5946;8;4;
/org.eclipse.pde/src/org/eclipse/pde/internal/builders/DependencyLoop.java;1;0;2;1;1;1;1;1;6;0;1;4203;8;8;1;0;0;1;2;4203;0;6336;2;1;
/org.eclipse.help.ide/src/org/eclipse/help/ui/internal/search/ResultTableLabelProvider.java;1;1;3;1;3;3;3;0;2;0;0;5216;3;3;1;0;0;0;3;5216;0;5827;3;1;
/org.eclipse.core.runtime/src/org/eclipse/core/internal/preferences/ExportedPreferences.java;1;1;8;1;5;5;5;3;19;1;3;4374;63;63;1;0;0;3;8;4374;0;5735;8;1;
/org.eclipse.swt.tests/JUnit Tests/org/eclipse/swt/tests/junit/Test_org_eclipse_swt_graphics_ImageLoader.java;3;0;4;1;1;1;1;3;151;1;3;2175;236;236;1;0;0;3;4;2175;0;6352;4;3;
/org.eclipse.jdt.ui/core extension/org/eclipse/jdt/internal/corext/codemanipulation/CodeBlock.java;1;0;1;1;0;0;0;1;0;0;1;159;0;0;1;0;0;1;1;159;0;159;1;1;
/org.eclipse.team.webdav/src/org/eclipse/team/internal/ui/target/TargetSyncCompareInput.java;2;0;2;1;0;0;0;2;0;1;2;2495;0;0;1;0;0;2;2;2495;0;4216;2;2;
/org.eclipse.pde.ui/src/org/eclipse/pde/internal/ui/wizards/tools/ExtensionPointMappings.java;2;1;3;1;2;2;2;1;34;0;1;3840;44;44;1;0;0;1;3;3840;0;6336;3;2;
/org.eclipse.help/src/org/eclipse/help/internal/toc/TocManager.java;1;1;15;1;4;4;4;11;47;3;8;2330;207;207;3;3;0;11;15;4609;3;6337;12;1;
/org.eclipse.update.core/srcnew/org/eclipse/update/search/IQueryUpdateSiteAdapter.java;2;0;2;1;0;0;0;2;0;1;2;630;0;0;1;0;0;2;2;630;0;825;2;2;
/org.eclipse.ant.ui/Remote Ant Support/org/eclipse/ant/ui/internal/antsupport/InputHandlerSetter.java;1;0;2;1;0;0;0;2;0;1;2;1696;0;0;1;0;0;2;2;1696;0;1811;2;1;
/org.eclipse.jface.text/src/org/eclipse/jface/text/TextSelection.java;2;1;4;1;3;3;3;1;22;0;1;186;39;39;1;0;0;1;4;186;0;6359;4;2;
/org.eclipse.swt/Eclipse SWT Custom Widgets/common/org/eclipse/swt/custom/CBanner.java;4;3;46;1;21;15;21;25;380;2;20;3013;1879;1879;3;5;6;25;46;5205;11;6352;35;4;
/org.eclipse.jdt.core.tests.model/workspace/Converter/test0453/A.java;1;0;1;1;0;0;0;1;0;0;1;3714;0;0;1;0;0;1;1;3714;0;3714;1;1;
/org.eclipse.jdt.core.tests.model/workspace/Converter/test0100/Test.java;1;0;1;1;0;0;0;1;0;0;1;3714;0;0;1;0;0;1;1;3714;0;3714;1;1;
/org.eclipse.jdt.ui.tests.refactoring/resources/ChangeTypeRefactoring/positive/A_testFieldType_in.java;1;0;1;1;0;0;0;1;0;0;1;2844;0;0;1;0;0;1;1;2844;0;2844;1;1;
/org.eclipse.jdt.debug.ui/ui/org/eclipse/jdt/internal/debug/ui/actions/RuntimeClasspathAction.java;1;0;3;1;0;0;0;3;31;2;2;1496;35;35;2;1;0;3;3;2691;1;2691;2;1;
/org.eclipse.jdt.ui.tests.refactoring/resources/Delete/testDeleteWithinCu0/out/A.java;1;0;1;1;0;0;0;1;0;0;1;442;0;0;1;0;0;1;1;442;0;442;1;1;
/org.eclipse.jdt.ui/ui refactoring/org/eclipse/jdt/internal/ui/refactoring/InlineConstantInputPage.java;1;0;1;1;0;0;0;1;0;0;1;518;0;0;1;0;0;1;1;518;0;518;1;1;
/org.eclipse.update.core/src/org/eclipse/update/core/NonPluginEntry.java;2;1;3;1;2;2;2;1;6;0;1;890;12;12;1;0;0;1;3;890;0;6336;3;2;
/org.eclipse.jdt.core/dom/org/eclipse/jdt/core/dom/Annotation.java;1;1;7;1;2;2;2;5;125;1;5;4054;198;198;1;0;0;5;7;4054;0;5268;7;1;
/org.eclipse.ui.workbench/Eclipse UI/org/eclipse/ui/wizards/datatransfer/DataTransferMessages.java;1;0;1;1;0;0;0;1;0;0;1;2737;0;0;1;0;0;1;1;2737;0;2737;1;1;
/org.eclipse.core.tests.runtime/src/org/eclipse/core/tests/runtime/locks/FussyProgressProvider.java;1;0;2;1;0;0;0;2;0;1;2;698;0;0;1;0;0;2;2;698;0;850;2;1;
/org.eclipse.jdt.core/model/org/eclipse/jdt/internal/core/CopyElementsOperation.java;2;0;7;1;1;1;1;6;20;1;6;134;73;73;1;0;0;6;7;134;0;5584;7;2;
/org.eclipse.jdt.core.tests.model/workspace/Converter/src/test0489/A.java;1;0;1;1;0;0;0;1;0;0;1;3714;0;0;1;0;0;1;1;3714;0;3714;1;1;
/org.eclipse.ui.workbench/Eclipse UI/org/eclipse/ui/internal/csm/activities/api/ActivityNotDefinedException.java;1;0;3;1;0;0;0;3;2;2;2;2225;2;2;2;1;0;3;3;2238;1;2238;2;1;
/org.eclipse.jdt.ui/ui refactoring/org/eclipse/jdt/internal/ui/refactoring/reorg/RenameJavaProjectWizard.java;2;0;4;1;1;1;1;3;8;2;2;1125;17;17;2;1;0;3;4;1125;1;6340;3;2;
/org.eclipse.ui.tests/Eclipse UI Tests/org/eclipse/ui/tests/dnd/AbstractTestDropTarget.java;1;0;1;1;0;0;0;1;0;0;1;5007;0;0;1;0;0;1;1;5007;0;5007;1;1;
/org.eclipse.jdt.ui/ui/org/eclipse/jdt/internal/ui/preferences/PreferencePageSupport.java;1;0;1;1;0;0;0;1;0;0;1;4407;0;0;1;0;0;1;1;4407;0;4407;1;1;
/org.eclipse.jdt.ui/ui/org/eclipse/jdt/internal/ui/text/SubstitutionTextReader.java;1;0;1;1;1;1;1;0;2;0;0;6340;2;2;1;0;0;0;1;6340;0;6340;1;1;
/org.eclipse.core.runtime.compatibility/src-boot/org/eclipse/core/internal/boot/FeatureEntry.java;3;1;4;1;2;2;2;2;10;1;2;3013;22;22;1;0;0;2;4;3013;0;6340;4;3;
/org.eclipse.swt/Eclipse SWT Drag and Drop/win32/org/eclipse/swt/dnd/TableDragUnderEffect.java;1;0;5;1;0;0;0;5;35;2;3;766;81;81;2;2;0;5;5;766;2;803;3;1;
/org.eclipse.compare/compare/org/eclipse/compare/structuremergeviewer/IDiffElement.java;1;0;1;1;0;0;0;1;2;0;1;3938;2;2;1;0;0;1;1;3938;0;3938;1;1;
/org.eclipse.swt/Eclipse SWT Mozilla/common/org/eclipse/swt/internal/mozilla/nsIFactory.java;1;0;1;1;0;0;0;1;0;0;1;1654;0;0;1;0;0;1;1;1654;0;1654;1;1;
/org.eclipse.jdt.ui.tests.refactoring/resources/ExtractMethodWorkSpace/ExtractMethodTests/return_in/A_test717.java;1;0;1;1;0;0;0;1;4;0;1;844;4;4;1;0;0;1;1;844;0;844;1;1;
/org.eclipse.update.ui.forms/src/org/eclipse/update/ui/forms/internal/ToggleControl.java;1;0;1;1;0;0;0;1;1;0;1;3071;1;1;1;0;0;1;1;3071;0;3071;1;1;
/org.eclipse.jdt.ui/ui/org/eclipse/jdt/internal/ui/browsing/ToggleLinkingAction.java;1;0;2;1;1;1;1;1;13;0;1;1285;15;15;1;0;0;1;2;1285;0;6340;2;1;
/org.eclipse.team.ui/src/org/eclipse/team/internal/ui/synchronize/SyncInfoDiffTableViewer.java;1;0;1;1;0;0;0;1;0;0;1;3286;0;0;1;0;0;1;1;3286;0;3286;1;1;
/org.eclipse.core.expressions/src/org/eclipse/core/internal/expressions/AdaptExpression.java;1;0;3;1;1;1;1;2;38;1;2;4108;40;40;1;0;0;2;3;4108;0;6340;3;1;
/org.eclipse.ui.workbench/Eclipse UI/org/eclipse/ui/internal/commands/old/Category.java;1;0;2;1;0;0;0;2;0;1;2;1322;0;0;1;0;0;2;2;1322;0;1695;2;1;
/org.eclipse.jdt.ui.tests.refactoring/resources/ExtractMethodWorkSpace/ExtractMethodTests/branch_in/A_test750.java;1;0;2;1;0;0;0;2;4;1;2;844;4;4;1;0;0;2;2;844;0;2256;2;1;
/org.eclipse.jdt.core/compiler/org/eclipse/jdt/internal/compiler/ast/Javadoc.java;2;2;17;1;4;3;4;13;139;1;13;2887;584;584;2;0;1;13;17;5608;1;6100;16;2;
/org.eclipse.jdt.core/compiler/org/eclipse/jdt/internal/compiler/ast/ASTNode.java;2;2;7;1;3;2;3;4;63;1;4;2974;115;115;2;0;1;4;7;5352;1;5615;6;2;
/org.eclipse.ui.tests/Eclipse UI Tests/org/eclipse/ui/tests/api/IEditorSiteTest.java;1;0;1;1;0;0;0;1;3;0;1;2738;3;3;1;0;0;1;1;2738;0;2738;1;1;
/org.eclipse.update.ui.forms/src/org/eclipse/ui/forms/parts/ToggleHyperlink.java;1;0;2;1;0;0;0;2;0;0;1;3095;0;0;2;1;0;2;2;3095;1;3095;1;1;
/org.eclipse.update.ui.forms/src/org/eclipse/ui/forms/parts/ILayoutExtension.java;1;0;2;1;0;0;0;2;0;1;2;3038;0;0;1;0;0;2;2;3038;0;3096;2;1;
/org.eclipse.jdt.core/compiler/org/eclipse/jdt/internal/compiler/lookup/NestedTypeBinding.java;2;0;2;1;0;0;0;2;26;1;2;24;28;28;1;0;0;2;2;24;0;3560;2;2;
/org.eclipse.jdt.core.tests.compiler/src/org/eclipse/jdt/core/tests/compiler/parser/ParserTest.java;3;3;12;1;7;5;7;5;77;2;4;1149;458;458;3;1;2;5;12;5502;3;6095;9;3;
/org.eclipse.jdt.core.tests.model/workspace/Formatter/test450/A_out.java;1;0;1;1;0;0;0;1;0;0;1;3651;0;0;1;0;0;1;1;3651;0;3651;1;1;
/org.eclipse.update.core/src/org/eclipse/update/internal/configuration/ConfigurationPolicyModel.java;1;0;1;1;0;0;0;1;0;0;1;2828;0;0;1;0;0;1;1;2828;0;2828;1;1;
/org.eclipse.jdt.ui.tests.refactoring/resources/ChangeTypeRefactoring/positive/A_testParameterTypeWithOverride_out.java;1;0;1;1;0;0;0;1;0;0;1;2844;0;0;1;0;0;1;1;2844;0;2844;1;1;
/org.eclipse.jdt.ui.tests.refactoring/resources/ChangeSignature/canModify/A_testException05_in.java;1;0;1;1;1;1;1;0;0;0;0;5630;0;0;1;0;0;0;1;5630;0;5630;1;1;
/org.eclipse.update.core/src/org/eclipse/update/internal/core/SiteFileContentConsumer.java;3;0;4;1;2;1;2;2;31;1;2;890;51;51;2;0;1;2;4;5664;1;5664;3;3;
/org.eclipse.jdt.ui/core refactoring/org/eclipse/jdt/internal/corext/refactoring/participants/MoveHtmlFileParticipant.java;1;0;2;1;0;0;0;2;0;1;2;825;0;0;1;0;0;2;2;825;0;882;2;1;
/org.eclipse.jdt.core.tests.model/workspace/Converter/src/test0201/Test.java;1;0;1;1;0;0;0;1;0;0;1;3714;0;0;1;0;0;1;1;3714;0;3714;1;1;
/org.eclipse.jdt.ui.tests.refactoring/resources/ExtractMethodWorkSpace/ExtractMethodTests/locals_out/A_test557.java;1;0;1;1;0;0;0;1;4;0;1;844;4;4;1;0;0;1;1;844;0;844;1;1;
/org.eclipse.jdt.core.tests.model/workspace/Formatter/test497/ClockCmd_in.java;1;0;2;1;2;1;2;0;2;0;0;5617;2;2;2;0;1;0;2;5617;1;5617;1;1;
/org.eclipse.jdt.ui/core extension/org/eclipse/jdt/internal/corext/textmanipulation/RangeMarker.java;1;0;6;1;0;0;0;6;26;2;4;1607;62;62;2;2;0;6;6;1869;2;1946;4;1;
/org.eclipse.jdt.ui/ui/org/eclipse/jdt/internal/ui/preferences/AppearancePreferencePage.java;2;0;3;1;1;1;1;2;44;1;2;1332;58;58;1;0;0;2;3;1332;0;6340;3;2;
/org.eclipse.jdt.debug.tests/tests/org/eclipse/jdt/debug/tests/core/ArrayTests.java;1;0;1;1;0;0;0;1;0;0;1;2564;0;0;1;0;0;1;1;2564;0;2564;1;1;
/org.eclipse.jdt.debug.ui/ui/org/eclipse/jdt/internal/debug/ui/jres/JREsUpdater.java;4;1;8;1;4;4;4;4;186;2;3;1060;281;281;2;1;0;4;8;1060;1;6336;7;4;
/org.eclipse.pde.ui/src_Forms/org/eclipse/pde/internal/ui/newparts/FormEntry.java;2;0;12;1;1;1;1;11;11;2;9;4260;50;50;2;2;0;11;12;4260;2;5431;10;2;
/org.eclipse.jdt.core.tests.model/workspace/Formatter/test319/A_in.java;1;0;1;1;0;0;0;1;0;0;1;2459;0;0;1;0;0;1;1;2459;0;2459;1;1;
/org.eclipse.ui.workbench/Eclipse UI/org/eclipse/ui/internal/decorators/FullDecoratorDefinition.java;2;0;2;1;0;0;0;2;3;1;2;1333;5;5;1;0;0;2;2;1333;0;2737;2;2;
/org.eclipse.jdt.ui/core extension/org/eclipse/jdt/internal/corext/codemanipulation/OrganizeImportsOperation.java;4;1;15;1;5;5;5;10;296;2;9;428;669;669;2;1;0;10;15;4921;1;6340;14;4;
/org.eclipse.jdt.launching.macosx/macosx/org/eclipse/jdt/internal/launching/macosx/MacOSXVMRunner.java;1;0;2;1;0;0;0;2;4;1;2;2721;6;6;1;0;0;2;2;2721;0;3622;2;1;
/org.eclipse.ui.workbench/Eclipse UI/org/eclipse/ui/internal/csm/activities/service/IActivityService.java;1;0;2;1;0;0;0;2;0;1;2;2370;0;0;1;0;0;2;2;2370;0;2444;2;1;
/org.eclipse.pde.ui/src/org/eclipse/pde/internal/ui/editor/PDESection.java;3;1;4;1;4;4;4;0;10;0;0;5431;15;15;1;0;0;0;4;5431;0;6336;4;3;
/org.eclipse.jdt.core.tests.model/workspace/Formatter/test150/A_in.java;1;0;1;1;0;0;0;1;0;0;1;2425;0;0;1;0;0;1;1;2425;0;2425;1;1;
/org.eclipse.core.tests.runtime/src/org/eclipse/core/tests/internal/plugins/SoftPrereqTest_14.java;1;0;1;1;0;0;0;1;0;0;1;3014;0;0;1;0;0;1;1;3014;0;3014;1;1;
/org.eclipse.jdt.ui.tests.refactoring/resources/SurroundWithWorkSpace/SurroundWithTests/trycatch_out/TestWrappedLocal5.java;1;0;2;1;0;0;0;2;8;1;2;155;9;9;1;0;0;2;2;155;0;845;2;1;
/org.eclipse.jdt.ui/ui/org/eclipse/jdt/internal/ui/callhierarchy/DeferredMethodWrapper.java;2;1;6;1;2;2;2;4;5;1;4;4168;15;15;1;0;0;4;6;4168;0;6340;6;2;
/org.eclipse.help.base/src/org/eclipse/help/internal/workingset/PropertyChange.java;1;1;3;1;2;2;2;1;189;0;1;1740;195;195;1;0;0;1;3;1740;0;6337;3;1;
/org.eclipse.ui.forms/src/org/eclipse/ui/forms/internal/widgets/WrappedPageBook.java;1;0;3;1;0;0;0;3;24;1;3;4068;24;24;1;0;0;3;3;4068;0;5044;3;1;
/org.eclipse.jface/src/org/eclipse/jface/viewers/ViewerLabel.java;1;0;1;1;0;0;0;1;0;0;1;4587;0;0;1;0;0;1;1;4587;0;4587;1;1;
/org.eclipse.swt/Eclipse SWT/carbon2/org/eclipse/swt/widgets/TableItem.java;2;0;3;1;0;0;0;3;34;1;3;2;35;35;1;0;0;3;3;2;0;231;3;2;
/org.eclipse.jdt.ui.tests.refactoring/test cases/org/eclipse/jdt/ui/tests/xml/PropertyTesterTests.java;1;0;2;1;0;0;0;2;0;1;2;4091;0;0;1;0;0;2;2;4091;0;4108;2;1;
/org.eclipse.pde.core/src/org/eclipse/pde/internal/core/ifeature/IVersionable.java;2;1;3;1;2;2;2;1;4;0;1;4203;10;10;1;0;0;1;3;4203;0;6336;3;2;
/org.eclipse.jdt.debug/jdi interfaces/com/sun/jdi/ClassType.java;1;0;1;1;0;0;0;1;3;0;1;4267;3;3;1;0;0;1;1;4267;0;4267;1;1;
/org.eclipse.jface.text/src/org/eclipse/jface/text/PaintManager.java;3;1;7;1;3;3;3;4;18;1;4;1347;46;46;1;0;0;4;7;1347;0;6359;7;3;
/org.eclipse.ui.workbench/Eclipse UI/org/eclipse/ui/internal/dialogs/NewWizardCollectionSorter.java;2;0;3;1;1;1;1;2;13;1;2;4063;21;21;1;0;0;2;3;4063;0;6338;3;2;
/org.eclipse.jdt.ui/ui/org/eclipse/jdt/internal/ui/util/TableLayoutComposite.java;1;0;1;1;1;1;1;0;2;0;0;6340;2;2;1;0;0;0;1;6340;0;6340;1;1;
/org.eclipse.ui.ide/src/org/eclipse/ui/internal/dialogs/ProductInfoDialog.java;2;0;3;1;0;0;0;3;6;1;3;1741;6;6;1;0;0;3;3;1741;0;2263;3;2;
/org.eclipse.core.runtime.osgi/src/org/eclipse/core/runtime/jobs/IJobManager.java;1;0;1;1;0;0;0;1;0;0;1;3013;0;0;1;0;0;1;1;3013;0;3013;1;1;
/org.eclipse.jdt.ui/core refactoring/org/eclipse/jdt/internal/corext/refactoring/structure/ASTNodeSearchUtil.java;4;1;14;1;2;2;2;12;67;1;12;42;364;364;1;0;0;12;14;42;0;6340;14;4;
/org.eclipse.swt/Eclipse SWT PI/gtk/org/eclipse/swt/internal/gtk/GdkImage.java;3;0;3;1;1;1;1;2;17;1;2;1653;27;27;1;0;0;2;3;1653;0;6352;3;3;
/org.eclipse.jdt.debug.tests/tests/org/eclipse/jdt/debug/tests/eval/TypeHierarchy_32_1.java;1;0;1;1;0;0;0;1;6;0;1;1274;6;6;1;0;0;1;1;1274;0;1274;1;1;
/org.eclipse.ui.workbench/Eclipse UI/org/eclipse/ui/internal/csm/commands/IImageBindingDefinition.java;1;0;3;1;0;0;0;3;43;2;2;2532;43;43;2;1;0;3;3;2532;1;2562;2;1;
/org.eclipse.jdt.ui.tests.refactoring/resources/MoveInnerToTopLevel/test25/out/Inner.java;1;0;1;1;0;0;0;1;0;0;1;1131;0;0;1;0;0;1;1;1131;0;1131;1;1;
/org.eclipse.releng.basebuilder/plugins/org.eclipse.build.tools/src/org/eclipse/releng/generators/ErrorTracker.java;1;0;4;1;1;1;1;3;17;1;3;2748;41;41;1;0;0;3;4;2748;0;6248;4;1;
/org.eclipse.ant.ui/Ant Tools Support/org/eclipse/ant/internal/ui/launchConfigurations/AntHomeClasspathEntry.java;2;0;5;1;1;1;1;4;37;2;3;4332;58;58;2;1;0;4;5;4472;1;5581;4;2;
/org.eclipse.jdt.ui.tests.refactoring/resources/MoveInnerToTopLevel/test_nonstatic_39/out/Inner.java;2;0;2;1;0;0;0;2;8;1;2;1314;8;8;1;0;0;2;2;1314;0;2563;2;2;
/org.eclipse.ui.tests/Eclipse UI Tests/org/eclipse/ui/tests/multipageeditor/MultiPageEditorTestSuite.java;2;0;4;1;1;1;1;3;4;1;3;4218;8;8;1;0;0;3;4;4218;0;6338;4;2;
/org.eclipse.jdt.core.tests.model/workspace/Converter/test0429/A.java;1;0;1;1;0;0;0;1;0;0;1;3714;0;0;1;0;0;1;1;3714;0;3714;1;1;
/org.eclipse.jdt.ui/ui/org/eclipse/jdt/internal/ui/callhierarchy/FocusOnSelectionAction.java;3;0;7;1;1;1;1;6;35;2;5;155;66;66;2;1;0;6;7;169;1;6340;6;3;
/org.eclipse.jdt.core/model/org/eclipse/jdt/core/CompilationUnitOwner.java;1;0;2;1;0;0;0;2;0;0;1;818;0;0;2;1;0;2;2;818;1;818;1;1;
/org.eclipse.ui.workbench/Eclipse UI/org/eclipse/ui/internal/commands/old/GestureSupport.java;1;0;2;1;0;0;0;2;0;1;2;1322;0;0;1;0;0;2;2;1322;0;1356;2;1;
/org.eclipse.jdt.ui.tests.refactoring/resources/ConvertAnonymousToNested/canConvert/A_test28_in.java;2;0;2;1;0;0;0;2;2;1;2;3291;2;2;1;0;0;2;2;3291;0;3434;2;2;
/org.eclipse.jdt.ui.tests.refactoring/resources/InlineMethodWorkspace/TestCases/receiver_out/TestStaticReceiver.java;1;0;1;1;0;0;0;1;2;0;1;845;2;2;1;0;0;1;1;845;0;845;1;1;
/org.eclipse.ui.views/src/org/eclipse/ui/views/tasklist/ResolveMarkerAction.java;1;0;1;1;0;0;0;1;0;0;1;2738;0;0;1;0;0;1;1;2738;0;2738;1;1;
/org.eclipse.jdt.ui.tests.refactoring/resources/ExtractMethodWorkSpace/ExtractMethodTests/locals_out/A_test515.java;1;0;2;1;0;0;0;2;4;1;2;130;5;5;1;0;0;2;2;130;0;844;2;1;
/org.eclipse.ua.tests/src/org/eclipse/ui/examples/cheatsheets/pattern/actions/OpenJavaProjectWizard.java;1;0;1;1;1;1;1;0;0;0;0;6081;0;0;1;0;0;0;1;6081;0;6081;1;1;
/org.eclipse.update.core/src/org/eclipse/update/internal/model/ConfiguredSite.java;1;0;1;1;0;0;0;1;0;0;1;2634;0;0;1;0;0;1;1;2634;0;2634;1;1;
/org.eclipse.update.ui/src/org/eclipse/update/internal/ui/forms/UnknownObjectForm.java;1;0;1;1;0;0;0;1;0;0;1;755;0;0;1;0;0;1;1;755;0;755;1;1;
/org.eclipse.jdt.ui/ui/org/eclipse/jdt/internal/ui/preferences/TemplateEditorSourceViewerConfiguration.java;3;1;7;1;3;3;3;4;14;1;4;2726;38;38;1;0;0;4;7;2726;0;6340;7;3;
/org.eclipse.jdt.core/model/org/eclipse/jdt/core/IBuffer.java;2;0;3;1;0;0;0;3;41;1;3;581;49;49;1;0;0;3;3;581;0;3560;3;2;
/org.eclipse.jdt.core.tests.model/src/org/eclipse/jdt/core/tests/model/Semaphore.java;1;0;1;1;0;0;0;1;2;0;1;3560;2;2;1;0;0;1;1;3560;0;3560;1;1;
/org.eclipse.jdt.core.tests.model/workspace/Formatter/test491/BundleChain_out.java;1;0;1;1;1;1;1;0;0;0;0;5253;0;0;1;0;0;0;1;5253;0;5253;1;1;
/org.eclipse.ui.workbench/Eclipse UI/org/eclipse/ui/internal/commands/api/ICommandServiceEvent.java;1;0;2;1;0;0;0;2;2;0;1;2562;2;2;2;1;0;2;2;2562;1;2562;1;1;
/org.eclipse.ui.workbench/Eclipse UI/org/eclipse/ui/actions/LabelRetargetAction.java;1;0;2;1;0;0;0;2;21;1;2;1527;22;22;1;0;0;2;2;1527;0;2737;2;1;
/org.eclipse.swt/Eclipse SWT/emulated/treetable/org/eclipse/swt/widgets/SelectableItemWidget.java;5;1;9;1;3;3;3;6;23;1;6;180;97;97;1;0;0;6;9;180;0;6352;9;5;
/org.eclipse.ui.editors/src/org/eclipse/ui/texteditor/MarkerUpdater.java;2;0;3;1;1;1;1;2;65;1;2;1983;70;70;1;0;0;2;3;1983;0;6337;3;2;
/org.eclipse.jdt.core.tests.model/workspace/Converter/src/test0135/Test.java;1;0;1;1;0;0;0;1;0;0;1;3714;0;0;1;0;0;1;1;3714;0;3714;1;1;
/org.eclipse.jdt.ui/ui/org/eclipse/jdt/internal/ui/search/FiltersDialogAction.java;1;0;1;1;1;1;1;0;0;0;0;6143;0;0;1;0;0;0;1;6143;0;6143;1;1;
/org.eclipse.pde.ui/src/org/eclipse/pde/internal/ui/editor/plugin/RuntimePage.java;2;1;9;1;9;9;9;0;10;0;0;5431;56;56;1;0;0;0;9;5431;0;6366;9;2;
/org.eclipse.jdt.core.tests.model/workspace/Formatter/test180/A_out.java;1;0;1;1;0;0;0;1;0;0;1;2425;0;0;1;0;0;1;1;2425;0;2425;1;1;
/org.eclipse.ant.ui/Ant Tools Support/org/eclipse/ant/internal/ui/launchConfigurations/AntStreamsProxy.java;1;0;2;1;0;0;0;2;4;1;2;1811;4;4;1;0;0;2;2;1811;0;2310;2;1;
/org.eclipse.jdt.core/model/org/eclipse/jdt/internal/core/CopyPackageFragmentRootOperation.java;3;0;5;2;0;0;0;5;18;2;4;3034;37;37;2;1;0;5;5;4887;1;4887;4;3;
/org.eclipse.ui.workbench/Eclipse UI/org/eclipse/ui/internal/commands/IKeyConfigurationDefinition.java;1;0;4;1;0;0;0;4;38;1;4;1422;42;42;1;0;0;4;4;1422;0;3128;4;1;
/org.eclipse.jdt.debug/jdi/org/eclipse/jdi/internal/MethodImpl.java;4;0;12;1;1;1;1;11;146;1;11;566;326;326;1;0;0;11;12;566;0;6098;12;4;
/org.eclipse.pde.ui/src/org/eclipse/pde/internal/ui/PDEPluginImages.java;3;3;19;2;7;5;7;12;293;2;11;368;349;349;3;1;2;12;19;5778;3;6336;16;3;
/org.eclipse.ui.workbench/Eclipse UI/org/eclipse/ui/internal/commands/KeySequenceBindingNode.java;4;1;19;2;5;5;5;14;754;2;13;2564;2999;2999;2;1;0;14;19;4127;1;6338;18;4;
/org.eclipse.swt.graphics.text/Eclipse SWT PI/win32/org/eclipse/swt/internal/win32/SCRIPT_CONTROL.java;1;0;1;1;0;0;0;1;0;0;1;2985;0;0;1;0;0;1;1;2985;0;2985;1;1;
/org.eclipse.search.tests/src/org/eclipse/search/tests/filesearch/AnnotationManagerTest.java;1;1;10;1;6;6;6;4;38;1;4;4345;148;148;1;0;0;4;10;4345;0;6116;10;1;
/org.eclipse.team.cvs.ui/src/org/eclipse/team/internal/ccvs/ui/ReleaseCommentDialog.java;2;1;9;1;3;3;3;6;153;1;6;2381;255;255;1;0;0;6;9;2381;0;6337;9;2;
/org.eclipse.jdt.core.tests.model/workspace/Formatter/test020/A_out.java;1;0;1;1;0;0;0;1;0;0;1;2425;0;0;1;0;0;1;1;2425;0;2425;1;1;
/org.eclipse.team.ui/src/org/eclipse/team/ui/sync/SubscriberAction.java;2;0;7;1;0;0;0;7;103;1;7;595;209;209;1;0;0;7;7;595;0;2632;7;2;
/org.eclipse.ui.workbench/Eclipse UI/org/eclipse/ui/internal/activities/IObjectActivityManager.java;1;0;2;1;0;0;0;2;0;0;1;3008;0;0;2;1;0;2;2;3008;1;3008;1;1;
/org.eclipse.jdt.debug.ui/ui/org/eclipse/jdt/internal/debug/ui/sourcelookup/SourceLookupMessages.java;1;0;1;1;0;0;0;1;0;0;1;4167;0;0;1;0;0;1;1;4167;0;4167;1;1;
/org.eclipse.jdt.debug.ui/ui/org/eclipse/jdt/internal/debug/ui/launcher/ResourceExtender.java;2;1;3;1;2;2;2;1;75;0;1;4520;75;75;1;0;0;1;3;4520;0;5508;3;2;
/org.eclipse.pde.ui/src_Forms/org/eclipse/pde/internal/ui/neweditor/feature/IncludedFeaturesSection.java;2;1;4;1;2;2;2;2;95;0;1;4926;126;126;2;1;0;2;4;4926;1;5431;3;2;
/org.eclipse.ui.workbench/Eclipse UI/org/eclipse/ui/model/PerspectiveLabelProvider.java;5;0;6;1;1;1;1;5;138;1;5;1527;186;186;1;0;0;5;6;1527;0;6338;6;5;
/org.eclipse.ant.ui/Ant Tools Support/org/eclipse/ant/ui/internal/preferences/AntPreferencesMessages.java;1;0;4;1;0;0;0;4;10;1;4;250;12;12;1;0;0;4;4;250;0;1811;4;1;
/org.eclipse.ui.ide/src/org/eclipse/ui/internal/registry/ProjectImageRegistry.java;2;0;2;1;0;0;0;2;0;1;2;1526;0;0;1;0;0;2;2;1526;0;2263;2;2;
/org.eclipse.jdt.core.tests.model/workspace/Converter/test0480/A.java;1;0;2;1;0;0;0;2;0;1;2;1289;0;0;1;0;0;2;2;1289;0;3714;2;1;
/org.eclipse.ui.workbench/Eclipse UI/org/eclipse/ui/internal/skins/StackPresentation.java;2;0;4;1;0;0;0;4;84;1;4;4328;99;99;1;0;0;4;4;4328;0;4469;4;2;
/org.eclipse.ui.workbench/Eclipse UI/org/eclipse/ui/progress/WorkbenchUIJob.java;1;0;2;1;0;0;0;2;0;1;2;954;0;0;1;0;0;2;2;954;0;972;2;1;
/org.eclipse.core.variables/src/org/eclipse/core/internal/variables/StringVariableManager.java;3;1;4;1;2;2;2;2;20;1;2;2514;35;35;1;0;0;2;4;2514;0;5661;4;3;
/org.eclipse.jdt.ui.tests.refactoring/resources/InlineMethodWorkspace/TestCases/nameconflict_in/TestSameTypeAfter.java;1;0;1;1;0;0;0;1;2;0;1;845;2;2;1;0;0;1;1;845;0;845;1;1;
/org.eclipse.jdt.core.tests.model/workspace/Converter/test0053/Test.java;1;0;1;1;0;0;0;1;0;0;1;3714;0;0;1;0;0;1;1;3714;0;3714;1;1;
/org.eclipse.update.core/src/org/eclipse/update/internal/core/FeatureExecutableContentConsumer.java;2;1;3;1;2;2;2;1;4;0;1;890;9;9;1;0;0;1;3;890;0;6336;3;2;
/org.eclipse.pde.core/src/org/eclipse/pde/core/osgi/bundle/IBundlePluginModelBase.java;2;1;5;1;4;4;4;1;62;0;1;4203;85;85;1;0;0;1;5;4203;0;5445;5;2;
/org.eclipse.team.cvs.core/src/org/eclipse/team/internal/ccvs/core/ICVSRemoteFile.java;1;0;2;1;1;1;1;1;10;0;1;4216;12;12;1;0;0;1;2;4216;0;6337;2;1;
/org.eclipse.jdt.core.tests.model/workspace/Converter/src/test0369/A.java;1;0;1;1;0;0;0;1;0;0;1;3714;0;0;1;0;0;1;1;3714;0;3714;1;1;
/org.eclipse.ui.intro/src/org/eclipse/ui/intro/internal/model/IntroDiv.java;1;0;6;1;1;1;1;5;83;1;5;4429;100;100;1;0;0;5;6;4429;0;5115;6;1;
/org.eclipse.team.ui/src/org/eclipse/team/internal/ui/preferences/ComboFieldEditor.java;1;0;2;1;0;0;0;2;185;1;2;1316;185;185;1;0;0;2;2;1316;0;1354;2;1;
/org.eclipse.jdt.core.tests.model/workspace/Converter/src/test0470/A.java;1;0;1;1;0;0;0;1;0;0;1;3714;0;0;1;0;0;1;1;3714;0;3714;1;1;
/org.eclipse.core.tests.resources/src/org/eclipse/core/tests/internal/resources/Bug29116Nature.java;1;0;2;1;2;1;2;0;10;0;0;5147;10;10;2;0;1;0;2;5147;1;5147;1;1;
/org.eclipse.pde.core/src/org/eclipse/pde/internal/core/feature/Feature.java;3;2;7;2;4;3;4;3;320;1;3;2229;362;362;2;0;1;3;7;5798;1;6336;6;3;
/org.eclipse.pde.core/src/org/eclipse/pde/internal/core/site/VersionableObject.java;2;1;3;1;2;2;2;1;8;0;1;4203;14;14;1;0;0;1;3;4203;0;6336;3;2;
/org.eclipse.ui.intro/src/org/eclipse/ui/internal/intro/impl/parts/IStandbyContentPart.java;2;1;3;1;3;3;3;0;61;0;0;5115;61;61;1;0;0;0;3;5115;0;5277;3;2;
/org.eclipse.ui.workbench/Eclipse UI/org/eclipse/ui/internal/Geometry.java;1;0;1;1;0;0;0;1;0;0;1;3677;0;0;1;0;0;1;1;3677;0;3677;1;1;
/org.eclipse.help.webapp/src_servlets/org/eclipse/help/internal/webapp/servlet/ContextServlet.java;1;1;6;1;3;3;3;3;58;1;3;2105;112;112;1;0;0;3;6;2105;0;6337;6;1;
/org.eclipse.jdt.ui/ui refactoring/org/eclipse/jdt/internal/ui/refactoring/nls/search/FileEntry.java;2;0;2;1;1;1;1;1;10;0;1;4943;10;10;1;0;0;1;2;4943;0;5591;2;2;
/org.eclipse.jdt.core/model/org/eclipse/jdt/internal/core/SelectionRequestor.java;3;1;8;1;2;2;2;6;259;1;6;818;464;464;1;0;0;6;8;818;0;6222;8;3;
/org.eclipse.debug.core/core/org/eclipse/debug/internal/core/variables/ResourceNameExpander.java;2;0;2;1;0;0;0;2;0;1;2;737;0;0;1;0;0;2;2;737;0;2120;2;2;
/org.eclipse.debug.ui/ui/org/eclipse/debug/ui/variables/PromptExpanderBase.java;1;0;3;1;0;0;0;3;103;2;2;316;103;103;2;1;0;3;3;316;1;550;2;1;
/org.eclipse.jdt.debug/eval/org/eclipse/jdt/internal/debug/eval/ast/instructions/NoOp.java;1;0;1;1;0;0;0;1;3;0;1;2497;3;3;1;0;0;1;1;2497;0;2497;1;1;
/org.eclipse.jdt.ui/ui/org/eclipse/jdt/internal/ui/preferences/ClasspathVariablesPreferencePage.java;2;0;3;1;1;1;1;2;39;1;2;597;51;51;1;0;0;2;3;597;0;6340;3;2;
/org.eclipse.core.tests.runtime/src/org/eclipse/core/tests/internal/plugins/SoftPrereqTest_8.java;1;0;1;1;0;0;0;1;0;0;1;3014;0;0;1;0;0;1;1;3014;0;3014;1;1;
/org.eclipse.jdt.ui/core refactoring/org/eclipse/jdt/internal/corext/refactoring/participants/xml/EvaluationResult.java;1;0;2;1;0;0;0;2;0;1;2;4091;0;0;1;0;0;2;2;4091;0;4108;2;1;
/org.eclipse.jdt.ui.tests.refactoring/resources/TypeConstraints/A_testConstraints5.java;1;0;1;1;0;0;0;1;0;0;1;65;0;0;1;0;0;1;1;65;0;65;1;1;
/org.eclipse.text/src/org/eclipse/jface/text/IDocumentExtension.java;2;0;2;1;1;1;1;1;17;0;1;4554;19;19;1;0;0;1;2;4554;0;6296;2;2;
/org.eclipse.jdt.ui.tests.refactoring/resources/DeleteSourceReference/test3/in/A.java;1;0;1;1;0;0;0;1;0;0;1;1652;0;0;1;0;0;1;1;1652;0;1652;1;1;
/org.eclipse.help.webapp/src_servlets/org/eclipse/help/internal/webapp/data/ServletResources.java;1;1;10;1;3;3;3;7;76;2;6;180;188;188;2;1;0;7;10;1084;1;6337;9;1;
/org.eclipse.pde.ui/src_Forms/org/eclipse/pde/internal/ui/neweditor/feature/RequiresSection.java;2;1;4;1;2;2;2;2;93;0;1;4926;109;109;2;1;0;2;4;4926;1;5431;3;2;
/org.eclipse.team.ui/src/org/eclipse/team/ui/SaveablePartDialog.java;2;1;4;1;4;4;4;0;94;0;0;5192;119;119;1;0;0;0;4;5192;0;6337;4;2;
/org.eclipse.team.ui/src/org/eclipse/team/ui/synchronize/views/SyncInfoSetTreeContentProvider.java;1;0;1;1;0;0;0;1;0;0;1;3764;0;0;1;0;0;1;1;3764;0;3764;1;1;
/org.eclipse.debug.core/core/org/eclipse/debug/internal/core/sourcelookup/containers/CompositeSourceContainer.java;1;0;6;1;0;0;0;6;47;2;5;3678;61;61;2;1;0;6;6;3678;1;4949;5;1;
/org.eclipse.ant.ui/Ant Editor/org/eclipse/ant/internal/ui/editor/text/MultilineDamagerRepairer.java;1;0;1;1;0;0;0;1;0;0;1;2252;0;0;1;0;0;1;1;2252;0;2252;1;1;
/org.eclipse.pde.ui/src_Forms/org/eclipse/pde/internal/ui/neweditor/plugin/ExtensionElementDetails.java;2;2;14;1;3;2;3;11;131;2;8;3834;262;262;2;3;1;11;14;4284;4;5431;10;2;
/org.eclipse.jdt.ui/ui/org/eclipse/jdt/internal/ui/javaeditor/EditorWorkbookLinkManager.java;1;0;1;1;1;1;1;0;0;0;0;5550;0;0;1;0;0;0;1;5550;0;5550;1;1;
/org.eclipse.pde.ui/src/org/eclipse/pde/internal/ui/editor/site/SiteForm.java;1;0;2;1;0;0;0;2;41;1;2;2311;41;41;1;0;0;2;2;2311;0;3721;2;1;
/org.eclipse.jdt.ui/ui/org/eclipse/jdt/internal/ui/javaeditor/JavaEditor.java;7;5;156;3;53;29;53;103;780;3;79;505;7951;7951;5;24;24;103;156;5121;48;6340;108;7;
/org.eclipse.jdt.ui/ui refactoring/org/eclipse/jdt/internal/ui/refactoring/IVisibilityChangeListener.java;2;0;2;1;1;1;1;1;2;0;1;363;3;3;1;0;0;1;2;363;0;6340;2;2;
/org.eclipse.team.webdav/src/org/eclipse/team/ui/target/MappingSelectionPage.java;1;0;1;1;0;0;0;1;0;0;1;3461;0;0;1;0;0;1;1;3461;0;3461;1;1;
/org.eclipse.ui.cheatsheets/src/org/eclipse/ui/cheatsheets/CheatSheetStandbyContent.java;1;0;2;1;0;0;0;2;0;1;2;4663;0;0;1;0;0;2;2;4663;0;4693;2;1;
/org.eclipse.jdt.core/compiler/org/eclipse/jdt/internal/compiler/lookup/ImportBinding.java;1;0;1;1;0;0;0;1;2;0;1;3560;2;2;1;0;0;1;1;3560;0;3560;1;1;
/org.eclipse.core.tests.runtime/src/org/eclipse/core/tests/runtime/jobs/JobQueueTest.java;2;0;6;1;1;1;1;5;22;1;5;850;38;38;1;0;0;5;6;850;0;5149;6;2;
/org.eclipse.search/search/org/eclipse/search/internal/ui/SearchPageDescriptor.java;2;0;5;1;1;1;1;4;22;1;4;1101;77;77;1;0;0;4;5;1101;0;5455;5;2;
/org.eclipse.pde.core/srcnew/org/eclipse/pde/internal/core/plugin/IDocumentNode.java;1;0;1;1;1;1;1;0;0;0;0;5431;0;0;1;0;0;0;1;5431;0;5431;1;1;
/org.eclipse.ui.internal.r21presentation/src/org/eclipse/ui/internal/r21presentation/widgets/CTabFolderListener.java;1;0;1;1;1;1;1;0;0;0;0;5275;0;0;1;0;0;0;1;5275;0;5275;1;1;
/org.eclipse.debug.core/core/org/eclipse/debug/internal/core/memory/IExtendedMemoryBlock.java;1;0;1;1;1;1;1;0;0;0;0;5254;0;0;1;0;0;0;1;5254;0;5254;1;1;
/org.eclipse.team.webdav/src/org/eclipse/team/core/target/ITeamStatus.java;1;0;1;1;0;0;0;1;0;0;1;3438;0;0;1;0;0;1;1;3438;0;3438;1;1;
/org.eclipse.text/src/org/eclipse/text/edits/InsertEdit.java;2;0;5;1;1;1;1;4;18;1;4;1986;37;37;1;0;0;4;5;1986;0;6340;5;2;
/org.eclipse.jdt.debug/jdi/org/eclipse/jdi/internal/VerboseWriter.java;1;0;1;1;0;0;0;1;6;0;1;1276;6;6;1;0;0;1;1;1276;0;1276;1;1;
/org.eclipse.debug.ui/ui/org/eclipse/debug/internal/ui/views/variables/VariableViewToggleAction.java;1;0;1;1;0;0;0;1;41;0;1;3281;41;41;1;0;0;1;1;3281;0;3281;1;1;
/org.eclipse.pde.ui/src/org/eclipse/pde/internal/ui/editor/plugin/MatchSection.java;3;2;10;1;10;9;10;0;60;0;0;5431;139;139;2;0;1;0;10;5664;1;6336;9;3;
/org.eclipse.help.base/src/org/eclipse/help/internal/browser/MozillaFactory.java;1;1;6;1;3;3;3;3;55;2;2;1740;116;116;2;1;0;3;6;1740;1;6337;5;1;
/org.eclipse.ui.ide/extensions/org/eclipse/ui/actions/TextActionHandler.java;1;0;1;1;0;0;0;1;0;0;1;2263;0;0;1;0;0;1;1;2263;0;2263;1;1;
/org.eclipse.ui.workbench/Eclipse UI/org/eclipse/ui/commands/ICommandHandler.java;1;0;3;1;0;0;0;3;6;1;3;1223;6;6;1;0;0;3;3;1223;0;1321;3;1;
/org.eclipse.jdt.core.tests.model/workspace/Converter/test0304/Test.java;1;0;1;1;0;0;0;1;0;0;1;3714;0;0;1;0;0;1;1;3714;0;3714;1;1;
/org.eclipse.jdt.ui.tests.refactoring/resources/ExtractMethodWorkSpace/ExtractMethodTests/locals_in/A_test539.java;1;0;1;1;0;0;0;1;2;0;1;844;2;2;1;0;0;1;1;844;0;844;1;1;
/org.eclipse.core.tests.resources/src/org/eclipse/core/tests/resources/Comparator.java;1;0;2;1;2;1;2;0;268;0;0;5147;268;268;2;0;1;0;2;5147;1;5147;1;1;
/org.eclipse.team.examples.filesystem/src/org/eclipse/team/examples/filesystem/ui/FileSystemSynchronizeOperation.java;1;0;1;1;1;1;1;0;0;0;0;6206;0;0;1;0;0;0;1;6206;0;6206;1;1;
/org.eclipse.ui.forms/src/org/eclipse/ui/forms/IFormPart.java;1;0;6;1;1;1;1;5;63;2;4;4068;76;76;2;1;0;5;6;4284;1;6336;5;1;
/org.eclipse.ui.ide/src/org/eclipse/ui/wizards/datatransfer/ZipFileStructureProvider.java;1;0;1;1;0;0;0;1;0;0;1;1511;0;0;1;0;0;1;1;1511;0;1511;1;1;
/org.eclipse.core.tests.runtime/src/org/eclipse/core/tests/internal/plugins/ExtensiveRequiresTest.java;1;0;1;1;0;0;0;1;0;0;1;3014;0;0;1;0;0;1;1;3014;0;3014;1;1;
/org.eclipse.jdt.core.tests.model/workspace/Converter/src/test0137/Test.java;1;0;1;1;0;0;0;1;0;0;1;3714;0;0;1;0;0;1;1;3714;0;3714;1;1;
/org.eclipse.jdt.ui/ui/org/eclipse/jdt/internal/ui/wizards/buildpaths/ExclusionInclusionDialog.java;2;1;3;1;2;2;2;1;167;0;1;4928;169;169;1;0;0;1;3;4928;0;6340;3;2;
/org.eclipse.ui.workbench/Eclipse UI/org/eclipse/ui/internal/intro/IntroDescriptor.java;2;0;6;1;1;1;1;5;41;1;5;3632;70;70;1;0;0;5;6;3632;0;5489;6;2;
/org.eclipse.osgi/resolver/src/org/eclipse/osgi/internal/resolver/PackageSpecificationImpl.java;3;1;3;1;2;2;2;1;7;0;1;3013;11;11;1;0;0;1;3;3013;0;6337;3;3;
/org.eclipse.team.core/src/org/eclipse/team/core/subscribers/WorkingSetFilteredSyncInfoCollector.java;2;0;3;2;2;1;2;1;184;0;1;4982;184;184;2;0;1;1;3;5358;1;5358;2;2;
/org.eclipse.update.tests.core/src/org/eclipse/update/tests/mirror/TestRemoteEmbeddedFeatureMirror.java;1;0;2;1;0;0;0;2;14;0;1;2104;14;14;2;1;0;2;2;2104;1;2104;1;1;
/org.eclipse.jdt.core/model/org/eclipse/jdt/core/IJavaModelMarker.java;2;0;2;1;0;0;0;2;2;1;2;2173;4;4;1;0;0;2;2;2173;0;3560;2;2;
/org.eclipse.jdt.debug.tests/testprograms/org/eclipse/debug/tests/targets/StepIntoSelectionClass.java;3;0;3;1;1;1;1;2;9;1;2;631;13;13;1;0;0;2;3;631;0;6337;3;3;
/org.eclipse.core.runtime/src/org/eclipse/core/internal/registry/EclipseBundleListener.java;5;3;20;2;13;9;13;7;294;1;7;3049;475;475;3;0;4;7;20;5637;4;6151;16;5;
/org.eclipse.ltk.ui.refactoring/src/org/eclipse/ltk/internal/ui/refactoring/NotCancelableProgressMonitor.java;1;0;1;1;1;1;1;0;0;0;0;5269;0;0;1;0;0;0;1;5269;0;5269;1;1;
/org.eclipse.help.base/src/org/eclipse/help/browser/IBrowser.java;1;1;4;1;2;2;2;2;57;1;2;1740;65;65;1;0;0;2;4;1740;0;6337;4;1;
/org.eclipse.jdt.core.tests.model/workspace/Converter/src/javadoc/testBug51478/X3.java;1;0;2;1;1;1;1;1;2;0;1;3994;2;2;1;0;0;1;2;3994;0;5869;2;1;
/org.eclipse.ui.workbench/Eclipse UI/org/eclipse/ui/internal/misc/WorkInProgressMessages.java;1;0;2;1;0;0;0;2;0;1;2;2334;0;0;1;0;0;2;2;2334;0;3710;2;1;
/org.eclipse.team.cvs.core/src/org/eclipse/team/internal/ccvs/core/syncinfo/OptimizedRemoteSynchronizer.java;2;0;9;1;0;0;0;9;77;2;8;532;148;148;2;1;0;9;9;1954;1;4216;8;2;
/org.eclipse.ui.workbench/Eclipse UI/org/eclipse/ui/internal/activities/service/IActivityServiceListener.java;1;0;2;1;0;0;0;2;0;1;2;2444;0;0;1;0;0;2;2;2444;0;2491;2;1;
/org.eclipse.ui.workbench/Eclipse UI/org/eclipse/ui/internal/misc/StringMatcher.java;3;1;3;1;2;2;2;1;6;0;1;1442;10;10;1;0;0;1;3;1442;0;6338;3;3;
/org.eclipse.jdt.ui.tests.refactoring/resources/ExtractMethodWorkSpace/ExtractMethodTests/initializer_in/A_test1003.java;1;0;1;1;0;0;0;1;0;0;1;3310;0;0;1;0;0;1;1;3310;0;3310;1;1;
/org.eclipse.team.tests.cvs.core/src/org/eclipse/team/tests/ccvs/ui/old/Result.java;1;0;2;1;0;0;0;2;0;1;2;2632;0;0;1;0;0;2;2;2632;0;4216;2;1;
/org.eclipse.jdt.core.tests.model/workspace/Formatter/test298/A_in.java;1;0;1;1;0;0;0;1;0;0;1;2444;0;0;1;0;0;1;1;2444;0;2444;1;1;
/org.eclipse.ui.ide/src/org/eclipse/ui/internal/registry/ProjectImageRegistryReader.java;2;0;7;2;0;0;0;7;19;2;5;1526;39;39;2;2;0;7;7;1536;2;2263;5;2;
/org.eclipse.help/src/org/eclipse/help/internal/search/SearchResults.java;1;0;4;1;0;0;0;4;54;1;4;105;96;96;1;0;0;4;4;105;0;2732;4;1;
/org.eclipse.swt/Eclipse SWT PI/win32/org/eclipse/swt/internal/win32/NMTVCUSTOMDRAW.java;1;0;1;1;0;0;0;1;1;0;1;2915;1;1;1;0;0;1;1;2915;0;2915;1;1;
/org.eclipse.ui.workbench/Eclipse UI/org/eclipse/ui/internal/commands/XCaptureEvent.java;1;0;2;1;0;0;0;2;0;1;2;1695;0;0;1;0;0;2;2;1695;0;1721;2;1;
/org.eclipse.debug.ui/ui/org/eclipse/debug/internal/ui/sourcelookup/SourceContainerLabelProvider.java;1;0;4;1;0;0;0;4;40;1;4;3770;77;77;1;0;0;4;4;3770;0;4949;4;1;
/org.eclipse.debug.core/core/org/eclipse/debug/core/sourcelookup/containers/ContainerSourceContainer.java;1;0;2;1;1;1;1;1;0;0;1;4949;0;0;1;0;0;1;2;4949;0;5109;2;1;
/org.eclipse.core.resources/src/org/eclipse/core/internal/refresh/RefreshJob.java;2;1;6;1;2;2;2;4;10;1;4;3681;23;23;1;0;0;4;6;3681;0;5275;6;2;
/org.eclipse.ui.workbench/Eclipse UI/org/eclipse/ui/internal/contexts/registry/PreferenceContextRegistry.java;1;0;2;1;0;0;0;2;0;1;2;1422;0;0;1;0;0;2;2;1422;0;1724;2;1;
/org.eclipse.jdt.core.tests.model/workspace/Converter/test0091/Test.java;1;0;1;1;0;0;0;1;0;0;1;3714;0;0;1;0;0;1;1;3714;0;3714;1;1;
/org.eclipse.jdt.ui/ui/org/eclipse/jdt/internal/ui/compare/LocalHistoryActionGroup.java;2;0;2;1;1;1;1;1;26;0;1;1730;28;28;1;0;0;1;2;1730;0;6340;2;2;
/org.eclipse.ui.ide/src/org/eclipse/ui/dialogs/WizardExportPage.java;2;0;4;1;0;0;0;4;46;1;4;1511;50;50;1;0;0;4;4;1511;0;2263;4;2;
/org.eclipse.swt.tests/JUnit Tests/org/eclipse/swt/tests/junit/browser/Browser2.java;2;1;5;1;2;2;2;3;21;2;2;2767;42;42;2;1;0;3;5;2767;1;6352;4;2;
/org.eclipse.swt.tests/JUnit Tests/org/eclipse/swt/tests/junit/browser/Browser5.java;1;0;5;1;0;0;0;5;46;3;2;3134;82;82;3;3;0;5;5;3166;3;3166;2;1;
/org.eclipse.jdt.debug.tests/test plugin/org/eclipse/jdt/debug/testplugin/TestLaunchDelegate.java;2;0;3;1;0;0;0;3;18;1;3;4371;20;20;1;0;0;3;3;4371;0;4585;3;2;
/org.eclipse.ltk.core.refactoring/src/org/eclipse/ltk/core/refactoring/participants/CheckConditionsContext.java;1;1;5;1;4;4;4;1;24;0;1;4845;37;37;1;0;0;1;5;4845;0;6351;5;1;
/org.eclipse.update.tests.core/src/org/eclipse/update/tests/api/TestNestedFeatureAPI.java;2;0;3;1;1;1;1;2;64;1;2;3813;84;84;1;0;0;2;3;3813;0;6336;3;2;
/org.eclipse.ui.workbench.texteditor/src/org/eclipse/ui/texteditor/MarkerUtilities.java;1;0;2;1;0;0;0;2;12;1;2;1569;12;12;1;0;0;2;2;1569;0;2741;2;1;
/org.eclipse.ui.ide/src/org/eclipse/ui/internal/ide/dialogs/FileSystemResourceExporter.java;1;0;1;1;0;0;0;1;0;0;1;2264;0;0;1;0;0;1;1;2264;0;2264;1;1;
/org.eclipse.debug.core/core/org/eclipse/debug/internal/core/memory/IMemoryRenderingManager.java;1;0;1;1;1;1;1;0;0;0;0;5254;0;0;1;0;0;0;1;5254;0;5254;1;1;
/org.eclipse.jdt.ui.tests.refactoring/resources/Paste/test3/out/B.java;1;0;1;1;0;0;0;1;0;0;1;1311;0;0;1;0;0;1;1;1311;0;1311;1;1;
/org.eclipse.jdt.ui.tests.refactoring/resources/TypeConstraints/A_testConstraints21.java;1;0;1;1;0;0;0;1;0;0;1;67;0;0;1;0;0;1;1;67;0;67;1;1;
/org.eclipse.ui.cheatsheets/src/org/eclipse/ui/cheatsheets/OpenCheatSheetFromHelpAction.java;2;0;5;1;0;0;0;5;30;1;5;4428;55;55;1;0;0;5;5;4428;0;4662;5;2;
/org.eclipse.core.runtime/src/org/eclipse/core/internal/content/TextContentDescriber.java;1;1;2;1;2;2;2;0;13;0;0;5405;13;13;1;0;0;0;2;5405;0;5682;2;1;
/org.eclipse.update.ui.forms/Eclipse Forms/org/eclipse/ui/forms/internal/widgets/ParagraphSegment.java;1;0;2;1;0;0;0;2;0;1;2;3138;0;0;1;0;0;2;2;3138;0;4157;2;1;
/org.eclipse.ui.views/src/org/eclipse/ui/views/markers/internal/IField.java;2;0;2;1;0;0;0;2;0;1;2;755;0;0;1;0;0;2;2;755;0;2738;2;2;
/org.eclipse.swt/Eclipse SWT Browser/mozilla/org/eclipse/swt/browser/BrowserSite.java;1;0;3;1;0;0;0;3;138;1;3;1654;138;138;1;0;0;3;3;1654;0;1707;3;1;
/org.eclipse.jdt.ui/ui/org/eclipse/jdt/internal/ui/wizards/OpenPackageWizardAction.java;1;0;1;1;1;1;1;0;2;0;0;6340;2;2;1;0;0;0;1;6340;0;6340;1;1;
/org.eclipse.pde.ui/templates_3.0/editor/java/XMLTagScanner.java;1;0;1;1;0;0;0;1;0;0;1;2786;0;0;1;0;0;1;1;2786;0;2786;1;1;
/org.eclipse.team.cvs.ui/src/org/eclipse/team/internal/ccvs/ui/model/RemoteContentProvider.java;2;0;10;1;0;0;0;10;111;2;9;990;214;214;2;1;0;10;10;1064;1;3253;9;2;
/org.eclipse.team.ui/src/org/eclipse/team/internal/ui/synchronize/actions/DirectionFilterActionGroup.java;2;2;5;2;4;3;4;1;203;0;1;5082;218;218;2;0;1;1;5;5358;1;6337;4;2;
/org.eclipse.jface.text/src/org/eclipse/jface/text/AbstractInformationControlManager.java;2;2;13;2;4;3;4;9;198;1;9;692;419;419;2;0;1;9;13;5099;1;6359;12;2;
/org.eclipse.ui.externaltools/External Tools Base/org/eclipse/ui/externaltools/internal/model/ExternalToolBuilder.java;2;1;24;1;5;5;5;19;89;2;17;198;387;387;2;2;0;19;24;753;2;6336;22;2;
/org.eclipse.jdt.ui.tests.refactoring/resources/TypeConstraints/A_testConstraints19.java;1;0;1;1;0;0;0;1;0;0;1;65;0;0;1;0;0;1;1;65;0;65;1;1;
/org.eclipse.jdt.core.tests.model/workspace/Converter/test0061/Test.java;1;0;1;1;0;0;0;1;0;0;1;3714;0;0;1;0;0;1;1;3714;0;3714;1;1;
/org.eclipse.jdt.core.tests.model/workspace/Formatter/test051/A_out.java;1;0;1;1;0;0;0;1;0;0;1;2425;0;0;1;0;0;1;1;2425;0;2425;1;1;
/org.eclipse.core.resources/src/org/eclipse/core/internal/resources/NatureManager.java;2;1;4;1;3;3;3;1;1140;0;1;1477;1180;1180;1;0;0;1;4;1477;0;5484;4;2;
/org.eclipse.jdt.ui.tests.refactoring/resources/ExtractMethodWorkSpace/ExtractMethodTests/return_in/A_test723.java;1;0;1;1;0;0;0;1;2;0;1;844;2;2;1;0;0;1;1;844;0;844;1;1;
/org.eclipse.team.ui/src/org/eclipse/team/ui/sync/actions/RefactorActionGroup.java;1;0;1;1;0;0;0;1;0;0;1;2446;0;0;1;0;0;1;1;2446;0;2446;1;1;
/org.eclipse.search/search/org/eclipse/search/internal/ui/text/FileSearchQuery.java;2;2;15;1;9;8;9;6;46;1;6;3711;162;162;2;0;1;6;15;5867;1;6340;14;2;
/org.eclipse.pde.ui/src/org/eclipse/pde/internal/ui/feature/FeatureCustomHandlerPage.java;2;0;4;1;0;0;0;4;12;2;3;3791;23;23;2;1;0;4;4;3791;1;3840;3;2;
/org.eclipse.jdt.ui/ui/org/eclipse/jdt/internal/ui/packageview/FileTransferDragAdapter.java;1;0;1;1;1;1;1;0;2;0;0;6340;2;2;1;0;0;0;1;6340;0;6340;1;1;
/org.eclipse.team.ftp/src/org/eclipse/team/internal/ftp/subscriber/FTPRemoteResourceVariantTree.java;2;0;4;1;1;1;1;3;8;1;3;4259;14;14;1;0;0;3;4;4259;0;6337;4;2;
/org.eclipse.jdt.core.tests.model/workspace/Converter/src/test0194/Test.java;1;0;1;1;0;0;0;1;0;0;1;3714;0;0;1;0;0;1;1;3714;0;3714;1;1;
/org.eclipse.jdt.core.tests.model/workspace/Formatter/test468/A_out.java;1;0;1;1;0;0;0;1;0;0;1;3915;0;0;1;0;0;1;1;3915;0;3915;1;1;
/org.eclipse.jdt.core.tests.model/workspace/Converter/test0253/Test.java;1;0;1;1;0;0;0;1;0;0;1;3714;0;0;1;0;0;1;1;3714;0;3714;1;1;
/org.eclipse.ui.intro/src/org/eclipse/ui/internal/intro/impl/model/IntroDiv.java;1;1;6;1;6;6;6;0;19;0;0;5115;33;33;1;0;0;0;6;5115;0;5639;6;1;
/org.eclipse.ui.views/src/org/eclipse/ui/views/markers/internal/DialogProblemProperties.java;2;0;3;1;0;0;0;3;16;1;3;755;16;16;1;0;0;3;3;755;0;2738;3;2;
/org.eclipse.update.ui/srcnew/org/eclipse/update/internal/ui/wizards/SearchRunner.java;2;0;2;1;0;0;0;2;0;1;2;329;0;0;1;0;0;2;2;329;0;413;2;2;
/org.eclipse.jdt.ui/core refactoring/org/eclipse/jdt/internal/corext/refactoring/participants/xml/JavaTypeExtender.java;1;0;4;1;0;0;0;4;21;1;4;2546;23;23;1;0;0;4;4;2546;0;4941;4;1;
/org.eclipse.jdt.core.tests.model/workspace/Formatter/test303/A_out.java;1;0;1;1;0;0;0;1;0;0;1;2442;0;0;1;0;0;1;1;2442;0;2442;1;1;
/org.eclipse.ui.ide/src/org/eclipse/ui/views/navigator/CollapseAllAction.java;2;0;2;1;0;0;0;2;4;1;2;2208;4;4;1;0;0;2;2;2208;0;3308;2;2;
/org.eclipse.update.ui.forms/Eclipse Forms/org/eclipse/ui/forms/FormWizard.java;1;0;3;1;0;0;0;3;33;2;2;3176;33;33;2;1;0;3;3;3176;1;4157;2;1;
/org.eclipse.ui.workbench/Eclipse UI/org/eclipse/ui/handles/NotDefinedException.java;1;0;4;1;0;0;0;4;2;1;4;1294;3;3;1;0;0;4;4;1294;0;1507;4;1;
/org.eclipse.update.ui/src/org/eclipse/update/internal/ui/search/SearchCategory.java;1;0;1;1;0;0;0;1;0;0;1;824;0;0;1;0;0;1;1;824;0;824;1;1;
/org.eclipse.jdt.junit/src/org/eclipse/jdt/internal/junit/launcher/JUnitMainTab.java;3;2;11;1;8;7;8;3;247;1;3;1320;396;396;2;0;1;3;11;6124;1;6340;10;3;
/org.eclipse.swt/Eclipse SWT PI/motif/org/eclipse/swt/internal/motif/XineramaScreenInfo.java;1;0;1;1;0;0;0;1;0;0;1;16;0;0;1;0;0;1;1;16;0;16;1;1;
/org.eclipse.pde.ui/src_Forms/org/eclipse/pde/internal/ui/neweditor/schema/NewReferenceAction.java;2;0;2;1;1;1;1;1;0;0;1;4856;0;0;1;0;0;1;2;4856;0;5431;2;2;
/org.eclipse.update.ui.forms/src/org/eclipse/ui/forms/parts/HyperlinkListener.java;1;0;2;1;0;0;0;2;0;1;2;3038;0;0;1;0;0;2;2;3038;0;3095;2;1;
/org.eclipse.jdt.ui.tests.refactoring/resources/RenamePackage/testImportFromMultiRoots1/out/srcPrg/q/A.java;1;0;3;1;0;0;0;3;6;1;3;3219;11;11;1;0;0;3;3;3219;0;4585;3;1;
/org.eclipse.swt/Eclipse SWT Custom Widgets/common/org/eclipse/swt/custom/TableCursor.java;5;2;17;1;7;6;7;10;218;2;9;7;591;591;2;1;1;10;17;3963;2;6352;15;5;
/org.eclipse.jdt.ui/ui/org/eclipse/jdt/ui/actions/ImportActionGroup.java;4;1;4;1;3;3;3;1;11;0;1;762;33;33;1;0;0;1;4;762;0;6340;4;4;
/org.eclipse.core.expressions.tests/src/org/eclipse/core/internal/expressions/tests/Adaptee.java;1;0;1;1;0;0;0;1;0;0;1;4507;0;0;1;0;0;1;1;4507;0;4507;1;1;
/org.eclipse.team.ui/src/org/eclipse/team/internal/ui/sync/actions/OpenInCompareAction.java;2;0;18;2;0;0;0;18;139;2;16;488;443;443;2;2;0;18;18;1181;2;2632;16;2;
/org.eclipse.ui.externaltools/Ant Tools Support/org/eclipse/ui/externaltools/internal/ant/launchConfigurations/AntPropertiesTab.java;1;0;1;1;0;0;0;1;0;0;1;282;0;0;1;0;0;1;1;282;0;282;1;1;
/org.eclipse.update/src/org/eclipse/update/internal/ui/UMWizardPageLaunchHistoryComplete.java;1;0;1;1;1;1;1;0;0;0;0;6339;0;0;1;0;0;0;1;6339;0;6339;1;1;
/org.eclipse.jdt.ui/ui/org/eclipse/jdt/internal/ui/dialogs/ListDialog.java;1;0;1;1;1;1;1;0;2;0;0;6340;2;2;1;0;0;0;1;6340;0;6340;1;1;
/org.eclipse.ui.cheatsheets/src/org/eclipse/ui/internal/cheatsheets/data/Action.java;1;0;1;1;1;1;1;0;0;0;0;5189;0;0;1;0;0;0;1;5189;0;5189;1;1;
/org.eclipse.jdt.ui.tests.refactoring/resources/ExtractMethodWorkSpace/ExtractMethodTests/wiki_out/A_test2003.java;1;0;2;1;0;0;0;2;7;1;2;130;11;11;1;0;0;2;2;130;0;844;2;1;
/org.eclipse.jdt.ui/core extension/org/eclipse/jdt/internal/corext/codemanipulation/AddCustomConstructorOperation.java;4;0;14;2;1;1;1;13;85;1;13;1044;323;323;1;0;0;13;14;1044;0;6340;14;4;
/org.eclipse.ui.workbench/Eclipse UI/org/eclipse/ui/activities/service/AbstractActivityService.java;1;0;2;1;0;0;0;2;0;1;2;2896;0;0;1;0;0;2;2;2896;0;3066;2;1;
/org.eclipse.ant.ui/Ant Editor/org/eclipse/ant/internal/ui/editor/xml/AntEditorXMLMessages.java;1;0;2;1;0;0;0;2;0;1;2;1811;0;0;1;0;0;2;2;1811;0;3661;2;1;
/org.eclipse.jdt.ui/ui/org/eclipse/jdt/internal/ui/search/PathNameSorter.java;3;1;3;1;2;2;2;1;36;0;1;3251;40;40;1;0;0;1;3;3251;0;6340;3;3;
/org.eclipse.update.configurator/src/org/eclipse/update/internal/configurator/PluginEntry.java;1;0;3;1;1;1;1;2;17;1;2;3265;27;27;1;0;0;2;3;3265;0;5616;3;1;
/org.eclipse.jdt.ui.tests.refactoring/resources/InlineMethodWorkspace/TestCases/cast_in/TestNotOverloaded.java;1;0;1;1;0;0;0;1;0;0;1;955;0;0;1;0;0;1;1;955;0;955;1;1;
/org.eclipse.ui.workbench/Eclipse UI/org/eclipse/ui/activities/IIdentifierListener.java;3;1;5;1;2;2;2;3;11;1;3;2989;22;22;1;0;0;3;5;2989;0;6338;5;3;
/org.eclipse.pde.ui/src_Forms/org/eclipse/pde/internal/ui/neweditor/schema/SchemaFormOutlinePage.java;2;1;4;1;2;2;2;2;85;1;2;4856;119;119;1;0;0;2;4;4856;0;5431;4;2;
/org.eclipse.jdt.core.tests.model/workspace/Converter/junit/extensions/RepeatedTest.java;1;0;1;1;0;0;0;1;0;0;1;3714;0;0;1;0;0;1;1;3714;0;3714;1;1;
/org.eclipse.update.core/src/org/eclipse/update/standalone/RemoveSiteCommand.java;1;1;5;1;5;5;5;0;27;0;0;5231;51;51;1;0;0;0;5;5231;0;6336;5;1;
/org.eclipse.jdt.ui/ui/org/eclipse/jdt/internal/ui/search/OpenJavaSearchPageAction.java;2;1;3;1;3;3;3;0;10;0;0;5396;16;16;1;0;0;0;3;5396;0;6340;3;2;
/org.eclipse.jdt.ui/ui refactoring/org/eclipse/jdt/internal/ui/refactoring/nls/search/NLSSearchQuery.java;1;1;3;1;2;2;2;1;24;0;1;4943;30;30;1;0;0;1;3;4943;0;5397;3;1;
/org.eclipse.jdt.ui.tests.refactoring/resources/IntroduceFactory/positive/staticInstance_in.java;1;0;2;1;0;0;0;2;0;1;2;2846;0;0;1;0;0;2;2;2846;0;2862;2;1;
/org.eclipse.jdt.core/dom/org/eclipse/jdt/core/dom/SingleMemberAnnotation.java;2;2;12;1;4;3;4;8;142;1;8;4054;281;281;2;0;1;8;12;5268;1;5335;11;2;
/org.eclipse.ui.workbench/Eclipse UI/org/eclipse/ui/internal/csm/activities/AbstractActivityRegistry.java;1;0;4;1;0;0;0;4;6;1;4;2225;11;11;1;0;0;4;4;2225;0;2444;4;1;
/org.eclipse.team.tests.cvs.core/src/org/eclipse/team/tests/ccvs/ui/logformatter/PrintCSVDiffVisitor.java;1;0;1;1;0;0;0;1;0;0;1;2632;0;0;1;0;0;1;1;2632;0;2632;1;1;
/org.eclipse.jdt.ui/ui/org/eclipse/jdt/internal/ui/preferences/formatter/BracesTabPage.java;1;0;10;1;1;1;1;9;87;2;8;3103;272;272;2;1;0;9;10;3103;1;5207;9;1;
/org.eclipse.update.ui.forms/Eclipse Forms/org/eclipse/ui/forms/editor/MultiPageKeyBindingService.java;1;0;4;1;0;0;0;4;24;1;4;3499;48;48;1;0;0;4;4;3499;0;4157;4;1;
/org.eclipse.pde.core/src/org/eclipse/pde/internal/core/bundle/BundleFragment.java;2;1;7;1;7;7;7;0;72;0;0;5445;109;109;1;0;0;0;7;5445;0;6336;7;2;
/org.eclipse.debug.core/core/org/eclipse/debug/internal/core/sourcelookup/containers/DirectorySourceContainerType.java;2;0;6;2;1;1;1;5;20;3;2;3678;24;24;3;3;0;5;6;4949;3;5672;3;2;
/org.eclipse.swt/Eclipse SWT/gtk1x/org/eclipse/swt/widgets/List.java;2;0;2;1;0;0;0;2;11;1;2;110;11;11;1;0;0;2;2;110;0;2327;2;2;
/org.eclipse.jdt.ui/ui/org/eclipse/jdt/ui/search/ISearchRequestor.java;3;1;5;1;4;4;4;1;6;0;1;5075;16;16;1;0;0;1;5;5075;0;6334;5;3;
/org.eclipse.jdt.ui/ui/org/eclipse/jdt/ui/actions/ConvertNestedToTopAction.java;3;0;11;1;1;1;1;10;191;2;9;42;400;400;2;1;0;10;11;135;1;6340;10;3;
/org.eclipse.releng.basebuilder/plugins/org.eclipse.build.tools/org.eclipse.build.tools/src/org/eclipse/releng/generators/ErrorTracker.java;1;0;1;1;1;1;1;0;0;0;0;5735;0;0;1;0;0;0;1;5735;0;5735;1;1;
/org.eclipse.jdt.core.tests.model/workspace/Converter/test0519/A.java;1;0;2;1;0;0;0;2;0;1;2;3612;0;0;1;0;0;2;2;3612;0;3714;2;1;
/org.eclipse.jdt.ui/ui/org/eclipse/jdt/internal/ui/text/folding/DefaultJavaFoldingPreferenceBlock.java;1;1;2;1;2;2;2;0;6;0;0;5440;6;6;1;0;0;0;2;5440;0;6340;2;1;
/org.eclipse.text/src/org/eclipse/text/edits/CopyTargetEdit.java;2;0;4;1;1;1;1;3;36;1;3;1986;65;65;1;0;0;3;4;1986;0;6340;4;2;
/org.eclipse.jdt.ui.tests.refactoring/test cases/org/eclipse/jdt/ui/tests/actions/CopyResourcesToClipboardActionTest.java;1;0;2;1;0;0;0;2;12;1;2;469;14;14;1;0;0;2;2;469;0;1111;2;1;
/org.eclipse.ui.intro/src/org/eclipse/ui/intro/internal/model/IntroLink.java;1;0;5;1;1;1;1;4;115;1;4;4429;127;127;1;0;0;4;5;4429;0;5115;5;1;
/org.eclipse.team.core/src/org/eclipse/team/core/sync/ISyncTreeSubscriberFactory.java;1;0;1;1;0;0;0;1;0;0;1;494;0;0;1;0;0;1;1;494;0;494;1;1;
/org.eclipse.ui.workbench/Eclipse UI/org/eclipse/ui/internal/commands/registry/ContextBinding.java;1;0;2;1;0;0;0;2;0;1;2;1077;0;0;1;0;0;2;2;1077;0;1222;2;1;
/org.eclipse.compare.examples.xml/src/org/eclipse/compare/examples/xml/IdMap.java;1;0;2;1;0;0;0;2;2;1;2;1106;2;2;1;0;0;2;2;1106;0;3938;2;1;
/org.eclipse.pde.core/src/org/eclipse/pde/core/osgi/bundle/IBundleFragmentModel.java;2;1;4;1;3;3;3;1;16;0;1;4203;24;24;1;0;0;1;4;4203;0;5445;4;2;
/org.eclipse.update.core/src/org/eclipse/update/internal/api/search/UpdateSearchScope.java;1;0;5;1;0;0;0;5;21;2;4;3270;41;41;2;1;0;5;5;3917;1;4928;4;1;
/org.eclipse.jdt.ui/core extension/org/eclipse/jdt/internal/corext/textmanipulation/TextEditCopier.java;1;0;6;1;0;0;0;6;236;2;4;1607;254;254;2;2;0;6;6;1869;2;1946;4;1;
/org.eclipse.jdt.ui.tests.refactoring/resources/InlineMethodWorkspace/TestCases/simple_out/TestSuper.java;1;0;1;1;0;0;0;1;2;0;1;845;2;2;1;0;0;1;1;845;0;845;1;1;
/org.eclipse.jdt.core.tests.model/workspace/JavaSearchMultipleProjects1/lib/p/X.java;1;0;1;1;0;0;0;1;3;0;1;3024;3;3;1;0;0;1;1;3024;0;3024;1;1;
/org.eclipse.ltk.core.refactoring/src/org/eclipse/ltk/core/refactoring/CreateChangeOperation.java;1;2;10;1;7;6;7;3;29;1;3;4845;63;63;2;0;1;3;10;6338;1;6338;9;1;
/org.eclipse.team.cvs.core/src/org/eclipse/team/internal/ccvs/core/client/Commit.java;2;0;4;1;1;1;1;3;9;1;3;1672;20;20;1;0;0;3;4;1672;0;6337;4;2;
/org.eclipse.jdt.ui.tests.refactoring/resources/PullUp/test43/out/A.java;1;0;2;1;0;0;0;2;2;1;2;346;2;2;1;0;0;2;2;346;0;1690;2;1;
/org.eclipse.jdt.launching/launching/org/eclipse/jdt/launching/LibraryLocation.java;2;0;3;1;0;0;0;3;12;1;3;685;20;20;1;0;0;3;3;685;0;2988;3;2;
/org.eclipse.pde.ui/src/org/eclipse/pde/internal/ui/wizards/plugin/FragmentContentPage.java;2;1;4;1;2;2;2;2;196;1;2;3840;202;202;1;0;0;2;4;3840;0;6336;4;2;
/org.eclipse.core.tools/src/org/eclipse/core/tools/runtime/LoadedClassesViewSorter.java;1;0;1;1;1;1;1;0;0;0;0;6302;0;0;1;0;0;0;1;6302;0;6302;1;1;
/org.eclipse.jface.text/src/org/eclipse/jface/text/source/IChangeRulerColumn.java;3;1;4;1;2;2;2;2;8;1;2;1240;18;18;1;0;0;2;4;1240;0;6353;4;3;
/org.eclipse.jdt.core.tests.model/workspace/Converter/test0172/Test.java;1;0;1;1;0;0;0;1;0;0;1;3714;0;0;1;0;0;1;1;3714;0;3714;1;1;
/org.eclipse.ui.ide/src/org/eclipse/ui/views/navigator/WorkspaceActionGroup.java;6;0;8;1;1;1;1;7;18;1;7;2208;56;56;1;0;0;7;8;2208;0;6338;8;6;
/org.eclipse.pde.ui/src/org/eclipse/pde/internal/ui/wizards/feature/NewFeatureProjectWizard.java;3;1;9;1;7;7;7;2;320;1;2;3840;450;450;1;0;0;2;9;3840;0;6336;9;3;
/org.eclipse.core.resources/src/org/eclipse/core/internal/indexing/IndexCursor.java;1;0;1;1;1;1;1;0;211;0;0;5146;211;211;1;0;0;0;1;5146;0;5146;1;1;
/org.eclipse.core.filebuffers/src/org/eclipse/core/filebuffers/annotations/AbstractMarkerAnnotationModel.java;1;0;1;1;0;0;0;1;0;0;1;2815;0;0;1;0;0;1;1;2815;0;2815;1;1;
/org.eclipse.pde.ui/src/org/eclipse/pde/internal/ui/editor/feature/IncludeFeaturesWizard.java;2;1;3;1;2;2;2;1;4;0;1;4203;7;7;1;0;0;1;3;4203;0;6336;3;2;
/org.eclipse.ui.workbench/Eclipse UI/org/eclipse/ui/internal/contexts/registry/AbstractRegistry.java;1;0;2;1;0;0;0;2;0;0;1;1396;0;0;2;1;0;2;2;1396;1;1396;1;1;
/org.eclipse.core.tests.runtime/src/org/eclipse/core/tests/internal/plugins/JarSearchTests.java;1;0;1;1;0;0;0;1;0;0;1;3014;0;0;1;0;0;1;1;3014;0;3014;1;1;
/org.eclipse.debug.ui/ui/org/eclipse/debug/internal/ui/launchConfigurations/DeleteLaunchConfigurationAction.java;1;0;1;1;0;0;0;1;4;0;1;473;4;4;1;0;0;1;1;473;0;473;1;1;
/org.eclipse.jdt.core.tests.model/workspace/Converter/test0193/Test.java;1;0;1;1;0;0;0;1;0;0;1;3714;0;0;1;0;0;1;1;3714;0;3714;1;1;
/org.eclipse.jdt.debug/model/org/eclipse/jdt/internal/debug/core/breakpoints/JavaPatternBreakpoint.java;4;1;5;1;2;2;2;3;7;1;3;363;24;24;1;0;0;3;5;363;0;6336;5;4;
/org.eclipse.core.tests.runtime/src/org/eclipse/core/tests/internal/plugin/a/ExtensionDirectCompilerReferenceToOtherClass.java;1;0;1;1;1;1;1;0;16;0;0;5149;16;16;1;0;0;0;1;5149;0;5149;1;1;
/org.eclipse.debug.ui/ui/org/eclipse/debug/internal/ui/sourcelookup/SourceContainerAdapterFactory.java;1;0;1;1;0;0;0;1;0;0;1;4627;0;0;1;0;0;1;1;4627;0;4627;1;1;
/org.eclipse.team.tests.cvs.core/src/org/eclipse/team/tests/ccvs/ui/old/PrintCSVDiffVisitor.java;1;0;2;1;0;0;0;2;0;1;2;2632;0;0;1;0;0;2;2;2632;0;4216;2;1;
/org.eclipse.jdt.core/codeassist/org/eclipse/jdt/internal/codeassist/complete/CompletionOnKeyword2.java;2;0;4;1;0;0;0;4;5;1;4;85;11;11;1;0;0;4;4;85;0;3560;4;2;
/org.eclipse.text/src/org/eclipse/jface/text/IDocumentPartitioner.java;1;0;1;1;1;1;1;0;60;0;0;6296;60;60;1;0;0;0;1;6296;0;6296;1;1;
/org.eclipse.jdt.core/compiler/org/eclipse/jdt/internal/compiler/util/HashtableOfObject.java;2;0;2;1;0;0;0;2;26;1;2;3560;28;28;1;0;0;2;2;3560;0;4469;2;2;
/org.eclipse.jdt.ui/ui/org/eclipse/jdt/internal/ui/compare/CompareDialog.java;1;0;1;1;1;1;1;0;2;0;0;6340;2;2;1;0;0;0;1;6340;0;6340;1;1;
/org.eclipse.ui.workbench/Eclipse UI/org/eclipse/ui/commands/IHandlerListener.java;2;0;2;1;1;1;1;1;9;0;1;4088;9;9;1;0;0;1;2;4088;0;5231;2;2;
/org.eclipse.swt/Eclipse SWT/emulated/textlayout/org/eclipse/swt/graphics/TextLayout.java;3;2;28;1;18;15;18;10;532;2;8;4565;1091;1091;2;2;3;10;28;4565;5;6352;23;3;
/org.eclipse.team.ui/src/org/eclipse/team/internal/ui/ConfigureProjectWizardMainPage.java;1;0;1;1;0;0;0;1;0;0;1;993;0;0;1;0;0;1;1;993;0;993;1;1;
/org.eclipse.ui.editors/src/org/eclipse/ui/internal/editors/quickdiff/QuickDiffToggleAction.java;1;0;2;1;0;0;0;2;0;1;2;1118;0;0;1;0;0;2;2;1118;0;1214;2;1;
/org.eclipse.swt/Eclipse SWT PI/gtk/org/eclipse/swt/internal/accessibility/gtk/AtkObjectClass.java;4;0;4;1;1;1;1;3;46;1;3;1214;65;65;1;0;0;3;4;1214;0;6352;4;4;
/org.eclipse.jdt.ui/core refactoring/org/eclipse/jdt/internal/corext/refactoring/changes/CopyCompilationUnitChange.java;3;1;6;1;2;2;2;4;17;2;3;596;49;49;2;1;0;4;6;596;1;6340;5;3;
/org.eclipse.jdt.core/model/org/eclipse/jdt/internal/core/jdom/DOMMethod.java;3;1;6;1;2;2;2;4;46;1;4;90;83;83;1;0;0;4;6;90;0;5916;6;3;
/org.eclipse.ui.externaltools/Ant Runner Support/org/eclipse/ui/externaltools/internal/ant/logger/AntProcessBuildLogger.java;1;0;1;1;0;0;0;1;0;0;1;282;0;0;1;0;0;1;1;282;0;282;1;1;
/org.eclipse.jdt.core.tests.model/src/org/eclipse/jdt/core/tests/model/JavaConventionTests.java;1;0;2;1;0;0;0;2;2;1;2;3560;4;4;1;0;0;2;2;3560;0;4843;2;1;
/org.eclipse.jdt.ui/ui/org/eclipse/jdt/internal/ui/wizards/OpenInterfaceWizardAction.java;1;0;1;1;1;1;1;0;2;0;0;6340;2;2;1;0;0;0;1;6340;0;6340;1;1;
/org.eclipse.swt.tools/JNI Generation/org/eclipse/swt/tools/internal/MetaDataGenerator.java;2;0;2;1;0;0;0;2;14;1;2;4175;14;14;1;0;0;2;2;4175;0;4201;2;2;
/org.eclipse.pde.ui/sandbox/org/eclipse/pde/internal/ui/editor/standalone/manifest/PluginManifestSourceEditor.java;1;0;2;1;0;0;0;2;0;1;2;2320;0;0;1;0;0;2;2;2320;0;2906;2;1;
/org.eclipse.core.tests.runtime/src/org/eclipse/core/tests/internal/plugins/FragmentResolveTest_3.java;1;0;1;1;0;0;0;1;0;0;1;3014;0;0;1;0;0;1;1;3014;0;3014;1;1;
/org.eclipse.jdt.ui.tests.refactoring/resources/MoveMembers/test30/out/A.java;1;0;1;1;0;0;0;1;0;0;1;1651;0;0;1;0;0;1;1;1651;0;1651;1;1;
/org.eclipse.osgi/core/framework/org/eclipse/osgi/framework/internal/core/PackageAdminImpl.java;3;2;15;1;15;12;15;0;59;0;0;5116;315;315;2;0;3;0;15;5116;3;6104;12;3;
/org.eclipse.osgi/eclipseAdaptor/src/org/eclipse/osgi/service/pluginconversion/PluginConversionException.java;1;2;3;1;3;2;3;0;7;0;0;5277;7;7;2;0;1;0;3;5321;1;5321;2;1;
/org.eclipse.ant.ui/Ant Tools Support/org/eclipse/ant/ui/internal/preferences/AntRuntimePreferencePage.java;1;0;3;1;0;0;0;3;4;1;3;250;4;4;1;0;0;3;3;250;0;1811;3;1;
/org.eclipse.team.tests.cvs.core/src/org/eclipse/team/tests/ccvs/core/AllTests.java;2;0;6;1;0;0;0;6;17;1;6;790;32;32;1;0;0;6;6;790;0;2947;6;2;
/org.eclipse.ui.workbench/Eclipse UI/org/eclipse/ui/part/MarkerTransfer.java;2;0;2;1;0;0;0;2;6;1;2;1;6;6;1;0;0;2;2;1;0;2737;2;2;
/org.eclipse.pde.ui/src/org/eclipse/pde/internal/ui/feature/NewSiteProjectWizard.java;2;0;7;1;0;0;0;7;327;1;7;2618;666;666;1;0;0;7;7;2618;0;3840;7;2;
/org.eclipse.ui.views/src/org/eclipse/ui/views/navigator/PasteAction.java;2;0;4;1;0;0;0;4;72;1;4;66;90;90;1;0;0;4;4;66;0;2738;4;2;
/org.eclipse.update.core/src/org/eclipse/update/internal/operations/FeatureHierarchyElement.java;1;1;4;1;3;3;3;1;4;0;1;1521;7;7;1;0;0;1;4;1521;0;6336;4;1;
/org.eclipse.search/new search/org/eclipse/search/ui/text/ITextSearchResult.java;1;0;2;1;0;0;0;2;0;1;2;3474;0;0;1;0;0;2;2;3474;0;3711;2;1;
/org.eclipse.jdt.core.tests.model/workspace/Formatter/test013/A_out.java;1;0;4;1;0;0;0;4;7;2;3;2425;10;10;2;1;0;4;4;3029;1;3086;3;1;
/org.eclipse.ui.workbench/Eclipse UI/org/eclipse/ui/internal/LayoutPartSash.java;4;2;6;1;4;3;4;2;343;1;2;4015;413;413;2;0;1;2;6;5922;1;6338;5;4;
/org.eclipse.debug.ui/ui/org/eclipse/debug/internal/ui/stringsubstitution/StringSubstitutionMessages.java;2;0;2;1;0;0;0;2;13;1;2;2046;13;13;1;0;0;2;2;2046;0;2572;2;2;
/org.eclipse.update.ui/src/org/eclipse/update/internal/ui/properties/NamedObjectPropertyPage.java;1;0;1;1;0;0;0;1;0;0;1;794;0;0;1;0;0;1;1;794;0;794;1;1;
/org.eclipse.jdt.ui.tests.refactoring/resources/Copy/test_import_container_yes_cu/in/C.java;1;0;1;1;0;0;0;1;0;0;1;696;0;0;1;0;0;1;1;696;0;696;1;1;
/org.eclipse.swt.tests/JUnit Tests/org/eclipse/swt/tests/junit/Test_org_eclipse_swt_events_MouseMoveListener.java;1;0;1;1;0;0;0;1;16;0;1;2175;16;16;1;0;0;1;1;2175;0;2175;1;1;
/org.eclipse.ui.tutorials.rcp.part3/src/org/eclipse/ui/tutorials/rcp/part3/RcpApplication.java;1;0;1;1;1;1;1;0;0;0;0;5118;0;0;1;0;0;0;1;5118;0;5118;1;1;
/org.eclipse.jdt.ui/ui/org/eclipse/jdt/internal/ui/text/java/hover/JavaExpandHover.java;4;2;11;2;7;6;7;4;350;2;3;2544;451;451;2;1;1;4;11;3826;2;6340;9;4;
/org.eclipse.jdt.ui/ui/org/eclipse/jdt/internal/ui/packageview/PackageExplorerLabelProvider.java;1;0;1;1;1;1;1;0;2;0;0;6340;2;2;1;0;0;0;1;6340;0;6340;1;1;
/org.eclipse.ui.workbench/Eclipse UI/org/eclipse/ui/IMarkerActionFilter.java;1;0;1;1;0;0;0;1;0;0;1;2737;0;0;1;0;0;1;1;2737;0;2737;1;1;
/org.eclipse.ui.workbench/Eclipse UI/org/eclipse/ui/contexts/activationservice/ContextActivationServiceEvent.java;1;0;2;1;0;0;0;2;0;1;2;3066;0;0;1;0;0;2;2;3066;0;3109;2;1;
/org.eclipse.jdt.ui.tests.refactoring/resources/MoveInnerToTopLevel/test_nonstatic_39/in/A.java;1;0;1;1;0;0;0;1;0;0;1;1314;0;0;1;0;0;1;1;1314;0;1314;1;1;
/org.eclipse.team.ftp/src/org/eclipse/team/internal/ftp/subscriber/FTPSynchronizer.java;2;0;4;1;1;1;1;3;53;1;3;3494;74;74;1;0;0;3;4;3494;0;6337;4;2;
/org.eclipse.ui.workbench/Eclipse UI/org/eclipse/ui/internal/ToolbarFloatingWindow.java;3;0;6;1;1;1;1;5;189;1;5;3746;357;357;1;0;0;5;6;3746;0;5338;6;3;
/org.eclipse.ui.workbench/Eclipse UI/org/eclipse/ui/actions/WorkspaceAction.java;1;0;1;1;0;0;0;1;0;0;1;2737;0;0;1;0;0;1;1;2737;0;2737;1;1;
/org.eclipse.jdt.core.tests.model/workspace/Formatter/test117/A_in.java;1;0;1;1;0;0;0;1;0;0;1;2425;0;0;1;0;0;1;1;2425;0;2425;1;1;
/org.eclipse.team.ui/src/org/eclipse/team/internal/ui/dialogs/PreferencePageContainerDialog.java;1;0;7;1;1;1;1;6;421;2;5;987;467;467;2;1;0;6;7;987;1;6337;6;1;
/org.eclipse.ltk.core.refactoring/src/org/eclipse/ltk/core/refactoring/participants/MoveProcessor.java;1;1;6;1;3;3;3;3;63;1;3;4845;107;107;1;0;0;3;6;4845;0;6340;6;1;
/org.eclipse.jdt.core.tests.model/workspace/Completion/src/CompletionStaticMethodDeclaration6.java;1;0;1;1;0;0;0;1;0;0;1;3039;0;0;1;0;0;1;1;3039;0;3039;1;1;
/org.eclipse.jface.text/src/org/eclipse/jface/text/rules/IPartitionTokenScanner.java;1;0;1;1;1;1;1;0;2;0;0;6340;2;2;1;0;0;0;1;6340;0;6340;1;1;
/org.eclipse.pde.ui/src/org/eclipse/pde/internal/ui/launcher/RunWorkbenchAction.java;2;1;2;1;2;2;2;0;6;0;0;5408;6;6;1;0;0;0;2;5408;0;6336;2;2;
/org.eclipse.swt/Eclipse SWT Mozilla/common/org/eclipse/swt/internal/mozilla/nsIWebNavigation.java;1;0;2;1;0;0;0;2;14;1;2;1654;14;14;1;0;0;2;2;1654;0;2568;2;1;
/org.eclipse.ui.ide/src/org/eclipse/ui/ide/IDEContributionItemFactory.java;3;0;3;1;0;0;0;3;2;1;3;1937;2;2;1;0;0;3;3;1937;0;3067;3;3;
/org.eclipse.jdt.core.tests.model/workspace/Converter/src/junit/awtui/AboutDialog.java;1;0;1;1;0;0;0;1;0;0;1;3714;0;0;1;0;0;1;1;3714;0;3714;1;1;
/org.eclipse.ui.forms.examples/src/org/eclipse/ui/forms/examples/internal/rcp/FreeFormPage.java;1;0;6;1;1;1;1;5;26;3;3;4075;44;44;3;2;0;5;6;4135;2;5781;4;1;
/org.eclipse.jdt.ui/ui/org/eclipse/jdt/internal/ui/wizards/ClassPathDetector.java;3;1;7;1;2;2;2;5;51;1;5;451;109;109;1;0;0;5;7;451;0;6340;7;3;
/org.eclipse.jdt.debug.ui/ui/org/eclipse/jdt/debug/ui/IJavaDebugUIConstants.java;3;1;6;1;2;2;2;4;7;1;4;670;32;32;1;0;0;4;6;670;0;6336;6;3;
/org.eclipse.ui.workbench/Eclipse UI/org/eclipse/ui/internal/commands/Scope.java;1;0;1;1;0;0;0;1;0;0;1;607;0;0;1;0;0;1;1;607;0;607;1;1;
/org.eclipse.ant.ui/Ant Tools Support/org/eclipse/ant/internal/ui/launchConfigurations/AntTargetsTab.java;3;2;32;2;8;7;8;24;156;2;21;1811;769;769;2;3;1;24;32;2059;4;6336;28;3;
/org.eclipse.jdt.core.tests.model/workspace/Formatter/test282/A_out.java;1;0;1;1;0;0;0;1;0;0;1;2443;0;0;1;0;0;1;1;2443;0;2443;1;1;
/org.eclipse.jdt.core.tests.model/workspace/Converter/src/test0123/Test.java;1;0;1;1;0;0;0;1;0;0;1;3714;0;0;1;0;0;1;1;3714;0;3714;1;1;
/org.eclipse.ui.workbench/Eclipse UI/org/eclipse/ui/internal/dialogs/FakeActionSetDescriptor.java;1;0;1;1;0;0;0;1;0;0;1;830;0;0;1;0;0;1;1;830;0;830;1;1;
/org.eclipse.pde.core/src/org/eclipse/pde/core/plugin/IPluginExtensionPoint.java;3;1;5;1;4;4;4;1;30;0;1;4203;42;42;1;0;0;1;5;4203;0;6336;5;3;
/org.eclipse.ant.ui/Ant Editor/org/eclipse/ant/internal/ui/dtd/IDfm.java;1;0;1;1;0;0;0;1;0;0;1;1811;0;0;1;0;0;1;1;1811;0;1811;1;1;
/org.eclipse.update.core/srcnew/org/eclipse/update/standalone/Script.java;1;0;2;1;0;0;0;2;0;1;2;646;0;0;1;0;0;2;2;646;0;671;2;1;
/org.eclipse.jdt.core.tests.model/workspace/Completion/src3/test0018/Test.java;1;0;1;1;1;1;1;0;0;0;0;5181;0;0;1;0;0;0;1;5181;0;5181;1;1;
/org.eclipse.jdt.core/compiler/org/eclipse/jdt/internal/compiler/ast/DoStatement.java;3;0;9;2;2;1;2;7;32;2;6;989;84;84;2;1;1;7;9;989;2;5339;7;3;
/org.eclipse.jdt.core.tests.model/workspace/Converter/test0272/Test.java;1;0;1;1;0;0;0;1;0;0;1;3714;0;0;1;0;0;1;1;3714;0;3714;1;1;
/org.eclipse.jdt.ui.tests.refactoring/resources/StructureSelectionAction/A_testZeroLength3.java;1;0;1;1;1;1;1;0;0;0;0;6144;0;0;1;0;0;0;1;6144;0;6144;1;1;
/org.eclipse.compare/compare/org/eclipse/compare/internal/IStructureCreatorDescriptor.java;1;0;1;1;1;1;1;0;0;0;0;5165;0;0;1;0;0;0;1;5165;0;5165;1;1;
/org.eclipse.update.core/src/org/eclipse/update/internal/api/search/UpdateSearchRequest.java;1;0;5;1;0;0;0;5;4;2;4;3270;7;7;2;1;0;5;5;3917;1;4928;4;1;
/org.eclipse.debug.ui/ui/org/eclipse/debug/internal/ui/stringsubstitution/FolderPrompt.java;2;1;3;1;2;2;2;1;3;0;1;2081;5;5;1;0;0;1;3;2081;0;6339;3;2;
/org.eclipse.ui.console/src/org/eclipse/ui/console/actions/TextViewerAction.java;3;1;4;1;2;2;2;2;14;1;2;1988;27;27;1;0;0;2;4;1988;0;6336;4;3;
/org.eclipse.update.core/src/org/eclipse/update/internal/operations/InstallOperation.java;1;1;11;1;5;5;5;6;41;1;6;825;101;101;1;0;0;6;11;825;0;6336;11;1;
/org.eclipse.jdt.launching/launching/org/eclipse/jdt/internal/launching/DefaultProjectClasspathEntryResolver.java;1;0;2;1;0;0;0;2;0;1;2;3810;0;0;1;0;0;2;2;3810;0;4167;2;1;
/org.eclipse.pde.ui/src/org/eclipse/pde/internal/ui/editor/site/SitePage.java;1;0;2;1;0;0;0;2;2;1;2;2311;2;2;1;0;0;2;2;2311;0;3721;2;1;
/org.eclipse.ui.views/src/org/eclipse/ui/views/internal/markers/DialogTaskFilter.java;1;0;2;1;0;0;0;2;0;0;1;749;0;0;2;1;0;2;2;749;1;749;1;1;
/org.eclipse.jdt.ui.tests.refactoring/resources/ExtractMethodWorkSpace/ExtractMethodTests/wiki_out/A_test2001.java;1;0;2;1;0;0;0;2;6;1;2;130;10;10;1;0;0;2;2;130;0;844;2;1;
/org.eclipse.ui.intro/src/org/eclipse/ui/intro/internal/model/AbstractCommonIntroElement.java;1;0;2;1;0;0;0;2;0;1;2;4898;0;0;1;0;0;2;2;4898;0;4948;2;1;
/org.eclipse.jdt.core.tests.model/workspace/Formatter/test145/A_out.java;1;0;1;1;0;0;0;1;0;0;1;2425;0;0;1;0;0;1;1;2425;0;2425;1;1;
/org.eclipse.ui.workbench/Eclipse UI/org/eclipse/ui/internal/roles/RoleLabelProvider.java;2;0;4;1;0;0;0;4;59;2;3;1952;69;69;2;1;0;4;4;2443;1;2443;3;2;
/org.eclipse.ui.tests/UI Test Utils/org/eclipse/ui/tests/internal/util/VerifyDialog.java;2;0;2;1;1;1;1;1;2;0;1;5087;4;4;1;0;0;1;2;5087;0;6338;2;2;
/org.eclipse.swt/Eclipse SWT Mozilla/gtk/org/eclipse/swt/internal/mozilla/GRE.java;1;1;4;1;2;2;2;2;54;1;2;1654;82;82;1;0;0;2;4;1654;0;5641;4;1;
/org.eclipse.jdt.core.tests.model/workspace/Converter/test0011/Test.java;1;0;1;1;0;0;0;1;0;0;1;3714;0;0;1;0;0;1;1;3714;0;3714;1;1;
/org.eclipse.jdt.ui/ui/org/eclipse/jdt/internal/ui/text/JavaMultiPassReconciler.java;1;0;2;1;0;0;0;2;0;1;2;3829;0;0;1;0;0;2;2;3829;0;3930;2;1;
/org.eclipse.core.tools/src/org/eclipse/core/tools/AbstractTreeContentProvider.java;1;0;1;1;1;1;1;0;0;0;0;6302;0;0;1;0;0;0;1;6302;0;6302;1;1;
/org.eclipse.team.ui/src/org/eclipse/team/ui/synchronize/viewers/SyncInfoCompareInput.java;2;0;10;2;0;0;0;10;285;3;7;3972;440;440;3;3;0;10;10;4234;3;4632;7;2;
/org.eclipse.jdt.ui/core refactoring/org/eclipse/jdt/internal/corext/refactoring/changes/CreatePackageChange.java;2;1;6;1;2;2;2;4;32;1;4;3708;56;56;1;0;0;4;6;3708;0;6340;6;2;
/org.eclipse.jdt.core.tests.model/workspace/Formatter/test296/A_out.java;1;0;1;1;0;0;0;1;0;0;1;2444;0;0;1;0;0;1;1;2444;0;2444;1;1;
/org.eclipse.ui.ide/extensions/org/eclipse/ui/IMarkerResolutionGenerator.java;1;0;1;1;0;0;0;1;0;0;1;2263;0;0;1;0;0;1;1;2263;0;2263;1;1;
/org.eclipse.osgi/osgi/src/org/eclipse/osgi/service/resolver/StateObjectFactory.java;3;0;10;1;1;1;1;9;131;2;8;3013;207;207;2;1;0;9;10;4127;1;5117;9;3;
/org.eclipse.jdt.debug.tests/tests/org/eclipse/jdt/debug/tests/AutomatedSuite.java;5;1;41;2;5;5;5;36;222;2;30;463;690;690;2;6;0;36;41;629;6;6337;35;5;
/org.eclipse.core.runtime/src/org/eclipse/core/runtime/PlatformObject.java;2;0;5;1;1;1;1;4;126;1;4;3013;262;262;1;0;0;4;5;3013;0;5117;5;2;
/org.eclipse.jdt.ui/ui/org/eclipse/jdt/internal/ui/preferences/formatter/ProfileVersioner.java;2;1;9;1;2;2;2;7;414;1;7;3554;791;791;1;0;0;7;9;3554;0;6120;9;2;
/org.eclipse.ui.workbench/Eclipse UI/org/eclipse/ui/internal/dialogs/PathVariablesGroup.java;1;0;1;1;0;0;0;1;0;0;1;2737;0;0;1;0;0;1;1;2737;0;2737;1;1;
/org.eclipse.ui.views/src/org/eclipse/ui/views/tasklist/FiltersAction.java;1;0;1;1;0;0;0;1;0;0;1;2738;0;0;1;0;0;1;1;2738;0;2738;1;1;
/org.eclipse.update.core/src/org/eclipse/update/internal/api/operations/IConfigFeatureOperation.java;1;0;2;1;0;0;0;2;0;1;2;3270;0;0;1;0;0;2;2;3270;0;4928;2;1;
/org.eclipse.jdt.launching/launching/org/eclipse/jdt/internal/launching/DefaultEntryResolver.java;1;0;3;1;0;0;0;3;4;1;3;3810;5;5;1;0;0;3;3;3810;0;4974;3;1;
/org.eclipse.jdt.core.tests.model/workspace/Formatter/test500/A_out.java;1;0;1;1;1;1;1;0;0;0;0;5871;0;0;1;0;0;0;1;5871;0;5871;1;1;
/org.eclipse.jdt.core.tests.model/workspace/Formatter/test238/A_out.java;1;0;1;1;0;0;0;1;0;0;1;2437;0;0;1;0;0;1;1;2437;0;2437;1;1;
/org.eclipse.debug.core/core/org/eclipse/debug/internal/core/stringsubstitution/IStringVariableManager.java;2;0;6;1;0;0;0;6;43;2;5;1118;117;117;2;1;0;6;6;1118;1;2514;5;2;
/org.eclipse.jdt.ui/ui/org/eclipse/jdt/internal/ui/text/comment/HTMLEntity2JavaReader.java;2;0;2;1;1;1;1;1;2;0;1;3573;2;2;1;0;0;1;2;3573;0;6340;2;2;
/org.eclipse.update.ui.win32/src/org/eclipse/welcome/internal/webbrowser/IEmbeddedWebBrowser.java;1;0;1;1;0;0;0;1;0;0;1;907;0;0;1;0;0;1;1;907;0;907;1;1;
/org.eclipse.ui.externaltools/Ant Editor/org/eclipse/ui/externaltools/internal/ant/editor/xml/IAntEditorConstants.java;1;0;1;1;0;0;0;1;0;0;1;282;0;0;1;0;0;1;1;282;0;282;1;1;
/org.eclipse.ui.workbench/Eclipse UI/org/eclipse/ui/internal/CloseAllAction.java;1;0;1;1;0;0;0;1;73;0;1;2737;73;73;1;0;0;1;1;2737;0;2737;1;1;
/org.eclipse.jdt.junit/src/org/eclipse/jdt/internal/junit/ui/ShowPreviousFailureAction.java;3;0;3;1;1;1;1;2;2;1;2;498;4;4;1;0;0;2;3;498;0;6340;3;3;
/org.eclipse.jdt.ui.tests.refactoring/resources/ExtractMethodWorkSpace/ExtractMethodTests/return_out/A_test708.java;1;0;1;1;0;0;0;1;6;0;1;844;6;6;1;0;0;1;1;844;0;844;1;1;
/org.eclipse.core.tests.runtime/src/org/eclipse/core/tests/runtime/content/SampleBinaryDescriber.java;2;1;3;1;2;2;2;1;6;0;1;4941;6;6;1;0;0;1;3;4941;0;5195;3;2;
/org.eclipse.pde.ui/src/org/eclipse/pde/internal/ui/wizards/templates/EditorTemplate.java;3;2;12;1;5;4;5;7;60;2;6;2184;138;138;2;1;1;7;12;3435;2;6336;10;3;
/org.eclipse.jface/src/org/eclipse/jface/dialogs/InputDialog.java;3;3;9;2;7;5;7;2;341;1;2;635;403;403;3;0;2;2;9;5509;2;6338;7;3;
/org.eclipse.jdt.ui/core refactoring/org/eclipse/jdt/internal/corext/refactoring/changes/UndoTextFileChange.java;1;0;6;1;0;0;0;6;96;1;6;3646;134;134;1;0;0;6;6;3646;0;4624;6;1;
/org.eclipse.search/search/org/eclipse/search/internal/ui/util/ExceptionHandler.java;2;1;2;1;2;2;2;0;12;0;0;6116;14;14;1;0;0;0;2;6116;0;6340;2;2;
/org.eclipse.jface.text/src/org/eclipse/jface/text/source/IVerticalRuler.java;2;1;4;1;2;2;2;2;48;1;2;4944;52;52;1;0;0;2;4;4944;0;6361;4;2;
/org.eclipse.ui.workbench/Eclipse UI/org/eclipse/ui/internal/PartPlaceholder.java;2;1;2;1;2;2;2;0;20;0;0;5110;22;22;1;0;0;0;2;5110;0;6338;2;2;
/org.eclipse.ui.workbench/Eclipse UI/org/eclipse/ui/dialogs/WizardNewLinkPage.java;1;0;1;1;0;0;0;1;0;0;1;2737;0;0;1;0;0;1;1;2737;0;2737;1;1;
/org.eclipse.core.resources/src/org/eclipse/core/internal/watson/IElementTreeData.java;1;0;1;1;1;1;1;0;14;0;0;5146;14;14;1;0;0;0;1;5146;0;5146;1;1;
/org.eclipse.jdt.debug.ui/ui/org/eclipse/jdt/internal/debug/ui/JDIModelPresentation.java;5;1;37;2;2;2;2;35;199;3;29;749;1007;1007;3;6;0;35;37;2269;6;6041;31;5;
/org.eclipse.jdt.ui/ui/org/eclipse/jdt/internal/ui/text/javadoc/JavaDocCompletionProcessor.java;5;1;9;1;3;3;3;6;13;1;6;1152;45;45;1;0;0;6;9;1152;0;6340;9;5;
/org.eclipse.ui.intro/src/org/eclipse/ui/internal/intro/impl/IntroPlugin.java;1;1;9;1;9;9;9;0;56;0;0;5115;116;116;1;0;0;0;9;5115;0;5937;9;1;
/org.eclipse.ui.workbench/Eclipse UI/org/eclipse/ui/IActionDelegate.java;1;0;1;1;0;0;0;1;2;0;1;2737;2;2;1;0;0;1;1;2737;0;2737;1;1;
/org.eclipse.jdt.ui/core refactoring/org/eclipse/jdt/internal/corext/refactoring/code/ExceptionAnalyzer.java;3;0;3;1;1;1;1;2;8;1;2;1312;13;13;1;0;0;2;3;1312;0;6340;3;3;
/org.eclipse.help.base/src/org/eclipse/help/internal/base/util/TString.java;1;1;5;1;3;3;3;2;43;1;2;1747;83;83;1;0;0;2;5;1747;0;6337;5;1;
/org.eclipse.team.examples.filesystem/src/org/eclipse/team/examples/filesystem/ui/GetAction.java;2;1;3;1;2;2;2;1;11;0;1;4368;15;15;1;0;0;1;3;4368;0;6337;3;2;
/org.eclipse.ui.workbench/Eclipse UI/org/eclipse/ui/internal/commands/old/Context.java;1;0;2;1;0;0;0;2;0;1;2;1322;0;0;1;0;0;2;2;1322;0;1695;2;1;
/org.eclipse.help.base/src/org/eclipse/help/internal/standalone/Options.java;1;1;7;1;5;5;5;2;83;1;2;1740;205;205;1;0;0;2;7;1740;0;6337;7;1;
/org.eclipse.pde.ui/src_Forms/org/eclipse/pde/internal/ui/model/plugin/PluginExtensionNode.java;3;1;11;1;8;8;8;3;47;1;3;4438;133;133;1;0;0;3;11;4438;0;6336;11;3;
/org.eclipse.team.webdav/src/org/eclipse/team/internal/ui/target/GetAsProjectAction.java;2;0;2;1;0;0;0;2;0;1;2;2495;0;0;1;0;0;2;2;2495;0;4216;2;2;
/org.eclipse.ui.workbench/Eclipse UI/org/eclipse/ui/internal/model/WorkbenchStatusList.java;1;0;1;1;0;0;0;1;0;0;1;2737;0;0;1;0;0;1;1;2737;0;2737;1;1;
/org.eclipse.core.runtime/src/org/eclipse/core/runtime/preferences/IPreferenceManager.java;1;0;3;1;0;0;0;3;33;1;3;4033;33;33;1;0;0;3;3;4033;0;4327;3;1;
/org.eclipse.pde.core/src/org/eclipse/pde/internal/core/ischema/ISchemaComplexType.java;1;0;2;1;1;1;1;1;4;0;1;4203;6;6;1;0;0;1;2;4203;0;6336;2;1;
/org.eclipse.ui.views/src/org/eclipse/ui/views/properties/IPropertySource2.java;1;0;1;1;1;1;1;0;0;0;0;5506;0;0;1;0;0;0;1;5506;0;5506;1;1;
/org.eclipse.jdt.launching.macosx/macosx/org/eclipse/jdt/internal/launching/macosx/MacOSXVMInstallType.java;1;0;4;1;0;0;0;4;43;1;4;1296;69;69;1;0;0;4;4;1296;0;3622;4;1;
/org.eclipse.jdt.ui/core refactoring/org/eclipse/jdt/internal/corext/refactoring/reorg2/ReorgCopyAction.java;1;0;6;1;0;0;0;6;11;3;3;802;22;22;3;3;0;6;6;1111;3;1111;3;1;
/org.eclipse.team.ui/src/org/eclipse/team/internal/ui/TeamAdapterFactory.java;1;0;3;1;1;1;1;2;40;1;2;4077;42;42;1;0;0;2;3;4077;0;6337;3;1;
/org.eclipse.ui.workbench/Eclipse UI/org/eclipse/ui/internal/activities/PatternBinding.java;1;0;5;1;0;0;0;5;26;1;5;2444;58;58;1;0;0;5;5;2444;0;2896;5;1;
/org.eclipse.jdt.ui/ui/org/eclipse/jdt/internal/ui/EditorInputAdapterFactory.java;1;0;1;1;1;1;1;0;2;0;0;6340;2;2;1;0;0;0;1;6340;0;6340;1;1;
/org.eclipse.ui.views/src/org/eclipse/ui/views/internal/markers/tasks/MarkCompletedAction.java;1;0;2;1;0;0;0;2;0;1;2;265;0;0;1;0;0;2;2;265;0;749;2;1;
/org.eclipse.debug.ui/ui/org/eclipse/debug/internal/ui/views/variables/VariablesViewer.java;4;0;5;1;1;1;1;4;142;1;4;1020;328;328;1;0;0;4;5;1020;0;6336;5;4;
/org.eclipse.ui.editors/src/org/eclipse/ui/internal/editors/text/AbstractConfigurationBlockPreferencePage.java;1;0;1;1;1;1;1;0;0;0;0;5501;0;0;1;0;0;0;1;5501;0;5501;1;1;
/org.eclipse.jdt.core/search/org/eclipse/jdt/internal/core/search/matching/SuperTypeNamesCollector.java;3;0;18;1;1;1;1;17;465;1;17;77;845;845;1;0;0;17;18;77;0;5113;18;3;
/org.eclipse.core.tests.runtime/src/org/eclipse/core/tests/internal/plugins/SoftPrereqTest_21.java;1;0;1;1;0;0;0;1;0;0;1;3014;0;0;1;0;0;1;1;3014;0;3014;1;1;
/org.eclipse.jdt.ui.tests.refactoring/resources/PullUp/test43/in/A.java;1;0;1;1;0;0;0;1;0;0;1;346;0;0;1;0;0;1;1;346;0;346;1;1;
/org.eclipse.ui.workbench/Eclipse UI/org/eclipse/ui/internal/themes/ThemeElementCategory.java;1;0;4;1;0;0;0;4;11;1;4;4392;19;19;1;0;0;4;4;4392;0;5025;4;1;
/org.eclipse.jdt.debug.ui/ui/org/eclipse/jdt/internal/debug/ui/snippeteditor/OpenSnippetWizardAction.java;1;0;2;1;0;0;0;2;0;1;2;4854;0;0;1;0;0;2;2;4854;0;4956;2;1;
/org.eclipse.team.ui/src/org/eclipse/team/ui/synchronize/actions/DirectionFilterActionGroup.java;1;0;4;1;0;0;0;4;177;1;4;2535;185;185;1;0;0;4;4;2535;0;4216;4;1;
/org.eclipse.jdt.ui/ui/org/eclipse/jdt/internal/ui/search/JavaSearchPageScoreComputer.java;2;1;2;1;2;2;2;0;5;0;0;5396;7;7;1;0;0;0;2;5396;0;6340;2;2;
/org.eclipse.jdt.ui.tests.refactoring/resources/ChangeTypeRefactoring/positive/A_testReturnType_out.java;1;0;1;1;0;0;0;1;0;0;1;2844;0;0;1;0;0;1;1;2844;0;2844;1;1;
/org.eclipse.ui.workbench/Eclipse UI/org/eclipse/ui/commands/ICategoryHandle.java;1;0;4;1;0;0;0;4;0;1;4;1321;0;0;1;0;0;4;4;1321;0;1417;4;1;
/org.eclipse.jdt.ui/ui/org/eclipse/jdt/internal/ui/util/ProgressService.java;1;1;2;1;2;2;2;0;0;0;0;5651;0;0;1;0;0;0;2;5651;0;5911;2;1;
/org.eclipse.swt.examples/src/org/eclipse/swt/examples/addressbook/Composite.java;1;0;1;1;0;0;0;1;0;0;1;106;0;0;1;0;0;1;1;106;0;106;1;1;
/org.eclipse.ui.views/src/org/eclipse/ui/views/internal/tableview/TableContentProvider.java;1;0;2;1;0;0;0;2;0;1;2;267;0;0;1;0;0;2;2;267;0;749;2;1;
/org.eclipse.team.ui/src/org/eclipse/team/internal/ui/synchronize/actions/TeamParticipantRefreshAction.java;2;0;4;1;0;0;0;4;33;1;4;3709;41;41;1;0;0;4;4;3709;0;4449;4;2;
/org.eclipse.jdt.ui.tests.refactoring/resources/RenamePackage/testImportFromMultiRoots3/out/srcTest/p/p/Ref.java;1;0;2;1;0;0;0;2;8;1;2;3219;8;8;1;0;0;2;2;3219;0;4105;2;1;
/org.eclipse.jdt.core.tests.model/workspace/Formatter/test172/A_in.java;1;0;1;1;0;0;0;1;0;0;1;2425;0;0;1;0;0;1;1;2425;0;2425;1;1;
/org.eclipse.ui.ide/src/org/eclipse/ui/views/markers/internal/ActionProblemProperties.java;3;1;3;1;2;2;2;1;4;0;1;2208;6;6;1;0;0;1;3;2208;0;6338;3;3;
/org.eclipse.ui.forms.examples/src/org/eclipse/ui/forms/examples/internal/rcp/SecondPage.java;1;0;4;1;1;1;1;3;16;1;3;4075;22;22;1;0;0;3;4;4075;0;5781;4;1;
/org.eclipse.jdt.ui/ui/org/eclipse/jdt/internal/ui/text/template/contentassist/VariablePosition.java;2;0;2;1;1;1;1;1;2;0;1;4927;2;2;1;0;0;1;2;4927;0;6340;2;2;
/org.eclipse.ui.workbench/Eclipse UI/org/eclipse/ui/internal/keys/CancelOnModifyListener.java;2;0;2;1;1;1;1;1;4;0;1;4327;4;4;1;0;0;1;2;4327;0;6338;2;2;
/org.eclipse.jdt.core.tests.model/workspace/Converter/src/test0524/A.java;1;0;1;1;0;0;0;1;0;0;1;3714;0;0;1;0;0;1;1;3714;0;3714;1;1;
/org.eclipse.ui.workbench/Eclipse UI/org/eclipse/ui/internal/csm/activities/FileActivityRegistry.java;1;0;2;1;0;0;0;2;0;1;2;2225;0;0;1;0;0;2;2;2225;0;2310;2;1;
/org.eclipse.jdt.core.tests.model/workspace/Formatter/test463/A_out.java;1;0;1;1;0;0;0;1;0;0;1;3902;0;0;1;0;0;1;1;3902;0;3902;1;1;
/org.eclipse.team.ui/src/org/eclipse/team/internal/ui/wizards/GlobalRefreshWizardSelectionPage.java;2;1;3;1;3;3;3;0;174;0;0;5532;176;176;1;0;0;0;3;5532;0;6337;3;2;
/org.eclipse.ui.workbench/Eclipse UI/org/eclipse/ui/part/EditorInputTransfer.java;3;0;3;1;0;0;0;3;12;1;3;1;18;18;1;0;0;3;3;1;0;2737;3;3;
/org.eclipse.jdt.core/model/org/eclipse/jdt/internal/core/DestroyWorkingCopyOperation.java;1;0;2;1;0;0;0;2;1;1;2;761;1;1;1;0;0;2;2;761;0;818;2;1;
/org.eclipse.osgi/core/framework/org/eclipse/osgi/framework/tracker/ServiceTrackerCustomizer.java;3;0;3;1;0;0;0;3;77;1;3;3013;77;77;1;0;0;3;3;3013;0;5079;3;3;
/org.eclipse.core.resources/src/org/eclipse/core/internal/localstore/IUnifiedTreeVisitor.java;1;0;1;1;1;1;1;0;12;0;0;5146;12;12;1;0;0;0;1;5146;0;5146;1;1;
/org.eclipse.osgi/supplement/src/org/eclipse/osgi/framework/internal/reliablefile/ReliableFileOutputStream.java;5;1;7;1;4;4;4;3;220;1;3;3013;282;282;1;0;0;3;7;3013;0;5856;7;5;
/org.eclipse.debug.ui/ui/org/eclipse/debug/internal/ui/launchVariables/ContextVariableComponentManager.java;3;0;5;2;0;0;0;5;48;2;3;562;57;57;2;2;0;5;5;562;2;2120;3;3;
/org.eclipse.pde.core/src/org/eclipse/pde/internal/core/feature/VersionableObject.java;2;1;3;1;2;2;2;1;8;0;1;4203;14;14;1;0;0;1;3;4203;0;6336;3;2;
/org.eclipse.jface.text/src/org/eclipse/jface/text/reconciler/DocumentAdapter.java;2;0;2;1;1;1;1;1;0;0;1;1629;0;0;1;0;0;1;2;1629;0;5177;2;2;
/org.eclipse.jdt.core.tests.model/workspace/Converter/src/javadoc/testBug52908unicode/Y.java;1;0;1;1;0;0;0;1;0;0;1;4369;0;0;1;0;0;1;1;4369;0;4369;1;1;
/org.eclipse.team.cvs.ui/src/org/eclipse/team/internal/ccvs/ui/subscriber/WorkspaceUpdateAction.java;2;1;15;1;2;2;2;13;124;2;12;709;354;354;2;1;0;13;15;1132;1;6337;14;2;
/org.eclipse.pde.ui/src_Forms/org/eclipse/pde/internal/ui/neweditor/site/BaseNewDialog.java;2;0;2;1;1;1;1;1;0;0;1;4832;0;0;1;0;0;1;2;4832;0;5431;2;2;
/org.eclipse.core.tests.runtime/src/org/eclipse/core/tests/runtime/URLTest.java;1;0;1;1;1;1;1;0;0;0;0;5987;0;0;1;0;0;0;1;5987;0;5987;1;1;
/org.eclipse.jdt.core.tests.model/workspace/Formatter/test136/A_out.java;1;0;1;1;0;0;0;1;0;0;1;2425;0;0;1;0;0;1;1;2425;0;2425;1;1;
/org.eclipse.jdt.core.tests.model/workspace/Converter/test0418/A.java;1;0;1;1;0;0;0;1;0;0;1;3714;0;0;1;0;0;1;1;3714;0;3714;1;1;
/org.eclipse.jdt.core.tests.model/workspace/Converter/src/test0325/Test.java;1;0;1;1;0;0;0;1;0;0;1;3714;0;0;1;0;0;1;1;3714;0;3714;1;1;
/org.eclipse.pde.ui/sandbox/org/eclipse/pde/internal/ui/editor/standalone/text/IXMLColorConstants.java;1;0;2;1;0;0;0;2;0;1;2;2320;0;0;1;0;0;2;2;2320;0;2906;2;1;
/org.eclipse.jdt.ui/core refactoring/org/eclipse/jdt/internal/corext/refactoring/participants/IResourceModifications.java;1;0;3;1;0;0;0;3;2;1;3;1125;2;2;1;0;0;3;3;1125;0;4624;3;1;
/org.eclipse.team.ui/src/org/eclipse/team/internal/ui/sync/pages/NewSynchronizeView.java;1;0;1;1;0;0;0;1;0;0;1;2406;0;0;1;0;0;1;1;2406;0;2406;1;1;
/org.eclipse.jface/src/org/eclipse/jface/resource/GradientData.java;1;0;3;1;0;0;0;3;70;1;3;4235;70;70;1;0;0;3;3;4235;0;4560;3;1;
/org.eclipse.jdt.debug.jdi.tests/tests/org/eclipse/debug/jdi/tests/program/TestClass1.java;1;0;1;1;1;1;1;0;3;0;0;6339;3;3;1;0;0;0;1;6339;0;6339;1;1;
/org.eclipse.jdt.core.tests.model/workspace/Converter/src/test0064/Test.java;1;0;1;1;0;0;0;1;0;0;1;3714;0;0;1;0;0;1;1;3714;0;3714;1;1;
/org.eclipse.team.tests.cvs.core/src/org/eclipse/team/tests/ccvs/core/subscriber/SyncSetTests.java;1;1;5;1;2;2;2;3;29;1;3;1593;48;48;1;0;0;3;5;1593;0;6337;5;1;
/org.eclipse.jdt.ui.tests.refactoring/resources/InlineMethodWorkspace/TestCases/argument_in/TestLocalReferenceLoop.java;1;0;1;1;0;0;0;1;2;0;1;845;2;2;1;0;0;1;1;845;0;845;1;1;
/org.eclipse.core.resources/src/org/eclipse/core/internal/indexing/StoreException.java;1;0;1;1;1;1;1;0;68;0;0;5146;68;68;1;0;0;0;1;5146;0;5146;1;1;
/org.eclipse.swt.tests/JUnit Tests/org/eclipse/swt/tests/junit/Test_org_eclipse_swt_accessibility_AccessibleListener.java;1;0;1;1;0;0;0;1;0;0;1;2104;0;0;1;0;0;1;1;2104;0;2104;1;1;
/org.eclipse.jdt.core.tests.model/workspace/Converter/src/test0231/Test.java;1;0;1;1;0;0;0;1;0;0;1;3714;0;0;1;0;0;1;1;3714;0;3714;1;1;
/org.eclipse.jdt.ui/ui/org/eclipse/jdt/internal/ui/javaeditor/ASTProvider.java;3;1;19;1;5;5;5;14;397;3;9;4627;773;773;3;5;0;14;19;4644;5;6340;14;3;
/org.eclipse.jface.text/src/org/eclipse/jface/text/source/MatchingCharacterPainter.java;3;1;4;1;3;3;3;1;28;0;1;4689;50;50;1;0;0;1;4;4689;0;6361;4;3;
/org.eclipse.jdt.core/eval/org/eclipse/jdt/internal/eval/Evaluator.java;3;0;6;1;0;0;0;6;6;1;6;71;21;21;1;0;0;6;6;71;0;3560;6;3;
/org.eclipse.jdt.ui.tests.refactoring/resources/ExtractInterface/testConstant85/in/A.java;1;0;1;1;0;0;0;1;6;0;1;1166;6;6;1;0;0;1;1;1166;0;1166;1;1;
/org.eclipse.jdt.launching/launching/org/eclipse/jdt/launching/AbstractJavaLaunchConfigurationDelegate.java;5;1;25;2;5;5;5;20;913;2;18;2609;1734;1734;2;2;0;20;25;2695;2;6247;23;5;
/org.eclipse.pde.ui/src/org/eclipse/pde/internal/ui/editor/feature/URLSection.java;2;1;6;1;4;4;4;2;77;1;2;2751;134;134;1;0;0;2;6;2751;0;6336;6;2;
/org.eclipse.ui.workbench/Eclipse UI/org/eclipse/ui/internal/activities/ws/ActivityMessages.java;1;0;1;1;0;0;0;1;0;0;1;3066;0;0;1;0;0;1;1;3066;0;3066;1;1;
/org.eclipse.jdt.core.tests.model/workspace/Converter/src/test0328/Test.java;1;0;1;1;0;0;0;1;0;0;1;3714;0;0;1;0;0;1;1;3714;0;3714;1;1;
/org.eclipse.jdt.ui/ui/org/eclipse/jdt/ui/actions/FindImplementorsInWorkingSetAction.java;2;1;6;1;3;3;3;3;15;1;3;1350;29;29;1;0;0;3;6;1350;0;6340;6;2;
/org.eclipse.jdt.ui/ui refactoring/org/eclipse/jdt/internal/ui/refactoring/nls/ExternalizeWizardPage2.java;3;1;7;1;3;3;3;4;757;1;4;1309;820;820;1;0;0;4;7;1309;0;5375;7;3;
/org.eclipse.jdt.core.tests.model/workspace/Converter/src/test0144/Test.java;1;0;1;1;0;0;0;1;0;0;1;3714;0;0;1;0;0;1;1;3714;0;3714;1;1;
/org.eclipse.jdt.ui.examples.javafamily/src/org/eclipse/jsp/AbstractJspParser.java;2;0;6;1;0;0;0;6;29;2;5;1033;56;56;2;1;0;6;6;1128;1;2622;5;2;
/org.eclipse.jdt.ui/ui/org/eclipse/jdt/internal/ui/text/spelling/HtmlTagDictionary.java;2;0;2;1;1;1;1;1;2;0;1;3930;2;2;1;0;0;1;2;3930;0;6340;2;2;
/org.eclipse.jdt.ui/core extension/org/eclipse/jdt/internal/corext/util/TypeInfoFactory.java;1;0;1;1;1;1;1;0;2;0;0;6340;2;2;1;0;0;0;1;6340;0;6340;1;1;
/org.eclipse.jdt.core.tests.model/workspace/Formatter/test205/A_out.java;1;0;1;1;0;0;0;1;0;0;1;2424;0;0;1;0;0;1;1;2424;0;2424;1;1;
/org.eclipse.ui.workbench/Eclipse UI/org/eclipse/ui/internal/colors/ColorsPreferencePage.java;1;0;3;1;0;0;0;3;300;1;3;3216;300;300;1;0;0;3;3;3216;0;4235;3;1;
/org.eclipse.update.ui/src/org/eclipse/update/internal/ui/wizards/SitePage.java;3;4;23;1;10;7;10;13;541;2;11;200;979;979;4;2;3;13;23;6004;5;6336;18;3;
/org.eclipse.ui.workbench/Eclipse UI/org/eclipse/ui/internal/csm/commands/api/ICommandListener.java;1;0;2;1;0;0;0;2;0;1;2;2515;0;0;1;0;0;2;2;2515;0;2562;2;1;
/org.eclipse.ui.ide/extensions/org/eclipse/ui/dialogs/ResourceListSelectionDialog.java;2;0;2;1;0;0;0;2;35;1;2;2263;35;35;1;0;0;2;2;2263;0;3013;2;2;
/org.eclipse.jdt.junit/src/org/eclipse/jdt/internal/junit/ui/FailureTraceView.java;2;0;8;1;1;1;1;7;38;2;6;261;93;93;2;1;0;7;8;416;1;5633;7;2;
/org.eclipse.pde.ui/src_OSGi/org/eclipse/pde/internal/ui/osgi/wizards/PluginToBundleWizardPage.java;2;0;4;1;0;0;0;4;47;1;4;2244;48;48;1;0;0;4;4;2244;0;3839;4;2;
/org.eclipse.jdt.core.tests.model/workspace/Converter/src/test0238/Test.java;1;0;1;1;0;0;0;1;0;0;1;3714;0;0;1;0;0;1;1;3714;0;3714;1;1;
/org.eclipse.search/new search/org/eclipse/search/ui/NewSearchUI.java;3;1;15;1;8;8;8;7;91;2;6;3474;429;429;2;1;0;7;15;4841;1;6340;14;3;
/org.eclipse.jdt.core/model/org/eclipse/jdt/internal/core/util/SourceFileAttribute.java;1;0;1;1;0;0;0;1;2;0;1;3560;2;2;1;0;0;1;1;3560;0;3560;1;1;
/org.eclipse.jdt.ui/ui/org/eclipse/jdt/internal/ui/text/SmartBackspaceManager.java;2;1;3;1;3;3;3;0;12;0;0;5226;18;18;1;0;0;0;3;5226;0;6340;3;2;
/org.eclipse.jdt.core/search/org/eclipse/jdt/internal/core/index/impl/IIndexConstants.java;2;0;7;2;0;0;0;7;4;2;6;1287;12;12;2;1;0;7;7;3556;1;4060;6;2;
/org.eclipse.jdt.core.tests.model/workspace/Formatter/test341/A_in.java;1;0;1;1;0;0;0;1;0;0;1;2865;0;0;1;0;0;1;1;2865;0;2865;1;1;
/org.eclipse.jdt.ui.tests.refactoring/resources/InlineMethodWorkspace/TestCases/argument_in/TestLiteralReferenceRead.java;1;0;1;1;0;0;0;1;2;0;1;845;2;2;1;0;0;1;1;845;0;845;1;1;
/org.eclipse.ui.views/src/org/eclipse/ui/views/properties/PropertySheetEntry.java;2;1;2;1;2;2;2;0;56;0;0;5506;60;60;1;0;0;0;2;5506;0;5530;2;2;
/org.eclipse.jdt.core.tests.model/workspace/Formatter/test120/A_in.java;1;0;1;1;0;0;0;1;0;0;1;2425;0;0;1;0;0;1;1;2425;0;2425;1;1;
/org.eclipse.jdt.core.tests.model/workspace/Converter/src/test0396/A.java;1;0;1;1;0;0;0;1;0;0;1;3714;0;0;1;0;0;1;1;3714;0;3714;1;1;
/org.eclipse.team.tests.cvs.core/src/org/eclipse/team/tests/ccvs/core/subscriber/CVSSyncSubscriberTest.java;2;1;21;1;4;4;4;17;224;2;16;725;442;442;2;1;0;17;21;1217;1;6337;20;2;
/org.eclipse.update.core/src/org/eclipse/update/search/EnvironmentFilter.java;2;1;6;1;2;2;2;4;7;1;4;825;15;15;1;0;0;4;6;825;0;6336;6;2;
/org.eclipse.core.applicationrunner/src/org/eclipse/core/internal/applicationrunner/ApplicationRunnerActivator.java;2;0;3;1;0;0;0;3;34;1;3;3013;38;38;1;0;0;3;3;3013;0;3061;3;2;
/org.eclipse.jdt.core.tests.model/workspace/Converter/src/javadoc/testBug65174/Test.java;1;0;1;1;1;1;1;0;0;0;0;6100;0;0;1;0;0;0;1;6100;0;6100;1;1;
/org.eclipse.swt/Eclipse SWT PI/gtk/org/eclipse/swt/internal/gtk/GInterfaceInfo.java;1;0;2;1;0;0;0;2;0;1;2;1102;0;0;1;0;0;2;2;1102;0;1214;2;1;
/org.eclipse.jdt.core.tests.model/workspace/Converter/src/test0021/Test.java;1;0;1;1;0;0;0;1;0;0;1;3714;0;0;1;0;0;1;1;3714;0;3714;1;1;
/org.eclipse.pde.ui/src/org/eclipse/pde/internal/ui/editor/ModelDataTransfer.java;2;1;2;1;2;2;2;0;6;0;0;5778;10;10;1;0;0;0;2;5778;0;6336;2;2;
/org.eclipse.ui.ide/src/org/eclipse/ui/views/navigator/SortAndFilterActionGroup.java;4;0;5;1;1;1;1;4;20;1;4;2208;29;29;1;0;0;4;5;2208;0;6338;5;4;
/org.eclipse.jdt.debug.tests/tests/org/eclipse/jdt/debug/tests/eval/NestedTypeFieldValue_481.java;1;0;1;1;0;0;0;1;74;0;1;1274;74;74;1;0;0;1;1;1274;0;1274;1;1;
/org.eclipse.jdt.ui/ui refactoring/org/eclipse/jdt/internal/ui/refactoring/nls/ExternalizeWizardPage.java;7;3;32;2;19;15;19;13;1153;2;12;42;2974;2974;3;1;4;13;32;5197;5;6340;27;7;
/org.eclipse.ant.ui/Ant Editor/org/eclipse/ant/internal/ui/editor/formatter/XmlCommentFormattingStrategy.java;1;0;5;1;1;1;1;4;18;2;3;4179;36;36;2;1;0;4;5;4583;1;5139;4;1;
/org.eclipse.core.expressions/src/org/eclipse/core/internal/expressions/InstanceofExpression.java;1;0;3;1;1;1;1;2;17;1;2;4108;25;25;1;0;0;2;3;4108;0;6340;3;1;
/org.eclipse.compare.examples.xml/tests/org/eclipse/compare/examples/xml/AllXMLCompareTests.java;1;0;3;1;0;0;0;3;2;1;3;1106;4;4;1;0;0;3;3;1106;0;4711;3;1;
/org.eclipse.ui.ide/src/org/eclipse/ui/views/navigator/NavigatorDropAdapter.java;1;0;2;1;0;0;0;2;5;1;2;2208;5;5;1;0;0;2;2;2208;0;2264;2;1;
/org.eclipse.jdt.core.tests.model/workspace/JavaSearch/src/j4/MC47209.java;1;0;1;1;0;0;0;1;0;0;1;3330;0;0;1;0;0;1;1;3330;0;3330;1;1;
/org.eclipse.core.expressions.tests/src/org/eclipse/core/internal/expressions/tests/ExpressionTests.java;1;1;9;1;3;3;3;6;206;1;6;4108;591;591;1;0;0;6;9;4108;0;5485;9;1;
/org.eclipse.jdt.core/model/org/eclipse/jdt/internal/core/NameLookup.java;3;1;21;1;3;3;3;18;148;3;16;192;355;355;3;2;0;18;21;1056;2;5855;19;3;
/org.eclipse.team.core/src/org/eclipse/team/core/sync/ITeamDelta.java;1;0;1;1;0;0;0;1;0;0;1;431;0;0;1;0;0;1;1;431;0;431;1;1;
/org.eclipse.jdt.launching/launching/org/eclipse/jdt/launching/IVMInstall.java;1;0;1;1;0;0;0;1;24;0;1;4493;24;24;1;0;0;1;1;4493;0;4493;1;1;
/org.eclipse.osgi.tests/src/org/eclipse/osgi/tests/internal/state/PlatformAdminTest.java;2;1;3;1;2;2;2;1;8;0;1;4705;8;8;1;0;0;1;3;4705;0;5993;3;2;
/org.eclipse.pde.ui/src_Forms/org/eclipse/pde/internal/ui/neweditor/schema/AttributePropertySource.java;1;0;2;1;0;0;0;2;0;1;2;4856;0;0;1;0;0;2;2;4856;0;4879;2;1;
/org.eclipse.swt.tests/JUnit Tests/org/eclipse/swt/tests/junit/Test_org_eclipse_swt_custom_StyleRange.java;1;0;1;1;0;0;0;1;16;0;1;2104;16;16;1;0;0;1;1;2104;0;2104;1;1;
/org.eclipse.ui.workbench/Eclipse UI/org/eclipse/ui/internal/RootLayoutContainer.java;3;1;9;1;2;2;2;7;80;2;6;3828;213;213;2;1;0;7;9;4807;1;5539;8;3;
/org.eclipse.ui.cheatsheets/src/org/eclipse/ui/internal/cheatsheets/data/SubContentItem.java;2;0;4;2;0;0;0;4;42;2;3;4428;42;42;2;1;0;4;4;4625;1;4662;3;2;
/org.eclipse.jdt.ui/ui/org/eclipse/jdt/internal/ui/text/comment/IHtmlTagConstants.java;1;0;2;1;0;0;0;2;0;1;2;1998;0;0;1;0;0;2;2;1998;0;3829;2;1;
/org.eclipse.swt/Eclipse SWT Program/gtk1x/org/eclipse/swt/program/Program.java;1;0;1;1;0;0;0;1;0;0;1;2327;0;0;1;0;0;1;1;2327;0;2327;1;1;
/org.eclipse.debug.ui/ui/org/eclipse/debug/ui/EnvironmentVariable.java;3;0;4;1;0;0;0;4;7;1;4;265;9;9;1;0;0;4;4;265;0;2729;4;3;
/org.eclipse.ui.workbench/Eclipse UI/org/eclipse/ui/internal/skins/IPartPresentationSite.java;1;0;2;1;0;0;0;2;0;1;2;4328;0;0;1;0;0;2;2;4328;0;4449;2;1;
/org.eclipse.jdt.core.tests.model/workspace/Converter/test0486/A.java;1;0;2;1;0;0;0;2;0;1;2;1289;0;0;1;0;0;2;2;1289;0;3714;2;1;
/org.eclipse.update.ui/src/org/eclipse/update/internal/ui/model/IUpdateModelChangedListener.java;1;0;1;1;0;0;0;1;0;0;1;4928;0;0;1;0;0;1;1;4928;0;4928;1;1;
/org.eclipse.pde.ui/sandbox/org/eclipse/pde/internal/ui/editor/standalone/StandaloneXMLEditor.java;1;0;2;1;0;0;0;2;0;1;2;2320;0;0;1;0;0;2;2;2320;0;2906;2;1;
/org.eclipse.core.tools.resources/src/org/eclipse/core/tools/metadata/SyncInfoDumpingStrategy_2.java;1;0;1;1;1;1;1;0;0;0;0;6302;0;0;1;0;0;0;1;6302;0;6302;1;1;
/org.eclipse.jdt.core/compiler/org/eclipse/jdt/internal/compiler/ast/ImportReference.java;2;0;4;1;0;0;0;4;84;1;4;85;113;113;1;0;0;4;4;85;0;3560;4;2;
/org.eclipse.jdt.ui/core refactoring/org/eclipse/ltk/core/refactoring/participants/RefactoringParticipant.java;1;0;3;1;0;0;0;3;14;1;3;4624;14;14;1;0;0;3;3;4624;0;4864;3;1;
/org.eclipse.jdt.core.tests.model/src/org/eclipse/jdt/core/tests/model/ContainerInitializer.java;1;0;1;1;0;0;0;1;2;0;1;3560;2;2;1;0;0;1;1;3560;0;3560;1;1;
/org.eclipse.jdt.core.tests.model/workspace/Converter/src/test0184/Test.java;1;0;1;1;0;0;0;1;0;0;1;3714;0;0;1;0;0;1;1;3714;0;3714;1;1;
/org.eclipse.jdt.core.tests.model/workspace/Converter/src/test0549/A.java;1;2;3;1;3;2;3;0;33;0;0;5382;33;33;2;0;1;0;3;5382;1;5407;2;1;
/org.eclipse.debug.core/core/org/eclipse/debug/core/variables/IVariableExpander.java;2;0;4;1;0;0;0;4;11;1;4;562;19;19;1;0;0;4;4;562;0;2120;4;2;
/org.eclipse.ui.workbench/Eclipse UI/org/eclipse/ui/commands/ICategoryListener.java;3;1;6;1;2;2;2;4;23;2;3;1435;67;67;2;1;0;4;6;2562;1;6338;5;3;
/org.eclipse.ui.workbench/Eclipse UI/org/eclipse/ui/model/WorkbenchContentProvider.java;2;0;3;1;0;0;0;3;41;1;3;1;43;43;1;0;0;3;3;1;0;2737;3;2;
/org.eclipse.ui.ide/src/org/eclipse/ui/views/markers/internal/MarkerList.java;4;2;6;2;5;4;5;1;61;0;1;3214;106;106;2;0;1;1;6;6338;1;6338;5;4;
/org.eclipse.jdt.core.tests.model/workspace/Converter/src/test0063/Test.java;1;0;1;1;0;0;0;1;0;0;1;3714;0;0;1;0;0;1;1;3714;0;3714;1;1;
/org.eclipse.core.runtime/src/org/eclipse/core/internal/jobs/Worker.java;3;1;24;1;4;4;4;20;168;2;19;320;528;528;2;1;0;20;24;1775;1;6018;23;3;
/org.eclipse.ui.workbench/Eclipse UI/org/eclipse/ui/actions/CreateFolderAction.java;1;0;1;1;0;0;0;1;0;0;1;2737;0;0;1;0;0;1;1;2737;0;2737;1;1;
/org.eclipse.jdt.debug.ui/ui/org/eclipse/jdt/internal/debug/ui/JavaUtilMapVariablesContentProvider.java;1;0;5;1;0;0;0;5;12;1;5;670;28;28;1;0;0;5;5;670;0;861;5;1;
/org.eclipse.webdav/src/kernel/org/eclipse/webdav/internal/kernel/ContextFactory.java;1;0;2;1;2;1;2;0;6;0;0;5151;6;6;2;0;1;0;2;5151;1;5151;1;1;
/org.eclipse.swt/Eclipse SWT PI/gtk/org/eclipse/swt/internal/gtk/XEvent.java;2;1;2;1;2;2;2;0;4;0;0;5463;4;4;1;0;0;0;2;5463;0;6352;2;2;
/org.eclipse.jdt.core.tests.model/workspace/Formatter/test099/A_out.java;1;0;1;1;0;0;0;1;0;0;1;2425;0;0;1;0;0;1;1;2425;0;2425;1;1;
/org.eclipse.swt/Eclipse SWT/win32/org/eclipse/swt/graphics/Image.java;5;1;15;1;3;3;3;12;172;2;11;251;295;295;2;1;0;12;15;4311;1;6352;14;5;
/org.eclipse.releng.tools/src/org/eclipse/releng/tools/MapEntry.java;1;1;2;1;2;2;2;0;4;0;0;5183;4;4;1;0;0;0;2;5183;0;6340;2;1;
/org.eclipse.team.cvs.ui/src/org/eclipse/team/internal/ccvs/ui/operations/RemoteOperation.java;2;1;4;1;2;2;2;2;6;1;2;994;12;12;1;0;0;2;4;994;0;6337;4;2;
/org.eclipse.jdt.debug.ui/ui/org/eclipse/jdt/internal/debug/ui/launcher/AppletSelectionDialog.java;1;0;2;1;0;0;0;2;66;1;2;125;127;127;1;0;0;2;2;125;0;176;2;1;
/org.eclipse.jdt.core.tests.model/workspace/Converter/test0246/Test.java;1;0;1;1;0;0;0;1;0;0;1;3714;0;0;1;0;0;1;1;3714;0;3714;1;1;
/org.eclipse.ui.workbench/Eclipse UI/org/eclipse/ui/internal/registry/ActionSetRegistryReader.java;3;0;3;1;1;1;1;2;7;1;2;3500;11;11;1;0;0;2;3;3500;0;6338;3;3;
/org.eclipse.search/search/org/eclipse/search/internal/core/text/IMatchCollector.java;1;0;1;1;0;0;0;1;0;0;1;4045;0;0;1;0;0;1;1;4045;0;4045;1;1;
/org.eclipse.team.ui/src/org/eclipse/team/ui/synchronize/SynchronizeModelAction.java;2;1;8;1;7;7;7;1;233;0;1;4632;385;385;1;0;0;1;8;4632;0;6337;8;2;
/org.eclipse.ui.workbench.texteditor/src/org/eclipse/ui/texteditor/ConvertLineDelimitersAction.java;3;2;7;2;3;2;3;4;21;1;4;403;65;65;2;0;1;4;7;6334;1;6334;6;3;
/org.eclipse.core.tests.resources/src/org/eclipse/core/tests/internal/localstore/CopyTest.java;1;0;2;1;2;1;2;0;239;0;0;5147;239;239;2;0;1;0;2;5147;1;5147;1;1;
/org.eclipse.jdt.ui/ui/org/eclipse/jdt/internal/ui/wizards/buildpaths/CPVariableElementLabelProvider.java;1;0;1;1;1;1;1;0;2;0;0;6340;2;2;1;0;0;0;1;6340;0;6340;1;1;
/org.eclipse.jdt.core/eval/org/eclipse/jdt/internal/eval/EvaluationContext.java;5;0;9;1;1;1;1;8;48;1;8;13;108;108;1;0;0;8;9;13;0;5536;9;5;
/org.eclipse.ui.editors/src/org/eclipse/ui/internal/editors/quickdiff/engine/DiffInitializer.java;1;0;2;1;0;0;0;2;0;1;2;1118;0;0;1;0;0;2;2;1118;0;1214;2;1;
/org.eclipse.ui.workbench/Eclipse UI/org/eclipse/ui/internal/FolderLayout.java;4;1;12;1;5;5;5;7;144;1;7;3146;287;287;1;0;0;7;12;3146;0;6338;12;4;
/org.eclipse.releng.tools/src/org/eclipse/releng/tools/ProjectValidationDialog.java;3;1;3;1;3;3;3;0;141;0;0;5183;145;145;1;0;0;0;3;5183;0;5472;3;3;
/org.eclipse.core.tests.resources/src/org/eclipse/core/tests/resources/IWorkspaceTest.java;2;2;9;1;3;2;3;6;2174;1;6;232;2244;2244;2;0;1;6;9;5147;1;5408;8;2;
/org.eclipse.jdt.core.tests.model/workspace/Converter/test0511/A.java;1;0;2;1;0;0;0;2;0;1;2;3009;0;0;1;0;0;2;2;3009;0;3714;2;1;
/org.eclipse.jdt.debug/eval/org/eclipse/jdt/internal/debug/eval/ast/instructions/AssignmentOperator.java;1;0;1;1;0;0;0;1;2;0;1;1276;2;2;1;0;0;1;1;1276;0;1276;1;1;
/org.eclipse.jdt.ui.tests.refactoring/test cases/org/eclipse/jdt/ui/tests/refactoring/RenameVirtualMethodInClassTests.java;4;1;16;1;6;6;6;10;23;1;10;130;162;162;1;0;0;10;16;130;0;6340;16;4;
/org.eclipse.update.core/src/org/eclipse/update/search/IUpdateSearchSite.java;2;1;6;2;2;2;2;4;7;2;3;825;17;17;2;1;0;4;6;825;1;6336;5;2;
/org.eclipse.ui.examples.javaeditor/Eclipse Java Editor Example/org/eclipse/ui/examples/javaeditor/spelling/IHtmlTagConstants.java;1;0;1;1;0;0;0;1;0;0;1;2565;0;0;1;0;0;1;1;2565;0;2565;1;1;
/org.eclipse.ui.workbench/Eclipse UI/org/eclipse/ui/part/FileEditorInput.java;2;0;2;1;0;0;0;2;7;1;2;121;7;7;1;0;0;2;2;121;0;2737;2;2;
/org.eclipse.team.tests.core/src/org/eclipse/team/tests/core/AllTeamTests.java;1;0;1;1;0;0;0;1;3;0;1;2495;3;3;1;0;0;1;1;2495;0;2495;1;1;
/org.eclipse.jdt.ui.tests.refactoring/test cases/org/eclipse/jdt/ui/tests/refactoring/InlineConstantTests.java;3;0;8;1;1;1;1;7;12;1;7;149;50;50;1;0;0;7;8;149;0;6340;8;3;
/org.eclipse.swt/Eclipse SWT Mozilla/common/org/eclipse/swt/internal/mozilla/nsIDocShellTreeItem.java;1;0;2;1;0;0;0;2;34;1;2;1654;34;34;1;0;0;2;2;1654;0;2568;2;1;
/org.eclipse.pde.ui/src/org/eclipse/pde/internal/ui/wizards/templates/PreprocessorParser.java;2;1;3;1;2;2;2;1;42;0;1;368;63;63;1;0;0;1;3;368;0;6336;3;2;
/org.eclipse.ui.workbench/Eclipse UI/org/eclipse/ui/internal/WorkbenchCommandsAndContexts.java;2;0;6;1;0;0;0;6;301;1;6;3109;313;313;1;0;0;6;6;3109;0;4144;6;2;
/org.eclipse.update.configurator/src/org/eclipse/update/internal/configurator/FeatureEntry.java;1;1;20;1;8;8;8;12;102;2;11;3243;376;376;2;1;0;12;20;4113;1;6229;19;1;
/org.eclipse.swt/Eclipse SWT/common/org/eclipse/swt/internal/image/TIFFRandomFileAccess.java;1;0;1;1;0;0;0;1;0;0;1;364;0;0;1;0;0;1;1;364;0;364;1;1;
/org.eclipse.jdt.debug.jdi.tests/tests/org/eclipse/debug/jdi/tests/program/TestClazz9.java;1;0;1;1;1;1;1;0;3;0;0;6339;3;3;1;0;0;0;1;6339;0;6339;1;1;
/org.eclipse.core.tests.runtime/src/org/eclipse/core/tests/internal/plugins/SoftPrereqTest_20.java;1;0;1;1;0;0;0;1;0;0;1;3014;0;0;1;0;0;1;1;3014;0;3014;1;1;
/org.eclipse.pde.core/src/org/eclipse/pde/core/bundle/IBundle.java;1;0;2;1;0;0;0;2;0;1;2;2184;0;0;1;0;0;2;2;2184;0;2193;2;1;
/org.eclipse.debug.ui/ui/org/eclipse/debug/internal/ui/views/memory/ReformatAction.java;1;0;1;1;1;1;1;0;0;0;0;5254;0;0;1;0;0;0;1;5254;0;5254;1;1;
/org.eclipse.ui.workbench/Eclipse UI/org/eclipse/ui/internal/dialogs/ProjectReferencePage.java;2;0;3;1;0;0;0;3;3;1;3;79;5;5;1;0;0;3;3;79;0;2737;3;2;
/org.eclipse.webdav/src/client/org/eclipse/webdav/internal/authentication/BasicAuthority.java;1;0;1;1;1;1;1;0;23;0;0;5151;23;23;1;0;0;0;1;5151;0;5151;1;1;
/org.eclipse.core.resources/src/org/eclipse/core/internal/utils/Cache.java;2;2;3;1;3;2;3;0;12;0;0;5445;12;12;2;0;1;0;3;5735;1;5735;2;2;
/org.eclipse.help.ui/src/org/eclipse/help/ui/internal/DefaultHelp.java;1;0;1;1;0;0;0;1;0;0;1;2732;0;0;1;0;0;1;1;2732;0;2732;1;1;
/org.eclipse.team.webdav/src/org/eclipse/team/internal/webdav/subscriber/WebDavSubscriber.java;2;0;6;1;1;1;1;5;69;1;5;3496;119;119;1;0;0;5;6;3496;0;6337;6;2;
/org.eclipse.update.core/srcnew/org/eclipse/update/operations/IOperation.java;1;0;3;1;0;0;0;3;3;1;3;569;3;3;1;0;0;3;3;569;0;825;3;1;
/org.eclipse.jdt.ui/ui/org/eclipse/jdt/internal/ui/search/SearchViewActionGroup.java;2;1;2;1;2;2;2;0;9;0;0;5396;11;11;1;0;0;0;2;5396;0;6340;2;2;
/org.eclipse.jdt.ui.tests.refactoring/resources/MultiMove/test2/out/p1/B.java;1;0;1;1;1;1;1;0;2;0;0;5329;2;2;1;0;0;0;1;5329;0;5329;1;1;
/org.eclipse.ui.examples.multipageeditor/Eclipse UI Examples MultiPageEditor/org/eclipse/ui/examples/multipageeditor/MultiPageEditorExample.java;1;0;1;1;0;0;0;1;51;0;1;2738;51;51;1;0;0;1;1;2738;0;2738;1;1;
/org.eclipse.jdt.core/compiler/org/eclipse/jdt/internal/compiler/ast/AbstractMethodDeclaration.java;5;1;19;2;3;3;3;16;118;2;13;25;328;328;2;3;0;16;19;1304;3;6151;16;5;
/org.eclipse.pde.core/src/org/eclipse/pde/internal/core/plugin/PluginElement.java;3;1;6;1;4;4;4;2;35;1;2;4203;61;61;1;0;0;2;6;4203;0;6336;6;3;
/org.eclipse.text/src/org/eclipse/jface/text/templates/TemplateException.java;2;1;3;1;2;2;2;1;3;0;1;5081;5;5;1;0;0;1;3;5081;0;6340;3;2;
/org.eclipse.debug.ui/ui/org/eclipse/debug/internal/ui/sourcelookup/CommonSourceNotFoundEditor.java;3;2;8;2;4;3;4;4;141;2;3;3770;216;216;2;1;1;4;8;4949;2;5758;6;3;
/org.eclipse.core.tests.runtime/src/org/eclipse/core/tests/runtime/content/LocalContentTypeManager.java;2;1;7;1;5;5;5;2;48;1;2;4574;81;81;1;0;0;2;7;4574;0;6225;7;2;
/org.eclipse.jdt.core.tests.model/workspace/Converter/test0245/Test.java;1;0;1;1;0;0;0;1;0;0;1;3714;0;0;1;0;0;1;1;3714;0;3714;1;1;
/org.eclipse.jdt.debug.ui/ui/org/eclipse/jdt/internal/debug/ui/propertypages/JavaLineBreakpointPage.java;3;1;9;1;3;3;3;6;36;1;6;1358;89;89;1;0;0;6;9;1358;0;6336;9;3;
/org.eclipse.swt/Eclipse SWT Browser/carbon/org/eclipse/swt/browser/WebKit.java;2;2;3;1;3;2;3;0;6;0;0;5339;10;10;2;0;1;0;3;5339;1;6352;2;2;
/org.eclipse.debug.ui/ui/org/eclipse/debug/internal/ui/launchConfigurations/DuplicateLaunchConfigurationAction.java;1;0;1;1;0;0;0;1;4;0;1;473;4;4;1;0;0;1;1;473;0;473;1;1;
/org.eclipse.ui.workbench/Eclipse UI/org/eclipse/ui/internal/themes/CascadingTheme.java;1;0;1;1;0;0;0;1;0;0;1;4563;0;0;1;0;0;1;1;4563;0;4563;1;1;
/org.eclipse.jdt.ui/ui/org/eclipse/jdt/internal/ui/wizards/buildpaths/NewSourceFolderDialog.java;1;0;1;1;1;1;1;0;2;0;0;6340;2;2;1;0;0;0;1;6340;0;6340;1;1;
/org.eclipse.debug.ui/ui/org/eclipse/debug/ui/launchVariables/expanders/WorkingSetExpander.java;1;0;3;1;0;0;0;3;15;1;3;562;15;15;1;0;0;3;3;562;0;771;3;1;
/org.eclipse.swt/Eclipse SWT PI/gtk/org/eclipse/swt/internal/gtk/GdkVisual.java;2;0;2;1;1;1;1;1;17;0;1;1653;19;19;1;0;0;1;2;1653;0;6352;2;2;
/org.eclipse.swt/Eclipse SWT/photon/org/eclipse/swt/widgets/Sash.java;2;0;3;1;0;0;0;3;2;1;3;269;6;6;1;0;0;3;3;269;0;2402;3;2;
/org.eclipse.jdt.core.tests.model/workspace/Formatter/test309/A_out.java;1;0;1;1;0;0;0;1;0;0;1;2442;0;0;1;0;0;1;1;2442;0;2442;1;1;
/org.eclipse.team.cvs.core/src/org/eclipse/team/internal/ccvs/core/CVSRevisionNumberCompareCriteria.java;2;0;9;1;1;1;1;8;92;1;8;431;182;182;1;0;0;8;9;431;0;6337;9;2;
/org.eclipse.jdt.ui.tests.refactoring/resources/ExtractMethodWorkSpace/ExtractMethodTests/return_in/A_test716.java;1;0;1;1;0;0;0;1;4;0;1;844;4;4;1;0;0;1;1;844;0;844;1;1;
/org.eclipse.sdk.tests-feature/plugins/org.eclipse.perfmsr.ui.client/src/org/eclipse/perfmsr/ui/client/OpenSnapshotsViewActionDelegate.java;1;1;2;1;2;2;2;0;10;0;0;5443;10;10;1;0;0;0;2;5443;0;5513;2;1;
/org.eclipse.ui.workbench/Eclipse UI/org/eclipse/ui/internal/commands/util/old/KeySupport.java;1;0;3;1;0;0;0;3;21;2;2;1222;21;21;2;1;0;3;3;1321;1;1321;2;1;
/org.eclipse.team.ui/src/org/eclipse/team/internal/ui/TextPreferencePage.java;2;0;2;1;0;0;0;2;14;1;2;790;14;14;1;0;0;2;2;790;0;993;2;2;
/org.eclipse.jdt.core/dom/org/eclipse/jdt/internal/core/dom/rewrite/RewriteEvent.java;2;0;2;1;1;1;1;1;4;0;1;4802;4;4;1;0;0;1;2;4802;0;6336;2;2;
/org.eclipse.ui.externaltools/Ant Editor/org/eclipse/ui/externaltools/internal/ant/editor/PlantyEditor.java;1;0;2;1;0;0;0;2;4;1;2;126;4;4;1;0;0;2;2;126;0;178;2;1;
/org.eclipse.core.runtime/src/org/eclipse/core/internal/plugins/PluginEventDispatcher.java;2;0;4;1;0;0;0;4;12;1;4;2105;14;14;1;0;0;4;4;2105;0;3013;4;2;
/org.eclipse.swt/Eclipse SWT/win32/org/eclipse/swt/graphics/TextLayout.java;4;2;36;2;22;20;22;14;642;2;11;4565;2238;2238;2;3;2;14;36;4584;5;6352;31;4;
/org.eclipse.jdt.ui/ui/org/eclipse/jdt/internal/ui/text/spelling/AddWordProposal.java;2;0;2;1;1;1;1;1;2;0;1;3930;2;2;1;0;0;1;2;3930;0;6340;2;2;
/org.eclipse.update.ui.forms/Eclipse Forms/org/eclipse/ui/forms/parts/FormUtil.java;1;0;4;1;0;0;0;4;66;3;2;3096;66;66;3;2;0;4;4;3133;2;3133;2;1;
/org.eclipse.core.runtime/src/org/eclipse/core/runtime/IExtensionRegistry.java;4;1;9;1;3;3;3;6;199;2;5;3134;394;394;2;1;0;6;9;4173;1;5531;8;4;
/org.eclipse.pde.build/src/org/eclipse/pde/internal/build/FeatureWriter.java;2;1;12;1;4;4;4;8;26;1;8;447;61;61;1;0;0;8;12;447;0;5783;12;2;
/org.eclipse.ui.ide/extensions/org/eclipse/ui/IResourceActionFilter.java;6;2;7;1;4;3;4;3;21;1;3;2263;49;49;2;0;1;3;7;5127;1;6338;6;6;
/org.eclipse.jdt.core/compiler/org/eclipse/jdt/internal/compiler/ast/SingleMemberAnnotation.java;1;0;1;1;0;0;0;1;0;0;1;4495;0;0;1;0;0;1;1;4495;0;4495;1;1;
/org.eclipse.core.runtime/src/org/eclipse/core/runtime/jobs/MultiJob.java;1;0;2;1;0;0;0;2;74;1;2;689;74;74;1;0;0;2;2;689;0;698;2;1;
/org.eclipse.team.ui/src/org/eclipse/team/ui/synchronize/SyncInfoCompareInput.java;1;2;13;1;10;9;10;3;308;1;3;3848;604;604;2;0;1;3;13;6087;1;6337;12;1;
/org.eclipse.jdt.text.tests/src/org/eclipse/jdt/ui/tests/comments/MultiLineTestCase.java;1;1;3;1;2;2;2;1;1;0;1;5082;1;1;1;0;0;1;3;5082;0;5130;3;1;
/org.eclipse.ant.core/src_ant/org/eclipse/ant/internal/core/ant/AntSecurityManager.java;1;0;2;1;0;0;0;2;68;1;2;1141;134;134;1;0;0;2;2;1141;0;2988;2;1;
/org.eclipse.jface/src/org/eclipse/jface/dialogs/IDialogSettings.java;2;1;2;1;2;2;2;0;427;0;0;5468;431;431;1;0;0;0;2;5468;0;6338;2;2;
/org.eclipse.jdt.core/model/org/eclipse/jdt/core/util/ISignatureAttribute.java;2;0;2;1;0;0;0;2;37;1;2;3791;37;37;1;0;0;2;2;3791;0;4843;2;2;
/org.eclipse.ui.workbench/Eclipse UI/org/eclipse/ui/activities/EnablementDialog.java;1;1;5;1;2;2;2;3;123;1;3;4304;207;207;1;0;0;3;5;4304;0;5269;5;1;
/org.eclipse.core.tests.resources/src/org/eclipse/core/tests/internal/watson/AllTests.java;1;0;1;1;1;1;1;0;34;0;0;5147;34;34;1;0;0;0;1;5147;0;5147;1;1;
/org.eclipse.jdt.ui/ui/org/eclipse/jdt/internal/ui/typehierarchy/MethodsViewer.java;2;0;4;1;1;1;1;3;4;1;3;435;10;10;1;0;0;3;4;435;0;6340;4;2;
/org.eclipse.ui.views/src/org/eclipse/ui/views/tasklist/DefaultTaskListResourceAdapter.java;1;0;1;1;0;0;0;1;0;0;1;2738;0;0;1;0;0;1;1;2738;0;2738;1;1;
/org.eclipse.jface.text/src/org/eclipse/jface/text/templates/persistence/TemplateMessages.java;2;0;2;1;1;1;1;1;0;0;1;4627;0;0;1;0;0;1;2;4627;0;5262;2;2;
/org.eclipse.jdt.core.tests.model/workspace/Converter/test0151/Test.java;1;0;1;1;0;0;0;1;0;0;1;3714;0;0;1;0;0;1;1;3714;0;3714;1;1;
/org.eclipse.jdt.debug/eval/org/eclipse/jdt/internal/debug/eval/ast/engine/ASTInstructionCompiler.java;2;0;5;1;0;0;0;5;17;1;5;1276;36;36;1;0;0;5;5;1276;0;3315;5;2;
/org.eclipse.ui.tutorials.rcp.part3/src/org/eclipse/ui/tutorials/rcp/part3/views/SampleView.java;1;0;1;1;1;1;1;0;0;0;0;5118;0;0;1;0;0;0;1;5118;0;5118;1;1;
/org.eclipse.jdt.ui/ui/org/eclipse/jdt/internal/ui/search/JavaSearchPresentationFactory.java;1;0;1;1;0;0;0;1;0;0;1;3488;0;0;1;0;0;1;1;3488;0;3488;1;1;
/org.eclipse.pde.core/src/org/eclipse/pde/internal/core/TargetPlatformRegistryLoader.java;2;2;17;1;8;7;8;9;212;2;8;3170;492;492;2;1;1;9;17;4802;2;6336;15;2;
/org.eclipse.jdt.ui.tests.refactoring/resources/Delete/testDeleteWithinCu12/in/A.java;1;0;1;1;0;0;0;1;0;0;1;442;0;0;1;0;0;1;1;442;0;442;1;1;
/org.eclipse.jdt.debug.ui/ui/org/eclipse/jdt/internal/debug/ui/actions/MoveDownAction.java;1;0;2;1;0;0;0;2;13;1;2;1496;17;17;1;0;0;2;2;1496;0;2691;2;1;
/org.eclipse.team.cvs.core/src/org/eclipse/team/internal/ccvs/core/client/NOOPVisitor.java;1;0;1;1;0;0;0;1;5;0;1;1843;5;5;1;0;0;1;1;1843;0;1843;1;1;
/org.eclipse.jface/src/org/eclipse/jface/dialogs/IMessageProvider.java;2;1;2;1;2;2;2;0;34;0;0;5468;38;38;1;0;0;0;2;5468;0;6338;2;2;
/org.eclipse.ui.workbench/Eclipse UI/org/eclipse/ui/wizards/datatransfer/ExternalProjectImportWizard.java;2;0;2;1;0;0;0;2;2;1;2;1080;2;2;1;0;0;2;2;1080;0;2737;2;2;
/org.eclipse.team.ui/src/org/eclipse/team/internal/ui/sync/views/SubscriberEventHandler.java;1;0;1;1;0;0;0;1;0;0;1;1276;0;0;1;0;0;1;1;1276;0;1276;1;1;
/org.eclipse.jdt.core/search/org/eclipse/jdt/internal/core/index/IIndexer.java;1;0;2;1;0;0;0;2;19;1;2;3240;19;19;1;0;0;2;2;3240;0;3384;2;1;
/org.eclipse.team.cvs.core/src/org/eclipse/team/internal/ccvs/core/resources/SessionPropertySyncInfoCache.java;2;2;12;1;4;3;4;8;80;1;8;866;243;243;2;0;1;8;12;6035;1;6337;11;2;
/org.eclipse.core.tests.resources/src/org/eclipse/core/tests/resources/regression/PR_1GEAB3C_Test.java;1;0;2;1;2;1;2;0;132;0;0;5147;132;132;2;0;1;0;2;5147;1;5147;1;1;
/org.eclipse.jdt.debug.tests/tests/org/eclipse/jdt/debug/tests/core/StringSubstitutionTests.java;5;1;9;2;3;3;3;6;260;1;6;2032;445;445;1;0;0;6;9;2032;0;6337;9;5;
/org.eclipse.jdt.ui.tests.refactoring/resources/SurroundWithWorkSpace/SurroundWithTests/trycatch_in/TestWrappedLocal6.java;1;0;1;1;0;0;0;1;5;0;1;845;5;5;1;0;0;1;1;845;0;845;1;1;
/org.eclipse.jdt.core.tests.model/workspace/Formatter/test327/A_out.java;1;0;1;1;0;0;0;1;0;0;1;2565;0;0;1;0;0;1;1;2565;0;2565;1;1;
/org.eclipse.update.ui/src/org/eclipse/update/internal/ui/parts/SharedLabelProvider.java;2;0;4;1;1;1;1;3;10;1;3;890;24;24;1;0;0;3;4;890;0;6336;4;2;
/org.eclipse.update.ui/src/org/eclipse/update/internal/ui/pages/MultipleSelectionPage.java;1;0;1;1;0;0;0;1;0;0;1;755;0;0;1;0;0;1;1;755;0;755;1;1;
/org.eclipse.jdt.ui.tests.refactoring/resources/StructureSelectionAction/A_testZeroLength5.java;1;0;1;1;1;1;1;0;0;0;0;6144;0;0;1;0;0;0;1;6144;0;6144;1;1;
/org.eclipse.jdt.ui.tests.refactoring/resources/MoveMembers/test11/out/B.java;1;0;1;1;0;0;0;1;1;0;1;1522;1;1;1;0;0;1;1;1522;0;1522;1;1;
/org.eclipse.ui.ide/src/org/eclipse/ui/internal/ide/IDEWorkbenchMessages.java;1;0;1;1;0;0;0;1;0;0;1;1512;0;0;1;0;0;1;1;1512;0;1512;1;1;
/org.eclipse.core.resources/src/org/eclipse/core/internal/refresh/PollingMonitor.java;2;2;11;1;6;5;6;5;134;2;4;3681;238;238;2;1;1;5;11;4851;2;6248;9;2;
/org.eclipse.ui.views/src/org/eclipse/ui/views/tasklist/MarkerUtil.java;1;0;1;1;0;0;0;1;0;0;1;2738;0;0;1;0;0;1;1;2738;0;2738;1;1;
/org.eclipse.jdt.core.tests.model/workspace/Converter/test0460/A.java;1;0;1;1;0;0;0;1;0;0;1;3714;0;0;1;0;0;1;1;3714;0;3714;1;1;
/org.eclipse.ui.workbench/Eclipse UI/org/eclipse/ui/internal/commands/registry/AbstractMutableCommandRegistry.java;1;0;2;1;0;0;0;2;0;1;2;1422;0;0;1;0;0;2;2;1422;0;1724;2;1;
/org.eclipse.jdt.core.tests.model/workspace/Formatter/test422/A_out.java;1;0;1;1;0;0;0;1;0;0;1;3475;0;0;1;0;0;1;1;3475;0;3475;1;1;
/org.eclipse.swt/Eclipse SWT/carbon/org/eclipse/swt/internal/Platform.java;1;0;2;1;0;0;0;2;0;1;2;1955;0;0;1;0;0;2;2;1955;0;1969;2;1;
/org.eclipse.ui.workbench/Eclipse UI/org/eclipse/ui/commands/internal/ContextBinding.java;1;0;2;1;0;0;0;2;0;1;2;786;0;0;1;0;0;2;2;786;0;956;2;1;
/org.eclipse.jdt.ui.tests.refactoring/resources/ExtractInterface/test99/in/A.java;1;0;1;1;0;0;0;1;0;0;1;3710;0;0;1;0;0;1;1;3710;0;3710;1;1;
/org.eclipse.team.webdav/src/org/eclipse/team/internal/core/target/BaseIdentifierNotInitializedException.java;1;0;1;1;0;0;0;1;0;0;1;2495;0;0;1;0;0;1;1;2495;0;2495;1;1;
/org.eclipse.swt/Eclipse SWT PI/carbon/org/eclipse/swt/internal/carbon/ATSUUnhighlightData.java;2;2;4;1;3;2;3;1;16;0;1;4535;20;20;2;0;1;1;4;5534;1;5614;3;2;
/org.eclipse.jdt.debug.tests/tests/org/eclipse/jdt/debug/tests/core/PreLaunchBreakpointTest.java;3;1;4;1;3;3;3;1;6;0;1;4810;16;16;1;0;0;1;4;4810;0;6337;4;3;
/org.eclipse.jdt.core.tests.model/workspace/Completion/src/TypeWithAMethodAndAStaticMethod.java;1;0;1;1;0;0;0;1;0;0;1;3039;0;0;1;0;0;1;1;3039;0;3039;1;1;
/org.eclipse.jdt.ui/core extension/org/eclipse/jdt/internal/corext/dom/HierarchicalASTVisitor.java;2;1;2;1;2;2;2;0;277;0;0;6006;279;279;1;0;0;0;2;6006;0;6340;2;2;
/org.eclipse.jdt.ui.tests.refactoring/resources/ExtractMethodWorkSpace/ExtractMethodTests/locals_in/A_test563.java;1;0;1;1;0;0;0;1;2;0;1;844;2;2;1;0;0;1;1;844;0;844;1;1;
/org.eclipse.jdt.core.tests.compiler/src/org/eclipse/jdt/core/tests/compiler/regression/JavadocTestForMethod.java;2;0;7;1;0;0;0;7;191;1;7;2887;285;285;1;0;0;7;7;2887;0;4561;7;2;
/org.eclipse.jdt.ui/core refactoring/org/eclipse/jdt/internal/corext/refactoring/participants/IQualifiedNameUpdating.java;1;0;2;1;0;0;0;2;0;1;2;591;0;0;1;0;0;2;2;591;0;1125;2;1;
/org.eclipse.jdt.ui.tests.refactoring/test cases/org/eclipse/jdt/ui/tests/refactoring/IntroduceParameterTests.java;3;1;9;1;5;5;5;4;12;1;4;2281;44;44;1;0;0;4;9;2281;0;6340;9;3;
/org.eclipse.ui.workbench/Eclipse UI/org/eclipse/ui/internal/roles/api/secondstage/IRoleDefinition.java;1;0;2;1;0;0;0;2;0;1;2;2199;0;0;1;0;0;2;2;2199;0;2207;2;1;
/org.eclipse.core.runtime/src/org/eclipse/core/internal/content/DefaultDescription.java;1;1;2;1;2;2;2;0;5;0;0;5733;5;5;1;0;0;0;2;5733;0;5918;2;1;
/org.eclipse.swt/Eclipse SWT Custom Widgets/common/org/eclipse/swt/custom/ScrolledComposite.java;3;1;3;1;2;2;2;1;8;0;1;125;14;14;1;0;0;1;3;125;0;6352;3;3;
/org.eclipse.core.runtime.osgi/src/org/eclipse/core/runtime/registry/IExtensionRegistry.java;1;0;2;1;0;0;0;2;4;1;2;3013;4;4;1;0;0;2;2;3013;0;3030;2;1;
/org.eclipse.ui.tests/Eclipse UI Tests/org/eclipse/ui/tests/commands/CommandsTestCase2.java;2;0;2;1;1;1;1;1;0;0;1;4896;0;0;1;0;0;1;2;4896;0;6224;2;2;
/org.eclipse.jdt.core/model/org/eclipse/jdt/core/ClasspathVariableInitializer.java;2;0;3;1;0;0;0;3;4;1;3;1802;7;7;1;0;0;3;3;1802;0;3560;3;2;
/org.eclipse.jdt.debug.ui/ui/org/eclipse/jdt/internal/debug/ui/launchConfigurations/ClasspathEntry.java;1;0;3;1;0;0;0;3;5;0;1;2685;5;5;3;2;0;3;3;2685;2;2685;1;1;
/org.eclipse.team.ui/src/org/eclipse/team/ui/ISharedImages.java;2;1;17;1;5;5;5;12;94;1;12;790;214;214;1;0;0;12;17;790;0;6337;17;2;
/org.eclipse.team.ui/src/org/eclipse/team/internal/ui/target/MappingSelectionPage.java;2;0;4;1;0;0;0;4;3;1;4;990;6;6;1;0;0;4;4;990;0;2495;4;2;
/org.eclipse.jdt.core.tests.model/workspace/Converter/test0322/Test.java;1;0;1;1;0;0;0;1;0;0;1;3714;0;0;1;0;0;1;1;3714;0;3714;1;1;
/org.eclipse.swt.tests/JUnit Tests/org/eclipse/swt/tests/junit/Test_org_eclipse_swt_events_MouseTrackListener.java;1;0;1;1;0;0;0;1;16;0;1;2175;16;16;1;0;0;1;1;2175;0;2175;1;1;
/org.eclipse.ua.tests/src/org/eclipse/ui/tests/cheatsheets/actions/TestStartWebApp.java;1;0;1;1;1;1;1;0;0;0;0;6081;0;0;1;0;0;0;1;6081;0;6081;1;1;
/org.eclipse.jdt.launching.j9/j9/org/eclipse/jdt/internal/launching/j9/J9VMInstallType.java;3;1;5;1;2;2;2;3;13;1;3;685;37;37;1;0;0;3;5;685;0;5235;5;3;
/org.eclipse.jdt.core.tests.model/src/org/eclipse/jdt/core/tests/dom/ConverterTestSetup.java;5;1;17;1;4;4;4;13;64;1;13;903;231;231;1;0;0;13;17;903;0;5853;17;5;
/org.eclipse.pde.ui/src_Forms/org/eclipse/pde/internal/ui/neweditor/IModelUndoManager.java;2;0;2;1;1;1;1;1;0;0;1;4832;0;0;1;0;0;1;2;4832;0;5431;2;2;
/org.eclipse.team.examples.filesystem/src/org/eclipse/team/examples/filesystem/ui/GetSynchronizeOperation.java;1;0;1;1;1;1;1;0;0;0;0;6206;0;0;1;0;0;0;1;6206;0;6206;1;1;
/org.eclipse.jdt.ui.tests.refactoring/resources/PullUp/test0/out/A.java;1;0;1;1;0;0;0;1;2;0;1;1690;2;2;1;0;0;1;1;1690;0;1690;1;1;
/org.eclipse.jdt.debug.ui/ui/org/eclipse/jdt/internal/debug/ui/launcher/JavaElementPropertyTester.java;2;1;2;1;2;2;2;0;11;0;0;5508;11;11;1;0;0;0;2;5508;0;6339;2;2;
/org.eclipse.ant.ui/Ant Tools Support/org/eclipse/ant/internal/ui/preferences/AntCodeAssistPreferencePage.java;1;2;4;1;4;3;4;0;4;0;0;5705;8;8;2;0;1;0;4;5720;1;6080;3;1;
/org.eclipse.jdt.ui/ui/org/eclipse/jdt/internal/ui/javaeditor/selectionactions/StructureSelectEnclosingAction.java;1;0;1;1;1;1;1;0;2;0;0;6340;2;2;1;0;0;0;1;6340;0;6340;1;1;
/org.eclipse.pde.build/src/org/eclipse/pde/internal/build/packager/UnzipperGenerator.java;2;1;11;1;2;2;2;9;107;1;9;447;163;163;1;0;0;9;11;447;0;6340;11;2;
/org.eclipse.jdt.core/model/org/eclipse/jdt/core/jdom/IDOMMethod.java;2;0;4;1;1;1;1;3;53;1;3;3560;67;67;1;0;0;3;4;3560;0;5584;4;2;
/org.eclipse.jdt.core.tests.model/workspace/Formatter/test185/A_in.java;1;0;1;1;0;0;0;1;0;0;1;2425;0;0;1;0;0;1;1;2425;0;2425;1;1;
/org.eclipse.jface/src/org/eclipse/jface/dialogs/MessageDialogWithToggle.java;2;2;5;1;5;4;5;0;143;0;0;5386;278;278;2;0;1;0;5;5593;1;6145;4;2;
/org.eclipse.jdt.core.tests.model/workspace/Formatter/test024/A_in.java;1;0;1;1;0;0;0;1;0;0;1;2425;0;0;1;0;0;1;1;2425;0;2425;1;1;
/org.eclipse.update/src/org/eclipse/update/internal/ui/UMApplication.java;1;0;1;1;1;1;1;0;0;0;0;6339;0;0;1;0;0;0;1;6339;0;6339;1;1;
/org.eclipse.jdt.ui/core refactoring/org/eclipse/jdt/internal/corext/refactoring/rename/RefactoringScopeFactory.java;3;0;5;1;1;1;1;4;51;1;4;1522;132;132;1;0;0;4;5;1522;0;6340;5;3;
/org.eclipse.jdt.core.tests.model/workspace/Formatter/test205/A_in.java;1;0;1;1;0;0;0;1;0;0;1;2424;0;0;1;0;0;1;1;2424;0;2424;1;1;
/org.eclipse.jdt.ui/ui refactoring/org/eclipse/jdt/internal/ui/refactoring/reorg/NewNameQueries.java;3;0;9;2;1;1;1;8;142;2;7;1112;237;237;2;1;0;8;9;1125;1;6340;8;3;
/org.eclipse.osgi/resolver/src/org/eclipse/osgi/internal/resolver/BundleSpecificationImpl.java;3;1;3;1;2;2;2;1;6;0;1;3013;10;10;1;0;0;1;3;3013;0;6337;3;3;
/org.eclipse.ui.workbench.texteditor/src/org/eclipse/ui/internal/texteditor/quickdiff/compare/rangedifferencer/LinkedRangeFactory.java;3;1;3;1;3;3;3;0;34;0;0;6269;38;38;1;0;0;0;3;6269;0;6340;3;3;
/org.eclipse.jdt.ui/core refactoring/org/eclipse/jdt/internal/corext/refactoring/participants/ExtensionManager.java;2;0;9;2;0;0;0;9;57;2;8;825;175;175;2;1;0;9;9;1668;1;4624;8;2;
/org.eclipse.ui.workbench/Eclipse UI/org/eclipse/ui/internal/commands/api/IKeyConfigurationListener.java;1;0;2;1;0;0;0;2;2;0;1;2562;2;2;2;1;0;2;2;2562;1;2562;1;1;
/org.eclipse.jdt.ui.tests.refactoring/resources/Copy/test_import_container_yes_type_in_different_cu/in/A.java;1;0;1;1;0;0;0;1;0;0;1;685;0;0;1;0;0;1;1;685;0;685;1;1;
/org.eclipse.jdt.core.tests.model/workspace/Formatter/test073/A_in.java;1;0;1;1;0;0;0;1;0;0;1;2425;0;0;1;0;0;1;1;2425;0;2425;1;1;
/org.eclipse.core.tests.runtime/src/org/eclipse/core/tests/internal/plugins/PluginResolveTest_29.java;1;0;1;1;0;0;0;1;0;0;1;3014;0;0;1;0;0;1;1;3014;0;3014;1;1;
/org.eclipse.jdt.ui.tests.refactoring/resources/InlineMethodWorkspace/TestCases/cast_in/TestHierarchyOverloaded.java;1;0;1;1;0;0;0;1;0;0;1;955;0;0;1;0;0;1;1;955;0;955;1;1;
/org.eclipse.jdt.core.tests.model/workspace/Converter/test0388/A.java;1;0;1;1;0;0;0;1;0;0;1;3714;0;0;1;0;0;1;1;3714;0;3714;1;1;
/org.eclipse.ui.workbench/Eclipse UI/org/eclipse/ui/keys/NativeModifierKeyComparator.java;2;0;3;1;0;0;0;3;2;1;3;3169;2;2;1;0;0;3;3;3169;0;3310;3;2;
/org.eclipse.update.tests.core/src/org/eclipse/update/tests/regularInstall/TestInstallURLSIteXML.java;1;1;7;1;3;3;3;4;82;1;4;2048;164;164;1;0;0;4;7;2048;0;6336;7;1;
/org.eclipse.jdt.ui.tests.refactoring/resources/ExtractMethodWorkSpace/ExtractMethodTests/try_in/A_test457.java;1;0;2;1;0;0;0;2;2;1;2;130;4;4;1;0;0;2;2;130;0;844;2;1;
/org.eclipse.ui.ide/src/org/eclipse/ui/internal/dialogs/MultiStepCapabilityWizard.java;2;0;2;1;0;0;0;2;0;1;2;1526;0;0;1;0;0;2;2;1526;0;2263;2;2;
/org.eclipse.jdt.debug.ui/ui/org/eclipse/jdt/internal/debug/ui/JDIContentAssistPreference.java;3;1;4;1;3;3;3;1;8;0;1;1275;17;17;1;0;0;1;4;1275;0;6336;4;3;
/org.eclipse.jdt.core.tests.model/workspace/Formatter/test394/A_out.java;1;0;1;1;0;0;0;1;0;0;1;3426;0;0;1;0;0;1;1;3426;0;3426;1;1;
/org.eclipse.jdt.core.tests.model/workspace/Formatter/test281/A_in.java;1;0;1;1;0;0;0;1;0;0;1;2443;0;0;1;0;0;1;1;2443;0;2443;1;1;
/org.eclipse.ui.workbench/Eclipse UI/org/eclipse/ui/internal/progress/ProgressViewUpdater.java;2;1;13;1;2;2;2;11;118;2;10;2307;393;393;2;1;0;11;13;2307;1;6338;12;2;
/org.eclipse.ui.workbench/Eclipse UI/org/eclipse/ui/internal/roles/RoleMessages.java;2;0;3;1;0;0;0;3;7;2;2;2079;7;7;2;1;0;3;3;2079;1;2443;2;2;
/org.eclipse.ui.workbench/Eclipse UI/org/eclipse/ui/commands/ICommandHandlerService.java;1;0;6;1;0;0;0;6;75;1;6;1223;102;102;1;0;0;6;6;1223;0;4144;6;1;
/org.eclipse.swt/Eclipse SWT/motif/org/eclipse/swt/widgets/Shell.java;7;1;35;2;8;8;8;27;128;2;25;83;586;586;2;2;0;27;35;847;2;6352;33;7;
/org.eclipse.jdt.core.tests.model/workspace/Formatter/test465/A_out.java;1;0;1;1;0;0;0;1;0;0;1;3915;0;0;1;0;0;1;1;3915;0;3915;1;1;
/org.eclipse.ui.workbench/Eclipse UI/org/eclipse/ui/internal/UIWorkspaceLock.java;1;0;1;1;0;0;0;1;0;0;1;1524;0;0;1;0;0;1;1;1524;0;1524;1;1;
/org.eclipse.jdt.ui/ui/org/eclipse/jdt/internal/ui/javaeditor/CompilationUnitAnnotationModelEvent.java;3;0;6;2;1;1;1;5;59;2;4;1127;93;93;2;1;0;5;6;1127;1;6340;5;3;
/org.eclipse.compare.examples.xml/src/org/eclipse/compare/examples/xml/XMLCompareEditCopyIdMapDialog.java;1;0;3;1;0;0;0;3;43;1;3;1106;45;45;1;0;0;3;3;1106;0;3938;3;1;
/org.eclipse.jdt.core/compiler/org/eclipse/jdt/internal/compiler/ast/EmptyStatement.java;2;0;6;1;1;1;1;5;13;2;4;953;32;32;2;1;0;5;6;989;1;5339;5;2;
/org.eclipse.debug.ui/ui/org/eclipse/debug/internal/ui/DebugPerspectiveFactory.java;4;0;6;1;1;1;1;5;10;1;5;2060;28;28;1;0;0;5;6;2060;0;6336;6;4;
/org.eclipse.swt/Eclipse SWT/motif/org/eclipse/swt/widgets/FontDialog.java;4;1;10;2;2;2;2;8;909;3;4;166;1081;1081;3;4;0;8;10;166;4;6352;6;4;
/org.eclipse.team.ui/src/org/eclipse/team/internal/ui/synchronize/LocalResourceTypedElement.java;1;1;6;1;2;2;2;4;157;1;4;4118;189;189;1;0;0;4;6;4118;0;6337;6;1;
/org.eclipse.jdt.ui.tests.refactoring/resources/Copy/test_import_container_yes_type_in_different_cu/in/C.java;1;0;1;1;0;0;0;1;0;0;1;685;0;0;1;0;0;1;1;685;0;685;1;1;
/org.eclipse.osgi.tests/src/org/eclipse/osgi/tests/services/resolver/AllTests.java;1;0;1;1;1;1;1;0;0;0;0;5993;0;0;1;0;0;0;1;5993;0;5993;1;1;
/org.eclipse.ui.workbench/Eclipse UI/org/eclipse/ui/intro/IIntroDescriptor.java;1;0;3;1;0;0;0;3;2;1;3;3632;2;2;1;0;0;3;3;3632;0;4649;3;1;
/org.eclipse.jdt.core.tests.model/workspace/JavaSearch/src/j2/Bug47968s.java;1;0;1;1;0;0;0;1;0;0;1;3129;0;0;1;0;0;1;1;3129;0;3129;1;1;
/org.eclipse.jdt.core/compiler/org/eclipse/jdt/internal/compiler/parser/RecoveredBlock.java;4;0;8;1;2;1;2;6;92;1;6;488;210;210;2;0;1;6;8;5354;1;5354;7;4;
/org.eclipse.jdt.text.tests/src/org/eclipse/jdt/ui/text/tests/JavaHeuristicScannerTest.java;1;0;2;1;1;1;1;1;0;0;1;5082;0;0;1;0;0;1;2;5082;0;5129;2;1;
/org.eclipse.releng.basebuilder/plugins/org.eclipse.build.tools/src/org/eclipse/releng/BuildMachineManager.java;1;0;2;1;0;0;0;2;10;0;1;3593;10;10;2;1;0;2;2;3593;1;3593;1;1;
/org.eclipse.jdt.debug.ui/ui/org/eclipse/jdt/internal/debug/ui/breakpoints/AddExceptionAction.java;3;1;3;1;2;2;2;1;20;0;1;3093;25;25;1;0;0;1;3;3093;0;5476;3;3;
/org.eclipse.debug.ui/ui/org/eclipse/debug/internal/ui/sourcelookup/CommonSourceNotFoundEditorInput.java;1;0;2;1;1;1;1;1;59;0;1;3770;59;59;1;0;0;1;2;3770;0;5534;2;1;
/org.eclipse.ant.tests.ui/Ant Editor Tests/org/eclipse/ant/tests/ui/editor/AntEditorContentOutlineTests.java;1;0;9;1;0;0;0;9;343;2;6;1811;564;564;2;3;0;9;9;1811;3;4389;6;1;
/org.eclipse.team.cvs.core/src/org/eclipse/team/internal/ccvs/core/client/UpdateMergableOnly.java;2;1;8;1;2;2;2;6;113;2;5;712;201;201;2;1;0;6;8;1672;1;6337;7;2;
/org.eclipse.ui.views/src/org/eclipse/ui/views/markers/internal/ActionAddGlobalTask.java;3;0;3;1;0;0;0;3;1;1;3;755;1;1;1;0;0;3;3;755;0;2738;3;3;
/org.eclipse.team.core/src/org/eclipse/team/core/subscribers/ITeamResourceChangeListener.java;1;0;3;1;0;0;0;3;44;1;3;649;44;44;1;0;0;3;3;649;0;4216;3;1;
/org.eclipse.jdt.core.tests.model/workspace/Converter/src/junit/textui/ResultPrinter.java;1;0;1;1;0;0;0;1;0;0;1;3714;0;0;1;0;0;1;1;3714;0;3714;1;1;
/org.eclipse.jdt.debug.ui/ui/org/eclipse/jdt/internal/debug/ui/launcher/MainMethodSearchEngine.java;3;1;4;1;2;2;2;2;111;1;2;4188;116;116;1;0;0;2;4;4188;0;5408;4;3;
/org.eclipse.jdt.core.tests.model/workspace/Converter/test0414/B.java;1;0;1;1;0;0;0;1;0;0;1;3714;0;0;1;0;0;1;1;3714;0;3714;1;1;
/org.eclipse.jdt.ui.tests.refactoring/resources/ExtractInterface/test99/out/B.java;1;0;1;1;0;0;0;1;0;0;1;3710;0;0;1;0;0;1;1;3710;0;3710;1;1;
/org.eclipse.swt/Eclipse SWT PI/win32/org/eclipse/swt/internal/win32/NONCLIENTMETRICSW.java;2;0;2;1;0;0;0;2;1;1;2;957;1;1;1;0;0;2;2;957;0;2915;2;2;
/org.eclipse.jdt.core/model/org/eclipse/jdt/core/jdom/DOMException.java;1;0;3;1;1;1;1;2;4;1;2;1806;10;10;1;0;0;2;3;1806;0;5774;3;1;
/org.eclipse.ant.ui/Ant Editor/org/eclipse/ant/internal/ui/editor/derived/HTML2TextReader.java;1;0;1;1;0;0;0;1;0;0;1;1811;0;0;1;0;0;1;1;1811;0;1811;1;1;
/org.eclipse.debug.ui/ui/org/eclipse/debug/internal/ui/actions/RetargetWatchpointAction.java;1;0;2;1;0;0;0;2;1;0;1;4492;1;1;2;1;0;2;2;4492;1;4492;1;1;
/org.eclipse.swt/Eclipse SWT PI/carbon/org/eclipse/swt/internal/carbon/HMHelpContentRec.java;1;2;3;1;3;2;3;0;16;0;0;5534;20;20;2;0;1;0;3;5534;1;5614;2;1;
/org.eclipse.update.configurator/src/org/eclipse/update/internal/configurator/Utils.java;1;2;19;1;6;4;6;13;98;2;12;3270;359;359;2;1;2;13;19;4760;3;5878;16;1;
/org.eclipse.ui.workbench/Eclipse UI/org/eclipse/ui/internal/commands/gestures/GestureStroke.java;1;0;3;1;0;0;0;3;14;1;3;1264;25;25;1;0;0;3;3;1264;0;1294;3;1;
/org.eclipse.ui.workbench/Eclipse UI/org/eclipse/ui/internal/commands/MutableCommandHandlerService.java;2;0;5;1;0;0;0;5;19;1;5;3131;22;22;1;0;0;5;5;3131;0;4144;5;2;
/org.eclipse.jdt.core/compiler/org/eclipse/jdt/internal/compiler/ast/QualifiedSuperReference.java;2;0;4;1;0;0;0;4;10;1;4;991;18;18;1;0;0;4;4;991;0;4910;4;2;
/org.eclipse.core.runtime.compatibility/src-boot/org/eclipse/core/boot/IPlatformRunnable.java;2;1;2;1;2;2;2;0;2;0;0;5541;2;2;1;0;0;0;2;5541;0;6340;2;2;
/org.eclipse.swt/Eclipse SWT Drag and Drop/win32/org/eclipse/swt/dnd/DropTarget.java;2;0;7;1;0;0;0;7;385;2;6;173;713;713;2;1;0;7;7;441;1;789;6;2;
/org.eclipse.ui.workbench/Eclipse UI/org/eclipse/ui/internal/commands/registry/old/ConfigurationElementMemento.java;1;0;2;1;0;0;0;2;0;0;1;1222;0;0;2;1;0;2;2;1222;1;1222;1;1;
/org.eclipse.jdt.ui/ui/org/eclipse/jdt/internal/ui/search/ParticipantSelectionDialog.java;1;0;3;1;0;0;0;3;119;1;3;3488;119;119;1;0;0;3;3;3488;0;5075;3;1;
/org.eclipse.jdt.ui.tests.refactoring/resources/RenameType/test62/in/A.java;1;0;1;1;1;1;1;0;0;0;0;6118;0;0;1;0;0;0;1;6118;0;6118;1;1;
/org.eclipse.core.tests.runtime/src/org/eclipse/core/tests/runtime/model/AllTests.java;1;0;1;1;1;1;1;0;0;0;0;5987;0;0;1;0;0;0;1;5987;0;5987;1;1;
/org.eclipse.jdt.ui/ui/org/eclipse/jdt/internal/ui/callhierarchy/MethodCall.java;1;0;2;1;0;0;0;2;0;1;2;155;0;0;1;0;0;2;2;155;0;169;2;1;
/org.eclipse.core.resources/src/org/eclipse/core/resources/team/ResourceRuleFactory.java;2;1;5;1;2;2;2;3;42;1;3;4999;91;91;1;0;0;3;5;4999;0;5897;5;2;
/org.eclipse.swt/Eclipse SWT PI/carbon/org/eclipse/swt/internal/carbon/FontInfo.java;1;2;3;1;3;2;3;0;16;0;0;5534;20;20;2;0;1;0;3;5534;1;5614;2;1;
/org.eclipse.jdt.debug.ui/ui/org/eclipse/jdt/internal/debug/core/refactoring/JavaClassPrepareBreakpointTypeChange.java;2;1;3;1;3;3;3;0;8;0;0;5319;16;16;1;0;0;0;3;5319;0;6339;3;2;
/org.eclipse.core.filebuffers/src/org/eclipse/core/filebuffers/IPersistableAnnotationModel.java;1;1;2;1;2;2;2;0;27;0;0;5382;27;27;1;0;0;0;2;5382;0;6302;2;1;
/org.eclipse.jdt.ui.tests.refactoring/resources/IntroduceFactory/negative/A_testFail0_in.java;1;0;2;1;1;1;1;1;2;0;1;2846;2;2;1;0;0;1;2;2846;0;5659;2;1;
/org.eclipse.team.ui/src/org/eclipse/team/internal/ui/sync/views/ISyncSetChangedListener.java;1;0;3;1;0;0;0;3;24;1;3;488;24;24;1;0;0;3;3;488;0;1354;3;1;
/org.eclipse.jdt.ui.tests/leaks/org/eclipse/jdt/ui/leaktest/ProfileNatives.java;4;1;5;1;2;2;2;3;107;1;3;3124;113;113;1;0;0;3;5;3124;0;6340;5;4;
/org.eclipse.core.tests.harness/src/org/eclipse/core/tests/harness/LoggingPerformanceTestResult.java;1;0;1;1;1;1;1;0;20;0;0;5146;20;20;1;0;0;0;1;5146;0;5146;1;1;
/org.eclipse.ui.workbench/Eclipse UI/org/eclipse/ui/internal/dialogs/WizardNewProjectCapabilityPage.java;1;0;1;1;0;0;0;1;0;0;1;2737;0;0;1;0;0;1;1;2737;0;2737;1;1;
/org.eclipse.jdt.launching/launching/org/eclipse/jdt/internal/launching/JavaClasspathVariablesInitializer.java;3;1;3;1;2;2;2;1;10;0;1;2497;16;16;1;0;0;1;3;2497;0;6336;3;3;
/org.eclipse.ltk.core.refactoring/src/org/eclipse/ltk/core/refactoring/participants/ParticipantDescriptor.java;1;0;2;1;0;0;0;2;0;1;2;4845;0;0;1;0;0;2;2;4845;0;4913;2;1;
/org.eclipse.ui.ide/extensions/org/eclipse/ui/dialogs/NewFolderDialog.java;3;0;3;1;1;1;1;2;35;1;2;2263;59;59;1;0;0;2;3;2263;0;6338;3;3;
/org.eclipse.ui.workbench/Eclipse UI/org/eclipse/ui/internal/commands/old/GesturePreferencePage.java;1;0;4;1;0;0;0;4;21;2;3;1222;21;21;2;1;0;4;4;1321;1;1356;3;1;
/org.eclipse.debug.ui/ui/org/eclipse/debug/internal/ui/views/memory/ViewTabEnablementManager.java;2;1;2;1;2;2;2;0;2;0;0;5254;2;2;1;0;0;0;2;5254;0;5364;2;2;
/org.eclipse.jdt.ui.tests.refactoring/resources/ChangeSignature/canModify/A_testImport05_in.java;1;0;1;1;0;0;0;1;0;0;1;3940;0;0;1;0;0;1;1;3940;0;3940;1;1;
/org.eclipse.ui.intro/src/org/eclipse/ui/intro/internal/model/IntroURL.java;2;0;14;1;1;1;2;12;562;3;10;4429;725;725;3;2;1;13;14;4609;3;5115;11;2;
/org.eclipse.jdt.core.tests.model/workspace/Converter/src/junit/extensions/TestDecorator.java;1;0;1;1;0;0;0;1;0;0;1;3714;0;0;1;0;0;1;1;3714;0;3714;1;1;
/org.eclipse.jdt.core.tests.model/workspace/Formatter/test070/A_out.java;1;0;1;1;0;0;0;1;0;0;1;2425;0;0;1;0;0;1;1;2425;0;2425;1;1;
/org.eclipse.ant.ui/Ant Tools Support/org/eclipse/ui/ant/internal/views/actions/EditLaunchConfigurationAction.java;1;0;2;1;0;0;0;2;4;1;2;250;4;4;1;0;0;2;2;250;0;263;2;1;
/org.eclipse.team.tests.core/src/org/eclipse/team/tests/ui/views/ContentProviderTestView.java;2;0;4;1;1;1;1;3;36;2;2;3715;40;40;2;1;0;3;4;3715;1;6337;3;2;
/org.eclipse.update.core/src/org/eclipse/update/internal/core/ISiteContentConsumer.java;2;1;3;1;2;2;2;1;4;0;1;890;11;11;1;0;0;1;3;890;0;6336;3;2;
/org.eclipse.jdt.core.tests.model/workspace/Converter/test0293/Test.java;1;0;1;1;0;0;0;1;0;0;1;3714;0;0;1;0;0;1;1;3714;0;3714;1;1;
/org.eclipse.team.core/src/org/eclipse/team/internal/core/target/TargetManager.java;1;0;2;1;0;0;0;2;6;1;2;866;6;6;1;0;0;2;2;866;0;2495;2;1;
/org.eclipse.jdt.core.tests.compiler/src/org/eclipse/jdt/core/tests/eval/DebugEvaluationSetup.java;2;0;4;1;0;0;0;4;213;1;4;1387;221;221;1;0;0;4;4;1387;0;3560;4;2;
/org.eclipse.update.ui/src/org/eclipse/update/internal/ui/forms/ActivitySection.java;1;0;1;1;0;0;0;1;0;0;1;755;0;0;1;0;0;1;1;755;0;755;1;1;
/org.eclipse.jdt.core.tests.model/workspace/Formatter/test012/A_in.java;1;0;1;1;0;0;0;1;0;0;1;2425;0;0;1;0;0;1;1;2425;0;2425;1;1;
/org.eclipse.update.core/src/org/eclipse/update/internal/api/search/BackLevelFilter.java;1;0;2;1;0;0;0;2;0;1;2;3270;0;0;1;0;0;2;2;3270;0;4928;2;1;
/org.eclipse.swt/Eclipse SWT/win32/org/eclipse/swt/widgets/TrayItem.java;3;1;11;2;3;3;3;8;38;2;6;4517;126;126;2;2;0;8;11;4517;2;6133;9;3;
/org.eclipse.jdt.junit/src/org/eclipse/jdt/internal/junit/refactoring/TypeRenameParticipant.java;2;0;2;1;1;1;1;1;10;0;1;5041;10;10;1;0;0;1;2;5041;0;6340;2;2;
/org.eclipse.ui.workbench/Eclipse UI/org/eclipse/ui/internal/commands/api/XIPropertyListener.java;1;0;4;1;0;0;0;4;0;2;3;1724;0;0;2;1;0;4;4;2515;1;2532;3;1;
/org.eclipse.ui.workbench/Eclipse UI/org/eclipse/ui/handles/IHandleListener.java;1;0;3;1;0;0;0;3;2;1;3;1294;2;2;1;0;0;3;3;1294;0;1507;3;1;
/org.eclipse.team.ui/src/org/eclipse/team/internal/ui/synchronize/SynchronizeView.java;2;2;23;2;11;9;11;12;305;2;11;2535;962;962;2;1;2;12;23;4216;3;6335;20;2;
/org.eclipse.swt.tools/JNI Generation/org/eclipse/swt/tools/internal/NativeTest.java;2;0;2;1;0;0;0;2;0;1;2;4175;0;0;1;0;0;2;2;4175;0;4270;2;2;
/org.eclipse.pde.ui/src/org/eclipse/pde/internal/ui/editor/build/JARFileFilter.java;2;1;5;1;3;3;3;2;25;1;2;1727;35;35;1;0;0;2;5;1727;0;6336;5;2;
/org.eclipse.core.resources/src/org/eclipse/core/internal/resources/WorkspacePreferences.java;3;1;7;1;2;2;2;5;32;1;5;91;79;79;1;0;0;5;7;91;0;5146;7;3;
/org.eclipse.team.examples.filesystem/src/org/eclipse/team/examples/pessimistic/ui/CheckOutAction.java;1;0;2;1;1;1;1;1;43;0;1;3368;43;43;1;0;0;1;2;3368;0;6103;2;1;
/org.eclipse.ltk.core.refactoring/src/org/eclipse/ltk/internal/core/refactoring/TextChanges.java;1;0;2;1;1;1;1;1;2;0;1;4845;2;2;1;0;0;1;2;4845;0;5162;2;1;
/org.eclipse.jdt.core.tests.model/workspace/Converter/test0117/Test.java;1;0;1;1;0;0;0;1;0;0;1;3714;0;0;1;0;0;1;1;3714;0;3714;1;1;
/org.eclipse.pde.core/src/org/eclipse/pde/core/plugin/ISharedPluginModel.java;2;1;3;1;2;2;2;1;20;0;1;2184;24;24;1;0;0;1;3;2184;0;6336;3;2;
/org.eclipse.ui.workbench/Eclipse UI/org/eclipse/ui/internal/SelectionEnabler.java;1;0;1;1;0;0;0;1;0;0;1;2737;0;0;1;0;0;1;1;2737;0;2737;1;1;
/org.eclipse.ui.workbench/Eclipse UI/org/eclipse/ui/internal/decorators/FullDecoratorRunnable.java;1;0;1;1;0;0;0;1;0;0;1;4237;0;0;1;0;0;1;1;4237;0;4237;1;1;
/org.eclipse.update.core/srcnew/org/eclipse/update/search/IUpdateSearchFilter.java;2;0;4;1;0;0;0;4;23;2;3;580;41;41;2;1;0;4;4;580;1;825;3;2;
/org.eclipse.jdt.ui.tests.refactoring/test cases/org/eclipse/jdt/ui/tests/reorg/CopyTest.java;3;0;26;1;1;1;1;25;1056;2;20;516;3092;3092;2;5;0;25;26;516;5;6340;21;3;
/org.eclipse.swt/Eclipse SWT/motif/org/eclipse/swt/widgets/Sash.java;4;1;8;1;2;2;2;6;37;1;6;83;107;107;1;0;0;6;8;83;0;6352;8;4;
/org.eclipse.jdt.core.tests.model/workspace/Formatter/test342/A_out.java;1;0;1;1;0;0;0;1;0;0;1;2865;0;0;1;0;0;1;1;2865;0;2865;1;1;
/org.eclipse.jdt.core.tests.model/workspace/Converter/test0181/Test.java;1;0;1;1;0;0;0;1;0;0;1;3714;0;0;1;0;0;1;1;3714;0;3714;1;1;
/org.eclipse.core.tests.runtime/src/org/eclipse/core/tests/runtime/content/LazyReaderTest.java;2;0;1;2;1;1;1;0;20;0;0;6225;20;20;1;0;0;0;1;6225;0;6225;1;2;
/org.eclipse.pde.core/src/org/eclipse/pde/internal/core/feature/IdentifiableObject.java;2;1;3;1;2;2;2;1;8;0;1;4203;14;14;1;0;0;1;3;4203;0;6336;3;2;
/org.eclipse.update.ui/src/org/eclipse/update/internal/ui/wizards/OptionalFeaturesPage.java;3;1;11;1;2;2;2;9;232;2;8;755;319;319;2;1;0;9;11;1521;1;6336;10;3;
/org.eclipse.pde.core/src/org/eclipse/pde/internal/core/ischema/IDocumentSection.java;1;0;1;1;1;1;1;0;12;0;0;5799;12;12;1;0;0;0;1;5799;0;5799;1;1;
/org.eclipse.ui.ide/src/org/eclipse/ui/part/MarkerTransfer.java;2;0;2;1;0;0;0;2;0;1;2;1511;0;0;1;0;0;2;2;1511;0;2263;2;2;
/org.eclipse.core.expressions.tests/src/org/eclipse/core/internal/expressions/tests/A_TypeExtender3.java;1;0;2;1;1;1;1;1;2;0;1;4108;2;2;1;0;0;1;2;4108;0;6340;2;1;
/org.eclipse.jdt.debug.jdi.tests/tests/org/eclipse/debug/jdi/tests/AutomatedSuite.java;1;0;1;1;0;0;0;1;0;0;1;4264;0;0;1;0;0;1;1;4264;0;4264;1;1;
/org.eclipse.jdt.ui/ui/org/eclipse/jdt/internal/ui/jarpackager/ManifestProvider.java;1;0;1;1;1;1;1;0;2;0;0;6340;2;2;1;0;0;0;1;6340;0;6340;1;1;
/org.eclipse.jdt.debug.ui/ui/org/eclipse/jdt/internal/debug/ui/JavaWatchExpressionActionFilter.java;1;0;1;1;0;0;0;1;0;0;1;1516;0;0;1;0;0;1;1;1516;0;1516;1;1;
/org.eclipse.jdt.core.tests.model/workspace/Formatter/test356/A_in.java;1;0;1;1;0;0;0;1;2;0;1;3086;2;2;1;0;0;1;1;3086;0;3086;1;1;
/org.eclipse.core.runtime.osgi/src/org/eclipse/core/internal/registry/ExtensionsParser.java;2;0;4;2;0;0;0;4;31;3;2;3013;31;31;3;2;0;4;4;3030;2;3030;2;2;
/org.eclipse.pde.core/src/org/eclipse/pde/internal/core/feature/FeatureObject.java;2;0;3;1;1;1;1;2;7;1;2;4203;13;13;1;0;0;2;3;4203;0;6336;3;2;
/org.eclipse.pde.ui/src/org/eclipse/pde/internal/ui/editor/manifest/ExtensionsForm.java;1;0;1;1;1;1;1;0;0;0;0;5431;0;0;1;0;0;0;1;5431;0;5431;1;1;
/org.eclipse.team.core/src/org/eclipse/team/internal/core/streams/TimeoutInputStream.java;2;0;3;1;1;1;1;2;62;0;1;4824;64;64;2;1;0;2;3;4824;1;6336;2;2;
/org.eclipse.jdt.core.tests.model/workspace/Formatter/test279/A_out.java;1;0;1;1;0;0;0;1;0;0;1;2443;0;0;1;0;0;1;1;2443;0;2443;1;1;
/org.eclipse.jdt.debug.ui/ui/org/eclipse/jdt/internal/debug/ui/JavaUtilMapEntryObjectBrowser.java;3;0;4;1;0;0;0;4;7;1;4;861;12;12;1;0;0;4;4;861;0;2647;4;3;
/org.eclipse.jdt.core.tests.model/workspace/Converter/test0139/Test.java;1;0;1;1;0;0;0;1;0;0;1;3714;0;0;1;0;0;1;1;3714;0;3714;1;1;
/org.eclipse.jdt.core.tests.model/workspace/Converter/src/test0443/A.java;1;0;1;1;0;0;0;1;0;0;1;3714;0;0;1;0;0;1;1;3714;0;3714;1;1;
/org.eclipse.jdt.ui.tests.refactoring/resources/TypeConstraints/A_testConstraints16.java;1;0;1;1;0;0;0;1;0;0;1;62;0;0;1;0;0;1;1;62;0;62;1;1;
/org.eclipse.ui.workbench/Eclipse UI/org/eclipse/ui/internal/presentation/CascadingFontRegistry.java;1;0;3;1;0;0;0;3;2;1;3;4263;2;2;1;0;0;3;3;4263;0;4392;3;1;
/org.eclipse.pde.core/src/org/eclipse/pde/core/osgi/bundle/IBundleModel.java;2;1;5;1;3;3;3;2;43;1;2;4203;67;67;1;0;0;2;5;4203;0;5445;5;2;
/org.eclipse.pde.ui/sandbox/org/eclipse/pde/internal/ui/editor/standalone/parser/DocumentModelFactory.java;1;0;2;1;0;0;0;2;0;1;2;2320;0;0;1;0;0;2;2;2320;0;2931;2;1;
/org.eclipse.pde.ui/src/org/eclipse/pde/internal/ui/wizards/imports/PluginImportWizardDetailedPage.java;2;1;31;2;3;3;3;28;714;5;20;95;1836;1836;5;8;0;28;31;727;8;6336;23;2;
/org.eclipse.jdt.ui.tests.refactoring/resources/ExtractMethodWorkSpace/ExtractMethodTests/parameterName_in/A_test905.java;1;0;1;1;0;0;0;1;0;0;1;2256;0;0;1;0;0;1;1;2256;0;2256;1;1;
/org.eclipse.debug.core/core/org/eclipse/debug/internal/core/LaunchManager.java;4;1;40;1;4;4;4;36;110;2;33;463;891;891;2;3;0;36;40;2462;3;5672;37;4;
/org.eclipse.ui.externaltools/Ant Editor/org/eclipse/ui/externaltools/internal/ant/editor/xml/XmlElement.java;1;0;2;1;0;0;0;2;6;1;2;178;6;6;1;0;0;2;2;178;0;282;2;1;
/org.eclipse.jdt.ui/core refactoring/org/eclipse/jdt/internal/corext/refactoring/reorg/DeleteRefactoring2.java;1;0;2;1;0;0;0;2;0;1;2;1114;0;0;1;0;0;2;2;1114;0;1126;2;1;
/org.eclipse.ui.cheatsheets/src/org/eclipse/ui/internal/cheatsheets/views/CheatSheetView.java;3;1;21;2;6;6;6;15;958;3;10;4428;2186;2186;3;5;0;15;21;4701;5;6336;16;3;
/org.eclipse.update.core/src/org/eclipse/update/internal/model/ConfigurationPolicyModel.java;2;1;6;1;3;3;3;3;33;1;3;890;66;66;1;0;0;3;6;890;0;6336;6;2;
/org.eclipse.jdt.core.tests.model/workspace/Converter/src/test0217/Test.java;1;0;1;1;0;0;0;1;0;0;1;3714;0;0;1;0;0;1;1;3714;0;3714;1;1;
/org.eclipse.ui.views/src/org/eclipse/ui/views/internal/markers/MarkerType.java;1;0;2;1;0;0;0;2;0;1;2;265;0;0;1;0;0;2;2;265;0;755;2;1;
/org.eclipse.ant.ui/Ant Editor/org/eclipse/ant/ui/internal/editor/AntCompletionProposal.java;1;0;3;1;0;0;0;3;6;2;2;1294;6;6;2;1;0;3;3;1294;1;1811;2;1;
/org.eclipse.jdt.core.tests.model/workspace/Converter/test0289/Test.java;1;0;1;1;0;0;0;1;0;0;1;3714;0;0;1;0;0;1;1;3714;0;3714;1;1;
/org.eclipse.update.ui/src/org/eclipse/update/internal/ui/search/MyComputerSearchDialog.java;1;0;1;1;0;0;0;1;0;0;1;824;0;0;1;0;0;1;1;824;0;824;1;1;
/org.eclipse.jdt.core.tests.compiler/src/org/eclipse/jdt/core/tests/compiler/parser/ExplicitConstructorInvocationCompletionTest.java;2;0;2;1;0;0;0;2;8;1;2;991;10;10;1;0;0;2;2;991;0;3560;2;2;
/org.eclipse.ui.editors/src/org/eclipse/ui/internal/editors/text/JavaFileEditorInput.java;2;0;3;1;1;1;1;2;22;1;2;2224;44;44;1;0;0;2;3;2224;0;6340;3;2;
/org.eclipse.jdt.ui.tests.refactoring/resources/RenameNonPrivateField/test0/in/A.java;1;0;1;1;0;0;0;1;15;0;1;4560;15;15;1;0;0;1;1;4560;0;4560;1;1;
/org.eclipse.jdt.core.tests.model/workspace/Formatter/test173/A_in.java;1;0;1;1;0;0;0;1;0;0;1;2425;0;0;1;0;0;1;1;2425;0;2425;1;1;
/org.eclipse.ui.workbench/Eclipse UI/org/eclipse/ui/internal/themes/IHierarchalThemeElementDefinition.java;1;0;1;1;0;0;0;1;0;0;1;4392;0;0;1;0;0;1;1;4392;0;4392;1;1;
/org.eclipse.jdt.core.tests.model/src/org/eclipse/jdt/core/tests/model/ClassNameTests.java;1;0;2;1;0;0;0;2;2;1;2;1907;4;4;1;0;0;2;2;1907;0;3560;2;1;
/org.eclipse.team.tests.cvs.core/src/org/eclipse/team/tests/ccvs/core/TestsUserAuthenticator.java;1;0;3;1;1;1;1;2;7;1;2;3113;9;9;1;0;0;2;3;3113;0;6337;3;1;
/org.eclipse.jdt.ui.tests.refactoring/resources/RenamePackage/testImportFromMultiRoots7/out/srcPrj.ref/pack/Referer.java;1;0;1;1;0;0;0;1;0;0;1;4105;0;0;1;0;0;1;1;4105;0;4105;1;1;
/org.eclipse.jdt.ui/core refactoring/org/eclipse/ltk/core/refactoring/participants/ExtensionManagers.java;1;0;3;1;0;0;0;3;92;1;3;4624;92;92;1;0;0;3;3;4624;0;4688;3;1;
/org.eclipse.search/new search/org/eclipse/search2/internal/ui/basic/views/SortByAction.java;1;0;2;1;0;0;0;2;0;1;2;3474;0;0;1;0;0;2;2;3474;0;3711;2;1;
/org.eclipse.jdt.core.tests.model/workspace/Formatter/test027/A_in.java;1;0;1;1;0;0;0;1;0;0;1;2425;0;0;1;0;0;1;1;2425;0;2425;1;1;
/org.eclipse.jdt.ui.examples.javafamily/src/org/eclipse/jdt/internal/ui/search2/SearchViewAdapter.java;1;0;2;1;0;0;0;2;8;1;2;1033;8;8;1;0;0;2;2;1033;0;2344;2;1;
/org.eclipse.jdt.ui/ui/org/eclipse/jdt/internal/ui/preferences/WorkInProgressPreferencePage.java;6;2;36;2;5;4;5;31;669;2;27;500;2399;2399;2;4;1;31;36;1113;5;5531;31;6;
/org.eclipse.jdt.ui/ui/org/eclipse/jdt/internal/ui/text/java/hover/JavaHoverMessages.java;1;0;2;1;1;1;1;1;55;0;1;3689;57;57;1;0;0;1;2;3689;0;6340;2;1;
/org.eclipse.team.cvs.core/src/org/eclipse/team/internal/ccvs/core/client/Tag.java;1;0;3;1;0;0;0;3;4;1;3;994;8;8;1;0;0;3;3;994;0;1843;3;1;
/org.eclipse.team.ui/src/org/eclipse/team/internal/ui/synchronize/sets/SyncSetChangedEvent.java;1;0;3;1;0;0;0;3;131;1;3;2535;131;131;1;0;0;3;3;2535;0;4216;3;1;
/org.eclipse.ui.workbench/Eclipse UI/org/eclipse/ui/internal/commands/api/ICommandListener.java;1;0;2;1;0;0;0;2;2;0;1;2562;2;2;2;1;0;2;2;2562;1;2562;1;1;
/org.eclipse.jdt.core.tests.model/workspace/Completion/src/z1/z2/qla2.java;1;0;1;1;0;0;0;1;0;0;1;3253;0;0;1;0;0;1;1;3253;0;3253;1;1;
/org.eclipse.pde.ui/src_Forms/org/eclipse/pde/internal/ui/neweditor/plugin/BuildInputContext.java;1;0;5;1;0;0;0;5;30;1;5;3777;36;36;1;0;0;5;5;3777;0;4354;5;1;
/org.eclipse.swt.tests/JUnit Tests/org/eclipse/swt/tests/junit/Test_org_eclipse_swt_browser_LocationAdapter.java;1;0;2;1;0;0;0;2;15;0;1;2862;15;15;2;1;0;2;2;2862;1;2862;1;1;
/org.eclipse.jdt.core.tests.model/workspace/Converter/test0281/Test.java;1;0;1;1;0;0;0;1;0;0;1;3714;0;0;1;0;0;1;1;3714;0;3714;1;1;
/org.eclipse.jdt.ui.tests.refactoring/resources/InlineMethodWorkspace/TestCases/receiver_out/TestThisExpression.java;1;0;1;1;0;0;0;1;4;0;1;845;4;4;1;0;0;1;1;845;0;845;1;1;
/org.eclipse.jdt.core.tests.model/workspace/Converter/junit/extensions/TestDecorator.java;1;0;2;1;0;0;0;2;4;1;2;787;4;4;1;0;0;2;2;787;0;3714;2;1;
/org.eclipse.core.tests.runtime/src/org/eclipse/core/tests/internal/plugins/RegressionResolveTest_6.java;1;0;1;1;0;0;0;1;0;0;1;3014;0;0;1;0;0;1;1;3014;0;3014;1;1;
/org.eclipse.jface.text/src/org/eclipse/jface/text/source/AnnotationColumn.java;2;1;2;1;2;2;2;0;2;0;0;6340;4;4;1;0;0;0;2;6340;0;6361;2;2;
/org.eclipse.ui.externaltools/Ant Editor/org/eclipse/ui/externaltools/internal/ant/dtd/IAtom.java;1;0;1;1;0;0;0;1;0;0;1;282;0;0;1;0;0;1;1;282;0;282;1;1;
/org.eclipse.ui.workbench/Eclipse UI/org/eclipse/ui/internal/csm/activities/AbstractMutableActivityRegistry.java;1;0;2;1;0;0;0;2;0;1;2;2225;0;0;1;0;0;2;2;2225;0;2310;2;1;
/org.eclipse.debug.core/core/org/eclipse/debug/internal/core/sourcelookup/containers/ExternalArchiveSourceContainerType.java;2;0;5;1;1;1;1;4;20;3;2;4652;25;25;3;2;0;4;5;4949;2;5672;3;2;
/org.eclipse.debug.ui/ui/org/eclipse/debug/ui/EnvironmentVariableContentProvider.java;1;0;2;1;0;0;0;2;0;1;2;265;0;0;1;0;0;2;2;265;0;278;2;1;
/org.eclipse.jdt.ui/core extension/org/eclipse/jdt/internal/corext/textmanipulation/TreeIterationInfo.java;1;0;2;1;0;0;0;2;0;0;1;1946;0;0;2;1;0;2;2;1946;1;1946;1;1;
/org.eclipse.update.core/src/org/eclipse/update/internal/standalone/UninstallCommand.java;1;0;6;1;0;0;0;6;19;2;5;1793;26;26;2;1;0;6;6;4585;1;4928;5;1;
/org.eclipse.team.cvs.ui/src/org/eclipse/team/internal/ccvs/ui/operations/ICVSRunnableContext.java;2;0;3;1;0;0;0;3;1;1;3;1840;1;1;1;0;0;3;3;1840;0;4216;3;2;
/org.eclipse.team.ui/src/org/eclipse/team/ui/synchronize/TeamSubscriberOverviewComposite.java;1;0;1;1;0;0;0;1;0;0;1;3200;0;0;1;0;0;1;1;3200;0;3200;1;1;
/org.eclipse.jdt.ui/core refactoring/org/eclipse/ltk/core/refactoring/participants/DeleteProcessor.java;1;0;5;1;0;0;0;5;12;1;5;4624;22;22;1;0;0;5;5;4624;0;4864;5;1;
/org.eclipse.ui.workbench/Eclipse UI/org/eclipse/ui/actions/SelectionListenerAction.java;1;0;1;1;0;0;0;1;0;0;1;2737;0;0;1;0;0;1;1;2737;0;2737;1;1;
/org.eclipse.jdt.ui/core extension/org/eclipse/jdt/internal/corext/dom/fragments/ASTFragmentFactory.java;3;0;4;1;1;1;1;3;21;1;3;1309;30;30;1;0;0;3;4;1309;0;6340;4;3;
/org.eclipse.ui.workbench/Eclipse UI/org/eclipse/ui/internal/dialogs/UpdateProjectCapabilityWizard.java;1;0;1;1;0;0;0;1;0;0;1;2737;0;0;1;0;0;1;1;2737;0;2737;1;1;
/org.eclipse.ui.workbench/Eclipse UI/org/eclipse/ui/internal/csm/activities/IActivityRegistryListener.java;1;0;3;1;0;0;0;3;18;1;3;2225;18;18;1;0;0;3;3;2225;0;2444;3;1;
/org.eclipse.ant.ui/Ant Editor/org/eclipse/ant/internal/ui/dtd/schema/NfmParser.java;1;0;1;1;0;0;0;1;0;0;1;1811;0;0;1;0;0;1;1;1811;0;1811;1;1;
/org.eclipse.team.examples.filesystem/src/org/eclipse/team/examples/filesystem/ui/FileSystemMainPage.java;1;0;1;1;0;0;0;1;6;0;1;1708;6;6;1;0;0;1;1;1708;0;1708;1;1;
/org.eclipse.jdt.ui/core extension/org/eclipse/jdt/internal/corext/template/Templates.java;2;0;2;1;0;0;0;2;4;1;2;664;4;4;1;0;0;2;2;664;0;4258;2;2;
/org.eclipse.jdt.ui.examples.javafamily/src/org/eclipse/jsp/launching/TomcatSourceLookupTab.java;1;0;2;1;0;0;0;2;0;1;2;1387;0;0;1;0;0;2;2;1387;0;5091;2;1;
/org.eclipse.jdt.ui/ui refactoring/org/eclipse/jdt/internal/ui/refactoring/code/InlineMethodInputPage.java;2;0;5;1;1;1;1;4;8;1;4;4575;22;22;1;0;0;4;5;4575;0;6340;5;2;
/org.eclipse.jdt.ui.tests.refactoring/test cases/org/eclipse/jdt/ui/tests/refactoring/ConvertAnonymousToNestedTests.java;5;0;15;1;1;1;1;14;32;1;14;130;155;155;1;0;0;14;15;130;0;6340;15;5;
/org.eclipse.ui.workbench/Eclipse UI/org/eclipse/ui/internal/dialogs/LinkedResourcesPreferencePage.java;1;0;1;1;0;0;0;1;0;0;1;2737;0;0;1;0;0;1;1;2737;0;2737;1;1;
/org.eclipse.jdt.ui/ui/org/eclipse/jdt/internal/ui/compare/JavaStructureDiffViewerCreator.java;1;0;1;1;1;1;1;0;2;0;0;6340;2;2;1;0;0;0;1;6340;0;6340;1;1;
/org.eclipse.ltk.ui.refactoring/src/org/eclipse/ltk/internal/ui/refactoring/ChangeElement.java;1;1;5;1;2;2;2;3;9;1;3;4965;17;17;1;0;0;3;5;4965;0;6340;5;1;
/org.eclipse.update.core/src/org/eclipse/update/configuration/ILocalSite.java;2;0;3;1;1;1;1;2;4;1;2;890;9;9;1;0;0;2;3;890;0;6336;3;2;
/org.eclipse.jdt.debug/eval/org/eclipse/jdt/debug/eval/IAstEvaluationEngine.java;2;0;2;2;2;1;2;0;6;0;0;6335;6;6;2;0;1;0;2;6335;1;6335;1;2;
/org.eclipse.jdt.ui/core extension/org/eclipse/jdt/internal/corext/template/java/JavaContextType.java;4;1;8;1;2;2;2;6;99;1;6;3090;241;241;1;0;0;6;8;3090;0;6340;8;4;
/org.eclipse.core.tests.runtime/src/org/eclipse/core/tests/internal/plugins/BadPluginsTest.java;2;0;2;1;0;0;0;2;68;1;2;2444;68;68;1;0;0;2;2;2444;0;3014;2;2;
/org.eclipse.jdt.core.tests.model/workspace/Completion/src3/test0019/Test.java;1;0;1;1;1;1;1;0;0;0;0;5181;0;0;1;0;0;0;1;5181;0;5181;1;1;
/org.eclipse.team.core/src/org/eclipse/team/internal/core/subscribers/ThreeWayBaseTree.java;2;0;2;1;1;1;1;1;2;0;1;4349;2;2;1;0;0;1;2;4349;0;6336;2;2;
/org.eclipse.core.tests.resources/src/org/eclipse/core/tests/resources/ChangingListenerTest.java;1;0;1;1;0;0;0;1;0;0;1;1334;0;0;1;0;0;1;1;1334;0;1334;1;1;
/org.eclipse.debug.core/core/org/eclipse/debug/internal/core/LogicalStructureType.java;1;0;4;1;0;0;0;4;25;2;2;2647;34;34;2;2;0;4;4;2647;2;2661;2;1;
/org.eclipse.swt.tests/JUnit Tests/org/eclipse/swt/tests/junit/Test_org_eclipse_swt_widgets_TabFolder.java;3;0;4;1;1;1;1;3;78;1;3;2123;94;94;1;0;0;3;4;2123;0;6352;4;3;
/org.eclipse.swt.opengl/gtk/org/eclipse/swt/opengl/GLContext.java;1;0;3;1;0;0;0;3;147;1;3;1175;147;147;1;0;0;3;3;1175;0;2143;3;1;
/org.eclipse.ui.tests/Eclipse UI Tests/org/eclipse/ui/tests/dialogs/DeprecatedUIDialogs.java;1;0;1;1;0;0;0;1;9;0;1;2738;9;9;1;0;0;1;1;2738;0;2738;1;1;
/org.eclipse.ui.workbench.texteditor/src/org/eclipse/ui/texteditor/IDocumentProviderExtension.java;2;0;2;2;2;1;2;0;4;0;0;6334;4;4;2;0;1;0;2;6334;1;6334;1;2;
/org.eclipse.jdt.core/compiler/org/eclipse/jdt/internal/compiler/ast/MethodDeclaration.java;1;0;9;1;0;0;0;9;15;2;8;13;53;53;2;1;0;9;9;1088;1;3557;8;1;
/org.eclipse.ui.ide/src/org/eclipse/ui/internal/ide/model/WorkbenchAdapter.java;1;0;2;1;0;0;0;2;0;1;2;2264;0;0;1;0;0;2;2;2264;0;2616;2;1;
/org.eclipse.text/src/org/eclipse/text/edits/EditDocument.java;2;0;2;1;1;1;1;1;2;0;1;2113;2;2;1;0;0;1;2;2113;0;6340;2;2;
/org.eclipse.jdt.ui/ui/org/eclipse/jdt/internal/ui/text/correction/SimilarElementsRequestor.java;2;1;4;1;2;2;2;2;44;1;2;3168;61;61;1;0;0;2;4;3168;0;6340;4;2;
/org.eclipse.jdt.ui/ui/org/eclipse/jdt/internal/ui/callhierarchy/CancelSearchAction.java;2;0;2;1;1;1;1;1;2;0;1;4492;2;2;1;0;0;1;2;4492;0;6340;2;2;
/org.eclipse.jdt.ui/ui/org/eclipse/jdt/internal/ui/search/JavaSearchSorter.java;3;1;4;1;3;3;3;1;9;0;1;3251;12;12;1;0;0;1;4;3251;0;6340;4;3;
/org.eclipse.ui.forms/src/org/eclipse/ui/internal/forms/WizardForm.java;1;0;1;1;0;0;0;1;0;0;1;5044;0;0;1;0;0;1;1;5044;0;5044;1;1;
/org.eclipse.jdt.core.tests.model/workspace/Formatter/test395/A_in.java;1;0;1;1;0;0;0;1;0;0;1;3435;0;0;1;0;0;1;1;3435;0;3435;1;1;
/org.eclipse.jdt.core.tests.model/workspace/Resolve/src/ResolveLocalClass6.java;1;0;1;1;0;0;0;1;0;0;1;1968;0;0;1;0;0;1;1;1968;0;1968;1;1;
/org.eclipse.search/search/org/eclipse/search/internal/ui/ShowSearchAction.java;1;0;1;1;1;1;1;0;2;0;0;6340;2;2;1;0;0;0;1;6340;0;6340;1;1;
/org.eclipse.team.ui/src/org/eclipse/team/internal/ui/synchronize/ParticipantOverviewComposite.java;1;0;1;1;0;0;0;1;0;0;1;3468;0;0;1;0;0;1;1;3468;0;3468;1;1;
/org.eclipse.core.resources/src/org/eclipse/core/internal/resources/Rules.java;2;1;13;1;5;5;5;8;201;2;7;2589;396;396;2;1;0;8;13;3633;1;6206;12;2;
/org.eclipse.jdt.core.tests.model/workspace/Formatter/test220/A_out.java;1;0;1;1;0;0;0;1;0;0;1;2426;0;0;1;0;0;1;1;2426;0;2426;1;1;
/org.eclipse.pde.ui/src/org/eclipse/pde/internal/ui/search/PluginSearchPage.java;2;1;5;1;2;2;2;3;38;1;3;1525;59;59;1;0;0;3;5;1525;0;6336;5;2;
/org.eclipse.ui.views/src/org/eclipse/ui/views/internal/markers/tasks/TaskViewConstants.java;1;0;2;1;0;0;0;2;0;1;2;265;0;0;1;0;0;2;2;265;0;728;2;1;
/org.eclipse.swt/Eclipse SWT Drag and Drop/emulated/org/eclipse/swt/dnd/DropTarget.java;1;0;1;1;0;0;0;1;4;0;1;0;4;4;1;0;0;1;1;0;0;0;1;1;
/org.eclipse.debug.ui/ui/org/eclipse/debug/internal/ui/views/breakpoints/BreakpointsView.java;5;1;19;2;5;5;5;14;116;4;10;1581;390;390;4;4;0;14;19;1591;4;6336;15;5;
/org.eclipse.jdt.core/compiler/org/eclipse/jdt/internal/compiler/ast/SingleTypeReference.java;3;0;4;2;0;0;0;4;103;1;4;13;115;115;1;0;0;4;4;13;0;3560;4;3;
/org.eclipse.core.tests.runtime/src/org/eclipse/core/tests/internal/plugins/ConflictResolveTest_7.java;1;0;1;1;0;0;0;1;0;0;1;3014;0;0;1;0;0;1;1;3014;0;3014;1;1;
/org.eclipse.jdt.core.tests.model/workspace/Converter/src/test0243/Test.java;1;0;1;1;0;0;0;1;0;0;1;3714;0;0;1;0;0;1;1;3714;0;3714;1;1;
/org.eclipse.core.resources/src/org/eclipse/core/resources/IResourceChangeEvent.java;2;2;6;1;4;3;4;2;117;1;2;2989;219;219;2;0;1;2;6;5463;1;5463;5;2;
/org.eclipse.swt.tests/JUnit Tests/org/eclipse/swt/tests/junit/Test_org_eclipse_swt_events_TypedEvent.java;1;0;3;1;1;1;1;2;33;0;1;3443;37;37;2;1;0;2;3;3443;1;6352;2;1;
/org.eclipse.ui.workbench/Eclipse UI/org/eclipse/ui/commands/internal/AbstractMutableRegistry.java;1;0;2;1;0;0;0;2;0;1;2;786;0;0;1;0;0;2;2;786;0;956;2;1;
/org.eclipse.ui.ide/src/org/eclipse/ui/actions/CopyFilesAndFoldersOperation.java;2;0;4;1;0;0;0;4;82;1;4;1511;84;84;1;0;0;4;4;1511;0;2263;4;2;
/org.eclipse.jdt.ui.tests.refactoring/resources/SefWorkSpace/SefTests/object_out/TestFinalField.java;1;0;1;1;0;0;0;1;1;0;1;1492;1;1;1;0;0;1;1;1492;0;1492;1;1;
/org.eclipse.jdt.ui.tests.refactoring/resources/ExtractMethodWorkSpace/ExtractMethodTests/locals_in/A_test555.java;1;0;1;1;0;0;0;1;2;0;1;844;2;2;1;0;0;1;1;844;0;844;1;1;
/org.eclipse.jdt.core.tests.model/workspace/Formatter/test233/A_in.java;1;0;1;1;0;0;0;1;0;0;1;2437;0;0;1;0;0;1;1;2437;0;2437;1;1;
/org.eclipse.swt.tests/JUnit Tests/org/eclipse/swt/tests/junit/Test_org_eclipse_swt_events_ControlListener.java;1;0;1;1;0;0;0;1;16;0;1;2175;16;16;1;0;0;1;1;2175;0;2175;1;1;
/org.eclipse.ui.workbench/Eclipse UI/org/eclipse/ui/internal/progress/ProgressTableContentProvider.java;1;0;10;1;0;0;0;10;118;2;9;3560;388;388;2;1;0;10;10;4127;1;4262;9;1;
/org.eclipse.jdt.ui/core refactoring/org/eclipse/jdt/internal/corext/refactoring/nls/changes/CreateTextFileChange.java;3;1;4;1;3;3;3;1;14;0;1;1033;23;23;1;0;0;1;4;1033;0;6340;4;3;
/org.eclipse.jdt.core/search/org/eclipse/jdt/internal/core/search/matching/OrPathCombiner.java;1;0;1;1;0;0;0;1;0;0;1;2837;0;0;1;0;0;1;1;2837;0;2837;1;1;
/org.eclipse.ant.ui/Ant Editor/org/eclipse/ant/internal/ui/dtd/schema/Schema.java;1;0;2;1;0;0;0;2;6;1;2;1811;6;6;1;0;0;2;2;1811;0;3615;2;1;
/org.eclipse.ui.views/src/org/eclipse/ui/views/navigator/ResourceNavigatorRenameAction.java;1;0;1;1;0;0;0;1;0;0;1;2738;0;0;1;0;0;1;1;2738;0;2738;1;1;
/org.eclipse.ui.workbench/Eclipse UI/org/eclipse/ui/internal/dialogs/BuildOrderPreferencePage.java;1;0;1;1;0;0;0;1;0;0;1;2737;0;0;1;0;0;1;1;2737;0;2737;1;1;
/org.eclipse.jdt.core.tests.model/src/org/eclipse/jdt/core/tests/model/TestPessimisticProvider.java;2;0;3;1;0;0;0;3;6;1;3;1167;8;8;1;0;0;3;3;1167;0;3560;3;2;
/org.eclipse.core.tests.runtime/src/org/eclipse/core/tests/plugintests/ApiTest.java;1;0;1;1;0;0;0;1;0;0;1;3014;0;0;1;0;0;1;1;3014;0;3014;1;1;
/org.eclipse.jdt.junit/src/org/eclipse/jdt/internal/junit/util/PixelConverter.java;2;1;2;1;2;2;2;0;8;0;0;5112;10;10;1;0;0;0;2;5112;0;6340;2;2;
/org.eclipse.ui.examples.rcp.browser/src/org/eclipse/ui/examples/rcp/browser/BrowserActionBuilder.java;1;1;6;1;2;2;2;4;53;1;4;3532;109;109;1;0;0;4;6;3532;0;6169;6;1;
/org.eclipse.core.tests.resources/src/org/eclipse/core/tests/internal/watson/ElementTreeSerializationTest.java;2;2;4;1;3;2;3;1;380;0;1;78;384;384;2;0;1;1;4;5147;1;5408;3;2;
/org.eclipse.swt/Eclipse SWT/win32/org/eclipse/swt/widgets/Button.java;4;0;8;1;0;0;0;8;12;2;7;44;34;34;2;1;0;8;8;1313;1;3354;7;4;
/org.eclipse.jdt.ui.tests.refactoring/resources/IntroduceFactory/Bugzilla/46373/ImplicitCtor_out.java;1;0;2;1;1;1;1;1;2;0;1;2846;2;2;1;0;0;1;2;2846;0;5659;2;1;
/org.eclipse.swt/Eclipse SWT Custom Widgets/common/org/eclipse/swt/custom/PrintRenderer.java;3;0;5;1;1;1;1;4;77;2;3;1930;85;85;2;1;0;4;5;4612;1;6352;4;3;
/org.eclipse.jdt.ui/ui/org/eclipse/jdt/internal/ui/text/HTML2TextReader.java;3;1;4;1;2;2;2;2;5;1;2;143;11;11;1;0;0;2;4;143;0;6340;4;3;
/org.eclipse.swt/Eclipse SWT PI/win32/org/eclipse/swt/internal/win32/SHRGINFO.java;1;0;1;1;0;0;0;1;2;0;1;2915;2;2;1;0;0;1;1;2915;0;2915;1;1;
/org.eclipse.jdt.core.tests.model/workspace/Formatter/test037/A_out.java;1;0;1;1;0;0;0;1;0;0;1;2425;0;0;1;0;0;1;1;2425;0;2425;1;1;
/org.eclipse.ui.workbench/Eclipse UI/org/eclipse/ui/internal/ViewFactory.java;6;1;17;1;11;11;11;6;637;1;6;3146;1110;1110;1;0;0;6;17;3146;0;6338;17;6;
/org.eclipse.jdt.core/search/org/eclipse/jdt/internal/core/search/IIndexSearchRequestor.java;1;0;1;1;0;0;0;1;0;0;1;3384;0;0;1;0;0;1;1;3384;0;3384;1;1;
/org.eclipse.jdt.debug/jdi/org/eclipse/jdi/internal/SourceDebugExtensionParser.java;3;0;5;1;0;0;0;5;62;1;5;566;71;71;1;0;0;5;5;566;0;1240;5;3;
/org.eclipse.help.ide/src/org/eclipse/help/ui/internal/search/HelpSearchSorter.java;1;0;4;1;1;1;1;3;41;1;3;1738;47;47;1;0;0;3;4;1738;0;5216;4;1;
/org.eclipse.swt.opengl.examples/src/org/eclipse/swt/opengl/examples/GradientTab.java;1;0;1;1;0;0;0;1;0;0;1;1175;0;0;1;0;0;1;1;1175;0;1175;1;1;
/org.eclipse.jdt.core.tests.model/workspace/Formatter/test298/A_out.java;1;0;1;1;0;0;0;1;0;0;1;2444;0;0;1;0;0;1;1;2444;0;2444;1;1;
/org.eclipse.osgi/resolver/src/org/eclipse/core/internal/dependencies/Dependency.java;4;1;5;1;4;4;4;1;27;0;1;3013;56;56;1;0;0;1;5;3013;0;6337;5;4;
/org.eclipse.jface/src/org/eclipse/jface/preference/FileFieldEditor.java;2;1;2;1;2;2;2;0;5;0;0;5463;7;7;1;0;0;0;2;5463;0;6338;2;2;
/org.eclipse.jdt.ui/core refactoring/org/eclipse/jdt/internal/corext/refactoring/structure/InstanceMethodMover.java;5;1;36;1;3;3;3;33;213;2;30;218;685;685;2;3;0;33;36;1570;3;6340;33;5;
/org.eclipse.ui.workbench/Eclipse UI/org/eclipse/ui/wizards/datatransfer/FileSystemExportWizard.java;1;0;1;1;0;0;0;1;0;0;1;2737;0;0;1;0;0;1;1;2737;0;2737;1;1;
/org.eclipse.jdt.core.tests.model/workspace/JavaSearch/src/j3/Y.java;1;0;1;1;0;0;0;1;0;0;1;3129;0;0;1;0;0;1;1;3129;0;3129;1;1;
/org.eclipse.jface.text/src/org/eclipse/jface/text/contentassist/ComboContentAssistSubjectAdapter.java;1;0;6;1;2;1;2;4;19;1;4;3672;48;48;2;0;1;4;6;5177;1;5177;5;1;
/org.eclipse.jdt.ui/ui/org/eclipse/jdt/internal/ui/wizards/dialogfields/TreeListDialogField.java;3;1;4;1;2;2;2;2;27;1;2;1446;42;42;1;0;0;2;4;1446;0;6340;4;3;
/org.eclipse.jface/src/org/eclipse/jface/action/IStatusLineWithProgressManager.java;1;0;2;1;0;0;0;2;0;1;2;2119;0;0;1;0;0;2;2;2119;0;4563;2;1;
/org.eclipse.jdt.core.tests.model/workspace/Converter/test0521/A.java;2;0;2;1;0;0;0;2;0;1;2;3626;0;0;1;0;0;2;2;3626;0;3714;2;2;
/org.eclipse.swt/Eclipse SWT Custom Widgets/common/org/eclipse/swt/custom/ViewForm2.java;1;0;5;1;0;0;0;5;367;1;5;3518;483;483;1;0;0;5;5;3518;0;4232;5;1;
/org.eclipse.jdt.core.tests.model/workspace/Formatter/test004/A_out.java;1;0;1;1;0;0;0;1;0;0;1;2425;0;0;1;0;0;1;1;2425;0;2425;1;1;
/org.eclipse.osgi.tests/src/org/eclipse/osgi/tests/AllTests.java;1;0;2;1;0;0;0;2;0;0;1;5062;0;0;2;1;0;2;2;5062;1;5062;1;1;
/org.eclipse.ui.workbench/Eclipse UI/org/eclipse/ui/commands/internal/SimpleContextService.java;1;0;3;1;0;0;0;3;1;1;3;772;1;1;1;0;0;3;3;772;0;956;3;1;
/org.eclipse.jdt.ui/ui/org/eclipse/jdt/internal/ui/compare/JavaCompareWithEditionAction.java;2;0;3;1;1;1;1;2;22;1;2;1730;32;32;1;0;0;2;3;1730;0;6340;3;2;
/org.eclipse.jdt.core.tests.model/workspace/Converter/junit/framework/TestResult.java;1;0;2;1;0;0;0;2;23;1;2;787;23;23;1;0;0;2;2;787;0;3714;2;1;
/org.eclipse.jdt.ui.tests.refactoring/resources/ChangeTypeRefactoring/positive/A_testFieldDecl_in.java;1;0;1;1;0;0;0;1;0;0;1;2844;0;0;1;0;0;1;1;2844;0;2844;1;1;
/org.eclipse.jdt.ui.tests.refactoring/resources/ExtractMethodWorkSpace/ExtractMethodTests/locals_out/A_test523.java;1;0;2;1;0;0;0;2;6;1;2;130;10;10;1;0;0;2;2;130;0;844;2;1;
/org.eclipse.jdt.core/compiler/org/eclipse/jdt/internal/compiler/ast/SwitchStatement.java;3;0;17;2;2;1;2;15;389;2;14;148;591;591;2;1;1;15;17;4061;2;5339;15;3;
/org.eclipse.ui.workbench/Eclipse UI/org/eclipse/ui/keys/NativeKeyFormatter.java;2;0;4;1;0;0;0;4;6;1;4;3169;9;9;1;0;0;4;4;3169;0;3310;4;2;
/org.eclipse.ui.ide/src/org/eclipse/ui/internal/ide/model/WorkbenchResource.java;5;1;8;1;4;4;4;4;180;1;4;2264;513;513;1;0;0;4;8;2264;0;6338;8;5;
/org.eclipse.team.cvs.core/src/org/eclipse/team/internal/ccvs/core/resources/RemoteFolderSandbox.java;1;0;1;1;0;0;0;1;0;0;1;3276;0;0;1;0;0;1;1;3276;0;3276;1;1;
/org.eclipse.ltk.core.refactoring/src/org/eclipse/ltk/core/refactoring/RefactoringStatus.java;1;1;6;1;4;4;4;2;23;1;2;4845;58;58;1;0;0;2;6;4845;0;6338;6;1;
/org.eclipse.team.core/src/org/eclipse/team/core/subscribers/RefreshSubscriberJob.java;1;0;4;1;0;0;0;4;27;1;4;1015;34;34;1;0;0;4;4;1015;0;1117;4;1;
/org.eclipse.jdt.ui/ui refactoring/org/eclipse/jdt/internal/ui/refactoring/reorg/RenameSourceFolderWizard.java;2;0;4;1;1;1;1;3;10;2;2;1125;19;19;2;1;0;3;4;1125;1;6340;3;2;
/org.eclipse.core.runtime/src/org/eclipse/core/internal/runtime/Product.java;2;1;10;1;4;4;4;6;30;1;6;3680;123;123;1;0;0;6;10;3680;0;5917;10;2;
/org.eclipse.jdt.debug.ui/ui/org/eclipse/jdt/debug/ui/launchConfigurations/AppletMainTab.java;5;1;14;1;2;2;2;12;126;2;11;1240;349;349;2;1;0;12;14;4447;1;6336;13;5;
/org.eclipse.swt/Eclipse SWT/photon/org/eclipse/swt/graphics/Font.java;1;0;1;1;0;0;0;1;4;0;1;2309;4;4;1;0;0;1;1;2309;0;2309;1;1;
/org.eclipse.ant.ui/Ant Editor/org/eclipse/ant/internal/ui/editor/text/AntStorageDocumentProvider.java;1;0;2;1;1;1;1;1;13;0;1;5047;13;13;1;0;0;1;2;5047;0;6028;2;1;
/org.eclipse.team.examples.filesystem/src/org/eclipse/team/examples/localhistory/LocalHistoryVariant.java;1;1;2;1;2;2;2;0;2;0;0;6305;2;2;1;0;0;0;2;6305;0;6337;2;1;
/org.eclipse.ui.workbench/Eclipse UI/org/eclipse/ui/actions/RetargetAction.java;4;0;5;2;2;1;2;3;23;1;3;1527;63;63;2;0;1;3;5;6338;1;6338;4;4;
/org.eclipse.update.core/src/org/eclipse/update/internal/core/ConfigurationActivity.java;2;0;4;1;1;1;1;3;46;1;3;890;71;71;1;0;0;3;4;890;0;6336;4;2;
/org.eclipse.jdt.core.tests.model/src/org/eclipse/jdt/core/tests/model/ClasspathTests.java;4;1;46;2;7;7;7;39;404;4;29;100;1562;1562;4;10;0;39;46;100;10;6217;36;4;
/org.eclipse.osgi/eclipseAdaptor/src/org/eclipse/osgi/service/datalocation/Location.java;2;1;8;1;2;2;2;6;50;2;5;4113;119;119;2;1;0;6;8;4113;1;5193;7;2;
/org.eclipse.swt/Eclipse SWT PI/carbon/org/eclipse/swt/internal/carbon/DataBrowserListViewColumnDesc.java;1;2;3;1;3;2;3;0;16;0;0;5534;20;20;2;0;1;0;3;5534;1;5614;2;1;
/org.eclipse.jdt.ui/ui/org/eclipse/jdt/internal/ui/text/comment/JavaDocLine.java;2;0;7;1;1;1;1;6;266;1;6;1589;441;441;1;0;0;6;7;1589;0;6340;7;2;
/org.eclipse.ui.forms/src/org/eclipse/ui/forms/widgets/TreeNode.java;1;1;7;1;2;2;2;5;22;1;5;4068;44;44;1;0;0;5;7;4068;0;6336;7;1;
/org.eclipse.ui.workbench/Eclipse UI/org/eclipse/ui/internal/commands/registry/old/RegistryEvent.java;1;0;3;1;0;0;0;3;6;1;3;1222;6;6;1;0;0;3;3;1222;0;1322;3;1;
/org.eclipse.pde.ui/templates/helloWorld/java/$className$.java;1;0;1;1;0;0;0;1;10;0;1;851;10;10;1;0;0;1;1;851;0;851;1;1;
/org.eclipse.update.tests.core/src/org/eclipse/update/tests/branding/PrimaryFeatureTest.java;1;0;3;1;0;0;0;3;4;1;3;4613;4;4;1;0;0;3;3;4613;0;4951;3;1;
/org.eclipse.ui.workbench/Eclipse UI/org/eclipse/ui/IWorkbench.java;7;2;39;2;3;2;3;36;718;3;30;1;1488;1488;3;6;1;36;39;2800;7;6338;32;7;
/org.eclipse.text/src/org/eclipse/jface/text/Assert.java;2;2;3;1;3;2;3;0;10;0;0;5105;12;12;2;0;1;0;3;6298;1;6298;2;2;
/org.eclipse.jdt.ui.tests.refactoring/resources/MoveInnerToTopLevel/test_nonstatic_34/out/Inner.java;1;0;1;1;0;0;0;1;1;0;1;305;1;1;1;0;0;1;1;305;0;305;1;1;
/org.eclipse.swt.graphics.text/org.eclipse.swt/Eclipse SWT/emulated/bidi/org/eclipse/swt/internal/BidiUtil.java;3;0;3;1;0;0;0;3;211;1;3;2267;231;231;1;0;0;3;3;2267;0;2371;3;3;
/org.eclipse.ui.workbench/Eclipse UI/org/eclipse/ui/internal/registry/MarkerQuery.java;1;0;1;1;0;0;0;1;0;0;1;2737;0;0;1;0;0;1;1;2737;0;2737;1;1;
/org.eclipse.update.ui.forms/Eclipse Forms/org/eclipse/ui/forms/widgets/Form.java;1;0;13;1;0;0;0;13;178;2;12;3138;599;599;2;1;0;13;13;3984;1;4157;12;1;
/org.eclipse.team.cvs.ui/src/org/eclipse/team/internal/ccvs/ui/repo/CVSWorkingSetPage.java;2;0;2;1;1;1;1;1;2;0;1;2381;2;2;1;0;0;1;2;2381;0;6015;2;2;
/org.eclipse.update.ui/srcnew/org/eclipse/update/internal/ui/properties/FeatureGeneralPropertyPage.java;2;0;10;2;0;0;0;10;150;3;7;299;223;223;3;3;0;10;10;299;3;825;7;2;
/org.eclipse.osgi/eclipseAdaptor/src/org/eclipse/core/runtime/adaptor/IPluginInfo.java;3;1;8;1;4;4;4;4;16;1;4;3134;30;30;1;0;0;4;8;3134;0;6133;8;3;
/org.eclipse.jdt.junit/src/org/eclipse/jdt/internal/junit/ui/TestMethodSelectionDialog.java;3;1;4;1;3;3;3;1;52;0;1;3424;73;73;1;0;0;1;4;3424;0;6340;4;3;
/org.eclipse.jdt.core.tests.model/workspace/Formatter/test398/A_in.java;1;0;1;1;0;0;0;1;0;0;1;3436;0;0;1;0;0;1;1;3436;0;3436;1;1;
/org.eclipse.jdt.core.tests.model/workspace/Converter/test0356/A.java;1;0;1;1;0;0;0;1;0;0;1;3714;0;0;1;0;0;1;1;3714;0;3714;1;1;
/org.eclipse.pde.ui/src_Forms/org/eclipse/pde/internal/ui/neweditor/feature/FeatureEditorContributor.java;2;0;2;1;1;1;1;1;0;0;1;4926;0;0;1;0;0;1;2;4926;0;5431;2;2;
/org.eclipse.jdt.core.tests.model/workspace/Formatter/test246/A_out.java;1;0;1;1;0;0;0;1;0;0;1;2442;0;0;1;0;0;1;1;2442;0;2442;1;1;
/org.eclipse.help/src/org/eclipse/help/internal/IHelpRoleManager.java;1;0;3;1;0;0;0;3;5;1;3;2330;5;5;1;0;0;3;3;2330;0;3319;3;1;
/org.eclipse.swt/Eclipse SWT/win32/org/eclipse/swt/widgets/Slider.java;4;1;11;2;3;3;3;8;38;2;7;151;176;176;2;1;0;8;11;3169;1;6352;10;4;
/org.eclipse.team.cvs.ui/src/org/eclipse/team/internal/ccvs/ui/ResourcePropertiesPage.java;1;0;1;1;0;0;0;1;2;0;1;2381;2;2;1;0;0;1;1;2381;0;2381;1;1;
/org.eclipse.core.resources/src/org/eclipse/core/internal/localstore/CopyVisitor.java;2;0;3;1;1;1;1;2;273;1;2;93;277;277;1;0;0;2;3;93;0;5146;3;2;
/org.eclipse.ui.views/src/org/eclipse/ui/views/internal/table/TableSortDialog.java;1;0;2;1;0;0;0;2;0;0;1;749;0;0;2;1;0;2;2;749;1;749;1;1;
/org.eclipse.text/src/org/eclipse/jface/text/IDocumentPartitioningListenerExtension.java;2;1;2;1;2;2;2;0;16;0;0;5105;18;18;1;0;0;0;2;5105;0;6296;2;2;
/org.eclipse.jdt.ui/core refactoring/org/eclipse/jdt/internal/corext/refactoring/typeconstraints/ASTCreator.java;3;1;5;1;2;2;2;3;20;1;3;1557;26;26;1;0;0;3;5;1557;0;6340;5;3;
/org.eclipse.ui.internal.r21presentation/src/org/eclipse/ui/internal/r21presentation/R21PresentationPlugin.java;1;1;2;1;2;2;2;0;19;0;0;5275;19;19;1;0;0;0;2;5275;0;5381;2;1;
/org.eclipse.team.cvs.core/src/org/eclipse/team/internal/ccvs/core/syncinfo/ResourceSyncInfo.java;2;0;6;1;1;1;1;5;65;1;5;790;102;102;1;0;0;5;6;790;0;6337;6;2;
/org.eclipse.jdt.core.tests.model/workspace/Converter/test0182/Test.java;1;0;1;1;0;0;0;1;0;0;1;3714;0;0;1;0;0;1;1;3714;0;3714;1;1;
/org.eclipse.ui.workbench/Eclipse UI/org/eclipse/ui/commands/internal/Stroke.java;1;0;2;1;0;0;0;2;0;1;2;786;0;0;1;0;0;2;2;786;0;956;2;1;
/org.eclipse.jdt.ui.examples.javafamily/src/org/eclipse/jsp/JspMatchLocatorParser.java;1;0;4;1;0;0;0;4;2;1;4;1033;5;5;1;0;0;4;4;1033;0;2344;4;1;
/org.eclipse.ui.workbench/Eclipse UI/org/eclipse/ui/internal/activities/AbstractActivityService.java;1;0;2;1;0;0;0;2;0;0;1;2800;0;0;2;1;0;2;2;2800;1;2800;1;1;
/org.eclipse.jdt.ui.tests.refactoring/resources/ExtractMethodWorkSpace/ExtractMethodTests/initializer_out/A_test1001.java;1;0;1;1;0;0;0;1;0;0;1;3310;0;0;1;0;0;1;1;3310;0;3310;1;1;
/org.eclipse.jdt.core.tests.model/workspace/Formatter/test458/A_out.java;1;0;1;1;0;0;0;1;0;0;1;3861;0;0;1;0;0;1;1;3861;0;3861;1;1;
/org.eclipse.pde.ui/src/org/eclipse/pde/ui/IPluginFieldData.java;2;1;5;1;4;4;4;1;39;0;1;3986;105;105;1;0;0;1;5;3986;0;6336;5;2;
/org.eclipse.jdt.core.tests.model/workspace/Completion/src3/test0011/Test.java;1;0;1;1;1;1;1;0;0;0;0;5181;0;0;1;0;0;0;1;5181;0;5181;1;1;
/org.eclipse.core.runtime/src/org/osgi/service/prefs/BackingStoreException.java;1;0;1;1;1;1;1;0;0;0;0;5484;0;0;1;0;0;0;1;5484;0;5484;1;1;
/org.eclipse.team.ui/src/org/eclipse/team/ui/synchronize/SynchronizeViewCompareConfiguration.java;1;0;1;1;0;0;0;1;0;0;1;3749;0;0;1;0;0;1;1;3749;0;3749;1;1;
/org.eclipse.jdt.core.tests.model/workspace/Formatter/test391/A_out.java;1;0;1;1;0;0;0;1;0;0;1;3172;0;0;1;0;0;1;1;3172;0;3172;1;1;
/org.eclipse.jdt.core/codeassist/org/eclipse/jdt/internal/codeassist/complete/CompletionOnSingleTypeReference.java;2;0;2;1;0;0;0;2;10;1;2;991;12;12;1;0;0;2;2;991;0;3560;2;2;
/org.eclipse.core.runtime.compatibility/src-runtime/org/eclipse/core/runtime/IPluginListener.java;2;0;4;1;0;0;0;4;3;1;4;3013;5;5;1;0;0;4;4;3013;0;3169;4;2;
/org.eclipse.team.core/src/org/eclipse/team/internal/core/DefaultFileModificationValidator.java;2;0;3;1;1;1;1;2;13;1;2;2441;18;18;1;0;0;2;3;2441;0;6336;3;2;
/org.eclipse.jdt.ui.tests.refactoring/resources/MoveInnerToTopLevel/test_nonstatic_27/out/Inner.java;2;0;2;1;1;1;1;1;2;0;1;305;4;4;1;0;0;1;2;305;0;5854;2;2;
/org.eclipse.update.core/src/org/eclipse/update/core/INonPluginEntry.java;2;1;3;1;2;2;2;1;6;0;1;890;12;12;1;0;0;1;3;890;0;6336;3;2;
/org.eclipse.jdt.core/model/org/eclipse/jdt/internal/core/CreatePackageFragmentOperation.java;2;0;4;1;0;0;0;4;12;1;4;3034;18;18;1;0;0;4;4;3034;0;4887;4;2;
/org.eclipse.jdt.ui/ui/org/eclipse/jdt/ui/text/spelling/engine/ISpellCheckPreferenceKeys.java;1;0;2;1;0;0;0;2;0;1;2;3829;0;0;1;0;0;2;2;3829;0;3930;2;1;
/org.eclipse.ant.ui/Ant Editor/org/eclipse/ant/internal/ui/editor/templates/AntSourceViewerInformationControl.java;1;1;2;1;2;2;2;0;10;0;0;5260;10;10;1;0;0;0;2;5260;0;5901;2;1;
/org.eclipse.team.ui/src/org/eclipse/team/internal/ui/target/SyncAction.java;1;0;1;1;0;0;0;1;0;0;1;2495;0;0;1;0;0;1;1;2495;0;2495;1;1;
/org.eclipse.osgi/core/framework/org/eclipse/osgi/framework/internal/core/FilterImpl.java;3;2;5;1;5;4;5;0;337;0;0;5116;523;523;2;0;1;0;5;5116;1;6337;4;3;
/org.eclipse.swt/Eclipse SWT Mozilla/common/org/eclipse/swt/internal/mozilla/nsIDOMEvent.java;2;1;2;1;2;2;2;0;2;0;0;5271;2;2;1;0;0;0;2;5271;0;6342;2;2;
/org.eclipse.pde.ui/src/org/eclipse/pde/ui/IPluginStructureData.java;1;1;3;1;2;2;2;1;48;0;1;2786;60;60;1;0;0;1;3;2786;0;5152;3;1;
/org.eclipse.debug.ui/ui/org/eclipse/debug/internal/ui/actions/ResumeActionDelegate.java;1;1;2;1;2;2;2;0;22;0;0;5232;26;26;1;0;0;0;2;5232;0;6336;2;1;
/org.eclipse.ui.examples.javaeditor/Eclipse Java Editor Example/org/eclipse/ui/examples/javaeditor/JavaActionContributor.java;1;0;1;1;1;1;1;0;2;0;0;6340;2;2;1;0;0;0;1;6340;0;6340;1;1;
/org.eclipse.jdt.ui.tests.refactoring/resources/InlineMethodWorkspace/TestCases/simple_in/TestInitializer.java;1;0;1;1;0;0;0;1;2;0;1;845;2;2;1;0;0;1;1;845;0;845;1;1;
/org.eclipse.pde.ui/src/org/eclipse/pde/internal/ui/editor/site/FeaturesForm.java;1;0;2;1;1;1;1;1;0;0;1;3721;0;0;1;0;0;1;2;3721;0;5431;2;1;
/org.eclipse.jdt.core/model/org/eclipse/jdt/core/ICompletionRequestor.java;2;0;4;1;0;0;0;4;31;1;4;2583;73;73;1;0;0;4;4;2583;0;5063;4;2;
/org.eclipse.jdt.ui/core refactoring/org/eclipse/jdt/internal/corext/refactoring/reorg2/DeleteAction.java;2;0;5;1;0;0;0;5;38;1;5;457;45;45;1;0;0;5;5;457;0;1114;5;2;
/org.eclipse.ant.ui/Ant Tools Support/org/eclipse/ant/ui/internal/preferences/AddCustomDialog.java;1;0;7;1;0;0;0;7;58;3;5;250;117;117;3;2;0;7;7;262;2;1811;5;1;
/org.eclipse.jdt.core.tests.model/workspace/Formatter/test440/A_out.java;1;0;1;1;0;0;0;1;0;0;1;3513;0;0;1;0;0;1;1;3513;0;3513;1;1;
/org.eclipse.ui.cheatsheets/src/org/eclipse/ui/cheatsheets/events/ICheatSheetViewEvent.java;1;0;2;1;0;0;0;2;0;1;2;4428;0;0;1;0;0;2;2;4428;0;4625;2;1;
/org.eclipse.pde.ui/src/org/eclipse/pde/internal/ui/search/ShowDescriptionAction.java;3;1;8;1;3;3;3;5;34;1;5;964;115;115;1;0;0;5;8;964;0;6336;8;3;
/org.eclipse.jdt.ui/ui refactoring/org/eclipse/jdt/internal/ui/refactoring/actions/RenameInputDialog.java;1;0;1;1;0;0;0;1;0;0;1;1126;0;0;1;0;0;1;1;1126;0;1126;1;1;
/org.eclipse.jdt.debug/model/org/eclipse/jdt/internal/debug/core/model/JDIFieldVariable.java;2;0;6;1;0;0;0;6;60;2;5;2181;146;146;2;1;0;6;6;2306;1;2306;5;2;
/org.eclipse.team.tests.cvs.core/src/org/eclipse/team/tests/ccvs/ui/logformatter/PrintTextSummaryVisitor.java;1;0;1;1;0;0;0;1;0;0;1;2632;0;0;1;0;0;1;1;2632;0;2632;1;1;
/org.eclipse.jdt.ui/core refactoring/org/eclipse/jdt/internal/corext/refactoring/typeconstraints/DefinesOperator.java;1;0;3;1;0;0;0;3;2;1;3;64;2;2;1;0;0;3;3;64;0;1600;3;1;
/org.eclipse.jdt.ui/ui/org/eclipse/jdt/internal/ui/reorg/CopyResourcesToClipboardAction.java;2;0;5;1;0;0;0;5;4;2;4;147;9;9;2;1;0;5;5;487;1;1111;4;2;
/org.eclipse.update.ui/src/org/eclipse/update/internal/ui/search/ISearchObjectAdapter.java;1;0;1;1;0;0;0;1;0;0;1;824;0;0;1;0;0;1;1;824;0;824;1;1;
/org.eclipse.pde.ui/src_Forms/org/eclipse/pde/internal/ui/neweditor/schema/SchemaSpecSection.java;2;0;2;1;1;1;1;1;0;0;1;4856;0;0;1;0;0;1;2;4856;0;5431;2;2;
/org.eclipse.jdt.ui.tests.refactoring/resources/TypeConstraints/A_testNumber1.java;1;0;1;1;0;0;0;1;0;0;1;53;0;0;1;0;0;1;1;53;0;53;1;1;
/org.eclipse.jdt.core.tests.model/workspace/Converter/Test0170.java;1;0;1;1;0;0;0;1;0;0;1;3714;0;0;1;0;0;1;1;3714;0;3714;1;1;
/org.eclipse.ui.workbench/Eclipse UI/org/eclipse/ui/internal/progress/ProgressFeedbackDialog.java;1;0;4;1;1;1;1;3;4;1;3;1854;6;6;1;0;0;3;4;1854;0;5129;4;1;
/org.eclipse.jdt.core.tests.model/src/org/eclipse/jdt/core/tests/model/ResolveTests.java;5;1;30;3;4;4;4;26;1122;5;15;1059;2537;2537;5;11;0;26;30;1947;11;6222;19;5;
/org.eclipse.compare/compare/org/eclipse/compare/IContentChangeNotifier.java;1;0;1;1;0;0;0;1;2;0;1;3935;2;2;1;0;0;1;1;3935;0;3935;1;1;
/org.eclipse.core.tests.resources/src/org/eclipse/core/tests/internal/localstore/MoveTest.java;2;0;3;1;2;1;2;1;1319;0;1;2080;1322;1322;2;0;1;1;3;5147;1;5147;2;2;
/org.eclipse.jdt.core.tests.model/workspace/Converter/src/test0173/Test.java;1;0;1;1;0;0;0;1;0;0;1;3714;0;0;1;0;0;1;1;3714;0;3714;1;1;
/org.eclipse.update.ui.forms/Eclipse Forms/org/eclipse/ui/forms/parts/FormToolkit.java;1;0;4;1;0;0;0;4;13;2;3;3096;17;17;2;1;0;4;4;3137;1;3137;3;1;
/org.eclipse.ui.ide/src/org/eclipse/ui/views/bookmarkexplorer/BookmarkMessages.java;1;0;1;1;0;0;0;1;0;0;1;2208;0;0;1;0;0;1;1;2208;0;2208;1;1;
/org.eclipse.core.runtime/src/org/eclipse/core/internal/jobs/ProgressHandler.java;1;0;1;1;0;0;0;1;0;0;1;320;0;0;1;0;0;1;1;320;0;320;1;1;
/org.eclipse.jdt.ui/ui/org/eclipse/jdt/ui/actions/IntroduceParameterAction.java;3;1;7;1;3;3;3;4;36;1;4;2217;49;49;1;0;0;4;7;2217;0;6340;7;3;
/org.eclipse.debug.ui/ui/org/eclipse/debug/internal/ui/preferences/DebugActionGroupsManager.java;2;0;2;1;0;0;0;2;6;1;2;307;6;6;1;0;0;2;2;307;0;5086;2;2;
/org.eclipse.jdt.core.tests.model/workspace/Formatter/test045/A_in.java;1;0;1;1;0;0;0;1;0;0;1;2425;0;0;1;0;0;1;1;2425;0;2425;1;1;
/org.eclipse.jface.text/src/org/eclipse/jface/text/rules/RuleBasedScanner.java;1;1;3;1;2;2;2;1;2;0;1;3760;6;6;1;0;0;1;3;3760;0;6340;3;1;
/org.eclipse.jdt.core.tests.model/workspace/Formatter/test286/A_out.java;1;0;1;1;0;0;0;1;0;0;1;2443;0;0;1;0;0;1;1;2443;0;2443;1;1;
/org.eclipse.ui.ide/src/org/eclipse/ui/views/properties/IResourcePropertyConstants.java;1;0;1;1;0;0;0;1;0;0;1;2208;0;0;1;0;0;1;1;2208;0;2208;1;1;
/org.eclipse.jdt.core/model/org/eclipse/jdt/internal/core/util/CharArrayOps.java;2;0;2;2;0;0;0;2;2;0;1;85;2;2;2;1;0;2;2;85;1;85;1;2;
/org.eclipse.update.ui.forms/src/org/eclipse/ui/forms/internal/parts/HyperlinkListener.java;1;0;2;1;0;0;0;2;0;1;2;3038;0;0;1;0;0;2;2;3038;0;3071;2;1;
/org.eclipse.jdt.ui/ui/org/eclipse/jdt/ui/actions/FindDeclarationsInWorkingSetAction.java;2;1;6;1;3;3;3;3;25;1;3;1350;42;42;1;0;0;3;6;1350;0;6340;6;2;
/org.eclipse.jdt.ui.tests.refactoring/resources/Paste/testPastingTypedResources3/out/A.java;1;0;2;1;0;0;0;2;2;1;2;1646;2;2;1;0;0;2;2;1646;0;1670;2;1;
/org.eclipse.jdt.ui.tests.refactoring/resources/ExtractTemp/cannotExtract/A_testFail31.java;1;0;1;1;0;0;0;1;0;0;1;1569;0;0;1;0;0;1;1;1569;0;1569;1;1;
/org.eclipse.jdt.core/search/org/eclipse/jdt/internal/core/search/matching/FieldReferencePattern.java;3;0;5;1;0;0;0;5;27;1;5;77;41;41;1;0;0;5;5;77;0;1115;5;3;
/org.eclipse.jdt.core/compiler/org/eclipse/jdt/internal/compiler/ast/BranchStatement.java;3;0;4;1;1;1;1;3;19;1;3;148;28;28;1;0;0;3;4;148;0;5343;4;3;
/org.eclipse.jdt.ui/core refactoring/org/eclipse/jdt/internal/corext/refactoring/participants/CopyExtensionManager.java;1;0;6;1;0;0;0;6;7;1;6;1125;19;19;1;0;0;6;6;1125;0;4624;6;1;
/org.eclipse.webdav/src/client/org/eclipse/webdav/internal/authentication/ParserException.java;1;0;1;1;1;1;1;0;5;0;0;5151;5;5;1;0;0;0;1;5151;0;5151;1;1;
/org.eclipse.core.runtime/src/org/eclipse/core/internal/plugins/ConfigurationProperty.java;1;0;1;1;0;0;0;1;0;0;1;3013;0;0;1;0;0;1;1;3013;0;3013;1;1;
/org.eclipse.team.cvs.ssh/src/org/eclipse/team/internal/ccvs/ssh/Client.java;2;1;6;1;2;2;2;4;38;2;3;161;50;50;2;1;0;4;6;1541;1;6337;5;2;
/org.eclipse.pde.ui/src/org/eclipse/pde/internal/ui/feature/SiteHTMLPage.java;1;0;4;1;0;0;0;4;156;1;4;2618;167;167;1;0;0;4;4;2618;0;3840;4;1;
/org.eclipse.team.tests.cvs.core/src/org/eclipse/team/tests/ccvs/ui/unit/CheckoutOperationTests.java;2;0;7;1;0;0;0;7;73;1;7;809;140;140;1;0;0;7;7;809;0;2632;7;2;
/org.eclipse.jdt.ui.tests.refactoring/resources/MoveInnerToTopLevel/test25/out/A.java;1;0;1;1;0;0;0;1;0;0;1;1131;0;0;1;0;0;1;1;1131;0;1131;1;1;
/org.eclipse.ui.workbench/Eclipse UI/org/eclipse/ui/internal/commands/KeysPreferencePage2.java;2;1;3;1;3;3;3;0;46;0;0;5107;86;86;1;0;0;0;3;5107;0;5273;3;2;
/org.eclipse.ui.workbench/Eclipse UI/org/eclipse/ui/internal/presentations/PartTabFolderPresentation.java;5;2;16;2;8;6;8;8;124;2;7;4469;345;345;2;1;2;8;16;4469;3;5532;13;5;
/org.eclipse.team.tests.cvs.core/src/org/eclipse/team/tests/ccvs/core/subscriber/CVSWorkspaceSubscriberTest.java;2;1;34;2;4;4;4;30;1034;3;23;725;2063;2063;3;7;0;30;34;1237;7;6337;27;2;
/org.eclipse.ui.tests/Eclipse UI Tests/org/eclipse/ui/tests/adaptable/AdaptableDecoratorTestCase.java;2;0;2;1;0;0;0;2;12;1;2;1216;22;22;1;0;0;2;2;1216;0;3091;2;2;
/org.eclipse.ui.carbon/src/org/eclipse/ui/carbon/CarbonPlugin.java;1;0;4;1;0;0;0;4;112;0;1;2884;112;112;4;3;0;4;4;2884;3;2884;1;1;
/org.eclipse.team.ui/src/org/eclipse/team/ui/synchronize/ParticipantPageDialog.java;2;1;5;1;5;5;5;0;93;0;0;5192;106;106;1;0;0;0;5;5192;0;6337;5;2;
/org.eclipse.debug.core/core/org/eclipse/debug/internal/core/sourcelookup/containers/AbstractSourceContainerTypeDelegate.java;1;0;3;1;0;0;0;3;2;2;2;3678;2;2;2;1;0;3;3;4949;1;4949;2;1;
/org.eclipse.jdt.core.tests.model/workspace/Converter/src/javadoc/testBug48489/TestC.java;1;0;1;1;0;0;0;1;0;0;1;3890;0;0;1;0;0;1;1;3890;0;3890;1;1;
/org.eclipse.search.tests/src/org/eclipse/search/tests/filesearch/PositionTrackerTest.java;1;0;1;1;1;1;1;0;0;0;0;5846;0;0;1;0;0;0;1;5846;0;5846;1;1;
/org.eclipse.ui.workbench/Eclipse UI/org/eclipse/ui/internal/commands/older/ContextBinding.java;1;0;2;1;0;0;0;2;2;0;1;2562;2;2;2;1;0;2;2;2562;1;2562;1;1;
/org.eclipse.jdt.core.tests.model/workspace/Formatter/test248/A_in.java;1;0;1;1;0;0;0;1;0;0;1;2442;0;0;1;0;0;1;1;2442;0;2442;1;1;
/org.eclipse.team.cvs.ui/src/org/eclipse/team/internal/ccvs/ui/subscriber/CompareWithLatestParticipant.java;1;0;1;1;1;1;1;0;0;0;0;5520;0;0;1;0;0;0;1;5520;0;5520;1;1;
/org.eclipse.jdt.ui.tests.refactoring/resources/ChangeSignature/canModify/A_testAll61_out.java;1;0;1;1;1;1;1;0;0;0;0;5674;0;0;1;0;0;0;1;5674;0;5674;1;1;
/org.eclipse.swt/Eclipse SWT/win32/org/eclipse/swt/widgets/List.java;5;1;19;2;2;2;2;17;112;3;13;110;353;353;3;4;0;17;19;2784;4;6352;15;5;
/org.eclipse.ui.externaltools/Ant Tools Support/org/eclipse/ui/externaltools/internal/ant/launchConfigurations/AntLaunchDelegate.java;1;0;3;1;0;0;0;3;9;1;3;163;11;11;1;0;0;3;3;163;0;282;3;1;
/org.eclipse.jdt.ui/core refactoring/org/eclipse/jdt/internal/corext/refactoring/structure/ParameterOffsetFinder.java;1;0;1;1;0;0;0;1;0;0;1;1166;0;0;1;0;0;1;1;1166;0;1166;1;1;
/org.eclipse.osgi/core/framework/org/eclipse/osgi/framework/internal/core/MultiSourcePackage.java;4;1;5;1;2;2;2;3;10;1;3;3013;22;22;1;0;0;3;5;3013;0;6337;5;4;
/org.eclipse.jdt.core.tests.model/workspace/Formatter/test088/A_in.java;1;0;1;1;0;0;0;1;0;0;1;2425;0;0;1;0;0;1;1;2425;0;2425;1;1;
/org.eclipse.team.ui/src/org/eclipse/team/internal/ui/sync/actions/CopyAction.java;2;0;2;1;0;0;0;2;0;1;2;1876;0;0;1;0;0;2;2;1876;0;2632;2;2;
/org.eclipse.team.cvs.ui/src/org/eclipse/team/internal/ccvs/ui/subscriber/OverrideAndUpdateAction.java;2;1;13;1;2;2;2;11;56;2;10;1650;185;185;2;1;0;11;13;1650;1;6337;12;2;
/org.eclipse.jdt.core/batch/org/eclipse/jdt/internal/compiler/batch/CompilationUnit.java;2;0;3;1;0;0;0;3;12;1;3;1301;15;15;1;0;0;3;3;1301;0;3560;3;2;
/org.eclipse.team.ui/src/org/eclipse/team/ui/synchronize/views/LogicalViewProvider.java;1;0;1;1;0;0;0;1;0;0;1;3764;0;0;1;0;0;1;1;3764;0;3764;1;1;
/org.eclipse.jface/src/org/eclipse/jface/wizard/WizardDialog.java;4;2;18;2;9;6;9;9;314;2;8;1;487;487;2;1;3;9;18;5081;4;6011;14;4;
/org.eclipse.jdt.core/codeassist/org/eclipse/jdt/internal/codeassist/complete/CompletionParser.java;5;0;30;2;1;1;1;29;100;2;27;69;369;369;2;2;0;29;30;2255;2;5733;28;5;
/org.eclipse.pde.core/srcnew/org/eclipse/pde/internal/core/plugin/ISourceRange.java;1;0;2;1;1;1;1;1;20;0;1;2906;20;20;1;0;0;1;2;2906;0;5431;2;1;
/org.eclipse.ui.workbench/Eclipse UI/org/eclipse/ui/internal/commands/registry/ImageBindingDefinition.java;1;0;5;1;0;0;0;5;58;2;4;1396;93;93;2;1;0;5;5;1396;1;1724;4;1;
/org.eclipse.team.ui/src/org/eclipse/team/internal/ui/synchronize/ScopableSubscriberParticipant.java;1;1;2;1;2;2;2;0;59;0;0;5534;59;59;1;0;0;0;2;5534;0;5596;2;1;
/org.eclipse.jdt.core.tests.model/workspace/Converter/src/test0101/Test.java;1;0;1;1;0;0;0;1;0;0;1;3714;0;0;1;0;0;1;1;3714;0;3714;1;1;
/org.eclipse.ui.ide/src/org/eclipse/ui/internal/registry/NewWizardsRegistryReader.java;2;0;11;2;0;0;0;11;51;2;9;1526;110;110;2;2;0;11;11;1536;2;2263;9;2;
/org.eclipse.jdt.ui.tests.refactoring/resources/InlineMethodWorkspace/TestCases/argument_out/TestParameterNameUnused3.java;1;0;1;1;0;0;0;1;4;0;1;845;4;4;1;0;0;1;1;845;0;845;1;1;
/org.eclipse.osgi/defaultAdaptor/src/org/eclipse/osgi/framework/internal/defaultadaptor/BundleResourceHandler.java;1;0;4;1;0;0;0;4;58;1;4;3620;65;65;1;0;0;4;4;3620;0;4336;4;1;
/org.eclipse.ui.ide/src/org/eclipse/ui/ide/IGotoMarker.java;1;0;1;1;0;0;0;1;0;0;1;2241;0;0;1;0;0;1;1;2241;0;2241;1;1;
/org.eclipse.swt/Eclipse SWT/photon/org/eclipse/swt/widgets/Caret.java;3;1;4;1;2;2;2;2;6;1;2;269;15;15;1;0;0;2;4;269;0;6352;4;3;
/org.eclipse.ant.ui/Ant Editor/org/eclipse/ant/internal/ui/editor/outline/AntRunTargetAction.java;2;1;7;1;2;2;2;5;82;2;4;3514;131;131;2;1;0;5;7;3514;1;5600;6;2;
/org.eclipse.jdt.core.tests.model/workspace/Formatter/test460/A_out.java;1;0;1;1;0;0;0;1;0;0;1;3890;0;0;1;0;0;1;1;3890;0;3890;1;1;
/org.eclipse.jdt.core/compiler/org/eclipse/jdt/internal/compiler/ast/AnnotationSingleTypeReference.java;1;0;3;1;0;0;0;3;4;1;3;2397;4;4;1;0;0;3;3;2397;0;2887;3;1;
/org.eclipse.ui.workbench/Eclipse UI/org/eclipse/ui/internal/TabbedEditorWorkbook.java;6;0;20;2;0;0;0;20;1429;3;16;2620;1641;1641;3;4;0;20;20;4468;4;4517;16;6;
/org.eclipse.ui.views/src/org/eclipse/ui/views/internal/markers/IMarkerChangedListener.java;1;0;2;1;0;0;0;2;0;1;2;265;0;0;1;0;0;2;2;265;0;755;2;1;
/org.eclipse.ui.workbench/Eclipse UI/org/eclipse/ui/plugin/AbstractUIPlugin.java;5;2;13;2;8;7;8;5;91;1;5;1;425;425;2;0;1;5;13;5313;1;6338;12;5;
/org.eclipse.swt.tests/JUnit Tests/org/eclipse/swt/tests/junit/Test_org_eclipse_swt_widgets_FontDialog.java;2;0;4;1;0;0;0;4;22;2;3;171;53;53;2;1;0;4;4;171;1;2123;3;2;
/org.eclipse.jdt.core.tests.model/workspace/Converter/test0440/A.java;1;0;1;1;0;0;0;1;0;0;1;3714;0;0;1;0;0;1;1;3714;0;3714;1;1;
/org.eclipse.team.ui/src/org/eclipse/team/internal/ui/target/TargetProjectAction.java;1;0;1;1;0;0;0;1;0;0;1;2495;0;0;1;0;0;1;1;2495;0;2495;1;1;
/org.eclipse.ant.ui/Ant Editor/org/eclipse/ant/ui/internal/editor/AntEditor.java;2;0;10;1;0;0;0;10;133;2;8;250;266;266;2;2;0;10;10;264;2;1811;8;2;
/org.eclipse.ui.ide/src/org/eclipse/ui/views/markers/internal/FieldCreationTime.java;2;0;3;1;1;1;1;2;53;1;2;2208;88;88;1;0;0;2;3;2208;0;6340;3;2;
/org.eclipse.jdt.core.tests.model/workspace/Converter/src/test0422/A.java;1;0;1;1;0;0;0;1;0;0;1;3714;0;0;1;0;0;1;1;3714;0;3714;1;1;
/org.eclipse.jdt.ui/ui/org/eclipse/jdt/internal/ui/text/correction/CUCorrectionProposal.java;3;1;41;2;3;3;3;38;149;2;36;973;1095;1095;2;2;0;38;41;1946;2;6013;39;3;
/org.eclipse.ui.presentations.r21/src/org/eclipse/ui/internal/presentations/r21/R21PresentationMessages.java;1;0;1;1;1;1;1;0;0;0;0;6075;0;0;1;0;0;0;1;6075;0;6075;1;1;
/org.eclipse.swt.tests/JUnit Tests/org/eclipse/swt/tests/junit/browser/Test_BrowserSuite.java;2;0;10;1;1;1;1;9;12;3;7;2763;55;55;3;2;0;9;10;2763;2;6352;8;2;
/org.eclipse.ua.tests/src/org/eclipse/ui/examples/cheatsheets/pattern/actions/ExtensionActionI.java;1;0;1;1;1;1;1;0;0;0;0;6081;0;0;1;0;0;0;1;6081;0;6081;1;1;
/org.eclipse.jdt.ui/ui refactoring/org/eclipse/jdt/internal/ui/refactoring/TextContextViewer.java;1;0;2;1;0;0;0;2;0;1;2;3536;0;0;1;0;0;2;2;3536;0;4965;2;1;
/org.eclipse.jdt.ui/ui refactoring/org/eclipse/jdt/internal/ui/refactoring/nls/search/NLSSearchEditorOpener.java;1;0;1;1;1;1;1;0;0;0;0;5460;0;0;1;0;0;0;1;5460;0;5460;1;1;
/org.eclipse.ui.workbench/Eclipse UI/org/eclipse/ui/internal/keys/AlphabeticModifierKeyComparator.java;1;0;1;1;0;0;0;1;0;0;1;3310;0;0;1;0;0;1;1;3310;0;3310;1;1;
/org.eclipse.core.resources/src_ant/org/eclipse/core/resources/ant/Policy.java;1;0;2;1;1;1;1;1;95;0;1;5082;96;96;1;0;0;1;2;5082;0;5146;2;1;
/org.eclipse.jdt.debug.ui/ui/org/eclipse/jdt/internal/debug/ui/actions/NewDetailFormatterAction.java;1;0;1;1;0;0;0;1;4;0;1;1240;4;4;1;0;0;1;1;1240;0;1240;1;1;
/org.eclipse.ui.editors/src/org/eclipse/ui/internal/editors/quickdiff/restore/QuickDiffRestoreAction.java;1;0;2;1;0;0;0;2;0;1;2;1118;0;0;1;0;0;2;2;1118;0;1214;2;1;
/org.eclipse.ui.intro/src/org/eclipse/ui/internal/intro/impl/presentations/BrowserIntroPartLocationListener.java;2;2;7;1;7;6;7;0;30;0;0;5115;65;65;2;0;1;0;7;5877;1;6367;6;2;
/org.eclipse.jdt.ui/ui/org/eclipse/jdt/internal/ui/search/SearchLabelProvider.java;2;2;7;1;7;6;7;0;43;0;0;5106;72;72;2;0;1;0;7;5123;1;5438;6;2;
/org.eclipse.help.ide/src/org/eclipse/help/ui/internal/search/SortAction.java;1;0;1;1;1;1;1;0;0;0;0;5216;0;0;1;0;0;0;1;5216;0;5216;1;1;
/org.eclipse.swt.examples/src/org/eclipse/swt/examples/controlexample/ButtonTab.java;1;0;1;1;0;0;0;1;2;0;1;1560;2;2;1;0;0;1;1;1560;0;1560;1;1;
/org.eclipse.jdt.ui.tests.refactoring/resources/ExtractTemp/canExtract/A_test65_in.java;1;0;1;1;0;0;0;1;0;0;1;87;0;0;1;0;0;1;1;87;0;87;1;1;
/org.eclipse.osgi/osgi/src/org/osgi/framework/ServiceReference.java;2;0;2;1;1;1;1;1;3;0;1;3013;3;3;1;0;0;1;2;3013;0;5536;2;2;
/org.eclipse.ui.views/src/org/eclipse/ui/views/properties/PropertyDescriptor.java;2;0;2;1;1;1;1;1;11;0;1;3013;15;15;1;0;0;1;2;3013;0;6340;2;2;
/org.eclipse.help.base/src/org/eclipse/help/internal/browser/CustomBrowser.java;1;1;6;1;3;3;3;3;42;2;2;1740;88;88;2;1;0;3;6;1740;1;6337;5;1;
/org.eclipse.core.tests.runtime/src/org/eclipse/core/tests/internal/plugins/PluginResolveTest_19.java;1;0;1;1;0;0;0;1;0;0;1;3014;0;0;1;0;0;1;1;3014;0;3014;1;1;
/org.eclipse.ui.externaltools/External Tools Base/org/eclipse/ui/externaltools/internal/variable/ResourceComponent.java;2;0;2;1;0;0;0;2;9;1;2;163;9;9;1;0;0;2;2;163;0;321;2;2;
/org.eclipse.ui.editors/src/org/eclipse/ui/texteditor/ResourceTextEditor.java;1;0;1;1;0;0;0;1;0;0;1;1983;0;0;1;0;0;1;1;1983;0;1983;1;1;
/org.eclipse.core.runtime/src/org/eclipse/core/internal/registry/Extension.java;5;3;19;2;11;9;11;8;339;3;6;3049;479;479;3;2;2;8;19;3164;4;5875;15;5;
/org.eclipse.jdt.core.tests.model/workspace/Converter/src/javadoc/test018/TestD2.java;1;0;2;1;0;0;0;2;0;1;2;4311;0;0;1;0;0;2;2;4311;0;4390;2;1;
/org.eclipse.core.resources/src/org/eclipse/core/internal/resources/MarkerAttributeMap.java;1;1;2;1;2;2;2;0;457;0;0;5111;515;515;1;0;0;0;2;5111;0;5146;2;1;
/org.eclipse.ant.ui/Ant Editor/org/eclipse/ant/internal/ui/editor/outline/XMLProblem.java;1;0;7;1;2;1;2;5;47;1;5;3661;143;143;2;0;1;5;7;5919;1;5919;6;1;
/org.eclipse.jdt.core.tests.model/src/org/eclipse/jdt/core/tests/rewrite/describing/SourceModifierTest.java;3;1;4;1;2;2;2;2;7;1;2;4711;11;11;1;0;0;2;4;4711;0;5853;4;3;
/org.eclipse.jdt.core.tests.model/workspace/Formatter/test236/A_out.java;1;0;1;1;0;0;0;1;0;0;1;2437;0;0;1;0;0;1;1;2437;0;2437;1;1;
/org.eclipse.ui.workbench/Eclipse UI/org/eclipse/ui/internal/ResourcePerspective.java;2;0;2;1;0;0;0;2;1;1;2;520;1;1;1;0;0;2;2;520;0;2737;2;2;
/org.eclipse.jdt.ui/ui/org/eclipse/jdt/internal/ui/jarpackager/JarManifestWizardPage.java;4;1;6;1;3;3;3;3;20;1;3;1350;43;43;1;0;0;3;6;1350;0;6340;6;4;
/org.eclipse.update.core/src/org/eclipse/update/internal/core/SiteFileNonPluginContentConsumer.java;1;1;2;1;2;2;2;0;4;0;0;5665;8;8;1;0;0;0;2;5665;0;6336;2;1;
/org.eclipse.help.webapp/src_servlets/org/eclipse/help/internal/webapp/data/ActivitiesData.java;1;1;5;1;5;5;5;0;31;0;0;5310;58;58;1;0;0;0;5;5310;0;6337;5;1;
/org.eclipse.jdt.core.tests.model/workspace/Converter/test0055/Test.java;1;0;1;1;0;0;0;1;0;0;1;3714;0;0;1;0;0;1;1;3714;0;3714;1;1;
/org.eclipse.core.runtime/src/org/eclipse/core/internal/registry/RegistryCacheWriter.java;4;3;20;2;9;6;9;11;529;2;10;3049;711;711;3;1;3;11;20;5637;4;6157;16;4;
/org.eclipse.core.runtime/src/org/eclipse/core/internal/dependencies/SelectionVisitor.java;2;0;2;1;0;0;0;2;0;1;2;2105;0;0;1;0;0;2;2;2105;0;3013;2;2;
/org.eclipse.swt.tests/JUnit Tests/org/eclipse/swt/tests/junit/Test_org_eclipse_swt_browser_ProgressListener.java;1;0;2;1;0;0;0;2;16;1;2;2104;16;16;1;0;0;2;2;2104;0;2863;2;1;
/org.eclipse.jdt.ui/ui refactoring/org/eclipse/jdt/internal/ui/refactoring/RefactoringWizard.java;2;0;10;1;0;0;0;10;93;1;10;532;198;198;1;0;0;10;10;532;0;4965;10;2;
/org.eclipse.pde.core/src/org/eclipse/pde/internal/core/ischema/ISchemaDescriptor.java;2;0;2;1;1;1;1;1;11;0;1;4912;15;15;1;0;0;1;2;4912;0;6336;2;2;
/org.eclipse.jdt.ui.tests.refactoring/resources/TypeConstraints/A_testConstraints22.java;1;0;1;1;0;0;0;1;0;0;1;67;0;0;1;0;0;1;1;67;0;67;1;1;
/org.eclipse.core.runtime/src/org/eclipse/core/internal/registry/Factory.java;4;1;6;1;3;3;3;3;204;1;3;3049;220;220;1;0;0;3;6;3049;0;5531;6;4;
/org.eclipse.jdt.ui.tests.refactoring/resources/MoveInstanceMethod/canMove/test24/out/StarDecorator.java;1;0;1;1;0;0;0;1;0;0;1;1627;0;0;1;0;0;1;1;1627;0;1627;1;1;
/org.eclipse.team.ui/src/org/eclipse/team/internal/ui/synchronize/actions/SubscriberActionContribution.java;2;2;7;2;6;5;6;1;107;0;1;5082;179;179;2;0;1;1;7;5358;1;5872;6;2;
/org.eclipse.jdt.ui/core extension/org/eclipse/jdt/internal/corext/textmanipulation/MultiTextEdit.java;1;0;9;1;0;0;0;9;84;3;6;1012;195;195;3;3;0;9;9;1946;3;1946;6;1;
/org.eclipse.swt/Eclipse SWT/win32/org/eclipse/swt/widgets/Decorations.java;7;1;37;1;9;9;9;28;199;3;24;110;865;865;3;4;0;28;37;463;4;6352;33;7;
/org.eclipse.ui.workbench/Eclipse UI/org/eclipse/ui/internal/contexts/IContextDefinition.java;1;0;1;1;0;0;0;1;0;0;1;1422;0;0;1;0;0;1;1;1422;0;1422;1;1;
/org.eclipse.swt/Eclipse SWT Accessibility/common/org/eclipse/swt/accessibility/AccessibleControlEvent.java;1;0;1;1;0;0;0;1;11;0;1;2729;11;11;1;0;0;1;1;2729;0;2729;1;1;
/org.eclipse.search/new search/org/eclipse/search2/internal/ui/InternalSearchUI.java;4;3;27;3;14;10;14;13;113;2;11;3474;730;730;3;2;4;13;27;5398;6;6340;21;4;
/org.eclipse.jdt.core/dom/org/eclipse/jdt/core/internal/dom/rewrite/RewriteEventStore.java;2;0;3;2;0;0;0;3;7;2;2;4711;7;7;2;1;0;3;3;4711;1;4802;2;2;
/org.eclipse.swt/Eclipse SWT/gtk/org/eclipse/swt/widgets/FileDialog.java;3;1;8;1;3;3;3;5;137;2;4;2663;206;206;2;1;0;5;8;2663;1;6352;7;3;
/org.eclipse.jdt.ui.tests.refactoring/test cases/org/eclipse/jdt/ui/tests/refactoring/AbstractSelectionTestCase.java;3;1;11;1;3;3;3;8;72;1;8;345;159;159;1;0;0;8;11;345;0;6340;11;3;
/org.eclipse.ui.workbench/Eclipse UI/org/eclipse/ui/internal/themes/ColorsAndFontsPreferencePage.java;2;2;26;1;5;4;5;21;859;4;11;4392;1602;1602;4;10;1;21;26;4559;11;6338;15;2;
/org.eclipse.ui.workbench/Eclipse UI/org/eclipse/ui/internal/skins/newlook/PartTabFolderPresentation.java;3;0;4;3;0;0;0;4;23;3;2;4438;23;23;3;2;0;4;4;4460;2;4460;2;3;
/org.eclipse.ui.workbench/Eclipse UI/org/eclipse/ui/internal/gestures/Capture.java;1;0;2;1;0;0;0;2;111;1;2;1721;145;145;1;0;0;2;2;1721;0;2824;2;1;
/org.eclipse.jdt.ui/ui/org/eclipse/jdt/internal/ui/search/CountingTreeContentProvider.java;1;0;2;1;0;0;0;2;0;1;2;4107;0;0;1;0;0;2;2;4107;0;4625;2;1;
/org.eclipse.jdt.ui/ui/org/eclipse/jdt/ui/actions/JdtActionConstants.java;6;2;19;2;6;4;6;13;40;2;12;237;215;215;2;1;2;13;19;2844;3;6334;16;6;
/org.eclipse.pde.ui/src/org/eclipse/pde/internal/ui/parts/FolderSelectionDialog.java;1;0;2;1;0;0;0;2;0;1;2;2311;0;0;1;0;0;2;2;2311;0;3393;2;1;
/org.eclipse.search/search/org/eclipse/search/internal/core/text/TextSearchJob.java;1;0;3;1;0;0;0;3;78;1;3;3458;78;78;1;0;0;3;3;3458;0;3711;3;1;
/org.eclipse.jdt.ui/ui refactoring/org/eclipse/jdt/internal/ui/refactoring/nls/search/NLSGroupByKeyComputer.java;4;1;4;1;2;2;2;2;7;1;2;1309;14;14;1;0;0;2;4;1309;0;6340;4;4;
/org.eclipse.jdt.core.tests.model/workspace/Formatter/test208/A_in.java;1;0;1;1;0;0;0;1;0;0;1;2424;0;0;1;0;0;1;1;2424;0;2424;1;1;
/org.eclipse.core.runtime.osgi/src/org/eclipse/core/internal/registry/IRegistryConstants.java;1;0;1;1;0;0;0;1;0;0;1;3013;0;0;1;0;0;1;1;3013;0;3013;1;1;
/org.eclipse.text/src/org/eclipse/text/edits/TextEdit.java;2;1;8;1;3;3;3;5;260;1;5;1986;477;477;1;0;0;5;8;1986;0;6340;8;2;
/org.eclipse.ant.ui/Ant Editor/org/eclipse/ant/ui/internal/editor/text/XMLMarkerAnnotation.java;1;0;5;1;0;0;0;5;99;1;5;250;109;109;1;0;0;5;5;250;0;1811;5;1;
/org.eclipse.jdt.ui/ui/org/eclipse/jdt/internal/ui/reorg/StructuredSelectionUtil.java;1;0;1;1;0;0;0;1;0;0;1;1111;0;0;1;0;0;1;1;1111;0;1111;1;1;
/org.eclipse.pde.ui/src/org/eclipse/pde/internal/ui/wizards/project/PluginClassCodeGenerator.java;1;0;5;1;0;0;0;5;20;1;5;698;37;37;1;0;0;5;5;698;0;3840;5;1;
/org.eclipse.ui.console/src/org/eclipse/ui/internal/console/MessageConsolePartition.java;1;0;3;1;0;0;0;3;3;2;2;1988;4;4;2;1;0;3;3;1988;1;2024;2;1;
/org.eclipse.ui.views/src/org/eclipse/ui/views/internal/markers/IFilter.java;1;0;3;1;0;0;0;3;4;2;2;265;4;4;2;1;0;3;3;265;1;755;2;1;
/org.eclipse.jdt.core.tests.model/workspace/Formatter/test371/A_in.java;1;0;1;1;0;0;0;1;0;0;1;3130;0;0;1;0;0;1;1;3130;0;3130;1;1;
/org.eclipse.ltk.ui.refactoring/src/org/eclipse/ltk/internal/ui/refactoring/RefactoringWizardDialog2.java;1;1;6;1;5;5;5;1;4;0;1;5052;14;14;1;0;0;1;6;5052;0;6340;6;1;
/org.eclipse.jdt.core/compiler/org/eclipse/jdt/internal/compiler/ast/FloatLiteral.java;3;0;3;1;0;0;0;3;4;1;3;2173;8;8;1;0;0;3;3;2173;0;3560;3;3;
/org.eclipse.swt/Eclipse SWT/gtk1x/org/eclipse/swt/widgets/FontDialog.java;3;0;6;2;0;0;0;6;44;3;3;166;64;64;3;3;0;6;6;166;3;2327;3;3;
/org.eclipse.ui.workbench/Eclipse UI/org/eclipse/ui/internal/csm/commands/ExtensionCommandRegistry.java;1;0;6;1;0;0;0;6;142;3;3;2515;204;204;3;3;0;6;6;2553;3;2553;3;1;
/org.eclipse.ui.workbench/Eclipse UI/org/eclipse/ui/internal/gestures/ICaptureListener.java;1;0;1;1;0;0;0;1;0;0;1;1721;0;0;1;0;0;1;1;1721;0;1721;1;1;
/org.eclipse.jdt.ui/ui/org/eclipse/jdt/ui/JavaElementLabelProvider.java;2;0;2;2;2;1;2;0;20;0;0;6334;20;20;2;0;1;0;2;6334;1;6334;1;2;
/org.eclipse.jdt.ui.tests.refactoring/resources/MoveInstanceMethod/canMove/test24/out/B.java;1;0;1;1;0;0;0;1;0;0;1;1627;0;0;1;0;0;1;1;1627;0;1627;1;1;
/org.eclipse.ui.ide/src/org/eclipse/ui/wizards/newresource/BasicNewResourceWizard.java;3;0;4;1;0;0;0;4;36;1;4;1511;57;57;1;0;0;4;4;1511;0;3150;4;3;
/org.eclipse.jdt.core.tests.model/src/org/eclipse/jdt/core/tests/model/BufferTests.java;1;0;7;1;0;0;0;7;42;1;7;241;88;88;1;0;0;7;7;241;0;3560;7;1;
/org.eclipse.ui.ide/src/org/eclipse/ui/internal/ide/dialogs/AboutDialog.java;4;1;9;1;3;3;3;6;411;1;6;2264;665;665;1;0;0;6;9;2264;0;5483;9;4;
/org.eclipse.jdt.core.tests.model/workspace/Formatter/test090/A_in.java;1;0;1;1;0;0;0;1;0;0;1;2425;0;0;1;0;0;1;1;2425;0;2425;1;1;
/org.eclipse.jface/src/org/eclipse/jface/preference/BooleanFieldEditor.java;2;1;2;1;2;2;2;0;3;0;0;5463;5;5;1;0;0;0;2;5463;0;6338;2;2;
/org.eclipse.jdt.debug.ui/ui/org/eclipse/jdt/internal/debug/ui/actions/BreakpointHitCountAction.java;3;1;5;1;3;3;3;2;50;1;2;1240;73;73;1;0;0;2;5;1240;0;6336;5;3;
/org.eclipse.ui.editors/src/org/eclipse/ui/editors/text/TextEditorMessages.java;1;1;2;1;2;2;2;0;20;0;0;5918;37;37;1;0;0;0;2;5918;0;6334;2;1;
/org.eclipse.pde.ui/sandbox/org/eclipse/pde/internal/ui/editor/standalone/parser/ISourceRange.java;1;0;2;1;0;0;0;2;0;1;2;2320;0;0;1;0;0;2;2;2320;0;2931;2;1;
/org.eclipse.core.resources/src/org/eclipse/core/internal/indexing/ObjectID.java;1;0;1;1;1;1;1;0;12;0;0;5146;12;12;1;0;0;0;1;5146;0;5146;1;1;
/org.eclipse.jdt.ui/ui/org/eclipse/jdt/internal/ui/filters/NonJavaProjectsFilter.java;1;0;1;1;1;1;1;0;2;0;0;6340;2;2;1;0;0;0;1;6340;0;6340;1;1;
/org.eclipse.jdt.core/model/org/eclipse/jdt/internal/core/ImportContainer.java;2;0;9;1;1;1;1;8;23;1;8;576;72;72;1;0;0;8;9;576;0;5185;9;2;
/org.eclipse.ui.workbench/Eclipse UI/org/eclipse/ui/actions/CreateProjectAction.java;1;0;1;1;0;0;0;1;0;0;1;2737;0;0;1;0;0;1;1;2737;0;2737;1;1;
/org.eclipse.ant.ui/Ant Tools Support/org/eclipse/ant/ui/internal/launchConfigurations/AntClasspathProvider.java;1;0;5;1;0;0;0;5;26;1;5;250;43;43;1;0;0;5;5;250;0;1811;5;1;
/org.eclipse.jdt.core.tests.model/workspace/Converter/src/javadoc/test107/TestD1.java;1;0;1;1;0;0;0;1;0;0;1;4390;0;0;1;0;0;1;1;4390;0;4390;1;1;
/org.eclipse.ui.examples.javaeditor/Template Editor Example/org/eclipse/ui/examples/templateeditor/editors/IXMLColorConstants.java;2;0;2;1;1;1;1;1;10;0;1;4644;10;10;1;0;0;1;2;4644;0;6340;2;2;
/org.eclipse.swt/Eclipse SWT PI/gtk1x/org/eclipse/swt/internal/gtk/GtkDialog.java;1;0;1;1;0;0;0;1;0;0;1;2327;0;0;1;0;0;1;1;2327;0;2327;1;1;
/org.eclipse.ui.workbench/Eclipse UI/org/eclipse/ui/internal/util/ConfigurationElementMemento.java;2;0;7;2;0;0;0;7;41;2;6;1220;66;66;2;1;0;7;7;3170;1;3170;6;2;
/org.eclipse.ltk.ui.refactoring/src/org/eclipse/ltk/internal/ui/refactoring/ChangeElementContentProvider.java;1;1;4;1;3;3;3;1;20;0;1;4965;25;25;1;0;0;1;4;4965;0;6340;4;1;
/org.eclipse.jdt.ui/ui/org/eclipse/jdt/internal/ui/dialogs/PackageSelectionDialog.java;3;1;4;1;3;3;3;1;54;0;1;3167;60;60;1;0;0;1;4;3167;0;6340;4;3;
/org.eclipse.sdk.tests-feature/plugins/org.eclipse.perfmsr.ui/src/org/eclipse/perfmsr/ui/ExtConstants.java;2;0;2;1;1;1;1;1;10;0;1;4845;10;10;1;0;0;1;2;4845;0;6342;2;2;
/org.eclipse.jdt.ui/ui/org/eclipse/jdt/internal/ui/util/StringMatcher.java;1;0;2;1;1;1;1;1;6;0;1;1445;8;8;1;0;0;1;2;1445;0;6340;2;1;
/org.eclipse.update.core/src/org/eclipse/update/internal/api/operations/IInstallFeatureOperation.java;1;0;2;1;0;0;0;2;0;1;2;3270;0;0;1;0;0;2;2;3270;0;4928;2;1;
/org.eclipse.jdt.core.tests.model/workspace/Converter/test0192/Test.java;1;0;1;1;0;0;0;1;0;0;1;3714;0;0;1;0;0;1;1;3714;0;3714;1;1;
/org.eclipse.core.tests.runtime/src/org/eclipse/core/tests/runtime/StatusTest.java;1;0;1;1;1;1;1;0;353;0;0;5149;353;353;1;0;0;0;1;5149;0;5149;1;1;
/org.eclipse.jdt.ui.tests.refactoring/resources/IntroduceParameter/simple/Formatting1.java;1;0;1;1;1;1;1;0;0;0;0;5748;0;0;1;0;0;0;1;5748;0;5748;1;1;
/org.eclipse.update.ui/src/org/eclipse/update/internal/ui/model/MyComputer.java;3;0;4;1;0;0;0;4;59;1;4;824;68;68;1;0;0;4;4;824;0;2085;4;3;
/org.eclipse.debug.ui/ui/org/eclipse/debug/internal/ui/views/variables/VariablesView.java;6;1;43;1;4;4;4;39;127;2;34;228;931;931;2;5;0;39;43;670;5;5701;38;6;
/org.eclipse.ant.ui/Ant Tools Support/org/eclipse/ant/ui/internal/model/IAntUIConstants.java;1;0;10;1;0;0;0;10;56;4;7;262;124;124;4;3;0;10;10;262;3;1811;7;1;
/org.eclipse.jdt.ui/core refactoring/org/eclipse/jdt/internal/corext/refactoring/reorg2/ReadOnlyResourceFinder.java;1;0;2;1;0;0;0;2;0;1;2;818;0;0;1;0;0;2;2;818;0;1114;2;1;
/org.eclipse.update.configurator/src/org/eclipse/update/configurator/migration/PluginConverter.java;2;0;2;1;0;0;0;2;0;1;2;3014;0;0;1;0;0;2;2;3014;0;3087;2;2;
/org.eclipse.swt/Eclipse SWT/gtk1x/org/eclipse/swt/widgets/Combo.java;1;0;1;1;0;0;0;1;0;0;1;2327;0;0;1;0;0;1;1;2327;0;2327;1;1;
/org.eclipse.ui.workbench/Eclipse UI/org/eclipse/ui/internal/commands/older/XPropertyEvent.java;1;0;1;1;0;0;0;1;0;0;1;2562;0;0;1;0;0;1;1;2562;0;2562;1;1;
/org.eclipse.team.tests.cvs.core/src/org/eclipse/team/tests/ccvs/ui/old/EclipseUITestHarnessApplication.java;1;0;2;1;0;0;0;2;0;1;2;2632;0;0;1;0;0;2;2;2632;0;2747;2;1;
/org.eclipse.jdt.core.tests.model/workspace/Converter/test0248/Test.java;1;0;1;1;0;0;0;1;0;0;1;3714;0;0;1;0;0;1;1;3714;0;3714;1;1;
/org.eclipse.jdt.ui/core refactoring/org/eclipse/jdt/internal/corext/refactoring/code/NameCollector.java;1;0;1;1;1;1;1;0;2;0;0;6340;2;2;1;0;0;0;1;6340;0;6340;1;1;
/org.eclipse.jdt.ui/core refactoring/org/eclipse/jdt/internal/corext/refactoring/participants/xml/ResolveExpression.java;1;0;2;1;0;0;0;2;0;1;2;4091;0;0;1;0;0;2;2;4091;0;4108;2;1;
/org.eclipse.jface.text/projection/org/eclipse/jface/text/source/projection/AnnotationBag.java;2;1;4;1;3;3;3;1;22;0;1;4974;26;26;1;0;0;1;4;4974;0;6362;4;2;
/org.eclipse.core.tests.resources/src/org/eclipse/core/tests/internal/alias/AllTests.java;1;0;1;1;1;1;1;0;6;0;0;5147;6;6;1;0;0;0;1;5147;0;5147;1;1;
/org.eclipse.core.runtime/src/org/eclipse/core/internal/runtime/URLTool.java;2;1;5;1;2;2;2;3;971;1;3;3013;1956;1956;1;0;0;3;5;3013;0;6340;5;2;
/org.eclipse.jdt.core.tests.model/workspace/Formatter/test455/A_out.java;1;0;2;1;1;1;1;1;9;0;1;3788;9;9;1;0;0;1;2;3788;0;5132;2;1;
/org.eclipse.debug.ui/ui/org/eclipse/debug/internal/ui/stringsubstitution/PromptingResolver.java;4;1;6;1;2;2;2;4;9;1;4;2081;26;26;1;0;0;4;6;2081;0;6339;6;4;
/org.eclipse.core.resources/src/org/eclipse/core/internal/localstore/RefreshLocalAliasVisitor.java;1;0;1;1;1;1;1;0;20;0;0;5146;20;20;1;0;0;0;1;5146;0;5146;1;1;
/org.eclipse.jdt.core/compiler/org/eclipse/jdt/internal/compiler/ast/DoubleLiteral.java;2;0;2;1;0;0;0;2;4;1;2;2974;6;6;1;0;0;2;2;2974;0;3560;2;2;
/org.eclipse.osgi/osgi/src/org/osgi/service/permissionadmin/PermissionInfo.java;2;0;2;1;1;1;1;1;3;0;1;3013;3;3;1;0;0;1;2;3013;0;5536;2;2;
/org.eclipse.jdt.core/model/org/eclipse/jdt/internal/core/util/SimpleSet.java;2;0;2;1;0;0;0;2;2;1;2;1357;2;2;1;0;0;2;2;1357;0;3560;2;2;
/org.eclipse.ui.workbench/Eclipse UI/org/eclipse/ui/internal/commands/registry/ICategoryDefinition.java;1;0;2;1;0;0;0;2;0;1;2;1422;0;0;1;0;0;2;2;1422;0;1724;2;1;
/org.eclipse.swt.tests/JUnit Tests/org/eclipse/swt/tests/junit/Test_org_eclipse_swt_widgets_TableColumn.java;3;0;4;1;1;1;1;3;48;1;3;2123;107;107;1;0;0;3;4;2123;0;6352;4;3;
/org.eclipse.jdt.ui/ui/org/eclipse/jdt/internal/ui/text/comment/CommentRange.java;3;0;10;1;1;1;1;9;142;1;9;1589;418;418;1;0;0;9;10;1589;0;6340;10;3;
/org.eclipse.pde.build/src_ant/org/eclipse/pde/internal/build/tasks/ManifestModifier.java;2;2;5;1;3;2;3;2;93;1;2;4175;138;138;2;0;1;2;5;6340;1;6340;4;2;
/org.eclipse.ui.workbench/Eclipse UI/org/eclipse/ui/internal/commands/CommandHandlerService.java;1;0;5;1;0;0;0;5;48;2;4;1223;59;59;2;1;0;5;5;1239;1;1321;4;1;
/org.eclipse.team.ui/src/org/eclipse/team/ui/synchronize/actions/PseudoConflictFilter.java;1;0;1;1;0;0;0;1;0;0;1;2535;0;0;1;0;0;1;1;2535;0;2535;1;1;
/org.eclipse.core.runtime/src/org/eclipse/core/internal/runtime/ExtensionAdapterFactory.java;1;0;2;1;0;0;0;2;0;1;2;3812;0;0;1;0;0;2;2;3812;0;4128;2;1;
/org.eclipse.ant.ui/Ant Tools Support/org/eclipse/ant/ui/internal/views/actions/EditLaunchConfigurationAction.java;1;0;2;1;0;0;0;2;0;1;2;263;0;0;1;0;0;2;2;263;0;1811;2;1;
/org.eclipse.jdt.core.tests.model/workspace/Formatter/test041/A_out.java;1;0;1;1;0;0;0;1;0;0;1;2425;0;0;1;0;0;1;1;2425;0;2425;1;1;
/org.eclipse.jdt.ui/core refactoring/org/eclipse/jdt/internal/corext/refactoring/participants/xml/JavaElementExtender.java;1;0;5;1;0;0;0;5;20;1;5;2546;34;34;1;0;0;5;5;2546;0;4941;5;1;
/org.eclipse.ui.ide/src/org/eclipse/ui/actions/OpenFileAction.java;2;0;6;1;0;0;0;6;21;1;6;1511;55;55;1;0;0;6;6;1511;0;2263;6;2;
/org.eclipse.jdt.core/model/org/eclipse/jdt/core/util/IInnerClassesAttribute.java;1;0;1;1;0;0;0;1;2;0;1;3560;2;2;1;0;0;1;1;3560;0;3560;1;1;
/org.eclipse.ui.workbench/Eclipse UI/org/eclipse/ui/activities/AbstractActivityService.java;1;0;5;1;0;0;0;5;21;3;3;2800;42;42;3;2;0;5;5;2800;2;2896;3;1;
/org.eclipse.jdt.ui.tests.refactoring/resources/ExtractTemp/canExtract/A_test67_in.java;1;0;1;1;0;0;0;1;0;0;1;1309;0;0;1;0;0;1;1;1309;0;1309;1;1;
/org.eclipse.ui.workbench/Eclipse UI/org/eclipse/ui/dialogs/FilteredList.java;2;0;8;1;1;1;1;7;402;1;7;1483;1084;1084;1;0;0;7;8;1483;0;5464;8;2;
/org.eclipse.swt/Eclipse SWT/win32/org/eclipse/swt/widgets/ToolBar.java;7;1;22;2;3;3;3;19;125;2;16;110;307;307;2;3;0;19;22;207;3;6352;19;7;
/org.eclipse.ui.workbench/Eclipse UI/org/eclipse/ui/internal/commands/registry/old/CoreRegistry.java;1;0;4;1;0;0;0;4;20;2;2;1222;21;21;2;2;0;4;4;1222;2;1321;2;1;
/org.eclipse.jdt.debug.tests/tests/org/eclipse/jdt/debug/tests/eval/LongAssignmentOperatorsTests.java;1;0;1;1;0;0;0;1;130;0;1;1274;130;130;1;0;0;1;1;1274;0;1274;1;1;
/org.eclipse.update.configurator/src/org/eclipse/update/internal/configurator/Selector.java;1;0;2;1;0;0;0;2;0;1;2;3243;0;0;1;0;0;2;2;3243;0;3265;2;1;
/org.eclipse.team.webdav/src/org/eclipse/team/internal/webdav/subscriber/WebDavRemoteResourceVariantTree.java;2;0;4;1;1;1;1;3;16;1;3;4259;23;23;1;0;0;3;4;4259;0;6337;4;2;
/org.eclipse.jdt.core/model/org/eclipse/jdt/internal/core/util/LocalVariableAttribute.java;1;0;1;1;0;0;0;1;2;0;1;3560;2;2;1;0;0;1;1;3560;0;3560;1;1;
/org.eclipse.jdt.core.tests.model/workspace/Converter/test0314/Test.java;1;0;1;1;0;0;0;1;0;0;1;3714;0;0;1;0;0;1;1;3714;0;3714;1;1;
/org.eclipse.ui.editors/src/org/eclipse/ui/internal/editors/text/TextEditorPreferencePage2.java;3;4;23;1;7;4;7;16;310;1;16;849;1196;1196;4;0;3;16;23;5501;3;6340;20;3;
/org.eclipse.core.tests.runtime/src/org/eclipse/core/tests/internal/plugin/a/Dummy.java;1;0;1;1;1;1;1;0;15;0;0;5149;15;15;1;0;0;0;1;5149;0;5149;1;1;
/org.eclipse.update.core/src/org/eclipse/update/internal/operations/FeatureHierarchyElement2.java;1;0;2;1;0;0;0;2;0;1;2;825;0;0;1;0;0;2;2;825;0;1521;2;1;
/org.eclipse.jdt.core/codeassist/org/eclipse/jdt/internal/codeassist/complete/CompletionOnQualifiedTypeReference.java;2;0;2;1;0;0;0;2;13;1;2;991;15;15;1;0;0;2;2;991;0;3560;2;2;
/org.eclipse.pde.ui/src/org/eclipse/pde/internal/ui/launcher/JUnitCoreApplicationShortcut.java;1;0;3;1;0;0;0;3;13;1;3;1549;13;13;1;0;0;3;3;1549;0;1638;3;1;
/org.eclipse.jdt.core.tests.model/workspace/Formatter/test134/A_out.java;1;0;1;1;0;0;0;1;0;0;1;2425;0;0;1;0;0;1;1;2425;0;2425;1;1;
/org.eclipse.jdt.core/compiler/org/eclipse/jdt/internal/compiler/ast/AllocationExpression.java;2;0;6;1;0;0;0;6;60;1;6;41;99;99;1;0;0;6;6;41;0;3560;6;2;
/org.eclipse.jdt.ui/ui refactoring/org/eclipse/jdt/internal/ui/refactoring/contentassist/JavaSourcePackageFragmentRootCompletionProcessor.java;4;2;6;2;5;4;5;1;16;0;1;4930;34;34;2;0;1;1;6;5197;1;6340;5;4;
/org.eclipse.ui.workbench/Eclipse UI/org/eclipse/ui/contexts/IContextManagerListener.java;4;1;10;1;2;2;2;8;20;2;7;1119;62;62;2;1;0;8;10;1135;1;6338;9;4;
/org.eclipse.ui.versioncheck/src/org/eclipse/ui/internal/versioncheck/VersionCheck.java;1;0;1;1;0;0;0;1;2;0;1;620;2;2;1;0;0;1;1;620;0;620;1;1;
/org.eclipse.ui.views/src/org/eclipse/ui/views/properties/FilePropertySource.java;1;0;1;1;0;0;0;1;0;0;1;2738;0;0;1;0;0;1;1;2738;0;2738;1;1;
/org.eclipse.ui.workbench/Eclipse UI/org/eclipse/ui/commands/IAction.java;1;0;10;1;0;0;0;10;129;3;6;767;144;144;3;4;0;10;10;1419;4;3151;6;1;
/org.eclipse.debug.ui/ui/org/eclipse/debug/internal/ui/views/memory/MemoryViewLine.java;2;1;2;1;2;2;2;0;6;0;0;5254;6;6;1;0;0;0;2;5254;0;5364;2;2;
/org.eclipse.ui.workbench/Eclipse UI/org/eclipse/ui/internal/dialogs/ZipFileResourceExporter.java;1;0;1;1;0;0;0;1;0;0;1;2737;0;0;1;0;0;1;1;2737;0;2737;1;1;
/org.eclipse.jdt.ui/ui/org/eclipse/jdt/internal/ui/javadocexport/JavadocLinkDialogLabelProvider.java;2;1;3;1;2;2;2;1;68;0;1;4798;98;98;1;0;0;1;3;4798;0;6340;3;2;
/org.eclipse.ui.workbench/Eclipse UI/org/eclipse/ui/internal/commands/MutableCommandManager.java;3;1;10;1;5;5;5;5;2018;3;3;4927;3969;3969;3;2;0;5;10;4952;2;6338;8;3;
/org.eclipse.jdt.core.tests.model/workspace/Converter/Test0158.java;1;0;1;1;0;0;0;1;0;0;1;3714;0;0;1;0;0;1;1;3714;0;3714;1;1;
/org.eclipse.swt/Eclipse SWT/gtk/org/eclipse/swt/widgets/Canvas.java;6;1;11;1;2;2;2;9;24;1;9;220;88;88;1;0;0;9;11;220;0;6352;11;6;
/org.eclipse.jdt.core.tests.model/workspace/Converter/src/test0436/A.java;1;0;1;1;0;0;0;1;0;0;1;3714;0;0;1;0;0;1;1;3714;0;3714;1;1;
/org.eclipse.update.ui/srcnew/org/eclipse/update/internal/ui/wizards/MultiInstallWizard2.java;1;0;3;1;0;0;0;3;31;1;3;367;32;32;1;0;0;3;3;367;0;408;3;1;
/org.eclipse.update.core/src/org/eclipse/update/operations/IOperationFactory.java;1;2;9;1;4;3;4;5;68;2;4;825;153;153;2;1;1;5;9;825;2;6336;7;1;
/org.eclipse.ui.workbench/Eclipse UI/org/eclipse/ui/internal/commands/Persistence.java;4;2;50;2;5;4;5;45;1642;4;34;535;7728;7728;4;11;1;45;50;1389;12;6338;38;4;
/org.eclipse.pde.ui/src/org/eclipse/pde/internal/ui/preferences/TargetEnvironmentPreferencePage.java;2;1;6;1;2;2;2;4;37;1;4;1614;82;82;1;0;0;4;6;1614;0;6336;6;2;
/org.eclipse.core.tests.runtime/src/org/eclipse/core/tests/internal/plugins/SoftPrereqTest_18.java;1;0;1;1;0;0;0;1;0;0;1;3014;0;0;1;0;0;1;1;3014;0;3014;1;1;
/org.eclipse.jdt.ui/ui refactoring/org/eclipse/jdt/internal/ui/refactoring/ChangeTypeContentProvider.java;2;0;3;1;1;1;1;2;4;1;2;2844;6;6;1;0;0;2;3;2844;0;6340;3;2;
/org.eclipse.team.core/src/org/eclipse/team/internal/core/subscribers/SubscriberSyncInfoCollector.java;2;2;4;2;4;3;4;0;24;0;0;5362;35;35;2;0;1;0;4;5362;1;5753;3;2;
/org.eclipse.team.cvs.ui/src/org/eclipse/team/internal/ccvs/ui/jobs/DeferredWorkbenchContentProvider.java;1;0;5;1;0;0;0;5;227;2;4;977;350;350;2;1;0;5;5;1008;1;1064;4;1;
/org.eclipse.ui.workbench/Eclipse UI/org/eclipse/ui/activities/ICategoryListener.java;3;1;5;1;2;2;2;3;11;1;3;2867;23;23;1;0;0;3;5;2867;0;6338;5;3;
/org.eclipse.core.tools/src/org/eclipse/core/tools/IFlattable.java;1;0;1;1;1;1;1;0;0;0;0;6302;0;0;1;0;0;0;1;6302;0;6302;1;1;
/org.eclipse.team.cvs.ui/src/org/eclipse/team/internal/ccvs/ui/CVSFolderPropertiesPage.java;2;1;6;1;2;2;2;4;36;1;4;81;80;80;1;0;0;4;6;81;0;6337;6;2;
/org.eclipse.team.tests.cvs.core/src/org/eclipse/team/tests/ccvs/ui/SynchronizeViewTestAdapter.java;2;2;16;2;4;3;4;12;89;2;9;2632;340;340;2;3;1;12;16;2863;4;6337;12;2;
/org.eclipse.jface.text/src/org/eclipse/jface/text/DocumentClone.java;1;1;2;1;2;2;2;0;12;0;0;6337;12;12;1;0;0;0;2;6337;0;6359;2;1;
/org.eclipse.team.ui/src/org/eclipse/team/ui/synchronize/views/SyncInfoDiffNodeBuilder.java;1;0;1;1;0;0;0;1;0;0;1;3832;0;0;1;0;0;1;1;3832;0;3832;1;1;
/org.eclipse.jdt.ui/core extension/org/eclipse/jdt/internal/corext/dom/CodeScopeBuilder.java;1;0;1;1;1;1;1;0;2;0;0;6340;2;2;1;0;0;0;1;6340;0;6340;1;1;
/org.eclipse.core.tests.runtime/src/org/eclipse/core/tests/internal/plugin/a/ExtensionIndirectReferenceToPlugin.java;1;0;1;1;1;1;1;0;14;0;0;5149;14;14;1;0;0;0;1;5149;0;5149;1;1;
/org.eclipse.jdt.ui/core refactoring/org/eclipse/jdt/internal/corext/refactoring/rename/TempOccurrenceAnalyzer.java;2;0;2;1;1;1;1;1;2;0;1;4605;2;2;1;0;0;1;2;4605;0;6340;2;2;
/org.eclipse.jdt.core/compiler/org/eclipse/jdt/internal/compiler/flow/FlowContext.java;3;1;7;1;2;2;2;5;37;1;5;148;79;79;1;0;0;5;7;148;0;5871;7;3;
/org.eclipse.ui.intro/src/org/eclipse/ui/internal/intro/impl/IIntroConstants.java;2;2;15;1;15;12;15;0;17;0;0;5115;83;83;2;0;3;0;15;5314;3;6167;12;2;
/org.eclipse.jdt.core.tests.model/workspace/Converter/test0507/B.java;1;0;2;1;0;0;0;2;0;1;2;3009;0;0;1;0;0;2;2;3009;0;3714;2;1;
/org.eclipse.jdt.ui/core refactoring/org/eclipse/jdt/internal/corext/refactoring/reorg/ICopyQueries.java;1;0;1;1;0;0;0;1;0;0;1;808;0;0;1;0;0;1;1;808;0;808;1;1;
/org.eclipse.team.cvs.ui/src/org/eclipse/team/internal/ccvs/ui/CVSCompareEditorInput.java;2;1;4;1;2;2;2;2;40;1;2;866;75;75;1;0;0;2;4;866;0;6337;4;2;
/org.eclipse.jface.text/src/org/eclipse/jface/text/DocumentCommand.java;3;1;5;1;3;3;3;2;91;1;2;583;165;165;1;0;0;2;5;583;0;6359;5;3;
/org.eclipse.ant.ui/Ant Tools Support/org/eclipse/ant/ui/internal/views/actions/RunTargetAction.java;2;0;5;2;0;0;0;5;26;2;3;263;36;36;2;2;0;5;5;263;2;1811;3;2;
/org.eclipse.swt/Eclipse SWT PI/gtk1x/org/eclipse/swt/internal/gtk/GtkCListRow.java;1;0;1;1;0;0;0;1;0;0;1;2327;0;0;1;0;0;1;1;2327;0;2327;1;1;
/org.eclipse.jdt.core.tests.model/workspace/Formatter/test479/A_in.java;1;0;1;1;0;0;0;1;0;0;1;4173;0;0;1;0;0;1;1;4173;0;4173;1;1;
/org.eclipse.jdt.ui/ui/org/eclipse/jdt/internal/ui/actions/FoldingExpandAllRulerAction.java;2;1;2;1;2;2;2;0;6;0;0;5612;6;6;1;0;0;0;2;5612;0;6340;2;2;
/org.eclipse.team.webdav/src/org/eclipse/team/internal/ui/target/TargetSiteExportWizard.java;2;0;2;1;0;0;0;2;0;1;2;2495;0;0;1;0;0;2;2;2495;0;4216;2;2;
/org.eclipse.text/src/org/eclipse/jface/text/link/ILinkedModeListener.java;2;1;3;1;3;3;3;0;57;0;0;5128;65;65;1;0;0;0;3;5128;0;6340;3;2;
/org.eclipse.pde.ui/sandbox/org/eclipse/pde/internal/ui/editor/standalone/site/SiteEditorUtil.java;1;0;2;1;0;0;0;2;0;1;2;2320;0;0;1;0;0;2;2;2320;0;2906;2;1;
/org.eclipse.ui.ide/extensions/org/eclipse/ui/actions/ResourceSelectionListenerAction.java;1;0;2;1;0;0;0;2;0;1;2;2263;0;0;1;0;0;2;2;2263;0;2611;2;1;
/org.eclipse.jdt.debug.tests/tests/org/eclipse/jdt/debug/tests/core/ConsoleTests.java;1;0;1;1;1;1;1;0;0;0;0;5463;0;0;1;0;0;0;1;5463;0;5463;1;1;
/org.eclipse.swt.graphics.text/Eclipse SWT/win32/org/eclipse/swt/graphics/TextLayout.java;1;0;2;1;0;0;0;2;190;1;2;4830;190;190;1;0;0;2;2;4830;0;4896;2;1;
/org.eclipse.jdt.core.tests.model/workspace/Converter/src/test0490/B.java;1;0;1;1;0;0;0;1;0;0;1;3714;0;0;1;0;0;1;1;3714;0;3714;1;1;
/org.eclipse.jdt.core/codeassist/org/eclipse/jdt/internal/codeassist/complete/CompletionOnFieldType.java;2;0;2;1;0;0;0;2;4;1;2;991;6;6;1;0;0;2;2;991;0;3560;2;2;
/org.eclipse.ui.workbench/Eclipse UI/org/eclipse/ui/internal/ObjectActionContributorManager.java;1;0;2;1;0;0;0;2;21;1;2;2737;23;23;1;0;0;2;2;2737;0;3150;2;1;
/org.eclipse.ui.ide/src/org/eclipse/ui/wizards/datatransfer/WizardExternalProjectImportPage.java;4;1;4;1;2;2;2;2;6;1;2;1511;9;9;1;0;0;2;4;1511;0;6338;4;4;
/org.eclipse.search/search/org/eclipse/search/internal/core/text/ITextSearchResultCollector.java;2;1;2;1;2;2;2;0;4;0;0;5636;6;6;1;0;0;0;2;5636;0;6340;2;2;
/org.eclipse.jdt.ui/ui/org/eclipse/jdt/internal/ui/text/correction/ProblemLocation.java;2;0;6;1;1;1;1;5;21;1;5;1034;50;50;1;0;0;5;6;1034;0;6340;6;2;
/org.eclipse.pde/src/org/eclipse/pde/internal/SiteProject.java;1;0;2;1;1;1;1;1;4;0;1;4203;6;6;1;0;0;1;2;4203;0;6336;2;1;
/org.eclipse.swt/Eclipse SWT Accessibility/gtk/org/eclipse/swt/accessibility/AccessibleFactory.java;3;1;15;1;2;2;2;13;261;2;11;1104;708;708;2;2;0;13;15;1133;2;6352;13;3;
/org.eclipse.jdt.core/dom/org/eclipse/jdt/core/dom/InternalASTRewrite.java;2;0;4;2;0;0;0;4;16;2;3;4711;33;33;2;1;0;4;4;4711;1;5090;3;2;
/org.eclipse.jdt.core.tests.model/workspace/Converter/test0448/A.java;1;0;1;1;0;0;0;1;0;0;1;3714;0;0;1;0;0;1;1;3714;0;3714;1;1;
/org.eclipse.ui.workbench/Eclipse UI/org/eclipse/ui/activities/IActivityBinding.java;1;0;2;1;0;0;0;2;0;1;2;2867;0;0;1;0;0;2;2;2867;0;2896;2;1;
/org.eclipse.ant.ui/Ant Editor/org/eclipse/ant/ui/internal/editor/text/XMLTextHover.java;1;0;2;1;0;0;0;2;0;1;2;250;0;0;1;0;0;2;2;250;0;1811;2;1;
/org.eclipse.jface/src/org/eclipse/jface/viewers/ViewerDropAdapter.java;2;0;2;1;0;0;0;2;92;1;2;1;100;100;1;0;0;2;2;1;0;192;2;2;
/org.eclipse.ui.workbench/Eclipse UI/org/eclipse/ui/internal/decorators/DecorationReference.java;2;0;2;1;1;1;1;1;42;0;1;4050;44;44;1;0;0;1;2;4050;0;6338;2;2;
/org.eclipse.ant.ui/Ant Editor/org/eclipse/ant/ui/internal/editor/text/AnnotationType.java;1;0;2;1;0;0;0;2;0;1;2;250;0;0;1;0;0;2;2;250;0;1673;2;1;
/org.eclipse.jdt.ui/core refactoring/org/eclipse/jdt/internal/corext/refactoring/typeconstraints/ExtractInterfaceUtil.java;2;0;8;1;0;0;0;8;240;2;6;42;356;356;2;2;0;8;8;50;2;1164;6;2;
/org.eclipse.ui.externaltools/External Tools Base/org/eclipse/ui/externaltools/internal/model/IPreferenceConstants.java;2;1;3;1;2;2;2;1;15;0;1;282;32;32;1;0;0;1;3;282;0;6336;3;2;
/org.eclipse.swt/Eclipse SWT AWT/win32/org/eclipse/swt/internal/awt/win32/SWT_AWT.java;2;0;5;1;0;0;0;5;46;1;5;517;110;110;1;0;0;5;5;517;0;1650;5;2;
/org.eclipse.core.runtime/src/org/eclipse/core/internal/jobs/ImplicitJobs.java;3;1;49;1;12;12;12;37;606;2;30;1541;2636;2636;2;7;0;37;49;1541;7;6220;42;3;
/org.eclipse.jdt.core/model/org/eclipse/jdt/internal/core/JavaModel.java;2;0;15;2;1;1;1;14;198;2;13;576;306;306;2;1;0;14;15;1948;1;5185;14;2;
/org.eclipse.jdt.ui.tests.refactoring/resources/InlineMethodWorkspace/TestCases/controlStatement_out/TestIfThenTwo.java;2;0;2;1;0;0;0;2;10;1;2;845;14;14;1;0;0;2;2;845;0;1805;2;2;
/org.eclipse.jdt.core/codeassist/org/eclipse/jdt/internal/codeassist/select/SelectionOnSuperReference.java;2;0;2;1;0;0;0;2;10;1;2;991;12;12;1;0;0;2;2;991;0;3560;2;2;
/org.eclipse.jdt.core/eval/org/eclipse/jdt/internal/eval/CodeSnippetSingleNameReference.java;3;0;6;2;0;0;0;6;150;2;5;49;312;312;2;1;0;6;6;1855;1;3560;5;3;
/org.eclipse.text/src/org/eclipse/jface/text/templates/ITemplateEditor.java;1;0;2;1;0;0;0;2;0;1;2;4259;0;0;1;0;0;2;2;4259;0;4382;2;1;
/org.eclipse.jface/src/org/eclipse/jface/dialogs/ProgressMonitorDialog.java;4;1;18;1;6;6;6;12;787;2;10;2202;1120;1120;2;2;0;12;18;2334;2;5615;16;4;
/org.eclipse.swt/Eclipse SWT Browser/common/org/eclipse/swt/browser/VisibilityListener.java;1;0;3;1;0;0;0;3;2;1;3;2849;2;2;1;0;0;3;3;2849;0;3166;3;1;
/org.eclipse.swt/Eclipse SWT PI/win32/org/eclipse/swt/internal/ole/win32/OLECMD.java;1;0;1;1;0;0;0;1;1;0;1;2915;1;1;1;0;0;1;1;2915;0;2915;1;1;
/org.eclipse.ui.externaltools/Ant Tools Support/org/eclipse/ui/externaltools/internal/ant/view/elements/RootNode.java;1;0;1;1;0;0;0;1;0;0;1;282;0;0;1;0;0;1;1;282;0;282;1;1;
/org.eclipse.debug.ui/ui/org/eclipse/debug/ui/launchVariables/ProjectExpander.java;1;0;2;1;0;0;0;2;0;1;2;550;0;0;1;0;0;2;2;550;0;562;2;1;
/org.eclipse.jdt.ui/core refactoring/org/eclipse/jdt/internal/corext/refactoring/tagging/IReferenceUpdating.java;2;0;2;1;1;1;1;1;2;0;1;1125;2;2;1;0;0;1;2;1125;0;6340;2;2;
/org.eclipse.jdt.core/dom/org/eclipse/jdt/core/dom/VariableDeclaration.java;2;0;2;1;0;0;0;2;2;1;2;3560;4;4;1;0;0;2;2;3560;0;4202;2;2;
/org.eclipse.jdt.ui.tests.refactoring/resources/ExtractMethodWorkSpace/ExtractMethodTests/expression_out/A_test609.java;1;0;4;1;0;0;0;4;4;1;4;130;5;5;1;0;0;4;4;130;0;1474;4;1;
/org.eclipse.jdt.core.tests.model/workspace/Formatter/test226/A_in.java;1;0;1;1;0;0;0;1;0;0;1;2426;0;0;1;0;0;1;1;2426;0;2426;1;1;
/org.eclipse.team.tests.cvs.core/src/org/eclipse/team/tests/ccvs/core/provider/SyncElementTest.java;1;0;3;1;0;0;0;3;16;1;3;994;22;22;1;0;0;3;3;994;0;2863;3;1;
/org.eclipse.swt/Eclipse SWT PI/win32/org/eclipse/swt/internal/win32/LOGFONTA.java;1;0;1;1;0;0;0;1;0;0;1;957;0;0;1;0;0;1;1;957;0;957;1;1;
/org.eclipse.ui.workbench/Eclipse UI/org/eclipse/ui/internal/csm/commands/AbstractMutableCommandRegistry.java;1;0;5;1;0;0;0;5;21;3;2;2532;27;27;3;3;0;5;5;2553;3;2553;2;1;
/org.eclipse.jdt.ui/ui refactoring/org/eclipse/jdt/internal/ui/refactoring/ChangeTypeWizard.java;2;1;11;1;2;2;2;9;48;1;9;2844;151;151;1;0;0;9;11;2844;0;6340;11;2;
/org.eclipse.ui.ide/src/org/eclipse/ui/internal/ide/dialogs/AboutPluginsDialog.java;5;1;10;2;2;2;2;8;767;2;7;2264;864;864;2;1;0;8;10;4559;1;5483;9;5;
/org.eclipse.swt.graphics.text/Eclipse SWT Custom Widgets/common/org/eclipse/swt/custom/DisplayRenderer.java;1;0;5;1;0;0;0;5;86;1;5;3889;119;119;1;0;0;5;5;3889;0;4830;5;1;
/org.eclipse.jdt.core.tests.model/workspace/Converter/test0220/Test.java;1;0;1;1;0;0;0;1;0;0;1;3714;0;0;1;0;0;1;1;3714;0;3714;1;1;
/org.eclipse.ui.ide/src/org/eclipse/ui/internal/dialogs/WelcomeEditorActionContributor.java;2;0;3;1;0;0;0;3;3;1;3;1526;3;3;1;0;0;3;3;1526;0;2263;3;2;
/org.eclipse.team.ui/src/org/eclipse/team/ui/sync/ISynchronizeParticipantListener.java;1;0;1;1;0;0;0;1;0;0;1;2463;0;0;1;0;0;1;1;2463;0;2463;1;1;
/org.eclipse.ui.workbench/Eclipse UI/org/eclipse/ui/internal/roles/ExtensionCategoryRegistry.java;1;0;2;1;0;0;0;2;0;0;1;2864;0;0;2;1;0;2;2;2864;1;2864;1;1;
/org.eclipse.jdt.core/model/org/eclipse/jdt/internal/core/JavaElement.java;3;1;30;1;6;6;6;24;126;2;20;85;631;631;2;4;0;24;30;1089;4;5913;26;3;
/org.eclipse.osgi/resolver/src/org/eclipse/osgi/internal/resolver/StateHelperImpl.java;3;1;7;1;4;4;4;3;38;1;3;4514;78;78;1;0;0;3;7;4514;0;5537;7;3;
/org.eclipse.jdt.core/compiler/org/eclipse/jdt/internal/compiler/lookup/ProblemReasons.java;1;0;1;1;0;0;0;1;2;0;1;3560;2;2;1;0;0;1;1;3560;0;3560;1;1;
/org.eclipse.pde.ui/src_Forms/org/eclipse/pde/internal/ui/neweditor/context/IInputContextListener.java;2;0;2;1;1;1;1;1;0;0;1;4243;0;0;1;0;0;1;2;4243;0;5431;2;2;
/org.eclipse.osgi/resolver/src/org/eclipse/core/dependencies/IDependencySystem.java;3;1;3;1;2;2;2;1;16;0;1;3013;16;16;1;0;0;1;3;3013;0;5226;3;3;
/org.eclipse.ui.workbench/Eclipse UI/org/eclipse/ui/internal/contexts/ContextRegistryEvent.java;1;0;10;1;0;0;0;10;15;4;6;1388;33;33;4;4;0;10;10;1396;4;3066;6;1;
/org.eclipse.jdt.ui.tests.refactoring/resources/ExtractMethodWorkSpace/ExtractMethodTests/return_in/A_test708.java;1;0;1;1;0;0;0;1;4;0;1;844;4;4;1;0;0;1;1;844;0;844;1;1;
/org.eclipse.jdt.ui.tests/ui/org/eclipse/jdt/ui/tests/search/WorkspaceScopeTest.java;1;0;2;1;1;1;1;1;10;0;1;3940;10;10;1;0;0;1;2;3940;0;5531;2;1;
/org.eclipse.ui.examples.javaeditor/Eclipse Java Editor Example/org/eclipse/ui/examples/javaeditor/spelling/RankedWordProposal.java;1;0;1;1;0;0;0;1;0;0;1;2565;0;0;1;0;0;1;1;2565;0;2565;1;1;
/org.eclipse.jface/src/org/eclipse/jface/progress/IBackgroundRunnableContext.java;1;0;3;1;0;0;0;3;37;1;3;848;37;37;1;0;0;3;3;848;0;955;3;1;
/org.eclipse.text/src/org/eclipse/jface/text/ISlaveDocumentManagerExtension.java;1;0;2;1;1;1;1;1;11;0;1;4710;11;11;1;0;0;1;2;4710;0;6297;2;1;
/org.eclipse.jdt.core.tests.model/workspace/Converter/test0302/Test.java;1;0;1;1;0;0;0;1;0;0;1;3714;0;0;1;0;0;1;1;3714;0;3714;1;1;
/org.eclipse.jdt.ui/ui/org/eclipse/jdt/internal/ui/text/template/TemplateContentProvider.java;1;0;1;1;0;0;0;1;0;0;1;4258;0;0;1;0;0;1;1;4258;0;4258;1;1;
/org.eclipse.jdt.debug.ui/ui/org/eclipse/jdt/debug/ui/launchConfigurations/JavaMainTab.java;4;1;13;1;2;2;2;11;160;2;9;1192;356;356;2;2;0;11;13;4188;2;6336;11;4;
/org.eclipse.jdt.ui.tests.refactoring/resources/InlineMethodWorkspace/TestCases/nameconflict_in/TestFieldInType.java;1;0;1;1;0;0;0;1;2;0;1;845;2;2;1;0;0;1;1;845;0;845;1;1;
/org.eclipse.jdt.core.tests.model/workspace/Converter/src/test0148/Test.java;1;0;1;1;0;0;0;1;0;0;1;3714;0;0;1;0;0;1;1;3714;0;3714;1;1;
/org.eclipse.jdt.ui.tests.refactoring/resources/InlineMethodWorkspace/TestCases/expression_out/TestSimpleExpressionWithStatements.java;1;0;1;1;0;0;0;1;2;0;1;845;2;2;1;0;0;1;1;845;0;845;1;1;
/org.eclipse.jdt.core.tests.model/workspace/Formatter/test245/A_in.java;1;0;1;1;0;0;0;1;0;0;1;2437;0;0;1;0;0;1;1;2437;0;2437;1;1;
/org.eclipse.team.cvs.ui/src/org/eclipse/team/internal/ccvs/ui/operations/UpdateOnlyMergableOperation.java;2;1;11;1;3;3;3;8;93;1;8;721;195;195;1;0;0;8;11;721;0;6337;11;2;
/org.eclipse.core.runtime/src/org/eclipse/core/internal/registry/ConfigurationElement.java;5;2;20;2;11;10;11;9;853;2;8;3049;1040;1040;2;1;1;9;20;3164;2;6340;18;5;
/org.eclipse.jdt.core/codeassist/org/eclipse/jdt/internal/codeassist/complete/CompletionNodeFound.java;2;0;2;1;0;0;0;2;8;1;2;2974;10;10;1;0;0;2;2;2974;0;3560;2;2;
/org.eclipse.team.ui/src/org/eclipse/team/internal/ui/synchronize/actions/GlobalSynchronizeWizard.java;1;0;1;1;0;0;0;1;0;0;1;4389;0;0;1;0;0;1;1;4389;0;4389;1;1;
/org.eclipse.jdt.debug.ui/ui/org/eclipse/jdt/internal/debug/ui/classpath/ClasspathGroup.java;3;0;3;1;1;1;1;2;7;1;2;2691;11;11;1;0;0;2;3;2691;0;6336;3;3;
/org.eclipse.jdt.core/model/org/eclipse/jdt/core/util/IAnnotationDefaultAttribute.java;2;0;2;1;0;0;0;2;30;1;2;4515;30;30;1;0;0;2;2;4515;0;4843;2;2;
/org.eclipse.jdt.core/search/org/eclipse/jdt/core/search/IJavaSearchScope.java;4;1;7;1;3;3;3;4;20;1;4;3240;69;69;1;0;0;4;7;3240;0;5871;7;4;
/org.eclipse.update.core/src/org/eclipse/update/core/JarEntryContentReference.java;3;1;5;1;3;3;3;2;6;1;2;7;21;21;1;0;0;2;5;7;0;6336;5;3;
/org.eclipse.ui.workbench/Eclipse UI/org/eclipse/ui/internal/roles/ActivityContentProvider.java;2;0;2;1;0;0;0;2;0;1;2;2279;0;0;1;0;0;2;2;2279;0;2443;2;2;
/org.eclipse.ui.workbench.texteditor/src/org/eclipse/ui/texteditor/AnnotationPreference.java;3;2;14;2;5;4;5;9;529;1;9;1539;1206;1206;2;0;1;9;14;6334;1;6334;13;3;
/org.eclipse.core.expressions/src/org/eclipse/core/expressions/IEvaluationContext.java;1;1;6;1;3;3;3;3;8;1;3;4108;22;22;1;0;0;3;6;4108;0;6301;6;1;
/org.eclipse.jdt.ui/ui refactoring/org/eclipse/jdt/internal/ui/refactoring/reorg/RenameInputWizardPage2.java;1;0;3;1;0;0;0;3;36;2;2;1047;36;36;2;1;0;3;3;1125;1;1125;2;1;
/org.eclipse.ui.intro/src/org/eclipse/ui/intro/config/IIntroAction.java;2;1;3;1;3;3;3;0;14;0;0;5277;18;18;1;0;0;0;3;5277;0;5315;3;2;
/org.eclipse.swt.tests/JUnit Tests/org/eclipse/swt/tests/junit/Test_org_eclipse_swt_accessibility_AccessibleTextEvent.java;1;0;3;1;1;1;1;2;19;1;2;3373;23;23;1;0;0;2;3;3373;0;6352;3;1;
/org.eclipse.jdt.core.tests.model/workspace/Formatter/test325/A_in.java;1;0;1;1;0;0;0;1;0;0;1;2528;0;0;1;0;0;1;1;2528;0;2528;1;1;
/org.eclipse.ui.workbench/Eclipse UI/org/eclipse/ui/internal/commands/old/ImageBinding.java;1;0;1;1;0;0;0;1;0;0;1;1321;0;0;1;0;0;1;1;1321;0;1321;1;1;
/org.eclipse.core.runtime/src/org/eclipse/core/internal/plugins/PluginClassLoader.java;2;0;7;1;0;0;0;7;27;2;6;407;56;56;2;1;0;7;7;1170;1;3013;6;2;
/org.eclipse.jdt.junit/src/org/eclipse/jdt/internal/junit/ui/EnableStackFilterAction.java;3;1;3;1;2;2;2;1;4;0;1;4985;8;8;1;0;0;1;3;4985;0;6340;3;3;
/org.eclipse.jdt.ui.tests.refactoring/resources/MoveMembers/test27/in/A.java;1;0;1;1;0;0;0;1;0;0;1;1522;0;0;1;0;0;1;1;1522;0;1522;1;1;
/org.eclipse.ui.workbench.texteditor/src/org/eclipse/ui/texteditor/WorkbenchChainedTextFontFieldEditor.java;1;1;2;1;2;2;2;0;2;0;0;5632;3;3;1;0;0;0;2;5632;0;6340;2;1;
/org.eclipse.jdt.ui.tests/examples/org/eclipse/jdt/ui/examples/MyQuickFixProcessor.java;2;0;2;1;1;1;1;1;2;0;1;1238;2;2;1;0;0;1;2;1238;0;6340;2;2;
/org.eclipse.ui.externaltools/External Tools Base/org/eclipse/ui/externaltools/internal/launchConfigurations/ExternalToolsRefreshTab.java;2;0;10;1;0;0;0;10;28;3;7;163;66;66;3;3;0;10;10;321;3;728;7;2;
/org.eclipse.swt.tests/JUnit Tests/org/eclipse/swt/tests/junit/Test_org_eclipse_swt_custom_CTabItem.java;2;0;2;1;0;0;0;2;12;1;2;2104;20;20;1;0;0;2;2;2104;0;3373;2;2;
/org.eclipse.jdt.ui/ui/org/eclipse/jdt/internal/ui/javaeditor/JavaSelectAnnotationRulerAction.java;2;1;5;1;2;2;2;3;55;1;3;4940;65;65;1;0;0;3;5;4940;0;6340;5;2;
/org.eclipse.team.cvs.ui/src/org/eclipse/team/internal/ccvs/ui/subscriber/UpdateDialog.java;2;0;10;1;1;1;1;9;180;2;8;709;376;376;2;1;0;9;10;1132;1;6337;9;2;
/org.eclipse.team.examples.filesystem/src/org/eclipse/team/examples/pessimistic/ui/AddToControlAction.java;1;0;2;1;1;1;1;1;83;0;1;3368;83;83;1;0;0;1;2;3368;0;6103;2;1;
/org.eclipse.ui.workbench/Eclipse UI/org/eclipse/ui/internal/EditorsDropDownAction.java;2;0;4;1;0;0;0;4;10;1;4;2620;13;13;1;0;0;4;4;2620;0;4687;4;2;
/org.eclipse.jdt.ui/ui/org/eclipse/jdt/internal/ui/wizards/JavaCapabilityWizard.java;1;0;2;1;0;0;0;2;2;1;2;2321;2;2;1;0;0;2;2;2321;0;3955;2;1;
/org.eclipse.jdt.ui.tests.refactoring/resources/ExtractTemp/canExtract/A_testZeroLengthSelection0_out.java;1;0;1;1;0;0;0;1;0;0;1;1684;0;0;1;0;0;1;1;1684;0;1684;1;1;
/org.eclipse.swt/Eclipse SWT/common/org/eclipse/swt/graphics/Rectangle.java;3;1;4;1;2;2;2;2;62;1;2;1657;86;86;1;0;0;2;4;1657;0;6352;4;3;
/org.eclipse.jdt.ui/core refactoring/org/eclipse/jdt/internal/corext/refactoring/tagging/IQualifiedNameUpdatingRefactoring.java;1;0;1;1;1;1;1;0;2;0;0;6340;2;2;1;0;0;0;1;6340;0;6340;1;1;
/org.eclipse.jdt.core/compiler/org/eclipse/jdt/internal/compiler/lookup/Scope.java;4;2;33;1;9;8;9;24;531;3;17;10;2145;2145;3;7;1;24;33;10;8;6316;25;4;
/org.eclipse.team.cvs.ui/src/org/eclipse/team/internal/ccvs/ui/sync/ForceCommitSyncAction.java;2;0;2;1;0;0;0;2;2;1;2;866;2;2;1;0;0;2;2;866;0;4217;2;2;
/org.eclipse.update.tests.core/src/org/eclipse/update/tests/types/TestFeatureType.java;2;0;3;1;1;1;1;2;22;1;2;3813;34;34;1;0;0;2;3;3813;0;6336;3;2;
/org.eclipse.pde.core/src_OSGi/org/eclipse/pde/internal/core/osgi/bundle/BundleObject.java;2;0;2;1;0;0;0;2;0;1;2;2229;0;0;1;0;0;2;2;2229;0;4203;2;2;
/org.eclipse.jdt.junit/src/org/eclipse/jdt/internal/junit/ui/ITestRunListener2.java;2;1;3;1;2;2;2;1;2;0;1;417;6;6;1;0;0;1;3;417;0;6340;3;2;
/org.eclipse.pde.ui/src_Forms/org/eclipse/pde/internal/ui/neweditor/site/SiteSourcePage.java;2;1;3;1;2;2;2;1;15;0;1;4832;15;15;1;0;0;1;3;4832;0;5431;3;2;
/org.eclipse.update.ui/srcnew/org/eclipse/update/internal/ui/views/SiteStateAction.java;2;0;2;1;0;0;0;2;0;1;2;767;0;0;1;0;0;2;2;767;0;825;2;2;
/org.eclipse.debug.ui/ui/org/eclipse/debug/internal/ui/views/variables/VariablesContentProviderManager.java;2;0;4;1;0;0;0;4;9;1;4;534;11;11;1;0;0;4;4;534;0;861;4;2;
/org.eclipse.jdt.ui.tests.refactoring/test cases/org/eclipse/jdt/ui/tests/reorg/PasteSourceReferenceActionTests.java;1;0;2;1;0;0;0;2;0;1;2;1111;0;0;1;0;0;2;2;1111;0;1311;2;1;
/org.eclipse.jdt.junit/src/org/eclipse/jdt/internal/junit/wizards/UpdateTestSuite.java;2;1;2;1;2;2;2;0;41;0;0;5112;43;43;1;0;0;0;2;5112;0;6340;2;2;
/org.eclipse.jdt.core/dom/org/eclipse/jdt/core/dom/BooleanLiteral.java;3;0;6;1;1;1;1;5;65;1;5;3560;77;77;1;0;0;5;6;3560;0;5272;6;3;
/org.eclipse.jdt.ui.tests.refactoring/resources/ChangeTypeRefactoring/positive/A_testFieldName_in.java;1;0;1;1;0;0;0;1;0;0;1;2844;0;0;1;0;0;1;1;2844;0;2844;1;1;
/org.eclipse.jdt.ui.tests.refactoring/resources/RenameType/test57/out/B.java;1;0;1;1;0;0;0;1;3;0;1;4577;3;3;1;0;0;1;1;4577;0;4577;1;1;
/org.eclipse.swt/Eclipse SWT/common/org/eclipse/swt/internal/image/PngHuffmanTable.java;1;0;1;1;0;0;0;1;2;0;1;2160;2;2;1;0;0;1;1;2160;0;2160;1;1;
/org.eclipse.team.ui/src/org/eclipse/team/internal/ui/sync/actions/ExpandAllAction.java;1;0;4;1;0;0;0;4;16;1;4;848;19;19;1;0;0;4;4;848;0;2632;4;1;
/org.eclipse.jdt.ui/core refactoring/org/eclipse/jdt/internal/corext/refactoring/reorg/JavaDeleteProcessor.java;3;1;24;2;8;8;8;16;105;2;15;1668;425;425;2;1;0;16;24;5052;1;6340;23;3;
/org.eclipse.jdt.core/codeassist/org/eclipse/jdt/internal/codeassist/complete/InvalidCursorLocation.java;1;0;1;1;0;0;0;1;2;0;1;3560;2;2;1;0;0;1;1;3560;0;3560;1;1;
/org.eclipse.jdt.core/dom/org/eclipse/jdt/core/dom/QualifiedType.java;4;2;13;1;5;4;5;8;198;1;8;2867;359;359;2;0;1;8;13;5268;1;6336;12;4;
/org.eclipse.ui.workbench/Eclipse UI/org/eclipse/ui/internal/activities/PatternBindingDefinition.java;1;0;4;1;0;0;0;4;66;1;4;2533;113;113;1;0;0;4;4;2533;0;2896;4;1;
/org.eclipse.debug.core/core/org/eclipse/debug/internal/core/LaunchConfiguration.java;4;0;19;2;1;1;1;18;115;3;14;463;315;315;3;4;0;18;19;1657;4;6336;15;4;
/org.eclipse.ant.ui/Ant Tools Support/org/eclipse/ant/ui/internal/model/AntUIImages.java;1;0;5;1;0;0;0;5;20;3;3;262;22;22;3;2;0;5;5;262;2;1811;3;1;
/org.eclipse.ui.workbench/Eclipse UI/org/eclipse/ui/internal/csm/activities/service/IActivityServiceListener.java;1;0;2;1;0;0;0;2;0;1;2;2370;0;0;1;0;0;2;2;2370;0;2444;2;1;
/org.eclipse.ui.intro/src/org/eclipse/ui/intro/internal/IIntroConstants.java;1;0;5;1;1;1;1;4;23;1;4;4429;26;26;1;0;0;4;5;4429;0;5115;5;1;
/org.eclipse.pde.ui/src/org/eclipse/pde/internal/ui/wizards/tools/MigratePluginWizard.java;2;2;9;1;7;6;7;2;58;1;2;3840;126;126;2;0;1;2;9;6149;1;6336;8;2;
/org.eclipse.jdt.core/model/org/eclipse/jdt/internal/core/CreateFieldOperation.java;3;1;6;1;2;2;2;4;19;1;4;377;30;30;1;0;0;4;6;377;0;5916;6;3;
/org.eclipse.jdt.core.tests.model/workspace/Converter/src/test0229/Test.java;1;0;1;1;0;0;0;1;0;0;1;3714;0;0;1;0;0;1;1;3714;0;3714;1;1;
/org.eclipse.jdt.core.tests.model/workspace/Formatter/test420/A_in.java;1;0;1;1;0;0;0;1;0;0;1;3475;0;0;1;0;0;1;1;3475;0;3475;1;1;
/org.eclipse.team.ui/src/org/eclipse/team/internal/ui/synchronize/SyncChangesTreeViewer.java;1;0;1;1;0;0;0;1;0;0;1;3221;0;0;1;0;0;1;1;3221;0;3221;1;1;
/org.eclipse.jdt.ui.tests.refactoring/resources/DeleteSourceReference/test8/in/A.java;1;0;1;1;0;0;0;1;0;0;1;1652;0;0;1;0;0;1;1;1652;0;1652;1;1;
/org.eclipse.jdt.ui.tests.refactoring/resources/SurroundWithWorkSpace/SurroundWithTests/trycatch_in/TestSuperCall.java;1;0;1;1;0;0;0;1;2;0;1;845;2;2;1;0;0;1;1;845;0;845;1;1;
/org.eclipse.jdt.launching/launching/org/eclipse/jdt/internal/launching/JavaApplicationSourcePathComputer.java;1;0;5;1;0;0;0;5;33;1;5;4109;46;46;1;0;0;5;5;4109;0;4971;5;1;
/org.eclipse.team.webdav/src/org/eclipse/team/internal/ui/target/UploadAction.java;2;0;3;1;0;0;0;3;5;1;3;2495;5;5;1;0;0;3;3;2495;0;4216;3;2;
/org.eclipse.jdt.core.tests.model/workspace/Formatter/test295/A_in.java;1;0;1;1;0;0;0;1;0;0;1;2444;0;0;1;0;0;1;1;2444;0;2444;1;1;
/org.eclipse.swt.tests/JUnit Tests/org/eclipse/swt/tests/junit/browser/Browser4.java;1;0;3;1;0;0;0;3;14;2;2;3011;14;14;2;1;0;3;3;3166;1;3166;2;1;
/org.eclipse.jdt.ui.tests.refactoring/resources/IntroduceFactory/positive/DifferentArgs2_in.java;1;0;2;1;1;1;1;1;2;0;1;2862;2;2;1;0;0;1;2;2862;0;5659;2;1;
/org.eclipse.core.tests.resources/src/org/eclipse/core/tests/resources/regression/NLTest.java;1;0;2;1;2;1;2;0;194;0;0;5147;194;194;2;0;1;0;2;5147;1;5147;1;1;
/org.eclipse.update/src/org/eclipse/update/internal/ui/KeyStores.java;1;0;1;1;1;1;1;0;0;0;0;6339;0;0;1;0;0;0;1;6339;0;6339;1;1;
/org.eclipse.jdt.core.tests.model/workspace/JavaSearch/src/j4/FC47209.java;1;0;1;1;0;0;0;1;0;0;1;3330;0;0;1;0;0;1;1;3330;0;3330;1;1;
/org.eclipse.jdt.ui.tests.refactoring/test cases/org/eclipse/jdt/ui/tests/refactoring/TestCreateParticipantSingle.java;2;0;2;1;1;1;1;1;8;0;1;4913;8;8;1;0;0;1;2;4913;0;6340;2;2;
/org.eclipse.jdt.core.tests.model/workspace/Converter/src/test0466/Assert.java;1;0;1;1;0;0;0;1;0;0;1;3714;0;0;1;0;0;1;1;3714;0;3714;1;1;
/org.eclipse.ui.workbench/Eclipse UI/org/eclipse/ui/internal/csm/activities/ActivityContentProvider.java;1;0;2;1;0;0;0;2;0;0;1;2443;0;0;2;1;0;2;2;2443;1;2443;1;1;
/org.eclipse.update.core/src/org/eclipse/update/core/IInstalledSite.java;1;0;1;1;0;0;0;1;0;0;1;2634;0;0;1;0;0;1;1;2634;0;2634;1;1;
/org.eclipse.jdt.core.tests.model/workspace/Converter/src/codeManipulation/bug.java;1;0;1;1;0;0;0;1;0;0;1;3714;0;0;1;0;0;1;1;3714;0;3714;1;1;
/org.eclipse.ui.workbench/Eclipse UI/org/eclipse/ui/instrumentation/IInstrumentationHelpListener.java;1;0;2;1;0;0;0;2;0;1;2;1634;0;0;1;0;0;2;2;1634;0;1686;2;1;
/org.eclipse.ui.examples.javaeditor/Template Editor Example/org/eclipse/ui/examples/templateeditor/editors/TemplateEditor.java;2;1;4;1;2;2;2;2;10;1;2;4644;16;16;1;0;0;2;4;4644;0;6340;4;2;
/org.eclipse.jface.text/src/org/eclipse/jface/text/ITextViewerExtension4.java;2;0;4;2;2;1;2;2;42;1;2;1213;62;62;2;0;1;2;4;6340;1;6340;3;2;
/org.eclipse.jdt.ui.tests.refactoring/resources/Delete/testDeleteWithinCu15/in/A.java;1;0;1;1;0;0;0;1;0;0;1;442;0;0;1;0;0;1;1;442;0;442;1;1;
/org.eclipse.core.tests.resources/src/org/eclipse/core/tests/resources/session/TestMultiSnap.java;1;0;1;1;1;1;1;0;87;0;0;5147;87;87;1;0;0;0;1;5147;0;5147;1;1;
/org.eclipse.jdt.ui/core refactoring/org/eclipse/jdt/internal/corext/refactoring/base/IRefactoring.java;1;0;1;1;0;0;0;1;0;0;1;3536;0;0;1;0;0;1;1;3536;0;3536;1;1;
/org.eclipse.jdt.core.tests.model/workspace/Formatter/test124/A_in.java;1;0;1;1;0;0;0;1;0;0;1;2425;0;0;1;0;0;1;1;2425;0;2425;1;1;
/org.eclipse.releng.basebuilder/plugins/org.eclipse.build.tools/src/org/eclipse/releng/ElementParser.java;1;0;2;1;0;0;0;2;19;1;2;2748;29;29;1;0;0;2;2;2748;0;3597;2;1;
/org.eclipse.ui.views/src/org/eclipse/ui/views/internal/markers/problems/ProblemFilter.java;1;0;3;1;0;0;0;3;211;1;3;265;211;211;1;0;0;3;3;265;0;749;3;1;
/org.eclipse.core.tests.runtime/src/org/eclipse/core/tests/runtime/content/LocalContentTypeBuilder.java;3;1;4;1;3;3;3;1;4;0;1;4941;7;7;1;0;0;1;4;4941;0;5906;4;3;
/org.eclipse.jdt.core.tests.model/workspace/Converter/src/test0019/Test.java;1;0;1;1;0;0;0;1;0;0;1;3714;0;0;1;0;0;1;1;3714;0;3714;1;1;
/org.eclipse.pde.ui/src_Forms/org/eclipse/pde/internal/ui/neweditor/plugin/ManifestEditor.java;2;2;21;2;7;5;7;14;154;2;13;3769;634;634;2;1;2;14;21;4919;3;5431;18;2;
/org.eclipse.jdt.core.tests.model/workspace/Converter/test0037/Test.java;1;0;1;1;0;0;0;1;0;0;1;3714;0;0;1;0;0;1;1;3714;0;3714;1;1;
/org.eclipse.ui.workbench/Eclipse UI/org/eclipse/ui/internal/activities/ui/ActivityMessages.java;1;0;3;1;0;0;0;3;18;1;3;2444;18;18;1;0;0;3;3;2444;0;3066;3;1;
/org.eclipse.team.cvs.ui/src/org/eclipse/team/internal/ccvs/ui/wizards/KSubstWizardSummaryPage.java;1;0;1;1;0;0;0;1;2;0;1;2381;2;2;1;0;0;1;1;2381;0;2381;1;1;
/org.eclipse.ui.externaltools/Ant Editor/org/eclipse/ui/externaltools/internal/ant/editor/derived/HTMLTextPresenter.java;1;0;1;1;0;0;0;1;0;0;1;282;0;0;1;0;0;1;1;282;0;282;1;1;
/org.eclipse.pde.ui/sandbox/org/eclipse/pde/internal/ui/editor/standalone/extensions/ExtensionsContentProvider.java;1;0;2;1;0;0;0;2;0;1;2;2320;0;0;1;0;0;2;2;2320;0;2906;2;1;
/org.eclipse.core.runtime/src/org/eclipse/core/internal/dependencies/IElementSet.java;2;0;2;1;0;0;0;2;0;1;2;2105;0;0;1;0;0;2;2;2105;0;3013;2;2;
/org.eclipse.jdt.debug.tests/tests/org/eclipse/jdt/debug/tests/core/ArchiveSourceContainerTests.java;1;0;3;1;0;0;0;3;34;1;3;4091;34;34;1;0;0;3;3;4091;0;4652;3;1;
/org.eclipse.ui.workbench.texteditor/src/org/eclipse/ui/texteditor/AbstractDocumentProvider.java;3;2;14;2;5;4;5;9;172;1;9;1237;378;378;2;0;1;9;14;6334;1;6334;13;3;
/org.eclipse.swt/Eclipse SWT/gtk1x/org/eclipse/swt/widgets/Canvas.java;1;0;1;1;0;0;0;1;0;0;1;2327;0;0;1;0;0;1;1;2327;0;2327;1;1;
/org.eclipse.jdt.ui/ui/org/eclipse/jdt/internal/ui/wizards/buildpaths/VariableBlock.java;2;1;8;1;2;2;2;6;99;1;6;1350;241;241;1;0;0;6;8;1350;0;6340;8;2;
/org.eclipse.update.core/src/org/eclipse/update/core/JarContentReference.java;3;2;6;1;4;3;4;2;10;1;2;7;35;35;2;0;1;2;6;5664;1;6336;5;3;
/org.eclipse.update.configurator/src/org/eclipse/update/internal/configurator/BootDescriptor.java;1;0;2;1;0;0;0;2;2;1;2;3243;2;2;1;0;0;2;2;3243;0;4095;2;1;
/org.eclipse.ui.workbench/Eclipse UI/org/eclipse/ui/internal/decorators/LightweightActionDescriptor.java;3;0;5;1;1;1;1;4;39;1;4;2737;71;71;1;0;0;4;5;2737;0;6338;5;3;
/org.eclipse.jdt.ui.tests.refactoring/resources/PullUp/testFieldMethod0/out/A.java;1;0;1;1;0;0;0;1;4;0;1;1690;4;4;1;0;0;1;1;1690;0;1690;1;1;
/org.eclipse.jdt.ui.tests.refactoring/resources/ExtractMethodWorkSpace/ExtractMethodTests/expression_out/A_test610.java;1;0;4;1;0;0;0;4;4;1;4;130;5;5;1;0;0;4;4;130;0;1474;4;1;
/org.eclipse.team.examples.filesystem/src/org/eclipse/team/examples/localhistory/RevertAllOperation.java;1;1;2;1;2;2;2;0;2;0;0;6305;2;2;1;0;0;0;2;6305;0;6337;2;1;
/org.eclipse.update.ui/src/org/eclipse/update/internal/ui/model/ISiteAdapter.java;1;0;1;1;0;0;0;1;7;0;1;890;7;7;1;0;0;1;1;890;0;890;1;1;
/org.eclipse.jdt.core.tests.model/workspace/Converter/test0250/Test.java;1;0;1;1;0;0;0;1;0;0;1;3714;0;0;1;0;0;1;1;3714;0;3714;1;1;
/org.eclipse.jdt.ui.tests.refactoring/resources/RenamePrivateField/test4/out/A.java;1;0;1;1;0;0;0;1;10;0;1;4560;10;10;1;0;0;1;1;4560;0;4560;1;1;
/org.eclipse.jdt.core/compiler/org/eclipse/jdt/internal/compiler/DefaultErrorHandlingPolicies.java;1;0;1;1;0;0;0;1;2;0;1;3560;2;2;1;0;0;1;1;3560;0;3560;1;1;
/org.eclipse.pde.core/src/org/eclipse/pde/core/plugin/IPluginObject.java;3;1;6;1;4;4;4;2;72;1;2;2184;102;102;1;0;0;2;6;2184;0;6336;6;3;
/org.eclipse.jdt.core.tests.model/src/org/eclipse/jdt/core/tests/model/TypeResolveTests.java;1;0;2;1;0;0;0;2;13;1;2;3452;15;15;1;0;0;2;2;3452;0;3511;2;1;
/org.eclipse.jdt.core/model/org/eclipse/jdt/internal/core/MovePackageFragmentRootOperation.java;2;0;2;1;0;0;0;2;18;1;2;3034;20;20;1;0;0;2;2;3034;0;3560;2;2;
/org.eclipse.jdt.ui/core extension/org/eclipse/jdt/internal/corext/callhierarchy/IImplementorFinder.java;2;0;2;1;1;1;1;1;2;0;1;155;2;2;1;0;0;1;2;155;0;6340;2;2;
/org.eclipse.team.ftp/src/org/eclipse/team/internal/ftp/target/FTPResourceState.java;1;0;2;1;1;1;1;1;8;0;1;4216;10;10;1;0;0;1;2;4216;0;6337;2;1;
/org.eclipse.jdt.core.tests.model/workspace/Converter15/src/test0008/X.java;1;0;1;1;0;0;0;1;0;0;1;4651;0;0;1;0;0;1;1;4651;0;4651;1;1;
/org.eclipse.team.core/src/org/eclipse/team/internal/core/SaveContextXMLWriter.java;2;0;5;1;0;0;0;5;215;1;5;684;238;238;1;0;0;5;5;684;0;2632;5;2;
/org.eclipse.swt/Eclipse SWT Browser/motif/org/eclipse/swt/browser/WindowCreator.java;3;1;8;1;4;4;4;4;264;1;4;2849;344;344;1;0;0;4;8;2849;0;6352;8;3;
/org.eclipse.ui.workbench/Eclipse UI/org/eclipse/ui/internal/dialogs/ViewSorter.java;1;0;1;1;0;0;0;1;6;0;1;2737;6;6;1;0;0;1;1;2737;0;2737;1;1;
/org.eclipse.help/src/org/eclipse/help/internal/search/DefaultAnalyzer.java;1;0;3;1;0;0;0;3;4;1;3;105;8;8;1;0;0;3;3;105;0;2732;3;1;
/org.eclipse.ui.ide/src/org/eclipse/ui/internal/dialogs/WelcomeItem.java;2;0;2;1;0;0;0;2;0;1;2;1526;0;0;1;0;0;2;2;1526;0;2263;2;2;
/org.eclipse.releng.tools/src/org/eclipse/releng/tools/MapProject.java;2;1;3;1;3;3;3;0;55;0;0;5183;75;75;1;0;0;0;3;5183;0;5463;3;2;
/org.eclipse.core.filebuffers/src/org/eclipse/core/internal/filebuffers/FileBuffer.java;3;0;8;1;0;0;0;8;360;2;7;1522;465;465;2;1;0;8;8;1574;1;2224;7;3;
/org.eclipse.jdt.core/compiler/org/eclipse/jdt/internal/compiler/impl/BooleanConstant.java;4;0;7;1;1;1;1;6;45;2;5;1111;67;67;2;1;0;6;7;2580;1;5587;6;4;
/org.eclipse.jdt.ui.tests.refactoring/resources/RenamePrivateField/test3/out/A.java;1;0;1;1;0;0;0;1;6;0;1;4560;6;6;1;0;0;1;1;4560;0;4560;1;1;
/org.eclipse.ui.ide/src/org/eclipse/ui/views/markers/internal/TaskView.java;5;1;7;1;2;2;2;5;8;2;4;3260;13;13;2;1;0;5;7;3260;1;6338;6;5;
/org.eclipse.jdt.debug/model/org/eclipse/jdt/internal/debug/core/logicalstructures/LogicalObjectStructureInterfaceType.java;3;1;5;1;3;3;3;2;11;1;2;2709;21;21;1;0;0;2;5;2709;0;6336;5;3;
/org.eclipse.text/src/org/eclipse/jface/text/Document.java;1;0;1;1;1;1;1;0;23;0;0;6298;23;23;1;0;0;0;1;6298;0;6298;1;1;
/org.eclipse.swt/Eclipse SWT/emulated/treetable/org/eclipse/swt/widgets/TableColumn.java;4;1;4;1;2;2;2;2;12;1;2;270;26;26;1;0;0;2;4;270;0;6352;4;4;
/org.eclipse.jdt.core.tests.model/workspace/Converter/src/test0415/A.java;1;0;1;1;0;0;0;1;0;0;1;3714;0;0;1;0;0;1;1;3714;0;3714;1;1;
/org.eclipse.help.base/src/org/eclipse/help/internal/workingset/WorkingSetManager.java;1;1;12;1;3;3;3;9;239;3;7;1740;401;401;3;2;0;9;12;1740;2;6337;10;1;
/org.eclipse.search/search/org/eclipse/search/internal/ui/ShowSearchesAction.java;1;0;3;1;1;1;1;2;77;1;2;190;84;84;1;0;0;2;3;190;0;6340;3;1;
/org.eclipse.jdt.ui/core extension/org/eclipse/text/edits/CopyTargetEdit.java;1;0;4;1;0;0;0;4;69;2;3;1953;71;71;2;1;0;4;4;1985;1;1985;3;1;
/org.eclipse.ui.ide/src/org/eclipse/ui/internal/ide/dialogs/AboutFeaturesDialog.java;4;1;9;1;2;2;2;7;1071;1;7;2264;1493;1493;1;0;0;7;9;2264;0;5483;9;4;
/org.eclipse.ui.workbench/Eclipse UI/org/eclipse/ui/internal/commands/old/AbstractRegistry.java;1;0;4;1;0;0;0;4;38;1;4;1322;53;53;1;0;0;4;4;1322;0;1695;4;1;
/org.eclipse.update.ui/src/org/eclipse/update/internal/ui/RestartDialog.java;1;1;3;1;2;2;2;1;4;0;1;4433;8;8;1;0;0;1;3;4433;0;6336;3;1;
/org.eclipse.ui.cheatsheets/src/org/eclipse/ui/internal/cheatsheets/registry/CheatSheetCollectionSorter.java;2;0;2;1;0;0;0;2;17;1;2;4428;17;17;1;0;0;2;2;4428;0;4626;2;2;
/org.eclipse.team.core/src/org/eclipse/team/internal/core/target/AuthenticatedSite.java;1;0;1;1;0;0;0;1;0;0;1;2495;0;0;1;0;0;1;1;2495;0;2495;1;1;
/org.eclipse.team.cvs.core/src/org/eclipse/team/internal/ccvs/core/resources/RemoteModule.java;2;0;5;1;1;1;1;4;10;1;4;866;19;19;1;0;0;4;5;866;0;6337;5;2;
/org.eclipse.ui.forms/src/org/eclipse/ui/forms/widgets/TableWrapLayout.java;1;1;7;1;2;2;2;5;348;1;5;4068;391;391;1;0;0;5;7;4068;0;6336;7;1;
/org.eclipse.jdt.ui/core refactoring/org/eclipse/jdt/internal/corext/refactoring/code/flow/BlockFlowInfo.java;1;0;1;1;1;1;1;0;2;0;0;6340;2;2;1;0;0;0;1;6340;0;6340;1;1;
/org.eclipse.ui.workbench/Eclipse UI/org/eclipse/ui/wizards/newresource/ResourceMessages.java;1;0;1;1;0;0;0;1;0;0;1;2737;0;0;1;0;0;1;1;2737;0;2737;1;1;
/org.eclipse.core.tests.resources/src/org/eclipse/core/tests/internal/builders/SnowBuilder.java;1;0;2;1;2;1;2;0;72;0;0;5147;72;72;2;0;1;0;2;5147;1;5147;1;1;
/org.eclipse.team.ui/src/org/eclipse/team/internal/ui/sync/sets/SubscriberEventHandler.java;2;0;15;2;0;0;0;15;292;2;13;1289;1073;1073;2;2;0;15;15;1932;2;2632;13;2;
/org.eclipse.ant.tests.core/tests/org/eclipse/ant/tests/core/tests/TypeTests.java;1;0;7;1;1;1;1;6;25;1;6;807;52;52;1;0;0;6;7;807;0;6336;7;1;
/org.eclipse.core.resources/src/org/eclipse/core/resources/IResourceDeltaVisitor.java;1;0;2;1;1;1;1;1;20;0;1;4994;22;22;1;0;0;1;2;4994;0;5146;2;1;
/org.eclipse.team.ui/src/org/eclipse/team/internal/ui/TeamPreferencePage.java;1;0;2;1;0;0;0;2;7;1;2;917;7;7;1;0;0;2;2;917;0;993;2;1;
/org.eclipse.ant.ui/Ant Tools Support/org/eclipse/ant/ui/internal/views/elements/TargetNode.java;1;0;2;1;0;0;0;2;0;1;2;250;0;0;1;0;0;2;2;250;0;1811;2;1;
/org.eclipse.text/src/org/eclipse/jface/text/templates/GlobalVariables.java;2;0;4;1;1;1;1;3;36;1;3;4259;43;43;1;0;0;3;4;4259;0;5177;4;2;
/org.eclipse.update.ui.forms/Eclipse Forms/org/eclipse/ui/forms/widgets/ColumnLayoutData.java;1;0;4;1;0;0;0;4;49;1;4;3701;57;57;1;0;0;4;4;3701;0;4157;4;1;
/org.eclipse.jdt.core/compiler/org/eclipse/jdt/internal/compiler/ast/ConditionalExpression.java;2;0;6;1;0;0;0;6;47;1;6;991;108;108;1;0;0;6;6;991;0;3560;6;2;
/org.eclipse.jdt.ui/core refactoring/org/eclipse/jdt/internal/corext/refactoring/participants/xml/SelectionExpression.java;1;0;3;1;0;0;0;3;33;1;3;1668;33;33;1;0;0;3;3;1668;0;2682;3;1;
/org.eclipse.ui.workbench/Eclipse UI/org/eclipse/ui/internal/colors/ColorUtils.java;1;0;2;1;0;0;0;2;0;0;1;4235;0;0;2;1;0;2;2;4235;1;4235;1;1;
/org.eclipse.ui.workbench/Eclipse UI/org/eclipse/ui/internal/EditorSite.java;3;1;7;1;4;4;4;3;34;1;3;2737;71;71;1;0;0;3;7;2737;0;6338;7;3;
/org.eclipse.debug.ui/ui/org/eclipse/debug/ui/variables/ContainerNameExpander.java;1;0;4;1;0;0;0;4;43;3;2;316;43;43;3;2;0;4;4;316;2;550;2;1;
/org.eclipse.ui.workbench/Eclipse UI/org/eclipse/ui/internal/csm/roles/RoleManagerEvent.java;1;0;4;1;0;0;0;4;10;2;3;2213;14;14;2;1;0;4;4;2441;1;2441;3;1;
/org.eclipse.jdt.debug.ui/ui/org/eclipse/jdt/debug/ui/AbstractJavaObjectBrowser.java;2;0;3;1;0;0;0;3;37;1;3;861;37;37;1;0;0;3;3;861;0;2647;3;2;
/org.eclipse.webdav/src/interface/org/eclipse/webdav/dom/HrefSet.java;1;0;2;1;2;1;2;0;347;0;0;5151;347;347;2;0;1;0;2;5151;1;5151;1;1;
/org.eclipse.jdt.core/compiler/org/eclipse/jdt/internal/compiler/parser/RecoveredElement.java;4;0;8;1;1;1;1;7;63;1;7;488;130;130;1;0;0;7;8;488;0;5355;8;4;
/org.eclipse.pde.ui/srcnew/org/eclipse/pde/internal/ui/editor/manifest/XMLOutlinePageContentProvider.java;1;0;1;1;0;0;0;1;0;0;1;2320;0;0;1;0;0;1;1;2320;0;2320;1;1;
/org.eclipse.debug.core/core/org/eclipse/debug/internal/core/variables/ProjectExpander.java;2;0;2;1;0;0;0;2;0;1;2;737;0;0;1;0;0;2;2;737;0;2120;2;2;
/org.eclipse.ui.workbench/Eclipse UI/org/eclipse/ui/internal/misc/WorkInProgressPreferencePage.java;2;0;4;1;0;0;0;4;15;1;4;2334;16;16;1;0;0;4;4;2334;0;3710;4;2;
/org.eclipse.jdt.ui/ui refactoring/org/eclipse/jdt/internal/ui/refactoring/IExceptionListChangeListener.java;2;0;2;1;1;1;1;1;2;0;1;2562;2;2;1;0;0;1;2;2562;0;6340;2;2;
/org.eclipse.jdt.ui/ui/org/eclipse/jdt/internal/ui/javaeditor/selectionactions/StructureSelectionAction.java;3;1;4;1;3;3;3;1;25;0;1;4897;34;34;1;0;0;1;4;4897;0;6340;4;3;
/org.eclipse.help.base/src/org/eclipse/help/internal/browser/BrowserManager.java;1;1;17;1;3;3;3;14;186;4;8;1740;509;509;4;6;0;14;17;1740;6;6337;11;1;
/org.eclipse.jdt.core.tests.model/workspace/Formatter/test170/A_out.java;1;0;2;1;0;0;0;2;4;1;2;2425;4;4;1;0;0;2;2;2425;0;3029;2;1;
/org.eclipse.ui.cheatsheets/src/org/eclipse/ui/cheatsheets/CheatSheetListener.java;2;0;3;2;0;0;0;3;28;2;2;4625;47;47;2;1;0;3;3;4625;1;4634;2;2;
/org.eclipse.ui.views/src/org/eclipse/ui/views/framelist/FrameList.java;1;0;1;1;0;0;0;1;0;0;1;2738;0;0;1;0;0;1;1;2738;0;2738;1;1;
/org.eclipse.jdt.ui.tests.refactoring/resources/IntroduceFactory/Bugzilla/59284/ArgTypeImport.java;1;0;1;1;1;1;1;0;2;0;0;5659;2;2;1;0;0;0;1;5659;0;5659;1;1;
/org.eclipse.jdt.core.tests.model/workspace/Formatter/test449/A_in.java;1;0;1;1;0;0;0;1;0;0;1;3611;0;0;1;0;0;1;1;3611;0;3611;1;1;
/org.eclipse.jdt.ui.tests.refactoring/resources/IntroduceFactory/positive/SelectConstructor_in.java;1;0;2;1;1;1;1;1;2;0;1;2862;2;2;1;0;0;1;2;2862;0;5659;2;1;
/org.eclipse.jdt.ui/ui/org/eclipse/jdt/internal/ui/text/template/contentassist/TemplateProposal.java;3;2;19;2;8;7;8;11;70;2;9;4258;354;354;2;2;1;11;19;4258;3;6340;16;3;
/org.eclipse.ui.tests/Eclipse UI Tests/org/eclipse/ui/tests/UiTestSuite.java;8;2;18;2;5;4;5;13;88;1;13;1542;232;232;2;0;1;13;18;6081;1;6338;17;8;
/org.eclipse.jdt.ui.tests.refactoring/resources/ExtractConstant/nameGuessing/testGuessFromGetterName0.java;1;0;1;1;0;0;0;1;0;0;1;1191;0;0;1;0;0;1;1;1191;0;1191;1;1;
/org.eclipse.jdt.ui.tests.refactoring/resources/IntroduceParameter/invalid/NoMethodBinding.java;1;0;1;1;0;0;0;1;0;0;1;4048;0;0;1;0;0;1;1;4048;0;4048;1;1;
/org.eclipse.team.ui/src/org/eclipse/team/internal/ui/synchronize/IRefreshEvent.java;1;1;5;1;2;2;2;3;69;1;3;3796;109;109;1;0;0;3;5;3796;0;6337;5;1;
/org.eclipse.help.ui/src/org/eclipse/help/ui/internal/util/HelpWorkbenchException.java;1;0;1;1;0;0;0;1;0;0;1;2732;0;0;1;0;0;1;1;2732;0;2732;1;1;
/org.eclipse.core.tests.resources/src/org/eclipse/core/tests/internal/watson/ElementTreeIteratorTest.java;1;0;3;1;3;1;3;0;254;0;0;5147;254;254;3;0;2;0;3;5147;2;5147;1;1;
/org.eclipse.team.tests.cvs.core/src/org/eclipse/team/tests/ccvs/ui/logformatter/PrintCSVSummaryVisitor.java;1;0;1;1;0;0;0;1;0;0;1;2632;0;0;1;0;0;1;1;2632;0;2632;1;1;
/org.eclipse.jdt.ui/ui/org/eclipse/jdt/ui/text/java/IProblemLocation.java;3;1;6;1;3;3;3;3;35;1;3;1232;89;89;1;0;0;3;6;1232;0;6322;6;3;
/org.eclipse.team.cvs.ui/src/org/eclipse/team/internal/ccvs/ui/operations/RemoteLogOperation.java;2;1;7;1;6;6;6;1;58;0;1;4953;109;109;1;0;0;1;7;4953;0;6080;7;2;
/org.eclipse.team.ui/src/org/eclipse/team/ui/synchronize/viewers/SyncInfoDiffNodeBuilder.java;1;0;1;1;0;0;0;1;0;0;1;3972;0;0;1;0;0;1;1;3972;0;3972;1;1;
/org.eclipse.update.ui.forms/Eclipse Forms/org/eclipse/ui/forms/widgets/FormContent.java;1;0;3;1;0;0;0;3;46;1;3;4017;46;46;1;0;0;3;3;4017;0;4157;3;1;
/org.eclipse.jdt.core/compiler/org/eclipse/jdt/internal/compiler/lookup/ParameterizedTypeBinding.java;1;0;1;1;0;0;0;1;0;0;1;3579;0;0;1;0;0;1;1;3579;0;3579;1;1;
/org.eclipse.ui.externaltools/External Tools Base/org/eclipse/ui/externaltools/internal/variable/ExternalToolsVariableMessages.java;1;0;1;1;0;0;0;1;0;0;1;321;0;0;1;0;0;1;1;321;0;321;1;1;
/org.eclipse.pde.ui/src_Forms/org/eclipse/pde/internal/ui/neweditor/EditorEntryAdapter.java;1;0;3;1;0;0;0;3;8;2;2;4260;8;8;2;1;0;3;3;4284;1;4284;2;1;
/org.eclipse.ant.ui/Ant Runner Support/org/eclipse/ant/ui/internal/antsupport/AntSupportMessages.java;1;0;4;1;0;0;0;4;3;2;3;250;3;3;2;1;0;4;4;263;1;1811;3;1;
/org.eclipse.pde.core/src/org/eclipse/pde/internal/core/plugin/PluginAttribute.java;3;1;7;1;3;3;3;4;14;1;4;3320;34;34;1;0;0;4;7;3320;0;6336;7;3;
/org.eclipse.swt/Eclipse SWT Drag and Drop/photon/org/eclipse/swt/dnd/ByteArrayTransfer.java;1;1;2;1;2;2;2;0;4;0;0;5606;6;6;1;0;0;0;2;5606;0;6352;2;1;
/org.eclipse.debug.core/core/org/eclipse/debug/internal/core/LaunchConfigurationType.java;3;1;11;1;3;3;3;8;109;2;7;463;188;188;2;1;0;8;11;4949;1;5672;10;3;
/org.eclipse.jdt.ui.tests.refactoring/resources/InlineMethodWorkspace/TestCases/argument_out/TestLocalReferenceLoop.java;1;0;1;1;0;0;0;1;4;0;1;845;4;4;1;0;0;1;1;845;0;845;1;1;
/org.eclipse.swt/Eclipse SWT/carbon/org/eclipse/swt/widgets/Caret.java;3;1;6;1;3;3;3;3;50;1;3;268;73;73;1;0;0;3;6;268;0;6352;6;3;
/org.eclipse.update.ui.forms/src/org/eclipse/ui/forms/parts/AbstractHyperlink.java;1;0;2;1;0;0;0;2;0;0;1;3095;0;0;2;1;0;2;2;3095;1;3095;1;1;
/org.eclipse.jdt.ui/ui/org/eclipse/jdt/ui/search/ISearchUIParticipant.java;2;2;4;2;3;2;3;1;30;0;1;5075;38;38;2;0;1;1;4;5176;1;5176;3;2;
/org.eclipse.jdt.core.tests.model/workspace/Formatter/test376/A_out.java;1;0;2;1;0;0;0;2;1;1;2;3146;1;1;1;0;0;2;2;3146;0;3172;2;1;
/org.eclipse.jdt.ui/ui/org/eclipse/jdt/internal/ui/wizards/IStatusChangeListener.java;1;0;1;1;1;1;1;0;2;0;0;6340;2;2;1;0;0;0;1;6340;0;6340;1;1;
/org.eclipse.ui.workbench/Eclipse UI/org/eclipse/ui/internal/commands/api/older/ICommandManagerEvent.java;1;0;2;1;0;0;0;2;0;0;1;2562;0;0;2;1;0;2;2;2562;1;2562;1;1;
/org.eclipse.ui.workbench/Eclipse UI/org/eclipse/ui/internal/commands/older/KeyBinding.java;1;0;2;1;0;0;0;2;2;0;1;2562;2;2;2;1;0;2;2;2562;1;2562;1;1;
/org.eclipse.jdt.ui.tests.refactoring/resources/Copy/test_type_yes_type/out/A.java;1;0;1;1;0;0;0;1;0;0;1;696;0;0;1;0;0;1;1;696;0;696;1;1;
/org.eclipse.jdt.debug.ui/ui/org/eclipse/jdt/internal/debug/ui/JavaUtilMapEntryVariablesContentProvider.java;1;0;5;1;0;0;0;5;11;1;5;670;25;25;1;0;0;5;5;670;0;861;5;1;
/org.eclipse.ui.workbench/Eclipse UI/org/eclipse/ui/internal/WorkbenchActivityMonitor.java;1;0;2;1;0;0;0;2;0;1;2;2735;0;0;1;0;0;2;2;2735;0;2800;2;1;
/org.eclipse.releng.tools/src/org/eclipse/releng/tools/ProjectComparePageTreeInput.java;2;1;2;1;2;2;2;0;0;0;0;5183;0;0;1;0;0;0;2;5183;0;5364;2;2;
/org.eclipse.team.ui/src/org/eclipse/team/internal/ui/widgets/TextChangePreviewViewer.java;1;0;1;1;0;0;0;1;0;0;1;3280;0;0;1;0;0;1;1;3280;0;3280;1;1;
/org.eclipse.debug.core/core/org/eclipse/debug/core/IBreakpointManager.java;2;0;2;1;1;1;1;1;42;0;1;4235;46;46;1;0;0;1;2;4235;0;6336;2;2;
/org.eclipse.jdt.ui.tests.refactoring/resources/PasteSourceReference/test0/in/B.java;1;0;1;1;0;0;0;1;0;0;1;1311;0;0;1;0;0;1;1;1311;0;1311;1;1;
/org.eclipse.debug.ui/ui/org/eclipse/debug/internal/ui/console/IConsoleListener.java;2;0;2;1;0;0;0;2;0;1;2;1294;0;0;1;0;0;2;2;1294;0;2060;2;2;
/org.eclipse.jdt.core.tests.model/workspace/Formatter/test411/A_in.java;1;0;1;1;0;0;0;1;0;0;1;3460;0;0;1;0;0;1;1;3460;0;3460;1;1;
/org.eclipse.jdt.core/model/org/eclipse/jdt/internal/core/PackageDeclaration.java;1;1;8;1;2;2;2;6;15;2;5;916;39;39;2;1;0;6;8;1089;1;5614;7;1;
/org.eclipse.ui.ide/src/org/eclipse/ui/internal/dialogs/PathVariablesGroup.java;2;0;7;1;0;0;0;7;13;2;6;1526;32;32;2;1;0;7;7;1739;1;2263;6;2;
/org.eclipse.jdt.ui/ui/org/eclipse/jdt/internal/ui/search/LevelTreeContentProvider.java;2;2;11;2;6;5;6;5;158;1;5;4107;465;465;2;0;1;5;11;6338;1;6338;10;2;
/org.eclipse.core.runtime/src/org/eclipse/core/internal/runtime/CipherInputStream.java;3;1;7;1;3;3;3;4;183;1;4;1369;382;382;1;0;0;4;7;1369;0;6340;7;3;
/org.eclipse.swt/Eclipse SWT/common/org/eclipse/swt/internal/image/PngLzBlockReader.java;1;0;1;1;0;0;0;1;2;0;1;2160;2;2;1;0;0;1;1;2160;0;2160;1;1;
/org.eclipse.jdt.core.tests.model/workspace/Formatter/test431/A_in.java;1;0;1;1;0;0;0;1;0;0;1;3479;0;0;1;0;0;1;1;3479;0;3479;1;1;
/org.eclipse.swt.tests/JUnit Tests/org/eclipse/swt/tests/junit/Test_org_eclipse_swt_custom_StackLayout.java;1;0;1;1;0;0;0;1;12;0;1;2104;12;12;1;0;0;1;1;2104;0;2104;1;1;
/org.eclipse.jdt.ui/ui/org/eclipse/jdt/internal/ui/filters/PackageDeclarationFilter.java;1;0;1;1;1;1;1;0;2;0;0;6340;2;2;1;0;0;0;1;6340;0;6340;1;1;
/org.eclipse.team.cvs.ui/src/org/eclipse/team/internal/ccvs/ui/actions/CompareRemoteResourcesAction.java;2;1;5;1;2;2;2;3;49;1;3;2529;117;117;1;0;0;3;5;2529;0;6337;5;2;
/org.eclipse.jdt.ui/core refactoring/org/eclipse/jdt/internal/corext/refactoring/code/IntroduceFactoryRefactoring.java;4;3;33;2;12;9;12;21;140;2;19;2846;544;544;3;2;3;21;33;5656;5;6340;28;4;
/org.eclipse.jface.text/src/org/eclipse/jface/text/IAutoEditStrategy.java;1;0;1;1;1;1;1;0;2;0;0;6340;2;2;1;0;0;0;1;6340;0;6340;1;1;
/org.eclipse.jdt.ui/core refactoring/org/eclipse/ltk/internal/core/refactoring/Resources.java;1;0;2;1;0;0;0;2;0;1;2;4624;0;0;1;0;0;2;2;4624;0;4864;2;1;
/org.eclipse.pde.ui/src/org/eclipse/pde/internal/ui/editor/manifest/ExtensionsPropertySheet.java;2;0;5;1;1;1;1;4;6;1;4;368;12;12;1;0;0;4;5;368;0;5431;5;2;
/org.eclipse.jdt.ui.tests.refactoring/resources/ExtractMethodWorkSpace/ExtractMethodTests/return_in/A_test712.java;1;0;1;1;0;0;0;1;2;0;1;844;2;2;1;0;0;1;1;844;0;844;1;1;
/org.eclipse.ui.ide/src/org/eclipse/ui/internal/model/ResourceFactory.java;2;0;2;1;0;0;0;2;0;1;2;1511;0;0;1;0;0;2;2;1511;0;2263;2;2;
/org.eclipse.ui.workbench/Eclipse UI/org/eclipse/ui/internal/EditorHistoryItem.java;1;0;1;1;0;0;0;1;2;0;1;2737;2;2;1;0;0;1;1;2737;0;2737;1;1;
/org.eclipse.jdt.ui/core extension/org/eclipse/jdt/internal/corext/codemanipulation/AddJavaDocStubOperation.java;3;1;8;1;2;2;2;6;94;1;6;762;176;176;1;0;0;6;8;762;0;6340;8;3;
/org.eclipse.ui.views/src/org/eclipse/ui/views/progress/ProgressView.java;1;0;3;1;0;0;0;3;55;1;3;320;55;55;1;0;0;3;3;320;0;1061;3;1;
/org.eclipse.team.ui/src/org/eclipse/team/ui/synchronize/views/SyncInfoDecoratingLabelProvider.java;1;0;1;1;0;0;0;1;0;0;1;3764;0;0;1;0;0;1;1;3764;0;3764;1;1;
/org.eclipse.ui.workbench/Eclipse UI/org/eclipse/ui/internal/contexts/ContextManagerFactory.java;3;1;6;1;2;2;2;4;32;2;3;4927;45;45;2;1;0;4;6;4927;1;6338;5;3;
/org.eclipse.jdt.debug.ui/ui/org/eclipse/jdt/internal/debug/ui/launcher/IAddVMDialogRequestor.java;1;0;1;1;0;0;0;1;0;0;1;1039;0;0;1;0;0;1;1;1039;0;1039;1;1;
/org.eclipse.jdt.core/model/org/eclipse/jdt/internal/core/util/SimpleLookupTable.java;2;0;3;1;0;0;0;3;11;1;3;1357;19;19;1;0;0;3;3;1357;0;4327;3;2;
/org.eclipse.jdt.ui/core extension/org/eclipse/jdt/internal/corext/textmanipulation/CopyTargetEdit.java;1;0;6;1;0;0;0;6;45;2;4;1576;128;128;2;2;0;6;6;1869;2;1946;4;1;
/org.eclipse.ui.workbench/Eclipse UI/org/eclipse/ui/internal/commands/old/Command.java;1;0;3;1;0;0;0;3;232;2;2;1321;232;232;2;1;0;3;3;1321;1;1695;2;1;
/org.eclipse.ui.workbench/Eclipse UI/org/eclipse/ui/internal/model/WorkbenchAdapter.java;1;0;1;1;0;0;0;1;0;0;1;2737;0;0;1;0;0;1;1;2737;0;2737;1;1;
/org.eclipse.jdt.core.tests.model/workspace/Converter/test0265/Test.java;1;0;1;1;0;0;0;1;0;0;1;3714;0;0;1;0;0;1;1;3714;0;3714;1;1;
/org.eclipse.team.tests.cvs.core/src/org/eclipse/team/tests/ccvs/core/cvsresources/EclipseSynchronizerTest.java;2;0;6;2;0;0;0;6;226;2;5;2181;281;281;2;1;0;6;6;2865;1;2893;5;2;
/org.eclipse.ui.workbench/Eclipse UI/org/eclipse/ui/internal/presentations/DefaultStandalonePresentation.java;1;0;1;1;1;1;1;0;0;0;0;5539;0;0;1;0;0;0;1;5539;0;5539;1;1;
/org.eclipse.core.resources/src/org/eclipse/core/internal/resources/OS.java;2;1;4;1;2;2;2;2;64;1;2;3063;79;79;1;0;0;2;4;3063;0;5484;4;2;
/org.eclipse.swt/Eclipse SWT PI/carbon/org/eclipse/swt/internal/carbon/Point.java;1;2;3;1;3;2;3;0;16;0;0;5534;20;20;2;0;1;0;3;5534;1;5614;2;1;
/org.eclipse.ui.workbench/Eclipse UI/org/eclipse/ui/dialogs/ISelectionValidator.java;1;0;1;1;1;1;1;0;4;0;0;5464;4;4;1;0;0;0;1;5464;0;5464;1;1;
/org.eclipse.jdt.ui/ui/org/eclipse/jdt/internal/ui/text/correction/NoCorrectionProposal.java;1;0;1;1;0;0;0;1;0;0;1;1034;0;0;1;0;0;1;1;1034;0;1034;1;1;
/org.eclipse.ui.workbench/Eclipse UI/org/eclipse/ui/internal/LayoutTree.java;4;1;6;2;2;2;2;4;26;2;3;4015;86;86;2;1;0;4;6;4015;1;6338;5;4;
/org.eclipse.jdt.core.tests.model/workspace/Converter/src/test0468/A.java;1;0;1;1;0;0;0;1;0;0;1;3714;0;0;1;0;0;1;1;3714;0;3714;1;1;
/org.eclipse.team.cvs.ui/src/org/eclipse/team/internal/ccvs/ui/actions/TagLocalAction.java;2;0;5;1;1;1;1;4;11;1;4;994;17;17;1;0;0;4;5;994;0;6337;5;2;
/org.eclipse.swt.tests/JUnit Tests/org/eclipse/swt/tests/junit/Test_org_eclipse_swt_widgets_Layout.java;2;0;2;1;0;0;0;2;23;1;2;2123;38;38;1;0;0;2;2;2123;0;2144;2;2;
/org.eclipse.update.ui/src/org/eclipse/update/internal/ui/UpdateWebSitesAction.java;3;0;3;1;0;0;0;3;21;1;3;825;21;21;1;0;0;3;3;825;0;3010;3;3;
/org.eclipse.jdt.core.tests.model/workspace/Converter/src/test0548/PaletteStackEditPart.java;1;0;1;1;1;1;1;0;0;0;0;5407;0;0;1;0;0;0;1;5407;0;5407;1;1;
/org.eclipse.ui.workbench/Eclipse UI/org/eclipse/ui/actions/BuildAction.java;1;0;1;1;0;0;0;1;0;0;1;2737;0;0;1;0;0;1;1;2737;0;2737;1;1;
/org.eclipse.team.ui/src/org/eclipse/team/internal/ui/IHelpContextIds.java;2;1;2;1;2;2;2;0;2;0;0;6015;4;4;1;0;0;0;2;6015;0;6337;2;2;
/org.eclipse.jdt.core/model/org/eclipse/jdt/internal/core/JarPackageFragmentRoot.java;2;0;8;1;1;1;1;7;206;1;7;761;256;256;1;0;0;7;8;761;0;6143;8;2;
/org.eclipse.core.runtime/src/org/eclipse/core/runtime/jobs/IJobListener.java;1;0;1;1;0;0;0;1;0;0;1;320;0;0;1;0;0;1;1;320;0;320;1;1;
/org.eclipse.swt/Eclipse SWT Browser/common/org/eclipse/swt/browser/StatusTextListener.java;2;0;6;1;1;1;1;5;19;1;5;1654;45;45;1;0;0;5;6;1654;0;6352;6;2;
/org.eclipse.team.examples.filesystem/src/org/eclipse/team/examples/filesystem/ui/PutAction.java;2;1;3;1;2;2;2;1;14;0;1;4368;18;18;1;0;0;1;3;4368;0;6337;3;2;
/org.eclipse.jdt.core.tests.model/workspace/Converter/test0229/Test.java;1;0;1;1;0;0;0;1;0;0;1;3714;0;0;1;0;0;1;1;3714;0;3714;1;1;
/org.eclipse.ui.tests/Eclipse JFace Tests/org/eclipse/jface/tests/viewers/ComboViewerTest.java;1;0;1;1;0;0;0;1;0;0;1;5004;0;0;1;0;0;1;1;5004;0;5004;1;1;
/org.eclipse.pde.build/src-temp/Test2.java;2;1;4;1;2;2;2;2;15;1;2;4328;25;25;1;0;0;2;4;4328;0;5755;4;2;
/org.eclipse.team.cvs.ui/src/org/eclipse/team/internal/ccvs/ui/model/RemoteProjectsElement.java;1;0;1;1;0;0;0;1;5;0;1;990;5;5;1;0;0;1;1;990;0;990;1;1;
/org.eclipse.jdt.ui.tests.refactoring/resources/InlineMethodWorkspace/TestCases/argument_in/TestParameterNameUsed4.java;1;0;1;1;0;0;0;1;2;0;1;845;2;2;1;0;0;1;1;845;0;845;1;1;
/org.eclipse.ant.ui/Ant Editor/org/eclipse/ant/ui/internal/editor/derived/HTMLTextPresenter.java;1;0;3;1;0;0;0;3;6;1;3;250;6;6;1;0;0;3;3;250;0;1811;3;1;
/org.eclipse.jface.text/src/org/eclipse/jface/contentassist/AbstractControlContentAssistSubjectAdapter.java;1;2;7;1;7;6;7;0;82;0;0;5181;172;172;2;0;1;0;7;6340;1;6340;6;1;
/org.eclipse.osgi/core/framework/org/eclipse/osgi/framework/internal/core/OSGi.java;5;1;7;1;3;3;3;4;181;1;4;3013;207;207;1;0;0;4;7;3013;0;6337;7;5;
/org.eclipse.jdt.debug.ui/ui/org/eclipse/jdt/internal/debug/ui/sourcelookup/WorkbenchAdapterFactory.java;1;0;1;1;0;0;0;1;0;0;1;4609;0;0;1;0;0;1;1;4609;0;4609;1;1;
/org.eclipse.debug.ui/ui/org/eclipse/debug/internal/ui/sourcelookup/browsers/WorkspaceSourceContainerBrowser.java;1;0;5;1;0;0;0;5;6;1;5;3770;21;21;1;0;0;5;5;3770;0;4970;5;1;
/org.eclipse.swt/Eclipse SWT Mozilla/common/org/eclipse/swt/internal/mozilla/nsIDOMMouseEvent.java;2;1;2;1;2;2;2;0;2;0;0;5271;2;2;1;0;0;0;2;5271;0;6342;2;2;
/org.eclipse.jdt.core/dom/org/eclipse/jdt/core/dom/Name.java;3;0;7;1;1;1;1;6;44;1;6;2871;94;94;1;0;0;6;7;2871;0;5209;7;3;
/org.eclipse.webdav/src/client/org/eclipse/webdav/client/CollectionHandle.java;1;0;2;1;2;1;2;0;45;0;0;5151;45;45;2;0;1;0;2;5151;1;5151;1;1;
/org.eclipse.jdt.ui/ui/org/eclipse/jdt/internal/ui/text/java/IJavaReconcilingListener.java;1;0;3;1;1;1;1;2;13;1;2;4627;20;20;1;0;0;2;3;4627;0;5397;3;1;
/org.eclipse.jdt.ui.tests/ui/org/eclipse/jdt/ui/tests/text/StringsTest.java;1;0;1;1;0;0;0;1;0;0;1;4516;0;0;1;0;0;1;1;4516;0;4516;1;1;
/org.eclipse.core.runtime/src/org/eclipse/core/internal/preferences/InstancePreferences.java;1;2;20;1;6;4;6;14;79;2;11;4351;347;347;2;3;2;14;20;4513;5;5874;15;1;
/org.eclipse.jdt.ui/core refactoring/org/eclipse/jdt/internal/corext/refactoring/code/flow/SwitchFlowInfo.java;1;0;1;1;1;1;1;0;2;0;0;6340;2;2;1;0;0;0;1;6340;0;6340;1;1;
/org.eclipse.jdt.ui/ui/org/eclipse/jdt/ui/text/spelling/TaskTagDictionary.java;1;0;2;1;0;0;0;2;0;1;2;3829;0;0;1;0;0;2;2;3829;0;3930;2;1;
/org.eclipse.team.cvs.ui/src/org/eclipse/team/internal/ccvs/ui/merge/TagElement.java;2;0;4;1;1;1;1;3;18;2;2;4655;37;37;2;1;0;3;4;5039;1;6337;3;2;
/org.eclipse.ui.ide/src/org/eclipse/ui/internal/ide/misc/CheckboxTreeAndListGroup.java;4;2;4;2;3;2;3;1;28;0;1;2264;34;34;2;0;1;1;4;6338;1;6338;3;4;
/org.eclipse.jdt.core.tests.model/workspace/Converter/src/test0530/A.java;1;0;1;1;0;0;0;1;0;0;1;3714;0;0;1;0;0;1;1;3714;0;3714;1;1;
/org.eclipse.jdt.ui/ui/org/eclipse/jdt/ui/wizards/IClasspathContainerPage.java;1;0;1;1;1;1;1;0;2;0;0;6340;2;2;1;0;0;0;1;6340;0;6340;1;1;
/org.eclipse.ui.workbench/Eclipse UI/org/eclipse/ui/internal/fonts/FontDefinitionReader.java;1;0;3;1;0;0;0;3;23;1;3;3877;27;27;1;0;0;3;3;3877;0;4263;3;1;
/org.eclipse.compare.examples.xml/src/org/eclipse/compare/examples/xml/XMLNode.java;1;0;3;1;0;0;0;3;75;1;3;1106;77;77;1;0;0;3;3;1106;0;3938;3;1;
/org.eclipse.team.core/src/org/eclipse/team/internal/core/subscribers/SubscriberSyncInfoSet.java;2;0;2;1;0;0;0;2;80;1;2;4002;80;80;1;0;0;2;2;4002;0;4216;2;2;
/org.eclipse.swt/Eclipse SWT PI/motif/org/eclipse/swt/internal/motif/XtWidgetGeometry.java;1;0;1;1;0;0;0;1;7;0;1;829;7;7;1;0;0;1;1;829;0;829;1;1;
/org.eclipse.jdt.ui.tests.refactoring/resources/ExtractMethodWorkSpace/ExtractMethodTests/duplicates_in/A_test955.java;1;0;3;1;0;0;0;3;0;1;3;1442;0;0;1;0;0;3;3;1442;0;1474;3;1;
/org.eclipse.team.tests.cvs.core/src/org/eclipse/team/tests/ccvs/ui/old/WorkflowTests.java;1;0;2;1;0;0;0;2;0;1;2;2632;0;0;1;0;0;2;2;2632;0;4216;2;1;
/org.eclipse.ui.cheatsheets/src/org/eclipse/ui/internal/cheatsheets/data/CheatSheetParser.java;1;2;10;1;10;9;10;0;324;0;0;5189;637;637;2;0;1;0;10;5715;1;5944;9;1;
/org.eclipse.ui.views/src/org/eclipse/ui/views/markers/internal/TableSortAction.java;2;0;2;1;0;0;0;2;0;1;2;755;0;0;1;0;0;2;2;755;0;2738;2;2;
/org.eclipse.jdt.core/compiler/org/eclipse/jdt/internal/compiler/ast/NullLiteral.java;2;0;2;1;0;0;0;2;4;1;2;2974;6;6;1;0;0;2;2;2974;0;3560;2;2;
/org.eclipse.update.core/src/org/eclipse/update/internal/model/PluginParser.java;1;0;1;1;0;0;0;1;0;0;1;2634;0;0;1;0;0;1;1;2634;0;2634;1;1;
/org.eclipse.jdt.core/search/org/eclipse/jdt/core/search/PackageDeclarationMatch.java;2;1;7;1;3;3;3;4;23;1;4;3913;59;59;1;0;0;4;7;3913;0;5242;7;2;
/org.eclipse.jdt.debug.ui/ui/org/eclipse/jdt/internal/debug/ui/snippeteditor/JavaSnippetCompletionProcessor.java;5;1;9;2;2;2;2;7;26;2;6;1152;58;58;2;1;0;7;9;4870;1;6336;8;5;
/org.eclipse.team.ui/src/org/eclipse/team/internal/ui/IgnorePreferencePage.java;2;0;2;1;0;0;0;2;21;1;2;790;21;21;1;0;0;2;2;790;0;993;2;2;
/org.eclipse.jdt.ui/ui/org/eclipse/jdt/internal/ui/javaeditor/RemoveOccurrenceAnnotations.java;1;0;2;1;1;1;1;1;4;0;1;2582;4;4;1;0;0;1;2;2582;0;6340;2;1;
/org.eclipse.ui.workbench/Eclipse UI/org/eclipse/ui/internal/EditorStack.java;4;2;8;1;8;7;8;0;62;0;0;5539;210;210;2;0;1;0;8;5539;1;6338;7;4;
/org.eclipse.ui.intro/src/org/eclipse/ui/intro/internal/html/FormattedHTMLElement.java;2;0;3;1;1;1;1;2;67;1;2;4429;67;67;1;0;0;2;3;4429;0;5115;3;2;
/org.eclipse.jdt.ui/core refactoring/org/eclipse/jdt/internal/corext/refactoring/rename/RenameMethodInInterfaceRefactoring.java;2;0;4;1;0;0;0;4;24;1;4;122;39;39;1;0;0;4;4;122;0;1125;4;2;
/org.eclipse.jdt.core.tests.model/workspace/Converter/test0435/A.java;1;0;1;1;0;0;0;1;0;0;1;3714;0;0;1;0;0;1;1;3714;0;3714;1;1;
/org.eclipse.jdt.ui/ui/org/eclipse/jdt/internal/ui/search/TextSearchTableContentProvider.java;2;0;2;1;1;1;1;1;1;0;1;4943;1;1;1;0;0;1;2;4943;0;5396;2;2;
/org.eclipse.jdt.debug.ui/ui/org/eclipse/jdt/internal/debug/ui/launchConfigurations/ClasspathGroup.java;1;0;2;1;0;0;0;2;0;0;1;2685;0;0;2;1;0;2;2;2685;1;2685;1;1;
/org.eclipse.releng.tools/src/org/eclipse/releng/tools/TagPage.java;1;0;1;1;1;1;1;0;0;0;0;5183;0;0;1;0;0;0;1;5183;0;5183;1;1;
/org.eclipse.swt.tests/JUnit Tests/org/eclipse/swt/tests/junit/Test_org_eclipse_swt_graphics_ImageData.java;3;0;3;1;0;0;0;3;165;1;3;2175;222;222;1;0;0;3;3;2175;0;2492;3;3;
/org.eclipse.jdt.core.tests.model/workspace/Converter/test0148/Test.java;1;0;1;1;0;0;0;1;0;0;1;3714;0;0;1;0;0;1;1;3714;0;3714;1;1;
/org.eclipse.ui.views/src/org/eclipse/ui/views/internal/markers/ActionProblemProperties.java;1;0;2;1;0;0;0;2;0;0;1;749;0;0;2;1;0;2;2;749;1;749;1;1;
/org.eclipse.ui.intro/src/org/eclipse/ui/intro/internal/parts/IStandbyContentPart.java;1;0;2;1;1;1;1;1;0;0;1;4609;0;0;1;0;0;1;2;4609;0;5115;2;1;
/org.eclipse.jdt.core.tests.model/workspace/Converter/src/test0329/Test.java;1;0;1;1;0;0;0;1;0;0;1;3714;0;0;1;0;0;1;1;3714;0;3714;1;1;
/org.eclipse.update.configurator/src/org/eclipse/update/internal/configurator/FeatureParser.java;2;2;11;2;3;2;3;8;24;1;8;3265;100;100;2;0;1;8;11;5662;1;5662;10;2;
/org.eclipse.compare.tests/JUnit Tests/org/eclipse/compare/tests/AllTests.java;1;0;5;1;1;1;1;4;20;1;4;560;25;25;1;0;0;4;5;560;0;5165;5;1;
/org.eclipse.team.core/src/org/eclipse/team/internal/core/Policy.java;2;1;5;1;2;2;2;3;8;1;3;790;16;16;1;0;0;3;5;790;0;6336;5;2;
/org.eclipse.core.resources/src/org/eclipse/core/internal/watson/ElementTreeDelta.java;1;0;2;1;2;1;2;0;245;0;0;5146;245;245;2;0;1;0;2;5146;1;5146;1;1;
/org.eclipse.swt/Eclipse SWT/common/org/eclipse/swt/internal/image/TIFFFileFormat.java;1;0;1;1;0;0;0;1;0;0;1;364;0;0;1;0;0;1;1;364;0;364;1;1;
/org.eclipse.debug.ui/ui/org/eclipse/debug/ui/launchVariables/ContainerExpander.java;1;0;2;1;0;0;0;2;0;1;2;550;0;0;1;0;0;2;2;550;0;562;2;1;
/org.eclipse.jface.text/src/org/eclipse/jface/text/IFindReplaceTarget.java;2;2;4;1;4;3;4;0;35;0;0;5268;51;51;2;0;1;0;4;5268;1;6359;3;2;
/org.eclipse.ui.workbench/Eclipse UI/org/eclipse/ui/contexts/IMutableContextActivationService.java;2;0;3;1;0;0;0;3;3;1;3;3109;3;3;1;0;0;3;3;3109;0;4144;3;2;
/org.eclipse.core.resources/src/org/eclipse/core/internal/indexing/Insertable.java;1;0;1;1;1;1;1;0;4;0;0;5146;4;4;1;0;0;0;1;5146;0;5146;1;1;
/org.eclipse.update.core/srcnew/org/eclipse/update/standalone/UpdateCommand.java;1;0;4;1;0;0;0;4;216;2;3;699;218;218;2;1;0;4;4;699;1;825;3;1;
/org.eclipse.ui.intro/src/org/eclipse/ui/internal/intro/impl/parts/StandbyPart.java;4;3;19;2;19;13;19;0;248;0;0;5115;435;435;3;0;6;0;19;5742;6;5937;13;4;
/org.eclipse.osgi/osgi/src/org/osgi/framework/BundleActivator.java;2;0;2;1;1;1;1;1;3;0;1;3013;3;3;1;0;0;1;2;3013;0;5536;2;2;
/org.eclipse.jdt.ui/core extension/org/eclipse/jdt/internal/corext/javadoc/JavaDocLocations.java;3;1;7;1;3;3;3;4;114;1;4;1309;263;263;1;0;0;4;7;1309;0;6340;7;3;
/org.eclipse.team.ui/src/org/eclipse/team/ui/synchronize/viewers/SyncInfoModelElement.java;2;0;7;1;0;0;0;7;234;2;6;4213;323;323;2;1;0;7;7;4213;1;4588;6;2;
/org.eclipse.jdt.ui.tests.refactoring/resources/IntroduceFactory/positive/multiUnit1C_FFF_out.java;1;0;2;1;0;0;0;2;0;1;2;2846;0;0;1;0;0;2;2;2846;0;2862;2;1;
/org.eclipse.jdt.ui.tests.refactoring/resources/MoveInnerToTopLevel/test_nonstatic_22/out/Inner.java;2;0;2;1;1;1;1;1;2;0;1;305;4;4;1;0;0;1;2;305;0;5854;2;2;
/org.eclipse.ui.workbench/Eclipse UI/org/eclipse/ui/internal/csm/roles/api/IRoleDefinition.java;1;0;2;1;0;0;0;2;0;1;2;2213;0;0;1;0;0;2;2;2213;0;2225;2;1;
/org.eclipse.pde.core/srcnew/org/eclipse/pde/internal/core/plugin/TicketManager.java;1;0;1;1;1;1;1;0;0;0;0;5431;0;0;1;0;0;0;1;5431;0;5431;1;1;
/org.eclipse.debug.ui/ui/org/eclipse/debug/internal/ui/views/breakpoints/BreakpointsSorter.java;2;0;2;1;1;1;1;1;15;0;1;4808;19;19;1;0;0;1;2;4808;0;6336;2;2;
/org.eclipse.ui.externaltools/Ant Tools Support/org/eclipse/ui/externaltools/internal/ant/launchConfigurations/TaskLinkManager.java;1;0;1;1;0;0;0;1;0;0;1;282;0;0;1;0;0;1;1;282;0;282;1;1;
/org.eclipse.ui.views/src/org/eclipse/ui/views/internal/markers/PasteMarkerAction.java;1;0;2;1;0;0;0;2;0;1;2;265;0;0;1;0;0;2;2;265;0;749;2;1;
/org.eclipse.update.core/src/org/eclipse/update/internal/core/InstallLogParser.java;1;1;12;1;4;4;4;8;37;2;7;4376;165;165;2;1;0;8;12;4376;1;6336;11;1;
/org.eclipse.ui.views/src/org/eclipse/ui/views/internal/table/TableSortAction.java;1;0;2;1;0;0;0;2;0;0;1;749;0;0;2;1;0;2;2;749;1;749;1;1;
/org.eclipse.jdt.core/model/org/eclipse/jdt/internal/core/util/MementoTokenizer.java;1;0;1;1;1;1;1;0;0;0;0;5185;0;0;1;0;0;0;1;5185;0;5185;1;1;
/org.eclipse.core.boot/src/org/eclipse/core/internal/boot/DelegatingURLClassLoader.java;1;0;2;1;0;0;0;2;2;1;2;2444;2;2;1;0;0;2;2;2444;0;3013;2;1;
/org.eclipse.osgi/core/framework/org/eclipse/osgi/framework/internal/core/ExportedPackageImpl.java;6;2;11;1;5;4;5;6;11;1;6;3013;54;54;2;0;1;6;11;5116;1;6337;10;6;
/org.eclipse.jdt.ui.tests.refactoring/resources/PullUp/testEnablement1/in/A.java;1;0;1;1;0;0;0;1;0;0;1;1312;0;0;1;0;0;1;1;1312;0;1312;1;1;
/org.eclipse.help.tests/src/org/eclipse/help/tests/servlets/TestContextServlet.java;1;1;3;1;2;2;2;1;68;0;1;2732;88;88;1;0;0;1;3;2732;0;6337;3;1;
/org.eclipse.jdt.ui.tests.refactoring/test cases/org/eclipse/jdt/ui/tests/refactoring/ReorgTests.java;1;0;4;1;0;0;0;4;26;1;4;130;33;33;1;0;0;4;4;130;0;1111;4;1;
/org.eclipse.core.boot/src/org/eclipse/core/boot/IPlatformRunnable.java;1;0;1;1;0;0;0;1;0;0;1;3013;0;0;1;0;0;1;1;3013;0;3013;1;1;
/org.eclipse.pde.core/srcnew/org/eclipse/pde/internal/core/plugin/DocumentModelHandler.java;1;1;7;1;3;3;3;4;8;2;3;2906;25;25;2;1;0;4;7;2919;1;5431;6;1;
/org.eclipse.ui.workbench/Eclipse UI/org/eclipse/ui/dialogs/SaveAsDialog.java;2;0;2;1;0;0;0;2;3;1;2;1;3;3;1;0;0;2;2;1;0;2737;2;2;
/org.eclipse.debug.ui/ui/org/eclipse/debug/ui/actions/ToggleWatchpointActionDelegate.java;1;0;2;1;1;1;1;1;3;0;1;4496;3;3;1;0;0;1;2;4496;0;5134;2;1;
/org.eclipse.osgi.tests/src/org/eclipse/osgi/tests/internal/state/StateComparisonTest.java;1;1;2;1;2;2;2;0;0;0;0;5536;0;0;1;0;0;0;2;5536;0;5993;2;1;
/org.eclipse.ui.workbench/Eclipse UI/org/eclipse/ui/internal/PresentableViewPart.java;5;1;16;2;4;4;4;12;162;3;8;4460;354;354;3;4;0;12;16;4517;4;5517;12;5;
/org.eclipse.pde.ui/templates/editor/java/XMLTagScanner.java;1;0;1;1;0;0;0;1;10;0;1;851;10;10;1;0;0;1;1;851;0;851;1;1;
/org.eclipse.pde.core/src/org/eclipse/pde/internal/core/WorkspaceModelManager.java;3;2;33;2;12;11;12;21;1256;2;17;368;1661;1661;2;4;1;21;33;2229;5;6336;28;3;
/org.eclipse.jdt.ui.tests.refactoring/resources/ChangeTypeRefactoring/positive/A_testFieldDecl_out.java;1;0;1;1;0;0;0;1;0;0;1;2844;0;0;1;0;0;1;1;2844;0;2844;1;1;
/org.eclipse.update.ui/src/org/eclipse/update/internal/ui/search/NewPluginEntryDialog.java;1;0;1;1;0;0;0;1;0;0;1;757;0;0;1;0;0;1;1;757;0;757;1;1;
/org.eclipse.jdt.ui.tests.refactoring/resources/ChangeTypeRefactoring/negative/A_testInvalidSelection_out.java;1;0;1;1;0;0;0;1;0;0;1;2844;0;0;1;0;0;1;1;2844;0;2844;1;1;
/org.eclipse.jdt.ui.tests.refactoring/test cases/org/eclipse/jdt/ui/tests/refactoring/RenameSourceFolderChangeTests.java;2;0;2;1;1;1;1;1;4;0;1;3930;6;6;1;0;0;1;2;3930;0;6340;2;2;
/org.eclipse.jdt.core/model/org/eclipse/jdt/internal/core/SimpleDelta.java;1;0;2;1;0;0;0;2;2;1;2;2236;2;2;1;0;0;2;2;2236;0;3560;2;1;
/org.eclipse.update.core/src/org/eclipse/update/internal/search/UpdateMap.java;3;0;4;1;0;0;0;4;41;1;4;825;43;43;1;0;0;4;4;825;0;963;4;3;
/org.eclipse.ant.tests.core/test plugin/org/eclipse/ant/tests/core/testplugin/AntTestChecker.java;1;0;4;1;0;0;0;4;25;1;4;148;45;45;1;0;0;4;4;148;0;2594;4;1;
/org.eclipse.jdt.core.tests.model/workspace/Formatter/test448/A_out.java;1;0;1;1;0;0;0;1;0;0;1;3611;0;0;1;0;0;1;1;3611;0;3611;1;1;
/org.eclipse.jdt.core.tests.model/workspace/Resolve/src/ResolveDuplicateMethodDeclaration7.java;1;0;1;1;1;1;1;0;0;0;0;6222;0;0;1;0;0;0;1;6222;0;6222;1;1;
/org.eclipse.swt/Eclipse SWT Drag and Drop/motif/org/eclipse/swt/dnd/TextTransfer.java;1;0;1;1;0;0;0;1;91;0;1;328;91;91;1;0;0;1;1;328;0;328;1;1;
/org.eclipse.jdt.ui/ui/org/eclipse/jdt/ui/actions/ConvertLocalToFieldAction.java;3;0;8;1;1;1;1;7;53;1;7;42;88;88;1;0;0;7;8;42;0;6340;8;3;
/org.eclipse.jdt.core.tests.compiler/src/org/eclipse/jdt/core/tests/compiler/regression/Requestor.java;4;0;4;1;0;0;0;4;101;1;4;1129;108;108;1;0;0;4;4;1129;0;3560;4;4;
/org.eclipse.jdt.ui/ui/org/eclipse/jdt/internal/ui/text/java/ExperimentalProposal.java;3;2;13;1;6;5;6;7;26;1;7;3030;111;111;2;0;1;7;13;5127;1;6340;12;3;
/org.eclipse.jdt.ui/core refactoring/org/eclipse/ltk/core/refactoring/participants/ExtensionManager.java;1;0;4;1;0;0;0;4;156;1;4;4624;211;211;1;0;0;4;4;4624;0;4864;4;1;
/org.eclipse.team.core/src/org/eclipse/team/core/subscribers/utils/SynchronizationCacheRefreshOperation.java;1;0;1;1;0;0;0;1;0;0;1;3563;0;0;1;0;0;1;1;3563;0;3563;1;1;
/org.eclipse.jdt.ui/ui/org/eclipse/jdt/internal/ui/text/javadoc/JavaDocCompletionEvaluator.java;3;1;8;1;2;2;2;6;47;1;6;598;81;81;1;0;0;6;8;598;0;6340;8;3;
/org.eclipse.osgi/eclipseAdaptor/src/org/eclipse/core/runtime/adaptor/CachedManifest.java;5;1;17;1;6;6;6;11;11;1;11;3013;105;105;1;0;0;11;17;3013;0;6133;17;5;
/org.eclipse.jdt.ui/ui/org/eclipse/jdt/internal/ui/infoviews/InfoViewMessages.java;1;0;2;1;1;1;1;1;2;0;1;1415;2;2;1;0;0;1;2;1415;0;6340;2;1;
/org.eclipse.ui.forms.examples/src/org/eclipse/ui/forms/examples/internal/rcp/SimpleFormEditorInput.java;1;0;2;1;1;1;1;1;16;0;1;4075;16;16;1;0;0;1;2;4075;0;5781;2;1;
/org.eclipse.update.core/src/org/eclipse/update/internal/operations/ReplaceFeatureVersionOperation.java;1;0;7;1;1;1;1;6;4;1;6;1242;16;16;1;0;0;6;7;1242;0;6336;7;1;
/org.eclipse.jdt.debug/eval/org/eclipse/jdt/internal/debug/eval/ast/instructions/Instruction.java;2;0;3;1;0;0;0;3;13;1;3;1240;27;27;1;0;0;3;3;1240;0;2497;3;2;
/org.eclipse.jdt.ui/ui/org/eclipse/jdt/internal/ui/text/TypingRun.java;2;1;2;1;2;2;2;0;8;0;0;5226;8;8;1;0;0;0;2;5226;0;6340;2;2;
/org.eclipse.ui.examples.javaeditor/Eclipse Java Editor Example/org/eclipse/ui/examples/javaeditor/javadoc/JavaDocScanner.java;1;0;2;1;1;1;1;1;2;0;1;1349;4;4;1;0;0;1;2;1349;0;6340;2;1;
/org.eclipse.swt/Eclipse SWT/motif/org/eclipse/swt/widgets/Combo.java;5;2;16;2;5;4;5;11;63;2;10;110;252;252;2;1;1;11;16;268;2;6352;14;5;
/org.eclipse.jdt.ui/core extension/org/eclipse/jdt/internal/corext/codemanipulation/TryCatchBlock.java;1;0;1;1;0;0;0;1;0;0;1;155;0;0;1;0;0;1;1;155;0;155;1;1;
/org.eclipse.team.core/src/org/eclipse/team/core/variants/ThreeWaySynchronizer.java;1;2;5;1;3;2;3;2;6;1;2;4349;12;12;2;0;1;2;5;5660;1;6125;4;1;
/org.eclipse.core.resources/src/org/eclipse/core/internal/resources/WorkspaceDescription.java;2;0;2;1;1;1;1;1;25;0;1;1485;40;40;1;0;0;1;2;1485;0;5146;2;2;
/org.eclipse.ui.intro/src/org/eclipse/ui/internal/intro/impl/model/IIntroAction.java;2;1;2;1;2;2;2;0;0;0;0;5115;0;0;1;0;0;0;2;5115;0;5277;2;2;
/org.eclipse.swt/Eclipse SWT Browser/common/org/eclipse/swt/browser/NewWindowListener.java;1;0;2;1;0;0;0;2;0;1;2;2849;0;0;1;0;0;2;2;2849;0;3007;2;1;
/org.eclipse.swt.tests/JUnit Tests/org/eclipse/swt/tests/junit/Test_org_eclipse_swt_dnd_DropTarget.java;1;0;1;1;0;0;0;1;12;0;1;2176;12;12;1;0;0;1;1;2176;0;2176;1;1;
/org.eclipse.debug.core/core/org/eclipse/debug/internal/core/memory/IMemoryBlockListener.java;1;0;1;1;1;1;1;0;0;0;0;5254;0;0;1;0;0;0;1;5254;0;5254;1;1;
/org.eclipse.swt/Eclipse SWT/gtk/org/eclipse/swt/widgets/Monitor.java;1;0;5;1;0;0;0;5;135;3;2;15;148;148;3;3;0;5;5;15;3;29;2;1;
/org.eclipse.jdt.ui/ui refactoring/org/eclipse/jdt/internal/ui/refactoring/RefactoringPreferences.java;1;0;2;1;0;0;0;2;5;1;2;4575;5;5;1;0;0;2;2;4575;0;4965;2;1;
/org.eclipse.jdt.debug.tests/tests/org/eclipse/jdt/debug/tests/core/LaunchVariableTests.java;2;0;5;1;0;0;0;5;11;2;4;771;13;13;2;1;0;5;5;848;1;2120;4;2;
/org.eclipse.ui.workbench/Eclipse UI/org/eclipse/ui/internal/activities/ActivityPatternBindingDefinition.java;3;0;8;1;1;1;1;7;112;1;7;2444;148;148;1;0;0;7;8;2444;0;6338;8;3;
/org.eclipse.jdt.debug/jdi interfaces/com/sun/jdi/request/DuplicateRequestException.java;2;0;2;1;0;0;0;2;4;1;2;1290;8;8;1;0;0;2;2;1290;0;1318;2;2;
/org.eclipse.jdt.core.tests.model/workspace/Formatter/test319/A_out.java;1;0;1;1;0;0;0;1;0;0;1;2459;0;0;1;0;0;1;1;2459;0;2459;1;1;
/org.eclipse.pde.ui/templates/propertyPages/java/$className$.java;1;0;1;1;0;0;0;1;10;0;1;851;10;10;1;0;0;1;1;851;0;851;1;1;
/org.eclipse.jdt.core.tests.model/workspace/Formatter/test164/A_in.java;1;0;1;1;0;0;0;1;0;0;1;2425;0;0;1;0;0;1;1;2425;0;2425;1;1;
/org.eclipse.ui.workbench/Eclipse UI/org/eclipse/ui/commands/IGestureBinding.java;1;0;7;1;0;0;0;7;16;2;5;1239;31;31;2;2;0;7;7;1239;2;1340;5;1;
/org.eclipse.core.resources/src/org/eclipse/core/internal/resources/InternalTeamHook.java;2;0;2;1;1;1;1;1;4;0;1;4999;4;4;1;0;0;1;2;4999;0;5146;2;2;
/org.eclipse.core.runtime/src/org/eclipse/core/runtime/jobs/IJobFamily.java;1;0;1;1;0;0;0;1;0;0;1;320;0;0;1;0;0;1;1;320;0;320;1;1;
/org.eclipse.ui.views/src/org/eclipse/ui/views/tasklist/RemoveTaskAction.java;1;0;1;1;0;0;0;1;0;0;1;2738;0;0;1;0;0;1;1;2738;0;2738;1;1;
/org.eclipse.update.core/srcnew/org/eclipse/update/search/VersionedIdentifiersFilter.java;1;0;2;1;0;0;0;2;0;1;2;717;0;0;1;0;0;2;2;717;0;825;2;1;
/org.eclipse.jdt.core.tests.model/workspace/Formatter/test306/A_out.java;1;0;1;1;0;0;0;1;0;0;1;2442;0;0;1;0;0;1;1;2442;0;2442;1;1;
/org.eclipse.ui.workbench/Eclipse UI/org/eclipse/ui/internal/csm/commands/ICategoryDefinition.java;1;0;3;1;0;0;0;3;33;2;2;2532;33;33;2;1;0;3;3;2532;1;2562;2;1;
/org.eclipse.jdt.ui/ui/org/eclipse/jdt/internal/ui/text/link/ProposalPosition.java;2;0;5;1;0;0;0;5;57;1;5;1132;68;68;1;0;0;5;5;1132;0;4214;5;2;
/org.eclipse.jdt.core.tests.model/workspace/Formatter/test308/A_in.java;1;0;1;1;0;0;0;1;0;0;1;2442;0;0;1;0;0;1;1;2442;0;2442;1;1;
/org.eclipse.jdt.core.tests.model/workspace/Formatter/test314/A_out.java;1;0;2;1;0;0;0;2;4;1;2;2444;4;4;1;0;0;2;2;2444;0;4173;2;1;
/org.eclipse.pde.ui/src_Forms/org/eclipse/pde/internal/ui/neweditor/feature/InfoFormPage.java;2;0;2;1;1;1;1;1;0;0;1;4926;0;0;1;0;0;1;2;4926;0;5431;2;2;
/org.eclipse.jdt.core/model/org/eclipse/jdt/internal/core/jdom/DOMCompilationUnit.java;2;0;8;1;1;1;1;7;10;1;7;90;45;45;1;0;0;7;8;90;0;5584;8;2;
/org.eclipse.jdt.core/model/org/eclipse/jdt/core/IBufferFactory.java;1;0;3;1;0;0;0;3;2;1;3;2583;4;4;1;0;0;3;3;2583;0;3560;3;1;
/org.eclipse.pde/src_ant/org/eclipse/pde/ant/ConvertSchemaToHTML.java;2;1;11;1;3;3;3;8;67;1;8;964;248;248;1;0;0;8;11;964;0;6336;11;2;
/org.eclipse.jdt.ui/ui refactoring/org/eclipse/jdt/internal/ui/refactoring/CreateTextFileChangePreviewViewer.java;5;1;10;1;3;3;3;7;54;1;7;1033;143;143;1;0;0;7;10;1033;0;6340;10;5;
/org.eclipse.team.ui/src/org/eclipse/team/ui/synchronize/subscriber/ProgressDialogRunnableContext.java;1;0;1;1;0;0;0;1;0;0;1;4055;0;0;1;0;0;1;1;4055;0;4055;1;1;
/org.eclipse.jdt.ui/ui/org/eclipse/jdt/internal/ui/text/template/TemplateProposal.java;5;0;12;1;0;0;0;12;84;1;12;787;256;256;1;0;0;12;12;787;0;4258;12;5;
/org.eclipse.ltk.core.refactoring/src/org/eclipse/ltk/core/refactoring/participants/ProcessorDescriptor.java;1;0;2;1;1;1;1;1;0;0;1;4845;0;0;1;0;0;1;2;4845;0;5106;2;1;
/org.eclipse.pde.ui/src_Forms/org/eclipse/pde/internal/ui/neweditor/plugin/ManifestEditorContributor.java;2;0;2;1;1;1;1;1;0;0;1;3812;0;0;1;0;0;1;2;3812;0;5431;2;2;
/org.eclipse.update.ui.forms/Eclipse Forms/org/eclipse/ui/forms/internal/widgets/ImageSegment.java;1;0;2;1;0;0;0;2;0;1;2;3138;0;0;1;0;0;2;2;3138;0;4157;2;1;
/org.eclipse.ui.editors/src/org/eclipse/ui/editors/text/TextEditorPreferencePage.java;1;1;2;1;2;2;2;0;11;0;0;5632;13;13;1;0;0;0;2;5632;0;6334;2;1;
/org.eclipse.jdt.core.tests.model/workspace/Formatter/test372/A_out.java;2;0;2;1;0;0;0;2;12;1;2;3130;12;12;1;0;0;2;2;3130;0;3362;2;2;
/org.eclipse.update.ui.forms/src/org/eclipse/update/ui/forms/richtext/RichText.java;1;0;3;1;0;0;0;3;367;2;2;2849;367;367;2;1;0;3;3;2849;1;2898;2;1;
/org.eclipse.jdt.ui/ui/org/eclipse/jdt/internal/ui/reorg/ReorgDestinationAction.java;2;0;5;1;0;0;0;5;28;1;5;130;60;60;1;0;0;5;5;130;0;1111;5;2;
/org.eclipse.ui.ide/src/org/eclipse/ui/views/markers/internal/ActionMarkCompleted.java;3;1;3;1;2;2;2;1;2;0;1;2208;3;3;1;0;0;1;3;2208;0;6338;3;3;
/org.eclipse.swt/Eclipse SWT/common/org/eclipse/swt/events/KeyEvent.java;1;0;1;1;0;0;0;1;26;0;1;2729;26;26;1;0;0;1;1;2729;0;2729;1;1;
/org.eclipse.ui.ide/src/org/eclipse/ui/internal/ide/IDEWorkbenchPlugin.java;8;2;25;2;6;5;6;19;261;3;16;1499;689;689;3;3;1;19;25;1654;4;6338;21;8;
/org.eclipse.jdt.ui.tests/test plugin/org/eclipse/jdt/testplugin/TestOptions.java;1;1;2;1;2;2;2;0;20;0;0;6083;20;20;1;0;0;0;2;6083;0;6096;2;1;
/org.eclipse.jdt.ui/ui/org/eclipse/jdt/internal/ui/javadocexport/JavadocExportMessages.java;1;0;1;1;1;1;1;0;2;0;0;6340;2;2;1;0;0;0;1;6340;0;6340;1;1;
/org.eclipse.jdt.ui.tests.refactoring/resources/InlineMethodWorkspace/TestCases/argument_in/TestParameterNameUsed3.java;1;0;1;1;0;0;0;1;2;0;1;845;2;2;1;0;0;1;1;845;0;845;1;1;
/org.eclipse.jdt.ui.tests.refactoring/resources/InlineMethodWorkspace/TestCases/simple_in/TestLabeledStatement.java;1;0;1;1;0;0;0;1;0;0;1;2277;0;0;1;0;0;1;1;2277;0;2277;1;1;
/org.eclipse.pde.runtime/src/org/eclipse/pde/internal/runtime/logview/LogSessionPropertyPage.java;2;0;3;1;0;0;0;3;3;1;3;997;3;3;1;0;0;3;3;997;0;3621;3;2;
/org.eclipse.jdt.ui.tests/examples/org/eclipse/jdt/ui/examples/ASTChildConstantsGenerator.java;1;0;6;1;0;0;0;6;211;1;6;2401;493;493;1;0;0;6;6;2401;0;4794;6;1;
/org.eclipse.team.ui/src/org/eclipse/team/internal/ui/synchronize/actions/OpenWithActionGroup.java;2;1;9;1;2;2;2;7;101;1;7;2561;223;223;1;0;0;7;9;2561;0;6337;9;2;
/org.eclipse.jdt.launching/launching/org/eclipse/jdt/internal/launching/Standard11xVMType.java;3;0;5;1;1;1;1;4;4;1;4;685;16;16;1;0;0;4;5;685;0;6336;5;3;
/org.eclipse.ant.ui/Ant Tools Support/org/eclipse/ant/internal/ui/launchConfigurations/ContributedClasspathEntriesEntry.java;2;0;7;1;1;1;1;6;40;1;6;4332;130;130;1;0;0;6;7;4332;0;5879;7;2;
/org.eclipse.team.cvs.ui/src/org/eclipse/team/internal/ccvs/ui/subscriber/ChangeLogViewerInput.java;1;0;3;1;0;0;0;3;299;1;3;3987;299;299;1;0;0;3;3;3987;0;4244;3;1;
/org.eclipse.team.ui/src/org/eclipse/team/internal/ui/widgets/FormSection.java;1;0;1;1;0;0;0;1;0;0;1;3171;0;0;1;0;0;1;1;3171;0;3171;1;1;
/org.eclipse.pde.ui/src/org/eclipse/pde/internal/ui/IPreferenceConstants.java;2;1;7;1;3;3;3;4;18;1;4;1111;55;55;1;0;0;4;7;1111;0;6336;7;2;
/org.eclipse.jdt.core.tests.model/workspace/Converter/src/test0046/Test.java;1;0;1;1;0;0;0;1;0;0;1;3714;0;0;1;0;0;1;1;3714;0;3714;1;1;
/org.eclipse.jdt.core/compiler/org/eclipse/jdt/internal/compiler/env/IGenericField.java;1;0;1;1;0;0;0;1;2;0;1;3560;2;2;1;0;0;1;1;3560;0;3560;1;1;
/org.eclipse.swt/Eclipse SWT PI/win32/org/eclipse/swt/internal/ole/win32/FUNCDESC1.java;1;0;1;1;0;0;0;1;8;0;1;2915;8;8;1;0;0;1;1;2915;0;2915;1;1;
/org.eclipse.ui.workbench/Eclipse UI/org/eclipse/ui/commands/old/IPropertyListener.java;1;0;2;1;0;0;0;2;0;0;1;1222;0;0;2;1;0;2;2;1222;1;1222;1;1;
/org.eclipse.compare/compare/org/eclipse/compare/internal/patch/PreviewPatchPage.java;1;0;7;1;1;1;1;6;50;1;6;1289;80;80;1;0;0;6;7;1289;0;5920;7;1;
/org.eclipse.ant.tests.ui/Ant Editor Tests/org/eclipse/ant/ui/internal/editor/test/AntEditorContentOutlineTests.java;1;0;3;1;0;0;0;3;69;1;3;1274;69;69;1;0;0;3;3;1274;0;1811;3;1;
/org.eclipse.osgi/eclipseAdaptor/src/org/eclipse/core/runtime/adaptor/LocationManager.java;2;1;15;1;6;6;6;9;61;2;8;4113;348;348;2;1;0;9;15;4113;1;6230;14;2;
/org.eclipse.team.webdav/src/org/eclipse/team/internal/target/subscriber/PutOperation.java;2;0;4;1;1;1;1;3;165;1;3;3494;169;169;1;0;0;3;4;3494;0;6337;4;2;
/org.eclipse.ui.views/src/org/eclipse/ui/views/bookmarkexplorer/OpenBookmarkAction.java;1;0;1;1;0;0;0;1;0;0;1;2738;0;0;1;0;0;1;1;2738;0;2738;1;1;
/org.eclipse.ui.externaltools/External Tools Base/org/eclipse/ui/externaltools/internal/variable/IVariableComponent.java;2;0;2;1;0;0;0;2;9;1;2;282;9;9;1;0;0;2;2;282;0;321;2;2;
/org.eclipse.ui.workbench/Eclipse UI/org/eclipse/ui/internal/csm/activities/IPatternBindingDefinition.java;1;0;2;1;0;0;0;2;0;1;2;2310;0;0;1;0;0;2;2;2310;0;2412;2;1;
/org.eclipse.team.cvs.core/src/org/eclipse/team/internal/ccvs/core/syncinfo/RemoteSynchronizer.java;2;0;8;1;0;0;0;8;316;1;8;532;662;662;1;0;0;8;8;532;0;1954;8;2;
/org.eclipse.jdt.ui.tests.refactoring/resources/MoveInstanceMethod/canMove/test23/in/Second.java;1;0;1;1;0;0;0;1;0;0;1;1603;0;0;1;0;0;1;1;1603;0;1603;1;1;
/org.eclipse.jdt.ui/core refactoring/org/eclipse/jdt/internal/corext/refactoring/rename/RenamePackageProcessor.java;4;1;34;1;10;10;10;24;346;3;21;1125;755;755;3;3;0;24;34;1125;3;6340;31;4;
/org.eclipse.update.core/src/org/eclipse/update/core/Utilities.java;3;2;13;2;4;3;4;9;70;3;7;890;143;143;3;2;1;9;13;3090;3;6336;10;3;
/org.eclipse.swt.graphics.text/Eclipse SWT Custom Widgets/common/org/eclipse/swt/custom/WrappedContent.java;2;0;11;1;0;0;0;11;206;2;10;3889;243;243;2;1;0;11;11;4472;1;4830;10;2;
/org.eclipse.jdt.core.tests.model/workspace/Formatter/test014/A_out.java;1;0;2;1;0;0;0;2;3;1;2;2425;3;3;1;0;0;2;2;2425;0;3086;2;1;
/org.eclipse.jdt.core/dom/org/eclipse/jdt/core/dom/rewrite/ITrackedNodePosition.java;3;0;5;2;0;0;0;5;10;2;4;4711;26;26;2;1;0;5;5;4711;1;4823;4;3;
/org.eclipse.jdt.core/model/org/eclipse/jdt/internal/core/builder/ReferenceCollection.java;2;0;3;1;0;0;0;3;32;1;3;2728;56;56;1;0;0;3;3;2728;0;3560;3;2;
/org.eclipse.jdt.ui.tests.refactoring/resources/InlineMethodWorkspace/TestCases/call_out/TestExpressionStatement.java;1;0;1;1;0;0;0;1;2;0;1;845;2;2;1;0;0;1;1;845;0;845;1;1;
/org.eclipse.team.ui/src/org/eclipse/team/ui/sync/actions/AndSyncInfoFilter.java;1;0;1;1;0;0;0;1;0;0;1;2405;0;0;1;0;0;1;1;2405;0;2405;1;1;
/org.eclipse.debug.ui/ui/org/eclipse/debug/ui/actions/IRunToLineTarget.java;1;1;3;1;2;2;2;1;5;0;1;4496;8;8;1;0;0;1;3;4496;0;5183;3;1;
/org.eclipse.jdt.core.tests.model/workspace/Formatter/test410/A_out.java;1;0;2;1;0;0;0;2;6;0;1;3458;6;6;2;1;0;2;2;3458;1;3458;1;1;
/org.eclipse.jdt.launching/launching/org/eclipse/jdt/internal/launching/AbstractRuntimeClasspathEntry.java;2;0;6;1;1;1;1;5;22;2;4;3810;43;43;2;1;0;5;6;4973;1;5625;5;2;
/org.eclipse.ant.tests.ui/Ant Editor Tests/org/eclipse/ui/externaltools/internal/ant/editor/test/CodeCompletionTest.java;1;0;5;1;0;0;0;5;678;1;5;178;712;712;1;0;0;5;5;178;0;1274;5;1;
/org.eclipse.jdt.ui.tests.refactoring/resources/MoveMembers/test20/in/A.java;1;0;1;1;0;0;0;1;2;0;1;1522;2;2;1;0;0;1;1;1522;0;1522;1;1;
/org.eclipse.jface.text/src/org/eclipse/jface/text/TextAttribute.java;2;1;2;1;2;2;2;0;7;0;0;6340;9;9;1;0;0;0;2;6340;0;6359;2;2;
/org.eclipse.ui.ide/src/org/eclipse/ui/internal/dialogs/MultiStepWizardDialog.java;2;0;2;1;0;0;0;2;0;1;2;1526;0;0;1;0;0;2;2;1526;0;2263;2;2;
/org.eclipse.jdt.ui/core extension/org/eclipse/jdt/internal/corext/dom/RewriteEvent.java;1;0;5;1;1;1;1;4;51;1;4;2505;65;65;1;0;0;4;5;2505;0;5406;5;1;
/org.eclipse.jdt.core.tests.model/workspace/Converter/src/test0364/A.java;1;0;1;1;0;0;0;1;0;0;1;3714;0;0;1;0;0;1;1;3714;0;3714;1;1;
/org.eclipse.ui.workbench/Eclipse UI/org/eclipse/ui/actions/RenameResourceAction.java;2;0;2;1;0;0;0;2;9;1;2;1872;9;9;1;0;0;2;2;1872;0;2737;2;2;
/org.eclipse.jdt.ui.tests.refactoring/resources/DeleteSourceReference/test10/out/A.java;1;0;1;1;0;0;0;1;0;0;1;1652;0;0;1;0;0;1;1;1652;0;1652;1;1;
/org.eclipse.team.cvs.ui/src/org/eclipse/team/internal/ccvs/ui/subscriber/SubscriberCommitOperation.java;1;1;5;1;2;2;2;3;81;1;3;4450;111;111;1;0;0;3;5;4450;0;5508;5;1;
/org.eclipse.swt/Eclipse SWT Mozilla/common/org/eclipse/swt/internal/mozilla/nsIPromptService.java;1;0;2;1;0;0;0;2;30;1;2;1654;30;30;1;0;0;2;2;1654;0;2568;2;1;
/org.eclipse.ui.ide/src/org/eclipse/ui/views/markers/internal/ActionOpenMarker.java;4;0;5;1;1;1;1;4;58;1;4;2208;68;68;1;0;0;4;5;2208;0;6338;5;4;
/org.eclipse.team.ui/src/org/eclipse/team/ui/synchronize/subscriber/TeamOperation.java;2;0;2;1;0;0;0;2;0;1;2;4466;0;0;1;0;0;2;2;4466;0;4518;2;2;
/org.eclipse.pde.runtime/src/org/eclipse/pde/internal/runtime/logview/LogView.java;3;4;66;2;12;9;12;54;1921;4;41;798;5826;5826;4;13;3;54;66;831;16;6336;50;3;
/org.eclipse.jdt.core.tests.model/workspace/Formatter/test038/A_in.java;1;0;1;1;0;0;0;1;0;0;1;2425;0;0;1;0;0;1;1;2425;0;2425;1;1;
/org.eclipse.ui.workbench/Eclipse UI/org/eclipse/ui/internal/roles/api/IRoleRegistryListener.java;1;0;2;1;0;0;0;2;0;1;2;1952;0;0;1;0;0;2;2;1952;0;2199;2;1;
/org.eclipse.ui.workbench/Eclipse UI/org/eclipse/ui/internal/commands/SequenceNode.java;1;0;5;1;0;0;0;5;47;2;4;786;47;47;2;1;0;5;5;1077;1;1222;4;1;
/org.eclipse.text/src/org/eclipse/text/edits/CopyingRangeMarker.java;2;0;4;1;1;1;1;3;16;1;3;1986;31;31;1;0;0;3;4;1986;0;6340;4;2;
/org.eclipse.pde.ui/src/org/eclipse/pde/internal/ui/editor/feature/IncludeFeaturesWizardPage.java;3;1;5;1;3;3;3;2;31;1;2;2229;67;67;1;0;0;2;5;2229;0;6336;5;3;
/org.eclipse.jdt.ui/ui/org/eclipse/jdt/internal/ui/callhierarchy/Utility.java;1;0;3;1;0;0;0;3;25;2;2;155;25;25;2;1;0;3;3;169;1;169;2;1;
/org.eclipse.ui.workbench/Eclipse UI/org/eclipse/ui/internal/registry/WizardsRegistryReader.java;3;0;4;1;1;1;1;3;54;1;3;2737;67;67;1;0;0;3;4;2737;0;6338;4;3;
/org.eclipse.team.tests.cvs.core/src/org/eclipse/team/tests/ccvs/ui/CVSUITestCase.java;2;0;6;2;0;0;0;6;25;2;5;898;50;50;2;1;0;6;6;990;1;2632;5;2;
/org.eclipse.ui.tests/Eclipse UI Tests/org/eclipse/ui/tests/keys/Bug36420Test.java;4;1;10;1;2;2;2;8;26;1;8;2307;85;85;1;0;0;8;10;2307;0;6338;10;4;
/org.eclipse.jdt.ui/core refactoring/org/eclipse/jdt/internal/corext/refactoring/typeconstraints/TypeConstraintFactory.java;1;0;1;1;0;0;0;1;0;0;1;3902;0;0;1;0;0;1;1;3902;0;3902;1;1;
/org.eclipse.jdt.ui/ui/org/eclipse/jdt/internal/ui/text/correction/ModifierCorrectionSubProcessor.java;2;1;25;1;5;5;5;20;91;2;18;218;617;617;2;2;0;20;25;341;2;6340;23;2;
/org.eclipse.swt.tests/JUnit Tests/org/eclipse/swt/tests/junit/Test_org_eclipse_swt_graphics_ImageLoaderEvent.java;1;0;1;1;0;0;0;1;14;0;1;2492;14;14;1;0;0;1;1;2492;0;2492;1;1;
/org.eclipse.jdt.core/compiler/org/eclipse/jdt/internal/compiler/IProblemFactory.java;1;0;1;1;0;0;0;1;2;0;1;3560;2;2;1;0;0;1;1;3560;0;3560;1;1;
/org.eclipse.ui.editors/src/org/eclipse/ui/editors/text/TextEditor.java;3;2;22;2;5;4;5;17;694;3;15;677;1418;1418;3;2;1;17;22;4581;3;6334;19;3;
/org.eclipse.jdt.core/compiler/org/eclipse/jdt/internal/compiler/ASTVisitor.java;3;1;5;1;2;2;2;3;8;1;3;2974;20;20;1;0;0;3;5;2974;0;5635;5;3;
/org.eclipse.ui.workbench/Eclipse UI/org/eclipse/ui/internal/dialogs/FileSystemResourceExporter.java;1;0;1;1;0;0;0;1;0;0;1;2737;0;0;1;0;0;1;1;2737;0;2737;1;1;
/org.eclipse.team.ui/src/org/eclipse/team/ui/synchronize/ISyncInfoSetChangeEvent.java;1;0;1;1;0;0;0;1;0;0;1;3286;0;0;1;0;0;1;1;3286;0;3286;1;1;
/org.eclipse.jdt.core/model/org/eclipse/jdt/internal/core/MoveElementsOperation.java;1;0;2;1;0;0;0;2;2;1;2;3194;3;3;1;0;0;2;2;3194;0;3560;2;1;
/org.eclipse.jdt.ui.tests.refactoring/resources/InlineMethodWorkspace/TestCases/nameconflict_in/TestSameTypeInSibling.java;1;0;1;1;0;0;0;1;2;0;1;845;2;2;1;0;0;1;1;845;0;845;1;1;
/org.eclipse.swt/Eclipse SWT Custom Widgets/common/org/eclipse/swt/custom/CTabFolder2Listener.java;2;1;4;1;3;3;3;1;79;0;1;4232;93;93;1;0;0;1;4;4232;0;6352;4;2;
/org.eclipse.update.tests.core/webserver/bundleSitesrc/com.example.bundle.plugin.ui/src/com/example/bundle/plugin/ui/UiPlugin.java;2;0;2;1;1;1;1;1;10;0;1;4134;10;10;1;0;0;1;2;4134;0;6336;2;2;
/org.eclipse.pde.ui/src/org/eclipse/pde/internal/ui/wizards/feature/PluginListPage.java;2;1;5;1;3;3;3;2;30;1;2;3840;46;46;1;0;0;2;5;3840;0;6336;5;2;
/org.eclipse.core.runtime.osgi/src/org/eclipse/core/internal/runtime/PlatformURLPluginHandlerFactory.java;1;0;2;1;0;0;0;2;35;1;2;3013;35;35;1;0;0;2;2;3013;0;3030;2;1;
/org.eclipse.ui.workbench.texteditor/src/org/eclipse/ui/internal/texteditor/NextPulldownActionDelegate.java;2;0;2;1;0;0;0;2;0;1;2;1539;0;0;1;0;0;2;2;1539;0;2741;2;2;
/org.eclipse.jdt.core.tests.model/workspace/Converter/test0023/Test.java;1;0;1;1;0;0;0;1;0;0;1;3714;0;0;1;0;0;1;1;3714;0;3714;1;1;
/org.eclipse.jdt.core.tests.model/workspace/Converter/src/test0502/A.java;1;0;1;1;0;0;0;1;0;0;1;3714;0;0;1;0;0;1;1;3714;0;3714;1;1;
/org.eclipse.ui.externaltools/Ant Tools Support/org/eclipse/ui/externaltools/internal/ant/view/actions/RemoveAllAction.java;1;0;1;1;0;0;0;1;0;0;1;282;0;0;1;0;0;1;1;282;0;282;1;1;
/org.eclipse.ui.ide/src/org/eclipse/ui/views/navigator/FiltersContentProvider.java;2;0;2;1;0;0;0;2;4;1;2;2208;4;4;1;0;0;2;2;2208;0;2794;2;2;
/org.eclipse.swt/Eclipse SWT PI/gtk/org/eclipse/swt/internal/gtk/ATK.java;1;0;2;1;0;0;0;2;29;1;2;1136;29;29;1;0;0;2;2;1136;0;1214;2;1;
/org.eclipse.jdt.core.tests.model/workspace/Formatter/test140/A_out.java;1;0;1;1;0;0;0;1;0;0;1;2425;0;0;1;0;0;1;1;2425;0;2425;1;1;
/org.eclipse.core.runtime.compatibility/src-boot/org/eclipse/core/internal/boot/PlatformConfiguration.java;2;1;2;1;2;2;2;0;2;0;0;5254;2;2;1;0;0;0;2;5254;0;6340;2;2;
/org.eclipse.swt.tools/JNI Generation/org/eclipse/swt/tools/internal/ItemData.java;1;0;1;1;0;0;0;1;0;0;1;4175;0;0;1;0;0;1;1;4175;0;4175;1;1;
/org.eclipse.jdt.ui.tests.refactoring/resources/PullUp/testFail29/in/A.java;1;0;1;1;1;1;1;0;0;0;0;5686;0;0;1;0;0;0;1;5686;0;5686;1;1;
/org.eclipse.swt/Eclipse SWT/common/org/eclipse/swt/layout/GridData.java;2;0;4;1;1;1;1;3;25;2;2;2244;37;37;2;1;0;3;4;3461;1;6352;3;2;
/org.eclipse.compare/compare/org/eclipse/compare/structuremergeviewer/DiffElement.java;1;0;1;1;0;0;0;1;2;0;1;3938;2;2;1;0;0;1;1;3938;0;3938;1;1;
/org.eclipse.team.ui/src/org/eclipse/team/ui/synchronize/SyncInfoSetCheckboxCompareInput.java;1;0;1;1;0;0;0;1;0;0;1;3623;0;0;1;0;0;1;1;3623;0;3623;1;1;
/org.eclipse.help.tests/src/org/eclipse/help/tests/webapp/TestFrames.java;1;1;3;1;2;2;2;1;133;0;1;2732;153;153;1;0;0;1;3;2732;0;6337;3;1;
/org.eclipse.jdt.core.tests.model/workspace/Converter/src/test0214/Test.java;1;0;1;1;0;0;0;1;0;0;1;3714;0;0;1;0;0;1;1;3714;0;3714;1;1;
/org.eclipse.jdt.ui.tests/examples/org/eclipse/jdt/ui/examples/TreeListDialogFieldExample.java;1;0;1;1;1;1;1;0;2;0;0;6340;2;2;1;0;0;0;1;6340;0;6340;1;1;
/org.eclipse.ui.workbench/Eclipse UI/org/eclipse/ui/internal/PluginActionBuilder.java;3;0;3;1;1;1;1;2;25;1;2;4609;29;29;1;0;0;2;3;4609;0;6338;3;3;
/org.eclipse.jface.text/src/org/eclipse/jface/text/rules/MultiLineRule.java;1;0;1;1;1;1;1;0;2;0;0;6340;2;2;1;0;0;0;1;6340;0;6340;1;1;
/org.eclipse.core.tests.resources/src/org/eclipse/core/tests/internal/builders/CycleBuilder.java;2;0;3;1;2;1;2;1;18;0;1;2011;20;20;2;0;1;1;3;5147;1;5147;2;2;
/org.eclipse.swt/Eclipse SWT/gtk/org/eclipse/swt/widgets/Caret.java;4;1;5;1;2;2;2;3;17;1;3;269;40;40;1;0;0;3;5;269;0;6352;5;4;
/org.eclipse.jdt.ui.tests.refactoring/resources/ExtractMethodWorkSpace/ExtractMethodTests/duplicates_in/A_test950.java;1;0;3;1;0;0;0;3;0;1;3;1219;0;0;1;0;0;3;3;1219;0;1474;3;1;
/org.eclipse.jdt.ui/core extension/org/eclipse/text/edits/CopyingRangeMarker.java;1;0;2;1;0;0;0;2;0;0;1;1985;0;0;2;1;0;2;2;1985;1;1985;1;1;
/org.eclipse.ui.presentations.r21/src/org/eclipse/ui/internal/presentations/R21PresentationFactory.java;1;0;1;1;1;1;1;0;0;0;0;6075;0;0;1;0;0;0;1;6075;0;6075;1;1;
/org.eclipse.compare/compare/org/eclipse/compare/internal/merge/TextMerger.java;1;1;2;1;2;2;2;0;0;0;0;5165;0;0;1;0;0;0;2;5165;0;5185;2;1;
/org.eclipse.pde.ui/src/org/eclipse/pde/internal/ui/editor/PDEChildFormPage.java;1;0;1;1;1;1;1;0;0;0;0;5431;0;0;1;0;0;0;1;5431;0;5431;1;1;
/org.eclipse.team.cvs.core/src/org/eclipse/team/internal/ccvs/core/client/AbstractMessageCommand.java;1;0;1;1;0;0;0;1;2;0;1;1843;2;2;1;0;0;1;1;1843;0;1843;1;1;
/org.eclipse.swt/Eclipse SWT Custom Widgets/common/org/eclipse/swt/custom/ControlEditor.java;1;0;1;1;0;0;0;1;6;0;1;866;6;6;1;0;0;1;1;866;0;866;1;1;
/org.eclipse.ui.workbench.texteditor/src/org/eclipse/ui/internal/texteditor/quickdiff/compare/rangedifferencer/ITokenComparator.java;1;1;3;1;2;2;2;1;2;0;1;1644;3;3;1;0;0;1;3;1644;0;6340;3;1;
/org.eclipse.jdt.ui/ui/org/eclipse/jdt/internal/ui/browsing/PackagesView.java;2;1;5;1;2;2;2;3;6;1;3;1350;13;13;1;0;0;3;5;1350;0;6340;5;2;
/org.eclipse.jdt.core.tests.model/workspace/Formatter/test035/A_out.java;1;0;1;1;0;0;0;1;0;0;1;2425;0;0;1;0;0;1;1;2425;0;2425;1;1;
/org.eclipse.jdt.ui/core refactoring/org/eclipse/ltk/core/refactoring/PerformChangeOperation.java;1;0;2;1;0;0;0;2;0;1;2;4575;0;0;1;0;0;2;2;4575;0;4864;2;1;
/org.eclipse.ui.ide/src/org/eclipse/ui/wizards/datatransfer/FileSystemExportOperation.java;1;0;2;1;0;0;0;2;20;1;2;1511;20;20;1;0;0;2;2;1511;0;2040;2;1;
/org.eclipse.jdt.core.tests.model/workspace/Formatter/test126/A_out.java;1;0;1;1;0;0;0;1;0;0;1;2425;0;0;1;0;0;1;1;2425;0;2425;1;1;
/org.eclipse.jdt.core.tests.model/workspace/Formatter/test108/A_out.java;1;0;2;1;0;0;0;2;2;1;2;2425;2;2;1;0;0;2;2;2425;0;2462;2;1;
/org.eclipse.jdt.core.tests.model/workspace/Formatter/test420/A_out.java;1;0;1;1;0;0;0;1;0;0;1;3475;0;0;1;0;0;1;1;3475;0;3475;1;1;
/org.eclipse.ant.core/src_ant/org/eclipse/ant/internal/core/ant/InternalAntRunner.java;2;1;29;1;6;6;6;23;116;2;22;148;961;961;2;1;0;23;29;333;1;6339;28;2;
/org.eclipse.team.cvs.ui/src/org/eclipse/team/internal/ccvs/ui/operations/RepositoryLocationOperation.java;2;0;2;1;1;1;1;1;5;0;1;4953;5;5;1;0;0;1;2;4953;0;5474;2;2;
/org.eclipse.jdt.core/dom/org/eclipse/jdt/core/internal/dom/rewrite/TokenScanner.java;1;0;2;1;0;0;0;2;0;1;2;4711;0;0;1;0;0;2;2;4711;0;4802;2;1;
/org.eclipse.swt/Eclipse SWT PI/win32/org/eclipse/swt/internal/win32/NONCLIENTMETRICS.java;2;0;2;1;0;0;0;2;16;1;2;957;17;17;1;0;0;2;2;957;0;2915;2;2;
/org.eclipse.pde.core/src/org/eclipse/pde/internal/core/isite/ISiteObject.java;2;1;3;1;2;2;2;1;6;0;1;4203;12;12;1;0;0;1;3;4203;0;6336;3;2;
/org.eclipse.help/src/org/eclipse/help/internal/standalone/Options.java;1;0;3;1;0;0;0;3;16;1;3;808;22;22;1;0;0;3;3;808;0;2732;3;1;
/org.eclipse.jdt.ui.tests.refactoring/resources/TypeConstraints/A_testBad4.java;1;0;2;1;0;0;0;2;0;1;2;53;0;0;1;0;0;2;2;53;0;74;2;1;
/org.eclipse.jdt.ui/core refactoring/org/eclipse/jdt/internal/corext/refactoring/rename/RenameFieldRefactoring.java;2;0;4;1;0;0;0;4;24;1;4;122;43;43;1;0;0;4;4;122;0;1125;4;2;
/org.eclipse.ui.workbench/Eclipse UI/org/eclipse/ui/internal/commands/keys/Key.java;1;0;3;1;0;0;0;3;11;1;3;1264;18;18;1;0;0;3;3;1264;0;1294;3;1;
/org.eclipse.ui.tests/Eclipse UI Tests/org/eclipse/ui/tests/dnd/EditorTabDropTarget.java;1;0;1;1;1;1;1;0;0;0;0;5825;0;0;1;0;0;0;1;5825;0;5825;1;1;
/org.eclipse.pde.ui/src_Forms/org/eclipse/pde/internal/ui/model/plugin/PluginModelBase.java;3;2;15;2;9;8;9;6;50;1;6;4438;160;160;2;0;1;6;15;5425;1;6336;14;3;
/org.eclipse.search.tests/src/org/eclipse/search/tests/filesearch/SortingTest.java;1;0;1;1;1;1;1;0;0;0;0;5652;0;0;1;0;0;0;1;5652;0;5652;1;1;
/org.eclipse.jdt.core.tests.model/workspace/Converter/src/test0414/A.java;1;0;1;1;0;0;0;1;0;0;1;3714;0;0;1;0;0;1;1;3714;0;3714;1;1;
/org.eclipse.ui.workbench/Eclipse UI/org/eclipse/ui/wizards/newresource/BasicNewFolderResourceWizard.java;1;0;1;1;0;0;0;1;0;0;1;2737;0;0;1;0;0;1;1;2737;0;2737;1;1;
/org.eclipse.ui.views/src/org/eclipse/ui/views/markers/internal/DefaultMarkerResourceAdapter.java;2;0;2;1;0;0;0;2;0;1;2;755;0;0;1;0;0;2;2;755;0;2738;2;2;
/org.eclipse.update/src/org/eclipse/update/internal/ui/UMWizard.java;1;0;1;1;1;1;1;0;0;0;0;6339;0;0;1;0;0;0;1;6339;0;6339;1;1;
/org.eclipse.jface.text/src/org/eclipse/jface/text/rules/RuleBasedPartitionScanner.java;1;0;1;1;1;1;1;0;2;0;0;6340;2;2;1;0;0;0;1;6340;0;6340;1;1;
/org.eclipse.team.cvs.ui/src/org/eclipse/team/internal/ccvs/ui/actions/TagInRepositoryAction.java;2;0;5;1;1;1;1;4;116;1;4;699;151;151;1;0;0;4;5;699;0;6337;5;2;
/org.eclipse.jdt.core.tests.model/workspace/Converter/src/javadoc/test001/Test.java;1;0;1;1;0;0;0;1;0;0;1;3792;0;0;1;0;0;1;1;3792;0;3792;1;1;
/org.eclipse.ui.workbench/Eclipse UI/org/eclipse/ui/commands/ICommandDefinitionHandle.java;1;0;2;1;0;0;0;2;0;1;2;1389;0;0;1;0;0;2;2;1389;0;1400;2;1;
/org.eclipse.jdt.ui.tests.refactoring/resources/ExtractMethodWorkSpace/ExtractMethodTests/locals_out/A_test525.java;1;0;1;1;0;0;0;1;6;0;1;844;6;6;1;0;0;1;1;844;0;844;1;1;
/org.eclipse.core.resources/src/org/eclipse/core/resources/IPathVariableChangeListener.java;1;0;2;1;1;1;1;1;4;0;1;4994;8;8;1;0;0;1;2;4994;0;5146;2;1;
/org.eclipse.debug.ui/ui/org/eclipse/debug/internal/ui/launchConfigurations/NewEnvironmentVariableDialog.java;2;0;4;1;1;1;1;3;49;2;2;4568;49;49;2;1;0;3;4;4837;1;5205;3;2;
/org.eclipse.core.tests.runtime/src/org/eclipse/core/tests/internal/plugins/FragmentResolveTest_6.java;1;0;1;1;0;0;0;1;0;0;1;3014;0;0;1;0;0;1;1;3014;0;3014;1;1;
/org.eclipse.jdt.ui/ui/org/eclipse/jdt/internal/ui/compare/JavaHistoryAction.java;6;1;16;1;4;4;4;12;143;1;12;1289;361;361;1;0;0;12;16;1289;0;6340;16;6;
/org.eclipse.jdt.ui.tests/ui/org/eclipse/jdt/ui/tests/astrewrite/ASTRewritingInsertBoundTest.java;2;0;9;1;1;1;1;8;505;1;8;920;1010;1010;1;0;0;8;9;920;0;5406;9;2;
/org.eclipse.swt/Eclipse SWT/photon/org/eclipse/swt/graphics/Color.java;1;1;2;1;2;2;2;0;4;0;0;5606;8;8;1;0;0;0;2;5606;0;6352;2;1;
/org.eclipse.jdt.ui.tests.refactoring/resources/ConvertAnonymousToNested/canConvert/A_test20_out.java;2;0;3;1;0;0;0;3;5;1;3;458;7;7;1;0;0;3;3;458;0;1607;3;2;
/org.eclipse.ui.forms/src/org/eclipse/ui/forms/FormWizard.java;1;0;3;1;0;0;0;3;3;1;3;4068;3;3;1;0;0;3;3;4068;0;5044;3;1;
/org.eclipse.jdt.ui/core extension/org/eclipse/text/edits/AbstractTransferEdit.java;1;0;4;1;0;0;0;4;4;2;3;1953;6;6;2;1;0;4;4;1985;1;1985;3;1;
/org.eclipse.jdt.ui/core refactoring/org/eclipse/jdt/internal/corext/refactoring/participants/xml/ObjectStateExpression.java;1;0;5;1;0;0;0;5;24;1;5;1033;55;55;1;0;0;5;5;1033;0;2682;5;1;
/org.eclipse.swt/Eclipse SWT PI/win32/org/eclipse/swt/internal/ole/win32/CONTROLINFO.java;1;0;1;1;0;0;0;1;4;0;1;2915;4;4;1;0;0;1;1;2915;0;2915;1;1;
/org.eclipse.jdt.ui/ui/org/eclipse/jdt/ui/jarpackager/IJarDescriptionReader.java;1;0;1;1;1;1;1;0;2;0;0;6340;2;2;1;0;0;0;1;6340;0;6340;1;1;
/org.eclipse.jdt.ui.tests.refactoring/resources/PullUp/test42/out/A.java;2;0;3;1;0;0;0;3;4;1;3;328;5;5;1;0;0;3;3;328;0;1690;3;2;
/org.eclipse.osgi/resolver/src/org/eclipse/osgi/internal/resolver/VersionConstraintImpl.java;3;1;7;1;5;5;5;2;65;1;2;3013;149;149;1;0;0;2;7;3013;0;6337;7;3;
/org.eclipse.team.ui/src/org/eclipse/team/internal/ui/target/UploadAction.java;2;0;3;1;0;0;0;3;4;1;3;790;6;6;1;0;0;3;3;790;0;2495;3;2;
/org.eclipse.team.ui/src/org/eclipse/team/ui/synchronize/AbstractSynchronizeScope.java;2;2;3;1;3;2;3;0;158;0;0;5594;172;172;2;0;1;0;3;5594;1;6131;2;2;
/org.eclipse.jdt.core.tests.model/workspace/Formatter/test496/A_out.java;1;0;1;1;1;1;1;0;0;0;0;5381;0;0;1;0;0;0;1;5381;0;5381;1;1;
/org.eclipse.jdt.ui/core refactoring/org/eclipse/jdt/internal/corext/refactoring/participants/xml/MethodPropertyTester.java;1;0;6;1;0;0;0;6;25;2;5;1125;33;33;2;1;0;6;6;1270;1;2546;5;1;
/org.eclipse.pde.ui/src/org/eclipse/pde/internal/ui/editor/build/RuntimeInfoSection.java;3;2;27;1;11;10;11;16;1778;3;12;1727;4652;4652;3;4;1;16;27;1767;5;6336;22;3;
/org.eclipse.jdt.core.tests.model/workspace/Formatter/test497/A_in.java;1;0;1;1;1;1;1;0;0;0;0;5623;0;0;1;0;0;0;1;5623;0;5623;1;1;
/org.eclipse.jdt.ui/ui/org/eclipse/jdt/internal/ui/search/SearchParticipantDescriptor.java;1;0;1;1;1;1;1;0;0;0;0;5590;0;0;1;0;0;0;1;5590;0;5590;1;1;
/org.eclipse.swt.tests/JUnit Tests/org/eclipse/swt/tests/junit/AllWidgetTests.java;1;0;1;1;0;0;0;1;1;0;1;1242;1;1;1;0;0;1;1;1242;0;1242;1;1;
/org.eclipse.pde.ui/src/org/eclipse/pde/internal/ui/editor/LinkSection.java;2;1;2;1;2;2;2;0;4;0;0;5431;4;4;1;0;0;0;2;5431;0;5778;2;2;
/org.eclipse.swt/Eclipse SWT AWT/gtk/org/eclipse/swt/awt/SWT_AWT.java;5;2;16;2;10;8;10;6;41;2;5;3012;196;196;2;1;2;6;16;3012;3;6352;13;5;
/org.eclipse.ui.workbench/Eclipse UI/org/eclipse/ui/internal/commands/CategoryEvent.java;1;0;4;1;0;0;0;4;28;2;3;1500;28;28;2;1;0;4;4;2562;1;2823;3;1;
/org.eclipse.swt/Eclipse SWT/win32/org/eclipse/swt/widgets/Menu.java;6;1;24;2;7;7;7;17;72;3;13;33;360;360;3;4;0;17;24;4330;4;6352;20;6;
/org.eclipse.jdt.core/compiler/org/eclipse/jdt/internal/compiler/lookup/SignatureWrapper.java;1;0;1;1;0;0;0;1;0;0;1;4741;0;0;1;0;0;1;1;4741;0;4741;1;1;
/org.eclipse.jdt.ui/ui/org/eclipse/jdt/internal/ui/typehierarchy/HistoryListAction.java;3;0;4;1;1;1;1;3;3;1;3;1350;9;9;1;0;0;3;4;1350;0;6340;4;3;
/org.eclipse.search.tests/src/org/eclipse/search/tests/filesearch/LineAnnotationManagerTest.java;1;1;3;1;3;3;3;0;4;0;0;5815;7;7;1;0;0;0;3;5815;0;6116;3;1;
/org.eclipse.debug.ui/ui/org/eclipse/debug/internal/ui/stringsubstitution/StringVariableSelectionDialog.java;4;1;9;1;3;3;3;6;136;1;6;2088;337;337;1;0;0;6;9;2088;0;5648;9;4;
/org.eclipse.pde.ui/src/org/eclipse/pde/internal/ui/editor/manifest/NullToolBarManager.java;1;0;1;1;0;0;0;1;0;0;1;3235;0;0;1;0;0;1;1;3235;0;3235;1;1;
/org.eclipse.jdt.core.tests.model/workspace/Converter/src/test0096/Test.java;1;0;1;1;0;0;0;1;0;0;1;3714;0;0;1;0;0;1;1;3714;0;3714;1;1;
/org.eclipse.jdt.ui/core refactoring/org/eclipse/ltk/refactoring/core/ChangePerformException.java;1;0;2;1;0;0;0;2;0;1;2;3930;0;0;1;0;0;2;2;3930;0;4091;2;1;
/org.eclipse.ui.externaltools/External Tools Base/org/eclipse/ui/externaltools/internal/registry/ExternalToolVariable.java;1;0;1;1;0;0;0;1;0;0;1;321;0;0;1;0;0;1;1;321;0;321;1;1;
/org.eclipse.swt/Eclipse SWT PI/gtk1x/org/eclipse/swt/internal/gtk/GtkWidget.java;1;0;1;1;0;0;0;1;0;0;1;2327;0;0;1;0;0;1;1;2327;0;2327;1;1;
/org.eclipse.text/src/org/eclipse/jface/text/TypedRegion.java;1;0;1;1;1;1;1;0;19;0;0;6298;19;19;1;0;0;0;1;6298;0;6298;1;1;
/org.eclipse.team.ui/src/org/eclipse/team/ui/sync/SyncInfoSynchronizeTarget.java;1;0;1;1;0;0;0;1;0;0;1;2378;0;0;1;0;0;1;1;2378;0;2378;1;1;
/org.eclipse.ui.views/src/org/eclipse/ui/views/internal/markers/TaskFilter.java;1;0;2;1;0;0;0;2;0;0;1;749;0;0;2;1;0;2;2;749;1;749;1;1;
/org.eclipse.jdt.ui.examples.javafamily/src/org/eclipse/text/reconcilerpipe/IReconcilePipeParticipant.java;1;0;2;1;0;0;0;2;0;1;2;1071;0;0;1;0;0;2;2;1071;0;1629;2;1;
/org.eclipse.core.resources/src/org/eclipse/core/internal/indexing/Index.java;1;0;1;1;1;1;1;0;33;0;0;5146;33;33;1;0;0;0;1;5146;0;5146;1;1;
/org.eclipse.debug.ui/ui/org/eclipse/debug/internal/ui/views/memory/AbstractMemoryAction.java;1;0;1;1;1;1;1;0;0;0;0;5254;0;0;1;0;0;0;1;5254;0;5254;1;1;
/org.eclipse.search/new search/org/eclipse/search2/internal/ui/text/SearchResult.java;1;0;2;1;0;0;0;2;0;1;2;3474;0;0;1;0;0;2;2;3474;0;3711;2;1;
/org.eclipse.text/projection/org/eclipse/jface/text/projection/SegmentUpdater.java;1;1;4;1;3;3;3;1;12;0;1;4516;16;16;1;0;0;1;4;4516;0;6301;4;1;
/org.eclipse.update.tests.core/src/org/eclipse/update/tests/configurations/AllConfigurationsTests.java;1;1;2;1;2;2;2;0;4;0;0;5362;6;6;1;0;0;0;2;5362;0;6336;2;1;
/org.eclipse.team.cvs.ui/src/org/eclipse/team/internal/ccvs/ui/model/RemoteFileElement.java;1;0;1;1;0;0;0;1;2;0;1;990;2;2;1;0;0;1;1;990;0;990;1;1;
/org.eclipse.ui.ide/src/org/eclipse/ui/views/markers/internal/ActionSelectAll.java;4;1;4;1;2;2;2;2;17;1;2;2208;20;20;1;0;0;2;4;2208;0;6338;4;4;
/org.eclipse.ui.tests/Eclipse UI Tests/org/eclipse/ui/tests/api/workbenchpart/TitleTestView.java;1;0;1;1;1;1;1;0;0;0;0;6101;0;0;1;0;0;0;1;6101;0;6101;1;1;
/org.eclipse.ui.ide/src/org/eclipse/ui/views/bookmarkexplorer/PasteBookmarkAction.java;1;0;1;1;0;0;0;1;0;0;1;2208;0;0;1;0;0;1;1;2208;0;2208;1;1;
/org.eclipse.jdt.ui/ui/org/eclipse/jdt/internal/ui/callhierarchy/CalleeAnalyzerVisitor.java;1;0;2;1;0;0;0;2;0;1;2;155;0;0;1;0;0;2;2;155;0;169;2;1;
/org.eclipse.debug.ui/ui/org/eclipse/debug/internal/ui/console/MessageConsoleViewer.java;2;0;3;1;0;0;0;3;11;1;3;1418;11;11;1;0;0;3;3;1418;0;2060;3;2;
/org.eclipse.jdt.ui/ui refactoring/org/eclipse/jdt/internal/ui/refactoring/actions/UndoManagerAction.java;3;0;7;2;1;1;1;6;44;2;5;42;69;69;2;1;0;6;7;4575;1;5162;6;3;
/org.eclipse.core.tools/src/org/eclipse/core/tools/runtime/LoadedClassesViewContentProvider.java;1;0;1;1;1;1;1;0;0;0;0;6302;0;0;1;0;0;0;1;6302;0;6302;1;1;
/org.eclipse.jdt.ui/ui refactoring/org/eclipse/jdt/internal/ui/refactoring/contentassist/ControlContentAssistHelper.java;3;2;13;2;4;2;4;9;210;4;5;3648;422;422;4;4;2;9;13;3658;6;5197;7;3;
/org.eclipse.team.examples.filesystem/src/org/eclipse/team/examples/pessimistic/ui/SourceManagementAction.java;1;0;2;1;1;1;1;1;71;0;1;3368;71;71;1;0;0;1;2;3368;0;6103;2;1;
/org.eclipse.swt/Eclipse SWT/common_j2se/org/eclipse/swt/internal/Compatibility.java;4;1;4;1;2;2;2;2;17;1;2;4062;39;39;1;0;0;2;4;4062;0;6352;4;4;
/org.eclipse.ui.workbench/Eclipse UI/org/eclipse/ui/internal/commands/util/old/Util.java;1;0;2;1;0;0;0;2;0;1;2;1222;0;0;1;0;0;2;2;1222;0;1321;2;1;
/org.eclipse.swt/Eclipse SWT/carbon2/org/eclipse/swt/widgets/TreeItem.java;1;0;1;1;0;0;0;1;0;0;1;231;0;0;1;0;0;1;1;231;0;231;1;1;
/org.eclipse.ui.examples.javaeditor/Eclipse Java Editor Example/org/eclipse/ui/examples/javaeditor/spelling/SpellCheckEngine.java;1;0;1;1;0;0;0;1;0;0;1;2565;0;0;1;0;0;1;1;2565;0;2565;1;1;
/org.eclipse.ltk.core.refactoring/src/org/eclipse/ltk/core/refactoring/Change.java;1;1;10;1;7;7;7;3;13;1;3;4845;51;51;1;0;0;3;10;4845;0;6338;10;1;
/org.eclipse.osgi/core/adaptor/org/eclipse/osgi/framework/util/SecurePermissionStorage.java;2;2;3;1;3;2;3;0;4;0;0;5116;6;6;2;0;1;0;3;5116;1;6337;2;2;
/org.eclipse.help.base/src/org/eclipse/help/internal/search/AnalyzerDescriptor.java;1;1;6;1;3;3;3;3;74;2;2;1740;142;142;2;1;0;3;6;1740;1;6337;5;1;
/org.eclipse.pde.ui/src/org/eclipse/pde/internal/ui/editor/plugin/PluginExportAction.java;2;1;4;1;4;4;4;0;30;0;0;5431;53;53;1;0;0;0;4;5431;0;6336;4;2;
/org.eclipse.jdt.core.tests.model/workspace/Converter/test0485/A.java;1;0;2;1;0;0;0;2;0;1;2;1289;0;0;1;0;0;2;2;1289;0;3714;2;1;
/org.eclipse.update.core/src/org/eclipse/update/operations/IInstallFeatureOperation.java;1;3;9;1;4;2;4;5;18;2;4;825;31;31;3;1;2;5;9;6335;3;6335;6;1;
/org.eclipse.ant.ui/Ant Tools Support/org/eclipse/ant/internal/ui/views/AntViewLabelProvider.java;1;0;4;1;1;1;1;3;4;1;3;1811;7;7;1;0;0;3;4;1811;0;6336;4;1;
/org.eclipse.jdt.core.tests.model/workspace/Converter/src/test0365/A.java;1;0;1;1;0;0;0;1;0;0;1;3714;0;0;1;0;0;1;1;3714;0;3714;1;1;
/org.eclipse.team.tests.cvs.core/src/org/eclipse/team/tests/ccvs/ui/old/LogEntryContainer.java;1;0;2;1;0;0;0;2;0;1;2;2632;0;0;1;0;0;2;2;2632;0;4216;2;1;
/org.eclipse.jdt.ui.tests.refactoring/resources/ChangeTypeRefactoring/positive/A_testLocalVarCast_out.java;1;0;1;1;0;0;0;1;0;0;1;2844;0;0;1;0;0;1;1;2844;0;2844;1;1;
/org.eclipse.ui.views/src/org/eclipse/ui/views/internal/markers/RevealMarkerAction.java;1;0;2;1;0;0;0;2;0;1;2;265;0;0;1;0;0;2;2;265;0;749;2;1;
/org.eclipse.jdt.core.tests.model/workspace/Formatter/test333/A_out.java;1;0;1;1;0;0;0;1;0;0;1;2689;0;0;1;0;0;1;1;2689;0;2689;1;1;
/org.eclipse.ui.tests/Eclipse UI Tests/org/eclipse/ui/tests/dialogs/UIWizardsAuto.java;2;0;2;1;1;1;1;1;18;0;1;4969;20;20;1;0;0;1;2;4969;0;6338;2;2;
/org.eclipse.debug.ui/ui/org/eclipse/debug/internal/ui/views/console/ConsoleRemoveAllTerminatedAction.java;3;0;3;1;1;1;1;2;73;1;2;1415;90;90;1;0;0;2;3;1415;0;6336;3;3;
/org.eclipse.help.ui/src/org/eclipse/help/ui/internal/browser/SystemBrowserFactory.java;1;1;3;1;2;2;2;1;16;0;1;4590;36;36;1;0;0;1;3;4590;0;6337;3;1;
/org.eclipse.ui.workbench/Eclipse UI/org/eclipse/ui/internal/csm/roles/Role.java;1;0;7;1;0;0;0;7;72;2;5;2213;185;185;2;2;0;7;7;2370;2;2441;5;1;
/org.eclipse.jdt.core.tests.model/workspace/Formatter/test043/A_out.java;1;0;1;1;0;0;0;1;0;0;1;2425;0;0;1;0;0;1;1;2425;0;2425;1;1;
/org.eclipse.team.ui/src/org/eclipse/team/ui/synchronize/viewers/ISynchronizeModelElement.java;1;0;3;1;0;0;0;3;2;1;3;4588;2;2;1;0;0;3;3;4588;0;4632;3;1;
/org.eclipse.jdt.core.tests.model/workspace/JavaSearch/src/j4/CC47209.java;1;0;1;1;0;0;0;1;0;0;1;3330;0;0;1;0;0;1;1;3330;0;3330;1;1;
/org.eclipse.ui.workbench/Eclipse UI/org/eclipse/ui/internal/commands/older/Category.java;1;0;2;1;0;0;0;2;8;0;1;2562;8;8;2;1;0;2;2;2562;1;2562;1;1;
/org.eclipse.core.tests.runtime/src/org/eclipse/core/tests/runtime/locks/TestRunnable.java;1;0;2;1;0;0;0;2;0;1;2;698;0;0;1;0;0;2;2;698;0;850;2;1;
/org.eclipse.jdt.debug.tests/testprograms/ArrayTests.java;1;0;1;1;0;0;0;1;0;0;1;2564;0;0;1;0;0;1;1;2564;0;2564;1;1;
/org.eclipse.jdt.core.tests.model/workspace/Converter/test0226/Test.java;1;0;1;1;0;0;0;1;0;0;1;3714;0;0;1;0;0;1;1;3714;0;3714;1;1;
/org.eclipse.update.core/src/org/eclipse/update/internal/core/FeatureExecutableContentProvider.java;3;2;5;1;3;2;3;2;40;1;2;890;89;89;2;0;1;2;5;5664;1;6336;4;3;
/org.eclipse.jdt.ui/core refactoring/org/eclipse/jdt/internal/corext/refactoring/typeconstraints/SubtypeConstraint.java;1;0;3;1;0;0;0;3;3;1;3;42;3;3;1;0;0;3;3;42;0;64;3;1;
/org.eclipse.swt.examples/src/org/eclipse/swt/examples/controlexample/ToolBarTab.java;3;0;3;1;0;0;0;3;14;1;3;1560;26;26;1;0;0;3;3;1560;0;2750;3;3;
/org.eclipse.ui.workbench/Eclipse UI/org/eclipse/ui/internal/csm/roles/api/IRoleManagerListener.java;1;0;4;1;0;0;0;4;18;2;3;2213;20;20;2;1;0;4;4;2238;1;2238;3;1;
/org.eclipse.jdt.core/dom/org/eclipse/jdt/core/dom/VariableBinding.java;3;0;7;2;1;1;1;6;80;1;6;2729;250;250;1;0;0;6;7;2729;0;5639;7;3;
/org.eclipse.jdt.core/model/org/eclipse/jdt/internal/core/util/ILRUCacheable.java;1;0;1;1;0;0;0;1;2;0;1;3560;2;2;1;0;0;1;1;3560;0;3560;1;1;
/org.eclipse.ui.ide/src/org/eclipse/ui/views/markers/internal/FieldSeverity.java;4;0;5;2;2;1;2;3;41;1;3;2208;82;82;2;0;1;3;5;6338;1;6338;4;4;
/org.eclipse.jdt.core/model/org/eclipse/jdt/internal/core/util/Annotation.java;1;0;1;1;0;0;0;1;0;0;1;4466;0;0;1;0;0;1;1;4466;0;4466;1;1;
/org.eclipse.jdt.ui.tests.refactoring/resources/MoveInnerToTopLevel/test_nonstatic_30/out/Inner.java;2;0;2;1;1;1;1;1;2;0;1;305;4;4;1;0;0;1;2;305;0;5854;2;2;
/org.eclipse.jdt.core.tests.model/workspace/Formatter/test264/A_out.java;1;0;1;1;0;0;0;1;0;0;1;2442;0;0;1;0;0;1;1;2442;0;2442;1;1;
/org.eclipse.jdt.ui/core extension/org/eclipse/jdt/internal/corext/userlibrary/UserLibraryManager.java;1;1;3;1;2;2;2;1;40;0;1;4407;40;40;1;0;0;1;3;4407;0;5226;3;1;
/org.eclipse.jdt.ui/ui/org/eclipse/jdt/internal/ui/browsing/JavaBrowsingContentProvider.java;3;1;8;2;2;2;2;6;61;2;5;227;140;140;2;1;0;6;8;3961;1;6340;7;3;
/org.eclipse.core.tests.runtime/src/org/eclipse/core/tests/internal/plugins/SoftPrereqTest_12.java;1;0;1;1;0;0;0;1;0;0;1;3014;0;0;1;0;0;1;1;3014;0;3014;1;1;
/org.eclipse.jface.text/src/org/eclipse/jface/text/templates/TemplateCompletionProcessor.java;3;1;7;1;4;4;4;3;20;1;3;4632;44;44;1;0;0;3;7;4632;0;6353;7;3;
/org.eclipse.jdt.ui/ui/org/eclipse/jdt/internal/ui/JavaUIStatus.java;2;0;2;1;1;1;1;1;8;0;1;4675;10;10;1;0;0;1;2;4675;0;6340;2;2;
/org.eclipse.jdt.ui/ui/org/eclipse/jdt/ui/actions/AddGetterSetterAction.java;4;1;31;1;5;5;5;26;557;2;23;363;2580;2580;2;3;0;26;31;504;3;6340;28;4;
/org.eclipse.jdt.ui/core extension/org/eclipse/jdt/internal/corext/template/TemplateContext.java;1;0;1;1;0;0;0;1;0;0;1;4258;0;0;1;0;0;1;1;4258;0;4258;1;1;
/org.eclipse.help/src/org/eclipse/help/internal/browser/macosx/DefaultBrowserAdapter.java;1;0;1;1;0;0;0;1;0;0;1;2732;0;0;1;0;0;1;1;2732;0;2732;1;1;
/org.eclipse.pde.ui/src/org/eclipse/pde/internal/ui/wizards/templates/PopupMenuNewWizard.java;3;1;5;1;4;4;4;1;12;0;1;3986;27;27;1;0;0;1;5;3986;0;6336;5;3;
/org.eclipse.jdt.ui.tests.refactoring/resources/RenamePackage/testImportFromMultiRoots1/out/srcTest/p/p/ATest.java;1;0;3;1;0;0;0;3;8;1;3;3219;10;10;1;0;0;3;3;3219;0;4585;3;1;
/org.eclipse.ant.ui/Ant Tools Support/org/eclipse/ant/internal/ui/preferences/AntJREPage.java;1;0;2;1;0;0;0;2;0;0;1;1811;0;0;2;1;0;2;2;1811;1;1811;1;1;
/org.eclipse.ui.workbench/Eclipse UI/org/eclipse/ui/internal/roles/ui/RoleContentProvider.java;1;0;4;1;0;0;0;4;38;1;4;2444;39;39;1;0;0;4;4;2444;0;2864;4;1;
/org.eclipse.team.webdav/src/org/eclipse/team/internal/webdav/ui/subscriber/WebDavGetAction.java;2;2;7;1;3;2;3;4;37;1;4;3499;63;63;2;0;1;4;7;5508;1;6337;6;2;
/org.eclipse.text/src/org/eclipse/jface/text/IDocumentInformationMappingExtension.java;2;2;5;2;4;3;4;1;45;0;1;4516;55;55;2;0;1;1;5;5099;1;6297;4;2;
/org.eclipse.ant.tests.ui/test plugin/org/eclipse/ant/tests/ui/testplugin/DebugElementKindEventWaiter.java;1;0;1;1;0;0;0;1;0;0;1;1610;0;0;1;0;0;1;1;1610;0;1610;1;1;
/org.eclipse.team.ui/src/org/eclipse/team/internal/ui/ProjectSetExportWizard.java;1;0;2;1;0;0;0;2;4;1;2;917;4;4;1;0;0;2;2;917;0;993;2;1;
/org.eclipse.update.ui/srcnew/org/eclipse/update/internal/ui/WebBookmarksAction.java;1;0;3;1;0;0;0;3;5;2;2;699;5;5;2;1;0;3;3;699;1;768;2;1;
/org.eclipse.test/src/org/eclipse/test/CoreTestApplication.java;2;1;4;1;2;2;2;2;7;1;2;632;14;14;1;0;0;2;4;632;0;6297;4;2;
/org.eclipse.jface.text/src/org/eclipse/jface/text/IUndoManager.java;2;1;2;1;2;2;2;0;20;0;0;6340;22;22;1;0;0;0;2;6340;0;6359;2;2;
/org.eclipse.text/src/org/eclipse/jface/text/ParentChildMapping.java;1;0;2;1;1;1;1;1;2;0;1;4623;2;2;1;0;0;1;2;4623;0;5177;2;1;
/org.eclipse.team.cvs.ui/src/org/eclipse/team/internal/ccvs/ui/merge/OverrideUpdateMergeAction.java;1;0;1;1;0;0;0;1;0;0;1;4217;0;0;1;0;0;1;1;4217;0;4217;1;1;
/org.eclipse.jdt.core.tests.model/workspace/Converter/src/test0098/Test.java;1;0;1;1;0;0;0;1;0;0;1;3714;0;0;1;0;0;1;1;3714;0;3714;1;1;
/org.eclipse.debug.core/core/org/eclipse/debug/core/ILaunchConfigurationWorkingCopy.java;1;0;1;1;0;0;0;1;13;0;1;3276;13;13;1;0;0;1;1;3276;0;3276;1;1;
/org.eclipse.jdt.ui/core refactoring/org/eclipse/ltk/internal/core/refactoring/TextChanges.java;1;0;3;1;0;0;0;3;4;1;3;4510;4;4;1;0;0;3;3;4510;0;4864;3;1;
/org.eclipse.jdt.debug.tests/tests/org/eclipse/jdt/debug/tests/core/CommandArgumentTests.java;2;0;3;1;0;0;0;3;9;1;3;1860;11;11;1;0;0;3;3;1860;0;2166;3;2;
/org.eclipse.ui.workbench/Eclipse UI/org/eclipse/ui/internal/contexts/ws/WorkbenchContextSupport.java;5;2;34;2;11;10;11;23;486;4;15;3066;1631;1631;4;8;1;23;34;4949;9;6338;25;5;
/org.eclipse.ant.ui/Ant Editor/org/eclipse/ant/ui/internal/dtd/util/SortedSet.java;1;0;2;1;0;0;0;2;0;1;2;250;0;0;1;0;0;2;2;250;0;1811;2;1;
/org.eclipse.jdt.ui/ui/org/eclipse/jdt/ui/actions/FormatAllAction.java;3;2;7;2;7;6;7;0;37;0;0;5608;55;55;2;0;1;0;7;6334;1;6352;6;3;
/org.eclipse.swt/Eclipse SWT/common/org/eclipse/swt/internal/image/WinBMPFileFormat.java;2;1;2;1;2;2;2;0;4;0;0;5661;8;8;1;0;0;0;2;5661;0;6352;2;2;
/org.eclipse.swt/Eclipse SWT/gtk/org/eclipse/swt/widgets/Scrollable.java;6;1;12;1;2;2;2;10;21;2;9;269;80;80;2;1;0;10;12;4128;1;6352;11;6;
/org.eclipse.update.ui.forms/src/org/eclipse/ui/forms/parts/SelectableControl.java;1;0;2;1;0;0;0;2;0;1;2;3071;0;0;1;0;0;2;2;3071;0;3095;2;1;
/org.eclipse.jdt.ui.tests.refactoring/resources/RenamePackage/test6/in/r/A.java;1;0;1;1;1;1;1;0;0;0;0;6118;0;0;1;0;0;0;1;6118;0;6118;1;1;
/org.eclipse.ui.ide/src/org/eclipse/ui/part/ResourceTransfer.java;2;0;3;1;0;0;0;3;4;1;3;1511;4;4;1;0;0;3;3;1511;0;2263;3;2;
/org.eclipse.debug.ui/ui/org/eclipse/debug/internal/ui/views/launch/LaunchView.java;4;3;67;3;28;21;28;39;227;3;33;455;1805;1805;3;6;7;39;67;1220;13;6227;54;4;
/org.eclipse.team.webdav/src/org/eclipse/team/internal/ui/target/subscriber/ContainerContentProvider.java;2;0;3;1;1;1;1;2;104;1;2;3494;106;106;1;0;0;2;3;3494;0;6337;3;2;
/org.eclipse.ui.views/src/org/eclipse/ui/views/bookmarkexplorer/BookmarkMessages.java;1;0;1;1;0;0;0;1;0;0;1;2738;0;0;1;0;0;1;1;2738;0;2738;1;1;
/org.eclipse.pde.ui/src/org/eclipse/pde/internal/ui/wizards/extension/PointSelectionPage.java;3;2;15;1;8;7;8;7;401;1;7;368;1030;1030;2;0;1;7;15;5496;1;6336;14;3;
/org.eclipse.ui.examples.readmetool/Eclipse UI Examples Readme Tool/org/eclipse/ui/examples/readmetool/MarkElement.java;1;0;2;1;0;0;0;2;13;1;2;4071;26;26;1;0;0;2;2;4071;0;4083;2;1;
/org.eclipse.core.tools.resources/src/org/eclipse/core/tools/resources/ResourceChangeView.java;1;0;1;1;1;1;1;0;0;0;0;6302;0;0;1;0;0;0;1;6302;0;6302;1;1;
/org.eclipse.osgi/eclipseAdaptor/src/org/eclipse/core/runtime/adaptor/BundleLocalizationImpl.java;2;2;5;1;5;3;5;0;193;0;0;5116;196;196;2;0;2;0;5;5116;2;6133;3;2;
/org.eclipse.jdt.ui.tests.refactoring/resources/MoveInnerToTopLevel/test_nonstatic_10/out/Inner.java;2;0;2;1;1;1;1;1;2;0;1;305;4;4;1;0;0;1;2;305;0;5854;2;2;
/org.eclipse.ui.internal.r21presentation/src/org/eclipse/ui/internal/r21presentation/widgets/CTabFolderEvent.java;1;0;1;1;1;1;1;0;0;0;0;5275;0;0;1;0;0;0;1;5275;0;5275;1;1;
/org.eclipse.ui.workbench/Eclipse UI/org/eclipse/ui/internal/progress/ProgressContentProvider.java;3;1;34;2;2;2;2;32;399;4;23;320;1749;1749;4;9;0;32;34;1110;9;6338;25;3;
/org.eclipse.text/projection/org/eclipse/jface/text/projection/ProjectionTextStore.java;1;1;3;1;2;2;2;1;9;0;1;4516;11;11;1;0;0;1;3;4516;0;6301;3;1;
/org.eclipse.pde.core/src/org/eclipse/pde/internal/core/ExternalModelManager.java;3;1;17;1;5;5;5;12;202;2;11;2100;336;336;2;1;0;12;17;2229;1;6336;16;3;
/org.eclipse.pde.core/src/org/eclipse/pde/internal/core/bundle/WorkspaceBundleModel.java;3;1;6;1;4;4;4;2;21;1;2;2184;29;29;1;0;0;2;6;2184;0;6336;6;3;
/org.eclipse.jface.text/src/org/eclipse/jface/text/DefaultAutoIndentStrategy.java;2;1;2;1;2;2;2;0;9;0;0;6340;11;11;1;0;0;0;2;6340;0;6359;2;2;
/org.eclipse.ui.editors/src/org/eclipse/ui/texteditor/DocumentProviderRegistry.java;3;1;8;1;3;3;3;5;301;2;4;1983;364;364;2;1;0;5;8;3675;1;6334;7;3;
/org.eclipse.ui.intro/src/org/eclipse/ui/intro/internal/model/loader/IntroConfigParser.java;1;0;2;1;0;0;0;2;0;0;1;4948;0;0;2;1;0;2;2;4948;1;4948;1;1;
/org.eclipse.jdt.ui/core extension/org/eclipse/jdt/internal/corext/textmanipulation/TextRange.java;1;0;7;1;0;0;0;7;143;3;5;1012;179;179;3;2;0;7;7;1946;2;1946;5;1;
/org.eclipse.jdt.ui/ui/org/eclipse/jdt/ui/JavaElementImageDescriptor.java;2;2;5;2;4;2;4;1;73;0;1;4081;136;136;2;0;2;1;5;5403;2;6334;3;2;
/org.eclipse.jdt.core.tests.model/workspace/Formatter/test037/A_in.java;1;0;1;1;0;0;0;1;0;0;1;2425;0;0;1;0;0;1;1;2425;0;2425;1;1;
/org.eclipse.team.cvs.ui/src/org/eclipse/team/internal/ccvs/ui/model/RepositoryLocationSchedulingRule.java;1;0;1;1;0;0;0;1;0;0;1;1984;0;0;1;0;0;1;1;1984;0;1984;1;1;
/org.eclipse.jdt.ui/ui/org/eclipse/jdt/internal/ui/viewsupport/GoToBackProgressMonitorDialog.java;1;0;3;1;0;0;0;3;6;1;3;4627;6;6;1;0;0;3;3;4627;0;4996;3;1;
/org.eclipse.jdt.core.tests.model/workspace/Converter/test0232/Test.java;1;0;1;1;0;0;0;1;0;0;1;3714;0;0;1;0;0;1;1;3714;0;3714;1;1;
/org.eclipse.ui.ide/src/org/eclipse/ui/actions/CreateFolderAction.java;2;0;5;1;0;0;0;5;15;1;5;1511;20;20;1;0;0;5;5;1511;0;2263;5;2;
/org.eclipse.ui.workbench/Eclipse UI/org/eclipse/ui/internal/csm/activities/workbench/ActivityActivationService.java;1;0;2;1;0;0;0;2;0;1;2;2310;0;0;1;0;0;2;2;2310;0;2371;2;1;
/org.eclipse.text/src/org/eclipse/jface/text/templates/ContextTypeRegistry.java;1;0;4;1;0;0;0;4;54;2;3;4259;107;107;2;1;0;4;4;4627;1;4627;3;1;
/org.eclipse.jdt.core.tests.model/workspace/Formatter/test414/A_in.java;1;0;1;1;0;0;0;1;0;0;1;3460;0;0;1;0;0;1;1;3460;0;3460;1;1;
/org.eclipse.core.tests.resources/src/org/eclipse/core/tests/resources/session/TestBug20127.java;1;0;2;1;2;1;2;0;123;0;0;5147;123;123;2;0;1;0;2;5147;1;5147;1;1;
/org.eclipse.jdt.core.tests.model/workspace/Converter/src/Hello.java;1;0;1;1;0;0;0;1;0;0;1;3714;0;0;1;0;0;1;1;3714;0;3714;1;1;
/org.eclipse.ui.workbench.texteditor/src/org/eclipse/ui/internal/texteditor/SharedTextColors.java;2;0;2;1;0;0;0;2;0;1;2;1644;0;0;1;0;0;2;2;1644;0;2741;2;2;
/org.eclipse.jdt.core.tests.model/workspace/Converter/src/test0536/A.java;1;0;1;1;0;0;0;1;0;0;1;3813;0;0;1;0;0;1;1;3813;0;3813;1;1;
/org.eclipse.jdt.core.tests.model/workspace/Formatter/test229/A_out.java;1;0;1;1;0;0;0;1;0;0;1;2437;0;0;1;0;0;1;1;2437;0;2437;1;1;
/org.eclipse.core.tests.resources/src/org/eclipse/core/tests/resources/ResourceDeltaVerifier.java;1;0;2;1;2;1;2;0;1201;0;0;5147;1201;1201;2;0;1;0;2;5147;1;5147;1;1;
/org.eclipse.pde.ui/src/org/eclipse/pde/internal/ui/wizards/NewWizard.java;3;1;4;1;3;3;3;1;77;0;1;4529;111;111;1;0;0;1;4;4529;0;6336;4;3;
/org.eclipse.jface/src/org/eclipse/jface/action/IContributionManager.java;2;1;2;1;2;2;2;0;4;0;0;5438;6;6;1;0;0;0;2;5438;0;6338;2;2;
/org.eclipse.jdt.core.tests.model/workspace/Converter/src/test0199/Test.java;1;0;1;1;0;0;0;1;0;0;1;3714;0;0;1;0;0;1;1;3714;0;3714;1;1;
/org.eclipse.sdk.tests-feature/plugins/org.eclipse.perfmsr.core/src/org/eclipse/perfmsr/core/PerformanceMonitorLinux.java;2;2;5;1;5;4;5;0;27;0;0;5638;38;38;2;0;1;0;5;5654;1;6342;4;2;
/org.eclipse.jdt.launching.macosx/macosx/org/eclipse/jdt/internal/ui/macbundler/BundleBuilder.java;1;0;2;1;0;0;0;2;15;1;2;3622;15;15;1;0;0;2;2;3622;0;4133;2;1;
/org.eclipse.debug.ui/ui/org/eclipse/debug/internal/ui/actions/ConsoleTerminateActionDelegate.java;1;0;1;1;0;0;0;1;0;0;1;1414;0;0;1;0;0;1;1;1414;0;1414;1;1;
/org.eclipse.ui.workbench.texteditor/src/org/eclipse/ui/internal/texteditor/quickdiff/compare/rangedifferencer/RangeDifference.java;2;1;5;1;2;2;2;3;67;1;3;1644;97;97;1;0;0;3;5;1644;0;6340;5;2;
/org.eclipse.ui.workbench/Eclipse UI/org/eclipse/ui/IResourceActionFilter.java;1;0;1;1;0;0;0;1;0;0;1;2737;0;0;1;0;0;1;1;2737;0;2737;1;1;
/org.eclipse.pde.ui/src_OSGi/org/eclipse/pde/internal/ui/osgi/wizards/project/NewBundleFragmentProjectWizard.java;2;0;4;1;0;0;0;4;3;2;3;2498;5;5;2;1;0;4;4;2498;1;3986;3;2;
/org.eclipse.jdt.ui.tests.refactoring/resources/IntroduceParameter/simple/ConstantExpression2.java;1;0;1;1;0;0;0;1;0;0;1;2281;0;0;1;0;0;1;1;2281;0;2281;1;1;
/org.eclipse.ant.core/src/org/eclipse/ant/internal/core/AntObject.java;1;1;7;1;2;2;2;5;34;1;5;1401;99;99;1;0;0;5;7;1401;0;6336;7;1;
/org.eclipse.swt/Eclipse SWT PI/motif/org/eclipse/swt/internal/motif/GnomeVFSMimeApplication.java;1;0;1;1;0;0;0;1;0;0;1;4333;0;0;1;0;0;1;1;4333;0;4333;1;1;
/org.eclipse.jdt.core.tests.model/workspace/Formatter/test284/A_in.java;1;0;1;1;0;0;0;1;0;0;1;2443;0;0;1;0;0;1;1;2443;0;2443;1;1;
/org.eclipse.compare/compare/org/eclipse/compare/internal/StructureCreatorDescriptor.java;1;0;1;1;1;1;1;0;0;0;0;5165;0;0;1;0;0;0;1;5165;0;5165;1;1;
/org.eclipse.ui.workbench/Eclipse UI/org/eclipse/ui/part/PluginTransfer.java;1;0;1;1;0;0;0;1;6;0;1;1;6;6;1;0;0;1;1;1;0;1;1;1;
/org.eclipse.jdt.core.tests.model/workspace/Converter/src/test0002/Test.java;1;0;1;1;0;0;0;1;0;0;1;3714;0;0;1;0;0;1;1;3714;0;3714;1;1;
/org.eclipse.swt.tests/JUnit Tests/org/eclipse/swt/tests/junit/Test_org_eclipse_swt_program_Program.java;1;0;1;1;0;0;0;1;46;0;1;2175;46;46;1;0;0;1;1;2175;0;2175;1;1;
/org.eclipse.ui.tests/Eclipse UI Tests/org/eclipse/ui/tests/api/IPageServiceTest.java;1;0;3;1;0;0;0;3;13;1;3;2738;17;17;1;0;0;3;3;2738;0;3091;3;1;
/org.eclipse.ant.ui/Ant Editor/org/eclipse/ant/internal/ui/editor/outline/AntEditorMarkerUpdater.java;1;1;11;1;7;7;7;4;84;2;3;4569;207;207;2;1;0;4;11;4852;1;6321;10;1;
/org.eclipse.jdt.core.tests.model/workspace/Converter/src/javadoc/test006/Test.java;1;0;1;1;0;0;0;1;0;0;1;3813;0;0;1;0;0;1;1;3813;0;3813;1;1;
/org.eclipse.jdt.core.tests.model/workspace/Converter/src/junit/extensions/TestSetup.java;1;0;1;1;0;0;0;1;0;0;1;3714;0;0;1;0;0;1;1;3714;0;3714;1;1;
/org.eclipse.osgi.tests/src/org/eclipse/osgi/tests/services/resolver/VersionRangeTests.java;1;0;1;1;1;1;1;0;0;0;0;5993;0;0;1;0;0;0;1;5993;0;5993;1;1;
/org.eclipse.swt.graphics.text/Eclipse SWT Custom Widgets/common/org/eclipse/swt/custom/StyledTextRenderer.java;2;1;18;1;2;2;2;16;137;3;13;3889;538;538;3;3;0;16;18;4472;3;5534;15;2;
/org.eclipse.jface/src/org/eclipse/jface/operation/ModalContext.java;2;1;3;1;2;2;2;1;2;0;1;1;5;5;1;0;0;1;3;1;0;6338;3;2;
/org.eclipse.jdt.core.tests.model/src/org/eclipse/jdt/core/tests/rewrite/describing/ASTRewritingStatementsTest.java;6;1;7;1;5;5;5;2;340;1;2;4711;521;521;1;0;0;2;7;4711;0;6336;7;6;
/org.eclipse.team.ui/src/org/eclipse/team/ui/synchronize/ISyncSetChangedListener.java;1;0;1;1;0;0;0;1;0;0;1;3286;0;0;1;0;0;1;1;3286;0;3286;1;1;
/org.eclipse.core.resources/src/org/eclipse/core/resources/IContainer.java;3;1;11;1;4;4;4;7;715;1;7;1909;977;977;1;0;0;7;11;1909;0;6339;11;3;
/org.eclipse.team.ui/src/org/eclipse/team/internal/ui/sync/views/SyncSetTreeContentProvider.java;2;0;9;1;0;0;0;9;108;2;8;488;149;149;2;1;0;9;9;1477;1;2632;8;2;
/org.eclipse.ui.workbench/Eclipse UI/org/eclipse/ui/internal/WorkbenchColors.java;4;0;7;1;1;1;1;6;347;1;6;4015;756;756;1;0;0;6;7;4015;0;6338;7;4;
/org.eclipse.jdt.ui/core refactoring/org/eclipse/ltk/core/refactoring/RefactoringStatus.java;1;0;4;1;0;0;0;4;3;1;4;4575;5;5;1;0;0;4;4;4575;0;4864;4;1;
/org.eclipse.team.core/src/org/eclipse/team/internal/core/PessimisticResourceRuleFactory.java;1;0;1;1;1;1;1;0;0;0;0;5112;0;0;1;0;0;0;1;5112;0;5112;1;1;
/org.eclipse.ui.ide/extensions/org/eclipse/ui/actions/CopyProjectAction.java;4;1;5;1;2;2;2;3;26;1;3;2263;36;36;1;0;0;3;5;2263;0;6338;5;4;
/org.eclipse.jdt.ui.tests.refactoring/resources/IntroduceParameter/simple/StaticGetter1.java;2;0;2;1;1;1;1;1;2;0;1;2281;2;2;1;0;0;1;2;2281;0;5851;2;2;
/org.eclipse.jdt.ui.tests.refactoring/resources/Copy/test_initializer_yes_method/in/A.java;1;0;1;1;0;0;0;1;0;0;1;685;0;0;1;0;0;1;1;685;0;685;1;1;
/org.eclipse.swt/Eclipse SWT PI/win32/org/eclipse/swt/internal/win32/NMCUSTOMDRAW.java;1;0;1;1;0;0;0;1;3;0;1;2915;3;3;1;0;0;1;1;2915;0;2915;1;1;
/org.eclipse.ui.workbench.texteditor/src/org/eclipse/ui/internal/texteditor/quickdiff/compare/rangedifferencer/DifferencesIterator.java;1;1;3;1;2;2;2;1;2;0;1;1644;4;4;1;0;0;1;3;1644;0;6340;3;1;
/org.eclipse.swt.opengl/win32/org/eclipse/swt/opengl/internal/win32/PIXELFORMATDESCRIPTOR.java;1;0;1;1;0;0;0;1;0;0;1;1175;0;0;1;0;0;1;1;1175;0;1175;1;1;
/org.eclipse.ui.workbench.texteditor/src/org/eclipse/ui/contentassist/ContentAssistHandler.java;3;5;8;2;8;4;8;0;36;0;0;5177;58;58;5;0;4;0;8;5177;4;6334;4;3;
/org.eclipse.jdt.core.tests.model/workspace/Converter/src/junit/runner/ReloadingTestSuiteLoader.java;1;0;1;1;0;0;0;1;0;0;1;3714;0;0;1;0;0;1;1;3714;0;3714;1;1;
/org.eclipse.help/src/org/eclipse/help/internal/toc/TocBuilder.java;1;1;5;1;3;3;3;2;37;1;2;2732;65;65;1;0;0;2;5;2732;0;6337;5;1;
/org.eclipse.ui.tests/Eclipse UI Tests/org/eclipse/ui/tests/dnd/WindowDropTarget.java;1;0;2;1;0;0;0;2;8;1;2;5007;8;8;1;0;0;2;2;5007;0;5066;2;1;
/org.eclipse.jdt.core.tests.model/workspace/Formatter/test273/A_out.java;1;0;2;1;0;0;0;2;4;1;2;2442;4;4;1;0;0;2;2;2442;0;2863;2;1;
/org.eclipse.debug.core/core/org/eclipse/debug/internal/core/ILogicalStructureTypeDelegate.java;1;0;2;1;0;0;0;2;0;1;2;2647;0;0;1;0;0;2;2;2647;0;2663;2;1;
/org.eclipse.swt/Eclipse SWT PI/carbon/org/eclipse/swt/internal/carbon/Rect.java;1;2;3;1;3;2;3;0;16;0;0;5534;20;20;2;0;1;0;3;5534;1;5614;2;1;
/org.eclipse.jdt.core.tests.compiler/src/org/eclipse/jdt/core/tests/compiler/regression/LocalVariableTest.java;2;0;2;1;0;0;0;2;2;1;2;1785;2;2;1;0;0;2;2;1785;0;2389;2;2;
/org.eclipse.ant.ui/Ant Editor/org/eclipse/ant/internal/ui/editor/formatter/XmlDocumentFormattingStrategy.java;1;1;8;1;4;4;4;4;120;2;3;3916;225;225;2;1;0;4;8;3916;1;5901;7;1;
/org.eclipse.sdk.tests-feature/plugins/org.eclipse.perfmsr.ui/src/org/eclipse/perfmsr/ui/UploadDialog.java;2;1;4;1;3;3;3;1;14;0;1;4845;29;29;1;0;0;1;4;4845;0;6342;4;2;
/org.eclipse.core.resources/src/org/eclipse/core/internal/resources/MarkerReader_2.java;2;0;2;1;1;1;1;1;205;0;1;1744;207;207;1;0;0;1;2;1744;0;5146;2;2;
/org.eclipse.ui.workbench/Eclipse UI/org/eclipse/ui/internal/util/Util.java;4;1;23;1;3;3;3;20;785;2;19;1220;1513;1513;2;1;0;20;23;1711;1;6338;22;4;
/org.eclipse.core.runtime.osgi/src/org/eclipse/core/internal/registry/RegistryCacheWriter.java;2;0;3;2;0;0;0;3;7;2;2;3013;7;7;2;1;0;3;3;3030;1;3030;2;2;
/org.eclipse.pde.ui/src_Forms/org/eclipse/pde/internal/ui/neweditor/site/FeaturesPage.java;3;1;3;1;2;2;2;1;1;0;1;4832;1;1;1;0;0;1;3;4832;0;5431;3;3;
/org.eclipse.update.ui/src/org/eclipse/update/internal/ui/wizards/SearchRunner.java;3;0;10;1;1;1;1;9;82;1;9;200;126;126;1;0;0;9;10;200;0;6122;10;3;
/org.eclipse.jdt.core.tests.model/workspace/Converter/src/test0473/A.java;1;0;1;1;0;0;0;1;0;0;1;3714;0;0;1;0;0;1;1;3714;0;3714;1;1;
/org.eclipse.ltk.core.refactoring/src/org/eclipse/ltk/core/refactoring/participants/RefactoringStyles.java;1;0;2;1;0;0;0;2;0;1;2;4845;0;0;1;0;0;2;2;4845;0;5052;2;1;
/org.eclipse.team.cvs.ui/src/org/eclipse/team/internal/ccvs/ui/CVSAbstractResolutionGenerator.java;1;0;1;1;0;0;0;1;0;0;1;2040;0;0;1;0;0;1;1;2040;0;2040;1;1;
/org.eclipse.ui.ide/src/org/eclipse/ui/dialogs/WizardImportPage.java;2;0;3;1;0;0;0;3;22;1;3;1511;22;22;1;0;0;3;3;1511;0;2263;3;2;
/org.eclipse.team.ui/src/org/eclipse/team/ui/sync/AbstractSynchronizeParticipant.java;1;0;1;1;0;0;0;1;0;0;1;2463;0;0;1;0;0;1;1;2463;0;2463;1;1;
/org.eclipse.jdt.ui.tests.refactoring/resources/Delete/testDeleteWithinCu8/in/A.java;1;0;1;1;0;0;0;1;0;0;1;442;0;0;1;0;0;1;1;442;0;442;1;1;
/org.eclipse.jdt.core/compiler/org/eclipse/jdt/internal/compiler/env/ISourceMethod.java;1;0;1;1;0;0;0;1;2;0;1;3560;2;2;1;0;0;1;1;3560;0;3560;1;1;
/org.eclipse.jface/src/org/eclipse/jface/action/Separator.java;3;0;3;1;0;0;0;3;11;1;3;3220;26;26;1;0;0;3;3;3220;0;3310;3;3;
/org.eclipse.pde.ui/src/org/eclipse/pde/internal/ui/wizards/project/ConvertJavaToPDEProjectAction.java;1;0;1;1;0;0;0;1;0;0;1;571;0;0;1;0;0;1;1;571;0;571;1;1;
/org.eclipse.core.tests.runtime/src/org/eclipse/core/tests/internal/runtimetests/SampleJPB.java;1;0;1;1;1;1;1;0;21;0;0;5149;21;21;1;0;0;0;1;5149;0;5149;1;1;
/org.eclipse.swt/Eclipse SWT/gtk1x/org/eclipse/swt/widgets/Decorations.java;2;0;2;1;0;0;0;2;4;1;2;110;4;4;1;0;0;2;2;110;0;2327;2;2;
/org.eclipse.ui.workbench/Eclipse UI/org/eclipse/ui/internal/commands/GestureConfigurationHandle.java;1;0;2;1;0;0;0;2;0;1;2;1321;0;0;1;0;0;2;2;1321;0;1340;2;1;
/org.eclipse.ui.editors/extensions/org/eclipse/ui/internal/SystemSummaryMessages.java;1;0;1;1;0;0;0;1;0;0;1;2741;0;0;1;0;0;1;1;2741;0;2741;1;1;
/org.eclipse.jdt.core/search/org/eclipse/jdt/internal/core/search/indexing/BinaryIndexer.java;4;1;11;1;2;2;2;9;1005;1;9;259;1247;1247;1;0;0;9;11;259;0;5614;11;4;
/org.eclipse.debug.core/core/org/eclipse/debug/internal/core/sourcelookup/containers/DefaultSourceContainer.java;2;0;9;2;0;0;0;9;63;3;5;3678;102;102;3;4;0;9;9;3678;4;4949;5;2;
/org.eclipse.jdt.core/model/org/eclipse/jdt/core/IProblemRequestor.java;1;0;1;1;0;0;0;1;2;0;1;3560;2;2;1;0;0;1;1;3560;0;3560;1;1;
/org.eclipse.jdt.ui/ui/org/eclipse/jdt/internal/ui/javaeditor/ICompilationUnitDocumentProvider.java;2;0;3;1;1;1;1;2;20;1;2;1581;23;23;1;0;0;2;3;1581;0;6340;3;2;
/org.eclipse.osgi/core/adaptor/org/eclipse/osgi/framework/adaptor/PermissionStorage.java;4;1;4;1;2;2;2;2;77;1;2;3013;83;83;1;0;0;2;4;3013;0;6337;4;4;
/org.eclipse.osgi/defaultAdaptor/src/org/eclipse/osgi/framework/internal/reliablefile/ReliableFile.java;5;1;8;1;4;4;4;4;940;1;4;3013;1429;1429;1;0;0;4;8;3013;0;5507;8;5;
/org.eclipse.ui.workbench.texteditor/src/org/eclipse/ui/texteditor/ITextEditorExtension2.java;3;0;3;2;2;1;2;1;11;0;1;3811;13;13;2;0;1;1;3;6334;1;6334;2;3;
/org.eclipse.update.ui.forms/Eclipse Forms/org/eclipse/ui/forms/widgets/ScrollableRichText.java;1;0;2;1;0;0;0;2;0;1;2;3138;0;0;1;0;0;2;2;3138;0;3733;2;1;
/org.eclipse.jdt.ui.tests.refactoring/resources/MoveMembers/test8/out/B.java;1;0;1;1;0;0;0;1;1;0;1;1522;1;1;1;0;0;1;1;1522;0;1522;1;1;
/org.eclipse.jface.text/src/org/eclipse/jface/contentassist/SubjectControlContentAssistant.java;1;2;3;1;3;2;3;0;5;0;0;5199;5;5;2;0;1;0;3;6340;1;6340;2;1;
/org.eclipse.jdt.core.tests.model/workspace/Formatter/test090/A_out.java;1;0;1;1;0;0;0;1;0;0;1;2425;0;0;1;0;0;1;1;2425;0;2425;1;1;
/org.eclipse.swt/Eclipse SWT/gtk1x/org/eclipse/swt/widgets/Tracker.java;2;0;2;1;0;0;0;2;4;1;2;110;4;4;1;0;0;2;2;110;0;2327;2;2;
/org.eclipse.jdt.ui.tests.refactoring/resources/ExtractMethodWorkSpace/ExtractMethodTests/return_out/A_test712.java;1;0;2;1;0;0;0;2;4;1;2;130;5;5;1;0;0;2;2;130;0;844;2;1;
/org.eclipse.jdt.ui.tests.refactoring/resources/ExtractInterface/test80/out/I.java;1;0;1;1;0;0;0;1;8;0;1;2274;8;8;1;0;0;1;1;2274;0;2274;1;1;
/org.eclipse.team.core/src/org/eclipse/team/internal/core/JobStatusHandler.java;1;0;1;1;0;0;0;1;0;0;1;3966;0;0;1;0;0;1;1;3966;0;3966;1;1;
/org.eclipse.jdt.ui.tests.refactoring/resources/RenamePackage/testImportFromMultiRoots3/out/srcPrg/q/ToQ.java;1;0;2;1;0;0;0;2;7;1;2;3219;7;7;1;0;0;2;2;3219;0;4105;2;1;
/org.eclipse.jdt.core.tests.compiler/src/org/eclipse/jdt/core/tests/compiler/parser/TestSourceElementRequestor.java;2;0;2;1;0;0;0;2;2;1;2;85;4;4;1;0;0;2;2;85;0;3560;2;2;
/org.eclipse.jdt.ui.tests.refactoring/resources/InlineMethodWorkspace/TestCases/argument_out/TestArray.java;1;0;1;1;0;0;0;1;0;0;1;2136;0;0;1;0;0;1;1;2136;0;2136;1;1;
/org.eclipse.jdt.core.tests.model/workspace/Formatter/test109/A_in.java;1;0;1;1;0;0;0;1;0;0;1;2425;0;0;1;0;0;1;1;2425;0;2425;1;1;
/org.eclipse.jdt.ui.tests.refactoring/resources/Copy/test_method_yes_cu_with_main_type/out/A.java;1;0;1;1;0;0;0;1;2;0;1;685;2;2;1;0;0;1;1;685;0;685;1;1;
/org.eclipse.ant.ui/Ant Tools Support/org/eclipse/ui/ant/internal/views/actions/RunTargetAction.java;1;0;2;1;0;0;0;2;0;1;2;250;0;0;1;0;0;2;2;250;0;263;2;1;
/org.eclipse.ui.workbench/Eclipse UI/org/eclipse/ui/commands/IMutableCommandManager.java;2;0;2;1;1;1;1;1;0;0;1;4927;0;0;1;0;0;1;2;4927;0;5231;2;2;
/org.eclipse.swt/Eclipse SWT Mozilla/common/org/eclipse/swt/internal/mozilla/nsIDOMWindow.java;1;0;2;1;0;0;0;2;26;1;2;1654;26;26;1;0;0;2;2;1654;0;2568;2;1;
/org.eclipse.jdt.core.tests.model/workspace/Converter/src/test0370/Test.java;1;0;1;1;0;0;0;1;0;0;1;3714;0;0;1;0;0;1;1;3714;0;3714;1;1;
/org.eclipse.ui.workbench/Eclipse UI/org/eclipse/ui/internal/commands/GesturePreferencePage.java;1;0;8;1;0;0;0;8;28;2;7;516;58;58;2;1;0;8;8;1077;1;1222;7;1;
/org.eclipse.releng.basebuilder/plugins/org.eclipse.build.tools/org.eclipse.build.tools/src/org/eclipse/releng/BuildProperties.java;1;0;1;1;1;1;1;0;0;0;0;5735;0;0;1;0;0;0;1;5735;0;5735;1;1;
/org.eclipse.swt/Eclipse SWT/gtk/org/eclipse/swt/widgets/Control.java;7;4;94;4;29;20;29;65;206;3;56;0;1878;1878;4;9;9;65;94;6205;18;6352;76;7;
/org.eclipse.jdt.launching/launching/org/eclipse/jdt/launching/SocketUtil.java;2;0;5;1;0;0;0;5;46;1;5;125;107;107;1;0;0;5;5;125;0;1987;5;2;
/org.eclipse.help.base/src/org/eclipse/help/internal/browser/MozillaBrowserAdapter.java;1;1;7;1;3;3;3;4;65;3;2;1740;130;130;3;2;0;4;7;1740;2;6337;5;1;
/org.eclipse.jdt.core/dom/org/eclipse/jdt/core/dom/BodyDeclaration.java;3;2;14;1;5;4;5;9;110;1;9;2872;304;304;2;0;1;9;14;5268;1;5781;13;3;
/org.eclipse.jdt.junit/src/org/eclipse/jdt/internal/junit/launcher/JUnitTabGroup.java;2;1;4;1;2;2;2;2;5;1;2;2746;13;13;1;0;0;2;4;2746;0;6340;4;2;
/org.eclipse.update.core/src/org/eclipse/update/search/BackLevelFilter.java;2;1;6;1;2;2;2;4;7;1;4;825;15;15;1;0;0;4;6;825;0;6336;6;2;
/org.eclipse.team.ui/src/org/eclipse/team/internal/ui/synchronize/SyncChangesStructuredViewer.java;1;0;1;1;0;0;0;1;0;0;1;3221;0;0;1;0;0;1;1;3221;0;3221;1;1;
/org.eclipse.team.ui/src/org/eclipse/team/internal/ui/preferences/IgnorePreferencePage.java;1;0;4;1;1;1;1;3;194;2;2;987;213;213;2;1;0;3;4;987;1;6337;3;1;
/org.eclipse.swt/Eclipse SWT PI/gtk/org/eclipse/swt/internal/gtk/XAnyEvent.java;3;2;3;2;3;2;3;0;4;0;0;5463;6;6;2;0;1;0;3;5463;1;6352;2;3;
/org.eclipse.debug.ui/ui/org/eclipse/debug/ui/launchVariables/components/AbstractVariableComponent.java;1;0;2;1;0;0;0;2;0;1;2;562;0;0;1;0;0;2;2;562;0;647;2;1;
/org.eclipse.pde.build/src/org/eclipse/pde/internal/build/packager/PackagingConfigScriptGenerator.java;2;1;12;1;6;6;6;6;151;1;6;447;277;277;1;0;0;6;12;447;0;6272;12;2;
/org.eclipse.ui.workbench.texteditor/src/org/eclipse/ui/texteditor/FindReplaceDialog.java;3;3;32;2;14;11;14;18;334;4;14;986;1101;1101;4;4;3;18;32;2131;7;6340;25;3;
/org.eclipse.pde.core/src/org/eclipse/pde/internal/core/SourceLocationManager.java;2;2;15;2;4;3;4;11;249;2;10;624;473;473;2;1;1;11;15;1123;2;6336;13;2;
/org.eclipse.jdt.core/model/org/eclipse/jdt/internal/core/util/IDumpable.java;2;0;2;1;1;1;1;1;2;0;1;3560;2;2;1;0;0;1;2;3560;0;5644;2;2;
/org.eclipse.jdt.ui/ui refactoring/org/eclipse/jdt/internal/ui/refactoring/code/InlineMethodWizard.java;2;0;4;1;1;1;1;3;5;1;3;1047;13;13;1;0;0;3;4;1047;0;6340;4;2;
/org.eclipse.team.cvs.ssh2/src/org/eclipse/team/ccvs/ssh2/PasswordDialog.java;2;0;3;1;0;0;0;3;2;1;3;2956;2;2;1;0;0;3;3;2956;0;3113;3;2;
/org.eclipse.text/src/org/eclipse/jface/text/IPositionUpdater.java;1;0;1;1;1;1;1;0;25;0;0;6298;25;25;1;0;0;0;1;6298;0;6298;1;1;
/org.eclipse.swt/Eclipse SWT/common/org/eclipse/swt/widgets/Tray.java;2;0;3;1;1;1;1;2;16;1;2;4520;21;21;1;0;0;2;3;4520;0;6358;3;2;
/org.eclipse.swt/Eclipse SWT Browser/common/org/eclipse/swt/browser/OpenWindowEvent.java;1;0;2;1;0;0;0;2;0;1;2;3007;0;0;1;0;0;2;2;3007;0;3167;2;1;
/org.eclipse.core.tests.runtime/src/org/eclipse/core/tests/internal/runtimetests/SampleKPB.java;1;0;1;1;1;1;1;0;21;0;0;5149;21;21;1;0;0;0;1;5149;0;5149;1;1;
/org.eclipse.jdt.core.tests.model/workspace/Formatter/test390/A_in.java;1;0;1;1;0;0;0;1;0;0;1;3172;0;0;1;0;0;1;1;3172;0;3172;1;1;
/org.eclipse.ant.tests.ui/Ant Editor Tests/org/eclipse/ant/tests/ui/editor/formatter/XmlDocumentFormatterTest.java;1;1;5;1;2;2;2;3;7;2;2;4583;12;12;2;1;0;3;5;4604;1;5139;4;1;
/org.eclipse.team.tests.cvs.core/src/org/eclipse/team/tests/ccvs/ui/old/PrintTextSummaryVisitor.java;1;0;2;1;0;0;0;2;0;1;2;2632;0;0;1;0;0;2;2;2632;0;4216;2;1;
/org.eclipse.ui.workbench/Eclipse UI/org/eclipse/ui/internal/CycleEditorAction.java;1;0;1;1;0;0;0;1;16;0;1;2737;16;16;1;0;0;1;1;2737;0;2737;1;1;
/org.eclipse.pde.ui/src/org/eclipse/pde/ui/templates/NewPluginTemplateWizard.java;2;1;5;1;4;4;4;1;44;0;1;3986;86;86;1;0;0;1;5;3986;0;6336;5;2;
/org.eclipse.update.core/src/org/eclipse/update/internal/api/operations/IUnconfigFeatureOperation.java;1;0;2;1;0;0;0;2;0;1;2;3270;0;0;1;0;0;2;2;3270;0;4928;2;1;
/org.eclipse.jdt.debug.ui/ui/org/eclipse/jdt/internal/debug/ui/classpath/ClasspathContentProvider.java;3;0;5;1;1;1;1;4;17;1;4;2691;32;32;1;0;0;4;5;2691;0;6336;5;3;
/org.eclipse.jdt.ui.tests.refactoring/resources/ChangeTypeRefactoring/positive/A_testParameterDecl_in.java;1;0;1;1;0;0;0;1;0;0;1;2844;0;0;1;0;0;1;1;2844;0;2844;1;1;
/org.eclipse.jdt.core.tests.model/workspace/Formatter/test030/A_in.java;1;0;1;1;0;0;0;1;0;0;1;2425;0;0;1;0;0;1;1;2425;0;2425;1;1;
/org.eclipse.jdt.core.tests.model/workspace/Resolve/src/ResolveLocalConstructor.java;1;0;1;1;0;0;0;1;0;0;1;1970;0;0;1;0;0;1;1;1970;0;1970;1;1;
/org.eclipse.jdt.ui/ui/org/eclipse/jdt/ui/actions/FindReferencesInHierarchyAction.java;2;0;3;1;1;1;1;2;13;1;2;3266;20;20;1;0;0;2;3;3266;0;6340;3;2;
/org.eclipse.jdt.ui/ui/org/eclipse/jdt/internal/ui/wizards/dialogfields/IDialogFieldListener.java;1;0;1;1;1;1;1;0;2;0;0;6340;2;2;1;0;0;0;1;6340;0;6340;1;1;
/org.eclipse.jdt.ui/core refactoring/org/eclipse/jdt/internal/corext/refactoring/participants/xml/WithExpression.java;1;0;4;1;0;0;0;4;11;1;4;2682;20;20;1;0;0;4;4;2682;0;4108;4;1;
/org.eclipse.jdt.ui/ui/org/eclipse/jdt/internal/ui/wizards/SuperInterfaceSelectionDialog.java;2;0;2;1;1;1;1;1;10;0;1;2196;12;12;1;0;0;1;2;2196;0;6340;2;2;
/org.eclipse.jdt.core.tests.model/workspace/Converter/test0375/A.java;1;0;1;1;0;0;0;1;0;0;1;3714;0;0;1;0;0;1;1;3714;0;3714;1;1;
/org.eclipse.core.filebuffers/src/org/eclipse/core/filebuffers/annotations/MarkerAnnotation.java;1;0;1;1;0;0;0;1;0;0;1;2815;0;0;1;0;0;1;1;2815;0;2815;1;1;
/org.eclipse.ui.ide/src/org/eclipse/ui/internal/ide/dialogs/ConfigurationLogUpdateSection.java;1;1;2;1;2;2;2;0;2;0;0;5483;2;2;1;0;0;0;2;5483;0;6338;2;1;
/org.eclipse.pde.ui/src/org/eclipse/pde/internal/ui/editor/feature/NewFeatureRequireWizardPage.java;3;1;5;1;4;4;4;1;15;0;1;4203;38;38;1;0;0;1;5;4203;0;6336;5;3;
/org.eclipse.ui.workbench/Eclipse UI/org/eclipse/ui/internal/commands/api/ICommandRegistryEvent.java;1;0;4;1;0;0;0;4;0;2;3;1724;0;0;2;1;0;4;4;2515;1;2532;3;1;
/org.eclipse.ltk.ui.refactoring/src/org/eclipse/ltk/internal/ui/refactoring/AbstractDescriptor.java;1;0;3;1;1;1;1;2;11;1;2;4965;19;19;1;0;0;2;3;4965;0;6340;3;1;
/org.eclipse.search/new search/org/eclipse/search2/internal/ui/text/AnnotationManager.java;2;2;16;1;6;5;6;10;177;2;9;3474;617;617;2;1;1;10;16;4461;2;6035;14;2;
/org.eclipse.pde.core/src/org/eclipse/pde/internal/core/feature/FeatureInstallHandler.java;2;1;3;1;2;2;2;1;16;0;1;4203;30;30;1;0;0;1;3;4203;0;6336;3;2;
/org.eclipse.ui.tests/Eclipse UI Tests/org/eclipse/ui/tests/keys/Bug43538Test.java;1;0;1;1;0;0;0;1;0;0;1;2516;0;0;1;0;0;1;1;2516;0;2516;1;1;
/org.eclipse.pde.ui/src/org/eclipse/pde/internal/ui/feature/BuildSiteOperation.java;1;0;2;1;0;0;0;2;0;1;2;3721;0;0;1;0;0;2;2;3721;0;3840;2;1;
/org.eclipse.jdt.core.tests.builder/src/org/eclipse/jdt/core/tests/builder/EfficiencyCompilerRequestor.java;2;0;3;1;0;0;0;3;2;1;3;3194;5;5;1;0;0;3;3;3194;0;3560;3;2;
/org.eclipse.jdt.core.tests.model/workspace/Formatter/test153/A_out.java;1;0;2;1;0;0;0;2;2;1;2;2425;2;2;1;0;0;2;2;2425;0;4173;2;1;
/org.eclipse.ui.workbench/Eclipse UI/org/eclipse/ui/internal/commands/api/older/ICategoryListener.java;1;0;2;1;0;0;0;2;0;0;1;2562;0;0;2;1;0;2;2;2562;1;2562;1;1;
/org.eclipse.debug.ui/ui/org/eclipse/debug/internal/ui/launchConfigurations/PerspectivesTab.java;4;1;11;1;2;2;2;9;101;1;9;618;225;225;1;0;0;9;11;618;0;6336;11;4;
/org.eclipse.jdt.ui.tests.refactoring/resources/MoveMembers/test6/in/A.java;1;0;1;1;0;0;0;1;1;0;1;1522;1;1;1;0;0;1;1;1522;0;1522;1;1;
/org.eclipse.core.tests.resources/src/org/eclipse/core/tests/resources/session/WorkspaceDescriptionTest.java;1;0;1;1;1;1;1;0;8;0;0;5147;8;8;1;0;0;0;1;5147;0;5147;1;1;
/org.eclipse.jdt.text.tests/src/org/eclipse/jdt/ui/text/tests/JavaParameterListValidatorTest.java;1;1;3;1;2;2;2;1;6;0;1;5082;6;6;1;0;0;1;3;5082;0;5129;3;1;
/org.eclipse.ui.workbench/Eclipse UI/org/eclipse/ui/internal/ActionSetContributionItem.java;2;0;2;1;1;1;1;1;54;0;1;3460;56;56;1;0;0;1;2;3460;0;6338;2;2;
/org.eclipse.jdt.text.tests/testResources/folderLinkTarget1/test1/test2/C.java;1;0;1;1;0;0;0;1;0;0;1;5082;0;0;1;0;0;1;1;5082;0;5082;1;1;
/org.eclipse.ui.ide/src/org/eclipse/ui/views/markers/internal/FieldMessage.java;4;2;5;2;3;2;3;2;37;1;2;2208;76;76;2;0;1;2;5;6338;1;6338;4;4;
/org.eclipse.swt.tests/JUnit Tests/org/eclipse/swt/tests/junit/Test_org_eclipse_swt_custom_TableTreeItem.java;1;0;1;1;0;0;0;1;36;0;1;2104;36;36;1;0;0;1;1;2104;0;2104;1;1;
/org.eclipse.jdt.ui/ui/org/eclipse/jdt/internal/ui/preferences/CodeTemplateBlock.java;4;1;25;2;7;7;7;18;201;3;15;371;443;443;3;3;0;18;25;2396;3;6340;22;4;
/org.eclipse.team.cvs.core/src/org/eclipse/team/internal/ccvs/core/ICVSFile.java;1;0;2;1;0;0;0;2;30;1;2;2259;34;34;1;0;0;2;2;2259;0;3131;2;1;
/org.eclipse.debug.ui/ui/org/eclipse/debug/internal/ui/launchConfigurations/LaunchConfigurationView.java;3;0;5;1;1;1;1;4;33;1;4;473;62;62;1;0;0;4;5;473;0;6336;5;3;
/org.eclipse.jdt.ui.tests.refactoring/resources/Copy/test_type_yes_type/in/A.java;1;0;1;1;0;0;0;1;0;0;1;696;0;0;1;0;0;1;1;696;0;696;1;1;
/org.eclipse.jdt.ui/ui/org/eclipse/jdt/ui/wizards/NewContainerWizardPage.java;3;2;5;2;3;2;3;2;23;1;2;1350;40;40;2;0;1;2;5;6334;1;6334;4;3;
/org.eclipse.jdt.ui.tests.refactoring/resources/ChangeSignature/canModify/A_testAll39_out.java;1;0;1;1;0;0;0;1;6;0;1;2093;6;6;1;0;0;1;1;2093;0;2093;1;1;
/org.eclipse.help.webapp/src_servlets/org/eclipse/help/internal/webapp/data/Topic.java;1;1;2;1;2;2;2;0;23;0;0;5827;39;39;1;0;0;0;2;5827;0;6337;2;1;
/org.eclipse.jdt.core.tests.model/workspace/Converter/src/test0307/Test.java;1;0;1;1;0;0;0;1;0;0;1;3714;0;0;1;0;0;1;1;3714;0;3714;1;1;
/org.eclipse.team.ui/src/org/eclipse/team/internal/ui/target/TargetWizardPage.java;1;0;1;1;0;0;0;1;0;0;1;2495;0;0;1;0;0;1;1;2495;0;2495;1;1;
/org.eclipse.jdt.core.tests.model/workspace/Formatter/test023/A_out.java;1;0;1;1;0;0;0;1;0;0;1;2425;0;0;1;0;0;1;1;2425;0;2425;1;1;
/org.eclipse.jdt.ui/ui/org/eclipse/jdt/internal/ui/javaeditor/ToggleMarkOccurrencesAction.java;1;1;2;1;2;2;2;0;6;0;0;5309;6;6;1;0;0;0;2;5309;0;5360;2;1;
/org.eclipse.jdt.core.tests.model/workspace/Formatter/test009/A_in.java;1;0;1;1;0;0;0;1;0;0;1;2425;0;0;1;0;0;1;1;2425;0;2425;1;1;
/org.eclipse.core.runtime/src/org/eclipse/core/runtime/IAdapterManager.java;3;0;9;1;1;1;1;8;224;2;7;3013;703;703;2;1;0;8;9;4128;1;5117;8;3;
/org.eclipse.update.ui/srcnew/org/eclipse/update/internal/ui/search/UnifiedSearchObject.java;1;0;2;1;0;0;0;2;0;1;2;369;0;0;1;0;0;2;2;369;0;824;2;1;
/org.eclipse.jdt.ui.tests.refactoring/resources/ExtractMethodWorkSpace/ExtractMethodTests/locals_in/A_test508.java;1;0;1;1;0;0;0;1;4;0;1;844;4;4;1;0;0;1;1;844;0;844;1;1;
/org.eclipse.jface.text/src/org/eclipse/jface/text/templates/ITemplateEditor.java;1;0;2;1;0;0;0;2;0;0;1;4258;0;0;2;1;0;2;2;4258;1;4258;1;1;
/org.eclipse.help.base/src/org/eclipse/help/internal/base/HelpApplication.java;2;2;14;1;8;6;8;6;40;2;5;1747;205;205;2;1;2;6;14;1747;3;6337;11;2;
/org.eclipse.ui.ide/extensions/org/eclipse/ui/dialogs/WizardNewLinkPage.java;1;0;1;1;0;0;0;1;0;0;1;2263;0;0;1;0;0;1;1;2263;0;2263;1;1;
/org.eclipse.jdt.core.tests.model/workspace/Converter/test0241/Test.java;1;0;1;1;0;0;0;1;0;0;1;3714;0;0;1;0;0;1;1;3714;0;3714;1;1;
/org.eclipse.core.runtime/src/org/eclipse/core/runtime/registry/IExecutableExtension.java;4;0;5;2;0;0;0;5;242;2;4;2105;484;484;2;1;0;5;5;3164;1;3164;4;4;
/org.eclipse.search/new search/org/eclipse/search2/internal/ui/basic/views/SearchResultModel.java;1;0;2;1;0;0;0;2;0;1;2;3474;0;0;1;0;0;2;2;3474;0;3711;2;1;
/org.eclipse.jdt.debug.jdi.tests/tests/org/eclipse/debug/jdi/tests/program/TestClass3.java;1;0;1;1;1;1;1;0;3;0;0;6339;3;3;1;0;0;0;1;6339;0;6339;1;1;
/org.eclipse.ui.workbench/Eclipse UI/org/eclipse/ui/internal/csm/roles/api/IRoleRegistry.java;1;0;2;1;0;0;0;2;0;1;2;2213;0;0;1;0;0;2;2;2213;0;2225;2;1;
/org.eclipse.jdt.core/model/org/eclipse/jdt/internal/core/SingleTypeRequestor.java;2;0;2;1;0;0;0;2;4;1;2;1892;6;6;1;0;0;2;2;1892;0;3557;2;2;
/org.eclipse.jdt.ui.tests.refactoring/resources/ExtractMethodWorkSpace/ExtractMethodTests/expression_out/A_test621.java;1;0;3;1;0;0;0;3;4;1;3;844;4;4;1;0;0;3;3;844;0;1474;3;1;
/org.eclipse.ui.ide/src/org/eclipse/ui/internal/model/WorkbenchStatusList.java;2;0;2;1;0;0;0;2;0;1;2;1511;0;0;1;0;0;2;2;1511;0;2263;2;2;
/org.eclipse.jdt.ui.tests.refactoring/resources/IntroduceParameter/simple/out/Formatting1.java;1;0;1;1;1;1;1;0;0;0;0;5748;0;0;1;0;0;0;1;5748;0;5748;1;1;
/org.eclipse.team.ui/src/org/eclipse/team/internal/ui/synchronize/TeamSubscriberParticipantComposite.java;1;0;1;1;0;0;0;1;0;0;1;3206;0;0;1;0;0;1;1;3206;0;3206;1;1;
/org.eclipse.jdt.ui.tests.refactoring/resources/DeleteSourceReferenceEdit/A_test5_in.java;1;0;1;1;0;0;0;1;0;0;1;1652;0;0;1;0;0;1;1;1652;0;1652;1;1;
/org.eclipse.jdt.core/dom/org/eclipse/jdt/core/dom/ASTNode.java;5;2;32;2;9;7;9;23;950;2;18;2564;1875;1875;2;5;2;23;32;2871;7;5916;25;5;
/org.eclipse.team.core/src/org/eclipse/team/core/variants/AbstractResourceVariantTree.java;2;2;6;1;5;4;5;1;31;0;1;4349;54;54;2;0;1;1;6;6038;1;6336;5;2;
/org.eclipse.jdt.core.tests.model/workspace/Converter/src/test0011/Test.java;1;0;1;1;0;0;0;1;0;0;1;3714;0;0;1;0;0;1;1;3714;0;3714;1;1;
/org.eclipse.jdt.core/compiler/org/eclipse/jdt/internal/compiler/SourceElementParser.java;5;0;33;2;0;0;0;33;73;3;29;69;476;476;3;4;0;33;33;2682;4;4461;29;5;
/org.eclipse.ui.intro/src/org/eclipse/ui/internal/intro/impl/parts/EmptyStandbyContentPart.java;1;1;4;1;4;4;4;0;6;0;0;5747;10;10;1;0;0;0;4;5747;0;5937;4;1;
/org.eclipse.update.ui.forms/Eclipse Forms/org/eclipse/ui/forms/editor/FormEditor.java;1;0;11;1;0;0;0;11;177;2;10;3179;465;465;2;1;0;11;11;3749;1;4157;10;1;
/org.eclipse.debug.ui/ui/org/eclipse/debug/internal/ui/actions/ProfileLastAction.java;1;0;1;1;0;0;0;1;0;0;1;472;0;0;1;0;0;1;1;472;0;472;1;1;
/org.eclipse.ui.ide/src/org/eclipse/ui/internal/dialogs/FileStatesPage.java;2;0;4;1;0;0;0;4;24;1;4;1526;26;26;1;0;0;4;4;1526;0;2263;4;2;
/org.eclipse.core.runtime.compatibility/src-runtime/org/eclipse/core/runtime/IConfigurationElement.java;2;0;4;1;0;0;0;4;386;1;4;3013;387;387;1;0;0;4;4;3013;0;3169;4;2;
/org.eclipse.jdt.debug.tests/tests/org/eclipse/jdt/debug/tests/eval/TypeHierarchy_119_1.java;1;0;1;1;0;0;0;1;26;0;1;1274;26;26;1;0;0;1;1;1274;0;1274;1;1;
/org.eclipse.osgi/resolver/src/org/eclipse/core/internal/dependencies/ElementSet.java;3;2;6;1;5;4;5;1;72;0;1;3013;177;177;2;0;1;1;6;5529;1;5529;5;3;
/org.eclipse.jdt.ui/ui/org/eclipse/jdt/ui/actions/SelfEncapsulateFieldAction.java;4;0;7;1;1;1;1;6;65;1;6;122;139;139;1;0;0;6;7;122;0;6340;7;4;
/org.eclipse.swt.tests/JUnit Tests/org/eclipse/swt/tests/junit/Test_org_eclipse_swt_widgets_Caret.java;3;0;3;1;0;0;0;3;36;1;3;2105;39;39;1;0;0;3;3;2105;0;2991;3;3;
/org.eclipse.jdt.ui.tests.refactoring/resources/IntroduceFactory/positive/InstanceContext_in.java;1;0;2;1;1;1;1;1;2;0;1;2862;2;2;1;0;0;1;2;2862;0;5659;2;1;
/org.eclipse.core.resources/src/org/eclipse/core/internal/resources/TestingSupport.java;2;0;6;1;1;1;1;5;54;1;5;230;90;90;1;0;0;5;6;230;0;5146;6;2;
/org.eclipse.ui.tests/Eclipse UI Tests/org/eclipse/ui/tests/navigator/AbstractNavigatorTest.java;1;0;1;1;0;0;0;1;4;0;1;3091;4;4;1;0;0;1;1;3091;0;3091;1;1;
/org.eclipse.ui.tests/Eclipse UI Tests/org/eclipse/ui/tests/api/IDeprecatedWorkbenchPageTest.java;2;0;7;1;0;0;0;7;63;1;7;1542;129;129;1;0;0;7;7;1542;0;3091;7;2;
/org.eclipse.core.resources.linux/src/org/eclipse/core/resources/refresh/linux/LinuxNatives.java;1;0;4;1;0;0;0;4;7;1;4;3681;13;13;1;0;0;4;4;3681;0;4851;4;1;
/org.eclipse.update.ui.forms/src/org/eclipse/ui/forms/internal/parts/BulletParagraph.java;1;0;2;1;0;0;0;2;0;1;2;2898;0;0;1;0;0;2;2;2898;0;3096;2;1;
/org.eclipse.sdk.tests-feature/plugins/org.eclipse.perfmsr.ui.client/src/org/eclipse/perfmsr/ui/client/VariationDescriptor.java;1;1;4;1;4;4;4;0;10;0;0;5443;16;16;1;0;0;0;4;5443;0;5803;4;1;
/org.eclipse.jdt.debug.tests/tests/org/eclipse/jdt/debug/tests/eval/NestedTypeFieldValue_94.java;1;0;1;1;0;0;0;1;108;0;1;1274;108;108;1;0;0;1;1;1274;0;1274;1;1;
/org.eclipse.update.core/src/org/eclipse/update/internal/api/operations/IOperationFactory.java;1;0;3;1;0;0;0;3;9;1;3;3270;9;9;1;0;0;3;3;3270;0;4928;3;1;
/org.eclipse.jdt.core.tests.model/workspace/Formatter/test428/A_in.java;1;0;1;1;0;0;0;1;0;0;1;3478;0;0;1;0;0;1;1;3478;0;3478;1;1;
/org.eclipse.ui.views/src/org/eclipse/ui/views/navigator/ResourceNavigatorActionGroup.java;1;0;1;1;0;0;0;1;0;0;1;2738;0;0;1;0;0;1;1;2738;0;2738;1;1;
/org.eclipse.ui.workbench/Eclipse UI/org/eclipse/ui/commands/SpecialKey.java;1;0;5;1;0;0;0;5;13;4;2;1321;13;13;4;3;0;5;5;1336;3;1336;2;1;
/org.eclipse.ui.workbench/Eclipse UI/org/eclipse/ui/internal/presentation/ColorDefinitionReader.java;1;0;3;1;0;0;0;3;10;1;3;4237;10;10;1;0;0;3;3;4237;0;4392;3;1;
/org.eclipse.ant.ui/Ant Editor/org/eclipse/ant/ui/internal/dtd/util/IMapHolder.java;1;0;2;1;0;0;0;2;0;1;2;250;0;0;1;0;0;2;2;250;0;1811;2;1;
/org.eclipse.swt/Eclipse SWT/win32/org/eclipse/swt/graphics/Font.java;2;1;3;1;2;2;2;1;4;0;1;957;7;7;1;0;0;1;3;957;0;6352;3;2;
/org.eclipse.search/search/org/eclipse/search/internal/ui/text/TextSearchPage.java;2;2;25;1;6;5;6;19;152;2;18;122;837;837;2;1;1;19;25;2888;2;6340;23;2;
/org.eclipse.ui.workbench/Eclipse UI/org/eclipse/ui/internal/commands/old/IMutableRegistry.java;1;0;2;1;0;0;0;2;0;1;2;1322;0;0;1;0;0;2;2;1322;0;1356;2;1;
/org.eclipse.swt/Eclipse SWT Mozilla/common/org/eclipse/swt/internal/mozilla/nsIComponentRegistrar.java;1;0;2;1;0;0;0;2;30;1;2;1654;30;30;1;0;0;2;2;1654;0;2568;2;1;
/org.eclipse.jdt.core.tests.model/workspace/Converter/src/test0434/A.java;1;0;1;1;0;0;0;1;0;0;1;3714;0;0;1;0;0;1;1;3714;0;3714;1;1;
/org.eclipse.ui.views/src/org/eclipse/ui/views/internal/table/IItemsChangedListener.java;1;0;2;1;0;0;0;2;0;0;1;749;0;0;2;1;0;2;2;749;1;749;1;1;
/org.eclipse.ui.views/src/org/eclipse/ui/views/tasklist/IMarkerConstants.java;1;0;1;1;0;0;0;1;0;0;1;2738;0;0;1;0;0;1;1;2738;0;2738;1;1;
/org.eclipse.jdt.core.tests.model/workspace/Converter/test0396/A.java;1;0;1;1;0;0;0;1;0;0;1;3714;0;0;1;0;0;1;1;3714;0;3714;1;1;
/org.eclipse.ui.workbench.texteditor/src/org/eclipse/ui/texteditor/templates/TemplateContentProvider.java;3;1;3;1;2;2;2;1;2;0;1;4627;4;4;1;0;0;1;3;4627;0;6340;3;3;
/org.eclipse.jdt.core/model/org/eclipse/jdt/internal/core/DiscardWorkingCopyOperation.java;1;0;8;1;0;0;0;8;32;1;8;818;79;79;1;0;0;8;8;818;0;3560;8;1;
/org.eclipse.sdk.tests-feature/plugins/org.eclipse.perfmsr.ui.client/src/org/eclipse/perfmsr/ui/client/ToggleSnapshotDataAction.java;1;1;2;1;2;2;2;0;10;0;0;5443;10;10;1;0;0;0;2;5443;0;5513;2;1;
/org.eclipse.ui.workbench/Eclipse UI/org/eclipse/ui/commands/GestureKey.java;1;0;2;1;0;0;0;2;0;0;1;1340;0;0;2;1;0;2;2;1340;1;1340;1;1;
/org.eclipse.help.webapp/src_servlets/org/eclipse/help/internal/webapp/servlet/ControlServlet.java;1;2;6;1;4;3;4;2;49;1;2;2732;112;112;2;0;1;2;6;5594;1;6337;5;1;
/org.eclipse.jdt.core/model/org/eclipse/jdt/internal/core/SourceMethod.java;4;2;18;1;6;4;6;12;33;2;10;88;169;169;2;2;2;12;18;1089;4;6220;14;4;
/org.eclipse.jdt.ui.tests.refactoring/resources/MoveInnerToTopLevel/test_nonstatic_0/out/Inner.java;2;0;2;1;1;1;1;1;2;0;1;305;4;4;1;0;0;1;2;305;0;5854;2;2;
/org.eclipse.ui.editors/src/org/eclipse/ui/editors/text/ILocationProvider.java;2;2;7;1;3;2;3;4;26;1;4;2224;49;49;2;0;1;4;7;6334;1;6334;6;2;
/org.eclipse.jdt.core.tests.model/workspace/Formatter/test137/A_out.java;1;0;1;1;0;0;0;1;0;0;1;2425;0;0;1;0;0;1;1;2425;0;2425;1;1;
/org.eclipse.core.tools.resources/src/org/eclipse/core/tools/metadata/IDump.java;1;0;1;1;1;1;1;0;0;0;0;6302;0;0;1;0;0;0;1;6302;0;6302;1;1;
/org.eclipse.jdt.core.tests.model/workspace/Formatter/test484/A_out.java;1;0;1;1;1;1;1;0;0;0;0;5132;0;0;1;0;0;0;1;5132;0;5132;1;1;
/org.eclipse.jdt.launching/launching/org/eclipse/jdt/internal/launching/JavaProjectSourceContainer.java;1;0;6;1;0;0;0;6;22;2;4;4109;50;50;2;2;0;6;6;4109;2;4971;4;1;
/org.eclipse.jface.text/src/org/eclipse/jface/text/MarkSelection.java;2;1;2;1;2;2;2;0;3;0;0;6340;5;5;1;0;0;0;2;6340;0;6359;2;2;
/org.eclipse.ui.editors/src/org/eclipse/ui/texteditor/IMarkerUpdater.java;2;2;5;1;3;2;3;2;59;1;2;1983;70;70;2;0;1;2;5;6334;1;6334;4;2;
/org.eclipse.jdt.debug.ui/ui/org/eclipse/jdt/internal/debug/ui/classpath/VariableClasspathEntryWorkbenchAdapter.java;1;0;1;1;0;0;0;1;0;0;1;4973;0;0;1;0;0;1;1;4973;0;4973;1;1;
/org.eclipse.jdt.core.tests.model/workspace/Converter/src/test0309/Test.java;1;0;1;1;0;0;0;1;0;0;1;3714;0;0;1;0;0;1;1;3714;0;3714;1;1;
/org.eclipse.ant.tests.ui/Ant in Separate VM/org/eclipse/ant/tests/ui/separateVM/SeparateVMTests.java;1;0;3;1;0;0;0;3;98;1;3;1610;98;98;1;0;0;3;3;1610;0;1796;3;1;
/org.eclipse.swt/Eclipse SWT/common/org/eclipse/swt/events/SelectionEvent.java;3;0;3;1;0;0;0;3;20;1;3;1;40;40;1;0;0;3;3;1;0;3197;3;3;
/org.eclipse.team.cvs.ui/src/org/eclipse/team/internal/ccvs/ui/KeyboardInteractiveDialog.java;2;0;4;1;1;1;1;3;7;1;3;3808;16;16;1;0;0;3;4;3808;0;6015;4;2;
/org.eclipse.jdt.core/model/org/eclipse/jdt/core/IPackageFragment.java;3;0;9;1;0;0;0;9;33;1;9;346;88;88;1;0;0;9;9;346;0;4997;9;3;
/org.eclipse.ui.workbench.texteditor/src/org/eclipse/ui/texteditor/templates/StatusInfo.java;2;1;4;1;3;3;3;1;25;0;1;4627;29;29;1;0;0;1;4;4627;0;6340;4;2;
/org.eclipse.ui.editors/src/org/eclipse/ui/internal/editors/text/LastSaveReferenceProvider.java;1;0;1;1;0;0;0;1;0;0;1;2080;0;0;1;0;0;1;1;2080;0;2080;1;1;
/org.eclipse.pde.ui/templates_3.0/newWizard/java/$wizardPageClassName$.java;1;0;1;1;0;0;0;1;0;0;1;2786;0;0;1;0;0;1;1;2786;0;2786;1;1;
/org.eclipse.jdt.debug.ui/ui/org/eclipse/jdt/internal/debug/ui/snippeteditor/NewSnippetFileWizardPage.java;1;0;1;1;0;0;0;1;0;0;1;4854;0;0;1;0;0;1;1;4854;0;4854;1;1;
/org.eclipse.ui.workbench/Eclipse UI/org/eclipse/ui/actions/MoveProjectAction.java;1;0;1;1;0;0;0;1;0;0;1;2737;0;0;1;0;0;1;1;2737;0;2737;1;1;
/org.eclipse.jdt.core.tests.model/workspace/Completion/src/CompletionEmptyTypeName3.java;1;0;1;1;0;0;0;1;0;0;1;2260;0;0;1;0;0;1;1;2260;0;2260;1;1;
/org.eclipse.pde.ui/src/org/eclipse/pde/internal/ui/wizards/extension/NewSchemaFileMainPage.java;2;1;5;1;4;4;4;1;54;0;1;5063;69;69;1;0;0;1;5;5063;0;6336;5;2;
/org.eclipse.core.tests.runtime/src/org/eclipse/core/tests/internal/plugins/TestClass.java;1;0;1;1;0;0;0;1;0;0;1;3014;0;0;1;0;0;1;1;3014;0;3014;1;1;
/org.eclipse.team.ui/src/org/eclipse/team/internal/ui/widgets/ViewerPane.java;1;0;1;1;0;0;0;1;0;0;1;3280;0;0;1;0;0;1;1;3280;0;3280;1;1;
/org.eclipse.jdt.ui.tests.refactoring/resources/MoveInstanceMethod/canMove/test22/out/Second.java;1;0;1;1;0;0;0;1;0;0;1;1603;0;0;1;0;0;1;1;1603;0;1603;1;1;
/org.eclipse.update.core/srcnew/org/eclipse/update/internal/operations/UpdateManagerAuthenticator.java;1;0;6;1;0;0;0;6;10;1;6;367;15;15;1;0;0;6;6;367;0;825;6;1;
/org.eclipse.team.tests.cvs.core/src/org/eclipse/team/tests/ccvs/ui/old/Waiter.java;1;0;2;1;0;0;0;2;0;1;2;2632;0;0;1;0;0;2;2;2632;0;4216;2;1;
/org.eclipse.jdt.ui/core refactoring/org/eclipse/jdt/internal/corext/refactoring/RefactoringCoreMessages.java;1;0;1;1;1;1;1;0;2;0;0;6340;2;2;1;0;0;0;1;6340;0;6340;1;1;
/org.eclipse.jdt.core.tests.model/workspace/Converter/test0094/Test.java;1;0;1;1;0;0;0;1;0;0;1;3714;0;0;1;0;0;1;1;3714;0;3714;1;1;
/org.eclipse.pde.ui/src_Forms/org/eclipse/pde/internal/ui/neweditor/feature/SynchronizeVersionsAction.java;2;0;2;1;1;1;1;1;0;0;1;4926;0;0;1;0;0;1;2;4926;0;5431;2;2;
/org.eclipse.jdt.ui.tests.refactoring/resources/Copy/test_field_declared_in_multi_yes_type/out/A.java;1;0;1;1;0;0;0;1;0;0;1;685;0;0;1;0;0;1;1;685;0;685;1;1;
/org.eclipse.core.runtime/src/org/eclipse/core/internal/runtime/PlatformURLFragmentConnection.java;4;1;9;1;4;4;4;5;134;1;5;3013;284;284;1;0;0;5;9;3013;0;6340;9;4;
/org.eclipse.jdt.ui.tests.refactoring/resources/RenamePackage/testImportFromMultiRoots6/in/srcPrg/p/p/A.java;1;0;1;1;0;0;0;1;0;0;1;4105;0;0;1;0;0;1;1;4105;0;4105;1;1;
/org.eclipse.core.resources/src/org/eclipse/core/internal/resources/MarkerWriter.java;2;0;2;1;1;1;1;1;352;0;1;2628;356;356;1;0;0;1;2;2628;0;5146;2;2;
/org.eclipse.ui.workbench/Eclipse UI/org/eclipse/ui/keys/Key.java;3;1;15;1;2;2;2;13;129;2;12;1294;340;340;2;1;0;13;15;2202;1;6338;14;3;
/org.eclipse.update.ui.win32/src/org/eclipse/welcome/internal/actions/TipsAndTricksContentProvider.java;1;0;3;1;0;0;0;3;3;2;2;925;4;4;2;1;0;3;3;925;1;4143;2;1;
/org.eclipse.jdt.ui/ui refactoring/org/eclipse/jdt/internal/ui/refactoring/nls/search/LineReader.java;1;0;1;1;0;0;0;1;18;0;1;4954;18;18;1;0;0;1;1;4954;0;4954;1;1;
/org.eclipse.ui.workbench.texteditor/src/org/eclipse/ui/texteditor/DeleteLineAction.java;2;2;5;2;3;2;3;2;16;1;2;2097;30;30;2;0;1;2;5;6334;1;6334;4;2;
/org.eclipse.core.tests.resources/src/org/eclipse/core/tests/internal/localstore/HistoryStoreTest.java;1;3;6;1;6;4;6;0;4022;0;0;5147;4587;4587;3;0;2;0;6;5147;2;6127;4;1;
/org.eclipse.jdt.ui/core extension/org/eclipse/jdt/internal/corext/dom/ASTRewrite.java;4;1;40;1;2;2;2;38;663;2;34;85;3448;3448;2;4;0;38;40;85;4;5406;36;4;
/org.eclipse.jface/src/org/eclipse/jface/preference/PreferenceDialog.java;4;1;25;1;8;8;8;17;848;2;15;1;2283;2283;2;2;0;17;25;1739;2;6199;23;4;
/org.eclipse.jdt.debug.tests/tests/org/eclipse/jdt/debug/tests/eval/TypeHierarchy_32_4.java;1;0;1;1;0;0;0;1;6;0;1;1274;6;6;1;0;0;1;1;1274;0;1274;1;1;
/org.eclipse.core.resources/src/org/eclipse/core/internal/events/LifecycleEvent.java;1;0;1;1;1;1;1;0;15;0;0;5146;15;15;1;0;0;0;1;5146;0;5146;1;1;
/org.eclipse.team.ui/src/org/eclipse/team/ui/synchronize/actions/RefactorActionGroup.java;1;0;1;1;0;0;0;1;0;0;1;2535;0;0;1;0;0;1;1;2535;0;2535;1;1;
/org.eclipse.ltk.ui.refactoring/src/org/eclipse/ltk/internal/ui/refactoring/DescriptorManager.java;1;1;4;1;2;2;2;2;14;1;2;4965;26;26;1;0;0;2;4;4965;0;6340;4;1;
/org.eclipse.jdt.core.tests.model/workspace/Formatter/test066/A_out.java;1;0;1;1;0;0;0;1;0;0;1;2425;0;0;1;0;0;1;1;2425;0;2425;1;1;
/org.eclipse.swt/Eclipse SWT PI/win32/org/eclipse/swt/internal/win32/PAINTSTRUCT.java;1;0;1;1;0;0;0;1;5;0;1;957;5;5;1;0;0;1;1;957;0;957;1;1;
/org.eclipse.ui.views/src/org/eclipse/ui/views/internal/markers/FieldResource.java;1;0;2;1;0;0;0;2;0;0;1;749;0;0;2;1;0;2;2;749;1;749;1;1;
/org.eclipse.ant.ui/Ant Editor/org/eclipse/ant/ui/internal/dtd/schema/Element.java;1;0;5;1;0;0;0;5;19;1;5;250;31;31;1;0;0;5;5;250;0;1811;5;1;
/org.eclipse.help.ui/src/org/eclipse/help/ui/internal/search/HelpSearchSorter.java;1;0;1;1;0;0;0;1;0;0;1;2732;0;0;1;0;0;1;1;2732;0;2732;1;1;
/org.eclipse.ui.cheatsheets/src/org/eclipse/ui/internal/cheatsheets/data/IContainsContent.java;2;0;3;1;1;1;1;2;17;1;2;4428;17;17;1;0;0;2;3;4428;0;5189;3;2;
/org.eclipse.compare/compare/org/eclipse/compare/rangedifferencer/DifferencesIterator.java;1;0;1;1;0;0;0;1;2;0;1;3938;2;2;1;0;0;1;1;3938;0;3938;1;1;
/org.eclipse.ui.workbench/Eclipse UI/org/eclipse/ui/internal/csm/commands/ActivityBinding.java;1;0;3;1;0;0;0;3;24;2;2;2533;32;32;2;1;0;3;3;2556;1;2556;2;1;
/org.eclipse.jface.text/src/org/eclipse/jface/text/rules/RuleBasedDamagerRepairer.java;1;0;1;1;1;1;1;0;2;0;0;6340;2;2;1;0;0;0;1;6340;0;6340;1;1;
/org.eclipse.ui.tests/Eclipse UI Tests/org/eclipse/ui/tests/api/IWorkbenchPartSiteTest.java;1;0;1;1;0;0;0;1;3;0;1;3091;3;3;1;0;0;1;1;3091;0;3091;1;1;
/org.eclipse.team.tests.cvs.core/src/org/eclipse/team/tests/ccvs/ui/old/FakeSelectionProvider.java;1;0;2;1;0;0;0;2;0;1;2;2632;0;0;1;0;0;2;2;2632;0;4216;2;1;
/org.eclipse.jdt.ui/ui/org/eclipse/jdt/ui/actions/OpenProjectAction.java;3;2;5;2;3;2;3;2;22;1;2;592;38;38;2;0;1;2;5;6334;1;6334;4;3;
/org.eclipse.update.core/srcnew/org/eclipse/update/internal/operations/ToggleSiteOperation.java;1;0;5;1;0;0;0;5;11;2;4;602;24;24;2;1;0;5;5;602;1;825;4;1;
/org.eclipse.team.cvs.ui/src/org/eclipse/team/internal/ccvs/ui/subscriber/ChangeLogDiffNodeRoot.java;1;0;1;1;0;0;0;1;0;0;1;3838;0;0;1;0;0;1;1;3838;0;3838;1;1;
/org.eclipse.ui.workbench/Eclipse UI/org/eclipse/ui/internal/activities/ProxyActivityManager.java;4;1;15;1;2;2;2;13;28;2;11;2808;131;131;2;2;0;13;15;2808;2;6338;13;4;
/org.eclipse.core.resources/src/org/eclipse/core/internal/events/BuilderPersistentInfo.java;1;0;1;1;1;1;1;0;59;0;0;5146;59;59;1;0;0;0;1;5146;0;5146;1;1;
/org.eclipse.ui.workbench/Eclipse UI/org/eclipse/ui/internal/csm/commands/IActiveKeyConfigurationDefinition.java;1;0;3;1;0;0;0;3;23;2;2;2532;23;23;2;1;0;3;3;2532;1;2562;2;1;
/org.eclipse.help.webapp/src_servlets/org/eclipse/help/internal/webapp/servlet/ContentServlet.java;1;1;3;1;3;3;3;0;26;0;0;5594;34;34;1;0;0;0;3;5594;0;6337;3;1;
/org.eclipse.ui.workbench/Eclipse UI/org/eclipse/ui/internal/themes/ThemeDescriptor.java;2;0;9;1;0;0;0;9;174;2;7;3684;371;371;2;2;0;9;9;4235;2;4559;7;2;
/org.eclipse.ui.editors/src/org/eclipse/ui/internal/editors/text/OverlayPreferenceStore.java;1;1;3;1;2;2;2;1;33;0;1;1347;41;41;1;0;0;1;3;1347;0;6340;3;1;
/org.eclipse.pde.core/src/org/eclipse/pde/internal/core/PDEStateHelper.java;1;0;2;1;1;1;1;1;10;0;1;4726;10;10;1;0;0;1;2;4726;0;6336;2;1;
/org.eclipse.update.core/src/org/eclipse/update/internal/model/InstallChangeParser.java;2;0;4;1;1;1;1;3;19;1;3;890;48;48;1;0;0;3;4;890;0;5518;4;2;
/org.eclipse.pde.core/src/org/eclipse/pde/core/IAlternativeRuntimeSupport.java;2;0;7;1;0;0;0;7;4;2;6;2229;9;9;2;1;0;7;7;3008;1;4203;6;2;
/org.eclipse.ui.ide/src/org/eclipse/ui/internal/ide/dialogs/WelcomeEditor.java;5;1;5;1;3;3;3;2;72;1;2;2264;78;78;1;0;0;2;5;2264;0;6338;5;5;
/org.eclipse.team.ftp/src/org/eclipse/team/internal/ftp/deployment/FTPSynchronizer.java;1;0;1;1;0;0;0;1;0;0;1;3221;0;0;1;0;0;1;1;3221;0;3221;1;1;
/org.eclipse.jdt.core.tests.model/workspace/Formatter/test050/A_in.java;1;0;1;1;0;0;0;1;0;0;1;2425;0;0;1;0;0;1;1;2425;0;2425;1;1;
/org.eclipse.jdt.ui/core refactoring/org/eclipse/jdt/internal/corext/refactoring/changes/CompilationUnitReorgChange.java;2;1;5;1;2;2;2;3;18;1;3;3708;33;33;1;0;0;3;5;3708;0;6340;5;2;
/org.eclipse.ui.ide/src/org/eclipse/ui/internal/dialogs/NewProjectWizard.java;2;0;6;2;0;0;0;6;48;2;5;1526;51;51;2;1;0;6;6;1537;1;2263;5;2;
/org.eclipse.swt/Eclipse SWT PI/win32/org/eclipse/swt/internal/win32/TEXTMETRIC.java;1;0;1;1;0;0;0;1;10;0;1;957;10;10;1;0;0;1;1;957;0;957;1;1;
/org.eclipse.core.tools/src/org/eclipse/core/tools/runtime/PluginDependencyView.java;1;0;1;1;1;1;1;0;0;0;0;6302;0;0;1;0;0;0;1;6302;0;6302;1;1;
/org.eclipse.jdt.core.tests.model/workspace/Formatter/test170/A_in.java;1;0;1;1;0;0;0;1;0;0;1;2425;0;0;1;0;0;1;1;2425;0;2425;1;1;
/org.eclipse.osgi/eclipseAdaptor/src/org/eclipse/core/runtime/adaptor/ComputeNodeOrder.java;2;1;3;1;2;2;2;1;4;0;1;4678;4;4;1;0;0;1;3;4678;0;5313;3;2;
/org.eclipse.debug.ui/ui/org/eclipse/debug/internal/ui/views/variables/ToggleLogicalStructureAction.java;1;0;2;1;0;0;0;2;9;1;2;2647;9;9;1;0;0;2;2;2647;0;2687;2;1;
/org.eclipse.jdt.ui/ui/org/eclipse/jdt/internal/ui/text/link/contentassist/ContentAssistant2.java;3;0;9;1;0;0;0;9;90;1;9;1132;256;256;1;0;0;9;9;1132;0;4214;9;3;
/org.eclipse.ui.workbench/Eclipse UI/org/eclipse/ui/commands/registry/IKeyBindingDefinition.java;1;0;3;1;0;0;0;3;2;2;2;1400;2;2;2;1;0;3;3;1400;1;1417;2;1;
/org.eclipse.jdt.core.tests.model/workspace/Converter/src/test0461/A.java;1;0;1;1;0;0;0;1;0;0;1;3714;0;0;1;0;0;1;1;3714;0;3714;1;1;
/org.eclipse.core.tests.runtime/src/org/eclipse/core/tests/internal/plugins/RegressionResolveTest_4.java;1;0;1;1;0;0;0;1;0;0;1;3014;0;0;1;0;0;1;1;3014;0;3014;1;1;
/org.eclipse.jdt.ui.tests.refactoring/resources/ExtractMethodWorkSpace/ExtractMethodTests/return_out/A_test700.java;1;0;2;1;0;0;0;2;4;1;2;130;5;5;1;0;0;2;2;130;0;844;2;1;
/org.eclipse.debug.ui/ui/org/eclipse/debug/internal/ui/views/memory/RemoveMemoryBlockAction.java;1;0;1;1;1;1;1;0;0;0;0;5254;0;0;1;0;0;0;1;5254;0;5254;1;1;
/org.eclipse.core.tests.runtime/src/org/eclipse/core/tests/runtime/jobs/AbstractJobManagerTest.java;2;1;4;1;2;2;2;2;48;1;2;1985;64;64;1;0;0;2;4;1985;0;5689;4;2;
/org.eclipse.ui.workbench.texteditor/src/org/eclipse/ui/texteditor/MarkerAnnotationPresentation.java;1;0;1;1;0;0;0;1;0;0;1;2243;0;0;1;0;0;1;1;2243;0;2243;1;1;
/org.eclipse.team.webdav/src/org/eclipse/team/internal/ui/target/MappingSelectionPage.java;2;0;3;1;1;1;1;2;24;1;2;2495;26;26;1;0;0;2;3;2495;0;6337;3;2;
/org.eclipse.swt/Eclipse SWT PI/win32/org/eclipse/swt/internal/win32/DROPFILES.java;1;0;1;1;0;0;0;1;3;0;1;2915;3;3;1;0;0;1;1;2915;0;2915;1;1;
/org.eclipse.jdt.ui/ui/org/eclipse/jdt/internal/ui/text/correction/UnimplementedMethodsCompletionProposal.java;3;1;16;2;4;4;4;12;32;1;12;218;163;163;1;0;0;12;16;218;0;6340;16;3;
/org.eclipse.swt.graphics.text/Examples/examples/Tests.java;1;0;1;1;0;0;0;1;0;0;1;3154;0;0;1;0;0;1;1;3154;0;3154;1;1;
/org.eclipse.help.tests/src/org/eclipse/help/tests/launching/DisplayHelpResource_IHrefResource_toc.java;1;0;1;1;0;0;0;1;0;0;1;2732;0;0;1;0;0;1;1;2732;0;2732;1;1;
/org.eclipse.core.runtime/src/org/eclipse/core/internal/content/XMLContentDescriber.java;2;2;14;1;10;8;10;4;55;1;4;4574;192;192;2;0;2;4;14;5185;2;6012;12;2;
/org.eclipse.team.tests.cvs.core/src/org/eclipse/team/tests/ccvs/ui/logformatter/LogEntry.java;1;0;1;1;0;0;0;1;0;0;1;2632;0;0;1;0;0;1;1;2632;0;2632;1;1;
/org.eclipse.ui.workbench/Eclipse UI/org/eclipse/ui/dialogs/IWorkingSetSelectionDialog.java;1;0;1;1;0;0;0;1;2;0;1;1;2;2;1;0;0;1;1;1;0;1;1;1;
/org.eclipse.jface.text/src/org/eclipse/jface/text/rules/Token.java;1;1;2;1;2;2;2;0;6;0;0;5123;8;8;1;0;0;0;2;5123;0;6340;2;1;
/org.eclipse.jdt.core/codeassist/org/eclipse/jdt/internal/codeassist/impl/Engine.java;3;0;6;1;0;0;0;6;27;1;6;1043;57;57;1;0;0;6;6;1043;0;3560;6;3;
/org.eclipse.jdt.ui.tests.refactoring/resources/MoveInnerToTopLevel/test12/out/Inner.java;1;0;1;1;0;0;0;1;2;0;1;305;2;2;1;0;0;1;1;305;0;305;1;1;
/org.eclipse.ui.workbench/Eclipse UI/org/eclipse/ui/internal/commands/ws/CommandView.java;2;0;2;1;1;1;1;1;10;0;1;4896;10;10;1;0;0;1;2;4896;0;6338;2;2;
/org.eclipse.ui.workbench/Eclipse UI/org/eclipse/ui/actions/MoveResourceAction.java;1;0;1;1;0;0;0;1;0;0;1;2737;0;0;1;0;0;1;1;2737;0;2737;1;1;
/org.eclipse.jdt.ui.tests.refactoring/resources/ConvertAnonymousToNested/canConvert/A_test23_out.java;1;0;1;1;0;0;0;1;0;0;1;3195;0;0;1;0;0;1;1;3195;0;3195;1;1;
/org.eclipse.core.runtime/src/org/eclipse/core/runtime/model/ExtensionPointModel.java;1;0;1;1;0;0;0;1;0;0;1;3013;0;0;1;0;0;1;1;3013;0;3013;1;1;
/org.eclipse.ui.workbench/Eclipse UI/org/eclipse/ui/internal/commands/old/ICommandImpl.java;1;0;2;1;0;0;0;2;0;1;2;1356;0;0;1;0;0;2;2;1356;0;1507;2;1;
/org.eclipse.team.ui/src/org/eclipse/team/ui/synchronize/subscriber/SubscriberParticipantDialog.java;1;0;4;1;0;0;0;4;94;1;4;4449;94;94;1;0;0;4;4;4449;0;4632;4;1;
/org.eclipse.ui.workbench/Eclipse UI/org/eclipse/ui/internal/commands/old/SequenceNode.java;1;0;4;1;0;0;0;4;5;2;3;1222;5;5;2;1;0;4;4;1321;1;1695;3;1;
/org.eclipse.ui.console/src/org/eclipse/ui/internal/console/ConsoleDropDownAction.java;3;0;4;1;1;1;1;3;25;1;3;1988;39;39;1;0;0;3;4;1988;0;6336;4;3;
/org.eclipse.core.runtime/src/org/eclipse/core/runtime/IPluginPrerequisite.java;4;2;13;2;7;5;7;6;191;2;5;3013;495;495;2;1;2;6;13;5038;3;6339;10;4;
/org.eclipse.swt/Eclipse SWT PI/gtk/org/eclipse/swt/internal/gtk/GdkDragContext.java;3;0;4;1;1;1;1;3;17;1;3;1653;27;27;1;0;0;3;4;1653;0;6352;4;3;
/org.eclipse.jface.text/src/org/eclipse/jface/text/templates/TemplatePosition.java;1;0;2;1;0;0;0;2;0;0;1;4258;0;0;2;1;0;2;2;4258;1;4258;1;1;
/org.eclipse.jdt.ui.tests.refactoring/resources/ExtractMethodWorkSpace/ExtractMethodTests/duplicates_out/A_test952.java;1;0;1;1;0;0;0;1;0;0;1;1219;0;0;1;0;0;1;1;1219;0;1219;1;1;
/org.eclipse.jdt.ui.tests.refactoring/resources/MoveInnerToTopLevel/test_nonstatic_7/out/Inner.java;2;0;2;1;1;1;1;1;2;0;1;305;4;4;1;0;0;1;2;305;0;5854;2;2;
/org.eclipse.pde.ui/src/org/eclipse/pde/internal/ui/editor/schema/ElementSectionDragAdapter.java;2;1;2;1;2;2;2;0;4;0;0;5781;6;6;1;0;0;0;2;5781;0;6336;2;2;
/org.eclipse.jdt.debug.ui/ui/org/eclipse/jdt/internal/debug/ui/propertypages/InstanceFilterEditor.java;1;0;1;1;0;0;0;1;0;0;1;1358;0;0;1;0;0;1;1;1358;0;1358;1;1;
/org.eclipse.ui.ide/src/org/eclipse/ui/views/tasklist/TaskSorter.java;1;0;1;1;0;0;0;1;0;0;1;2208;0;0;1;0;0;1;1;2208;0;2208;1;1;
/org.eclipse.compare/compare/org/eclipse/compare/IStreamContentAccessorExtension2.java;1;0;7;1;0;0;0;7;23;3;5;2898;35;35;3;2;0;7;7;3953;2;4688;5;1;
/org.eclipse.jdt.core.tests.model/workspace/Formatter/test331/A_out.java;1;0;1;1;0;0;0;1;0;0;1;2640;0;0;1;0;0;1;1;2640;0;2640;1;1;
/org.eclipse.jdt.core.tests.model/workspace/Converter/test0155/Test.java;1;0;1;1;0;0;0;1;0;0;1;3714;0;0;1;0;0;1;1;3714;0;3714;1;1;
/org.eclipse.ui.externaltools/Ant Tools Support/org/eclipse/ui/externaltools/internal/ant/preferences/AddCustomDialog.java;1;0;1;1;0;0;0;1;0;0;1;282;0;0;1;0;0;1;1;282;0;282;1;1;
/org.eclipse.pde.ui/templates_3.0/editor/java/XMLDocumentProvider.java;1;0;1;1;0;0;0;1;0;0;1;2786;0;0;1;0;0;1;1;2786;0;2786;1;1;
/org.eclipse.jdt.ui.tests.refactoring/resources/Copy/test_import_container_yes_method_in_different_cu/out/A.java;1;0;1;1;0;0;0;1;0;0;1;685;0;0;1;0;0;1;1;685;0;685;1;1;
/org.eclipse.core.tests.runtime/src/org/eclipse/core/tests/internal/dynamicregistry/ExtensionRegistryDynamicTest.java;1;0;1;1;1;1;1;0;0;0;0;6201;0;0;1;0;0;0;1;6201;0;6201;1;1;
/org.eclipse.jdt.ui.tests.refactoring/resources/ExtractTemp/canExtract/A_test69_out.java;1;0;1;1;0;0;0;1;0;0;1;1309;0;0;1;0;0;1;1;1309;0;1309;1;1;
/org.eclipse.jdt.core/search/org/eclipse/jdt/internal/core/search/matching/DeclarationOfReferencedMethodsPattern.java;2;0;8;1;1;1;1;7;88;1;7;86;165;165;1;0;0;7;8;86;0;5207;8;2;
/org.eclipse.ui.cheatsheets/src/org/eclipse/ui/internal/cheatsheets/registry/CheatSheetItemExtensionElement.java;1;1;2;1;2;2;2;0;6;0;0;5363;6;6;1;0;0;0;2;5363;0;5976;2;1;
/org.eclipse.core.tests.runtime/src/org/eclipse/core/tests/internal/plugin/d/PluginClass.java;1;0;1;1;1;1;1;0;19;0;0;5149;19;19;1;0;0;0;1;5149;0;5149;1;1;
/org.eclipse.core.tests.runtime/src/org/eclipse/core/tests/internal/plugins/LoaderTest.java;1;0;1;1;0;0;0;1;0;0;1;3014;0;0;1;0;0;1;1;3014;0;3014;1;1;
/org.eclipse.team.ui/src/org/eclipse/team/internal/ui/sync/views/SyncSetInput.java;1;0;3;1;0;0;0;3;107;1;3;488;107;107;1;0;0;3;3;488;0;1354;3;1;
/org.eclipse.update.ui.win32/src/org/eclipse/welcome/internal/GlobalActionHandler.java;1;0;2;1;0;0;0;2;0;1;2;889;0;0;1;0;0;2;2;889;0;907;2;1;
/org.eclipse.team.cvs.ui/src/org/eclipse/team/internal/ccvs/ui/repo/CommentHistoryContentHandler.java;1;0;1;1;0;0;0;1;24;0;1;2402;24;24;1;0;0;1;1;2402;0;2402;1;1;
/org.eclipse.team.tests.cvs.core/src/org/eclipse/team/tests/ccvs/core/provider/ImportTest.java;1;0;2;1;0;0;0;2;25;1;2;1591;28;28;1;0;0;2;2;1591;0;2986;2;1;
/org.eclipse.pde.core/src/org/eclipse/pde/core/ModelChangedEvent.java;2;1;4;1;3;3;3;1;102;0;1;4834;128;128;1;0;0;1;4;4834;0;6336;4;2;
/org.eclipse.pde.core/src/org/eclipse/pde/internal/core/isite/ISiteCategory.java;2;1;3;1;2;2;2;1;4;0;1;4203;8;8;1;0;0;1;3;4203;0;6336;3;2;
/org.eclipse.ui.workbench/Eclipse UI/org/eclipse/ui/commands/IHandlerService.java;1;0;3;1;0;0;0;3;24;1;3;1065;24;24;1;0;0;3;3;1065;0;1222;3;1;
/org.eclipse.ui.ide/src/org/eclipse/ui/internal/ide/registry/ProjectImageRegistryReader.java;2;0;2;1;0;0;0;2;3;1;2;2264;3;3;1;0;0;2;2;2264;0;2804;2;2;
/org.eclipse.ui.ide/src/org/eclipse/ui/views/navigator/ResourcePatternFilter.java;1;0;2;1;0;0;0;2;4;1;2;2208;4;4;1;0;0;2;2;2208;0;2264;2;1;
/org.eclipse.jdt.debug/model/org/eclipse/jdt/internal/debug/core/JDIDebugPlugin.java;3;1;6;1;2;2;2;4;58;1;4;2210;116;116;1;0;0;4;6;2210;0;5471;6;3;
/org.eclipse.jdt.debug.tests/tests/org/eclipse/jdt/debug/tests/eval/NestedTypeFieldValue_203.java;1;0;1;1;0;0;0;1;74;0;1;1274;74;74;1;0;0;1;1;1274;0;1274;1;1;
/org.eclipse.team.core/src/org/eclipse/team/internal/core/subscribers/caches/AbstractResourceVariantTree.java;1;0;3;1;0;0;0;3;59;1;3;4238;59;59;1;0;0;3;3;4238;0;4349;3;1;
/org.eclipse.team.core/src/org/eclipse/team/internal/core/subscribers/SyncSetInputFromSubscriber.java;1;0;3;1;1;1;1;2;57;1;2;3550;59;59;1;0;0;2;3;3550;0;6336;3;1;
/org.eclipse.jdt.core.tests.model/workspace/Converter/test0441/A.java;1;0;1;1;0;0;0;1;0;0;1;3714;0;0;1;0;0;1;1;3714;0;3714;1;1;
/org.eclipse.jdt.core/search/org/eclipse/jdt/internal/core/search/indexing/AddJarFileToIndex.java;3;0;12;2;1;1;1;11;70;2;8;937;142;142;2;3;0;11;12;937;3;5659;9;3;
/org.eclipse.ua.tests/src/org/eclipse/ui/tests/cheatsheets/CheatSheetTestPlugin.java;1;0;1;1;1;1;1;0;0;0;0;6081;0;0;1;0;0;0;1;6081;0;6081;1;1;
/org.eclipse.swt.tests/JUnit Tests/org/eclipse/swt/tests/junit/Test_org_eclipse_swt_events_ControlEvent.java;1;0;2;1;1;1;1;1;7;0;1;3444;11;11;1;0;0;1;2;3444;0;6352;2;1;
/org.eclipse.jdt.ui.examples.javafamily/src/org/eclipse/jsp/launching/TomcatLaunchDelegate.java;2;1;10;1;2;2;2;8;83;2;7;1373;142;142;2;1;0;8;10;1384;1;5923;9;2;
/org.eclipse.ui.tests/Eclipse UI Tests/org/eclipse/ui/tests/navigator/HeavyNullTextDecorator.java;3;1;3;1;2;2;2;1;12;0;1;4238;22;22;1;0;0;1;3;4238;0;6338;3;3;
/org.eclipse.ui.cheatsheets/src/org/eclipse/ui/internal/cheatsheets/data/CheatSheetSaveHelper.java;2;1;10;1;7;7;7;3;496;1;3;4428;787;787;1;0;0;3;10;4428;0;5975;10;2;
/org.eclipse.debug.core/core/org/eclipse/debug/internal/core/sourcelookup/ISourceLookupParticipant.java;1;0;6;1;0;0;0;6;29;1;6;3169;49;49;1;0;0;6;6;3169;0;4949;6;1;
/org.eclipse.ui.workbench/Eclipse UI/org/eclipse/ui/internal/ViewPane.java;7;2;63;4;17;16;17;46;1376;6;34;774;4004;4004;6;12;1;46;63;4460;13;6219;50;7;
/org.eclipse.team.ui/src/org/eclipse/team/ui/sync/actions/workingsets/EditWorkingSetAction.java;1;0;1;1;0;0;0;1;0;0;1;2451;0;0;1;0;0;1;1;2451;0;2451;1;1;
/org.eclipse.ui.editors/src/org/eclipse/ui/internal/editors/quickdiff/DocumentLineDiffer.java;2;0;5;1;0;0;0;5;237;1;5;1214;255;255;1;0;0;5;5;1214;0;1644;5;2;
/org.eclipse.jdt.core.tests.model/workspace/Formatter/test302/A_in.java;1;0;1;1;0;0;0;1;0;0;1;2442;0;0;1;0;0;1;1;2442;0;2442;1;1;
/org.eclipse.team.cvs.ui/src/org/eclipse/team/internal/ccvs/ui/Console.java;2;0;3;1;0;0;0;3;13;1;3;866;15;15;1;0;0;3;3;866;0;3944;3;2;
/org.eclipse.team.tests.cvs.core/src/org/eclipse/team/tests/ccvs/core/subscriber/TestOverrideAndCommit.java;2;0;4;1;0;0;0;4;2;1;4;2206;4;4;1;0;0;4;4;2206;0;4450;4;2;
/org.eclipse.jdt.junit/src/org/eclipse/jdt/junit/ITestRunListener.java;2;1;2;1;2;2;2;0;6;0;0;5112;8;8;1;0;0;0;2;5112;0;6340;2;2;
/org.eclipse.jface/src/org/eclipse/jface/resource/StringConverter.java;3;0;6;1;1;1;1;5;99;1;5;39;263;263;1;0;0;5;6;39;0;6338;6;3;
/org.eclipse.team.ui/src/org/eclipse/team/internal/ui/synchronize/views/TeamSynchronizingPerspective.java;1;0;1;1;0;0;0;1;0;0;1;2535;0;0;1;0;0;1;1;2535;0;2535;1;1;
/org.eclipse.jdt.ui.tests.refactoring/resources/Copy/test_inner_type_yes_cu/in/C.java;1;0;1;1;0;0;0;1;0;0;1;1009;0;0;1;0;0;1;1;1009;0;1009;1;1;
/org.eclipse.releng.basebuilder/plugins/org.eclipse.build.tools/src/org/eclipse/releng/generators/FileCounter.java;1;0;2;1;0;0;0;2;19;1;2;991;29;29;1;0;0;2;2;991;0;3597;2;1;
/org.eclipse.debug.ui/ui/org/eclipse/debug/internal/ui/actions/RunToLineActionDelegate.java;1;0;3;1;0;0;0;3;64;2;2;4471;64;64;2;1;0;3;3;4492;1;4492;2;1;
/org.eclipse.ui.workbench.texteditor/src/org/eclipse/ui/texteditor/TextOperationAction.java;2;1;4;1;2;2;2;2;21;1;2;2097;29;29;1;0;0;2;4;2097;0;6340;4;2;
/org.eclipse.team.ui/src/org/eclipse/team/internal/ui/synchronize/StructuredViewerAdvisor.java;2;2;6;2;6;5;6;0;77;0;0;5362;178;178;2;0;1;0;6;5362;1;6337;5;2;
/org.eclipse.jdt.ui/core refactoring/org/eclipse/jdt/internal/corext/refactoring/structure/ImportRemover.java;1;1;2;1;2;2;2;0;6;0;0;5612;6;6;1;0;0;0;2;5612;0;5651;2;1;
/org.eclipse.ui.views/src/org/eclipse/ui/views/framelist/UpAction.java;1;0;1;1;0;0;0;1;0;0;1;2738;0;0;1;0;0;1;1;2738;0;2738;1;1;
/org.eclipse.swt/Eclipse SWT Browser/common/org/eclipse/swt/browser/VisibilityAdapter.java;1;0;3;1;0;0;0;3;2;1;3;2862;2;2;1;0;0;3;3;2862;0;3166;3;1;
/org.eclipse.swt.graphics.text/Eclipse SWT/gtk/org/eclipse/swt/graphics/FontMetrics.java;2;0;2;1;0;0;0;2;0;1;2;3875;0;0;1;0;0;2;2;3875;0;4213;2;2;
/org.eclipse.jdt.launching/launching/org/eclipse/jdt/launching/sourcelookup/PackageFragmentRootSourceLocation.java;3;1;6;1;2;2;2;4;34;1;4;811;100;100;1;0;0;4;6;811;0;6336;6;3;
/org.eclipse.jdt.ui/ui refactoring/org/eclipse/jdt/internal/ui/refactoring/reorg/ReorgMoveStarter.java;4;1;9;1;3;3;3;6;40;1;6;1114;77;77;1;0;0;6;9;1114;0;6340;9;4;
/org.eclipse.ui.ide/src/org/eclipse/ui/wizards/datatransfer/WizardZipFileExportPage1.java;1;0;1;1;0;0;0;1;0;0;1;1511;0;0;1;0;0;1;1;1511;0;1511;1;1;
/org.eclipse.jdt.core/model/org/eclipse/jdt/internal/core/DefaultWorkingCopyOwner.java;2;0;12;2;1;1;1;11;53;2;10;825;101;101;2;1;0;11;12;1048;1;5179;11;2;
/org.eclipse.ui.tests/Eclipse UI Tests/org/eclipse/ui/tests/api/SessionCreateTest.java;1;0;1;1;0;0;0;1;9;0;1;2738;9;9;1;0;0;1;1;2738;0;2738;1;1;
/org.eclipse.update.core/srcnew/org/eclipse/update/search/IUpdateSearchQuery.java;2;0;4;1;0;0;0;4;3;1;4;574;5;5;1;0;0;4;4;574;0;825;4;2;
/org.eclipse.ui.intro/src/org/eclipse/ui/internal/intro/impl/model/IntroPage.java;1;1;3;1;3;3;3;0;8;0;0;5115;10;10;1;0;0;0;3;5115;0;5314;3;1;
/org.eclipse.team.tests.cvs.core/src/org/eclipse/team/tests/ccvs/ui/EmptyPerspective.java;1;0;1;1;0;0;0;1;0;0;1;2632;0;0;1;0;0;1;1;2632;0;2632;1;1;
/org.eclipse.jdt.ui/core refactoring/org/eclipse/ltk/core/refactoring/IDynamicValidationStateChange.java;1;0;4;1;0;0;0;4;3;1;4;4510;5;5;1;0;0;4;4;4510;0;4864;4;1;
/org.eclipse.jdt.core.tests.model/workspace/Converter/junit/awtui/AboutDialog.java;1;0;1;1;0;0;0;1;0;0;1;3714;0;0;1;0;0;1;1;3714;0;3714;1;1;
/org.eclipse.team.ui/src/org/eclipse/team/ui/synchronize/subscribers/SubscriberParticipant.java;2;2;10;2;5;4;5;5;225;1;5;4632;443;443;2;0;1;5;10;5358;1;5358;9;2;
/org.eclipse.core.runtime.compatibility/src-runtime/org/eclipse/core/internal/plugins/PluginClassLoader.java;2;1;7;1;2;2;2;5;25;1;5;3013;58;58;1;0;0;5;7;3013;0;6340;7;2;
/org.eclipse.jdt.core/search/org/eclipse/jdt/internal/core/search/matching/FieldPattern.java;2;3;18;1;5;3;5;13;263;1;13;1115;552;552;3;0;2;13;18;5207;2;5335;16;2;
/org.eclipse.ui.workbench/Eclipse UI/org/eclipse/ui/internal/gestures/GestureSupport.java;2;0;5;1;0;0;0;5;38;1;5;1721;79;79;1;0;0;5;5;1721;0;3214;5;2;
/org.eclipse.team.cvs.core/src/org/eclipse/team/internal/ccvs/core/client/TemplateHandler.java;1;0;2;1;0;0;0;2;63;0;1;3130;63;63;2;1;0;2;2;3130;1;3130;1;1;
/org.eclipse.jdt.core.tests.model/workspace/Converter/src/test0555/A.java;1;0;1;1;1;1;1;0;0;0;0;5641;0;0;1;0;0;0;1;5641;0;5641;1;1;
/org.eclipse.jdt.core/model/org/eclipse/jdt/internal/core/JavaElementRequestor.java;1;0;1;1;0;0;0;1;2;0;1;3560;2;2;1;0;0;1;1;3560;0;3560;1;1;
/org.eclipse.ui.workbench/Eclipse UI/org/eclipse/ui/internal/EditActionSetsAction.java;1;0;1;1;0;0;0;1;46;0;1;2737;46;46;1;0;0;1;1;2737;0;2737;1;1;
/org.eclipse.jdt.ui.tests.refactoring/resources/RenamePackage/testImportFromMultiRoots7/in/srcPrj.ref/pack/Referer.java;1;0;1;1;0;0;0;1;0;0;1;4105;0;0;1;0;0;1;1;4105;0;4105;1;1;
/org.eclipse.ui.workbench/Eclipse UI/org/eclipse/ui/internal/commands/Context.java;1;0;4;1;0;0;0;4;0;1;4;607;0;0;1;0;0;4;4;607;0;1077;4;1;
/org.eclipse.jdt.ui.tests.refactoring/resources/Delete/testDeleteWithinCu13/out/A.java;1;0;1;1;0;0;0;1;0;0;1;442;0;0;1;0;0;1;1;442;0;442;1;1;
/org.eclipse.team.examples.filesystem/src/org/eclipse/team/examples/filesystem/subscriber/FileSystemSyncInfo.java;1;0;1;1;1;1;1;0;0;0;0;6206;0;0;1;0;0;0;1;6206;0;6206;1;1;
/org.eclipse.swt/Eclipse SWT/common/org/eclipse/swt/widgets/Synchronizer.java;2;1;5;1;2;2;2;3;13;1;3;766;27;27;1;0;0;3;5;766;0;6352;5;2;
/org.eclipse.swt/Eclipse SWT/gtk/org/eclipse/swt/graphics/FontData.java;2;1;4;1;2;2;2;2;42;1;2;174;53;53;1;0;0;2;4;174;0;6352;4;2;
/org.eclipse.update.ui/srcnew/org/eclipse/update/internal/ui/wizards/PendingOperationAdapter.java;1;0;2;1;0;0;0;2;0;0;1;376;0;0;2;1;0;2;2;376;1;376;1;1;
/org.eclipse.jdt.core.tests.model/workspace/Converter/junit/framework/Assert.java;1;0;2;1;0;0;0;2;122;1;2;787;122;122;1;0;0;2;2;787;0;3714;2;1;
/org.eclipse.jface.text/src/org/eclipse/jface/text/source/ITagHandlerFactory.java;1;0;4;1;1;1;1;3;4;1;3;1629;6;6;1;0;0;3;4;1629;0;5122;4;1;
/org.eclipse.ant.ui/Ant Tools Support/org/eclipse/ant/internal/ui/launchConfigurations/AntTargetContentProvider.java;2;1;7;1;2;2;2;5;72;2;4;1811;156;156;2;1;0;5;7;2025;1;6336;6;2;
/org.eclipse.jdt.core.tests.model/workspace/Converter/test0405/A.java;1;0;1;1;0;0;0;1;0;0;1;3714;0;0;1;0;0;1;1;3714;0;3714;1;1;
/org.eclipse.ant.ui/Ant Tools Support/org/eclipse/ant/ui/internal/views/AntProjectContentProvider.java;1;0;2;1;0;0;0;2;0;1;2;250;0;0;1;0;0;2;2;250;0;1811;2;1;
/org.eclipse.ui.ide/src/org/eclipse/ui/internal/dialogs/MultiStepReviewWizardPage.java;2;0;3;1;0;0;0;3;12;1;3;1526;12;12;1;0;0;3;3;1526;0;2263;3;2;
/org.eclipse.jdt.ui.tests.refactoring/resources/ConvertAnonymousToNested/canConvert/A_test23_in.java;1;0;1;1;0;0;0;1;0;0;1;3195;0;0;1;0;0;1;1;3195;0;3195;1;1;
/org.eclipse.jdt.ui.tests.refactoring/resources/IntroduceFactory/positive/DifferentArgs3.java;1;0;2;1;1;1;1;1;2;0;1;2846;2;2;1;0;0;1;2;2846;0;5659;2;1;
/org.eclipse.team.tests.cvs.core/src/org/eclipse/team/tests/ccvs/core/provider/ModuleTest.java;2;1;7;1;3;3;3;4;70;1;4;790;119;119;1;0;0;4;7;790;0;6337;7;2;
/org.eclipse.jdt.ui.tests.refactoring/resources/PullUp/test41/in/A.java;1;0;1;1;0;0;0;1;0;0;1;328;0;0;1;0;0;1;1;328;0;328;1;1;
/org.eclipse.jdt.core.tests.compiler/src/org/eclipse/jdt/core/tests/compiler/regression/TryStatementTest.java;2;1;6;1;2;2;2;4;79;1;4;1785;147;147;1;0;0;4;6;1785;0;6336;6;2;
/org.eclipse.pde.ui/src_Forms/org/eclipse/pde/internal/ui/neweditor/PDEMultiPagePropertySheet.java;2;0;2;1;1;1;1;1;0;0;1;4877;0;0;1;0;0;1;2;4877;0;5431;2;2;
/org.eclipse.update.core/src/org/eclipse/update/core/ISiteFeatureReference.java;3;1;4;1;2;2;2;2;8;1;2;0;20;20;1;0;0;2;4;0;0;6336;4;3;
/org.eclipse.help.ui/src/org/eclipse/help/ui/internal/util/WorkbenchResources.java;1;0;1;1;0;0;0;1;0;0;1;2732;0;0;1;0;0;1;1;2732;0;2732;1;1;
/org.eclipse.swt/Eclipse SWT/photon/org/eclipse/swt/graphics/FontData.java;2;1;4;1;2;2;2;2;42;1;2;174;53;53;1;0;0;2;4;174;0;6352;4;2;
/org.eclipse.team.cvs.ui/src/org/eclipse/team/internal/ccvs/ui/actions/NewRepositoryAction.java;1;0;2;1;1;1;1;1;8;0;1;5049;10;10;1;0;0;1;2;5049;0;6337;2;1;
/org.eclipse.osgi.tests/src/org/eclipse/osgi/tests/OSGiTests.java;1;0;1;1;1;1;1;0;0;0;0;6227;0;0;1;0;0;0;1;6227;0;6227;1;1;
/org.eclipse.ui.cheatsheets/src/org/eclipse/ui/cheatsheets/OpenCheatSheetAction.java;2;1;7;1;3;3;3;4;43;1;4;4662;98;98;1;0;0;4;7;4662;0;5791;7;2;
/org.eclipse.jdt.core/model/org/eclipse/jdt/core/IWorkingCopy.java;1;0;6;1;0;0;0;6;16;2;5;818;23;23;2;1;0;6;6;818;1;3560;5;1;
/org.eclipse.jdt.ui.tests.refactoring/resources/InlineMethodWorkspace/TestCases/InlineBug.java;1;0;1;1;0;0;0;1;0;0;1;597;0;0;1;0;0;1;1;597;0;597;1;1;
/org.eclipse.ui.workbench/Eclipse UI/org/eclipse/ui/IActionService.java;1;0;2;1;0;0;0;2;0;1;2;618;0;0;1;0;0;2;2;618;0;689;2;1;
/org.eclipse.ant.ui/Ant Tools Support/org/eclipse/ant/internal/ui/preferences/MessageLine.java;1;0;1;1;0;0;0;1;0;0;1;1811;0;0;1;0;0;1;1;1811;0;1811;1;1;
/org.eclipse.jdt.ui.tests.refactoring/test cases/org/eclipse/jdt/ui/tests/refactoring/TestCreateParticipantShared.java;2;0;2;1;1;1;1;1;8;0;1;4913;8;8;1;0;0;1;2;4913;0;6340;2;2;
/org.eclipse.text/src/org/eclipse/text/edits/UndoMemento.java;1;0;2;1;0;0;0;2;0;1;2;1986;0;0;1;0;0;2;2;1986;0;2038;2;1;
/org.eclipse.ui.workbench.texteditor/src/org/eclipse/ui/texteditor/ITextEditorExtension.java;2;0;2;2;2;1;2;0;5;0;0;6334;5;5;2;0;1;0;2;6334;1;6334;1;2;
/org.eclipse.debug.ui/ui/org/eclipse/debug/internal/ui/stringsubstitution/SelectedResourceManager.java;4;2;8;2;5;4;5;3;53;1;3;2046;149;149;2;0;1;3;8;5277;1;6336;7;4;
/org.eclipse.jdt.core.tests.model/workspace/Formatter/test009/A_out.java;1;0;1;1;0;0;0;1;0;0;1;2425;0;0;1;0;0;1;1;2425;0;2425;1;1;
/org.eclipse.core.runtime.osgi/src/org/eclipse/core/internal/runtime/AssertionFailedException.java;1;0;2;1;0;0;0;2;21;1;2;3013;21;21;1;0;0;2;2;3013;0;3030;2;1;
/org.eclipse.jdt.ui.tests.refactoring/resources/IntroduceFactory/Bugzilla/45942/UseTestClass_out.java;1;0;2;1;1;1;1;1;2;0;1;2846;2;2;1;0;0;1;2;2846;0;5659;2;1;
/org.eclipse.jdt.ui.tests.refactoring/resources/SurroundWithWorkSpace/SurroundWithTests/trycatch_in/TestRuntimeException1.java;1;0;1;1;0;0;0;1;2;0;1;845;2;2;1;0;0;1;1;845;0;845;1;1;
/org.eclipse.pde.ui/src/org/eclipse/pde/internal/ui/util/Sorter.java;1;0;1;1;0;0;0;1;0;0;1;1962;0;0;1;0;0;1;1;1962;0;1962;1;1;
/org.eclipse.swt.tests/JUnit Tests/org/eclipse/swt/tests/junit/Test_org_eclipse_swt_events_ArmListener.java;1;0;1;1;0;0;0;1;16;0;1;2175;16;16;1;0;0;1;1;2175;0;2175;1;1;
/org.eclipse.swt.graphics.text/Eclipse SWT/win32/org/eclipse/swt/graphics/text/TextStyleRange.java;1;0;2;1;0;0;0;2;0;1;2;2869;0;0;1;0;0;2;2;2869;0;3132;2;1;
/org.eclipse.debug.ui/ui/org/eclipse/debug/internal/ui/actions/RelaunchLastAction.java;1;0;1;1;0;0;0;1;36;0;1;472;36;36;1;0;0;1;1;472;0;472;1;1;
/org.eclipse.jdt.ui/ui/org/eclipse/jdt/internal/ui/text/java/hover/JavaInformationProvider.java;1;0;2;1;1;1;1;1;2;0;1;1350;4;4;1;0;0;1;2;1350;0;6340;2;1;
/org.eclipse.jdt.ui.tests.refactoring/resources/ExtractMethodWorkSpace/ExtractMethodTests/locals_in/A_test537.java;1;0;1;1;0;0;0;1;4;0;1;844;4;4;1;0;0;1;1;844;0;844;1;1;
/org.eclipse.jdt.core.tests.model/workspace/Formatter/test115/A_in.java;1;0;1;1;0;0;0;1;0;0;1;2425;0;0;1;0;0;1;1;2425;0;2425;1;1;
/org.eclipse.jdt.ui/core refactoring/org/eclipse/ltk/core/refactoring/UndoManagerAdapter.java;1;0;2;1;0;0;0;2;0;1;2;4575;0;0;1;0;0;2;2;4575;0;4864;2;1;
/org.eclipse.osgi/osgi/src/org/osgi/framework/ServiceFactory.java;2;0;2;1;1;1;1;1;3;0;1;3013;3;3;1;0;0;1;2;3013;0;5536;2;2;
/org.eclipse.jdt.core/model/org/eclipse/jdt/core/IPackageFragmentRoot.java;2;0;6;1;1;1;1;5;19;1;5;346;37;37;1;0;0;5;6;346;0;5507;6;2;
/org.eclipse.ui.workbench/Eclipse UI/org/eclipse/ui/internal/dialogs/MultiStepReviewWizardPage.java;1;0;1;1;0;0;0;1;0;0;1;2737;0;0;1;0;0;1;1;2737;0;2737;1;1;
/org.eclipse.jdt.core.tests.model/workspace/Converter/test0114/Test.java;1;0;1;1;0;0;0;1;0;0;1;3714;0;0;1;0;0;1;1;3714;0;3714;1;1;
/org.eclipse.ui.workbench.texteditor/src/org/eclipse/ui/texteditor/IStatusFieldExtension.java;2;0;3;2;2;1;2;1;6;0;1;2490;6;6;2;0;1;1;3;6334;1;6334;2;2;
/org.eclipse.jdt.launching.macosx/macosx/org/eclipse/jdt/internal/ui/macbundler/BundleWizardPage3.java;1;0;1;1;0;0;0;1;0;0;1;3622;0;0;1;0;0;1;1;3622;0;3622;1;1;
/org.eclipse.jdt.debug.tests/tests/org/eclipse/jdt/debug/tests/core/WorkspaceSourceContainerTests.java;1;0;4;1;0;0;0;4;31;1;4;3679;43;43;1;0;0;4;4;3679;0;4949;4;1;
/org.eclipse.jdt.ui/ui/org/eclipse/jdt/internal/ui/text/correction/QuickFixProcessor.java;2;2;31;1;9;8;9;22;85;2;20;393;398;398;2;2;1;22;31;4229;3;6340;28;2;
/org.eclipse.pde.build/src/org/eclipse/pde/internal/build/AssembleConfigScriptGenerator.java;2;2;24;1;13;12;13;11;268;1;11;447;695;695;2;0;1;11;24;6265;1;6265;23;2;
/org.eclipse.swt/Eclipse SWT PI/motif/org/eclipse/swt/internal/motif/XDestroyWindowEvent.java;1;0;1;1;0;0;0;1;0;0;1;1450;0;0;1;0;0;1;1;1450;0;1450;1;1;
/org.eclipse.core.runtime.compatibility/src-runtime/org/eclipse/core/internal/runtime/PreferenceExporter.java;2;0;2;2;0;0;0;2;0;0;1;3013;0;0;2;1;0;2;2;3013;1;3013;1;2;
/org.eclipse.ui.workbench/Eclipse UI/org/eclipse/ui/internal/progress/ImageAnimationProcessor.java;1;0;2;1;1;1;1;1;0;0;1;4427;0;0;1;0;0;1;2;4427;0;5186;2;1;
/org.eclipse.jdt.ui.tests.refactoring/resources/SefWorkSpace/SefTests/base_in/TestFinal.java;1;0;1;1;0;0;0;1;0;0;1;2263;0;0;1;0;0;1;1;2263;0;2263;1;1;
/org.eclipse.jdt.ui.tests.refactoring/resources/ExtractMethodWorkSpace/ExtractMethodTests/initializer_in/A_test1000.java;1;0;1;1;0;0;0;1;0;0;1;3310;0;0;1;0;0;1;1;3310;0;3310;1;1;
/org.eclipse.jdt.core.tests.model/workspace/Converter/src/test0119/Test.java;1;0;1;1;0;0;0;1;0;0;1;3714;0;0;1;0;0;1;1;3714;0;3714;1;1;
/org.eclipse.jdt.core.tests.model/workspace/Converter/src/test0268/Test.java;1;0;1;1;0;0;0;1;0;0;1;3714;0;0;1;0;0;1;1;3714;0;3714;1;1;
/org.eclipse.jdt.core/model/org/eclipse/jdt/internal/core/BecomeWorkingCopyOperation.java;2;0;14;1;0;0;0;14;19;2;13;818;98;98;2;1;0;14;14;818;1;3910;13;2;
/org.eclipse.ui.externaltools/Ant Tools Support/org/eclipse/ui/externaltools/internal/ant/model/AntUtil.java;2;0;3;1;0;0;0;3;16;1;3;139;18;18;1;0;0;3;3;139;0;298;3;2;
/org.eclipse.team.ui/src/org/eclipse/team/internal/ui/DetailsDialogWithProjects.java;1;0;1;1;0;0;0;1;0;0;1;993;0;0;1;0;0;1;1;993;0;993;1;1;
/org.eclipse.swt/Eclipse SWT Mozilla/common/org/eclipse/swt/internal/mozilla/nsIURIContentListener.java;1;0;2;1;0;0;0;2;33;1;2;1855;33;33;1;0;0;2;2;1855;0;2568;2;1;
/org.eclipse.help.base/src/org/eclipse/help/internal/workingset/AdaptableTocsArray.java;1;1;3;1;2;2;2;1;26;0;1;1740;30;30;1;0;0;1;3;1740;0;6337;3;1;
/org.eclipse.swt.tests/JUnit Tests/org/eclipse/swt/tests/junit/Test_org_eclipse_swt_custom_SashForm.java;2;0;2;1;0;0;0;2;24;1;2;2104;38;38;1;0;0;2;2;2104;0;3373;2;2;
/org.eclipse.jdt.core.tests.model/workspace/Converter/test0018/Test.java;1;0;1;1;0;0;0;1;0;0;1;3714;0;0;1;0;0;1;1;3714;0;3714;1;1;
/org.eclipse.ui.workbench/Eclipse UI/org/eclipse/ui/internal/commands/registry/IMutableCommandRegistry.java;1;0;2;1;0;0;0;2;0;1;2;1422;0;0;1;0;0;2;2;1422;0;1724;2;1;
/org.eclipse.swt/Eclipse SWT/gtk1x/org/eclipse/swt/graphics/Image.java;1;0;1;1;0;0;0;1;0;0;1;2327;0;0;1;0;0;1;1;2327;0;2327;1;1;
/org.eclipse.jdt.core/search/org/eclipse/jdt/internal/core/index/impl/IndexOutput.java;1;0;2;1;0;0;0;2;2;1;2;3560;2;2;1;0;0;2;2;3560;0;4060;2;1;
/org.eclipse.jface.text/src/org/eclipse/jface/text/ITextPresentationListener.java;2;1;5;1;2;2;2;3;23;1;3;2762;32;32;1;0;0;3;5;2762;0;6359;5;2;
/org.eclipse.jdt.ui/ui/org/eclipse/jdt/internal/ui/wizards/OpenSnippetWizardAction.java;1;0;1;1;0;0;0;1;0;0;1;4920;0;0;1;0;0;1;1;4920;0;4920;1;1;
/org.eclipse.jdt.core/eval/org/eclipse/jdt/internal/eval/CodeSnippetCompiler.java;3;0;5;1;0;0;0;5;18;1;5;69;26;26;1;0;0;5;5;69;0;3560;5;3;
/org.eclipse.swt/Eclipse SWT/common/org/eclipse/swt/SWTError.java;2;1;3;1;2;2;2;1;18;0;1;4062;24;24;1;0;0;1;3;4062;0;6352;3;2;
/org.eclipse.debug.ui/ui/org/eclipse/debug/ui/variables/VariableUtil.java;1;0;5;1;0;0;0;5;286;3;3;316;438;438;3;2;0;5;5;316;2;550;3;1;
/org.eclipse.jdt.ui.tests.refactoring/resources/ExtractMethodWorkSpace/ExtractMethodTests/parameterName_out/A_test903.java;1;0;2;1;0;0;0;2;4;1;2;130;5;5;1;0;0;2;2;130;0;844;2;1;
/org.eclipse.jdt.ui/ui/org/eclipse/jdt/ui/actions/OpenAction.java;3;1;6;2;2;2;2;4;12;1;4;592;24;24;1;0;0;4;6;592;0;6340;6;3;
/org.eclipse.pde.ui/src/org/eclipse/pde/internal/ui/wizards/tools/UpdateClasspathAction.java;2;1;6;1;3;3;3;3;11;1;3;3840;34;34;1;0;0;3;6;3840;0;6336;6;2;
/org.eclipse.jdt.core.tests.model/workspace/Converter/test0169/Test.java;1;0;1;1;0;0;0;1;0;0;1;3714;0;0;1;0;0;1;1;3714;0;3714;1;1;
/org.eclipse.team.ui/src/org/eclipse/team/internal/ui/actions/TeamAction.java;2;1;10;1;3;3;3;7;129;1;7;790;352;352;1;0;0;7;10;790;0;6337;10;2;
/org.eclipse.jface.text/src/org/eclipse/jface/text/formatter/ContextBasedFormattingStrategy.java;3;1;9;1;4;4;4;5;66;1;5;1998;180;180;1;0;0;5;9;1998;0;6357;9;3;
/org.eclipse.jdt.ui.tests/ui/org/eclipse/jdt/ui/tests/packageview/ContentProviderTests3.java;2;1;4;1;3;3;3;1;20;0;1;1647;39;39;1;0;0;1;4;1647;0;6340;4;2;
/org.eclipse.ui.cheatsheets/src/org/eclipse/ui/internal/cheatsheets/ICheatSheetResource.java;2;2;12;1;9;7;9;3;104;1;3;4428;169;169;2;0;2;3;12;5715;2;5975;10;2;
/org.eclipse.jdt.core.tests.model/workspace/Formatter/test156/A_in.java;1;0;1;1;0;0;0;1;0;0;1;2425;0;0;1;0;0;1;1;2425;0;2425;1;1;
/org.eclipse.compare.tests/JUnit Tests/org/eclipse/compare/tests/FilterTest.java;1;0;2;1;0;0;0;2;2;1;2;3416;2;2;1;0;0;2;2;3416;0;3938;2;1;
/org.eclipse.jdt.core.tests.model/workspace/Converter/src/test0160/Test.java;1;0;1;1;0;0;0;1;0;0;1;3714;0;0;1;0;0;1;1;3714;0;3714;1;1;
/org.eclipse.team.ui/src/org/eclipse/team/internal/ui/synchronize/views/TeamSubscriberParticipantLabelProvider.java;1;0;1;1;0;0;0;1;0;0;1;3243;0;0;1;0;0;1;1;3243;0;3243;1;1;
/org.eclipse.ui.ide/src/org/eclipse/ui/views/markers/BookmarkView.java;3;0;5;1;0;0;0;5;98;2;4;2208;124;124;2;1;0;5;5;3260;1;3939;4;3;
/org.eclipse.jdt.ui.tests.refactoring/resources/UseSupertypeWherePossible/testNew14/in/Test.java;1;0;1;1;0;0;0;1;2;0;1;1166;2;2;1;0;0;1;1;1166;0;1166;1;1;
/org.eclipse.jdt.debug.tests/tests/org/eclipse/jdt/debug/tests/eval/TestsNestedTypes2.java;1;0;1;1;0;0;0;1;38;0;1;1274;38;38;1;0;0;1;1;1274;0;1274;1;1;
/org.eclipse.jdt.ui.tests.refactoring/resources/IntroduceFactory/Bugzilla/59280/ExplicitSuperCtorCall.java;1;0;2;1;2;1;2;0;2;0;0;5656;2;2;2;0;1;0;2;5656;1;5656;1;1;
/org.eclipse.update.core/src/org/eclipse/update/internal/security/JarVerificationResult.java;2;1;4;1;2;2;2;2;19;1;2;890;33;33;1;0;0;2;4;890;0;6336;4;2;
/org.eclipse.jdt.ui/ui refactoring/org/eclipse/jdt/internal/ui/refactoring/nls/search/NLSSearchMessages.java;1;0;1;1;1;1;1;0;2;0;0;6340;2;2;1;0;0;0;1;6340;0;6340;1;1;
/org.eclipse.team.ftp/src/org/eclipse/team/internal/ftp/target/FTPTargetProvider.java;1;0;2;1;1;1;1;1;42;0;1;4216;44;44;1;0;0;1;2;4216;0;6337;2;1;
/org.eclipse.core.resources/src/org/eclipse/core/resources/team/TeamHook.java;2;0;5;1;1;1;1;4;133;1;4;1477;236;236;1;0;0;4;5;1477;0;5146;5;2;
/org.eclipse.swt/Eclipse SWT/gtk1x/org/eclipse/swt/widgets/Scrollable.java;1;0;1;1;0;0;0;1;0;0;1;2327;0;0;1;0;0;1;1;2327;0;2327;1;1;
/org.eclipse.webdav/src/interface/org/eclipse/webdav/dom/PropertyBehavior.java;1;0;2;1;2;1;2;0;385;0;0;5151;385;385;2;0;1;0;2;5151;1;5151;1;1;
/org.eclipse.jface.text/src/org/eclipse/jface/text/rules/IWordDetector.java;1;0;1;1;1;1;1;0;2;0;0;6340;2;2;1;0;0;0;1;6340;0;6340;1;1;
/org.eclipse.pde.ui/src/org/eclipse/pde/internal/ui/parts/StatusDialog.java;1;0;1;1;0;0;0;1;7;0;1;648;7;7;1;0;0;1;1;648;0;648;1;1;
/org.eclipse.jdt.ui/ui/org/eclipse/jdt/internal/ui/text/CompoundContentAssistProcessor.java;2;1;4;1;3;3;3;1;43;0;1;4802;54;54;1;0;0;1;4;4802;0;6340;4;2;
/org.eclipse.pde.build/src/org/eclipse/pde/internal/build/IBuildPropertiesConstants.java;2;2;6;1;4;3;4;2;51;1;2;4490;74;74;2;0;1;2;6;5817;1;5817;5;2;
/org.eclipse.update.core/src/org/eclipse/update/internal/core/FeatureDownloadException.java;2;1;4;1;3;3;3;1;4;0;1;3168;8;8;1;0;0;1;4;3168;0;6336;4;2;
/org.eclipse.jdt.ui/ui/org/eclipse/jdt/internal/ui/text/comment/ICommentTagConstants.java;1;0;2;1;0;0;0;2;0;1;2;2310;0;0;1;0;0;2;2;2310;0;3829;2;1;
/org.eclipse.jdt.core/codeassist/org/eclipse/jdt/internal/codeassist/select/SelectionNodeFound.java;2;0;2;1;1;1;1;1;5;0;1;3560;7;7;1;0;0;1;2;3560;0;6095;2;2;
/org.eclipse.jdt.core.tests.builder/src/org/eclipse/jdt/core/tests/builder/AssertionFailedException.java;2;0;2;1;0;0;0;2;2;1;2;3308;3;3;1;0;0;2;2;3308;0;3560;2;2;
/org.eclipse.swt.tests/JUnit Tests/org/eclipse/swt/tests/junit/Test_org_eclipse_swt_widgets_Listener.java;1;0;1;1;0;0;0;1;15;0;1;2123;15;15;1;0;0;1;1;2123;0;2123;1;1;
/org.eclipse.jdt.debug.ui/ui/org/eclipse/jdt/debug/ui/JavaSourceLookupDialog.java;3;0;3;1;1;1;1;2;8;1;2;2988;18;18;1;0;0;2;3;2988;0;6336;3;3;
/org.eclipse.ui.workbench/Eclipse UI/org/eclipse/ui/actions/WorkspaceModifyDelegatingOperation.java;1;0;1;1;0;0;0;1;0;0;1;2737;0;0;1;0;0;1;1;2737;0;2737;1;1;
/org.eclipse.ui.ide/extensions/org/eclipse/ui/actions/NewWizardMenu.java;4;0;9;2;0;0;0;9;46;2;7;2263;98;98;2;2;0;9;9;3008;2;3061;7;4;
/org.eclipse.debug.ui/ui/org/eclipse/debug/internal/ui/views/memory/FormatColumnAction.java;1;0;1;1;1;1;1;0;0;0;0;5254;0;0;1;0;0;0;1;5254;0;5254;1;1;
/org.eclipse.core.runtime.compatibility/src-model/org/eclipse/core/runtime/model/Factory.java;3;2;6;1;4;3;4;2;18;1;2;3013;27;27;2;0;1;2;6;5117;1;6340;5;3;
/org.eclipse.core.tests.runtime/src/org/eclipse/core/tests/internal/preferences/PreferencesServiceTest.java;2;1;12;1;7;7;7;5;207;1;5;4493;620;620;1;0;0;5;12;4493;0;5938;12;2;
/org.eclipse.team.ftp/src/org/eclipse/team/internal/ftp/target/FTPRemoteSyncElement.java;1;0;1;1;0;0;0;1;0;0;1;4216;0;0;1;0;0;1;1;4216;0;4216;1;1;
/org.eclipse.osgi/osgi/src/org/osgi/framework/BundleEvent.java;3;1;4;1;3;3;3;1;59;0;1;3013;77;77;1;0;0;1;4;3013;0;5590;4;3;
/org.eclipse.update.ui/src/org/eclipse/update/internal/ui/pages/MainPage.java;1;0;1;1;0;0;0;1;0;0;1;755;0;0;1;0;0;1;1;755;0;755;1;1;
/org.eclipse.pde.ui/templates_3.0/multiPageEditor/java/$editorClassName$.java;2;0;2;1;1;1;1;1;2;0;1;2786;2;2;1;0;0;1;2;2786;0;5924;2;2;
/org.eclipse.jdt.core.tests.model/workspace/Formatter/test124/A_out.java;1;0;1;1;0;0;0;1;0;0;1;2425;0;0;1;0;0;1;1;2425;0;2425;1;1;
/org.eclipse.jdt.ui.tests.refactoring/resources/MoveMembers/test9/out/B.java;1;0;1;1;0;0;0;1;1;0;1;1522;1;1;1;0;0;1;1;1522;0;1522;1;1;
/org.eclipse.jface/src/org/eclipse/jface/dialogs/TitleAreaDialog.java;3;1;11;1;4;4;4;7;1060;2;5;365;1142;1142;2;2;0;7;11;632;2;6338;9;3;
/org.eclipse.jdt.text.tests/src/org/eclipse/jdt/text/tests/JdtTextTestPlugin.java;1;1;3;1;2;2;2;1;2;0;1;5082;4;4;1;0;0;1;3;5082;0;6340;3;1;
/org.eclipse.jface/src/org/eclipse/jface/preference/FieldEditorPreferencePage.java;1;0;2;1;1;1;1;1;7;0;1;1;9;9;1;0;0;1;2;1;0;5463;2;1;
/org.eclipse.update.ui.win32/src/org/eclipse/welcome/internal/webbrowser/WebBrowserEditor.java;1;0;1;1;0;0;0;1;0;0;1;907;0;0;1;0;0;1;1;907;0;907;1;1;
/org.eclipse.jdt.ui/core refactoring/org/eclipse/jdt/internal/corext/refactoring/participants/DeleteRefactoring.java;1;0;8;1;0;0;0;8;102;2;7;1668;151;151;2;1;0;8;8;4507;1;4624;7;1;
/org.eclipse.swt.graphics.text/Eclipse SWT PI/gtk/org/eclipse/swt/internal/gtk/PangoAttrColor.java;2;0;2;1;0;0;0;2;0;1;2;3874;0;0;1;0;0;2;2;3874;0;4213;2;2;
/org.eclipse.jface.text/src/org/eclipse/jface/text/IInformationControlCreatorExtension.java;2;1;5;1;3;3;3;2;11;1;2;692;26;26;1;0;0;2;5;692;0;6359;5;2;
/org.eclipse.team.ui/src/org/eclipse/team/internal/ui/actions/SubscriberAction.java;2;0;5;1;0;0;0;5;319;1;5;4071;565;565;1;0;0;5;5;4071;0;4466;5;2;
/org.eclipse.debug.ui/ui/org/eclipse/debug/ui/launchVariables/expanders/FolderPromptExpander.java;1;0;2;1;0;0;0;2;0;1;2;562;0;0;1;0;0;2;2;562;0;771;2;1;
/org.eclipse.ui.workbench/Eclipse UI/org/eclipse/ui/internal/dialogs/FakeActionSetCategory.java;1;0;1;1;0;0;0;1;0;0;1;830;0;0;1;0;0;1;1;830;0;830;1;1;
/org.eclipse.core.tests.runtime/src/org/eclipse/core/tests/internal/runtimetests/SampleHFB.java;1;0;1;1;1;1;1;0;21;0;0;5149;21;21;1;0;0;0;1;5149;0;5149;1;1;
/org.eclipse.ltk.core.refactoring/src/org/eclipse/ltk/core/refactoring/IDynamicValidationStateChange.java;1;0;2;1;0;0;0;2;0;1;2;4845;0;0;1;0;0;2;2;4845;0;4864;2;1;
/org.eclipse.team.cvs.ui/src/org/eclipse/team/internal/ccvs/ui/actions/AddAction.java;2;0;2;1;1;1;1;1;44;0;1;4780;46;46;1;0;0;1;2;4780;0;6337;2;2;
/org.eclipse.swt/Eclipse SWT PI/gtk/org/eclipse/swt/internal/gtk/GTypeInfo.java;1;0;2;1;0;0;0;2;0;1;2;1102;0;0;1;0;0;2;2;1102;0;1214;2;1;
/org.eclipse.jdt.ui/ui/org/eclipse/jdt/internal/ui/preferences/UserLibraryPreferencePage.java;3;3;20;1;12;8;12;8;115;1;8;4407;434;434;3;0;4;8;20;5123;4;6340;16;3;
/org.eclipse.jdt.debug/model/org/eclipse/jdt/internal/debug/core/model/JDIDebugTarget.java;5;2;22;2;4;3;4;18;262;1;18;363;540;540;2;0;1;18;22;6080;1;6336;21;5;
/org.eclipse.jdt.core.tests.model/workspace/Formatter/test139/A_out.java;1;0;1;1;0;0;0;1;0;0;1;2425;0;0;1;0;0;1;1;2425;0;2425;1;1;
/org.eclipse.jdt.core.tests.model/workspace/Converter/test0109/Test.java;1;0;1;1;0;0;0;1;0;0;1;3714;0;0;1;0;0;1;1;3714;0;3714;1;1;
/org.eclipse.team.ui/src/org/eclipse/team/ui/synchronize/viewers/CompressedFolderDiffNode.java;1;0;1;1;0;0;0;1;0;0;1;3972;0;0;1;0;0;1;1;3972;0;3972;1;1;
/org.eclipse.jface/src/org/eclipse/jface/dialogs/IDialogConstants.java;1;0;1;1;1;1;1;0;151;0;0;5468;151;151;1;0;0;0;1;5468;0;5468;1;1;
/org.eclipse.ui.workbench/Eclipse UI/org/eclipse/ui/commands/registry/IKeyConfigurationDefinition.java;1;0;3;1;0;0;0;3;2;2;2;1400;2;2;2;1;0;3;3;1400;1;1417;2;1;
/org.eclipse.jdt.core.tests.model/workspace/Formatter/test436/A_in.java;1;0;1;1;0;0;0;1;0;0;1;3495;0;0;1;0;0;1;1;3495;0;3495;1;1;
/org.eclipse.jdt.debug.ui/ui/org/eclipse/jdt/internal/debug/ui/actions/MoveResultToViewerAction.java;3;0;4;1;0;0;0;4;7;1;4;4238;9;9;1;0;0;4;4;4238;0;4855;4;3;
/org.eclipse.jdt.debug.ui/ui/org/eclipse/jdt/internal/debug/ui/jres/IAddVMDialogRequestor.java;1;0;1;1;0;0;0;1;0;0;1;1039;0;0;1;0;0;1;1;1039;0;1039;1;1;
/org.eclipse.jdt.core.tests.model/workspace/Converter/test0043/Test.java;1;0;1;1;0;0;0;1;0;0;1;3714;0;0;1;0;0;1;1;3714;0;3714;1;1;
/org.eclipse.jface.text/src/org/eclipse/jface/text/source/ITranslatorResultCollector.java;1;0;2;1;1;1;1;1;0;0;1;1629;0;0;1;0;0;1;2;1629;0;5122;2;1;
/org.eclipse.ui.workbench/Eclipse UI/org/eclipse/ui/internal/csm/commands/api/NotDefinedException.java;1;0;2;1;0;0;0;2;0;1;2;2532;0;0;1;0;0;2;2;2532;0;2562;2;1;
/org.eclipse.core.runtime/src/org/eclipse/core/internal/runtime/ResourceTranslator.java;4;1;12;1;11;11;11;1;98;0;1;4891;205;205;1;0;0;1;12;4891;0;6340;12;4;
/org.eclipse.debug.ui/ui/org/eclipse/debug/internal/ui/views/launch/MarkerTextSelection.java;1;0;3;1;1;1;1;2;7;1;2;1220;7;7;1;0;0;2;3;1220;0;5157;3;1;
/org.eclipse.webdav/src/client/org/eclipse/webdav/http/client/RequestInputStream.java;1;0;2;1;2;1;2;0;284;0;0;5151;284;284;2;0;1;0;2;5151;1;5151;1;1;
/org.eclipse.ui.ide/src/org/eclipse/ui/internal/ide/IHelpContextIds.java;4;2;5;2;3;2;3;2;4;1;2;1539;6;6;2;0;1;2;5;6338;1;6338;4;4;
/org.eclipse.jdt.ui.tests.refactoring/resources/PromoteTempToField/canPromote/A_test21_out.java;1;0;1;1;0;0;0;1;0;0;1;4632;0;0;1;0;0;1;1;4632;0;4632;1;1;
/org.eclipse.ui.views/src/org/eclipse/ui/views/markers/internal/FieldSeverity.java;2;0;2;1;0;0;0;2;0;1;2;755;0;0;1;0;0;2;2;755;0;2738;2;2;
/org.eclipse.team.cvs.ui/src/org/eclipse/team/internal/ccvs/ui/model/RemoteModule.java;2;1;6;1;2;2;2;4;227;1;4;66;446;446;1;0;0;4;6;66;0;6337;6;2;
/org.eclipse.jdt.ui/core refactoring/org/eclipse/jdt/internal/corext/refactoring/reorg/MoveRefactoring2.java;1;0;2;1;0;0;0;2;0;1;2;1114;0;0;1;0;0;2;2;1114;0;1126;2;1;
/org.eclipse.jdt.ui/core extension/org/eclipse/jdt/internal/corext/codemanipulation/CodeGenerationMessages.java;1;0;1;1;1;1;1;0;2;0;0;6340;2;2;1;0;0;0;1;6340;0;6340;1;1;
/org.eclipse.ui.workbench.texteditor/src/org/eclipse/ui/texteditor/AbstractRulerActionDelegate.java;3;0;4;2;2;1;2;2;3;1;2;682;6;6;2;0;1;2;4;6334;1;6334;3;3;
/org.eclipse.team.ui/src/org/eclipse/team/internal/ui/sync/actions/SyncViewerDirectionFilters.java;2;0;12;1;0;0;0;12;231;3;10;488;532;532;3;2;0;12;12;1215;2;2632;10;2;
/org.eclipse.team.cvs.core/src/org/eclipse/team/internal/ccvs/core/syncinfo/RemoteResourceFactory.java;2;0;3;1;0;0;0;3;21;1;3;532;21;21;1;0;0;3;3;532;0;4216;3;2;
/org.eclipse.jdt.ui/core refactoring/org/eclipse/jdt/internal/corext/refactoring/typeconstraints/SimpleTypeConstraint.java;2;0;8;1;1;1;1;7;80;1;7;42;166;166;1;0;0;7;8;42;0;6340;8;2;
/org.eclipse.ant.ui/Ant Tools Support/org/eclipse/ant/ui/internal/model/IAntUIHelpContextIds.java;1;0;2;1;0;0;0;2;0;1;2;250;0;0;1;0;0;2;2;250;0;1811;2;1;
/org.eclipse.ui.workbench/Eclipse UI/org/eclipse/ui/internal/LayoutPart.java;8;2;25;2;12;11;12;13;481;2;12;1092;817;817;2;1;1;13;25;4015;2;6338;23;8;
/org.eclipse.jdt.core/antadapter/org/eclipse/jdt/core/JDTCompilerAdapter.java;3;1;17;1;2;2;2;15;307;2;14;306;724;724;2;1;0;15;17;2220;1;5916;16;3;
/org.eclipse.debug.ui/ui/org/eclipse/debug/internal/ui/launchConfigurations/EnvironmentVariable.java;2;0;3;1;1;1;1;2;19;1;2;2729;21;21;1;0;0;2;3;2729;0;6339;3;2;
/org.eclipse.team.ui/src/org/eclipse/team/internal/ui/sync/CatchupReleaseViewer.java;2;0;3;1;0;0;0;3;39;1;3;866;41;41;1;0;0;3;3;866;0;4216;3;2;
/org.eclipse.jdt.core.tests.model/workspace/Converter/src/test0410/A.java;1;0;1;1;0;0;0;1;0;0;1;3714;0;0;1;0;0;1;1;3714;0;3714;1;1;
/org.eclipse.jdt.junit/src/org/eclipse/jdt/internal/junit/wizards/WizardMessages.java;1;0;1;1;1;1;1;0;2;0;0;6340;2;2;1;0;0;0;1;6340;0;6340;1;1;
/org.eclipse.jdt.ui.tests.refactoring/resources/SurroundWithWorkSpace/SurroundWithTests/trycatch_out/TestExpressionStatement.java;1;0;1;1;0;0;0;1;0;0;1;2276;0;0;1;0;0;1;1;2276;0;2276;1;1;
/org.eclipse.ui.workbench/Eclipse UI/org/eclipse/ui/internal/EditorHistory.java;1;0;1;1;0;0;0;1;60;0;1;2737;60;60;1;0;0;1;1;2737;0;2737;1;1;
/org.eclipse.swt/Eclipse SWT PI/motif/org/eclipse/swt/internal/motif/OS.java;7;2;40;1;6;5;6;34;2892;2;32;16;7555;7555;2;2;1;34;40;825;3;6352;37;7;
/org.eclipse.jdt.core/model/org/eclipse/jdt/internal/core/InternalNamingConventions.java;4;0;5;1;1;1;1;4;8;1;4;69;16;16;1;0;0;4;5;69;0;5651;5;4;
/org.eclipse.ltk.core.refactoring/src/org/eclipse/ltk/core/refactoring/ContentStamp.java;1;1;3;1;3;3;3;0;14;0;0;5162;18;18;1;0;0;0;3;5162;0;5269;3;1;
/org.eclipse.jdt.ui/ui/org/eclipse/jdt/internal/ui/text/java/SmartBracesAutoEditStrategy.java;4;0;4;1;0;0;0;4;5;1;4;583;8;8;1;0;0;4;4;583;0;3475;4;4;
/org.eclipse.ui.workbench/Eclipse UI/org/eclipse/ui/internal/commands/old/KeyFilter.java;1;0;2;1;0;0;0;2;0;1;2;1322;0;0;1;0;0;2;2;1322;0;1695;2;1;
/org.eclipse.ui.workbench/Eclipse UI/org/eclipse/ui/roles/IContextBinding.java;1;0;2;1;0;0;0;2;0;1;2;1961;0;0;1;0;0;2;2;1961;0;2202;2;1;
/org.eclipse.help/src/org/eclipse/help/ITopic.java;1;1;4;1;3;3;3;1;6;0;1;1177;17;17;1;0;0;1;4;1177;0;6337;4;1;
/org.eclipse.ui.ide/src/org/eclipse/ui/internal/dialogs/WelcomeEditorInput.java;2;0;3;1;0;0;0;3;11;1;3;1526;11;11;1;0;0;3;3;1526;0;2263;3;2;
/org.eclipse.ui.editors/src/org/eclipse/ui/internal/editors/text/AnnotationsPreferencePage.java;1;2;3;1;3;2;3;0;8;0;0;5501;10;10;2;0;1;0;3;5501;1;6340;2;1;
/org.eclipse.jdt.ui.tests.refactoring/resources/ExtractTemp/canExtract/A_test70_out.java;1;0;1;1;0;0;0;1;0;0;1;1569;0;0;1;0;0;1;1;1569;0;1569;1;1;
/org.eclipse.jdt.core.tests.compiler/src/org/eclipse/jdt/core/tests/util/AbstractCompilerTest.java;2;0;3;1;0;0;0;3;2;1;3;2389;4;4;1;0;0;3;3;2389;0;4369;3;2;
/org.eclipse.pde.ui/srcnew/org/eclipse/pde/internal/ui/editor/manifest/XMLViewerConfiguration.java;1;0;1;1;0;0;0;1;0;0;1;2320;0;0;1;0;0;1;1;2320;0;2320;1;1;
/org.eclipse.pde.ui/src/org/eclipse/pde/internal/ui/wizards/templates/HelpTemplate.java;3;1;7;1;3;3;3;4;100;1;4;2184;128;128;1;0;0;4;7;2184;0;6336;7;3;
/org.eclipse.ui.intro/src/org/eclipse/ui/intro/config/IStandbyContentPart.java;2;1;6;1;6;6;6;0;111;0;0;5277;254;254;1;0;0;0;6;5277;0;6343;6;2;
/org.eclipse.ant.ui/Ant Tools Support/org/eclipse/ant/ui/internal/launchConfigurations/AntLaunchShortcut.java;3;0;16;1;0;0;0;16;38;2;14;250;132;132;2;2;0;16;16;262;2;1811;14;3;
/org.eclipse.team.ui/src/org/eclipse/team/internal/ui/DialogArea.java;1;0;1;1;0;0;0;1;0;0;1;942;0;0;1;0;0;1;1;942;0;942;1;1;
/org.eclipse.update.core/srcnew/org/eclipse/update/operations/IOperationFactory.java;1;0;6;1;0;0;0;6;54;2;5;569;71;71;2;1;0;6;6;602;1;825;5;1;
/org.eclipse.update.core/src/org/eclipse/update/internal/operations/UpdateUtils.java;4;2;23;2;8;7;8;15;103;2;14;825;468;468;2;1;1;15;23;1217;2;6336;21;4;
/org.eclipse.jdt.core.tests.model/workspace/Converter/src/javadoc/test017b/Test.java;1;0;2;1;0;0;0;2;0;1;2;4311;0;0;1;0;0;2;2;4311;0;4390;2;1;
/org.eclipse.jdt.ui.tests.refactoring/resources/InlineMethodWorkspace/TestCases/simple_in/TestSuper.java;1;0;1;1;0;0;0;1;2;0;1;845;2;2;1;0;0;1;1;845;0;845;1;1;
/org.eclipse.pde.ui/src_Forms/org/eclipse/pde/internal/ui/neweditor/plugin/PackageLabelProvider.java;2;0;2;1;1;1;1;1;0;0;1;4974;0;0;1;0;0;1;2;4974;0;5431;2;2;
/org.eclipse.ui.workbench/Eclipse UI/org/eclipse/ui/internal/contexts/IContextRegistry.java;1;0;2;1;0;0;0;2;32;1;2;1422;32;32;1;0;0;2;2;1422;0;3066;2;1;
/org.eclipse.ltk.ui.refactoring/src/org/eclipse/ltk/ui/refactoring/UserInputWizardPage.java;2;1;10;2;7;7;7;3;85;1;3;4965;160;160;1;0;0;3;10;4965;0;6340;10;2;
/org.eclipse.pde.ui/src/org/eclipse/pde/internal/ui/editor/feature/FeatureOutlinePage.java;2;1;4;1;3;3;3;1;140;0;1;4203;174;174;1;0;0;1;4;4203;0;6336;4;2;
/org.eclipse.jdt.core/model/org/eclipse/jdt/internal/core/builder/State.java;4;0;7;1;1;1;1;6;37;1;6;1109;61;61;1;0;0;6;7;1109;0;5822;7;4;
/org.eclipse.ui.workbench/Eclipse UI/org/eclipse/ui/commands/ICommandEvent.java;1;0;8;1;0;0;0;8;61;2;7;1222;70;70;2;1;0;8;8;2562;1;2824;7;1;
/org.eclipse.jdt.ui.tests.refactoring/resources/Delete/testDeleteWithinCu20/in/A.java;1;0;1;1;0;0;0;1;0;0;1;710;0;0;1;0;0;1;1;710;0;710;1;1;
/org.eclipse.ui.editors/src/org/eclipse/ui/editors/text/FileDocumentProvider.java;3;2;25;2;12;9;12;13;246;2;12;1347;718;718;2;1;3;13;25;3675;4;6359;21;3;
/org.eclipse.jdt.core.tests.model/workspace/Converter/src/javadoc/test014/X.java;1;0;1;1;0;0;0;1;0;0;1;4311;0;0;1;0;0;1;1;4311;0;4311;1;1;
/org.eclipse.jdt.core.tests.model/src/org/eclipse/jdt/core/tests/model/SnippetCompletionTests.java;3;1;4;1;2;2;2;2;32;1;2;1059;75;75;1;0;0;2;4;1059;0;5726;4;3;
/org.eclipse.ui.workbench/Eclipse UI/org/eclipse/ui/internal/csm/commands/api/ICommandServiceEvent.java;1;0;2;1;0;0;0;2;0;1;2;2515;0;0;1;0;0;2;2;2515;0;2562;2;1;
/org.eclipse.text.tests/src/org/eclipse/text/tests/link/LinkTestSuite.java;2;2;6;1;6;5;6;0;2;0;0;5129;6;6;2;0;1;0;6;5176;1;6340;5;2;
/org.eclipse.team.examples.filesystem/src/org/eclipse/team/examples/filesystem/ui/ReplaceAction.java;2;0;2;1;1;1;1;1;66;0;1;4368;68;68;1;0;0;1;2;4368;0;6337;2;2;
/org.eclipse.ui.views/src/org/eclipse/ui/views/internal/markers/problems/ProblemPropertiesDialog.java;1;0;2;1;0;0;0;2;0;1;2;265;0;0;1;0;0;2;2;265;0;749;2;1;
/org.eclipse.jdt.ui/ui/org/eclipse/jdt/internal/ui/workingsets/ClearWorkingSetAction.java;1;0;1;1;1;1;1;0;2;0;0;6340;2;2;1;0;0;0;1;6340;0;6340;1;1;
/org.eclipse.ui.cheatsheets/src/org/eclipse/ui/cheatsheets/ICheatSheetManager.java;2;0;5;2;0;0;0;5;192;4;2;4428;192;192;4;3;0;5;5;4625;3;4625;2;2;
/org.eclipse.pde.ui/src/org/eclipse/pde/internal/ui/editor/PDEFormEditor.java;3;4;18;2;18;14;18;0;89;0;0;5431;242;242;4;0;4;0;18;5481;4;6308;14;3;
/org.eclipse.ui.ide/extensions/org/eclipse/ui/IMarkerResolutionGenerator2.java;1;0;1;1;0;0;0;1;0;0;1;2263;0;0;1;0;0;1;1;2263;0;2263;1;1;
/org.eclipse.jdt.core/dom/org/eclipse/jdt/core/dom/Initializer.java;5;1;17;1;4;4;4;13;176;1;13;1114;316;316;1;0;0;13;17;1114;0;5781;17;5;
/org.eclipse.core.variables/src/org/eclipse/core/internal/variables/ListenerList.java;1;0;1;1;0;0;0;1;0;0;1;2514;0;0;1;0;0;1;1;2514;0;2514;1;1;
/org.eclipse.jdt.ui/ui/org/eclipse/jdt/internal/ui/packageview/GotoRequiredProjectAction.java;2;1;2;1;2;2;2;0;2;0;0;5910;2;2;1;0;0;0;2;5910;0;6340;2;2;
/org.eclipse.jface/src/org/eclipse/jface/wizard/IWizardBlockedHandler.java;1;1;2;1;2;2;2;0;0;0;0;5112;0;0;1;0;0;0;2;5112;0;5363;2;1;
/org.eclipse.pde.core/src/org/eclipse/pde/internal/core/ifeature/IFeatureImport.java;2;1;3;1;2;2;2;1;6;0;1;4203;14;14;1;0;0;1;3;4203;0;6336;3;2;
/org.eclipse.core.resources/src/org/eclipse/core/internal/indexing/AbstractPagePolicy.java;1;0;1;1;1;1;1;0;6;0;0;5146;6;6;1;0;0;0;1;5146;0;5146;1;1;
/org.eclipse.jdt.core/model/org/eclipse/jdt/internal/core/builder/ClasspathDirectory.java;4;0;6;1;0;0;0;6;16;1;6;32;31;31;1;0;0;6;6;32;0;3560;6;4;
/org.eclipse.jdt.ui.tests.refactoring/resources/ExtractTemp/canExtract/A_test69_in.java;1;0;1;1;0;0;0;1;0;0;1;1309;0;0;1;0;0;1;1;1309;0;1309;1;1;
/org.eclipse.swt/Eclipse SWT/gtk/org/eclipse/swt/widgets/ScrollBar.java;5;1;10;1;2;2;2;8;32;2;7;17;96;96;2;1;0;8;10;4128;1;6352;9;5;
/org.eclipse.ui.workbench/Eclipse UI/org/eclipse/ui/internal/about/AboutAction.java;1;0;1;1;1;1;1;0;0;0;0;5483;0;0;1;0;0;0;1;5483;0;5483;1;1;
/org.eclipse.ui.ide/src/org/eclipse/ui/views/markers/internal/IMarkerChangedListener.java;1;0;1;1;0;0;0;1;0;0;1;2208;0;0;1;0;0;1;1;2208;0;2208;1;1;
/org.eclipse.pde.ui/src/org/eclipse/pde/internal/ui/editor/build/JarSelectionValidator.java;1;0;2;1;1;1;1;1;0;0;1;4919;0;0;1;0;0;1;2;4919;0;5431;2;1;
/org.eclipse.ui.externaltools/External Tools Base/org/eclipse/ui/externaltools/internal/variable/WorkingSetExpander.java;1;0;1;1;0;0;0;1;0;0;1;321;0;0;1;0;0;1;1;321;0;321;1;1;
/org.eclipse.jdt.ui.tests.refactoring/resources/IntroduceFactory/positive/ProtectConstructor2.java;1;0;2;1;1;1;1;1;2;0;1;2846;2;2;1;0;0;1;2;2846;0;5659;2;1;
/org.eclipse.swt/Eclipse SWT PI/gtk/org/eclipse/swt/internal/gtk/GdkWindowAttr.java;2;1;2;1;2;2;2;0;2;0;0;5737;2;2;1;0;0;0;2;5737;0;6352;2;2;
/org.eclipse.jdt.ui/ui refactoring/org/eclipse/jdt/internal/ui/refactoring/reorg/CopyToClipboardAction.java;3;0;9;2;1;1;1;8;55;1;8;1114;125;125;1;0;0;8;9;1114;0;6340;9;3;
/org.eclipse.swt.tools/JNI Generation/org/eclipse/swt/tools/internal/NativesGenerator.java;2;2;11;2;4;3;4;7;138;3;5;4175;451;451;3;2;1;7;11;4280;3;5781;8;2;
/org.eclipse.osgi/eclipseAdaptor/src/org/eclipse/core/runtime/adaptor/BundleLocalization.java;3;0;3;1;1;1;1;2;4;1;2;4780;4;4;1;0;0;2;3;4780;0;5116;3;3;
/org.eclipse.jdt.core.tests.model/workspace/Formatter/test425/A_in.java;1;0;1;1;0;0;0;1;0;0;1;3478;0;0;1;0;0;1;1;3478;0;3478;1;1;
/org.eclipse.swt.tests/JUnit Tests/org/eclipse/swt/tests/junit/Test_org_eclipse_swt_graphics_Region.java;5;0;8;1;1;1;1;7;451;3;5;1741;675;675;3;2;0;7;8;2963;2;6352;6;5;
/org.eclipse.team.webdav/src/org/eclipse/team/internal/core/target/TargetSubscriber.java;1;0;1;1;0;0;0;1;0;0;1;3477;0;0;1;0;0;1;1;3477;0;3477;1;1;
/org.eclipse.pde.build/src_ant/org/eclipse/pde/internal/build/tasks/IdReplaceTask.java;2;2;14;1;7;6;7;7;69;1;7;447;163;163;2;0;1;7;14;6340;1;6340;13;2;
/org.eclipse.help.base/src/org/eclipse/help/standalone/Help.java;1;1;5;1;4;4;4;1;160;0;1;1740;183;183;1;0;0;1;5;1740;0;6337;5;1;
/org.eclipse.jdt.core.tests.model/workspace/Converter/test0004/Test.java;1;0;1;1;0;0;0;1;0;0;1;3714;0;0;1;0;0;1;1;3714;0;3714;1;1;
/org.eclipse.ui.workbench/Eclipse UI/org/eclipse/ui/internal/commands/api/IImageBinding.java;1;0;2;1;0;0;0;2;2;0;1;2562;2;2;2;1;0;2;2;2562;1;2562;1;1;
/org.eclipse.webdav/src/kernel/org/eclipse/webdav/internal/kernel/ConditionFactor.java;1;0;2;1;2;1;2;0;31;0;0;5151;31;31;2;0;1;0;2;5151;1;5151;1;1;
/org.eclipse.ui.workbench/Eclipse UI/org/eclipse/ui/internal/registry/RegistryReader.java;5;0;7;1;1;1;1;6;24;1;6;1356;73;73;1;0;0;6;7;1356;0;6338;7;5;
/org.eclipse.jdt.ui.tests.refactoring/resources/MoveMembers/test5/out/B.java;1;0;1;1;0;0;0;1;1;0;1;1522;1;1;1;0;0;1;1;1522;0;1522;1;1;
/org.eclipse.ui.ide/src/org/eclipse/ui/internal/ide/dialogs/PathVariableDialog.java;2;1;3;1;2;2;2;1;22;0;1;2264;41;41;1;0;0;1;3;2264;0;6338;3;2;
/org.eclipse.jdt.ui/ui/org/eclipse/jdt/internal/ui/preferences/JavaTemplatePreferencePage.java;2;1;5;1;4;4;4;1;89;0;1;4826;121;121;1;0;0;1;5;4826;0;6340;5;2;
/org.eclipse.debug.ui/ui/org/eclipse/debug/internal/ui/views/launch/Decoration.java;1;0;1;1;0;0;0;1;0;0;1;1220;0;0;1;0;0;1;1;1220;0;1220;1;1;
/org.eclipse.ui.workbench/Eclipse UI/org/eclipse/ui/internal/commands/ActionService.java;2;0;12;1;0;0;0;12;119;2;10;689;210;210;2;2;0;12;12;1629;2;3258;10;2;
/org.eclipse.ant.ui/Ant Tools Support/org/eclipse/ant/ui/internal/model/ColorManager.java;1;0;2;1;0;0;0;2;0;1;2;264;0;0;1;0;0;2;2;264;0;1811;2;1;
/org.eclipse.jdt.debug.tests/test plugin/org/eclipse/jdt/debug/testplugin/ConsoleLineTracker.java;2;0;3;1;0;0;0;3;13;1;3;2119;26;26;1;0;0;3;3;2119;0;2149;3;2;
/org.eclipse.jdt.debug.tests/console tests/org/eclipse/jdt/debug/tests/console/TestBufferredOutputActionDelegate.java;2;0;2;1;1;1;1;1;10;0;1;3565;10;10;1;0;0;1;2;3565;0;6337;2;2;
/org.eclipse.debug.ui/ui/org/eclipse/debug/internal/ui/launchConfigurations/LaunchHistory.java;4;1;4;1;2;2;2;2;27;1;2;2449;44;44;1;0;0;2;4;2449;0;5741;4;4;
/org.eclipse.ui.workbench/Eclipse UI/org/eclipse/ui/internal/csm/roles/RoleManager.java;1;0;14;1;0;0;0;14;158;4;7;2213;318;318;4;7;0;14;14;2405;7;2433;7;1;
/org.eclipse.ant.tests.ui/Ant Editor Tests/org/eclipse/ant/ui/internal/dtd/test/dumper.java;1;0;2;1;0;0;0;2;0;1;2;1274;0;0;1;0;0;2;2;1274;0;1811;2;1;
/org.eclipse.ant.ui/Ant Editor/org/eclipse/ant/ui/internal/editor/derived/HTMLPrinter.java;1;0;2;1;0;0;0;2;0;1;2;250;0;0;1;0;0;2;2;250;0;1811;2;1;
/org.eclipse.releng.tools/src/org/eclipse/releng/tools/RelEngPlugin.java;1;1;2;1;2;2;2;0;4;0;0;5183;4;4;1;0;0;0;2;5183;0;6340;2;1;
/org.eclipse.update.core/src/org/eclipse/update/internal/core/UpdatePreferencesInitializer.java;1;1;2;1;2;2;2;0;6;0;0;5369;6;6;1;0;0;0;2;5369;0;5665;2;1;
/org.eclipse.update/src/org/eclipse/update/internal/ui/JarVerificationService.java;1;0;1;1;1;1;1;0;0;0;0;6339;0;0;1;0;0;0;1;6339;0;6339;1;1;
/org.eclipse.jdt.debug/eval/org/eclipse/jdt/internal/debug/eval/ast/instructions/Constructor.java;1;0;1;1;0;0;0;1;2;0;1;1276;2;2;1;0;0;1;1;1276;0;1276;1;1;
/org.eclipse.core.runtime.compatibility/src-runtime/org/eclipse/core/runtime/ILibrary.java;2;0;4;1;0;0;0;4;149;1;4;3013;152;152;1;0;0;4;4;3013;0;3169;4;2;
/org.eclipse.releng.basebuilder/plugins/org.eclipse.build.tools/org.eclipse.build.tools/src/org/eclipse/releng/generators/AbstractApplication.java;1;0;1;1;1;1;1;0;0;0;0;5735;0;0;1;0;0;0;1;5735;0;5735;1;1;
/org.eclipse.jdt.ui.tests.refactoring/resources/ExtractMethodWorkSpace/ExtractMethodTests/initializer_out/A_test1000.java;1;0;1;1;0;0;0;1;0;0;1;3310;0;0;1;0;0;1;1;3310;0;3310;1;1;
/org.eclipse.ui.workbench/Eclipse UI/org/eclipse/ui/internal/commands/Manager.java;1;0;6;1;0;0;0;6;87;2;5;607;95;95;2;1;0;6;6;1077;1;1222;5;1;
/org.eclipse.jdt.debug.ui/ui/org/eclipse/jdt/internal/debug/ui/actions/ValidBreakpointLocationLocator.java;2;0;9;1;0;0;0;9;78;1;9;1610;178;178;1;0;0;9;9;1610;0;3276;9;2;
/org.eclipse.jdt.ui/ui/org/eclipse/jdt/internal/ui/packageview/GotoResourceAction.java;2;0;2;1;1;1;1;1;28;0;1;450;30;30;1;0;0;1;2;450;0;6340;2;2;
/org.eclipse.core.resources/src/org/eclipse/core/internal/indexing/LogReader.java;1;1;2;1;2;2;2;0;31;0;0;5146;51;51;1;0;0;0;2;5146;0;5507;2;1;
/org.eclipse.search/new search/org/eclipse/search2/internal/ui/basic/views/SortDropDownActon.java;1;0;2;1;0;0;0;2;0;1;2;3474;0;0;1;0;0;2;2;3474;0;3711;2;1;
/org.eclipse.jdt.core.tests.model/workspace/Formatter/test167/A_out.java;1;0;2;1;0;0;0;2;4;1;2;2425;4;4;1;0;0;2;2;2425;0;3029;2;1;
/org.eclipse.pde.ui/src_Forms/org/eclipse/pde/internal/ui/model/build/Build.java;3;2;10;1;10;9;10;0;31;0;0;5298;91;91;2;0;1;0;10;5370;1;6336;9;3;
/org.eclipse.osgi.tests/src/org/eclipse/osgi/tests/AutomatedTests.java;3;1;5;1;4;4;4;1;3;0;1;5066;8;8;1;0;0;1;5;5066;0;5993;5;3;
/org.eclipse.team.tests.core/src/org/eclipse/team/tests/core/TargetTestSetup.java;1;0;1;1;0;0;0;1;0;0;1;2495;0;0;1;0;0;1;1;2495;0;2495;1;1;
/org.eclipse.jdt.ui/core refactoring/org/eclipse/jdt/internal/corext/refactoring/nls/NLSHint.java;3;1;9;1;7;7;7;2;219;1;2;4930;611;611;1;0;0;2;9;4930;0;6340;9;3;
/org.eclipse.jdt.core.tests.compiler/src/org/eclipse/jdt/core/tests/compiler/regression/InternalScannerTest.java;3;0;3;1;0;0;0;3;2;1;3;1149;3;3;1;0;0;3;3;1149;0;3560;3;3;
/org.eclipse.search/new search/org/eclipse/search2/internal/ui/text/AnnotationManagers.java;2;1;2;1;2;2;2;0;2;0;0;6035;2;2;1;0;0;0;2;6035;0;6340;2;2;
/org.eclipse.update.core/src/org/eclipse/update/operations/IUpdateModelChangedListener.java;1;2;8;1;3;2;3;5;22;2;4;825;46;46;2;1;1;5;8;825;2;6336;6;1;
/org.eclipse.ui.workbench/Eclipse UI/org/eclipse/ui/contexts/IWorkbenchPageContextSupport.java;2;0;4;1;0;0;0;4;20;1;4;3066;34;34;1;0;0;4;4;3066;0;4144;4;2;
/org.eclipse.debug.ui/ui/org/eclipse/debug/internal/ui/actions/IRunToLineTarget.java;1;0;4;1;0;0;0;4;33;2;3;4425;49;49;2;1;0;4;4;4425;1;4496;3;1;
/org.eclipse.jdt.ui/ui/org/eclipse/jdt/internal/ui/javaeditor/BreakpointImageProvider.java;2;0;2;1;0;0;0;2;0;1;2;3217;0;0;1;0;0;2;2;3217;0;4850;2;2;
/org.eclipse.jface.text/src/org/eclipse/jface/text/source/AnnotationModel.java;3;1;21;2;2;2;2;19;169;2;17;1118;636;636;2;2;0;19;21;3217;2;5382;19;3;
/org.eclipse.update.ui.win32/src/org/eclipse/welcome/internal/WebBrowserEditorContributor.java;1;0;2;1;0;0;0;2;0;1;2;892;0;0;1;0;0;2;2;892;0;907;2;1;
/org.eclipse.pde.ui/src/org/eclipse/pde/internal/ui/editor/feature/FeatureInputContext.java;3;2;5;2;5;4;5;0;6;0;0;5431;17;17;2;0;1;0;5;5431;1;6336;4;3;
/org.eclipse.jdt.core.tests.model/workspace/Converter/src/javadoc/test105/TestB2.java;1;0;1;1;0;0;0;1;0;0;1;4390;0;0;1;0;0;1;1;4390;0;4390;1;1;
/org.eclipse.search/search/org/eclipse/search/internal/ui/CopyToClipboardAction.java;2;0;2;1;1;1;1;1;5;0;1;3475;7;7;1;0;0;1;2;3475;0;6340;2;2;
/org.eclipse.core.resources.win32/src/org/eclipse/core/internal/resources/refresh/win32/Win32RefreshProvider.java;1;0;2;1;1;1;1;1;5;0;1;3695;5;5;1;0;0;1;2;3695;0;5313;2;1;
/org.eclipse.team.ui/src/org/eclipse/team/ui/IConfigurationWizard.java;1;1;2;1;2;2;2;0;4;0;0;5661;6;6;1;0;0;0;2;5661;0;6337;2;1;
/org.eclipse.ui.tests/Eclipse UI Tests/org/eclipse/ui/tests/api/workbenchpart/OverriddenTitleView.java;1;0;1;1;1;1;1;0;0;0;0;6101;0;0;1;0;0;0;1;6101;0;6101;1;1;
/org.eclipse.core.expressions/src/org/eclipse/core/internal/expressions/PropertyTesterDescriptor.java;1;1;5;1;3;3;3;2;40;1;2;4108;58;58;1;0;0;2;5;4108;0;6340;5;1;
/org.eclipse.core.tests.runtime/src/org/eclipse/core/tests/internal/runtime/AuthorizationDatabaseTest.java;1;0;1;1;1;1;1;0;221;0;0;5149;221;221;1;0;0;0;1;5149;0;5149;1;1;
/org.eclipse.jdt.ui.tests.refactoring/resources/ExtractMethodWorkSpace/ExtractMethodTests/expression_out/A_test608.java;1;0;4;1;0;0;0;4;6;1;4;130;10;10;1;0;0;4;4;130;0;1474;4;1;
/org.eclipse.ui.tests/Eclipse UI Tests/org/eclipse/ui/tests/menus/ObjectContributionTest.java;2;1;2;1;2;2;2;0;2;0;0;5535;2;2;1;0;0;0;2;5535;0;5758;2;2;
/org.eclipse.core.resources/src/org/eclipse/core/resources/ISaveContext.java;1;0;3;1;1;1;1;2;282;1;2;44;322;322;1;0;0;2;3;44;0;5146;3;1;
/org.eclipse.jdt.core.tests.model/workspace/Converter/src/test0294/Test.java;1;0;1;1;0;0;0;1;0;0;1;3714;0;0;1;0;0;1;1;3714;0;3714;1;1;
/org.eclipse.swt/Eclipse SWT Mozilla/common/org/eclipse/swt/internal/mozilla/nsIWebBrowserChrome.java;1;0;2;1;0;0;0;2;12;1;2;1654;12;12;1;0;0;2;2;1654;0;2568;2;1;
/org.eclipse.ui.workbench/Eclipse UI/org/eclipse/ui/commands/ICommandManagerListener.java;3;1;9;1;2;2;2;7;20;2;6;1119;90;90;2;1;0;7;9;2562;1;6338;8;3;
/org.eclipse.update.core/src/org/eclipse/update/core/IFeatureFactory.java;2;1;3;1;2;2;2;1;6;0;1;890;15;15;1;0;0;1;3;890;0;6336;3;2;
/org.eclipse.update.core/src/org/eclipse/update/core/ISite.java;2;2;6;1;5;4;5;1;10;0;1;890;28;28;2;0;1;1;6;5663;1;6336;5;2;
/org.eclipse.ui.workbench/Eclipse UI/org/eclipse/ui/keys/AbstractKeyFormatter.java;2;0;3;1;0;0;0;3;45;1;3;3169;45;45;1;0;0;3;3;3169;0;3310;3;2;
/org.eclipse.ui.workbench/Eclipse UI/org/eclipse/ui/internal/Perspective.java;11;3;52;3;24;15;24;28;265;2;27;330;1348;1348;3;1;9;28;52;5532;10;6338;42;11;
/org.eclipse.ui.ide/src/org/eclipse/ui/views/markers/internal/ActionMarkerProperties.java;3;1;3;1;2;2;2;1;4;0;1;2208;6;6;1;0;0;1;3;2208;0;6338;3;3;
/org.eclipse.team.tests.cvs.core/src/org/eclipse/team/tests/ccvs/core/AllTeamAndCVSTests.java;1;0;1;1;0;0;0;1;0;0;1;2632;0;0;1;0;0;1;1;2632;0;2632;1;1;
/org.eclipse.ui.workbench/Eclipse UI/org/eclipse/ui/internal/roles/RoleDefinition.java;1;0;4;1;0;0;0;4;101;1;4;2444;121;121;1;0;0;4;4;2444;0;2864;4;1;
/org.eclipse.jdt.ui.tests/test plugin/org/eclipse/jdt/testplugin/JavaElementDecorator.java;1;0;1;1;1;1;1;0;2;0;0;6340;2;2;1;0;0;0;1;6340;0;6340;1;1;
/org.eclipse.pde.core/src/org/eclipse/pde/core/build/IBuildEntry.java;3;1;5;1;3;3;3;2;80;1;2;3986;108;108;1;0;0;2;5;3986;0;6336;5;3;
/org.eclipse.jdt.ui/ui/org/eclipse/jdt/internal/ui/actions/RemoveBlockCommentAction.java;2;0;5;1;1;1;1;4;167;1;4;1631;179;179;1;0;0;4;5;1631;0;6340;5;2;
/org.eclipse.swt.tests/JUnit Tests/org/eclipse/swt/tests/junit/Test_org_eclipse_swt_events_DisposeListener.java;1;0;1;1;0;0;0;1;16;0;1;2175;16;16;1;0;0;1;1;2175;0;2175;1;1;
/org.eclipse.search/new search/org/eclipse/search2/internal/ui/basic/views/NoSortAction.java;1;0;2;1;0;0;0;2;0;1;2;3474;0;0;1;0;0;2;2;3474;0;3711;2;1;
/org.eclipse.webdav/src/kernel/org/eclipse/webdav/internal/kernel/WebDAVPropertyNames.java;1;0;1;1;1;1;1;0;7;0;0;5151;7;7;1;0;0;0;1;5151;0;5151;1;1;
/org.eclipse.jdt.ui/ui refactoring/org/eclipse/jdt/internal/ui/refactoring/nls/search/NLSSearchResultLabelProvider2.java;1;0;2;1;1;1;1;1;1;0;1;4943;1;1;1;0;0;1;2;4943;0;5268;2;1;
/org.eclipse.ui.workbench/Eclipse UI/org/eclipse/ui/keys/CompactKeyFormatter.java;2;0;3;1;0;0;0;3;5;1;3;3221;5;5;1;0;0;3;3;3221;0;3310;3;2;
/org.eclipse.jdt.ui/ui/org/eclipse/jdt/ui/text/spelling/engine/ISpellDictionary.java;1;0;2;1;0;0;0;2;0;1;2;3829;0;0;1;0;0;2;2;3829;0;3930;2;1;
/org.eclipse.ant.ui/Ant Tools Support/org/eclipse/ant/ui/internal/views/elements/AntNode.java;1;0;2;1;0;0;0;2;0;1;2;250;0;0;1;0;0;2;2;250;0;1811;2;1;
/org.eclipse.jdt.ui/ui/org/eclipse/jdt/internal/ui/JavaHierarchyPerspectiveFactory.java;6;1;10;1;8;8;8;2;13;1;2;2218;47;47;1;0;0;2;10;2218;0;6340;10;6;
/org.eclipse.team.ui/src/org/eclipse/team/internal/ui/target/TargetSiteImportWizard.java;2;0;2;1;0;0;0;2;6;1;2;917;6;6;1;0;0;2;2;917;0;2495;2;2;
/org.eclipse.releng.basebuilder/plugins/org.eclipse.build.tools/src/org/eclipse/releng/FindMachineTask.java;1;0;2;1;0;0;0;2;10;0;1;3593;10;10;2;1;0;2;2;3593;1;3593;1;1;
/org.eclipse.jdt.ui.tests.refactoring/resources/ExtractMethodWorkSpace/ExtractMethodTests/duplicates_in/A_test951.java;1;0;3;1;0;0;0;3;0;1;3;1219;0;0;1;0;0;3;3;1219;0;1474;3;1;
/org.eclipse.jdt.core/formatter/org/eclipse/jdt/internal/formatter/Location.java;2;1;8;1;2;2;2;6;12;1;6;535;27;27;1;0;0;6;8;535;0;5871;8;2;
/org.eclipse.jdt.launching/launching/org/eclipse/jdt/internal/launching/VariableClasspathEntry.java;3;0;3;2;0;0;0;3;19;2;2;4972;22;22;2;1;0;3;3;4972;1;4983;2;3;
/org.eclipse.ant.ui/Ant Editor/org/eclipse/ant/ui/internal/editor/AntEditorCompletionProcessor.java;1;0;15;1;0;0;0;15;470;3;11;250;1164;1164;3;4;0;15;15;264;4;1811;11;1;
/org.eclipse.jdt.ui.tests.refactoring/resources/PushDown/test24/out/A.java;1;0;1;1;0;0;0;1;2;0;1;1312;2;2;1;0;0;1;1;1312;0;1312;1;1;
/org.eclipse.update.ui/src/org/eclipse/update/internal/ui/model/NamedModelObject.java;1;0;2;1;0;0;0;2;6;1;2;890;8;8;1;0;0;2;2;890;0;900;2;1;
/org.eclipse.debug.ui/ui/org/eclipse/debug/internal/ui/preferences/PreferencePageContainerDialog.java;2;2;3;2;3;2;3;0;23;0;0;5515;23;23;2;0;1;0;3;5515;1;5529;2;2;
/org.eclipse.ltk.core.refactoring/src/org/eclipse/ltk/core/refactoring/CompositeChange.java;1;2;17;1;13;11;13;4;72;1;4;4845;223;223;2;0;2;4;17;6338;2;6352;15;1;
/org.eclipse.ui.views/src/org/eclipse/ui/views/bookmarkexplorer/BookmarkAction.java;1;0;1;1;0;0;0;1;0;0;1;2738;0;0;1;0;0;1;1;2738;0;2738;1;1;
/org.eclipse.jdt.ui/core extension/org/eclipse/jdt/internal/corext/dom/NodeInfoStore.java;2;0;10;1;1;1;1;9;280;1;9;3593;506;506;1;0;0;9;10;3593;0;5406;10;2;
/org.eclipse.jdt.debug/jdi/org/eclipse/jdi/internal/TypeComponentImpl.java;2;0;2;1;1;1;1;1;12;0;1;4267;16;16;1;0;0;1;2;4267;0;6336;2;2;
/org.eclipse.ui.workbench/Eclipse UI/org/eclipse/ui/internal/EditorAreaDropAdapter.java;2;0;3;1;0;0;0;3;7;1;3;52;9;9;1;0;0;3;3;52;0;2737;3;2;
/org.eclipse.ui.examples.rcp.browser/src/org/eclipse/ui/examples/rcp/browser/BrowserAdvisor.java;1;1;7;1;2;2;2;5;106;2;4;3532;161;161;2;1;0;5;7;4637;1;6341;6;1;
/org.eclipse.pde/src/org/eclipse/pde/internal/builders/UpdateSiteBuilder.java;2;1;4;1;2;2;2;2;34;1;2;2906;79;79;1;0;0;2;4;2906;0;6336;4;2;
/org.eclipse.core.tests.resources/src/org/eclipse/core/tests/internal/resources/WaterNature.java;1;0;1;1;1;1;1;0;16;0;0;5147;16;16;1;0;0;0;1;5147;0;5147;1;1;
/org.eclipse.jdt.ui.tests.refactoring/resources/RenameNonPrivateField/test3/out/A.java;1;0;1;1;0;0;0;1;10;0;1;4560;10;10;1;0;0;1;1;4560;0;4560;1;1;
/org.eclipse.jdt.core.tests.model/workspace/Converter/src/javadoc/testBug51226/X1.java;1;0;1;1;0;0;0;1;0;0;1;3899;0;0;1;0;0;1;1;3899;0;3899;1;1;
/org.eclipse.core.tests.runtime/src/org/eclipse/core/tests/internal/plugins/PluginResolveTest_16.java;1;0;1;1;0;0;0;1;0;0;1;3014;0;0;1;0;0;1;1;3014;0;3014;1;1;
/org.eclipse.jface.text/src/org/eclipse/jface/text/templates/persistence/TemplateStore.java;2;1;10;1;3;3;3;7;180;3;5;4627;456;456;3;2;0;7;10;4627;2;6353;8;2;
/org.eclipse.pde.ui/src/org/eclipse/pde/internal/ui/wizards/feature/FeatureCustomHandlerPage.java;3;1;6;1;4;4;4;2;264;1;2;3840;347;347;1;0;0;2;6;3840;0;6108;6;3;
/org.eclipse.core.filebuffers/src/org/eclipse/core/internal/filebuffers/IDocumentProvider2.java;1;0;2;1;0;0;0;2;0;1;2;1522;0;0;1;0;0;2;2;1522;0;1574;2;1;
/org.eclipse.team.core/src/org/eclipse/team/internal/core/subscribers/caches/SynchronizationCacheRefreshOperation.java;1;0;1;1;0;0;0;1;0;0;1;3966;0;0;1;0;0;1;1;3966;0;3966;1;1;
/org.eclipse.pde.ui/src_Forms/org/eclipse/pde/internal/ui/neweditor/plugin/TextAttributeRow.java;1;0;2;1;0;0;0;2;0;1;2;3834;0;0;1;0;0;2;2;3834;0;4354;2;1;
/org.eclipse.update.ui/src/org/eclipse/update/internal/ui/wizards/UIProblemHandler.java;2;0;3;1;0;0;0;3;6;1;3;825;9;9;1;0;0;3;3;825;0;900;3;2;
/org.eclipse.jdt.core.tests.model/workspace/Converter/test0012/Test.java;1;0;1;1;0;0;0;1;0;0;1;3714;0;0;1;0;0;1;1;3714;0;3714;1;1;
/org.eclipse.ui.ide/src/org/eclipse/ui/views/markers/internal/SelectionProviderAdapter.java;1;0;1;1;0;0;0;1;0;0;1;3214;0;0;1;0;0;1;1;3214;0;3214;1;1;
/org.eclipse.update.ui/src/org/eclipse/update/internal/ui/forms/DetailsForm.java;2;0;2;2;0;0;0;2;4;0;1;749;4;4;2;1;0;2;2;749;1;749;1;2;
/org.eclipse.jface.text.tests/src/org/eclipse/jface/text/tests/TestTextEvent.java;1;0;2;1;1;1;1;1;2;0;1;5082;2;2;1;0;0;1;2;5082;0;6340;2;1;
/org.eclipse.jdt.core.tests.model/workspace/Converter/test0307/Test.java;1;0;1;1;0;0;0;1;0;0;1;3714;0;0;1;0;0;1;1;3714;0;3714;1;1;
/org.eclipse.team.ui/src/org/eclipse/team/internal/ui/sync/sets/SyncSetInput.java;1;0;3;1;0;0;0;3;89;1;3;1289;89;89;1;0;0;3;3;1289;0;2632;3;1;
/org.eclipse.jdt.ui.tests.refactoring/test cases/org/eclipse/jdt/ui/tests/refactoring/TestDeleteParticipantSingle.java;2;0;2;1;1;1;1;1;8;0;1;4913;8;8;1;0;0;1;2;4913;0;6340;2;2;
/org.eclipse.jdt.core/dom/org/eclipse/jdt/core/dom/rewrite/ListRewriter.java;2;0;4;2;0;0;0;4;262;2;3;4711;267;267;2;1;0;4;4;4711;1;4802;3;2;
/org.eclipse.jdt.ui.tests.refactoring/resources/PasteSourceReference/test1/in/A.java;1;0;1;1;0;0;0;1;0;0;1;1311;0;0;1;0;0;1;1;1311;0;1311;1;1;
/org.eclipse.jdt.ui.tests.refactoring/resources/IntroduceParameter/simple/out/Javadoc2.java;1;0;1;1;1;1;1;0;2;0;0;5851;2;2;1;0;0;0;1;5851;0;5851;1;1;
/org.eclipse.jdt.core.tests.model/workspace/Converter/src/test0060/Test.java;1;0;1;1;0;0;0;1;0;0;1;3714;0;0;1;0;0;1;1;3714;0;3714;1;1;
/org.eclipse.osgi/defaultAdaptor/src/org/eclipse/osgi/framework/internal/defaultadaptor/BundleURLConnection.java;1;0;3;1;0;0;0;3;4;1;3;3620;4;4;1;0;0;3;3;3620;0;4336;3;1;
/org.eclipse.jdt.ui.tests.refactoring/resources/IntroduceFactory/positive/SelectConstructor.java;1;0;2;1;1;1;1;1;2;0;1;2862;2;2;1;0;0;1;2;2862;0;5659;2;1;
/org.eclipse.jdt.debug.tests/tests/org/eclipse/jdt/debug/tests/core/SourceContainerTests.java;1;0;2;1;0;0;0;2;0;0;1;3678;0;0;2;1;0;2;2;3678;1;3678;1;1;
/org.eclipse.ant.ui/Ant Editor/org/eclipse/ant/ui/internal/editor/outline/IProblem.java;1;0;2;1;0;0;0;2;0;1;2;250;0;0;1;0;0;2;2;250;0;1811;2;1;
/org.eclipse.ui.examples.javaeditor/Template Editor Example/org/eclipse/ui/examples/templateeditor/template/AntVariableResolver.java;2;0;3;1;1;1;1;2;10;1;2;4644;12;12;1;0;0;2;3;4644;0;6340;3;2;
/org.eclipse.jdt.core/model/org/eclipse/jdt/internal/core/RenameElementsOperation.java;1;0;4;1;0;0;0;4;6;1;4;134;11;11;1;0;0;4;4;134;0;3560;4;1;
/org.eclipse.jdt.ui.tests.refactoring/resources/ExtractMethodWorkSpace/ExtractMethodTests/expression_in/A_test619.java;1;0;1;1;0;0;0;1;2;0;1;844;2;2;1;0;0;1;1;844;0;844;1;1;
/org.eclipse.jdt.junit/src/org/eclipse/jdt/internal/junit/ui/TestRunTab.java;2;1;2;1;2;2;2;0;2;0;0;5633;2;2;1;0;0;0;2;5633;0;6340;2;2;
/org.eclipse.pde.core/src/org/eclipse/pde/internal/core/site/SiteBuildObject.java;3;1;4;1;2;2;2;2;16;1;2;4203;27;27;1;0;0;2;4;4203;0;6336;4;3;
/org.eclipse.jdt.ui/ui/org/eclipse/jdt/internal/ui/viewsupport/ProblemMarkerManager.java;2;0;3;1;1;1;1;2;13;1;2;1127;17;17;1;0;0;2;3;1127;0;6340;3;2;
/org.eclipse.jdt.core/search/org/eclipse/jdt/internal/core/search/matching/MatchSet.java;1;0;1;1;0;0;0;1;0;0;1;77;0;0;1;0;0;1;1;77;0;77;1;1;
/org.eclipse.jdt.ui/core refactoring/org/eclipse/jdt/internal/corext/refactoring/nls/NLSElement.java;2;1;3;1;2;2;2;1;65;0;1;1464;79;79;1;0;0;1;3;1464;0;5375;3;2;
/org.eclipse.update.ui.forms/src/org/eclipse/ui/forms/parts/SectionChangeManager.java;1;0;2;1;0;0;0;2;0;1;2;3071;0;0;1;0;0;2;2;3071;0;3096;2;1;
/org.eclipse.jface/src/org/eclipse/jface/action/Action.java;5;1;6;1;3;3;3;3;39;1;3;1;80;80;1;0;0;3;6;1;0;6338;6;5;
/org.eclipse.core.variables/src/org/eclipse/core/internal/variables/VariablesMessages.java;2;0;2;1;0;0;0;2;16;1;2;2514;16;16;1;0;0;2;2;2514;0;2572;2;2;
/org.eclipse.osgi.tests/src/org/eclipse/osgi/tests/services/resolver/AbstractStateTest.java;1;0;1;1;1;1;1;0;0;0;0;5993;0;0;1;0;0;0;1;5993;0;5993;1;1;
/org.eclipse.jdt.ui.tests.refactoring/resources/MoveMembers/testFail20/in/A.java;1;0;1;1;0;0;0;1;0;0;1;1856;0;0;1;0;0;1;1;1856;0;1856;1;1;
/org.eclipse.core.variables/src/org/eclipse/core/variables/IStringVariable.java;1;0;1;1;0;0;0;1;0;0;1;2514;0;0;1;0;0;1;1;2514;0;2514;1;1;
/org.eclipse.jdt.junit/src/org/eclipse/jdt/internal/junit/util/ExceptionHandler.java;1;0;1;1;1;1;1;0;2;0;0;6340;2;2;1;0;0;0;1;6340;0;6340;1;1;
/org.eclipse.jface.text/src/org/eclipse/jface/text/reconciler/IReconcilingStrategyExtension.java;1;2;3;1;3;2;3;0;14;0;0;6340;16;16;2;0;1;0;3;6353;1;6353;2;1;
/org.eclipse.ui.views/src/org/eclipse/ui/internal/views/ViewsPlugin.java;4;1;4;1;2;2;2;2;50;1;2;2208;59;59;1;0;0;2;4;2208;0;6338;4;4;
/org.eclipse.team.ui/src/org/eclipse/team/internal/ui/synchronize/SynchronizeModelManager.java;2;1;5;1;4;4;4;1;242;0;1;5065;282;282;1;0;0;1;5;5065;0;5732;5;2;
/org.eclipse.swt/Eclipse SWT PI/win32/org/eclipse/swt/internal/win32/OS.java;7;2;75;2;18;15;18;57;107;2;49;13;530;530;2;8;3;57;75;33;11;6352;64;7;
/org.eclipse.core.runtime/src/org/eclipse/core/internal/plugins/ConfigurationElementWrapper.java;2;0;3;1;0;0;0;3;3;1;3;2105;3;3;1;0;0;3;3;2105;0;3013;3;2;
/org.eclipse.osgi/supplement/src/org/eclipse/osgi/framework/debug/Debug.java;4;1;8;1;4;4;4;4;248;1;4;3013;390;390;1;0;0;4;8;3013;0;6337;8;4;
/org.eclipse.jdt.ui/core extension/org/eclipse/jdt/internal/corext/textmanipulation/TextEdit.java;1;0;11;1;0;0;0;11;701;3;8;949;1450;1450;3;3;0;11;11;1946;3;1946;8;1;
/org.eclipse.jdt.core.tests.model/src/org/eclipse/jdt/core/tests/model/TypeHierarchyTests2.java;2;0;2;1;0;0;0;2;0;1;2;4493;0;0;1;0;0;2;2;4493;0;4606;2;2;
/org.eclipse.jdt.core/model/org/eclipse/jdt/internal/core/SortElementsOperation.java;4;0;10;1;0;0;0;10;30;1;10;130;62;62;1;0;0;10;10;130;0;4731;10;4;
/org.eclipse.ui.workbench/Eclipse UI/org/eclipse/ui/internal/EarlyStartupRunnable.java;2;0;3;1;1;1;1;2;5;1;2;4937;9;9;1;0;0;2;3;4937;0;5127;3;2;
/org.eclipse.jdt.core/model/org/eclipse/jdt/core/jdom/IDOMField.java;2;0;3;1;1;1;1;2;3;1;2;3560;8;8;1;0;0;2;3;3560;0;5584;3;2;
/org.eclipse.jdt.ui.tests.refactoring/resources/Paste/test3/out/A.java;1;0;1;1;0;0;0;1;0;0;1;1311;0;0;1;0;0;1;1;1311;0;1311;1;1;
/org.eclipse.jdt.ui/ui/org/eclipse/jdt/ui/text/spelling/HtmlTagDictionary.java;1;0;2;1;0;0;0;2;0;1;2;3829;0;0;1;0;0;2;2;3829;0;3930;2;1;
/org.eclipse.ui.views/src/org/eclipse/ui/views/internal/table/TableSorter.java;1;0;2;1;0;0;0;2;0;0;1;749;0;0;2;1;0;2;2;749;1;749;1;1;
/org.eclipse.ui.workbench/Eclipse UI/org/eclipse/ui/internal/PopupMenuExtender.java;3;0;3;1;1;1;1;2;34;1;2;1154;44;44;1;0;0;2;3;1154;0;6338;3;3;
/org.eclipse.jdt.ui.tests.refactoring/resources/ExtractMethodWorkSpace/ExtractMethodTests/locals_in/A_test535.java;1;0;1;1;0;0;0;1;4;0;1;844;4;4;1;0;0;1;1;844;0;844;1;1;
/org.eclipse.team.cvs.ui/src/org/eclipse/team/internal/ccvs/ui/subscriber/CVSSubscriberAction.java;2;0;19;1;0;0;0;19;186;2;18;595;659;659;2;1;0;19;19;1132;1;4450;18;2;
/org.eclipse.jdt.core.tests.model/workspace/Formatter/test044/A_out.java;1;0;1;1;0;0;0;1;0;0;1;2425;0;0;1;0;0;1;1;2425;0;2425;1;1;
/org.eclipse.swt.graphics.text/org.eclipse.swt/Eclipse SWT Custom Widgets/common/org/eclipse/swt/custom/StyledTextRenderer.java;1;0;1;1;0;0;0;1;0;0;1;2267;0;0;1;0;0;1;1;2267;0;2267;1;1;
/org.eclipse.ui.views/src/org/eclipse/ui/views/markers/internal/FieldMessage.java;2;0;2;1;0;0;0;2;0;1;2;755;0;0;1;0;0;2;2;755;0;2738;2;2;
/org.eclipse.team.core/src/org/eclipse/team/internal/core/ResourceVariantCache.java;2;1;5;1;2;2;2;3;250;1;3;4088;285;285;1;0;0;3;5;4088;0;6336;5;2;
/org.eclipse.ui.intro/src/org/eclipse/ui/intro/internal/html/IntroHTMLGenerator.java;2;0;10;2;1;1;1;9;3868;1;9;4429;4242;4242;1;0;0;9;10;4429;0;5115;10;2;
/org.eclipse.jdt.core/compiler/org/eclipse/jdt/internal/compiler/ast/ThisReference.java;2;0;4;1;0;0;0;4;12;1;4;991;21;21;1;0;0;4;4;991;0;3560;4;2;
/org.eclipse.jdt.ui/ui/org/eclipse/jdt/internal/ui/preferences/CodeFormatterConfigurationBlock.java;4;0;13;2;0;0;0;13;241;2;12;1134;455;455;2;1;0;13;13;2396;1;3827;12;4;
/org.eclipse.ui.workbench/Eclipse UI/org/eclipse/ui/application/IWorkbenchPreferences.java;4;1;10;1;2;2;2;8;103;1;8;1259;258;258;1;0;0;8;10;1259;0;5449;10;4;
/org.eclipse.jdt.ui.tests.refactoring/resources/ExtractConstant/canExtract/A_testZeroLengthSelection0_in.java;1;0;1;1;0;0;0;1;0;0;1;1687;0;0;1;0;0;1;1;1687;0;1687;1;1;
/org.eclipse.ant.ui/Ant Editor/org/eclipse/ant/internal/ui/dtd/schema/Dfm.java;1;0;2;1;0;0;0;2;29;1;2;1811;29;29;1;0;0;2;2;1811;0;3533;2;1;
/org.eclipse.ui.workbench/Eclipse UI/org/eclipse/ui/internal/activities/ui/ActivityContentProvider.java;1;0;4;1;0;0;0;4;69;1;4;2444;70;70;1;0;0;4;4;2444;0;3066;4;1;
/org.eclipse.jdt.junit/src/org/eclipse/jdt/internal/junit/wizards/IAboutToRunOperation.java;2;1;2;1;2;2;2;0;2;0;0;5676;2;2;1;0;0;0;2;5676;0;6340;2;2;
/org.eclipse.team.webdav/src/org/eclipse/team/internal/ui/target/TargetProjectAction.java;2;0;2;1;0;0;0;2;0;1;2;2495;0;0;1;0;0;2;2;2495;0;4216;2;2;
/org.eclipse.jdt.ui/core refactoring/org/eclipse/jdt/internal/corext/refactoring/sef/EncapsulateReadAccess.java;1;0;1;1;0;0;0;1;0;0;1;1492;0;0;1;0;0;1;1;1492;0;1492;1;1;
/org.eclipse.jdt.debug.ui/ui/org/eclipse/jdt/internal/debug/ui/launcher/SourceLookupBlock.java;3;1;7;1;3;3;3;4;56;1;4;124;113;113;1;0;0;4;7;124;0;6336;7;3;
/org.eclipse.jdt.ui/ui/org/eclipse/jdt/internal/ui/callhierarchy/CallSearchResultCollector.java;1;0;2;1;0;0;0;2;0;1;2;155;0;0;1;0;0;2;2;155;0;169;2;1;
/org.eclipse.ui.console/src/org/eclipse/ui/internal/console/ShowConsoleAction.java;3;1;4;1;2;2;2;2;9;1;2;1988;23;23;1;0;0;2;4;1988;0;6336;4;3;
/org.eclipse.ui.examples.job/src/org/eclipse/ui/examples/jobs/views/SlowElement.java;2;1;2;1;2;2;2;0;4;0;0;5126;4;4;1;0;0;0;2;5126;0;5800;2;2;
/org.eclipse.jdt.core/model/org/eclipse/jdt/core/ISourceManipulation.java;1;0;1;1;0;0;0;1;2;0;1;3560;2;2;1;0;0;1;1;3560;0;3560;1;1;
/org.eclipse.team.ui/src/org/eclipse/team/ui/synchronize/ISynchronizeParticipantListener.java;1;1;4;1;2;2;2;2;38;1;2;2535;42;42;1;0;0;2;4;2535;0;6337;4;1;
/org.eclipse.core.runtime/src/org/eclipse/core/internal/jobs/Deadlock.java;2;0;2;1;1;1;1;1;7;0;1;3135;7;7;1;0;0;1;2;3135;0;5150;2;2;
/org.eclipse.ui.workbench/Eclipse UI/org/eclipse/ui/internal/progress/ProgressTreeViewer.java;2;0;11;1;1;1;1;10;61;2;9;1115;287;287;2;1;0;10;11;1115;1;5916;10;2;
/org.eclipse.jdt.ui.tests.refactoring/resources/ExtractMethodWorkSpace/ExtractMethodTests/return_in/A_test704.java;1;0;1;1;0;0;0;1;4;0;1;844;4;4;1;0;0;1;1;844;0;844;1;1;
/org.eclipse.jdt.ui/ui/org/eclipse/jdt/internal/ui/packageview/ToggleLinkingAction.java;1;0;2;1;1;1;1;1;13;0;1;1285;15;15;1;0;0;1;2;1285;0;6340;2;1;
/org.eclipse.update.core/src/org/eclipse/update/core/model/FeatureReference.java;1;0;1;1;0;0;0;1;0;0;1;2634;0;0;1;0;0;1;1;2634;0;2634;1;1;
/org.eclipse.ui.ide/src/org/eclipse/ui/internal/registry/MarkerQuery.java;2;0;3;1;0;0;0;3;11;1;3;1526;11;11;1;0;0;3;3;1526;0;2263;3;2;
/org.eclipse.jdt.core.tests.model/workspace/Converter/src/javadoc/test019/TestD1.java;1;0;2;1;0;0;0;2;0;1;2;4311;0;0;1;0;0;2;2;4311;0;4390;2;1;
/org.eclipse.jdt.debug/eval/org/eclipse/jdt/internal/debug/eval/ast/engine/ASTEvaluationEngine.java;3;1;7;1;2;2;2;5;16;1;5;1276;43;43;1;0;0;5;7;1276;0;5664;7;3;
/org.eclipse.ui.workbench/Eclipse UI/org/eclipse/ui/internal/csm/commands/Command.java;1;0;6;1;0;0;0;6;193;3;3;2515;304;304;3;3;0;6;6;2549;3;2549;3;1;
/org.eclipse.jdt.ui.tests/ui/org/eclipse/jdt/ui/tests/core/CodeCompletionTest.java;3;1;10;1;5;5;5;5;286;2;4;1570;318;318;2;1;0;5;10;1570;1;6340;9;3;
/org.eclipse.core.runtime/src/org/eclipse/core/internal/dependencies/IMatchRule.java;2;0;2;1;0;0;0;2;0;1;2;2105;0;0;1;0;0;2;2;2105;0;3013;2;2;
/org.eclipse.jdt.core.tests.model/workspace/Formatter/test264/A_in.java;1;0;1;1;0;0;0;1;0;0;1;2442;0;0;1;0;0;1;1;2442;0;2442;1;1;
/org.eclipse.jdt.core.tests.compiler/src/org/eclipse/jdt/core/tests/compiler/regression/GenericTypeSignatureTest.java;1;0;1;1;0;0;0;1;0;0;1;4558;0;0;1;0;0;1;1;4558;0;4558;1;1;
/org.eclipse.jdt.core/search/org/eclipse/jdt/internal/core/index/impl/BlocksIndexOutput.java;1;0;2;1;0;0;0;2;2;1;2;3560;2;2;1;0;0;2;2;3560;0;4060;2;1;
/org.eclipse.ant.ui/Ant Tools Support/org/eclipse/ant/ui/internal/views/actions/SearchForBuildFilesDialog.java;1;0;4;1;0;0;0;4;4;2;3;263;8;8;2;1;0;4;4;263;1;1811;3;1;
/org.eclipse.jdt.ui/ui/org/eclipse/jdt/internal/ui/javaeditor/BasicEditorActionContributor.java;2;0;5;1;1;1;1;4;7;1;4;2980;23;23;1;0;0;4;5;2980;0;6340;5;2;
/org.eclipse.jdt.ui/core refactoring/org/eclipse/jdt/internal/corext/refactoring/code/flow/FlowAnalyzer.java;2;0;5;1;1;1;1;4;24;2;3;189;55;55;2;1;0;4;5;1952;1;6340;4;2;
/org.eclipse.update.core/src/org/eclipse/update/internal/core/Assert.java;1;1;2;1;2;2;2;0;10;0;0;5406;14;14;1;0;0;0;2;5406;0;6336;2;1;
/org.eclipse.team.cvs.core/src/org/eclipse/team/internal/ccvs/core/syncinfo/CVSSynchronizationCache.java;2;0;4;1;0;0;0;4;52;2;3;3440;58;58;2;1;0;4;4;4233;1;4233;3;2;
/org.eclipse.jdt.core.tests.model/workspace/Converter/test0045/Test.java;1;0;1;1;0;0;0;1;0;0;1;3714;0;0;1;0;0;1;1;3714;0;3714;1;1;
/org.eclipse.ui.workbench/Eclipse UI/org/eclipse/ui/branding/IProductConstants.java;3;1;5;1;4;4;4;1;26;0;1;4428;63;63;1;0;0;1;5;4428;0;6321;5;3;
/org.eclipse.sdk.tests-feature/plugins/org.eclipse.perfmsr.ui.client/src/org/eclipse/perfmsr/ui/client/Run.java;1;1;4;1;4;4;4;0;11;0;0;5443;23;23;1;0;0;0;4;5443;0;6339;4;1;
/org.eclipse.swt/Eclipse SWT Mozilla/common/org/eclipse/swt/internal/mozilla/nsIWebProgressListener.java;1;0;1;1;0;0;0;1;0;0;1;1654;0;0;1;0;0;1;1;1654;0;1654;1;1;
/org.eclipse.jdt.ui/ui/org/eclipse/jdt/internal/ui/packageview/PackagesMessages.java;1;0;1;1;1;1;1;0;2;0;0;6340;2;2;1;0;0;0;1;6340;0;6340;1;1;
/org.eclipse.core.tools/src/org/eclipse/core/tools/runtime/LoadedClassesView.java;1;0;1;1;1;1;1;0;0;0;0;6302;0;0;1;0;0;0;1;6302;0;6302;1;1;
/org.eclipse.jdt.core/search/org/eclipse/jdt/internal/core/index/IEntryResult.java;1;0;1;1;0;0;0;1;0;0;1;3218;0;0;1;0;0;1;1;3218;0;3218;1;1;
/org.eclipse.text.tests/projection/org/eclipse/text/tests/ProjectionTestSuite.java;1;1;2;1;2;2;2;0;2;0;0;5129;2;2;1;0;0;0;2;5129;0;6340;2;1;
/org.eclipse.jdt.ui/core extension/org/eclipse/jdt/internal/corext/template/java/TemplateSet.java;3;1;4;1;4;4;4;0;9;0;0;5110;15;15;1;0;0;0;4;5110;0;6340;4;3;
/org.eclipse.jdt.ui/ui refactoring/org/eclipse/jdt/internal/ui/refactoring/ChangeElementTreeViewer.java;2;0;2;1;0;0;0;2;4;1;2;456;4;4;1;0;0;2;2;456;0;4965;2;2;
/org.eclipse.core.tests.runtime/src/org/eclipse/core/tests/runtime/jobs/RuleSetB.java;2;0;2;1;0;0;0;2;0;1;2;2160;0;0;1;0;0;2;2;2160;0;3408;2;2;
/org.eclipse.core.resources/src/org/eclipse/core/internal/resources/SyncInfoSnapReader.java;1;0;1;1;1;1;1;0;86;0;0;5146;86;86;1;0;0;0;1;5146;0;5146;1;1;
/org.eclipse.pde.core/src/org/eclipse/pde/internal/core/feature/FeatureChild.java;3;1;4;1;2;2;2;2;48;1;2;2229;66;66;1;0;0;2;4;2229;0;6336;4;3;
/org.eclipse.jdt.core.tests.model/workspace/Converter/src/test0110/Test.java;1;0;1;1;0;0;0;1;0;0;1;3714;0;0;1;0;0;1;1;3714;0;3714;1;1;
/org.eclipse.jdt.ui.tests.refactoring/resources/IntroduceFactory/positive/staticContext_in.java;1;0;2;1;0;0;0;2;0;1;2;2846;0;0;1;0;0;2;2;2846;0;2862;2;1;
/org.eclipse.jdt.ui.tests.refactoring/test cases/org/eclipse/jdt/ui/tests/refactoring/TestRenameParticipantShared.java;1;0;1;1;0;0;0;1;0;0;1;4913;0;0;1;0;0;1;1;4913;0;4913;1;1;
/org.eclipse.ui.workbench/Eclipse UI/org/eclipse/ui/internal/dialogs/WelcomeParser.java;2;0;2;1;0;0;0;2;70;1;2;2608;70;70;1;0;0;2;2;2608;0;2737;2;2;
/org.eclipse.jdt.core/dom/org/eclipse/jdt/core/dom/InfixExpression.java;3;1;8;1;2;2;2;6;174;1;6;3560;222;222;1;0;0;6;8;3560;0;5272;8;3;
/org.eclipse.ui.workbench.texteditor/src/org/eclipse/ui/texteditor/ITextEditorActionDefinitionIds.java;3;0;7;2;2;1;2;5;42;1;5;436;96;96;2;0;1;5;7;6334;1;6334;6;3;
/org.eclipse.ant.ui/Ant Editor/org/eclipse/ant/internal/ui/editor/outline/AntModelProject.java;1;2;5;1;3;2;3;2;48;1;2;4572;82;82;2;0;1;2;5;5513;1;5513;4;1;
/org.eclipse.ant.ui/Ant Editor/org/eclipse/ant/internal/ui/editor/text/AnnotationAccess.java;1;0;2;1;0;0;0;2;21;1;2;1811;21;21;1;0;0;2;2;1811;0;3584;2;1;
/org.eclipse.jdt.ui.tests.refactoring/resources/DeleteSourceReferenceEdit/A_test5_out.java;1;0;1;1;0;0;0;1;0;0;1;1652;0;0;1;0;0;1;1;1652;0;1652;1;1;
/org.eclipse.jdt.junit/src/org/eclipse/jdt/internal/junit/wizards/NewTestCaseCreationWizard.java;3;0;3;1;1;1;1;2;2;1;2;190;6;6;1;0;0;2;3;190;0;6340;3;3;
/org.eclipse.team.ui/org.eclipse.jdt.ui.team/src/org/eclipse/jdt/ui/team/TeamPlugin.java;1;0;1;1;0;0;0;1;0;0;1;3734;0;0;1;0;0;1;1;3734;0;3734;1;1;
/org.eclipse.jdt.ui/core refactoring/org/eclipse/jdt/internal/corext/refactoring/participants/xml/InstanceofExpression.java;1;0;4;1;0;0;0;4;8;1;4;3480;11;11;1;0;0;4;4;3480;0;4108;4;1;
/org.eclipse.debug.ui/ui/org/eclipse/debug/internal/ui/launchConfigurations/LaunchConfigurationTabGroupViewer.java;4;1;14;1;2;2;2;12;247;2;11;473;579;579;2;1;0;12;14;2821;1;6336;13;4;
/org.eclipse.jdt.core.tests.model/workspace/Converter/src/test0014/Test.java;1;0;1;1;0;0;0;1;0;0;1;3714;0;0;1;0;0;1;1;3714;0;3714;1;1;
/org.eclipse.update.ui/srcnew/org/eclipse/update/internal/ui/wizards/ISearchProvider2.java;2;0;5;1;0;0;0;5;7;2;4;367;9;9;2;1;0;5;5;572;1;825;4;2;
/org.eclipse.ui.tests/Eclipse UI Tests/org/eclipse/ui/tests/dialogs/UIWorkingSetWizardsAuto.java;4;0;6;2;0;0;0;6;69;2;5;374;105;105;2;1;0;6;6;374;1;3091;5;4;
/org.eclipse.ui.views/src/org/eclipse/ui/views/properties/ComboBoxPropertyDescriptor.java;1;0;1;1;0;0;0;1;77;0;1;3013;77;77;1;0;0;1;1;3013;0;3013;1;1;
/org.eclipse.jdt.core.tests.model/workspace/JavaSearch/src/j4/CM47209.java;1;0;1;1;0;0;0;1;0;0;1;3330;0;0;1;0;0;1;1;3330;0;3330;1;1;
/org.eclipse.jdt.ui/ui refactoring/org/eclipse/jdt/internal/ui/refactoring/changes/AbortChangeExceptionHandler.java;1;0;2;1;0;0;0;2;4;1;2;3930;4;4;1;0;0;2;2;3930;0;4575;2;1;
/org.eclipse.jdt.core.tests.compiler/src/org/eclipse/jdt/core/tests/eval/JDIStackFrame.java;3;0;4;1;1;1;1;3;6;1;3;1059;13;13;1;0;0;3;4;1059;0;5853;4;3;
/org.eclipse.webdav/src/client/org/eclipse/webdav/http/client/Request.java;1;0;2;1;2;1;2;0;280;0;0;5151;280;280;2;0;1;0;2;5151;1;5151;1;1;
/org.eclipse.osgi/osgi/src/org/osgi/framework/ServiceListener.java;2;0;2;1;1;1;1;1;3;0;1;3013;3;3;1;0;0;1;2;3013;0;5536;2;2;
/org.eclipse.ltk.ui.refactoring/src/org/eclipse/ltk/internal/ui/refactoring/DefaultChangeElement.java;1;1;5;1;2;2;2;3;6;1;3;4965;15;15;1;0;0;3;5;4965;0;6340;5;1;
/org.eclipse.ant.ui/Ant Tools Support/org/eclipse/ant/internal/ui/views/elements/ProjectNode.java;1;0;3;1;1;1;1;2;4;1;2;1811;6;6;1;0;0;2;3;1811;0;6336;3;1;
/org.eclipse.jdt.core/compiler/org/eclipse/jdt/internal/compiler/util/HashtableOfType.java;2;0;3;1;0;0;0;3;6;1;3;3560;10;10;1;0;0;3;3;3560;0;4469;3;2;
/org.eclipse.swt/Eclipse SWT Mozilla/common/org/eclipse/swt/internal/mozilla/nsIDirectoryService.java;1;0;1;1;0;0;0;1;0;0;1;1654;0;0;1;0;0;1;1;1654;0;1654;1;1;
/org.eclipse.ui.externaltools/Ant Tools Support/org/eclipse/ui/externaltools/internal/ant/view/actions/RefreshBuildFilesAction.java;2;0;3;2;0;0;0;3;7;2;2;223;7;7;2;1;0;3;3;223;1;282;2;2;
/org.eclipse.jdt.core.tests.model/workspace/Formatter/test497/A_out.java;1;0;1;1;1;1;1;0;0;0;0;5623;0;0;1;0;0;0;1;5623;0;5623;1;1;
/org.eclipse.pde.ui/src/org/eclipse/pde/internal/ui/editor/site/SiteEditorContributor.java;1;1;4;1;2;2;2;2;27;1;2;2311;42;42;1;0;0;2;4;2311;0;6336;4;1;
/org.eclipse.jdt.ui.tests.refactoring/resources/ExtractMethodWorkSpace/ExtractMethodTests/duplicates_out/A_test958.java;1;1;2;1;2;2;2;0;2;0;0;5650;2;2;1;0;0;0;2;5650;0;5681;2;1;
/org.eclipse.ui.examples.javaeditor/Eclipse Java Editor Example/org/eclipse/ui/examples/javaeditor/spelling/ISpellCheckIterator.java;1;0;1;1;0;0;0;1;0;0;1;2565;0;0;1;0;0;1;1;2565;0;2565;1;1;
/org.eclipse.jdt.ui/core extension/org/eclipse/jdt/internal/corext/javadoc/JavaDocVMInstallListener.java;1;0;1;1;1;1;1;0;2;0;0;6340;2;2;1;0;0;0;1;6340;0;6340;1;1;
/org.eclipse.jdt.core.tests.model/workspace/Formatter/test054/A_out.java;1;0;1;1;0;0;0;1;0;0;1;2425;0;0;1;0;0;1;1;2425;0;2425;1;1;
/org.eclipse.jdt.core.tests.model/workspace/Converter/src/javadoc/testBug51226/X5.java;1;0;1;1;0;0;0;1;0;0;1;3899;0;0;1;0;0;1;1;3899;0;3899;1;1;
/org.eclipse.jface/src/org/eclipse/jface/action/SubContributionItem.java;1;0;1;1;0;0;0;1;13;0;1;3220;13;13;1;0;0;1;1;3220;0;3220;1;1;
/org.eclipse.jdt.core.tests.model/workspace/Converter/test0303/Test.java;1;0;1;1;0;0;0;1;0;0;1;3714;0;0;1;0;0;1;1;3714;0;3714;1;1;
/org.eclipse.swt/Eclipse SWT Drag and Drop/win32/org/eclipse/swt/dnd/DragSource.java;2;0;2;1;0;0;0;2;77;1;2;268;81;81;1;0;0;2;2;268;0;603;2;2;
/org.eclipse.swt/Eclipse SWT PI/gtk1x/org/eclipse/swt/internal/gtk/OS.java;1;0;1;1;0;0;0;1;0;0;1;2327;0;0;1;0;0;1;1;2327;0;2327;1;1;
/org.eclipse.ui.editors/src/org/eclipse/ui/editors/text/templates/ContributionTemplateStore.java;3;2;7;2;7;6;7;0;15;0;0;5360;48;48;2;0;1;0;7;5360;1;6334;6;3;
/org.eclipse.ui.ide/src/org/eclipse/ui/internal/ide/dialogs/ProjectCapabilitySimpleAddWizard.java;2;0;2;1;0;0;0;2;1;1;2;2264;1;1;1;0;0;2;2;2264;0;2766;2;2;
/org.eclipse.jdt.ui/ui/org/eclipse/jdt/internal/ui/filters/FilterMessages.java;1;0;1;1;1;1;1;0;2;0;0;6340;2;2;1;0;0;0;1;6340;0;6340;1;1;
/org.eclipse.team.tests.cvs.core/src/org/eclipse/team/tests/ccvs/ui/logformatter/PrintSummaryMain.java;1;0;1;1;0;0;0;1;0;0;1;2632;0;0;1;0;0;1;1;2632;0;2632;1;1;
/org.eclipse.jdt.core.tests.model/workspace/Formatter/test042/A_out.java;1;0;1;1;0;0;0;1;0;0;1;2425;0;0;1;0;0;1;1;2425;0;2425;1;1;
/org.eclipse.ant.ui/Ant Editor/org/eclipse/ant/internal/ui/editor/model/AntDefiningTaskNode.java;1;1;8;1;3;3;3;5;37;1;5;4524;88;88;1;0;0;5;8;4524;0;6080;8;1;
/org.eclipse.jdt.ui/ui/org/eclipse/jdt/internal/ui/javaeditor/filebuffers/CompilationUnitDocumentProvider2.java;3;0;31;2;0;0;0;31;153;3;26;1581;661;661;3;5;0;31;31;1581;5;4425;26;3;
/org.eclipse.jdt.ui.tests.refactoring/resources/RenamePackage/testImportFromMultiRoots6/out/srcTest/cheese/ATest.java;1;0;1;1;0;0;0;1;0;0;1;4105;0;0;1;0;0;1;1;4105;0;4105;1;1;
/org.eclipse.ui.editors/src/org/eclipse/ui/internal/editors/text/WorkspaceOperationRunner.java;2;1;2;1;2;2;2;0;2;0;0;5177;2;2;1;0;0;0;2;5177;0;6340;2;2;
/org.eclipse.jdt.core.tests.model/workspace/Formatter/test442/A_out.java;1;0;1;1;0;0;0;1;0;0;1;3513;0;0;1;0;0;1;1;3513;0;3513;1;1;
/org.eclipse.jdt.core.tests.model/workspace/Formatter/test060/Parser_out.java;1;0;2;1;0;0;0;2;41;1;2;2425;41;41;1;0;0;2;2;2425;0;3146;2;1;
/org.eclipse.ui.ide/src/org/eclipse/ui/actions/ResourceSelectionListenerAction.java;1;0;3;1;0;0;0;3;1;1;3;1512;1;1;1;0;0;3;3;1512;0;2263;3;1;
/org.eclipse.jface.text/src/org/eclipse/jface/text/templates/TemplateProposal.java;3;2;19;2;10;8;10;9;100;2;8;4387;416;416;2;1;2;9;19;4482;3;6353;16;3;
/org.eclipse.jdt.core/dom/org/eclipse/jdt/core/dom/DefaultCommentMapper.java;4;1;16;2;2;2;2;14;415;3;8;3762;1026;1026;3;6;0;14;16;3762;6;6125;10;4;
/org.eclipse.ui.cheatsheets/src/org/eclipse/ui/internal/cheatsheets/data/ContentItemWithSubItems.java;2;0;4;2;0;0;0;4;109;2;3;4428;109;109;2;1;0;4;4;4625;1;4662;3;2;
/org.eclipse.team.ui/src/org/eclipse/team/ui/synchronize/presentation/IFlagChangeListener.java;1;0;1;1;0;0;0;1;0;0;1;4113;0;0;1;0;0;1;1;4113;0;4113;1;1;
/org.eclipse.team.ui/src/org/eclipse/team/internal/ui/sync/compare/LocalResourceTypedElement.java;1;0;3;1;0;0;0;3;154;1;3;488;154;154;1;0;0;3;3;488;0;2632;3;1;
/org.eclipse.ui.intro/src/org/eclipse/ui/intro/internal/parts/StandbyPart.java;1;0;8;1;1;1;1;7;543;2;6;4429;582;582;2;1;0;7;8;4609;1;5115;7;1;
/org.eclipse.update.configurator/src/org/eclipse/update/configurator/Utils.java;2;0;4;1;0;0;0;4;42;2;3;3014;47;47;2;1;0;4;4;3265;1;3265;3;2;
/org.eclipse.core.tests.runtime/src/org/eclipse/core/tests/plugintests/LibraryLookupTests.java;1;0;1;1;0;0;0;1;0;0;1;3014;0;0;1;0;0;1;1;3014;0;3014;1;1;
/org.eclipse.jdt.core.tests.model/workspace/Converter/test0054/Test.java;1;0;1;1;0;0;0;1;0;0;1;3714;0;0;1;0;0;1;1;3714;0;3714;1;1;
/org.eclipse.core.resources/src/org/eclipse/core/internal/watson/IPathRequestor.java;1;0;1;1;1;1;1;0;8;0;0;5146;8;8;1;0;0;0;1;5146;0;5146;1;1;
/org.eclipse.jdt.ui/ui refactoring/org/eclipse/jdt/internal/ui/refactoring/RefactoringStatusContentProvider.java;1;0;3;1;0;0;0;3;2;1;3;3536;4;4;1;0;0;3;3;3536;0;4965;3;1;
/org.eclipse.jdt.ui/core refactoring/org/eclipse/ltk/core/refactoring/participants/DeleteRefactoring.java;1;0;5;1;0;0;0;5;117;1;5;4624;153;153;1;0;0;5;5;4624;0;4864;5;1;
/org.eclipse.ui.editors/src/org/eclipse/ui/internal/editors/quickdiff/restore/RestoreAction.java;1;0;2;1;0;0;0;2;0;1;2;1118;0;0;1;0;0;2;2;1118;0;1214;2;1;
/org.eclipse.swt/Eclipse SWT/gtk1x/org/eclipse/swt/widgets/Scale.java;1;0;1;1;0;0;0;1;0;0;1;2327;0;0;1;0;0;1;1;2327;0;2327;1;1;
/org.eclipse.swt/Eclipse SWT/win32/org/eclipse/swt/widgets/TabItem.java;3;0;4;1;1;1;1;3;5;1;3;268;18;18;1;0;0;3;4;268;0;6352;4;3;
/org.eclipse.jdt.ui/ui/org/eclipse/jdt/ui/IWorkingCopyProvider.java;2;0;2;1;1;1;1;1;2;0;1;3961;3;3;1;0;0;1;2;3961;0;6340;2;2;
/org.eclipse.core.filebuffers.tests/src/org/eclipse/core/filebuffers/tests/FilebuffersTestSuite.java;1;1;3;1;3;3;3;0;2;0;0;5129;3;3;1;0;0;0;3;5129;0;6340;3;1;
/org.eclipse.jdt.ui.tests.refactoring/resources/ExtractMethodWorkSpace/ExtractMethodTests/return_in/A_test721.java;1;0;1;1;0;0;0;1;2;0;1;844;2;2;1;0;0;1;1;844;0;844;1;1;
/org.eclipse.jdt.core.tests.model/workspace/Formatter/test326/A_in.java;1;0;1;1;0;0;0;1;0;0;1;2552;0;0;1;0;0;1;1;2552;0;2552;1;1;
/org.eclipse.ui.tests/Eclipse UI Tests/org/eclipse/ui/tests/dynamicplugins/DynamicPluginsTestSuite.java;1;0;2;1;0;0;0;2;3;1;2;4825;3;3;1;0;0;2;2;4825;0;4969;2;1;
/org.eclipse.debug.core/core/org/eclipse/debug/internal/core/sourcelookup/containers/ContainerSourceContainer.java;1;0;8;1;1;1;1;7;49;2;5;3678;84;84;2;2;0;7;8;3678;2;5109;6;1;
/org.eclipse.core.tests.runtime/src/org/eclipse/core/tests/internal/plugins/PluginResolveTest_34.java;1;0;1;1;0;0;0;1;0;0;1;3014;0;0;1;0;0;1;1;3014;0;3014;1;1;
/org.eclipse.pde.ui/src/org/eclipse/pde/ui/templates/AbstractNewPluginTemplateWizard.java;3;4;26;2;10;7;10;16;384;2;15;1111;854;854;4;1;3;16;26;5204;4;6336;22;3;
/org.eclipse.update.core/src/org/eclipse/update/internal/search/UpdateSiteAdapter.java;3;1;7;1;2;2;2;5;6;1;5;825;23;23;1;0;0;5;7;825;0;6336;7;3;
/org.eclipse.ui.workbench/Eclipse UI/org/eclipse/ui/internal/ViewPluginAction.java;2;1;2;1;2;2;2;0;4;0;0;5310;6;6;1;0;0;0;2;5310;0;6338;2;2;
/org.eclipse.update.ui/src/org/eclipse/update/internal/ui/pages/SitePage.java;1;0;1;1;0;0;0;1;0;0;1;755;0;0;1;0;0;1;1;755;0;755;1;1;
/org.eclipse.ui.workbench/Eclipse UI/org/eclipse/ui/internal/layout/Row.java;1;0;1;1;0;0;0;1;0;0;1;5003;0;0;1;0;0;1;1;5003;0;5003;1;1;
/org.eclipse.pde.ui/src/org/eclipse/pde/internal/ui/feature/BuildPluginAction.java;2;0;6;1;0;0;0;6;213;1;6;648;642;642;1;0;0;6;6;648;0;3840;6;2;
/org.eclipse.jdt.ui.tests.refactoring/resources/InlineMethodWorkspace/TestCases/argument_in/TestLocalReferencePrefix.java;1;0;2;1;0;0;0;2;2;1;2;597;2;2;1;0;0;2;2;597;0;845;2;1;
/org.eclipse.osgi/osgi/src/org/osgi/service/packageadmin/PackageAdmin.java;3;1;12;1;5;5;5;7;146;2;6;3013;412;412;2;1;0;7;12;4311;1;5590;11;3;
/org.eclipse.ui.workbench/Eclipse UI/org/eclipse/ui/internal/dialogs/WelcomeItem.java;1;0;1;1;0;0;0;1;0;0;1;2737;0;0;1;0;0;1;1;2737;0;2737;1;1;
/org.eclipse.core.runtime.osgi/src/org/eclipse/core/runtime/registry/IConfigurationElement.java;1;0;2;1;0;0;0;2;384;1;2;3013;384;384;1;0;0;2;2;3013;0;3030;2;1;
/org.eclipse.jdt.ui.tests.refactoring/resources/ChangeTypeRefactoring/positive/A_testLocalVarDecl_out.java;1;0;1;1;0;0;0;1;0;0;1;2844;0;0;1;0;0;1;1;2844;0;2844;1;1;
/org.eclipse.jdt.core/dom/org/eclipse/jdt/internal/core/dom/rewrite/Strings.java;2;0;2;1;1;1;1;1;0;0;1;4802;0;0;1;0;0;1;2;4802;0;5404;2;2;
/org.eclipse.jdt.ui/core extension/org/eclipse/jdt/internal/corext/textmanipulation/TextBufferFactory.java;4;0;7;1;1;1;1;6;22;1;6;456;44;44;1;0;0;6;7;456;0;6340;7;4;
/org.eclipse.debug.ui/ui/org/eclipse/debug/internal/ui/actions/ChangeVariableValueAction.java;1;0;1;1;0;0;0;1;9;0;1;4424;9;9;1;0;0;1;1;4424;0;4424;1;1;
/org.eclipse.update.ui.forms/src/org/eclipse/ui/forms/parts/RichTextHyperlinkAction.java;1;0;2;1;0;0;0;2;0;1;2;2898;0;0;1;0;0;2;2;2898;0;3038;2;1;
/org.eclipse.jdt.ui/ui/org/eclipse/jdt/internal/ui/text/java/JavaCompletionProcessor.java;5;1;12;1;2;2;2;10;20;1;10;1152;71;71;1;0;0;10;12;1152;0;6340;12;5;
/org.eclipse.swt.tools/JNI Generation/org/eclipse/swt/tools/internal/StructsGenerator.java;3;0;5;1;1;1;1;4;94;1;4;4175;143;143;1;0;0;4;5;4175;0;5465;5;3;
/org.eclipse.ant.ui/Ant Editor/org/eclipse/ant/internal/ui/editor/model/AntElementNode.java;2;2;24;2;4;3;4;20;44;2;16;3661;375;375;2;4;1;20;24;3661;5;5895;19;2;
/org.eclipse.pde.ui/src_Forms/org/eclipse/pde/internal/ui/neweditor/plugin/RuntimePage.java;3;2;11;2;4;3;4;7;69;1;7;3777;111;111;2;0;1;7;11;5290;1;5431;10;3;
/org.eclipse.jface.text/src/org/eclipse/jface/text/IWidgetTokenKeeperExtension.java;3;1;4;1;2;2;2;2;20;1;2;1213;33;33;1;0;0;2;4;1213;0;6359;4;3;
/org.eclipse.debug.ui/ui/org/eclipse/debug/internal/ui/console/IConsole.java;2;0;6;1;0;0;0;6;41;2;5;1294;94;94;2;1;0;6;6;1430;1;2060;5;2;
/org.eclipse.update.ui/src/org/eclipse/update/internal/ui/wizards/MoreInfoGenerator.java;3;0;5;1;0;0;0;5;101;1;5;200;115;115;1;0;0;5;5;200;0;2997;5;3;
/org.eclipse.jdt.ui.tests.refactoring/resources/PullUp/test25/out/A.java;2;0;2;1;0;0;0;2;16;1;2;1690;20;20;1;0;0;2;2;1690;0;1738;2;2;
/org.eclipse.pde.core/src/org/eclipse/pde/internal/core/schema/DocumentSection.java;2;1;3;1;2;2;2;1;14;0;1;4203;20;20;1;0;0;1;3;4203;0;6336;3;2;
/org.eclipse.jdt.debug/model/org/eclipse/jdt/internal/debug/core/model/JDIStackFrame.java;5;2;28;2;7;6;7;21;160;3;16;173;388;388;3;5;1;21;28;2374;6;6336;22;5;
/org.eclipse.jdt.ui/ui/org/eclipse/jdt/internal/ui/preferences/BuildPathPreferencePage.java;1;0;2;1;1;1;1;1;0;0;1;4407;0;0;1;0;0;1;2;4407;0;6034;2;1;
/org.eclipse.jdt.ui/core refactoring/org/eclipse/jdt/internal/corext/refactoring/reorg2/MoveRefactoring2.java;1;0;6;1;0;0;0;6;16;2;3;802;39;39;2;3;0;6;6;802;3;1111;3;1;
/org.eclipse.debug.ui/ui/org/eclipse/debug/ui/launchVariables/expanders/StringPromptExpander.java;1;0;3;1;0;0;0;3;3;1;3;562;3;3;1;0;0;3;3;562;0;771;3;1;
/org.eclipse.core.resources/src/org/eclipse/core/internal/resources/ProjectPreferences.java;2;3;25;2;15;11;15;10;150;2;8;4351;565;565;3;2;4;10;25;6013;6;6013;19;2;
/org.eclipse.jdt.ui.tests.refactoring/resources/IntroduceFactory/positive/StaticInstance.java;1;0;2;1;1;1;1;1;2;0;1;2862;2;2;1;0;0;1;2;2862;0;5659;2;1;
/org.eclipse.update.core/srcnew/org/eclipse/update/operations/IFeatureOperation.java;1;0;3;1;0;0;0;3;2;1;3;602;2;2;1;0;0;3;3;602;0;825;3;1;
/org.eclipse.jdt.core.tests.model/workspace/Converter/test0191/Test.java;1;0;1;1;0;0;0;1;0;0;1;3714;0;0;1;0;0;1;1;3714;0;3714;1;1;
/org.eclipse.jdt.ui.tests.refactoring/resources/IntroduceFactory/Bugzilla/46608/p1/TT.java;1;0;1;1;0;0;0;1;0;0;1;2888;0;0;1;0;0;1;1;2888;0;2888;1;1;
/org.eclipse.swt.graphics.text/Eclipse SWT/gtk/org/eclipse/swt/graphics/text/TextLayout.java;2;0;25;1;0;0;0;25;1963;2;22;2707;12876;12876;2;3;0;25;25;3492;3;4213;22;2;
/org.eclipse.ant.ui/Ant Editor/org/eclipse/ant/internal/ui/editor/AntEditor.java;2;1;44;1;8;8;8;36;196;3;26;1811;981;981;3;10;0;36;44;3916;10;6085;34;2;
/org.eclipse.jdt.core.tests.model/workspace/Converter/test0514/A.java;1;0;2;1;0;0;0;2;0;1;2;3442;0;0;1;0;0;2;2;3442;0;3714;2;1;
/org.eclipse.ui.ide/src/org/eclipse/ui/internal/ide/model/WorkbenchWorkspace.java;2;0;3;1;1;1;1;2;11;1;2;2264;12;12;1;0;0;2;3;2264;0;6340;3;2;
/org.eclipse.update.ui.forms/Eclipse Forms/org/eclipse/ui/forms/widgets/Hyperlink.java;1;0;8;1;0;0;0;8;135;3;5;3138;163;163;3;3;0;8;8;3978;3;4157;5;1;
/org.eclipse.jdt.core/dom/org/eclipse/jdt/core/dom/WhileStatement.java;3;1;9;1;2;2;2;7;110;1;7;2872;166;166;1;0;0;7;9;2872;0;5272;9;3;
/org.eclipse.jface.text/src/org/eclipse/jface/contentassist/ISubjectControlContentAssistProcessor.java;1;2;3;1;3;2;3;0;7;0;0;5199;12;12;2;0;1;0;3;6340;1;6340;2;1;
/org.eclipse.jdt.debug.tests/tests/org/eclipse/jdt/debug/tests/core/DirectorySourceContainerTests.java;1;0;5;1;0;0;0;5;61;1;5;3679;84;84;1;0;0;5;5;3679;0;4949;5;1;
/org.eclipse.team.ui/src/org/eclipse/team/ui/sync/actions/NavigateAction.java;1;0;1;1;0;0;0;1;0;0;1;2433;0;0;1;0;0;1;1;2433;0;2433;1;1;
/org.eclipse.swt/Eclipse SWT PI/motif/org/eclipse/swt/internal/motif/XGCValues.java;1;0;1;1;0;0;0;1;40;0;1;829;40;40;1;0;0;1;1;829;0;829;1;1;
/org.eclipse.ui.workbench/Eclipse UI/org/eclipse/ui/internal/commands/older/ActionHandler.java;1;0;1;1;0;0;0;1;2;0;1;2562;2;2;1;0;0;1;1;2562;0;2562;1;1;
/org.eclipse.core.tests.resources/src/org/eclipse/core/tests/internal/watson/TreeFlatteningTest.java;1;0;3;1;3;1;3;0;162;0;0;5147;162;162;3;0;2;0;3;5147;2;5147;1;1;
/org.eclipse.jdt.core.tests.model/workspace/Formatter/test190/A_in.java;1;0;1;1;0;0;0;1;0;0;1;2425;0;0;1;0;0;1;1;2425;0;2425;1;1;
/org.eclipse.jdt.ui.tests/test plugin/org/eclipse/jdt/testplugin/JavaProjectHelper.java;4;1;8;1;3;3;3;5;59;1;5;372;152;152;1;0;0;5;8;372;0;6340;8;4;
/org.eclipse.jdt.ui/ui/org/eclipse/jdt/ui/text/IJavaColorConstants.java;2;1;4;1;2;2;2;2;16;1;2;1586;42;42;1;0;0;2;4;1586;0;6322;4;2;
/org.eclipse.jdt.junit/src/org/eclipse/jdt/internal/junit/ui/IJUnitHelpContextIds.java;3;0;4;1;1;1;1;3;3;1;3;261;7;7;1;0;0;3;4;261;0;6340;4;3;
/org.eclipse.ant.ui/Ant Editor/org/eclipse/ant/internal/ui/editor/formatter/NonParsingXMLFormatter.java;1;0;4;1;0;0;0;4;51;1;4;3916;54;54;1;0;0;4;4;3916;0;4583;4;1;
/org.eclipse.core.expressions.tests/src/org/eclipse/core/internal/expressions/tests/TestAdapterFactory.java;1;0;1;1;0;0;0;1;0;0;1;4507;0;0;1;0;0;1;1;4507;0;4507;1;1;
/org.eclipse.ui.forms.examples/src/org/eclipse/ui/forms/examples/internal/rcp/ScrolledPropertiesBlock.java;1;1;5;1;2;2;2;3;21;1;3;4075;42;42;1;0;0;3;5;4075;0;6269;5;1;
/org.eclipse.jdt.core/model/org/eclipse/jdt/internal/core/CreateTypeOperation.java;2;0;8;2;1;1;1;7;47;2;6;377;101;101;2;1;0;7;8;2308;1;5584;7;2;
/org.eclipse.swt/Eclipse SWT PI/gtk1x/org/eclipse/swt/internal/gtk/GtkBox.java;1;0;1;1;0;0;0;1;0;0;1;2327;0;0;1;0;0;1;1;2327;0;2327;1;1;
/org.eclipse.jdt.ui.tests.refactoring/test cases/org/eclipse/jdt/ui/tests/refactoring/extensions/ExtensionPointTestSetup.java;3;0;4;1;1;1;1;3;4;1;3;882;9;9;1;0;0;3;4;882;0;6340;4;3;
/org.eclipse.jdt.core.tests.model/workspace/Formatter/test149/A_in.java;1;0;1;1;0;0;0;1;0;0;1;2425;0;0;1;0;0;1;1;2425;0;2425;1;1;
/org.eclipse.jdt.core/model/org/eclipse/jdt/internal/core/DeletePackageFragmentRootOperation.java;2;0;2;1;0;0;0;2;8;1;2;3034;10;10;1;0;0;2;2;3034;0;3560;2;2;
/org.eclipse.tomcat/src/org/eclipse/tomcat/internal/LocalConnectionTest.java;1;0;1;1;0;0;0;1;0;0;1;379;0;0;1;0;0;1;1;379;0;379;1;1;
/org.eclipse.swt/Eclipse SWT PI/gtk1x/org/eclipse/swt/internal/gtk/GtkCList.java;1;0;1;1;0;0;0;1;0;0;1;2327;0;0;1;0;0;1;1;2327;0;2327;1;1;
/org.eclipse.pde.ui/sandbox/org/eclipse/pde/internal/ui/editor/standalone/extensions/ExtensionsEditorUtil.java;1;0;2;1;0;0;0;2;0;1;2;2320;0;0;1;0;0;2;2;2320;0;2906;2;1;
/org.eclipse.jdt.ui.tests.refactoring/resources/ExtractMethodWorkSpace/ExtractMethodTests/locals_in/A_test525.java;1;0;1;1;0;0;0;1;4;0;1;844;4;4;1;0;0;1;1;844;0;844;1;1;
/org.eclipse.core.tests.resources/src/org/eclipse/core/tests/internal/watson/TestUtil.java;1;0;3;1;3;1;3;0;702;0;0;5147;702;702;3;0;2;0;3;5147;2;5147;1;1;
/org.eclipse.team.cvs.ui/src/org/eclipse/team/internal/ccvs/ui/WorkbenchUserAuthenticator.java;1;1;8;1;2;2;2;6;79;3;4;3113;209;209;3;2;0;6;8;5083;2;6337;6;1;
/org.eclipse.help.ui/src/org/eclipse/help/ui/internal/IHelpUIConstants.java;1;1;4;1;3;3;3;1;17;0;1;2732;54;54;1;0;0;1;4;2732;0;6337;4;1;
/org.eclipse.core.tests.runtime/src/org/eclipse/core/tests/internal/plugin/b/PluginClass.java;1;0;1;1;1;1;1;0;19;0;0;5149;19;19;1;0;0;0;1;5149;0;5149;1;1;
/org.eclipse.ui.workbench/Eclipse UI/org/eclipse/ui/internal/commands/AbstractCommandRegistry.java;3;1;13;1;2;2;2;11;53;2;8;1400;150;150;2;3;0;11;13;1400;3;6338;10;3;
/org.eclipse.jdt.core.tests.model/workspace/Converter/test0402/A.java;1;0;1;1;0;0;0;1;0;0;1;3714;0;0;1;0;0;1;1;3714;0;3714;1;1;
/org.eclipse.jface.text/src/org/eclipse/jface/text/ISynchronizable.java;1;0;2;1;1;1;1;1;0;0;1;4425;0;0;1;0;0;1;2;4425;0;5382;2;1;
/org.eclipse.update.core/src/org/eclipse/update/configuration/IInstallConfiguration.java;2;1;3;1;2;2;2;1;7;0;1;890;13;13;1;0;0;1;3;890;0;6336;3;2;
/org.eclipse.core.runtime/src/org/eclipse/core/runtime/ISafeRunnable.java;2;1;6;1;2;2;2;4;94;1;4;3013;201;201;1;0;0;4;6;3013;0;6340;6;2;
/org.eclipse.jdt.core/compiler/org/eclipse/jdt/internal/compiler/ast/StringLiteralConcatenation.java;1;0;1;1;1;1;1;0;0;0;0;5635;0;0;1;0;0;0;1;5635;0;5635;1;1;
/org.eclipse.ui.externaltools/Ant Tools Support/org/eclipse/ui/externaltools/internal/ant/view/actions/RunTargetAction.java;2;0;4;1;0;0;0;4;57;1;4;134;66;66;1;0;0;4;4;134;0;282;4;2;
/org.eclipse.jdt.ui.examples.javafamily/src/org/eclipse/jsp/copied_from_jdtcore/AbstractIndexer.java;1;0;2;1;0;0;0;2;0;1;2;1033;0;0;1;0;0;2;2;1033;0;3235;2;1;
/org.eclipse.ui.workbench/Eclipse UI/org/eclipse/ui/commands/NotActiveException.java;1;0;2;1;0;0;0;2;0;1;2;1435;0;0;1;0;0;2;2;1435;0;2562;2;1;
/org.eclipse.jdt.core.tests.model/workspace/Converter/codeManipulation/bug.java;1;0;2;1;0;0;0;2;0;1;2;393;0;0;1;0;0;2;2;393;0;3714;2;1;
/org.eclipse.jdt.ui/ui/org/eclipse/jdt/internal/ui/text/spelling/engine/ISpellDictionary.java;2;0;3;1;1;1;1;2;6;1;2;3930;8;8;1;0;0;2;3;3930;0;6340;3;2;
/org.eclipse.releng.basebuilder/plugins/org.eclipse.build.tools/src/org/eclipse/releng/Mailer.java;1;0;3;1;0;0;0;3;10;2;2;993;10;10;2;1;0;3;3;3593;1;3593;2;1;
/org.eclipse.swt/Eclipse SWT Mozilla/common/org/eclipse/swt/internal/mozilla/nsIStreamListener.java;1;0;1;1;0;0;0;1;0;0;1;2663;0;0;1;0;0;1;1;2663;0;2663;1;1;
/org.eclipse.ui.workbench/Eclipse UI/org/eclipse/ui/IMarkerHelpRegistry.java;1;0;1;1;0;0;0;1;0;0;1;2737;0;0;1;0;0;1;1;2737;0;2737;1;1;
/org.eclipse.swt/Eclipse SWT PI/win32/org/eclipse/swt/internal/win32/TCHAR.java;1;0;1;1;0;0;0;1;4;0;1;957;4;4;1;0;0;1;1;957;0;957;1;1;
/org.eclipse.update.tests.core/src/org/eclipse/update/tests/parser/TestCategories.java;1;0;2;1;1;1;1;1;6;0;1;4928;10;10;1;0;0;1;2;4928;0;6336;2;1;
/org.eclipse.jdt.launching/launching/org/eclipse/jdt/launching/sourcelookup/containers/PackageFragmentRootSourceContainer.java;1;0;1;1;0;0;0;1;0;0;1;4971;0;0;1;0;0;1;1;4971;0;4971;1;1;
/org.eclipse.jdt.ui/core refactoring/org/eclipse/jdt/internal/corext/refactoring/base/ChangeContext.java;1;0;2;1;0;0;0;2;15;1;2;3930;15;15;1;0;0;2;2;3930;0;4575;2;1;
/org.eclipse.jdt.core.tests.model/workspace/Converter/test0320/Test.java;1;0;1;1;0;0;0;1;0;0;1;3714;0;0;1;0;0;1;1;3714;0;3714;1;1;
/org.eclipse.releng.basebuilder/plugins/org.eclipse.build.tools/org.eclipse.build.tools/src/org/eclipse/releng/BuildMachineManager.java;1;0;1;1;1;1;1;0;0;0;0;5735;0;0;1;0;0;0;1;5735;0;5735;1;1;
/org.eclipse.jdt.core/model/org/eclipse/jdt/internal/core/builder/AdditionalTypeCollection.java;1;0;1;1;0;0;0;1;2;0;1;3560;2;2;1;0;0;1;1;3560;0;3560;1;1;
/org.eclipse.pde.ui/src/org/eclipse/pde/internal/ui/wizards/IDefaultValueConsumer.java;2;1;2;1;2;2;2;0;4;0;0;5388;4;4;1;0;0;0;2;5388;0;6336;2;2;
/org.eclipse.jdt.core/model/org/eclipse/jdt/core/util/IParameterAnnotation.java;2;0;2;1;0;0;0;2;37;1;2;4466;37;37;1;0;0;2;2;4466;0;4843;2;2;
/org.eclipse.update.ui/src/org/eclipse/update/internal/ui/views/SaveConfigurationAction.java;3;0;3;1;0;0;0;3;11;1;3;825;11;11;1;0;0;3;3;825;0;4217;3;3;
/org.eclipse.ui.externaltools/External Tools Base/org/eclipse/ui/externaltools/internal/variable/FolderPromptExpander.java;2;0;3;1;0;0;0;3;74;1;3;245;74;74;1;0;0;3;3;245;0;321;3;2;
/org.eclipse.help.tests/src/org/eclipse/help/tests/base/AllHelpBaseTests.java;1;1;2;1;2;2;2;0;16;0;0;5827;32;32;1;0;0;0;2;5827;0;6337;2;1;
/org.eclipse.swt/Eclipse SWT/carbon/org/eclipse/swt/widgets/TreeItem.java;4;2;13;2;8;7;8;5;392;2;4;231;497;497;2;1;1;5;13;231;2;6352;11;4;
/org.eclipse.core.runtime/src/org/eclipse/core/internal/plugins/ExtensionRegistryBuilder.java;2;0;2;1;0;0;0;2;0;1;2;2105;0;0;1;0;0;2;2;2105;0;3013;2;2;
/org.eclipse.jdt.ui/ui/org/eclipse/jdt/internal/ui/text/JavaElementProvider.java;1;0;1;1;1;1;1;0;2;0;0;6340;2;2;1;0;0;0;1;6340;0;6340;1;1;
/org.eclipse.webdav/src/kernel/org/eclipse/webdav/internal/kernel/utils/AssertionFailedException.java;1;0;2;1;2;1;2;0;26;0;0;5151;26;26;2;0;1;0;2;5151;1;5151;1;1;
/org.eclipse.jface.text/projection/org/eclipse/jface/text/source/projection/IProjectionAnnotationModel.java;1;0;2;1;0;0;0;2;0;1;2;4516;0;0;1;0;0;2;2;4516;0;4866;2;1;
/org.eclipse.jdt.ui/core extension/org/eclipse/jdt/internal/corext/callhierarchy/CallLocation.java;4;0;12;1;1;1;1;11;91;2;10;169;233;233;2;1;0;11;12;169;1;6340;11;4;
/org.eclipse.text/src/org/eclipse/text/edits/TextEditProcessor.java;2;1;6;1;2;2;2;4;112;1;4;1986;237;237;1;0;0;4;6;1986;0;6340;6;2;
/org.eclipse.compare/compare/org/eclipse/compare/IEncodedStreamContentAccessor.java;1;0;4;1;1;1;1;3;12;2;2;3953;30;30;2;1;0;3;4;3953;1;6322;3;1;
/org.eclipse.jdt.core.tests.model/workspace/Converter/src/test0248/Test.java;1;0;1;1;0;0;0;1;0;0;1;3714;0;0;1;0;0;1;1;3714;0;3714;1;1;
/org.eclipse.ui.intro/src/org/eclipse/ui/intro/internal/model/AbstractIntroContainer.java;2;0;10;1;1;1;1;9;719;2;8;4429;981;981;2;1;0;9;10;4898;1;5115;9;2;
/org.eclipse.jface/src/org/eclipse/jface/viewers/StructuredViewer.java;3;2;11;2;7;5;7;4;2406;1;4;1;2640;2640;2;0;2;4;11;5730;2;6338;9;3;
/org.eclipse.ant.ui/Ant Tools Support/org/eclipse/ant/internal/ui/launchConfigurations/AntBuilderTabGroup.java;3;0;6;2;0;0;0;6;8;2;4;1811;14;14;2;2;0;6;6;1811;2;4628;4;3;
/org.eclipse.jdt.core.tests.model/workspace/Converter/test0039/Test.java;1;0;1;1;0;0;0;1;0;0;1;3714;0;0;1;0;0;1;1;3714;0;3714;1;1;
/org.eclipse.team.cvs.core/src/org/eclipse/team/internal/ccvs/core/client/SyncUpdate.java;1;0;3;1;0;0;0;3;2;1;3;1173;4;4;1;0;0;3;3;1173;0;1843;3;1;
/org.eclipse.jface.text/src/org/eclipse/jface/text/presentation/PresentationReconciler.java;3;1;19;1;4;4;4;15;71;2;14;862;346;346;2;1;0;15;19;951;1;6352;18;3;
/org.eclipse.jdt.core/dom/org/eclipse/jdt/core/dom/rewrite/RewriteException.java;2;0;5;2;0;0;0;5;13;2;4;4711;19;19;2;1;0;5;5;4711;1;5090;4;2;
/org.eclipse.swt/Eclipse SWT PI/photon/org/eclipse/swt/internal/photon/PtContainerCallback_t.java;1;0;1;1;0;0;0;1;0;0;1;808;0;0;1;0;0;1;1;808;0;808;1;1;
/org.eclipse.swt/Eclipse SWT/win32/org/eclipse/swt/widgets/TreeItem.java;5;1;13;2;6;6;6;7;49;2;6;43;184;184;2;1;0;7;13;4365;1;6352;12;5;
/org.eclipse.team.core/src/org/eclipse/team/core/WriteResourcesSchedulingRule.java;1;0;1;1;0;0;0;1;0;0;1;1954;0;0;1;0;0;1;1;1954;0;1954;1;1;
/org.eclipse.jdt.core.tests.model/workspace/Formatter/test175/A_out.java;1;0;1;1;0;0;0;1;0;0;1;2425;0;0;1;0;0;1;1;2425;0;2425;1;1;
/org.eclipse.update.ui.forms/Eclipse Forms/org/eclipse/ui/forms/parts/FormEntry.java;1;0;3;1;0;0;0;3;2;2;2;3096;2;2;2;1;0;3;3;3096;1;3138;2;1;
/org.eclipse.jdt.ui/core refactoring/org/eclipse/jdt/internal/corext/refactoring/participants/RenameExtensionManager.java;1;0;9;1;0;0;0;9;131;1;9;591;169;169;1;0;0;9;9;591;0;4624;9;1;
/org.eclipse.team.cvs.core/src/org/eclipse/team/internal/ccvs/core/Policy.java;1;0;1;1;0;0;0;1;2;0;1;2603;2;2;1;0;0;1;1;2603;0;2603;1;1;
/org.eclipse.help.base/src/org/eclipse/help/internal/browser/StreamConsumer.java;1;1;4;1;2;2;2;2;6;0;1;1740;13;13;2;1;0;2;4;1740;1;6337;3;1;
/org.eclipse.jdt.core.tests.model/workspace/Converter/src/javadoc/testBug51476/X1.java;1;0;1;1;0;0;0;1;0;0;1;3994;0;0;1;0;0;1;1;3994;0;3994;1;1;
/org.eclipse.team.ui/src/org/eclipse/team/internal/ui/Utils.java;2;1;27;2;10;10;10;17;312;2;15;987;1272;1272;2;2;0;17;27;987;2;6337;25;2;
/org.eclipse.jdt.debug.ui/ui/org/eclipse/jdt/internal/debug/ui/propertypages/BreakpointConditionEditor.java;4;1;12;1;2;2;2;10;54;1;10;1358;134;134;1;0;0;10;12;1358;0;6223;12;4;
/org.eclipse.jdt.text.tests/src/org/eclipse/jdt/text/tests/JavaPartitionerTest.java;1;1;2;1;2;2;2;0;2;0;0;5129;2;2;1;0;0;0;2;5129;0;6340;2;1;
/org.eclipse.team.ui/org.eclipse.jdt.ui.team/src/org/eclipse/jdt/ui/team/JavaSyncInfoLabelProvider.java;1;0;1;1;0;0;0;1;0;0;1;3734;0;0;1;0;0;1;1;3734;0;3734;1;1;
/org.eclipse.team.examples.filesystem/src/org/eclipse/team/examples/filesystem/ui/PutSynchronizeOperation.java;1;0;1;1;1;1;1;0;0;0;0;6206;0;0;1;0;0;0;1;6206;0;6206;1;1;
/org.eclipse.jdt.core.tests.model/workspace/Converter/test0038/Test.java;1;0;1;1;0;0;0;1;0;0;1;3714;0;0;1;0;0;1;1;3714;0;3714;1;1;
/org.eclipse.ui.intro/src/org/eclipse/ui/intro/internal/model/loader/ExtensionPointManager.java;1;0;2;1;1;1;1;1;0;0;1;4948;0;0;1;0;0;1;2;4948;0;5115;2;1;
/org.eclipse.help/src/org/eclipse/help/internal/model/ITopicElement.java;1;0;2;1;1;1;1;1;9;0;1;3513;9;9;1;0;0;1;2;3513;0;5827;2;1;
/org.eclipse.update.core/src/org/eclipse/update/search/IUpdateSearchCategory.java;1;1;5;1;2;2;2;3;7;1;3;825;13;13;1;0;0;3;5;825;0;6336;5;1;
/org.eclipse.help.base/src/org/eclipse/help/internal/search/Analyzer_en.java;1;1;4;1;3;3;3;1;62;0;1;1740;92;92;1;0;0;1;4;1740;0;6337;4;1;
/org.eclipse.jdt.ui.tests.refactoring/resources/IntroduceFactory/positive/ProtectConstructor2_in.java;1;0;2;1;1;1;1;1;2;0;1;2846;2;2;1;0;0;1;2;2846;0;5659;2;1;
/org.eclipse.jdt.ui.tests.refactoring/resources/ExtractMethodWorkSpace/ExtractMethodTests/locals_out/A_test510.java;1;0;2;1;0;0;0;2;4;1;2;130;5;5;1;0;0;2;2;130;0;844;2;1;
/org.eclipse.update.core/srcnew/org/eclipse/update/internal/operations/UninstallOperation.java;1;0;9;1;0;0;0;9;24;2;7;445;42;42;2;2;0;9;9;602;2;825;7;1;
/org.eclipse.team.ui/src/org/eclipse/team/internal/ui/sync/views/SyncSetTableContentProvider.java;2;0;5;1;0;0;0;5;64;1;5;488;76;76;1;0;0;5;5;488;0;2632;5;2;
/org.eclipse.swt/Eclipse SWT Drag and Drop/emulated/org/eclipse/swt/dnd/TransferData.java;1;1;2;1;2;2;2;0;7;0;0;5617;11;11;1;0;0;0;2;5617;0;6352;2;1;
/org.eclipse.jdt.core.tests.model/workspace/Converter/test0335/ExceptionTestCaseTest.java;1;0;1;1;0;0;0;1;0;0;1;3714;0;0;1;0;0;1;1;3714;0;3714;1;1;
/org.eclipse.jdt.ui/ui/org/eclipse/jdt/ui/jarpackager/IJarExportRunnable.java;2;0;2;2;2;1;2;0;4;0;0;6334;4;4;2;0;1;0;2;6334;1;6334;1;2;
/org.eclipse.core.runtime/src/org/eclipse/core/internal/runtime/PlatformURLPluginConnection.java;5;1;12;1;4;4;4;8;184;1;8;1369;399;399;1;0;0;8;12;1369;0;6340;12;5;
/org.eclipse.jdt.core/compiler/org/eclipse/jdt/internal/compiler/flow/LabelFlowContext.java;2;0;2;1;0;0;0;2;4;1;2;2974;6;6;1;0;0;2;2;2974;0;3560;2;2;
/org.eclipse.jdt.ui.tests.refactoring/resources/ExtractMethodWorkSpace/ExtractMethodTests/duplicates_in/A_test959.java;1;1;2;1;2;2;2;0;2;0;0;5650;2;2;1;0;0;0;2;5650;0;5681;2;1;
/org.eclipse.update.ui/srcnew/org/eclipse/update/internal/ui/properties/FeatureStatusPropertyPage.java;3;0;6;1;0;0;0;6;26;1;6;413;39;39;1;0;0;6;6;413;0;825;6;3;
/org.eclipse.ui.workbench/Eclipse UI/org/eclipse/ui/internal/csm/commands/IContextBindingDefinition.java;1;0;2;1;0;0;0;2;0;0;1;2532;0;0;2;1;0;2;2;2532;1;2532;1;1;
/org.eclipse.jdt.ui.tests.refactoring/resources/Copy/test_type_yes_cu/out/C.java;1;0;2;1;0;0;0;2;0;1;2;696;0;0;1;0;0;2;2;696;0;1009;2;1;
/org.eclipse.jdt.core.tests.model/workspace/Formatter/test294/A_in.java;1;0;1;1;0;0;0;1;0;0;1;2444;0;0;1;0;0;1;1;2444;0;2444;1;1;
/org.eclipse.ui.externaltools/External Tools Base/org/eclipse/ui/externaltools/internal/launchConfigurations/ExternalToolsUtil.java;3;1;27;2;3;3;3;24;152;2;21;265;812;812;2;3;0;24;27;295;3;5803;24;3;
/org.eclipse.ui.editors/src/org/eclipse/ui/texteditor/AbstractMarkerAnnotationModel.java;3;2;16;2;5;4;5;11;591;2;10;1983;831;831;2;1;1;11;16;3675;2;6334;14;3;
/org.eclipse.jdt.ui.tests.refactoring/test cases/org/eclipse/jdt/ui/tests/reorg/SourceReferenceTestUtil.java;1;0;4;1;0;0;0;4;28;2;3;1111;32;32;2;1;0;4;4;1111;1;1650;3;1;
/org.eclipse.ui.workbench/Eclipse UI/org/eclipse/ui/internal/activities/service/MutableActivityService.java;1;0;2;1;0;0;0;2;0;1;2;2896;0;0;1;0;0;2;2;2896;0;3066;2;1;
/org.eclipse.jdt.ui/ui/org/eclipse/jdt/internal/ui/dnd/TransferDragSourceListener.java;1;0;1;1;1;1;1;0;2;0;0;6340;2;2;1;0;0;0;1;6340;0;6340;1;1;
/org.eclipse.core.runtime.compatibility/src-boot/org/eclipse/core/internal/boot/SiteEntry.java;3;1;4;1;2;2;2;2;11;1;2;3013;19;19;1;0;0;2;4;3013;0;6340;4;3;
/org.eclipse.jdt.ui.tests.refactoring/resources/ExtractMethodWorkSpace/ExtractMethodTests/nested_in/A_test650.java;1;0;1;1;0;0;0;1;2;0;1;844;2;2;1;0;0;1;1;844;0;844;1;1;
/org.eclipse.ui.workbench/Eclipse UI/org/eclipse/ui/internal/LayoutHelper.java;3;0;5;1;1;1;1;4;35;1;4;3168;46;46;1;0;0;4;5;3168;0;6338;5;3;
/org.eclipse.jdt.ui/core refactoring/org/eclipse/jdt/internal/corext/refactoring/RefactoringSearchEngine.java;5;1;12;1;5;5;5;7;179;1;7;42;347;347;1;0;0;7;12;42;0;6340;12;5;
/org.eclipse.jdt.core.tests.model/workspace/Converter/test0489/A.java;1;0;2;1;0;0;0;2;0;1;2;1431;0;0;1;0;0;2;2;1431;0;3714;2;1;
/org.eclipse.team.tests.core/src/org/eclipse/team/tests/ui/views/TestTreeViewer.java;2;0;4;1;1;1;1;3;20;2;2;3715;22;22;2;1;0;3;4;3715;1;6337;3;2;
/org.eclipse.search/new search/org/eclipse/search2/internal/ui/basic/views/ShowPreviousResultAction.java;2;0;3;1;1;1;1;2;8;1;2;3474;10;10;1;0;0;2;3;3474;0;6340;3;2;
/org.eclipse.jdt.ui/core refactoring/org/eclipse/jdt/internal/corext/refactoring/participants/IRefactoringParticipant.java;1;0;5;1;0;0;0;5;4;1;5;825;10;10;1;0;0;5;5;825;0;4624;5;1;
/org.eclipse.jdt.ui/ui/org/eclipse/jdt/internal/ui/text/javadoc/ILinkTagConstants.java;2;0;2;1;1;1;1;1;6;0;1;3829;6;6;1;0;0;1;2;3829;0;6340;2;2;
/org.eclipse.ui.workbench/Eclipse UI/org/eclipse/ui/activities/ws/IPluginContribution.java;1;0;1;1;0;0;0;1;9;0;1;3066;9;9;1;0;0;1;1;3066;0;3066;1;1;
/org.eclipse.jdt.core.tests.model/workspace/Formatter/test102/A_out.java;1;0;1;1;0;0;0;1;0;0;1;2425;0;0;1;0;0;1;1;2425;0;2425;1;1;
/org.eclipse.jdt.core.tests.model/workspace/Converter/src/test0357/A.java;1;0;1;1;0;0;0;1;0;0;1;3714;0;0;1;0;0;1;1;3714;0;3714;1;1;
/org.eclipse.pde.ui/src/org/eclipse/pde/internal/ui/editor/site/SiteInputContext.java;3;1;4;1;4;4;4;0;6;0;0;5431;14;14;1;0;0;0;4;5431;0;6336;4;3;
/org.eclipse.core.resources/src/org/eclipse/core/internal/resources/MarkerSnapshotReader.java;1;0;1;1;1;1;1;0;57;0;0;5146;57;57;1;0;0;0;1;5146;0;5146;1;1;
/org.eclipse.jdt.debug/model/org/eclipse/jdt/debug/core/IJavaStackFrame.java;3;0;4;1;1;1;1;3;41;1;3;805;82;82;1;0;0;3;4;805;0;6336;4;3;
/org.eclipse.core.resources/src/org/eclipse/core/internal/resources/ListenerNotifyJob.java;1;0;1;1;0;0;0;1;0;0;1;629;0;0;1;0;0;1;1;629;0;629;1;1;
/org.eclipse.ui.views/src/org/eclipse/ui/views/navigator/FilterSelectionAction.java;1;0;1;1;0;0;0;1;0;0;1;2738;0;0;1;0;0;1;1;2738;0;2738;1;1;
/org.eclipse.update.core/src/org/eclipse/update/internal/core/SiteURLFactory.java;2;2;5;1;3;2;3;2;10;1;2;890;23;23;2;0;1;2;5;5664;1;6336;4;2;
/org.eclipse.pde.ui/src/org/eclipse/pde/internal/ui/preferences/SourceLocationDialog.java;1;0;2;1;0;0;0;2;4;1;2;1944;4;4;1;0;0;2;2;1944;0;3505;2;1;
/org.eclipse.jdt.ui.tests.refactoring/resources/ExtractMethodWorkSpace/ExtractMethodTests/return_in/A_test709.java;1;0;1;1;0;0;0;1;4;0;1;844;4;4;1;0;0;1;1;844;0;844;1;1;
/org.eclipse.core.resources/src/org/eclipse/core/resources/WorkspaceLock.java;2;0;3;1;1;1;1;2;98;1;2;1485;139;139;1;0;0;2;3;1485;0;5146;3;2;
/org.eclipse.update.ui/srcnew/org/eclipse/update/internal/ui/wizards/SearchRunner2.java;3;0;10;2;0;0;0;10;84;4;7;367;103;103;4;3;0;10;10;569;3;825;7;3;
/org.eclipse.jdt.ui.tests.refactoring/resources/DeleteSourceReferenceEdit/A_test4_in.java;1;0;1;1;0;0;0;1;0;0;1;1652;0;0;1;0;0;1;1;1652;0;1652;1;1;
/org.eclipse.jdt.core/model/org/eclipse/jdt/core/compiler/ITerminalSymbols.java;1;0;2;1;0;0;0;2;247;1;2;3560;249;249;1;0;0;2;2;3560;0;4843;2;1;
/org.eclipse.jdt.core.tests.model/workspace/Converter/src/test0287/Test.java;1;0;1;1;0;0;0;1;0;0;1;3714;0;0;1;0;0;1;1;3714;0;3714;1;1;
/org.eclipse.jdt.core.tests.model/workspace/Formatter/test104/A_in.java;1;0;1;1;0;0;0;1;0;0;1;2425;0;0;1;0;0;1;1;2425;0;2425;1;1;
/org.eclipse.update.ui.forms/Eclipse Forms/org/eclipse/ui/forms/internal/widgets/Paragraph.java;1;0;2;1;0;0;0;2;0;1;2;3138;0;0;1;0;0;2;2;3138;0;4157;2;1;
/org.eclipse.team.core/src/org/eclipse/team/core/subscribers/RefreshOperation.java;1;0;1;1;0;0;0;1;0;0;1;3193;0;0;1;0;0;1;1;3193;0;3193;1;1;
/org.eclipse.team.cvs.ui/src/org/eclipse/team/internal/ccvs/ui/CommitCommentArea.java;2;1;10;1;5;5;5;5;43;1;5;990;118;118;1;0;0;5;10;990;0;6337;10;2;
/org.eclipse.jdt.core.tests.model/workspace/Converter/src/javadoc/testBug51476/X2.java;1;0;1;1;0;0;0;1;0;0;1;3994;0;0;1;0;0;1;1;3994;0;3994;1;1;
/org.eclipse.jdt.ui/ui/org/eclipse/jdt/internal/ui/text/spelling/JavaDocTagDictionary.java;2;0;2;1;1;1;1;1;2;0;1;3930;2;2;1;0;0;1;2;3930;0;6340;2;2;
/org.eclipse.ui.ide/src/org/eclipse/ui/internal/dialogs/BuildOrderPreferencePage.java;2;0;3;1;0;0;0;3;24;1;3;1526;24;24;1;0;0;3;3;1526;0;2263;3;2;
/org.eclipse.jdt.ui.tests.refactoring/resources/ExtractMethodWorkSpace/ExtractMethodTests/branch_out/A_test750.java;1;0;4;1;0;0;0;4;6;1;4;844;6;6;1;0;0;4;4;844;0;2256;4;1;
/org.eclipse.jdt.core.tests.model/workspace/Formatter/test133/A_in.java;1;0;1;1;0;0;0;1;0;0;1;2425;0;0;1;0;0;1;1;2425;0;2425;1;1;
/org.eclipse.help.ui/src/org/eclipse/help/ui/internal/workingset/HelpWorkingSetElementLabelProvider.java;1;0;1;1;0;0;0;1;0;0;1;2732;0;0;1;0;0;1;1;2732;0;2732;1;1;
/org.eclipse.jdt.ui.tests.refactoring/resources/MoveMembers/test28/out/B.java;1;0;1;1;0;0;0;1;0;0;1;1522;0;0;1;0;0;1;1;1522;0;1522;1;1;
/org.eclipse.ui.workbench/Eclipse UI/org/eclipse/ui/internal/registry/WorkingSetRegistryReader.java;3;0;3;1;1;1;1;2;14;1;2;3500;18;18;1;0;0;2;3;3500;0;6338;3;3;
/org.eclipse.jdt.ui/ui/org/eclipse/jdt/internal/ui/text/java/OverrideCompletionProposal.java;2;1;2;1;2;2;2;0;2;0;0;5483;2;2;1;0;0;0;2;5483;0;6340;2;2;
/org.eclipse.jdt.ui/ui/org/eclipse/jdt/ui/search/IMatchPresentation.java;2;2;5;1;5;4;5;0;16;0;0;5183;34;34;2;0;1;0;5;6310;1;6334;4;2;
/org.eclipse.team.ui/src/org/eclipse/team/internal/ui/synchronize/DiffNodeWorkbenchAdapter.java;1;0;5;1;1;1;1;4;64;1;4;4077;76;76;1;0;0;4;5;4077;0;6337;5;1;
/org.eclipse.ant.ui/Ant Editor/org/eclipse/ant/internal/ui/editor/formatter/XmlTagFormatter.java;1;1;4;1;3;3;3;1;18;0;1;4583;33;33;1;0;0;1;4;4583;0;5865;4;1;
/org.eclipse.search/search/org/eclipse/search/internal/core/text/AmountOfWorkCalculator.java;2;1;2;1;2;2;2;0;16;0;0;5873;18;18;1;0;0;0;2;5873;0;6340;2;2;
/org.eclipse.team.ui/src/org/eclipse/team/internal/ui/sync/compare/SyncInfoDiffNode.java;2;0;4;1;0;0;0;4;78;1;4;488;137;137;1;0;0;4;4;488;0;2632;4;2;
/org.eclipse.team.core/src/org/eclipse/team/core/ResourceVariantCache.java;1;0;1;1;0;0;0;1;0;0;1;4084;0;0;1;0;0;1;1;4084;0;4084;1;1;
/org.eclipse.jdt.ui/ui/org/eclipse/jdt/internal/ui/search/JavaElementLine.java;1;0;1;1;0;0;0;1;0;0;1;4888;0;0;1;0;0;1;1;4888;0;4888;1;1;
/org.eclipse.jdt.core/model/org/eclipse/jdt/core/util/IRuntimeVisibleParameterAnnotationsAttribute.java;2;0;2;1;0;0;0;2;36;1;2;4466;36;36;1;0;0;2;2;4466;0;4843;2;2;
/org.eclipse.jdt.core.tests.model/workspace/JavaSearch/src/c10/X.java;1;0;1;1;0;0;0;1;0;0;1;2134;0;0;1;0;0;1;1;2134;0;2134;1;1;
/org.eclipse.swt/Eclipse SWT/win32/org/eclipse/swt/widgets/MenuItem.java;4;1;17;1;7;7;7;10;49;1;10;268;297;297;1;0;0;10;17;268;0;6352;17;4;
/org.eclipse.jdt.ui/ui/org/eclipse/jdt/internal/ui/text/comment/SingleCommentLine.java;2;0;7;1;1;1;1;6;58;1;6;1589;148;148;1;0;0;6;7;1589;0;6340;7;2;
/org.eclipse.jdt.ui/ui/org/eclipse/jdt/internal/ui/dnd/LocalSelectionTransfer.java;1;1;2;1;2;2;2;0;16;0;0;5530;16;16;1;0;0;0;2;5530;0;5682;2;1;
/org.eclipse.swt/Eclipse SWT Program/gnome/org/eclipse/swt/internal/gnome/GnomeVFSMimeApplication.java;2;0;2;1;1;1;1;1;2;0;1;4333;2;2;1;0;0;1;2;4333;0;6352;2;2;
/org.eclipse.ui.examples.job/org/eclipse/ui/examples/jobs/actions/JobAction.java;1;0;2;1;2;1;2;0;0;0;0;5125;0;0;2;0;1;0;2;5125;1;5125;1;1;
/org.eclipse.jdt.ui.tests.refactoring/resources/ExtractMethodWorkSpace/ExtractMethodTests/locals_in/A_test533.java;1;0;1;1;0;0;0;1;2;0;1;844;2;2;1;0;0;1;1;844;0;844;1;1;
/org.eclipse.ui.workbench/Eclipse UI/org/eclipse/ui/internal/activities/ws/EnablementDialog.java;1;1;2;1;2;2;2;0;149;0;0;5269;149;149;1;0;0;0;2;5269;0;5354;2;1;
/org.eclipse.debug.core/core/org/eclipse/debug/internal/core/SimpleVariableRegistry.java;1;0;9;1;0;0;0;9;50;3;6;550;149;149;3;3;0;9;9;616;3;754;6;1;
/org.eclipse.ui.intro/src/org/eclipse/ui/intro/internal/html/HTMLUtil.java;1;0;2;1;1;1;1;1;0;0;1;4429;0;0;1;0;0;1;2;4429;0;5115;2;1;
/org.eclipse.swt/Eclipse SWT/carbon/org/eclipse/swt/widgets/Decorations.java;5;1;8;1;3;3;3;5;61;1;5;110;116;116;1;0;0;5;8;110;0;6352;8;5;
/org.eclipse.jdt.core.tests.model/workspace/Converter15/src/test0012/X.java;1;0;1;1;0;0;0;1;0;0;1;4655;0;0;1;0;0;1;1;4655;0;4655;1;1;
/org.eclipse.jface/src/org/eclipse/jface/wizard/WizardSelectionPage.java;1;0;1;1;0;0;0;1;2;0;1;1950;2;2;1;0;0;1;1;1950;0;1950;1;1;
/org.eclipse.swt.tests/JUnit Tests/org/eclipse/swt/tests/junit/Test_org_eclipse_swt_custom_PopupList.java;1;0;1;1;0;0;0;1;6;0;1;2104;6;6;1;0;0;1;1;2104;0;2104;1;1;
/org.eclipse.core.tools.resources/src/org/eclipse/core/tools/metadata/SyncInfoSnapshotDumper.java;1;0;1;1;1;1;1;0;0;0;0;6302;0;0;1;0;0;0;1;6302;0;6302;1;1;
/org.eclipse.team.ui/src/org/eclipse/team/internal/ui/sync/sets/SyncInfoStatistics.java;1;0;4;1;0;0;0;4;107;1;4;1339;111;111;1;0;0;4;4;1339;0;2632;4;1;
/org.eclipse.jdt.core.tests.model/workspace/Formatter/test265/A_in.java;1;0;1;1;0;0;0;1;0;0;1;2442;0;0;1;0;0;1;1;2442;0;2442;1;1;
/org.eclipse.team.ui/src/org/eclipse/team/ui/synchronize/ISynchronizeConfiguration.java;1;0;1;1;0;0;0;1;0;0;1;4982;0;0;1;0;0;1;1;4982;0;4982;1;1;
/org.eclipse.ui.editors/src/org/eclipse/ui/texteditor/AnnotationTypeHierarchy.java;2;0;5;1;1;1;1;4;6;2;3;3217;8;8;2;1;0;4;5;3675;1;5177;4;2;
/org.eclipse.ui.workbench/Eclipse UI/org/eclipse/ui/internal/csm/roles/IRoleActivationServiceEvent.java;1;0;2;1;0;0;0;2;0;1;2;2213;0;0;1;0;0;2;2;2213;0;2225;2;1;
/org.eclipse.osgi/core/framework/org/eclipse/osgi/framework/internal/core/Framework.java;7;4;48;3;14;11;14;34;827;2;29;3013;2303;2303;4;5;3;34;48;5107;8;6228;40;7;
/org.eclipse.pde.ui/src/org/eclipse/pde/internal/ui/launcher/NewTracingPropertySource.java;3;1;4;1;2;2;2;2;12;1;2;4791;16;16;1;0;0;2;4;4791;0;6053;4;3;
/org.eclipse.core.tests.resources/src/org/eclipse/core/tests/internal/indexing/TestPagePolicy.java;1;0;1;1;1;1;1;0;6;0;0;5147;6;6;1;0;0;0;1;5147;0;5147;1;1;
/org.eclipse.pde.ui/src/org/eclipse/pde/internal/ui/wizards/templates/ViewTemplate.java;3;3;14;1;6;4;6;8;142;1;8;368;199;199;3;0;2;8;14;5204;2;6336;12;3;
/org.eclipse.jdt.ui.examples.javafamily/coresearch-experiment/org/eclipse/search/internal/core/InternalSearchQuery.java;2;0;3;1;0;0;0;3;2;1;3;1380;2;2;1;0;0;3;3;1380;0;3214;3;2;
/org.eclipse.jdt.core.tests.model/workspace/Formatter/test221/A_in.java;1;0;1;1;0;0;0;1;0;0;1;2426;0;0;1;0;0;1;1;2426;0;2426;1;1;
/org.eclipse.update.ui/src/org/eclipse/update/internal/ui/preferences/MainPreferencePage.java;3;1;12;2;3;3;3;9;228;3;6;460;621;621;3;3;0;9;12;962;3;6336;9;3;
/org.eclipse.pde.ui/sandbox/org/eclipse/pde/internal/ui/editor/standalone/parser/IProblemRequestor.java;1;0;2;1;0;0;0;2;0;1;2;2320;0;0;1;0;0;2;2;2320;0;2931;2;1;
/org.eclipse.pde.ui/src/org/eclipse/pde/internal/ui/editor/TreeSection.java;1;1;2;1;2;2;2;0;16;0;0;5431;20;20;1;0;0;0;2;5431;0;6336;2;1;
/org.eclipse.ui.intro/src/org/eclipse/ui/intro/internal/model/IntroPageTitle.java;1;0;3;1;1;1;1;2;14;1;2;4900;14;14;1;0;0;2;3;4900;0;5115;3;1;
/org.eclipse.jdt.core/model/org/eclipse/jdt/internal/compiler/parser/SourceTypeConverter.java;3;1;3;1;2;2;2;1;8;0;1;4461;10;10;1;0;0;1;3;4461;0;6073;3;3;
/org.eclipse.core.resources/src/org/eclipse/core/internal/dtree/IDataFlattener.java;1;0;1;1;1;1;1;0;44;0;0;5146;44;44;1;0;0;0;1;5146;0;5146;1;1;
/org.eclipse.jdt.core.tests.model/workspace/Converter/test0470/A.java;1;0;2;1;0;0;0;2;0;1;2;393;0;0;1;0;0;2;2;393;0;3714;2;1;
/org.eclipse.jdt.ui.tests.refactoring/resources/InlineMethodWorkspace/TestCases/simple_out/TestFieldInitializer1.java;1;0;1;1;0;0;0;1;0;0;1;2281;0;0;1;0;0;1;1;2281;0;2281;1;1;
/org.eclipse.ant.tests.core/test plugin/org/eclipse/ant/tests/core/testplugin/ProjectHelper.java;1;0;3;1;0;0;0;3;3;1;3;253;7;7;1;0;0;3;3;253;0;1402;3;1;
/org.eclipse.team.cvs.ui/src/org/eclipse/team/internal/ccvs/ui/ConsolePreferencesPage.java;1;0;2;1;0;0;0;2;10;1;2;3944;10;10;1;0;0;2;2;3944;0;4609;2;1;
/org.eclipse.update.core/src/org/eclipse/update/internal/core/ConfiguredSite.java;3;3;16;1;5;3;5;11;222;2;10;890;569;569;3;1;2;11;16;5662;3;6336;13;3;
/org.eclipse.pde.core/src_OSGi/org/eclipse/pde/core/osgi/bundle/IBundlePluginBase.java;2;0;4;1;0;0;0;4;5;1;4;2247;9;9;1;0;0;4;4;2247;0;4203;4;2;
/org.eclipse.pde.ui/sandbox/org/eclipse/pde/internal/ui/editor/standalone/parser/IDocumentModelFactory.java;1;0;2;1;0;0;0;2;0;1;2;2320;0;0;1;0;0;2;2;2320;0;2931;2;1;
/org.eclipse.core.tests.resources/src/org/eclipse/core/tests/resources/regression/AllTests.java;1;1;5;1;5;5;5;0;34;0;0;5147;56;56;1;0;0;0;5;5147;0;5988;5;1;
/org.eclipse.team.webdav/src/org/eclipse/team/internal/ui/target/subscriber/ErrorHandler.java;2;0;3;1;1;1;1;2;208;1;2;3494;210;210;1;0;0;2;3;3494;0;6337;3;2;
/org.eclipse.jdt.core.tests.model/workspace/Converter/test0130/Test.java;1;0;1;1;0;0;0;1;0;0;1;3714;0;0;1;0;0;1;1;3714;0;3714;1;1;
/org.eclipse.jdt.ui.tests.refactoring/resources/IntroduceFactory/positive/differentArgs2_in.java;1;0;2;1;0;0;0;2;0;1;2;2846;0;0;1;0;0;2;2;2846;0;2862;2;1;
/org.eclipse.ui.ide/extensions/org/eclipse/ui/model/WorkbenchContentProvider.java;2;0;3;1;0;0;0;3;56;2;2;2611;58;58;2;1;0;3;3;2611;1;2914;2;2;
/org.eclipse.jface.text/src/org/eclipse/jface/text/templates/persistence/TemplateSet.java;2;0;10;2;1;1;1;9;25;2;8;4258;71;71;2;1;0;9;10;4627;1;5110;9;2;
/org.eclipse.jdt.core/model/org/eclipse/jdt/internal/core/util/ExceptionTableEntry.java;1;0;1;1;0;0;0;1;2;0;1;3560;2;2;1;0;0;1;1;3560;0;3560;1;1;
/org.eclipse.pde.core/src/org/eclipse/pde/internal/core/schema/SchemaInclude.java;3;1;4;1;2;2;2;2;8;1;2;4203;22;22;1;0;0;2;4;4203;0;6336;4;3;
/org.eclipse.team.ui/src/org/eclipse/team/internal/ui/sync/views/StatisticsCounterBar.java;1;0;3;1;0;0;0;3;240;1;3;1896;240;240;1;0;0;3;3;1896;0;2632;3;1;
/org.eclipse.ui.workbench/Eclipse UI/org/eclipse/ui/internal/ObjectActionContributorReader.java;3;0;3;1;1;1;1;2;7;1;2;3862;11;11;1;0;0;2;3;3862;0;6338;3;3;
/org.eclipse.core.runtime.osgi/src/org/eclipse/core/internal/jobs/JobQueue.java;1;0;2;1;0;0;0;2;6;1;2;3013;6;6;1;0;0;2;2;3013;0;3028;2;1;
/org.eclipse.pde.ui/src_Forms/org/eclipse/pde/internal/ui/model/IDocumentKey.java;2;1;5;1;5;5;5;0;10;0;0;5298;23;23;1;0;0;0;5;5298;0;6336;5;2;
/org.eclipse.jdt.core.tests.model/workspace/Converter/src/test0178/Test.java;1;0;1;1;0;0;0;1;0;0;1;3714;0;0;1;0;0;1;1;3714;0;3714;1;1;
/org.eclipse.team.webdav/src/org/eclipse/team/internal/webdav/core/TeamWebDavPlugin.java;2;0;6;1;1;1;1;5;30;1;5;993;55;55;1;0;0;5;6;993;0;6337;6;2;
/org.eclipse.jdt.core.tests.compiler/src/org/eclipse/jdt/core/tests/eval/SanityTestEvaluationContext.java;2;0;3;1;0;0;0;3;8;1;3;992;12;12;1;0;0;3;3;992;0;3560;3;2;
/org.eclipse.ui.workbench/Eclipse UI/org/eclipse/ui/internal/keys/OutOfOrderVerifyListener.java;2;0;4;1;1;1;1;3;14;1;3;3010;15;15;1;0;0;3;4;3010;0;6338;4;2;
/org.eclipse.jdt.ui.tests.refactoring/test cases/org/eclipse/jdt/ui/tests/refactoring/ExtractInterfaceTests.java;6;1;17;1;3;3;3;14;30;1;14;1008;155;155;1;0;0;14;17;1008;0;6340;17;6;
/org.eclipse.swt/Eclipse SWT PI/common_j2me/org/eclipse/swt/internal/Library.java;5;2;65;1;16;15;16;49;9;2;48;215;143;143;2;1;1;49;65;943;2;6364;63;5;
/org.eclipse.ui.workbench/Eclipse UI/org/eclipse/ui/keys/IKeyConfigurationEvent.java;1;0;2;1;0;0;0;2;0;1;2;1294;0;0;1;0;0;2;2;1294;0;1321;2;1;
/org.eclipse.jdt.debug.ui/ui/org/eclipse/jdt/internal/debug/core/refactoring/RefactoringMessages.java;2;0;2;1;1;1;1;1;11;0;1;4030;11;11;1;0;0;1;2;4030;0;6339;2;2;
/org.eclipse.jdt.ui.examples.javafamily/src/org/eclipse/jdt/internal/ui/examples/jspeditor/JavaReconcileStep.java;4;0;8;1;1;1;1;7;10;1;7;1629;43;43;1;0;0;7;8;1629;0;5177;8;4;
/org.eclipse.ant.ui/Ant Tools Support/org/eclipse/ant/ui/internal/launchConfigurations/AntStreamsProxy.java;1;0;4;1;0;0;0;4;8;1;4;250;9;9;1;0;0;4;4;250;0;1811;4;1;
/org.eclipse.ui.externaltools/Ant Tools Support/org/eclipse/ui/externaltools/internal/ant/view/actions/EditLaunchConfigurationAction.java;1;0;1;1;0;0;0;1;0;0;1;282;0;0;1;0;0;1;1;282;0;282;1;1;
/org.eclipse.pde/src/org/eclipse/pde/internal/builders/ValidatingSAXParser.java;1;0;4;1;1;1;1;3;75;1;3;2906;106;106;1;0;0;3;4;2906;0;6336;4;1;
/org.eclipse.ui.workbench/Eclipse UI/org/eclipse/ui/internal/presentations/PresentableViewPart.java;1;1;2;1;2;2;2;0;0;0;0;5517;0;0;1;0;0;0;2;5517;0;5805;2;1;
/org.eclipse.jdt.ui/core refactoring/org/eclipse/jdt/internal/corext/refactoring/participants/CompositeExpression.java;1;0;2;1;0;0;0;2;0;1;2;825;0;0;1;0;0;2;2;825;0;1033;2;1;
/org.eclipse.ui.externaltools/External Tools Base/org/eclipse/ui/externaltools/internal/model/ExternalToolsPlugin.java;3;1;9;1;3;3;3;6;30;1;6;282;123;123;1;0;0;6;9;282;0;6106;9;3;
/org.eclipse.ui.workbench/Eclipse UI/org/eclipse/ui/actions/ActionGroup.java;2;1;2;1;2;2;2;0;13;0;0;5141;15;15;1;0;0;0;2;5141;0;6338;2;2;
/org.eclipse.jdt.core.tests.model/workspace/Converter/src/test0563/A.java;1;0;1;1;1;1;1;0;0;0;0;6078;0;0;1;0;0;0;1;6078;0;6078;1;1;
/org.eclipse.ui.tests/Eclipse UI Tests/org/eclipse/ui/tests/dialogs/UIPreferences.java;2;0;2;1;0;0;0;2;4;1;2;2007;6;6;1;0;0;2;2;2007;0;2738;2;2;
/org.eclipse.update.core/src/org/eclipse/update/core/Import.java;3;1;5;1;3;3;3;2;6;1;2;0;21;21;1;0;0;2;5;0;0;6336;5;3;
/org.eclipse.pde.ui/src/org/eclipse/pde/internal/ui/editor/site/ArchiveForm.java;1;0;3;1;1;1;1;2;88;1;2;2311;88;88;1;0;0;2;3;2311;0;5431;3;1;
/org.eclipse.debug.core/core/org/eclipse/debug/internal/core/StreamsProxy.java;1;0;1;1;0;0;0;1;16;0;1;1932;16;16;1;0;0;1;1;1932;0;1932;1;1;
/org.eclipse.jdt.core.tests.model/workspace/Converter/test0208/Test.java;1;0;1;1;0;0;0;1;0;0;1;3714;0;0;1;0;0;1;1;3714;0;3714;1;1;
/org.eclipse.jdt.ui/ui/org/eclipse/jdt/ui/text/spelling/engine/IPhoneticDistanceAlgorithm.java;1;0;2;1;0;0;0;2;0;1;2;3829;0;0;1;0;0;2;2;3829;0;3930;2;1;
/org.eclipse.ui.workbench/Eclipse UI/org/eclipse/ui/internal/commands/registry/IKeyConfigurationDefinition.java;1;0;2;1;0;0;0;2;0;1;2;1422;0;0;1;0;0;2;2;1422;0;1724;2;1;
/org.eclipse.ui.views/src/org/eclipse/ui/views/internal/markers/ImageFactory.java;1;0;3;1;0;0;0;3;2;2;2;265;2;2;2;1;0;3;3;749;1;749;2;1;
/org.eclipse.swt/Eclipse SWT/common/org/eclipse/swt/internal/image/LZWCodec.java;3;0;4;1;1;1;1;3;15;1;3;4085;35;35;1;0;0;3;4;4085;0;6352;4;3;
/org.eclipse.jdt.core.tests.model/workspace/Converter/test0284/Test.java;1;0;1;1;0;0;0;1;0;0;1;3714;0;0;1;0;0;1;1;3714;0;3714;1;1;
/org.eclipse.ui.views/src/org/eclipse/ui/views/markers/internal/FieldCreationTime.java;2;0;2;1;0;0;0;2;0;1;2;755;0;0;1;0;0;2;2;755;0;2738;2;2;
/org.eclipse.jdt.ui/ui/org/eclipse/jdt/ui/actions/FindReadReferencesAction.java;2;0;2;1;1;1;1;1;5;0;1;3266;7;7;1;0;0;1;2;3266;0;6340;2;2;
/org.eclipse.jdt.ui.tests.refactoring/resources/ExtractMethodWorkSpace/ExtractMethodTests/locals_out/A_test530.java;1;0;1;1;0;0;0;1;4;0;1;844;4;4;1;0;0;1;1;844;0;844;1;1;
/org.eclipse.jdt.core/model/org/eclipse/jdt/internal/core/SourceField.java;2;1;12;1;2;2;2;10;56;2;8;916;117;117;2;2;0;10;12;1089;2;5614;10;2;
/org.eclipse.jdt.ui/core refactoring/org/eclipse/jdt/internal/corext/refactoring/code/flow/ForFlowInfo.java;1;0;1;1;1;1;1;0;2;0;0;6340;2;2;1;0;0;0;1;6340;0;6340;1;1;
/org.eclipse.ui.workbench/Eclipse UI/org/eclipse/ui/internal/PerspectiveControl.java;1;0;1;1;0;0;0;1;0;0;1;2733;0;0;1;0;0;1;1;2733;0;2733;1;1;
/org.eclipse.core.runtime/src/org/eclipse/core/runtime/jobs/JobChangeAdapter.java;3;0;8;1;1;1;1;7;132;1;7;688;354;354;1;0;0;7;8;688;0;5150;8;3;
/org.eclipse.pde.ui/src/org/eclipse/pde/internal/ui/wizards/WizardNode.java;2;1;2;1;2;2;2;0;6;0;0;5783;10;10;1;0;0;0;2;5783;0;6336;2;2;
/org.eclipse.ui.workbench/Eclipse UI/org/eclipse/ui/internal/commands/api/older/ICommandListener.java;1;0;2;1;0;0;0;2;0;0;1;2562;0;0;2;1;0;2;2;2562;1;2562;1;1;
/org.eclipse.jdt.ui.tests.refactoring/resources/InlineMethodWorkspace/TestCases/nameconflict_in/TestLocalInType.java;1;0;1;1;0;0;0;1;2;0;1;845;2;2;1;0;0;1;1;845;0;845;1;1;
/org.eclipse.team.cvs.ui/src/org/eclipse/team/internal/ccvs/ui/subscriber/MergeUpdateAction.java;2;1;24;1;2;2;2;22;327;2;19;709;1076;1076;2;3;0;22;24;1132;3;6337;21;2;
/org.eclipse.team.cvs.ui/src/org/eclipse/team/internal/ccvs/ui/WorkingSetSelectionArea.java;2;0;6;1;1;1;1;5;13;1;5;280;39;39;1;0;0;5;6;280;0;6337;6;2;
/org.eclipse.jdt.ui/ui/org/eclipse/jdt/internal/ui/search/JavaSearchTableContentProvider.java;2;1;6;1;4;4;4;2;37;1;2;3711;59;59;1;0;0;2;6;3711;0;6340;6;2;
/org.eclipse.ui.workbench/Eclipse UI/org/eclipse/ui/internal/commands/util/old/GestureSupport.java;1;0;3;1;0;0;0;3;22;2;2;1222;22;22;2;1;0;3;3;1321;1;1321;2;1;
/org.eclipse.jdt.core.tests.model/workspace/Formatter/test181/A_in.java;1;0;1;1;0;0;0;1;0;0;1;2425;0;0;1;0;0;1;1;2425;0;2425;1;1;
/org.eclipse.jdt.core.tests.model/workspace/Converter/test0085/Test.java;1;0;1;1;0;0;0;1;0;0;1;3714;0;0;1;0;0;1;1;3714;0;3714;1;1;
/org.eclipse.core.resources/src/org/eclipse/core/internal/dtree/DataDeltaNode.java;1;0;2;1;2;1;2;0;202;0;0;5146;202;202;2;0;1;0;2;5146;1;5146;1;1;
/org.eclipse.jdt.ui.tests.refactoring/resources/ChangeTypeRefactoring/positive/A_testFieldDeclSubtypesOfList_in.java;1;0;1;1;0;0;0;1;0;0;1;2844;0;0;1;0;0;1;1;2844;0;2844;1;1;
/org.eclipse.jdt.debug.ui/ui/org/eclipse/jdt/internal/debug/ui/launcher/StandardVMCommandTab.java;1;0;1;1;0;0;0;1;0;0;1;1136;0;0;1;0;0;1;1;1136;0;1136;1;1;
/org.eclipse.jdt.ui/core refactoring/org/eclipse/jdt/internal/corext/refactoring/base/JavaStringStatusContext.java;2;0;4;1;1;1;1;3;9;1;3;882;12;12;1;0;0;3;4;882;0;6340;4;2;
/org.eclipse.ui.intro/src/org/eclipse/ui/intro/internal/model/AbstractIntroPartImplementation.java;1;0;3;1;1;1;1;2;2;1;2;4609;2;2;1;0;0;2;3;4609;0;5115;3;1;
/org.eclipse.ui.workbench/Eclipse UI/org/eclipse/ui/IActionBars.java;1;0;1;1;0;0;0;1;2;0;1;1;2;2;1;0;0;1;1;1;0;1;1;1;
/org.eclipse.ui.ide/src/org/eclipse/ui/views/navigator/FilterSelectionAction.java;1;0;1;1;0;0;0;1;0;0;1;2208;0;0;1;0;0;1;1;2208;0;2208;1;1;
/org.eclipse.core.tests.resources/src/org/eclipse/core/tests/resources/usecase/IWorkspaceRunnableUseCaseTest.java;1;2;3;1;3;2;3;0;165;0;0;5147;168;168;2;0;1;0;3;5147;1;5998;2;1;
/org.eclipse.ltk.ui.refactoring/src/org/eclipse/ltk/internal/ui/refactoring/AssertionFailedException.java;1;0;3;1;1;1;1;2;5;1;2;4965;7;7;1;0;0;2;3;4965;0;6340;3;1;
/org.eclipse.ltk.core.refactoring/src/org/eclipse/ltk/core/refactoring/RefactoringCore.java;1;1;5;1;2;2;2;3;21;1;3;4845;43;43;1;0;0;3;5;4845;0;5190;5;1;
/org.eclipse.ui.workbench/Eclipse UI/org/eclipse/ui/internal/registry/NavigatorAbstractContentDescriptor.java;1;0;1;1;0;0;0;1;0;0;1;1014;0;0;1;0;0;1;1;1014;0;1014;1;1;
/org.eclipse.jdt.core.tests.model/workspace/Formatter/test415/A_out.java;1;0;2;1;0;0;0;2;5;1;2;3460;5;5;1;0;0;2;2;3460;0;4994;2;1;
/org.eclipse.pde.runtime/src/org/eclipse/pde/internal/runtime/registry/ExtensionPropertySource.java;2;1;5;1;2;2;2;3;96;1;3;924;211;211;1;0;0;3;5;924;0;6336;5;2;
/org.eclipse.ui.intro/src/org/eclipse/ui/internal/intro/impl/model/StandbyPartContent.java;1;1;3;1;3;3;3;0;6;0;0;5115;6;6;1;0;0;0;3;5115;0;5305;3;1;
/org.eclipse.jdt.core.tests.model/workspace/Converter/test0118/Test.java;1;0;1;1;0;0;0;1;0;0;1;3714;0;0;1;0;0;1;1;3714;0;3714;1;1;
/org.eclipse.pde.ui/src/org/eclipse/pde/internal/ui/wizards/project/ConvertedProjectsPage.java;1;0;9;1;0;0;0;9;131;1;9;368;174;174;1;0;0;9;9;368;0;3839;9;1;
/org.eclipse.jface/src/org/eclipse/jface/preference/ColorSelector.java;3;2;6;2;3;2;3;3;108;1;3;1338;293;293;2;0;1;3;6;6338;1;6338;5;3;
/org.eclipse.ui.ide/src/org/eclipse/ui/internal/dialogs/InternalBase64Encoder.java;2;0;2;1;0;0;0;2;0;1;2;1526;0;0;1;0;0;2;2;1526;0;2263;2;2;
/org.eclipse.jdt.core.tests.model/workspace/Formatter/test101/A_in.java;1;0;1;1;0;0;0;1;0;0;1;2425;0;0;1;0;0;1;1;2425;0;2425;1;1;
/org.eclipse.ui.views/src/org/eclipse/ui/views/navigator/GotoResourceAction.java;1;0;1;1;0;0;0;1;0;0;1;2738;0;0;1;0;0;1;1;2738;0;2738;1;1;
/org.eclipse.search.tests/src/org/eclipse/search/core/tests/AllSearchModelTests.java;1;0;2;1;1;1;1;1;1;0;1;4345;1;1;1;0;0;1;2;4345;0;5852;2;1;
/org.eclipse.team.webdav/src/org/eclipse/team/internal/ui/target/subscriber/ExportWizard.java;2;1;5;1;2;2;2;3;171;1;3;3494;187;187;1;0;0;3;5;3494;0;6337;5;2;
/org.eclipse.ui.cheatsheets/src/org/eclipse/ui/internal/cheatsheets/data/Intro.java;1;0;1;1;1;1;1;0;0;0;0;5189;0;0;1;0;0;0;1;5189;0;5189;1;1;
/org.eclipse.ant.tests.ui/Ant Tests/org/eclipse/ant/tests/ui/separateVM/SeparateVMTests.java;1;1;17;1;2;2;2;15;41;3;11;1796;162;162;3;4;0;15;17;2085;4;5700;13;1;
/org.eclipse.jdt.ui/core extension/org/eclipse/jdt/internal/corext/textmanipulation/IllegalEditException.java;2;0;3;1;0;0;0;3;5;1;3;1875;5;5;1;0;0;3;3;1875;0;1946;3;2;
/org.eclipse.ui.workbench.texteditor/src/org/eclipse/ui/texteditor/StatusTextEditor.java;2;0;3;1;1;1;1;2;20;1;2;2580;29;29;1;0;0;2;3;2580;0;6340;3;2;
/org.eclipse.swt/Eclipse SWT/win32/org/eclipse/swt/widgets/Scrollable.java;2;1;3;1;2;2;2;1;4;0;1;268;12;12;1;0;0;1;3;268;0;6352;3;2;
/org.eclipse.ui.workbench/Eclipse UI/org/eclipse/ui/internal/commands/ActionServiceEvent.java;1;0;5;1;0;0;0;5;8;2;4;1419;10;10;2;1;0;5;5;2562;1;3129;4;1;
/org.eclipse.jface.text/src/org/eclipse/jface/text/formatter/FormattingContext.java;2;0;3;1;1;1;1;2;132;1;2;1998;138;138;1;0;0;2;3;1998;0;6340;3;2;
/org.eclipse.pde.ui/src/org/eclipse/pde/internal/ui/wizards/feature/OpenProjectWizardAction.java;3;1;4;1;4;4;4;0;10;0;0;5387;18;18;1;0;0;0;4;5387;0;6336;4;3;
/org.eclipse.webdav/src/kernel/org/eclipse/webdav/internal/kernel/Status.java;1;0;2;1;2;1;2;0;155;0;0;5151;155;155;2;0;1;0;2;5151;1;5151;1;1;
/org.eclipse.ui.forms/src/org/eclipse/ui/internal/forms/widgets/FormTextModel.java;1;1;4;1;3;3;3;1;68;0;1;5044;85;85;1;0;0;1;4;5044;0;6336;4;1;
/org.eclipse.ui.tests/Eclipse UI Tests/org/eclipse/ui/tests/zoom/ZoomTestCase.java;4;1;6;1;2;2;2;4;23;1;4;2624;40;40;1;0;0;4;6;2624;0;6338;6;4;
/org.eclipse.jdt.core.tests.model/workspace/Formatter/test445/A_out.java;1;0;2;1;0;0;0;2;2;1;2;3513;2;2;1;0;0;2;2;3513;0;4994;2;1;
/org.eclipse.update.core/src/org/eclipse/update/operations/IUnconfigFeatureOperation.java;1;2;8;1;3;2;3;5;13;2;4;825;22;22;2;1;1;5;8;825;2;6336;6;1;
/org.eclipse.core.resources/src/org/eclipse/core/internal/resources/ProjectDescriptionReader.java;3;1;7;1;2;2;2;5;41;1;5;1477;95;95;1;0;0;5;7;1477;0;5168;7;3;
/org.eclipse.jdt.core.tests.compiler/src/org/eclipse/jdt/core/tests/util/SocketHelper.java;1;0;1;1;0;0;0;1;0;0;1;2007;0;0;1;0;0;1;1;2007;0;2007;1;1;
/org.eclipse.compare.examples.xml/tests/org/eclipse/compare/examples/xml/TestMinCostBipartiteMatching.java;1;0;4;1;0;0;0;4;2;1;4;1106;3;3;1;0;0;4;4;1106;0;4711;4;1;
/org.eclipse.jdt.ui/core refactoring/org/eclipse/jdt/internal/corext/refactoring/base/ICompositeChange.java;1;0;1;1;0;0;0;1;0;0;1;3930;0;0;1;0;0;1;1;3930;0;3930;1;1;
/org.eclipse.osgi/resolver/src/org/eclipse/osgi/internal/resolver/StateObjectFactoryImpl.java;4;1;14;1;5;5;5;9;67;1;9;3013;258;258;1;0;0;9;14;3013;0;5536;14;4;
/org.eclipse.update.core/srcnew/org/eclipse/update/operations/IToggleSiteOperation.java;1;0;2;1;0;0;0;2;0;1;2;602;0;0;1;0;0;2;2;602;0;825;2;1;
/org.eclipse.osgi/supplement/src/org/eclipse/osgi/framework/internal/reliablefile/ReliableFile.java;5;1;8;1;4;4;4;4;940;1;4;3013;1429;1429;1;0;0;4;8;3013;0;5507;8;5;
/org.eclipse.ui.workbench/Eclipse UI/org/eclipse/ui/internal/dialogs/SelectPerspectiveDialog.java;5;1;10;2;2;2;2;8;326;2;7;1952;605;605;2;1;0;8;10;3061;1;6338;9;5;
/org.eclipse.jdt.core.tests.model/src/org/eclipse/jdt/core/tests/rewrite/modifying/ASTRewritingModifyingRemoveTest.java;2;0;2;1;1;1;1;1;7;0;1;4711;7;7;1;0;0;1;2;4711;0;5853;2;2;
/org.eclipse.ant.ui/Ant Editor/org/eclipse/ant/ui/internal/editor/text/NonRuleBasedDamagerRepairer.java;1;0;2;1;0;0;0;2;0;1;2;250;0;0;1;0;0;2;2;250;0;1811;2;1;
/org.eclipse.swt.opengl.examples/src/org/eclipse/swt/opengl/examples/BezierTab.java;1;0;1;1;0;0;0;1;0;0;1;1175;0;0;1;0;0;1;1;1175;0;1175;1;1;
/org.eclipse.swt.tests/JUnit Tests/org/eclipse/swt/tests/junit/Test_org_eclipse_swt_events_ModifyListener.java;1;0;1;1;0;0;0;1;16;0;1;2175;16;16;1;0;0;1;1;2175;0;2175;1;1;
/org.eclipse.jdt.core.tests.model/workspace/Formatter/test003/A_in.java;1;0;1;1;0;0;0;1;0;0;1;2425;0;0;1;0;0;1;1;2425;0;2425;1;1;
/org.eclipse.ui.workbench/Eclipse UI/org/eclipse/ui/internal/csm/commands/CommandDefinition.java;1;0;4;1;0;0;0;4;72;2;3;2515;72;72;2;1;0;4;4;2532;1;2562;3;1;
/org.eclipse.update.ui/src/org/eclipse/update/internal/ui/forms/ExtensionRootForm.java;1;0;1;1;0;0;0;1;0;0;1;755;0;0;1;0;0;1;1;755;0;755;1;1;
/org.eclipse.ui.workbench/Eclipse UI/org/eclipse/ui/activities/IActivityServiceListener.java;1;0;5;1;0;0;0;5;21;2;4;2491;21;21;2;1;0;5;5;2800;1;2896;4;1;
/org.eclipse.pde.runtime/src/org/eclipse/pde/internal/runtime/logview/EventDetailsDialogAction.java;2;1;5;1;3;3;3;2;31;1;2;4212;43;43;1;0;0;2;5;4212;0;6336;5;2;
/org.eclipse.help.tests/src/org/eclipse/help/tests/livehelp/TestAction.java;1;1;2;1;2;2;2;0;6;0;0;5827;8;8;1;0;0;0;2;5827;0;6337;2;1;
/org.eclipse.core.tests.runtime/src/org/eclipse/core/tests/internal/runtimetests/SampleCPB.java;1;0;1;1;1;1;1;0;19;0;0;5149;19;19;1;0;0;0;1;5149;0;5149;1;1;
/org.eclipse.core.runtime/src/org/eclipse/core/internal/runtime/NoDataArea.java;3;0;3;1;0;0;0;3;11;1;3;3677;11;11;1;0;0;3;3;3677;0;4113;3;3;
/org.eclipse.debug.ui/ui/org/eclipse/debug/internal/ui/stringsubstitution/ProjectResolver.java;2;0;3;1;0;0;0;3;16;1;3;2046;20;20;1;0;0;3;3;2046;0;2447;3;2;
/org.eclipse.ui.externaltools/External Tools Base/org/eclipse/ui/externaltools/internal/model/ColorManager.java;1;0;1;1;0;0;0;1;0;0;1;282;0;0;1;0;0;1;1;282;0;282;1;1;
/org.eclipse.jdt.core.tests.model/workspace/Formatter/test303/A_in.java;1;0;1;1;0;0;0;1;0;0;1;2442;0;0;1;0;0;1;1;2442;0;2442;1;1;
/org.eclipse.jdt.ui.tests.refactoring/resources/ExtractMethodWorkSpace/ExtractMethodTests/locals_out/A_test509.java;1;0;2;1;0;0;0;2;6;1;2;130;7;7;1;0;0;2;2;130;0;844;2;1;
/org.eclipse.pde.ui/src/org/eclipse/pde/internal/ui/launcher/JUnitWorkbenchShortcut.java;2;1;11;1;2;2;2;9;68;1;9;1549;205;205;1;0;0;9;11;1549;0;5782;11;2;
/org.eclipse.ui.forms/src/org/eclipse/ui/internal/forms/widgets/TextSegment.java;1;0;2;1;1;1;1;1;4;0;1;5044;4;4;1;0;0;1;2;5044;0;6336;2;1;
/org.eclipse.jdt.ui/ui refactoring/org/eclipse/jdt/internal/ui/refactoring/ChangeElementLabelProvider.java;1;0;4;1;0;0;0;4;13;1;4;3930;20;20;1;0;0;4;4;3930;0;4965;4;1;
/org.eclipse.jdt.ui.tests.refactoring/resources/ChangeSignature/canModify/A_testImport02_out.java;1;0;1;1;0;0;0;1;0;0;1;3820;0;0;1;0;0;1;1;3820;0;3820;1;1;
/org.eclipse.jdt.ui/ui/org/eclipse/jdt/internal/ui/search/JavaSearchTreeContentProvider2.java;1;0;2;1;0;0;0;2;0;1;2;4045;0;0;1;0;0;2;2;4045;0;4625;2;1;
/org.eclipse.jdt.ui/ui/org/eclipse/jdt/internal/ui/search/ParentNameSorter.java;3;1;3;1;2;2;2;1;35;0;1;3251;39;39;1;0;0;1;3;3251;0;6340;3;3;
/org.eclipse.jdt.ui.tests.refactoring/resources/Delete/testDeleteWithinCu16/in/A.java;1;0;1;1;0;0;0;1;0;0;1;442;0;0;1;0;0;1;1;442;0;442;1;1;
/org.eclipse.team.ui/src/org/eclipse/team/internal/ui/synchronize/sets/SubscriberInputSyncInfoSetExtension.java;1;0;1;1;0;0;0;1;0;0;1;3518;0;0;1;0;0;1;1;3518;0;3518;1;1;
/org.eclipse.ui.workbench/Eclipse UI/org/eclipse/ui/internal/dialogs/WorkbenchDialogBlockedHandler.java;1;1;4;1;4;4;4;0;34;0;0;5363;58;58;1;0;0;0;4;5363;0;6012;4;1;
/org.eclipse.jdt.core/model/org/eclipse/jdt/internal/core/CreateTypeMemberOperation.java;3;0;6;1;1;1;1;5;23;1;5;377;43;43;1;0;0;5;6;377;0;5584;6;3;
/org.eclipse.jdt.core.tests.model/workspace/Formatter/test092/A_in.java;1;0;1;1;0;0;0;1;0;0;1;2425;0;0;1;0;0;1;1;2425;0;2425;1;1;
/org.eclipse.ui.workbench/Eclipse UI/org/eclipse/ui/internal/ShortcutBarPart.java;2;0;2;1;0;0;0;2;2;1;2;2737;2;2;1;0;0;2;2;2737;0;4015;2;2;
/org.eclipse.jdt.debug.tests/tests/org/eclipse/jdt/debug/tests/eval/IntAssignmentOperatorsTests.java;1;0;1;1;0;0;0;1;130;0;1;1274;130;130;1;0;0;1;1;1274;0;1274;1;1;
/org.eclipse.swt/Eclipse SWT Drag and Drop/carbon/org/eclipse/swt/dnd/ByteArrayTransfer.java;1;0;3;1;0;0;0;3;42;2;2;298;43;43;2;1;0;3;3;298;1;316;2;1;
/org.eclipse.team.ui/src/org/eclipse/team/ui/synchronize/viewers/SyncInfoSetViewerInput.java;1;0;1;1;0;0;0;1;0;0;1;3987;0;0;1;0;0;1;1;3987;0;3987;1;1;
/org.eclipse.ui.workbench/Eclipse UI/org/eclipse/ui/internal/commands/CompoundCommandHandlerService.java;3;0;7;2;0;0;0;7;59;2;6;3131;129;129;2;1;0;7;7;3170;1;4144;6;3;
/org.eclipse.pde.ui/src/org/eclipse/pde/internal/ui/editor/PDEMultiSelectionProvider.java;1;0;2;1;1;1;1;1;4;0;1;690;4;4;1;0;0;1;2;690;0;5431;2;1;
/org.eclipse.help.ui/src/org/eclipse/help/ui/internal/browser/embedded/EmbeddedBrowserFactory.java;1;1;14;1;4;4;4;10;51;2;9;2898;119;119;2;1;0;10;14;3018;1;6337;13;1;
/org.eclipse.help.webapp/src_servlets/org/eclipse/help/internal/webapp/servlet/WebappWorkingSetManager.java;1;1;10;1;3;3;3;7;117;2;6;364;205;205;2;1;0;7;10;4974;1;6337;9;1;
/org.eclipse.sdk.tests-feature/plugins/org.eclipse.perfmsr.ui.client/src/org/eclipse/perfmsr/ui/client/Values.java;1;1;2;1;2;2;2;0;10;0;0;5443;10;10;1;0;0;0;2;5443;0;5513;2;1;
/org.eclipse.swt.tests/JUnit Tests/org/eclipse/swt/tests/junit/Test_org_eclipse_swt_custom_CCombo.java;2;0;2;1;0;0;0;2;48;1;2;2104;86;86;1;0;0;2;2;2104;0;3373;2;2;
/org.eclipse.jdt.core.tests.model/workspace/Converter/test0251/Test.java;1;0;1;1;0;0;0;1;0;0;1;3714;0;0;1;0;0;1;1;3714;0;3714;1;1;
/org.eclipse.jdt.ui/ui/org/eclipse/jdt/internal/ui/preferences/SearchParticipantsPreferencePage.java;4;1;8;1;6;6;6;2;10;0;1;5075;39;39;2;1;0;2;8;5075;1;5590;7;4;
/org.eclipse.jdt.ui/core refactoring/org/eclipse/jdt/internal/corext/refactoring/changes/TextChangeCompatibility.java;1;0;3;1;0;0;0;3;4;1;3;3646;5;5;1;0;0;3;3;3646;0;4624;3;1;
/org.eclipse.jdt.core.tests.model/workspace/Converter/src/javadoc/test102/TestB1.java;1;0;1;1;0;0;0;1;0;0;1;4390;0;0;1;0;0;1;1;4390;0;4390;1;1;
/org.eclipse.ui.workbench/Eclipse UI/org/eclipse/ui/commands/IHandlerServiceListener.java;1;0;3;1;0;0;0;3;10;1;3;1065;10;10;1;0;0;3;3;1065;0;1222;3;1;
/org.eclipse.jdt.core.tests.model/workspace/Formatter/test060/Parser_in.java;1;0;1;1;0;0;0;1;0;0;1;2425;0;0;1;0;0;1;1;2425;0;2425;1;1;
/org.eclipse.jdt.ui.tests.refactoring/resources/UseSupertypeWherePossible/testNew14/in/B.java;1;0;1;1;0;0;0;1;2;0;1;1166;2;2;1;0;0;1;1;1166;0;1166;1;1;
/org.eclipse.jdt.core.tests.model/workspace/Formatter/test244/A_in.java;1;0;1;1;0;0;0;1;0;0;1;2437;0;0;1;0;0;1;1;2437;0;2437;1;1;
/org.eclipse.team.cvs.core/src/org/eclipse/team/internal/ccvs/core/ICVSResource.java;1;0;2;1;0;0;0;2;11;1;2;2002;16;16;1;0;0;2;2;2002;0;2100;2;1;
/org.eclipse.ui.workbench/Eclipse UI/org/eclipse/ui/internal/presentations/SystemMenuMovePane.java;1;1;3;1;3;3;3;0;3;0;0;5173;5;5;1;0;0;0;3;5173;0;5805;3;1;
/org.eclipse.jdt.debug.tests/test plugin/org/eclipse/jdt/debug/testplugin/SampleContextVariableResolver.java;1;0;2;1;0;0;0;2;0;1;2;2032;0;0;1;0;0;2;2;2032;0;2140;2;1;
/org.eclipse.search/new search/org/eclipse/search2/internal/ui/text/RemoveAllEvent.java;1;0;2;1;0;0;0;2;0;1;2;3474;0;0;1;0;0;2;2;3474;0;3711;2;1;
/org.eclipse.jdt.ui.tests.refactoring/resources/MoveInstanceMethod/canMove/test23/out/A.java;1;0;1;1;0;0;0;1;0;0;1;1603;0;0;1;0;0;1;1;1603;0;1603;1;1;
/org.eclipse.jdt.core.tests.model/workspace/Converter/src/junit/awtui/ProgressBar.java;1;0;1;1;0;0;0;1;0;0;1;3714;0;0;1;0;0;1;1;3714;0;3714;1;1;
/org.eclipse.core.filebuffers/src/org/eclipse/core/internal/filebuffers/JavaFileBuffer.java;3;2;7;2;3;2;3;4;20;1;4;2224;40;40;2;0;1;4;7;5504;1;6340;6;3;
/org.eclipse.update.core/src/org/eclipse/update/internal/mirror/MirrorCommand.java;2;1;12;1;2;2;2;10;55;1;10;1566;178;178;1;0;0;10;12;1566;0;6336;12;2;
/org.eclipse.help.webapp/src_servlets/org/eclipse/help/internal/webapp/data/RequestData.java;1;1;8;1;3;3;3;5;38;1;5;95;85;85;1;0;0;5;8;95;0;6337;8;1;
/org.eclipse.ui.workbench/Eclipse UI/org/eclipse/ui/contexts/IContext.java;4;2;23;2;3;2;3;20;204;2;17;1119;652;652;2;3;1;20;23;1135;4;6338;19;4;
/org.eclipse.text/src/org/eclipse/text/edits/UndoEdit.java;2;0;4;1;1;1;1;3;14;1;3;2038;26;26;1;0;0;3;4;2038;0;6340;4;2;
/org.eclipse.jdt.core.tests.model/workspace/Resolve/src/ResolveDuplicateTypeDeclaration.java;1;0;1;1;1;1;1;0;0;0;0;6222;0;0;1;0;0;0;1;6222;0;6222;1;1;
/org.eclipse.jdt.ui.examples.javafamily/src/org/eclipse/jsp/copied_from_jdtcore/AddFileToIndex.java;1;0;3;1;0;0;0;3;5;1;3;1033;5;5;1;0;0;3;3;1033;0;3235;3;1;
/org.eclipse.ui.workbench/Eclipse UI/org/eclipse/ui/internal/util/OldConfigurationElementMemento.java;2;0;3;1;0;0;0;3;42;1;3;2405;43;43;1;0;0;3;3;2405;0;3170;3;2;
/org.eclipse.ui.workbench/Eclipse UI/org/eclipse/ui/internal/csm/roles/IRoleActivationService.java;1;0;2;1;0;0;0;2;0;1;2;2213;0;0;1;0;0;2;2;2213;0;2225;2;1;
/org.eclipse.jdt.debug/model/org/eclipse/jdt/internal/debug/core/model/JDIThread.java;5;2;35;3;7;5;7;28;132;3;23;173;638;638;3;5;2;28;35;2987;7;6336;28;5;
/org.eclipse.ui.workbench/Eclipse UI/org/eclipse/ui/internal/WorkbenchWindowContextActivationService.java;1;0;2;1;0;0;0;2;0;1;2;3066;0;0;1;0;0;2;2;3066;0;3109;2;1;
/org.eclipse.jdt.ui/core refactoring/org/eclipse/jdt/internal/corext/refactoring/participants/IDeleteParticipant.java;1;0;3;1;0;0;0;3;2;1;3;825;2;2;1;0;0;3;3;825;0;4624;3;1;
/org.eclipse.team.ui/src/org/eclipse/team/internal/ui/UIProjectSetSerializationContext.java;2;1;3;1;3;3;3;0;4;0;0;5362;7;7;1;0;0;0;3;5362;0;5923;3;2;
/org.eclipse.ui.ide/src/org/eclipse/ui/internal/dialogs/ResourceWorkingSetPage.java;2;0;6;1;0;0;0;6;47;1;6;1526;61;61;1;0;0;6;6;1526;0;2263;6;2;
/org.eclipse.jdt.launching.macosx/macosx/org/eclipse/jdt/internal/ui/macbundler/BundleWizardBasePage.java;1;0;1;1;0;0;0;1;0;0;1;3622;0;0;1;0;0;1;1;3622;0;3622;1;1;
/org.eclipse.ui.ide/src/org/eclipse/ui/wizards/datatransfer/FileSystemExporter.java;3;0;3;1;1;1;1;2;2;1;2;1511;4;4;1;0;0;2;3;1511;0;6338;3;3;
/org.eclipse.ui.workbench/Eclipse UI/org/eclipse/ui/internal/csm/activities/ActivityManagerEvent.java;1;0;4;1;0;0;0;4;20;2;3;2225;24;24;2;1;0;4;4;2441;1;2441;3;1;
/org.eclipse.jface.text/projection/org/eclipse/jface/text/source/ProjectionAnnotation.java;1;0;3;1;1;1;1;2;2;1;2;3217;3;3;1;0;0;2;3;3217;0;5177;3;1;
/org.eclipse.swt.examples/src/org/eclipse/swt/examples/controlexample/ListTab.java;1;0;1;1;0;0;0;1;2;0;1;1560;2;2;1;0;0;1;1;1560;0;1560;1;1;
/org.eclipse.pde.ui/src/org/eclipse/pde/internal/ui/parts/WizardCheckboxTablePart.java;2;1;4;1;3;3;3;1;12;0;1;2653;28;28;1;0;0;1;4;2653;0;6336;4;2;
/org.eclipse.jdt.ui/ui/org/eclipse/jdt/internal/ui/javaeditor/JavaProjectionModelUpdater.java;2;1;5;1;5;5;5;0;84;0;0;5099;93;93;1;0;0;0;5;5099;0;5440;5;2;
/org.eclipse.jdt.core.tests.model/workspace/Converter/src/test0353/Test.java;1;0;1;1;0;0;0;1;0;0;1;3714;0;0;1;0;0;1;1;3714;0;3714;1;1;
/org.eclipse.ui.workbench/Eclipse UI/org/eclipse/ui/keys/KeyFormatter.java;1;0;2;1;0;0;0;2;0;1;2;3169;0;0;1;0;0;2;2;3169;0;3236;2;1;
/org.eclipse.core.runtime.compatibility/src-boot/org/eclipse/core/internal/boot/SitePolicy.java;3;1;4;1;2;2;2;2;9;1;2;3013;15;15;1;0;0;2;4;3013;0;6340;4;3;
/org.eclipse.jdt.core.tests.model/workspace/Converter/src/javadoc/testBug51600/Test51617.java;1;1;2;1;2;2;2;0;0;0;0;5608;0;0;1;0;0;0;2;5608;0;5713;2;1;
/org.eclipse.ui.workbench/Eclipse UI/org/eclipse/ui/commands/IGestureSequence.java;1;0;3;1;0;0;0;3;4;1;3;1239;4;4;1;0;0;3;3;1239;0;1294;3;1;
/org.eclipse.ui.workbench/Eclipse UI/org/eclipse/ui/internal/roles/api/NotDefinedException.java;1;0;2;1;0;0;0;2;0;0;1;2202;0;0;2;1;0;2;2;2202;1;2202;1;1;
/org.eclipse.jdt.core/dom/org/eclipse/jdt/internal/core/dom/rewrite/CodeFormatterUtil.java;2;0;2;1;1;1;1;1;0;0;1;4802;0;0;1;0;0;1;2;4802;0;5404;2;2;
/org.eclipse.ui.workbench/Eclipse UI/org/eclipse/ui/internal/model/WorkbenchAdapterFactory.java;1;0;1;1;0;0;0;1;0;0;1;2737;0;0;1;0;0;1;1;2737;0;2737;1;1;
/org.eclipse.debug.ui/ui/org/eclipse/debug/internal/ui/views/memory/BasicDebugViewContentProvider.java;2;1;2;1;2;2;2;0;16;0;0;5254;16;16;1;0;0;0;2;5254;0;5315;2;2;
/org.eclipse.pde.core/src/org/eclipse/pde/internal/core/feature/AbstractFeatureModel.java;3;1;8;2;3;3;3;5;27;2;4;2906;49;49;2;1;0;5;8;2936;1;6336;7;3;
/org.eclipse.jdt.core/model/org/eclipse/jdt/core/util/CompilationUnitSorter.java;2;0;4;1;0;0;0;4;3;1;4;1790;8;8;1;0;0;4;4;1790;0;3976;4;2;
/org.eclipse.jdt.ui.tests.refactoring/resources/SurroundWithWorkSpace/SurroundWithTests/trycatch_out/TestRuntimeException1.java;1;0;1;1;0;0;0;1;6;0;1;845;6;6;1;0;0;1;1;845;0;845;1;1;
/org.eclipse.ui.workbench/Eclipse UI/org/eclipse/ui/commands/internal/ActionServiceManager.java;1;0;2;1;0;0;0;2;0;0;1;772;0;0;2;1;0;2;2;772;1;772;1;1;
/org.eclipse.jdt.core.tests.model/workspace/Formatter/test156/A_out.java;1;0;2;1;0;0;0;2;2;1;2;2425;2;2;1;0;0;2;2;2425;0;2462;2;1;
/org.eclipse.ui.workbench/Eclipse UI/org/eclipse/ui/commands/ParseException.java;1;0;2;1;0;0;0;2;0;0;1;1336;0;0;2;1;0;2;2;1336;1;1336;1;1;
/org.eclipse.core.resources/src/org/eclipse/core/internal/events/ResourceDeltaInfo.java;1;0;1;1;1;1;1;0;75;0;0;5146;75;75;1;0;0;0;1;5146;0;5146;1;1;
/org.eclipse.jdt.debug.tests/tests/org/eclipse/jdt/debug/tests/core/ArchiveSourceLookupTests.java;1;0;1;1;0;0;0;1;0;0;1;811;0;0;1;0;0;1;1;811;0;811;1;1;
/org.eclipse.debug.ui/ui/org/eclipse/debug/ui/launchVariables/expanders/ContainerNameExpander.java;1;0;2;1;0;0;0;2;0;1;2;562;0;0;1;0;0;2;2;562;0;737;2;1;
/org.eclipse.jdt.core.tests.model/workspace/Converter/test0027/Test.java;1;0;1;1;0;0;0;1;0;0;1;3714;0;0;1;0;0;1;1;3714;0;3714;1;1;
/org.eclipse.core.runtime.osgi/src/org/eclipse/core/internal/jobs/JobManager.java;1;0;2;1;0;0;0;2;25;1;2;3013;25;25;1;0;0;2;2;3013;0;3028;2;1;
/org.eclipse.jdt.debug.tests/tests/org/eclipse/jdt/debug/tests/eval/TestsNumberLiteral.java;1;0;1;1;0;0;0;1;104;0;1;1274;104;104;1;0;0;1;1;1274;0;1274;1;1;
/org.eclipse.jdt.core/compiler/org/eclipse/jdt/internal/compiler/parser/diagnose/DiagnoseParser.java;4;2;16;2;5;4;5;11;84;2;10;764;260;260;2;1;1;11;16;781;2;5938;14;4;
/org.eclipse.core.tests.resources/src/org/eclipse/core/tests/internal/indexing/BasicIndexedStoreTest.java;1;0;2;1;2;1;2;0;163;0;0;5147;163;163;2;0;1;0;2;5147;1;5147;1;1;
/org.eclipse.releng.tools/src/org/eclipse/releng/tools/MapFile.java;1;0;1;1;1;1;1;0;0;0;0;5183;0;0;1;0;0;0;1;5183;0;5183;1;1;
/org.eclipse.ui.ide/src/org/eclipse/ui/internal/ide/dialogs/WelcomeEditorInputFactory.java;2;1;5;1;2;2;2;3;28;1;3;2264;51;51;1;0;0;3;5;2264;0;6338;5;2;
/org.eclipse.debug.ui/ui/org/eclipse/debug/internal/ui/sourcelookup/WorkingSetSourceContainerType.java;1;0;2;1;1;1;1;1;2;0;1;4970;2;2;1;0;0;1;2;4970;0;5799;2;1;
/org.eclipse.pde.ui/src/org/eclipse/pde/internal/ui/editor/feature/RequiredFeaturesWizardPage.java;3;1;5;1;3;3;3;2;31;1;2;2229;67;67;1;0;0;2;5;2229;0;6336;5;3;
/org.eclipse.ui.intro/src/org/eclipse/ui/internal/intro/impl/model/AbstractIntroContainer.java;1;1;14;1;14;14;14;0;136;0;0;5115;385;385;1;0;0;0;14;5115;0;6251;14;1;
/org.eclipse.team.ui/src/org/eclipse/team/internal/ui/Policy.java;1;0;4;1;1;1;1;3;25;1;3;917;47;47;1;0;0;3;4;917;0;6337;4;1;
/org.eclipse.jdt.core.tests.model/workspace/Formatter/test184/A_out.java;1;0;2;1;1;1;1;1;3;0;1;2425;3;3;1;0;0;1;2;2425;0;5132;2;1;
/org.eclipse.jdt.junit/src/org/eclipse/jdt/internal/junit/util/CheckedTableSelectionDialog.java;1;0;1;1;1;1;1;0;2;0;0;6340;2;2;1;0;0;0;1;6340;0;6340;1;1;
/org.eclipse.jdt.core/model/org/eclipse/jdt/internal/core/util/ICacheEnumeration.java;1;0;1;1;0;0;0;1;2;0;1;3560;2;2;1;0;0;1;1;3560;0;3560;1;1;
/org.eclipse.ui.workbench/Eclipse UI/org/eclipse/ui/internal/commands/CommandActivationServiceEvent.java;1;0;2;1;0;0;0;2;0;0;1;1222;0;0;2;1;0;2;2;1222;1;1222;1;1;
/org.eclipse.update.examples/src/org/eclipse/update/examples/buildzip/BuildZipConverter.java;1;0;1;1;1;1;1;0;296;0;0;6339;296;296;1;0;0;0;1;6339;0;6339;1;1;
/org.eclipse.jdt.core.tests.model/workspace/Converter/src/junit/framework/Protectable.java;1;0;1;1;0;0;0;1;0;0;1;3714;0;0;1;0;0;1;1;3714;0;3714;1;1;
/org.eclipse.jdt.debug/jdi/org/eclipse/jdi/internal/VoidValueImpl.java;1;0;1;1;0;0;0;1;3;0;1;2497;3;3;1;0;0;1;1;2497;0;2497;1;1;
/org.eclipse.jdt.ui/core refactoring/org/eclipse/jdt/internal/corext/refactoring/code/LocalTypeAnalyzer.java;2;0;3;1;1;1;1;2;6;1;2;3310;10;10;1;0;0;2;3;3310;0;6340;3;2;
/org.eclipse.jdt.ui/core extension/org/eclipse/jdt/internal/corext/javadoc/JavaDocAccess.java;2;0;5;1;1;1;1;4;42;1;4;2131;86;86;1;0;0;4;5;2131;0;6340;5;2;
/org.eclipse.ui.workbench/Eclipse UI/org/eclipse/ui/internal/activities/IObjectContributionRecord.java;1;0;2;1;0;0;0;2;0;0;1;3008;0;0;2;1;0;2;2;3008;1;3008;1;1;
/org.eclipse.jdt.ui/ui/org/eclipse/jdt/internal/ui/util/JavadocHelpContext.java;2;0;3;1;1;1;1;2;22;1;2;2033;26;26;1;0;0;2;3;2033;0;6340;3;2;
/org.eclipse.jdt.ui.tests.refactoring/resources/ChangeSignature/canModify/A_testAdd32_out.java;1;0;1;1;0;0;0;1;2;0;1;2093;2;2;1;0;0;1;1;2093;0;2093;1;1;
/org.eclipse.update.ui/src/org/eclipse/update/internal/ui/pages/DiscoveryFolderPage.java;1;0;1;1;0;0;0;1;0;0;1;755;0;0;1;0;0;1;1;755;0;755;1;1;
/org.eclipse.jdt.core/model/org/eclipse/jdt/core/util/IConstantPoolConstant.java;1;0;1;1;0;0;0;1;2;0;1;3560;2;2;1;0;0;1;1;3560;0;3560;1;1;
/org.eclipse.jdt.ui/ui/org/eclipse/jdt/internal/ui/text/spelling/engine/ISpellChecker.java;3;1;4;1;2;2;2;2;6;1;2;3930;12;12;1;0;0;2;4;3930;0;6340;4;3;
/org.eclipse.pde.ui/src/org/eclipse/pde/internal/ui/editor/build/TokenSection.java;2;0;3;1;0;0;0;3;3;1;3;648;5;5;1;0;0;3;3;648;0;1727;3;2;
/org.eclipse.pde.ui/src_Forms/org/eclipse/pde/internal/ui/neweditor/plugin/PluginInputContextManager.java;2;0;6;2;2;1;2;4;8;1;4;4313;21;21;2;0;1;4;6;5426;1;5426;5;2;
/org.eclipse.jdt.debug.tests/tests/org/eclipse/jdt/debug/tests/core/DirectorySourceLookupTests.java;1;0;1;1;0;0;0;1;0;0;1;811;0;0;1;0;0;1;1;811;0;811;1;1;
/org.eclipse.text/src/org/eclipse/text/edits/ISourceModifier.java;2;0;3;1;1;1;1;2;15;1;2;1986;17;17;1;0;0;2;3;1986;0;6340;3;2;
/org.eclipse.releng.eclipsebuilder/plugins/org.eclipse.build.extra.tools/src/org/eclipse/releng/build/listeners/EclipseBuildListener.java;1;0;1;1;0;0;0;1;0;0;1;991;0;0;1;0;0;1;1;991;0;991;1;1;
/org.eclipse.help.tests/src/org/eclipse/help/tests/servlets/AllHelpServletsTests.java;1;1;2;1;2;2;2;0;16;0;0;5827;32;32;1;0;0;0;2;5827;0;6337;2;1;
/org.eclipse.swt/Eclipse SWT Drag and Drop/gtk/org/eclipse/swt/dnd/DropTarget.java;4;0;12;1;1;1;1;11;441;3;8;0;609;609;3;3;0;11;12;408;3;6352;9;4;
/org.eclipse.core.resources.spysupport/src/org/eclipse/core/internal/properties/SpySupport.java;1;1;2;1;2;2;2;0;6;0;0;6302;6;6;1;0;0;0;2;6302;0;6340;2;1;
/org.eclipse.debug.ui/ui/org/eclipse/debug/ui/variables/BuildTypeExpander.java;1;0;1;1;0;0;0;1;0;0;1;316;0;0;1;0;0;1;1;316;0;316;1;1;
/org.eclipse.ui.workbench/Eclipse UI/org/eclipse/ui/internal/roles/ActivityLabelProvider.java;2;0;2;1;0;0;0;2;0;1;2;2279;0;0;1;0;0;2;2;2279;0;2443;2;2;
/org.eclipse.search/new search/org/eclipse/search/ui/text/IPresentationFactory.java;1;0;2;1;0;0;0;2;0;1;2;3474;0;0;1;0;0;2;2;3474;0;3711;2;1;
/org.eclipse.jdt.ui.tests/ui/org/eclipse/jdt/ui/tests/search/ParticipantTest.java;1;1;3;1;3;3;3;0;14;0;0;5590;21;21;1;0;0;0;3;5590;0;5676;3;1;
/org.eclipse.jdt.ui/core refactoring/org/eclipse/jdt/internal/corext/refactoring/rename/RippleMethodFinder2.java;1;0;2;1;1;1;1;1;0;0;1;4970;0;0;1;0;0;1;2;4970;0;5404;2;1;
/org.eclipse.compare/compare/org/eclipse/compare/internal/CompareEditor.java;1;0;7;1;1;1;1;6;71;3;4;935;113;113;3;2;0;6;7;1216;2;6143;5;1;
/org.eclipse.debug.ui/ui/org/eclipse/debug/internal/ui/views/memory/SynchronizeInfo.java;2;1;3;1;3;3;3;0;8;0;0;5254;11;11;1;0;0;0;3;5254;0;5475;3;2;
/org.eclipse.jdt.core.tests.model/workspace/Converter/src/test0371/A.java;1;0;1;1;0;0;0;1;0;0;1;3714;0;0;1;0;0;1;1;3714;0;3714;1;1;
/org.eclipse.pde.core/src/org/eclipse/pde/internal/core/plugin/ExternalFragmentModel.java;3;1;4;1;2;2;2;2;38;1;2;3278;46;46;1;0;0;2;4;3278;0;6336;4;3;
/org.eclipse.ui.ide/src/org/eclipse/ui/actions/QuickStartAction.java;2;0;7;1;0;0;0;7;68;1;7;1511;133;133;1;0;0;7;7;1511;0;2263;7;2;
/org.eclipse.releng.basebuilder/plugins/org.eclipse.build.tools/src/org/eclipse/releng/generators/ContributionBuilder.java;1;0;1;1;0;0;0;1;0;0;1;993;0;0;1;0;0;1;1;993;0;993;1;1;
/org.eclipse.ui.workbench/Eclipse UI/org/eclipse/ui/dialogs/ContainerGenerator.java;1;0;1;1;0;0;0;1;0;0;1;2737;0;0;1;0;0;1;1;2737;0;2737;1;1;
/org.eclipse.jdt.core/compiler/org/eclipse/jdt/internal/compiler/lookup/ParameterizedFieldBinding.java;1;0;1;1;0;0;0;1;0;0;1;4334;0;0;1;0;0;1;1;4334;0;4334;1;1;
/org.eclipse.swt/Eclipse SWT Mozilla/win32/org/eclipse/swt/internal/mozilla/GRE.java;1;0;1;1;0;0;0;1;0;0;1;1654;0;0;1;0;0;1;1;1654;0;1654;1;1;
/org.eclipse.swt.graphics.text/Eclipse SWT PI/gtk/org/eclipse/swt/internal/gtk/PangoLayoutLine.java;2;0;2;1;0;0;0;2;17;1;2;3091;17;17;1;0;0;2;2;3091;0;4213;2;2;
/org.eclipse.team.cvs.core/src/org/eclipse/team/internal/ccvs/core/util/BuildCleanupListener.java;2;1;4;1;2;2;2;2;14;1;2;2061;28;28;1;0;0;2;4;2061;0;6337;4;2;
/org.eclipse.jdt.text.tests/src/org/eclipse/jdt/text/tests/JdtTextTestSuite.java;1;1;3;1;3;3;3;0;2;0;0;5129;3;3;1;0;0;0;3;5129;0;6340;3;1;
/org.eclipse.jdt.ui/ui/org/eclipse/jdt/internal/ui/callhierarchy/ToggleJavaLabelFormatAction.java;1;0;3;1;0;0;0;3;2;1;3;155;2;2;1;0;0;3;3;155;0;236;3;1;
/org.eclipse.swt/Eclipse SWT Drag and Drop/win32/org/eclipse/swt/dnd/Clipboard.java;3;1;8;1;3;3;3;5;228;1;5;311;477;477;1;0;0;5;8;311;0;6352;8;3;
/org.eclipse.jdt.ui.tests/ui/org/eclipse/jdt/ui/tests/quickfix/JavadocQuickFixTest.java;2;1;9;1;4;4;4;5;311;1;5;2547;365;365;1;0;0;5;9;2547;0;6340;9;2;
/org.eclipse.jdt.ui.tests.refactoring/resources/ExtractMethodWorkSpace/ExtractMethodTests/locals_out/A_test521.java;1;0;1;1;0;0;0;1;6;0;1;844;6;6;1;0;0;1;1;844;0;844;1;1;
/org.eclipse.help.base/src/org/eclipse/help/internal/browser/macosx/DefaultBrowserAdapter.java;1;1;5;1;3;3;3;2;47;1;2;1740;91;91;1;0;0;2;5;1740;0;6337;5;1;
/org.eclipse.debug.ui/ui/org/eclipse/debug/internal/ui/sourcelookup/SourceLookupDirectorActiveManager.java;1;0;2;1;0;0;0;2;0;1;2;3770;0;0;1;0;0;2;2;3770;0;4627;2;1;
/org.eclipse.swt/Eclipse SWT/win32/org/eclipse/swt/widgets/TableItem.java;4;1;36;2;9;9;9;27;230;3;20;26;999;999;3;7;0;27;36;3613;7;6352;29;4;
/org.eclipse.swt/Eclipse SWT PI/gtk/org/eclipse/swt/internal/gtk/XExposeEvent.java;2;1;2;1;2;2;2;0;4;0;0;5463;4;4;1;0;0;0;2;5463;0;6352;2;2;
/org.eclipse.core.expressions/src/org/eclipse/core/internal/expressions/IPropertyTester.java;1;0;2;1;0;0;0;2;0;1;2;4108;0;0;1;0;0;2;2;4108;0;4131;2;1;
/org.eclipse.jdt.core.tests.model/workspace/Converter/src/test0289/Test.java;1;0;1;1;0;0;0;1;0;0;1;3714;0;0;1;0;0;1;1;3714;0;3714;1;1;
/org.eclipse.jdt.core.tests.model/workspace/Converter/src/test0389/A.java;1;0;1;1;0;0;0;1;0;0;1;3714;0;0;1;0;0;1;1;3714;0;3714;1;1;
/org.eclipse.ui.forms/src/org/eclipse/ui/forms/widgets/RichText.java;1;0;3;1;0;0;0;3;1;1;3;4068;1;1;1;0;0;3;3;4068;0;4147;3;1;
/org.eclipse.pde.core/src_OSGi/org/eclipse/pde/internal/core/osgi/BundleLoader.java;2;0;5;1;0;0;0;5;72;1;5;3278;94;94;1;0;0;5;5;3278;0;4203;5;2;
/org.eclipse.jdt.ui/ui/org/eclipse/jdt/internal/ui/callhierarchy/FiltersDialog.java;2;0;6;1;1;1;1;5;111;2;4;169;192;192;2;1;0;5;6;169;1;6340;5;2;
/org.eclipse.jdt.core/compiler/org/eclipse/jdt/internal/compiler/lookup/ArrayBinding.java;2;0;5;1;1;1;1;4;16;1;4;530;40;40;1;0;0;4;5;530;0;5587;5;2;
/org.eclipse.core.tests.runtime/src/org/eclipse/core/tests/internal/plugins/SoftPrereqTest_9.java;1;0;1;1;0;0;0;1;0;0;1;3014;0;0;1;0;0;1;1;3014;0;3014;1;1;
/org.eclipse.jdt.core.tests.model/workspace/Formatter/test465/A_in.java;1;0;1;1;0;0;0;1;0;0;1;3915;0;0;1;0;0;1;1;3915;0;3915;1;1;
/org.eclipse.ui.ide/extensions/org/eclipse/ui/IMarkerResolution.java;1;0;1;1;0;0;0;1;0;0;1;2263;0;0;1;0;0;1;1;2263;0;2263;1;1;
/org.eclipse.pde.ui/src_Forms/org/eclipse/pde/internal/ui/neweditor/schema/SchemaEditor.java;2;1;5;1;3;3;3;2;9;1;2;4856;13;13;1;0;0;2;5;4856;0;5431;5;2;
/org.eclipse.team.cvs.core/src/org/eclipse/team/internal/ccvs/core/client/listeners/DiffListener.java;1;0;2;1;1;1;1;1;14;0;1;4216;16;16;1;0;0;1;2;4216;0;6337;2;1;
/org.eclipse.jdt.ui/ui refactoring/org/eclipse/jdt/internal/ui/refactoring/reorg/RenameUserInterfaceManager.java;1;0;1;1;0;0;0;1;0;0;1;4507;0;0;1;0;0;1;1;4507;0;4507;1;1;
/org.eclipse.ui.tests/Eclipse UI Tests/org/eclipse/ui/tests/multipageeditor/MultiPageKeyBindingTest.java;3;0;5;2;1;1;1;4;27;2;3;4218;39;39;2;1;0;4;5;4255;1;6338;4;3;
/org.eclipse.help.ide/src/org/eclipse/help/ui/internal/HelpIdePlugin.java;1;0;6;1;0;0;0;6;141;5;2;1738;141;141;5;4;0;6;6;1738;4;1778;2;1;
/org.eclipse.text/src/org/eclipse/jface/text/Line.java;1;0;1;1;1;1;1;0;7;0;0;6299;7;7;1;0;0;0;1;6299;0;6299;1;1;
/org.eclipse.team.ftp/src/org/eclipse/team/internal/ftp/subscriber/FTPRefreshOperation.java;2;0;3;1;0;0;0;3;171;1;3;3200;171;171;1;0;0;3;3;3200;0;4259;3;2;
/org.eclipse.update.ui.forms/src/org/eclipse/ui/forms/parts/FormLabel.java;1;0;5;1;0;0;0;5;7;2;4;3038;10;10;2;1;0;5;5;3095;1;3095;4;1;
/org.eclipse.jdt.ui/ui/org/eclipse/jdt/internal/ui/search/OccurrencesSearchResult.java;2;2;5;1;3;2;3;2;40;1;2;4888;59;59;2;0;1;2;5;5178;1;5854;4;2;
/org.eclipse.ui.workbench/Eclipse UI/org/eclipse/ui/internal/csm/roles/api/IRoleActivityBinding.java;1;0;3;1;0;0;0;3;7;0;1;2225;7;7;3;2;0;3;3;2225;2;2225;1;1;
/org.eclipse.jdt.core.tests.model/workspace/Converter/src/test0033/Test.java;1;0;1;1;0;0;0;1;0;0;1;3714;0;0;1;0;0;1;1;3714;0;3714;1;1;
/org.eclipse.ui.workbench/Eclipse UI/org/eclipse/ui/internal/commands/ws/WorkbenchPageCommandSupport.java;1;0;3;1;0;0;0;3;35;1;3;3129;35;35;1;0;0;3;3;3129;0;4144;3;1;
/org.eclipse.ant.ui/Ant Tools Support/org/eclipse/ant/internal/ui/views/elements/AntNode.java;1;0;1;1;0;0;0;1;0;0;1;1811;0;0;1;0;0;1;1;1811;0;1811;1;1;
/org.eclipse.swt.graphics.text/Eclipse SWT/win32/org/eclipse/swt/graphics/text/TextLayout.java;1;0;30;1;0;0;0;30;1303;3;25;2744;8608;8608;3;5;0;30;30;3677;5;4830;25;1;
/org.eclipse.team.webdav/src/org/eclipse/team/internal/target/subscriber/TargetSyncInfo.java;2;0;5;1;1;1;1;4;60;1;4;3514;71;71;1;0;0;4;5;3514;0;6337;5;2;
/org.eclipse.jdt.core.tests.model/workspace/Converter/test0215/Test.java;1;0;1;1;0;0;0;1;0;0;1;3714;0;0;1;0;0;1;1;3714;0;3714;1;1;
/org.eclipse.ui.editors/src/org/eclipse/ui/internal/editors/text/StatusInfo.java;2;1;4;1;2;2;2;2;31;1;2;3611;39;39;1;0;0;2;4;3611;0;6340;4;2;
/org.eclipse.team.cvs.ui/src/org/eclipse/team/internal/ccvs/ui/operations/HasProjectMetaFileOperation.java;2;0;8;1;1;1;1;7;92;1;7;276;142;142;1;0;0;7;8;276;0;6337;8;2;
/org.eclipse.pde.ui/src/org/eclipse/pde/internal/ui/editor/manifest/JavaAttributeWizardPage.java;1;0;15;1;1;1;1;14;411;3;10;285;858;858;3;4;0;14;15;625;4;5431;11;1;
/org.eclipse.ui.ide/src/org/eclipse/ui/wizards/datatransfer/WizardZipFileResourceImportPage1.java;1;0;1;1;0;0;0;1;0;0;1;1511;0;0;1;0;0;1;1;1511;0;1511;1;1;
/org.eclipse.jdt.core.tests.model/workspace/Formatter/test461/A_out.java;1;0;1;1;0;0;0;1;0;0;1;3900;0;0;1;0;0;1;1;3900;0;3900;1;1;
/org.eclipse.ui.workbench/Eclipse UI/org/eclipse/ui/internal/model/WorkbenchProject.java;1;0;1;1;0;0;0;1;0;0;1;2737;0;0;1;0;0;1;1;2737;0;2737;1;1;
/org.eclipse.help.tests/src/org/eclipse/help/tests/livehelp/TestLiveHelp.java;1;1;5;1;2;2;2;3;38;1;3;2732;76;76;1;0;0;3;5;2732;0;6337;5;1;
/org.eclipse.jdt.core.tests.model/workspace/Converter/src/test0038/Test.java;1;0;1;1;0;0;0;1;0;0;1;3714;0;0;1;0;0;1;1;3714;0;3714;1;1;
/org.eclipse.update.configurator/src/org/eclipse/update/internal/configurator/SiteEntry.java;2;2;31;1;11;8;11;20;430;3;16;3243;1090;1090;3;4;3;20;31;5021;7;6248;24;2;
/org.eclipse.jdt.debug/jdi interfaces/com/sun/jdi/connect/IllegalConnectorArgumentsException.java;2;0;2;1;0;0;0;2;12;1;2;1290;14;14;1;0;0;2;2;1290;0;1318;2;2;
/org.eclipse.help.base/src/org/eclipse/help/internal/util/PluginVersionInfo.java;1;0;3;1;0;0;0;3;3;0;1;1740;3;3;3;2;0;3;3;1740;2;1740;1;1;
/org.eclipse.jdt.core.tests.model/workspace/Formatter/test432/A_in.java;1;0;1;1;0;0;0;1;0;0;1;3495;0;0;1;0;0;1;1;3495;0;3495;1;1;
/org.eclipse.swt.tests/JUnit Tests/org/eclipse/swt/tests/junit/Test_org_eclipse_swt_SWT.java;1;0;1;1;0;0;0;1;75;0;1;2176;75;75;1;0;0;1;1;2176;0;2176;1;1;
/org.eclipse.ui.forms/src/org/eclipse/ui/forms/events/HyperlinkEvent.java;1;0;5;1;1;1;1;4;47;1;4;4068;71;71;1;0;0;4;5;4068;0;6336;5;1;
/org.eclipse.ui.workbench/Eclipse UI/org/eclipse/ui/internal/decorators/DeclarativeDecorator.java;4;0;4;2;1;1;1;3;42;2;2;4017;59;59;2;1;0;3;4;4609;1;6338;3;4;
/org.eclipse.ui.workbench/Eclipse UI/org/eclipse/ui/internal/ViewIntroAdapterPart.java;1;1;10;1;3;3;3;7;38;2;6;3632;150;150;2;1;0;7;10;4131;1;5595;9;1;
/org.eclipse.jdt.ui/core refactoring/org/eclipse/jdt/internal/corext/refactoring/nls/NLSInfo.java;1;2;8;1;8;7;8;0;506;0;0;5186;565;565;2;0;1;0;8;5375;1;5640;7;1;
/org.eclipse.ui.workbench/Eclipse UI/org/eclipse/ui/internal/progress/BlockedJobsDialog.java;4;2;28;2;21;15;21;7;158;2;6;3743;1004;1004;2;1;6;7;28;5081;7;6077;21;4;
/org.eclipse.team.ui/src/org/eclipse/team/internal/ui/widgets/HyperlinkSettings.java;1;0;1;1;0;0;0;1;0;0;1;3176;0;0;1;0;0;1;1;3176;0;3176;1;1;
/org.eclipse.team.cvs.ui/src/org/eclipse/team/internal/ccvs/ui/sync/CVSCatchupReleaseViewer.java;2;0;6;1;0;0;0;6;27;1;6;243;46;46;1;0;0;6;6;243;0;4217;6;2;
/org.eclipse.core.resources/src_ant/org/eclipse/core/resources/ant/RefreshLocalTask.java;2;0;3;1;1;1;1;2;129;1;2;179;136;136;1;0;0;2;3;179;0;5146;3;2;
/org.eclipse.ui.workbench/Eclipse UI/org/eclipse/ui/internal/layout/CellData.java;1;0;1;1;0;0;0;1;0;0;1;5003;0;0;1;0;0;1;1;5003;0;5003;1;1;
/org.eclipse.sdk.tests-feature/plugins/org.eclipse.perfmsr.ui.client/src/org/eclipse/perfmsr/ui/client/SnapshotsDataManager.java;1;1;3;1;3;3;3;0;27;0;0;5443;37;37;1;0;0;0;3;5443;0;5661;3;1;
/org.eclipse.osgi/resolver/src/org/eclipse/osgi/internal/resolver/StateWriter.java;4;1;11;1;4;4;4;7;25;1;7;3013;53;53;1;0;0;7;11;3013;0;5536;11;4;
/org.eclipse.jdt.ui/core refactoring/org/eclipse/jdt/internal/corext/refactoring/changes/Changes.java;2;0;3;1;0;0;0;3;5;1;3;3646;5;5;1;0;0;3;3;3646;0;4624;3;2;
/org.eclipse.jdt.core.tests.model/src/org/eclipse/jdt/core/tests/model/DefaultJavaElementComparator.java;2;0;2;1;1;1;1;1;17;0;1;3560;19;19;1;0;0;1;2;3560;0;5853;2;2;
/org.eclipse.ui.workbench/Eclipse UI/org/eclipse/ui/internal/commands/ActiveConfiguration.java;1;0;4;1;0;0;0;4;4;1;4;607;4;4;1;0;0;4;4;607;0;1077;4;1;
/org.eclipse.jdt.core.tests.model/workspace/Formatter/test025/A_in.java;1;0;1;1;0;0;0;1;0;0;1;2425;0;0;1;0;0;1;1;2425;0;2425;1;1;
/org.eclipse.jdt.ui/ui/org/eclipse/jdt/internal/ui/search/FilterDialog.java;1;1;2;1;2;2;2;0;0;0;0;5396;0;0;1;0;0;0;2;5396;0;5506;2;1;
/org.eclipse.core.expressions/src/org/eclipse/core/internal/expressions/ExpressionPlugin.java;1;0;3;1;1;1;1;2;29;1;2;4108;31;31;1;0;0;2;3;4108;0;5380;3;1;
/org.eclipse.team.cvs.ui/src/org/eclipse/team/internal/ccvs/ui/operations/ReconcileProjectOperation.java;2;1;9;1;2;2;2;7;176;1;7;3276;270;270;1;0;0;7;9;3276;0;6337;9;2;
/org.eclipse.swt/Eclipse SWT Drag and Drop/carbon/org/eclipse/swt/dnd/DropTarget.java;2;0;10;1;0;0;0;10;587;3;8;0;1138;1138;3;2;0;10;10;440;2;564;8;2;
/org.eclipse.jdt.ui/core refactoring/org/eclipse/jdt/internal/corext/refactoring/structure/ExtractInterfaceUtil.java;5;1;24;2;5;5;5;19;340;2;17;1166;735;735;2;2;0;19;24;1574;2;6340;22;5;
/org.eclipse.jdt.ui.tests.refactoring/resources/InlineMethodWorkspace/TestCases/receiver_out/TestExpressionZeroImplicitReceiver.java;1;0;1;1;0;0;0;1;2;0;1;845;2;2;1;0;0;1;1;845;0;845;1;1;
/org.eclipse.jdt.launching.j9/j9/org/eclipse/jdt/internal/launching/j9/JavaVMRunner.java;3;0;4;1;0;0;0;4;52;1;4;1455;80;80;1;0;0;4;4;1455;0;4626;4;3;
/org.eclipse.team.ui/src/org/eclipse/team/ui/synchronize/actions/SyncInfoSet.java;1;0;3;1;0;0;0;3;214;1;3;2535;214;214;1;0;0;3;3;2535;0;4216;3;1;
/org.eclipse.ui.workbench/Eclipse UI/org/eclipse/ui/internal/commands/KeySequenceBinding.java;3;1;8;1;2;2;2;6;39;3;4;2562;64;64;3;2;0;6;8;2562;2;6338;6;3;
/org.eclipse.pde.ui/src/org/eclipse/pde/internal/ui/editor/plugin/LibrarySection.java;3;2;8;1;8;7;8;0;28;0;0;5431;45;45;2;0;1;0;8;5778;1;6336;7;3;
/org.eclipse.jdt.junit/src/org/eclipse/jdt/internal/junit/ui/CopyFailureListAction.java;3;1;5;1;2;2;2;3;5;1;3;261;13;13;1;0;0;3;5;261;0;6340;5;3;
/org.eclipse.pde.ui/src/org/eclipse/pde/internal/ui/editor/feature/PortabilityChoiceCellEditor.java;2;1;3;1;2;2;2;1;6;0;1;4203;14;14;1;0;0;1;3;4203;0;6336;3;2;
/org.eclipse.ui.workbench/Eclipse UI/org/eclipse/ui/internal/dialogs/WorkbenchWizardListSelectionPage.java;4;1;6;1;2;2;2;4;520;1;4;2737;813;813;1;0;0;4;6;2737;0;6338;6;4;
/org.eclipse.team.cvs.core/src/org/eclipse/team/internal/ccvs/core/client/CheckoutWithOverwrite.java;1;0;1;1;0;0;0;1;0;0;1;1689;0;0;1;0;0;1;1;1689;0;1689;1;1;
/org.eclipse.update.ui/src/org/eclipse/update/ui/UpdateManagerUI.java;1;2;3;1;3;2;3;0;32;0;0;5767;32;32;2;0;1;0;3;5779;1;5779;2;1;
/org.eclipse.swt/Eclipse SWT/motif/org/eclipse/swt/widgets/Text.java;5;1;21;2;3;3;3;18;41;3;15;110;278;278;3;3;0;18;21;2805;3;6352;18;5;
/org.eclipse.pde.core/src/org/eclipse/pde/internal/core/isite/ISiteArchive.java;2;1;3;1;2;2;2;1;4;0;1;4203;10;10;1;0;0;1;3;4203;0;6336;3;2;
/org.eclipse.jdt.core/search/org/eclipse/jdt/internal/core/search/processing/IJob.java;1;0;3;1;0;0;0;3;12;2;2;2840;14;14;2;1;0;3;3;2840;1;3560;2;1;
/org.eclipse.debug.ui/ui/org/eclipse/debug/internal/ui/views/memory/IMemoryBlockModelPresentation.java;1;0;1;1;1;1;1;0;0;0;0;5254;0;0;1;0;0;0;1;5254;0;5254;1;1;
/org.eclipse.search/search/org/eclipse/search/internal/core/text/FileMatchCollector.java;1;0;1;1;0;0;0;1;0;0;1;4045;0;0;1;0;0;1;1;4045;0;4045;1;1;
/org.eclipse.ant.ui/Ant Runner Support/org/eclipse/ant/internal/ui/antsupport/AntSupportMessages.java;1;0;2;1;0;0;0;2;0;0;1;1811;0;0;2;1;0;2;2;1811;1;1811;1;1;
/org.eclipse.jdt.core.tests.model/workspace/Formatter/test372/A_in.java;1;0;1;1;0;0;0;1;0;0;1;3130;0;0;1;0;0;1;1;3130;0;3130;1;1;
/org.eclipse.jface.text/src/org/eclipse/jface/text/ISelectionValidator.java;2;1;3;1;2;2;2;1;14;0;1;4870;16;16;1;0;0;1;3;4870;0;6359;3;2;
/org.eclipse.jdt.core.tests.model/workspace/Converter/test0515/A.java;1;0;2;1;0;0;0;2;0;1;2;3442;0;0;1;0;0;2;2;3442;0;3714;2;1;
/org.eclipse.jdt.core/compiler/org/eclipse/jdt/internal/compiler/ast/Statement.java;3;0;6;1;1;1;1;5;26;1;5;953;63;63;1;0;0;5;6;953;0;5343;6;3;
/org.eclipse.jdt.ui/ui/org/eclipse/jdt/internal/ui/packageview/SelectionTransferDropAdapter.java;3;1;10;1;3;3;3;7;418;2;6;130;543;543;2;1;0;7;10;1111;1;6340;9;3;
/org.eclipse.jface/src/org/eclipse/jface/window/ColorSchemeService.java;2;0;3;1;0;0;0;3;121;1;3;2710;121;121;1;0;0;3;3;2710;0;4049;3;2;
/org.eclipse.debug.core/core/org/eclipse/debug/core/variables/VariablesMessages.java;1;0;1;1;0;0;0;1;0;0;1;648;0;0;1;0;0;1;1;648;0;648;1;1;
/org.eclipse.core.runtime/src/org/eclipse/core/runtime/registry/IExtensionRegistry.java;4;0;8;2;0;0;0;8;394;2;7;2105;862;862;2;1;0;8;8;3164;1;3164;7;4;
/org.eclipse.core.tests.runtime/src/org/eclipse/core/tests/internal/osgi/StateResolverTest.java;3;1;7;1;4;4;4;3;32;1;3;4430;85;85;1;0;0;3;7;4430;0;5339;7;3;
/org.eclipse.ui.workbench/Eclipse UI/org/eclipse/ui/activities/ICategoryActivityBinding.java;3;1;5;1;2;2;2;3;6;1;3;2896;14;14;1;0;0;3;5;2896;0;6338;5;3;
/org.eclipse.jdt.core/compiler/org/eclipse/jdt/internal/compiler/ast/IteratorForStatement.java;2;0;3;1;0;0;0;3;4;1;3;2645;4;4;1;0;0;3;3;2645;0;3513;3;2;
/org.eclipse.ui.workbench/Eclipse UI/org/eclipse/ui/internal/registry/NavigatorDelegateDescriptor.java;1;0;1;1;0;0;0;1;0;0;1;1093;0;0;1;0;0;1;1;1093;0;1093;1;1;
/org.eclipse.jdt.ui/ui refactoring/org/eclipse/jdt/internal/ui/refactoring/RefactoringSupport.java;2;0;6;1;0;0;0;6;285;2;5;122;476;476;2;1;0;6;6;1125;1;1125;5;2;
/org.eclipse.jdt.core/dom/org/eclipse/jdt/core/dom/ArrayAccess.java;3;1;8;1;2;2;2;6;108;1;6;3560;156;156;1;0;0;6;8;3560;0;5272;8;3;
/org.eclipse.jdt.core.tests.model/workspace/Converter/test0323/Test.java;1;0;1;1;0;0;0;1;0;0;1;3714;0;0;1;0;0;1;1;3714;0;3714;1;1;
/org.eclipse.help.tests/src/org/eclipse/help/tests/base/TestTocs.java;1;1;3;1;2;2;2;1;26;0;1;2732;48;48;1;0;0;1;3;2732;0;6337;3;1;
/org.eclipse.pde.ui/src_Forms/org/eclipse/pde/internal/ui/neweditor/plugin/DummyExtension.java;1;0;2;1;0;0;0;2;0;1;2;3834;0;0;1;0;0;2;2;3834;0;4223;2;1;
/org.eclipse.ui.tests/Eclipse UI Tests/org/eclipse/ui/tests/api/MockViewPart.java;3;1;4;1;2;2;2;2;12;1;2;3691;16;16;1;0;0;2;4;3691;0;6338;4;3;
/org.eclipse.jdt.ui/core refactoring/org/eclipse/jdt/internal/corext/refactoring/participants/xml/ExpressionMessages.java;1;0;2;1;0;0;0;2;0;1;2;3930;0;0;1;0;0;2;2;3930;0;4108;2;1;
/org.eclipse.search/search/org/eclipse/search/internal/ui/text/ReplaceDialog.java;2;0;12;1;1;1;1;11;843;2;10;2743;1128;1128;2;1;0;11;12;3306;1;6340;11;2;
/org.eclipse.jdt.ui/ui refactoring/org/eclipse/jdt/internal/ui/refactoring/reorg/ReorgCopyWizard.java;4;1;9;1;2;2;2;7;10;1;7;1114;43;43;1;0;0;7;9;1114;0;6340;9;4;
/org.eclipse.swt/Eclipse SWT PI/gtk1x/org/eclipse/swt/internal/gtk/GdkGCValues.java;1;0;1;1;0;0;0;1;0;0;1;2327;0;0;1;0;0;1;1;2327;0;2327;1;1;
/org.eclipse.swt.graphics.text/Eclipse SWT PI/gtk/org/eclipse/swt/internal/gtk/PangoLogAttr.java;2;0;4;1;0;0;0;4;18;1;4;3494;34;34;1;0;0;4;4;3494;0;4213;4;2;
/org.eclipse.jdt.ui/core refactoring/org/eclipse/jdt/internal/corext/refactoring/reorg/ParentChecker.java;2;0;3;1;1;1;1;2;8;1;2;1114;10;10;1;0;0;2;3;1114;0;6340;3;2;
/org.eclipse.update.core/srcnew/org/eclipse/update/internal/search/QueryUpdateSiteAdapter.java;2;0;2;1;0;0;0;2;0;1;2;630;0;0;1;0;0;2;2;630;0;825;2;2;
/org.eclipse.jdt.ui/core refactoring/org/eclipse/jdt/internal/corext/refactoring/typeconstraints/ITypeConstraint.java;2;0;4;1;1;1;1;3;19;1;3;42;33;33;1;0;0;3;4;42;0;6340;4;2;
/org.eclipse.swt/Eclipse SWT/common/org/eclipse/swt/layout/FormAttachment.java;2;0;3;1;1;1;1;2;73;1;2;2285;80;80;1;0;0;2;3;2285;0;6352;3;2;
/org.eclipse.update.core/srcnew/org/eclipse/update/internal/search/IUpdateSearchCategory.java;1;0;3;1;0;0;0;3;8;2;2;553;8;8;2;1;0;3;3;572;1;572;2;1;
/org.eclipse.jdt.text.tests/src/org/eclipse/jdt/text/tests/spelling/SpellingTestSuite.java;1;1;3;1;3;3;3;0;2;0;0;5129;3;3;1;0;0;0;3;5129;0;6340;3;1;
/org.eclipse.pde.ui/src_Forms/org/eclipse/pde/internal/ui/neweditor/build/BuildClasspathSection.java;2;1;7;1;5;5;5;2;110;1;2;4406;193;193;1;0;0;2;7;4406;0;5431;7;2;
/org.eclipse.jface.text/src/org/eclipse/jface/text/source/IAnnotationMap.java;1;0;2;1;1;1;1;1;0;0;1;4425;0;0;1;0;0;1;2;4425;0;5382;2;1;
/org.eclipse.pde.ui/src/org/eclipse/pde/internal/ui/editor/PDEMultiPagePropertySheet.java;2;1;3;1;2;2;2;1;4;0;1;368;10;10;1;0;0;1;3;368;0;6336;3;2;
/org.eclipse.core.runtime/src/org/eclipse/core/internal/preferences/RootPreferences.java;2;1;10;1;4;4;4;6;68;1;6;4351;227;227;1;0;0;6;10;4351;0;5572;10;2;
/org.eclipse.ui.workbench/Eclipse UI/org/eclipse/ui/internal/dialogs/RemoveCapabilityWizard.java;1;0;1;1;0;0;0;1;0;0;1;2737;0;0;1;0;0;1;1;2737;0;2737;1;1;
/org.eclipse.jdt.core.tests.model/workspace/Converter/src/test0463/A.java;1;0;1;1;0;0;0;1;0;0;1;3714;0;0;1;0;0;1;1;3714;0;3714;1;1;
/org.eclipse.ant.tests.ui/Ant Editor Tests/org/eclipse/ant/tests/ui/editor/EnclosingTargetSearchingHandlerTest.java;1;0;6;1;0;0;0;6;21;2;4;1811;32;32;2;2;0;6;6;1811;2;3685;4;1;
/org.eclipse.jdt.core.tests.model/workspace/Formatter/test221/A_out.java;1;0;1;1;0;0;0;1;0;0;1;2426;0;0;1;0;0;1;1;2426;0;2426;1;1;
/org.eclipse.core.tests.runtime/src/org/eclipse/core/tests/plugintests/AllTests.java;1;0;1;1;0;0;0;1;0;0;1;3014;0;0;1;0;0;1;1;3014;0;3014;1;1;
/org.eclipse.jdt.ui.tests.refactoring/resources/RenameVirtualMethodInClass/test36/out/A.java;1;0;1;1;0;0;0;1;0;0;1;1653;0;0;1;0;0;1;1;1653;0;1653;1;1;
/org.eclipse.ui.views/src/org/eclipse/ui/views/markers/internal/TaskFilter.java;2;0;2;1;0;0;0;2;0;1;2;755;0;0;1;0;0;2;2;755;0;2738;2;2;
/org.eclipse.debug.ui/ui/org/eclipse/debug/internal/ui/console/MessageConsole.java;2;0;4;1;0;0;0;4;127;2;3;1418;136;136;2;1;0;4;4;1418;1;2060;3;2;
/org.eclipse.text/src/org/eclipse/jface/text/link/LinkedManager.java;1;0;2;1;1;1;1;1;0;0;1;4214;0;0;1;0;0;1;2;4214;0;5128;2;1;
/org.eclipse.ant.tests.ui/test support/org/eclipse/ant/tests/ui/support/types/AntTestPath.java;1;0;1;1;0;0;0;1;0;0;1;4097;0;0;1;0;0;1;1;4097;0;4097;1;1;
/org.eclipse.jdt.core.tests.model/workspace/Converter/src/test0298/Test.java;1;0;1;1;0;0;0;1;0;0;1;3714;0;0;1;0;0;1;1;3714;0;3714;1;1;
/org.eclipse.update.core/src/org/eclipse/update/core/model/SiteModelFactory.java;2;1;5;1;3;3;3;2;13;1;2;890;37;37;1;0;0;2;5;890;0;6336;5;2;
/org.eclipse.jdt.core.tests.model/workspace/Converter/src/test0559/A.java;1;0;1;1;1;1;1;0;0;0;0;6078;0;0;1;0;0;0;1;6078;0;6078;1;1;
/org.eclipse.team.webdav/src/org/eclipse/team/internal/ui/target/subscriber/TargetSubscriberViewerAdvisor.java;2;0;5;1;1;1;1;4;16;1;4;4588;22;22;1;0;0;4;5;4588;0;5359;5;2;
/org.eclipse.ui.workbench/Eclipse UI/org/eclipse/ui/activities/support/WorkbenchActivityHelper.java;2;0;2;2;0;0;0;2;0;0;1;3061;0;0;2;1;0;2;2;3061;1;3061;1;2;
/org.eclipse.pde.core/src/org/eclipse/pde/internal/core/ischema/IMetaAttribute.java;2;1;2;1;2;2;2;0;4;0;0;5799;6;6;1;0;0;0;2;5799;0;6336;2;2;
/org.eclipse.jdt.ui/ui/org/eclipse/jdt/internal/ui/jarpackager/JarPackageReader.java;1;1;5;1;2;2;2;3;12;2;2;239;26;26;2;1;0;3;5;239;1;6340;4;1;
/org.eclipse.core.runtime.compatibility/src-model/org/eclipse/core/runtime/model/PluginModelObject.java;3;2;6;1;4;3;4;2;23;1;2;3013;32;32;2;0;1;2;6;5117;1;6340;5;3;
/org.eclipse.ui.editors/src/org/eclipse/ui/texteditor/AnnotationLayerLookup.java;1;0;3;1;0;0;0;3;32;2;2;3654;32;32;2;1;0;3;3;3668;1;3668;2;1;
/org.eclipse.update.ui/src/org/eclipse/update/internal/ui/views/UpdatesView.java;2;0;2;2;0;0;0;2;2;0;1;749;2;2;2;1;0;2;2;749;1;749;1;2;
/org.eclipse.jdt.ui.tests.refactoring/test cases/org/eclipse/jdt/ui/tests/xml/B.java;1;0;2;1;0;0;0;2;0;1;2;2204;0;0;1;0;0;2;2;2204;0;4108;2;1;
/org.eclipse.ui.intro/src/org/eclipse/ui/internal/intro/impl/model/IntroText.java;1;1;11;1;11;11;11;0;28;0;0;5115;78;78;1;0;0;0;11;5115;0;5894;11;1;
/org.eclipse.pde.ui/src/org/eclipse/pde/internal/ui/editor/text/XMLTagScanner.java;3;1;4;1;2;2;2;2;30;1;2;3795;38;38;1;0;0;2;4;3795;0;6336;4;3;
/org.eclipse.jdt.ui/ui/org/eclipse/jdt/internal/ui/search/JavaSearchScopeFactory.java;3;1;16;1;6;6;6;10;73;1;10;1350;329;329;1;0;0;10;16;1350;0;6340;16;3;
/org.eclipse.ui.cheatsheets/src/org/eclipse/ui/internal/cheatsheets/data/ContentItem.java;2;0;3;1;0;0;0;3;17;1;3;4428;17;17;1;0;0;3;3;4428;0;4662;3;2;
/org.eclipse.team.webdav/src/org/eclipse/team/internal/core/target/DeploymentProviderRegistry.java;2;1;4;1;3;3;3;1;16;0;1;4633;22;22;1;0;0;1;4;4633;0;6337;4;2;
/org.eclipse.team.ui/src/org/eclipse/team/ui/synchronize/content/LogicalViewProvider.java;1;0;1;1;0;0;0;1;0;0;1;3734;0;0;1;0;0;1;1;3734;0;3734;1;1;
/org.eclipse.jdt.core.tests.model/workspace/Converter/test0065/Test.java;1;0;1;1;0;0;0;1;0;0;1;3714;0;0;1;0;0;1;1;3714;0;3714;1;1;
/org.eclipse.ui.workbench/Eclipse UI/org/eclipse/ui/internal/roles/api/IContextBindingDefinition.java;1;0;2;1;0;0;0;2;0;1;2;1961;0;0;1;0;0;2;2;1961;0;2199;2;1;
/org.eclipse.jdt.ui.tests.refactoring/resources/ExtractInterface/test100/out/A.java;1;0;1;1;0;0;0;1;0;0;1;3942;0;0;1;0;0;1;1;3942;0;3942;1;1;
/org.eclipse.jdt.debug.tests/tests/org/eclipse/jdt/debug/tests/eval/XfixOperatorsTests.java;1;0;1;1;0;0;0;1;56;0;1;1274;56;56;1;0;0;1;1;1274;0;1274;1;1;
/org.eclipse.swt/Eclipse SWT Mozilla/common/org/eclipse/swt/internal/mozilla/nsIObserverService.java;1;0;2;1;0;0;0;2;4;1;2;1654;4;4;1;0;0;2;2;1654;0;2568;2;1;
/org.eclipse.jdt.ui.tests.refactoring/resources/ExtractTemp/canExtract/A_test79_out.java;1;0;1;1;1;1;1;0;0;0;0;5909;0;0;1;0;0;0;1;5909;0;5909;1;1;
/org.eclipse.ui.workbench/Eclipse UI/org/eclipse/ui/internal/colors/GradientDefinition.java;1;0;2;1;0;0;0;2;0;0;1;4235;0;0;2;1;0;2;2;4235;1;4235;1;1;
/org.eclipse.jdt.launching.macosx/macosx/org/eclipse/jdt/internal/ui/macbundler/BundleWizardPage1.java;1;0;2;1;0;0;0;2;13;1;2;3622;13;13;1;0;0;2;2;3622;0;3650;2;1;
/org.eclipse.update.core/srcnew/org/eclipse/update/operations/IMultiOperation.java;1;0;2;1;0;0;0;2;0;1;2;569;0;0;1;0;0;2;2;569;0;602;2;1;
/org.eclipse.pde.core/src/org/eclipse/pde/internal/core/feature/FeatureURL.java;2;1;3;1;2;2;2;1;8;0;1;4203;19;19;1;0;0;1;3;4203;0;6336;3;2;
/org.eclipse.pde.ui/src/org/eclipse/pde/internal/ui/editor/schema/SchemaInputContext.java;3;2;4;2;4;2;4;0;25;0;0;5431;27;27;2;0;2;0;4;5431;2;5780;2;3;
/org.eclipse.jdt.core.tests.model/workspace/Formatter/test086/A_out.java;1;0;1;1;0;0;0;1;0;0;1;2425;0;0;1;0;0;1;1;2425;0;2425;1;1;
/org.eclipse.ui.tests/Eclipse UI Tests/org/eclipse/ui/tests/keys/Bug44460Test.java;4;0;12;1;1;1;1;11;25;1;11;2404;82;82;1;0;0;11;12;2404;0;6338;12;4;
/org.eclipse.jdt.core.tests.model/workspace/Encoding/src/testUTF8BOM/Test.java;1;1;2;1;2;2;2;0;0;0;0;5586;0;0;1;0;0;0;2;5586;0;6218;2;1;
/org.eclipse.jdt.core.tests.model/workspace/JavaSearch/src/e4/A.java;1;0;1;1;0;0;0;1;0;0;1;1128;0;0;1;0;0;1;1;1128;0;1128;1;1;
/org.eclipse.jdt.core.tests.model/workspace/Formatter/test088/A_out.java;1;0;1;1;0;0;0;1;0;0;1;2425;0;0;1;0;0;1;1;2425;0;2425;1;1;
/org.eclipse.jdt.ui.tests.refactoring/resources/InlineMethodWorkspace/TestCases/nameconflict_in/TestBlocks.java;1;0;1;1;0;0;0;1;2;0;1;845;2;2;1;0;0;1;1;845;0;845;1;1;
/org.eclipse.jdt.core.tests.model/workspace/Converter/test0162/Test.java;1;0;1;1;0;0;0;1;0;0;1;3714;0;0;1;0;0;1;1;3714;0;3714;1;1;
/org.eclipse.swt.graphics.text/Eclipse SWT PI/win32/org/eclipse/swt/internal/win32/SCRIPT_STATE.java;1;0;1;1;0;0;0;1;0;0;1;2985;0;0;1;0;0;1;1;2985;0;2985;1;1;
/org.eclipse.debug.ui/ui/org/eclipse/debug/ui/launchVariables/ContextLaunchVariable.java;1;0;2;1;0;0;0;2;0;1;2;550;0;0;1;0;0;2;2;550;0;562;2;1;
/org.eclipse.jdt.debug.tests/tests/org/eclipse/jdt/debug/tests/eval/NestedTypeFieldValue_279.java;1;0;1;1;0;0;0;1;92;0;1;1274;92;92;1;0;0;1;1;1274;0;1274;1;1;
/org.eclipse.swt/Eclipse SWT PI/gtk/org/eclipse/swt/internal/accessibility/gtk/AtkHypertextIface.java;2;1;2;1;2;2;2;0;2;0;0;5384;2;2;1;0;0;0;2;5384;0;6352;2;2;
/org.eclipse.core.tests.resources/src/org/eclipse/core/tests/resources/IProjectDescriptionTest.java;2;1;3;1;2;2;2;1;42;0;1;4514;60;60;1;0;0;1;3;4514;0;5897;3;2;
/org.eclipse.jdt.ui/core refactoring/org/eclipse/jdt/internal/corext/refactoring/surround/ExceptionAnalyzer.java;2;0;2;1;1;1;1;1;2;0;1;218;4;4;1;0;0;1;2;218;0;6340;2;2;
/org.eclipse.pde.ui/src/org/eclipse/pde/internal/ui/wizards/tools/UpdateBuildpathWizard.java;2;1;3;1;2;2;2;1;4;0;1;3840;8;8;1;0;0;1;3;3840;0;6336;3;2;
/org.eclipse.ui.console/src/org/eclipse/ui/internal/console/MessageConsolePage.java;3;0;9;1;1;1;1;8;17;1;8;1988;74;74;1;0;0;8;9;1988;0;6336;9;3;
/org.eclipse.jdt.debug.ui/ui/org/eclipse/jdt/internal/debug/ui/actions/ProjectSelectionDialog.java;2;0;2;2;2;1;2;0;43;0;0;5460;43;43;2;0;1;0;2;5460;1;5460;1;2;
/org.eclipse.jdt.core.tests.model/workspace/Formatter/test397/A_out.java;1;0;1;1;0;0;0;1;0;0;1;3436;0;0;1;0;0;1;1;3436;0;3436;1;1;
/org.eclipse.core.expressions/src/org/eclipse/core/internal/expressions/Expressions.java;1;1;5;1;2;2;2;3;125;1;3;4108;225;225;1;0;0;3;5;4108;0;6340;5;1;
/org.eclipse.jdt.ui/core refactoring/org/eclipse/ltk/internal/refactoring/core/TextChanges.java;1;0;2;1;0;0;0;2;0;1;2;3930;0;0;1;0;0;2;2;3930;0;4510;2;1;
/org.eclipse.jdt.ui/ui/org/eclipse/jdt/internal/ui/preferences/JavaEditorHoverConfigurationBlock.java;1;2;17;1;13;11;13;4;254;1;4;600;519;519;2;0;2;4;17;5481;2;6340;15;1;
/org.eclipse.jdt.core.tests.model/workspace/Converter/src/test0133/Test.java;1;0;1;1;0;0;0;1;0;0;1;3714;0;0;1;0;0;1;1;3714;0;3714;1;1;
/org.eclipse.jdt.ui.tests.refactoring/resources/Delete/testDeleteWithinCu10/out/A.java;1;0;1;1;0;0;0;1;0;0;1;442;0;0;1;0;0;1;1;442;0;442;1;1;
/org.eclipse.team.ui/src/org/eclipse/team/ui/synchronize/SyncInfoDiffTreeViewer.java;1;0;1;1;0;0;0;1;0;0;1;3286;0;0;1;0;0;1;1;3286;0;3286;1;1;
/org.eclipse.jdt.core.tests.model/workspace/Formatter/test359/A_in.java;1;0;1;1;0;0;0;1;0;0;1;3087;0;0;1;0;0;1;1;3087;0;3087;1;1;
/org.eclipse.jface/src/org/eclipse/jface/action/SubContributionManager.java;3;1;3;1;2;2;2;1;29;0;1;4699;44;44;1;0;0;1;3;4699;0;6338;3;3;
/org.eclipse.help.tests/src/org/eclipse/help/tests/servlets/TestSearchServlet.java;1;1;3;1;2;2;2;1;63;0;1;2732;83;83;1;0;0;1;3;2732;0;6337;3;1;
/org.eclipse.pde.ui/src_samples/org/eclipse/pde/ui/internal/samples/SampleWizard.java;3;1;11;1;6;6;6;5;142;2;4;4523;248;248;2;1;0;5;11;4538;1;6336;10;3;
/org.eclipse.jdt.ui/core refactoring/org/eclipse/jdt/internal/corext/refactoring/reorg2/CopyRefactoring2.java;1;0;11;1;0;0;0;11;792;2;7;516;1637;1637;2;4;0;11;11;516;4;1111;7;1;
/org.eclipse.jdt.ui.tests/ui/org/eclipse/jdt/ui/tests/core/AddImportTest.java;2;1;9;1;4;4;4;5;43;2;4;803;144;144;2;1;0;5;9;2331;1;6340;8;2;
/org.eclipse.ant.ui/Ant Tools Support/org/eclipse/ant/ui/internal/preferences/AntPropertiesPage.java;1;0;5;1;0;0;0;5;21;2;4;250;37;37;2;1;0;5;5;1402;1;1811;4;1;
/org.eclipse.team.cvs.ui/src/org/eclipse/team/internal/ccvs/ui/DateTagDialog.java;2;1;7;1;5;5;5;2;266;1;2;2569;320;320;1;0;0;2;7;2569;0;6337;7;2;
/org.eclipse.jdt.ui.tests.refactoring/resources/ExtractMethodWorkSpace/ExtractMethodTests/locals_in/A_test518.java;1;0;1;1;0;0;0;1;2;0;1;844;2;2;1;0;0;1;1;844;0;844;1;1;
/org.eclipse.ui.externaltools/External Tools Base/org/eclipse/ui/externaltools/internal/ui/StatusDialog.java;2;0;2;1;0;0;0;2;14;1;2;244;14;14;1;0;0;2;2;244;0;282;2;2;
/org.eclipse.ant.tests.ui/Ant Tests/org/eclipse/ant/tests/ui/AbstractAntUIBuildTest.java;1;1;4;1;2;2;2;2;9;1;2;1796;20;20;1;0;0;2;4;1796;0;6336;4;1;
/org.eclipse.ui.workbench/Eclipse UI/org/eclipse/ui/internal/roles/ActivityEvent.java;2;0;3;1;0;0;0;3;4;1;3;2060;4;4;1;0;0;3;3;2060;0;2443;3;2;
/org.eclipse.ui.workbench/Eclipse UI/org/eclipse/ui/internal/chris/roles/api/IRoleListener.java;1;0;2;1;0;0;0;2;0;0;1;2207;0;0;2;1;0;2;2;2207;1;2207;1;1;
/org.eclipse.pde.ui/src/org/eclipse/pde/internal/ui/wizards/templates/PropertyPageNewWizard.java;3;1;5;1;4;4;4;1;12;0;1;3986;31;31;1;0;0;1;5;3986;0;6336;5;3;
/org.eclipse.ui.cheatsheets/src/org/eclipse/ui/internal/cheatsheets/views/CheatSheetEvent.java;2;0;3;2;0;0;0;3;55;2;2;4428;55;55;2;1;0;3;3;4625;1;4625;2;2;
/org.eclipse.ui.workbench/Eclipse UI/org/eclipse/ui/internal/contexts/ContextEvent.java;1;0;6;1;0;0;0;6;45;1;6;1137;65;65;1;0;0;6;6;1137;0;2425;6;1;
/org.eclipse.ui.ide/src/org/eclipse/ui/views/tasklist/TaskList.java;5;1;8;1;3;3;3;5;22;1;5;2208;72;72;1;0;0;5;8;2208;0;6338;8;5;
/org.eclipse.core.expressions.tests/src/org/eclipse/core/internal/expressions/tests/B.java;1;0;2;1;1;1;1;1;2;0;1;4108;2;2;1;0;0;1;2;4108;0;6340;2;1;
/org.eclipse.debug.ui/ui/org/eclipse/debug/internal/ui/DebugPluginImages.java;4;2;28;1;6;5;6;22;45;1;22;550;187;187;2;0;1;22;28;5475;1;5475;27;4;
/org.eclipse.ui.workbench/Eclipse UI/org/eclipse/ui/internal/csm/activities/api/IActivityPatternBinding.java;1;0;3;1;0;0;0;3;7;0;1;2225;7;7;3;2;0;3;3;2225;2;2225;1;1;
/org.eclipse.ui.editors/src/org/eclipse/ui/editors/text/ITextEditorHelpContextIds.java;3;1;4;1;2;2;2;2;17;1;2;2741;35;35;1;0;0;2;4;2741;0;6334;4;3;
/org.eclipse.jdt.core.tests.model/workspace/Converter/test0214/Test.java;1;0;1;1;0;0;0;1;0;0;1;3714;0;0;1;0;0;1;1;3714;0;3714;1;1;
/org.eclipse.core.runtime/src/org/eclipse/core/runtime/IBundleGroup.java;3;1;11;2;2;2;2;9;35;2;8;3680;96;96;2;1;0;9;11;3748;1;5541;10;3;
/org.eclipse.pde.build/src/org/eclipse/pde/internal/build/SourceFeatureWriter.java;2;1;8;1;2;2;2;6;4;1;6;447;11;11;1;0;0;6;8;447;0;5730;8;2;
/org.eclipse.core.tests.runtime/src/org/eclipse/core/tests/internal/plugins/ActivationTest_IndirectRef.java;1;0;1;1;0;0;0;1;0;0;1;3014;0;0;1;0;0;1;1;3014;0;3014;1;1;
/org.eclipse.releng.basebuilder/plugins/org.eclipse.build.tools/src/org/eclipse/releng/CvsDiffParser.java;2;0;6;2;0;0;0;6;197;2;4;3236;319;319;2;2;0;6;6;3236;2;3597;4;2;
/org.eclipse.jdt.ui/ui/org/eclipse/jdt/ui/text/spelling/WordIgnoreProposal.java;1;0;2;1;0;0;0;2;0;1;2;3829;0;0;1;0;0;2;2;3829;0;3930;2;1;
/org.eclipse.update.ui/src/org/eclipse/update/internal/ui/UpdateUIImages.java;3;1;15;1;3;3;3;12;182;2;10;200;377;377;2;2;0;12;15;489;2;6336;13;3;
/org.eclipse.jdt.core/dom/org/eclipse/jdt/internal/core/dom/rewrite/SourceModifier.java;3;1;3;1;2;2;2;1;53;0;1;4802;57;57;1;0;0;1;3;4802;0;6336;3;3;
/org.eclipse.core.variables/src/org/eclipse/core/internal/variables/ValueVariable.java;1;0;1;1;0;0;0;1;0;0;1;2514;0;0;1;0;0;1;1;2514;0;2514;1;1;
/org.eclipse.update.core/srcnew/org/eclipse/update/internal/operations/JobTargetSites.java;1;0;4;1;0;0;0;4;6;1;4;646;10;10;1;0;0;4;4;646;0;825;4;1;
/org.eclipse.jdt.core/search/org/eclipse/jdt/internal/core/index/impl/WordEntryHashedArray.java;2;0;3;1;0;0;0;3;8;1;3;2535;10;10;1;0;0;3;3;2535;0;4060;3;2;
/org.eclipse.jdt.ui/ui/org/eclipse/jdt/internal/ui/text/java/ResultCollector.java;3;2;9;1;6;5;6;3;34;1;3;1127;106;106;2;0;1;3;9;5505;1;6340;8;3;
/org.eclipse.jdt.ui/ui/org/eclipse/jdt/ui/actions/MoveAction.java;3;1;11;1;2;2;2;9;193;2;8;122;317;317;2;1;0;9;11;1111;1;6340;10;3;
/org.eclipse.ant.ui/Ant Tools Support/org/eclipse/ant/internal/ui/launchConfigurations/MessageIds.java;1;0;1;1;0;0;0;1;0;0;1;1811;0;0;1;0;0;1;1;1811;0;1811;1;1;
/org.eclipse.team.ui/src/org/eclipse/team/ui/synchronize/subscriber/IRefreshSubscriberListenerFactory.java;1;0;2;1;0;0;0;2;0;1;2;4518;0;0;1;0;0;2;2;4518;0;4632;2;1;
/org.eclipse.jdt.core.tests.model/workspace/Converter/src/test0124/Test.java;1;0;1;1;0;0;0;1;0;0;1;3714;0;0;1;0;0;1;1;3714;0;3714;1;1;
/org.eclipse.pde.ui/src/org/eclipse/pde/ui/templates/BooleanOption.java;2;1;3;1;3;3;3;0;66;0;0;5115;116;116;1;0;0;0;3;5115;0;6336;3;2;
/org.eclipse.core.runtime/src/org/eclipse/core/runtime/IProduct.java;2;2;10;2;3;2;3;7;31;2;6;3680;113;113;2;1;1;7;10;3748;2;5917;8;2;
/org.eclipse.jdt.ui/ui/org/eclipse/jdt/internal/ui/javaeditor/IJavaAnnotation.java;3;1;5;1;2;2;2;3;51;1;3;1218;83;83;1;0;0;3;5;1218;0;6340;5;3;
/org.eclipse.jdt.core/dom/org/eclipse/jdt/core/dom/DoStatement.java;3;1;9;1;2;2;2;7;110;1;7;2872;166;166;1;0;0;7;9;2872;0;5272;9;3;
/org.eclipse.jdt.core.tests.model/src/org/eclipse/jdt/core/tests/model/AbstractJavaModelTests.java;5;3;47;2;14;10;14;33;1926;1;33;104;2551;2551;3;0;4;33;47;5853;4;6033;43;5;
/org.eclipse.ant.ui/Ant Tools Support/org/eclipse/ant/internal/ui/launchConfigurations/AntStreamMonitor.java;3;0;3;1;0;0;0;3;10;1;3;1811;20;20;1;0;0;3;3;1811;0;2149;3;3;
/org.eclipse.jdt.ui/ui/org/eclipse/jdt/internal/ui/ResourceLocator.java;1;0;2;1;1;1;1;1;4;0;1;3580;6;6;1;0;0;1;2;3580;0;6340;2;1;
/org.eclipse.ui.workbench/Eclipse UI/org/eclipse/ui/internal/decorators/DecoratorDefinition.java;2;0;3;1;1;1;1;2;8;1;2;596;13;13;1;0;0;2;3;596;0;6338;3;2;
/org.eclipse.ant.ui/Ant Tools Support/org/eclipse/ant/ui/internal/preferences/AntTasksPage.java;1;0;8;1;0;0;0;8;36;2;6;250;67;67;2;2;0;8;8;262;2;1811;6;1;
/org.eclipse.help.webapp/src/org/eclipse/help/internal/webapp/HelpWebappPlugin.java;1;1;5;1;3;3;3;2;39;1;2;401;90;90;1;0;0;2;5;401;0;6337;5;1;
/org.eclipse.swt/Eclipse SWT/gtk1x/org/eclipse/swt/widgets/FileDialog.java;1;0;1;1;0;0;0;1;0;0;1;2327;0;0;1;0;0;1;1;2327;0;2327;1;1;
/org.eclipse.jdt.core.tests.model/workspace/Converter/src/test0244/Test.java;1;0;1;1;0;0;0;1;0;0;1;3714;0;0;1;0;0;1;1;3714;0;3714;1;1;
/org.eclipse.team.ui/org.eclipse.jdt.ui.team/src/org/eclipse/jdt/ui/team/JavaLogicalViewProvider.java;1;0;1;1;0;0;0;1;0;0;1;3734;0;0;1;0;0;1;1;3734;0;3734;1;1;
/org.eclipse.debug.ui/ui/org/eclipse/debug/internal/ui/views/memory/AbstractMemoryViewTab.java;1;0;1;1;1;1;1;0;0;0;0;5254;0;0;1;0;0;0;1;5254;0;5254;1;1;
/org.eclipse.jdt.ui/ui/org/eclipse/jdt/internal/ui/text/spelling/engine/IPhoneticHashProvider.java;2;0;2;1;1;1;1;1;2;0;1;3930;2;2;1;0;0;1;2;3930;0;6340;2;2;
/org.eclipse.core.runtime/src/org/eclipse/core/internal/runtime/SafeFileOutputStream.java;2;1;7;1;4;4;4;3;251;1;3;3013;529;529;1;0;0;3;7;3013;0;6340;7;2;
/org.eclipse.update.core/src/org/eclipse/update/search/VersionedIdentifiersFilter.java;1;1;5;1;2;2;2;3;7;1;3;825;11;11;1;0;0;3;5;825;0;6336;5;1;
/org.eclipse.jdt.ui.tests.refactoring/resources/ExtractMethodWorkSpace/ExtractMethodTests/return_in/A_test710.java;1;0;1;1;0;0;0;1;4;0;1;844;4;4;1;0;0;1;1;844;0;844;1;1;
/org.eclipse.help.tests/src/org/eclipse/help/tests/base/TestHelpUrls.java;1;1;3;1;2;2;2;1;123;0;1;2781;182;182;1;0;0;1;3;2781;0;6337;3;1;
/org.eclipse.jdt.core/search/org/eclipse/jdt/internal/core/search/HierarchyScope.java;2;0;6;1;1;1;1;5;7;1;5;259;23;23;1;0;0;5;6;259;0;5728;6;2;
/org.eclipse.core.runtime/src/org/eclipse/core/runtime/Platform.java;6;3;56;2;18;14;18;38;969;4;32;698;3165;3165;4;6;4;38;56;3194;10;6363;46;6;
/org.eclipse.jdt.core/model/org/eclipse/jdt/core/CorrectionEngine.java;3;0;10;1;0;0;0;10;112;1;10;440;165;165;1;0;0;10;10;440;0;3560;10;3;
/org.eclipse.ui.forms/src/org/eclipse/ui/forms/widgets/Hyperlink.java;1;0;7;1;0;0;0;7;15;1;7;4068;30;30;1;0;0;7;7;4068;0;5044;7;1;
/org.eclipse.team.core/src/org/eclipse/team/internal/core/subscribers/DescendantResourceVariantByteStore.java;2;1;3;1;2;2;2;1;9;0;1;4349;11;11;1;0;0;1;3;4349;0;6336;3;2;
/org.eclipse.core.tests.runtime/src/org/eclipse/core/tests/runtime/TestAdaptable.java;2;0;2;1;1;1;1;1;2;0;1;3812;2;2;1;0;0;1;2;3812;0;5149;2;2;
/org.eclipse.update.core/src/org/eclipse/update/internal/search/BaseSearchCategory.java;2;0;4;1;1;1;1;3;4;1;3;955;8;8;1;0;0;3;4;955;0;6336;4;2;
/org.eclipse.core.runtime/src/org/eclipse/core/internal/jobs/OrderedLock.java;3;1;26;1;3;3;3;23;526;1;23;351;1773;1773;1;0;0;23;26;351;0;5879;26;3;
/org.eclipse.jdt.ui/core refactoring/org/eclipse/jdt/internal/corext/refactoring/structure/MoveStaticMembersProcessor.java;3;1;11;1;11;11;11;0;123;0;0;5264;279;279;1;0;0;0;11;5264;0;6340;11;3;
/org.eclipse.jdt.ui/core refactoring/org/eclipse/jdt/internal/corext/refactoring/base/Refactoring.java;2;0;7;1;0;0;0;7;103;1;7;1126;140;140;1;0;0;7;7;1126;0;4575;7;2;
/org.eclipse.team.ui/src/org/eclipse/team/internal/ui/synchronize/SynchronizePageConfiguration.java;2;2;8;1;7;6;7;1;552;0;1;5043;612;612;2;0;1;1;8;5358;1;5732;7;2;
/org.eclipse.core.resources/src/org/eclipse/core/internal/resources/IModelObjectConstants.java;2;1;3;1;2;2;2;1;6;0;1;4085;8;8;1;0;0;1;3;4085;0;5168;3;2;
/org.eclipse.jdt.ui/ui/org/eclipse/jdt/internal/ui/reorg/JdtCopyAction.java;2;0;4;1;0;0;0;4;6;1;4;130;10;10;1;0;0;4;4;130;0;1111;4;2;
/org.eclipse.team.core/src/org/eclipse/team/core/synchronize/SyncInfo.java;2;2;8;1;5;4;5;3;411;1;3;4045;558;558;2;0;1;3;8;6123;1;6336;7;2;
/org.eclipse.ui.intro/src/org/eclipse/ui/internal/intro/impl/model/IntroGroup.java;1;0;1;1;1;1;1;0;0;0;0;5639;0;0;1;0;0;0;1;5639;0;5639;1;1;
/org.eclipse.pde.ui/src/org/eclipse/pde/internal/ui/editor/manifest/ManifestEditor.java;2;0;9;1;1;1;1;8;30;1;8;648;66;66;1;0;0;8;9;648;0;5431;9;2;
/org.eclipse.ui.workbench/Eclipse UI/org/eclipse/ui/internal/commands/IMutableCommandRegistry.java;3;1;9;1;2;2;2;7;12;2;6;1400;32;32;2;1;0;7;9;1417;1;6338;8;3;
/org.eclipse.ui.workbench/Eclipse UI/org/eclipse/ui/internal/csm/commands/ImageBindingDefinition.java;1;0;4;1;0;0;0;4;34;2;2;2532;66;66;2;2;0;4;4;2532;2;2556;2;1;
/org.eclipse.debug.ui/ui/org/eclipse/debug/internal/ui/views/launch/StandardDecoration.java;2;1;3;1;2;2;2;1;4;0;1;1220;8;8;1;0;0;1;3;1220;0;6336;3;2;
/org.eclipse.ui.workbench/Eclipse UI/org/eclipse/ui/internal/roles/RoleRegistryEvent.java;1;0;4;1;0;0;0;4;2;1;4;2444;4;4;1;0;0;4;4;2444;0;2864;4;1;
/org.eclipse.ui.workbench.texteditor/src/org/eclipse/ui/texteditor/SaveAction.java;1;1;2;1;2;2;2;0;2;0;0;5123;4;4;1;0;0;0;2;5123;0;6340;2;1;
/org.eclipse.jdt.core/model/org/eclipse/jdt/internal/compiler/DocumentElementParser.java;2;0;2;1;1;1;1;1;16;0;1;4461;16;16;1;0;0;1;2;4461;0;5878;2;2;
/org.eclipse.ui.ide/src/org/eclipse/ui/internal/ide/model/WorkbenchProject.java;1;0;1;1;0;0;0;1;0;0;1;2264;0;0;1;0;0;1;1;2264;0;2264;1;1;
/org.eclipse.jdt.core.tests.model/workspace/Converter/src/junit/framework/AssertionFailedError.java;1;0;1;1;0;0;0;1;0;0;1;3714;0;0;1;0;0;1;1;3714;0;3714;1;1;
/org.eclipse.ui.ide/src/org/eclipse/ui/internal/ide/misc/WorkInProgressMessages.java;3;1;3;1;2;2;2;1;2;0;1;3710;4;4;1;0;0;1;3;3710;0;6338;3;3;
/org.eclipse.jdt.ui.tests.refactoring/resources/ExtractMethodWorkSpace/ExtractMethodTests/return_out/A_test720.java;1;0;1;1;0;0;0;1;6;0;1;844;6;6;1;0;0;1;1;844;0;844;1;1;
/org.eclipse.jface/src/org/eclipse/jface/viewers/IDecoration.java;2;1;2;1;2;2;2;0;16;0;0;5108;18;18;1;0;0;0;2;5108;0;6338;2;2;
/org.eclipse.jdt.core.tests.model/workspace/Formatter/test169/A_in.java;1;0;1;1;0;0;0;1;0;0;1;2425;0;0;1;0;0;1;1;2425;0;2425;1;1;
/org.eclipse.jdt.ui/core refactoring/org/eclipse/jdt/internal/corext/refactoring/reorg/IPackageFragmentRootManipulationQuery.java;1;0;1;1;1;1;1;0;2;0;0;6340;2;2;1;0;0;0;1;6340;0;6340;1;1;
/org.eclipse.core.tests.runtime/src/org/eclipse/core/tests/runtime/content/MyContentDescriber.java;1;0;1;1;1;1;1;0;0;0;0;5781;0;0;1;0;0;0;1;5781;0;5781;1;1;
/org.eclipse.ui.workbench/Eclipse UI/org/eclipse/ui/internal/commands/registry/PluginCommandRegistry.java;1;0;3;1;0;0;0;3;14;1;3;1422;14;14;1;0;0;3;3;1422;0;1724;3;1;
/org.eclipse.ui.tests/Eclipse UI Tests/org/eclipse/ui/tests/api/IEditorRegistryTest.java;2;0;3;1;0;0;0;3;326;1;3;2375;586;586;1;0;0;3;3;2375;0;2738;3;2;
/org.eclipse.text.tests/src/org/eclipse/text/tests/link/ExclusivePositionUpdaterTest.java;2;0;2;1;1;1;1;1;0;0;1;5082;0;0;1;0;0;1;2;5082;0;5181;2;2;
/org.eclipse.ui.workbench/Eclipse UI/org/eclipse/ui/internal/intro/IntroMessages.java;1;0;3;1;0;0;0;3;6;1;3;3632;8;8;1;0;0;3;3;3632;0;4825;3;1;
/org.eclipse.osgi/osgi/src/org/eclipse/osgi/service/resolver/BundleSpecification.java;3;2;6;2;3;2;3;3;19;1;3;3013;39;39;2;0;1;3;6;6337;1;6337;5;3;
/org.eclipse.swt/Eclipse SWT/carbon/org/eclipse/swt/graphics/GC.java;4;2;28;1;7;6;7;21;317;2;18;332;1066;1066;2;3;1;21;28;1578;4;6352;24;4;
/org.eclipse.jdt.ui.tests.refactoring/resources/SurroundWithWorkSpace/SurroundWithTests/trycatch_out/TestMultiLine.java;1;0;1;1;0;0;0;1;4;0;1;845;4;4;1;0;0;1;1;845;0;845;1;1;
/org.eclipse.ui.workbench/Eclipse UI/org/eclipse/ui/internal/contexts/ExtensionContextRegistry.java;3;1;9;2;2;2;2;7;24;2;6;3066;74;74;2;1;0;7;9;3170;1;6338;8;3;
/org.eclipse.team.ui/src/org/eclipse/team/ui/sync/AndSyncInfoFilter.java;2;0;3;1;0;0;0;3;35;1;3;595;35;35;1;0;0;3;3;595;0;2632;3;2;
/org.eclipse.ui.ide/src/org/eclipse/ui/internal/dialogs/NewWizardNewPage.java;2;0;5;1;0;0;0;5;4;2;4;1526;8;8;2;1;0;5;5;1710;1;2263;4;2;
/org.eclipse.search/new search/org/eclipse/search/ui/ISearchResultPage.java;3;1;12;1;5;5;5;7;69;2;6;3474;284;284;2;1;0;7;12;4841;1;6340;11;3;
/org.eclipse.jdt.ui.tests.refactoring/resources/ExtractMethodWorkSpace/ExtractMethodTests/expression_out/A_test601.java;1;0;3;1;0;0;0;3;4;1;3;844;4;4;1;0;0;3;3;844;0;1474;3;1;
/org.eclipse.jdt.core/compiler/org/eclipse/jdt/internal/compiler/lookup/MethodScope.java;4;1;9;1;2;2;2;7;13;1;7;13;43;43;1;0;0;7;9;13;0;6126;9;4;
/org.eclipse.swt.tests/JUnit Tests/org/eclipse/swt/tests/junit/Test_org_eclipse_swt_widgets_Scrollable.java;2;0;2;1;0;0;0;2;36;1;2;2123;38;38;1;0;0;2;2;2123;0;2162;2;2;
/org.eclipse.jdt.core.tests.model/workspace/Converter/test0442/A.java;1;0;1;1;0;0;0;1;0;0;1;3714;0;0;1;0;0;1;1;3714;0;3714;1;1;
/org.eclipse.jdt.ui/core refactoring/org/eclipse/jdt/internal/corext/refactoring/typeconstraints/ConstraintCreator.java;2;0;2;1;1;1;1;1;8;0;1;74;8;8;1;0;0;1;2;74;0;6340;2;2;
/org.eclipse.jdt.core.tests.model/workspace/Formatter/test288/A_in.java;1;0;1;1;0;0;0;1;0;0;1;2443;0;0;1;0;0;1;1;2443;0;2443;1;1;
/org.eclipse.team.ui/src/org/eclipse/team/internal/ui/ConfigurationWizardNode.java;1;0;1;1;0;0;0;1;0;0;1;993;0;0;1;0;0;1;1;993;0;993;1;1;
/org.eclipse.jdt.debug.jdi.tests/tests/org/eclipse/debug/jdi/tests/ReferenceTypeTest.java;1;0;1;1;0;0;0;1;19;0;1;4264;19;19;1;0;0;1;1;4264;0;4264;1;1;
/org.eclipse.jdt.ui/core refactoring/org/eclipse/jdt/internal/corext/refactoring/base/Change.java;3;0;8;1;0;0;0;8;363;2;7;596;430;430;2;1;0;8;8;596;1;4575;7;3;
/org.eclipse.team.ftp/src/org/eclipse/team/internal/ftp/deployment/FTPRemoteResource.java;1;0;1;1;0;0;0;1;0;0;1;3221;0;0;1;0;0;1;1;3221;0;3221;1;1;
/org.eclipse.webdav/src/kernel/org/eclipse/webdav/internal/kernel/Policy.java;1;0;1;1;1;1;1;0;84;0;0;5151;84;84;1;0;0;0;1;5151;0;5151;1;1;
/org.eclipse.jdt.core.tests.model/workspace/Formatter/test486/A_in.java;1;0;1;1;1;1;1;0;0;0;0;5132;0;0;1;0;0;0;1;5132;0;5132;1;1;
/org.eclipse.jdt.ui/ui/org/eclipse/jdt/internal/ui/javaeditor/selectionactions/GoToNextPreviousMemberAction.java;1;0;1;1;1;1;1;0;2;0;0;6340;2;2;1;0;0;0;1;6340;0;6340;1;1;
/org.eclipse.webdav/src/interface/org/eclipse/webdav/dom/PropFind.java;1;0;2;1;2;1;2;0;340;0;0;5151;340;340;2;0;1;0;2;5151;1;5151;1;1;
/org.eclipse.text/src/org/eclipse/jface/text/templates/SimpleVariableResolver.java;2;1;4;1;2;2;2;2;11;1;2;4382;13;13;1;0;0;2;4;4382;0;5177;4;2;
/org.eclipse.jdt.core.tests.model/workspace/Converter/test0199/Test.java;1;0;1;1;0;0;0;1;0;0;1;3714;0;0;1;0;0;1;1;3714;0;3714;1;1;
/org.eclipse.team.ftp/src/org/eclipse/team/internal/ftp/client/FTPClient.java;2;0;5;1;1;1;1;4;88;1;4;1708;150;150;1;0;0;4;5;1708;0;6337;5;2;
/org.eclipse.jdt.core.tests.model/workspace/Converter/test0287/Test.java;1;0;1;1;0;0;0;1;0;0;1;3714;0;0;1;0;0;1;1;3714;0;3714;1;1;
/org.eclipse.swt/Eclipse SWT Mozilla/common/org/eclipse/swt/internal/mozilla/nsIWeakReference.java;1;0;1;1;0;0;0;1;0;0;1;1654;0;0;1;0;0;1;1;1654;0;1654;1;1;
/org.eclipse.jdt.core.tests.model/workspace/Converter/src/javadoc/test102/TestD1.java;1;0;1;1;0;0;0;1;0;0;1;4390;0;0;1;0;0;1;1;4390;0;4390;1;1;
/org.eclipse.core.runtime.osgi/src/org/eclipse/core/runtime/jobs/ILock.java;1;0;1;1;0;0;0;1;0;0;1;3013;0;0;1;0;0;1;1;3013;0;3013;1;1;
/org.eclipse.jdt.core.tests.model/workspace/Converter/src/test0399/A.java;1;0;1;1;0;0;0;1;0;0;1;3714;0;0;1;0;0;1;1;3714;0;3714;1;1;
/org.eclipse.jdt.ui.tests.refactoring/resources/RenameVirtualMethodInClass/test37/in/A.java;1;0;1;1;0;0;0;1;0;0;1;1653;0;0;1;0;0;1;1;1653;0;1653;1;1;
/org.eclipse.pde.build/src/org/eclipse/pde/internal/build/ant/ConditionTask.java;2;0;6;1;1;1;1;5;59;1;5;447;301;301;1;0;0;5;6;447;0;5145;6;2;
/org.eclipse.jdt.ui.tests.refactoring/resources/ExtractMethodWorkSpace/ExtractMethodTests/locals_out/A_test501.java;1;0;2;1;0;0;0;2;6;1;2;130;7;7;1;0;0;2;2;130;0;844;2;1;
/org.eclipse.core.runtime.compatibility/src-model/org/eclipse/core/runtime/model/ConfigurationPropertyModel.java;3;2;6;1;4;3;4;2;13;1;2;3013;22;22;2;0;1;2;6;5117;1;6340;5;3;
/org.eclipse.swt/Eclipse SWT Custom Widgets/common/org/eclipse/swt/custom/CTabFolderAdapter.java;2;1;2;1;2;2;2;0;4;0;0;5222;6;6;1;0;0;0;2;5222;0;6352;2;2;
/org.eclipse.debug.ui/ui/org/eclipse/debug/internal/ui/views/AbstractDebugEventHandler.java;1;0;1;1;0;0;0;1;2;0;1;2178;2;2;1;0;0;1;1;2178;0;2178;1;1;
/org.eclipse.jdt.core.tests.model/workspace/Converter/src/test0429/A.java;1;0;1;1;0;0;0;1;0;0;1;3714;0;0;1;0;0;1;1;3714;0;3714;1;1;
/org.eclipse.ui.workbench/Eclipse UI/org/eclipse/ui/internal/about/AboutItem.java;1;1;2;1;2;2;2;0;2;0;0;5483;2;2;1;0;0;0;2;5483;0;6338;2;1;
/org.eclipse.jdt.core.tests.model/workspace/Formatter/test084/A_out.java;1;0;1;1;0;0;0;1;0;0;1;2425;0;0;1;0;0;1;1;2425;0;2425;1;1;
/org.eclipse.jdt.ui/core refactoring/org/eclipse/jdt/internal/corext/refactoring/typeconstraints/ConstraintCollector.java;2;0;4;1;1;1;1;3;476;1;3;42;517;517;1;0;0;3;4;42;0;6340;4;2;
/org.eclipse.update.core/src/org/eclipse/update/internal/model/ConfigurationActivity.java;1;0;1;1;0;0;0;1;0;0;1;2634;0;0;1;0;0;1;1;2634;0;2634;1;1;
/org.eclipse.sdk.tests-feature/plugins/org.eclipse.perfmsr.core/src/org/eclipse/perfmsr/core/LoadValueConstants.java;2;1;7;1;6;6;6;1;26;0;1;4845;78;78;1;0;0;1;7;4845;0;6342;7;2;
/org.eclipse.jdt.ui.tests.refactoring/resources/ChangeSignature/canModify/A_testAll59_out.java;1;0;2;1;0;0;0;2;7;1;2;4350;7;7;1;0;0;2;2;4350;0;4486;2;1;
/org.eclipse.ui.views/src/org/eclipse/ui/views/navigator/NavigatorContentHandler.java;1;0;1;1;0;0;0;1;0;0;1;1083;0;0;1;0;0;1;1;1083;0;1083;1;1;
/org.eclipse.ui.workbench/Eclipse UI/org/eclipse/ui/internal/dialogs/WorkbenchWizardNode.java;3;1;3;1;2;2;2;1;254;0;1;3127;258;258;1;0;0;1;3;3127;0;6338;3;3;
/org.eclipse.jface/src/org/eclipse/jface/viewers/DecoratingLabelProvider.java;1;0;1;1;0;0;0;1;58;0;1;4587;58;58;1;0;0;1;1;4587;0;4587;1;1;
/org.eclipse.jdt.ui/core refactoring/org/eclipse/jdt/internal/corext/refactoring/participants/Processors.java;1;0;2;1;0;0;0;2;0;1;2;825;0;0;1;0;0;2;2;825;0;1668;2;1;
/org.eclipse.team.ui/src/org/eclipse/team/internal/ui/preferences/SyncViewerPreferencePage.java;2;1;20;1;3;3;3;17;146;2;13;987;606;606;2;4;0;17;20;987;4;6337;16;2;
/org.eclipse.ant.ui/Ant Editor/org/eclipse/ant/internal/ui/editor/templates/AntTemplateViewerConfiguration.java;1;0;1;1;1;1;1;0;0;0;0;5301;0;0;1;0;0;0;1;5301;0;5301;1;1;
/org.eclipse.jdt.core.tests.model/workspace/Formatter/test470/A_out.java;1;0;1;1;0;0;0;1;0;0;1;3942;0;0;1;0;0;1;1;3942;0;3942;1;1;
/org.eclipse.help/src/org/eclipse/help/internal/model/ITocElement.java;1;0;4;1;1;1;1;3;31;1;3;3513;62;62;1;0;0;3;4;3513;0;5827;4;1;
/org.eclipse.update.ui/src/org/eclipse/update/internal/ui/pages/InstallableSitePage.java;1;0;1;1;0;0;0;1;0;0;1;755;0;0;1;0;0;1;1;755;0;755;1;1;
/org.eclipse.ui.externaltools/Ant Editor/org/eclipse/ui/externaltools/internal/ant/dtd/schema/Nfm.java;1;0;1;1;0;0;0;1;0;0;1;282;0;0;1;0;0;1;1;282;0;282;1;1;
/org.eclipse.update.ui.forms/src/org/eclipse/update/ui/forms/internal/richtext/RichTextModel.java;1;0;2;1;0;0;0;2;0;1;2;2852;0;0;1;0;0;2;2;2852;0;2898;2;1;
/org.eclipse.ui.ide/src/org/eclipse/ui/views/markers/internal/ActionRemoveMarker.java;4;0;5;1;1;1;1;4;4;1;4;2208;10;10;1;0;0;4;5;2208;0;6338;5;4;
/org.eclipse.team.ui/src/org/eclipse/team/internal/ui/widgets/ControlFactory.java;1;0;1;1;0;0;0;1;0;0;1;3200;0;0;1;0;0;1;1;3200;0;3200;1;1;
/org.eclipse.ui.ide/src/org/eclipse/ui/internal/ide/Category.java;2;0;4;1;0;0;0;4;4;1;4;1537;8;8;1;0;0;4;4;1537;0;2616;4;2;
/org.eclipse.jdt.ui.tests.refactoring/resources/SurroundWithWorkSpace/SurroundWithTests/trycatch_in/TestOneLine.java;1;0;1;1;0;0;0;1;2;0;1;845;2;2;1;0;0;1;1;845;0;845;1;1;
/org.eclipse.swt/Eclipse SWT PI/gtk/org/eclipse/swt/internal/gtk/GNOME.java;2;0;5;1;0;0;0;5;17;1;5;1653;37;37;1;0;0;5;5;1653;0;4333;5;2;
/org.eclipse.jdt.ui/ui/org/eclipse/jdt/internal/ui/search/PathSorter.java;1;1;3;1;2;2;2;1;6;0;1;3711;10;10;1;0;0;1;3;3711;0;5462;3;1;
/org.eclipse.jdt.core.tests.model/workspace/Converter/test0299/Test.java;1;0;1;1;0;0;0;1;0;0;1;3714;0;0;1;0;0;1;1;3714;0;3714;1;1;
/org.eclipse.pde.ui/src_Forms/org/eclipse/pde/internal/ui/newparts/StructuredViewerPart.java;2;0;3;1;1;1;1;2;2;1;2;3795;2;2;1;0;0;2;3;3795;0;5431;3;2;
/org.eclipse.jdt.core.tests.model/workspace/Converter/test0132/Test.java;1;0;1;1;0;0;0;1;0;0;1;3714;0;0;1;0;0;1;1;3714;0;3714;1;1;
/org.eclipse.jdt.ui/core extension/org/eclipse/jdt/internal/corext/dom/Bindings.java;5;1;29;2;7;7;7;22;276;2;20;42;816;816;2;2;0;22;29;2561;2;6340;27;5;
/org.eclipse.jdt.ui/ui refactoring/org/eclipse/jdt/internal/ui/refactoring/UseSupertypeWizard.java;3;0;13;1;1;1;1;12;196;1;12;518;410;410;1;0;0;12;13;518;0;6340;13;3;
/org.eclipse.core.runtime/src/org/eclipse/core/internal/plugins/ConfigurationElement.java;2;0;3;1;0;0;0;3;28;1;3;536;38;38;1;0;0;3;3;536;0;3013;3;2;
/org.eclipse.jdt.core.tests.model/workspace/Converter/src/javadoc/test016b/Test.java;1;0;2;1;0;0;0;2;0;1;2;4311;0;0;1;0;0;2;2;4311;0;4390;2;1;
/org.eclipse.jdt.ui/ui/org/eclipse/jdt/ui/actions/AddToClasspathAction.java;5;1;8;1;2;2;2;6;66;1;6;592;156;156;1;0;0;6;8;592;0;6340;8;5;
/org.eclipse.ui.workbench/Eclipse UI/org/eclipse/ui/internal/CoolItemMultiToolBarManager.java;1;0;1;1;0;0;0;1;0;0;1;3220;0;0;1;0;0;1;1;3220;0;3220;1;1;
/org.eclipse.jdt.ui.tests/ui/org/eclipse/jdt/ui/tests/astrewrite/ASTRewritingMethodDeclTest.java;2;0;14;1;1;1;1;13;225;1;13;780;1555;1555;1;0;0;13;14;780;0;5406;14;2;
/org.eclipse.jdt.core.tests.model/workspace/Converter/junit/runner/StandardTestSuiteLoader.java;1;0;1;1;0;0;0;1;0;0;1;3714;0;0;1;0;0;1;1;3714;0;3714;1;1;
/org.eclipse.swt.opengl/gtk/org/eclipse/swt/opengl/internal/gtk/GTKGLEXT.java;1;0;2;1;0;0;0;2;0;1;2;1175;0;0;1;0;0;2;2;1175;0;1572;2;1;
/org.eclipse.jdt.core/dom/org/eclipse/jdt/core/dom/PostfixExpression.java;3;1;8;1;2;2;2;6;105;1;6;3560;135;135;1;0;0;6;8;3560;0;5272;8;3;
/org.eclipse.update.core/src/org/eclipse/update/internal/configuration/InstallConfigurationModel.java;1;0;1;1;0;0;0;1;0;0;1;2828;0;0;1;0;0;1;1;2828;0;2828;1;1;
/org.eclipse.update.core/src/org/eclipse/update/operations/IConfigFeatureOperation.java;1;2;8;1;3;2;3;5;11;2;4;825;20;20;2;1;1;5;8;825;2;6336;6;1;
/org.eclipse.osgi/core/framework/org/eclipse/osgi/framework/internal/core/PermissionsHash.java;4;1;5;1;3;3;3;2;145;1;2;3013;155;155;1;0;0;2;5;3013;0;6337;5;4;
/org.eclipse.swt/Eclipse SWT/common/org/eclipse/swt/layout/FormLayout.java;2;0;4;1;0;0;0;4;28;1;4;428;89;89;1;0;0;4;4;428;0;2767;4;2;
/org.eclipse.team.core/src/org/eclipse/team/internal/core/ExceptionCollector.java;1;0;1;1;0;0;0;1;0;0;1;1433;0;0;1;0;0;1;1;1433;0;1433;1;1;
/org.eclipse.ui.workbench.texteditor/src/org/eclipse/ui/texteditor/IReadOnlyDependent.java;1;0;1;1;1;1;1;0;2;0;0;6340;2;2;1;0;0;0;1;6340;0;6340;1;1;
/org.eclipse.update.ui.forms/Eclipse Forms/org/eclipse/ui/forms/parts/AbstractHyperlink.java;1;0;4;1;0;0;0;4;8;2;2;3096;12;12;2;2;0;4;4;3096;2;3133;2;1;
/org.eclipse.jdt.launching/launching/org/eclipse/jdt/launching/ExecutionArguments.java;4;1;5;1;2;2;2;3;11;1;3;2165;35;35;1;0;0;3;5;2165;0;6336;5;4;
/org.eclipse.team.cvs.ui/src/org/eclipse/team/internal/ccvs/ui/MessageDialogWithToggle.java;1;0;2;1;1;1;1;1;0;0;1;994;0;0;1;0;0;1;2;994;0;5614;2;1;
/org.eclipse.jdt.ui.tests.refactoring/resources/ChangeTypeRefactoring/positive/A_testParameterName_out.java;1;0;1;1;0;0;0;1;0;0;1;2844;0;0;1;0;0;1;1;2844;0;2844;1;1;
/org.eclipse.update.ui/src/org/eclipse/update/internal/ui/wizards/TargetPage.java;3;2;15;1;5;4;5;10;1060;1;10;755;2596;2596;2;0;1;10;15;6147;1;6336;14;3;
/org.eclipse.jdt.core.tests.model/workspace/Converter/test0407/A.java;1;0;1;1;0;0;0;1;0;0;1;3714;0;0;1;0;0;1;1;3714;0;3714;1;1;
/org.eclipse.jdt.ui.tests.refactoring/resources/ExtractMethodWorkSpace/ExtractMethodTests/semicolon_in/A_test406.java;1;0;1;1;0;0;0;1;2;0;1;844;2;2;1;0;0;1;1;844;0;844;1;1;
/org.eclipse.ui.examples.javaeditor/Eclipse Java Editor Example/org/eclipse/ui/examples/javaeditor/JavaAnnotationHover.java;1;0;1;1;1;1;1;0;2;0;0;6340;2;2;1;0;0;0;1;6340;0;6340;1;1;
/org.eclipse.team.ui/src/org/eclipse/team/ui/synchronize/content/SyncInfoLabelProvider.java;1;0;1;1;0;0;0;1;0;0;1;3734;0;0;1;0;0;1;1;3734;0;3734;1;1;
/org.eclipse.update.ui/src/org/eclipse/update/internal/ui/views/BaseView.java;1;0;1;1;0;0;0;1;0;0;1;755;0;0;1;0;0;1;1;755;0;755;1;1;
/org.eclipse.jdt.core/compiler/org/eclipse/jdt/internal/compiler/ast/EnumConstant.java;1;0;1;1;0;0;0;1;0;0;1;2843;0;0;1;0;0;1;1;2843;0;2843;1;1;
/org.eclipse.debug.core/core/org/eclipse/debug/core/model/IStep.java;2;0;2;1;1;1;1;1;5;0;1;3613;9;9;1;0;0;1;2;3613;0;6336;2;2;
/org.eclipse.ui.intro/src/org/eclipse/ui/internal/intro/impl/parts/PageStyleManager.java;1;4;9;1;9;6;9;0;171;0;0;5449;348;348;4;0;3;0;9;5533;3;5714;6;1;
/org.eclipse.jdt.core.tests.model/workspace/Converter/src/junit/runner/TestSuiteLoader.java;1;0;1;1;0;0;0;1;0;0;1;3714;0;0;1;0;0;1;1;3714;0;3714;1;1;
/org.eclipse.ui.workbench/Eclipse UI/org/eclipse/ui/internal/csm/activities/workbench/IActivityActivationServiceListener.java;1;0;2;1;0;0;0;2;0;1;2;2310;0;0;1;0;0;2;2;2310;0;2371;2;1;
/org.eclipse.team.ui/src/org/eclipse/team/internal/ui/widgets/FormLabel.java;1;0;1;1;0;0;0;1;0;0;1;3176;0;0;1;0;0;1;1;3176;0;3176;1;1;
/org.eclipse.compare.examples.xml/src/org/eclipse/compare/examples/xml/XMLCompareAddIdMapDialog.java;1;0;3;1;0;0;0;3;41;1;3;1106;43;43;1;0;0;3;3;1106;0;3938;3;1;
/org.eclipse.help.base/src/org/eclipse/help/internal/search/QueryTooComplexException.java;1;1;3;1;2;2;2;1;6;0;1;1930;12;12;1;0;0;1;3;1930;0;6337;3;1;
/org.eclipse.ui.workbench/Eclipse UI/org/eclipse/ui/internal/contexts/ContextContextBinding.java;2;0;4;1;0;0;0;4;1;1;4;3066;2;2;1;0;0;4;4;3066;0;4969;4;2;
/org.eclipse.ui.ide/src/org/eclipse/ui/views/bookmarkexplorer/BookmarkPropertiesDialog.java;1;0;1;1;0;0;0;1;0;0;1;2208;0;0;1;0;0;1;1;2208;0;2208;1;1;
/org.eclipse.update.tests.core/src/org/eclipse/update/tests/api/TestFeatureContentProvider_FileFilterAPI.java;1;0;2;1;1;1;1;1;4;0;1;4928;5;5;1;0;0;1;2;4928;0;6336;2;1;
/org.eclipse.jdt.debug.ui/ui/org/eclipse/jdt/internal/debug/ui/launchConfigurations/IClasspathEntry.java;1;0;2;1;0;0;0;2;0;0;1;2685;0;0;2;1;0;2;2;2685;1;2685;1;1;
/org.eclipse.swt.examples/src/org/eclipse/swt/examples/controlexample/ShellTab.java;1;1;3;1;2;2;2;1;4;0;1;2729;9;9;1;0;0;1;3;2729;0;6352;3;1;
/org.eclipse.jdt.core.tests.model/workspace/Converter/test0051/Test.java;1;0;1;1;0;0;0;1;0;0;1;3714;0;0;1;0;0;1;1;3714;0;3714;1;1;
/org.eclipse.jdt.ui/core extension/org/eclipse/jdt/internal/corext/template/java/CodeTemplateContext.java;3;0;9;1;1;1;1;8;40;2;6;762;96;96;2;2;0;8;9;4258;2;6340;7;3;
/org.eclipse.jdt.ui/core refactoring/org/eclipse/jdt/internal/corext/refactoring/typeconstraints/ParameterTypeVariable.java;2;0;6;1;1;1;1;5;19;1;5;42;39;39;1;0;0;5;6;42;0;6340;6;2;
/org.eclipse.ui.views/src/org/eclipse/ui/views/internal/table/TableContentProvider.java;1;0;2;1;0;0;0;2;0;0;1;749;0;0;2;1;0;2;2;749;1;749;1;1;
/org.eclipse.ui.views/src/org/eclipse/ui/views/internal/markers/tasks/Priority.java;1;0;2;1;0;0;0;2;0;1;2;265;0;0;1;0;0;2;2;265;0;749;2;1;
/org.eclipse.jdt.debug.ui/ui/org/eclipse/jdt/internal/debug/ui/snippeteditor/NewSnippetFileCreationWizard.java;1;0;1;1;0;0;0;1;0;0;1;4854;0;0;1;0;0;1;1;4854;0;4854;1;1;
/org.eclipse.jdt.core.tests.model/workspace/Converter/src/junit/swingui/TestRunContext.java;1;0;1;1;0;0;0;1;0;0;1;3714;0;0;1;0;0;1;1;3714;0;3714;1;1;
/org.eclipse.pde.ui/src/org/eclipse/pde/internal/ui/feature/FeatureSpecPage.java;2;0;3;1;0;0;0;3;26;1;3;3791;29;29;1;0;0;3;3;3791;0;3840;3;2;
/org.eclipse.jdt.core.tests.model/workspace/Converter/test0317/Test.java;1;0;1;1;0;0;0;1;0;0;1;3714;0;0;1;0;0;1;1;3714;0;3714;1;1;
/org.eclipse.ui.workbench/Eclipse UI/org/eclipse/ui/internal/dialogs/InternalBase64Encoder.java;1;0;1;1;0;0;0;1;0;0;1;2737;0;0;1;0;0;1;1;2737;0;2737;1;1;
/org.eclipse.jdt.ui/ui/org/eclipse/jdt/internal/ui/javaeditor/SemanticHighlighting.java;3;1;3;1;3;3;3;0;7;0;0;5272;12;12;1;0;0;0;3;5272;0;6144;3;3;
/org.eclipse.team.tests.cvs.core/src/org/eclipse/team/tests/ccvs/core/CVSTestLogListener.java;1;0;4;1;0;0;0;4;42;1;4;2761;84;84;1;0;0;4;4;2761;0;2946;4;1;
/org.eclipse.help.webapp/src_servlets/org/eclipse/help/internal/webapp/servlet/IFilter.java;1;1;2;1;2;2;2;0;14;0;0;5827;20;20;1;0;0;0;2;5827;0;6337;2;1;
/org.eclipse.swt/Eclipse SWT/photon/org/eclipse/swt/graphics/GCData.java;4;0;4;1;1;1;1;3;4;1;3;0;8;8;1;0;0;3;4;0;0;6352;4;4;
/org.eclipse.jdt.debug.tests/tests/org/eclipse/jdt/debug/tests/core/LaunchConfigurationVariableTests.java;1;0;3;1;0;0;0;3;16;1;3;737;16;16;1;0;0;3;3;737;0;771;3;1;
/org.eclipse.jdt.core.tests.model/workspace/Converter/src/test0296/Test.java;1;0;1;1;0;0;0;1;0;0;1;3714;0;0;1;0;0;1;1;3714;0;3714;1;1;
/org.eclipse.ui.workbench/Eclipse UI/org/eclipse/ui/internal/commands/old/RegistryReader.java;1;0;1;1;0;0;0;1;0;0;1;1321;0;0;1;0;0;1;1;1321;0;1321;1;1;
/org.eclipse.jdt.ui.tests.refactoring/resources/ExtractMethodWorkSpace/ExtractMethodTests/locals_out/A_test536.java;1;0;1;1;0;0;0;1;6;0;1;844;6;6;1;0;0;1;1;844;0;844;1;1;
/org.eclipse.jdt.ui/core refactoring/org/eclipse/jdt/internal/corext/refactoring/reorg2/ReorgQueries.java;1;0;5;1;0;0;0;5;147;1;5;444;254;254;1;0;0;5;5;444;0;1114;5;1;
/org.eclipse.ui.workbench/Eclipse UI/org/eclipse/ui/internal/csm/commands/ActivityBindingDefinition.java;1;0;3;1;0;0;0;3;60;2;2;2533;76;76;2;1;0;3;3;2556;1;2556;2;1;
/org.eclipse.ui.ide/src/org/eclipse/ui/internal/ide/dialogs/PathVariableSelectionDialog.java;1;0;1;1;0;0;0;1;0;0;1;2264;0;0;1;0;0;1;1;2264;0;2264;1;1;
/org.eclipse.jdt.ui.examples.javafamily/coresearch-experiment/org/eclipse/search/internal/core/SearchCore.java;1;0;2;1;0;0;0;2;0;1;2;1380;0;0;1;0;0;2;2;1380;0;3214;2;1;
/org.eclipse.ltk.ui.refactoring/src/org/eclipse/ltk/internal/ui/refactoring/WorkbenchRunnableAdapter.java;1;0;3;1;1;1;1;2;6;1;2;4965;9;9;1;0;0;2;3;4965;0;5651;3;1;
/org.eclipse.ui.tests/Eclipse UI Tests/org/eclipse/ui/tests/api/IWorkbenchPageTest.java;5;2;20;2;8;7;8;12;152;2;11;1542;739;739;2;1;1;12;20;4765;2;6338;18;5;
/org.eclipse.webdav/src/interface/org/eclipse/webdav/dom/ElementEditor.java;1;0;2;1;2;1;2;0;3466;0;0;5151;3466;3466;2;0;1;0;2;5151;1;5151;1;1;
/org.eclipse.ui.workbench/Eclipse UI/org/eclipse/ui/branding/IBundleGroupConstants.java;2;1;3;1;2;2;2;1;18;0;1;4428;23;23;1;0;0;1;3;4428;0;6321;3;2;
/org.eclipse.help/src/org/eclipse/help/internal/toc/HrefUtil.java;1;1;4;1;3;3;3;1;48;0;1;644;95;95;1;0;0;1;4;644;0;6337;4;1;
/org.eclipse.team.cvs.ui/src/org/eclipse/team/internal/ccvs/ui/subscriber/CompareParticipantPage.java;2;0;6;2;0;0;0;6;60;2;5;4137;106;106;2;1;0;6;6;4585;1;4585;5;2;
/org.eclipse.jdt.core.tests.model/workspace/Converter/src/junit/framework/ComparisonFailure.java;1;0;1;1;0;0;0;1;0;0;1;3714;0;0;1;0;0;1;1;3714;0;3714;1;1;
/org.eclipse.core.expressions.tests/src/org/eclipse/core/internal/expressions/tests/I.java;1;0;2;1;1;1;1;1;2;0;1;4108;2;2;1;0;0;1;2;4108;0;6340;2;1;
/org.eclipse.jdt.ui.tests.refactoring/resources/ExtractMethodWorkSpace/ExtractMethodTests/expression_out/A_test622.java;1;0;4;1;0;0;0;4;4;1;4;130;5;5;1;0;0;4;4;130;0;1474;4;1;
/org.eclipse.ui.views/src/org/eclipse/ui/views/internal/markers/Message.java;1;0;2;1;0;0;0;2;0;1;2;265;0;0;1;0;0;2;2;265;0;749;2;1;
/org.eclipse.core.tests.resources/src/org/eclipse/core/tests/resources/regression/IWorkspaceTest.java;1;0;3;1;3;1;3;0;458;0;0;5147;458;458;3;0;2;0;3;5147;2;5147;1;1;
/org.eclipse.jdt.debug.ui/ui/org/eclipse/jdt/internal/debug/ui/launcher/RuntimeClasspathAdvancedDialog.java;3;1;6;1;2;2;2;4;142;1;4;1139;258;258;1;0;0;4;6;1139;0;6336;6;3;
/org.eclipse.jdt.core.tests.model/workspace/Formatter/test464/A_in.java;1;0;1;1;0;0;0;1;0;0;1;3915;0;0;1;0;0;1;1;3915;0;3915;1;1;
/org.eclipse.osgi/resolver/src/org/eclipse/core/internal/dependencies/SimpleSelectionPolicy.java;3;1;3;1;2;2;2;1;11;0;1;3013;17;17;1;0;0;1;3;3013;0;5226;3;3;
/org.eclipse.ltk.ui.refactoring/src/org/eclipse/ltk/internal/ui/refactoring/util/PixelConverter.java;1;0;2;1;0;0;0;2;13;1;2;4965;13;13;1;0;0;2;2;4965;0;5083;2;1;
/org.eclipse.swt.tests/JUnit Tests/org/eclipse/swt/tests/junit/Test_org_eclipse_swt_layout_RowLayout.java;2;0;2;1;0;0;0;2;19;1;2;2144;26;26;1;0;0;2;2;2144;0;2176;2;2;
/org.eclipse.jdt.core.tests.model/workspace/Converter/src/junit/awtui/Logo.java;1;0;1;1;0;0;0;1;0;0;1;3714;0;0;1;0;0;1;1;3714;0;3714;1;1;
/org.eclipse.jdt.ui.tests.refactoring/resources/ExtractMethodWorkSpace/ExtractMethodTests/locals_in/A_test520.java;1;0;1;1;0;0;0;1;2;0;1;844;2;2;1;0;0;1;1;844;0;844;1;1;
/org.eclipse.update.ui.forms/src/org/eclipse/update/ui/forms/internal/richtext/ParagraphSegment.java;1;0;2;1;0;0;0;2;0;1;2;2849;0;0;1;0;0;2;2;2849;0;2898;2;1;
/org.eclipse.ui.workbench/Eclipse UI/org/eclipse/ui/commands/internal/KeySupport.java;1;0;2;1;0;0;0;2;0;1;2;786;0;0;1;0;0;2;2;786;0;956;2;1;
/org.eclipse.ui.workbench/Eclipse UI/org/eclipse/ui/internal/activities/ui/ActivityEnabler.java;2;0;7;2;0;0;0;7;78;2;5;2844;110;110;2;2;0;7;7;2864;2;3061;5;2;
/org.eclipse.jface.text/src/org/eclipse/jface/text/DefaultDocumentAdapter.java;2;2;4;2;4;3;4;0;73;0;0;5177;82;82;2;0;1;0;4;6337;1;6359;3;2;
/org.eclipse.jdt.core.tests.model/workspace/Converter/src/javadoc/test019b/Test.java;1;0;2;1;0;0;0;2;0;1;2;4311;0;0;1;0;0;2;2;4311;0;4390;2;1;
/org.eclipse.jdt.ui/ui/org/eclipse/jdt/internal/ui/wizards/dialogfields/StringButtonStatusDialogField.java;2;1;2;1;2;2;2;0;14;0;0;5247;16;16;1;0;0;0;2;5247;0;6340;2;2;
/org.eclipse.jdt.ui.tests.refactoring/resources/ConvertAnonymousToNested/canConvert/A_test11_out.java;1;0;1;1;0;0;0;1;2;0;1;1005;2;2;1;0;0;1;1;1005;0;1005;1;1;
/org.eclipse.team.ui/src/org/eclipse/team/ui/synchronize/subscriber/SubscriberRefreshWizard.java;1;0;3;1;0;0;0;3;8;1;3;4518;8;8;1;0;0;3;3;4518;0;4632;3;1;
/org.eclipse.sdk.tests-feature/plugins/org.eclipse.perfmsr.ui.client/src/org/eclipse/perfmsr/ui/client/ScenariosPreferencePage.java;1;1;2;1;2;2;2;0;2;0;0;5803;2;2;1;0;0;0;2;5803;0;6150;2;1;
/org.eclipse.debug.ui/ui/org/eclipse/debug/internal/ui/actions/ChangeVariableValueInputDialog.java;4;1;5;1;2;2;2;3;437;1;3;1239;507;507;1;0;0;3;5;1239;0;6336;5;4;
/org.eclipse.jdt.debug.tests/test plugin/org/eclipse/jdt/debug/testplugin/TestJavaApplicationTabGroup.java;1;0;1;1;0;0;0;1;0;0;1;473;0;0;1;0;0;1;1;473;0;473;1;1;
/org.eclipse.pde.core/src/org/eclipse/pde/internal/core/plugin/ImportObject.java;1;0;2;1;1;1;1;1;4;0;1;4203;5;5;1;0;0;1;2;4203;0;6336;2;1;
/org.eclipse.jdt.core/codeassist/org/eclipse/jdt/internal/codeassist/select/SelectionOnQualifiedAllocationExpression.java;3;0;4;1;0;0;0;4;69;1;4;991;76;76;1;0;0;4;4;991;0;3560;4;3;
/org.eclipse.pde.ui/src_OSGi/org/eclipse/pde/internal/ui/wizards/bundles/PluginToBundleAction.java;1;0;3;1;0;0;0;3;7;1;3;2184;7;7;1;0;0;3;3;2184;0;2244;3;1;
/org.eclipse.jdt.core.tests.model/workspace/Converter/test0347/Test2.java;1;0;1;1;0;0;0;1;0;0;1;3714;0;0;1;0;0;1;1;3714;0;3714;1;1;
/org.eclipse.ant.core/src/org/eclipse/ant/internal/core/IAntCoreConstants.java;1;0;2;1;1;1;1;1;9;0;1;2575;13;13;1;0;0;1;2;2575;0;5925;2;1;
/org.eclipse.jdt.ui.tests.refactoring/resources/PasteSourceReference/test0/in/A.java;1;0;1;1;0;0;0;1;0;0;1;1311;0;0;1;0;0;1;1;1311;0;1311;1;1;
/org.eclipse.jdt.core.tests.model/workspace/Converter/src/test0071/Test.java;1;0;1;1;0;0;0;1;0;0;1;3714;0;0;1;0;0;1;1;3714;0;3714;1;1;
/org.eclipse.pde.ui/src/org/eclipse/pde/internal/ui/editor/manifest/ResourceAttributeDescriptor.java;1;0;1;1;1;1;1;0;0;0;0;5431;0;0;1;0;0;0;1;5431;0;5431;1;1;
/org.eclipse.search/new search/org/eclipse/search/ui/text/MatchEvent.java;3;1;6;1;4;4;4;2;64;1;2;3711;130;130;1;0;0;2;6;3711;0;6340;6;3;
/org.eclipse.swt/Eclipse SWT/common/org/eclipse/swt/graphics/ImageLoader.java;3;0;3;1;1;1;1;2;12;1;2;2308;22;22;1;0;0;2;3;2308;0;6352;3;3;
/org.eclipse.swt/Eclipse SWT/gtk1x/org/eclipse/swt/graphics/Pixbuffer.java;1;0;1;1;0;0;0;1;0;0;1;2327;0;0;1;0;0;1;1;2327;0;2327;1;1;
/org.eclipse.swt/Eclipse SWT PI/carbon/org/eclipse/swt/internal/carbon/HFSFlavor.java;1;0;2;1;0;0;0;2;0;1;2;203;0;0;1;0;0;2;2;203;0;298;2;1;
/org.eclipse.team.cvs.core/src/org/eclipse/team/internal/ccvs/core/client/ResponseHandler.java;2;1;4;1;2;2;2;2;84;1;2;1672;101;101;1;0;0;2;4;1672;0;6337;4;2;
/org.eclipse.ant.tests.ui/Ant Editor Tests/org/eclipse/ant/tests/ui/editor/support/TestTextCompletionProcessor.java;1;1;16;1;4;4;4;12;46;2;9;1811;187;187;2;3;0;12;16;1811;3;6336;13;1;
/org.eclipse.search/new search/org/eclipse/search/ui/text/IFileMatchAdapter.java;3;3;5;1;5;3;5;0;22;0;0;5178;33;33;3;0;2;0;5;5178;2;6340;3;3;
/org.eclipse.debug.ui/ui/org/eclipse/debug/ui/launchVariables/expanders/ProjectExpander.java;1;0;2;1;0;0;0;2;0;1;2;562;0;0;1;0;0;2;2;562;0;737;2;1;
/org.eclipse.jdt.ui.tests.refactoring/resources/ExtractInterface/testConditional1/out/X.java;1;0;1;1;0;0;0;1;0;0;1;3902;0;0;1;0;0;1;1;3902;0;3902;1;1;
/org.eclipse.ui.views/src/org/eclipse/ui/views/internal/markers/ActionRemoveMarker.java;1;0;2;1;0;0;0;2;0;0;1;749;0;0;2;1;0;2;2;749;1;749;1;1;
/org.eclipse.update.core/src/org/eclipse/update/internal/model/ConfiguredSiteModel.java;2;1;4;1;2;2;2;2;8;1;2;890;21;21;1;0;0;2;4;890;0;6336;4;2;
/org.eclipse.team.ftp/src/org/eclipse/team/internal/ftp/subscriber/FTPSubscriberResource.java;2;0;4;1;1;1;1;3;259;1;3;3339;289;289;1;0;0;3;4;3339;0;6337;4;2;
/org.eclipse.jdt.core.tests.model/workspace/Formatter/test098/A_in.java;1;0;1;1;0;0;0;1;0;0;1;2425;0;0;1;0;0;1;1;2425;0;2425;1;1;
/org.eclipse.jdt.core/model/org/eclipse/jdt/core/IPackageDeclaration.java;1;0;2;1;0;0;0;2;2;1;2;2583;4;4;1;0;0;2;2;2583;0;3560;2;1;
/org.eclipse.ui.editors/src/org/eclipse/ui/texteditor/MarkerAnnotationPresentation.java;1;0;1;1;0;0;0;1;0;0;1;2815;0;0;1;0;0;1;1;2815;0;2815;1;1;
/org.eclipse.ui.ide/src/org/eclipse/ui/internal/ide/dialogs/MultiStepConfigureWizardPage.java;1;0;1;1;0;0;0;1;0;0;1;2264;0;0;1;0;0;1;1;2264;0;2264;1;1;
/org.eclipse.jdt.ui.tests.refactoring/resources/IntroduceParameter/invalid/NotInMethod2.java;1;0;1;1;0;0;0;1;0;0;1;2281;0;0;1;0;0;1;1;2281;0;2281;1;1;
/org.eclipse.jdt.ui/ui/org/eclipse/jdt/internal/ui/reorg/ReorgQueries.java;1;0;3;1;0;0;0;3;41;2;2;803;41;41;2;1;0;3;3;803;1;818;2;1;
/org.eclipse.jdt.core.tests.model/workspace/Converter/src/test0456/A.java;1;0;1;1;0;0;0;1;0;0;1;3714;0;0;1;0;0;1;1;3714;0;3714;1;1;
/org.eclipse.update.core/src/org/eclipse/update/internal/operations/PatchCleaner2.java;1;0;2;1;0;0;0;2;0;1;2;825;0;0;1;0;0;2;2;825;0;1131;2;1;
/org.eclipse.jdt.ui.examples.javafamily/src/org/eclipse/jdt/internal/ui/examples/jspeditor/Jsp2JavaReconcilePipeParticipant.java;1;0;9;1;0;0;0;9;81;2;8;1071;172;172;2;1;0;9;9;1150;1;1629;8;1;
/org.eclipse.team.cvs.ui/src/org/eclipse/team/internal/ccvs/ui/subscriber/CompareRevertOperation.java;2;1;5;1;3;3;3;2;11;1;2;4450;27;27;1;0;0;2;5;4450;0;6337;5;2;
/org.eclipse.search/search/org/eclipse/search/internal/ui/text/FileSearchPage.java;2;2;19;1;10;8;10;9;51;2;8;3711;299;299;2;1;2;9;19;4794;3;6340;16;2;
/org.eclipse.jdt.ui/ui/org/eclipse/jdt/ui/IWorkingCopyManagerExtension.java;2;0;2;2;2;1;2;0;4;0;0;6334;4;4;2;0;1;0;2;6334;1;6334;1;2;
/org.eclipse.core.resources/src/org/eclipse/core/internal/resources/ResourceStatus.java;2;1;3;1;2;2;2;1;118;0;1;1477;130;130;1;0;0;1;3;1477;0;5146;3;2;
/org.eclipse.core.variables/src/org/eclipse/core/variables/IDynamicVariable.java;3;1;5;1;2;2;2;3;13;1;3;2514;41;41;1;0;0;3;5;2514;0;6336;5;3;
/org.eclipse.update.ui/src/org/eclipse/update/internal/ui/views/InstallOptionalFeatureAction.java;3;1;12;1;3;3;3;9;20;1;9;825;82;82;1;0;0;9;12;825;0;6336;12;3;
/org.eclipse.swt.graphics.text/Eclipse SWT/motif/org/eclipse/swt/graphics/TextLayout.java;1;0;1;1;0;0;0;1;0;0;1;4854;0;0;1;0;0;1;1;4854;0;4854;1;1;
/org.eclipse.core.runtime/src/org/eclipse/core/internal/jobs/JobChangeEvent.java;3;1;6;1;2;2;2;4;98;1;4;1081;207;207;1;0;0;4;6;1081;0;5738;6;3;
/org.eclipse.jdt.core.tests.model/workspace/Formatter/test209/A_in.java;1;0;1;1;0;0;0;1;0;0;1;2424;0;0;1;0;0;1;1;2424;0;2424;1;1;
/org.eclipse.jdt.core.tests.model/workspace/Encoding/src/testUTF8/Test.java;1;0;3;1;1;1;1;2;2;1;2;4711;2;2;1;0;0;2;3;4711;0;6218;3;1;
/org.eclipse.ui.workbench/Eclipse UI/org/eclipse/ui/internal/CoolItemGroupSeparator.java;1;0;1;1;0;0;0;1;0;0;1;3220;0;0;1;0;0;1;1;3220;0;3220;1;1;
/org.eclipse.update.ui/src/org/eclipse/update/internal/ui/views/SearchMonitorManager.java;1;0;1;1;0;0;0;1;0;0;1;755;0;0;1;0;0;1;1;755;0;755;1;1;
/org.eclipse.jdt.ui.tests.refactoring/resources/MoveInnerToTopLevel/test_nonstatic_36/out/A.java;1;0;1;1;0;0;0;1;1;0;1;305;1;1;1;0;0;1;1;305;0;305;1;1;
/org.eclipse.ui.workbench/Eclipse UI/org/eclipse/ui/internal/skins/newlook/BasicStackPresentation.java;2;0;4;1;0;0;0;4;20;2;3;4438;20;20;2;1;0;4;4;4453;1;4469;3;2;
/org.eclipse.jface.text/src/org/eclipse/jface/text/source/LineChangeHover.java;4;2;16;1;8;7;8;8;117;1;8;1118;354;354;2;0;1;8;16;5658;1;6340;15;4;
/org.eclipse.swt/Eclipse SWT Custom Widgets/common/org/eclipse/swt/custom/WrappedContent.java;2;1;5;1;2;2;2;3;213;1;3;4612;233;233;1;0;0;3;5;4612;0;6352;5;2;
/org.eclipse.jdt.ui/ui/org/eclipse/jdt/internal/ui/javaeditor/ClassFileMarkerAnnotationModel.java;1;0;1;1;1;1;1;0;2;0;0;6340;2;2;1;0;0;0;1;6340;0;6340;1;1;
/org.eclipse.jdt.core/compiler/org/eclipse/jdt/internal/compiler/ast/IntLiteral.java;2;0;4;1;0;0;0;4;12;1;4;991;20;20;1;0;0;4;4;991;0;3560;4;2;
/org.eclipse.help.appserver/src/org/eclipse/help/internal/appserver/IWebappServer.java;1;1;2;1;2;2;2;0;48;0;0;5827;54;54;1;0;0;0;2;5827;0;6337;2;1;
/org.eclipse.help/src/org/eclipse/help/internal/search/Analyzer_en.java;1;0;1;1;0;0;0;1;0;0;1;2732;0;0;1;0;0;1;1;2732;0;2732;1;1;
/org.eclipse.jdt.core.tests.model/workspace/Formatter/test499/A_out.java;1;0;1;1;1;1;1;0;0;0;0;5624;0;0;1;0;0;0;1;5624;0;5624;1;1;
/org.eclipse.jdt.ui.tests/ui/org/eclipse/jdt/ui/tests/core/JavaModelUtilTest.java;2;0;4;1;1;1;1;3;11;1;3;803;22;22;1;0;0;3;4;803;0;6340;4;2;
/org.eclipse.team.webdav/src/org/eclipse/team/internal/core/target/Site.java;2;0;3;1;1;1;1;2;6;1;2;2495;8;8;1;0;0;2;3;2495;0;6337;3;2;
/org.eclipse.ui.ide/extensions/org/eclipse/ui/actions/RenameResourceAction.java;6;1;7;1;4;4;4;3;38;1;3;2263;103;103;1;0;0;3;7;2263;0;6338;7;6;
/org.eclipse.swt/Eclipse SWT PI/carbon/org/eclipse/swt/internal/carbon/ControlFontStyleRec.java;1;2;3;1;3;2;3;0;16;0;0;5534;20;20;2;0;1;0;3;5534;1;5614;2;1;
/org.eclipse.swt/Eclipse SWT PI/gtk/org/eclipse/swt/internal/gtk/PangoLayoutRun.java;2;0;2;1;1;1;1;1;2;0;1;4563;2;2;1;0;0;1;2;4563;0;6352;2;2;
/org.eclipse.swt/Eclipse SWT/motif/org/eclipse/swt/widgets/Display.java;7;3;56;2;12;9;12;44;366;3;36;0;1734;1734;3;8;3;44;56;16;11;6352;45;7;
/org.eclipse.ui.ide/src/org/eclipse/ui/internal/ide/actions/SelectBuildWorkingSetAction.java;1;0;1;1;0;0;0;1;0;0;1;4651;0;0;1;0;0;1;1;4651;0;4651;1;1;
/org.eclipse.compare/compare/org/eclipse/compare/internal/patch/PatchMessages.java;1;0;1;1;0;0;0;1;2;0;1;3938;2;2;1;0;0;1;1;3938;0;3938;1;1;
/org.eclipse.help.ui/src/org/eclipse/help/ui/internal/workingset/HelpWorkingSetSynchronizer.java;1;0;1;1;0;0;0;1;0;0;1;2732;0;0;1;0;0;1;1;2732;0;2732;1;1;
/org.eclipse.search/new search/org/eclipse/search/ui/text/AbstractTextSearchViewPage.java;3;2;50;2;28;24;28;22;537;4;18;3711;2297;2297;4;4;4;22;50;4841;8;6340;42;3;
/org.eclipse.ui.workbench/Eclipse UI/org/eclipse/ui/ICapabilityInstallWizard.java;1;0;1;1;0;0;0;1;0;0;1;2737;0;0;1;0;0;1;1;2737;0;2737;1;1;
/org.eclipse.help/src/org/eclipse/help/internal/search/WordTokenStream.java;1;0;2;1;0;0;0;2;2;1;2;1866;2;2;1;0;0;2;2;1866;0;2732;2;1;
/org.eclipse.jdt.ui/ui/org/eclipse/jdt/internal/ui/text/spelling/SpellReconcileDictionary.java;2;0;2;1;1;1;1;1;2;0;1;3930;2;2;1;0;0;1;2;3930;0;6340;2;2;
/org.eclipse.jdt.ui/ui/org/eclipse/jdt/ui/ProblemsLabelDecorator.java;2;0;5;2;2;1;2;3;9;1;3;2246;19;19;2;0;1;3;5;6334;1;6334;4;2;
/org.eclipse.pde.ui/sandbox/org/eclipse/pde/internal/ui/editor/standalone/text/NotifyingReconciler.java;1;0;2;1;0;0;0;2;0;1;2;2320;0;0;1;0;0;2;2;2320;0;2906;2;1;
/org.eclipse.jdt.core.tests.model/workspace/Formatter/test480/A_out.java;1;0;1;1;0;0;0;1;0;0;1;4173;0;0;1;0;0;1;1;4173;0;4173;1;1;
/org.eclipse.core.tests.resources/src/org/eclipse/core/tests/resources/CharsetTest.java;3;1;13;1;9;9;9;4;372;1;4;4340;708;708;1;0;0;4;13;4340;0;6339;13;3;
/org.eclipse.pde.ui/src/org/eclipse/pde/internal/ui/OpenPDEPerspectiveAction.java;3;2;4;1;4;3;4;0;23;0;0;5363;29;29;2;0;1;0;4;5363;1;6336;3;3;
/org.eclipse.swt/Eclipse SWT Mozilla/common/org/eclipse/swt/internal/mozilla/nsIProfileChangeStatus.java;1;0;1;1;0;0;0;1;0;0;1;1654;0;0;1;0;0;1;1;1654;0;1654;1;1;
/org.eclipse.team.tests.cvs.core/src/org/eclipse/team/tests/ccvs/core/CVSTestSetup.java;2;1;11;2;2;2;2;9;20;2;8;1872;85;85;2;1;0;9;11;2946;1;6337;10;2;
/org.eclipse.team.ui/src/org/eclipse/team/internal/ui/synchronize/actions/SyncViewerShowPreferencesAction.java;1;0;2;1;0;0;0;2;35;1;2;2561;35;35;1;0;0;2;2;2561;0;2632;2;1;
/org.eclipse.help.ide/src/org/eclipse/help/ui/internal/search/ResultPage.java;1;1;3;1;3;3;3;0;4;0;0;5216;7;7;1;0;0;0;3;5216;0;5827;3;1;
/org.eclipse.jdt.ui/core refactoring/org/eclipse/jdt/internal/corext/refactoring/participants/xml/AndExpression.java;1;0;6;1;0;0;0;6;7;1;6;1033;21;21;1;0;0;6;6;1033;0;4108;6;1;
/org.eclipse.jdt.ui.tests/ui/org/eclipse/jdt/ui/tests/core/CallHierarchyTest.java;5;0;13;1;1;1;1;12;474;1;12;155;1014;1014;1;0;0;12;13;155;0;6340;13;5;
/org.eclipse.jdt.ui.tests.refactoring/resources/IntroduceFactory/positive/selectConstructor_in.java;1;0;2;1;0;0;0;2;0;1;2;2846;0;0;1;0;0;2;2;2846;0;2862;2;1;
/org.eclipse.swt/Eclipse SWT Drag and Drop/gtk/org/eclipse/swt/dnd/Clipboard.java;4;1;12;1;6;6;6;6;104;1;6;0;262;262;1;0;0;6;12;0;0;6352;12;4;
/org.eclipse.pde.ui/src/org/eclipse/pde/internal/ui/editor/build/BuildUtil.java;1;0;1;1;0;0;0;1;0;0;1;1727;0;0;1;0;0;1;1;1727;0;1727;1;1;
/org.eclipse.ui.views/src/org/eclipse/ui/views/framelist/BackAction.java;1;0;1;1;0;0;0;1;0;0;1;2738;0;0;1;0;0;1;1;2738;0;2738;1;1;
/org.eclipse.swt/Eclipse SWT/motif/org/eclipse/swt/graphics/Image.java;4;1;8;1;2;2;2;6;10;1;6;0;36;36;1;0;0;6;8;0;0;6352;8;4;
/org.eclipse.ui.editors/src/org/eclipse/ui/editors/text/StorageDocumentProvider.java;2;2;9;1;5;4;5;4;21;1;4;1347;86;86;2;0;1;4;9;6334;1;6334;8;2;
/org.eclipse.ui.workbench/Eclipse UI/org/eclipse/ui/internal/chris/roles/api/IContextBinding.java;1;0;2;1;0;0;0;2;0;0;1;2207;0;0;2;1;0;2;2;2207;1;2207;1;1;
/org.eclipse.ui.views/src/org/eclipse/ui/views/navigator/ResourceNavigatorAction.java;1;0;1;1;0;0;0;1;0;0;1;2738;0;0;1;0;0;1;1;2738;0;2738;1;1;
/org.eclipse.debug.ui/ui/org/eclipse/debug/ui/launchVariables/IVariableComponent.java;3;0;3;1;0;0;0;3;12;1;3;550;12;12;1;0;0;3;3;550;0;2120;3;3;
/org.eclipse.sdk.tests-feature/plugins/org.eclipse.perfmsr.ui.client/src/org/eclipse/perfmsr/ui/client/RunRoot.java;1;1;2;1;2;2;2;0;10;0;0;5443;10;10;1;0;0;0;2;5443;0;5513;2;1;
/org.eclipse.core.runtime.osgi/src/org/eclipse/core/runtime/ISafeRunnable.java;1;0;2;1;0;0;0;2;44;1;2;3013;44;44;1;0;0;2;2;3013;0;3030;2;1;
/org.eclipse.jdt.core/compiler/org/eclipse/jdt/internal/compiler/parser/SourceFieldDeclaration.java;2;0;3;1;0;0;0;3;4;1;3;2604;6;6;1;0;0;3;3;2604;0;4461;3;2;
/org.eclipse.ui.tests/Eclipse UI Tests/org/eclipse/ui/tests/keys/Bug42627Test.java;2;0;4;1;0;0;0;4;61;2;3;2280;87;87;2;1;0;4;4;2280;1;3091;3;2;
/org.eclipse.jdt.core.tests.model/workspace/Converter/test0430/A.java;1;0;1;1;0;0;0;1;0;0;1;3714;0;0;1;0;0;1;1;3714;0;3714;1;1;
/org.eclipse.pde.ui/src/org/eclipse/pde/internal/ui/editor/manifest/UnknownElementPropertySource.java;1;0;3;1;1;1;1;2;2;1;2;742;4;4;1;0;0;2;3;742;0;5431;3;1;
/org.eclipse.jdt.ui.tests.refactoring/resources/ExtractTemp/canExtract/A_test67_out.java;1;0;1;1;0;0;0;1;0;0;1;1309;0;0;1;0;0;1;1;1309;0;1309;1;1;
/org.eclipse.jdt.core/dom/org/eclipse/jdt/core/dom/NaiveASTFlattener.java;5;2;27;1;4;3;4;23;541;2;22;245;1323;1323;2;1;1;23;27;4801;2;5482;25;5;
/org.eclipse.team.ui/src/org/eclipse/team/ui/synchronize/subscriber/TeamSubscriberParticipant.java;1;0;1;1;0;0;0;1;0;0;1;3972;0;0;1;0;0;1;1;3972;0;3972;1;1;
/org.eclipse.swt/Eclipse SWT Drag and Drop/gtk/org/eclipse/swt/dnd/DragSource.java;4;1;8;1;2;2;2;6;138;1;6;0;211;211;1;0;0;6;8;0;0;6352;8;4;
/org.eclipse.compare/compare/org/eclipse/compare/internal/AddFromHistoryAction.java;1;0;3;1;0;0;0;3;17;1;3;1289;23;23;1;0;0;3;3;1289;0;1742;3;1;
/org.eclipse.ui.workbench/Eclipse UI/org/eclipse/ui/contexts/ContextActivationServiceFactory.java;2;0;3;1;0;0;0;3;3;1;3;3109;3;3;1;0;0;3;3;3109;0;4144;3;2;
/org.eclipse.update.core/src/org/eclipse/update/core/model/Feature.java;1;0;1;1;0;0;0;1;0;0;1;2650;0;0;1;0;0;1;1;2650;0;2650;1;1;
/org.eclipse.jdt.ui.tests.refactoring/resources/ExtractMethodWorkSpace/ExtractMethodTests/locals_out/A_test535.java;1;0;1;1;0;0;0;1;6;0;1;844;6;6;1;0;0;1;1;844;0;844;1;1;
/org.eclipse.ant.ui/Ant Editor/org/eclipse/ant/ui/internal/editor/text/AntEditorWhitespaceDetector.java;1;0;2;1;0;0;0;2;0;1;2;250;0;0;1;0;0;2;2;250;0;1811;2;1;
/org.eclipse.jdt.core.tests.model/workspace/Converter/test0425/A.java;1;0;1;1;0;0;0;1;0;0;1;3714;0;0;1;0;0;1;1;3714;0;3714;1;1;
/org.eclipse.ui.workbench/Eclipse UI/org/eclipse/ui/internal/contexts/ContextManagerEvent.java;1;0;7;1;0;0;0;7;34;2;6;1137;54;54;2;1;0;7;7;1401;1;2425;6;1;
/org.eclipse.jdt.ui/ui refactoring/org/eclipse/jdt/internal/ui/refactoring/TextStatusContextViewer.java;2;0;5;2;0;0;0;5;6;2;4;1033;14;14;2;1;0;5;5;1033;1;3536;4;2;
/org.eclipse.pde.core/src/org/eclipse/pde/internal/core/plugin/WorkspacePluginModel.java;1;0;2;1;1;1;1;1;4;0;1;4203;7;7;1;0;0;1;2;4203;0;6336;2;1;
/org.eclipse.jdt.ui.tests.refactoring/resources/ExtractInterface/test99/in/C.java;1;0;1;1;0;0;0;1;0;0;1;3710;0;0;1;0;0;1;1;3710;0;3710;1;1;
/org.eclipse.help.base/src/org/eclipse/help/internal/base/BaseHelpSystem.java;2;2;20;1;5;4;5;15;69;2;12;1748;295;295;2;3;1;15;20;1776;4;6334;16;2;
/org.eclipse.jdt.core.tests.model/workspace/Formatter/test052/A_in.java;1;0;1;1;0;0;0;1;0;0;1;2425;0;0;1;0;0;1;1;2425;0;2425;1;1;
/org.eclipse.jdt.ui/core refactoring/org/eclipse/jdt/internal/corext/refactoring/typeconstraints/ConstraintOperator.java;2;0;3;1;1;1;1;2;57;1;2;64;67;67;1;0;0;2;3;64;0;6340;3;2;
/org.eclipse.jdt.core/search/org/eclipse/jdt/internal/core/index/impl/Int.java;1;0;2;1;0;0;0;2;2;1;2;3560;2;2;1;0;0;2;2;3560;0;4060;2;1;
/org.eclipse.webdav/src/interface/org/eclipse/webdav/dom/SupportedLock.java;1;0;1;1;1;1;1;0;129;0;0;5151;129;129;1;0;0;0;1;5151;0;5151;1;1;
/org.eclipse.jdt.ui/ui/org/eclipse/jdt/internal/ui/text/java/hover/AbstractJavaEditorTextHover.java;2;1;9;1;4;4;4;5;57;2;4;1463;111;111;2;1;0;5;9;1463;1;6340;8;2;
/org.eclipse.jdt.ui.tests/leaks/org/eclipse/jdt/ui/leaktest/LeakTestCase.java;3;0;3;1;1;1;1;2;16;1;2;3124;18;18;1;0;0;2;3;3124;0;6340;3;3;
/org.eclipse.jdt.ui.tests.refactoring/resources/InlineMethodWorkspace/TestCases/nameconflict_out/TestLocalInType.java;1;0;1;1;0;0;0;1;4;0;1;845;4;4;1;0;0;1;1;845;0;845;1;1;
/org.eclipse.swt/Eclipse SWT/gtk/org/eclipse/swt/graphics/GC.java;5;1;25;2;2;2;2;23;131;3;20;332;819;819;3;3;0;23;25;472;3;6352;22;5;
/org.eclipse.jdt.ui/ui/org/eclipse/jdt/internal/ui/jarpackager/JarPackageActionDelegate.java;1;0;1;1;1;1;1;0;2;0;0;6340;2;2;1;0;0;0;1;6340;0;6340;1;1;
/org.eclipse.team.examples.filesystem/src/org/eclipse/team/examples/pessimistic/PessimisticFilesystemProviderPlugin.java;1;0;2;1;1;1;1;1;152;0;1;3368;152;152;1;0;0;1;2;3368;0;6103;2;1;
/org.eclipse.ui.workbench/Eclipse UI/org/eclipse/ui/activities/service/ActivityServiceEvent.java;1;0;2;1;0;0;0;2;0;1;2;2896;0;0;1;0;0;2;2;2896;0;3066;2;1;
/org.eclipse.debug.ui/ui/org/eclipse/debug/ui/IVariablesContentProvider.java;1;0;4;1;0;0;0;4;5;1;4;534;9;9;1;0;0;4;4;534;0;861;4;1;
/org.eclipse.ui.intro/src/org/eclipse/ui/intro/internal/extensions/ExtensionPointManager.java;1;0;3;1;0;0;0;3;169;1;3;4429;169;169;1;0;0;3;3;4429;0;4948;3;1;
/org.eclipse.jdt.ui/ui/org/eclipse/jdt/internal/ui/search/JavaSearchResultPage.java;4;3;41;2;26;18;26;15;299;2;14;3711;1217;1217;3;1;8;15;41;5396;9;6340;32;4;
/org.eclipse.ui.views/src/org/eclipse/ui/views/navigator/CopyAction.java;1;0;1;1;0;0;0;1;0;0;1;2738;0;0;1;0;0;1;1;2738;0;2738;1;1;
/org.eclipse.jdt.core.tests.model/workspace/Formatter/test451/Format_out.java;1;0;3;1;0;0;0;3;2;1;3;3714;2;2;1;0;0;3;3;3714;0;3742;3;1;
/org.eclipse.team.cvs.ui/src/org/eclipse/team/internal/ccvs/ui/actions/RestoreFromRepositoryAction.java;2;0;5;1;1;1;1;4;45;1;4;848;67;67;1;0;0;4;5;848;0;6337;5;2;
/org.eclipse.jdt.ui/core refactoring/org/eclipse/jdt/internal/corext/refactoring/code/flow/InOutFlowAnalyzer.java;1;0;1;1;1;1;1;0;2;0;0;6340;2;2;1;0;0;0;1;6340;0;6340;1;1;
/org.eclipse.webdav/src/kernel/org/eclipse/webdav/internal/kernel/utils/NestedHashtable.java;1;0;2;1;2;1;2;0;208;0;0;5151;208;208;2;0;1;0;2;5151;1;5151;1;1;
/org.eclipse.team.ui/src/org/eclipse/team/internal/ui/synchronize/SyncInfoDiffTreeNavigator.java;1;0;1;1;0;0;0;1;0;0;1;3619;0;0;1;0;0;1;1;3619;0;3619;1;1;
/org.eclipse.jdt.core.tests.model/workspace/Converter/src/test0397/A.java;1;0;1;1;0;0;0;1;0;0;1;3714;0;0;1;0;0;1;1;3714;0;3714;1;1;
/org.eclipse.ant.ui/Ant Tools Support/org/eclipse/ant/internal/ui/views/actions/SearchForBuildFilesDialog.java;1;1;6;1;3;3;3;3;30;1;3;1811;46;46;1;0;0;3;6;1811;0;6336;6;1;
/org.eclipse.jdt.core.tests.model/workspace/Converter/src/test0444/A.java;1;0;1;1;0;0;0;1;0;0;1;3714;0;0;1;0;0;1;1;3714;0;3714;1;1;
/org.eclipse.jdt.core/compiler/org/eclipse/jdt/internal/compiler/parser/AnnotationParser.java;4;0;15;3;0;0;0;15;907;3;12;1360;2463;2463;3;3;0;15;15;1785;3;2887;12;4;
/org.eclipse.jdt.ui/ui/org/eclipse/jdt/internal/ui/typehierarchy/HistoryAction.java;1;0;1;1;1;1;1;0;2;0;0;6340;2;2;1;0;0;0;1;6340;0;6340;1;1;
/org.eclipse.core.tests.resources/src/org/eclipse/core/tests/internal/resources/WorkspacePreferencesTest.java;2;2;9;1;3;2;3;6;172;2;5;91;273;273;2;1;1;6;9;91;2;5460;7;2;
/org.eclipse.search/search/org/eclipse/search/internal/ui/SorterDescriptor.java;1;0;1;1;1;1;1;0;2;0;0;6340;2;2;1;0;0;0;1;6340;0;6340;1;1;
/org.eclipse.ui.editors/src/org/eclipse/ui/internal/texteditor/SourceViewerInformationControl.java;2;1;4;1;4;4;4;0;38;0;0;5311;55;55;1;0;0;0;4;5311;0;6340;4;2;
/org.eclipse.ui.workbench/Eclipse UI/org/eclipse/ui/internal/commands/ws/WorkbenchWindowCommandHandlerService.java;1;0;7;1;0;0;0;7;179;2;6;3129;351;351;2;1;0;7;7;3236;1;4144;6;1;
/org.eclipse.jdt.ui/core extension/org/eclipse/jdt/internal/corext/textmanipulation/PerformEditException.java;2;0;4;1;0;0;0;4;13;2;3;1875;18;18;2;1;0;4;4;1946;1;1946;3;2;
/org.eclipse.jdt.ui.tests.refactoring/resources/IntroduceFactory/Bugzilla/46608/p1/TT_out.java;1;0;1;1;0;0;0;1;0;0;1;2888;0;0;1;0;0;1;1;2888;0;2888;1;1;
/org.eclipse.jdt.ui/ui/org/eclipse/jdt/internal/ui/workingsets/WorkingSetFilterActionGroup.java;4;0;7;1;1;1;1;6;117;1;6;1336;151;151;1;0;0;6;7;1336;0;6340;7;4;
/org.eclipse.jdt.ui/ui/org/eclipse/jdt/internal/ui/infoviews/AbstractInfoView.java;2;1;11;1;3;3;3;8;142;1;8;724;482;482;1;0;0;8;11;724;0;6340;11;2;
/org.eclipse.team.webdav/src/org/eclipse/team/core/target/ITeamOperations.java;1;0;1;1;0;0;0;1;0;0;1;3438;0;0;1;0;0;1;1;3438;0;3438;1;1;
/org.eclipse.jdt.core.tests.model/workspace/Converter/test0104/Test.java;1;0;1;1;0;0;0;1;0;0;1;3714;0;0;1;0;0;1;1;3714;0;3714;1;1;
/org.eclipse.ui.tests/Eclipse UI Tests/org/eclipse/ui/tests/menus/MenusTestSuite.java;2;1;2;1;2;2;2;0;4;0;0;5535;4;4;1;0;0;0;2;5535;0;6338;2;2;
/org.eclipse.swt/Eclipse SWT PI/gtk/org/eclipse/swt/internal/gtk/XWindowChanges.java;3;0;4;1;1;1;1;3;6;1;3;2644;10;10;1;0;0;3;4;2644;0;6352;4;3;
/org.eclipse.ui.workbench/Eclipse UI/org/eclipse/ui/internal/commands/api/ICategoryListener.java;1;0;2;1;0;0;0;2;2;0;1;2562;2;2;2;1;0;2;2;2562;1;2562;1;1;
/org.eclipse.jdt.ui/ui/org/eclipse/jdt/internal/ui/preferences/JavaBasePreferencePage.java;5;2;9;1;4;3;4;5;176;1;5;170;341;341;2;0;1;5;9;6140;1;6340;8;5;
/org.eclipse.jdt.core/compiler/org/eclipse/jdt/internal/compiler/ast/LocalTypeDeclaration.java;1;0;2;1;0;0;0;2;1;1;2;1306;1;1;1;0;0;2;2;1306;0;2974;2;1;
/org.eclipse.ui.tests/Eclipse UI Tests/org/eclipse/ui/tests/contexts/ContextsTestCase1.java;2;0;2;1;1;1;1;1;0;0;1;4896;0;0;1;0;0;1;2;4896;0;5531;2;2;
/org.eclipse.ui.workbench/Eclipse UI/org/eclipse/ui/internal/IWorkbenchPresentationConstants.java;1;0;4;1;0;0;0;4;26;1;4;4351;32;32;1;0;0;4;4;4351;0;4560;4;1;
/org.eclipse.jdt.ui/ui/org/eclipse/jdt/internal/ui/compare/JavaCompareAction.java;2;1;5;1;2;2;2;3;16;1;3;240;26;26;1;0;0;3;5;240;0;6340;5;2;
/org.eclipse.jdt.core.tests.model/workspace/Converter/src/test0049/Test.java;1;0;1;1;0;0;0;1;0;0;1;3714;0;0;1;0;0;1;1;3714;0;3714;1;1;
/org.eclipse.jdt.ui/ui/org/eclipse/jdt/internal/ui/search/UIAdapter.java;1;0;1;1;0;0;0;1;0;0;1;3488;0;0;1;0;0;1;1;3488;0;3488;1;1;
/org.eclipse.search/search/org/eclipse/search/ui/IActionGroupFactory.java;2;1;3;1;3;3;3;0;3;0;0;6116;7;7;1;0;0;0;3;6116;0;6340;3;2;
/org.eclipse.jdt.ui.tests.refactoring/resources/InlineMethodWorkspace/TestCases/simple_out/TestBasic2.java;1;0;1;1;0;0;0;1;4;0;1;845;4;4;1;0;0;1;1;845;0;845;1;1;
/org.eclipse.jdt.ui.tests.refactoring/resources/ExtractMethodWorkSpace/ExtractMethodTests/validSelection_out/A_test361.java;1;0;2;1;0;0;0;2;6;1;2;130;7;7;1;0;0;2;2;130;0;844;2;1;
/org.eclipse.core.expressions/src/org/eclipse/core/internal/expressions/DefaultVariable.java;1;0;3;1;1;1;1;2;2;1;2;4108;3;3;1;0;0;2;3;4108;0;6340;3;1;
/org.eclipse.jdt.ui.tests.refactoring/resources/Copy/test_method_yes_type/in/A.java;1;0;2;1;0;0;0;2;2;1;2;685;4;4;1;0;0;2;2;685;0;696;2;1;
/org.eclipse.search/new search/org/eclipse/search2/internal/ui/basic/views/RemoveSelectedMatchesAction.java;3;1;3;1;3;3;3;0;2;0;0;5128;4;4;1;0;0;0;3;5128;0;6340;3;3;
/org.eclipse.pde.ui/src/org/eclipse/pde/internal/ui/wizards/imports/BinaryProjectFilter.java;2;1;4;1;4;4;4;0;30;0;0;5336;50;50;1;0;0;0;4;5336;0;6336;4;2;
/org.eclipse.core.resources/src/org/eclipse/core/internal/resources/SavedState.java;2;1;10;1;5;5;5;5;11;1;5;1485;40;40;1;0;0;5;10;1485;0;5463;10;2;
/org.eclipse.jdt.ui/ui/org/eclipse/jdt/internal/ui/dialogs/OpenTypeSelectionDialog.java;1;0;1;1;1;1;1;0;2;0;0;6340;2;2;1;0;0;0;1;6340;0;6340;1;1;
/org.eclipse.jdt.ui/ui/org/eclipse/jdt/internal/ui/browsing/IPackagesViewViewer.java;1;0;1;1;1;1;1;0;2;0;0;6340;2;2;1;0;0;0;1;6340;0;6340;1;1;
/org.eclipse.team.webdav/src/org/eclipse/team/core/target/TargetDeploymentProvider.java;1;0;1;1;0;0;0;1;0;0;1;3387;0;0;1;0;0;1;1;3387;0;3387;1;1;
/org.eclipse.team.ui/src/org/eclipse/team/internal/ui/synchronize/SubscriberParticipantWizard.java;2;1;5;1;5;5;5;0;93;0;0;5534;175;175;1;0;0;0;5;5534;0;6082;5;2;
/org.eclipse.jdt.ui/core refactoring/org/eclipse/jdt/internal/corext/refactoring/rename/RefactoringScanner2.java;1;0;2;1;0;0;0;2;0;1;2;4560;0;0;1;0;0;2;2;4560;0;4585;2;1;
/org.eclipse.ant.ui/Ant Tools Support/org/eclipse/ant/internal/ui/views/actions/SearchForBuildFilesAction.java;1;0;4;1;1;1;1;3;9;1;3;1811;15;15;1;0;0;3;4;1811;0;5370;4;1;
/org.eclipse.jdt.core.tests.model/workspace/Converter/src/test0448/A.java;1;0;1;1;0;0;0;1;0;0;1;3714;0;0;1;0;0;1;1;3714;0;3714;1;1;
/org.eclipse.jdt.ui.tests.refactoring/resources/Copy/test_fields_declared_in_multi_yes_type/in/A.java;1;0;1;1;0;0;0;1;0;0;1;686;0;0;1;0;0;1;1;686;0;686;1;1;
/org.eclipse.swt/Eclipse SWT/carbon/org/eclipse/swt/widgets/Label.java;3;1;10;1;3;3;3;7;71;1;7;16;138;138;1;0;0;7;10;16;0;6352;10;3;
/org.eclipse.ui.intro/src/org/eclipse/ui/internal/intro/impl/model/loader/ModelLoaderUtil.java;1;1;6;1;6;6;6;0;60;0;0;5115;185;185;1;0;0;0;6;5115;0;5804;6;1;
/org.eclipse.help/src/org/eclipse/help/IHelp.java;1;1;3;1;2;2;2;1;232;0;1;2732;284;284;1;0;0;1;3;2732;0;6337;3;1;
/org.eclipse.jdt.core/search/org/eclipse/jdt/internal/core/search/IInfoConstants.java;1;0;1;1;0;0;0;1;0;0;1;2837;0;0;1;0;0;1;1;2837;0;2837;1;1;
/org.eclipse.ui.externaltools/Ant Editor/org/eclipse/ui/externaltools/internal/ant/editor/AntEditorActionContributor.java;1;0;2;1;0;0;0;2;0;1;2;178;0;0;1;0;0;2;2;178;0;282;2;1;
/org.eclipse.jdt.core.tests.model/workspace/Formatter/test238/A_in.java;1;0;1;1;0;0;0;1;0;0;1;2437;0;0;1;0;0;1;1;2437;0;2437;1;1;
/org.eclipse.help.tests/src/org/eclipse/help/tests/launching/DisplayHelpResource_topicHref.java;1;1;3;1;2;2;2;1;58;0;1;2732;66;66;1;0;0;1;3;2732;0;6337;3;1;
/org.eclipse.jface.text/src/org/eclipse/jface/text/reconciler/IReconcileResult.java;1;2;4;1;3;2;3;1;9;0;1;1629;11;11;2;0;1;1;4;6353;1;6353;3;1;
/org.eclipse.pde.ui/src/org/eclipse/pde/internal/ui/editor/manifest/ManifestRuntimePage.java;1;0;1;1;1;1;1;0;0;0;0;5431;0;0;1;0;0;0;1;5431;0;5431;1;1;
/org.eclipse.ui.ide/src/org/eclipse/ui/internal/ide/dialogs/WizardNewProjectNameAndLocationPage.java;1;0;1;1;0;0;0;1;0;0;1;2264;0;0;1;0;0;1;1;2264;0;2264;1;1;
/org.eclipse.jdt.ui/core refactoring/org/eclipse/jdt/internal/corext/refactoring/code/flow/IfFlowInfo.java;1;0;1;1;1;1;1;0;2;0;0;6340;2;2;1;0;0;0;1;6340;0;6340;1;1;
/org.eclipse.core.runtime/src/org/eclipse/core/internal/registry/ExtensionsParser.java;5;2;19;2;13;10;13;6;1037;2;5;3049;1480;1480;2;1;3;6;19;3164;4;6151;15;5;
/org.eclipse.ui.editors/src/org/eclipse/ui/editors/text/TextSourceViewerConfiguration.java;3;2;8;1;4;3;4;4;51;1;4;1118;145;145;2;0;1;4;8;6334;1;6334;7;3;
/org.eclipse.ui.workbench/Eclipse UI/org/eclipse/ui/keys/IKeyConfigurationListener.java;1;0;2;1;0;0;0;2;0;1;2;1294;0;0;1;0;0;2;2;1294;0;1321;2;1;
/org.eclipse.jdt.core/search/org/eclipse/jdt/internal/core/index/impl/InMemoryIndex.java;3;0;6;1;0;0;0;6;6;1;6;61;17;17;1;0;0;6;6;61;0;4060;6;3;
/org.eclipse.ui.workbench/Eclipse UI/org/eclipse/ui/ISharedImages.java;4;1;6;1;2;2;2;4;62;2;3;2737;162;162;2;1;0;4;6;4651;1;6338;5;4;
/org.eclipse.ui.ide/src/org/eclipse/ui/internal/ide/dialogs/FileFolderSelectionDialog.java;1;0;1;1;0;0;0;1;0;0;1;2264;0;0;1;0;0;1;1;2264;0;2264;1;1;
/org.eclipse.osgi/osgi/src/org/osgi/framework/InvalidSyntaxException.java;2;0;2;1;1;1;1;1;7;0;1;3013;7;7;1;0;0;1;2;3013;0;5536;2;2;
/org.eclipse.jdt.ui.tests.refactoring/resources/ExtractTemp/canExtract/A_test72_in.java;1;0;1;1;0;0;0;1;0;0;1;1569;0;0;1;0;0;1;1;1569;0;1569;1;1;
/org.eclipse.ui.workbench/Eclipse UI/org/eclipse/ui/internal/activities/Activity.java;5;1;22;2;2;2;2;20;178;2;15;2444;725;725;2;5;0;20;22;2490;5;6338;17;5;
/org.eclipse.jdt.ui/ui refactoring/org/eclipse/jdt/internal/ui/refactoring/RenameInputWizardPage.java;1;0;1;1;0;0;0;1;0;0;1;1126;0;0;1;0;0;1;1;1126;0;1126;1;1;
/org.eclipse.jdt.ui/core refactoring/org/eclipse/jdt/internal/corext/refactoring/participants/xml/EnablementExpression.java;1;0;4;1;0;0;0;4;15;1;4;2682;21;21;1;0;0;4;4;2682;0;4108;4;1;
/org.eclipse.update.ui/src/org/eclipse/update/internal/ui/wizards/ReviewPage.java;4;1;23;2;5;5;5;18;1562;2;17;755;2835;2835;2;1;0;18;23;1219;1;6270;22;4;
/org.eclipse.update.core/src/org/eclipse/update/internal/api/operations/IBatchOperation.java;1;0;2;1;0;0;0;2;0;1;2;3270;0;0;1;0;0;2;2;3270;0;4928;2;1;
/org.eclipse.ui.workbench/Eclipse UI/org/eclipse/ui/commands/internal/GesturePreferencePage.java;1;0;2;1;0;0;0;2;0;1;2;786;0;0;1;0;0;2;2;786;0;956;2;1;
/org.eclipse.swt.examples/src/org/eclipse/swt/examples/controlexample/ComboTab.java;3;0;3;1;0;0;0;3;25;1;3;72;32;32;1;0;0;3;3;72;0;2729;3;3;
/org.eclipse.jdt.core.tests.model/workspace/Formatter/test079/A_in.java;1;0;1;1;0;0;0;1;0;0;1;2425;0;0;1;0;0;1;1;2425;0;2425;1;1;
/org.eclipse.team.webdav/src/org/eclipse/team/internal/target/subscriber/BatchingLock.java;2;0;3;1;0;0;0;3;300;1;3;3494;300;300;1;0;0;3;3;3494;0;4349;3;2;
/org.eclipse.jdt.core/compiler/org/eclipse/jdt/internal/compiler/codegen/ResetStateForCodeGenerationVisitor.java;3;0;4;1;1;1;1;3;5;1;3;150;11;11;1;0;0;3;4;150;0;5343;4;3;
/org.eclipse.jdt.core.tests.model/workspace/Converter/test0482/A.java;1;0;2;1;0;0;0;2;0;1;2;1289;0;0;1;0;0;2;2;1289;0;3714;2;1;
/org.eclipse.ui.ide/src/org/eclipse/ui/internal/model/WorkbenchAdapterFactory.java;2;0;2;1;0;0;0;2;0;1;2;1511;0;0;1;0;0;2;2;1511;0;2263;2;2;
/org.eclipse.team.cvs.ui/src/org/eclipse/team/internal/ccvs/ui/subscriber/SyncInfoSetDetailsDialog.java;2;0;6;1;1;1;1;5;18;1;5;1132;32;32;1;0;0;5;6;1132;0;6337;6;2;
/org.eclipse.team.webdav/src/org/eclipse/team/internal/ui/target/subscriber/ITeamRunnableContext.java;2;0;3;1;1;1;1;2;46;1;2;3494;50;50;1;0;0;2;3;3494;0;6337;3;2;
/org.eclipse.swt/Eclipse SWT PI/carbon/org/eclipse/swt/internal/carbon/CGRect.java;1;2;3;1;3;2;3;0;16;0;0;5534;20;20;2;0;1;0;3;5534;1;5614;2;1;
/org.eclipse.jdt.debug.ui/ui/org/eclipse/jdt/internal/debug/ui/DialogSettingsHelper.java;1;0;1;1;0;0;0;1;0;0;1;4837;0;0;1;0;0;1;1;4837;0;4837;1;1;
/org.eclipse.ui.workbench/Eclipse UI/org/eclipse/ui/gestures/GestureSequence.java;1;0;2;1;0;0;0;2;0;1;2;1294;0;0;1;0;0;2;2;1294;0;1321;2;1;
/org.eclipse.jdt.core/dom/org/eclipse/jdt/core/dom/NullLiteral.java;3;0;7;1;1;1;1;6;37;1;6;3560;51;51;1;0;0;6;7;3560;0;5272;7;3;
/org.eclipse.ui.tests/Eclipse UI Tests/org/eclipse/ui/tests/api/ApiTestSuite.java;4;1;8;1;5;5;5;3;10;1;3;3012;26;26;1;0;0;3;8;3012;0;6338;8;4;
/org.eclipse.jdt.core.tests.model/workspace/Converter/test0496/A.java;1;0;2;1;0;0;0;2;0;1;2;1950;0;0;1;0;0;2;2;1950;0;3714;2;1;
/org.eclipse.jdt.core.tests.model/workspace/Formatter/test300/A_out.java;1;0;1;1;0;0;0;1;0;0;1;2444;0;0;1;0;0;1;1;2444;0;2444;1;1;
/org.eclipse.update/src/org/eclipse/update/internal/ui/UMWizardPageComplete.java;1;0;1;1;1;1;1;0;0;0;0;6339;0;0;1;0;0;0;1;6339;0;6339;1;1;
/org.eclipse.update.tests.core/src/org/eclipse/update/tests/regularRemove/TestRemove.java;2;0;3;1;1;1;1;2;8;1;2;3813;16;16;1;0;0;2;3;3813;0;6336;3;2;
/org.eclipse.jdt.core/formatter/org/eclipse/jdt/internal/formatter/align/Alignment.java;3;0;17;1;0;0;0;17;38;2;16;535;189;189;2;1;0;17;17;3172;1;3996;16;3;
/org.eclipse.jdt.ui/ui refactoring/org/eclipse/jdt/internal/ui/refactoring/UserInterfaceStarter.java;2;0;6;1;1;1;1;5;73;1;5;1709;103;103;1;0;0;5;6;1709;0;6340;6;2;
/org.eclipse.ui.workbench/Eclipse UI/org/eclipse/ui/actions/CopyFilesAndFoldersOperation.java;1;0;1;1;0;0;0;1;0;0;1;2737;0;0;1;0;0;1;1;2737;0;2737;1;1;
/org.eclipse.team.ui/src/org/eclipse/team/ui/synchronize/views/SyncViewerSorter.java;1;0;1;1;0;0;0;1;0;0;1;3764;0;0;1;0;0;1;1;3764;0;3764;1;1;
/org.eclipse.jdt.ui/ui/org/eclipse/jdt/internal/ui/dialogs/StatusUtil.java;1;0;2;1;1;1;1;1;7;0;1;1350;9;9;1;0;0;1;2;1350;0;6340;2;1;
/org.eclipse.team.ui/src/org/eclipse/team/ui/synchronize/subscribers/SubscriberRefreshSchedule.java;2;2;7;2;4;3;4;3;15;1;3;4632;25;25;2;0;1;3;7;5358;1;5358;6;2;
/org.eclipse.ui.workbench.texteditor/src/org/eclipse/ui/internal/texteditor/TextEditorPlugin.java;2;1;9;1;5;5;5;4;62;1;4;1539;203;203;1;0;0;4;9;1539;0;6340;9;2;
/org.eclipse.pde.core/src/org/eclipse/pde/internal/core/plugin/Fragment.java;3;2;14;1;7;6;7;7;52;2;6;2184;161;161;2;1;1;7;14;4726;2;6336;12;3;
/org.eclipse.compare/compare/org/eclipse/compare/CompareEditorInput.java;1;1;10;1;4;4;4;6;207;1;6;1222;419;419;1;0;0;6;10;1222;0;6322;10;1;
/org.eclipse.team.ui/src/org/eclipse/team/ui/synchronize/actions/RemoveSynchronizeParticipantAction.java;1;0;4;1;0;0;0;4;41;1;4;2561;45;45;1;0;0;4;4;2561;0;4216;4;1;
/org.eclipse.update.ui.forms/Eclipse Forms/org/eclipse/ui/forms/widgets/ExpandableComposite.java;2;0;8;1;0;0;0;8;215;1;8;3138;410;410;1;0;0;8;8;3138;0;4157;8;2;
/org.eclipse.ant.ui/Ant Editor/org/eclipse/ant/internal/ui/editor/text/AntEditorTagScanner.java;1;1;5;1;2;2;2;3;43;1;3;1811;114;114;1;0;0;3;5;1811;0;5721;5;1;
/org.eclipse.jdt.core.tests.model/workspace/Converter/test0067/Test.java;1;0;1;1;0;0;0;1;0;0;1;3714;0;0;1;0;0;1;1;3714;0;3714;1;1;
/org.eclipse.pde.ui/src/org/eclipse/pde/internal/ui/wizards/RenameDialog.java;3;2;5;2;3;2;3;2;81;1;2;3393;94;94;2;0;1;2;5;5780;1;6336;4;3;
/org.eclipse.osgi/core/framework/org/eclipse/osgi/framework/internal/protocol/ContentHandlerProxy.java;5;1;6;1;2;2;2;4;146;1;4;3013;175;175;1;0;0;4;6;3013;0;6337;6;5;
/org.eclipse.ant.ui/Ant Tools Support/org/eclipse/ant/internal/ui/launchConfigurations/AntEnvironmentTab.java;1;0;3;1;1;1;1;2;7;1;2;4628;10;10;1;0;0;2;3;4628;0;5448;3;1;
/org.eclipse.jdt.ui/ui/org/eclipse/jdt/internal/ui/text/spelling/TaskTagDictionary.java;2;0;2;1;1;1;1;1;2;0;1;3930;2;2;1;0;0;1;2;3930;0;6340;2;2;
/org.eclipse.jdt.core.tests.model/workspace/Formatter/test293/A_out.java;1;0;2;1;0;0;0;2;2;1;2;2444;2;2;1;0;0;2;2;2444;0;4173;2;1;
/org.eclipse.update.ui/src/org/eclipse/update/internal/ui/wizards/NewWizard.java;1;0;1;1;0;0;0;1;0;0;1;755;0;0;1;0;0;1;1;755;0;755;1;1;
/org.eclipse.swt/Eclipse SWT PI/win32/org/eclipse/swt/internal/win32/SCRIPT_STATE.java;2;0;2;1;1;1;1;1;4;0;1;4563;4;4;1;0;0;1;2;4563;0;6352;2;2;
/org.eclipse.ui.examples.javaeditor/Template Editor Example/org/eclipse/ui/examples/templateeditor/template/XMLCompletionProcessor.java;3;1;3;1;2;2;2;1;4;0;1;4644;6;6;1;0;0;1;3;4644;0;6340;3;3;
/org.eclipse.team.core/src/org/eclipse/team/internal/registry/TeamProviderDescriptor.java;1;0;1;1;0;0;0;1;0;0;1;2777;0;0;1;0;0;1;1;2777;0;2777;1;1;
/org.eclipse.ui.intro/src/org/eclipse/ui/intro/config/CustomizableIntroPart.java;4;4;21;2;21;13;21;0;132;0;0;5314;562;562;4;0;8;0;21;5797;8;6167;13;4;
/org.eclipse.team.ui/src/org/eclipse/team/ui/synchronize/viewers/SynchronizeDialog.java;1;0;4;1;0;0;0;4;37;1;4;4449;49;49;1;0;0;4;4;4449;0;4632;4;1;
/org.eclipse.ui.externaltools/Ant Editor/org/eclipse/ui/externaltools/internal/ant/dtd/util/SortedSet.java;1;0;1;1;0;0;0;1;0;0;1;282;0;0;1;0;0;1;1;282;0;282;1;1;
/org.eclipse.pde.ui/src/org/eclipse/pde/internal/ui/editor/schema/NewReferenceAction.java;1;0;2;1;0;0;0;2;2;1;2;368;3;3;1;0;0;2;2;368;0;648;2;1;
/org.eclipse.ui.workbench/Eclipse UI/org/eclipse/ui/roles/RoleManagerFactory.java;1;0;4;1;0;0;0;4;14;1;4;2240;16;16;1;0;0;4;4;2240;0;2864;4;1;
/org.eclipse.jdt.core.tests.model/workspace/Converter/src/test0010/Test.java;1;0;1;1;0;0;0;1;0;0;1;3714;0;0;1;0;0;1;1;3714;0;3714;1;1;
/org.eclipse.jdt.core/model/org/eclipse/jdt/internal/core/jdom/CompilationUnit.java;1;0;1;1;0;0;0;1;2;0;1;3560;2;2;1;0;0;1;1;3560;0;3560;1;1;
/org.eclipse.search/search/org/eclipse/search/internal/ui/text/FileSearchCategory.java;1;0;3;1;0;0;0;3;45;1;3;3458;45;45;1;0;0;3;3;3458;0;3711;3;1;
/org.eclipse.jdt.ui/ui refactoring/org/eclipse/jdt/internal/ui/refactoring/ChangeExceptionsControl.java;3;1;5;1;3;3;3;2;8;1;2;2562;20;20;1;0;0;2;5;2562;0;6340;5;3;
/org.eclipse.team.ui/src/org/eclipse/team/internal/ui/synchronize/compare/RemoteResourceTypedElement.java;1;0;3;1;0;0;0;3;113;1;3;2535;113;113;1;0;0;3;3;2535;0;4216;3;1;
/org.eclipse.ua.tests/src/org/eclipse/ui/tests/cheatsheets/actions/TestCheatSheetViewerSetInputAction.java;1;0;1;1;1;1;1;0;0;0;0;6081;0;0;1;0;0;0;1;6081;0;6081;1;1;
/org.eclipse.jdt.core.tests.model/src/org/eclipse/jdt/core/tests/dom/ASTVisitorTest.java;3;0;15;2;1;1;1;14;516;3;11;1113;963;963;3;3;0;14;15;3683;3;5272;12;3;
/org.eclipse.core.tests.resources/src/org/eclipse/core/tests/internal/builders/BuilderCycleTest.java;2;0;3;1;1;1;1;2;42;1;2;1098;66;66;1;0;0;2;3;1098;0;5147;3;2;
/org.eclipse.ui.workbench/Eclipse UI/org/eclipse/ui/internal/csm/commands/ICommandDefinition.java;1;0;3;1;0;0;0;3;4;1;3;2515;4;4;1;0;0;3;3;2515;0;2562;3;1;
/org.eclipse.jdt.core.tests.model/workspace/Completion/src3/test0025/Test.java;1;0;1;1;1;1;1;0;0;0;0;5222;0;0;1;0;0;0;1;5222;0;5222;1;1;
/org.eclipse.update.core/src/org/eclipse/update/core/model/PluginEntryModel.java;2;1;4;1;3;3;3;1;24;0;1;4332;38;38;1;0;0;1;4;4332;0;5665;4;2;
/org.eclipse.ui.workbench/Eclipse UI/org/eclipse/ui/internal/LegacyResourceSupport.java;2;0;3;1;1;1;1;2;30;1;2;3150;32;32;1;0;0;2;3;3150;0;6338;3;2;
/org.eclipse.search/new search/org/eclipse/search2/internal/ui/text/PositionTracker.java;2;2;19;1;12;10;12;7;59;1;7;3474;280;280;2;0;2;7;19;5178;2;6340;17;2;
/org.eclipse.jdt.ui/ui/org/eclipse/jdt/internal/ui/text/JavaWordDetector.java;1;0;1;1;1;1;1;0;2;0;0;6340;2;2;1;0;0;0;1;6340;0;6340;1;1;
/org.eclipse.text/src/org/eclipse/text/edits/ReplaceEdit.java;2;0;4;1;1;1;1;3;20;1;3;1986;36;36;1;0;0;3;4;1986;0;6340;4;2;
/org.eclipse.team.cvs.ui/src/org/eclipse/team/internal/ccvs/ui/CVSCompareRevisionsInput.java;2;1;12;1;5;5;5;7;142;1;7;784;396;396;1;0;0;7;12;784;0;6337;12;2;
/org.eclipse.jdt.ui/core refactoring/org/eclipse/ltk/core/refactoring/participants/DeleteArguments.java;1;0;2;1;0;0;0;2;0;1;2;4624;0;0;1;0;0;2;2;4624;0;4864;2;1;
/org.eclipse.jdt.core.tests.model/workspace/Converter/test0167/Test.java;1;0;1;1;0;0;0;1;0;0;1;3714;0;0;1;0;0;1;1;3714;0;3714;1;1;
/org.eclipse.search/new search/org/eclipse/search/ui/ISearchQuery.java;3;1;8;1;4;4;4;4;55;2;3;3711;159;159;2;1;0;4;8;4841;1;6340;7;3;
/org.eclipse.swt/Eclipse SWT Browser/carbon/org/eclipse/swt/browser/Browser.java;3;2;26;1;14;13;14;12;1148;2;10;1654;1490;1490;2;2;1;12;26;2899;3;6352;23;3;
/org.eclipse.jface/src/org/eclipse/jface/resource/ImageRegistry.java;4;3;8;1;5;3;5;3;62;1;3;1497;164;164;3;0;2;3;8;5612;2;6338;6;4;
/org.eclipse.team.ui/src/org/eclipse/team/ui/sync/actions/workingsets/ClearWorkingSetAction.java;1;0;1;1;0;0;0;1;0;0;1;2451;0;0;1;0;0;1;1;2451;0;2451;1;1;
/org.eclipse.jdt.core/dom/org/eclipse/jdt/core/dom/SimpleName.java;4;0;10;1;1;1;1;9;109;1;9;1059;180;180;1;0;0;9;10;1059;0;5272;10;4;
/org.eclipse.jdt.core.tests.compiler/src/org/eclipse/jdt/core/tests/compiler/regression/AssertionTest.java;3;0;5;1;0;0;0;5;63;1;5;676;115;115;1;0;0;5;5;676;0;4977;5;3;
/org.eclipse.team.cvs.ui/src/org/eclipse/team/internal/ccvs/ui/subscriber/MergeSynchronizeAdvisor.java;2;0;5;1;1;1;1;4;19;1;4;4588;26;26;1;0;0;4;5;4588;0;5358;5;2;
/org.eclipse.ui.ide/src/org/eclipse/ui/internal/ide/dialogs/WelcomeEditorCopyAction.java;1;0;1;1;0;0;0;1;0;0;1;2264;0;0;1;0;0;1;1;2264;0;2264;1;1;
/org.eclipse.core.tests.runtime/src/org/eclipse/core/tests/runtime/AutomatedTests.java;2;1;3;1;3;3;3;0;27;0;0;5149;38;38;1;0;0;0;3;5149;0;6201;3;2;
/org.eclipse.jdt.ui.tests.refactoring/resources/Copy/test_initializer_yes_method/out/A.java;1;0;1;1;0;0;0;1;0;0;1;685;0;0;1;0;0;1;1;685;0;685;1;1;
/org.eclipse.jdt.ui.tests/ui/org/eclipse/jdt/ui/tests/dialogs/DialogsTest.java;3;2;3;2;3;2;3;0;22;0;0;5265;24;24;2;0;1;0;3;5265;1;6340;2;3;
/org.eclipse.jdt.core/model/org/eclipse/jdt/internal/core/SourceTypeElementInfo.java;3;0;9;2;0;0;0;9;105;2;7;85;213;213;2;2;0;9;9;1868;2;3560;7;3;
/org.eclipse.ui.views/src/org/eclipse/ui/views/properties/PropertySheet.java;1;0;2;1;0;0;0;2;22;1;2;2738;23;23;1;0;0;2;2;2738;0;2760;2;1;
/org.eclipse.ui.workbench/Eclipse UI/org/eclipse/ui/contexts/IContextListener.java;4;1;12;1;2;2;2;10;19;2;9;1119;71;71;2;1;0;10;12;1135;1;6338;11;4;
/org.eclipse.ui.intro/src/org/eclipse/ui/intro/internal/model/IntroExtensionContent.java;1;0;2;1;1;1;1;1;0;0;1;4948;0;0;1;0;0;1;2;4948;0;5115;2;1;
/org.eclipse.jdt.ui.tests.refactoring/resources/MoveInnerToTopLevel/testFail_nonstatic_0/in/A.java;1;0;1;1;0;0;0;1;4;0;1;2563;4;4;1;0;0;1;1;2563;0;2563;1;1;
/org.eclipse.jdt.ui/ui/org/eclipse/jdt/internal/ui/javaeditor/selectionactions/StructureSelectHistoryAction.java;1;0;1;1;1;1;1;0;2;0;0;6340;2;2;1;0;0;0;1;6340;0;6340;1;1;
/org.eclipse.ui.workbench/Eclipse UI/org/eclipse/ui/internal/IWorkbenchDropTarget.java;3;0;3;1;0;0;0;3;39;1;3;3092;39;39;1;0;0;3;3;3092;0;4600;3;3;
/org.eclipse.osgi/osgi/src/org/eclipse/osgi/service/resolver/StateChangeEvent.java;3;1;4;1;2;2;2;2;10;1;2;3013;16;16;1;0;0;2;4;3013;0;6337;4;3;
/org.eclipse.ui.ide/src/org/eclipse/ui/internal/ide/dialogs/UpdateProjectCapabilityWizard.java;2;0;2;1;0;0;0;2;1;1;2;2264;1;1;1;0;0;2;2;2264;0;2766;2;2;
/org.eclipse.core.tools/src/org/eclipse/core/tools/runtime/PluginDependencyPerspective.java;1;0;1;1;1;1;1;0;0;0;0;6302;0;0;1;0;0;0;1;6302;0;6302;1;1;
/org.eclipse.osgi/core/framework/org/eclipse/osgi/framework/internal/core/StartLevelListener.java;3;0;3;1;0;0;0;3;3;1;3;3013;3;3;1;0;0;3;3;3013;0;3150;3;3;
/org.eclipse.jface/src/org/eclipse/jface/viewers/IFontProvider.java;1;0;1;1;0;0;0;1;0;0;1;4235;0;0;1;0;0;1;1;4235;0;4235;1;1;
/org.eclipse.jdt.ui.tests.refactoring/test cases/org/eclipse/jdt/ui/tests/refactoring/infra/SourceCompareUtil.java;1;0;2;1;0;0;0;2;8;1;2;1738;8;8;1;0;0;2;2;1738;0;1822;2;1;
/org.eclipse.jdt.core.tests.model/workspace/Converter/src/test0275/Test.java;1;0;1;1;0;0;0;1;0;0;1;3714;0;0;1;0;0;1;1;3714;0;3714;1;1;
/org.eclipse.team.core/src/org/eclipse/team/core/subscribers/SyncInfoFilter.java;1;0;1;1;0;0;0;1;0;0;1;3550;0;0;1;0;0;1;1;3550;0;3550;1;1;
/org.eclipse.sdk.tests-feature/plugins/org.eclipse.perfmsr.ui.client/src/org/eclipse/perfmsr/ui/client/RunGroupRoot.java;1;1;2;1;2;2;2;0;10;0;0;5443;10;10;1;0;0;0;2;5443;0;5513;2;1;
/org.eclipse.ui.externaltools/Ant Tools Support/org/eclipse/ui/externaltools/internal/ant/view/actions/RemoveProjectAction.java;1;0;1;1;0;0;0;1;0;0;1;282;0;0;1;0;0;1;1;282;0;282;1;1;
/org.eclipse.osgi/supplement/src/org/eclipse/osgi/util/ManifestElement.java;5;1;14;2;4;4;4;10;498;2;8;3216;754;754;2;2;0;10;14;4366;2;6337;12;5;
/org.eclipse.jdt.ui.tests.refactoring/resources/DeleteSourceReferenceEdit/A_testField0_in.java;1;0;1;1;0;0;0;1;0;0;1;1652;0;0;1;0;0;1;1;1652;0;1652;1;1;
/org.eclipse.core.runtime.osgi/src/org/eclipse/core/runtime/BundleHelper.java;1;0;1;1;0;0;0;1;0;0;1;3013;0;0;1;0;0;1;1;3013;0;3013;1;1;
/org.eclipse.core.runtime.osgi/src/org/eclipse/core/internal/runtime/CipherOutputStream.java;1;0;2;1;0;0;0;2;47;1;2;3013;47;47;1;0;0;2;2;3013;0;3030;2;1;
/org.eclipse.jdt.debug.tests/testprograms/org/eclipse/debug/tests/targets/ClassTwo.java;1;0;1;1;0;0;0;1;0;0;1;584;0;0;1;0;0;1;1;584;0;584;1;1;
/org.eclipse.ui.cheatsheets/src/org/eclipse/ui/cheatsheets/events/ICheatSheetItemEvent.java;1;0;2;1;0;0;0;2;0;1;2;4428;0;0;1;0;0;2;2;4428;0;4625;2;1;
/org.eclipse.ui.ide/src/org/eclipse/ui/actions/CreateProjectAction.java;2;0;5;2;0;0;0;5;27;2;4;1511;34;34;2;1;0;5;5;1537;1;2263;4;2;
/org.eclipse.team.ui/src/org/eclipse/team/internal/ui/sync/SyncView.java;2;0;5;1;0;0;0;5;45;1;5;866;80;80;1;0;0;5;5;866;0;4216;5;2;
/org.eclipse.update.ui.win32/src/org/eclipse/welcome/internal/portal/WelcomePortalPart.java;1;0;2;1;0;0;0;2;197;0;1;907;197;197;2;1;0;2;2;907;1;907;1;1;
/org.eclipse.update.ui/src/org/eclipse/update/internal/ui/views/NewExtensionLocationAction.java;3;1;18;1;5;5;5;13;87;2;12;825;243;243;2;1;0;13;18;3408;1;6336;17;3;
/org.eclipse.ui.externaltools/Ant Tools Support/org/eclipse/ui/externaltools/internal/ant/preferences/AntTypesPage.java;1;0;2;1;0;0;0;2;4;1;2;253;4;4;1;0;0;2;2;253;0;298;2;1;
/org.eclipse.team.core/src/org/eclipse/team/internal/core/target/ITeamStatusConstants.java;1;0;1;1;0;0;0;1;0;0;1;2495;0;0;1;0;0;1;1;2495;0;2495;1;1;
/org.eclipse.debug.ui/ui/org/eclipse/debug/internal/ui/launchConfigurations/LaunchConfigurationPropertiesDialog.java;3;1;4;1;2;2;2;2;18;1;2;643;29;29;1;0;0;2;4;643;0;6336;4;3;
/org.eclipse.jdt.ui/ui/org/eclipse/jdt/internal/ui/actions/AbstractToggleLinkAction.java;1;0;1;1;0;0;0;1;0;0;1;1285;0;0;1;0;0;1;1;1285;0;1285;1;1;
/org.eclipse.ui.workbench/Eclipse UI/org/eclipse/ui/internal/progress/ProgressManager.java;4;4;89;2;39;23;39;50;1888;3;37;2119;7233;7233;4;13;16;50;89;6074;29;6338;60;4;
/org.eclipse.jdt.core.tests.model/workspace/Converter/test0254/Test.java;1;0;1;1;0;0;0;1;0;0;1;3714;0;0;1;0;0;1;1;3714;0;3714;1;1;
/org.eclipse.ui.views/src/org/eclipse/ui/views/bookmarkexplorer/RemoveBookmarkAction.java;1;0;1;1;0;0;0;1;0;0;1;2738;0;0;1;0;0;1;1;2738;0;2738;1;1;
/org.eclipse.ui.workbench/Eclipse UI/org/eclipse/ui/internal/activities/ActivityPatternBinding.java;4;0;5;1;1;1;1;4;4;1;4;2896;8;8;1;0;0;4;5;2896;0;6338;5;4;
/org.eclipse.jdt.ui/ui/org/eclipse/jdt/internal/ui/jarpackager/JarPackageWizardPage.java;1;1;5;1;2;2;2;3;57;1;3;244;90;90;1;0;0;3;5;244;0;6340;5;1;
/org.eclipse.jdt.core.tests.model/workspace/Converter/src/javadoc/test009/Test.java;1;0;1;1;0;0;0;1;0;0;1;3813;0;0;1;0;0;1;1;3813;0;3813;1;1;
/org.eclipse.jdt.ui/core refactoring/org/eclipse/jdt/internal/corext/refactoring/typeconstraints/SubtypeOperator.java;1;0;3;1;0;0;0;3;2;1;3;64;2;2;1;0;0;3;3;64;0;1600;3;1;
/org.eclipse.ui.cheatsheets/src/org/eclipse/ui/cheatsheets/ICheatSheetViewer.java;2;2;4;1;3;2;3;1;76;0;1;5093;87;87;2;0;1;1;4;5107;1;5735;3;2;
/org.eclipse.swt/Eclipse SWT/common/org/eclipse/swt/events/ShellEvent.java;1;0;1;1;0;0;0;1;21;0;1;2729;21;21;1;0;0;1;1;2729;0;2729;1;1;
/org.eclipse.jdt.ui.tests/ui/org/eclipse/jdt/ui/tests/quickfix/UnresolvedVariablesQuickFixTest.java;3;1;20;1;5;5;5;15;216;1;15;428;1175;1175;1;0;0;15;20;428;0;6340;20;3;
/org.eclipse.core.tests.runtime/src/org/eclipse/core/tests/internal/runtimetests/SampleNFR.java;1;0;1;1;1;1;1;0;21;0;0;5149;21;21;1;0;0;0;1;5149;0;5149;1;1;
/org.eclipse.jdt.debug.jdi.tests/tests/org/eclipse/debug/jdi/tests/VirtualMachineTest.java;1;0;1;1;0;0;0;1;6;0;1;1320;6;6;1;0;0;1;1;1320;0;1320;1;1;
/org.eclipse.ui.workbench/Eclipse UI/org/eclipse/ui/internal/PluginAction.java;7;1;13;2;3;3;3;10;41;2;9;45;180;180;2;1;0;10;13;3061;1;6338;12;7;
/org.eclipse.update.core/srcnew/org/eclipse/update/internal/operations/ConfigOperation.java;2;0;14;2;0;0;0;14;81;2;10;442;212;212;2;4;0;14;14;442;4;825;10;2;
/org.eclipse.core.runtime/src/org/eclipse/core/runtime/IProgressBlockedMonitor.java;1;0;2;1;0;0;0;2;0;1;2;2064;0;0;1;0;0;2;2;2064;0;2159;2;1;
/org.eclipse.update.ui/srcnew/org/eclipse/update/internal/ui/views/ConfigurationView.java;2;0;2;1;0;0;0;2;4;1;2;767;4;4;1;0;0;2;2;767;0;825;2;2;
/org.eclipse.osgi/osgi/src/org/osgi/framework/AdminPermission.java;2;0;2;1;1;1;1;1;3;0;1;3013;3;3;1;0;0;1;2;3013;0;5536;2;2;
/org.eclipse.jdt.core.tests.model/workspace/Formatter/test001/A_out.java;1;0;1;1;0;0;0;1;0;0;1;2425;0;0;1;0;0;1;1;2425;0;2425;1;1;
/org.eclipse.ui.workbench/Eclipse UI/org/eclipse/ui/actions/WorkspaceModifyOperation.java;1;0;1;1;0;0;0;1;0;0;1;2737;0;0;1;0;0;1;1;2737;0;2737;1;1;
/org.eclipse.jface/src/org/eclipse/jface/progress/IElementCollector.java;1;2;6;1;3;2;3;3;35;1;3;921;62;62;2;0;1;3;6;5208;1;5334;5;1;
/org.eclipse.jdt.core.tests.model/workspace/Converter/src/test0564/A.java;1;0;1;1;1;1;1;0;0;0;0;6078;0;0;1;0;0;0;1;6078;0;6078;1;1;
/org.eclipse.jdt.ui.tests.refactoring/resources/RenamePackage/testImportFromMultiRoots1/in/srcTest/p/p/ATest.java;1;0;3;1;0;0;0;3;6;1;3;3219;8;8;1;0;0;3;3;3219;0;4585;3;1;
/org.eclipse.webdav/src/client/org/eclipse/webdav/http/client/ContentType.java;1;0;2;1;2;1;2;0;245;0;0;5151;245;245;2;0;1;0;2;5151;1;5151;1;1;
/org.eclipse.core.tests.resources/src/org/eclipse/core/tests/resources/session/WorkspaceSerializationTest.java;1;0;1;1;1;1;1;0;36;0;0;5147;36;36;1;0;0;0;1;5147;0;5147;1;1;
/org.eclipse.jdt.ui.examples.javafamily/src/org/eclipse/core/indexsearch/IIndex.java;1;0;1;1;0;0;0;1;2;0;1;3235;2;2;1;0;0;1;1;3235;0;3235;1;1;
/org.eclipse.core.tools.resources/src/org/eclipse/core/tools/metadata/Dump.java;1;0;1;1;1;1;1;0;0;0;0;6302;0;0;1;0;0;0;1;6302;0;6302;1;1;
/org.eclipse.team.ui/src/org/eclipse/team/internal/ui/synchronize/ConfigureRefreshScheduleDialog.java;2;1;8;1;3;3;3;5;197;1;5;3436;394;394;1;0;0;5;8;3436;0;6337;8;2;
/org.eclipse.ui.tests/Eclipse UI Tests/org/eclipse/ui/tests/dialogs/UIDialogsAuto.java;4;1;7;1;2;2;2;5;127;1;5;830;178;178;1;0;0;5;7;830;0;6338;7;4;
/org.eclipse.team.cvs.ui/src/org/eclipse/team/internal/ccvs/ui/subscriber/CVSActionDelegateWrapper.java;1;1;2;1;2;2;2;0;43;0;0;5495;43;43;1;0;0;0;2;5495;0;5508;2;1;
/org.eclipse.pde.ui/src/org/eclipse/pde/internal/ui/wizards/convert/ConvertedProjectsPage.java;1;0;2;1;0;0;0;2;0;0;1;3839;0;0;2;1;0;2;2;3839;1;3839;1;1;
/org.eclipse.help.ui/src/org/eclipse/help/ui/internal/ContextHelpDialog.java;1;2;9;1;5;4;5;4;129;1;4;1879;278;278;2;0;1;4;9;5404;1;6337;8;1;
/org.eclipse.compare/compare/org/eclipse/compare/internal/MergeSourceViewer.java;1;0;1;1;0;0;0;1;6;0;1;1289;6;6;1;0;0;1;1;1289;0;1289;1;1;
/org.eclipse.jdt.ui/ui/org/eclipse/jdt/internal/ui/browsing/JavaBrowsingPerspectiveFactory.java;5;1;12;1;8;8;8;4;19;2;3;1378;102;102;2;1;0;4;12;2946;1;6340;11;5;
/org.eclipse.jdt.core/eval/org/eclipse/jdt/internal/eval/VariablesEvaluator.java;2;0;4;1;0;0;0;4;4;1;4;241;10;10;1;0;0;4;4;241;0;3560;4;2;
/org.eclipse.ui.editors/src/org/eclipse/ui/texteditor/AddTaskAction.java;1;1;2;1;2;2;2;0;3;0;0;5126;5;5;1;0;0;0;2;5126;0;6334;2;1;
/org.eclipse.team.cvs.ui/src/org/eclipse/team/internal/ccvs/ui/operations/TagInRepositoryOperation.java;2;1;7;1;2;2;2;5;14;1;5;994;35;35;1;0;0;5;7;994;0;6337;7;2;
/org.eclipse.team.cvs.ui/src/org/eclipse/team/internal/ccvs/ui/ResourceEditionNode.java;2;1;6;1;3;3;3;3;86;1;3;866;112;112;1;0;0;3;6;866;0;6337;6;2;
/org.eclipse.ui.views/src/org/eclipse/ui/views/properties/IPropertySource.java;2;0;3;1;1;1;1;2;28;1;2;1;52;52;1;0;0;2;3;1;0;5506;3;2;
/org.eclipse.ui.workbench/Eclipse UI/org/eclipse/ui/internal/commands/XPropertyEvent.java;1;0;6;1;0;0;0;6;11;1;6;1695;14;14;1;0;0;6;6;1695;0;4088;6;1;
/org.eclipse.core.tests.runtime/src/org/eclipse/core/tests/internal/plugins/PluginResolveTest_33.java;1;0;1;1;0;0;0;1;0;0;1;3014;0;0;1;0;0;1;1;3014;0;3014;1;1;
/org.eclipse.swt.opengl/motif/org/eclipse/swt/opengl/internal/motif/XGL.java;1;0;1;1;0;0;0;1;0;0;1;1175;0;0;1;0;0;1;1;1175;0;1175;1;1;
/org.eclipse.jdt.ui.tests.refactoring/resources/ExtractMethodWorkSpace/ExtractMethodTests/try_out/A_test457.java;1;0;2;1;0;0;0;2;4;1;2;130;6;6;1;0;0;2;2;130;0;844;2;1;
/org.eclipse.ui.workbench.texteditor/src/org/eclipse/ui/texteditor/BookmarkRulerAction.java;1;0;1;1;0;0;0;1;0;0;1;2741;0;0;1;0;0;1;1;2741;0;2741;1;1;
/org.eclipse.jface.text/src/org/eclipse/jface/text/presentation/IPresentationReconciler.java;2;1;3;1;3;3;3;0;81;0;0;5123;85;85;1;0;0;0;3;5123;0;6352;3;2;
/org.eclipse.core.runtime.osgi/src/org/eclipse/core/runtime/registry/IExtension.java;1;0;2;1;0;0;0;2;9;1;2;3013;9;9;1;0;0;2;2;3013;0;3030;2;1;
/org.eclipse.jdt.ui.examples.javafamily/src/org/eclipse/jdt/internal/ui/examples/jspeditor/AnnotationTextHover.java;3;0;4;1;1;1;1;3;18;1;3;1629;22;22;1;0;0;3;4;1629;0;5380;4;3;
/org.eclipse.jdt.ui.tests.refactoring/resources/ExtractMethodWorkSpace/ExtractMethodTests/semicolon_out/A_test406.java;1;0;2;1;0;0;0;2;4;1;2;130;5;5;1;0;0;2;2;130;0;844;2;1;
/org.eclipse.core.runtime/src/org/eclipse/core/internal/plugins/ExtensionPoint.java;2;0;2;1;0;0;0;2;7;1;2;536;7;7;1;0;0;2;2;536;0;3013;2;2;
/org.eclipse.osgi/eclipseAdaptor/src/org/eclipse/core/runtime/adaptor/Locker_JavaIo.java;3;1;5;1;3;3;3;2;4;1;2;4854;17;17;1;0;0;2;5;4854;0;6133;5;3;
/org.eclipse.jdt.ui/core refactoring/org/eclipse/ltk/internal/core/refactoring/BufferValidationState.java;1;0;3;1;0;0;0;3;2;1;3;4510;2;2;1;0;0;3;3;4510;0;4864;3;1;
/org.eclipse.swt/Eclipse SWT/carbon2/org/eclipse/swt/widgets/Table.java;2;0;5;1;0;0;0;5;108;1;5;110;190;190;1;0;0;5;5;110;0;231;5;2;
/org.eclipse.jdt.ui/core refactoring/org/eclipse/ltk/core/refactoring/CompositeChange.java;1;0;3;1;0;0;0;3;6;1;3;4624;6;6;1;0;0;3;3;4624;0;4864;3;1;
/org.eclipse.swt/Eclipse SWT PI/win32/org/eclipse/swt/internal/win32/SCRIPT_FONTPROPERTIES.java;2;0;2;1;1;1;1;1;4;0;1;5000;4;4;1;0;0;1;2;5000;0;6352;2;2;
/org.eclipse.pde.core/src/org/eclipse/pde/internal/core/schema/StorageSchemaDescriptor.java;1;0;2;1;1;1;1;1;11;0;1;4203;15;15;1;0;0;1;2;4203;0;6336;2;1;
/org.eclipse.compare/compare/org/eclipse/compare/ITypedElement.java;1;0;1;1;0;0;0;1;2;0;1;3935;2;2;1;0;0;1;1;3935;0;3935;1;1;
/org.eclipse.jdt.ui/ui/org/eclipse/jdt/internal/ui/text/spelling/engine/DefaultPhoneticHashProvider.java;2;0;2;1;1;1;1;1;2;0;1;3930;2;2;1;0;0;1;2;3930;0;6340;2;2;
/org.eclipse.jdt.ui/ui/org/eclipse/jdt/internal/ui/text/link/contentassist/CompletionProposalPopup2.java;3;0;10;1;0;0;0;10;60;1;10;1132;208;208;1;0;0;10;10;1132;0;4214;10;3;
/org.eclipse.ui.workbench.texteditor/src/org/eclipse/ui/texteditor/ValidateStateException.java;1;0;1;1;1;1;1;0;2;0;0;6340;2;2;1;0;0;0;1;6340;0;6340;1;1;
/org.eclipse.jface.text/src/org/eclipse/jface/text/source/IAnnotationModelListenerExtension.java;1;0;1;1;1;1;1;0;0;0;0;5382;0;0;1;0;0;0;1;5382;0;5382;1;1;
/org.eclipse.ui.tests/Eclipse UI Tests/org/eclipse/ui/tests/api/workbenchpart/TitleTestEditor.java;1;0;1;1;1;1;1;0;0;0;0;6101;0;0;1;0;0;0;1;6101;0;6101;1;1;
/org.eclipse.jdt.core.tests.model/workspace/Completion/src3/test0027/Test.java;1;0;1;1;1;1;1;0;0;0;0;5222;0;0;1;0;0;0;1;5222;0;5222;1;1;
/org.eclipse.swt/Eclipse SWT Browser/motif/org/eclipse/swt/browser/PromptServiceFactory.java;2;0;2;1;1;1;1;1;6;0;1;4853;6;6;1;0;0;1;2;4853;0;6352;2;2;
/org.eclipse.core.tests.runtime/src/org/eclipse/core/tests/runtime/jobs/RuleSetE.java;2;0;2;1;0;0;0;2;0;1;2;2160;0;0;1;0;0;2;2;2160;0;3408;2;2;
/org.eclipse.team.ui/src/org/eclipse/team/ui/synchronize/subscriber/IRefreshEvent.java;1;0;5;1;0;0;0;5;55;1;5;4319;95;95;1;0;0;5;5;4319;0;4632;5;1;
/org.eclipse.debug.ui/ui/org/eclipse/debug/internal/ui/views/registers/RegistersViewerState.java;1;0;1;1;0;0;0;1;0;0;1;4348;0;0;1;0;0;1;1;4348;0;4348;1;1;
/org.eclipse.jdt.launching/launching/org/eclipse/jdt/internal/launching/RuntimeClasspathEntryResolver.java;2;0;2;1;1;1;1;1;8;0;1;3810;12;12;1;0;0;1;2;3810;0;6336;2;2;
/org.eclipse.pde.build/src/org/eclipse/pde/internal/build/Policy.java;2;0;7;1;1;1;1;6;176;1;6;447;904;904;1;0;0;6;7;447;0;5145;7;2;
/org.eclipse.jdt.ui/core refactoring/org/eclipse/jdt/internal/corext/refactoring/changes/ResourceReorgChange.java;3;0;6;1;1;1;1;5;48;2;4;596;70;70;2;1;0;5;6;596;1;6340;5;3;
/org.eclipse.team.core/src/org/eclipse/team/internal/core/IJobListener.java;2;0;3;1;1;1;1;2;26;1;2;3966;28;28;1;0;0;2;3;3966;0;6336;3;2;
/org.eclipse.swt/Eclipse SWT/win32/org/eclipse/swt/graphics/FontData.java;3;1;7;1;4;4;4;3;175;1;3;174;238;238;1;0;0;3;7;174;0;6352;7;3;
/org.eclipse.update.core/src/org/eclipse/update/internal/model/ConfigurationActivityModel.java;1;0;1;1;0;0;0;1;4;0;1;890;4;4;1;0;0;1;1;890;0;890;1;1;
/org.eclipse.jdt.ui/core refactoring/org/eclipse/jdt/internal/corext/refactoring/participants/DeleteProcessor.java;1;0;2;1;0;0;0;2;0;1;2;1668;0;0;1;0;0;2;2;1668;0;4624;2;1;
/org.eclipse.jdt.ui.tests.refactoring/resources/IntroduceFactory/Bugzilla/59283/proj2/pB/B_out.java;1;0;1;1;1;1;1;0;0;0;0;5661;0;0;1;0;0;0;1;5661;0;5661;1;1;
/org.eclipse.jdt.debug.ui/ui/org/eclipse/jdt/internal/debug/ui/console/J9StackTraceHyperlink.java;1;0;1;1;0;0;0;1;2;0;1;2497;2;2;1;0;0;1;1;2497;0;2497;1;1;
/org.eclipse.jdt.core.tests.model/workspace/Formatter/test462/A_out.java;1;0;1;1;0;0;0;1;0;0;1;3901;0;0;1;0;0;1;1;3901;0;3901;1;1;
/org.eclipse.jdt.core.tests.model/workspace/Completion/src3/test0020/Test.java;1;0;1;1;1;1;1;0;0;0;0;5181;0;0;1;0;0;0;1;5181;0;5181;1;1;
/org.eclipse.jdt.core.tests.model/workspace/Formatter/test021/A_in.java;1;0;1;1;0;0;0;1;0;0;1;2425;0;0;1;0;0;1;1;2425;0;2425;1;1;
/org.eclipse.pde.ui/src/org/eclipse/pde/internal/ui/util/ChoicePropertyDescriptor.java;1;0;1;1;0;0;0;1;6;0;1;1774;6;6;1;0;0;1;1;1774;0;1774;1;1;
/org.eclipse.ui.workbench/Eclipse UI/org/eclipse/ui/internal/keys/WindowsKeyFormatter.java;1;0;2;1;0;0;0;2;6;1;2;3329;6;6;1;0;0;2;2;3329;0;3350;2;1;
/org.eclipse.ui.workbench/Eclipse UI/org/eclipse/ui/dialogs/CheckedTreeSelectionDialog.java;1;2;3;1;3;2;3;0;197;0;0;5188;225;225;2;0;1;0;3;5464;1;5464;2;1;
/org.eclipse.core.expressions.tests/src/org/eclipse/core/internal/expressions/tests/I_TypeExtender.java;1;0;2;1;1;1;1;1;2;0;1;4108;2;2;1;0;0;1;2;4108;0;6340;2;1;
/org.eclipse.jdt.core.tests.model/workspace/Converter/src/test0164/Test.java;1;0;1;1;0;0;0;1;0;0;1;3714;0;0;1;0;0;1;1;3714;0;3714;1;1;
/org.eclipse.jface.text/src/org/eclipse/jface/text/DocumentAdapter.java;3;1;6;1;2;2;2;4;82;1;4;1589;257;257;1;0;0;4;6;1589;0;5177;6;3;
/org.eclipse.ui.workbench/Eclipse UI/org/eclipse/ui/actions/TextActionHandler.java;1;0;1;1;0;0;0;1;0;0;1;2737;0;0;1;0;0;1;1;2737;0;2737;1;1;
/org.eclipse.core.filebuffers/src/org/eclipse/core/internal/filebuffers/IStorageDocumentProvider2.java;1;0;2;1;0;0;0;2;0;1;2;1522;0;0;1;0;0;2;2;1522;0;1574;2;1;
/org.eclipse.ui.workbench/Eclipse UI/org/eclipse/ui/internal/themes/ThemeElementHelper.java;1;0;8;1;0;0;0;8;78;2;7;4392;231;231;2;1;0;8;8;4423;1;5025;7;1;
/org.eclipse.jdt.ui.tests.refactoring/resources/PushDown/testEnablement3/in/A.java;1;0;1;1;0;0;0;1;0;0;1;1312;0;0;1;0;0;1;1;1312;0;1312;1;1;
/org.eclipse.jdt.debug.ui/ui/org/eclipse/jdt/internal/debug/ui/launcher/DefineSystemLibraryQuickFix.java;1;0;2;1;0;0;0;2;3;1;2;1036;6;6;1;0;0;2;2;1036;0;1240;2;1;
/org.eclipse.jdt.debug/jdi/org/eclipse/jdi/internal/ClassTypeImpl.java;1;0;2;1;0;0;0;2;24;1;2;2223;34;34;1;0;0;2;2;2223;0;4267;2;1;
/org.eclipse.jdt.ui/ui/org/eclipse/jdt/ui/wizards/NewClassWizardPage.java;1;0;1;1;1;1;1;0;2;0;0;6340;2;2;1;0;0;0;1;6340;0;6340;1;1;
/org.eclipse.update.ui/src/org/eclipse/update/internal/ui/properties/FeatureGeneralPropertyPage.java;2;0;3;1;0;0;0;3;27;1;3;825;51;51;1;0;0;3;3;825;0;900;3;2;
/org.eclipse.team.ui/src/org/eclipse/team/internal/ui/synchronize/actions/ComparisonCriteriaActionGroup.java;1;0;4;1;0;0;0;4;148;1;4;2561;157;157;1;0;0;4;4;2561;0;4216;4;1;
/org.eclipse.ui.workbench/Eclipse UI/org/eclipse/ui/internal/SetPagePerspectiveAction.java;1;0;1;1;0;0;0;1;0;0;1;4015;0;0;1;0;0;1;1;4015;0;4015;1;1;
/org.eclipse.jdt.debug/eval/org/eclipse/jdt/internal/debug/eval/LocalEvaluationEngine.java;3;2;4;2;3;2;3;1;77;0;1;1276;83;83;2;0;1;1;4;6016;1;6336;3;3;
/org.eclipse.jdt.ui.tests.refactoring/resources/InlineMethodWorkspace/TestCases/nameconflict_out/TestSameType.java;1;0;1;1;0;0;0;1;4;0;1;845;4;4;1;0;0;1;1;845;0;845;1;1;
/org.eclipse.jdt.core.tests.compiler/src/org/eclipse/jdt/core/tests/compiler/regression/TestAll.java;5;0;14;1;1;1;1;13;75;1;13;164;168;168;1;0;0;13;14;164;0;5273;14;5;
/org.eclipse.ui.workbench/Eclipse UI/org/eclipse/ui/internal/chris/roles/RoleRegistryEvent.java;1;0;4;1;0;0;0;4;4;2;3;1952;8;8;2;1;0;4;4;2207;1;2207;3;1;
/org.eclipse.help.webapp/src_servlets/org/eclipse/help/internal/webapp/data/ToolbarData.java;1;1;8;1;7;7;7;1;46;0;1;2105;181;181;1;0;0;1;8;2105;0;6337;8;1;
/org.eclipse.update.core/srcnew/org/eclipse/update/standalone/DisableCommand.java;1;0;4;1;0;0;0;4;2;1;4;671;3;3;1;0;0;4;4;671;0;825;4;1;
/org.eclipse.jdt.debug.ui/ui/org/eclipse/jdt/internal/debug/ui/JavaModelListener.java;2;0;5;1;1;1;1;4;17;1;4;307;31;31;1;0;0;4;5;307;0;5319;5;2;
/org.eclipse.jdt.ui/ui refactoring/org/eclipse/jdt/internal/ui/refactoring/nls/NLSAccessorConfigurationDialog.java;2;2;8;1;8;7;8;0;88;0;0;5375;186;186;2;0;1;0;8;5375;1;6340;7;2;
/org.eclipse.jdt.ui.tests.refactoring/resources/ExtractMethodWorkSpace/ExtractMethodTests/branch_in/A_test755.java;1;0;2;1;0;0;0;2;4;1;2;844;4;4;1;0;0;2;2;844;0;2256;2;1;
/org.eclipse.jdt.ui.tests.refactoring/resources/DeleteSourceReferenceEdit/A_testField0_out.java;1;0;1;1;0;0;0;1;0;0;1;1652;0;0;1;0;0;1;1;1652;0;1652;1;1;
/org.eclipse.ui.workbench/Eclipse UI/org/eclipse/ui/commands/registry/IImageBindingDefinition.java;1;0;3;1;0;0;0;3;2;2;2;1400;2;2;2;1;0;3;3;1400;1;1417;2;1;
/org.eclipse.team.ui/src/org/eclipse/team/ui/ISaveableWorkbenchPart.java;2;1;3;1;3;3;3;0;22;0;0;5192;31;31;1;0;0;0;3;5192;0;5661;3;2;
/org.eclipse.update.ui.forms/src/org/eclipse/update/ui/forms/internal/WebForm.java;3;0;3;1;0;0;0;3;2;1;3;891;6;6;1;0;0;3;3;891;0;2027;3;3;
/org.eclipse.swt.tests/JUnit Tests/org/eclipse/swt/tests/junit/Test_org_eclipse_swt_custom_CLabel.java;1;0;1;1;0;0;0;1;14;0;1;2104;14;14;1;0;0;1;1;2104;0;2104;1;1;
/org.eclipse.swt.examples/src/org/eclipse/swt/examples/controlexample/CTabFolderTab.java;4;1;13;1;6;6;6;7;204;2;5;1560;410;410;2;2;0;7;13;2772;2;6352;11;4;
/org.eclipse.ui.workbench.texteditor/src/org/eclipse/ui/texteditor/PropagatingFontFieldEditor.java;1;0;1;1;1;1;1;0;2;0;0;6340;2;2;1;0;0;0;1;6340;0;6340;1;1;
/org.eclipse.ui.console/src/org/eclipse/ui/internal/console/ConsoleManager.java;5;1;7;1;3;3;3;4;53;1;4;1988;110;110;1;0;0;4;7;1988;0;6336;7;5;
/org.eclipse.update.core/srcnew/org/eclipse/update/internal/search/Sorter.java;2;0;2;1;0;0;0;2;0;1;2;572;0;0;1;0;0;2;2;572;0;825;2;2;
/org.eclipse.jdt.core.tests.model/workspace/Formatter/test232/A_out.java;1;0;1;1;0;0;0;1;0;0;1;2437;0;0;1;0;0;1;1;2437;0;2437;1;1;
/org.eclipse.jdt.debug.ui/ui/org/eclipse/jdt/internal/debug/ui/monitors/MonitorsView.java;5;2;7;2;5;4;5;2;97;1;2;4333;137;137;2;0;1;2;7;5616;1;5856;6;5;
/org.eclipse.debug.core/core/org/eclipse/debug/internal/core/stringsubstitution/IStringVariableContext.java;1;0;2;1;0;0;0;2;0;1;2;1118;0;0;1;0;0;2;2;1118;0;2032;2;1;
/org.eclipse.swt/Eclipse SWT/gtk/org/eclipse/swt/widgets/Combo.java;7;2;43;2;8;7;8;35;80;2;30;54;675;675;2;5;1;35;43;1240;6;6352;37;7;
/org.eclipse.pde.core/src/org/eclipse/pde/internal/core/PluginModelManager.java;3;2;37;1;16;14;16;21;120;2;18;2229;782;782;2;3;2;21;37;2811;5;6336;32;3;
/org.eclipse.team.cvs.ui/src/org/eclipse/team/internal/ccvs/ui/repo/RepositoriesViewContentHandler.java;2;1;9;1;4;4;4;5;48;1;5;2043;135;135;1;0;0;5;9;2043;0;6337;9;2;
/org.eclipse.ui.workbench/Eclipse UI/org/eclipse/ui/internal/PerspectiveContributionItem.java;2;0;2;1;0;0;0;2;3;1;2;2737;3;3;1;0;0;2;2;2737;0;4015;2;2;
/org.eclipse.jdt.ui.tests.refactoring/resources/SurroundWithWorkSpace/SurroundWithTests/trycatch_out/TestInitializer.java;1;0;1;1;0;0;0;1;6;0;1;845;6;6;1;0;0;1;1;845;0;845;1;1;
/org.eclipse.ui.workbench/Eclipse UI/org/eclipse/ui/internal/commands/State.java;1;0;10;1;0;0;0;10;65;1;10;607;115;115;1;0;0;10;10;607;0;1634;10;1;
/org.eclipse.update.core/src/org/eclipse/update/standalone/ScriptedCommand.java;1;1;7;1;4;4;4;3;78;2;2;825;115;115;2;1;0;3;7;825;1;6336;6;1;
/org.eclipse.jdt.ui/ui refactoring/org/eclipse/jdt/internal/ui/refactoring/IntroduceParameterWizard.java;3;1;5;1;2;2;2;3;17;1;3;2217;28;28;1;0;0;3;5;2217;0;6340;5;3;
/org.eclipse.jdt.ui/ui refactoring/org/eclipse/jdt/internal/ui/refactoring/PreviewWizardPage.java;2;0;10;1;0;0;0;10;207;2;9;1033;369;369;2;1;0;10;10;1253;1;4965;9;2;
/org.eclipse.team.tests.cvs.core/src/org/eclipse/team/tests/ccvs/core/cvsresources/ResourceSyncInfoTest.java;1;0;1;1;0;0;0;1;42;0;1;2761;42;42;1;0;0;1;1;2761;0;2761;1;1;
/org.eclipse.ui.views/src/org/eclipse/ui/views/internal/markers/bookmarks/BookmarkFiltersDialog.java;1;0;3;1;0;0;0;3;2;1;3;265;2;2;1;0;0;3;3;265;0;749;3;1;
/org.eclipse.ui.tests/Eclipse UI Tests/org/eclipse/ui/tests/internal/PopupMenuExpressionTest.java;2;1;2;1;2;2;2;0;20;0;0;5437;24;24;1;0;0;0;2;5437;0;6338;2;2;
/org.eclipse.team.cvs.core/src/org/eclipse/team/internal/ccvs/core/syncinfo/CVSDescendantResourceVariantTree.java;1;0;2;1;0;0;0;2;0;1;2;4238;0;0;1;0;0;2;2;4238;0;4259;2;1;
/org.eclipse.core.tests.resources/src/org/eclipse/core/tests/resources/regression/Bug_29671.java;1;0;2;1;2;1;2;0;19;0;0;5147;19;19;2;0;1;0;2;5147;1;5147;1;1;
/org.eclipse.team.core/src/org/eclipse/team/core/wvcm/WVCMAuthenticationProvider.java;1;0;1;1;0;0;0;1;0;0;1;3049;0;0;1;0;0;1;1;3049;0;3049;1;1;
/org.eclipse.ui.tests/Eclipse UI Tests/org/eclipse/ui/tests/api/IWorkbenchWindowActionDelegateTest.java;2;0;2;2;0;0;0;2;31;0;1;3312;31;31;2;1;0;2;2;3312;1;3312;1;2;
/org.eclipse.jdt.core/search/org/eclipse/jdt/internal/core/search/indexing/IndexBinaryFolder.java;3;0;13;2;1;1;1;12;24;2;9;937;84;84;2;3;0;12;13;937;3;5266;10;3;
/org.eclipse.swt/Eclipse SWT/gtk/org/eclipse/swt/widgets/TreeItem.java;7;2;15;2;5;4;5;10;48;1;10;269;202;202;2;0;1;10;15;5683;1;6352;14;7;
/org.eclipse.team.ui/src/org/eclipse/team/ui/synchronize/subscriber/TeamSubscriberParticipantPage.java;1;0;1;1;0;0;0;1;0;0;1;3972;0;0;1;0;0;1;1;3972;0;3972;1;1;
/org.eclipse.jdt.core.tests.model/workspace/Converter/test0337/Test.java;1;0;1;1;0;0;0;1;0;0;1;3714;0;0;1;0;0;1;1;3714;0;3714;1;1;
/org.eclipse.ui.editors/src/org/eclipse/ui/editors/text/TextFileDocumentProvider.java;3;2;44;2;12;10;12;32;192;2;28;1580;1283;1283;2;4;2;32;44;1592;6;6360;38;3;
/org.eclipse.pde.ui/src/org/eclipse/pde/internal/ui/wizards/project/OpenProjectWizardAction.java;1;0;1;1;0;0;0;1;0;0;1;3839;0;0;1;0;0;1;1;3839;0;3839;1;1;
/org.eclipse.team.ui/src/org/eclipse/team/ui/sync/actions/ComparisonCriteriaActionGroup.java;1;0;1;1;0;0;0;1;0;0;1;2460;0;0;1;0;0;1;1;2460;0;2460;1;1;
/org.eclipse.team.cvs.core/src/org/eclipse/team/internal/ccvs/core/client/CheckedInHandler.java;1;0;1;1;0;0;0;1;7;0;1;3131;7;7;1;0;0;1;1;3131;0;3131;1;1;
/org.eclipse.debug.ui/ui/org/eclipse/debug/internal/ui/views/expression/ExpressionView.java;4;0;13;1;0;0;0;13;53;1;13;670;165;165;1;0;0;13;13;670;0;5045;13;4;
/org.eclipse.jdt.ui/ui/org/eclipse/jdt/internal/ui/filters/CustomFiltersDialog.java;3;1;6;1;3;3;3;3;72;1;3;2157;116;116;1;0;0;3;6;2157;0;6340;6;3;
/org.eclipse.jdt.ui/ui/org/eclipse/jdt/internal/ui/preferences/formatter/JavaPreview.java;2;1;11;1;2;2;2;9;202;2;7;3103;309;309;2;2;0;9;11;3103;2;5197;9;2;
/org.eclipse.team.cvs.ui/src/org/eclipse/team/internal/ccvs/ui/AnnotateView.java;2;1;9;1;3;3;3;6;68;1;6;784;221;221;1;0;0;6;9;784;0;6337;9;2;
/org.eclipse.jdt.ui.tests.refactoring/test cases/org/eclipse/jdt/ui/tests/nls/NlsRefactoringCheckInitialConditionsTest.java;3;1;3;1;2;2;2;1;76;0;1;4930;80;80;1;0;0;1;3;4930;0;6340;3;3;
/org.eclipse.jdt.ui/ui/org/eclipse/jdt/ui/text/spelling/engine/ISpellChecker.java;1;0;2;1;0;0;0;2;0;1;2;3829;0;0;1;0;0;2;2;3829;0;3930;2;1;
/org.eclipse.jdt.core.tests.model/workspace/Formatter/test383/A_in.java;1;0;1;1;0;0;0;1;0;0;1;3163;0;0;1;0;0;1;1;3163;0;3163;1;1;
/org.eclipse.jdt.ui/core refactoring/org/eclipse/jdt/internal/corext/refactoring/nls/Messages.java;2;1;2;1;2;2;2;0;2;0;0;5186;2;2;1;0;0;0;2;5186;0;6340;2;2;
/org.eclipse.jdt.core.tests.model/workspace/Converter/src/test0190/Test.java;1;0;1;1;0;0;0;1;0;0;1;3714;0;0;1;0;0;1;1;3714;0;3714;1;1;
/org.eclipse.debug.ui/ui/org/eclipse/debug/internal/ui/views/variables/IValueContentProvider.java;1;0;1;1;0;0;0;1;0;0;1;2564;0;0;1;0;0;1;1;2564;0;2564;1;1;
/org.eclipse.jdt.core.tests.model/workspace/Converter/test0009/Test.java;1;0;1;1;0;0;0;1;0;0;1;3714;0;0;1;0;0;1;1;3714;0;3714;1;1;
/org.eclipse.jdt.core.tests.model/workspace/Converter/test0022/Test.java;1;0;1;1;0;0;0;1;0;0;1;3714;0;0;1;0;0;1;1;3714;0;3714;1;1;
/org.eclipse.jdt.core.tests.model/workspace/Formatter/test320/A_in.java;1;0;1;1;0;0;0;1;0;0;1;2462;0;0;1;0;0;1;1;2462;0;2462;1;1;
/org.eclipse.team.ui/src/org/eclipse/team/internal/ui/target/GetAsProjectAction.java;2;0;3;1;0;0;0;3;7;1;3;990;12;12;1;0;0;3;3;990;0;2495;3;2;
/org.eclipse.compare/compare/org/eclipse/compare/internal/patch/PatchWizard.java;1;0;10;1;0;0;0;10;19;1;10;257;42;42;1;0;0;10;10;257;0;4021;10;1;
/org.eclipse.jdt.core.tests.model/workspace/Formatter/test061/Parser_out.java;1;0;1;1;0;0;0;1;0;0;1;2425;0;0;1;0;0;1;1;2425;0;2425;1;1;
/org.eclipse.pde.ui/src_Forms/org/eclipse/pde/internal/ui/neweditor/XMLSourcePage.java;2;2;8;1;4;3;4;4;17;1;4;3777;65;65;2;0;1;4;8;5341;1;5431;7;2;
/org.eclipse.jface.text/src/org/eclipse/jface/text/contentassist/PopupCloser.java;2;2;4;1;3;2;3;1;13;0;1;2004;22;22;2;0;1;1;4;6353;1;6353;3;2;
/org.eclipse.team.core/src/org/eclipse/team/core/sync/IRemoteResource.java;2;0;3;1;0;0;0;3;12;1;3;917;18;18;1;0;0;3;3;917;0;4217;3;2;
/org.eclipse.swt/Eclipse SWT/gtk1x/org/eclipse/swt/widgets/MenuItem.java;1;0;1;1;0;0;0;1;0;0;1;2327;0;0;1;0;0;1;1;2327;0;2327;1;1;
/org.eclipse.jdt.core.tests.model/workspace/Converter/test0036/Test.java;1;0;1;1;0;0;0;1;0;0;1;3714;0;0;1;0;0;1;1;3714;0;3714;1;1;
/org.eclipse.ui.externaltools/Ant Editor/org/eclipse/ui/externaltools/internal/ant/editor/outline/ILocationProvider.java;1;0;1;1;0;0;0;1;0;0;1;282;0;0;1;0;0;1;1;282;0;282;1;1;
/org.eclipse.jdt.ui.tests.refactoring/resources/DeleteSourceReference/test10/in/A.java;1;0;1;1;0;0;0;1;0;0;1;1652;0;0;1;0;0;1;1;1652;0;1652;1;1;
/org.eclipse.osgi/resolver/src/org/eclipse/osgi/internal/resolver/StateManager.java;5;1;23;1;7;7;7;16;93;2;15;3013;378;378;2;1;0;16;23;4238;1;6156;22;5;
/org.eclipse.ui.tests/Eclipse UI Tests/org/eclipse/ui/tests/dialogs/DeprecatedUIPreferencesAuto.java;2;0;2;1;0;0;0;2;5;1;2;2007;7;7;1;0;0;2;2;2007;0;2738;2;2;
/org.eclipse.ui.ide/src/org/eclipse/ui/views/tasklist/IMarkerConstants.java;1;0;1;1;0;0;0;1;0;0;1;2208;0;0;1;0;0;1;1;2208;0;2208;1;1;
/org.eclipse.ui.editors/src/org/eclipse/ui/editors/text/IEncodingSupport.java;1;0;1;1;1;1;1;0;4;0;0;6334;4;4;1;0;0;0;1;6334;0;6334;1;1;
/org.eclipse.search/search/org/eclipse/search/internal/ui/util/ListDialog.java;1;0;1;1;1;1;1;0;2;0;0;6340;2;2;1;0;0;0;1;6340;0;6340;1;1;
/org.eclipse.jdt.ui/core refactoring/org/eclipse/jdt/internal/corext/refactoring/participants/RenameParticipantElement.java;1;0;2;1;0;0;0;2;0;1;2;591;0;0;1;0;0;2;2;591;0;825;2;1;
/org.eclipse.jdt.core.tests.model/src/org/eclipse/jdt/core/tests/model/NamingConventionTests.java;3;0;3;1;1;1;1;2;66;1;2;2094;126;126;1;0;0;2;3;2094;0;5651;3;3;
/org.eclipse.ui.ide/src/org/eclipse/ui/wizards/datatransfer/WizardZipFileResourceExportPage1.java;2;0;3;1;0;0;0;3;33;1;3;1511;40;40;1;0;0;3;3;1511;0;2780;3;2;
/org.eclipse.jdt.core/search/org/eclipse/jdt/internal/core/search/AbstractSearchScope.java;2;0;2;1;0;0;0;2;2;1;2;1893;4;4;1;0;0;2;2;1893;0;3560;2;2;
/org.eclipse.jface.text/src/org/eclipse/jface/text/formatter/ContentFormatter2.java;2;0;3;1;0;0;0;3;27;1;3;2506;27;27;1;0;0;3;3;2506;0;4365;3;2;
/org.eclipse.team.core/src/org/eclipse/team/core/subscribers/Subscriber.java;2;1;9;1;3;3;3;6;280;1;6;3966;500;500;1;0;0;6;9;3966;0;6336;9;2;
/org.eclipse.ltk.core.refactoring/src/org/eclipse/ltk/core/refactoring/participants/RenameRefactoring.java;1;1;4;1;2;2;2;2;21;1;2;4845;32;32;1;0;0;2;4;4845;0;6340;4;1;
/org.eclipse.update.core/src/org/eclipse/update/core/model/FeatureInstaller.java;1;0;1;1;0;0;0;1;0;0;1;2650;0;0;1;0;0;1;1;2650;0;2650;1;1;
/org.eclipse.pde.ui/src/org/eclipse/pde/internal/ui/editor/site/ArchiveSection.java;2;1;6;1;3;3;3;3;399;1;3;2311;666;666;1;0;0;3;6;2311;0;6336;6;2;
/org.eclipse.team.tests.cvs.core/src/org/eclipse/team/tests/ccvs/ui/logformatter/GroupEntry.java;1;0;1;1;0;0;0;1;0;0;1;2632;0;0;1;0;0;1;1;2632;0;2632;1;1;
/org.eclipse.help/src/org/eclipse/help/internal/protocols/HelpURLConnection.java;1;1;9;1;3;3;3;6;232;2;5;1010;476;476;2;1;0;6;9;4609;1;6337;8;1;
/org.eclipse.ant.tests.ui/Ant in Separate VM/org/eclipse/ant/tests/ui/testplugin/ConsoleLineTracker.java;1;0;3;1;0;0;0;3;24;1;3;1610;24;24;1;0;0;3;3;1610;0;1796;3;1;
/org.eclipse.jdt.junit/src/org/eclipse/jdt/internal/junit/ui/JUnitPreferencePage.java;2;1;3;1;3;3;3;0;5;0;0;5676;11;11;1;0;0;0;3;5676;0;6340;3;2;
/org.eclipse.ui.workbench/Eclipse UI/org/eclipse/ui/internal/chris/roles/api/secondstage/IRoleRegistryEvent.java;1;0;2;1;0;0;0;2;0;0;1;2207;0;0;2;1;0;2;2;2207;1;2207;1;1;
/org.eclipse.update.ui/srcnew/org/eclipse/update/internal/ui/wizards/UnifiedLicensePage.java;3;0;5;2;0;0;0;5;10;2;4;481;15;15;2;1;0;5;5;481;1;825;4;3;
/org.eclipse.jdt.core.tests.compiler/src/org/eclipse/jdt/core/tests/runtime/TargetException.java;1;0;1;1;0;0;0;1;2;0;1;3560;2;2;1;0;0;1;1;3560;0;3560;1;1;
/org.eclipse.jdt.ui.tests.refactoring/resources/ExtractMethodWorkSpace/ExtractMethodTests/locals_in/A_test561.java;1;0;1;1;0;0;0;1;2;0;1;844;2;2;1;0;0;1;1;844;0;844;1;1;
/org.eclipse.jdt.core.tests.model/workspace/Formatter/test283/A_out.java;1;0;1;1;0;0;0;1;0;0;1;2443;0;0;1;0;0;1;1;2443;0;2443;1;1;
/org.eclipse.jdt.core/model/org/eclipse/jdt/internal/core/JarEntryFile.java;1;0;1;1;0;0;0;1;2;0;1;3560;2;2;1;0;0;1;1;3560;0;3560;1;1;
/org.eclipse.jdt.core.tests.model/src/org/eclipse/jdt/core/tests/model/JavaSearchAnnotationTests.java;1;0;2;1;0;0;0;2;0;1;2;2661;0;0;1;0;0;2;2;2661;0;2887;2;1;
/org.eclipse.jdt.core.tests.builder/src/org/eclipse/jdt/core/tests/builder/ErrorsTests.java;2;0;2;1;0;0;0;2;4;1;2;1387;6;6;1;0;0;2;2;1387;0;3560;2;2;
/org.eclipse.jdt.core.tests.model/workspace/Converter/test0153/Test.java;1;0;1;1;0;0;0;1;0;0;1;3714;0;0;1;0;0;1;1;3714;0;3714;1;1;
/org.eclipse.debug.ui/ui/org/eclipse/debug/internal/ui/actions/ContextualLaunchObjectActionDelegate.java;3;2;10;2;3;2;3;7;167;2;6;3806;482;482;2;1;1;7;10;3806;2;5510;8;3;
/org.eclipse.team.cvs.ui/src/org/eclipse/team/internal/ccvs/ui/SynchronizeProjectsDialog.java;1;0;1;1;0;0;0;1;9;0;1;2381;9;9;1;0;0;1;1;2381;0;2381;1;1;
/org.eclipse.jdt.ui/core refactoring/org/eclipse/jdt/internal/corext/refactoring/structure/UseSupertypeWherePossibleUtil.java;2;0;3;1;0;0;0;3;23;1;3;218;39;39;1;0;0;3;3;218;0;1166;3;2;
/org.eclipse.osgi/eclipseAdaptor/src/org/eclipse/osgi/service/localization/BundleLocalization.java;3;0;3;1;1;1;1;2;4;1;2;4780;8;8;1;0;0;2;3;4780;0;5117;3;3;
/org.eclipse.text.tests/projection/org/eclipse/text/tests/ProjectionMappingTest.java;2;1;4;1;3;3;3;1;175;0;1;5082;193;193;1;0;0;1;4;5082;0;6340;4;2;
/org.eclipse.debug.core/core/org/eclipse/debug/core/variables/IContextLaunchVariable.java;2;0;7;1;0;0;0;7;22;2;6;562;45;45;2;1;0;7;7;562;1;2120;6;2;
/org.eclipse.jdt.ui.tests.refactoring/resources/IntroduceFactory/positive/DifferentSigs_in.java;1;0;2;1;1;1;1;1;2;0;1;2862;2;2;1;0;0;1;2;2862;0;5659;2;1;
/org.eclipse.jdt.ui/ui/org/eclipse/jdt/internal/ui/workingsets/WorkingSetFilter.java;2;0;3;1;1;1;1;2;5;1;2;1386;12;12;1;0;0;2;3;1386;0;6340;3;2;
/org.eclipse.jdt.ui/core extension/org/eclipse/jdt/internal/corext/dom/NodeFinder.java;3;0;5;1;1;1;1;4;50;1;4;377;71;71;1;0;0;4;5;377;0;6340;5;3;
/org.eclipse.ui.ide/src/org/eclipse/ui/views/markers/internal/FiltersAction.java;5;0;5;1;1;1;1;4;12;1;4;2208;17;17;1;0;0;4;5;2208;0;6338;5;5;
/org.eclipse.ui.workbench/Eclipse UI/org/eclipse/ui/internal/commands/registry/old/AbstractMutableRegistry.java;1;0;3;1;0;0;0;3;2;2;2;1222;2;2;2;1;0;3;3;1321;1;1321;2;1;
/org.eclipse.ui.tests/Eclipse UI Tests/org/eclipse/ui/tests/dnd/TestDragSource.java;1;0;1;1;0;0;0;1;0;0;1;5007;0;0;1;0;0;1;1;5007;0;5007;1;1;
/org.eclipse.swt.opengl/gtk/org/eclipse/swt/opengl/internal/gtk/XGL.java;1;0;1;1;0;0;0;1;0;0;1;2143;0;0;1;0;0;1;1;2143;0;2143;1;1;
/org.eclipse.jdt.ui/core extension/org/eclipse/jdt/internal/corext/dom/ScopeAnalyzer.java;2;1;14;1;2;2;2;12;122;2;11;223;631;631;2;1;0;12;14;356;1;6340;13;2;
/org.eclipse.core.runtime/src/org/eclipse/core/runtime/model/ConfigurationPropertyModel.java;2;0;2;1;0;0;0;2;14;1;2;536;14;14;1;0;0;2;2;536;0;3013;2;2;
/org.eclipse.jdt.debug.ui/ui/org/eclipse/jdt/internal/debug/ui/snippeteditor/ScrapbookLauncher.java;3;1;10;1;4;4;4;6;16;2;5;648;47;47;2;1;0;6;10;3382;1;6336;9;3;
/org.eclipse.ui.views/src/org/eclipse/ui/views/markers/internal/ActionPasteMarker.java;2;0;2;1;0;0;0;2;0;1;2;755;0;0;1;0;0;2;2;755;0;2738;2;2;
/org.eclipse.jdt.ui.tests.refactoring/resources/TypeConstraints/A_testConstraints1.java;1;0;1;1;0;0;0;1;0;0;1;53;0;0;1;0;0;1;1;53;0;53;1;1;
/org.eclipse.jdt.ui/ui refactoring/org/eclipse/jdt/internal/ui/refactoring/reorg/ReorgCopyStarter.java;3;1;7;1;2;2;2;5;11;1;5;1114;36;36;1;0;0;5;7;1114;0;6340;7;3;
/org.eclipse.jdt.ui.tests.refactoring/resources/TypeConstraints/A_testConstraints4.java;1;0;1;1;0;0;0;1;0;0;1;65;0;0;1;0;0;1;1;65;0;65;1;1;
/org.eclipse.debug.ui/ui/org/eclipse/debug/ui/launchVariables/PromptExpanderBase.java;1;0;2;1;0;0;0;2;0;1;2;550;0;0;1;0;0;2;2;550;0;562;2;1;
/org.eclipse.team.tests.cvs.core/src/org/eclipse/team/tests/ccvs/ui/old/MergeRunsVisitor.java;1;0;2;1;0;0;0;2;0;1;2;2632;0;0;1;0;0;2;2;2632;0;4216;2;1;
/org.eclipse.debug.ui/ui/org/eclipse/debug/ui/IDebugModelPresentation.java;3;0;3;1;1;1;1;2;4;1;2;2184;6;6;1;0;0;2;3;2184;0;6336;3;3;
/org.eclipse.pde.build/src/org/eclipse/pde/internal/build/builder/FragmentBuildScriptGenerator.java;2;0;6;1;0;0;0;6;1;1;6;447;1;1;1;0;0;6;6;447;0;5036;6;2;
/org.eclipse.jdt.ui.tests.refactoring/resources/MoveMembers/test26/out/A.java;3;0;3;1;1;1;1;2;2;1;2;347;3;3;1;0;0;2;3;347;0;5676;3;3;
/org.eclipse.jdt.ui/ui/org/eclipse/jdt/internal/ui/viewsupport/JavaElementImageProvider.java;4;1;8;1;4;4;4;4;22;1;4;1235;42;42;1;0;0;4;8;1235;0;6340;8;4;
/org.eclipse.ui.intro/src/org/eclipse/ui/internal/intro/impl/parts/SharedStyleManager.java;1;2;7;1;7;5;7;0;226;0;0;5449;315;315;2;0;2;0;7;5539;2;5712;5;1;
/org.eclipse.debug.ui/ui/org/eclipse/debug/internal/ui/actions/RetargetToggleLineBreakpointAction.java;1;0;2;1;0;0;0;2;1;1;2;4471;1;1;1;0;0;2;2;4471;0;4496;2;1;
/org.eclipse.swt/Eclipse SWT PI/motif/org/eclipse/swt/internal/motif/XButtonEvent.java;1;0;2;1;0;0;0;2;12;1;2;825;16;16;1;0;0;2;2;825;0;868;2;1;
/org.eclipse.ui.workbench/Eclipse UI/org/eclipse/ui/IViewPart2.java;2;0;2;2;2;1;2;0;0;0;0;5467;0;0;2;0;1;0;2;5467;1;5467;1;2;
/org.eclipse.ui.workbench/Eclipse UI/org/eclipse/ui/internal/EditorSashContainer.java;4;2;7;1;7;6;7;0;49;0;0;5539;76;76;2;0;1;0;7;6248;1;6338;6;4;
/org.eclipse.ua.tests/src/org/eclipse/ui/examples/cheatsheets/pattern/wizards/MyProjectCreationWizard.java;1;0;1;1;1;1;1;0;0;0;0;6081;0;0;1;0;0;0;1;6081;0;6081;1;1;
/org.eclipse.jdt.core.tests.model/src/org/eclipse/jdt/core/tests/model/HierarchyOnWorkingCopiesTests.java;2;1;7;1;2;2;2;5;35;1;5;2138;63;63;1;0;0;5;7;2138;0;5934;7;2;
/org.eclipse.update.core/src/org/eclipse/update/internal/core/FeatureExecutableFactory.java;2;1;3;1;2;2;2;1;11;0;1;890;24;24;1;0;0;1;3;890;0;6336;3;2;
/org.eclipse.pde.ui/src/org/eclipse/pde/internal/ui/editor/feature/PreviewAction.java;1;0;1;1;0;0;0;1;0;0;1;1615;0;0;1;0;0;1;1;1615;0;1615;1;1;
/org.eclipse.ant.ui/Ant Tools Support/org/eclipse/ant/internal/ui/preferences/StatusInfo.java;1;0;3;1;1;1;1;2;10;1;2;1811;14;14;1;0;0;2;3;1811;0;6336;3;1;
/org.eclipse.osgi/eclipseAdaptor/src/org/eclipse/osgi/service/environment/Constants.java;4;1;5;1;3;3;3;2;8;1;2;3147;26;26;1;0;0;2;5;3147;0;6337;5;4;
/org.eclipse.ui.workbench/Eclipse UI/org/eclipse/ui/internal/dnd/SwtUtil.java;1;1;5;1;3;3;3;2;27;1;2;4855;72;72;1;0;0;2;5;4855;0;5917;5;1;
/org.eclipse.jdt.ui/ui refactoring/org/eclipse/jdt/internal/ui/refactoring/RefactoringStatusEntryLabelProvider.java;1;0;2;1;0;0;0;2;4;1;2;4575;4;4;1;0;0;2;2;4575;0;4965;2;1;
/org.eclipse.team.tests.cvs.core/src/org/eclipse/team/tests/ccvs/core/subscriber/TestCommitAction.java;2;0;7;1;0;0;0;7;13;1;7;1241;25;25;1;0;0;7;7;1241;0;4450;7;2;
/org.eclipse.update.ui.forms/Eclipse Forms/org/eclipse/ui/forms/internal/widgets/HyperlinkSegment.java;1;0;2;1;0;0;0;2;0;1;2;3138;0;0;1;0;0;2;2;3138;0;4157;2;1;
/org.eclipse.jdt.core/compiler/org/eclipse/jdt/internal/compiler/ast/Argument.java;2;0;8;1;1;1;1;7;44;1;7;13;129;129;1;0;0;7;8;13;0;5587;8;2;
/org.eclipse.text.tests/src/org/eclipse/text/tests/link/LinkedPositionTest.java;1;0;2;1;1;1;1;1;2;0;1;5082;2;2;1;0;0;1;2;5082;0;6340;2;1;
/org.eclipse.jdt.core.tests.model/workspace/Converter/src/test0251/Test.java;1;0;1;1;0;0;0;1;0;0;1;3714;0;0;1;0;0;1;1;3714;0;3714;1;1;
/org.eclipse.team.webdav/src/org/eclipse/team/internal/core/target/ResourceState.java;2;0;3;1;1;1;1;2;2;1;2;2495;4;4;1;0;0;2;3;2495;0;6337;3;2;
/org.eclipse.search/search/org/eclipse/search/internal/ui/SearchResultContentProvider.java;1;0;1;1;1;1;1;0;2;0;0;6340;2;2;1;0;0;0;1;6340;0;6340;1;1;
/org.eclipse.team.ui/src/org/eclipse/team/internal/ui/target/TargetSyncAction.java;1;0;2;1;0;0;0;2;2;1;2;866;2;2;1;0;0;2;2;866;0;2495;2;1;
/org.eclipse.team.cvs.ssh2/src/org/eclipse/team/ccvs/ssh2/PassphraseDialog.java;2;0;3;1;0;0;0;3;2;1;3;2956;2;2;1;0;0;3;3;2956;0;3113;3;2;
/org.eclipse.update.ui.forms/Eclipse Forms/org/eclipse/ui/forms/events/IFormEntryListener.java;1;0;3;1;0;0;0;3;2;1;3;3098;2;2;1;0;0;3;3;3098;0;4157;3;1;
/org.eclipse.jdt.core/model/org/eclipse/jdt/internal/core/jdom/SiblingEnumeration.java;1;0;2;1;1;1;1;1;6;0;1;3560;8;8;1;0;0;1;2;3560;0;5584;2;1;
/org.eclipse.jdt.core/model/org/eclipse/jdt/internal/core/hierarchy/HierarchyBinaryType.java;1;0;1;1;0;0;0;1;2;0;1;3560;2;2;1;0;0;1;1;3560;0;3560;1;1;
/org.eclipse.jdt.core/model/org/eclipse/jdt/internal/core/util/AnnotationDefaultAttribute.java;1;0;1;1;0;0;0;1;0;0;1;4515;0;0;1;0;0;1;1;4515;0;4515;1;1;
/org.eclipse.jdt.ui.tests.refactoring/resources/InlineMethodWorkspace/TestCases/cast_out/TestNotOverloaded.java;1;0;1;1;0;0;0;1;0;0;1;955;0;0;1;0;0;1;1;955;0;955;1;1;
/org.eclipse.core.runtime.osgi/src/org/eclipse/core/boot/IPlatformRunnable.java;1;0;2;1;0;0;0;2;36;1;2;3013;36;36;1;0;0;2;2;3013;0;3028;2;1;
/org.eclipse.jdt.debug.ui/ui/org/eclipse/jdt/internal/debug/ui/actions/InstanceFilterViewer.java;1;0;1;1;0;0;0;1;0;0;1;1484;0;0;1;0;0;1;1;1484;0;1484;1;1;
/org.eclipse.debug.ui/ui/org/eclipse/debug/internal/ui/launchVariables/DefaultVariableComponent.java;1;0;4;1;0;0;0;4;3;1;4;562;4;4;1;0;0;4;4;562;0;771;4;1;
/org.eclipse.sdk.tests-feature/plugins/org.eclipse.perfmsr.ui.client/src/org/eclipse/perfmsr/ui/client/ValuesDescriptor.java;1;1;4;1;4;4;4;0;78;0;0;5443;92;92;1;0;0;0;4;5443;0;5736;4;1;
/org.eclipse.ui.workbench/Eclipse UI/org/eclipse/ui/internal/csm/activities/ActivityActivationServiceEvent.java;1;0;2;1;0;0;0;2;0;1;2;2225;0;0;1;0;0;2;2;2225;0;2310;2;1;
/org.eclipse.jdt.core/model/org/eclipse/jdt/core/BufferChangedEvent.java;1;0;2;1;0;0;0;2;2;1;2;3324;4;4;1;0;0;2;2;3324;0;3560;2;1;
/org.eclipse.core.tools.resources/src/org/eclipse/core/tools/metadata/MarkersDumpingStrategy_2.java;1;0;1;1;1;1;1;0;0;0;0;6302;0;0;1;0;0;0;1;6302;0;6302;1;1;
/org.eclipse.ui.workbench/Eclipse UI/org/eclipse/ui/internal/util/SWTResourceUtil.java;1;0;1;1;1;1;1;0;0;0;0;5876;0;0;1;0;0;0;1;5876;0;5876;1;1;
/org.eclipse.jdt.ui.tests/ui/org/eclipse/jdt/ui/tests/core/AddUnimplementedMethodsTest.java;2;0;4;1;1;1;1;3;27;1;3;578;37;37;1;0;0;3;4;578;0;6340;4;2;
/org.eclipse.jdt.core/compiler/org/eclipse/jdt/internal/compiler/classfmt/ClassFileReader.java;4;1;9;1;3;3;3;6;29;1;6;232;99;99;1;0;0;6;9;232;0;6243;9;4;
/org.eclipse.swt.opengl.examples/src/org/eclipse/swt/opengl/examples/StencilTab.java;1;0;1;1;0;0;0;1;0;0;1;1175;0;0;1;0;0;1;1;1175;0;1175;1;1;
/org.eclipse.jdt.ui.tests.refactoring/resources/Move/testDestination_no_methodToItself/out/A.java;1;0;2;1;0;0;0;2;0;1;2;841;0;0;1;0;0;2;2;841;0;1008;2;1;
/org.eclipse.pde.ui/src_Forms/org/eclipse/pde/internal/ui/neweditor/plugin/rows/ClassAttributeRow.java;3;2;8;1;4;3;4;4;172;1;4;4354;347;347;2;0;1;4;8;5286;1;5431;7;3;
/org.eclipse.ui.workbench/Eclipse UI/org/eclipse/ui/internal/IHelpContextIds.java;3;1;5;1;3;3;3;2;2;1;2;808;6;6;1;0;0;2;5;808;0;6338;5;3;
/org.eclipse.pde.core/src/org/eclipse/pde/internal/core/osgi/bundle/BundlePluginModelBase.java;2;1;4;1;2;2;2;2;116;1;2;4203;132;132;1;0;0;2;4;4203;0;5445;4;2;
/org.eclipse.core.resources.linux/src/org/eclipse/core/resources/refresh/linux/LinuxRefreshProvider.java;1;0;4;1;0;0;0;4;93;1;4;3695;98;98;1;0;0;4;4;3695;0;4851;4;1;
/org.eclipse.jdt.ui.tests.refactoring/resources/MoveInstanceMethod/canMove/test17/in/Shape.java;1;0;1;1;0;0;0;1;0;0;1;1570;0;0;1;0;0;1;1;1570;0;1570;1;1;
/org.eclipse.jdt.ui/ui/org/eclipse/jdt/internal/ui/javaeditor/JavaMarkerAnnotation.java;4;1;11;1;2;2;2;9;286;2;8;1218;446;446;2;1;0;9;11;3217;1;6340;10;4;
/org.eclipse.jdt.ui/ui/org/eclipse/jdt/internal/ui/text/correction/AssistContext.java;3;1;11;1;2;2;2;9;21;1;9;1034;60;60;1;0;0;9;11;1034;0;6340;11;3;
/org.eclipse.ui.workbench/Eclipse UI/org/eclipse/ui/internal/ActionDescriptor.java;5;1;8;2;2;2;2;6;21;2;5;830;73;73;2;1;0;6;8;4609;1;6338;7;5;
/org.eclipse.ua.tests/src/org/eclipse/ui/examples/cheatsheets/pattern/actions/FactoryCustomizeAction.java;1;0;1;1;1;1;1;0;0;0;0;6081;0;0;1;0;0;0;1;6081;0;6081;1;1;
/org.eclipse.core.runtime/src/org/eclipse/core/runtime/IExtensionDelta.java;4;2;7;1;3;2;3;4;52;1;4;3134;75;75;2;0;1;4;7;5117;1;6340;6;4;
/org.eclipse.jdt.ui/ui/org/eclipse/jdt/internal/ui/browsing/PackageViewerWrapper.java;1;0;2;1;1;1;1;1;6;0;1;556;8;8;1;0;0;1;2;556;0;6340;2;1;
/org.eclipse.jdt.core.tests.model/workspace/Converter15/src/test0021/X.java;1;0;1;1;0;0;0;1;0;0;1;4828;0;0;1;0;0;1;1;4828;0;4828;1;1;
/org.eclipse.ui.views/src/org/eclipse/ui/views/properties/IPropertySheetEntry.java;2;1;2;1;2;2;2;0;273;0;0;5506;277;277;1;0;0;0;2;5506;0;6338;2;2;
/org.eclipse.search/search/org/eclipse/search/internal/ui/ResourceToItemsMapper.java;1;0;1;1;1;1;1;0;2;0;0;6340;2;2;1;0;0;0;1;6340;0;6340;1;1;
/org.eclipse.pde.ui/src_Forms/org/eclipse/pde/internal/ui/neweditor/plugin/OSGiSection.java;3;7;11;2;11;4;11;0;232;0;0;5290;270;270;7;0;7;0;11;5290;7;5431;4;3;
/org.eclipse.jdt.ui/ui/org/eclipse/jdt/internal/ui/preferences/formatter/ControlStatementsTabPage.java;1;0;10;1;1;1;1;9;84;2;8;3103;179;179;2;1;0;9;10;3103;1;5207;9;1;
/org.eclipse.ui.workbench/Eclipse UI/org/eclipse/ui/internal/commands/old/SequenceMachine.java;1;0;4;1;0;0;0;4;6;2;3;1222;6;6;2;1;0;4;4;1321;1;1695;3;1;
/org.eclipse.jdt.ui.tests.refactoring/resources/IntroduceFactory/positive/names_FFF.java;1;0;2;1;0;0;0;2;0;1;2;2846;0;0;1;0;0;2;2;2846;0;2862;2;1;
/org.eclipse.ui.workbench/Eclipse UI/org/eclipse/ui/internal/csm/commands/CategoryDefinition.java;1;0;3;1;0;0;0;3;28;2;2;2532;28;28;2;1;0;3;3;2532;1;2562;2;1;
/org.eclipse.jdt.core.tests.model/workspace/Converter/src/test0534/A.java;1;0;1;1;0;0;0;1;0;0;1;3748;0;0;1;0;0;1;1;3748;0;3748;1;1;
/org.eclipse.team.core/src/org/eclipse/team/internal/core/subscribers/SyncInfoWorkingSetFilter.java;1;0;3;1;1;1;1;2;111;1;2;3550;113;113;1;0;0;2;3;3550;0;6336;3;1;
/org.eclipse.swt/Eclipse SWT PI/gtk/org/eclipse/swt/internal/accessibility/gtk/GtkAccessible.java;4;0;4;1;1;1;1;3;17;1;3;1214;21;21;1;0;0;3;4;1214;0;6352;4;4;
/org.eclipse.ui.cheatsheets/src/org/eclipse/ui/internal/cheatsheets/data/Content.java;2;0;3;1;1;1;1;2;17;1;2;4428;17;17;1;0;0;2;3;4428;0;5189;3;2;
/org.eclipse.update.ui.forms/Eclipse Forms/org/eclipse/ui/forms/widgets/Twistie.java;1;0;2;1;0;0;0;2;0;1;2;3138;0;0;1;0;0;2;2;3138;0;4157;2;1;
/org.eclipse.osgi/resolver/src/org/eclipse/core/internal/dependencies/SelectionVisitor.java;3;1;3;1;2;2;2;1;14;0;1;3013;22;22;1;0;0;1;3;3013;0;5226;3;3;
/org.eclipse.jdt.debug.tests/tests/org/eclipse/jdt/debug/tests/eval/TypeHierarchy_68_3.java;1;0;1;1;0;0;0;1;16;0;1;1274;16;16;1;0;0;1;1;1274;0;1274;1;1;
/org.eclipse.ui.workbench/Eclipse UI/org/eclipse/ui/internal/csm/commands/CommandService.java;1;0;2;1;0;0;0;2;0;1;2;2515;0;0;1;0;0;2;2;2515;0;2562;2;1;
/org.eclipse.jdt.core.tests.model/workspace/Converter/test0468/A.java;1;0;2;1;0;0;0;2;0;1;2;230;0;0;1;0;0;2;2;230;0;3714;2;1;
/org.eclipse.team.ui/src/org/eclipse/team/internal/ui/synchronize/RefreshCompleteDialog.java;2;2;9;2;3;2;3;6;297;1;6;3170;635;635;2;0;1;6;9;5362;1;5438;8;2;
/org.eclipse.jface.text.tests/src/org/eclipse/jface/text/tests/TextPresentationTest.java;2;1;4;1;3;3;3;1;56;0;1;5082;60;60;1;0;0;1;4;5082;0;6340;4;2;
/org.eclipse.ui.ide/src/org/eclipse/ui/views/navigator/SortViewAction.java;1;0;1;1;0;0;0;1;0;0;1;2208;0;0;1;0;0;1;1;2208;0;2208;1;1;
/org.eclipse.jdt.ui/core refactoring/org/eclipse/ltk/core/refactoring/TextChange.java;1;0;2;1;0;0;0;2;0;1;2;4624;0;0;1;0;0;2;2;4624;0;4864;2;1;
/org.eclipse.text/src/org/eclipse/jface/text/BadPartitioningException.java;2;1;4;1;3;3;3;1;20;0;1;1510;23;23;1;0;0;1;4;1510;0;6340;4;2;
/org.eclipse.core.runtime/src/org/eclipse/core/internal/runtime/AuthorizationHandler.java;2;1;3;1;3;3;3;0;3;0;0;5189;5;5;1;0;0;0;3;5189;0;5536;3;2;
/org.eclipse.jdt.core.tests.model/workspace/Formatter/test429/A_in.java;1;0;1;1;0;0;0;1;0;0;1;3478;0;0;1;0;0;1;1;3478;0;3478;1;1;
/org.eclipse.debug.ui/ui/org/eclipse/debug/ui/variables/ExternalToolVariable.java;1;0;4;1;0;0;0;4;148;0;1;316;148;148;4;3;0;4;4;316;3;316;1;1;
/org.eclipse.core.tests.runtime/src/org/eclipse/core/tests/runtime/jobs/PathRule.java;2;1;3;1;2;2;2;1;13;0;1;3235;19;19;1;0;0;1;3;3235;0;5613;3;2;
/org.eclipse.update.core/srcnew/org/eclipse/update/standalone/EnableCommand.java;1;0;4;1;0;0;0;4;2;1;4;671;3;3;1;0;0;4;4;671;0;825;4;1;
/org.eclipse.team.core/src/org/eclipse/team/core/subscribers/SubscriberSyncInfoCollector.java;2;0;7;2;2;1;2;5;384;1;5;3966;516;516;2;0;1;5;7;5358;1;5358;6;2;
/org.eclipse.jdt.ui.tests.refactoring/resources/ConvertAnonymousToNested/canConvert/A_test24_out.java;1;0;1;1;0;0;0;1;0;0;1;3195;0;0;1;0;0;1;1;3195;0;3195;1;1;
/org.eclipse.ui.workbench/Eclipse UI/org/eclipse/ui/help/DialogPageContextComputer.java;2;0;2;1;0;0;0;2;3;1;2;1;5;5;1;0;0;2;2;1;0;1223;2;2;
/org.eclipse.ui.workbench/Eclipse UI/org/eclipse/ui/internal/themes/ITheme.java;1;0;4;1;0;0;0;4;31;1;4;4235;34;34;1;0;0;4;4;4235;0;4428;4;1;
/org.eclipse.swt.opengl/common/org/eclipse/swt/opengl/ImageDataUtil.java;1;0;1;1;0;0;0;1;0;0;1;1175;0;0;1;0;0;1;1;1175;0;1175;1;1;
/org.eclipse.jdt.ui.tests.refactoring/resources/Copy/test_inner_type_yes_cu/out/C.java;1;0;1;1;0;0;0;1;0;0;1;1009;0;0;1;0;0;1;1;1009;0;1009;1;1;
/org.eclipse.jdt.core.tests.model/workspace/JavaSearch/src/f2/X.java;1;0;1;1;0;0;0;1;0;0;1;2581;0;0;1;0;0;1;1;2581;0;2581;1;1;
/org.eclipse.ui.tutorials.rcp.part1/src/org/eclipse/ui/tutorials/rcp/part1/RcpApplication.java;1;0;1;1;1;1;1;0;0;0;0;5118;0;0;1;0;0;0;1;5118;0;5118;1;1;
/org.eclipse.jdt.core.tests.model/src/org/eclipse/jdt/core/tests/model/SignatureTests.java;4;0;8;1;0;0;0;8;459;2;7;1447;689;689;2;1;0;8;8;5022;1;5061;7;4;
/org.eclipse.jdt.ui.examples.javafamily/src/org/eclipse/jdt/internal/ui/examples/jspeditor/JspEditor.java;1;0;5;1;0;0;0;5;22;1;5;1071;65;65;1;0;0;5;5;1071;0;3654;5;1;
/org.eclipse.osgi/defaultAdaptor/src/org/eclipse/osgi/framework/internal/defaultadaptor/DefaultBundleData.java;6;2;25;2;6;5;6;19;640;3;17;3013;1723;1723;3;2;1;19;25;4309;3;5507;22;6;
/org.eclipse.jdt.ui.tests.refactoring/resources/InlineMethodWorkspace/TestCases/nameconflict_in/TestSameLocal.java;1;0;1;1;0;0;0;1;2;0;1;845;2;2;1;0;0;1;1;845;0;845;1;1;
/org.eclipse.jdt.ui.tests.refactoring/resources/ExtractMethodWorkSpace/ExtractMethodTests/expression_out/B.java;1;0;2;1;0;0;0;2;0;1;2;1465;0;0;1;0;0;2;2;1465;0;1474;2;1;
/org.eclipse.jdt.core.tests.model/workspace/JavaSearch/src/net/sf/saxon/om/Navigator.java;1;0;1;1;1;1;1;0;0;0;0;5938;0;0;1;0;0;0;1;5938;0;5938;1;1;
/org.eclipse.jdt.core/compiler/org/eclipse/jdt/internal/compiler/ast/ExplicitConstructorCall.java;2;0;6;1;0;0;0;6;41;1;6;41;111;111;1;0;0;6;6;41;0;3560;6;2;
/org.eclipse.jface.text/src/org/eclipse/jface/text/contentassist/IContentAssistProcessor.java;2;2;4;1;3;2;3;1;16;0;1;4085;22;22;2;0;1;1;4;6353;1;6353;3;2;
/org.eclipse.jdt.core.tests.model/workspace/Completion/src/CompletionAfterSupercall1.java;1;0;1;1;0;0;0;1;0;0;1;3140;0;0;1;0;0;1;1;3140;0;3140;1;1;
/org.eclipse.ui.views/src/org/eclipse/ui/views/markers/internal/ImageFactory.java;2;0;3;1;0;0;0;3;2;1;3;755;2;2;1;0;0;3;3;755;0;2738;3;2;
/org.eclipse.core.tests.resources/src/org/eclipse/core/tests/resources/MarkerSetTest.java;1;0;3;1;3;1;3;0;276;0;0;5147;276;276;3;0;2;0;3;5147;2;5147;1;1;
/org.eclipse.jdt.ui/ui/org/eclipse/jdt/internal/ui/text/TextMessages.java;1;0;1;1;0;0;0;1;0;0;1;4469;0;0;1;0;0;1;1;4469;0;4469;1;1;
/org.eclipse.update.core/srcnew/org/eclipse/update/internal/operations/BatchInstallOperation.java;1;0;11;1;0;0;0;11;36;2;10;569;129;129;2;1;0;11;11;602;1;825;10;1;
/org.eclipse.team.webdav/src/org/eclipse/team/internal/webdav/ui/subscriber/WebDavParticipantViewerAdvisor.java;2;0;5;1;1;1;1;4;7;1;4;4588;10;10;1;0;0;4;5;4588;0;5358;5;2;
/org.eclipse.jdt.core.tests.model/workspace/Converter/test0386/A.java;1;0;1;1;0;0;0;1;0;0;1;3714;0;0;1;0;0;1;1;3714;0;3714;1;1;
/org.eclipse.jdt.ui.tests.refactoring/resources/ExtractConstant/nameGuessing/testGuessStringLiteral1.java;1;0;1;1;0;0;0;1;0;0;1;1191;0;0;1;0;0;1;1;1191;0;1191;1;1;
/org.eclipse.ant.core/src/org/eclipse/ant/core/AntCorePreferences.java;3;2;39;2;8;6;8;31;400;4;23;0;1579;1579;4;8;2;31;39;2662;10;6335;29;3;
/org.eclipse.webdav/src/interface/org/eclipse/webdav/IContextFactory.java;1;0;1;1;1;1;1;0;47;0;0;5151;47;47;1;0;0;0;1;5151;0;5151;1;1;
/org.eclipse.team.cvs.core/src/org/eclipse/team/internal/ccvs/core/util/SyncFileWriter.java;2;2;15;1;10;9;10;5;35;1;5;866;117;117;2;0;1;5;15;5617;1;6337;14;2;
/org.eclipse.jdt.core.tests.model/workspace/Converter/src/test0347/Test2.java;1;0;1;1;0;0;0;1;0;0;1;3714;0;0;1;0;0;1;1;3714;0;3714;1;1;
/org.eclipse.core.tests.runtime/src/org/eclipse/core/tests/internal/osgi/PlatformAdminTest.java;2;1;8;1;3;3;3;5;203;3;3;4238;289;289;3;2;0;5;8;4238;2;5339;6;2;
/org.eclipse.pde.ui/src/org/eclipse/pde/internal/ui/editor/site/ArchivePage.java;2;1;7;1;5;5;5;2;57;1;2;2311;106;106;1;0;0;2;7;2311;0;6336;7;2;
/org.eclipse.ui.workbench/Eclipse UI/org/eclipse/ui/internal/keys/AbstractKeyFormatter.java;1;0;2;1;0;0;0;2;1;1;2;3310;1;1;1;0;0;2;2;3310;0;3350;2;1;
/org.eclipse.jdt.ui.tests.refactoring/resources/DeleteSourceReference/test4/out/A.java;1;0;1;1;0;0;0;1;0;0;1;1652;0;0;1;0;0;1;1;1652;0;1652;1;1;
/org.eclipse.team.examples.filesystem/src/org/eclipse/team/examples/filesystem/FileSystemProviderType.java;1;0;1;1;1;1;1;0;0;0;0;5822;0;0;1;0;0;0;1;5822;0;5822;1;1;
/org.eclipse.pde.ui/src/org/eclipse/pde/internal/ui/wizards/templates/BaseEditorTemplate.java;3;1;6;1;3;3;3;3;15;1;3;2786;38;38;1;0;0;3;6;2786;0;6336;6;3;
/org.eclipse.debug.ui/ui/org/eclipse/debug/internal/ui/sourcelookup/browsers/FolderSourceContainerBrowser.java;2;0;6;1;0;0;0;6;7;1;6;3770;25;25;1;0;0;6;6;3770;0;4970;6;2;
/org.eclipse.jdt.ui.tests.refactoring/resources/InlineMethodWorkspace/TestCases/A.java;1;0;1;1;0;0;0;1;11;0;1;788;11;11;1;0;0;1;1;788;0;788;1;1;
/org.eclipse.update.core/src/org/eclipse/update/core/model/Import.java;1;0;1;1;0;0;0;1;0;0;1;2634;0;0;1;0;0;1;1;2634;0;2634;1;1;
/org.eclipse.ui.workbench/Eclipse UI/org/eclipse/ui/internal/activities/ICategoryActivityBindingDefinition.java;1;0;2;1;0;0;0;2;0;1;2;2896;0;0;1;0;0;2;2;2896;0;3066;2;1;
/org.eclipse.core.runtime/src/org/eclipse/core/runtime/preferences/IPreferenceInitializer.java;1;1;2;1;2;2;2;0;0;0;0;5333;0;0;1;0;0;0;2;5333;0;5360;2;1;
/org.eclipse.jdt.core.tests.model/workspace/Formatter/test357/A_in.java;1;0;1;1;0;0;0;1;0;0;1;3087;0;0;1;0;0;1;1;3087;0;3087;1;1;
/org.eclipse.debug.core/core/org/eclipse/debug/internal/core/OutputStreamMonitor.java;4;1;7;2;2;2;2;5;60;2;4;2066;113;113;2;1;0;5;7;2066;1;6336;6;4;
/org.eclipse.pde.ui/src_Forms/org/eclipse/pde/internal/ui/neweditor/plugin/BooleanAttributeRow.java;1;0;2;1;0;0;0;2;0;1;2;3834;0;0;1;0;0;2;2;3834;0;4354;2;1;
/org.eclipse.jdt.core.tests.model/workspace/Converter/test0294/Test.java;1;0;1;1;0;0;0;1;0;0;1;3714;0;0;1;0;0;1;1;3714;0;3714;1;1;
/org.eclipse.update.ui.win32/src/org/eclipse/welcome/internal/portal/IPortalSectionForm.java;1;0;1;1;0;0;0;1;0;0;1;925;0;0;1;0;0;1;1;925;0;925;1;1;
/org.eclipse.jdt.ui/ui refactoring/org/eclipse/jdt/internal/ui/refactoring/contentassist/TextContentAssistSubjectAdapter.java;2;0;2;1;0;0;0;2;0;1;2;3648;0;0;1;0;0;2;2;3648;0;3672;2;2;
/org.eclipse.update.ui/srcnew/org/eclipse/update/internal/ui/wizards/BaseNewWizardPage2.java;1;0;4;1;0;0;0;4;3;2;3;367;4;4;2;1;0;4;4;367;1;488;3;1;
/org.eclipse.jdt.ui/ui/org/eclipse/jdt/internal/ui/javaeditor/JavaMarkerAnnotation2.java;1;0;2;1;0;0;0;2;0;0;1;3217;0;0;2;1;0;2;2;3217;1;3217;1;1;
/org.eclipse.jface/src/org/eclipse/jface/action/ContributionManager.java;6;2;13;2;4;3;4;9;70;2;8;2830;193;193;2;1;1;9;13;4126;2;6338;11;6;
/org.eclipse.ui.ide/extensions/org/eclipse/ui/actions/CloseResourceAction.java;1;0;2;1;0;0;0;2;4;1;2;2263;4;4;1;0;0;2;2;2263;0;2611;2;1;
/org.eclipse.jdt.ui/core refactoring/org/eclipse/jdt/internal/corext/refactoring/changes/CopyPackageChange.java;2;1;4;1;2;2;2;2;8;1;2;3930;16;16;1;0;0;2;4;3930;0;6340;4;2;
/org.eclipse.team.cvs.ui/src/org/eclipse/team/internal/ccvs/ui/subscriber/WorkspaceCommitAction.java;2;1;3;1;3;3;3;0;44;0;0;5490;48;48;1;0;0;0;3;5490;0;6337;3;2;
/org.eclipse.update.ui/srcnew/org/eclipse/update/internal/ui/wizards/MultiReviewPage2.java;1;0;3;1;0;0;0;3;1;1;3;367;1;1;1;0;0;3;3;367;0;433;3;1;
/org.eclipse.swt/Eclipse SWT/gtk/org/eclipse/swt/widgets/Slider.java;6;1;10;1;2;2;2;8;30;1;8;269;110;110;1;0;0;8;10;269;0;6352;10;6;
/org.eclipse.jdt.core/search/org/eclipse/jdt/internal/core/index/impl/FileListBlock.java;3;0;5;1;0;0;0;5;38;1;5;488;44;44;1;0;0;5;5;488;0;4060;5;3;
/org.eclipse.jdt.ui/ui refactoring/org/eclipse/jdt/internal/ui/refactoring/nls/search/NLSSearchResultPage.java;2;1;4;1;3;3;3;1;45;0;1;4943;67;67;1;0;0;1;4;4943;0;5591;4;2;
/org.eclipse.jdt.ui/core refactoring/org/eclipse/ltk/core/refactoring/NullChange.java;1;0;4;1;0;0;0;4;16;1;4;4510;21;21;1;0;0;4;4;4510;0;4864;4;1;
/org.eclipse.jdt.core/model/org/eclipse/jdt/internal/core/jdom/DOMPackage.java;1;0;2;1;1;1;1;1;6;0;1;3560;8;8;1;0;0;1;2;3560;0;5584;2;1;
/org.eclipse.jdt.core.tests.builder/src/org/eclipse/jdt/core/tests/builder/MultiSourceFolderAndOutputFolderTests.java;3;0;5;1;1;1;1;4;22;1;4;989;37;37;1;0;0;4;5;989;0;6141;5;3;
/org.eclipse.ui.views/src/org/eclipse/ui/views/internal/markers/MarkerPropertiesDialog.java;1;0;3;1;0;0;0;3;24;2;2;265;24;24;2;1;0;3;3;265;1;749;2;1;
/org.eclipse.core.runtime.osgi/src/org/eclipse/core/internal/runtime/AuthorizationDatabase.java;1;0;2;1;0;0;0;2;518;1;2;3013;518;518;1;0;0;2;2;3013;0;3030;2;1;
/org.eclipse.jdt.ui/core refactoring/org/eclipse/jdt/internal/corext/refactoring/participants/OrExpression.java;1;0;2;1;0;0;0;2;0;1;2;882;0;0;1;0;0;2;2;882;0;1033;2;1;
/org.eclipse.ui.ide/src/org/eclipse/ui/IMarkerHelpRegistry.java;2;0;2;1;0;0;0;2;0;1;2;1511;0;0;1;0;0;2;2;1511;0;2263;2;2;
/org.eclipse.ltk.ui.refactoring/src/org/eclipse/ltk/internal/ui/refactoring/ChangeElementTreeViewer.java;1;0;2;1;1;1;1;1;2;0;1;4965;2;2;1;0;0;1;2;4965;0;6340;2;1;
/org.eclipse.jdt.ui/ui/org/eclipse/jdt/internal/ui/callhierarchy/CallHierarchyViewAdapter.java;2;0;3;1;0;0;0;3;2;1;3;186;2;2;1;0;0;3;3;186;0;2893;3;2;
/org.eclipse.jdt.ui/ui refactoring/org/eclipse/jdt/internal/ui/refactoring/RefactoringStatusDialog.java;1;0;2;1;0;0;0;2;2;1;2;4575;2;2;1;0;0;2;2;4575;0;4965;2;1;
/org.eclipse.jdt.ui.tests/ui/org/eclipse/jdt/ui/tests/quickfix/MarkerResolutionTest.java;2;1;12;1;4;4;4;8;17;1;8;1033;66;66;1;0;0;8;12;1033;0;6340;12;2;
/org.eclipse.core.tools/src/org/eclipse/core/tools/runtime/PluginDependencyGraphNode.java;1;0;1;1;1;1;1;0;0;0;0;6302;0;0;1;0;0;0;1;6302;0;6302;1;1;
/org.eclipse.jdt.ui/core refactoring/org/eclipse/jdt/internal/corext/refactoring/reorg/SourceRangeComputer.java;2;0;2;1;1;1;1;1;4;0;1;2131;6;6;1;0;0;1;2;2131;0;6340;2;2;
/org.eclipse.ui.workbench.texteditor/src/org/eclipse/ui/internal/texteditor/quickdiff/RevertLineAction.java;3;0;4;1;1;1;1;3;6;1;3;1644;15;15;1;0;0;3;4;1644;0;6340;4;3;
/org.eclipse.jdt.core.tests.model/workspace/Converter/test0507/A.java;1;0;2;1;0;0;0;2;0;1;2;3009;0;0;1;0;0;2;2;3009;0;3714;2;1;
/org.eclipse.releng.basebuilder/plugins/org.eclipse.build.tools/src/org/eclipse/releng/generators/AbstractApplication.java;1;0;1;1;0;0;0;1;10;0;1;3597;10;10;1;0;0;1;1;3597;0;3597;1;1;
/org.eclipse.jdt.ui.tests.refactoring/resources/UseSupertypeWherePossible/testNew14/out/Test.java;1;0;1;1;0;0;0;1;2;0;1;1166;2;2;1;0;0;1;1;1166;0;1166;1;1;
/org.eclipse.jdt.ui/ui/org/eclipse/jdt/internal/ui/preferences/TodoTaskPropertyPage.java;2;1;6;1;2;2;2;4;26;1;4;1332;50;50;1;0;0;4;6;1332;0;6340;6;2;
/org.eclipse.debug.ui/ui/org/eclipse/debug/internal/ui/sourcelookup/SourceContainerLookupPanel.java;2;0;11;1;0;0;0;11;86;2;10;3770;157;157;2;1;0;11;11;4949;1;4970;10;2;
/org.eclipse.ui.workbench/Eclipse UI/org/eclipse/ui/internal/presentations/SystemMenuCloseAllEditors.java;3;1;4;1;3;3;3;1;41;0;1;4680;43;43;1;0;0;1;4;4680;0;5522;4;3;
/org.eclipse.ui.workbench.texteditor/src/org/eclipse/ui/internal/texteditor/quickdiff/RevertBlockAction.java;3;0;4;1;1;1;1;3;6;1;3;1644;13;13;1;0;0;3;4;1644;0;6340;4;3;
/org.eclipse.jdt.core/search/org/eclipse/jdt/internal/core/search/indexing/IIndexConstants.java;2;0;6;1;0;0;0;6;23;1;6;1448;41;41;1;0;0;6;6;1448;0;4113;6;2;
/org.eclipse.ui.forms/src/org/eclipse/ui/forms/widgets/ScrolledRichText.java;1;0;3;1;0;0;0;3;4;2;2;4068;4;4;2;1;0;3;3;4147;1;4147;2;1;
/org.eclipse.jdt.core.tests.model/workspace/Converter/src/test0196/Test.java;1;0;1;1;0;0;0;1;0;0;1;3714;0;0;1;0;0;1;1;3714;0;3714;1;1;
/org.eclipse.team.ftp/src/org/eclipse/team/internal/ftp/deployment/FTPDeploymentProvider.java;1;0;1;1;0;0;0;1;0;0;1;3200;0;0;1;0;0;1;1;3200;0;3200;1;1;
/org.eclipse.jdt.ui.tests.refactoring/resources/ExtractInterface/test87/out/A.java;1;0;1;1;0;0;0;1;4;0;1;1166;4;4;1;0;0;1;1;1166;0;1166;1;1;
/org.eclipse.ui.views/src/org/eclipse/ui/views/tasklist/TaskListMessages.java;1;0;1;1;0;0;0;1;0;0;1;2738;0;0;1;0;0;1;1;2738;0;2738;1;1;
/org.eclipse.jdt.ui/core refactoring/org/eclipse/jdt/internal/corext/refactoring/tagging/IReferenceUpdatingRefactoring.java;1;0;1;1;0;0;0;1;0;0;1;1126;0;0;1;0;0;1;1;1126;0;1126;1;1;
/org.eclipse.team.ui/src/org/eclipse/team/internal/ui/IPreferenceIds.java;2;1;18;1;6;6;6;12;33;2;11;984;120;120;2;1;0;12;18;984;1;6337;17;2;
/org.eclipse.core.expressions/src/org/eclipse/core/expressions/ExpressionConverter.java;1;1;5;1;2;2;2;3;8;1;3;4108;17;17;1;0;0;3;5;4108;0;6340;5;1;
/org.eclipse.team.core/src/org/eclipse/team/internal/core/target/RemoteTargetSyncElement.java;1;0;2;1;0;0;0;2;2;1;2;866;2;2;1;0;0;2;2;866;0;2495;2;1;
/org.eclipse.update.core/srcnew/org/eclipse/update/search/BaseFilter.java;1;0;2;1;0;0;0;2;0;1;2;711;0;0;1;0;0;2;2;711;0;825;2;1;
/org.eclipse.jdt.ui/core extension/org/eclipse/jdt/internal/corext/userlibrary/UserLibraryClasspathContainerInitializer.java;1;1;4;1;2;2;2;2;8;1;2;4407;16;16;1;0;0;2;4;4407;0;5226;4;1;
/org.eclipse.ui.intro/src/org/eclipse/ui/internal/intro/impl/model/IntroURLCommand.java;1;2;3;1;3;2;3;0;2;0;0;5305;2;2;2;0;1;0;3;5314;1;5314;2;1;
/org.eclipse.ui.workbench/Eclipse UI/org/eclipse/ui/internal/commands/IMutableCommandManager.java;2;1;4;1;4;4;4;0;14;0;0;5231;27;27;1;0;0;0;4;5231;0;6338;4;2;
/org.eclipse.ui.workbench/Eclipse UI/org/eclipse/ui/internal/csm/activities/IActivityActivationService.java;1;0;2;1;0;0;0;2;0;1;2;2225;0;0;1;0;0;2;2;2225;0;2310;2;1;
/org.eclipse.pde.core/src/org/eclipse/pde/internal/core/schema/AbstractSchemaDescriptor.java;2;1;4;1;2;2;2;2;8;1;2;4203;16;16;1;0;0;2;4;4203;0;6336;4;2;
/org.eclipse.pde.build/src/org/eclipse/pde/internal/build/builder/ClasspathComputer.java;2;0;13;1;0;0;0;13;27;1;13;447;74;74;1;0;0;13;13;447;0;5036;13;2;
/org.eclipse.update.scheduler/src/org/eclipse/update/internal/scheduler/preferences/AutomaticUpdatesPreferencePage.java;3;2;15;1;4;3;4;11;85;4;6;978;335;335;4;5;1;11;15;995;6;6336;9;3;
/org.eclipse.ui.workbench/Eclipse UI/org/eclipse/ui/internal/commands/Util.java;1;0;4;1;0;0;0;4;40;1;4;767;40;40;1;0;0;4;4;767;0;1077;4;1;
/org.eclipse.ui.workbench/Eclipse UI/org/eclipse/ui/internal/contexts/ContextElement.java;1;0;2;1;0;0;0;2;0;1;2;1220;0;0;1;0;0;2;2;1220;0;1321;2;1;
/org.eclipse.jdt.ui/ui refactoring/org/eclipse/jdt/internal/ui/refactoring/UserInterfaceManager.java;1;0;5;1;0;0;0;5;15;1;5;4507;22;22;1;0;0;5;5;4507;0;5052;5;1;
/org.eclipse.jdt.core.tests.model/workspace/Converter/test0032/Test.java;1;0;1;1;0;0;0;1;0;0;1;3714;0;0;1;0;0;1;1;3714;0;3714;1;1;
/org.eclipse.jdt.ui.tests.refactoring/resources/ExtractMethodWorkSpace/ExtractMethodTests/locals_in/A_test528.java;1;0;2;1;0;0;0;2;5;1;2;130;7;7;1;0;0;2;2;130;0;844;2;1;
/org.eclipse.jdt.ui.examples.javafamily/src/org/eclipse/jface/text/source/translation/ITranslator.java;1;0;1;1;1;1;1;0;0;0;0;5122;0;0;1;0;0;0;1;5122;0;5122;1;1;
/org.eclipse.debug.ui/ui/org/eclipse/debug/internal/ui/sourcelookup/DownAction.java;1;0;1;1;0;0;0;1;0;0;1;3770;0;0;1;0;0;1;1;3770;0;3770;1;1;
/org.eclipse.jdt.core.tests.model/workspace/Converter/src/test0500/A.java;1;0;1;1;0;0;0;1;0;0;1;3714;0;0;1;0;0;1;1;3714;0;3714;1;1;
/org.eclipse.ui.workbench/Eclipse UI/org/eclipse/ui/internal/csm/activities/ActivityPatternBinding.java;1;0;4;1;0;0;0;4;24;2;3;2225;26;26;2;1;0;4;4;2225;1;2297;3;1;
/org.eclipse.core.resources/src/org/eclipse/core/internal/resources/DelayedSnapshotRunnable.java;1;0;2;1;0;0;0;2;2;1;2;1098;2;2;1;0;0;2;2;1098;0;1485;2;1;
/org.eclipse.jdt.core.tests.model/workspace/Formatter/test146/A_out.java;1;0;1;1;0;0;0;1;0;0;1;2425;0;0;1;0;0;1;1;2425;0;2425;1;1;
/org.eclipse.ui.workbench/Eclipse UI/org/eclipse/ui/internal/commands/ActiveKeyConfigurationDefinition.java;2;0;14;1;1;1;1;13;45;5;8;1389;144;144;5;5;0;13;14;1389;5;6338;9;2;
/org.eclipse.jdt.ui.tests.refactoring/resources/MoveMembers/test35/out/B.java;1;0;1;1;0;0;0;1;0;0;1;1856;0;0;1;0;0;1;1;1856;0;1856;1;1;
/org.eclipse.jdt.core.tests.model/workspace/Formatter/test091/A_out.java;1;0;1;1;0;0;0;1;0;0;1;2425;0;0;1;0;0;1;1;2425;0;2425;1;1;
/org.eclipse.search.tests/src/org/eclipse/search/tests/filesearch/AllFileSearchTests.java;1;1;7;1;5;5;5;2;5;1;2;4345;14;14;1;0;0;2;7;4345;0;6124;7;1;
/org.eclipse.team.webdav/src/org/eclipse/team/ui/subscriber/TeamSubscriberNonblockingContext.java;1;0;1;1;0;0;0;1;0;0;1;3373;0;0;1;0;0;1;1;3373;0;3373;1;1;
/org.eclipse.jdt.core/model/org/eclipse/jdt/internal/core/builder/ProblemFactory.java;1;0;1;1;0;0;0;1;2;0;1;3560;2;2;1;0;0;1;1;3560;0;3560;1;1;
/org.eclipse.jdt.debug/model/org/eclipse/jdt/internal/debug/core/breakpoints/JavaWatchpoint.java;5;0;7;1;1;1;1;6;54;1;6;363;79;79;1;0;0;6;7;363;0;6336;7;5;
/org.eclipse.update.ui/srcnew/org/eclipse/update/internal/ui/wizards/OptionalFeaturesPage2.java;2;0;2;1;0;0;0;2;0;1;2;367;0;0;1;0;0;2;2;367;0;478;2;2;
/org.eclipse.jdt.ui.tests.refactoring/resources/ExtractInterface/test99/out/C.java;1;0;1;1;0;0;0;1;0;0;1;3710;0;0;1;0;0;1;1;3710;0;3710;1;1;
/org.eclipse.jdt.core/model/org/eclipse/jdt/core/jdom/IDOMImport.java;3;1;6;1;3;3;3;3;31;1;3;3560;49;49;1;0;0;3;6;3560;0;5871;6;3;
/org.eclipse.swt/Eclipse SWT/carbon/org/eclipse/swt/graphics/Cursor.java;3;1;6;1;2;2;2;4;127;1;4;246;241;241;1;0;0;4;6;246;0;6352;6;3;
/org.eclipse.ui.ide/src/org/eclipse/ui/internal/ide/registry/IDERegistryReader.java;2;0;2;1;0;0;0;2;4;1;2;2264;4;4;1;0;0;2;2;2264;0;2804;2;2;
/org.eclipse.update.ui.win32/src/org/eclipse/welcome/internal/portal/WelcomePortalEditor.java;1;0;2;1;0;0;0;2;7;0;1;907;7;7;2;1;0;2;2;907;1;907;1;1;
/org.eclipse.jdt.debug.tests/tests/org/eclipse/jdt/debug/tests/core/JavaProjectSourceContainerTests.java;1;0;1;1;1;1;1;0;0;0;0;5920;0;0;1;0;0;0;1;5920;0;5920;1;1;
/org.eclipse.jface.text/projection/org/eclipse/jface/text/source/OutlinerRulerColumn.java;1;0;2;1;1;1;1;1;1;0;1;4516;1;1;1;0;0;1;2;4516;0;5177;2;1;
/org.eclipse.jdt.core/search/org/eclipse/jdt/internal/core/index/impl/Index.java;2;0;4;1;0;0;0;4;74;1;4;2095;84;84;1;0;0;4;4;2095;0;3384;4;2;
/org.eclipse.ui.workbench/Eclipse UI/org/eclipse/ui/internal/roles/api/secondstage/IContextBindingDefinition.java;1;0;2;1;0;0;0;2;0;1;2;2199;0;0;1;0;0;2;2;2199;0;2207;2;1;
/org.eclipse.jdt.core.tests.model/workspace/Converter/src/test0250/Test.java;1;0;1;1;0;0;0;1;0;0;1;3714;0;0;1;0;0;1;1;3714;0;3714;1;1;
/org.eclipse.text/src/org/eclipse/jface/text/IDocument.java;3;2;6;1;3;2;3;3;128;1;3;227;139;139;2;0;1;3;6;6339;1;6339;5;3;
/org.eclipse.jdt.ui/ui/org/eclipse/jdt/internal/ui/compare/JavaStructureCreator.java;3;1;9;1;3;3;3;6;25;1;6;1289;61;61;1;0;0;6;9;1289;0;6340;9;3;
/org.eclipse.update.ui/src/org/eclipse/update/internal/ui/model/PendingChange.java;1;0;1;1;0;0;0;1;0;0;1;756;0;0;1;0;0;1;1;756;0;756;1;1;
/org.eclipse.jdt.ui/ui/org/eclipse/jdt/internal/ui/text/java/hover/ProblemHover.java;1;0;1;1;1;1;1;0;0;0;0;5655;0;0;1;0;0;0;1;5655;0;5655;1;1;
/org.eclipse.jdt.ui/core refactoring/org/eclipse/jdt/internal/corext/refactoring/participants/xml/ExpressionStatus.java;1;0;4;1;0;0;0;4;70;1;4;2682;70;70;1;0;0;4;4;2682;0;4108;4;1;
/org.eclipse.jdt.core.tests.model/workspace/Formatter/test448/A_in.java;1;0;1;1;0;0;0;1;0;0;1;3611;0;0;1;0;0;1;1;3611;0;3611;1;1;
/org.eclipse.update.core/src/org/eclipse/update/internal/core/SiteReconciler.java;3;2;13;1;4;3;4;9;1878;2;8;890;3466;3466;2;1;1;9;13;3383;2;6336;11;3;
/org.eclipse.jdt.debug.ui/ui/org/eclipse/jdt/internal/debug/ui/JavaObjectBrowser.java;3;0;7;1;0;0;0;7;15;1;7;861;29;29;1;0;0;7;7;861;0;2647;7;3;
/org.eclipse.jdt.core.tests.model/src/org/eclipse/jdt/core/tests/rewrite/modifying/ASTRewritingModifyingTest.java;4;1;5;2;2;2;2;3;7;2;2;4711;24;24;2;1;0;3;5;4711;1;5853;4;4;
/org.eclipse.jdt.ui/ui/org/eclipse/jdt/internal/ui/preferences/formatter/ProfileStore.java;1;2;11;1;6;5;6;5;178;1;5;3554;432;432;2;0;1;5;11;5886;1;6163;10;1;
/org.eclipse.jdt.debug/jdi/org/eclipse/jdi/internal/AccessibleImpl.java;1;0;2;1;0;0;0;2;14;1;2;2223;16;16;1;0;0;2;2;2223;0;4267;2;1;
/org.eclipse.text/projection/org/eclipse/jface/text/projection/Segment.java;2;1;3;1;2;2;2;1;35;0;1;4516;37;37;1;0;0;1;3;4516;0;6340;3;2;
/org.eclipse.pde.ui/src/org/eclipse/pde/internal/ui/wizards/imports/BaseImportWizardSecondPage.java;2;1;18;1;3;3;3;15;114;2;14;655;386;386;2;1;0;15;18;863;1;6336;17;2;
/org.eclipse.jdt.core.tests.model/workspace/Formatter/test412/A_out.java;1;0;1;1;0;0;0;1;0;0;1;3460;0;0;1;0;0;1;1;3460;0;3460;1;1;
/org.eclipse.pde.core/src/org/eclipse/pde/internal/core/bundle/BundleObject.java;3;1;5;1;3;3;3;2;4;1;2;2184;10;10;1;0;0;2;5;2184;0;6336;5;3;
/org.eclipse.team.ui/src/org/eclipse/team/internal/ui/registry/SynchronizePartnerDescriptor.java;1;0;3;1;0;0;0;3;120;1;3;2493;120;120;1;0;0;3;3;2493;0;2747;3;1;
/org.eclipse.jdt.core.tests.model/workspace/Converter/test0244/Test.java;1;0;1;1;0;0;0;1;0;0;1;3714;0;0;1;0;0;1;1;3714;0;3714;1;1;
/org.eclipse.update.core/src/org/eclipse/update/operations/IToggleSiteOperation.java;1;0;7;1;1;1;1;6;13;2;5;825;22;22;2;1;0;6;7;825;1;5423;6;1;
/org.eclipse.jdt.ui/ui refactoring/org/eclipse/jdt/internal/ui/refactoring/MoveInnerToToplnputPage.java;1;0;1;1;0;0;0;1;0;0;1;518;0;0;1;0;0;1;1;518;0;518;1;1;
/org.eclipse.jdt.ui/ui/org/eclipse/jdt/ui/actions/OpenExternalJavadocAction.java;3;0;3;1;1;1;1;2;10;1;2;592;14;14;1;0;0;2;3;592;0;6340;3;3;
/org.eclipse.jdt.debug/model/org/eclipse/jdt/internal/debug/core/logicalstructures/JDIPlaceholderVariable.java;2;0;2;1;0;0;0;2;5;1;2;2647;5;5;1;0;0;2;2;2647;0;3133;2;2;
/org.eclipse.team.cvs.ui/src/org/eclipse/team/internal/ccvs/ui/actions/BranchAction.java;2;1;3;1;2;2;2;1;170;0;1;866;176;176;1;0;0;1;3;866;0;6337;3;2;
/org.eclipse.jdt.ui/ui/org/eclipse/jdt/internal/ui/wizards/dialogfields/SelectionButtonDialogFieldGroup.java;2;1;2;1;2;2;2;0;21;0;0;5247;23;23;1;0;0;0;2;5247;0;6340;2;2;
/org.eclipse.jdt.ui/ui/org/eclipse/jdt/internal/ui/wizards/buildpaths/JavadocPropertyDialog.java;1;0;2;1;1;1;1;1;0;0;1;4407;0;0;1;0;0;1;2;4407;0;5129;2;1;
/org.eclipse.pde.runtime/src/org/eclipse/pde/internal/runtime/PDERuntimePlugin.java;2;1;10;2;2;2;2;8;32;2;6;831;74;74;2;2;0;8;10;831;2;6336;8;2;
/org.eclipse.jface.text/src/org/eclipse/jface/contentassist/IContextInformationValidatorExtension.java;1;1;2;1;2;2;2;0;0;0;0;5181;0;0;1;0;0;0;2;5181;0;5199;2;1;
/org.eclipse.ui.workbench/Eclipse UI/org/eclipse/ui/internal/KeyBindingService.java;3;1;35;1;3;3;3;32;402;3;25;689;1588;1588;3;7;0;32;35;1220;7;6338;28;3;
/org.eclipse.ui.workbench/Eclipse UI/org/eclipse/ui/internal/commands/gestures/Direction.java;1;0;2;1;0;0;0;2;44;1;2;1264;44;44;1;0;0;2;2;1264;0;1277;2;1;
/org.eclipse.jdt.debug.ui/ui/org/eclipse/jdt/internal/debug/ui/actions/ManageBreakpointActionDelegate.java;3;0;7;1;0;0;0;7;85;2;6;1277;113;113;2;1;0;7;7;1915;1;4494;6;3;
/org.eclipse.team.cvs.core/src/org/eclipse/team/internal/ccvs/core/client/UpdatedHandler.java;2;0;5;1;1;1;1;4;29;1;4;790;59;59;1;0;0;4;5;790;0;6337;5;2;
/org.eclipse.jdt.ui/ui/org/eclipse/jdt/internal/ui/javaeditor/ClassFileEditorInputFactory.java;1;0;1;1;1;1;1;0;2;0;0;6340;2;2;1;0;0;0;1;6340;0;6340;1;1;
/org.eclipse.osgi/core/framework/org/eclipse/osgi/framework/eventmgr/EventManager.java;4;1;7;1;4;4;4;3;196;1;3;3013;435;435;1;0;0;3;7;3013;0;5688;7;4;
/org.eclipse.ui.workbench/Eclipse UI/org/eclipse/ui/internal/MaximizePartAction.java;4;0;5;1;1;1;1;4;21;1;4;808;53;53;1;0;0;4;5;808;0;6338;5;4;
/org.eclipse.core.tools.resources/src/org/eclipse/core/tools/metadata/SyncInfoDumpingStrategy_3.java;1;0;1;1;1;1;1;0;0;0;0;6302;0;0;1;0;0;0;1;6302;0;6302;1;1;
/org.eclipse.jdt.ui.tests.refactoring/resources/IntroduceFactory/positive/DontMoveArgs2.java;1;0;2;1;1;1;1;1;2;0;1;2846;2;2;1;0;0;1;2;2846;0;5659;2;1;
/org.eclipse.jdt.core/dom/org/eclipse/jdt/core/dom/StructuralPropertyDescriptor.java;2;0;2;1;1;1;1;1;6;0;1;4202;6;6;1;0;0;1;2;4202;0;5871;2;2;
/org.eclipse.jdt.core.tests.model/workspace/Converter/test0115/Test.java;1;0;1;1;0;0;0;1;0;0;1;3714;0;0;1;0;0;1;1;3714;0;3714;1;1;
/org.eclipse.jdt.core.tests.model/workspace/Formatter/test406/A_out.java;1;0;2;1;0;0;0;2;2;1;2;3438;4;4;1;0;0;2;2;3438;0;3475;2;1;
/org.eclipse.jdt.core.tests.model/workspace/Converter/test0459/A.java;1;0;1;1;0;0;0;1;0;0;1;3714;0;0;1;0;0;1;1;3714;0;3714;1;1;
/org.eclipse.jdt.core.tests.model/workspace/Converter/src/test0103/Test.java;1;0;1;1;0;0;0;1;0;0;1;3714;0;0;1;0;0;1;1;3714;0;3714;1;1;
/org.eclipse.ant.ui/Ant Editor/org/eclipse/ant/internal/ui/editor/text/IReconcilingParticipant.java;1;0;1;1;0;0;0;1;0;0;1;1811;0;0;1;0;0;1;1;1811;0;1811;1;1;
/org.eclipse.jdt.core.tests.model/workspace/Converter/src/junit/swingui/TestSuitePanel.java;1;0;1;1;0;0;0;1;0;0;1;3714;0;0;1;0;0;1;1;3714;0;3714;1;1;
/org.eclipse.jdt.ui/ui/org/eclipse/jdt/ui/actions/SurroundWithTryCatchAction.java;4;1;16;1;4;4;4;12;24;1;12;122;82;82;1;0;0;12;16;122;0;6340;16;4;
/org.eclipse.sdk.tests-feature/plugins/org.eclipse.perfmsr.ui/src/org/eclipse/perfmsr/ui/actions/GarbageCollect.java;2;1;3;1;2;2;2;1;12;0;1;4845;22;22;1;0;0;1;3;4845;0;6342;3;2;
/org.eclipse.debug.core/core/org/eclipse/debug/internal/core/sourcelookup/ISourceContainerTypeDelegate.java;1;0;2;1;0;0;0;2;0;1;2;3678;0;0;1;0;0;2;2;3678;0;4949;2;1;
/org.eclipse.ui.ide/src/org/eclipse/ui/internal/ide/misc/OverlayIcon.java;3;1;3;1;2;2;2;1;4;0;1;2264;6;6;1;0;0;1;3;2264;0;6338;3;3;
/org.eclipse.ui.views/src/org/eclipse/ui/views/internal/markers/MarkerViewConstants.java;1;0;2;1;0;0;0;2;0;1;2;265;0;0;1;0;0;2;2;265;0;749;2;1;
/org.eclipse.swt/Eclipse SWT/carbon/org/eclipse/swt/graphics/Font.java;3;1;8;1;5;5;5;3;41;1;3;1891;106;106;1;0;0;3;8;1891;0;6352;8;3;
/org.eclipse.core.expressions/src/org/eclipse/core/internal/expressions/AssertionFailedException.java;1;1;3;1;2;2;2;1;6;0;1;4108;8;8;1;0;0;1;3;4108;0;6340;3;1;
/org.eclipse.ui.workbench/Eclipse UI/org/eclipse/ui/internal/dialogs/ShowViewDialog.java;5;0;9;2;1;1;1;8;543;2;6;2737;968;968;2;2;0;8;9;3061;2;6338;7;5;
/org.eclipse.swt/Eclipse SWT/photon/org/eclipse/swt/widgets/ColorDialog.java;2;1;3;1;3;3;3;0;4;0;0;5606;10;10;1;0;0;0;3;5606;0;6352;3;2;
/org.eclipse.osgi/defaultAdaptor/src/org/eclipse/osgi/framework/internal/defaultadaptor/ReferenceInputStream.java;3;0;3;1;0;0;0;3;12;1;3;3013;12;12;1;0;0;3;3;3013;0;4336;3;3;
/org.eclipse.core.tests.resources/src/org/eclipse/core/tests/internal/alias/BasicAliasTest.java;1;0;3;1;3;1;3;0;90;0;0;5147;90;90;3;0;2;0;3;5147;2;5147;1;1;
/org.eclipse.ui.workbench/Eclipse UI/org/eclipse/ui/contexts/IWorkbenchPartSiteContextSupport.java;2;0;5;1;0;0;0;5;20;1;5;3066;41;41;1;0;0;5;5;3066;0;4144;5;2;
/org.eclipse.ant.ui/Ant Editor/org/eclipse/ant/internal/ui/dtd/IAtom.java;1;0;1;1;0;0;0;1;0;0;1;1811;0;0;1;0;0;1;1;1811;0;1811;1;1;
/org.eclipse.sdk.tests-feature/plugins/org.eclipse.perfmsr.ui.client/src/org/eclipse/perfmsr/ui/client/RefreshSnapshotsAction.java;1;1;3;1;3;3;3;0;10;0;0;5443;14;14;1;0;0;0;3;5443;0;5537;3;1;
/org.eclipse.pde.runtime/src/org/eclipse/pde/internal/runtime/registry/ShowPluginsMenu.java;1;0;3;1;0;0;0;3;2;1;3;4035;2;2;1;0;0;3;3;4035;0;4113;3;1;
/org.eclipse.jdt.core.tests.model/workspace/Converter/src/test0127/Test.java;1;0;1;1;0;0;0;1;0;0;1;3714;0;0;1;0;0;1;1;3714;0;3714;1;1;
/org.eclipse.team.ui/src/org/eclipse/team/internal/ui/DetailsDialog.java;1;0;2;1;0;0;0;2;31;1;2;790;31;31;1;0;0;2;2;790;0;993;2;1;
/org.eclipse.jface.text/projection/org/eclipse/jface/text/source/projection/SourceViewerInformationControl.java;2;1;5;1;4;4;4;1;12;0;1;4866;23;23;1;0;0;1;5;4866;0;6362;5;2;
/org.eclipse.search/search/org/eclipse/search/internal/ui/text/FileLabelProvider.java;2;1;9;1;5;5;5;4;128;1;4;3458;193;193;1;0;0;4;9;3458;0;6340;9;2;
/org.eclipse.ui.workbench/Eclipse UI/org/eclipse/example/ExampleExceptionHandler.java;1;0;1;1;0;0;0;1;0;0;1;1334;0;0;1;0;0;1;1;1334;0;1334;1;1;
/org.eclipse.jdt.core.tests.model/workspace/Converter/src/test0516/A.java;1;0;2;1;0;0;0;2;6;1;2;3714;6;6;1;0;0;2;2;3714;0;3886;2;1;
/org.eclipse.jdt.core/dom/org/eclipse/jdt/core/dom/IExtendedModifier.java;1;0;2;1;1;1;1;1;6;0;1;4495;6;6;1;0;0;1;2;4495;0;5268;2;1;
/org.eclipse.swt/Eclipse SWT/win32/org/eclipse/swt/graphics/FontMetrics.java;1;1;2;1;2;2;2;0;4;0;0;5597;7;7;1;0;0;0;2;5597;0;6352;2;1;
/org.eclipse.ui.workbench/Eclipse UI/org/eclipse/ui/commands/ICategoryDefinition.java;1;0;4;1;0;0;0;4;2;2;3;1389;2;2;2;1;0;4;4;1417;1;1417;3;1;
/org.eclipse.pde.core/srcnew/org/eclipse/pde/internal/core/plugin/XEEntityManager.java;1;0;1;1;0;0;0;1;0;0;1;2906;0;0;1;0;0;1;1;2906;0;2906;1;1;
/org.eclipse.ui.workbench/Eclipse UI/org/eclipse/ui/internal/csm/commands/ICommandRegistryEvent.java;1;0;2;1;0;0;0;2;0;1;2;2515;0;0;1;0;0;2;2;2515;0;2562;2;1;
/org.eclipse.swt/Eclipse SWT Custom Widgets/common/org/eclipse/swt/custom/CTabFolderCloseAdapter.java;1;0;3;1;0;0;0;3;20;1;3;2641;20;20;1;0;0;3;3;2641;0;4232;3;1;
/org.eclipse.jdt.ui.tests.refactoring/resources/ExtractMethodWorkSpace/ExtractMethodTests/locals_in/A_test543.java;1;0;1;1;0;0;0;1;2;0;1;844;2;2;1;0;0;1;1;844;0;844;1;1;
/org.eclipse.jdt.core.tests.model/workspace/Converter/test0479/A.java;1;0;2;1;0;0;0;2;0;1;2;1289;0;0;1;0;0;2;2;1289;0;3714;2;1;
/org.eclipse.ui.workbench/Eclipse UI/org/eclipse/ui/internal/dialogs/WizardContentProvider.java;4;0;9;2;1;1;1;8;38;2;6;3061;132;132;2;2;0;8;9;3061;2;6338;7;4;
/org.eclipse.core.resources/src/org/eclipse/core/internal/events/ResourceChangeEvent.java;1;0;2;1;2;1;2;0;132;0;0;5146;132;132;2;0;1;0;2;5146;1;5146;1;1;
/org.eclipse.jdt.ui.tests.refactoring/resources/ExtractInterface/test99/in/B.java;1;0;1;1;0;0;0;1;0;0;1;3710;0;0;1;0;0;1;1;3710;0;3710;1;1;
/org.eclipse.jdt.ui/core refactoring/org/eclipse/ltk/refactoring/core/IValidationStateListener.java;1;0;3;1;0;0;0;3;2;1;3;3708;2;2;1;0;0;3;3;3708;0;4510;3;1;
/org.eclipse.text.tests/src/org/eclipse/text/tests/link/LinkedModeModelTest.java;2;1;2;1;2;2;2;0;2;0;0;5128;2;2;1;0;0;0;2;5128;0;6340;2;2;
/org.eclipse.team.ui/src/org/eclipse/team/internal/ui/wizards/GlobalRefreshResourceSelectionPage.java;1;0;2;1;0;0;0;2;0;1;2;4449;0;0;1;0;0;2;2;4449;0;4518;2;1;
/org.eclipse.jdt.ui/ui/org/eclipse/jdt/internal/ui/wizards/buildpaths/CPListElement.java;2;0;8;1;1;1;1;7;50;1;7;1146;123;123;1;0;0;7;8;1146;0;6340;8;2;
/org.eclipse.ui.views/src/org/eclipse/ui/views/framelist/Frame.java;1;0;1;1;0;0;0;1;0;0;1;2738;0;0;1;0;0;1;1;2738;0;2738;1;1;
/org.eclipse.help/src/org/eclipse/help/standalone/Help.java;1;0;1;1;0;0;0;1;0;0;1;2732;0;0;1;0;0;1;1;2732;0;2732;1;1;
/org.eclipse.jdt.debug.ui/ui/org/eclipse/jdt/internal/debug/ui/launcher/IEntriesChangedListener.java;1;0;1;1;0;0;0;1;2;0;1;2691;2;2;1;0;0;1;1;2691;0;2691;1;1;
/org.eclipse.ui.ide/src/org/eclipse/ui/internal/misc/CheckboxTreeAndListGroup.java;2;0;2;1;0;0;0;2;0;1;2;1526;0;0;1;0;0;2;2;1526;0;2263;2;2;
/org.eclipse.jdt.ui.tests.refactoring/resources/IntroduceFactory/Bugzilla/48504/p1/B.java;1;1;2;1;2;2;2;0;2;0;0;5629;2;2;1;0;0;0;2;5629;0;5659;2;1;
/org.eclipse.pde.core/src/org/eclipse/pde/internal/core/ifeature/IFeatureInfo.java;2;1;3;1;2;2;2;1;4;0;1;4203;10;10;1;0;0;1;3;4203;0;6336;3;2;
/org.eclipse.jdt.core.tests.model/workspace/Formatter/test074/A_in.java;1;0;1;1;0;0;0;1;0;0;1;2425;0;0;1;0;0;1;1;2425;0;2425;1;1;
/org.eclipse.ui.workbench/Eclipse UI/org/eclipse/ui/internal/misc/ExternalEditor.java;2;0;3;1;1;1;1;2;19;1;2;2737;40;40;1;0;0;2;3;2737;0;6338;3;2;
/org.eclipse.jdt.core.tests.model/workspace/Converter/test0163/Test.java;1;0;1;1;0;0;0;1;0;0;1;3714;0;0;1;0;0;1;1;3714;0;3714;1;1;
/org.eclipse.jdt.ui.tests.refactoring/resources/ExtractMethodWorkSpace/ExtractMethodTests/return_in/A_test715.java;1;0;1;1;0;0;0;1;4;0;1;844;4;4;1;0;0;1;1;844;0;844;1;1;
/org.eclipse.ui.tests/Eclipse UI Tests/org/eclipse/ui/tests/activities/ActivitiesTestSuite.java;2;0;2;1;1;1;1;1;2;0;1;4853;2;2;1;0;0;1;2;4853;0;6338;2;2;
/org.eclipse.jdt.ui.tests.refactoring/resources/InlineMethodWorkspace/TestCases/controlStatement_out/TestForEmpty.java;2;0;2;1;0;0;0;2;3;1;2;845;5;5;1;0;0;2;2;845;0;1810;2;2;
/org.eclipse.team.ui/src/org/eclipse/team/internal/ui/jobs/RefreshUserNotificationPolicy.java;1;0;5;1;0;0;0;5;116;1;5;3402;244;244;1;0;0;5;5;3402;0;4518;5;1;
/org.eclipse.jdt.core/dom/org/eclipse/jdt/core/dom/SwitchCase.java;3;1;8;1;2;2;2;6;79;1;6;3560;111;111;1;0;0;6;8;3560;0;5272;8;3;
/org.eclipse.update.ui.forms/Eclipse Forms/org/eclipse/ui/forms/internal/widgets/WidgetTest.java;1;0;8;1;0;0;0;8;153;2;6;3138;336;336;2;2;0;8;8;3151;2;4157;6;1;
/org.eclipse.swt.tests/JUnit Tests/org/eclipse/swt/tests/junit/Test_org_eclipse_swt_custom_TableTree.java;2;0;6;1;1;1;1;5;171;1;5;2104;325;325;1;0;0;5;6;2104;0;6352;6;2;
/org.eclipse.update/src/org/eclipse/update/internal/ui/UMWizardProductComponentRevert.java;1;0;1;1;1;1;1;0;0;0;0;6339;0;0;1;0;0;0;1;6339;0;6339;1;1;
/org.eclipse.team.ui/src/org/eclipse/team/ui/synchronize/viewers/HierarchicalModelProvider.java;1;0;4;1;0;0;0;4;570;2;3;4213;1040;1040;2;1;0;4;4;4213;1;4449;3;1;
/org.eclipse.jdt.ui/ui/org/eclipse/jdt/internal/ui/reorg/NewNameQueries.java;1;0;4;1;0;0;0;4;27;2;3;818;47;47;2;1;0;4;4;1111;1;1111;3;1;
/org.eclipse.pde.ui/src/org/eclipse/pde/internal/ui/preferences/SourcePreferencePage.java;2;1;10;1;3;3;3;7;103;1;7;368;272;272;1;0;0;7;10;368;0;6336;10;2;
/org.eclipse.ui.externaltools/Ant Editor/org/eclipse/ui/externaltools/internal/ant/dtd/IModel.java;1;0;1;1;0;0;0;1;0;0;1;282;0;0;1;0;0;1;1;282;0;282;1;1;
/org.eclipse.jdt.ui.tests/ui/org/eclipse/jdt/ui/tests/astrewrite/ASTRewritingTrackingTest.java;2;0;17;1;1;1;1;16;246;2;15;991;865;865;2;1;0;16;17;1946;1;5406;16;2;
/org.eclipse.team.cvs.core/src/org/eclipse/team/internal/ccvs/core/CVSTeamProviderType.java;2;0;2;1;1;1;1;1;8;0;1;4969;10;10;1;0;0;1;2;4969;0;6337;2;2;
/org.eclipse.ant.ui/Ant Editor/org/eclipse/ant/internal/ui/editor/ResolveBuildfileAction.java;1;0;3;1;0;0;0;3;6;2;2;3807;6;6;2;1;0;3;3;3807;1;3835;2;1;
/org.eclipse.ui.workbench/Eclipse UI/org/eclipse/ui/internal/commands/api/older/IKeyBinding.java;1;0;2;1;0;0;0;2;0;0;1;2562;0;0;2;1;0;2;2;2562;1;2562;1;1;
/org.eclipse.ui.workbench.texteditor/src/org/eclipse/ui/internal/texteditor/quickdiff/DiffInitializer.java;2;0;3;1;0;0;0;3;1;1;3;1644;1;1;1;0;0;3;3;1644;0;2308;3;2;
/org.eclipse.pde.ui/src/org/eclipse/pde/internal/ui/editor/feature/FeatureSourcePage.java;1;1;4;1;2;2;2;2;27;1;2;909;58;58;1;0;0;2;4;909;0;6336;4;1;
/org.eclipse.jdt.ui/ui/org/eclipse/jdt/ui/actions/FindStringsToExternalizeAction.java;5;2;11;2;4;3;4;7;25;1;7;592;57;57;2;0;1;7;11;6334;1;6334;10;5;
/org.eclipse.jdt.core.tests.model/workspace/Formatter/test006/A_out.java;1;0;1;1;0;0;0;1;0;0;1;2425;0;0;1;0;0;1;1;2425;0;2425;1;1;
/org.eclipse.jdt.core.tests.model/workspace/Formatter/test417/A_out.java;1;0;1;1;0;0;0;1;0;0;1;3461;0;0;1;0;0;1;1;3461;0;3461;1;1;
/org.eclipse.update.ui.forms/src/org/eclipse/ui/forms/FormsResources.java;1;0;2;1;0;0;0;2;0;1;2;3051;0;0;1;0;0;2;2;3051;0;3096;2;1;
/org.eclipse.jdt.ui.tests.refactoring/test cases/org/eclipse/jdt/ui/tests/reorg/MoveTest.java;4;1;19;2;3;3;3;16;605;2;13;802;1587;1587;2;3;0;16;19;841;3;6340;16;4;
/org.eclipse.team.ui/src/org/eclipse/team/ui/synchronize/SyncInfoSetCollector.java;1;0;1;1;0;0;0;1;0;0;1;3530;0;0;1;0;0;1;1;3530;0;3530;1;1;
/org.eclipse.ui.editors/src/org/eclipse/ui/texteditor/MarkerUtilities.java;2;1;7;1;2;2;2;5;256;1;5;1983;436;436;1;0;0;5;7;1983;0;6337;7;2;
/org.eclipse.jface.text/src/org/eclipse/jface/text/templates/ContextTypeRegistry.java;3;1;8;1;4;4;4;4;178;2;3;4258;411;411;2;1;0;4;8;4258;1;6353;7;3;
/org.eclipse.releng.tools/src/org/eclipse/releng/tools/BlockComment.java;1;1;3;1;3;3;3;0;6;0;0;5183;10;10;1;0;0;0;3;5183;0;6340;3;1;
/org.eclipse.jdt.core/dom/org/eclipse/jdt/core/internal/dom/rewrite/TrackedNodePosition.java;1;0;2;1;0;0;0;2;0;1;2;4711;0;0;1;0;0;2;2;4711;0;4802;2;1;
/org.eclipse.jdt.debug.ui/ui/org/eclipse/jdt/internal/debug/ui/launcher/VMConnectTimeoutStatusHandler.java;1;0;1;1;0;0;0;1;6;0;1;2497;6;6;1;0;0;1;1;2497;0;2497;1;1;
/org.eclipse.debug.ui/ui/org/eclipse/debug/ui/launchVariables/IContextVariableComponentManager.java;1;0;2;1;0;0;0;2;0;0;1;562;0;0;2;1;0;2;2;562;1;562;1;1;
/org.eclipse.jdt.ui.tests.refactoring/resources/ExtractTemp/canExtract/A_test66_out.java;1;0;1;1;0;0;0;1;2;0;1;87;2;2;1;0;0;1;1;87;0;87;1;1;
/org.eclipse.jdt.ui.tests.refactoring/resources/IntroduceFactory/Bugzilla/59280/ExplicitSuperCtorCall_out.java;1;0;2;1;2;1;2;0;2;0;0;5656;2;2;2;0;1;0;2;5656;1;5656;1;1;
/org.eclipse.ui.workbench/Eclipse UI/org/eclipse/ui/keys/KeyFormatterFactory.java;3;1;6;1;2;2;2;4;78;2;3;3236;128;128;2;1;0;4;6;3350;1;6338;5;3;
/org.eclipse.jdt.ui.tests.refactoring/resources/ChangeTypeRefactoring/positive/A_testParameterNameWithOverride_out.java;1;0;1;1;0;0;0;1;0;0;1;2844;0;0;1;0;0;1;1;2844;0;2844;1;1;
/org.eclipse.jdt.ui/core refactoring/org/eclipse/jdt/internal/corext/refactoring/participants/xml/TypeExtensionManager.java;1;0;2;1;0;0;0;2;0;1;2;4091;0;0;1;0;0;2;2;4091;0;4108;2;1;
/org.eclipse.jdt.core.tests.model/workspace/Formatter/test413/A_in.java;1;0;1;1;0;0;0;1;0;0;1;3460;0;0;1;0;0;1;1;3460;0;3460;1;1;
/org.eclipse.jdt.ui/core refactoring/org/eclipse/jdt/internal/corext/refactoring/changes/CopyPackageFragmentRootChange.java;2;1;4;1;2;2;2;2;12;1;2;3930;23;23;1;0;0;2;4;3930;0;6340;4;2;
/org.eclipse.team.webdav/src/org/eclipse/team/core/target/TargetSynchronizer.java;1;0;1;1;0;0;0;1;0;0;1;3379;0;0;1;0;0;1;1;3379;0;3379;1;1;
/org.eclipse.ui.ide/src/org/eclipse/ui/internal/ide/DefaultContributorResourceAdapter.java;1;0;1;1;0;0;0;1;0;0;1;2614;0;0;1;0;0;1;1;2614;0;2614;1;1;
/org.eclipse.update.ui/src/org/eclipse/update/internal/ui/parts/AbstractOverlayIcon.java;1;0;1;1;0;0;0;1;7;0;1;890;7;7;1;0;0;1;1;890;0;890;1;1;
/org.eclipse.team.core/src/org/eclipse/team/core/wvcm/WVCMProvider.java;1;0;1;1;0;0;0;1;0;0;1;3049;0;0;1;0;0;1;1;3049;0;3049;1;1;
/org.eclipse.ui.workbench.texteditor/src/org/eclipse/ui/texteditor/IElementStateListener.java;2;0;2;2;2;1;2;0;13;0;0;6334;13;13;2;0;1;0;2;6334;1;6334;1;2;
/org.eclipse.jdt.debug.ui/ui/org/eclipse/jdt/internal/debug/ui/classpath/BootpathFilter.java;1;0;1;1;0;0;0;1;0;0;1;4332;0;0;1;0;0;1;1;4332;0;4332;1;1;
/org.eclipse.team.webdav/src/org/eclipse/team/internal/ui/target/RemoteResourceElement.java;2;0;3;1;1;1;1;2;9;1;2;2495;11;11;1;0;0;2;3;2495;0;6337;3;2;
/org.eclipse.core.resources/src_ant/org/eclipse/core/resources/ant/ConvertPath.java;2;1;4;1;3;3;3;1;229;0;1;5082;274;274;1;0;0;1;4;5082;0;5894;4;2;
/org.eclipse.ui.workbench/Eclipse UI/org/eclipse/ui/internal/presentations/SystemMenuClose.java;2;1;3;1;2;2;2;1;60;0;1;4680;62;62;1;0;0;1;3;4680;0;5522;3;2;
/org.eclipse.debug.ui/ui/org/eclipse/debug/internal/ui/views/console/ConsoleLineNotifier.java;2;0;6;1;0;0;0;6;47;1;6;1842;124;124;1;0;0;6;6;1842;0;2149;6;2;
/org.eclipse.team.ui/src/org/eclipse/team/internal/ui/sync/SyncCompareInput.java;2;0;3;1;0;0;0;3;2;1;3;790;4;4;1;0;0;3;3;790;0;4216;3;2;
/org.eclipse.jface.text/src/org/eclipse/jface/internal/text/link/contentassist/IProposalListener.java;2;0;2;1;1;1;1;1;2;0;1;4482;2;2;1;0;0;1;2;4482;0;6340;2;2;
/org.eclipse.ui.workbench/Eclipse UI/org/eclipse/ui/internal/contexts/AbstractContextManager.java;1;0;1;1;0;0;0;1;0;0;1;3066;0;0;1;0;0;1;1;3066;0;3066;1;1;
/org.eclipse.jdt.debug.ui/ui/org/eclipse/jdt/internal/debug/ui/monitors/MonitorQuitAction.java;2;0;3;1;0;0;0;3;41;2;2;1844;51;51;2;1;0;3;3;4480;1;4480;2;2;
/org.eclipse.debug.ui/ui/org/eclipse/debug/ui/launchVariables/ResourceComponent.java;1;0;2;1;0;0;0;2;0;1;2;550;0;0;1;0;0;2;2;550;0;562;2;1;
/org.eclipse.jdt.ui.tests.refactoring/resources/ChangeSignature/canModify/A_testImport06_in.java;1;0;1;1;0;0;0;1;0;0;1;3940;0;0;1;0;0;1;1;3940;0;3940;1;1;
/org.eclipse.jdt.core.tests.model/workspace/Converter/test0309/Test.java;1;0;1;1;0;0;0;1;0;0;1;3714;0;0;1;0;0;1;1;3714;0;3714;1;1;
/org.eclipse.jdt.ui.tests.refactoring/resources/ExtractMethodWorkSpace/ExtractMethodTests/locals_in/A_test515.java;1;0;1;1;0;0;0;1;2;0;1;844;2;2;1;0;0;1;1;844;0;844;1;1;
/org.eclipse.team.ui/src/org/eclipse/team/internal/ui/target/TargetSiteExportWizard.java;2;0;3;1;0;0;0;3;6;1;3;917;8;8;1;0;0;3;3;917;0;2495;3;2;
/org.eclipse.jdt.ui.tests.refactoring/resources/IntroduceFactory/positive/differentArgs2.java;1;0;2;1;0;0;0;2;0;1;2;2846;0;0;1;0;0;2;2;2846;0;2862;2;1;
/org.eclipse.jdt.ui.tests.refactoring/resources/IntroduceFactory/positive/CtorThrows_in.java;1;0;2;1;1;1;1;1;2;0;1;2846;2;2;1;0;0;1;2;2846;0;5659;2;1;
/org.eclipse.jdt.ui/ui/org/eclipse/jdt/internal/ui/wizards/buildpaths/ProjectsWorkbookPage.java;2;1;2;1;2;2;2;0;2;0;0;5833;4;4;1;0;0;0;2;5833;0;6340;2;2;
/org.eclipse.ant.ui/Ant Editor/org/eclipse/ant/ui/internal/dtd/IAtom.java;1;0;2;1;0;0;0;2;0;1;2;250;0;0;1;0;0;2;2;250;0;1811;2;1;
/org.eclipse.jdt.ui/core refactoring/org/eclipse/jdt/internal/corext/refactoring/structure/ReferenceAnalyzer.java;3;1;8;1;4;4;4;4;60;1;4;1522;98;98;1;0;0;4;8;1522;0;6340;8;3;
/org.eclipse.core.runtime/src/org/eclipse/core/runtime/jobs/ProgressProvider.java;3;0;9;1;1;1;1;8;92;1;8;2781;266;266;1;0;0;8;9;2781;0;5150;9;3;
/org.eclipse.ui.workbench/Eclipse UI/org/eclipse/ui/commands/registry/ICommandDefinition.java;1;0;3;1;0;0;0;3;2;2;2;1400;2;2;2;1;0;3;3;1400;1;1417;2;1;
/org.eclipse.jdt.core.tests.model/workspace/Converter/test0311/Test.java;1;0;1;1;0;0;0;1;0;0;1;3714;0;0;1;0;0;1;1;3714;0;3714;1;1;
/org.eclipse.ui.editors/src/org/eclipse/ui/texteditor/SelectRulerAction.java;1;0;1;1;1;1;1;0;6;0;0;6337;6;6;1;0;0;0;1;6337;0;6337;1;1;
/org.eclipse.jdt.debug.tests/tests/org/eclipse/jdt/debug/tests/eval/TypeHierarchy_32_2.java;1;0;1;1;0;0;0;1;6;0;1;1274;6;6;1;0;0;1;1;1274;0;1274;1;1;
/org.eclipse.swt/Eclipse SWT PI/gtk/org/eclipse/swt/internal/gtk/GtkAllocation.java;3;0;3;1;1;1;1;2;17;1;2;1653;21;21;1;0;0;2;3;1653;0;6352;3;3;
/org.eclipse.debug.core/core/org/eclipse/debug/internal/core/variables/ResourceExpander.java;3;0;4;1;0;0;0;4;6;1;4;737;10;10;1;0;0;4;4;737;0;2120;4;3;
/org.eclipse.ui.workbench/Eclipse UI/org/eclipse/ui/commands/Key.java;1;0;3;1;0;0;0;3;38;2;2;1321;38;38;2;1;0;3;3;1339;1;1339;2;1;
/org.eclipse.jdt.debug.ui/ui/org/eclipse/jdt/internal/debug/ui/console/JavaExceptionHyperLink.java;2;0;4;1;1;1;1;3;48;1;3;2306;54;54;1;0;0;3;4;2306;0;6336;4;2;
/org.eclipse.ui.workbench/Eclipse UI/org/eclipse/ui/part/intro/IntroPart.java;1;0;5;1;1;1;1;4;38;1;4;3632;47;47;1;0;0;4;5;3632;0;5187;5;1;
/org.eclipse.ui.workbench/Eclipse UI/org/eclipse/ui/keys/IKeyMachine.java;1;0;2;1;0;0;0;2;0;1;2;1294;0;0;1;0;0;2;2;1294;0;1321;2;1;
/org.eclipse.update.ui/src/org/eclipse/update/internal/ui/pages/SearchPage.java;1;0;1;1;0;0;0;1;0;0;1;755;0;0;1;0;0;1;1;755;0;755;1;1;
/org.eclipse.jdt.ui.tests.refactoring/resources/Move/testDestination_yes_methodToOtherType/out/A.java;1;0;2;1;0;0;0;2;1;0;1;1008;1;1;2;1;0;2;2;1008;1;1008;1;1;
/org.eclipse.jdt.core.tests.model/workspace/Formatter/test268/A_out.java;1;0;2;1;0;0;0;2;4;1;2;2442;4;4;1;0;0;2;2;2442;0;3029;2;1;
/org.eclipse.ui.workbench/Eclipse UI/org/eclipse/ui/internal/dialogs/ResourceInfoPage.java;2;0;2;1;0;0;0;2;2;1;2;79;2;2;1;0;0;2;2;79;0;2737;2;2;
/org.eclipse.ui.internal.r21presentation/src/org/eclipse/ui/internal/r21presentation/widgets/CTabItem.java;2;1;2;1;2;2;2;0;1;0;0;5275;1;1;1;0;0;0;2;5275;0;5625;2;2;
/org.eclipse.jdt.ui.tests.refactoring/resources/IntroduceFactory/positive/UnmovableArg1_in.java;1;0;2;1;1;1;1;1;2;0;1;2846;2;2;1;0;0;1;2;2846;0;5659;2;1;
/org.eclipse.jdt.ui.tests.refactoring/resources/ExtractMethodWorkSpace/ExtractMethodTests/return_out/A_test716.java;1;0;1;1;0;0;0;1;6;0;1;844;6;6;1;0;0;1;1;844;0;844;1;1;
/org.eclipse.core.resources/src/org/eclipse/core/internal/resources/Synchronizer.java;2;1;8;1;3;3;3;5;427;1;5;1541;457;457;1;0;0;5;8;1541;0;6206;8;2;
/org.eclipse.jdt.core.tests.model/workspace/Converter/src/test0131/Test.java;1;0;1;1;0;0;0;1;0;0;1;3714;0;0;1;0;0;1;1;3714;0;3714;1;1;
/org.eclipse.swt/Eclipse SWT Mozilla/common/org/eclipse/swt/internal/mozilla/nsIContextMenuListener.java;1;0;1;1;0;0;0;1;0;0;1;1654;0;0;1;0;0;1;1;1654;0;1654;1;1;
/org.eclipse.osgi/core/framework/org/eclipse/osgi/framework/internal/core/BundleContextImpl.java;2;2;6;1;6;5;6;0;142;0;0;5116;272;272;2;0;1;0;6;5116;1;6151;5;2;
/org.eclipse.pde.ui/src/org/eclipse/pde/internal/ui/editor/plugin/NewRuntimeLibraryDialog.java;3;2;4;2;4;3;4;0;13;0;0;5431;17;17;2;0;1;0;4;5779;1;6336;3;3;
/org.eclipse.jdt.core.tests.model/workspace/Converter/test0049/Test.java;1;0;1;1;0;0;0;1;0;0;1;3714;0;0;1;0;0;1;1;3714;0;3714;1;1;
/org.eclipse.swt.opengl.examples/src/org/eclipse/swt/opengl/examples/ObjectsTab.java;1;0;1;1;0;0;0;1;0;0;1;1175;0;0;1;0;0;1;1;1175;0;1175;1;1;
/org.eclipse.ui.externaltools/Ant Tools Support/org/eclipse/ui/externaltools/internal/ant/launchConfigurations/AntRunActionDelegate.java;1;0;1;1;0;0;0;1;0;0;1;282;0;0;1;0;0;1;1;282;0;282;1;1;
/org.eclipse.jdt.ui/ui/org/eclipse/jdt/internal/ui/preferences/EditTemplateDialog.java;5;2;30;1;9;8;9;21;131;3;18;761;673;673;3;3;1;21;30;2396;4;6340;26;5;
/org.eclipse.ui.workbench/Eclipse UI/org/eclipse/ui/internal/commands/old/KeyBindingNode.java;1;0;2;1;0;0;0;2;0;0;1;1374;0;0;2;1;0;2;2;1374;1;1374;1;1;
/org.eclipse.pde.ui/src/org/eclipse/pde/ui/IBasePluginWizard.java;2;1;4;1;4;4;4;0;14;0;0;5115;27;27;1;0;0;0;4;5115;0;6336;4;2;
/org.eclipse.jdt.ui.tests.refactoring/resources/MoveMembers/test40/out/B.java;1;0;1;1;0;0;0;1;0;0;1;4630;0;0;1;0;0;1;1;4630;0;4630;1;1;
/org.eclipse.jdt.core.tests.model/workspace/Converter/test0518/A.java;1;0;2;1;0;0;0;2;0;1;2;3612;0;0;1;0;0;2;2;3612;0;3714;2;1;
/org.eclipse.jdt.ui.tests.refactoring/resources/InlineMethodWorkspace/TestCases/argument_in/TestFieldReference.java;1;0;2;1;0;0;0;2;2;1;2;597;2;2;1;0;0;2;2;597;0;845;2;1;
/org.eclipse.jdt.debug/model/org/eclipse/jdt/internal/debug/core/model/JDIVariable.java;1;0;2;1;0;0;0;2;16;1;2;1840;20;20;1;0;0;2;2;1840;0;2497;2;1;
/org.eclipse.ui.workbench/Eclipse UI/org/eclipse/ui/testing/TestableEvent.java;1;0;1;1;0;0;0;1;0;0;1;2231;0;0;1;0;0;1;1;2231;0;2231;1;1;
/org.eclipse.ant.ui/Ant Editor/org/eclipse/ant/internal/ui/dtd/util/SortedMapFactory.java;1;0;1;1;0;0;0;1;0;0;1;1811;0;0;1;0;0;1;1;1811;0;1811;1;1;
/org.eclipse.pde.ui/src/org/eclipse/pde/internal/ui/parts/CheckboxTablePart.java;1;1;2;1;2;2;2;0;10;0;0;5431;14;14;1;0;0;0;2;5431;0;6336;2;1;
/org.eclipse.ant.ui/Ant Tools Support/org/eclipse/ui/ant/internal/views/actions/AntViewActionMessages.java;1;0;2;1;0;0;0;2;0;1;2;250;0;0;1;0;0;2;2;250;0;263;2;1;
/org.eclipse.osgi/defaultAdaptor/src/org/eclipse/osgi/framework/adaptor/core/AbstractBundleData.java;3;1;6;1;3;3;3;3;46;1;3;4336;78;78;1;0;0;3;6;4336;0;5507;6;3;
/org.eclipse.team.ui/src/org/eclipse/team/internal/ui/synchronize/actions/GlobalRefreshParticipantSelectionPage.java;1;0;1;1;0;0;0;1;0;0;1;4414;0;0;1;0;0;1;1;4414;0;4414;1;1;
/org.eclipse.jdt.ui/core extension/org/eclipse/jdt/internal/corext/codemanipulation/MemberEdit.java;3;0;6;2;0;0;0;6;6;2;3;546;12;12;2;3;0;6;6;546;3;1574;3;3;
/org.eclipse.core.filebuffers/src/org/eclipse/core/filebuffers/IDocumentSetupParticipant.java;2;2;6;2;4;3;4;2;22;1;2;1522;54;54;2;0;1;2;6;6333;1;6333;5;2;
/org.eclipse.update.core/src/org/eclipse/update/core/IVerifier.java;2;1;3;1;2;2;2;1;6;0;1;890;12;12;1;0;0;1;3;890;0;6336;3;2;
/org.eclipse.jdt.ui.tests.refactoring/resources/ExtractMethodWorkSpace/ExtractMethodTests/return_in/A_test714.java;1;0;1;1;0;0;0;1;4;0;1;844;4;4;1;0;0;1;1;844;0;844;1;1;
/org.eclipse.jdt.core/dom/org/eclipse/jdt/core/dom/rewrite/ListRewrite.java;3;0;4;1;1;1;1;3;48;1;3;4802;53;53;1;0;0;3;4;4802;0;5404;4;3;
/org.eclipse.ui.workbench/Eclipse UI/org/eclipse/ui/internal/dialogs/ViewLabelProvider.java;3;0;5;1;1;1;1;4;44;1;4;2737;74;74;1;0;0;4;5;2737;0;6338;5;3;
/org.eclipse.jdt.ui/ui/org/eclipse/jdt/internal/ui/dialogs/StatusDialog.java;1;1;4;1;2;2;2;2;18;1;2;1235;36;36;1;0;0;2;4;1235;0;5375;4;1;
/org.eclipse.jdt.ui/core refactoring/org/eclipse/jdt/internal/corext/refactoring/base/IReorgExceptionHandler.java;1;0;2;1;0;0;0;2;2;1;2;3708;2;2;1;0;0;2;2;3708;0;4575;2;1;
/org.eclipse.jdt.ui.tests.refactoring/resources/Copy/test_method_yes_other_method/in/A.java;1;0;1;1;0;0;0;1;2;0;1;685;2;2;1;0;0;1;1;685;0;685;1;1;
/org.eclipse.ui.workbench/Eclipse UI/org/eclipse/ui/internal/csm/roles/Persistence.java;1;0;7;1;0;0;0;7;37;3;5;2213;56;56;3;2;0;7;7;2406;2;2444;5;1;
/org.eclipse.swt/Eclipse SWT PI/win32/org/eclipse/swt/internal/ole/win32/LICINFO.java;1;0;1;1;0;0;0;1;4;0;1;2915;4;4;1;0;0;1;1;2915;0;2915;1;1;
/org.eclipse.ant.tests.ui/Ant Editor Tests/org/eclipse/ant/tests/ui/dtd/dumper.java;1;0;2;1;0;0;0;2;0;0;1;1811;0;0;2;1;0;2;2;1811;1;1811;1;1;
/org.eclipse.pde.core/src/org/eclipse/pde/core/IBaseModel.java;2;1;4;1;3;3;3;1;39;0;1;4856;46;46;1;0;0;1;4;4856;0;6336;4;2;
/org.eclipse.core.runtime/src/org/eclipse/core/internal/plugins/Extension.java;3;0;3;1;0;0;0;3;11;1;3;471;18;18;1;0;0;3;3;471;0;3013;3;3;
/org.eclipse.jdt.ui.tests.refactoring/resources/ExtractInterface/test63/out/A.java;1;0;1;1;0;0;0;1;2;0;1;1272;2;2;1;0;0;1;1;1272;0;1272;1;1;
/org.eclipse.jdt.core.tests.model/workspace/Formatter/test406/A_in.java;1;0;1;1;0;0;0;1;0;0;1;3438;0;0;1;0;0;1;1;3438;0;3438;1;1;
/org.eclipse.ui.workbench/Eclipse UI/org/eclipse/ui/internal/contexts/activationservice/MutableContextActivationService.java;1;0;2;1;0;0;0;2;0;1;2;3066;0;0;1;0;0;2;2;3066;0;3109;2;1;
/org.eclipse.jdt.ui.tests.refactoring/resources/InlineMethodWorkspace/TestCases/cast_in/TestHierarchyOverloadedPrivate.java;1;0;1;1;0;0;0;1;0;0;1;955;0;0;1;0;0;1;1;955;0;955;1;1;
/org.eclipse.jdt.core.tests.model/workspace/TypeHierarchy/src/q1/Z.java;1;0;1;1;0;0;0;1;0;0;1;3471;0;0;1;0;0;1;1;3471;0;3471;1;1;
/org.eclipse.ui.ide/src/org/eclipse/ui/dialogs/WizardNewProjectCreationPage.java;2;0;4;1;0;0;0;4;28;1;4;1511;50;50;1;0;0;4;4;1511;0;2263;4;2;
/org.eclipse.team.tests.cvs.core/src/org/eclipse/team/tests/ccvs/ui/old/DelimitedValuesWriter.java;1;0;2;1;0;0;0;2;0;1;2;2632;0;0;1;0;0;2;2;2632;0;4216;2;1;
/org.eclipse.ui.workbench/Eclipse UI/org/eclipse/ui/internal/csm/commands/api/ICommandManager.java;1;0;4;1;0;0;0;4;84;1;4;2515;89;89;1;0;0;4;4;2515;0;2562;4;1;
/org.eclipse.jdt.ui.tests.refactoring/resources/PullUp/test42/in/A.java;1;0;1;1;0;0;0;1;0;0;1;328;0;0;1;0;0;1;1;328;0;328;1;1;
/org.eclipse.jdt.core.tests.model/workspace/Formatter/test254/A_in.java;1;0;1;1;0;0;0;1;0;0;1;2442;0;0;1;0;0;1;1;2442;0;2442;1;1;
/org.eclipse.jface/src/org/eclipse/jface/progress/IJobCompletionListener.java;1;0;3;1;0;0;0;3;34;1;3;598;34;34;1;0;0;3;3;598;0;955;3;1;
/org.eclipse.debug.core/core/org/eclipse/debug/core/IStreamListener.java;2;0;2;1;0;0;0;2;7;1;2;2066;14;14;1;0;0;2;2;2066;0;2149;2;2;
/org.eclipse.debug.core/core/org/eclipse/debug/core/sourcelookup/containers/AbstractSourceContainer.java;1;0;3;1;1;1;1;2;19;0;1;4949;21;21;2;1;0;2;3;4949;1;5109;2;1;
/org.eclipse.pde.ui/src/org/eclipse/pde/internal/ui/editor/schema/DocSection.java;3;1;9;1;5;5;5;4;221;1;4;368;333;333;1;0;0;4;9;368;0;6336;9;3;
/org.eclipse.jdt.core.tests.model/workspace/Formatter/test331/A_in.java;1;0;1;1;0;0;0;1;0;0;1;2640;0;0;1;0;0;1;1;2640;0;2640;1;1;
/org.eclipse.jdt.core.tests.model/workspace/Converter/test0295/Test.java;1;0;1;1;0;0;0;1;0;0;1;3714;0;0;1;0;0;1;1;3714;0;3714;1;1;
/org.eclipse.ui.externaltools/Ant Editor/org/eclipse/ui/externaltools/internal/ant/dtd/schema/Dfm.java;1;0;1;1;0;0;0;1;0;0;1;282;0;0;1;0;0;1;1;282;0;282;1;1;
/org.eclipse.jdt.core.tests.model/workspace/Formatter/test191/A_in.java;1;0;1;1;0;0;0;1;0;0;1;2425;0;0;1;0;0;1;1;2425;0;2425;1;1;
/org.eclipse.jdt.core.tests.model/workspace/Formatter/test177/A_in.java;1;0;1;1;0;0;0;1;0;0;1;2425;0;0;1;0;0;1;1;2425;0;2425;1;1;
/org.eclipse.ui.workbench/Eclipse UI/org/eclipse/ui/themes/IThemePreview.java;1;1;3;1;2;2;2;1;3;0;1;5025;5;5;1;0;0;1;3;5025;0;5247;3;1;
/org.eclipse.jdt.ui/core extension/org/eclipse/jdt/internal/corext/textmanipulation/MoveTargetEdit.java;1;0;8;1;0;0;0;8;64;2;6;949;196;196;2;2;0;8;8;1869;2;1946;6;1;
/org.eclipse.help.ide/src/org/eclipse/help/ui/internal/workingset/HelpWorkingSetSynchronizer.java;1;1;6;1;2;2;2;4;234;2;3;1738;322;322;2;1;0;4;6;1747;1;6337;5;1;
/org.eclipse.team.ui/src/org/eclipse/team/internal/ui/synchronize/SynchronizeModelElementLabelProvider.java;1;0;5;1;1;1;1;4;125;1;4;4588;192;192;1;0;0;4;5;4588;0;6337;5;1;
/org.eclipse.core.runtime/src/org/eclipse/core/internal/plugins/RegistryCacheReader.java;1;0;2;1;0;0;0;2;26;1;2;2660;26;26;1;0;0;2;2;2660;0;3013;2;1;
/org.eclipse.core.tests.runtime/src/org/eclipse/core/tests/internal/dynamicregistry/AllTests.java;1;0;1;1;1;1;1;0;0;0;0;6201;0;0;1;0;0;0;1;6201;0;6201;1;1;
/org.eclipse.ant.ui/Ant Editor/org/eclipse/ant/internal/ui/editor/AntEditorMessages.java;1;0;1;1;0;0;0;1;0;0;1;1811;0;0;1;0;0;1;1;1811;0;1811;1;1;
/org.eclipse.ui.workbench/Eclipse UI/org/eclipse/ui/commands/IKeyConfiguration.java;3;1;14;1;2;2;2;12;162;2;10;1321;473;473;2;2;0;12;14;1417;2;6338;12;3;
/org.eclipse.jdt.core.tests.model/workspace/Formatter/test0001/A.java;1;0;1;1;0;0;0;1;0;0;1;393;0;0;1;0;0;1;1;393;0;393;1;1;
/org.eclipse.pde.ui/src/org/eclipse/pde/internal/ui/build/BaseBuildAction.java;3;2;13;1;12;11;12;1;129;0;1;3840;433;433;2;0;1;1;13;6067;1;6336;12;3;
/org.eclipse.core.runtime/src/org/eclipse/core/internal/registry/HostDelta.java;2;0;3;1;0;0;0;3;4;1;3;2105;4;4;1;0;0;3;3;2105;0;3013;3;2;
/org.eclipse.jdt.ui/ui/org/eclipse/jdt/ui/actions/FindReferencesInWorkingSetAction.java;2;1;6;1;3;3;3;3;14;1;3;1350;31;31;1;0;0;3;6;1350;0;6340;6;2;
/org.eclipse.swt.opengl.examples/src/org/eclipse/swt/opengl/examples/TransparencyTab.java;1;0;1;1;0;0;0;1;0;0;1;1175;0;0;1;0;0;1;1;1175;0;1175;1;1;
/org.eclipse.core.tests.runtime/src/org/eclipse/core/tests/internal/plugin/a/ConfigurableExtension.java;1;0;1;1;1;1;1;0;18;0;0;5149;18;18;1;0;0;0;1;5149;0;5149;1;1;
/org.eclipse.ui.tests/Eclipse JFace Tests/org/eclipse/jface/tests/viewers/StructuredViewerTest.java;3;1;3;1;2;2;2;1;10;0;1;2754;18;18;1;0;0;1;3;2754;0;6338;3;3;
/org.eclipse.jdt.ui/ui refactoring/org/eclipse/jdt/internal/ui/refactoring/InlineTempInputPage.java;1;0;1;1;0;0;0;1;0;0;1;518;0;0;1;0;0;1;1;518;0;518;1;1;
/org.eclipse.jdt.core.tests.model/src/org/eclipse/jdt/core/tests/model/JavaSearchJavadocTests.java;2;1;14;1;6;6;6;8;516;1;8;2887;2340;2340;1;0;0;8;14;2887;0;6100;14;2;
/org.eclipse.pde.ui/src/org/eclipse/pde/internal/ui/wizards/plugin/TemplateListSelectionPage.java;3;3;7;2;7;5;7;0;31;0;0;5514;60;60;3;0;2;0;7;6146;2;6336;5;3;
/org.eclipse.ui.workbench/Eclipse UI/org/eclipse/ui/internal/WorkbenchIntroManager.java;1;1;5;1;4;4;4;1;26;0;1;4991;56;56;1;0;0;1;5;4991;0;6319;5;1;
/org.eclipse.jdt.ui.tests.refactoring/resources/RenameStaticMethod/test11/out/A.java;1;0;1;1;0;0;0;1;0;0;1;1535;0;0;1;0;0;1;1;1535;0;1535;1;1;
/org.eclipse.jdt.ui/ui refactoring/org/eclipse/jdt/internal/ui/refactoring/reorg/RenameTypeWizard.java;2;0;4;1;1;1;1;3;8;1;3;1047;17;17;1;0;0;3;4;1047;0;6340;4;2;
/org.eclipse.ui.workbench/Eclipse UI/org/eclipse/ui/internal/CoolItemPosition.java;1;0;1;1;0;0;0;1;0;0;1;368;0;0;1;0;0;1;1;368;0;368;1;1;
/org.eclipse.ui.workbench/Eclipse UI/org/eclipse/ui/internal/commands/AbstractMutableRegistry.java;1;0;7;1;0;0;0;7;65;2;6;607;122;122;2;1;0;7;7;1389;1;1389;6;1;
/org.eclipse.swt/Eclipse SWT/gtk/org/eclipse/swt/internal/Platform.java;1;0;2;1;0;0;0;2;0;1;2;1955;0;0;1;0;0;2;2;1955;0;1969;2;1;
/org.eclipse.releng.eclipsebuilder/sdk.tests/tools/TestVersionTracker.java;1;0;2;1;0;0;0;2;25;1;2;1395;25;25;1;0;0;2;2;1395;0;2748;2;1;
/org.eclipse.update.ui/src/org/eclipse/update/internal/ui/search/ISearchCategory.java;1;0;1;1;0;0;0;1;0;0;1;825;0;0;1;0;0;1;1;825;0;825;1;1;
/org.eclipse.update.ui.win32/src/org/eclipse/welcome/internal/WelcomePortalImages.java;1;0;3;1;0;0;0;3;10;1;3;889;12;12;1;0;0;3;3;889;0;4143;3;1;
/org.eclipse.search/search/org/eclipse/search/internal/ui/SearchAgainAction.java;1;0;1;1;1;1;1;0;2;0;0;6340;2;2;1;0;0;0;1;6340;0;6340;1;1;
/org.eclipse.team.ui/src/org/eclipse/team/internal/ui/synchronize/GlobalRefreshSchedulePage.java;2;1;2;1;2;2;2;0;0;0;0;5362;0;0;1;0;0;0;2;5362;0;5596;2;2;
/org.eclipse.jdt.ui.tests.refactoring/resources/ExtractMethodWorkSpace/ExtractMethodTests/locals_out/A_test542.java;1;0;2;1;0;0;0;2;4;1;2;130;5;5;1;0;0;2;2;130;0;844;2;1;
/org.eclipse.jdt.ui/core refactoring/org/eclipse/jdt/internal/corext/refactoring/util/CommentAnalyzer.java;3;0;3;1;1;1;1;2;23;1;2;4575;27;27;1;0;0;2;3;4575;0;6340;3;3;
/org.eclipse.jdt.core/model/org/eclipse/jdt/core/IJavaModel.java;1;0;3;1;0;0;0;3;3;1;3;346;6;6;1;0;0;3;3;346;0;3560;3;1;
/org.eclipse.swt/Eclipse SWT Custom Widgets/common/org/eclipse/swt/custom/CTabFolder.java;4;4;104;2;47;21;47;57;3963;5;29;1;8199;8199;5;28;26;57;104;4125;54;6352;50;4;
/org.eclipse.jdt.ui.tests.refactoring/resources/ExtractTemp/canExtract/A_test76_out.java;1;0;1;1;0;0;0;1;0;0;1;1569;0;0;1;0;0;1;1;1569;0;1569;1;1;
/org.eclipse.jdt.core.tests.model/workspace/Converter/src/test0102/Test.java;1;0;1;1;0;0;0;1;0;0;1;3714;0;0;1;0;0;1;1;3714;0;3714;1;1;
/org.eclipse.jdt.ui.tests.refactoring/resources/ExtractMethodWorkSpace/ExtractMethodTests/expression_in/A_test618.java;1;0;1;1;0;0;0;1;2;0;1;844;2;2;1;0;0;1;1;844;0;844;1;1;
/org.eclipse.update.ui.forms/src/org/eclipse/update/ui/forms/internal/FormWidgetFactory.java;2;0;5;1;0;0;0;5;14;1;5;2751;47;47;1;0;0;5;5;2751;0;3178;5;2;
/org.eclipse.core.tests.resources/src/org/eclipse/core/tests/resources/session/TestBug30015.java;1;0;1;1;1;1;1;0;12;0;0;5147;12;12;1;0;0;0;1;5147;0;5147;1;1;
/org.eclipse.jdt.debug.ui/ui/org/eclipse/jdt/internal/debug/ui/JavaDebugPreferencePage.java;6;0;8;2;1;1;1;7;44;2;6;3964;145;145;2;1;0;7;8;4653;1;5135;7;6;
/org.eclipse.ant.ui/Ant Editor/org/eclipse/ant/internal/ui/editor/model/AntImportNode.java;1;1;4;1;2;2;2;2;13;0;1;4224;17;17;2;1;0;2;4;4224;1;5920;3;1;
/org.eclipse.swt/Eclipse SWT Drag and Drop/emulated/org/eclipse/swt/dnd/ByteArrayTransfer.java;1;1;2;1;2;2;2;0;4;0;0;5606;6;6;1;0;0;0;2;5606;0;6352;2;1;
/org.eclipse.swt.tests/JUnit Tests/org/eclipse/swt/tests/junit/Test_org_eclipse_swt_events_HelpListener.java;1;0;1;1;0;0;0;1;16;0;1;2175;16;16;1;0;0;1;1;2175;0;2175;1;1;
/org.eclipse.team.core/src/org/eclipse/team/internal/core/SubscriberManager.java;2;0;6;2;0;0;0;6;26;2;5;1852;67;67;2;1;0;6;6;2460;1;2632;5;2;
/org.eclipse.ui.ide/src/org/eclipse/ui/views/markers/internal/ActionAddGlobalTask.java;4;0;5;1;1;1;1;4;2;1;4;2208;7;7;1;0;0;4;5;2208;0;6338;5;4;
/org.eclipse.team.ftp/src/org/eclipse/team/internal/ftp/subscriber/FTPResourceVariantFactory.java;1;0;1;1;0;0;0;1;0;0;1;4208;0;0;1;0;0;1;1;4208;0;4208;1;1;
/org.eclipse.team.cvs.core/src/org/eclipse/team/internal/ccvs/core/client/RemoveEntryHandler.java;1;0;1;1;0;0;0;1;8;0;1;2375;8;8;1;0;0;1;1;2375;0;2375;1;1;
/org.eclipse.jdt.ui.tests/ui/org/eclipse/jdt/ui/tests/core/CodeFormatterUtilTest.java;3;1;13;1;5;5;5;8;106;2;7;1593;318;318;2;1;0;8;13;1593;1;6340;12;3;
/org.eclipse.ui.ide/extensions/org/eclipse/ui/dialogs/WizardNewFileCreationPage.java;3;1;3;1;2;2;2;1;24;0;1;2263;26;26;1;0;0;1;3;2263;0;6338;3;3;
/org.eclipse.team.webdav/src/org/eclipse/team/ui/subscriber/TargetSubscriberAction.java;1;0;1;1;0;0;0;1;0;0;1;3373;0;0;1;0;0;1;1;3373;0;3373;1;1;
/org.eclipse.ui.ide/extensions/org/eclipse/ui/dialogs/WizardImportPage.java;3;1;3;1;2;2;2;1;2;0;1;2263;4;4;1;0;0;1;3;2263;0;6338;3;3;
/org.eclipse.jdt.core/model/org/eclipse/jdt/internal/core/Buffer.java;3;0;12;2;0;0;0;12;56;2;11;27;154;154;2;1;0;12;12;3302;1;4753;11;3;
/org.eclipse.jdt.launching/launching/org/eclipse/jdt/launching/StandardSourcePathProvider.java;4;0;7;2;1;1;1;6;46;2;5;2534;105;105;2;1;0;6;7;2534;1;6336;6;4;
/org.eclipse.ui.cheatsheets/src/org/eclipse/ui/internal/cheatsheets/views/ToggleButton.java;2;0;3;1;0;0;0;3;17;1;3;4428;17;17;1;0;0;3;3;4428;0;4701;3;2;
/org.eclipse.jdt.ui.tests/ui/org/eclipse/jdt/ui/tests/core/BindingsNameTest.java;3;1;5;1;2;2;2;3;22;1;3;803;47;47;1;0;0;3;5;803;0;6340;5;3;
/org.eclipse.releng.tools/src/org/eclipse/releng/tools/TagAndReleaseOperation.java;1;1;2;1;2;2;2;0;4;0;0;5183;4;4;1;0;0;0;2;5183;0;6340;2;1;
/org.eclipse.jdt.ui/core refactoring/org/eclipse/ltk/core/refactoring/participants/CreateParticipant.java;1;0;2;1;0;0;0;2;0;1;2;4624;0;0;1;0;0;2;2;4624;0;4864;2;1;
/org.eclipse.ui.workbench/Eclipse UI/org/eclipse/ui/internal/dialogs/CustomizePerspectiveDialog.java;8;2;20;2;4;3;4;16;221;2;15;830;899;899;2;1;1;16;20;4609;2;6338;18;8;
/org.eclipse.jdt.ui/ui refactoring/org/eclipse/jdt/internal/ui/refactoring/reorg/CreateTargetQueries.java;1;1;2;1;2;2;2;0;34;0;0;5896;34;34;1;0;0;0;2;5896;0;6013;2;1;
/org.eclipse.update.ui/src/org/eclipse/update/internal/ui/EditBookmarksAction.java;3;0;5;1;1;1;1;4;17;1;4;825;24;24;1;0;0;4;5;825;0;5991;5;3;
/org.eclipse.debug.ui/ui/org/eclipse/debug/ui/launchVariables/AbstractVariableComponent.java;3;0;7;2;0;0;0;7;13;3;5;550;15;15;3;2;0;7;7;771;2;2120;5;3;
/org.eclipse.jdt.core/model/org/eclipse/jdt/core/util/ByteCodeVisitorAdapter.java;1;0;2;1;0;0;0;2;205;1;2;1806;207;207;1;0;0;2;2;1806;0;3560;2;1;
/org.eclipse.ui.workbench/Eclipse UI/org/eclipse/ui/internal/dialogs/WorkbenchWizardBlockedHandler.java;1;1;2;1;2;2;2;0;0;0;0;5112;0;0;1;0;0;0;2;5112;0;5363;2;1;
/org.eclipse.debug.ui/ui/org/eclipse/debug/internal/ui/actions/AddWatchExpressionAction.java;1;0;2;1;0;0;0;2;4;1;2;1516;4;4;1;0;0;2;2;1516;0;1524;2;1;
/org.eclipse.pde.ui/src/org/eclipse/pde/internal/ui/build/BuildPluginAction.java;2;2;11;1;8;7;8;3;15;1;3;3840;52;52;2;0;1;3;11;5189;1;6336;10;2;
/org.eclipse.pde.ui/src/org/eclipse/pde/internal/ui/wizards/exports/ExportFeatureBuildScriptGenerator.java;1;0;9;1;0;0;0;9;100;1;9;94;222;222;1;0;0;9;9;94;0;5044;9;1;
/org.eclipse.jdt.ui/core extension/org/eclipse/jdt/internal/corext/textmanipulation/EditProcessor.java;1;0;3;1;0;0;0;3;48;2;2;1875;48;48;2;1;0;3;3;1946;1;1946;2;1;
/org.eclipse.update.ui.forms/Eclipse Forms/org/eclipse/ui/forms/internal/widgets/WrappedPageBook.java;1;0;2;1;0;0;0;2;0;1;2;4024;0;0;1;0;0;2;2;4024;0;4157;2;1;
/org.eclipse.swt.tests/JUnit Tests/org/eclipse/swt/tests/junit/Test_org_eclipse_swt_browser_CloseWindowListener.java;1;0;2;1;0;0;0;2;8;1;2;3012;8;8;1;0;0;2;2;3012;0;3167;2;1;
/org.eclipse.swt.examples/src/org/eclipse/swt/examples/addressbook/AddressBook.java;1;0;1;1;0;0;0;1;16;0;1;88;16;16;1;0;0;1;1;88;0;88;1;1;
/org.eclipse.jdt.core.tests.compiler/src/org/eclipse/jdt/core/tests/junit/extension/ExcludedTestSuite.java;1;0;1;1;0;0;0;1;0;0;1;989;0;0;1;0;0;1;1;989;0;989;1;1;
/org.eclipse.jdt.debug.ui/ui/org/eclipse/jdt/internal/debug/ui/JavaWatchExpressionDelegate.java;4;0;5;1;1;1;1;4;38;1;4;1516;50;50;1;0;0;4;5;1516;0;6336;5;4;
/org.eclipse.jdt.core.tests.model/workspace/Converter15/src/test0020/X.java;1;0;1;1;0;0;0;1;0;0;1;4828;0;0;1;0;0;1;1;4828;0;4828;1;1;
/org.eclipse.swt/Eclipse SWT/gtk/org/eclipse/swt/widgets/Widget.java;6;1;33;2;5;5;5;28;166;2;27;35;779;779;2;1;0;28;33;2105;1;6362;32;6;
/org.eclipse.ui.views/src/org/eclipse/ui/views/internal/markers/tasks/DeleteCompletedAction.java;1;0;3;1;0;0;0;3;25;2;2;265;25;25;2;1;0;3;3;265;1;749;2;1;
/org.eclipse.ui.views/src/org/eclipse/ui/views/tasklist/ITaskListResourceAdapter.java;1;0;2;1;0;0;0;2;9;1;2;1941;9;9;1;0;0;2;2;1941;0;2738;2;1;
/org.eclipse.jdt.ui/ui refactoring/org/eclipse/jdt/internal/ui/refactoring/changes/ChangeExceptionHandler.java;2;0;4;1;0;0;0;4;6;1;4;1007;14;14;1;0;0;4;4;1007;0;4575;4;2;
/org.eclipse.update.ui/srcnew/org/eclipse/update/internal/ui/wizards/ModeSelectionPage2.java;2;0;2;1;0;0;0;2;0;1;2;367;0;0;1;0;0;2;2;367;0;478;2;2;
/org.eclipse.ui.examples.javaeditor/Template Editor Example/org/eclipse/ui/examples/templateeditor/editors/TemplateMessages.java;2;0;2;1;1;1;1;1;2;0;1;4644;2;2;1;0;0;1;2;4644;0;6340;2;2;
/org.eclipse.ui.examples.javaeditor/Eclipse Java Editor Example/org/eclipse/ui/examples/javaeditor/spelling/SpellCheckIterator.java;1;0;1;1;0;0;0;1;0;0;1;2565;0;0;1;0;0;1;1;2565;0;2565;1;1;
/org.eclipse.core.resources/src/org/eclipse/core/internal/localstore/SafeFileInputStream.java;1;0;1;1;1;1;1;0;49;0;0;5146;49;49;1;0;0;0;1;5146;0;5146;1;1;
/org.eclipse.jdt.core/compiler/org/eclipse/jdt/internal/compiler/parser/diagnose/RangeUtil.java;1;0;2;1;0;0;0;2;2;1;2;3194;2;2;1;0;0;2;2;3194;0;3560;2;1;
/org.eclipse.jdt.core/model/org/eclipse/jdt/internal/core/JarPackageFragmentInfo.java;1;0;3;1;1;1;1;2;23;1;2;1806;33;33;1;0;0;2;3;1806;0;6143;3;1;
/org.eclipse.jdt.ui.tests.refactoring/resources/RenamePackage/testImportFromMultiRoots4/in/srcTest/p/ATest.java;1;0;2;1;0;0;0;2;13;1;2;3219;13;13;1;0;0;2;2;3219;0;4105;2;1;
/org.eclipse.team.ui/src/org/eclipse/team/internal/ui/synchronize/views/SyncViewerLabelProvider.java;1;0;1;1;0;0;0;1;0;0;1;2535;0;0;1;0;0;1;1;2535;0;2535;1;1;
/org.eclipse.core.tests.resources/src/org/eclipse/core/tests/resources/MarkersChangeListener.java;1;0;2;1;2;1;2;0;170;0;0;5147;170;170;2;0;1;0;2;5147;1;5147;1;1;
/org.eclipse.swt/Eclipse SWT Mozilla/common/org/eclipse/swt/internal/mozilla/nsIRequestObserver.java;1;0;1;1;0;0;0;1;0;0;1;2663;0;0;1;0;0;1;1;2663;0;2663;1;1;
/org.eclipse.ui.ide/extensions/org/eclipse/ui/IContributorResourceAdapter.java;3;1;3;1;2;2;2;1;2;0;1;2614;4;4;1;0;0;1;3;2614;0;6338;3;3;
/org.eclipse.jdt.core.tests.model/workspace/Formatter/test324/A_out.java;2;0;3;1;0;0;0;3;30;1;3;2528;39;39;1;0;0;3;3;2528;0;3362;3;2;
/org.eclipse.jdt.ui.tests.refactoring/resources/DeleteSourceReference/test12/out/A.java;1;0;1;1;0;0;0;1;0;0;1;1652;0;0;1;0;0;1;1;1652;0;1652;1;1;
/org.eclipse.ui.workbench/Eclipse UI/org/eclipse/ui/internal/WorkbenchConfigurer.java;4;1;7;1;2;2;2;5;175;1;5;1259;214;214;1;0;0;5;7;1259;0;6338;7;4;
/org.eclipse.core.runtime/src/org/eclipse/core/runtime/content/ITextContentDescriber.java;1;1;4;1;4;4;4;0;6;0;0;5213;12;12;1;0;0;0;4;5213;0;6124;4;1;
/org.eclipse.pde.ui/src/org/eclipse/pde/internal/ui/launcher/LaunchListener.java;2;1;8;1;4;4;4;4;364;1;4;1611;541;541;1;0;0;4;8;1611;0;6336;8;2;
/org.eclipse.pde.ui/src_Forms/org/eclipse/pde/internal/ui/newparts/TablePart.java;2;0;2;1;1;1;1;1;0;0;1;3795;0;0;1;0;0;1;2;3795;0;5431;2;2;
/org.eclipse.pde.core/src/org/eclipse/pde/internal/core/site/SiteArchive.java;2;1;3;1;2;2;2;1;12;0;1;4203;28;28;1;0;0;1;3;4203;0;6336;3;2;
/org.eclipse.swt/Eclipse SWT/photon/org/eclipse/swt/widgets/Composite.java;4;1;9;1;2;2;2;7;59;1;7;269;121;121;1;0;0;7;9;269;0;6352;9;4;
/org.eclipse.ui.externaltools/Ant Editor/org/eclipse/ui/externaltools/internal/ant/dtd/AntDTDMessages.java;1;0;1;1;0;0;0;1;0;0;1;282;0;0;1;0;0;1;1;282;0;282;1;1;
/org.eclipse.jdt.ui.tests.refactoring/resources/DeleteSourceReferenceEdit/A_testField3_out.java;1;0;1;1;0;0;0;1;0;0;1;1652;0;0;1;0;0;1;1;1652;0;1652;1;1;
/org.eclipse.help/src/org/eclipse/help/internal/search/ParsedDocument.java;1;0;1;1;0;0;0;1;0;0;1;2732;0;0;1;0;0;1;1;2732;0;2732;1;1;
/org.eclipse.ui.views/src/org/eclipse/ui/views/internal/markers/DefaultMarkerResourceAdapter.java;1;0;2;1;0;0;0;2;0;1;2;265;0;0;1;0;0;2;2;265;0;755;2;1;
/org.eclipse.pde.core/src/org/eclipse/pde/internal/core/plugin/PluginImport.java;2;1;9;1;6;6;6;3;57;1;3;1723;153;153;1;0;0;3;9;1723;0;6336;9;2;
/org.eclipse.swt.graphics.text/org.eclipse.swt/Eclipse SWT PI/gtk/org/eclipse/swt/internal/gtk/PangoGlyphInfo.java;1;0;1;1;0;0;0;1;0;0;1;2267;0;0;1;0;0;1;1;2267;0;2267;1;1;
/org.eclipse.update.ui/src/org/eclipse/update/internal/ui/search/MyComputerSearchSettings.java;1;0;1;1;0;0;0;1;0;0;1;824;0;0;1;0;0;1;1;824;0;824;1;1;
/org.eclipse.jdt.core.tests.model/workspace/Completion/src/CompletionAbstractMethod2.java;1;0;1;1;0;0;0;1;0;0;1;1702;0;0;1;0;0;1;1;1702;0;1702;1;1;
/org.eclipse.core.resources/src/org/eclipse/core/internal/utils/Policy.java;2;1;8;1;3;3;3;5;184;1;5;1485;270;270;1;0;0;5;8;1485;0;5490;8;2;
/org.eclipse.swt.tests/JUnit Tests/org/eclipse/swt/tests/junit/Test_org_eclipse_swt_widgets_FileDialog.java;3;0;3;1;0;0;0;3;55;1;3;2123;89;89;1;0;0;3;3;2123;0;2824;3;3;
/org.eclipse.jdt.ui/core refactoring/org/eclipse/jdt/internal/corext/refactoring/participants/xml/PropertyCache.java;1;0;2;1;0;0;0;2;0;1;2;4091;0;0;1;0;0;2;2;4091;0;4108;2;1;
/org.eclipse.jdt.ui/ui/org/eclipse/jdt/ui/actions/FindWriteReferencesAction.java;2;0;2;1;1;1;1;1;5;0;1;3266;7;7;1;0;0;1;2;3266;0;6340;2;2;
/org.eclipse.update.core/src/org/eclipse/update/operations/IOperation.java;1;2;9;1;3;2;3;6;17;2;5;825;34;34;2;1;1;6;9;825;2;6336;7;1;
/org.eclipse.core.expressions/src/org/eclipse/core/internal/expressions/TypeExtensionManager.java;1;1;5;1;2;2;2;3;158;1;3;4108;249;249;1;0;0;3;5;4108;0;5404;5;1;
/org.eclipse.jdt.ui.examples.javafamily/src/org/eclipse/jface/text/source/ITagHandlerFactory.java;1;0;4;1;0;0;0;4;9;1;4;1172;15;15;1;0;0;4;4;1172;0;1642;4;1;
/org.eclipse.swt/Eclipse SWT Custom Widgets/common/org/eclipse/swt/custom/BusyIndicator.java;2;1;4;1;2;2;2;2;22;1;2;1139;51;51;1;0;0;2;4;1139;0;6352;4;2;
/org.eclipse.help.webapp/src_servlets/org/eclipse/help/internal/webapp/servlet/InfocenterWorkingSetManager.java;1;1;9;1;3;3;3;6;278;1;6;364;417;417;1;0;0;6;9;364;0;6337;9;1;
/org.eclipse.team.examples.filesystem/src/org/eclipse/team/examples/filesystem/subscriber/FileSystemRemoteTree.java;2;0;3;1;1;1;1;2;11;1;2;4349;13;13;1;0;0;2;3;4349;0;6337;3;2;
/org.eclipse.jdt.debug.ui/ui/org/eclipse/jdt/internal/debug/ui/launcher/ListContentProvider.java;1;0;1;1;0;0;0;1;0;0;1;1036;0;0;1;0;0;1;1;1036;0;1036;1;1;
/org.eclipse.jdt.debug.ui/ui/org/eclipse/jdt/internal/debug/ui/BreakpointUtils.java;5;0;7;1;1;1;1;6;18;1;6;1694;38;38;1;0;0;6;7;1694;0;6336;7;5;
/org.eclipse.swt.tests/JUnit Tests/org/eclipse/swt/tests/junit/Test_org_eclipse_swt_accessibility_AccessibleAdapter.java;1;0;1;1;0;0;0;1;0;0;1;2104;0;0;1;0;0;1;1;2104;0;2104;1;1;
/org.eclipse.webdav/src/kernel/org/eclipse/webdav/internal/kernel/utils/ExcludingEnumeration.java;1;0;2;1;2;1;2;0;71;0;0;5151;71;71;2;0;1;0;2;5151;1;5151;1;1;
/org.eclipse.jdt.ui.tests.refactoring/resources/Copy/test_import_container_yes_cu/in/A.java;1;0;1;1;0;0;0;1;0;0;1;696;0;0;1;0;0;1;1;696;0;696;1;1;
/org.eclipse.jdt.ui.tests.refactoring/resources/InlineMethodWorkspace/TestCases/argument_out/TestLocalReferenceRead2.java;1;0;1;1;0;0;0;1;4;0;1;845;4;4;1;0;0;1;1;845;0;845;1;1;
/org.eclipse.ui.workbench/Eclipse UI/org/eclipse/ui/internal/presentation/TemporaryFontRegistry.java;1;0;2;1;0;0;0;2;0;1;2;4235;0;0;1;0;0;2;2;4235;0;4263;2;1;
/org.eclipse.jdt.ui/core refactoring/org/eclipse/jdt/internal/corext/refactoring/base/Context.java;1;0;2;1;0;0;0;2;4;1;2;882;4;4;1;0;0;2;2;882;0;3536;2;1;
/org.eclipse.update.core/srcnew/org/eclipse/update/internal/operations/JobTargetSite.java;1;0;3;1;0;0;0;3;3;1;3;367;3;3;1;0;0;3;3;367;0;825;3;1;
/org.eclipse.jdt.ui.tests.refactoring/resources/PullUp/testEnablement2/in/A.java;1;0;1;1;0;0;0;1;0;0;1;1312;0;0;1;0;0;1;1;1312;0;1312;1;1;
/org.eclipse.jdt.ui.tests.refactoring/resources/SefWorkSpace/SefTests/object_out/TestArrayRead.java;1;0;1;1;0;0;0;1;2;0;1;1492;2;2;1;0;0;1;1;1492;0;1492;1;1;
/org.eclipse.jdt.ui/ui/org/eclipse/jdt/internal/ui/wizards/dialogfields/CheckedListDialogField.java;3;1;5;1;2;2;2;3;30;1;3;4407;64;64;1;0;0;3;5;4407;0;6340;5;3;
/org.eclipse.ui.forms.examples/src/org/eclipse/ui/forms/examples/internal/ExamplesPlugin.java;1;0;4;1;2;1;2;2;70;1;2;4075;72;72;2;0;1;2;4;5780;1;5780;3;1;
/org.eclipse.pde.ui/src/org/eclipse/pde/internal/ui/editor/schema/DocForm.java;1;0;1;1;1;1;1;0;0;0;0;5431;0;0;1;0;0;0;1;5431;0;5431;1;1;
/org.eclipse.jdt.ui.tests.refactoring/resources/ChangeSignature/canModify/A_testImport01_in.java;1;0;1;1;0;0;0;1;0;0;1;3820;0;0;1;0;0;1;1;3820;0;3820;1;1;
/org.eclipse.osgi/eclipseAdaptor/src/org/eclipse/osgi/service/urlconversion/URLConverter.java;2;0;3;1;1;1;1;2;10;1;2;3620;12;12;1;0;0;2;3;3620;0;5117;3;2;
/org.eclipse.team.ui/src/org/eclipse/team/internal/ui/sync/views/ViewStatusInformation.java;1;0;4;1;0;0;0;4;70;1;4;1293;76;76;1;0;0;4;4;1293;0;2632;4;1;
/org.eclipse.jdt.ui.tests/ui/org/eclipse/jdt/ui/tests/core/AllTypesCacheTest.java;3;1;13;1;2;2;2;11;95;2;10;803;262;262;2;1;0;11;13;3209;1;6340;12;3;
/org.eclipse.team.cvs.ui/src/org/eclipse/team/internal/ccvs/ui/operations/RepositoryProviderOperation.java;2;1;12;1;3;3;3;9;124;1;9;721;259;259;1;0;0;9;12;721;0;6337;12;2;
/org.eclipse.ui.workbench/Eclipse UI/org/eclipse/ui/IPlaceholderFolderLayout.java;2;1;3;1;2;2;2;1;14;0;1;4563;30;30;1;0;0;1;3;4563;0;6338;3;2;
/org.eclipse.ui.ide/src/org/eclipse/ui/internal/ide/dialogs/LinkedResourcesPreferencePage.java;4;1;4;1;2;2;2;2;19;1;2;2264;23;23;1;0;0;2;4;2264;0;6338;4;4;
/org.eclipse.update.ui/src/org/eclipse/update/internal/ui/wizards/ShowActivitiesDialog.java;1;1;6;1;4;4;4;2;120;1;2;4434;149;149;1;0;0;2;6;4434;0;6336;6;1;
/org.eclipse.jdt.ui/ui/org/eclipse/jdt/ui/actions/BuildActionGroup.java;3;0;3;1;1;1;1;2;12;1;2;4307;20;20;1;0;0;2;3;4307;0;6340;3;3;
/org.eclipse.jdt.ui/ui/org/eclipse/jdt/internal/ui/typehierarchy/EnableMemberFilterAction.java;1;0;1;1;1;1;1;0;2;0;0;6340;2;2;1;0;0;0;1;6340;0;6340;1;1;
/org.eclipse.jdt.core.tests.model/workspace/Converter/src/test0061/Test.java;1;0;1;1;0;0;0;1;0;0;1;3714;0;0;1;0;0;1;1;3714;0;3714;1;1;
/org.eclipse.pde.ui/src/org/eclipse/pde/internal/ui/editor/site/SiteSourcePage.java;1;1;5;1;2;2;2;3;24;1;3;909;55;55;1;0;0;3;5;909;0;6336;5;1;
/org.eclipse.ui.workbench/Eclipse UI/org/eclipse/ui/commands/ICommand.java;3;1;33;1;3;3;3;30;336;2;23;1119;1678;1678;2;7;0;30;33;1135;7;6338;26;3;
/org.eclipse.jdt.ui/ui refactoring/org/eclipse/jdt/internal/ui/refactoring/DescriptorManager.java;1;0;3;1;0;0;0;3;63;1;3;1033;63;63;1;0;0;3;3;1033;0;4965;3;1;
/org.eclipse.jdt.ui.tests.refactoring/resources/ExtractMethodWorkSpace/ExtractMethodTests/expression_in/A_test614.java;1;0;1;1;0;0;0;1;2;0;1;844;2;2;1;0;0;1;1;844;0;844;1;1;
/org.eclipse.jdt.core.tests.model/workspace/Converter/test0046/Test.java;1;0;1;1;0;0;0;1;0;0;1;3714;0;0;1;0;0;1;1;3714;0;3714;1;1;
/org.eclipse.ui.ide/src/org/eclipse/ui/views/markers/internal/FieldDone.java;2;0;3;1;1;1;1;2;56;1;2;2208;91;91;1;0;0;2;3;2208;0;6341;3;2;
/org.eclipse.ui.views/src/org/eclipse/ui/views/progress/ProgressTreeViewer.java;1;0;1;1;0;0;0;1;0;0;1;748;0;0;1;0;0;1;1;748;0;748;1;1;
/org.eclipse.ui.tests/Eclipse UI Tests/org/eclipse/ui/tests/api/IEditorActionBarContributorTest.java;1;0;2;1;0;0;0;2;3;1;2;2738;6;6;1;0;0;2;2;2738;0;3091;2;1;
/org.eclipse.jdt.core.tests.model/workspace/Converter/test0471/A.java;1;0;2;1;0;0;0;2;0;1;2;787;0;0;1;0;0;2;2;787;0;3714;2;1;
/org.eclipse.jdt.core/compiler/org/eclipse/jdt/internal/compiler/ast/AssertStatement.java;3;0;8;1;0;0;0;8;34;1;8;41;113;113;1;0;0;8;8;41;0;5042;8;3;
/org.eclipse.jdt.ui/ui refactoring/org/eclipse/jdt/internal/ui/refactoring/InlineConstantWizard.java;3;0;5;1;1;1;1;4;102;1;4;518;116;116;1;0;0;4;5;518;0;6340;5;3;
/org.eclipse.webdav/src/kernel/org/eclipse/webdav/internal/kernel/IDocumentFactory.java;1;0;1;1;1;1;1;0;4;0;0;5151;4;4;1;0;0;0;1;5151;0;5151;1;1;
/org.eclipse.ant.ui/Ant Tools Support/org/eclipse/ant/ui/internal/launchConfigurations/MessageIds.java;1;0;2;1;0;0;0;2;0;1;2;1456;0;0;1;0;0;2;2;1456;0;1811;2;1;
/org.eclipse.jdt.core.tests.model/workspace/Converter/test0424/A.java;1;0;1;1;0;0;0;1;0;0;1;3714;0;0;1;0;0;1;1;3714;0;3714;1;1;
/org.eclipse.ui.views/src/org/eclipse/ui/views/markers/internal/MarkerFilter.java;2;0;2;1;0;0;0;2;0;1;2;755;0;0;1;0;0;2;2;755;0;2738;2;2;
/org.eclipse.ui.tests/Eclipse UI Tests/org/eclipse/ui/tests/dynamicplugins/PerspectiveTests.java;1;0;2;1;1;1;1;1;89;0;1;4969;89;89;1;0;0;1;2;4969;0;6081;2;1;
/org.eclipse.jdt.core/compiler/org/eclipse/jdt/internal/compiler/parser/RecoveredImport.java;3;0;3;1;0;0;0;3;6;1;3;1043;12;12;1;0;0;3;3;1043;0;3560;3;3;
/org.eclipse.swt/Eclipse SWT/common/org/eclipse/swt/layout/FillLayout.java;2;0;5;1;1;1;1;4;78;1;4;398;118;118;1;0;0;4;5;398;0;6352;5;2;
/org.eclipse.jdt.text.tests/src/org/eclipse/jdt/ui/tests/comments/CommentFormatterUtil.java;1;1;3;1;2;2;2;1;2;0;1;5082;2;2;1;0;0;1;3;5082;0;5130;3;1;
/org.eclipse.jdt.ui.tests.refactoring/resources/ExtractMethodWorkSpace/ExtractMethodTests/semicolon_in/A_test409.java;1;0;1;1;0;0;0;1;4;0;1;844;4;4;1;0;0;1;1;844;0;844;1;1;
/org.eclipse.ui.ide/src/org/eclipse/ui/actions/RenameResourceAction.java;2;0;4;1;0;0;0;4;36;1;4;1511;46;46;1;0;0;4;4;1511;0;2263;4;2;
/org.eclipse.ui.workbench/Eclipse UI/org/eclipse/ui/internal/commands/api/IActivityBinding.java;1;0;2;1;0;0;0;2;2;0;1;2562;2;2;2;1;0;2;2;2562;1;2562;1;1;
/org.eclipse.webdav/src/kernel/org/eclipse/webdav/internal/kernel/utils/Assert.java;1;0;2;1;2;1;2;0;117;0;0;5151;117;117;2;0;1;0;2;5151;1;5151;1;1;
/org.eclipse.ui.ide/src/org/eclipse/ui/views/markers/internal/ProblemView.java;5;1;8;1;3;3;3;5;39;2;4;3260;54;54;2;1;0;5;8;3260;1;6338;7;5;
/org.eclipse.jdt.core.tests.model/workspace/Converter/test0233/Test.java;1;0;1;1;0;0;0;1;0;0;1;3714;0;0;1;0;0;1;1;3714;0;3714;1;1;
/org.eclipse.jdt.core.tests.model/workspace/Converter/test0491/A.java;1;0;2;1;0;0;0;2;0;1;2;1908;0;0;1;0;0;2;2;1908;0;3714;2;1;
/org.eclipse.team.ui/src/org/eclipse/team/ui/synchronize/TeamSubscriberParticipant.java;1;0;6;1;0;0;0;6;152;1;6;2535;238;238;1;0;0;6;6;2535;0;4216;6;1;
/org.eclipse.jdt.debug.jdi.tests/tests/org/eclipse/debug/jdi/tests/program/TestClass.java;1;0;1;1;1;1;1;0;3;0;0;6339;3;3;1;0;0;0;1;6339;0;6339;1;1;
/org.eclipse.ui.views/src/org/eclipse/ui/views/navigator/MainActionGroup.java;2;0;2;1;0;0;0;2;49;1;2;66;49;49;1;0;0;2;2;66;0;2738;2;2;
/org.eclipse.ui.ide/src/org/eclipse/ui/internal/ide/AboutBundleData.java;2;0;2;1;1;1;1;1;0;0;1;4936;0;0;1;0;0;1;2;4936;0;5483;2;2;
/org.eclipse.update.core/src/org/eclipse/update/internal/core/BaseSiteLocalFactory.java;1;0;1;1;0;0;0;1;2;0;1;890;2;2;1;0;0;1;1;890;0;890;1;1;
/org.eclipse.update.configurator/src/org/eclipse/update/internal/configurator/branding/IProductConstants.java;1;1;3;1;2;2;2;1;6;0;1;4502;7;7;1;0;0;1;3;4502;0;6036;3;1;
/org.eclipse.jdt.ui/ui/org/eclipse/jdt/internal/ui/preferences/CodeGenerationPreferencePage.java;1;0;1;1;0;0;0;1;0;0;1;4629;0;0;1;0;0;1;1;4629;0;4629;1;1;
/org.eclipse.debug.ui/ui/org/eclipse/debug/internal/ui/MultipleInputDialog.java;2;1;4;1;4;4;4;0;10;0;0;5205;22;22;1;0;0;0;4;5205;0;6336;4;2;
/org.eclipse.jdt.ui.tests.refactoring/test cases/org/eclipse/jdt/ui/tests/actions/AllTests.java;2;0;2;1;1;1;1;1;7;0;1;1111;9;9;1;0;0;1;2;1111;0;6340;2;2;
/org.eclipse.jdt.ui/ui/org/eclipse/jdt/internal/ui/callhierarchy/CallHierarchyLabelProvider.java;3;0;8;1;1;1;1;7;58;2;6;155;84;84;2;1;0;7;8;169;1;6340;7;3;
/org.eclipse.pde.ui/src/org/eclipse/pde/internal/ui/editor/site/SiteSourceOutlinePage.java;1;0;2;1;0;0;0;2;4;1;2;648;4;4;1;0;0;2;2;648;0;2311;2;1;
/org.eclipse.help/src/org/eclipse/help/internal/workingset/AdaptableToc.java;1;0;1;1;0;0;0;1;0;0;1;2732;0;0;1;0;0;1;1;2732;0;2732;1;1;
/org.eclipse.ltk.ui.refactoring/src/org/eclipse/ltk/ui/refactoring/UndoRefactoringAction.java;1;1;2;1;2;2;2;0;2;0;0;5355;2;2;1;0;0;0;2;5355;0;6340;2;1;
/org.eclipse.ui.workbench/Eclipse UI/org/eclipse/ui/internal/csm/commands/api/IActivityBinding.java;1;0;2;1;0;0;0;2;0;1;2;2533;0;0;1;0;0;2;2;2533;0;2562;2;1;
/org.eclipse.jdt.core.tests.model/workspace/Converter/src/test0375/A.java;1;0;1;1;0;0;0;1;0;0;1;3714;0;0;1;0;0;1;1;3714;0;3714;1;1;
/org.eclipse.pde.ui/src/org/eclipse/pde/internal/ui/feature/BaseBuildAction.java;1;0;13;1;0;0;0;13;32;2;12;648;89;89;2;1;0;13;13;2642;1;3840;12;1;
/org.eclipse.ui.views/src/org/eclipse/ui/views/internal/markers/IMarkerResourceAdapter.java;1;0;2;1;0;0;0;2;0;1;2;265;0;0;1;0;0;2;2;265;0;755;2;1;
/org.eclipse.core.tools/src/org/eclipse/core/tools/runtime/ActivePluginsView.java;1;0;1;1;1;1;1;0;0;0;0;6302;0;0;1;0;0;0;1;6302;0;6302;1;1;
/org.eclipse.ui.examples.job/src/org/eclipse/ui/examples/jobs/views/ProgressExampleAdapterFactory.java;1;0;1;1;1;1;1;0;0;0;0;5126;0;0;1;0;0;0;1;5126;0;5126;1;1;
/org.eclipse.jdt.ui/ui/org/eclipse/jdt/internal/ui/search/ElementNameSorter.java;3;1;3;1;2;2;2;1;35;0;1;3251;39;39;1;0;0;1;3;3251;0;6340;3;3;
/org.eclipse.osgi/osgi/src/org/osgi/framework/BundleContext.java;3;0;4;1;1;1;1;3;169;1;3;3013;221;221;1;0;0;3;4;3013;0;5536;4;3;
/org.eclipse.jdt.ui/core refactoring/org/eclipse/jdt/internal/corext/refactoring/participants/RenameProcessorElement.java;1;0;2;1;0;0;0;2;0;1;2;591;0;0;1;0;0;2;2;591;0;825;2;1;
/org.eclipse.swt.graphics.text/Eclipse SWT PI/win32/org/eclipse/swt/internal/win32/OS.java;1;0;1;1;0;0;0;1;0;0;1;2985;0;0;1;0;0;1;1;2985;0;2985;1;1;
/org.eclipse.ui.workbench/Eclipse UI/org/eclipse/ui/internal/NavigationHistoryEditorInfo.java;1;0;1;1;0;0;0;1;3;0;1;2737;3;3;1;0;0;1;1;2737;0;2737;1;1;
/org.eclipse.jdt.core.tests.model/workspace/Converter/src/test0003/Test.java;1;0;1;1;0;0;0;1;0;0;1;3714;0;0;1;0;0;1;1;3714;0;3714;1;1;
/org.eclipse.core.tests.resources/src/org/eclipse/core/tests/resources/usecase/SnapshotTest.java;1;0;2;1;2;1;2;0;81;0;0;5147;81;81;2;0;1;0;2;5147;1;5147;1;1;
/org.eclipse.pde.ui/src/org/eclipse/pde/internal/ui/wizards/SourceAttachmentDialog.java;1;0;1;1;1;1;1;0;0;0;0;5348;0;0;1;0;0;0;1;5348;0;5348;1;1;
/org.eclipse.jdt.core/model/org/eclipse/jdt/internal/core/SetClasspathOperation.java;3;2;25;2;3;2;3;22;76;3;19;13;387;387;3;3;1;22;25;4323;4;5728;21;3;
/org.eclipse.update.ui.win32/src/org/eclipse/welcome/internal/webbrowser/WebBrowserEditorInputFactory.java;1;0;1;1;0;0;0;1;0;0;1;907;0;0;1;0;0;1;1;907;0;907;1;1;
/org.eclipse.debug.ui/ui/org/eclipse/debug/internal/ui/views/memory/PrintViewTabContextAction.java;1;0;1;1;1;1;1;0;0;0;0;5254;0;0;1;0;0;0;1;5254;0;5254;1;1;
/org.eclipse.jdt.ui.tests.refactoring/test cases/org/eclipse/jdt/ui/tests/nls/NLSHolderTest.java;2;1;5;1;5;5;5;0;74;0;0;5186;99;99;1;0;0;0;5;5186;0;6340;5;2;
/org.eclipse.ui.cheatsheets/src/org/eclipse/ui/internal/cheatsheets/data/AbstractSubItem.java;1;0;1;1;1;1;1;0;0;0;0;5620;0;0;1;0;0;0;1;5620;0;5620;1;1;
/org.eclipse.jdt.core/model/org/eclipse/jdt/internal/core/CompilationUnitVisitor.java;4;0;8;1;0;0;0;8;11;1;8;1892;37;37;1;0;0;8;8;1892;0;4731;8;4;
/org.eclipse.jdt.core.tests.model/workspace/Formatter/test112/A_in.java;1;0;1;1;0;0;0;1;0;0;1;2425;0;0;1;0;0;1;1;2425;0;2425;1;1;
/org.eclipse.jdt.debug.tests/tests/org/eclipse/jdt/debug/tests/eval/FloatOperatorsTests.java;1;0;1;1;0;0;0;1;160;0;1;1274;160;160;1;0;0;1;1;1274;0;1274;1;1;
/org.eclipse.team.cvs.ui/src/org/eclipse/team/internal/ccvs/ui/wizards/KSubstWizardSelectionPage.java;1;0;1;1;0;0;0;1;2;0;1;2381;2;2;1;0;0;1;1;2381;0;2381;1;1;
/org.eclipse.jdt.ui/ui/org/eclipse/jdt/internal/ui/typehierarchy/MethodsLabelProvider.java;2;0;6;1;1;1;1;5;11;1;5;435;22;22;1;0;0;5;6;435;0;6340;6;2;
/org.eclipse.ui.workbench/Eclipse UI/org/eclipse/ui/internal/presentations/PaneFolder.java;3;3;18;2;18;13;18;0;97;0;0;5263;336;336;3;0;5;0;18;5917;5;6017;13;3;
/org.eclipse.jdt.core/model/org/eclipse/jdt/core/jdom/DOMFactory.java;1;0;3;1;1;1;1;2;6;1;2;1806;12;12;1;0;0;2;3;1806;0;5584;3;1;
/org.eclipse.jdt.ui.tests.refactoring/resources/MoveMembers/test38/out/B.java;1;0;1;1;0;0;0;1;0;0;1;2093;0;0;1;0;0;1;1;2093;0;2093;1;1;
/org.eclipse.ui.workbench/Eclipse UI/org/eclipse/ui/internal/contexts/IMutableContextManager.java;2;2;3;1;3;2;3;0;6;0;0;5273;10;10;2;0;1;0;3;5273;1;6338;2;2;
/org.eclipse.jdt.ui/core refactoring/org/eclipse/jdt/internal/corext/refactoring/code/ParameterData.java;2;0;2;1;1;1;1;1;14;0;1;597;16;16;1;0;0;1;2;597;0;6340;2;2;
/org.eclipse.jdt.ui.tests.refactoring/resources/ChangeSignature/canModify/A_testAll60_out.java;1;0;2;1;1;1;1;1;1;0;1;4486;1;1;1;0;0;1;2;4486;0;5612;2;1;
/org.eclipse.jdt.core/dom/org/eclipse/jdt/core/dom/ConstructorInvocation.java;3;2;9;1;3;2;3;6;88;1;6;3560;191;191;2;0;1;6;9;5268;1;5335;8;3;
/org.eclipse.jdt.ui/core refactoring/org/eclipse/jdt/internal/corext/refactoring/code/flow/LocalFlowInfo.java;2;0;2;1;1;1;1;1;9;0;1;189;11;11;1;0;0;1;2;189;0;6340;2;2;
/org.eclipse.team.ui/src/org/eclipse/team/ui/synchronize/ISynchronizeModelElement.java;1;1;3;1;2;2;2;1;81;0;1;4632;85;85;1;0;0;1;3;4632;0;6337;3;1;
/org.eclipse.team.ftp/src/org/eclipse/team/internal/ftp/ui/subscriber/FTPSynchronizeWizard.java;2;1;4;1;4;4;4;0;42;0;0;5534;52;52;1;0;0;0;4;5534;0;5940;4;2;
/org.eclipse.jdt.debug.ui/ui/org/eclipse/jdt/internal/debug/ui/jres/JREContainerWizardPage.java;3;1;9;1;2;2;2;7;37;3;5;1063;113;113;3;2;0;7;9;1063;2;6336;7;3;
/org.eclipse.jdt.core.tests.model/workspace/Formatter/test265/A_out.java;1;0;1;1;0;0;0;1;0;0;1;2442;0;0;1;0;0;1;1;2442;0;2442;1;1;
/org.eclipse.pde.build/src/org/eclipse/pde/internal/build/ant/AntScript.java;2;1;11;1;4;4;4;7;1099;1;7;447;5580;5580;1;0;0;7;11;447;0;6083;11;2;
/org.eclipse.jdt.debug.tests/tests/org/eclipse/jdt/debug/tests/core/StepFilterTests.java;2;0;2;1;1;1;1;1;52;0;1;3614;56;56;1;0;0;1;2;3614;0;6337;2;2;
/org.eclipse.update.ui/src/org/eclipse/update/internal/ui/properties/InstallConfigurationPropertyPage.java;1;1;2;1;2;2;2;0;10;0;0;6210;10;10;1;0;0;0;2;6210;0;6336;2;1;
/org.eclipse.jdt.core/model/org/eclipse/jdt/core/JavaModelException.java;2;0;4;1;0;0;0;4;23;1;4;1330;45;45;1;0;0;4;4;1330;0;4929;4;2;
/org.eclipse.jdt.core.tests.compiler/src/org/eclipse/jdt/core/tests/compiler/parser/SelectionTest.java;3;0;4;1;1;1;1;3;186;1;3;991;221;221;1;0;0;3;4;991;0;5731;4;3;
/org.eclipse.debug.ui/ui/org/eclipse/debug/internal/ui/sourcelookup/SourceElementAdapterFactory.java;1;0;1;1;0;0;0;1;0;0;1;4609;0;0;1;0;0;1;1;4609;0;4609;1;1;
/org.eclipse.debug.ui/ui/org/eclipse/debug/internal/ui/actions/OpenBreakpointMarkerAction.java;3;1;5;1;2;2;2;3;17;1;3;1610;46;46;1;0;0;3;5;1610;0;5313;5;3;
/org.eclipse.pde.ui/src_Forms/org/eclipse/pde/internal/ui/model/IDocumentNode.java;2;1;12;1;5;5;5;7;30;1;7;4438;93;93;1;0;0;7;12;4438;0;6336;12;2;
/org.eclipse.jdt.ui.examples.javafamily/src/org/eclipse/jsp/JspMessages.java;1;0;1;1;1;1;1;0;0;0;0;5607;0;0;1;0;0;0;1;5607;0;5607;1;1;
/org.eclipse.ui.workbench/Eclipse UI/org/eclipse/ui/internal/WWinPluginPulldown.java;4;1;4;1;3;3;3;1;167;0;1;45;179;179;1;0;0;1;4;45;0;6338;4;4;
/org.eclipse.debug.ui/ui/org/eclipse/debug/internal/ui/views/variables/StatusLineContributionItem.java;1;0;1;1;0;0;0;1;0;0;1;4456;0;0;1;0;0;1;1;4456;0;4456;1;1;
/org.eclipse.jdt.core/formatter/org/eclipse/jdt/internal/formatter/CodeFormatter.java;3;0;6;1;0;0;0;6;64;1;6;306;99;99;1;0;0;6;6;306;0;3673;6;3;
/org.eclipse.releng.tools/src/org/eclipse/releng/tools/PropertiesFile.java;1;1;2;1;2;2;2;0;4;0;0;5183;4;4;1;0;0;0;2;5183;0;6340;2;1;
/org.eclipse.jdt.core/compiler/org/eclipse/jdt/internal/compiler/util/SimpleNameVector.java;1;0;1;1;0;0;0;1;2;0;1;3560;2;2;1;0;0;1;1;3560;0;3560;1;1;
/org.eclipse.ant.ui/Ant Editor/org/eclipse/ant/internal/ui/editor/text/PartiallySynchronizedDocument.java;1;0;6;1;1;1;1;5;52;2;4;1811;90;90;2;1;0;5;6;4333;1;5343;5;1;
/org.eclipse.ui.workbench/Eclipse UI/org/eclipse/ui/internal/AbstractSelectionService.java;3;1;4;1;2;2;2;2;22;1;2;549;43;43;1;0;0;2;4;549;0;6338;4;3;
/org.eclipse.search/search/org/eclipse/search/internal/ui/text/NewTextSearchActionGroup.java;2;1;5;1;2;2;2;3;106;1;3;3458;128;128;1;0;0;3;5;3458;0;6340;5;2;
/org.eclipse.ui.views/src/org/eclipse/ui/views/markers/internal/FieldPriority.java;2;0;2;1;0;0;0;2;0;1;2;755;0;0;1;0;0;2;2;755;0;2738;2;2;
/org.eclipse.jface.text/src/org/eclipse/jface/text/formatter/IFormattingStrategy.java;1;0;2;1;1;1;1;1;2;0;1;3896;4;4;1;0;0;1;2;3896;0;6340;2;1;
/org.eclipse.ui.ide/src/org/eclipse/ui/views/tasklist/PurgeCompletedAction.java;1;0;1;1;0;0;0;1;0;0;1;2208;0;0;1;0;0;1;1;2208;0;2208;1;1;
/org.eclipse.jdt.ui/core refactoring/org/eclipse/jdt/internal/corext/refactoring/rename/RenameSourceFolderRefactoring.java;2;0;3;1;0;0;0;3;53;1;3;122;77;77;1;0;0;3;3;122;0;1125;3;2;
/org.eclipse.jdt.ui/core refactoring/org/eclipse/jdt/internal/corext/refactoring/changes/PackageReorgChange.java;3;0;6;1;1;1;1;5;32;2;4;596;49;49;2;1;0;5;6;596;1;6340;5;3;
/org.eclipse.update.core/src/org/eclipse/update/internal/model/DefaultPluginParser.java;2;1;4;1;2;2;2;2;20;1;2;890;38;38;1;0;0;2;4;890;0;6336;4;2;
/org.eclipse.jdt.core.tests.model/workspace/Formatter/test389/A_in.java;1;0;1;1;0;0;0;1;0;0;1;3172;0;0;1;0;0;1;1;3172;0;3172;1;1;
/org.eclipse.ui.externaltools/External Tools Base/org/eclipse/ui/externaltools/internal/variable/StringPromptExpander.java;1;0;2;1;0;0;0;2;0;1;2;245;0;0;1;0;0;2;2;245;0;321;2;1;
/org.eclipse.core.resources/src/org/eclipse/core/internal/resources/Container.java;3;1;9;1;6;6;6;3;461;1;3;4340;699;699;1;0;0;3;9;4340;0;6339;9;3;
/org.eclipse.jdt.ui.tests.refactoring/resources/DeleteSourceReference/test13/out/A.java;1;0;1;1;0;0;0;1;0;0;1;1652;0;0;1;0;0;1;1;1652;0;1652;1;1;
/org.eclipse.jdt.core.tests.model/workspace/Formatter/test001/A_in.java;1;0;1;1;0;0;0;1;0;0;1;2425;0;0;1;0;0;1;1;2425;0;2425;1;1;
/org.eclipse.compare/compare/org/eclipse/compare/CompareViewerPane.java;1;0;4;1;1;1;1;3;14;1;3;257;24;24;1;0;0;3;4;257;0;6322;4;1;
/org.eclipse.core.resources/src/org/eclipse/core/internal/indexing/IndexedStoreException.java;1;0;1;1;1;1;1;0;94;0;0;5146;94;94;1;0;0;0;1;5146;0;5146;1;1;
/org.eclipse.ui.workbench/Eclipse UI/org/eclipse/ui/commands/internal/ImageFactory.java;1;0;2;1;0;0;0;2;0;1;2;786;0;0;1;0;0;2;2;786;0;956;2;1;
/org.eclipse.team.ui/src/org/eclipse/team/internal/ui/sync/dialogs/PreferencePageContainerDialog.java;1;0;1;1;0;0;0;1;0;0;1;984;0;0;1;0;0;1;1;984;0;984;1;1;
/org.eclipse.jdt.core/compiler/org/eclipse/jdt/internal/compiler/lookup/SyntheticFieldBinding.java;1;0;1;1;0;0;0;1;2;0;1;3560;2;2;1;0;0;1;1;3560;0;3560;1;1;
/org.eclipse.jdt.core/codeassist/org/eclipse/jdt/internal/codeassist/impl/AssistOptions.java;3;0;3;1;0;0;0;3;149;1;3;1851;152;152;1;0;0;3;3;1851;0;3560;3;3;
/org.eclipse.swt/Eclipse SWT PI/motif/org/eclipse/swt/internal/motif/XSizeHints.java;2;0;2;1;1;1;1;1;4;0;1;4825;4;4;1;0;0;1;2;4825;0;6352;2;2;
/org.eclipse.jdt.core/dom/org/eclipse/jdt/core/dom/ASTConverter2.java;1;0;1;1;0;0;0;1;0;0;1;4371;0;0;1;0;0;1;1;4371;0;4371;1;1;
/org.eclipse.jdt.core.tests.model/workspace/Formatter/test471/A_out.java;1;0;1;1;0;0;0;1;0;0;1;3977;0;0;1;0;0;1;1;3977;0;3977;1;1;
/org.eclipse.ltk.core.refactoring/src/org/eclipse/ltk/core/refactoring/ChangeContext.java;1;0;2;1;0;0;0;2;0;1;2;4845;0;0;1;0;0;2;2;4845;0;4913;2;1;
/org.eclipse.ui.workbench/Eclipse UI/org/eclipse/ui/internal/commands/api/older/IKeySequenceBinding.java;1;0;2;1;0;0;0;2;0;0;1;2564;0;0;2;1;0;2;2;2564;1;2564;1;1;
/org.eclipse.core.tools.resources/src/org/eclipse/core/tools/metadata/MeteredInputStream.java;1;0;1;1;1;1;1;0;0;0;0;6302;0;0;1;0;0;0;1;6302;0;6302;1;1;
/org.eclipse.team.ftp/src/org/eclipse/team/internal/ftp/ui/ImportWizard.java;1;0;1;1;0;0;0;1;0;0;1;3240;0;0;1;0;0;1;1;3240;0;3240;1;1;
/org.eclipse.jdt.ui.tests.refactoring/resources/InlineMethodWorkspace/TestCases/argument_out/TestLiteralReferenceRead.java;1;0;1;1;0;0;0;1;4;0;1;845;4;4;1;0;0;1;1;845;0;845;1;1;
/org.eclipse.core.tests.runtime/src/org/eclipse/core/tests/plugintests/PrimaryFeaturePreferenceHelperTests.java;1;0;1;1;0;0;0;1;0;0;1;3014;0;0;1;0;0;1;1;3014;0;3014;1;1;
/org.eclipse.ui.internal.r21presentation/src/org/eclipse/ui/internal/r21presentation/presentations/R21BasicStackPresentation.java;5;2;12;1;12;11;12;0;105;0;0;5444;380;380;2;0;1;0;12;5468;1;6227;11;5;
/org.eclipse.jdt.debug.ui/ui/org/eclipse/jdt/internal/debug/ui/actions/EditDetailFormatterAction.java;1;0;1;1;0;0;0;1;4;0;1;1240;4;4;1;0;0;1;1;1240;0;1240;1;1;
/org.eclipse.ui.intro/src/org/eclipse/ui/intro/internal/html/HTMLElement.java;2;0;3;1;1;1;1;2;3;1;2;4429;3;3;1;0;0;2;3;4429;0;5115;3;2;
/org.eclipse.ant.tests.ui/Ant Editor Tests/org/eclipse/ui/externaltools/internal/ant/editor/support/TestTextCompletionProcessor.java;1;0;6;1;0;0;0;6;58;1;6;178;75;75;1;0;0;6;6;178;0;1274;6;1;
/org.eclipse.jdt.ui/core extension/org/eclipse/jdt/internal/corext/codemanipulation/AddUnimplementedConstructorsOperation.java;2;1;9;1;2;2;2;7;242;1;7;600;419;419;1;0;0;7;9;600;0;6340;9;2;
/org.eclipse.ant.ui/Ant Tools Support/org/eclipse/ant/internal/ui/preferences/AntClasspathContentProvider2.java;1;0;9;1;0;0;0;9;44;3;6;2182;136;136;3;3;0;9;9;2182;3;2550;6;1;
/org.eclipse.team.core/src/org/eclipse/team/internal/core/subscribers/BatchingLock.java;2;1;3;1;2;2;2;1;24;0;1;4349;26;26;1;0;0;1;3;4349;0;6336;3;2;
/org.eclipse.team.core/src/org/eclipse/team/core/subscribers/RemoteContentsCache.java;1;0;1;1;0;0;0;1;0;0;1;2780;0;0;1;0;0;1;1;2780;0;2780;1;1;
/org.eclipse.jdt.core.tests.model/workspace/Converter/test0353/Test.java;1;0;1;1;0;0;0;1;0;0;1;3714;0;0;1;0;0;1;1;3714;0;3714;1;1;
/org.eclipse.jdt.ui.tests.refactoring/resources/ExtractMethodWorkSpace/ExtractMethodTests/locals_out/A_test505.java;1;0;2;1;0;0;0;2;4;1;2;130;5;5;1;0;0;2;2;130;0;844;2;1;
/org.eclipse.jdt.ui/core refactoring/org/eclipse/jdt/internal/corext/refactoring/participants/xml/TypeExtension.java;1;0;5;1;0;0;0;5;163;1;5;2204;374;374;1;0;0;5;5;2204;0;4108;5;1;
/org.eclipse.jdt.core.tests.model/workspace/Converter/src/javadoc/testBug51650/X.java;1;0;1;1;0;0;0;1;0;0;1;3994;0;0;1;0;0;1;1;3994;0;3994;1;1;
/org.eclipse.update.core/srcnew/org/eclipse/update/operations/OperationsManager.java;1;0;5;1;0;0;0;5;20;1;5;617;38;38;1;0;0;5;5;617;0;825;5;1;
/org.eclipse.jface.text/src/org/eclipse/jface/text/IDocumentAdapterExtension.java;2;1;2;1;2;2;2;0;19;0;0;6340;21;21;1;0;0;0;2;6340;0;6359;2;2;
/org.eclipse.jdt.core.tests.model/src/org/eclipse/jdt/core/tests/model/RootManipulationsTests.java;2;1;9;1;2;2;2;7;70;1;7;1046;178;178;1;0;0;7;9;1046;0;6141;9;2;
/org.eclipse.jdt.core.tests.model/workspace/Formatter/test019/A_1_out.java;1;0;1;1;0;0;0;1;0;0;1;2425;0;0;1;0;0;1;1;2425;0;2425;1;1;
/org.eclipse.search/search/org/eclipse/search/internal/ui/text/TextSearchOperation.java;2;1;6;1;3;3;3;3;40;1;3;2888;65;65;1;0;0;3;6;2888;0;6340;6;2;
/org.eclipse.debug.core/core/org/eclipse/debug/core/model/IStreamMonitor.java;2;0;2;1;0;0;0;2;3;1;2;2066;6;6;1;0;0;2;2;2066;0;2149;2;2;
/org.eclipse.jdt.ui.tests.refactoring/resources/ExtractMethodWorkSpace/ExtractMethodTests/return_out/A_test717.java;1;0;2;1;0;0;0;2;6;1;2;130;7;7;1;0;0;2;2;130;0;844;2;1;
/org.eclipse.update.core/src/org/eclipse/update/core/Verifier.java;2;1;3;1;2;2;2;1;6;0;1;890;12;12;1;0;0;1;3;890;0;6336;3;2;
/org.eclipse.team.core/src/org/eclipse/team/core/Team.java;2;2;15;2;6;5;6;9;119;1;9;276;347;347;2;0;1;9;15;6333;1;6333;14;2;
/org.eclipse.osgi/core/framework/org/eclipse/osgi/framework/eventmgr/EventListeners.java;3;1;5;1;2;2;2;3;153;1;3;3013;298;298;1;0;0;3;5;3013;0;5688;5;3;
/org.eclipse.jdt.core/compiler/org/eclipse/jdt/internal/compiler/flow/InitializationFlowContext.java;2;0;2;1;0;0;0;2;10;1;2;2974;12;12;1;0;0;2;2;2974;0;3560;2;2;
/org.eclipse.jdt.ui.tests.refactoring/resources/RenamePackage/testImportFromMultiRoots5/out/srcPrg/p/p/A.java;1;0;1;1;0;0;0;1;0;0;1;4105;0;0;1;0;0;1;1;4105;0;4105;1;1;
/org.eclipse.jdt.ui.tests.refactoring/resources/ExtractMethodWorkSpace/ExtractMethodTests/locals_in/A_test554.java;1;0;1;1;0;0;0;1;4;0;1;844;4;4;1;0;0;1;1;844;0;844;1;1;
/org.eclipse.jdt.ui/ui/org/eclipse/jdt/internal/ui/util/ExceptionHandler.java;1;0;1;1;1;1;1;0;2;0;0;6340;2;2;1;0;0;0;1;6340;0;6340;1;1;
/org.eclipse.ui.workbench/Eclipse UI/org/eclipse/ui/internal/commands/registry/KeyConfigurationDefinitionHandle.java;1;0;2;1;0;0;0;2;0;0;1;1396;0;0;2;1;0;2;2;1396;1;1396;1;1;
/org.eclipse.ant.ui/Ant Editor/org/eclipse/ant/internal/ui/dtd/schema/Element.java;1;0;1;1;0;0;0;1;0;0;1;1811;0;0;1;0;0;1;1;1811;0;1811;1;1;
/org.eclipse.core.expressions/src/org/eclipse/core/internal/expressions/OrExpression.java;1;0;2;1;1;1;1;1;8;0;1;4108;8;8;1;0;0;1;2;4108;0;6340;2;1;
/org.eclipse.jdt.ui.tests.refactoring/resources/RenameVirtualMethodInClass/test35/in/A.java;1;0;1;1;0;0;0;1;0;0;1;1653;0;0;1;0;0;1;1;1653;0;1653;1;1;
/org.eclipse.jdt.core/search/org/eclipse/jdt/core/search/TypeReferenceMatch.java;3;2;10;1;5;4;5;5;22;1;5;3913;93;93;2;0;1;5;10;5200;1;5912;9;3;
/org.eclipse.jdt.ui.tests.refactoring/resources/PasteSourceReference/test2/out/A.java;1;0;1;1;0;0;0;1;0;0;1;1311;0;0;1;0;0;1;1;1311;0;1311;1;1;
/org.eclipse.pde.ui/src/org/eclipse/pde/internal/ui/editor/manifest/XMLReconcilingStrategy.java;1;0;2;1;1;1;1;1;0;0;1;2320;0;0;1;0;0;1;2;2320;0;5431;2;1;
/org.eclipse.update.core/src/org/eclipse/update/internal/core/DefaultInstallHandler.java;2;2;4;1;3;2;3;1;16;0;1;890;30;30;2;0;1;1;4;5664;1;6336;3;2;
/org.eclipse.core.tools.resources/src/org/eclipse/core/tools/resources/ElementTreeView.java;1;0;1;1;1;1;1;0;0;0;0;6302;0;0;1;0;0;0;1;6302;0;6302;1;1;
/org.eclipse.jdt.ui.tests.refactoring/resources/IntroduceParameter/simple/Constructor1.java;1;0;1;1;1;1;1;0;0;0;0;5851;0;0;1;0;0;0;1;5851;0;5851;1;1;
/org.eclipse.jdt.core.tests.model/workspace/JavaSearch/src/j5/Bug49994.java;1;0;1;1;0;0;0;1;0;0;1;3917;0;0;1;0;0;1;1;3917;0;3917;1;1;
/org.eclipse.osgi/core/framework/org/eclipse/osgi/framework/internal/core/NullPackageSource.java;4;1;6;1;3;3;3;3;10;1;3;3013;25;25;1;0;0;3;6;3013;0;6337;6;4;
/org.eclipse.update.ui.forms/src/org/eclipse/ui/forms/internal/parts/FormUtil.java;1;0;2;1;0;0;0;2;0;1;2;3038;0;0;1;0;0;2;2;3038;0;3071;2;1;
/org.eclipse.jdt.ui.tests.refactoring/resources/IntroduceFactory/positive/multiUnit1B_FFF_out.java;1;0;2;1;0;0;0;2;0;1;2;2846;0;0;1;0;0;2;2;2846;0;2862;2;1;
/org.eclipse.ant.core/src/org/eclipse/ant/internal/core/AntClassLoader.java;1;2;7;1;3;2;3;4;40;1;4;283;94;94;2;0;1;4;7;5515;1;6336;6;1;
/org.eclipse.jdt.ui/ui/org/eclipse/jdt/internal/ui/typehierarchy/TypeHierarchyTransferDropAdapter.java;1;0;1;1;1;1;1;0;2;0;0;6340;2;2;1;0;0;0;1;6340;0;6340;1;1;
/org.eclipse.ui.intro/src/org/eclipse/ui/intro/internal/model/IntroElement.java;1;0;5;1;0;0;0;5;433;1;5;4429;438;438;1;0;0;5;5;4429;0;4898;5;1;
/org.eclipse.jdt.ui.tests.refactoring/resources/Delete/testDeleteWithinCu20/out/A.java;1;0;1;1;0;0;0;1;0;0;1;710;0;0;1;0;0;1;1;710;0;710;1;1;
/org.eclipse.ui.workbench/Eclipse UI/org/eclipse/ui/commands/ICategory.java;3;1;13;1;2;2;2;11;110;2;9;1321;303;303;2;2;0;11;13;1417;2;6338;11;3;
/org.eclipse.jdt.core/compiler/org/eclipse/jdt/internal/compiler/parser/RecoveredInitializer.java;4;2;10;1;3;2;3;7;64;1;7;488;157;157;2;0;1;7;10;5405;1;5405;9;4;
/org.eclipse.jdt.core.tests.model/workspace/Formatter/test162/A_in.java;1;0;1;1;0;0;0;1;0;0;1;2425;0;0;1;0;0;1;1;2425;0;2425;1;1;
/org.eclipse.jdt.ui/ui/org/eclipse/jdt/internal/ui/search/JavaSearchPage.java;4;3;29;2;12;9;12;17;232;2;15;1350;909;909;3;2;3;17;29;5398;5;6340;24;4;
/org.eclipse.jface.text/src/org/eclipse/jface/text/source/TagHandlerFactory.java;1;0;2;1;1;1;1;1;0;0;1;1629;0;0;1;0;0;1;2;1629;0;5122;2;1;
/org.eclipse.jface.text/src/org/eclipse/jface/text/TextViewerHoverManager.java;3;1;12;1;4;4;4;8;60;1;8;692;259;259;1;0;0;8;12;692;0;6359;12;3;
/org.eclipse.ui.intro/src/org/eclipse/ui/intro/internal/parts/ContextHelpPart.java;2;0;5;1;1;1;1;4;549;1;4;4429;556;556;1;0;0;4;5;4429;0;5115;5;2;
/org.eclipse.update.core/src/org/eclipse/update/core/URLEntry.java;2;1;4;1;3;3;3;1;6;0;1;890;20;20;1;0;0;1;4;890;0;6336;4;2;
/org.eclipse.pde.ui/src_Forms/org/eclipse/pde/internal/ui/neweditor/manifest/JavaAttributeWizard.java;2;1;5;1;3;3;3;2;107;1;2;4952;192;192;1;0;0;2;5;4952;0;5431;5;2;
/org.eclipse.ui.examples.rcp.browser/src/org/eclipse/ui/examples/rcp/browser/HistoryView.java;1;0;1;1;1;1;1;0;0;0;0;6169;0;0;1;0;0;0;1;6169;0;6169;1;1;
/org.eclipse.jdt.core.tests.model/workspace/Converter/junit/framework/ComparisonFailure.java;1;0;2;1;0;0;0;2;0;1;2;787;0;0;1;0;0;2;2;787;0;3714;2;1;
/org.eclipse.ui.ide/src/org/eclipse/ui/actions/CreateFileAction.java;2;0;5;1;0;0;0;5;15;1;5;1511;20;20;1;0;0;5;5;1511;0;2263;5;2;
/org.eclipse.ui.workbench/Eclipse UI/org/eclipse/ui/contexts/ContextEvent.java;4;1;7;1;2;2;2;5;196;1;5;1119;359;359;1;0;0;5;7;1119;0;6338;7;4;
/org.eclipse.webdav/src/kernel/org/eclipse/webdav/internal/kernel/ServerException.java;1;0;1;1;1;1;1;0;41;0;0;5151;41;41;1;0;0;0;1;5151;0;5151;1;1;
/org.eclipse.jdt.ui/ui/org/eclipse/jdt/internal/ui/text/template/contentassist/TemplateEngine.java;4;1;8;2;2;2;2;6;12;2;5;4258;34;34;2;1;0;6;8;4422;1;6340;7;4;
/org.eclipse.jdt.core/search/org/eclipse/jdt/internal/core/search/matching/MatchingOpenable.java;1;0;1;1;0;0;0;1;0;0;1;77;0;0;1;0;0;1;1;77;0;77;1;1;
/org.eclipse.ui.workbench/Eclipse UI/org/eclipse/ui/internal/PartSite.java;6;1;43;2;3;3;3;40;70;4;29;689;604;604;4;11;0;40;43;768;11;6338;32;6;
/org.eclipse.update.ui/srcnew/org/eclipse/update/internal/ui/GoToWebsiteAction.java;3;0;7;2;0;0;0;7;18;3;4;699;25;25;3;3;0;7;7;699;3;824;4;3;
/org.eclipse.ui.ide/extensions/org/eclipse/ui/actions/WorkspaceModifyOperation.java;4;1;4;1;2;2;2;2;35;1;2;2263;45;45;1;0;0;2;4;2263;0;6338;4;4;
/org.eclipse.jdt.ui.tests.refactoring/resources/ExtractMethodWorkSpace/ExtractMethodTests/expression_out/A_test605.java;1;0;3;1;0;0;0;3;4;1;3;844;4;4;1;0;0;3;3;844;0;1474;3;1;
/org.eclipse.core.runtime/src/org/eclipse/core/internal/dependencies/ResolutionDelta.java;2;0;2;1;0;0;0;2;0;1;2;2105;0;0;1;0;0;2;2;2105;0;3013;2;2;
/org.eclipse.ui.workbench/Eclipse UI/org/eclipse/ui/internal/themes/GradientDefinition.java;1;0;3;1;0;0;0;3;3;1;3;4392;3;3;1;0;0;3;3;4392;0;4560;3;1;
/org.eclipse.update.configurator/src/org/eclipse/update/internal/configurator/PluginParser.java;2;0;4;1;1;1;1;3;31;1;3;3265;56;56;1;0;0;3;4;3265;0;5616;4;2;
/org.eclipse.jdt.core.tests.model/workspace/Formatter/test165/A_out.java;1;0;2;1;0;0;0;2;2;1;2;2425;2;2;1;0;0;2;2;2425;0;2462;2;1;
/org.eclipse.help/src/org/eclipse/help/internal/DefaultHelpSupport.java;1;0;6;1;0;0;0;6;84;1;6;113;297;297;1;0;0;6;6;113;0;2732;6;1;
/org.eclipse.jdt.ui.tests.refactoring/test cases/org/eclipse/jdt/ui/tests/all/AllAllTests.java;4;1;9;1;4;4;4;5;4;1;5;456;17;17;1;0;0;5;9;456;0;6340;9;4;
/org.eclipse.debug.core/core/org/eclipse/debug/internal/core/variables/LaunchVariable.java;2;0;3;1;0;0;0;3;2;1;3;886;2;2;1;0;0;3;3;886;0;2120;3;2;
/org.eclipse.team.tests.core/src/org/eclipse/team/tests/core/TargetProviderTests.java;1;0;1;1;0;0;0;1;0;0;1;2495;0;0;1;0;0;1;1;2495;0;2495;1;1;
/org.eclipse.update.ui/src/org/eclipse/update/internal/ui/forms/LocalSiteForm.java;1;0;1;1;0;0;0;1;0;0;1;755;0;0;1;0;0;1;1;755;0;755;1;1;
/org.eclipse.pde.core/src/org/eclipse/pde/internal/core/osgi/bundle/WorkspaceBundleModel.java;1;0;3;1;1;1;1;2;5;1;2;4203;5;5;1;0;0;2;3;4203;0;5445;3;1;
/org.eclipse.osgi/core/adaptor/org/eclipse/osgi/util/ManifestElement.java;5;1;14;2;4;4;4;10;498;2;8;3216;754;754;2;2;0;10;14;4366;2;6337;12;5;
/org.eclipse.webdav/src/kernel/org/eclipse/webdav/internal/kernel/LocatorFactory.java;1;0;1;1;1;1;1;0;4;0;0;5151;4;4;1;0;0;0;1;5151;0;5151;1;1;
/org.eclipse.jdt.ui/ui/org/eclipse/jdt/internal/ui/wizards/dialogfields/ITreeListAdapter.java;1;0;1;1;1;1;1;0;2;0;0;6340;2;2;1;0;0;0;1;6340;0;6340;1;1;
/org.eclipse.text/src/org/eclipse/jface/text/link/ILinkedListener.java;1;0;3;1;2;1;2;1;10;0;1;4214;10;10;2;0;1;1;3;5127;1;5127;2;1;
/org.eclipse.team.ui/src/org/eclipse/team/ui/synchronize/views/SyncInfoDiffNodeSorter.java;1;0;1;1;0;0;0;1;0;0;1;3839;0;0;1;0;0;1;1;3839;0;3839;1;1;
/org.eclipse.search/new search/org/eclipse/search/ui/text/TextSearchResultFactory.java;1;0;2;1;0;0;0;2;0;1;2;3474;0;0;1;0;0;2;2;3474;0;3711;2;1;
/org.eclipse.swt/Eclipse SWT PI/gtk1x/org/eclipse/swt/internal/gtk/GDKPIXBUF.java;1;0;1;1;0;0;0;1;0;0;1;2327;0;0;1;0;0;1;1;2327;0;2327;1;1;
/org.eclipse.pde.junit.runtime/src/org/eclipse/pde/internal/junit/runtime/PdeJUnitPlugin.java;1;1;3;1;2;2;2;1;10;0;1;3483;12;12;1;0;0;1;3;3483;0;6336;3;1;
/org.eclipse.ui.workbench/Eclipse UI/org/eclipse/ui/internal/commands/api/IKeyConfigurationEvent.java;1;0;2;1;0;0;0;2;2;0;1;2562;2;2;2;1;0;2;2;2562;1;2562;1;1;
/org.eclipse.ui.ide/src/org/eclipse/ui/internal/TipsAndTricksAction.java;2;0;7;1;0;0;0;7;57;2;5;1520;126;126;2;2;0;7;7;1520;2;2263;5;2;
/org.eclipse.update.tests.core/src/org/eclipse/update/tests/standalone/TestFeatureUninstall.java;2;0;8;1;1;1;1;7;34;2;6;2491;43;43;2;1;0;7;8;2521;1;6336;7;2;
/org.eclipse.jdt.core.tests.model/workspace/Converter/test0380/A.java;1;0;1;1;0;0;0;1;0;0;1;3714;0;0;1;0;0;1;1;3714;0;3714;1;1;
/org.eclipse.update.ui.win32/src/org/eclipse/welcome/internal/ShowBrowserAction.java;1;0;2;1;0;0;0;2;0;1;2;892;0;0;1;0;0;2;2;892;0;907;2;1;
/org.eclipse.ui.workbench/Eclipse UI/org/eclipse/ui/keys/FormalKeyFormatter.java;2;0;4;1;0;0;0;4;15;1;4;3169;28;28;1;0;0;4;4;3169;0;3310;4;2;
/org.eclipse.compare/compare/org/eclipse/compare/IStreamContentAccessor.java;1;0;1;1;0;0;0;1;2;0;1;3935;2;2;1;0;0;1;1;3935;0;3935;1;1;
/org.eclipse.ui.workbench/Eclipse UI/org/eclipse/ui/internal/dialogs/EditorSelectionDialog.java;1;0;2;1;0;0;0;2;26;1;2;2737;48;48;1;0;0;2;2;2737;0;3308;2;1;
/org.eclipse.jdt.ui/ui/org/eclipse/jdt/internal/ui/typehierarchy/TypeHierarchyContentProvider.java;2;1;7;1;2;2;2;5;132;1;5;3111;282;282;1;0;0;5;7;3111;0;6340;7;2;
/org.eclipse.jdt.core.tests.builder/src/org/eclipse/jdt/core/tests/builder/BuildpathTests.java;3;1;9;1;3;3;3;6;250;3;4;2075;363;363;3;2;0;6;9;2075;2;6141;7;3;
/org.eclipse.ui.tests/Eclipse UI Tests/org/eclipse/ui/tests/api/StickyViewTest.java;1;1;4;1;4;4;4;0;117;0;0;5110;225;225;1;0;0;0;4;5110;0;5590;4;1;
/org.eclipse.ui.workbench/Eclipse UI/org/eclipse/ui/internal/presentation/PresentationRegistryPopulator.java;1;0;6;1;0;0;0;6;55;2;5;4235;65;65;2;1;0;6;6;4235;1;4392;5;1;
/org.eclipse.team.ui/src/org/eclipse/team/ui/sync/actions/RefreshAction.java;1;0;1;1;0;0;0;1;0;0;1;2451;0;0;1;0;0;1;1;2451;0;2451;1;1;
/org.eclipse.swt/Eclipse SWT PI/gtk/org/eclipse/swt/internal/gtk/GObjectClass.java;1;0;2;1;0;0;0;2;0;1;2;1102;0;0;1;0;0;2;2;1102;0;1214;2;1;
/org.eclipse.jdt.core/search/org/eclipse/jdt/core/search/FieldDeclarationMatch.java;2;1;8;1;3;3;3;5;23;1;5;3913;60;60;1;0;0;5;8;3913;0;5242;8;2;
/org.eclipse.jdt.ui/ui/org/eclipse/jdt/internal/ui/text/java/ParameterGuessingProposal.java;3;2;21;2;8;6;8;13;102;1;13;1214;374;374;2;0;2;13;21;5127;2;6340;19;3;
/org.eclipse.search/search/org/eclipse/search/internal/ui/RemoveMatchAction.java;1;0;1;1;1;1;1;0;2;0;0;6340;2;2;1;0;0;0;1;6340;0;6340;1;1;
/org.eclipse.ui.workbench/Eclipse UI/org/eclipse/ui/internal/csm/activities/PatternBinding.java;1;0;5;1;0;0;0;5;15;1;5;2297;35;35;1;0;0;5;5;2297;0;2444;5;1;
/org.eclipse.pde.core/src/org/eclipse/pde/internal/core/IModelChangedListenerFilter.java;2;1;2;1;2;2;2;0;4;0;0;5557;4;4;1;0;0;0;2;5557;0;6336;2;2;
/org.eclipse.jdt.core.tests.model/workspace/Converter/src/test0537/A.java;1;0;1;1;0;0;0;1;0;0;1;3873;0;0;1;0;0;1;1;3873;0;3873;1;1;
/org.eclipse.core.resources/src/org/eclipse/core/internal/resources/MarkerSnapshotReader_2.java;1;0;1;1;1;1;1;0;179;0;0;5146;179;179;1;0;0;0;1;5146;0;5146;1;1;
/org.eclipse.pde.ui/src/org/eclipse/pde/internal/ui/editor/site/NewCategoryDefinitionDialog.java;2;0;4;1;1;1;1;3;23;1;3;584;50;50;1;0;0;3;4;584;0;6336;4;2;
/org.eclipse.ui.workbench/Eclipse UI/org/eclipse/ui/internal/presentations/PartTabFolderSystemContribution.java;3;0;4;1;0;0;0;4;13;1;4;4504;20;20;1;0;0;4;4;4504;0;4680;4;3;
/org.eclipse.update.ui/src/org/eclipse/update/internal/ui/wizards/InstallWizardDialog.java;1;0;1;1;0;0;0;1;0;0;1;755;0;0;1;0;0;1;1;755;0;755;1;1;
/org.eclipse.jdt.debug/model/org/eclipse/jdt/internal/debug/core/StringMatcher.java;1;0;1;1;0;0;0;1;4;0;1;1296;4;4;1;0;0;1;1;1296;0;1296;1;1;
/org.eclipse.jdt.ui.tests.refactoring/resources/PasteSourceReference/test1/out/A.java;1;0;1;1;0;0;0;1;0;0;1;1311;0;0;1;0;0;1;1;1311;0;1311;1;1;
/org.eclipse.pde.ui/src/org/eclipse/pde/internal/ui/launcher/JUnitTabGroup.java;3;1;10;1;3;3;3;7;80;1;7;1343;171;171;1;0;0;7;10;1343;0;6053;10;3;
/org.eclipse.ui.workbench/Eclipse UI/org/eclipse/ui/internal/activities/IActivityPatternBindingDefinition.java;1;0;4;1;0;0;0;4;2;1;4;2444;2;2;1;0;0;4;4;2444;0;3066;4;1;
/org.eclipse.update.ui/src/org/eclipse/update/internal/ui/wizards/ResizableInstallWizardDialog.java;1;1;3;1;3;3;3;0;13;0;0;5767;19;19;1;0;0;0;3;5767;0;6336;3;1;
/org.eclipse.ui.workbench/Eclipse UI/org/eclipse/ui/internal/commands/older/ActionService.java;1;0;1;1;0;0;0;1;8;0;1;2562;8;8;1;0;0;1;1;2562;0;2562;1;1;
/org.eclipse.debug.ui/ui/org/eclipse/debug/ui/actions/IToggleBreakpointsTarget.java;1;0;2;1;1;1;1;1;3;0;1;4496;3;3;1;0;0;1;2;4496;0;5134;2;1;
/org.eclipse.jdt.core.tests.model/src/org/eclipse/jdt/core/tests/dom/ASTConverterTest.java;5;2;16;2;5;4;5;11;796;2;10;231;927;927;2;1;1;11;16;4167;2;5617;14;5;
/org.eclipse.update.ui.forms/Eclipse Forms/org/eclipse/ui/forms/widgets/SharedScrolledComposite.java;1;0;3;1;0;0;0;3;2;1;3;3733;2;2;1;0;0;3;3;3733;0;4157;3;1;
/org.eclipse.pde.core/srcnew/org/eclipse/pde/internal/core/plugin/IProblemRequestor.java;1;0;1;1;0;0;0;1;0;0;1;2906;0;0;1;0;0;1;1;2906;0;2906;1;1;
/org.eclipse.swt.tools/JNI Generation/org/eclipse/swt/tools/internal/CleanupNatives.java;2;0;2;1;0;0;0;2;7;1;2;4175;7;7;1;0;0;2;2;4175;0;4270;2;2;
/org.eclipse.ui.externaltools/Ant Editor/org/eclipse/ui/externaltools/internal/ant/editor/PlantyCompletionProcessor.java;1;0;1;1;0;0;0;1;0;0;1;178;0;0;1;0;0;1;1;178;0;178;1;1;
/org.eclipse.swt/Eclipse SWT PI/gtk1x/org/eclipse/swt/internal/gtk/GtkCTree.java;1;0;1;1;0;0;0;1;0;0;1;2327;0;0;1;0;0;1;1;2327;0;2327;1;1;
/org.eclipse.jdt.ui.tests/ui/org/eclipse/jdt/ui/tests/core/TypeHierarchyTest.java;2;1;6;1;2;2;2;4;234;1;4;2057;258;258;1;0;0;4;6;2057;0;6340;6;2;
/org.eclipse.update.ui/srcnew/org/eclipse/update/internal/ui/wizards/IDynamicPage2.java;1;0;2;1;0;0;0;2;0;1;2;367;0;0;1;0;0;2;2;367;0;488;2;1;
/org.eclipse.debug.ui/ui/org/eclipse/debug/internal/ui/sourcelookup/SourceElementWorkbenchAdapter.java;1;0;4;1;0;0;0;4;44;2;3;4609;59;59;2;1;0;4;4;4609;1;4949;3;1;
/org.eclipse.ui.tests/Eclipse RCP Tests/org/eclipse/ui/rcp/tests/WorkbenchAdvisorTest.java;1;0;3;1;0;0;0;3;16;2;2;4930;16;16;2;1;0;3;3;4952;1;4952;2;1;
/org.eclipse.jface.text/src/org/eclipse/jface/text/reconciler/CompositeReconcilingStrategy.java;1;0;2;1;1;1;1;1;0;0;1;3930;0;0;1;0;0;1;2;3930;0;5177;2;1;
/org.eclipse.debug.ui/ui/org/eclipse/debug/internal/ui/views/breakpoints/BreakpointsViewContentProvider.java;2;1;7;1;2;2;2;5;25;1;5;2645;86;86;1;0;0;5;7;2645;0;5313;7;2;
/org.eclipse.debug.ui/ui/org/eclipse/debug/internal/ui/BreakpointImageProvider.java;1;0;1;1;0;0;0;1;0;0;1;4850;0;0;1;0;0;1;1;4850;0;4850;1;1;
/org.eclipse.update.core/srcnew/org/eclipse/update/standalone/StandaloneUpdateApplication.java;1;0;3;1;0;0;0;3;22;1;3;646;22;22;1;0;0;3;3;646;0;825;3;1;
/org.eclipse.jdt.core/model/org/eclipse/jdt/internal/core/util/Dumper.java;2;0;2;1;1;1;1;1;2;0;1;3560;2;2;1;0;0;1;2;3560;0;5644;2;2;
/org.eclipse.ui.editors/src/org/eclipse/ui/editors/text/EditorsUI.java;3;3;11;1;8;5;8;3;90;2;2;3675;142;142;3;1;3;3;11;5501;4;6334;7;3;
/org.eclipse.team.webdav/src/org/eclipse/team/internal/ui/target/subscriber/GetAction.java;2;2;11;1;3;2;3;8;111;1;8;3499;240;240;2;0;1;8;11;5508;1;6337;10;2;
/org.eclipse.ui.externaltools/Ant Editor/org/eclipse/ui/externaltools/internal/ant/dtd/ParseError.java;1;0;1;1;0;0;0;1;0;0;1;282;0;0;1;0;0;1;1;282;0;282;1;1;
/org.eclipse.ui.editors/src/org/eclipse/ui/internal/editors/text/TextEditorMessages.java;1;0;1;1;1;1;1;0;2;0;0;6340;2;2;1;0;0;0;1;6340;0;6340;1;1;
/org.eclipse.debug.ui/ui/org/eclipse/debug/ui/EnvironmentVariableLabelProvider.java;1;0;2;1;0;0;0;2;0;1;2;265;0;0;1;0;0;2;2;265;0;278;2;1;
/org.eclipse.text/src/org/eclipse/text/edits/MalformedTreeException.java;2;1;4;1;2;2;2;2;4;1;2;1986;11;11;1;0;0;2;4;1986;0;6340;4;2;
/org.eclipse.jdt.core.tests.model/workspace/Formatter/test159/A_out.java;1;0;1;1;0;0;0;1;0;0;1;2425;0;0;1;0;0;1;1;2425;0;2425;1;1;
/org.eclipse.jdt.core.tests.model/workspace/Formatter/test236/A_in.java;1;0;1;1;0;0;0;1;0;0;1;2437;0;0;1;0;0;1;1;2437;0;2437;1;1;
/org.eclipse.webdav/src/interface/org/eclipse/webdav/dom/Mkworkspace.java;1;0;2;1;2;1;2;0;68;0;0;5151;68;68;2;0;1;0;2;5151;1;5151;1;1;
/org.eclipse.ui.workbench/Eclipse UI/org/eclipse/ui/internal/contexts/FileContextRegistry.java;1;0;5;1;0;0;0;5;4;2;4;1400;6;6;2;1;0;5;5;1400;1;2425;4;1;
/org.eclipse.jdt.ui.tests.refactoring/resources/ExtractMethodWorkSpace/ExtractMethodTests/duplicates_in/A_test952.java;1;0;3;1;0;0;0;3;0;1;3;1219;0;0;1;0;0;3;3;1219;0;1474;3;1;
/org.eclipse.jdt.core.tests.model/workspace/Converter/test0477/A.java;1;0;2;1;0;0;0;2;0;1;2;989;0;0;1;0;0;2;2;989;0;3714;2;1;
/org.eclipse.ui.workbench/Eclipse UI/org/eclipse/ui/activities/IActivityRequirementBinding.java;2;1;2;1;2;2;2;0;4;0;0;5760;4;4;1;0;0;0;2;5760;0;6338;2;2;
/org.eclipse.jdt.core.tests.builder/src/org/eclipse/jdt/core/tests/builder/JCLTests.java;1;0;1;1;0;0;0;1;0;0;1;989;0;0;1;0;0;1;1;989;0;989;1;1;
/org.eclipse.jdt.core.tests.model/workspace/Formatter/test057/A_in.java;1;0;1;1;0;0;0;1;0;0;1;2425;0;0;1;0;0;1;1;2425;0;2425;1;1;
/org.eclipse.pde.ui/src_Forms/org/eclipse/pde/internal/ui/neweditor/schema/SchemaDoubleClickStrategy.java;2;0;2;1;1;1;1;1;0;0;1;4856;0;0;1;0;0;1;2;4856;0;5431;2;2;
/org.eclipse.jdt.ui/ui refactoring/org/eclipse/jdt/internal/ui/refactoring/IChangePreviewViewer.java;1;0;3;1;0;0;0;3;4;1;3;1033;4;4;1;0;0;3;3;1033;0;4965;3;1;
/org.eclipse.jdt.ui/ui/org/eclipse/jdt/internal/ui/wizards/buildpaths/CPListElementAttribute.java;2;0;2;1;1;1;1;1;2;0;1;3404;3;3;1;0;0;1;2;3404;0;6340;2;2;
/org.eclipse.jdt.core.tests.model/workspace/Formatter/test323/A_in.java;1;0;1;1;0;0;0;1;0;0;1;2462;0;0;1;0;0;1;1;2462;0;2462;1;1;
/org.eclipse.jdt.debug.ui/ui/org/eclipse/jdt/internal/debug/ui/snippeteditor/SnippetEditorActionContributor.java;2;0;2;1;1;1;1;1;16;0;1;5068;20;20;1;0;0;1;2;5068;0;6336;2;2;
/org.eclipse.ui.ide/src/org/eclipse/ui/internal/ide/dialogs/ResourceTreeAndListGroup.java;5;2;5;2;4;3;4;1;18;0;1;2264;40;40;2;0;1;1;5;6338;1;6338;4;5;
/org.eclipse.pde.ui/src/org/eclipse/pde/internal/ui/editor/feature/PortabilitySection.java;3;1;9;1;5;5;5;4;303;1;4;217;393;393;1;0;0;4;9;217;0;6336;9;3;
/org.eclipse.jdt.core.tests.model/workspace/Formatter/test256/A_out.java;1;0;1;1;0;0;0;1;0;0;1;2442;0;0;1;0;0;1;1;2442;0;2442;1;1;
/org.eclipse.ant.ui/Ant Editor/org/eclipse/ant/internal/ui/editor/formatter/ContentFormatter3.java;1;0;5;1;1;1;1;4;7;2;3;3916;17;17;2;1;0;4;5;3916;1;5139;4;1;
/org.eclipse.update.core/src/org/eclipse/update/internal/security/KeystoreHandle.java;1;0;1;1;0;0;0;1;2;0;1;890;2;2;1;0;0;1;1;890;0;890;1;1;
/org.eclipse.jdt.core.tests.model/workspace/Formatter/test314/A_in.java;1;0;1;1;0;0;0;1;0;0;1;2444;0;0;1;0;0;1;1;2444;0;2444;1;1;
/org.eclipse.jdt.core/model/org/eclipse/jdt/internal/core/hierarchy/ChangeCollector.java;1;0;3;1;0;0;0;3;4;1;3;2236;6;6;1;0;0;3;3;2236;0;3560;3;1;
/org.eclipse.ui.workbench/Eclipse UI/org/eclipse/ui/contexts/NotDefinedException.java;4;1;11;1;2;2;2;9;28;1;9;1137;81;81;1;0;0;9;11;1137;0;6338;11;4;
/org.eclipse.core.resources/src/org/eclipse/core/internal/resources/ResourceSchedulingRule.java;1;0;3;1;0;0;0;3;41;1;3;1133;41;41;1;0;0;3;3;1133;0;1541;3;1;
/org.eclipse.jdt.text.tests/src/org/eclipse/jdt/ui/text/tests/JavaLineSegmentationTest.java;1;1;3;1;2;2;2;1;8;0;1;5082;8;8;1;0;0;1;3;5082;0;5129;3;1;
/org.eclipse.jdt.core.tests.model/workspace/Converter15/src/test0009/X.java;1;0;1;1;0;0;0;1;0;0;1;4651;0;0;1;0;0;1;1;4651;0;4651;1;1;
/org.eclipse.jdt.core.tests.model/workspace/Formatter/test398/A_out.java;1;0;1;1;0;0;0;1;0;0;1;3436;0;0;1;0;0;1;1;3436;0;3436;1;1;
/org.eclipse.jdt.ui.tests.refactoring/resources/MoveMembers/test13/out/B.java;1;0;1;1;0;0;0;1;1;0;1;1522;1;1;1;0;0;1;1;1522;0;1522;1;1;
/org.eclipse.team.ui/src/org/eclipse/team/ui/sync/actions/INavigableControl.java;1;0;1;1;0;0;0;1;0;0;1;2433;0;0;1;0;0;1;1;2433;0;2433;1;1;
/org.eclipse.pde.ui/src/org/eclipse/pde/internal/ui/editor/plugin/ManifestSourcePage.java;3;1;5;1;5;5;5;0;10;0;0;5431;24;24;1;0;0;0;5;5431;0;6336;5;3;
/org.eclipse.jdt.core/compiler/org/eclipse/jdt/internal/compiler/util/HashtableOfInt.java;2;0;2;1;0;0;0;2;2;1;2;3560;4;4;1;0;0;2;2;3560;0;4110;2;2;
/org.eclipse.ui.workbench/Eclipse UI/org/eclipse/ui/internal/csm/activities/IActivityRegistryEvent.java;1;0;3;1;0;0;0;3;18;1;3;2225;18;18;1;0;0;3;3;2225;0;2444;3;1;
/org.eclipse.jdt.core.tests.model/workspace/Converter/test0249/Test.java;1;0;1;1;0;0;0;1;0;0;1;3714;0;0;1;0;0;1;1;3714;0;3714;1;1;
/org.eclipse.ltk.core.refactoring/src/org/eclipse/ltk/core/refactoring/participants/ParticipantExtensionPoint.java;1;1;5;1;4;4;4;1;34;0;1;4913;53;53;1;0;0;1;5;4913;0;6340;5;1;
/org.eclipse.ui.ide/src/org/eclipse/ui/views/tasklist/GotoTaskAction.java;1;0;2;1;0;0;0;2;2;1;2;2208;2;2;1;0;0;2;2;2208;0;2264;2;1;
/org.eclipse.jdt.text.tests/src/org/eclipse/jdt/text/tests/JavaParameterListValidatorTest.java;1;1;2;1;2;2;2;0;2;0;0;5129;2;2;1;0;0;0;2;5129;0;6340;2;1;
/org.eclipse.core.tests.runtime/src/org/eclipse/core/tests/internal/plugins/PluginResolveTest_10.java;1;0;1;1;0;0;0;1;0;0;1;3014;0;0;1;0;0;1;1;3014;0;3014;1;1;
/org.eclipse.jface.text/src/org/eclipse/jface/text/source/SourceViewer.java;3;1;24;1;5;5;5;19;234;2;17;1347;885;885;2;2;0;19;24;2097;2;6361;22;3;
/org.eclipse.jdt.ui.tests.refactoring/resources/SefWorkSpace/SefTests/base_out/TestTwoFragments.java;1;0;1;1;0;0;0;1;0;0;1;4692;0;0;1;0;0;1;1;4692;0;4692;1;1;
/org.eclipse.debug.core/core/org/eclipse/debug/internal/core/sourcelookup/SourceContainerType.java;1;0;4;1;0;0;0;4;12;2;3;3678;18;18;2;1;0;4;4;4949;1;4949;3;1;
/org.eclipse.jdt.ui/core refactoring/org/eclipse/jdt/internal/corext/refactoring/rename/MethodChecks.java;4;0;7;1;1;1;1;6;18;1;6;42;59;59;1;0;0;6;7;42;0;6340;7;4;
/org.eclipse.debug.core/core/org/eclipse/debug/core/model/IWatchExpressionDelegate.java;3;1;5;1;2;2;2;3;22;2;2;1516;28;28;2;1;0;3;5;1538;1;6336;4;3;
/org.eclipse.swt.tests/JUnit Tests/org/eclipse/swt/tests/junit/Test_org_eclipse_swt_widgets_Item.java;3;0;3;1;0;0;0;3;91;1;3;2123;141;141;1;0;0;3;3;2123;0;2824;3;3;
/org.eclipse.team.ui/src/org/eclipse/team/ui/synchronize/ISynchronizeParticipantDescriptor.java;2;1;7;1;2;2;2;5;59;2;4;2628;134;134;2;1;0;5;7;2628;1;6337;6;2;
/org.eclipse.jdt.core.tests.model/workspace/Converter15/src/test0027/Coin.java;1;0;1;1;0;0;0;1;0;0;1;4856;0;0;1;0;0;1;1;4856;0;4856;1;1;
/org.eclipse.ui.ide/src/org/eclipse/ui/dialogs/MarkerResolutionSelectionDialog.java;2;0;3;1;0;0;0;3;12;1;3;1511;12;12;1;0;0;3;3;1511;0;2263;3;2;
/org.eclipse.jface.text/src/org/eclipse/jface/text/ITextViewerExtension.java;2;0;2;2;2;1;2;0;73;0;0;6340;73;73;2;0;1;0;2;6340;1;6340;1;2;
/org.eclipse.jface/src/org/eclipse/jface/action/SubCoolBarManager.java;2;0;2;1;0;0;0;2;19;1;2;3220;19;19;1;0;0;2;2;3220;0;3238;2;2;
/org.eclipse.ui.workbench/Eclipse UI/org/eclipse/ui/internal/progress/ProgressRegion.java;3;2;14;1;5;4;5;9;111;3;7;4305;429;429;3;2;1;9;14;4350;3;5737;11;3;
/org.eclipse.team.webdav/src/org/eclipse/team/internal/target/subscriber/TargetRefreshOperation.java;2;0;4;1;0;0;0;4;55;1;4;3494;89;89;1;0;0;4;4;3494;0;4259;4;2;
/org.eclipse.swt/Eclipse SWT/photon/org/eclipse/swt/widgets/ProgressBar.java;3;1;4;1;2;2;2;2;18;1;2;269;25;25;1;0;0;2;4;269;0;6352;4;3;
/org.eclipse.ltk.ui.refactoring/src/org/eclipse/ltk/internal/ui/refactoring/ErrorWizardPage.java;1;1;8;1;6;6;6;2;18;1;2;4965;52;52;1;0;0;2;8;4965;0;6340;8;1;
/org.eclipse.team.core/src/org/eclipse/team/core/sync/ITeamResourceChangeListener.java;1;0;1;1;0;0;0;1;0;0;1;431;0;0;1;0;0;1;1;431;0;431;1;1;
/org.eclipse.jdt.ui.tests/ui/org/eclipse/jdt/ui/tests/core/ScopeAnalyzerTest.java;3;1;16;1;4;4;4;12;241;2;11;223;668;668;2;1;0;12;16;299;1;6340;15;3;
/org.eclipse.jdt.core/model/org/eclipse/jdt/internal/core/JavaModelManager.java;3;2;63;3;17;13;17;46;330;3;38;27;2214;2214;3;8;4;46;63;78;12;6240;51;3;
/org.eclipse.jdt.core/model/org/eclipse/jdt/internal/compiler/ISourceElementRequestor.java;1;0;1;1;0;0;0;1;0;0;1;4461;0;0;1;0;0;1;1;4461;0;4461;1;1;
/org.eclipse.ui.workbench/Eclipse UI/org/eclipse/ui/commands/internal/Configuration.java;1;0;2;1;0;0;0;2;0;1;2;786;0;0;1;0;0;2;2;786;0;956;2;1;
/org.eclipse.jdt.debug.tests/tests/org/eclipse/jdt/debug/tests/eval/CharOperatorsTests.java;1;0;1;1;0;0;0;1;222;0;1;1274;222;222;1;0;0;1;1;1274;0;1274;1;1;
/org.eclipse.jdt.ui/ui/org/eclipse/jdt/internal/ui/text/correction/InsertCorrectionProposal.java;1;0;1;1;0;0;0;1;0;0;1;393;0;0;1;0;0;1;1;393;0;393;1;1;
/org.eclipse.jdt.core/model/org/eclipse/jdt/internal/core/util/AnnotationComponentValue.java;1;0;1;1;0;0;0;1;0;0;1;4466;0;0;1;0;0;1;1;4466;0;4466;1;1;
/org.eclipse.jdt.ui.tests.refactoring/resources/InlineMethodWorkspace/TestCases/argument_out/TestParameterNameUsed2.java;1;0;1;1;0;0;0;1;4;0;1;845;4;4;1;0;0;1;1;845;0;845;1;1;
/org.eclipse.jdt.debug/jdi/org/eclipse/jdi/TimeoutException.java;1;0;1;1;0;0;0;1;1;0;1;1296;1;1;1;0;0;1;1;1296;0;1296;1;1;
/org.eclipse.swt/Eclipse SWT Custom Widgets/common/org/eclipse/swt/custom/CTabFolderEvent.java;2;1;7;1;4;4;4;3;27;1;3;2729;118;118;1;0;0;3;7;2729;0;6352;7;2;
/org.eclipse.ui.ide/src/org/eclipse/ui/views/framelist/UpAction.java;3;0;4;1;1;1;1;3;4;1;3;2208;9;9;1;0;0;3;4;2208;0;6338;4;3;
/org.eclipse.jdt.core.tests.model/workspace/Converter/src/test0258/Test.java;1;0;1;1;0;0;0;1;0;0;1;3714;0;0;1;0;0;1;1;3714;0;3714;1;1;
/org.eclipse.update.ui.forms/Eclipse Forms/org/eclipse/ui/forms/widgets/ILayoutExtension.java;1;0;2;1;0;0;0;2;0;1;2;3138;0;0;1;0;0;2;2;3138;0;4157;2;1;
/org.eclipse.jdt.ui/ui/org/eclipse/jdt/internal/ui/text/correction/RemoveDeclarationCorrectionProposal.java;2;1;13;1;4;4;4;9;35;1;9;393;234;234;1;0;0;9;13;393;0;6340;13;2;
/org.eclipse.jdt.ui.tests.refactoring/resources/ExtractTemp/canExtract/A_test80_out.java;1;0;1;1;1;1;1;0;0;0;0;5909;0;0;1;0;0;0;1;5909;0;5909;1;1;
/org.eclipse.help/src/org/eclipse/help/internal/workingset/WorkingSetComparator.java;1;0;1;1;0;0;0;1;0;0;1;2732;0;0;1;0;0;1;1;2732;0;2732;1;1;
/org.eclipse.ltk.core.refactoring/src/org/eclipse/ltk/core/refactoring/participants/SharableParticipants.java;1;1;5;1;3;3;3;2;14;1;2;4845;21;21;1;0;0;2;5;4845;0;6340;5;1;
/org.eclipse.ui.workbench/Eclipse UI/org/eclipse/ui/internal/ChangeToPerspectiveMenu.java;4;0;5;1;1;1;1;4;24;1;4;2737;52;52;1;0;0;4;5;2737;0;6338;5;4;
/org.eclipse.core.runtime.osgi/src/org/eclipse/core/internal/runtime/PlatformMetaArea.java;1;0;2;1;0;0;0;2;344;1;2;3013;344;344;1;0;0;2;2;3013;0;3030;2;1;
/org.eclipse.debug.ui/ui/org/eclipse/debug/ui/variables/ResourceComponent.java;1;0;5;1;0;0;0;5;245;4;2;316;245;245;4;3;0;5;5;316;3;550;2;1;
/org.eclipse.ltk.ui.refactoring/src/org/eclipse/ltk/ui/refactoring/IChangePreviewViewer.java;1;1;5;1;2;2;2;3;25;1;3;4965;42;42;1;0;0;3;5;4965;0;6340;5;1;
/org.eclipse.ant.core/src/org/eclipse/ant/core/TargetInfo.java;1;0;1;1;0;0;0;1;10;0;1;2988;10;10;1;0;0;1;1;2988;0;2988;1;1;
/org.eclipse.team.webdav/src/org/eclipse/team/internal/core/target/RemoteTargetSyncElement.java;2;0;2;1;0;0;0;2;0;1;2;2495;0;0;1;0;0;2;2;2495;0;4216;2;2;
/org.eclipse.jdt.ui/ui/org/eclipse/jdt/internal/ui/wizards/dialogfields/IStringButtonAdapter.java;1;0;1;1;1;1;1;0;2;0;0;6340;2;2;1;0;0;0;1;6340;0;6340;1;1;
/org.eclipse.jdt.core.tests.model/workspace/Converter/src/test0080/Test.java;1;0;1;1;0;0;0;1;0;0;1;3714;0;0;1;0;0;1;1;3714;0;3714;1;1;
/org.eclipse.jdt.ui/ui refactoring/org/eclipse/jdt/internal/ui/refactoring/ChangeSignatureInputPage.java;2;0;2;1;0;0;0;2;3;1;2;363;3;3;1;0;0;2;2;363;0;518;2;2;
/org.eclipse.ui.workbench/Eclipse UI/org/eclipse/ui/internal/roles/api/secondstage/IRoleRegistryEvent.java;1;0;2;1;0;0;0;2;0;1;2;2199;0;0;1;0;0;2;2;2199;0;2207;2;1;
/org.eclipse.swt.tests/JUnit Tests/org/eclipse/swt/tests/junit/Test_org_eclipse_swt_layout_GridData.java;1;0;2;1;1;1;1;1;30;0;1;3443;34;34;1;0;0;1;2;3443;0;6352;2;1;
/org.eclipse.jdt.core.tests.model/workspace/Formatter/test244/A_out.java;1;0;1;1;0;0;0;1;0;0;1;2437;0;0;1;0;0;1;1;2437;0;2437;1;1;
/org.eclipse.ant.ui/Ant Editor/org/eclipse/ant/internal/ui/editor/text/AntEditorDocumentProvider.java;1;0;9;1;1;1;1;8;265;2;7;1811;316;316;2;1;0;8;9;5047;1;6028;8;1;
/org.eclipse.help.tests/src/org/eclipse/help/tests/browsers/TestWin32IE.java;1;1;5;1;2;2;2;3;67;1;3;2898;149;149;1;0;0;3;5;2898;0;6337;5;1;
/org.eclipse.jdt.core.tests.model/workspace/JavaSearch/src/p10/a/b/dom/Y.java;1;0;1;1;1;1;1;0;0;0;0;5938;0;0;1;0;0;0;1;5938;0;5938;1;1;
/org.eclipse.jdt.core.tests.model/workspace/Converter/junit/framework/AssertionFailedError.java;1;0;1;1;0;0;0;1;0;0;1;3714;0;0;1;0;0;1;1;3714;0;3714;1;1;
/org.eclipse.jdt.ui.tests.refactoring/resources/ExtractMethodWorkSpace/ExtractMethodTests/return_out/A_test714.java;1;0;2;1;0;0;0;2;6;1;2;130;7;7;1;0;0;2;2;130;0;844;2;1;
/org.eclipse.ui.workbench/Eclipse UI/org/eclipse/ui/internal/UILockListener.java;3;0;4;1;1;1;1;3;17;1;3;1524;37;37;1;0;0;3;4;1524;0;6338;4;3;
/org.eclipse.update.ui/srcnew/org/eclipse/update/internal/ui/model/PendingOperationAdapter.java;2;0;3;1;0;0;0;3;1;2;2;380;1;1;2;1;0;3;3;380;1;481;2;2;
/org.eclipse.debug.ui/ui/org/eclipse/debug/internal/ui/actions/ClearOutputAction.java;2;0;2;1;0;0;0;2;18;1;2;1417;18;18;1;0;0;2;2;1417;0;2060;2;2;
/org.eclipse.team.ui/src/org/eclipse/team/internal/ui/target/SiteElement.java;2;0;3;1;0;0;0;3;5;1;3;917;10;10;1;0;0;3;3;917;0;2495;3;2;
/org.eclipse.jface.text/src/org/eclipse/jface/text/contentassist/ContextInformationValidator.java;1;3;9;1;7;5;7;2;32;0;1;2280;80;80;3;1;2;2;9;6353;3;6353;6;1;
/org.eclipse.swt/Eclipse SWT Mozilla/common/org/eclipse/swt/internal/mozilla/nsIContentViewerContainer.java;1;0;1;1;0;0;0;1;0;0;1;2663;0;0;1;0;0;1;1;2663;0;2663;1;1;
/org.eclipse.jdt.debug.tests/tests/org/eclipse/jdt/debug/tests/eval/QualifiedFieldValueTests.java;1;0;1;1;0;0;0;1;18;0;1;1274;18;18;1;0;0;1;1;1274;0;1274;1;1;
/org.eclipse.jdt.ui/ui/org/eclipse/jdt/internal/ui/browsing/PatchedOpenInNewWindowAction.java;1;0;1;1;1;1;1;0;2;0;0;6340;2;2;1;0;0;0;1;6340;0;6340;1;1;
/org.eclipse.jdt.ui.tests/ui/org/eclipse/jdt/ui/tests/quickfix/ModifierCorrectionsQuickFixTest.java;2;1;13;1;4;4;4;9;459;1;9;342;1351;1351;1;0;0;9;13;342;0;6340;13;2;
/org.eclipse.jdt.core/compiler/org/eclipse/jdt/internal/compiler/flow/LoopingFlowContext.java;2;0;6;1;0;0;0;6;4;1;6;485;15;15;1;0;0;6;6;485;0;3560;6;2;
/org.eclipse.team.ui/src/org/eclipse/team/ui/synchronize/SyncInfoSetCompareConfiguration.java;1;0;1;1;0;0;0;1;0;0;1;3676;0;0;1;0;0;1;1;3676;0;3676;1;1;
/org.eclipse.jdt.ui.tests.refactoring/resources/ExtractTemp/canExtract/A_test34_out.java;1;0;2;1;0;0;0;2;3;1;2;238;6;6;1;0;0;2;2;238;0;289;2;1;
/org.eclipse.ui.workbench/Eclipse UI/org/eclipse/ui/contexts/IContextServiceListener.java;1;0;3;1;0;0;0;3;2;1;3;1119;2;2;1;0;0;3;3;1119;0;1220;3;1;
/org.eclipse.jdt.ui/ui/org/eclipse/jdt/internal/ui/text/correction/ICorrectionProcessor.java;1;0;5;1;0;0;0;5;15;1;5;1011;35;35;1;0;0;5;5;1011;0;1232;5;1;
/org.eclipse.ui.forms/src/org/eclipse/ui/forms/editor/FormEditorSelectionProvider.java;1;0;3;1;0;0;0;3;6;1;3;4837;6;6;1;0;0;3;3;4837;0;4975;3;1;
/org.eclipse.jdt.core/model/org/eclipse/jdt/internal/core/ClasspathEntry.java;4;1;18;2;4;4;4;14;449;2;11;658;900;900;2;3;0;14;18;658;3;6217;15;4;
/org.eclipse.swt/Eclipse SWT/gtk/org/eclipse/swt/widgets/Scale.java;4;1;5;1;2;2;2;3;22;1;3;269;45;45;1;0;0;3;5;269;0;6352;5;4;
/org.eclipse.team.ui/src/org/eclipse/team/ui/synchronize/ISynchronizeView.java;2;1;8;1;4;4;4;4;53;1;4;2535;71;71;1;0;0;4;8;2535;0;6337;8;2;
/org.eclipse.jface.text/src/org/eclipse/jface/text/contentassist/CompletionProposalPopup.java;3;3;36;2;11;7;11;25;249;2;24;849;1115;1115;3;1;4;25;36;6353;5;6353;31;3;
/org.eclipse.pde.ui/src/org/eclipse/pde/internal/ui/wizards/imports/PluginImportWizardExpressPage.java;3;1;24;1;5;5;5;19;82;3;16;655;387;387;3;3;0;19;24;731;3;6336;21;3;
/org.eclipse.debug.ui/ui/org/eclipse/debug/internal/ui/actions/ToggleAutoManageViewsActionDelegate.java;1;0;2;1;1;1;1;1;0;0;1;3815;0;0;1;0;0;1;2;3815;0;5366;2;1;
/org.eclipse.jdt.core/dom/org/eclipse/jdt/core/dom/CompilationUnitResolver.java;4;0;35;1;0;0;0;35;347;2;34;69;1911;1911;2;1;0;35;35;1431;1;4731;34;4;
/org.eclipse.ui.workbench/Eclipse UI/org/eclipse/ui/internal/dialogs/ResourceWorkingSetPage.java;1;0;1;1;0;0;0;1;0;0;1;2737;0;0;1;0;0;1;1;2737;0;2737;1;1;
/org.eclipse.ui.tests/Eclipse JFace Tests/org/eclipse/jface/tests/viewers/interactive/TestBrowser.java;2;0;2;1;1;1;1;1;28;0;1;4641;30;30;1;0;0;1;2;4641;0;6338;2;2;
/org.eclipse.ui.workbench/Eclipse UI/org/eclipse/ui/internal/misc/Sorter.java;1;0;1;1;0;0;0;1;0;0;1;2737;0;0;1;0;0;1;1;2737;0;2737;1;1;
/org.eclipse.ui.views/src/org/eclipse/ui/views/internal/markers/TaskView.java;1;0;2;1;0;0;0;2;0;0;1;749;0;0;2;1;0;2;2;749;1;749;1;1;
/org.eclipse.ui.workbench/Eclipse UI/org/eclipse/ui/internal/ExtensionEventHandlerMessages.java;2;0;2;1;1;1;1;1;2;0;1;3862;2;2;1;0;0;1;2;3862;0;6338;2;2;
/org.eclipse.ui.intro/src/org/eclipse/ui/intro/internal/model/IntroPartPresentation.java;1;0;14;1;1;1;1;13;491;2;11;4429;879;879;2;2;0;13;14;4724;2;5115;12;1;
/org.eclipse.ant.tests.ui/Ant Editor Tests/org/eclipse/ui/externaltools/internal/ant/editor/support/TestEditor.java;1;0;4;1;0;0;0;4;7;1;4;178;13;13;1;0;0;4;4;178;0;1274;4;1;
/org.eclipse.jdt.ui/ui/org/eclipse/jdt/internal/ui/text/correction/IJavaMarkerResolutionExtension.java;1;0;2;1;0;0;0;2;25;1;2;1365;25;25;1;0;0;2;2;1365;0;4366;2;1;
/org.eclipse.update.tests.core/src/org/eclipse/update/tests/implementation/SiteFTPFactory.java;1;0;2;1;1;1;1;1;4;0;1;4760;7;7;1;0;0;1;2;4760;0;6336;2;1;
/org.eclipse.update.ui/src/org/eclipse/update/internal/ui/parts/ConfigurationInfo.java;2;0;4;1;0;0;0;4;19;1;4;890;27;27;1;0;0;4;4;890;0;4658;4;2;
/org.eclipse.team.cvs.core/src/org/eclipse/team/internal/ccvs/core/CVSProviderPlugin.java;2;1;27;1;3;3;3;24;222;2;23;790;768;768;2;1;0;24;27;2458;1;6337;26;2;
/org.eclipse.search/new search/org/eclipse/search2/internal/ui/basic/views/RemoveAllResultsAction.java;1;0;3;1;1;1;1;2;11;1;2;3474;11;11;1;0;0;2;3;3474;0;5128;3;1;
/org.eclipse.ui.externaltools/External Tools Base/org/eclipse/ui/externaltools/internal/variable/ContainerNameExpander.java;1;0;1;1;0;0;0;1;0;0;1;321;0;0;1;0;0;1;1;321;0;321;1;1;
/org.eclipse.team.ui/src/org/eclipse/team/internal/ui/synchronize/SyncInfoDiffViewerForSynchronizeView.java;1;0;1;1;0;0;0;1;0;0;1;3286;0;0;1;0;0;1;1;3286;0;3286;1;1;
/org.eclipse.update.core/src/org/eclipse/update/internal/configuration/InstallChangeParser.java;1;0;1;1;0;0;0;1;0;0;1;2828;0;0;1;0;0;1;1;2828;0;2828;1;1;
/org.eclipse.ant.ui/Ant Editor/org/eclipse/ant/internal/ui/dtd/util/SortedSet.java;1;0;2;1;1;1;1;1;22;0;1;1811;22;22;1;0;0;1;2;1811;0;5581;2;1;
/org.eclipse.swt/Eclipse SWT PI/gtk1x/org/eclipse/swt/internal/gtk/GdkEventMotion.java;1;0;1;1;0;0;0;1;0;0;1;2327;0;0;1;0;0;1;1;2327;0;2327;1;1;
/org.eclipse.jdt.ui/ui/org/eclipse/jdt/internal/ui/text/comment/DefaultTextMeasurement.java;2;0;2;1;0;0;0;2;46;1;2;4365;46;46;1;0;0;2;2;4365;0;4420;2;2;
/org.eclipse.pde.ui/src/org/eclipse/pde/internal/ui/elements/DefaultElement.java;2;1;2;1;2;2;2;0;4;0;0;5782;6;6;1;0;0;0;2;5782;0;6336;2;2;
/org.eclipse.jdt.ui.tests.refactoring/resources/UseSupertypeWherePossible/testNew13/in/B.java;1;0;1;1;0;0;0;1;2;0;1;1166;2;2;1;0;0;1;1;1166;0;1166;1;1;
/org.eclipse.pde.ui/src/org/eclipse/pde/internal/ui/editor/feature/FeatureEntryPropertySource.java;2;1;3;1;2;2;2;1;30;0;1;4203;48;48;1;0;0;1;3;4203;0;6336;3;2;
/org.eclipse.jdt.core.tests.model/workspace/Converter/src/p2/A.java;1;0;1;1;0;0;0;1;0;0;1;3714;0;0;1;0;0;1;1;3714;0;3714;1;1;
/org.eclipse.swt/Eclipse SWT PI/gtk/org/eclipse/swt/internal/gtk/GdkRectangle.java;3;0;3;1;1;1;1;2;17;1;2;1653;21;21;1;0;0;2;3;1653;0;6352;3;3;
/org.eclipse.jdt.debug.ui/ui/org/eclipse/jdt/internal/debug/ui/actions/ShowNullArrayEntriesAction.java;1;0;2;1;0;0;0;2;4;1;2;2568;4;4;1;0;0;2;2;2568;0;3296;2;1;
/org.eclipse.ui.workbench/Eclipse UI/org/eclipse/ui/internal/skins/newlook/PresentableViewPart.java;1;0;2;1;0;0;0;2;0;1;2;4438;0;0;1;0;0;2;2;4438;0;4460;2;1;
/org.eclipse.ui.tests/Eclipse JFace Tests/org/eclipse/jface/tests/images/AllTests.java;1;0;2;1;2;1;2;0;0;0;0;5613;0;0;2;0;1;0;2;5613;1;5613;1;1;
/org.eclipse.jdt.ui/ui/org/eclipse/jdt/internal/ui/text/correction/ModifierChangeCompletionProposal.java;4;1;12;1;3;3;3;9;41;1;9;1049;173;173;1;0;0;9;12;1049;0;6340;12;4;
/org.eclipse.jdt.core.tests.model/workspace/Formatter/test118/A_in.java;1;0;1;1;0;0;0;1;0;0;1;2425;0;0;1;0;0;1;1;2425;0;2425;1;1;
/org.eclipse.jdt.core.tests.model/workspace/Converter/src/test0163/Test.java;1;0;1;1;0;0;0;1;0;0;1;3714;0;0;1;0;0;1;1;3714;0;3714;1;1;
/org.eclipse.jdt.core/compiler/org/eclipse/jdt/internal/compiler/ast/UnaryExpression.java;2;0;5;1;0;0;0;5;26;1;5;991;45;45;1;0;0;5;5;991;0;3560;5;2;
/org.eclipse.jdt.core/compiler/org/eclipse/jdt/internal/compiler/ast/JavadocFieldReference.java;4;1;11;1;4;4;4;7;34;1;7;2887;121;121;1;0;0;7;11;2887;0;6151;11;4;
/org.eclipse.core.variables/src/org/eclipse/core/internal/variables/StringVariable.java;1;0;1;1;0;0;0;1;0;0;1;2514;0;0;1;0;0;1;1;2514;0;2514;1;1;
/org.eclipse.jdt.ui/core extension/org/eclipse/jdt/internal/corext/dom/SourceModifier.java;2;0;7;1;1;1;1;6;140;2;5;1607;298;298;2;1;0;6;7;1953;1;5406;6;2;
/org.eclipse.ant.ui/Ant Editor/org/eclipse/ant/internal/ui/editor/outline/IProblem.java;1;0;4;1;1;1;1;3;17;1;3;1811;30;30;1;0;0;3;4;1811;0;6336;4;1;
/org.eclipse.ant.ui/Ant Tools Support/org/eclipse/ant/internal/ui/preferences/AntCodeFormatterPreferencePage.java;1;1;4;1;2;2;2;2;292;1;2;4075;313;313;1;0;0;2;4;4075;0;5739;4;1;
/org.eclipse.ui.workbench.texteditor/src/org/eclipse/ui/texteditor/StatusLineContributionItem.java;3;1;12;1;2;2;2;10;117;1;10;600;251;251;1;0;0;10;12;600;0;6340;12;3;
/org.eclipse.ui.workbench.texteditor/src/org/eclipse/ui/texteditor/_DefaultRangeIndicatorPresentation.java;1;0;1;1;0;0;0;1;0;0;1;2874;0;0;1;0;0;1;1;2874;0;2874;1;1;
/org.eclipse.swt/Eclipse SWT Drag and Drop/common/org/eclipse/swt/dnd/DragSourceEvent.java;1;0;1;1;0;0;0;1;2;0;1;7;2;2;1;0;0;1;1;7;0;7;1;1;
/org.eclipse.jdt.core.tests.model/workspace/Converter/test0068/Test.java;1;0;1;1;0;0;0;1;0;0;1;3714;0;0;1;0;0;1;1;3714;0;3714;1;1;
/org.eclipse.jdt.core.tests.model/workspace/Formatter/test148/A_in.java;1;0;1;1;0;0;0;1;0;0;1;2425;0;0;1;0;0;1;1;2425;0;2425;1;1;
/org.eclipse.jdt.ui/ui/org/eclipse/jdt/internal/ui/javadocexport/JavadocLinkRef.java;2;1;2;1;2;2;2;0;10;0;0;5659;10;10;1;0;0;0;2;5659;0;6340;2;2;
/org.eclipse.ui.ide/src/org/eclipse/ui/views/framelist/Frame.java;1;0;1;1;0;0;0;1;0;0;1;2208;0;0;1;0;0;1;1;2208;0;2208;1;1;
/org.eclipse.jdt.core.tests.model/workspace/Formatter/test466/A_out.java;1;0;1;1;0;0;0;1;0;0;1;3915;0;0;1;0;0;1;1;3915;0;3915;1;1;
/org.eclipse.team.cvs.ui/src/org/eclipse/team/internal/ccvs/ui/subscriber/SubscriberConfirmMergedAction.java;2;0;15;1;1;1;1;14;78;2;13;645;260;260;2;1;0;14;15;3128;1;5508;14;2;
/org.eclipse.jdt.ui/ui/org/eclipse/jdt/ui/StandardJavaElementContentProvider.java;5;2;12;2;4;3;4;8;58;2;7;272;189;189;2;1;1;8;12;4064;2;6334;10;5;
/org.eclipse.jdt.debug.jdi.tests/tests/org/eclipse/debug/jdi/tests/ThreadGroupReferenceTest.java;1;0;1;1;0;0;0;1;2;0;1;1318;2;2;1;0;0;1;1;1318;0;1318;1;1;
/org.eclipse.jdt.core/compiler/org/eclipse/jdt/internal/compiler/env/ICompilationUnit.java;1;0;1;1;0;0;0;1;2;0;1;3560;2;2;1;0;0;1;1;3560;0;3560;1;1;
/org.eclipse.jface.text/src/org/eclipse/jface/text/rules/WordPatternRule.java;1;1;2;1;2;2;2;0;4;0;0;5123;6;6;1;0;0;0;2;5123;0;6340;2;1;
/org.eclipse.jdt.core.tests.model/workspace/Converter/src/test0207/Test.java;1;0;1;1;0;0;0;1;0;0;1;3714;0;0;1;0;0;1;1;3714;0;3714;1;1;
/org.eclipse.jdt.ui/ui/org/eclipse/jdt/ui/actions/FindReferencesInProjectAction.java;3;1;13;1;4;4;4;9;21;1;9;1586;95;95;1;0;0;9;13;1586;0;6340;13;3;
/org.eclipse.jdt.ui.tests.refactoring/resources/IntroduceFactory/positive/StaticInstance_in.java;1;0;2;1;1;1;1;1;2;0;1;2862;2;2;1;0;0;1;2;2862;0;5659;2;1;
/org.eclipse.jdt.core.tests.model/workspace/Formatter/test127/A_in.java;1;0;1;1;0;0;0;1;0;0;1;2425;0;0;1;0;0;1;1;2425;0;2425;1;1;
/org.eclipse.ui.workbench/Eclipse UI/org/eclipse/ui/intro/IIntroSite.java;1;1;6;1;2;2;2;4;40;1;4;3541;67;67;1;0;0;4;6;3541;0;5533;6;1;
/org.eclipse.jdt.ui/ui refactoring/org/eclipse/jdt/internal/ui/refactoring/PerformChangeOperation.java;2;0;5;1;0;0;0;5;135;1;5;3708;216;216;1;0;0;5;5;3708;0;4575;5;2;
/org.eclipse.core.tests.runtime/src/org/eclipse/core/tests/internal/plugins/BasicFragmentTest.java;1;0;1;1;0;0;0;1;0;0;1;3014;0;0;1;0;0;1;1;3014;0;3014;1;1;
/org.eclipse.jdt.core/dom/org/eclipse/jdt/core/dom/ThisExpression.java;4;1;9;1;3;3;3;6;79;1;6;3560;145;145;1;0;0;6;9;3560;0;5272;9;4;
/org.eclipse.jdt.core.tests.model/workspace/Converter/src/test0509/B.java;1;0;1;1;0;0;0;1;0;0;1;3714;0;0;1;0;0;1;1;3714;0;3714;1;1;
/org.eclipse.swt.opengl.examples/src/org/eclipse/swt/opengl/examples/OpenGLTab.java;1;0;1;1;0;0;0;1;0;0;1;1175;0;0;1;0;0;1;1;1175;0;1175;1;1;
/org.eclipse.jdt.core.tests.model/workspace/Converter/test0280/Test.java;1;0;1;1;0;0;0;1;0;0;1;3714;0;0;1;0;0;1;1;3714;0;3714;1;1;
/org.eclipse.jdt.ui.tests.refactoring/resources/ExtractMethodWorkSpace/ExtractMethodTests/validSelection_in/A_test365.java;1;0;1;1;0;0;0;1;2;0;1;844;2;2;1;0;0;1;1;844;0;844;1;1;
/org.eclipse.jdt.core.tests.compiler/src/org/eclipse/jdt/core/tests/compiler/regression/AnnotationTestForConstructor.java;1;0;3;1;0;0;0;3;4;1;3;2397;4;4;1;0;0;3;3;2397;0;2887;3;1;
/org.eclipse.jdt.ui/core extension/org/eclipse/jdt/internal/corext/template/java/JavaFormatter.java;5;1;16;2;3;3;3;13;262;3;10;1581;455;455;3;3;0;13;16;1952;3;6340;13;5;
/org.eclipse.ui.workbench/Eclipse UI/org/eclipse/ui/internal/themes/IEditable.java;1;0;1;1;0;0;0;1;0;0;1;4974;0;0;1;0;0;1;1;4974;0;4974;1;1;
/org.eclipse.team.examples.filesystem/src/org/eclipse/team/examples/pessimistic/IResourceStateListener.java;1;0;2;1;1;1;1;1;22;0;1;3368;22;22;1;0;0;1;2;3368;0;6103;2;1;
/org.eclipse.osgi/resolver/src/org/eclipse/osgi/internal/resolver/SystemState.java;3;1;4;1;3;3;3;1;16;0;1;3170;26;26;1;0;0;1;4;3170;0;6337;4;3;
/org.eclipse.ui.ide/src/org/eclipse/ui/dialogs/NewFolderDialog.java;2;0;3;1;0;0;0;3;32;1;3;1511;32;32;1;0;0;3;3;1511;0;2263;3;2;
/org.eclipse.jdt.core.tests.model/workspace/Formatter/test475/A_out.java;1;0;1;1;0;0;0;1;0;0;1;3977;0;0;1;0;0;1;1;3977;0;3977;1;1;
/org.eclipse.ui.externaltools/Ant Editor/org/eclipse/ui/externaltools/internal/ant/editor/outline/PlantyContentOutlinePage.java;1;0;1;1;0;0;0;1;0;0;1;178;0;0;1;0;0;1;1;178;0;178;1;1;
/org.eclipse.team.ui/src/org/eclipse/team/internal/ui/synchronize/RemoteResourceTypedElement.java;2;1;6;1;2;2;2;4;115;1;4;4118;150;150;1;0;0;4;6;4118;0;6337;6;2;
/org.eclipse.jdt.ui.tests.refactoring/resources/ExtractInterface/testConditional1/in/X.java;1;0;1;1;0;0;0;1;0;0;1;3902;0;0;1;0;0;1;1;3902;0;3902;1;1;
/org.eclipse.debug.ui/ui/org/eclipse/debug/internal/ui/sourcelookup/browsers/ArchiveFilter.java;2;0;2;1;1;1;1;1;4;0;1;4915;4;4;1;0;0;1;2;4915;0;6336;2;2;
/org.eclipse.ui.workbench/Eclipse UI/org/eclipse/ui/roles/IActivityBinding.java;1;0;3;1;0;0;0;3;9;1;3;2240;9;9;1;0;0;3;3;2240;0;2867;3;1;
/org.eclipse.jdt.core.tests.model/workspace/Converter/src/test0107/Test.java;1;0;1;1;0;0;0;1;0;0;1;3714;0;0;1;0;0;1;1;3714;0;3714;1;1;
/org.eclipse.jdt.core/compiler/org/eclipse/jdt/internal/compiler/lookup/ProblemMethodBinding.java;1;0;1;1;0;0;0;1;2;0;1;3560;2;2;1;0;0;1;1;3560;0;3560;1;1;
/org.eclipse.ui.workbench/Eclipse UI/org/eclipse/ui/internal/registry/IActionSetDescriptor.java;2;0;2;1;1;1;1;1;8;0;1;4550;10;10;1;0;0;1;2;4550;0;6338;2;2;
/org.eclipse.ui.forms/src/org/eclipse/ui/forms/internal/widgets/FormsResources.java;1;0;3;1;0;0;0;3;16;1;3;4068;16;16;1;0;0;3;3;4068;0;5044;3;1;
/org.eclipse.jdt.launching/launching/org/eclipse/jdt/internal/launching/ClasspathContainerSourceContainer.java;1;0;7;1;0;0;0;7;97;2;5;4109;141;141;2;2;0;7;7;4109;2;4971;5;1;
/org.eclipse.jdt.ui/ui refactoring/org/eclipse/jdt/internal/ui/refactoring/code/ExtractMethodWizard.java;2;0;7;1;1;1;1;6;5;1;6;1047;25;25;1;0;0;6;7;1047;0;6340;7;2;
/org.eclipse.jface.text/src/org/eclipse/jface/text/reconciler/IReconcilerExtension.java;2;2;4;1;3;2;3;1;20;0;1;1511;25;25;2;0;1;1;4;6353;1;6353;3;2;
/org.eclipse.jdt.core.tests.model/workspace/Converter/test0403/A.java;1;0;1;1;0;0;0;1;0;0;1;3714;0;0;1;0;0;1;1;3714;0;3714;1;1;
/org.eclipse.jdt.ui/core refactoring/org/eclipse/ltk/refactoring/core/RenameData.java;1;0;2;1;0;0;0;2;0;1;2;3930;0;0;1;0;0;2;2;3930;0;4510;2;1;
/org.eclipse.jdt.ui/core refactoring/org/eclipse/jdt/internal/corext/refactoring/rename/RenameResourceRefactoring.java;2;0;3;1;0;0;0;3;28;1;3;122;54;54;1;0;0;3;3;122;0;1125;3;2;
/org.eclipse.swt/Eclipse SWT PI/gtk1x/org/eclipse/swt/internal/gtk/GtkText.java;1;0;1;1;0;0;0;1;0;0;1;2327;0;0;1;0;0;1;1;2327;0;2327;1;1;
/org.eclipse.core.tools/src/org/eclipse/core/tools/ClearTextAction.java;1;0;1;1;1;1;1;0;0;0;0;6302;0;0;1;0;0;0;1;6302;0;6302;1;1;
/org.eclipse.ant.ui/Remote Ant Support/org/eclipse/ant/internal/ui/antsupport/AntSecurityException.java;1;0;1;1;0;0;0;1;0;0;1;1811;0;0;1;0;0;1;1;1811;0;1811;1;1;
/org.eclipse.ui.workbench/Eclipse UI/org/eclipse/ui/actions/ContributionItemFactory.java;3;0;4;1;1;1;1;3;196;1;3;1698;200;200;1;0;0;3;4;1698;0;6340;4;3;
/org.eclipse.core.resources/src/org/eclipse/core/internal/resources/PathVariableManager.java;3;1;8;1;3;3;3;5;22;1;5;728;67;67;1;0;0;5;8;728;0;5146;8;3;
/org.eclipse.jdt.debug.ui/ui/org/eclipse/jdt/internal/debug/ui/display/DisplayView.java;5;1;10;1;3;3;3;7;226;1;7;1240;501;501;1;0;0;7;10;1240;0;6223;10;5;
/org.eclipse.osgi/eclipseAdaptor/src/org/eclipse/osgi/framework/stats/ClassStats.java;3;1;4;1;3;3;3;1;8;0;1;3013;14;14;1;0;0;1;4;3013;0;6337;4;3;
/org.eclipse.jdt.ui.tests.refactoring/resources/Copy/test_import_container_yes_method_in_different_cu/in/A.java;1;0;1;1;0;0;0;1;0;0;1;685;0;0;1;0;0;1;1;685;0;685;1;1;
/org.eclipse.jdt.core.tests.model/workspace/Converter/src/test0479/A.java;1;0;1;1;0;0;0;1;0;0;1;3714;0;0;1;0;0;1;1;3714;0;3714;1;1;
/org.eclipse.ui.workbench/Eclipse UI/org/eclipse/ui/internal/progress/JobView.java;2;1;16;1;5;5;5;11;1053;4;5;4971;3032;3032;4;6;0;11;16;4989;6;6338;10;2;
/org.eclipse.ui.ide/src/org/eclipse/ui/ide/IIDEActionConstants.java;5;2;6;2;3;2;3;3;24;1;3;3050;38;38;2;0;1;3;6;6338;1;6338;5;5;
/org.eclipse.jdt.debug.ui/ui/org/eclipse/jdt/internal/debug/ui/sourcelookup/JavaProjectSourceContainerBrowser.java;1;0;6;1;1;1;1;5;14;2;3;4899;24;24;2;2;0;5;6;4949;2;6224;4;1;
/org.eclipse.pde.ui/src/org/eclipse/pde/internal/ui/editor/plugin/PluginActivationSection.java;3;4;8;2;8;5;8;0;563;0;0;5561;624;624;4;0;3;0;8;5575;3;6336;5;3;
/org.eclipse.jdt.ui/ui/org/eclipse/jdt/ui/text/spelling/WordCorrectionProposal.java;2;0;3;1;0;0;0;3;2;1;3;3829;2;2;1;0;0;3;3;3829;0;3930;3;2;
/org.eclipse.update.core/srcnew/org/eclipse/update/operations/IUninstallFeatureOperation.java;1;0;2;1;0;0;0;2;0;1;2;602;0;0;1;0;0;2;2;602;0;825;2;1;
/org.eclipse.ui.tests/Eclipse UI Tests/org/eclipse/ui/tests/keys/Bug42024Test.java;3;0;6;1;0;0;0;6;15;1;6;2281;39;39;1;0;0;6;6;2281;0;3091;6;3;
/org.eclipse.core.tests.runtime/src/org/eclipse/core/tests/internal/runtimetests/SampleMFB.java;1;0;1;1;1;1;1;0;21;0;0;5149;21;21;1;0;0;0;1;5149;0;5149;1;1;
/org.eclipse.jdt.launching/launching/org/eclipse/jdt/launching/sourcelookup/containers/JavaProjectSourceContainer.java;1;1;4;1;3;3;3;1;55;0;1;4971;104;104;1;0;0;1;4;4971;0;5920;4;1;
/org.eclipse.ui.workbench/Eclipse UI/org/eclipse/ui/internal/commands/ContextBindingDefinition.java;2;0;13;1;1;1;1;12;114;5;7;1389;237;237;5;5;0;12;13;1389;5;5231;8;2;
/org.eclipse.team.ui/src/org/eclipse/team/ui/synchronize/content/ILogicalView.java;1;0;1;1;0;0;0;1;0;0;1;3734;0;0;1;0;0;1;1;3734;0;3734;1;1;
/org.eclipse.debug.ui/ui/org/eclipse/debug/internal/ui/InstructionPointerContext.java;1;0;1;1;0;0;0;1;21;0;1;1445;21;21;1;0;0;1;1;1445;0;1445;1;1;
/org.eclipse.core.tests.resources/src/org/eclipse/core/tests/resources/session/Test1G1N9GZ.java;1;0;3;1;3;1;3;0;140;0;0;5147;140;140;3;0;2;0;3;5147;2;5147;1;1;
/org.eclipse.jdt.ui/core refactoring/org/eclipse/jdt/internal/corext/refactoring/util/RefactoringASTParser.java;2;0;4;1;1;1;1;3;10;2;2;4690;14;14;2;1;0;3;4;4690;1;5402;3;2;
/org.eclipse.swt/Eclipse SWT/gtk1x/org/eclipse/swt/widgets/ScrollBar.java;1;0;1;1;0;0;0;1;0;0;1;2327;0;0;1;0;0;1;1;2327;0;2327;1;1;
/org.eclipse.ui.editors/src/org/eclipse/ui/texteditor/ResourceMarkerAnnotationModelFactory.java;2;1;2;1;2;2;2;0;3;0;0;5382;3;3;1;0;0;0;2;5382;0;6337;2;2;
/org.eclipse.swt.graphics.text/Eclipse SWT PI/win32/org/eclipse/swt/internal/win32/SCRIPT_LOGATTR.java;1;0;1;1;0;0;0;1;0;0;1;2985;0;0;1;0;0;1;1;2985;0;2985;1;1;
/org.eclipse.jdt.ui.tests.refactoring/resources/MoveInnerToTopLevel/test_nonstatic_32/in/A.java;1;0;1;1;0;0;0;1;12;0;1;305;12;12;1;0;0;1;1;305;0;305;1;1;
/org.eclipse.ui.views/src/org/eclipse/ui/views/internal/markers/FiltersDialog.java;1;0;2;1;0;0;0;2;0;1;2;265;0;0;1;0;0;2;2;265;0;749;2;1;
/org.eclipse.jdt.core/dom/org/eclipse/jdt/core/dom/ConditionalExpression.java;3;1;8;1;2;2;2;6;146;1;6;3560;212;212;1;0;0;6;8;3560;0;5272;8;3;
/org.eclipse.jdt.ui.tests.refactoring/test cases/org/eclipse/jdt/ui/tests/reorg/MultiMoveTest.java;4;1;9;1;2;2;2;7;263;1;7;1111;362;362;1;0;0;7;9;1111;0;6340;9;4;
/org.eclipse.jdt.ui.tests.refactoring/resources/InlineMethodWorkspace/TestCases/Test.java;1;0;1;1;0;0;0;1;30;0;1;597;30;30;1;0;0;1;1;597;0;597;1;1;
/org.eclipse.jdt.ui.tests.refactoring/resources/InlineMethodWorkspace/TestCases/cast_in/TestReceiverCast.java;1;0;1;1;0;0;0;1;0;0;1;1446;0;0;1;0;0;1;1;1446;0;1446;1;1;
/org.eclipse.jdt.ui/ui/org/eclipse/jdt/internal/ui/text/JavaChangeHover.java;4;1;11;1;4;4;4;7;60;1;7;1118;123;123;1;0;0;7;11;1118;0;6340;11;4;
/org.eclipse.jdt.ui.tests/ui/org/eclipse/jdt/ui/tests/packageview/TestDelta.java;1;0;1;1;1;1;1;0;2;0;0;6340;2;2;1;0;0;0;1;6340;0;6340;1;1;
/org.eclipse.jdt.ui/core refactoring/org/eclipse/jdt/internal/corext/refactoring/code/Invocations.java;2;0;2;1;1;1;1;1;21;0;1;2493;23;23;1;0;0;1;2;2493;0;6340;2;2;
/org.eclipse.update.ui.win32/src/org/eclipse/welcome/internal/portal/SectionDescriptor.java;1;0;1;1;0;0;0;1;0;0;1;912;0;0;1;0;0;1;1;912;0;912;1;1;
/org.eclipse.ui.workbench/Eclipse UI/org/eclipse/ui/internal/csm/commands/api/CommandManagerFactory.java;1;0;2;1;0;0;0;2;0;1;2;2515;0;0;1;0;0;2;2;2515;0;2562;2;1;
/org.eclipse.jdt.ui/core extension/org/eclipse/jdt/internal/corext/dom/RewriteException.java;1;0;3;1;1;1;1;2;17;1;2;3692;17;17;1;0;0;2;3;3692;0;5406;3;1;
/org.eclipse.team.cvs.ui/src/org/eclipse/team/internal/ccvs/ui/subscriber/ConfirmMergedOperation.java;2;1;3;1;3;3;3;0;92;0;0;5490;94;94;1;0;0;0;3;5490;0;6337;3;2;
/org.eclipse.jdt.ui/ui/org/eclipse/jdt/internal/ui/preferences/SpellingConfigurationBlock.java;3;1;7;1;3;3;3;4;105;1;4;3829;150;150;1;0;0;4;7;3829;0;6340;7;3;
/org.eclipse.jdt.core/model/org/eclipse/jdt/internal/core/JavaModelStatus.java;2;0;7;1;0;0;0;7;134;1;7;530;178;178;1;0;0;7;7;530;0;4887;7;2;
/org.eclipse.ui.workbench/Eclipse UI/org/eclipse/ui/help/AbstractHelpUI.java;2;0;2;1;0;0;0;2;82;1;2;1881;82;82;1;0;0;2;2;1881;0;2737;2;2;
/org.eclipse.jdt.ui/ui refactoring/org/eclipse/jdt/internal/ui/refactoring/PullUpInputPage1.java;1;0;3;1;0;0;0;3;6;1;3;361;8;8;1;0;0;3;3;361;0;518;3;1;
/org.eclipse.jdt.ui.tests.refactoring/resources/Delete/testDeleteWithinCu4/in/A.java;1;0;1;1;0;0;0;1;0;0;1;442;0;0;1;0;0;1;1;442;0;442;1;1;
/org.eclipse.jdt.debug/eval/org/eclipse/jdt/internal/debug/eval/ast/instructions/PushStaticFieldVariable.java;1;0;1;1;0;0;0;1;3;0;1;1240;3;3;1;0;0;1;1;1240;0;1240;1;1;
/org.eclipse.ui.ide/src/org/eclipse/ui/internal/ide/NewWizardDropDownAction.java;5;1;6;1;3;3;3;3;8;1;3;2264;24;24;1;0;0;3;6;2264;0;6338;6;5;
/org.eclipse.swt.opengl.examples/src/org/eclipse/swt/opengl/examples/AreaTab.java;1;0;1;1;0;0;0;1;0;0;1;1175;0;0;1;0;0;1;1;1175;0;1175;1;1;
/org.eclipse.jdt.core.tests.model/workspace/Converter/src/test0467/Assert.java;1;0;1;1;0;0;0;1;0;0;1;3714;0;0;1;0;0;1;1;3714;0;3714;1;1;
/org.eclipse.ui.views/src/org/eclipse/ui/views/navigator/NavigatorDragAdapter.java;2;0;2;1;0;0;0;2;12;1;2;1;12;12;1;0;0;2;2;1;0;2738;2;2;
/org.eclipse.ui.externaltools/Ant Editor/org/eclipse/ui/externaltools/internal/ant/editor/outline/DocumentModelChangeEvent.java;1;0;1;1;0;0;0;1;0;0;1;282;0;0;1;0;0;1;1;282;0;282;1;1;
/org.eclipse.debug.ui/ui/org/eclipse/debug/internal/ui/actions/ToggleBreakpointObjectActionDelegate.java;2;0;3;1;0;0;0;3;9;2;2;4492;10;10;2;1;0;3;3;4492;1;5082;2;2;
/org.eclipse.ui.ide/src/org/eclipse/ui/wizards/datatransfer/ZipFileExportOperation.java;1;0;2;1;0;0;0;2;65;1;2;1511;65;65;1;0;0;2;2;1511;0;2040;2;1;
/org.eclipse.jdt.debug.ui/ui/org/eclipse/jdt/internal/debug/ui/jres/JREsComboBlock.java;3;1;8;1;2;2;2;6;39;1;6;1086;116;116;1;0;0;6;8;1086;0;6336;8;3;
/org.eclipse.ui.ide/src/org/eclipse/ui/internal/ide/UIWorkspaceLock.java;2;0;5;1;0;0;0;5;6;1;5;1512;9;9;1;0;0;5;5;1512;0;2059;5;2;
/org.eclipse.jdt.ui/ui/org/eclipse/jdt/ui/text/spelling/JavaDocTagDictionary.java;1;0;2;1;0;0;0;2;0;1;2;3829;0;0;1;0;0;2;2;3829;0;3930;2;1;
/org.eclipse.jdt.core.tests.model/workspace/Formatter/test040/A_out.java;1;0;1;1;0;0;0;1;0;0;1;2425;0;0;1;0;0;1;1;2425;0;2425;1;1;
/org.eclipse.core.resources.win32/src/org/eclipse/core/internal/resources/refresh/win32/Win32Monitor.java;2;1;11;1;6;6;6;5;72;2;4;3695;135;135;2;1;0;5;11;3711;1;6248;10;2;
/org.eclipse.ant.ui/Ant Tools Support/org/eclipse/ant/internal/ui/preferences/OverlayPreferenceStore.java;1;0;1;1;0;0;0;1;0;0;1;1811;0;0;1;0;0;1;1;1811;0;1811;1;1;
/org.eclipse.jdt.core.tests.model/workspace/Formatter/test219/A_out.java;1;0;1;1;0;0;0;1;0;0;1;2426;0;0;1;0;0;1;1;2426;0;2426;1;1;
/org.eclipse.team.core/src/org/eclipse/team/core/subscribers/RefreshSubscribersJob.java;1;0;3;1;0;0;0;3;108;1;3;938;108;108;1;0;0;3;3;938;0;1015;3;1;
/org.eclipse.team.tests.cvs.core/src/org/eclipse/team/tests/ccvs/core/subscriber/TestMergeUpdateAction.java;2;0;5;1;0;0;0;5;5;1;5;1241;9;9;1;0;0;5;5;1241;0;4450;5;2;
/org.eclipse.jdt.ui/core refactoring/org/eclipse/jdt/internal/corext/refactoring/participants/xml/Expression.java;1;0;7;1;0;0;0;7;56;1;7;1033;144;144;1;0;0;7;7;1033;0;4108;7;1;
/org.eclipse.jdt.ui/core extension/org/eclipse/jdt/internal/corext/textmanipulation/TextBuffer.java;2;1;7;1;2;2;2;5;23;1;5;1012;52;52;1;0;0;5;7;1012;0;6340;7;2;
/org.eclipse.jdt.ui/core extension/org/eclipse/jdt/internal/corext/util/JarFileEntryTypeInfo.java;2;0;2;1;1;1;1;1;51;0;1;2439;53;53;1;0;0;1;2;2439;0;6340;2;2;
/org.eclipse.jdt.core.tests.model/src/org/eclipse/jdt/core/tests/model/ExternalJarDeltaTests.java;1;0;3;1;2;1;2;1;202;0;1;3560;204;204;2;0;1;1;3;5934;1;5934;2;1;
/org.eclipse.swt/Eclipse SWT Custom Widgets/common/org/eclipse/swt/custom/CTabFolder2.java;1;0;73;1;0;0;0;73;2484;6;41;2780;10206;10206;6;32;0;73;73;3708;32;4232;41;1;
/org.eclipse.jdt.core.tests.model/workspace/JavaSearch/src/e2/X.java;1;0;1;1;0;0;0;1;13;0;1;1235;13;13;1;0;0;1;1;1235;0;1235;1;1;
/org.eclipse.jdt.ui/ui/org/eclipse/jdt/internal/ui/infoviews/TextSelectionConverter.java;1;0;2;1;1;1;1;1;2;0;1;1428;2;2;1;0;0;1;2;1428;0;6340;2;1;
/org.eclipse.jdt.ui/ui/org/eclipse/jdt/internal/ui/viewsupport/IViewPartInputProvider.java;1;0;1;1;1;1;1;0;2;0;0;6340;2;2;1;0;0;0;1;6340;0;6340;1;1;
/org.eclipse.ant.ui/Ant Editor/org/eclipse/ant/internal/ui/editor/TaskDescriptionProvider.java;1;0;4;1;1;1;1;3;32;1;3;1811;69;69;1;0;0;3;4;1811;0;5581;4;1;
/org.eclipse.help.ui/src/org/eclipse/help/ui/internal/HelpRoleManager.java;1;0;11;1;0;0;0;11;54;2;10;2330;169;169;2;1;0;11;11;3111;1;3319;10;1;
/org.eclipse.ui.views/src/org/eclipse/ui/views/navigator/OpenActionGroup.java;1;0;1;1;0;0;0;1;0;0;1;2738;0;0;1;0;0;1;1;2738;0;2738;1;1;
/org.eclipse.jdt.ui/core extension/org/eclipse/jdt/internal/corext/userlibrary/UserLibrary.java;1;1;3;1;2;2;2;1;2;0;1;4407;2;2;1;0;0;1;3;4407;0;5226;3;1;
/org.eclipse.team.tests.cvs.core/src/org/eclipse/team/tests/ccvs/ui/logformatter/ILogEntryVisitor.java;1;0;1;1;0;0;0;1;0;0;1;2632;0;0;1;0;0;1;1;2632;0;2632;1;1;
/org.eclipse.core.tests.runtime/src/org/eclipse/core/tests/internal/runtimetests/SampleE.java;1;0;1;1;1;1;1;0;19;0;0;5149;19;19;1;0;0;0;1;5149;0;5149;1;1;
/org.eclipse.pde.ui/src/org/eclipse/pde/internal/ui/parts/MessageDialogWithToggle.java;1;0;1;1;0;0;0;1;0;0;1;2675;0;0;1;0;0;1;1;2675;0;2675;1;1;
/org.eclipse.jdt.core.tests.model/workspace/Converter/src/javadoc/test003/Test.java;1;0;1;1;0;0;0;1;0;0;1;3792;0;0;1;0;0;1;1;3792;0;3792;1;1;
/org.eclipse.jdt.ui.examples.javafamily/src/org/eclipse/text/reconcilerpipe/AnnotationAdapter.java;1;0;2;1;0;0;0;2;0;1;2;1150;0;0;1;0;0;2;2;1150;0;1629;2;1;
/org.eclipse.debug.ui/ui/org/eclipse/debug/ui/DefaultVariablesContentProvider.java;1;0;4;1;0;0;0;4;8;1;4;534;15;15;1;0;0;4;4;534;0;861;4;1;
/org.eclipse.jdt.core.tests.model/workspace/Formatter/test230/A_in.java;1;0;1;1;0;0;0;1;0;0;1;2437;0;0;1;0;0;1;1;2437;0;2437;1;1;
/org.eclipse.update.core/src/org/eclipse/update/internal/core/FeaturePlugin.java;2;0;2;1;1;1;1;1;2;0;1;4053;2;2;1;0;0;1;2;4053;0;5665;2;2;
/org.eclipse.jdt.ui.tests.refactoring/resources/ExtractMethodWorkSpace/ExtractMethodTests/locals_out/A_test556.java;1;0;1;1;0;0;0;1;4;0;1;844;4;4;1;0;0;1;1;844;0;844;1;1;
/org.eclipse.ui.examples.propertysheet/Eclipse UI Examples PropertySheet/org/eclipse/ui/examples/propertysheet/Birthday.java;1;0;1;1;0;0;0;1;2;0;1;2754;2;2;1;0;0;1;1;2754;0;2754;1;1;
/org.eclipse.team.ui/src/org/eclipse/team/internal/ui/target/SiteViewSorter.java;1;0;1;1;0;0;0;1;0;0;1;2495;0;0;1;0;0;1;1;2495;0;2495;1;1;
/org.eclipse.debug.core/core/org/eclipse/debug/core/model/IProcess.java;2;1;3;1;2;2;2;1;7;0;1;5059;17;17;1;0;0;1;3;5059;0;6336;3;2;
/org.eclipse.ui.workbench/Eclipse UI/org/eclipse/ui/internal/csm/roles/api/NotDefinedException.java;1;0;2;1;0;0;0;2;0;1;2;2213;0;0;1;0;0;2;2;2213;0;2225;2;1;
/org.eclipse.team.tests.cvs.core/src/org/eclipse/team/tests/ccvs/ui/old/PrintDiffVisitor.java;1;0;2;1;0;0;0;2;0;1;2;2632;0;0;1;0;0;2;2;2632;0;4216;2;1;
/org.eclipse.debug.ui/ui/org/eclipse/debug/ui/launchVariables/WorkingSetComponent.java;1;0;2;1;0;0;0;2;0;1;2;550;0;0;1;0;0;2;2;550;0;562;2;1;
/org.eclipse.pde.ui/src/org/eclipse/pde/internal/ui/editor/IOpenablePropertySource.java;1;0;1;1;1;1;1;0;0;0;0;5431;0;0;1;0;0;0;1;5431;0;5431;1;1;
/org.eclipse.ui.intro/src/org/eclipse/ui/internal/intro/impl/model/IntroURLParser.java;2;1;4;1;4;4;4;0;8;0;0;5115;18;18;1;0;0;0;4;5115;0;6336;4;2;
/org.eclipse.pde.ui/src_samples/org/eclipse/pde/ui/internal/samples/ReviewPage.java;3;2;5;1;4;3;4;1;33;0;1;4538;55;55;2;0;1;1;5;5797;1;6336;4;3;
/org.eclipse.ui.workbench/Eclipse UI/org/eclipse/ui/dialogs/FileSystemElement.java;3;0;4;1;1;1;1;3;333;1;3;2737;403;403;1;0;0;3;4;2737;0;5464;4;3;
/org.eclipse.team.cvs.core/src/org/eclipse/team/internal/ccvs/core/syncinfo/MutableResourceSyncInfo.java;1;0;1;1;0;0;0;1;9;0;1;276;9;9;1;0;0;1;1;276;0;276;1;1;
/org.eclipse.debug.core/core/org/eclipse/debug/core/model/ILogicalStructureTypeDelegate.java;2;1;3;1;2;2;2;1;5;0;1;2663;9;9;1;0;0;1;3;2663;0;6336;3;2;
/org.eclipse.update.ui.forms/Eclipse Forms/org/eclipse/ui/forms/IFormPart.java;1;0;5;1;0;0;0;5;126;3;3;3151;126;126;3;2;0;5;5;3174;2;4157;3;1;
/org.eclipse.jdt.core.tests.model/workspace/Resolve/src/ResolveLocalMethodDeclaration2.java;1;0;1;1;0;0;0;1;0;0;1;3303;0;0;1;0;0;1;1;3303;0;3303;1;1;
/org.eclipse.ui.workbench/Eclipse UI/org/eclipse/ui/IPresentationPreview.java;1;0;4;1;0;0;0;4;10;2;3;4235;14;14;2;1;0;4;4;4235;1;4603;3;1;
/org.eclipse.jdt.core.tests.model/workspace/Formatter/test361/A_out.java;1;0;1;1;0;0;0;1;0;0;1;3087;0;0;1;0;0;1;1;3087;0;3087;1;1;
/org.eclipse.jdt.ui.tests.refactoring/resources/ChangeTypeRefactoring/positive/A_testLocalSuperTypesOfArrayList_out.java;1;0;1;1;0;0;0;1;0;0;1;2844;0;0;1;0;0;1;1;2844;0;2844;1;1;
/org.eclipse.webdav/src/interface/org/eclipse/webdav/dom/QualifiedNameImpl.java;1;0;2;1;2;1;2;0;146;0;0;5151;146;146;2;0;1;0;2;5151;1;5151;1;1;
/org.eclipse.team.tests.cvs.core/src/org/eclipse/team/tests/ccvs/core/subscriber/CVSMergeSubscriberTest.java;2;1;27;2;2;2;2;25;324;2;23;725;1197;1197;2;2;0;25;27;1237;2;6337;25;2;
/org.eclipse.jdt.core.tests.model/workspace/Converter/src/javadoc/testBug48489/TestB.java;1;0;1;1;0;0;0;1;0;0;1;3890;0;0;1;0;0;1;1;3890;0;3890;1;1;
/org.eclipse.jdt.ui.tests.refactoring/resources/IntroduceFactory/Bugzilla/59283/proj2/pB/B.java;1;0;1;1;1;1;1;0;0;0;0;5661;0;0;1;0;0;0;1;5661;0;5661;1;1;
/org.eclipse.jdt.ui/core extension/org/eclipse/jdt/internal/corext/textmanipulation/ReplaceEdit.java;1;0;3;1;0;0;0;3;4;0;1;1946;4;4;3;2;0;3;3;1946;2;1946;1;1;
/org.eclipse.jdt.ui.tests.refactoring/resources/ExtractMethodWorkSpace/ExtractMethodTests/branch_in/A_test751.java;1;0;2;1;0;0;0;2;4;1;2;844;4;4;1;0;0;2;2;844;0;2256;2;1;
/org.eclipse.jdt.ui.examples.javafamily/src/org/eclipse/jsp/JspUIPlugin.java;3;0;7;1;0;0;0;7;98;1;7;1168;144;144;1;0;0;7;7;1168;0;3235;7;3;
/org.eclipse.jdt.ui/ui/org/eclipse/jdt/internal/ui/text/SingleTokenJavaScanner.java;1;0;1;1;1;1;1;0;2;0;0;6340;2;2;1;0;0;0;1;6340;0;6340;1;1;
/org.eclipse.jdt.core.tests.model/workspace/Formatter/test249/A_out.java;1;0;1;1;0;0;0;1;0;0;1;2442;0;0;1;0;0;1;1;2442;0;2442;1;1;
/org.eclipse.jdt.core.tests.model/workspace/Converter/src/test0245/Test.java;1;0;1;1;0;0;0;1;0;0;1;3714;0;0;1;0;0;1;1;3714;0;3714;1;1;
/org.eclipse.pde.ui/src_ant/org/eclipse/pde/internal/ui/ant/FeatureExportTask.java;1;0;2;1;1;1;1;1;10;0;1;4686;10;10;1;0;0;1;2;4686;0;6336;2;1;
/org.eclipse.ui.workbench.texteditor/src/org/eclipse/ui/texteditor/PreferencesAdapter.java;2;1;4;1;2;2;2;2;143;1;2;4128;151;151;1;0;0;2;4;4128;0;5177;4;2;
/org.eclipse.core.runtime/src/org/eclipse/core/internal/jobs/CompoundRule.java;1;0;2;1;0;0;0;2;0;1;2;1133;0;0;1;0;0;2;2;1133;0;1415;2;1;
/org.eclipse.team.core/src/org/eclipse/team/core/sync/ISyncTreeSubscriber.java;1;0;1;1;0;0;0;1;0;0;1;431;0;0;1;0;0;1;1;431;0;431;1;1;
/org.eclipse.core.runtime.osgi/src/org/eclipse/core/runtime/IProgressMonitorWithBlocking.java;1;0;1;1;0;0;0;1;0;0;1;3013;0;0;1;0;0;1;1;3013;0;3013;1;1;
/org.eclipse.ui.views/src/org/eclipse/ui/views/internal/markers/CreationTime.java;1;0;2;1;0;0;0;2;0;1;2;265;0;0;1;0;0;2;2;265;0;749;2;1;
/org.eclipse.core.resources/src/org/eclipse/core/resources/IResourceProxyVisitor.java;1;0;2;1;1;1;1;1;4;0;1;4994;6;6;1;0;0;1;2;4994;0;5146;2;1;
/org.eclipse.pde.ui/src_Forms/org/eclipse/pde/internal/ui/model/AbstractEditingModel.java;3;1;18;1;13;13;13;5;57;1;5;4438;203;203;1;0;0;5;18;4438;0;6336;18;3;
/org.eclipse.jdt.ui.tests.refactoring/resources/UseSupertypeWherePossible/testNew1/out/A.java;1;0;1;1;0;0;0;1;3;0;1;1272;3;3;1;0;0;1;1;1272;0;1272;1;1;
/org.eclipse.jdt.ui.tests.refactoring/resources/MoveInstanceMethod/canMove/test20/out/StarDecorator.java;1;0;1;1;0;0;0;1;0;0;1;1586;0;0;1;0;0;1;1;1586;0;1586;1;1;
/org.eclipse.jdt.debug.tests/tests/org/eclipse/jdt/debug/tests/core/FolderSourceContainerTests.java;1;0;4;1;0;0;0;4;64;1;4;3679;76;76;1;0;0;4;4;3679;0;4949;4;1;
/org.eclipse.jdt.ui.tests.refactoring/resources/ExtractMethodWorkSpace/ExtractMethodTests/expression_out/A_test614.java;1;0;4;1;0;0;0;4;4;1;4;130;5;5;1;0;0;4;4;130;0;1474;4;1;
/org.eclipse.update.ui/srcnew/org/eclipse/update/internal/ui/views/SwapVersionAction.java;2;0;3;1;0;0;0;3;10;1;3;339;10;10;1;0;0;3;3;339;0;825;3;2;
/org.eclipse.jdt.ui/ui/org/eclipse/jdt/internal/ui/javaeditor/selectionactions/StructureSelectNextAction.java;2;1;2;1;2;2;2;0;34;0;0;6144;36;36;1;0;0;0;2;6144;0;6340;2;2;
/org.eclipse.jdt.core.tests.model/workspace/Formatter/test105/A_out.java;1;0;1;1;0;0;0;1;0;0;1;2425;0;0;1;0;0;1;1;2425;0;2425;1;1;
/org.eclipse.swt/Eclipse SWT PI/win32/org/eclipse/swt/internal/win32/MENUBARINFO.java;2;0;2;1;1;1;1;1;4;0;1;4113;4;4;1;0;0;1;2;4113;0;6352;2;2;
/org.eclipse.team.cvs.core/src/org/eclipse/team/internal/ccvs/core/util/PrepareForReplaceVisitor.java;1;0;1;1;0;0;0;1;7;0;1;2529;7;7;1;0;0;1;1;2529;0;2529;1;1;
/org.eclipse.swt.graphics.text/org.eclipse.swt.20031111/Eclipse SWT PI/gtk/org/eclipse/swt/internal/gtk/OS.java;2;0;2;1;0;0;0;2;0;1;2;2805;0;0;1;0;0;2;2;2805;0;2937;2;2;
/org.eclipse.update/src/org/eclipse/update/internal/ui/JarVerificationResult.java;1;0;1;1;1;1;1;0;0;0;0;6339;0;0;1;0;0;0;1;6339;0;6339;1;1;
/org.eclipse.jdt.core.tests.model/workspace/Completion/src/z1/z2/qla0/Wla.java;1;0;1;1;0;0;0;1;0;0;1;3253;0;0;1;0;0;1;1;3253;0;3253;1;1;
/org.eclipse.update.core/src/org/eclipse/update/core/model/PluginParser.java;1;0;1;1;0;0;0;1;0;0;1;2749;0;0;1;0;0;1;1;2749;0;2749;1;1;
/org.eclipse.ui.externaltools/Ant Editor/org/eclipse/ui/externaltools/internal/ant/editor/text/AntEditorProcInstrScanner.java;1;0;2;1;0;0;0;2;0;1;2;178;0;0;1;0;0;2;2;178;0;282;2;1;
/org.eclipse.jdt.ui.tests.refactoring/resources/TypeConstraints/A_testConstraints17.java;1;0;1;1;0;0;0;1;0;0;1;60;0;0;1;0;0;1;1;60;0;60;1;1;
/org.eclipse.ui.editors/src/org/eclipse/ui/editors/text/IEncodingActionsDefinitionIds.java;1;1;2;1;2;2;2;0;7;0;0;5918;12;12;1;0;0;0;2;5918;0;6334;2;1;
/org.eclipse.core.tests.runtime/src/org/eclipse/core/tests/internal/plugin/d/api/ApiClass.java;1;0;1;1;1;1;1;0;11;0;0;5149;11;11;1;0;0;0;1;5149;0;5149;1;1;
/org.eclipse.core.tools/src/org/eclipse/core/tools/GlobalAction.java;1;0;1;1;1;1;1;0;0;0;0;6302;0;0;1;0;0;0;1;6302;0;6302;1;1;
/org.eclipse.jdt.core.tests.model/workspace/JavaSearch/src/j4/CF47209.java;1;0;1;1;0;0;0;1;0;0;1;3330;0;0;1;0;0;1;1;3330;0;3330;1;1;
/org.eclipse.team.ui/src/org/eclipse/team/ui/synchronize/viewers/UnchangedResourceModelElement.java;1;0;3;1;0;0;0;3;42;2;2;4213;42;42;2;1;0;3;3;4213;1;4588;2;1;
/org.eclipse.jdt.core.tests.model/workspace/Converter/src/test0484/A.java;1;0;1;1;0;0;0;1;0;0;1;3714;0;0;1;0;0;1;1;3714;0;3714;1;1;
/org.eclipse.core.runtime.osgi/src/org/eclipse/core/internal/registry/IModel.java;1;0;1;1;0;0;0;1;0;0;1;3013;0;0;1;0;0;1;1;3013;0;3013;1;1;
/org.eclipse.jdt.ui/ui/org/eclipse/jdt/internal/ui/wizards/buildpaths/LibrariesWorkbookPage.java;4;4;22;1;10;7;10;12;291;2;10;1146;568;568;4;2;3;12;22;5126;5;6340;17;4;
/org.eclipse.releng.basebuilder/plugins/org.eclipse.build.tools/org.eclipse.build.tools/src/org/eclipse/releng/FetchValidator.java;1;0;1;1;1;1;1;0;0;0;0;5735;0;0;1;0;0;0;1;5735;0;5735;1;1;
/org.eclipse.swt/Eclipse SWT Program/carbon/org/eclipse/swt/program/Program.java;2;1;3;1;2;2;2;1;16;0;1;2665;22;22;1;0;0;1;3;2665;0;6352;3;2;
/org.eclipse.ant.ui/Ant Editor/org/eclipse/ant/ui/internal/dtd/schema/AntDTDSchemaMessages.java;1;0;2;1;0;0;0;2;0;1;2;250;0;0;1;0;0;2;2;250;0;1811;2;1;
/org.eclipse.swt/Eclipse SWT/motif/org/eclipse/swt/widgets/MessageBox.java;4;1;6;1;4;4;4;2;20;1;2;270;37;37;1;0;0;2;6;270;0;6352;6;4;
/org.eclipse.ui.views/src/org/eclipse/ui/views/markers/internal/FieldDone.java;2;0;2;1;0;0;0;2;0;1;2;755;0;0;1;0;0;2;2;755;0;2738;2;2;
/org.eclipse.ui.workbench.texteditor/src/org/eclipse/ui/texteditor/IStatusField.java;2;0;2;2;2;1;2;0;15;0;0;6334;15;15;2;0;1;0;2;6334;1;6334;1;2;
/org.eclipse.team.cvs.ui/src/org/eclipse/team/internal/ccvs/ui/actions/ShowHistoryAction.java;2;1;3;1;2;2;2;1;2;0;1;243;6;6;1;0;0;1;3;243;0;6337;3;2;
/org.eclipse.ui.workbench/Eclipse UI/org/eclipse/ui/internal/commands/ContextBinding.java;2;0;14;1;1;1;1;13;71;1;13;607;261;261;1;0;0;13;14;607;0;5231;14;2;
/org.eclipse.ui.workbench/Eclipse UI/org/eclipse/ui/internal/contexts/api/IContextRegistryListener.java;1;0;2;1;0;0;0;2;0;1;2;1724;0;0;1;0;0;2;2;1724;0;2425;2;1;
/org.eclipse.pde.ui/sandbox/org/eclipse/pde/internal/ui/editor/standalone/parser/XEErrorReporter.java;1;0;2;1;0;0;0;2;0;1;2;2320;0;0;1;0;0;2;2;2320;0;2931;2;1;
/org.eclipse.team.tests.core/src/org/eclipse/team/tests/ui/synchronize/TestSyncInfo.java;2;0;4;1;1;1;1;3;13;2;2;3715;15;15;2;1;0;3;4;3715;1;6337;3;2;
/org.eclipse.ant.ui/Ant Tools Support/org/eclipse/ant/internal/ui/preferences/AntEditorPreferenceConstants.java;1;2;15;1;7;6;7;8;264;2;7;1811;548;548;2;1;1;8;15;4068;2;6080;13;1;
/org.eclipse.jdt.ui.tests.refactoring/resources/ExtractMethodWorkSpace/ExtractMethodTests/locals_in/A_test524.java;1;0;2;1;0;0;0;2;4;1;2;130;6;6;1;0;0;2;2;130;0;844;2;1;
/org.eclipse.jdt.ui.tests.refactoring/resources/MoveInnerToTopLevel/test_nonstatic_33/in/A.java;1;0;1;1;0;0;0;1;4;0;1;305;4;4;1;0;0;1;1;305;0;305;1;1;
/org.eclipse.debug.ui/ui/org/eclipse/debug/ui/launchVariables/expanders/ContainerExpander.java;1;0;2;1;0;0;0;2;0;1;2;562;0;0;1;0;0;2;2;562;0;737;2;1;
/org.eclipse.ui.ide/src/org/eclipse/ui/internal/ide/misc/ContainerContentProvider.java;2;0;2;1;0;0;0;2;6;1;2;2264;6;6;1;0;0;2;2;2264;0;3012;2;2;
/org.eclipse.ui.workbench/Eclipse UI/org/eclipse/ui/presentations/PresentationUtil.java;3;1;11;1;2;2;2;9;36;2;8;4472;112;112;2;1;0;9;11;4809;1;6340;10;3;
/org.eclipse.core.resources/src/org/eclipse/core/internal/resources/RootInfo.java;1;0;2;1;1;1;1;1;52;0;1;3063;60;60;1;0;0;1;2;3063;0;5146;2;1;
/org.eclipse.ui.workbench/Eclipse UI/org/eclipse/ui/internal/commands/ICommandDefinition.java;1;0;4;1;0;0;0;4;68;1;4;1422;74;74;1;0;0;4;4;1422;0;3128;4;1;
/org.eclipse.ui.ide/src/org/eclipse/ui/views/markers/internal/ActionCopyMarker.java;5;1;7;1;2;2;2;5;19;1;5;2208;45;45;1;0;0;5;7;2208;0;6338;7;5;
/org.eclipse.jdt.core/eval/org/eclipse/jdt/internal/eval/CodeSnippetParser.java;5;0;18;1;0;0;0;18;196;1;18;69;314;314;1;0;0;18;18;69;0;3762;18;5;
/org.eclipse.jdt.ui/ui refactoring/org/eclipse/jdt/internal/ui/refactoring/ExtractInterfaceWizard.java;3;0;8;1;1;1;1;7;231;1;7;518;370;370;1;0;0;7;8;518;0;6340;8;3;
/org.eclipse.ui.workbench/Eclipse UI/org/eclipse/ui/commands/IWorkbenchPageCommandSupport.java;1;0;4;1;0;0;0;4;11;2;3;3129;13;13;2;1;0;4;4;3129;1;4144;3;1;
/org.eclipse.ui.tests/Eclipse UI Tests/org/eclipse/ui/tests/navigator/TestLightweightDecoratorMultipleQuadrantContributor.java;1;0;1;1;1;1;1;0;0;0;0;5108;0;0;1;0;0;0;1;5108;0;5108;1;1;
/org.eclipse.ui.workbench/Eclipse UI/org/eclipse/ui/internal/skins/StackDropResult.java;2;0;3;1;0;0;0;3;10;1;3;4328;10;10;1;0;0;3;3;4328;0;4469;3;2;
/org.eclipse.jdt.ui.tests.refactoring/resources/ExtractInterface/testConditional2/in/X.java;1;0;1;1;0;0;0;1;0;0;1;3902;0;0;1;0;0;1;1;3902;0;3902;1;1;
/org.eclipse.webdav/src/interface/org/eclipse/webdav/internal/utils/URLEncoder.java;1;0;2;1;2;1;2;0;271;0;0;5151;271;271;2;0;1;0;2;5151;1;5151;1;1;
/org.eclipse.jdt.core/search/org/eclipse/jdt/internal/core/search/matching/ConstructorDeclarationPattern.java;1;0;2;1;0;0;0;2;20;1;2;786;20;20;1;0;0;2;2;786;0;1115;2;1;
/org.eclipse.jdt.ui/core refactoring/org/eclipse/jdt/internal/corext/refactoring/rename/TextMatchFinder.java;3;0;8;1;0;0;0;8;91;2;7;1126;175;175;2;1;0;8;8;1953;1;4585;7;3;
/org.eclipse.jdt.core.tests.model/workspace/Resolve/src/ResolveLocalClass2.java;1;0;1;1;0;0;0;1;0;0;1;1968;0;0;1;0;0;1;1;1968;0;1968;1;1;
/org.eclipse.jdt.ui/ui/org/eclipse/jdt/internal/ui/text/link/LinkedPositionUI.java;3;0;9;1;0;0;0;9;81;2;7;1132;237;237;2;2;0;9;9;2133;2;3030;7;3;
/org.eclipse.ui.ide/src/org/eclipse/ui/internal/DefaultContributorResourceAdapter.java;2;0;2;1;0;0;0;2;0;1;2;1520;0;0;1;0;0;2;2;1520;0;1680;2;2;
/org.eclipse.jdt.ui/ui/org/eclipse/jdt/internal/ui/preferences/formatter/IndentationTabPage.java;1;0;11;1;0;0;0;11;74;2;10;3103;251;251;2;1;0;11;11;3103;1;3998;10;1;
/org.eclipse.ui.workbench.texteditor/src/org/eclipse/ui/texteditor/RetargetTextEditorAction.java;2;2;3;2;3;2;3;0;9;0;0;5123;14;14;2;0;1;0;3;6334;1;6334;2;2;
/org.eclipse.jdt.ui/core extension/org/eclipse/jdt/internal/corext/dom/fragments/ASTFragment.java;1;0;1;1;1;1;1;0;2;0;0;6340;2;2;1;0;0;0;1;6340;0;6340;1;1;
/org.eclipse.pde.ui/src/org/eclipse/pde/internal/ui/editor/manifest/ManifestSourceOutlinePage.java;1;0;2;1;1;1;1;1;4;0;1;648;4;4;1;0;0;1;2;648;0;5431;2;1;
/org.eclipse.jdt.core.tests.model/workspace/Converter/src/test0485/A.java;1;0;1;1;0;0;0;1;0;0;1;3714;0;0;1;0;0;1;1;3714;0;3714;1;1;
/org.eclipse.jdt.core.tests.model/workspace/Converter/src/test0532/A.java;1;0;3;1;0;0;0;3;0;1;3;3714;0;0;1;0;0;3;3;3714;0;3741;3;1;
/org.eclipse.update.ui/src/org/eclipse/update/internal/ui/wizards/ActivitiesTableViewer.java;3;0;7;1;1;1;1;6;50;2;5;825;171;171;2;1;0;6;7;4376;1;6336;6;3;
/org.eclipse.update.tests.core/src/org/eclipse/update/tests/core/boot/TestPlatCfgDefault.java;1;1;2;1;2;2;2;0;12;0;0;5271;16;16;1;0;0;0;2;5271;0;6336;2;1;
/org.eclipse.pde.ui/src_ant/org/eclipse/pde/internal/ui/ant/BaseExportTask.java;1;1;4;1;2;2;2;2;10;1;2;4686;20;20;1;0;0;2;4;4686;0;6336;4;1;
/org.eclipse.jdt.core.tests.model/workspace/Formatter/test493/MyClass_in.java;1;0;1;1;1;1;1;0;0;0;0;5254;0;0;1;0;0;0;1;5254;0;5254;1;1;
/org.eclipse.team.ui/src/org/eclipse/team/internal/ui/synchronize/sets/WorkingSetSyncSetInput.java;1;0;3;1;0;0;0;3;44;1;3;2535;44;44;1;0;0;3;3;2535;0;4216;3;1;
/org.eclipse.jdt.core.tests.model/workspace/Completion/src3/test0003/Test.java;1;0;1;1;0;0;0;1;0;0;1;5010;0;0;1;0;0;1;1;5010;0;5010;1;1;
/org.eclipse.team.ui/src/org/eclipse/team/ui/synchronize/presentation/AdaptableDiffNode.java;1;0;1;1;0;0;0;1;0;0;1;4077;0;0;1;0;0;1;1;4077;0;4077;1;1;
/org.eclipse.core.runtime/src/org/eclipse/core/runtime/ILibrary.java;3;2;10;1;4;3;4;6;153;2;5;3013;292;292;2;1;1;6;10;5038;2;6340;8;3;
/org.eclipse.update.core/src/org/eclipse/update/core/IFeatureContentProvider.java;2;1;4;1;3;3;3;1;6;0;1;890;16;16;1;0;0;1;4;890;0;6336;4;2;
/org.eclipse.team.ui/src/org/eclipse/team/ui/synchronize/TeamSubscriberParticipantLabelProvider.java;2;0;6;1;0;0;0;6;211;1;6;2584;295;295;1;0;0;6;6;2584;0;4216;6;2;
/org.eclipse.ui.intro/src/org/eclipse/ui/intro/internal/model/IntroContainerExtension.java;1;0;7;1;0;0;0;7;108;1;7;4429;131;131;1;0;0;7;7;4429;0;4948;7;1;
/org.eclipse.update.configurator/src/org/eclipse/update/configurator/ConfigurationActivator.java;3;0;15;2;0;0;0;15;51;3;12;3014;247;247;3;3;0;15;15;3126;3;3292;12;3;
/org.eclipse.jdt.core/compiler/org/eclipse/jdt/internal/compiler/ast/DefaultCase.java;1;0;1;1;0;0;0;1;0;0;1;148;0;0;1;0;0;1;1;148;0;148;1;1;
/org.eclipse.core.tests.runtime/src/org/eclipse/core/tests/internal/runtime/CipherTest.java;1;0;1;1;1;1;1;0;201;0;0;5149;201;201;1;0;0;0;1;5149;0;5149;1;1;
/org.eclipse.core.resources/src/org/eclipse/core/internal/localstore/ILocalStoreConstants.java;1;0;1;1;1;1;1;0;6;0;0;5146;6;6;1;0;0;0;1;5146;0;5146;1;1;
/org.eclipse.jdt.ui/core refactoring/org/eclipse/jdt/internal/corext/refactoring/NullChange.java;1;0;2;1;0;0;0;2;3;1;2;3708;3;3;1;0;0;2;2;3708;0;3930;2;1;
/org.eclipse.jdt.ui.tests.refactoring/resources/MoveMembers/test40/in/B.java;1;0;1;1;0;0;0;1;0;0;1;4630;0;0;1;0;0;1;1;4630;0;4630;1;1;
/org.eclipse.jdt.ui.examples.javafamily/src/org/eclipse/jdt/internal/ui/search2/JavaSearchOperation.java;2;0;3;1;0;0;0;3;2;1;3;1033;3;3;1;0;0;3;3;1033;0;2862;3;2;
/org.eclipse.ui.views/src/org/eclipse/ui/views/markers/internal/ActionResolveMarker.java;2;0;2;1;0;0;0;2;0;1;2;755;0;0;1;0;0;2;2;755;0;2738;2;2;
/org.eclipse.update.ui/src/org/eclipse/update/internal/ui/parts/PixelConverter.java;2;1;4;1;2;2;2;2;17;1;2;807;29;29;1;0;0;2;4;807;0;6336;4;2;
/org.eclipse.swt/Eclipse SWT AWT/win32/org/eclipse/swt/internal/awt/SWT_AWT.java;1;0;5;1;0;0;0;5;71;2;3;1650;73;73;2;2;0;5;5;2995;2;3012;3;1;
/org.eclipse.jdt.ui/ui/org/eclipse/jdt/internal/ui/text/LineBreakingReader.java;1;0;1;1;1;1;1;0;2;0;0;6340;2;2;1;0;0;0;1;6340;0;6340;1;1;
/org.eclipse.pde.ui/src/org/eclipse/pde/internal/ui/editor/context/IInputContextListener.java;1;1;2;1;2;2;2;0;10;0;0;5431;10;10;1;0;0;0;2;5431;0;6336;2;1;
/org.eclipse.jdt.ui/core refactoring/org/eclipse/ltk/internal/refactoring/core/ListenerList.java;1;0;2;1;0;0;0;2;0;1;2;3708;0;0;1;0;0;2;2;3708;0;4510;2;1;
/org.eclipse.jdt.ui/ui/org/eclipse/jdt/internal/ui/text/javadoc/JavaDocMessages.java;1;0;1;1;1;1;1;0;2;0;0;6340;2;2;1;0;0;0;1;6340;0;6340;1;1;
/org.eclipse.debug.core/core/org/eclipse/debug/internal/core/memory/MemoryRenderingInfo.java;2;1;2;1;2;2;2;0;13;0;0;5254;13;13;1;0;0;0;2;5254;0;5672;2;2;
/org.eclipse.jdt.core.tests.model/src/org/eclipse/jdt/core/tests/model/SortCompilationUnitElementsTests.java;2;0;6;1;1;1;1;5;186;1;5;95;336;336;1;0;0;5;6;95;0;6144;6;2;
/org.eclipse.team.cvs.core/src/org/eclipse/team/internal/ccvs/core/client/Annotate.java;1;0;1;1;0;0;0;1;0;0;1;784;0;0;1;0;0;1;1;784;0;784;1;1;
/org.eclipse.ant.ui/Ant Editor/org/eclipse/ant/internal/ui/editor/text/XMLAnnotationIterator.java;1;0;1;1;0;0;0;1;0;0;1;1811;0;0;1;0;0;1;1;1811;0;1811;1;1;
/org.eclipse.jdt.ui/ui/org/eclipse/jdt/internal/ui/javaeditor/ExternalClassFileEditorInput.java;1;0;1;1;1;1;1;0;2;0;0;6340;2;2;1;0;0;0;1;6340;0;6340;1;1;
/org.eclipse.swt/Eclipse SWT PI/motif/org/eclipse/swt/internal/motif/XMotionEvent.java;1;0;1;1;0;0;0;1;16;0;1;868;16;16;1;0;0;1;1;868;0;868;1;1;
/org.eclipse.swt/Eclipse SWT/motif/org/eclipse/swt/widgets/ProgressBar.java;3;1;6;1;2;2;2;4;85;2;3;269;113;113;2;1;0;4;6;2368;1;6352;5;3;
/org.eclipse.pde.ui/src/org/eclipse/pde/internal/ui/editor/manifest/ImportListSection.java;1;0;9;1;1;1;1;8;45;1;8;648;76;76;1;0;0;8;9;648;0;5431;9;1;
/org.eclipse.help.webapp/src_servlets/org/eclipse/help/internal/webapp/data/WebappPreferences.java;1;1;9;1;6;6;6;3;40;1;3;622;95;95;1;0;0;3;9;622;0;6337;9;1;
/org.eclipse.sdk.tests-feature/plugins/org.eclipse.perfmsr.ui/src/org/eclipse/perfmsr/ui/LabelFieldEditor.java;2;1;3;1;2;2;2;1;18;0;1;4845;28;28;1;0;0;1;3;4845;0;6342;3;2;
/org.eclipse.update.ui.forms/Eclipse Forms/org/eclipse/ui/forms/parts/FormLabel.java;1;0;2;1;0;0;0;2;0;0;1;3096;0;0;2;1;0;2;2;3096;1;3096;1;1;
/org.eclipse.jdt.core.tests.model/workspace/Converter/src/test0350/Test2.java;1;0;1;1;0;0;0;1;0;0;1;3714;0;0;1;0;0;1;1;3714;0;3714;1;1;
/org.eclipse.jdt.core.tests.model/workspace/Formatter/test407/A_in.java;1;0;1;1;0;0;0;1;0;0;1;3438;0;0;1;0;0;1;1;3438;0;3438;1;1;
/org.eclipse.swt.tests/JUnit Tests/org/eclipse/swt/tests/junit/Test_org_eclipse_swt_browser_ProgressAdapter.java;1;0;2;1;0;0;0;2;11;1;2;2104;11;11;1;0;0;2;2;2104;0;2863;2;1;
/org.eclipse.jdt.core.tests.model/workspace/Converter/test0086/Test.java;1;0;1;1;0;0;0;1;0;0;1;3714;0;0;1;0;0;1;1;3714;0;3714;1;1;
/org.eclipse.ui.workbench/Eclipse UI/org/eclipse/ui/contexts/IContextActivationServiceEvent.java;1;0;4;1;0;0;0;4;4;1;4;1220;6;6;1;0;0;4;4;1220;0;3109;4;1;
/org.eclipse.pde.core/src/org/eclipse/pde/internal/core/schema/ExternalSchemaDescriptor.java;3;1;5;1;2;2;2;3;6;1;3;2184;23;23;1;0;0;3;5;2184;0;6336;5;3;
/org.eclipse.update.tests.core/src/org/eclipse/update/tests/parser/TestFeatureParse.java;2;0;3;1;1;1;1;2;4;1;2;3813;8;8;1;0;0;2;3;3813;0;6336;3;2;
/org.eclipse.jdt.debug.ui/ui/org/eclipse/jdt/internal/debug/ui/CoreResourcesIContainerVariablesContentProvider.java;1;0;2;1;0;0;0;2;0;1;2;807;0;0;1;0;0;2;2;807;0;861;2;1;
/org.eclipse.swt/Eclipse SWT PI/win32/org/eclipse/swt/internal/win32/NMLVDISPINFO.java;1;0;1;1;0;0;0;1;0;0;1;2916;0;0;1;0;0;1;1;2916;0;2916;1;1;
/org.eclipse.pde.core/src/org/eclipse/pde/core/IModelProviderEvent.java;2;1;4;1;3;3;3;1;91;0;1;2230;99;99;1;0;0;1;4;2230;0;6336;4;2;
/org.eclipse.pde.ui/src/org/eclipse/pde/ui/IProjectProvider.java;1;1;2;1;2;2;2;0;64;0;0;5115;64;64;1;0;0;0;2;5115;0;5204;2;1;
/org.eclipse.pde.core/src/org/eclipse/pde/internal/core/XMLDefaultHandler.java;1;0;6;1;1;1;1;5;68;1;5;2906;82;82;1;0;0;5;6;2906;0;6336;6;1;
/org.eclipse.ant.ui/Ant Editor/org/eclipse/ant/internal/ui/editor/formatter/FormattingPreferences.java;1;1;7;1;2;2;2;5;79;1;5;3916;145;145;1;0;0;5;7;3916;0;5739;7;1;
/org.eclipse.core.tests.resources/src/org/eclipse/core/tests/internal/alias/SyncAliasTest.java;1;0;2;1;2;1;2;0;8;0;0;5147;8;8;2;0;1;0;2;5147;1;5147;1;1;
/org.eclipse.ui.workbench/Eclipse UI/org/eclipse/ui/internal/roles/api/secondstage/IRoleRegistry.java;1;0;2;1;0;0;0;2;0;1;2;2199;0;0;1;0;0;2;2;2199;0;2207;2;1;
/org.eclipse.jdt.core/formatter/org/eclipse/jdt/internal/formatter/DefaultCodeFormatter.java;4;2;39;2;5;4;5;34;178;3;29;822;1176;1176;3;5;1;34;39;2037;6;6077;33;4;
/org.eclipse.pde.core/src/org/eclipse/pde/internal/core/RequiredPluginsClasspathContainer.java;2;1;6;1;2;2;2;4;53;1;4;2617;72;72;1;0;0;4;6;2617;0;6336;6;2;
/org.eclipse.core.tests.resources/src/org/eclipse/core/tests/resources/TestPerformer.java;2;0;4;1;2;1;2;2;199;1;2;4999;215;215;2;0;1;2;4;5147;1;5147;3;2;
/org.eclipse.jdt.core.tests.model/workspace/Converter/src/javadoc/test016/TestB2.java;1;0;2;1;0;0;0;2;0;1;2;4311;0;0;1;0;0;2;2;4311;0;4390;2;1;
/org.eclipse.jdt.core.tests.compiler/src/org/eclipse/jdt/core/tests/compiler/regression/AnnotationTestForInterface.java;1;0;4;1;0;0;0;4;36;1;4;2397;44;44;1;0;0;4;4;2397;0;2887;4;1;
/org.eclipse.ui.editors/src/org/eclipse/ui/internal/editors/quickdiff/restore/RevertLineAction.java;1;0;2;1;0;0;0;2;0;1;2;1118;0;0;1;0;0;2;2;1118;0;1214;2;1;
/org.eclipse.ui.workbench/Eclipse UI/org/eclipse/ui/internal/contexts/PreferenceRegistry.java;1;0;4;1;0;0;0;4;4;2;3;1356;6;6;2;1;0;4;4;1356;1;1396;3;1;
/org.eclipse.jdt.debug.tests/tests/org/eclipse/jdt/debug/tests/eval/NumericTypesCastTests.java;3;0;3;2;0;0;0;3;210;2;2;1274;218;218;2;1;0;3;3;1274;1;1782;2;3;
/org.eclipse.jdt.ui.tests.refactoring/resources/DeleteSourceReference/test5/in/A.java;1;0;1;1;0;0;0;1;0;0;1;1652;0;0;1;0;0;1;1;1652;0;1652;1;1;
/org.eclipse.pde.ui/src_Forms/org/eclipse/pde/internal/ui/neweditor/feature/FeatureInputContextManager.java;2;0;2;1;1;1;1;1;0;0;1;4926;0;0;1;0;0;1;2;4926;0;5431;2;2;
/org.eclipse.swt/Eclipse SWT/common/org/eclipse/swt/widgets/TypedListener.java;1;0;1;1;0;0;0;1;8;0;1;2729;8;8;1;0;0;1;1;2729;0;2729;1;1;
/org.eclipse.jdt.core/search/org/eclipse/jdt/internal/core/index/impl/BlocksIndexInput.java;3;0;8;2;0;0;0;8;57;2;7;1824;72;72;2;1;0;8;8;3211;1;4060;7;3;
/org.eclipse.ui.workbench/Eclipse UI/org/eclipse/ui/actions/PartEventAction.java;1;0;3;1;0;0;0;3;14;1;3;1527;26;26;1;0;0;3;3;1527;0;2853;3;1;
/org.eclipse.swt.tools/JNI Generation/org/eclipse/swt/tools/internal/SizeofGenerator.java;2;0;2;1;0;0;0;2;10;1;2;4175;10;10;1;0;0;2;2;4175;0;4270;2;2;
/org.eclipse.team.ui/src/org/eclipse/team/ui/synchronize/SyncInfoDiffViewerConfiguration.java;1;0;1;1;0;0;0;1;0;0;1;3617;0;0;1;0;0;1;1;3617;0;3617;1;1;
/org.eclipse.webdav/src/interface/org/eclipse/webdav/dom/Owner.java;1;0;2;1;2;1;2;0;30;0;0;5151;30;30;2;0;1;0;2;5151;1;5151;1;1;
/org.eclipse.swt/Eclipse SWT PI/win32/org/eclipse/swt/internal/win32/NMLVCUSTOMDRAW.java;1;0;1;1;0;0;0;1;1;0;1;2915;1;1;1;0;0;1;1;2915;0;2915;1;1;
/org.eclipse.jdt.ui/ui/org/eclipse/jdt/internal/ui/search/MatchFilter.java;1;2;6;1;6;5;6;0;31;0;0;5396;55;55;2;0;1;0;6;5396;1;6259;5;1;
/org.eclipse.ui.workbench/Eclipse UI/org/eclipse/ui/internal/roles/IRoleRegistryEvent.java;1;0;2;1;0;0;0;2;0;1;2;2444;0;0;1;0;0;2;2;2444;0;2805;2;1;
/org.eclipse.jdt.ui.tests.refactoring/resources/MoveInnerToTopLevel/test_nonstatic_17/out/Inner.java;1;0;1;1;1;1;1;0;2;0;0;5854;2;2;1;0;0;0;1;5854;0;5854;1;1;
/org.eclipse.ui.ide/extensions/org/eclipse/ui/IProjectActionFilter.java;3;2;4;1;3;2;3;1;4;0;1;2263;6;6;2;0;1;1;4;5127;1;6338;3;3;
/org.eclipse.ui.workbench/Eclipse UI/org/eclipse/ui/internal/csm/activities/service/IActivityServiceEvent.java;1;0;2;1;0;0;0;2;0;1;2;2370;0;0;1;0;0;2;2;2370;0;2444;2;1;
/org.eclipse.ui.workbench/Eclipse UI/org/eclipse/ui/internal/registry/ActionSetRegistry.java;4;1;4;1;2;2;2;2;37;1;2;3500;51;51;1;0;0;2;4;3500;0;6338;4;4;
/org.eclipse.jdt.core.tests.model/workspace/Formatter/test434/A_out.java;1;0;2;1;0;0;0;2;16;0;1;3495;16;16;2;1;0;2;2;3495;1;3495;1;1;
/org.eclipse.jdt.ui.examples.javafamily/src/org/eclipse/jface/text/source/TemporaryAnnotation.java;1;0;5;1;0;0;0;5;67;3;3;1150;69;69;3;2;0;5;5;1150;2;1642;3;1;
/org.eclipse.jdt.ui.tests/ui/org/eclipse/jdt/ui/tests/text/JavaDoc2HTMLTextReaderTester.java;1;0;1;1;0;0;0;1;0;0;1;4516;0;0;1;0;0;1;1;4516;0;4516;1;1;
/org.eclipse.ui.forms/src/org/eclipse/ui/forms/internal/widgets/RichTextModel.java;1;0;3;1;0;0;0;3;19;2;2;4068;19;19;2;1;0;3;3;4140;1;4140;2;1;
/org.eclipse.team.core/src/org/eclipse/team/core/synchronize/FastSyncInfoFilter.java;2;1;5;1;3;3;3;2;192;1;2;4045;239;239;1;0;0;2;5;4045;0;6336;5;2;
/org.eclipse.team.ftp/src/org/eclipse/team/internal/ftp/ui/subscriber/FTPPutAction.java;2;2;7;1;3;2;3;4;36;1;4;3373;67;67;2;0;1;4;7;5508;1;6337;6;2;
/org.eclipse.jdt.ui.tests.refactoring/resources/InlineMethodWorkspace/TestCases/argument_in/TestParameterNameUnused1.java;1;0;1;1;0;0;0;1;2;0;1;845;2;2;1;0;0;1;1;845;0;845;1;1;
/org.eclipse.ui.views/src/org/eclipse/ui/views/internal/markers/BookmarkView.java;1;0;2;1;0;0;0;2;0;0;1;749;0;0;2;1;0;2;2;749;1;749;1;1;
/org.eclipse.jdt.ui/core refactoring/org/eclipse/jdt/internal/corext/refactoring/reorg2/DeleteWizard.java;2;0;11;2;0;0;0;11;55;3;7;444;108;108;3;4;0;11;11;615;4;1114;7;2;
/org.eclipse.ui.intro/src/org/eclipse/ui/internal/intro/impl/parts/PageContentForm.java;1;2;5;1;5;4;5;0;21;0;0;5449;23;23;2;0;1;0;5;5533;1;5714;4;1;
/org.eclipse.pde.ui/src/org/eclipse/pde/internal/ui/wizards/plugin/NewProjectCreationPage.java;2;2;4;1;4;3;4;0;9;0;0;6147;15;15;2;0;1;0;4;6147;1;6336;3;2;
/org.eclipse.webdav/src/interface/org/eclipse/webdav/dom/Conflict.java;1;0;2;1;2;1;2;0;71;0;0;5151;71;71;2;0;1;0;2;5151;1;5151;1;1;
/org.eclipse.osgi/core/framework/org/eclipse/osgi/framework/internal/core/NothingToUpdateException.java;3;1;3;1;2;2;2;1;4;0;1;3013;6;6;1;0;0;1;3;3013;0;6337;3;3;
/org.eclipse.ui.workbench/Eclipse UI/org/eclipse/ui/internal/commands/old/IKeyManager.java;1;0;2;1;0;0;0;2;0;1;2;1321;0;0;1;0;0;2;2;1321;0;1357;2;1;
/org.eclipse.ui.ide/src/org/eclipse/ui/actions/NewProjectAction.java;2;0;4;1;0;0;0;4;15;1;4;1511;22;22;1;0;0;4;4;1511;0;2263;4;2;
/org.eclipse.ltk.ui.refactoring/src/org/eclipse/ltk/internal/ui/refactoring/RefactoringStatusContentProvider.java;1;0;2;1;1;1;1;1;2;0;1;4965;2;2;1;0;0;1;2;4965;0;6340;2;1;
/org.eclipse.compare/compare/org/eclipse/compare/structuremergeviewer/IDiffContainer.java;1;0;1;1;0;0;0;1;2;0;1;3938;2;2;1;0;0;1;1;3938;0;3938;1;1;
/org.eclipse.jdt.core.tests.model/workspace/Converter/junit/runner/TestSuiteLoader.java;1;0;1;1;0;0;0;1;0;0;1;3714;0;0;1;0;0;1;1;3714;0;3714;1;1;
/org.eclipse.debug.ui/ui/org/eclipse/debug/internal/ui/preferences/LaunchHistoryPreferenceTab.java;2;0;4;1;0;0;0;4;9;2;3;205;11;11;2;1;0;4;4;1276;1;2589;3;2;
/org.eclipse.team.cvs.ui/src/org/eclipse/team/internal/ccvs/ui/merge/ProjectElement.java;2;0;3;1;1;1;1;2;34;1;2;4869;38;38;1;0;0;2;3;4869;0;6337;3;2;
/org.eclipse.debug.core/core/org/eclipse/debug/core/variables/IContextLaunchVariableRegistry.java;1;0;3;1;0;0;0;3;28;1;3;562;28;28;1;0;0;3;3;562;0;754;3;1;
/org.eclipse.search.tests/src/org/eclipse/search/tests/filesearch/LineBasedFileSearch.java;1;0;1;1;1;1;1;0;0;0;0;5815;0;0;1;0;0;0;1;5815;0;5815;1;1;
/org.eclipse.jdt.core.tests.model/workspace/Converter/src/test0126/Test.java;1;0;1;1;0;0;0;1;0;0;1;3714;0;0;1;0;0;1;1;3714;0;3714;1;1;
/org.eclipse.swt/Eclipse SWT PI/win32/org/eclipse/swt/internal/win32/NMTTDISPINFOA.java;1;0;1;1;0;0;0;1;0;0;1;957;0;0;1;0;0;1;1;957;0;957;1;1;
/org.eclipse.jdt.core.tests.model/workspace/Converter/src/test0409/A.java;1;0;1;1;0;0;0;1;0;0;1;3714;0;0;1;0;0;1;1;3714;0;3714;1;1;
/org.eclipse.jdt.core.tests.model/workspace/Converter/test0173/Test.java;1;0;1;1;0;0;0;1;0;0;1;3714;0;0;1;0;0;1;1;3714;0;3714;1;1;
/org.eclipse.jdt.core.tests.model/workspace/Formatter/test467/A_out.java;1;0;1;1;0;0;0;1;0;0;1;3915;0;0;1;0;0;1;1;3915;0;3915;1;1;
/org.eclipse.ui.workbench/Eclipse UI/org/eclipse/ui/internal/commands/ActiveKeyConfiguration.java;1;0;2;1;0;0;0;2;77;1;2;1354;77;77;1;0;0;2;2;1354;0;1389;2;1;
/org.eclipse.jface.text/src/org/eclipse/jface/text/rules/BufferedRuleBasedScanner.java;1;0;1;1;1;1;1;0;2;0;0;6340;2;2;1;0;0;0;1;6340;0;6340;1;1;
/org.eclipse.jdt.ui/ui/org/eclipse/jdt/internal/ui/text/correction/CorrectionMessages.java;1;0;1;1;1;1;1;0;2;0;0;6340;2;2;1;0;0;0;1;6340;0;6340;1;1;
/org.eclipse.team.cvs.ui/src/org/eclipse/team/internal/ccvs/ui/subscriber/CVSWorkspaceSynchronizeParticipant.java;1;0;1;1;0;0;0;1;0;0;1;2463;0;0;1;0;0;1;1;2463;0;2463;1;1;
/org.eclipse.jdt.ui.tests.refactoring/resources/RenameStaticMethod/test10/in/A.java;1;0;1;1;0;0;0;1;0;0;1;1347;0;0;1;0;0;1;1;1347;0;1347;1;1;
/org.eclipse.core.tests.resources/src/org/eclipse/core/tests/internal/utils/ObjectMapTest.java;1;3;4;1;4;2;4;0;20;0;0;5147;32;32;3;0;2;0;4;5147;2;5682;2;1;
/org.eclipse.ui.tests/Eclipse UI Tests/org/eclipse/ui/tests/dnd/FastViewBarDropTarget.java;1;0;2;1;1;1;1;1;7;0;1;5007;7;7;1;0;0;1;2;5007;0;5825;2;1;
/org.eclipse.jdt.ui.tests.refactoring/test cases/org/eclipse/jdt/ui/tests/actions/GoToNextPreviousMemberActionTests.java;2;0;2;1;1;1;1;1;3;0;1;1311;5;5;1;0;0;1;2;1311;0;6340;2;2;
/org.eclipse.ui.workbench/Eclipse UI/org/eclipse/ui/internal/commands/CommandDelegateService.java;1;0;3;1;0;0;0;3;1;1;3;1321;1;1;1;0;0;3;3;1321;0;1419;3;1;
/org.eclipse.team.ui/src/org/eclipse/team/ui/synchronize/SyncInfoSetSynchronizePage.java;2;2;3;2;3;2;3;0;309;0;0;5314;309;309;2;0;1;0;3;5358;1;5358;2;2;
/org.eclipse.jdt.ui/core refactoring/org/eclipse/jdt/internal/corext/refactoring/reorg/ArrayTypeConverter.java;2;0;2;1;1;1;1;1;2;0;1;1114;2;2;1;0;0;1;2;1114;0;6340;2;2;
/org.eclipse.osgi/resolver/src/org/eclipse/core/internal/dependencies/ISelectionPolicy.java;1;0;1;1;1;1;1;0;0;0;0;5226;0;0;1;0;0;0;1;5226;0;5226;1;1;
/org.eclipse.pde.ui/src/org/eclipse/pde/internal/ui/editor/text/PDEWhitespaceDetector.java;1;0;1;1;0;0;0;1;0;0;1;3795;0;0;1;0;0;1;1;3795;0;3795;1;1;
/org.eclipse.jdt.core.tests.model/workspace/Converter/src/test0477/A.java;1;0;1;1;0;0;0;1;0;0;1;3714;0;0;1;0;0;1;1;3714;0;3714;1;1;
/org.eclipse.ui.views/src/org/eclipse/ui/views/navigator/ProjectContentProvider.java;1;0;1;1;0;0;0;1;0;0;1;1014;0;0;1;0;0;1;1;1014;0;1014;1;1;
/org.eclipse.jdt.ui.tests.refactoring/resources/ChangeTypeRefactoring/positive/A_testParameterTypeWithOverriding2_out.java;1;0;1;1;0;0;0;1;0;0;1;2844;0;0;1;0;0;1;1;2844;0;2844;1;1;
/org.eclipse.jface.text/src/org/eclipse/jface/text/ITextDoubleClickStrategy.java;2;1;3;1;3;3;3;0;12;0;0;5106;16;16;1;0;0;0;3;5106;0;6359;3;2;
/org.eclipse.team.ui/src/org/eclipse/team/internal/ui/wizards/GlobalRefreshParticipantSelectionPage.java;2;1;5;1;2;2;2;3;41;1;3;4449;52;52;1;0;0;3;5;4449;0;5596;5;2;
/org.eclipse.jdt.core.tests.model/workspace/Formatter/test126/A_in.java;1;0;1;1;0;0;0;1;0;0;1;2425;0;0;1;0;0;1;1;2425;0;2425;1;1;
/org.eclipse.swt/Eclipse SWT PI/gtk1x/org/eclipse/swt/internal/gtk/GtkMenuItem.java;1;0;1;1;0;0;0;1;0;0;1;2327;0;0;1;0;0;1;1;2327;0;2327;1;1;
/org.eclipse.jdt.debug.ui/ui/org/eclipse/jdt/internal/debug/ui/JavaDebugOptionsManager.java;5;1;14;1;6;6;6;8;81;1;8;1240;194;194;1;0;0;8;14;1240;0;6336;14;5;
/org.eclipse.jface.text/src/org/eclipse/jface/internal/text/link/contentassist/SingleCharReader.java;2;0;2;1;1;1;1;1;2;0;1;4214;2;2;1;0;0;1;2;4214;0;6340;2;2;
/org.eclipse.jdt.ui/core refactoring/org/eclipse/jdt/internal/corext/refactoring/participants/xml/IExpressionStatus.java;1;0;2;1;0;0;0;2;0;1;2;2682;0;0;1;0;0;2;2;2682;0;3930;2;1;
/org.eclipse.jdt.core.tests.model/src/org/eclipse/jdt/core/tests/rewrite/describing/ASTRewritingJavadocTest.java;5;1;6;1;4;4;4;2;146;1;2;4711;247;247;1;0;0;2;6;4711;0;6336;6;5;
/org.eclipse.jdt.core.tests.model/workspace/Formatter/test019/A_1_in.java;1;0;1;1;0;0;0;1;0;0;1;2425;0;0;1;0;0;1;1;2425;0;2425;1;1;
/org.eclipse.team.cvs.core/src/org/eclipse/team/internal/ccvs/core/syncinfo/CVSSubscriberResourceTree.java;1;0;1;1;0;0;0;1;0;0;1;3199;0;0;1;0;0;1;1;3199;0;3199;1;1;
/org.eclipse.jdt.core/model/org/eclipse/jdt/core/jdom/IDOMCompilationUnit.java;2;0;6;1;1;1;1;5;18;1;5;969;45;45;1;0;0;5;6;969;0;5584;6;2;
/org.eclipse.jdt.ui.tests.refactoring/resources/ExtractMethodWorkSpace/ExtractMethodTests/return_out/A_test711.java;1;0;2;1;0;0;0;2;6;1;2;130;7;7;1;0;0;2;2;130;0;844;2;1;
/org.eclipse.team.cvs.core/src/org/eclipse/team/internal/ccvs/core/client/Remove.java;1;0;1;1;0;0;0;1;2;0;1;1843;2;2;1;0;0;1;1;1843;0;1843;1;1;
/org.eclipse.ui.workbench/Eclipse UI/org/eclipse/ui/internal/activities/ws/WorkbenchActivitySupport.java;4;2;9;2;3;2;3;6;178;1;6;3066;305;305;2;0;1;6;9;6012;1;6338;8;4;
/org.eclipse.ui.workbench/Eclipse UI/org/eclipse/ui/internal/registry/IPluginContribution.java;2;0;2;1;0;0;0;2;0;1;2;3008;0;0;1;0;0;2;2;3008;0;3061;2;2;
/org.eclipse.ui.workbench/Eclipse UI/org/eclipse/ui/internal/commands/KeyConfigurationDefinition.java;2;0;14;1;1;1;1;13;118;5;8;1389;347;347;5;5;0;13;14;1389;5;6338;9;2;
/org.eclipse.debug.ui/ui/org/eclipse/debug/internal/ui/console/MessageConsolePartition.java;2;0;2;1;0;0;0;2;0;1;2;1418;0;0;1;0;0;2;2;1418;0;2060;2;2;
/org.eclipse.jdt.core/codeassist/org/eclipse/jdt/internal/codeassist/select/SelectionOnQualifiedNameReference.java;3;0;3;1;0;0;0;3;20;1;3;991;26;26;1;0;0;3;3;991;0;3560;3;3;
/org.eclipse.jdt.ui/ui/org/eclipse/jdt/internal/ui/compare/JavaContentViewerCreator.java;1;0;1;1;1;1;1;0;2;0;0;6340;2;2;1;0;0;0;1;6340;0;6340;1;1;
/org.eclipse.core.resources/src/org/eclipse/core/internal/localstore/UnifiedTreeNode.java;1;0;1;1;1;1;1;0;191;0;0;5146;191;191;1;0;0;0;1;5146;0;5146;1;1;
/org.eclipse.pde.ui/src/org/eclipse/pde/internal/ui/editor/site/SiteFeatureSection.java;1;0;1;1;0;0;0;1;0;0;1;2311;0;0;1;0;0;1;1;2311;0;2311;1;1;
/org.eclipse.core.expressions/src/org/eclipse/core/expressions/PropertyTester.java;1;1;6;1;4;4;4;2;55;1;2;4108;124;124;1;0;0;2;6;4108;0;6340;6;1;
/org.eclipse.swt/Eclipse SWT/common/org/eclipse/swt/widgets/Monitor.java;1;0;2;1;0;0;0;2;2;1;2;33;2;2;1;0;0;2;2;33;0;174;2;1;
/org.eclipse.jdt.debug.tests/tests/org/eclipse/jdt/debug/tests/eval/NestedTypeFieldValue_517.java;1;0;1;1;0;0;0;1;78;0;1;1274;78;78;1;0;0;1;1;1274;0;1274;1;1;
/org.eclipse.core.tests.resources/src/org/eclipse/core/tests/internal/builders/BuildDeltaVerificationTest.java;1;0;2;1;2;1;2;0;768;0;0;5147;768;768;2;0;1;0;2;5147;1;5147;1;1;
/org.eclipse.jdt.core/compiler/org/eclipse/jdt/internal/compiler/flow/ConditionalFlowInfo.java;1;0;1;1;0;0;0;1;2;0;1;3560;2;2;1;0;0;1;1;3560;0;3560;1;1;
/org.eclipse.ui.ide/src/org/eclipse/ui/internal/ide/update/ConfigurationManagerAction.java;1;0;1;1;1;1;1;0;0;0;0;5789;0;0;1;0;0;0;1;5789;0;5789;1;1;
/org.eclipse.pde.ui/src/org/eclipse/pde/internal/ui/launcher/TracingLauncherTab.java;3;2;18;1;4;3;4;14;503;1;14;648;1271;1271;2;0;1;14;18;6047;1;6336;17;3;
/org.eclipse.jdt.ui/core refactoring/org/eclipse/jdt/internal/corext/refactoring/participants/xml/ExpressionPlugin.java;1;0;2;1;0;0;0;2;0;1;2;3930;0;0;1;0;0;2;2;3930;0;4108;2;1;
/org.eclipse.jdt.ui/ui/org/eclipse/jdt/internal/ui/browsing/JavaElementTypeComparator.java;1;0;1;1;1;1;1;0;2;0;0;6340;2;2;1;0;0;0;1;6340;0;6340;1;1;
/org.eclipse.jdt.debug.ui/ui/org/eclipse/jdt/internal/debug/ui/JavaDetailFormattersManager.java;3;2;7;2;4;3;4;3;151;1;3;3196;189;189;2;0;1;3;7;6015;1;6336;6;3;
/org.eclipse.jdt.ui/core extension/org/eclipse/jdt/internal/corext/template/java/Templates.java;2;1;13;1;5;5;5;8;9;1;8;4258;54;54;1;0;0;8;13;4258;0;6340;13;2;
/org.eclipse.ant.ui/Ant Editor/org/eclipse/ant/internal/ui/editor/outline/AntOutlineMessages.java;1;0;1;1;0;0;0;1;0;0;1;1811;0;0;1;0;0;1;1;1811;0;1811;1;1;
/org.eclipse.jdt.core.tests.model/workspace/Converter/src/test0377/A.java;1;0;1;1;0;0;0;1;0;0;1;3714;0;0;1;0;0;1;1;3714;0;3714;1;1;
/org.eclipse.swt/Eclipse SWT/common/org/eclipse/swt/graphics/Point.java;3;1;3;1;2;2;2;1;6;0;1;4062;14;14;1;0;0;1;3;4062;0;6352;3;3;
/org.eclipse.core.tests.runtime/src/org/eclipse/core/tests/internal/plugins/SoftPrereqTest_19.java;1;0;1;1;0;0;0;1;0;0;1;3014;0;0;1;0;0;1;1;3014;0;3014;1;1;
/org.eclipse.help.base/src/org/eclipse/help/internal/HelpApplication.java;1;0;3;1;0;0;0;3;5;0;1;1740;5;5;3;2;0;3;3;1740;2;1740;1;1;
/org.eclipse.ui.externaltools/External Tools Base/org/eclipse/ui/externaltools/internal/variable/DefaultVariableExpander.java;1;0;1;1;0;0;0;1;0;0;1;321;0;0;1;0;0;1;1;321;0;321;1;1;
/org.eclipse.jdt.ui.tests.refactoring/resources/MoveMembers/test30/out/B.java;1;0;2;1;0;0;0;2;1;1;2;1651;1;1;1;0;0;2;2;1651;0;1683;2;1;
/org.eclipse.ui.console/src/org/eclipse/ui/internal/console/IInternalConsoleConstants.java;1;0;1;1;0;0;0;1;0;0;1;1988;0;0;1;0;0;1;1;1988;0;1988;1;1;
/org.eclipse.osgi/resolver/src/org/eclipse/osgi/internal/resolver/ComputeNodeOrder.java;2;2;3;2;3;2;3;0;3;0;0;5313;5;5;2;0;1;0;3;5313;1;5507;2;2;
/org.eclipse.update.ui/src/org/eclipse/update/internal/ui/properties/FeatureCopyrightPropertyPage.java;3;1;5;1;2;2;2;3;14;1;3;825;37;37;1;0;0;3;5;825;0;6336;5;3;
/org.eclipse.jdt.ui.tests.refactoring/resources/MoveInnerToTopLevel/test_nonstatic_39/out/A.java;1;0;1;1;0;0;0;1;0;0;1;1314;0;0;1;0;0;1;1;1314;0;1314;1;1;
/org.eclipse.team.ftp/src/org/eclipse/team/internal/ftp/ui/subscriber/FTPImportWizard.java;2;1;8;1;5;5;5;3;81;1;3;3805;129;129;1;0;0;3;8;3805;0;6337;8;2;
/org.eclipse.jdt.core.tests.model/workspace/Formatter/test455/A_in.java;1;0;2;1;1;1;1;1;3;0;1;3788;3;3;1;0;0;1;2;3788;0;5132;2;1;
/org.eclipse.pde.build/src/org/eclipse/pde/internal/build/PluginBuildScriptGenerator.java;2;0;5;1;0;0;0;5;0;1;5;447;0;0;1;0;0;5;5;447;0;1113;5;2;
/org.eclipse.update.ui.win32/src/org/eclipse/welcome/internal/portal/WelcomePortalPage.java;1;0;1;1;0;0;0;1;0;0;1;912;0;0;1;0;0;1;1;912;0;912;1;1;
/org.eclipse.pde.core/src/org/eclipse/pde/internal/core/IPlatformConfiguration.java;1;0;2;1;0;0;0;2;0;1;2;4058;0;0;1;0;0;2;2;4058;0;4112;2;1;
/org.eclipse.jdt.core.tests.model/workspace/Formatter/test160/A_out.java;2;0;2;1;0;0;0;2;22;1;2;2425;22;22;1;0;0;2;2;2425;0;3362;2;2;
/org.eclipse.jdt.core.tests.model/workspace/Completion/src3/test0010/Test.java;1;0;1;1;0;0;0;1;0;0;1;5082;0;0;1;0;0;1;1;5082;0;5082;1;1;
/org.eclipse.jdt.text.tests/src/org/eclipse/jdt/ui/text/tests/SmartSemicolonAutoEditStrategyTest.java;1;0;2;1;1;1;1;1;0;0;1;5082;0;0;1;0;0;1;2;5082;0;5129;2;1;
/org.eclipse.ui.forms/src/org/eclipse/ui/forms/FormColors.java;1;2;12;1;4;3;4;8;78;2;7;4068;179;179;2;1;1;8;12;4856;2;6336;10;1;
/org.eclipse.core.resources/src/org/eclipse/core/internal/utils/UniversalUniqueIdentifier.java;2;0;2;1;1;1;1;1;713;0;1;179;730;730;1;0;0;1;2;179;0;5146;2;2;
/org.eclipse.jdt.core.tests.model/workspace/Formatter/test369/A_in.java;1;0;1;1;0;0;0;1;0;0;1;3130;0;0;1;0;0;1;1;3130;0;3130;1;1;
/org.eclipse.jdt.core.tests.model/workspace/Converter/test0497/A.java;1;0;2;1;0;0;0;2;0;1;2;1950;0;0;1;0;0;2;2;1950;0;3714;2;1;
/org.eclipse.debug.ui/ui/org/eclipse/debug/internal/ui/views/memory/PrintViewTabAction.java;2;1;2;1;2;2;2;0;5;0;0;5254;5;5;1;0;0;0;2;5254;0;5316;2;2;
/org.eclipse.jdt.debug/jdi/org/eclipse/jdi/internal/connect/SocketAttachingConnectorImpl.java;4;0;4;1;1;1;1;3;4;1;3;3278;9;9;1;0;0;3;4;3278;0;6336;4;4;
/org.eclipse.jdt.ui/ui refactoring/org/eclipse/jdt/internal/ui/refactoring/sef/SelfEncapsulateFieldWizard.java;2;0;5;1;1;1;1;4;9;1;4;1047;24;24;1;0;0;4;5;1047;0;6340;5;2;
/org.eclipse.ui.workbench/Eclipse UI/org/eclipse/ui/internal/themes/ViewThemeDescriptor.java;2;0;3;1;0;0;0;3;5;1;3;3684;5;5;1;0;0;3;3;3684;0;4471;3;2;
/org.eclipse.swt/Eclipse SWT/emulated/bidi/org/eclipse/swt/internal/BidiUtil.java;4;0;6;2;1;1;1;5;16;2;4;517;40;40;2;1;0;5;6;1258;1;6352;5;4;
/org.eclipse.jdt.ui/core refactoring/org/eclipse/jdt/internal/corext/refactoring/code/IntroduceParameterRefactoring.java;4;3;30;2;17;15;17;13;358;1;13;2217;707;707;3;0;2;13;30;5851;2;6340;28;4;
/org.eclipse.jdt.core.tests.model/workspace/Converter/test0074/Test.java;1;0;1;1;0;0;0;1;0;0;1;3714;0;0;1;0;0;1;1;3714;0;3714;1;1;
/org.eclipse.jdt.core/compiler/org/eclipse/jdt/internal/compiler/impl/ByteConstant.java;2;0;3;1;1;1;1;2;12;1;2;1111;20;20;1;0;0;2;3;1111;0;5587;3;2;
/org.eclipse.ui.views/src/org/eclipse/ui/views/navigator/NavigatorFrameSource.java;1;0;1;1;0;0;0;1;0;0;1;2738;0;0;1;0;0;1;1;2738;0;2738;1;1;
/org.eclipse.jdt.ui/ui/org/eclipse/jdt/internal/ui/callhierarchy/MethodWrapper.java;1;0;2;1;0;0;0;2;0;1;2;155;0;0;1;0;0;2;2;155;0;169;2;1;
/org.eclipse.team.core/src/org/eclipse/team/core/ReadOnlySchedulingRule.java;1;0;1;1;0;0;0;1;0;0;1;1954;0;0;1;0;0;1;1;1954;0;1954;1;1;
/org.eclipse.ui.workbench/Eclipse UI/org/eclipse/ui/internal/themes/Theme.java;2;0;14;1;0;0;0;14;88;2;12;4235;460;460;2;2;0;14;14;4235;2;5025;12;2;
/org.eclipse.jdt.core/compiler/org/eclipse/jdt/internal/compiler/lookup/TypeIds.java;2;0;2;1;0;0;0;2;5;1;2;3560;7;7;1;0;0;2;2;3560;0;4910;2;2;
/org.eclipse.swt/Eclipse SWT/carbon/org/eclipse/swt/widgets/Tracker.java;6;1;22;2;3;3;3;19;318;3;15;110;741;741;3;4;0;19;22;110;4;6352;18;6;
/org.eclipse.jdt.core.tests.model/workspace/Converter/test0133/Test.java;1;0;1;1;0;0;0;1;0;0;1;3714;0;0;1;0;0;1;1;3714;0;3714;1;1;
/org.eclipse.pde.junit.runtime/src/org/eclipse/pde/internal/junit/runtime/LegacyUITestApplication.java;1;1;4;1;2;2;2;2;10;1;2;3168;18;18;1;0;0;2;4;3168;0;6336;4;1;
/org.eclipse.core.variables/src/org/eclipse/core/variables/IDynamicVariableResolver.java;1;0;1;1;0;0;0;1;0;0;1;2514;0;0;1;0;0;1;1;2514;0;2514;1;1;
/org.eclipse.jdt.core.tests.model/workspace/Converter/src/test0438_a/W.java;1;0;1;1;0;0;0;1;0;0;1;3714;0;0;1;0;0;1;1;3714;0;3714;1;1;
/org.eclipse.team.ftp/src/org/eclipse/team/internal/ftp/ui/subscriber/FTPOverrideGetAction.java;2;2;5;1;3;2;3;2;32;1;2;3383;42;42;2;0;1;2;5;5508;1;6337;4;2;
/org.eclipse.swt/Eclipse SWT PI/motif/org/eclipse/swt/internal/motif/GNOME.java;1;0;3;1;0;0;0;3;8;1;3;2370;13;13;1;0;0;3;3;2370;0;4333;3;1;
/org.eclipse.jdt.core.tests.model/workspace/Converter/src/test0505/A.java;1;0;1;1;0;0;0;1;0;0;1;3714;0;0;1;0;0;1;1;3714;0;3714;1;1;
/org.eclipse.update.ui/src/org/eclipse/update/internal/ui/forms/PropertyWebForm.java;1;0;1;1;0;0;0;1;0;0;1;755;0;0;1;0;0;1;1;755;0;755;1;1;
/org.eclipse.core.filebuffers/src/org/eclipse/core/internal/filebuffers/FileBuffersPlugin.java;2;1;5;1;3;3;3;2;38;1;2;1522;68;68;1;0;0;2;5;1522;0;6340;5;2;
/org.eclipse.jdt.core.tests.model/workspace/Formatter/test299/A_in.java;1;0;1;1;0;0;0;1;0;0;1;2444;0;0;1;0;0;1;1;2444;0;2444;1;1;
/org.eclipse.update.core/src/org/eclipse/update/core/IArchiveReference.java;2;1;3;1;2;2;2;1;6;0;1;890;14;14;1;0;0;1;3;890;0;6336;3;2;
/org.eclipse.jdt.core.tests.model/workspace/Formatter/test089/A_in.java;1;0;1;1;0;0;0;1;0;0;1;2425;0;0;1;0;0;1;1;2425;0;2425;1;1;
/org.eclipse.jdt.debug.tests/tests/org/eclipse/jdt/debug/tests/core/DebugEventTests.java;1;0;1;1;0;0;0;1;0;0;1;995;0;0;1;0;0;1;1;995;0;995;1;1;
/org.eclipse.jdt.core/compiler/org/eclipse/jdt/internal/compiler/parser/RecoveredUnit.java;4;0;7;1;1;1;1;6;78;1;6;488;116;116;1;0;0;6;7;488;0;5405;7;4;
/org.eclipse.jface.text/src/org/eclipse/jface/text/source/AnnotationBarHoverManager.java;3;2;14;2;7;6;7;7;215;1;7;719;792;792;2;0;1;7;14;5122;1;6361;13;3;
/org.eclipse.compare/compare/org/eclipse/compare/internal/ColorEditor.java;1;0;1;1;1;1;1;0;0;0;0;5933;0;0;1;0;0;0;1;5933;0;5933;1;1;
/org.eclipse.jdt.core/search/org/eclipse/jdt/core/search/SearchEngine.java;5;3;57;2;15;10;15;42;1910;3;29;61;3320;3320;3;13;5;42;57;2656;18;6120;39;5;
/org.eclipse.update.ui/src/org/eclipse/update/internal/ui/model/ConfiguredFeatureAdapter.java;3;0;7;1;1;1;1;6;55;2;5;890;121;121;2;1;0;6;7;1629;1;6336;6;3;
/org.eclipse.jdt.ui.tests/ui/org/eclipse/jdt/ui/tests/core/PartialASTTest.java;3;1;12;1;5;5;5;7;140;2;6;1286;202;202;2;1;0;7;12;1517;1;6340;11;3;
/org.eclipse.jdt.core/compiler/org/eclipse/jdt/internal/compiler/lookup/BaseTypes.java;1;0;1;1;0;0;0;1;2;0;1;3560;2;2;1;0;0;1;1;3560;0;3560;1;1;
/org.eclipse.swt/Eclipse SWT Accessibility/win32/org/eclipse/swt/accessibility/Accessible.java;3;3;14;2;9;5;9;5;185;1;5;2246;463;463;3;0;4;5;14;5640;4;6352;10;3;
/org.eclipse.debug.ui/ui/org/eclipse/debug/internal/ui/actions/LinkBreakpointsWithDebugViewAction.java;1;0;1;1;0;0;0;1;0;0;1;1893;0;0;1;0;0;1;1;1893;0;1893;1;1;
/org.eclipse.releng.basebuilder/plugins/org.eclipse.build.tools/org.eclipse.build.tools/src/org/eclipse/releng/generators/VersionTrackerTask.java;1;0;1;1;1;1;1;0;0;0;0;5735;0;0;1;0;0;0;1;5735;0;5735;1;1;
/org.eclipse.jdt.ui.tests.refactoring/test cases/org/eclipse/jdt/ui/tests/reorg/CopyToClipboardActionTest.java;3;0;20;1;1;1;1;19;189;3;13;469;466;466;3;6;0;19;20;469;6;6340;14;3;
/org.eclipse.ant.ui/Ant Editor/org/eclipse/ant/ui/internal/editor/outline/OutlinePreparingHandler.java;1;0;5;1;0;0;0;5;26;2;4;250;26;26;2;1;0;5;5;262;1;2335;4;1;
/org.eclipse.ui.workbench/Eclipse UI/org/eclipse/ui/internal/commands/SimpleContextService.java;1;0;3;1;0;0;0;3;2;1;3;956;2;2;1;0;0;3;3;956;0;1119;3;1;
/org.eclipse.jdt.ui.tests.refactoring/resources/Copy/test_method_yes_type/out/A.java;1;0;2;1;0;0;0;2;4;1;2;685;6;6;1;0;0;2;2;685;0;696;2;1;
/org.eclipse.pde.core/src/org/eclipse/pde/core/plugin/ISharedExtensionsModel.java;2;1;2;1;2;2;2;0;6;0;0;5426;6;6;1;0;0;0;2;5426;0;6336;2;2;
/org.eclipse.core.runtime.osgi/src/org/eclipse/core/runtime/registry/IExtensionDelta.java;1;0;2;1;0;0;0;2;10;1;2;3013;10;10;1;0;0;2;2;3013;0;3030;2;1;
/org.eclipse.jdt.ui/ui/org/eclipse/jdt/internal/ui/wizards/NewElementWizard.java;4;1;9;1;2;2;2;7;9;1;7;1350;51;51;1;0;0;7;9;1350;0;6340;9;4;
/org.eclipse.ui.ide/src/org/eclipse/ui/internal/ide/presentations/IDEPresentationFactory.java;1;0;3;1;0;0;0;3;18;2;2;4469;18;18;2;1;0;3;3;4469;1;4517;2;1;
/org.eclipse.core.tests.runtime/src/org/eclipse/core/tests/internal/plugins/PluginResolveTest_13.java;1;0;1;1;0;0;0;1;0;0;1;3014;0;0;1;0;0;1;1;3014;0;3014;1;1;
/org.eclipse.swt/Eclipse SWT PI/gtk1x/org/eclipse/swt/internal/gtk/GtkObject.java;1;0;1;1;0;0;0;1;0;0;1;2327;0;0;1;0;0;1;1;2327;0;2327;1;1;
/org.eclipse.ui.intro/src/org/eclipse/ui/internal/intro/impl/util/Logger.java;1;1;2;1;2;2;2;0;0;0;0;5115;0;0;1;0;0;0;2;5115;0;5140;2;1;
/org.eclipse.swt/Eclipse SWT/emulated/coolbar/org/eclipse/swt/widgets/CoolItem.java;3;1;8;1;5;5;5;3;43;1;3;269;118;118;1;0;0;3;8;269;0;6352;8;3;
/org.eclipse.ua.tests/src/org/eclipse/ui/tests/cheatsheets/parameters/GatherDisplayDataAction.java;1;0;1;1;1;1;1;0;0;0;0;6081;0;0;1;0;0;0;1;6081;0;6081;1;1;
/org.eclipse.jdt.core.tests.compiler/src/org/eclipse/jdt/core/tests/compiler/parser/ReferenceTypeCompletionTest.java;3;0;3;1;0;0;0;3;4;1;3;991;10;10;1;0;0;3;3;991;0;3560;3;3;
/org.eclipse.jdt.core.tests.model/workspace/Converter/src/test0515/A.java;1;0;1;1;0;0;0;1;0;0;1;3714;0;0;1;0;0;1;1;3714;0;3714;1;1;
/org.eclipse.pde.ui/src_OSGi/org/eclipse/pde/internal/ui/osgi/templates/BundleActivatorClassCodeGenerator.java;2;0;2;1;0;0;0;2;0;1;2;3241;0;0;1;0;0;2;2;3241;0;3986;2;2;
/org.eclipse.jdt.ui/ui/org/eclipse/jdt/internal/ui/actions/OpenActionUtil.java;1;0;2;1;1;1;1;1;4;0;1;1350;6;6;1;0;0;1;2;1350;0;6340;2;1;
/org.eclipse.jdt.ui.tests.refactoring/resources/ExtractMethodWorkSpace/ExtractMethodTests/return_out/A_test704.java;1;0;1;1;0;0;0;1;6;0;1;844;6;6;1;0;0;1;1;844;0;844;1;1;
/org.eclipse.pde.ui/src_Forms/org/eclipse/pde/internal/ui/model/plugin/PluginNode.java;3;1;8;1;5;5;5;3;11;1;3;4438;38;38;1;0;0;3;8;4438;0;6336;8;3;
/org.eclipse.ui.externaltools/Ant Tools Support/org/eclipse/ui/externaltools/internal/ant/view/actions/SearchForBuildFilesDialog.java;1;0;1;1;0;0;0;1;0;0;1;282;0;0;1;0;0;1;1;282;0;282;1;1;
/org.eclipse.pde.ui/src/org/eclipse/pde/internal/ui/editor/schema/SchemaSourceOutlinePage.java;1;0;2;1;1;1;1;1;4;0;1;648;4;4;1;0;0;1;2;648;0;5431;2;1;
/org.eclipse.core.runtime/src/org/eclipse/core/runtime/Status.java;3;1;12;1;4;4;4;8;412;1;8;698;883;883;1;0;0;8;12;698;0;6340;12;3;
/org.eclipse.team.cvs.ui/src/org/eclipse/team/internal/ccvs/ui/actions/AddToWorkspaceAction.java;2;0;4;1;0;0;0;4;69;1;4;809;75;75;1;0;0;4;4;809;0;4969;4;2;
/org.eclipse.ui.presentations.r21/src/org/eclipse/ui/internal/presentations/r21/widgets/CTabFolderListener.java;1;1;2;1;2;2;2;0;2;0;0;6075;2;2;1;0;0;0;2;6075;0;6338;2;1;
/org.eclipse.ui.tests/Eclipse UI Tests/org/eclipse/ui/tests/api/MockPart.java;1;1;2;1;2;2;2;0;19;0;0;5533;19;19;1;0;0;0;2;5533;0;5659;2;1;
/org.eclipse.compare/compare/org/eclipse/compare/structuremergeviewer/IStructureCreator.java;1;0;1;1;0;0;0;1;2;0;1;3938;2;2;1;0;0;1;1;3938;0;3938;1;1;
/org.eclipse.jdt.core.tests.model/workspace/Formatter/test419/A_out.java;1;0;1;1;0;0;0;1;0;0;1;3475;0;0;1;0;0;1;1;3475;0;3475;1;1;
/org.eclipse.pde.ui/src/org/eclipse/pde/internal/ui/wizards/exports/FeatureExportJob.java;2;4;22;2;19;11;19;3;538;1;3;2571;873;873;4;0;8;3;22;6065;8;6336;14;2;
/org.eclipse.ui.ide/src/org/eclipse/ui/views/properties/ResourcePropertySource.java;3;1;3;1;2;2;2;1;4;0;1;2208;6;6;1;0;0;1;3;2208;0;6338;3;3;
/org.eclipse.update.core/src/org/eclipse/update/standalone/UninstallCommand.java;1;1;7;1;6;6;6;1;15;0;1;4928;39;39;1;0;0;1;7;4928;0;6336;7;1;
/org.eclipse.core.runtime.osgi/src/org/eclipse/core/internal/runtime/PlatformURLFragmentConnection.java;1;0;2;1;0;0;0;2;74;1;2;3013;74;74;1;0;0;2;2;3013;0;3030;2;1;
/org.eclipse.ant.ui/Ant Tools Support/org/eclipse/ant/internal/ui/preferences/MessageDialogWithToggle.java;2;0;4;1;1;1;1;3;9;1;3;1811;13;13;1;0;0;3;4;1811;0;5802;4;2;
/org.eclipse.jdt.core/compiler/org/eclipse/jdt/internal/compiler/lookup/SyntheticArgumentBinding.java;1;0;1;1;0;0;0;1;2;0;1;3560;2;2;1;0;0;1;1;3560;0;3560;1;1;
/org.eclipse.jdt.core.tests.model/workspace/Converter/test0112/Test.java;1;0;1;1;0;0;0;1;0;0;1;3714;0;0;1;0;0;1;1;3714;0;3714;1;1;
/org.eclipse.search/search/org/eclipse/search/internal/core/text/TextSearchVisitor.java;2;1;11;2;3;3;3;8;158;2;7;122;532;532;2;1;0;8;11;4626;1;6340;10;2;
/org.eclipse.ui.workbench/Eclipse UI/org/eclipse/ui/internal/commands/old/SequenceUtil.java;1;0;2;1;0;0;0;2;0;1;2;1322;0;0;1;0;0;2;2;1322;0;1356;2;1;
/org.eclipse.jdt.core.tests.model/workspace/Converter/src/test0320/Test.java;1;0;1;1;0;0;0;1;0;0;1;3714;0;0;1;0;0;1;1;3714;0;3714;1;1;
/org.eclipse.jdt.core/model/org/eclipse/jdt/internal/core/LRUCacheEnumerator.java;1;0;1;1;0;0;0;1;2;0;1;3560;2;2;1;0;0;1;1;3560;0;3560;1;1;
/org.eclipse.jdt.ui/core extension/org/eclipse/jdt/internal/corext/codemanipulation/ImportsStructure.java;4;2;24;3;6;5;6;18;181;3;14;239;710;710;3;4;1;18;24;239;5;6340;19;4;
/org.eclipse.ui.ide/src/org/eclipse/ui/views/tasklist/CopyTaskAction.java;1;0;2;1;0;0;0;2;3;1;2;2208;3;3;1;0;0;2;2;2208;0;2264;2;1;
/org.eclipse.jdt.ui.tests.refactoring/resources/Copy/test_initializer_yes_type/in/A.java;1;0;2;1;0;0;0;2;1;1;2;685;1;1;1;0;0;2;2;685;0;696;2;1;
/org.eclipse.ui.workbench/Eclipse UI/org/eclipse/ui/internal/commands/Configuration.java;1;0;4;1;0;0;0;4;4;1;4;607;4;4;1;0;0;4;4;607;0;1077;4;1;
/org.eclipse.ui.ide/src/org/eclipse/ui/actions/DeleteResourceAction.java;2;0;4;1;0;0;0;4;61;1;4;1511;63;63;1;0;0;4;4;1511;0;2263;4;2;
/org.eclipse.jdt.ui/core extension/org/eclipse/jdt/internal/corext/codemanipulation/GetterSetterUtil.java;3;1;4;1;2;2;2;2;136;1;2;916;159;159;1;0;0;2;4;916;0;6340;4;3;
/org.eclipse.ui.intro/src/org/eclipse/ui/internal/intro/impl/model/AbstractIntroPage.java;1;2;16;1;16;14;16;0;91;0;0;5115;449;449;2;0;2;0;16;5314;2;6251;14;1;
/org.eclipse.jdt.ui.tests.refactoring/resources/ExtractInterface/testConditional2/in/A.java;1;0;1;1;0;0;0;1;0;0;1;3902;0;0;1;0;0;1;1;3902;0;3902;1;1;
/org.eclipse.core.filebuffers/src/org/eclipse/core/internal/filebuffers/StorageDocumentProvider2.java;1;0;2;1;0;0;0;2;0;1;2;1522;0;0;1;0;0;2;2;1522;0;1574;2;1;
/org.eclipse.help.ui.win32/src/org/eclipse/help/ui/internal/win32/Placeholder.java;1;0;2;1;0;0;0;2;0;1;2;2899;0;0;1;0;0;2;2;2899;0;3062;2;1;
/org.eclipse.jdt.debug/jdi/org/eclipse/jdi/internal/spy/TcpipSpy.java;2;0;3;1;0;0;0;3;20;1;3;566;27;27;1;0;0;3;3;566;0;2497;3;2;
/org.eclipse.team.webdav/src/org/eclipse/team/internal/ui/target/subscriber/ExportResourceSelectionPage.java;2;2;14;2;8;7;8;6;228;2;5;3615;583;583;2;1;1;6;14;4306;2;6337;12;2;
/org.eclipse.jdt.core.tests.model/workspace/Converter/src/test0324/Test.java;1;0;1;1;0;0;0;1;0;0;1;3714;0;0;1;0;0;1;1;3714;0;3714;1;1;
/org.eclipse.jdt.core.tests.model/workspace/Completion/src/z1/z2/Qla1.java;1;0;1;1;0;0;0;1;0;0;1;3253;0;0;1;0;0;1;1;3253;0;3253;1;1;
/org.eclipse.team.cvs.ui/src/org/eclipse/team/internal/ccvs/ui/subscriber/WorkspaceSynchronizeParticipant.java;2;1;16;1;7;7;7;9;123;1;9;2590;358;358;1;0;0;9;16;2590;0;6337;16;2;
/org.eclipse.ui.forms/src/org/eclipse/ui/internal/forms/FormWizard.java;1;0;2;1;1;1;1;1;4;0;1;5044;4;4;1;0;0;1;2;5044;0;6336;2;1;
/org.eclipse.swt/Eclipse SWT/gtk/org/eclipse/swt/internal/Converter.java;5;0;6;1;1;1;1;5;8;1;5;0;26;26;1;0;0;5;6;0;0;6352;6;5;
/org.eclipse.jdt.ui.examples.javafamily/coresearch-experiment/org/eclipse/search/core/Document.java;1;0;3;1;0;0;0;3;18;1;3;1380;18;18;1;0;0;3;3;1380;0;3214;3;1;
/org.eclipse.ui.editors/src/org/eclipse/ui/texteditor/AbstractDecoratedTextEditor.java;3;2;9;2;9;7;9;0;56;0;0;5127;73;73;2;0;2;0;9;5127;2;6334;7;3;
/org.eclipse.ui.workbench/Eclipse UI/org/eclipse/ui/internal/commands/old/KeyBindingMachine.java;1;0;2;1;0;0;0;2;0;0;1;1374;0;0;2;1;0;2;2;1374;1;1374;1;1;
/org.eclipse.osgi/osgi/src/org/osgi/service/url/URLStreamHandlerService.java;2;0;2;1;1;1;1;1;3;0;1;3013;3;3;1;0;0;1;2;3013;0;5536;2;2;
/org.eclipse.jdt.core.tests.model/workspace/Formatter/test096/A_out.java;1;0;1;1;0;0;0;1;0;0;1;2425;0;0;1;0;0;1;1;2425;0;2425;1;1;
/org.eclipse.ua.tests/src/org/eclipse/ui/examples/cheatsheets/pattern/actions/OpenClassNameFilledAction.java;1;0;1;1;1;1;1;0;0;0;0;6081;0;0;1;0;0;0;1;6081;0;6081;1;1;
/org.eclipse.update.ui/src/org/eclipse/update/internal/ui/model/SiteCategory.java;2;0;3;1;0;0;0;3;9;1;3;369;25;25;1;0;0;3;3;369;0;900;3;2;
/org.eclipse.jdt.core.tests.model/workspace/Formatter/test178/A_in.java;1;0;1;1;0;0;0;1;0;0;1;2425;0;0;1;0;0;1;1;2425;0;2425;1;1;
/org.eclipse.core.resources/src/org/eclipse/core/internal/resources/MarkerInfo.java;2;0;4;1;1;1;1;3;184;1;3;180;208;208;1;0;0;3;4;180;0;5146;4;2;
/org.eclipse.ui.tests/Eclipse UI Tests/org/eclipse/ui/tests/keys/Bug36537Test.java;5;0;8;1;1;1;1;7;36;1;7;2285;60;60;1;0;0;7;8;2285;0;6338;8;5;
/org.eclipse.jdt.debug.ui/ui/org/eclipse/jdt/internal/debug/ui/JavaDebugImages.java;4;1;9;1;3;3;3;6;46;1;6;268;78;78;1;0;0;6;9;268;0;5475;9;4;
/org.eclipse.jdt.ui/ui refactoring/org/eclipse/jdt/internal/ui/refactoring/MoveMembersWizard.java;4;1;19;2;3;3;3;16;203;3;14;518;757;757;3;2;0;16;19;3648;2;6340;17;4;
/org.eclipse.core.runtime/src/org/eclipse/core/runtime/IProgressMonitor.java;2;2;7;1;3;2;3;4;240;1;4;3013;498;498;2;0;1;4;7;5117;1;6340;6;2;
/org.eclipse.jdt.ui/ui/org/eclipse/jdt/internal/ui/text/JavaWhitespaceDetector.java;1;0;1;1;1;1;1;0;2;0;0;6340;2;2;1;0;0;0;1;6340;0;6340;1;1;
/org.eclipse.jdt.core.tests.model/workspace/Converter/test0242/Test.java;1;0;1;1;0;0;0;1;0;0;1;3714;0;0;1;0;0;1;1;3714;0;3714;1;1;
/org.eclipse.pde.build/src_ant/org/eclipse/pde/internal/build/tasks/UnzipperGeneratorTask.java;2;2;11;1;3;2;3;8;20;1;8;447;35;35;2;0;1;8;11;6340;1;6340;10;2;
/org.eclipse.jdt.core.tests.model/workspace/Converter/src/test0177/Test.java;1;0;1;1;0;0;0;1;0;0;1;3714;0;0;1;0;0;1;1;3714;0;3714;1;1;
/org.eclipse.core.runtime/src/org/eclipse/core/runtime/jobs/LockListener.java;3;1;12;2;2;2;2;10;106;2;9;1263;250;250;2;1;0;10;12;5083;1;5688;11;3;
/org.eclipse.jdt.core.tests.model/workspace/Formatter/test113/A_in.java;1;0;1;1;0;0;0;1;0;0;1;2425;0;0;1;0;0;1;1;2425;0;2425;1;1;
/org.eclipse.team.webdav/src/org/eclipse/team/internal/ui/target/TargetSiteImportWizard.java;2;0;2;1;0;0;0;2;0;1;2;2495;0;0;1;0;0;2;2;2495;0;4216;2;2;
/org.eclipse.debug.ui/ui/org/eclipse/debug/ui/launchVariables/LaunchVariableMessages.java;1;0;2;1;0;0;0;2;0;1;2;754;0;0;1;0;0;2;2;754;0;771;2;1;
/org.eclipse.jdt.ui/core refactoring/org/eclipse/ltk/internal/core/refactoring/AssertionFailedException.java;1;0;2;1;0;0;0;2;0;1;2;4575;0;0;1;0;0;2;2;4575;0;4864;2;1;
/org.eclipse.releng.basebuilder/plugins/org.eclipse.build.tools/src/org/eclipse/releng/Component.java;2;0;3;2;0;0;0;3;4;2;2;3236;4;4;2;1;0;3;3;3236;1;3597;2;2;
/org.eclipse.jdt.ui.examples.javafamily/coresearch-experiment/org/eclipse/search/internal/core/PathCollector.java;1;0;2;1;0;0;0;2;0;1;2;1380;0;0;1;0;0;2;2;1380;0;3214;2;1;
/org.eclipse.ui.workbench/Eclipse UI/org/eclipse/ui/internal/csm/roles/AbstractRoleRegistry.java;1;0;6;1;0;0;0;6;12;2;5;2213;25;25;2;1;0;6;6;2370;1;2444;5;1;
/org.eclipse.debug.ui/ui/org/eclipse/debug/internal/ui/views/ViewerState.java;1;0;1;1;0;0;0;1;0;0;1;1986;0;0;1;0;0;1;1;1986;0;1986;1;1;
/org.eclipse.pde.ui/src_Forms/org/eclipse/pde/internal/ui/neweditor/PDESection.java;2;0;15;1;1;1;1;14;13;2;10;3795;48;48;2;4;0;14;15;4354;4;5431;11;2;
/org.eclipse.ui.workbench/Eclipse UI/org/eclipse/ui/handles/IHandle.java;1;0;5;1;0;0;0;5;14;1;5;1294;38;38;1;0;0;5;5;1294;0;1507;5;1;
/org.eclipse.jface.text/src/org/eclipse/jface/text/TextEvent.java;2;1;4;1;3;3;3;1;28;0;1;4732;33;33;1;0;0;1;4;4732;0;6359;4;2;
/org.eclipse.jdt.core/eval/org/eclipse/jdt/internal/eval/CodeSnippetReturnStatement.java;1;0;2;1;0;0;0;2;2;1;2;1252;4;4;1;0;0;2;2;1252;0;3560;2;1;
/org.eclipse.debug.ui/ui/org/eclipse/debug/internal/ui/console/AbstractConsole.java;2;0;4;1;0;0;0;4;41;2;3;1422;41;41;2;1;0;4;4;1430;1;2060;3;2;
/org.eclipse.jdt.ui.tests.refactoring/resources/ExtractMethodWorkSpace/ExtractMethodTests/locals_in/A_test556.java;1;0;1;1;0;0;0;1;2;0;1;844;2;2;1;0;0;1;1;844;0;844;1;1;
/org.eclipse.team.ui/src/org/eclipse/team/internal/ui/sync/sets/ISyncSetChangedListener.java;1;0;3;1;0;0;0;3;22;1;3;1289;22;22;1;0;0;3;3;1289;0;2632;3;1;
/org.eclipse.team.tests.cvs.core/src/org/eclipse/team/tests/ccvs/ui/benchmark/CommandTests.java;1;0;2;1;0;0;0;2;22;1;2;1417;22;22;1;0;0;2;2;1417;0;2632;2;1;
/org.eclipse.team.core/src/org/eclipse/team/internal/core/subscribers/caches/ResourceVariantTreeRefresh.java;2;0;3;1;0;0;0;3;339;1;3;4194;339;339;1;0;0;3;3;4194;0;4233;3;2;
/org.eclipse.swt.tests/JUnit Tests/org/eclipse/swt/tests/junit/Test_org_eclipse_swt_graphics_Cursor.java;2;0;4;2;0;0;0;4;61;3;2;2175;64;64;3;2;0;4;4;2175;2;2227;2;2;
/org.eclipse.jdt.ui/ui/org/eclipse/jdt/internal/ui/text/ContentAssistPreference.java;2;0;2;1;1;1;1;1;8;0;1;4950;10;10;1;0;0;1;2;4950;0;6340;2;2;
/org.eclipse.team.core/src/org/eclipse/team/core/synchronize/CachedResourceVariant.java;2;0;3;1;0;0;0;3;232;1;3;4127;232;232;1;0;0;3;3;4127;0;4349;3;2;
/org.eclipse.osgi/core/framework/org/eclipse/osgi/framework/internal/core/BundleCombinedPermissions.java;4;1;5;1;3;3;3;2;277;1;2;3013;287;287;1;0;0;2;5;3013;0;6337;5;4;
/org.eclipse.update.core/src/org/eclipse/update/operations/IFeatureOperation.java;1;2;8;1;3;2;3;5;26;2;4;825;59;59;2;1;1;5;8;825;2;6336;6;1;
/org.eclipse.ui.views/src/org/eclipse/ui/views/framelist/GoIntoAction.java;1;0;1;1;0;0;0;1;0;0;1;2738;0;0;1;0;0;1;1;2738;0;2738;1;1;
/org.eclipse.jdt.ui.tests.refactoring/resources/ExtractInterface/test95/out/I.java;1;0;1;1;0;0;0;1;0;0;1;1153;0;0;1;0;0;1;1;1153;0;1153;1;1;
/org.eclipse.jdt.ui/ui/org/eclipse/jdt/internal/ui/dialogs/MultiTypeSelectionDialog.java;2;1;2;1;2;2;2;0;6;0;0;5893;8;8;1;0;0;0;2;5893;0;6340;2;2;
/org.eclipse.jdt.core.tests.model/workspace/Converter/src/test0272/Test.java;1;0;1;1;0;0;0;1;0;0;1;3714;0;0;1;0;0;1;1;3714;0;3714;1;1;
/org.eclipse.help.ui/src/org/eclipse/help/ui/internal/browser/embedded/EmbeddedBrowserHost.java;1;0;7;1;0;0;0;7;70;1;7;2898;141;141;1;0;0;7;7;2898;0;4457;7;1;
/org.eclipse.jdt.core.tests.model/src/org/eclipse/jdt/core/tests/rewrite/modifying/ASTRewritingModifyingReplaceTest.java;2;0;2;1;1;1;1;1;7;0;1;4711;7;7;1;0;0;1;2;4711;0;5853;2;2;
/org.eclipse.update.core/src/org/eclipse/update/internal/core/InternalSiteManager.java;2;2;15;1;9;7;9;6;62;1;6;890;265;265;2;0;2;6;15;5518;2;6336;13;2;
/org.eclipse.jdt.ui.tests.refactoring/test cases/org/eclipse/jdt/ui/tests/nls/NLSElementTester.java;3;1;3;1;2;2;2;1;18;0;1;4930;22;22;1;0;0;1;3;4930;0;6340;3;3;
/org.eclipse.ui.workbench.texteditor/src/org/eclipse/ui/texteditor/MarkerRulerInfoAction.java;1;0;1;1;0;0;0;1;0;0;1;2741;0;0;1;0;0;1;1;2741;0;2741;1;1;
/org.eclipse.jdt.ui.tests.refactoring/resources/PasteSourceReference/test2/out/B.java;1;0;1;1;0;0;0;1;0;0;1;1311;0;0;1;0;0;1;1;1311;0;1311;1;1;
/org.eclipse.jdt.core.tests.model/workspace/Formatter/test414/A_out.java;1;0;2;1;0;0;0;2;3;1;2;3460;3;3;1;0;0;2;2;3460;0;4994;2;1;
/org.eclipse.team.webdav/src/org/eclipse/team/internal/ui/target/SiteExplorerView.java;2;1;5;1;2;2;2;3;53;1;3;2495;64;64;1;0;0;3;5;2495;0;6337;5;2;
/org.eclipse.ui.externaltools/Ant Tools Support/org/eclipse/ui/externaltools/internal/ant/preferences/OverlayPreferenceStore.java;1;0;1;1;0;0;0;1;0;0;1;282;0;0;1;0;0;1;1;282;0;282;1;1;
/org.eclipse.text/src/org/eclipse/jface/text/Region.java;1;0;1;1;1;1;1;0;17;0;0;6298;17;17;1;0;0;0;1;6298;0;6298;1;1;
/org.eclipse.jface.text/src/org/eclipse/jface/contentassist/ISubjectControlContextInformationPresenter.java;1;2;4;1;4;3;4;0;6;0;0;5199;14;14;2;0;1;0;4;6340;1;6356;3;1;
/org.eclipse.ui.ide/src/org/eclipse/ui/internal/ide/registry/MarkerQueryResult.java;3;1;3;1;2;2;2;1;2;0;1;2264;4;4;1;0;0;1;3;2264;0;6338;3;3;
/org.eclipse.jdt.ui/ui/org/eclipse/jdt/internal/ui/wizards/NewSourceFolderCreationWizard.java;2;1;5;1;2;2;2;3;12;1;3;4064;38;38;1;0;0;3;5;4064;0;6340;5;2;
/org.eclipse.jdt.ui.tests.refactoring/resources/DeleteSourceReference/test7/in/A.java;1;0;1;1;0;0;0;1;0;0;1;1652;0;0;1;0;0;1;1;1652;0;1652;1;1;
/org.eclipse.ui.workbench/Eclipse UI/org/eclipse/ui/internal/TipsAndTricksAction.java;1;0;1;1;0;0;0;1;0;0;1;2737;0;0;1;0;0;1;1;2737;0;2737;1;1;
/org.eclipse.jdt.junit/src/org/eclipse/jdt/internal/junit/wizards/JUnitWizard.java;2;2;6;1;5;4;5;1;22;0;1;2746;50;50;2;0;1;1;6;5873;1;6340;5;2;
/org.eclipse.ui.workbench/Eclipse UI/org/eclipse/ui/internal/commands/old/CaptureListener.java;1;0;2;1;0;0;0;2;0;1;2;1322;0;0;1;0;0;2;2;1322;0;1507;2;1;
/org.eclipse.ltk.core.refactoring/src/org/eclipse/ltk/core/refactoring/participants/ProcessorChange.java;1;0;2;1;1;1;1;1;0;0;1;4913;0;0;1;0;0;1;2;4913;0;5106;2;1;
/org.eclipse.ui.workbench/Eclipse UI/org/eclipse/ui/internal/contexts/ContextDefinition.java;2;0;12;1;1;1;1;11;137;4;7;1388;327;327;4;4;0;11;12;1396;4;6338;8;2;
/org.eclipse.jface.text/src/org/eclipse/jface/text/templates/SimpleTemplateVariable.java;1;0;2;1;0;0;0;2;0;0;1;4258;0;0;2;1;0;2;2;4258;1;4258;1;1;
/org.eclipse.ui.workbench/Eclipse UI/org/eclipse/ui/commands/ICommandDelegateService.java;1;0;2;1;0;0;0;2;0;1;2;1321;0;0;1;0;0;2;2;1321;0;1419;2;1;
/org.eclipse.core.tests.resources/src/org/eclipse/core/tests/internal/resources/ProjectPreferencesTest.java;3;2;15;1;11;10;11;4;181;1;4;4351;662;662;2;0;1;4;15;6013;1;6102;14;3;
/org.eclipse.help/src/org/eclipse/help/internal/util/ResourceLocator.java;1;1;11;1;3;3;3;8;196;2;7;1010;441;441;2;1;0;8;11;4609;1;6337;10;1;
/org.eclipse.ui.ide/src/org/eclipse/ui/views/markers/internal/ITableViewContentProvider.java;1;0;1;1;0;0;0;1;0;0;1;2208;0;0;1;0;0;1;1;2208;0;2208;1;1;
/org.eclipse.jdt.core.tests.model/workspace/Converter/test0290/Test.java;1;0;1;1;0;0;0;1;0;0;1;3714;0;0;1;0;0;1;1;3714;0;3714;1;1;
/org.eclipse.debug.ui/ui/org/eclipse/debug/internal/ui/actions/ProfileContextualLaunchAction.java;1;0;1;1;1;1;1;0;0;0;0;5496;0;0;1;0;0;0;1;5496;0;5496;1;1;
/org.eclipse.swt/Eclipse SWT/carbon/org/eclipse/swt/widgets/MenuItem.java;3;1;7;1;2;2;2;5;74;1;5;224;95;95;1;0;0;5;7;224;0;6352;7;3;
/org.eclipse.jdt.ui/ui/org/eclipse/jdt/internal/ui/jarpackager/JarFileExportOperation.java;2;1;10;1;4;4;4;6;163;1;6;244;286;286;1;0;0;6;10;244;0;6340;10;2;
/org.eclipse.jface/src/org/eclipse/jface/preference/DirectoryFieldEditor.java;2;1;2;1;2;2;2;0;3;0;0;5463;5;5;1;0;0;0;2;5463;0;6338;2;2;
/org.eclipse.jdt.core.tests.model/workspace/Converter/test0243/Test.java;1;0;1;1;0;0;0;1;0;0;1;3714;0;0;1;0;0;1;1;3714;0;3714;1;1;
/org.eclipse.jdt.core/dom/org/eclipse/jdt/core/dom/WildcardType.java;3;2;12;1;4;3;4;8;170;1;8;3043;347;347;2;0;1;8;12;5268;1;6336;11;3;
/org.eclipse.core.resources/src/org/eclipse/core/internal/localstore/TracingFileInputStream.java;1;0;2;1;0;0;0;2;0;1;2;1653;0;0;1;0;0;2;2;1653;0;1674;2;1;
/org.eclipse.jdt.ui/core refactoring/org/eclipse/jdt/internal/corext/refactoring/participants/xml/Method.java;1;0;4;1;0;0;0;4;4;1;4;2546;6;6;1;0;0;4;4;2546;0;4091;4;1;
/org.eclipse.pde.ui/src_Forms/org/eclipse/pde/internal/ui/model/bundle/BundleModel.java;2;1;7;1;7;7;7;0;69;0;0;5425;114;114;1;0;0;0;7;5425;0;6336;7;2;
/org.eclipse.update.core/src/org/eclipse/update/internal/core/UpdateManagerReconciler.java;2;0;5;1;1;1;1;4;56;1;4;890;66;66;1;0;0;4;5;890;0;5519;5;2;
/org.eclipse.ui.ide/src/org/eclipse/ui/internal/dialogs/IDEWorkbenchPreferencePage.java;2;0;5;2;0;0;0;5;44;2;4;1654;81;81;2;1;0;5;5;1654;1;2263;4;2;
/org.eclipse.jdt.ui/core refactoring/org/eclipse/ltk/core/refactoring/participants/CopyParticipant.java;1;0;2;1;0;0;0;2;0;1;2;4624;0;0;1;0;0;2;2;4624;0;4864;2;1;
/org.eclipse.swt/Eclipse SWT Accessibility/emulated/org/eclipse/swt/accessibility/AccessibleObject.java;1;0;2;1;0;0;0;2;0;0;1;1102;0;0;2;1;0;2;2;1102;1;1102;1;1;
/org.eclipse.swt.examples/src/org/eclipse/swt/examples/controlexample/CComboTab.java;1;0;1;1;0;0;0;1;2;0;1;1560;2;2;1;0;0;1;1;1560;0;1560;1;1;
/org.eclipse.ant.tests.ui/Ant Editor Tests/org/eclipse/ant/tests/ui/editor/TaskDescriptionProviderTest.java;1;0;4;1;0;0;0;4;6;2;3;1811;10;10;2;1;0;4;4;1811;1;3685;3;1;
/org.eclipse.sdk.tests-feature/plugins/org.eclipse.perfmsr.ui.client/src/org/eclipse/perfmsr/ui/client/ClientUIImages.java;1;1;3;1;3;3;3;0;10;0;0;5443;14;14;1;0;0;0;3;5443;0;5537;3;1;
/org.eclipse.jdt.debug/jdi/org/eclipse/jdi/internal/ObjectReferenceImpl.java;3;0;3;1;1;1;1;2;6;1;2;1240;12;12;1;0;0;2;3;1240;0;6336;3;3;
/org.eclipse.jdt.ui/ui/org/eclipse/jdt/internal/ui/search/SearchViewAdapter.java;2;1;2;1;2;2;2;0;2;0;0;5396;3;3;1;0;0;0;2;5396;0;6340;2;2;
/org.eclipse.jdt.core.tests.model/workspace/Converter/src/test0318/Test.java;1;0;1;1;0;0;0;1;0;0;1;3714;0;0;1;0;0;1;1;3714;0;3714;1;1;
/org.eclipse.pde.ui/src/org/eclipse/pde/internal/ui/editor/site/NewFeatureDialog.java;1;0;1;1;0;0;0;1;0;0;1;2311;0;0;1;0;0;1;1;2311;0;2311;1;1;
/org.eclipse.jdt.core.tests.model/workspace/Converter/src/test0319/Test.java;1;0;1;1;0;0;0;1;0;0;1;3714;0;0;1;0;0;1;1;3714;0;3714;1;1;
/org.eclipse.pde.ui/src/org/eclipse/pde/internal/ui/editor/manifest/ExtensionPointForm.java;1;0;1;1;1;1;1;0;0;0;0;5431;0;0;1;0;0;0;1;5431;0;5431;1;1;
/org.eclipse.swt/Eclipse SWT PI/gtk/org/eclipse/swt/internal/gtk/AtkObjectClass.java;1;0;2;1;0;0;0;2;0;1;2;1102;0;0;1;0;0;2;2;1102;0;1214;2;1;
/org.eclipse.ui.workbench/Eclipse UI/org/eclipse/ui/commands/HandlerSubmission.java;2;1;9;1;2;2;2;7;231;2;6;4098;578;578;2;1;0;7;9;4929;1;5309;8;2;
/org.eclipse.jdt.ui.tests.refactoring/resources/ExtractMethodWorkSpace/ExtractMethodTests/locals_out/A_test507.java;1;0;2;1;0;0;0;2;4;1;2;130;5;5;1;0;0;2;2;130;0;844;2;1;
/org.eclipse.jdt.core/model/org/eclipse/jdt/core/util/ISourceAttribute.java;1;0;1;1;0;0;0;1;2;0;1;3560;2;2;1;0;0;1;1;3560;0;3560;1;1;
/org.eclipse.core.tools.resources/src/org/eclipse/core/tools/resources/CountResourcesAction.java;1;0;1;1;1;1;1;0;0;0;0;6302;0;0;1;0;0;0;1;6302;0;6302;1;1;
/org.eclipse.jdt.core/model/org/eclipse/jdt/internal/core/builder/MissingClassFileException.java;1;0;1;1;0;0;0;1;2;0;1;3560;2;2;1;0;0;1;1;3560;0;3560;1;1;
/org.eclipse.jdt.core.tests.model/src/org/eclipse/jdt/core/tests/model/VariablesInitializer.java;1;0;1;1;0;0;0;1;2;0;1;3560;2;2;1;0;0;1;1;3560;0;3560;1;1;
/org.eclipse.ui.views/src/org/eclipse/ui/views/navigator/NavigatorContentProvider.java;1;0;1;1;0;0;0;1;0;0;1;947;0;0;1;0;0;1;1;947;0;947;1;1;
/org.eclipse.jdt.debug.ui/ui/org/eclipse/jdt/internal/debug/ui/JavaInspectExpressionActionFilter.java;2;0;3;1;1;1;1;2;9;1;2;3981;20;20;1;0;0;2;3;3981;0;6336;3;2;
/org.eclipse.search/search/org/eclipse/search/ui/ISearchPage.java;1;0;1;1;1;1;1;0;2;0;0;6340;2;2;1;0;0;0;1;6340;0;6340;1;1;
/org.eclipse.jdt.junit/src/org/eclipse/jdt/internal/junit/util/TestSearchEngine.java;3;2;8;2;7;6;7;1;59;0;1;1688;107;107;2;0;1;1;8;6008;1;6340;7;3;
/org.eclipse.ant.ui/Ant Editor/org/eclipse/ant/ui/internal/editor/outline/XEErrorHandler.java;1;0;2;1;0;0;0;2;0;1;2;250;0;0;1;0;0;2;2;250;0;1811;2;1;
/org.eclipse.jface/src/org/eclipse/jface/viewers/ComboViewer.java;1;0;1;1;0;0;0;1;0;0;1;5004;0;0;1;0;0;1;1;5004;0;5004;1;1;
/org.eclipse.jdt.core.tests.model/workspace/Converter/src/test0179/Test.java;1;0;1;1;0;0;0;1;0;0;1;3714;0;0;1;0;0;1;1;3714;0;3714;1;1;
/org.eclipse.ui.editors/src/org/eclipse/ui/internal/editors/quickdiff/RestoreAction.java;2;0;3;1;0;0;0;3;1;1;3;1214;1;1;1;0;0;3;3;1214;0;1644;3;2;
/org.eclipse.update.ui/src/org/eclipse/update/internal/ui/views/FeatureStateAction.java;3;1;10;1;2;2;2;8;24;1;8;825;53;53;1;0;0;8;10;825;0;6336;10;3;
/org.eclipse.ui.workbench/Eclipse UI/org/eclipse/ui/commands/CommandContributionItem.java;2;0;5;1;0;0;0;5;55;1;5;2746;86;86;1;0;0;5;5;2746;0;4927;5;2;
/org.eclipse.team.cvs.ui/src/org/eclipse/team/internal/ccvs/ui/HistoryTableProvider.java;2;0;5;1;1;1;1;4;49;1;4;848;105;105;1;0;0;4;5;848;0;6337;5;2;
/org.eclipse.jdt.ui/core refactoring/org/eclipse/jdt/internal/corext/refactoring/changes/RenameResourceChange.java;2;1;6;1;2;2;2;4;75;1;4;3708;101;101;1;0;0;4;6;3708;0;6340;6;2;
/org.eclipse.update.ui/srcnew/org/eclipse/update/internal/ui/views/IPreviewTask.java;1;0;3;1;0;0;0;3;22;1;3;489;22;22;1;0;0;3;3;489;0;825;3;1;
/org.eclipse.ui.ide/extensions/org/eclipse/ui/actions/RefreshAction.java;1;0;1;1;0;0;0;1;0;0;1;2263;0;0;1;0;0;1;1;2263;0;2263;1;1;
/org.eclipse.ui.ide/src/org/eclipse/ui/internal/ide/dialogs/IElementFilter.java;1;0;1;1;0;0;0;1;0;0;1;2264;0;0;1;0;0;1;1;2264;0;2264;1;1;
/org.eclipse.text/src/org/eclipse/jface/text/IRegion.java;1;0;1;1;1;1;1;0;16;0;0;6298;16;16;1;0;0;0;1;6298;0;6298;1;1;
/org.eclipse.pde.ui/src_Forms/org/eclipse/pde/internal/ui/neweditor/schema/SchemaEditorContributor.java;2;0;2;1;1;1;1;1;0;0;1;4856;0;0;1;0;0;1;2;4856;0;5431;2;2;
/org.eclipse.core.runtime/src/org/eclipse/core/runtime/preferences/IPreferencesService.java;2;2;14;1;5;4;5;9;202;2;8;4327;354;354;2;1;1;9;14;4384;2;5593;12;2;
/org.eclipse.jdt.ui/ui/org/eclipse/jdt/internal/ui/text/correction/JavaCorrectionProcessor.java;4;1;19;2;4;4;4;15;156;2;12;1011;552;552;2;3;0;15;19;1034;3;6340;16;4;
/org.eclipse.jdt.core/model/org/eclipse/jdt/internal/core/HandleFactory.java;1;0;1;1;0;0;0;1;0;0;1;1904;0;0;1;0;0;1;1;1904;0;1904;1;1;
/org.eclipse.team.ui/src/org/eclipse/team/internal/ui/synchronize/views/CompressedFolderContentProvider.java;1;0;3;1;0;0;0;3;164;1;3;2535;164;164;1;0;0;3;3;2535;0;4216;3;1;
/org.eclipse.team.ftp/src/org/eclipse/team/internal/ftp/ui/ExportWizard.java;1;0;1;1;0;0;0;1;0;0;1;3232;0;0;1;0;0;1;1;3232;0;3232;1;1;
/org.eclipse.jdt.debug.ui/ui/org/eclipse/jdt/internal/debug/ui/actions/OpenDialogAction.java;1;0;1;1;0;0;0;1;11;0;1;2691;11;11;1;0;0;1;1;2691;0;2691;1;1;
/org.eclipse.jdt.ui.tests.refactoring/resources/InlineMethodWorkspace/TestCases/simple_in/TestEmptyBody.java;1;0;1;1;0;0;0;1;2;0;1;845;2;2;1;0;0;1;1;845;0;845;1;1;
/org.eclipse.jdt.core/compiler/org/eclipse/jdt/internal/compiler/ast/MemberTypeDeclaration.java;1;0;2;1;0;0;0;2;1;1;2;1306;1;1;1;0;0;2;2;1306;0;2974;2;1;
/org.eclipse.core.runtime/src/org/eclipse/core/internal/plugins/RegistryLoader.java;1;0;2;1;0;0;0;2;9;1;2;2444;9;9;1;0;0;2;2;2444;0;3013;2;1;
/org.eclipse.osgi/core/framework/org/eclipse/osgi/framework/internal/core/ServiceRegistrationImpl.java;2;2;5;1;5;4;5;0;1391;0;0;5116;1462;1462;2;0;1;0;5;5116;1;5529;4;2;
/org.eclipse.debug.ui/ui/org/eclipse/debug/ui/console/FileLink.java;2;0;3;1;0;0;0;3;22;1;3;2060;40;40;1;0;0;3;3;2060;0;2917;3;2;
/org.eclipse.jdt.ui.tests.refactoring/resources/ExtractMethodWorkSpace/ExtractMethodTests/locals_out/A_test569.java;1;0;2;1;0;0;0;2;4;1;2;130;5;5;1;0;0;2;2;130;0;844;2;1;
/org.eclipse.ua.tests/src/org/eclipse/ui/tests/cheatsheets/actions/NavigateAction.java;1;0;1;1;1;1;1;0;0;0;0;6081;0;0;1;0;0;0;1;6081;0;6081;1;1;
/org.eclipse.jdt.ui/ui/org/eclipse/jdt/internal/ui/preferences/OccurrencesPreferencePage.java;1;0;2;1;2;1;2;0;7;0;0;5502;7;7;2;0;1;0;2;5502;1;5502;1;1;
/org.eclipse.jdt.ui/ui refactoring/org/eclipse/jdt/internal/ui/refactoring/reorg/RenameRefactoringWizard2.java;1;0;3;1;0;0;0;3;12;2;2;1047;12;12;2;1;0;3;3;1125;1;1125;2;1;
/org.eclipse.team.ui/src/org/eclipse/team/internal/ui/target/TargetSyncCompareInput.java;1;0;1;1;0;0;0;1;0;0;1;2495;0;0;1;0;0;1;1;2495;0;2495;1;1;
/org.eclipse.jdt.ui/ui/org/eclipse/jdt/internal/ui/viewsupport/ImageImageDescriptor.java;1;0;1;1;1;1;1;0;2;0;0;6340;2;2;1;0;0;0;1;6340;0;6340;1;1;
/org.eclipse.jdt.core.tests.compiler/src/org/eclipse/jdt/core/tests/compiler/parser/ComplianceDiagnoseTest.java;1;0;1;1;0;0;0;1;0;0;1;4466;0;0;1;0;0;1;1;4466;0;4466;1;1;
/org.eclipse.jdt.core.tests.model/workspace/Converter/src/javadoc/test105/TestB1.java;1;0;1;1;0;0;0;1;0;0;1;4390;0;0;1;0;0;1;1;4390;0;4390;1;1;
/org.eclipse.jdt.junit/src/org/eclipse/jdt/internal/junit/ui/JUnitHomeInitializer.java;3;1;7;1;4;4;4;3;12;1;3;609;35;35;1;0;0;3;7;609;0;6340;7;3;
/org.eclipse.core.tests.runtime/src/org/eclipse/core/tests/runtime/OperationCanceledExceptionTest.java;1;0;1;1;1;1;1;0;52;0;0;5149;52;52;1;0;0;0;1;5149;0;5149;1;1;
/org.eclipse.jdt.ui/ui/org/eclipse/jdt/internal/ui/wizards/NewTypeDropDownAction.java;3;1;4;1;2;2;2;2;49;1;2;4621;55;55;1;0;0;2;4;4621;0;6340;4;3;
/org.eclipse.jdt.ui/core extension/org/eclipse/jdt/internal/corext/template/java/CompilationUnitContextType.java;4;1;10;1;2;2;2;8;52;2;7;3090;156;156;2;1;0;8;10;4382;1;6340;9;4;
/org.eclipse.team.core/src/org/eclipse/team/core/variants/ResourceVariantTree.java;1;1;3;1;2;2;2;1;25;0;1;4349;43;43;1;0;0;1;3;4349;0;6125;3;1;
/org.eclipse.ui.ide/src/org/eclipse/ui/internal/ide/AboutBundleGroupData.java;2;0;2;1;1;1;1;1;0;0;1;4936;0;0;1;0;0;1;2;4936;0;5483;2;2;
/org.eclipse.jdt.core.tests.model/workspace/Converter/src/test0491/A.java;1;0;1;1;0;0;0;1;0;0;1;3714;0;0;1;0;0;1;1;3714;0;3714;1;1;
/org.eclipse.debug.ui/ui/org/eclipse/debug/internal/ui/preferences/StringVariablePreferencePage.java;4;1;7;1;2;2;2;5;27;1;5;2120;52;52;1;0;0;5;7;2120;0;6336;7;4;
/org.eclipse.ui.workbench.texteditor/src/org/eclipse/ui/texteditor/ComboContentAssistSubjectAdapter.java;1;0;2;1;0;0;0;2;0;1;2;2281;0;0;1;0;0;2;2;2281;0;3672;2;1;
/org.eclipse.update/src/org/eclipse/update/internal/core/UpdateManager.java;1;0;1;1;1;1;1;0;0;0;0;6339;0;0;1;0;0;0;1;6339;0;6339;1;1;
/org.eclipse.ui.workbench/Eclipse UI/org/eclipse/ui/internal/PartDropEvent.java;2;0;2;1;0;0;0;2;4;1;2;4015;4;4;1;0;0;2;2;4015;0;4600;2;2;
/org.eclipse.jdt.core.tests.model/workspace/Converter/src/test0368/A.java;1;0;1;1;0;0;0;1;0;0;1;3714;0;0;1;0;0;1;1;3714;0;3714;1;1;
/org.eclipse.team.ui/src/org/eclipse/team/internal/ui/sync/views/SyncViewerTableSorter.java;2;0;6;1;0;0;0;6;148;2;5;683;182;182;2;1;0;6;6;1219;1;2632;5;2;
/org.eclipse.jdt.core/compiler/org/eclipse/jdt/internal/compiler/env/IGenericType.java;1;0;1;1;0;0;0;1;2;0;1;3560;2;2;1;0;0;1;1;3560;0;3560;1;1;
/org.eclipse.jdt.ui/ui refactoring/org/eclipse/jdt/internal/ui/refactoring/StatusContextViewerDescriptor.java;1;0;4;1;0;0;0;4;58;1;4;882;59;59;1;0;0;4;4;882;0;4965;4;1;
/org.eclipse.jdt.core.tests.model/workspace/Formatter/test143/A_out.java;1;0;1;1;0;0;0;1;0;0;1;2425;0;0;1;0;0;1;1;2425;0;2425;1;1;
/org.eclipse.ui.workbench/Eclipse UI/org/eclipse/ui/actions/CopyProjectAction.java;1;0;1;1;0;0;0;1;0;0;1;2737;0;0;1;0;0;1;1;2737;0;2737;1;1;
/org.eclipse.jdt.core.tests.model/workspace/Formatter/test287/A_out.java;1;0;1;1;0;0;0;1;0;0;1;2443;0;0;1;0;0;1;1;2443;0;2443;1;1;
/org.eclipse.jdt.core.tests.model/workspace/Formatter/test492/Main_out.java;1;0;1;1;1;1;1;0;0;0;0;5253;0;0;1;0;0;0;1;5253;0;5253;1;1;
/org.eclipse.jdt.core.tests.model/workspace/Formatter/test208/A_out.java;1;0;1;1;0;0;0;1;0;0;1;2424;0;0;1;0;0;1;1;2424;0;2424;1;1;
/org.eclipse.core.runtime/src/org/eclipse/core/runtime/jobs/IJobChangeEvent.java;3;0;8;2;1;1;1;7;76;2;6;1081;164;164;2;1;0;7;8;5083;1;5150;7;3;
/org.eclipse.ui.workbench/Eclipse UI/org/eclipse/ui/internal/commands/api/IActionServiceListener.java;1;0;2;1;0;0;0;2;2;0;1;2562;2;2;2;1;0;2;2;2562;1;2562;1;1;
/org.eclipse.jdt.core/compiler/org/eclipse/jdt/internal/compiler/ast/SubRoutineStatement.java;3;0;5;2;1;1;1;4;7;2;3;148;17;17;2;1;0;4;5;148;1;5343;4;3;
/org.eclipse.pde.ui/src/org/eclipse/pde/internal/ui/wizards/templates/IFirstWizardPage.java;1;0;2;1;1;1;1;1;0;0;1;2519;0;0;1;0;0;1;2;2519;0;5152;2;1;
/org.eclipse.jdt.ui/core refactoring/org/eclipse/jdt/internal/corext/refactoring/typeconstraints/ReturnTypeVariable.java;2;0;6;1;1;1;1;5;21;1;5;42;38;38;1;0;0;5;6;42;0;6340;6;2;
/org.eclipse.ui.workbench/Eclipse UI/org/eclipse/ui/internal/QuitAction.java;2;0;4;2;0;0;0;4;138;3;2;2737;186;186;3;2;0;4;4;3028;2;3028;2;2;
/org.eclipse.team.ui/src/org/eclipse/team/ui/synchronize/viewers/CompressedFolderViewerInput.java;1;0;1;1;0;0;0;1;0;0;1;3987;0;0;1;0;0;1;1;3987;0;3987;1;1;
/org.eclipse.osgi/core/adaptor/org/eclipse/osgi/framework/adaptor/BundleData.java;4;1;8;1;3;3;3;5;83;1;5;3013;120;120;1;0;0;5;8;3013;0;6337;8;4;
/org.eclipse.update.core/src/org/eclipse/update/internal/core/ConfigurationPolicy.java;3;3;13;1;4;2;4;9;313;1;9;890;842;842;3;0;2;9;13;5664;2;5664;11;3;
/org.eclipse.jdt.core.tests.model/workspace/Converter/src/javadoc/testBug52908unicode/X.java;1;0;1;1;0;0;0;1;0;0;1;4369;0;0;1;0;0;1;1;4369;0;4369;1;1;
/org.eclipse.jdt.junit/src/org/eclipse/jdt/internal/junit/ui/JavaTypeExtender.java;4;1;7;1;3;3;3;4;62;1;4;3760;120;120;1;0;0;4;7;3760;0;6340;7;4;
/org.eclipse.jdt.launching/launching/org/eclipse/jdt/launching/sourcelookup/LocalFileStorage.java;2;0;3;1;1;1;1;2;93;1;2;2988;125;125;1;0;0;2;3;2988;0;5236;3;2;
/org.eclipse.core.tests.resources/src/org/eclipse/core/tests/resources/ProjectOrderTest.java;1;0;2;1;2;1;2;0;28;0;0;5147;28;28;2;0;1;0;2;5147;1;5147;1;1;
/org.eclipse.jdt.ui/core refactoring/org/eclipse/jdt/internal/corext/refactoring/base/UndoManagerAdapter.java;1;0;1;1;0;0;0;1;0;0;1;4575;0;0;1;0;0;1;1;4575;0;4575;1;1;
/org.eclipse.jdt.core.tests.model/workspace/Formatter/test125/A_out.java;1;0;1;1;0;0;0;1;0;0;1;2425;0;0;1;0;0;1;1;2425;0;2425;1;1;
/org.eclipse.ui.workbench/Eclipse UI/org/eclipse/ui/roles/CategoryEvent.java;1;0;2;1;0;0;0;2;0;0;1;2864;0;0;2;1;0;2;2;2864;1;2864;1;1;
/org.eclipse.ant.ui/Ant Editor/org/eclipse/ant/ui/internal/editor/xml/IAntEditorConstants.java;1;0;2;1;0;0;0;2;0;1;2;250;0;0;1;0;0;2;2;250;0;1811;2;1;
/org.eclipse.jface.text/src/org/eclipse/jface/text/presentation/IPresentationDamager.java;2;1;3;1;3;3;3;0;26;0;0;5123;32;32;1;0;0;0;3;5123;0;6352;3;2;
/org.eclipse.swt/Eclipse SWT/motif/org/eclipse/swt/widgets/ToolBar.java;4;1;8;1;3;3;3;5;26;1;5;110;65;65;1;0;0;5;8;110;0;6352;8;4;
/org.eclipse.ui.workbench/Eclipse UI/org/eclipse/ui/internal/csm/roles/RoleEvent.java;1;0;5;1;0;0;0;5;26;2;4;2213;30;30;2;1;0;5;5;2441;1;2441;4;1;
/org.eclipse.pde.ui/src_Forms/org/eclipse/pde/internal/ui/neweditor/context/XMLInputContext.java;2;1;14;1;5;5;5;9;372;3;7;4313;1000;1000;3;2;0;9;14;4933;2;5431;12;2;
/org.eclipse.jdt.core.tests.model/workspace/Formatter/test344/A_out.java;1;0;1;1;0;0;0;1;0;0;1;2865;0;0;1;0;0;1;1;2865;0;2865;1;1;
/org.eclipse.jface.text/src/org/eclipse/jface/text/contentassist/ICompletionProposalExtension2.java;1;3;4;1;4;2;4;0;24;0;0;6340;26;26;3;0;2;0;4;6353;2;6353;2;1;
/org.eclipse.ua.tests/src/org/eclipse/ui/examples/cheatsheets/pattern/actions/VisitorCustomizeAction.java;1;0;1;1;1;1;1;0;0;0;0;6081;0;0;1;0;0;0;1;6081;0;6081;1;1;
/org.eclipse.jdt.core.tests.model/workspace/Converter/src/test0066/Test.java;1;0;1;1;0;0;0;1;0;0;1;3714;0;0;1;0;0;1;1;3714;0;3714;1;1;
/org.eclipse.ui.intro/src/org/eclipse/ui/internal/intro/impl/model/IntroPageTitle.java;1;1;4;1;4;4;4;0;6;0;0;5115;10;10;1;0;0;0;4;5115;0;5314;4;1;
/org.eclipse.ui.workbench/Eclipse UI/org/eclipse/ui/internal/commands/api/IActiveKeyConfigurationDefinition.java;1;0;4;1;0;0;0;4;0;2;3;1724;0;0;2;1;0;4;4;2515;1;2532;3;1;
/org.eclipse.team.core/src/org/eclipse/team/core/synchronize/SyncInfoSet.java;2;1;6;1;3;3;3;3;594;1;3;4045;691;691;1;0;0;3;6;4045;0;6336;6;2;
/org.eclipse.team.cvs.ui/src/org/eclipse/team/internal/ccvs/ui/model/CVSModelElement.java;2;1;6;1;2;2;2;4;106;1;4;66;149;149;1;0;0;4;6;66;0;6337;6;2;
/org.eclipse.ant.tests.ui/EclipseCon/org/eclipse/ant/internal/ui/demo/ExternalAntBuildfileImportPage.java;1;0;7;1;0;0;0;7;241;3;5;3750;263;263;3;2;0;7;7;3750;2;4809;5;1;
/org.eclipse.jdt.core.tests.model/workspace/Converter/test0122/Test.java;1;0;1;1;0;0;0;1;0;0;1;3714;0;0;1;0;0;1;1;3714;0;3714;1;1;
/org.eclipse.ui.examples.javaeditor/Template Editor Example/org/eclipse/ui/examples/templateeditor/editors/TemplateEditorUI.java;2;1;4;1;2;2;2;2;10;1;2;4644;20;20;1;0;0;2;4;4644;0;6340;4;2;
/org.eclipse.jdt.ui/core extension/org/eclipse/jdt/internal/corext/util/TypeFilter.java;2;0;4;1;1;1;1;3;13;1;3;3168;23;23;1;0;0;3;4;3168;0;6340;4;2;
/org.eclipse.ui.workbench/Eclipse UI/org/eclipse/ui/commands/internal/Command.java;1;0;2;1;0;0;0;2;0;1;2;786;0;0;1;0;0;2;2;786;0;956;2;1;
/org.eclipse.ui.intro/src/org/eclipse/ui/intro/internal/model/IntroHead.java;1;0;5;1;1;1;1;4;12;1;4;4471;27;27;1;0;0;4;5;4471;0;5115;5;1;
/org.eclipse.jdt.ui/ui/org/eclipse/jdt/internal/ui/filters/ClassFilter.java;1;0;1;1;1;1;1;0;2;0;0;6340;2;2;1;0;0;0;1;6340;0;6340;1;1;
/org.eclipse.jdt.ui/core refactoring/org/eclipse/jdt/internal/corext/refactoring/base/IUndoManagerListener.java;1;0;1;1;0;0;0;1;0;0;1;4575;0;0;1;0;0;1;1;4575;0;4575;1;1;
/org.eclipse.ui.console/src/org/eclipse/ui/internal/console/MessageConsolePartitioner.java;3;1;7;2;2;2;2;5;255;2;3;1988;297;297;2;2;0;5;7;1988;2;5664;5;3;
/org.eclipse.jdt.core.tests.model/workspace/Converter/src/test0138/Test.java;1;0;1;1;0;0;0;1;0;0;1;3714;0;0;1;0;0;1;1;3714;0;3714;1;1;
/org.eclipse.ui.ide/src/org/eclipse/ui/wizards/datatransfer/WizardFileSystemResourceImportPage1.java;4;0;4;1;1;1;1;3;25;1;3;1511;29;29;1;0;0;3;4;1511;0;6338;4;4;
/org.eclipse.jdt.core.tests.model/workspace/Converter/test0266/Test.java;1;0;1;1;0;0;0;1;0;0;1;3714;0;0;1;0;0;1;1;3714;0;3714;1;1;
/org.eclipse.jdt.core.tests.model/workspace/Formatter/test376/A_in.java;1;0;2;1;0;0;0;2;1;1;2;3146;1;1;1;0;0;2;2;3146;0;3172;2;1;
/org.eclipse.jdt.core.tests.model/workspace/Converter/src/test0121/Test.java;1;0;1;1;0;0;0;1;0;0;1;3714;0;0;1;0;0;1;1;3714;0;3714;1;1;
/org.eclipse.jdt.debug.ui/ui/org/eclipse/jdt/internal/debug/ui/SWTCompositeVariablesContentProvider.java;1;0;4;1;0;0;0;4;12;1;4;750;17;17;1;0;0;4;4;750;0;861;4;1;
/org.eclipse.jdt.core/codeassist/org/eclipse/jdt/internal/codeassist/select/SelectionOnMessageSend.java;3;0;4;1;0;0;0;4;34;2;3;440;46;46;2;1;0;4;4;991;1;3560;3;3;
/org.eclipse.pde.core/src_OSGi/org/eclipse/pde/core/bundle/IBundle.java;1;0;2;1;0;0;0;2;0;1;2;2193;0;0;1;0;0;2;2;2193;0;2229;2;1;
/org.eclipse.team.cvs.core/src/org/eclipse/team/internal/ccvs/core/client/AddStructureVisitor.java;1;0;1;1;0;0;0;1;5;0;1;1843;5;5;1;0;0;1;1;1843;0;1843;1;1;
/org.eclipse.jdt.ui/ui/org/eclipse/jdt/internal/ui/preferences/formatter/LineWrappingTabPage.java;1;0;10;1;1;1;1;9;686;2;8;3103;1537;1537;2;1;0;9;10;3103;1;5710;9;1;
/org.eclipse.jdt.ui.tests.refactoring/resources/Delete/testDeleteWithinCu6/out/A.java;1;0;1;1;0;0;0;1;0;0;1;442;0;0;1;0;0;1;1;442;0;442;1;1;
/org.eclipse.core.resources/src/org/eclipse/core/internal/localstore/SafeFileOutputStream.java;1;0;2;1;1;1;1;1;192;0;1;2967;194;194;1;0;0;1;2;2967;0;5146;2;1;
/org.eclipse.jdt.ui.tests.refactoring/test cases/org/eclipse/jdt/ui/tests/reorg/DeleteSourceReferenceEditTests.java;2;0;3;1;0;0;0;3;15;1;3;1111;15;15;1;0;0;3;3;1111;0;1650;3;2;
/org.eclipse.pde.ui/templates/editor/java/ColorManager.java;1;0;1;1;0;0;0;1;10;0;1;851;10;10;1;0;0;1;1;851;0;851;1;1;
/org.eclipse.jdt.ui.tests.refactoring/resources/Paste/testPastingTypedResources0/out/A.java;1;0;2;1;0;0;0;2;1;1;2;1646;1;1;1;0;0;2;2;1646;0;1670;2;1;
/org.eclipse.jdt.core.tests.model/workspace/Formatter/test407/A_out.java;1;0;1;1;0;0;0;1;0;0;1;3438;0;0;1;0;0;1;1;3438;0;3438;1;1;
/org.eclipse.jdt.ui/core extension/org/eclipse/text/edits/SimpleTextEdit.java;1;0;3;1;0;0;0;3;24;2;2;1953;24;24;2;1;0;3;3;1953;1;1972;2;1;
/org.eclipse.jdt.ui/core refactoring/org/eclipse/ltk/core/refactoring/participants/RenameProcessor.java;1;0;5;1;0;0;0;5;121;1;5;4624;160;160;1;0;0;5;5;4624;0;4864;5;1;
/org.eclipse.jdt.ui/ui/org/eclipse/jdt/internal/ui/ResourceAdapterFactory.java;1;0;1;1;1;1;1;0;2;0;0;6340;2;2;1;0;0;0;1;6340;0;6340;1;1;
/org.eclipse.ui.workbench/Eclipse UI/org/eclipse/ui/IViewPart.java;2;1;2;1;2;2;2;0;8;0;0;5928;10;10;1;0;0;0;2;5928;0;6338;2;2;
/org.eclipse.jdt.core.tests.model/workspace/Formatter/test252/A_out.java;1;0;2;1;0;0;0;2;4;1;2;2442;4;4;1;0;0;2;2;2442;0;3029;2;1;
/org.eclipse.pde.ui/src/org/eclipse/pde/internal/ui/editor/schema/SchemaInputContextManager.java;2;1;3;1;3;3;3;0;10;0;0;5431;14;14;1;0;0;0;3;5431;0;6336;3;2;
/org.eclipse.jdt.core.tests.model/workspace/Converter/src/test0404/A.java;1;0;1;1;0;0;0;1;0;0;1;3714;0;0;1;0;0;1;1;3714;0;3714;1;1;
/org.eclipse.core.runtime/src/org/eclipse/core/runtime/model/PluginPrerequisiteModel.java;1;0;1;1;0;0;0;1;0;0;1;3013;0;0;1;0;0;1;1;3013;0;3013;1;1;
/org.eclipse.core.resources/src/org/eclipse/core/internal/localstore/UnifiedTree.java;2;1;8;1;2;2;2;6;666;1;6;2444;737;737;1;0;0;6;8;2444;0;5271;8;2;
/org.eclipse.jdt.ui.tests/ui/org/eclipse/jdt/ui/tests/search/TreeContentProviderTest.java;2;1;3;1;2;2;2;1;33;0;1;4625;49;49;1;0;0;1;3;4625;0;6340;3;2;
/org.eclipse.swt/Eclipse SWT/carbon/org/eclipse/swt/widgets/Control.java;7;2;58;2;13;12;13;45;196;2;42;17;1209;1209;2;3;1;45;58;265;4;6352;54;7;
/org.eclipse.jdt.ui.tests.refactoring/resources/SurroundWithWorkSpace/SurroundWithTests/trycatch_out/TestThrowInCatch.java;1;0;1;1;0;0;0;1;8;0;1;845;8;8;1;0;0;1;1;845;0;845;1;1;
/org.eclipse.ui.workbench/Eclipse UI/org/eclipse/ui/internal/contexts/IMutableRegistry.java;1;0;3;1;0;0;0;3;2;1;3;1356;2;2;1;0;0;3;3;1356;0;1396;3;1;
/org.eclipse.jdt.core.tests.model/workspace/Formatter/test250/A_in.java;1;0;1;1;0;0;0;1;0;0;1;2442;0;0;1;0;0;1;1;2442;0;2442;1;1;
/org.eclipse.jdt.ui/ui/org/eclipse/jdt/internal/ui/dialogs/MultiMainTypeSelectionDialog.java;1;0;1;1;1;1;1;0;2;0;0;6340;2;2;1;0;0;0;1;6340;0;6340;1;1;
/org.eclipse.ui.workbench/Eclipse UI/org/eclipse/ui/commands/internal/ActiveConfiguration.java;1;0;2;1;0;0;0;2;0;1;2;786;0;0;1;0;0;2;2;786;0;956;2;1;
/org.eclipse.jdt.core.tests.model/workspace/Formatter/test215/A_in.java;1;0;1;1;0;0;0;1;0;0;1;2426;0;0;1;0;0;1;1;2426;0;2426;1;1;
/org.eclipse.team.examples.filesystem/src/org/eclipse/team/examples/pessimistic/ui/PessimisticPreferencesPage.java;1;0;2;1;1;1;1;1;358;0;1;3368;358;358;1;0;0;1;2;3368;0;6103;2;1;
/org.eclipse.core.tests.runtime/src/org/eclipse/core/tests/internal/plugins/PluginResolveTest_3.java;1;0;1;1;0;0;0;1;0;0;1;3014;0;0;1;0;0;1;1;3014;0;3014;1;1;
/org.eclipse.core.tests.resources/src/org/eclipse/core/tests/internal/indexing/IntegratedIndexedStoreTest.java;1;0;2;1;2;1;2;0;8;0;0;5147;8;8;2;0;1;0;2;5147;1;5147;1;1;
/org.eclipse.pde.ui/src/org/eclipse/pde/internal/ui/editor/feature/OpenReferenceAction.java;2;1;4;1;2;2;2;2;11;1;2;2751;20;20;1;0;0;2;4;2751;0;6336;4;2;
/org.eclipse.ant.ui/Ant Runner Support/org/eclipse/ant/internal/ui/antsupport/logger/AntProcessBuildLogger.java;3;0;10;1;0;0;0;10;20;2;8;1811;67;67;2;2;0;10;10;1811;2;2433;8;3;
/org.eclipse.debug.ui/ui/org/eclipse/debug/internal/ui/stringsubstitution/FilePromptExpander.java;1;0;2;1;0;0;0;2;0;1;2;2081;0;0;1;0;0;2;2;2081;0;2120;2;1;
/org.eclipse.jdt.debug.tests/tests/org/eclipse/jdt/debug/tests/core/InstanceFilterTests.java;1;0;1;1;1;1;1;0;4;0;0;6339;4;4;1;0;0;0;1;6339;0;6339;1;1;
/org.eclipse.jdt.core.tests.model/workspace/Converter/src/test0483/A.java;1;0;1;1;0;0;0;1;0;0;1;3714;0;0;1;0;0;1;1;3714;0;3714;1;1;
/org.eclipse.update/src/org/eclipse/update/internal/ui/UMWizardURLNamePairComparator.java;1;0;1;1;1;1;1;0;0;0;0;6339;0;0;1;0;0;0;1;6339;0;6339;1;1;
/org.eclipse.search/new search/org/eclipse/search2/internal/ui/SearchPageRegistry.java;2;1;3;1;2;2;2;1;2;0;1;4461;4;4;1;0;0;1;3;4461;0;6340;3;2;
/org.eclipse.ant.ui/Ant Tools Support/org/eclipse/ant/internal/ui/launchConfigurations/AntMainTab.java;3;0;10;2;0;0;0;10;51;2;9;1811;100;100;2;1;0;10;10;1811;1;4899;9;3;
/org.eclipse.ui.intro/src/org/eclipse/ui/internal/intro/impl/presentations/CustomizableIntroPart.java;1;1;4;1;4;4;4;0;8;0;0;5115;10;10;1;0;0;0;4;5115;0;5314;4;1;
/org.eclipse.ui.workbench/Eclipse UI/org/eclipse/ui/internal/roles/ObjectActivityManager.java;2;0;8;1;0;0;0;8;155;3;5;2023;410;410;3;3;0;8;8;2079;3;2443;5;2;
/org.eclipse.text/src/org/eclipse/jface/text/source/Annotation.java;1;1;3;1;2;2;2;1;159;0;1;2243;180;180;1;0;0;1;3;2243;0;6300;3;1;
/org.eclipse.jdt.core.tests.model/workspace/Converter/src/test0475/A.java;1;0;1;1;0;0;0;1;0;0;1;3714;0;0;1;0;0;1;1;3714;0;3714;1;1;
/org.eclipse.ltk.core.refactoring/src/org/eclipse/ltk/core/refactoring/participants/ValidateEditChecker.java;1;2;7;1;6;5;6;1;20;0;1;4845;44;44;2;0;1;1;7;6351;1;6351;6;1;
/org.eclipse.jdt.core.tests.model/workspace/JavaSearch/src/j4/FT47209.java;1;0;1;1;0;0;0;1;0;0;1;3330;0;0;1;0;0;1;1;3330;0;3330;1;1;
/org.eclipse.core.tests.runtime/src/org/eclipse/core/tests/internal/plugins/SoftPrereqTest_4.java;1;0;1;1;0;0;0;1;0;0;1;3014;0;0;1;0;0;1;1;3014;0;3014;1;1;
/org.eclipse.ui.editors/src/org/eclipse/ui/internal/editors/text/IPreferenceConfigurationBlock.java;1;0;1;1;1;1;1;0;0;0;0;5501;0;0;1;0;0;0;1;5501;0;5501;1;1;
/org.eclipse.compare/compare/org/eclipse/compare/internal/merge/MergeMessages.java;1;0;1;1;1;1;1;0;0;0;0;5165;0;0;1;0;0;0;1;5165;0;5165;1;1;
/org.eclipse.pde.ui/src/org/eclipse/pde/internal/ui/wizards/imports/TargetPlatformPreferenceNode.java;1;0;1;1;0;0;0;1;0;0;1;3986;0;0;1;0;0;1;1;3986;0;3986;1;1;
/org.eclipse.team.ui/org.eclipse.jdt.ui.team/src/org/eclipse/jdt/ui/team/JavaSyncInfoSetContentProvider.java;1;0;1;1;0;0;0;1;0;0;1;3734;0;0;1;0;0;1;1;3734;0;3734;1;1;
/org.eclipse.team.cvs.core/src/org/eclipse/team/internal/ccvs/core/resources/EclipseFolder.java;2;2;16;1;5;4;5;11;47;2;10;790;121;121;2;1;1;11;16;1690;2;6337;14;2;
/org.eclipse.ui.views/src/org/eclipse/ui/views/markers/TaskView.java;2;0;3;1;0;0;0;3;11;1;3;755;15;15;1;0;0;3;3;755;0;2738;3;2;
/org.eclipse.jdt.ui/ui/org/eclipse/jdt/internal/ui/jarpackager/OpenJarPackageWizardActionDelegate.java;1;0;1;1;1;1;1;0;2;0;0;6340;2;2;1;0;0;0;1;6340;0;6340;1;1;
/org.eclipse.ui.editors/src/org/eclipse/ui/internal/editors/text/TabFolderLayout.java;1;0;1;1;1;1;1;0;2;0;0;6340;2;2;1;0;0;0;1;6340;0;6340;1;1;
/org.eclipse.jdt.ui.tests.refactoring/test cases/org/eclipse/jdt/ui/tests/refactoring/TestCopyParticipantSingle.java;1;0;2;1;1;1;1;1;0;0;1;4913;0;0;1;0;0;1;2;4913;0;5190;2;1;
/org.eclipse.ui.workbench/Eclipse UI/org/eclipse/ui/gestures/IGestureBinding.java;1;0;2;1;0;0;0;2;0;1;2;1294;0;0;1;0;0;2;2;1294;0;1321;2;1;
/org.eclipse.core.tools/src/org/eclipse/core/tools/runtime/ActivePluginsViewSorter.java;1;0;1;1;1;1;1;0;0;0;0;6302;0;0;1;0;0;0;1;6302;0;6302;1;1;
/org.eclipse.ui.tests/Eclipse UI Tests/org/eclipse/ui/tests/dnd/ViewDragSource.java;1;0;2;1;1;1;1;1;4;0;1;5007;4;4;1;0;0;1;2;5007;0;5539;2;1;
/org.eclipse.ui.workbench/Eclipse UI/org/eclipse/ui/internal/PluginActionContributionItem.java;5;0;15;2;1;1;1;14;121;2;12;2143;366;366;2;2;0;14;15;3008;2;6338;13;5;
/org.eclipse.jdt.core/compiler/org/eclipse/jdt/internal/compiler/util/ObjectVector.java;1;0;1;1;0;0;0;1;2;0;1;3560;2;2;1;0;0;1;1;3560;0;3560;1;1;
/org.eclipse.jdt.ui.tests.refactoring/test cases/org/eclipse/jdt/ui/tests/refactoring/InlineTempTests.java;3;0;5;1;1;1;1;4;17;1;4;130;29;29;1;0;0;4;5;130;0;6340;5;3;
/org.eclipse.jdt.core.tests.model/src/org/eclipse/jdt/core/tests/model/JavaSearchMultipleProjectsTests.java;2;1;17;1;4;4;4;13;172;1;13;157;754;754;1;0;0;13;17;157;0;5375;17;2;
/org.eclipse.jdt.core.tests.model/workspace/Converter/src/test0208/Test.java;1;0;1;1;0;0;0;1;0;0;1;3714;0;0;1;0;0;1;1;3714;0;3714;1;1;
/org.eclipse.ant.tests.core/test support/org/eclipse/ant/tests/core/support/inputHandlers/AntTestInputHandler.java;1;0;2;1;1;1;1;1;7;0;1;3497;11;11;1;0;0;1;2;3497;0;6336;2;1;
/org.eclipse.pde.ui/src/org/eclipse/pde/internal/ui/editor/manifest/JavaAttributeWizard.java;2;0;3;1;1;1;1;2;63;1;2;655;70;70;1;0;0;2;3;655;0;5431;3;2;
/org.eclipse.jdt.ui.tests.refactoring/resources/SefWorkSpace/SefTests/base_out/TestThisExpression.java;1;0;1;1;0;0;0;1;2;0;1;1492;2;2;1;0;0;1;1;1492;0;1492;1;1;
/org.eclipse.team.ui/src/org/eclipse/team/ui/synchronize/actions/SyncInfoDiffTreeNavigator.java;1;0;1;1;0;0;0;1;0;0;1;3709;0;0;1;0;0;1;1;3709;0;3709;1;1;
/org.eclipse.pde.core/src/org/eclipse/pde/internal/core/bundle/BundlePluginModel.java;1;1;2;1;2;2;2;0;10;0;0;5445;10;10;1;0;0;0;2;5445;0;6336;2;1;
/org.eclipse.ui.workbench/Eclipse UI/org/eclipse/ui/internal/csm/activities/IMutableActivityRegistry.java;1;0;2;1;0;0;0;2;0;1;2;2225;0;0;1;0;0;2;2;2225;0;2310;2;1;
/org.eclipse.core.tests.runtime/src/org/eclipse/core/tests/internal/runtimetests/SampleOFB.java;1;0;1;1;1;1;1;0;21;0;0;5149;21;21;1;0;0;0;1;5149;0;5149;1;1;
/org.eclipse.update.core/src/org/eclipse/update/standalone/SearchCommand.java;1;1;6;1;3;3;3;3;54;2;2;825;85;85;2;1;0;3;6;825;1;6336;5;1;
/org.eclipse.core.tests.resources/src/org/eclipse/core/tests/resources/regression/IFileTest.java;2;0;3;1;2;1;2;1;247;0;1;2313;280;280;2;0;1;1;3;5147;1;5147;2;2;
/org.eclipse.pde.ui/src_Forms/org/eclipse/pde/internal/ui/model/plugin/PluginParentNode.java;2;1;5;1;3;3;3;2;16;1;2;4438;32;32;1;0;0;2;5;4438;0;6336;5;2;
/org.eclipse.jdt.core/compiler/org/eclipse/jdt/internal/compiler/ast/TrueLiteral.java;2;0;2;1;0;0;0;2;4;1;2;2974;6;6;1;0;0;2;2;2974;0;3560;2;2;
/org.eclipse.ui.ide/src/org/eclipse/ui/part/FileInPlaceEditorInput.java;2;0;2;1;0;0;0;2;0;1;2;2083;0;0;1;0;0;2;2;2083;0;2263;2;2;
/org.eclipse.ui.ide/src/org/eclipse/ui/IMarkerResolutionGenerator.java;2;0;2;1;0;0;0;2;0;1;2;1511;0;0;1;0;0;2;2;1511;0;2263;2;2;
/org.eclipse.ui.views/src/org/eclipse/ui/views/internal/markers/MarkerView.java;1;0;7;1;0;0;0;7;745;2;5;265;821;821;2;2;0;7;7;265;2;749;5;1;
/org.eclipse.jface.text.tests/src/org/eclipse/jface/text/tests/rules/RulesTestSuite.java;1;1;2;1;2;2;2;0;2;0;0;5129;2;2;1;0;0;0;2;5129;0;6340;2;1;
/org.eclipse.jdt.core.tests.model/workspace/Formatter/test083/A_in.java;1;0;1;1;0;0;0;1;0;0;1;2425;0;0;1;0;0;1;1;2425;0;2425;1;1;
/org.eclipse.core.expressions/src/org/eclipse/core/expressions/IPropertyTester.java;1;1;4;1;3;3;3;1;8;0;1;4131;18;18;1;0;0;1;4;4131;0;6340;4;1;
/org.eclipse.jdt.core.tests.model/src/org/eclipse/jdt/core/tests/model/CodeCorrectionTestsRequestor.java;1;0;1;1;0;0;0;1;2;0;1;3560;2;2;1;0;0;1;1;3560;0;3560;1;1;
/org.eclipse.ui.ide/src/org/eclipse/ui/views/framelist/TreeViewerFrameSource.java;1;0;1;1;0;0;0;1;0;0;1;2208;0;0;1;0;0;1;1;2208;0;2208;1;1;
/org.eclipse.team.cvs.core/src/org/eclipse/team/internal/ccvs/core/util/ProjectDescriptionContentHandler.java;1;0;1;1;0;0;0;1;0;0;1;2143;0;0;1;0;0;1;1;2143;0;2143;1;1;
/org.eclipse.pde.build/src_ant/org/eclipse/pde/internal/build/tasks/GenericVersionReplacer.java;2;2;8;1;6;5;6;2;51;1;2;4210;109;109;2;0;1;2;8;6340;1;6340;7;2;
/org.eclipse.jface.text/src/org/eclipse/jface/text/rules/IPredicateRule.java;1;0;1;1;1;1;1;0;2;0;0;6340;2;2;1;0;0;0;1;6340;0;6340;1;1;
/org.eclipse.debug.ui/ui/org/eclipse/debug/internal/ui/actions/EnableBreakpointsAction.java;2;0;4;1;0;0;0;4;12;1;4;307;24;24;1;0;0;4;4;307;0;2740;4;2;
/org.eclipse.ui.workbench/Eclipse UI/org/eclipse/ui/internal/commands/KeysPreferencePage.java;4;2;74;2;8;6;8;66;3688;8;39;1695;13914;13914;8;27;2;66;74;1708;29;6338;45;4;
/org.eclipse.core.tools/src/org/eclipse/core/tools/runtime/PluginListView.java;1;0;1;1;1;1;1;0;0;0;0;6302;0;0;1;0;0;0;1;6302;0;6302;1;1;
/org.eclipse.swt.tests/JUnit Tests/org/eclipse/swt/tests/junit/Test_org_eclipse_swt_accessibility_AccessibleControlAdapter.java;1;0;1;1;0;0;0;1;0;0;1;2104;0;0;1;0;0;1;1;2104;0;2104;1;1;
/org.eclipse.ui.editors/src/org/eclipse/ui/internal/editors/text/PreviousPulldownActionDelegate.java;2;0;3;1;1;1;1;2;30;1;2;2080;32;32;1;0;0;2;3;2080;0;6340;3;2;
/org.eclipse.jdt.core/model/org/eclipse/jdt/internal/core/jdom/DOMType.java;3;1;12;2;2;2;2;10;81;2;9;90;163;163;2;1;0;10;12;2308;1;5916;11;3;
/org.eclipse.ui.ide/src/org/eclipse/ui/internal/registry/WizardsRegistryReader.java;2;0;11;2;0;0;0;11;33;2;8;1526;72;72;2;3;0;11;11;1536;3;2263;8;2;
/org.eclipse.ui.ide/src/org/eclipse/ui/internal/dialogs/WorkbenchWizardListSelectionPage.java;2;0;4;1;0;0;0;4;4;1;4;1526;6;6;1;0;0;4;4;1526;0;2263;4;2;
/org.eclipse.jdt.core.tests.model/workspace/Formatter/test109/A_out.java;1;0;1;1;0;0;0;1;0;0;1;2425;0;0;1;0;0;1;1;2425;0;2425;1;1;
/org.eclipse.osgi/osgi/src/org/osgi/framework/ServiceRegistration.java;2;0;2;1;1;1;1;1;3;0;1;3013;3;3;1;0;0;1;2;3013;0;5536;2;2;
/org.eclipse.jdt.core.tests.model/workspace/Converter/src/test0478/A.java;1;0;1;1;0;0;0;1;0;0;1;3714;0;0;1;0;0;1;1;3714;0;3714;1;1;
/org.eclipse.core.runtime/src/org/eclipse/core/internal/dependencies/SimpleSelectionPolicy.java;2;0;2;1;0;0;0;2;0;1;2;2105;0;0;1;0;0;2;2;2105;0;3013;2;2;
/org.eclipse.ui.workbench/Eclipse UI/org/eclipse/ui/internal/progress/ProgressControl.java;1;0;5;1;0;0;0;5;154;2;4;917;225;225;2;1;0;5;5;956;1;1079;4;1;
/org.eclipse.team.tests.cvs.core/src/org/eclipse/team/tests/ccvs/core/cvsresources/BatchedTestSetup.java;2;0;5;1;0;0;0;5;7;1;5;1649;19;19;1;0;0;5;5;1649;0;2206;5;2;
/org.eclipse.pde.ui/src_Forms/org/eclipse/pde/internal/ui/model/plugin/FragmentModel.java;2;1;4;1;2;2;2;2;14;1;2;4438;28;28;1;0;0;2;4;4438;0;6336;4;2;
/org.eclipse.jdt.ui.tests.refactoring/resources/InlineMethodWorkspace/TestCases/cast_in/TestNoCast.java;1;0;1;1;0;0;0;1;0;0;1;1671;0;0;1;0;0;1;1;1671;0;1671;1;1;
/org.eclipse.pde.ui/src/org/eclipse/pde/internal/ui/search/FindReferencesAction.java;3;1;7;1;5;5;5;2;15;1;2;2184;38;38;1;0;0;2;7;2184;0;6366;7;3;
/org.eclipse.debug.ui/ui/org/eclipse/debug/ui/launchVariables/VariableSelectionDialog.java;2;0;8;1;0;0;0;8;149;4;5;550;170;170;4;3;0;8;8;562;3;771;5;2;
/org.eclipse.jdt.core.tests.model/workspace/Formatter/test321/A_out.java;1;0;2;1;0;0;0;2;3;1;2;2462;3;3;1;0;0;2;2;2462;0;4173;2;1;
/org.eclipse.team.ui/src/org/eclipse/team/ui/synchronize/TreeViewerAdvisor.java;2;0;5;2;2;1;2;3;285;1;3;4632;296;296;2;0;1;3;5;5358;1;5358;4;2;
/org.eclipse.debug.ui/ui/org/eclipse/debug/internal/ui/sourcelookup/browsers/DirectorySourceContainerBrowser.java;1;0;5;1;0;0;0;5;6;1;5;3770;21;21;1;0;0;5;5;3770;0;4970;5;1;
/org.eclipse.jdt.ui/ui/org/eclipse/jdt/internal/ui/search/FindOccurrencesEngine.java;6;1;16;1;4;4;4;12;229;2;10;274;480;480;2;2;0;12;16;2560;2;6340;14;6;
/org.eclipse.jdt.core.tests.model/workspace/Formatter/test436/A_out.java;1;0;1;1;0;0;0;1;0;0;1;3495;0;0;1;0;0;1;1;3495;0;3495;1;1;
/org.eclipse.jface.text/src/org/eclipse/jface/internal/text/link/contentassist/ContextInformationPopup2.java;2;0;2;1;1;1;1;1;2;0;1;4214;2;2;1;0;0;1;2;4214;0;6340;2;2;
/org.eclipse.ui.views/src/org/eclipse/ui/views/internal/markers/DialogBookmarkFilter.java;1;0;2;1;0;0;0;2;0;0;1;749;0;0;2;1;0;2;2;749;1;749;1;1;
/org.eclipse.ui.externaltools/External Tools Base/org/eclipse/ui/externaltools/internal/ui/IExternalToolsUIConstants.java;2;0;2;1;0;0;0;2;12;1;2;53;12;12;1;0;0;2;2;53;0;282;2;2;
/org.eclipse.jdt.ui.tests/ui/org/eclipse/jdt/ui/tests/text/JavaHeuristicScannerTest.java;2;0;8;1;0;0;0;8;155;1;8;2004;301;301;1;0;0;8;8;2004;0;4210;8;2;
/org.eclipse.ui.workbench/Eclipse UI/org/eclipse/ui/internal/dnd/AbstractDragSource.java;3;0;3;1;0;0;0;3;46;1;3;3677;46;46;1;0;0;3;3;3677;0;5068;3;3;
/org.eclipse.jface/src/org/eclipse/jface/resource/FontRegistry.java;3;0;9;2;2;1;2;7;195;1;7;34;392;392;2;0;1;7;9;6338;1;6338;8;3;
/org.eclipse.team.ui/src/org/eclipse/team/internal/ui/synchronize/actions/EditWorkingSetAction.java;2;0;4;1;1;1;1;3;74;1;3;2535;79;79;1;0;0;3;4;2535;0;5596;4;2;
/org.eclipse.core.runtime.compatibility/src-model/org/eclipse/core/runtime/model/PluginRegistryModel.java;3;2;7;1;4;3;4;3;67;1;3;3013;87;87;2;0;1;3;7;5117;1;6340;6;3;
/org.eclipse.team.examples.filesystem/src/org/eclipse/team/examples/localhistory/LocalHistorySynchronizeWizard.java;1;1;2;1;2;2;2;0;2;0;0;6305;2;2;1;0;0;0;2;6305;0;6337;2;1;
/org.eclipse.jdt.ui.tests.refactoring/resources/ExtractMethodWorkSpace/ExtractMethodTests/locals_out/A_test532.java;1;0;1;1;0;0;0;1;4;0;1;844;4;4;1;0;0;1;1;844;0;844;1;1;
/org.eclipse.team.cvs.ui/src/org/eclipse/team/internal/ccvs/ui/wizards/CheckoutAsProjectSelectionPage.java;2;1;8;1;2;2;2;6;286;1;6;276;330;330;1;0;0;6;8;276;0;6337;8;2;
/org.eclipse.debug.core/core/org/eclipse/debug/core/model/LaunchConfigurationDelegate.java;3;1;14;1;9;9;9;5;126;1;5;4585;443;443;1;0;0;5;14;4585;0;6335;14;3;
/org.eclipse.update.ui/src/org/eclipse/update/internal/ui/views/ShowActivitiesAction.java;1;1;5;1;2;2;2;3;9;1;3;4434;17;17;1;0;0;3;5;4434;0;6336;5;1;
/org.eclipse.core.runtime/src/org/eclipse/core/internal/preferences/ListenerList.java;2;1;3;1;2;2;2;1;2;0;1;4351;2;2;1;0;0;1;3;4351;0;5686;3;2;
/org.eclipse.core.tests.harness/src/org/eclipse/core/tests/harness/CorePerformanceTest.java;1;0;2;1;1;1;1;1;27;0;1;2967;40;40;1;0;0;1;2;2967;0;5146;2;1;
/org.eclipse.jdt.core/compiler/org/eclipse/jdt/internal/compiler/ast/JavadocSingleTypeReference.java;3;0;7;1;0;0;0;7;46;1;7;2887;71;71;1;0;0;7;7;2887;0;3994;7;3;
/org.eclipse.debug.ui/ui/org/eclipse/debug/ui/launchVariables/WorkingSetExpander.java;1;0;2;1;0;0;0;2;0;1;2;550;0;0;1;0;0;2;2;550;0;562;2;1;
/org.eclipse.pde.ui/sandbox/org/eclipse/pde/internal/ui/editor/standalone/parser/DocumentNode.java;1;0;2;1;0;0;0;2;0;1;2;2320;0;0;1;0;0;2;2;2320;0;2906;2;1;
/org.eclipse.ui.ide/src/org/eclipse/ui/wizards/newresource/ResourceMessages.java;1;0;1;1;0;0;0;1;0;0;1;1511;0;0;1;0;0;1;1;1511;0;1511;1;1;
/org.eclipse.jdt.core.tests.model/workspace/Formatter/test174/A_out.java;1;0;1;1;0;0;0;1;0;0;1;2425;0;0;1;0;0;1;1;2425;0;2425;1;1;
/org.eclipse.core.runtime.compatibility/src-runtime/org/eclipse/core/internal/plugins/PreferenceExporter.java;4;1;5;2;2;2;2;3;52;2;2;3014;61;61;2;1;0;3;5;3168;1;5600;4;4;
/org.eclipse.team.ui/src/org/eclipse/team/internal/ui/sync/sets/SyncSetChangedEvent.java;1;0;4;1;0;0;0;4;127;1;4;1289;131;131;1;0;0;4;4;1289;0;2632;4;1;
/org.eclipse.jdt.core/model/org/eclipse/jdt/internal/core/DeleteResourceElementsOperation.java;3;0;9;1;1;1;1;8;11;1;8;1059;35;35;1;0;0;8;9;1059;0;5916;9;3;
/org.eclipse.core.runtime/src/org/eclipse/core/internal/content/FileSpec.java;2;1;3;1;2;2;2;1;10;0;1;4941;20;20;1;0;0;1;3;4941;0;5921;3;2;
/org.eclipse.jdt.core.tests.model/workspace/Formatter/test012/A_out.java;1;0;1;1;0;0;0;1;0;0;1;2425;0;0;1;0;0;1;1;2425;0;2425;1;1;
/org.eclipse.team.webdav/src/org/eclipse/team/internal/webdav/ui/subscriber/WebDavOverridePutAction.java;2;1;4;1;2;2;2;2;32;1;2;3499;39;39;1;0;0;2;4;3499;0;6337;4;2;
/org.eclipse.ui.workbench/Eclipse UI/org/eclipse/ui/internal/contexts/api/IContextDefinition.java;1;0;2;1;0;0;0;2;0;1;2;1724;0;0;1;0;0;2;2;1724;0;2425;2;1;
/org.eclipse.jdt.ui.tests.refactoring/resources/InlineMethodWorkspace/TestCases/cast_out/TestHierarchyOverloadedPrivate.java;1;0;1;1;0;0;0;1;0;0;1;955;0;0;1;0;0;1;1;955;0;955;1;1;
/org.eclipse.core.tests.resources/src/org/eclipse/core/tests/internal/localstore/DeleteTest.java;1;0;2;1;2;1;2;0;796;0;0;5147;796;796;2;0;1;0;2;5147;1;5147;1;1;
/org.eclipse.debug.ui/ui/org/eclipse/debug/internal/ui/views/AbstractViewerState.java;1;0;1;1;0;0;0;1;0;0;1;4348;0;0;1;0;0;1;1;4348;0;4348;1;1;
/org.eclipse.ui.tests/Eclipse UI Tests/org/eclipse/ui/tests/internal/InternalTestSuite.java;1;0;1;1;0;0;0;1;1;0;1;2351;1;1;1;0;0;1;1;2351;0;2351;1;1;
/org.eclipse.jdt.ui.examples.javafamily/stuff/easy_jsp.java;1;0;1;1;0;0;0;1;0;0;1;1033;0;0;1;0;0;1;1;1033;0;1033;1;1;
/org.eclipse.jdt.ui/core refactoring/org/eclipse/jdt/internal/corext/refactoring/participants/AndExpression.java;1;0;2;1;0;0;0;2;0;1;2;882;0;0;1;0;0;2;2;882;0;1033;2;1;
/org.eclipse.ui.workbench/Eclipse UI/org/eclipse/ui/internal/dialogs/WizardCollectionElement.java;3;0;3;2;0;0;0;3;342;2;2;2737;345;345;2;1;0;3;3;3061;1;3061;2;3;
/org.eclipse.jdt.ui/ui/org/eclipse/jdt/internal/ui/reorg/IRefactoringRenameSupport.java;1;0;1;1;0;0;0;1;0;0;1;1112;0;0;1;0;0;1;1;1112;0;1112;1;1;
/org.eclipse.swt/Eclipse SWT/gtk1x/org/eclipse/swt/graphics/FontMetrics.java;1;0;1;1;0;0;0;1;0;0;1;2327;0;0;1;0;0;1;1;2327;0;2327;1;1;
/org.eclipse.ui.workbench/Eclipse UI/org/eclipse/ui/dialogs/SelectionStatusDialog.java;2;1;2;1;2;2;2;0;24;0;0;5464;31;31;1;0;0;0;2;5464;0;6338;2;2;
/org.eclipse.swt/Eclipse SWT/gtk1x/org/eclipse/swt/widgets/ToolItem.java;1;0;1;1;0;0;0;1;0;0;1;2327;0;0;1;0;0;1;1;2327;0;2327;1;1;
/org.eclipse.jdt.ui/core refactoring/org/eclipse/jdt/internal/corext/refactoring/participants/ResourceModifications.java;2;1;12;1;3;3;3;9;158;1;9;825;548;548;1;0;0;9;12;825;0;6340;12;2;
/org.eclipse.team.ui/src/org/eclipse/team/ui/synchronize/subscriber/ITeamRunnableContext.java;1;0;1;1;0;0;0;1;0;0;1;4055;0;0;1;0;0;1;1;4055;0;4055;1;1;
/org.eclipse.jdt.debug/model/org/eclipse/jdt/internal/debug/core/model/JDIArrayPartitionValue.java;3;0;3;1;0;0;0;3;32;1;3;1316;39;39;1;0;0;3;3;1316;0;2564;3;3;
/org.eclipse.core.runtime.osgi/src/org/eclipse/core/runtime/Status.java;1;0;2;1;0;0;0;2;298;1;2;3013;298;298;1;0;0;2;2;3013;0;3030;2;1;
/org.eclipse.jdt.ui/ui/org/eclipse/jdt/internal/ui/preferences/TypeFilterInputDialog.java;2;1;4;1;2;2;2;2;4;1;2;3168;8;8;1;0;0;2;4;3168;0;6340;4;2;
/org.eclipse.jdt.core/codeassist/org/eclipse/jdt/internal/codeassist/select/SelectionOnPackageReference.java;2;0;3;1;0;0;0;3;14;1;3;85;18;18;1;0;0;3;3;85;0;3560;3;2;
/org.eclipse.text/src/org/eclipse/jface/text/ITypedRegion.java;1;0;1;1;1;1;1;0;14;0;0;6298;14;14;1;0;0;0;1;6298;0;6298;1;1;
/org.eclipse.jdt.ui.tests.refactoring/resources/ExtractMethodWorkSpace/ExtractMethodTests/locals_in/A_test534.java;1;0;1;1;0;0;0;1;2;0;1;844;2;2;1;0;0;1;1;844;0;844;1;1;
/org.eclipse.jdt.core/compiler/org/eclipse/jdt/internal/compiler/ast/SingleNameReference.java;2;0;14;1;0;0;0;14;1145;3;12;41;1207;1207;3;2;0;14;14;1784;2;3560;12;2;
/org.eclipse.ui.workbench/Eclipse UI/org/eclipse/ui/internal/registry/CapabilityRegistryReader.java;1;0;1;1;0;0;0;1;0;0;1;2737;0;0;1;0;0;1;1;2737;0;2737;1;1;
/org.eclipse.jdt.ui.tests.refactoring/resources/MoveMembers/test31/out/A.java;1;0;1;1;0;0;0;1;0;0;1;1651;0;0;1;0;0;1;1;1651;0;1651;1;1;
/org.eclipse.jdt.ui.tests.refactoring/resources/Copy/test_method_yes_other_method/out/A.java;1;0;1;1;0;0;0;1;2;0;1;685;2;2;1;0;0;1;1;685;0;685;1;1;
/org.eclipse.pde.ui/src/org/eclipse/pde/internal/ui/wizards/site/NewSiteProjectCreationPage.java;2;3;5;2;5;3;5;0;67;0;0;6020;71;71;3;0;2;0;5;6086;2;6336;3;2;
/org.eclipse.jdt.core/codeassist/org/eclipse/jdt/internal/codeassist/complete/CompletionNodeDetector.java;1;0;2;1;0;0;0;2;14;1;2;2974;16;16;1;0;0;2;2;2974;0;3557;2;1;
/org.eclipse.core.tests.runtime/src/org/eclipse/core/tests/runtime/AllTests.java;3;2;20;1;8;7;8;12;68;1;12;698;137;137;2;0;1;12;20;5987;1;5987;19;3;
/org.eclipse.pde.ui/src_Forms/org/eclipse/pde/internal/ui/neweditor/plugin/LoopDialog.java;1;0;2;1;1;1;1;1;0;0;1;4574;0;0;1;0;0;1;2;4574;0;5431;2;1;
/org.eclipse.jdt.core.tests.model/workspace/Converter/src/test0067/Test.java;1;0;1;1;0;0;0;1;0;0;1;3714;0;0;1;0;0;1;1;3714;0;3714;1;1;
/org.eclipse.jdt.debug/eval/org/eclipse/jdt/internal/debug/eval/ast/instructions/RemainderOperator.java;1;0;1;1;0;0;0;1;5;0;1;1240;5;5;1;0;0;1;1;1240;0;1240;1;1;
/org.eclipse.jdt.debug.ui/ui/org/eclipse/jdt/internal/debug/ui/actions/PopupInspectAction.java;4;1;11;1;4;4;4;7;100;2;6;3833;223;223;2;1;0;7;11;3833;1;6126;10;4;
/org.eclipse.jdt.ui.examples.javafamily/src/org/eclipse/core/indexsearch/ISearchResultCollector.java;1;0;1;1;0;0;0;1;0;0;1;1033;0;0;1;0;0;1;1;1033;0;1033;1;1;
/org.eclipse.jdt.core/model/org/eclipse/jdt/internal/core/jdom/DOMMember.java;3;1;6;1;2;2;2;4;11;1;4;90;33;33;1;0;0;4;6;90;0;5916;6;3;
/org.eclipse.debug.ui/ui/org/eclipse/debug/internal/ui/views/memory/IMemoryViewConstants.java;1;0;1;1;1;1;1;0;0;0;0;5254;0;0;1;0;0;0;1;5254;0;5254;1;1;
/org.eclipse.jdt.ui/ui/org/eclipse/jdt/ui/wizards/JavaCapabilityConfigurationPage.java;2;0;4;2;2;1;2;2;9;1;2;3580;20;20;2;0;1;2;4;6334;1;6334;3;2;
/org.eclipse.swt.tests/JUnit Tests/org/eclipse/swt/tests/junit/Test_org_eclipse_swt_events_ArmEvent.java;1;0;2;1;1;1;1;1;7;0;1;3444;11;11;1;0;0;1;2;3444;0;6352;2;1;
/org.eclipse.ui.examples.javaeditor/Eclipse Java Editor Example/org/eclipse/ui/examples/javaeditor/spelling/IJavaDocTagConstants.java;1;0;1;1;0;0;0;1;0;0;1;2565;0;0;1;0;0;1;1;2565;0;2565;1;1;
/org.eclipse.jdt.ui.tests.refactoring/resources/MoveInstanceMethod/canMove/test24/in/A.java;1;0;1;1;0;0;0;1;0;0;1;1627;0;0;1;0;0;1;1;1627;0;1627;1;1;
/org.eclipse.jdt.ui/ui/org/eclipse/jdt/ui/text/spelling/engine/LocaleSensitiveSpellDictionary.java;1;0;2;1;0;0;0;2;0;1;2;3829;0;0;1;0;0;2;2;3829;0;3930;2;1;
/org.eclipse.pde.ui/templates_3.0/editor/java/XMLWhitespaceDetector.java;1;0;1;1;0;0;0;1;0;0;1;2786;0;0;1;0;0;1;1;2786;0;2786;1;1;
/org.eclipse.jdt.ui.tests.refactoring/resources/Delete/testDeleteWithinCu3/in/A.java;1;0;1;1;0;0;0;1;0;0;1;442;0;0;1;0;0;1;1;442;0;442;1;1;
/org.eclipse.team.core/src/org/eclipse/team/core/variants/IResourceVariantTree.java;2;1;3;1;2;2;2;1;4;0;1;4349;8;8;1;0;0;1;3;4349;0;6336;3;2;
/org.eclipse.jdt.core.tests.model/workspace/Converter/test0412/A.java;1;0;1;1;0;0;0;1;0;0;1;3714;0;0;1;0;0;1;1;3714;0;3714;1;1;
/org.eclipse.team.ui/src/org/eclipse/team/ui/synchronize/SyncInfoSetCompareInput.java;1;0;1;1;0;0;0;1;0;0;1;3518;0;0;1;0;0;1;1;3518;0;3518;1;1;
/org.eclipse.jdt.core.tests.compiler/src/org/eclipse/jdt/core/tests/compiler/regression/JavadocTestForClass.java;1;0;6;1;0;0;0;6;45;1;6;2887;82;82;1;0;0;6;6;2887;0;4561;6;1;
/org.eclipse.jdt.ui/core refactoring/org/eclipse/jdt/internal/corext/refactoring/base/JavaStatusContext.java;3;1;5;1;2;2;2;3;20;1;3;882;26;26;1;0;0;3;5;882;0;6340;5;3;
/org.eclipse.debug.ui/ui/org/eclipse/debug/internal/ui/actions/RetargetBreakpointAction.java;1;0;2;1;0;0;0;2;2;1;2;4471;2;2;1;0;0;2;2;4471;0;4496;2;1;
/org.eclipse.swt/Eclipse SWT/gtk/org/eclipse/swt/widgets/Table.java;7;2;62;2;11;10;11;51;198;2;46;44;1800;1800;2;5;1;51;62;1401;6;6352;56;7;
/org.eclipse.update.ui/srcnew/org/eclipse/update/internal/ui/parts/MyComputerContentProvider.java;2;0;2;1;0;0;0;2;0;1;2;745;0;0;1;0;0;2;2;745;0;825;2;2;
/org.eclipse.ui.workbench/Eclipse UI/org/eclipse/ui/dialogs/AbstractElementListSelectionDialog.java;2;2;4;1;3;2;3;1;27;0;1;41;67;67;2;0;1;1;4;5464;1;6338;3;2;
/org.eclipse.jface/src/org/eclipse/jface/wizard/ProgressMonitorPart.java;2;1;3;1;2;2;2;1;48;0;1;3678;72;72;1;0;0;1;3;3678;0;6338;3;2;
/org.eclipse.team.ftp/src/org/eclipse/team/internal/ftp/client/EPLFDirectoryEntryParser.java;2;0;4;1;1;1;1;3;53;1;3;3382;82;82;1;0;0;3;4;3382;0;6337;4;2;
/org.eclipse.jdt.ui.tests.refactoring/resources/RenameVirtualMethodInClass/testLocal0/out/A.java;1;0;1;1;0;0;0;1;0;0;1;2821;0;0;1;0;0;1;1;2821;0;2821;1;1;
/org.eclipse.jdt.ui.tests.refactoring/resources/MoveMembers/test27/out/B.java;1;0;1;1;0;0;0;1;0;0;1;1522;0;0;1;0;0;1;1;1522;0;1522;1;1;
/org.eclipse.ui.presentations.r21/src/org/eclipse/ui/internal/presentations/r21/widgets/CTabItem.java;1;1;2;1;2;2;2;0;2;0;0;6075;2;2;1;0;0;0;2;6075;0;6338;2;1;
/org.eclipse.help/src/org/eclipse/help/internal/search/SearchIndex.java;1;0;3;1;0;0;0;3;93;2;2;1930;93;93;2;1;0;3;3;1930;1;2732;2;1;
/org.eclipse.jdt.core.tests.model/workspace/Formatter/test361/A_in.java;1;0;1;1;0;0;0;1;0;0;1;3087;0;0;1;0;0;1;1;3087;0;3087;1;1;
/org.eclipse.swt.graphics.text/Eclipse SWT/carbon/org/eclipse/swt/graphics/text/TextLayout.java;2;0;7;1;0;0;0;7;1021;4;4;2744;1080;1080;4;3;0;7;7;4535;3;4560;4;2;
/org.eclipse.jdt.core.tests.model/workspace/JavaSearch/src/p10/a/b/om/X.java;1;0;1;1;1;1;1;0;0;0;0;5938;0;0;1;0;0;0;1;5938;0;5938;1;1;
/org.eclipse.jdt.ui/core refactoring/org/eclipse/jdt/internal/corext/refactoring/reorg/ReorgUtils.java;4;1;9;1;2;2;2;7;530;1;7;443;681;681;1;0;0;7;9;443;0;6340;9;4;
/org.eclipse.jdt.ui.tests.refactoring/resources/ExtractMethodWorkSpace/ExtractMethodTests/initializer_in/A_test1002.java;1;0;1;1;0;0;0;1;0;0;1;3310;0;0;1;0;0;1;1;3310;0;3310;1;1;
/org.eclipse.ui.console/src/org/eclipse/ui/console/IConsoleView.java;3;1;3;1;2;2;2;1;7;0;1;1988;11;11;1;0;0;1;3;1988;0;6336;3;3;
/org.eclipse.team.cvs.ui/src/org/eclipse/team/internal/ccvs/ui/wizards/SharingWizardFinishPage.java;2;0;2;1;1;1;1;1;2;0;1;2381;2;2;1;0;0;1;2;2381;0;6015;2;2;
/org.eclipse.ui.workbench/Eclipse UI/org/eclipse/ui/part/DrillDownAdapter.java;3;0;4;2;2;1;2;2;10;1;2;4468;23;23;2;0;1;2;4;6338;1;6338;3;3;
/org.eclipse.team.cvs.ui/src/org/eclipse/team/internal/ccvs/ui/repo/RemoteTagsView.java;1;0;1;1;0;0;0;1;4;0;1;790;4;4;1;0;0;1;1;790;0;790;1;1;
/org.eclipse.debug.core/core/org/eclipse/debug/core/sourcelookup/ISourceLookupParticipant.java;1;1;5;1;3;3;3;2;6;1;2;4949;16;16;1;0;0;2;5;4949;0;6336;5;1;
/org.eclipse.compare/compare/org/eclipse/compare/structuremergeviewer/DiffTreeViewer.java;1;0;3;1;0;0;0;3;8;1;3;257;12;12;1;0;0;3;3;257;0;3938;3;1;
/org.eclipse.search/new search/org/eclipse/search2/internal/ui/ListDialog.java;2;1;3;1;2;2;2;1;2;0;1;3474;2;2;1;0;0;1;3;3474;0;5681;3;2;
/org.eclipse.ui.workbench/Eclipse UI/org/eclipse/ui/roles/IRoleActivationService.java;1;0;3;1;0;0;0;3;4;1;3;1952;4;4;1;0;0;3;3;1952;0;2202;3;1;
/org.eclipse.ui.views/src/org/eclipse/ui/views/navigator/FiltersContentProvider.java;1;0;1;1;0;0;0;1;0;0;1;2738;0;0;1;0;0;1;1;2738;0;2738;1;1;
/org.eclipse.jdt.ui.tests.refactoring/test cases/org/eclipse/jdt/ui/tests/refactoring/RenameStaticMethodTests.java;3;1;12;1;2;2;2;10;24;2;9;130;137;137;2;1;0;10;12;1347;1;6340;11;3;
/org.eclipse.jdt.core.tests.model/workspace/Formatter/test062/A_out.java;1;0;1;1;0;0;0;1;0;0;1;2425;0;0;1;0;0;1;1;2425;0;2425;1;1;
/org.eclipse.jdt.ui/core extension/org/eclipse/jdt/internal/corext/template/java/GlobalVariables.java;1;0;1;1;0;0;0;1;0;0;1;4258;0;0;1;0;0;1;1;4258;0;4258;1;1;
/org.eclipse.jdt.ui.tests.refactoring/resources/ExtractMethodWorkSpace/ExtractMethodTests/semicolon_out/A_test409.java;1;0;2;1;0;0;0;2;6;1;2;130;7;7;1;0;0;2;2;130;0;844;2;1;
/org.eclipse.jface.text/src/org/eclipse/jface/text/formatter/ContentFormatter.java;4;1;17;1;5;5;5;12;662;1;12;472;1817;1817;1;0;0;12;17;472;0;6357;17;4;
/org.eclipse.osgi/core/framework/org/eclipse/osgi/framework/internal/core/PermissionAdmin.java;3;1;4;1;2;2;2;2;1210;1;2;3013;1220;1220;1;0;0;2;4;3013;0;5116;4;3;
/org.eclipse.jdt.core/model/org/eclipse/jdt/internal/core/CreateTypeHierarchyOperation.java;2;0;5;1;0;0;0;5;30;1;5;970;46;46;1;0;0;5;5;970;0;3560;5;2;
/org.eclipse.ui.workbench/Eclipse UI/org/eclipse/ui/internal/csm/activities/PatternBindingDefinition.java;1;0;4;1;0;0;0;4;55;1;4;2297;89;89;1;0;0;4;4;2297;0;2412;4;1;
/org.eclipse.pde.ui/src/org/eclipse/pde/internal/ui/editor/plugin/ExtensionPointsSection.java;3;1;6;1;6;6;6;0;14;0;0;5431;37;37;1;0;0;0;6;5431;0;6336;6;3;
/org.eclipse.jdt.core.tests.model/workspace/Formatter/test382/A_out.java;1;0;1;1;0;0;0;1;0;0;1;3163;0;0;1;0;0;1;1;3163;0;3163;1;1;
/org.eclipse.update.core/srcnew/org/eclipse/update/internal/operations/OperationValidator.java;1;0;9;1;0;0;0;9;74;1;9;367;270;270;1;0;0;9;9;367;0;825;9;1;
/org.eclipse.jdt.ui/core refactoring/org/eclipse/jdt/internal/corext/refactoring/participants/ICopyProcessor.java;1;0;2;1;0;0;0;2;0;1;2;1125;0;0;1;0;0;2;2;1125;0;4624;2;1;
/org.eclipse.jdt.core/compiler/org/eclipse/jdt/internal/compiler/ast/SynchronizedStatement.java;3;0;6;2;1;1;1;5;28;2;4;148;51;51;2;1;0;5;6;148;1;5343;5;3;
/org.eclipse.update.configurator/src/org/eclipse/update/configurator/IPluginConverter.java;2;0;2;1;0;0;0;2;0;1;2;3014;0;0;1;0;0;2;2;3014;0;3087;2;2;
/org.eclipse.jdt.debug/eval/org/eclipse/jdt/internal/debug/eval/ast/engine/BinaryBasedSourceGenerator.java;1;0;1;1;0;0;0;1;3;0;1;2497;3;3;1;0;0;1;1;2497;0;2497;1;1;
/org.eclipse.team.ftp/src/org/eclipse/team/internal/ftp/ui/MappingSelectionPage.java;1;0;1;1;0;0;0;1;0;0;1;3240;0;0;1;0;0;1;1;3240;0;3240;1;1;
/org.eclipse.debug.ui/ui/org/eclipse/debug/internal/ui/launchConfigurations/AbstractLaunchConfigurationAction.java;1;0;1;1;0;0;0;1;16;0;1;473;16;16;1;0;0;1;1;473;0;473;1;1;
/org.eclipse.jdt.core.tests.compiler/src/org/eclipse/jdt/core/tests/compiler/parser/GenericDietRecoveryTest.java;1;0;1;1;0;0;0;1;0;0;1;4753;0;0;1;0;0;1;1;4753;0;4753;1;1;
/org.eclipse.jdt.text.tests/src/org/eclipse/jdt/ui/tests/spelling/SpellCheckEngineTestCase.java;1;0;2;1;1;1;1;1;0;0;1;5082;0;0;1;0;0;1;2;5082;0;5130;2;1;
/org.eclipse.update.core/src/org/eclipse/update/operations/IUninstallFeatureOperation.java;1;2;10;1;4;3;4;6;11;2;5;825;23;23;2;1;1;6;10;825;2;6336;8;1;
/org.eclipse.ui.workbench/Eclipse UI/org/eclipse/ui/contexts/IContextRegistryListener.java;1;0;4;1;0;0;0;4;0;2;3;1388;0;0;2;1;0;4;4;1417;1;1417;3;1;
/org.eclipse.jdt.ui.tests.refactoring/resources/ChangeTypeRefactoring/positive/A_testLocalVarType_out.java;1;0;1;1;0;0;0;1;0;0;1;2844;0;0;1;0;0;1;1;2844;0;2844;1;1;
/org.eclipse.team.cvs.core/src/org/eclipse/team/internal/ccvs/core/syncinfo/ResourceSynchronizer.java;2;0;8;1;0;0;0;8;64;1;8;532;115;115;1;0;0;8;8;532;0;1954;8;2;
/org.eclipse.ui.ide/src/org/eclipse/ui/views/tasklist/RemoveTaskAction.java;1;0;1;1;0;0;0;1;0;0;1;2208;0;0;1;0;0;1;1;2208;0;2208;1;1;
/org.eclipse.swt/Eclipse SWT/photon/org/eclipse/swt/widgets/ToolItem.java;2;0;5;1;0;0;0;5;31;1;5;46;57;57;1;0;0;5;5;46;0;2826;5;2;
/org.eclipse.debug.ui/ui/org/eclipse/debug/internal/ui/views/AsyncTreeViewer.java;1;0;2;1;0;0;0;2;0;1;2;267;0;0;1;0;0;2;2;267;0;1974;2;1;
/org.eclipse.compare.examples.xml/src/org/eclipse/compare/examples/xml/HungarianMethod.java;1;0;3;1;0;0;0;3;2;1;3;1106;2;2;1;0;0;3;3;1106;0;4711;3;1;
/org.eclipse.ui.workbench/Eclipse UI/org/eclipse/ui/internal/contexts/registry/IMutableContextRegistry.java;1;0;2;1;0;0;0;2;0;1;2;1422;0;0;1;0;0;2;2;1422;0;1724;2;1;
/org.eclipse.jdt.core.tests.model/workspace/Formatter/test363/A_out.java;1;0;1;1;0;0;0;1;0;0;1;3089;0;0;1;0;0;1;1;3089;0;3089;1;1;
/org.eclipse.jdt.core/model/org/eclipse/jdt/internal/compiler/SourceElementParser.java;2;0;3;2;2;1;2;1;38;0;1;4461;38;38;2;0;1;1;3;6141;1;6141;2;2;
/org.eclipse.team.webdav/src/org/eclipse/team/internal/target/subscriber/GetOperation.java;2;0;4;1;1;1;1;3;171;1;3;3494;175;175;1;0;0;3;4;3494;0;6337;4;2;
/org.eclipse.ui.workbench/Eclipse UI/org/eclipse/ui/internal/dialogs/NewWizardSelectionPage.java;5;0;6;2;1;1;1;5;45;2;4;2737;94;94;2;1;0;5;6;3061;1;6338;5;5;
/org.eclipse.jdt.ui/core refactoring/org/eclipse/jdt/internal/corext/refactoring/participants/IDeleteProcessor.java;1;0;2;1;0;0;0;2;0;1;2;1125;0;0;1;0;0;2;2;1125;0;1668;2;1;
/org.eclipse.ui.tests/Eclipse UI Tests/org/eclipse/ui/tests/dynamicplugins/Perspectives.java;1;0;2;1;0;0;0;2;0;1;2;4825;0;0;1;0;0;2;2;4825;0;4969;2;1;
/org.eclipse.pde.ui/src_samples/org/eclipse/pde/ui/internal/samples/SelectionPage.java;3;1;5;1;4;4;4;1;22;0;1;4538;46;46;1;0;0;1;5;4538;0;6336;5;3;
/org.eclipse.pde.build/src/org/eclipse/pde/internal/build/BuildActivator.java;2;0;3;1;1;1;1;2;23;1;2;4089;26;26;1;0;0;2;3;4089;0;5145;3;2;
/org.eclipse.ui.examples.javaeditor/Eclipse Java Editor Example/org/eclipse/ui/examples/javaeditor/spelling/IPhoneticHashProvider.java;1;0;1;1;0;0;0;1;0;0;1;2565;0;0;1;0;0;1;1;2565;0;2565;1;1;
/org.eclipse.sdk.tests-feature/plugins/org.eclipse.perfmsr.ui/src/org/eclipse/perfmsr/ui/PerformancePreferencePage.java;2;1;6;1;5;5;5;1;10;0;1;4845;24;24;1;0;0;1;6;4845;0;6342;6;2;
/org.eclipse.ant.ui/Ant Tools Support/org/eclipse/ant/ui/internal/views/elements/AntViewElementsMessages.java;1;0;3;1;0;0;0;3;2;1;3;250;2;2;1;0;0;3;3;250;0;1811;3;1;
/org.eclipse.jdt.ui.tests.refactoring/resources/Paste/test2/out/B.java;1;0;1;1;0;0;0;1;0;0;1;1311;0;0;1;0;0;1;1;1311;0;1311;1;1;
/org.eclipse.core.runtime/src/org/eclipse/core/runtime/Preferences.java;4;2;25;2;8;7;8;17;2684;3;13;3013;6090;6090;3;4;1;17;25;4351;5;6341;20;4;
/org.eclipse.jdt.core.tests.model/workspace/Converter/test0108/Test.java;1;0;1;1;0;0;0;1;0;0;1;3714;0;0;1;0;0;1;1;3714;0;3714;1;1;
/org.eclipse.core.runtime/src/org/eclipse/core/internal/runtime/PlatformURLPluginHandlerFactory.java;3;0;5;2;0;0;0;5;483;2;4;3013;779;779;2;1;0;5;5;3164;1;4891;4;3;
/org.eclipse.ui.workbench/Eclipse UI/org/eclipse/ui/dialogs/WizardNewFolderMainPage.java;2;0;2;1;0;0;0;2;36;1;2;534;36;36;1;0;0;2;2;534;0;2737;2;2;
/org.eclipse.team.webdav/src/org/eclipse/team/internal/core/target/ISiteFactory.java;1;0;1;1;0;0;0;1;0;0;1;2495;0;0;1;0;0;1;1;2495;0;2495;1;1;
/org.eclipse.team.webdav/src/org/eclipse/team/internal/ui/target/subscriber/DeploymentContainerSelectionPage.java;2;1;6;1;2;2;2;4;378;1;4;3805;402;402;1;0;0;4;6;3805;0;6337;6;2;
/org.eclipse.core.runtime/src/org/eclipse/core/internal/registry/RegistryModelObject.java;5;3;11;1;7;5;7;4;282;1;4;3049;415;415;3;0;2;4;11;5637;2;6340;9;5;
/org.eclipse.team.ftp/src/org/eclipse/team/internal/ftp/subscriber/BaseSynchronizationCache.java;1;0;1;1;0;0;0;1;0;0;1;3221;0;0;1;0;0;1;1;3221;0;3221;1;1;
/org.eclipse.jdt.ui/core refactoring/org/eclipse/jdt/internal/corext/refactoring/participants/xml/OrExpression.java;1;0;6;1;0;0;0;6;7;1;6;1033;21;21;1;0;0;6;6;1033;0;4108;6;1;
/org.eclipse.ua.tests/src/org/eclipse/ui/tests/cheatsheets/parameters/DisplayDataDialog.java;1;0;1;1;1;1;1;0;0;0;0;6081;0;0;1;0;0;0;1;6081;0;6081;1;1;
/org.eclipse.ui.externaltools/Ant Tools Support/org/eclipse/ui/externaltools/internal/ant/view/elements/TargetNode.java;1;0;1;1;0;0;0;1;0;0;1;282;0;0;1;0;0;1;1;282;0;282;1;1;
/org.eclipse.jdt.ui/ui/org/eclipse/jdt/ui/actions/PushDownAction.java;4;0;12;2;2;1;2;10;144;1;10;42;253;253;2;0;1;10;12;6334;1;6334;11;4;
/org.eclipse.jdt.ui/core refactoring/org/eclipse/jdt/internal/corext/refactoring/participants/RenameParticipant.java;1;0;5;1;0;0;0;5;22;1;5;591;33;33;1;0;0;5;5;591;0;4624;5;1;
/org.eclipse.ui.workbench/Eclipse UI/org/eclipse/ui/internal/csm/activities/IActivityPatternBindingDefinition.java;1;0;4;1;0;0;0;4;32;1;4;2225;32;32;1;0;0;4;4;2225;0;2444;4;1;
/org.eclipse.jdt.core.tests.model/workspace/Formatter/test040/A_in.java;1;0;1;1;0;0;0;1;0;0;1;2425;0;0;1;0;0;1;1;2425;0;2425;1;1;
/org.eclipse.ui.workbench/Eclipse UI/org/eclipse/ui/internal/PerspectiveBarContributionItem.java;8;1;17;2;7;7;7;10;177;2;9;3748;433;433;2;1;0;10;17;4120;1;6338;16;8;
/org.eclipse.ui.workbench/Eclipse UI/org/eclipse/ui/internal/csm/commands/api/ICommandServiceListener.java;1;0;2;1;0;0;0;2;0;1;2;2515;0;0;1;0;0;2;2;2515;0;2562;2;1;
/org.eclipse.jface.text/src/org/eclipse/jface/text/source/LineNumberChangeRulerColumn.java;3;1;11;1;3;3;3;8;79;1;8;1118;269;269;1;0;0;8;11;1118;0;6340;11;3;
/org.eclipse.ui.ide/src/org/eclipse/ui/dialogs/WizardNewLinkPage.java;2;0;3;1;0;0;0;3;28;1;3;1511;28;28;1;0;0;3;3;1511;0;2263;3;2;
/org.eclipse.debug.ui/ui/org/eclipse/debug/internal/ui/sourcelookup/SourceContainerLookupTab.java;1;0;4;1;0;0;0;4;21;1;4;3770;23;23;1;0;0;4;4;3770;0;4953;4;1;
/org.eclipse.ui.workbench/Eclipse UI/org/eclipse/ui/internal/PlaceholderContributionItem.java;2;0;5;1;1;1;1;4;194;2;3;3793;213;213;2;1;0;4;5;3810;1;6338;4;2;
/org.eclipse.core.tools/src/org/eclipse/core/tools/runtime/RuntimeSpyPerspective.java;1;0;1;1;1;1;1;0;0;0;0;6302;0;0;1;0;0;0;1;6302;0;6302;1;1;
/org.eclipse.jdt.core.tests.model/workspace/Converter/test0103/Test.java;1;0;1;1;0;0;0;1;0;0;1;3714;0;0;1;0;0;1;1;3714;0;3714;1;1;
/org.eclipse.core.tools/src/org/eclipse/core/tools/runtime/EclipsePreferencesView.java;1;0;1;1;1;1;1;0;0;0;0;6302;0;0;1;0;0;0;1;6302;0;6302;1;1;
/org.eclipse.ui.examples.job/src/org/eclipse/ui/examples/jobs/views/DeferredContentProvider.java;1;0;1;1;1;1;1;0;0;0;0;5126;0;0;1;0;0;0;1;5126;0;5126;1;1;
/org.eclipse.sdk.tests-feature/plugins/org.eclipse.perfmsr.ui/src/org/eclipse/perfmsr/ui/actions/DumpPluginInfo.java;2;1;4;1;3;3;3;1;12;0;1;4845;24;24;1;0;0;1;4;4845;0;6342;4;2;
/org.eclipse.jdt.core.tests.model/workspace/Formatter/test426/A_out.java;1;0;1;1;0;0;0;1;0;0;1;3478;0;0;1;0;0;1;1;3478;0;3478;1;1;
/org.eclipse.ui.ide/src/org/eclipse/ui/views/navigator/GotoResourceAction.java;1;0;1;1;0;0;0;1;0;0;1;2208;0;0;1;0;0;1;1;2208;0;2208;1;1;
/org.eclipse.team.cvs.ui/src/org/eclipse/team/internal/ccvs/ui/DialogArea.java;1;0;1;1;0;0;0;1;0;0;1;1013;0;0;1;0;0;1;1;1013;0;1013;1;1;
/org.eclipse.jdt.ui/ui refactoring/org/eclipse/jdt/internal/ui/refactoring/nls/OrderedMap.java;1;0;1;1;1;1;1;0;2;0;0;6340;2;2;1;0;0;0;1;6340;0;6340;1;1;
/org.eclipse.ui.workbench.texteditor/src/org/eclipse/ui/texteditor/RegExContentAssistProcessor.java;1;1;7;1;3;3;3;4;205;2;3;2279;272;272;2;1;0;4;7;2279;1;6340;6;1;
/org.eclipse.jdt.debug.jdi.tests/tests/org/eclipse/debug/jdi/tests/program/TestClass6.java;1;0;1;1;1;1;1;0;3;0;0;6339;3;3;1;0;0;0;1;6339;0;6339;1;1;
/org.eclipse.ui.externaltools/Ant Editor/org/eclipse/ui/externaltools/internal/ant/editor/text/PlantyDocumentProvider.java;1;0;1;1;0;0;0;1;0;0;1;178;0;0;1;0;0;1;1;178;0;178;1;1;
/org.eclipse.ui.workbench/Eclipse UI/org/eclipse/ui/internal/commands/registry/IContextBindingDefinition.java;1;0;2;1;0;0;0;2;0;1;2;1422;0;0;1;0;0;2;2;1422;0;1724;2;1;
/org.eclipse.sdk.tests-feature/plugins/org.eclipse.perfmsr.core/src/org/eclipse/perfmsr/core/IDriverInfo.java;2;0;2;1;1;1;1;1;10;0;1;4845;10;10;1;0;0;1;2;4845;0;6342;2;2;
/org.eclipse.update.ui.forms/Eclipse Forms/org/eclipse/ui/forms/events/ExpansionListener.java;1;0;2;1;0;0;0;2;0;1;2;3096;0;0;1;0;0;2;2;3096;0;4157;2;1;
/org.eclipse.ant.ui/Ant Tools Support/org/eclipse/ant/internal/ui/views/AntTargetContentProvider.java;1;0;1;1;0;0;0;1;0;0;1;1811;0;0;1;0;0;1;1;1811;0;1811;1;1;
/org.eclipse.update.core/src/org/eclipse/update/internal/standalone/SearchCommand.java;2;0;9;1;0;0;0;9;28;1;9;828;60;60;1;0;0;9;9;828;0;4928;9;2;
/org.eclipse.jdt.ui.tests.refactoring/resources/ChangeSignature/canModify/A_testAll58_in.java;2;0;3;1;0;0;0;3;10;1;3;2093;12;12;1;0;0;3;3;2093;0;4486;3;2;
/org.eclipse.jdt.ui/ui/org/eclipse/jdt/internal/ui/javaeditor/JavaSelectMarkerRulerAction.java;4;0;11;2;0;0;0;11;114;2;10;1094;252;252;2;1;0;11;11;1211;1;4940;10;4;
/org.eclipse.team.cvs.ui/src/org/eclipse/team/internal/ccvs/ui/operations/CVSWorkspaceModifyOperation.java;2;0;6;1;0;0;0;6;44;1;6;276;123;123;1;0;0;6;6;276;0;1840;6;2;
/org.eclipse.ui.externaltools/Ant Editor/org/eclipse/ui/externaltools/internal/ant/dtd/schema/Model.java;1;0;1;1;0;0;0;1;0;0;1;282;0;0;1;0;0;1;1;282;0;282;1;1;
/org.eclipse.team.ui/src/org/eclipse/team/internal/ui/synchronize/actions/ComparePageDropDownAction.java;2;1;2;1;2;2;2;0;28;0;0;5520;28;28;1;0;0;0;2;5520;0;5596;2;2;
/org.eclipse.swt/Eclipse SWT PI/motif/org/eclipse/swt/internal/motif/XInputEvent.java;1;0;2;1;0;0;0;2;2;1;2;825;2;2;1;0;0;2;2;825;0;868;2;1;
/org.eclipse.ui.views/src/org/eclipse/ui/views/markers/internal/MarkerLabelProvider.java;2;0;2;1;0;0;0;2;0;1;2;755;0;0;1;0;0;2;2;755;0;2738;2;2;
/org.eclipse.ui.cheatsheets/src/org/eclipse/ui/internal/cheatsheets/views/Page.java;2;1;9;2;4;4;4;5;81;3;3;4701;115;115;3;2;0;5;9;4701;2;5944;7;2;
/org.eclipse.ui.ide/src/org/eclipse/ui/wizards/datatransfer/IImportStructureProvider.java;1;0;1;1;0;0;0;1;0;0;1;1511;0;0;1;0;0;1;1;1511;0;1511;1;1;
/org.eclipse.update.core/src/org/eclipse/update/core/model/NonPluginEntry.java;1;0;1;1;0;0;0;1;0;0;1;2634;0;0;1;0;0;1;1;2634;0;2634;1;1;
/org.eclipse.jdt.core.tests.model/workspace/Formatter/test332/A_in.java;1;0;1;1;0;0;0;1;0;0;1;2640;0;0;1;0;0;1;1;2640;0;2640;1;1;
/org.eclipse.pde.ui/src_Forms/org/eclipse/pde/internal/ui/neweditor/plugin/DummyExtensionPoint.java;1;0;2;1;0;0;0;2;0;1;2;3812;0;0;1;0;0;2;2;3812;0;4223;2;1;
/org.eclipse.help.webapp/src_servlets/org/eclipse/help/internal/webapp/servlet/XMLGenerator.java;1;1;4;1;3;3;3;1;28;0;1;2732;57;57;1;0;0;1;4;2732;0;6337;4;1;
/org.eclipse.jdt.text.tests/src/org/eclipse/jdt/ui/tests/comments/SingleLineTestCase.java;1;1;3;1;2;2;2;1;1;0;1;5082;1;1;1;0;0;1;3;5082;0;5130;3;1;
/org.eclipse.swt/Eclipse SWT PI/photon/org/eclipse/swt/internal/photon/PtWebDataReqCallback_t.java;1;0;1;1;0;0;0;1;0;0;1;2986;0;0;1;0;0;1;1;2986;0;2986;1;1;
/org.eclipse.jdt.ui/ui/org/eclipse/jdt/ui/text/spelling/engine/ISpellEventListener.java;1;0;2;1;0;0;0;2;0;1;2;3829;0;0;1;0;0;2;2;3829;0;3930;2;1;
/org.eclipse.jdt.core.tests.model/workspace/Converter/src/javadoc/testBug51600/Test.java;1;0;1;1;1;1;1;0;0;0;0;5608;0;0;1;0;0;0;1;5608;0;5608;1;1;
/org.eclipse.core.tools/src/org/eclipse/core/tools/ByteUtil.java;1;0;1;1;1;1;1;0;0;0;0;6302;0;0;1;0;0;0;1;6302;0;6302;1;1;
/org.eclipse.team.ui/src/org/eclipse/team/ui/synchronize/viewers/SynchronizeModelElementSorter.java;1;0;3;1;0;0;0;3;47;2;2;4213;47;47;2;1;0;3;3;4213;1;4588;2;1;
/org.eclipse.jdt.ui/ui/org/eclipse/jdt/internal/ui/typehierarchy/FocusOnSelectionAction.java;3;0;3;1;1;1;1;2;10;1;2;762;14;14;1;0;0;2;3;762;0;6340;3;3;
/org.eclipse.core.tools/src/org/eclipse/core/tools/runtime/ActivePluginsViewLabelProvider.java;1;0;1;1;1;1;1;0;0;0;0;6302;0;0;1;0;0;0;1;6302;0;6302;1;1;
/org.eclipse.pde.ui/src/org/eclipse/pde/ui/IPluginContentWizard.java;2;2;6;1;5;4;5;1;130;0;1;3986;313;313;2;0;1;1;6;5204;1;6336;5;2;
/org.eclipse.jdt.ui.tests.refactoring/resources/ExtractMethodWorkSpace/ExtractMethodTests/return_out/A_test709.java;1;0;2;1;0;0;0;2;6;1;2;130;7;7;1;0;0;2;2;130;0;844;2;1;
/org.eclipse.pde.ui/src/org/eclipse/pde/internal/ui/wizards/feature/PatchSpecPage.java;2;2;11;1;11;9;11;0;94;0;0;5563;183;183;2;0;2;0;11;6108;2;6336;9;2;
/org.eclipse.jdt.core/codeassist/org/eclipse/jdt/internal/codeassist/complete/CompletionOnMemberAccess.java;2;0;3;1;0;0;0;3;14;1;3;13;22;22;1;0;0;3;3;13;0;3560;3;2;
/org.eclipse.swt/Eclipse SWT Drag and Drop/gtk/org/eclipse/swt/dnd/TableDragUnderEffect.java;3;0;4;1;1;1;1;3;55;1;3;728;82;82;1;0;0;3;4;728;0;6352;4;3;
/org.eclipse.ui.ide/src/org/eclipse/ui/actions/OpenSystemEditorAction.java;2;0;6;1;0;0;0;6;21;1;6;1511;54;54;1;0;0;6;6;1511;0;2263;6;2;
/org.eclipse.swt/Eclipse SWT PI/gtk/org/eclipse/swt/internal/Platform.java;1;0;1;1;0;0;0;1;0;0;1;1969;0;0;1;0;0;1;1;1969;0;1969;1;1;
/org.eclipse.jdt.core/compiler/org/eclipse/jdt/internal/compiler/ast/JavadocQualifiedTypeReference.java;3;0;7;1;0;0;0;7;46;1;7;2887;73;73;1;0;0;7;7;2887;0;3994;7;3;
/org.eclipse.jdt.ui/ui/org/eclipse/jdt/internal/ui/actions/GenerateJavadocAction.java;2;1;4;1;2;2;2;2;79;1;2;780;172;172;1;0;0;2;4;780;0;6340;4;2;
/org.eclipse.ant.ui/Ant Editor/org/eclipse/ant/ui/internal/dtd/IModel.java;1;0;2;1;0;0;0;2;0;1;2;250;0;0;1;0;0;2;2;250;0;1811;2;1;
/org.eclipse.jdt.core.tests.compiler/src/org/eclipse/jdt/core/tests/compiler/regression/JavadocTestForConstructor.java;1;0;6;1;0;0;0;6;51;1;6;2887;96;96;1;0;0;6;6;2887;0;4561;6;1;
/org.eclipse.text/src/org/eclipse/text/edits/TextEditCopier.java;2;0;2;1;1;1;1;1;2;0;1;1986;2;2;1;0;0;1;2;1986;0;6340;2;2;
/org.eclipse.ui.workbench/Eclipse UI/org/eclipse/ui/internal/testing/WorkbenchTestable.java;2;1;5;1;3;3;3;2;90;1;2;2231;105;105;1;0;0;2;5;2231;0;6338;5;2;
/org.eclipse.pde.ui/src/org/eclipse/pde/internal/ui/editor/manifest/JavaAttributeDescriptor.java;1;0;1;1;1;1;1;0;0;0;0;5431;0;0;1;0;0;0;1;5431;0;5431;1;1;
/org.eclipse.ui.workbench/Eclipse UI/org/eclipse/ui/part/MultiPageEditorPart.java;4;1;7;2;2;2;2;5;161;2;4;1;270;270;2;1;0;5;7;4233;1;6338;6;4;
/org.eclipse.jdt.ui/ui/org/eclipse/jdt/internal/ui/compare/JavaNode.java;2;0;2;1;1;1;1;1;16;0;1;1289;18;18;1;0;0;1;2;1289;0;6340;2;2;
/org.eclipse.ant.tests.core/tests/org/eclipse/ant/tests/core/ProjectCreationDecorator.java;1;0;2;1;0;0;0;2;6;1;2;253;8;8;1;0;0;2;2;253;0;1302;2;1;
/org.eclipse.jdt.core.tests.model/workspace/Formatter/test296/A_in.java;1;0;1;1;0;0;0;1;0;0;1;2444;0;0;1;0;0;1;1;2444;0;2444;1;1;
/org.eclipse.ltk.core.refactoring/src/org/eclipse/ltk/core/refactoring/participants/RefactoringArguments.java;1;1;3;1;2;2;2;1;4;0;1;4913;5;5;1;0;0;1;3;4913;0;5184;3;1;
/org.eclipse.jdt.ui/core refactoring/org/eclipse/jdt/internal/corext/refactoring/participants/LaunchConfigUpdater.java;1;0;3;1;0;0;0;3;13;1;3;591;13;13;1;0;0;3;3;591;0;882;3;1;
/org.eclipse.core.runtime/src/org/eclipse/core/internal/runtime/SafeFileInputStream.java;2;1;5;1;2;2;2;3;89;1;3;3013;186;186;1;0;0;3;5;3013;0;6340;5;2;
/org.eclipse.jdt.core.tests.model/src/org/eclipse/jdt/core/tests/rewrite/modifying/ASTRewritingModifyingMoveTest.java;2;0;2;1;1;1;1;1;7;0;1;4711;7;7;1;0;0;1;2;4711;0;5853;2;2;
/org.eclipse.jdt.ui.tests/ui/org/eclipse/jdt/ui/tests/packageview/ContentProviderTests1.java;2;1;4;1;2;2;2;2;9;1;2;1647;23;23;1;0;0;2;4;1647;0;6340;4;2;
/org.eclipse.releng.basebuilder/plugins/org.eclipse.build.tools/src/org/eclipse/releng/SiteCleaner.java;1;0;1;1;0;0;0;1;0;0;1;993;0;0;1;0;0;1;1;993;0;993;1;1;
/org.eclipse.team.ui/src/org/eclipse/team/internal/ui/UIConstants.java;1;0;2;1;0;0;0;2;1;1;2;848;1;1;1;0;0;2;2;848;0;917;2;1;
/org.eclipse.jface.text/src/org/eclipse/jface/text/ITextOperationTargetExtension.java;2;1;2;1;2;2;2;0;6;0;0;6340;8;8;1;0;0;0;2;6340;0;6359;2;2;
/org.eclipse.jdt.ui/ui/org/eclipse/jdt/internal/ui/typehierarchy/HierarchyLabelProvider.java;4;0;12;2;1;1;1;11;78;3;9;435;182;182;3;2;0;11;12;505;2;6340;10;4;
/org.eclipse.ui.workbench.texteditor/src/org/eclipse/ui/texteditor/link/EditorTarget.java;2;1;5;1;3;3;3;2;15;1;2;4214;37;37;1;0;0;2;5;4214;0;5177;5;2;
/org.eclipse.osgi/defaultAdaptor/src/org/eclipse/osgi/framework/internal/defaultadaptor/DefaultLog.java;3;2;14;2;4;3;4;10;343;4;6;3879;681;681;4;4;1;10;14;3879;5;5490;9;3;
/org.eclipse.jface/src/org/eclipse/jface/viewers/AbstractListViewer.java;2;0;2;1;1;1;1;1;2;0;1;5004;2;2;1;0;0;1;2;5004;0;6340;2;2;
/org.eclipse.pde.core/src/org/eclipse/pde/internal/core/plugin/IdentifiablePluginObject.java;1;0;2;1;1;1;1;1;4;0;1;4203;8;8;1;0;0;1;2;4203;0;6336;2;1;
/org.eclipse.team.ui/src/org/eclipse/team/internal/ui/target/TargetAction.java;2;0;3;1;0;0;0;3;3;1;3;990;4;4;1;0;0;3;3;990;0;2495;3;2;
/org.eclipse.core.tests.runtime/src/org/eclipse/core/tests/runtime/TestRegistryChangeListener.java;1;0;1;1;1;1;1;0;0;0;0;6201;0;0;1;0;0;0;1;6201;0;6201;1;1;
/org.eclipse.jdt.core/model/org/eclipse/jdt/core/jdom/IDOMPackage.java;2;0;3;1;1;1;1;2;5;1;2;3560;10;10;1;0;0;2;3;3560;0;5584;3;2;
/org.eclipse.jdt.debug.tests/tests/org/eclipse/jdt/debug/tests/eval/CharAssignmentOperatorsTests.java;1;0;1;1;0;0;0;1;130;0;1;1274;130;130;1;0;0;1;1;1274;0;1274;1;1;
/org.eclipse.search/search/org/eclipse/search/internal/ui/SearchResultView.java;2;0;5;1;1;1;1;4;9;1;4;1101;25;25;1;0;0;4;5;1101;0;5885;5;2;
/org.eclipse.core.tests.resources/src/org/eclipse/core/tests/resources/LinkedResourceWithPathVariableTest.java;2;1;3;1;3;3;3;0;63;0;0;5147;66;66;1;0;0;0;3;5147;0;5657;3;2;
/org.eclipse.core.tools.resources/src/org/eclipse/core/tools/resources/DeltaView.java;1;0;1;1;1;1;1;0;0;0;0;6302;0;0;1;0;0;0;1;6302;0;6302;1;1;
/org.eclipse.swt/Eclipse SWT PI/gtk/org/eclipse/swt/internal/gtk/GtkStyle.java;2;0;3;1;0;0;0;3;17;1;3;889;19;19;1;0;0;3;3;889;0;2285;3;2;
/org.eclipse.swt.examples/src/org/eclipse/swt/examples/controlexample/TextTab.java;3;0;4;1;0;0;0;4;84;1;4;724;113;113;1;0;0;4;4;724;0;2728;4;3;
/org.eclipse.team.tests.cvs.core/src/org/eclipse/team/tests/ccvs/ui/MenuEnablementTest.java;1;0;3;1;1;1;1;2;40;1;2;2632;42;42;1;0;0;2;3;2632;0;6337;3;1;
/org.eclipse.debug.ui/ui/org/eclipse/debug/ui/actions/IPopupInformationControlAdapter.java;2;0;4;1;1;1;1;3;13;1;3;3828;24;24;1;0;0;3;4;3828;0;5133;4;2;
/org.eclipse.ui.workbench/Eclipse UI/org/eclipse/ui/internal/roles/ObjectContributionRecord.java;2;0;6;1;0;0;0;6;55;2;4;2023;87;87;2;2;0;6;6;2079;2;2443;4;2;
/org.eclipse.jface.text/src/org/eclipse/jface/text/CursorLinePainter.java;2;1;6;1;5;5;5;1;18;0;1;4689;54;54;1;0;0;1;6;4689;0;6359;6;2;
/org.eclipse.team.ui/src/org/eclipse/team/ui/sync/actions/ExpandAllAction.java;1;0;1;1;0;0;0;1;0;0;1;2446;0;0;1;0;0;1;1;2446;0;2446;1;1;
/org.eclipse.ui.ide/src/org/eclipse/ui/internal/registry/Capability.java;2;0;6;2;0;0;0;6;9;2;5;1526;21;21;2;1;0;6;6;1739;1;2263;5;2;
/org.eclipse.ui.tests/Eclipse UI Tests/org/eclipse/ui/tests/activities/DynamicModelActivityRegistry.java;4;1;4;1;2;2;2;2;44;1;2;4853;74;74;1;0;0;2;4;4853;0;6338;4;4;
/org.eclipse.core.runtime/src/org/eclipse/core/internal/registry/BundleModel.java;5;2;21;2;10;9;10;11;674;2;10;3049;1051;1051;2;1;1;11;21;3164;2;5531;19;5;
/org.eclipse.jdt.core.tests.model/workspace/Converter/test0328/Test.java;1;0;1;1;0;0;0;1;0;0;1;3714;0;0;1;0;0;1;1;3714;0;3714;1;1;
/org.eclipse.ui.workbench/Eclipse UI/org/eclipse/ui/internal/csm/commands/api/ICommandEvent.java;1;0;4;1;0;0;0;4;14;2;3;2515;24;24;2;1;0;4;4;2556;1;2556;3;1;
/org.eclipse.ui.ide/src/org/eclipse/ui/internal/dialogs/RemoveCapabilityWizard.java;2;0;4;1;0;0;0;4;8;1;4;1526;10;10;1;0;0;4;4;1526;0;2263;4;2;
/org.eclipse.ui.workbench/Eclipse UI/org/eclipse/ui/internal/CompatibleWorkbenchPage.java;1;0;2;1;0;0;0;2;2;0;1;3335;2;2;2;1;0;2;2;3335;1;3335;1;1;
/org.eclipse.jdt.core.tests.model/workspace/Converter/src/javadoc/testBug51241/X.java;1;0;1;1;0;0;0;1;0;0;1;3910;0;0;1;0;0;1;1;3910;0;3910;1;1;
/org.eclipse.ltk.core.refactoring/src/org/eclipse/ltk/core/refactoring/UndoManagerAdapter.java;1;2;5;1;3;2;3;2;20;1;2;4845;28;28;2;0;1;2;5;6338;1;6338;4;1;
/org.eclipse.debug.ui/ui/org/eclipse/debug/internal/ui/sourcelookup/browsers/ArchiveSourceContainerBrowser.java;2;0;5;1;1;1;1;4;10;2;3;4915;20;20;2;1;0;4;5;4949;1;6336;4;2;
/org.eclipse.ui.editors/src/org/eclipse/ui/internal/editors/quickdiff/DiffInitializer.java;2;0;3;1;0;0;0;3;10;1;3;1214;10;10;1;0;0;3;3;1214;0;1644;3;2;
/org.eclipse.pde.core/src/org/eclipse/pde/internal/core/schema/SchemaRegistry.java;3;1;9;1;4;4;4;5;12;1;5;2184;48;48;1;0;0;5;9;2184;0;6336;9;3;
/org.eclipse.ui.intro/src/org/eclipse/ui/intro/internal/model/IntroText.java;1;0;5;1;1;1;1;4;42;1;4;4429;66;66;1;0;0;4;5;4429;0;5115;5;1;
/org.eclipse.swt/Eclipse SWT/gtk/org/eclipse/swt/widgets/TabItem.java;7;1;8;1;2;2;2;6;28;1;6;269;55;55;1;0;0;6;8;269;0;6352;8;7;
/org.eclipse.jdt.debug.ui/ui/org/eclipse/jdt/internal/debug/ui/actions/AddWatchExpressionAction.java;2;0;3;1;0;0;0;3;4;1;3;1175;6;6;1;0;0;3;3;1175;0;1516;3;2;
/org.eclipse.jdt.ui.tests.refactoring/resources/UseSupertypeWherePossible/test63/out/A.java;1;0;1;1;0;0;0;1;2;0;1;1272;2;2;1;0;0;1;1;1272;0;1272;1;1;
/org.eclipse.jdt.core/search/org/eclipse/jdt/core/search/ITypeNameRequestor.java;1;0;1;1;0;0;0;1;2;0;1;3560;2;2;1;0;0;1;1;3560;0;3560;1;1;
/org.eclipse.ui.workbench/Eclipse UI/org/eclipse/ui/activities/IMutableActivityService.java;1;0;2;1;0;0;0;2;0;1;2;2800;0;0;1;0;0;2;2;2800;0;2896;2;1;
/org.eclipse.ui.ide/src/org/eclipse/ui/views/navigator/CopyAction.java;1;0;3;1;0;0;0;3;4;1;3;2208;7;7;1;0;0;3;3;2208;0;2611;3;1;
/org.eclipse.swt.tests/JUnit Tests/org/eclipse/swt/tests/junit/Test_org_eclipse_swt_events_VerifyEvent.java;1;0;2;1;1;1;1;1;7;0;1;3444;11;11;1;0;0;1;2;3444;0;6352;2;1;
/org.eclipse.jdt.ui.tests.refactoring/resources/ExtractMethodWorkSpace/ExtractMethodTests/branch_out/A_test753.java;1;0;4;1;0;0;0;4;6;1;4;844;6;6;1;0;0;4;4;844;0;2256;4;1;
/org.eclipse.pde.runtime/src/org/eclipse/pde/internal/runtime/logview/StackSection.java;2;0;4;2;0;0;0;4;9;2;3;993;17;17;2;1;0;4;4;993;1;3754;3;2;
/org.eclipse.pde.ui/src/org/eclipse/pde/internal/ui/parts/TablePart.java;1;1;2;1;2;2;2;0;10;0;0;5431;14;14;1;0;0;0;2;5431;0;6336;2;1;
/org.eclipse.jdt.debug.tests/tests/org/eclipse/jdt/debug/tests/core/LaunchesTests.java;2;0;2;1;1;1;1;1;4;0;1;4194;4;4;1;0;0;1;2;4194;0;6337;2;2;
/org.eclipse.swt/Eclipse SWT Browser/common/org/eclipse/swt/browser/OpenWindowListener.java;2;0;5;1;1;1;1;4;24;1;4;3007;43;43;1;0;0;4;5;3007;0;6352;5;2;
/org.eclipse.core.variables/src/org/eclipse/core/variables/IValueVariable.java;3;0;4;1;1;1;1;3;29;1;3;2514;60;60;1;0;0;3;4;2514;0;6336;4;3;
/org.eclipse.jdt.core/model/org/eclipse/jdt/core/util/IExceptionTableEntry.java;1;0;1;1;0;0;0;1;2;0;1;3560;2;2;1;0;0;1;1;3560;0;3560;1;1;
/org.eclipse.jdt.ui/ui/org/eclipse/jdt/internal/ui/preferences/formatter/CommentsTabPage.java;2;0;10;1;0;0;0;10;147;2;9;3103;408;408;2;1;0;10;10;3103;1;4823;9;2;
/org.eclipse.jdt.debug.ui/ui/org/eclipse/jdt/internal/debug/ui/snippeteditor/ScrapbookMain.java;1;0;1;1;0;0;0;1;0;0;1;724;0;0;1;0;0;1;1;724;0;724;1;1;
/org.eclipse.jdt.core.tests.compiler/src/org/eclipse/jdt/core/tests/compiler/regression/NumericTest.java;2;0;2;1;0;0;0;2;2;1;2;1785;2;2;1;0;0;2;2;1785;0;2389;2;2;
/org.eclipse.ui.forms/src/org/eclipse/ui/internal/forms/widgets/BreakSegment.java;1;0;2;1;1;1;1;1;6;0;1;5044;6;6;1;0;0;1;2;5044;0;6336;2;1;
/org.eclipse.osgi/osgi/src/org/osgi/service/packageadmin/NamedClassSpace.java;3;2;6;1;4;3;4;2;28;1;2;4311;41;41;2;0;1;2;6;5207;1;5536;5;3;
/org.eclipse.ui.workbench/Eclipse UI/org/eclipse/ui/internal/ICompatibleWorkbenchPage.java;1;0;1;1;0;0;0;1;0;0;1;3335;0;0;1;0;0;1;1;3335;0;3335;1;1;
/org.eclipse.jdt.ui/ui/org/eclipse/jdt/internal/ui/util/RowLayouter.java;1;0;1;1;1;1;1;0;2;0;0;6340;2;2;1;0;0;0;1;6340;0;6340;1;1;
/org.eclipse.webdav/src/interface/org/eclipse/webdav/dom/QualifiedName.java;1;0;1;1;1;1;1;0;41;0;0;5151;41;41;1;0;0;0;1;5151;0;5151;1;1;
/org.eclipse.swt/Eclipse SWT PI/photon/org/eclipse/swt/internal/photon/PtWebClientData_t.java;1;0;1;1;0;0;0;1;0;0;1;2986;0;0;1;0;0;1;1;2986;0;2986;1;1;
/org.eclipse.ui.examples.javaeditor/Eclipse Java Editor Example/org/eclipse/ui/examples/javaeditor/JavaEditorMessages.java;1;0;1;1;1;1;1;0;2;0;0;6340;2;2;1;0;0;0;1;6340;0;6340;1;1;
/org.eclipse.jdt.core.tests.model/workspace/Converter/test0221/Test.java;1;0;1;1;0;0;0;1;0;0;1;3714;0;0;1;0;0;1;1;3714;0;3714;1;1;
/org.eclipse.jdt.ui.tests.refactoring/resources/InlineMethodWorkspace/TestCases/call_out/TestExpressionStatementWithReturn.java;1;0;1;1;0;0;0;1;2;0;1;845;2;2;1;0;0;1;1;845;0;845;1;1;
/org.eclipse.core.tools.resources/src/org/eclipse/core/tools/metadata/MarkersSnapshotDumpingStrategy_2.java;1;0;1;1;1;1;1;0;0;0;0;6302;0;0;1;0;0;0;1;6302;0;6302;1;1;
/org.eclipse.ui.workbench/Eclipse UI/org/eclipse/ui/internal/layout/TrimLayout.java;1;1;3;1;2;2;2;1;154;0;1;5000;210;210;1;0;0;1;3;5000;0;5452;3;1;
/org.eclipse.pde.build/src/org/eclipse/pde/internal/build/FetchScriptGenerator.java;2;2;13;1;5;4;5;8;742;1;8;447;3914;3914;2;0;1;8;13;5530;1;5897;12;2;
/org.eclipse.pde.ui/src/org/eclipse/pde/internal/ui/editor/manifest/SynchronizedSystemFileDocumentProvider.java;1;0;2;1;1;1;1;1;0;0;1;2320;0;0;1;0;0;1;2;2320;0;5431;2;1;
/org.eclipse.swt/Eclipse SWT/photon/org/eclipse/swt/widgets/TabFolder.java;4;1;8;1;2;2;2;6;10;1;6;269;38;38;1;0;0;6;8;269;0;6352;8;4;
/org.eclipse.pde.core/src/org/eclipse/pde/internal/core/build/ExternalBuildModel.java;2;1;4;1;2;2;2;2;6;1;2;368;13;13;1;0;0;2;4;368;0;6336;4;2;
/org.eclipse.jdt.core.tests.model/workspace/Formatter/test354/A_out.java;2;0;3;1;0;0;0;3;6;1;3;3033;11;11;1;0;0;3;3;3033;0;3362;3;2;
/org.eclipse.update.ui.forms/src/org/eclipse/update/ui/forms/internal/richtext/TextSegment.java;1;0;2;1;0;0;0;2;0;1;2;2849;0;0;1;0;0;2;2;2849;0;2898;2;1;
/org.eclipse.jdt.core/compiler/org/eclipse/jdt/internal/compiler/ast/Wildcard.java;1;0;1;1;0;0;0;1;0;0;1;2728;0;0;1;0;0;1;1;2728;0;2728;1;1;
/org.eclipse.ui.cheatsheets/src/org/eclipse/ui/internal/cheatsheets/data/Item.java;1;1;5;1;4;4;4;1;165;0;1;4662;243;243;1;0;0;1;5;4662;0;5694;5;1;
/org.eclipse.team.core/src/org/eclipse/team/internal/core/TeamHookDispatcher.java;2;1;3;1;3;3;3;0;33;0;0;5112;47;47;1;0;0;0;3;5112;0;6336;3;2;
/org.eclipse.jdt.core.tests.model/workspace/Formatter/test385/A_out.java;1;0;1;1;0;0;0;1;0;0;1;3164;0;0;1;0;0;1;1;3164;0;3164;1;1;
/org.eclipse.update.core/src/org/eclipse/update/configuration/IVolume.java;1;0;1;1;0;0;0;1;4;0;1;890;4;4;1;0;0;1;1;890;0;890;1;1;
/org.eclipse.ui.workbench/Eclipse UI/org/eclipse/ui/internal/chris/roles/RoleActivationService.java;1;0;4;1;0;0;0;4;12;3;2;1952;12;12;3;2;0;4;4;2202;2;2202;2;1;
/org.eclipse.update.ui.forms/src/org/eclipse/ui/forms/internal/parts/Paragraph.java;1;0;3;1;0;0;0;3;6;1;3;2898;6;6;1;0;0;3;3;2898;0;3096;3;1;
/org.eclipse.jdt.ui/ui/org/eclipse/jdt/ui/actions/CCPActionGroup.java;4;1;6;1;2;2;2;4;19;1;4;1112;55;55;1;0;0;4;6;1112;0;6340;6;4;
/org.eclipse.swt/Eclipse SWT Browser/mozilla/org/eclipse/swt/internal/mozilla/XPCOMObject.java;2;0;3;1;1;1;1;2;6;1;2;1654;10;10;1;0;0;2;3;1654;0;6352;3;2;
/org.eclipse.core.runtime.osgi/src/org/eclipse/core/internal/runtime/URLTool.java;1;0;2;1;0;0;0;2;891;1;2;3013;891;891;1;0;0;2;2;3013;0;3030;2;1;
/org.eclipse.jdt.ui.tests.refactoring/resources/MoveInnerToTopLevel/test25/in/A.java;1;0;1;1;0;0;0;1;0;0;1;1131;0;0;1;0;0;1;1;1131;0;1131;1;1;
/org.eclipse.ltk.core.refactoring/src/org/eclipse/ltk/core/refactoring/IValidationStateListener.java;1;0;2;1;0;0;0;2;0;1;2;4845;0;0;1;0;0;2;2;4845;0;4864;2;1;
/org.eclipse.update.configurator/src/org/eclipse/update/internal/configurator/branding/AboutInfo.java;1;0;4;1;1;1;1;3;4;1;3;4502;8;8;1;0;0;3;4;4502;0;5388;4;1;
/org.eclipse.core.resources/src/org/eclipse/core/resources/IFileModificationValidator.java;2;0;4;1;1;1;1;3;75;1;3;2426;89;89;1;0;0;3;4;2426;0;5146;4;2;
/org.eclipse.swt/Eclipse SWT PI/carbon/org/eclipse/swt/internal/carbon/AEDesc.java;1;2;3;1;3;2;3;0;16;0;0;5534;20;20;2;0;1;0;3;5534;1;5614;2;1;
/org.eclipse.team.ui/src/org/eclipse/team/internal/ui/target/SiteExplorerViewLabelProvider.java;1;0;1;1;0;0;0;1;0;0;1;2495;0;0;1;0;0;1;1;2495;0;2495;1;1;
/org.eclipse.pde.ui/src_Forms/org/eclipse/pde/internal/ui/neweditor/plugin/BundleInputContext.java;2;0;8;1;2;1;2;6;42;1;6;3777;105;105;2;0;1;6;8;5425;1;5425;7;2;
/org.eclipse.update.ui/src/org/eclipse/update/internal/ui/wizards/BannerPage.java;2;1;5;1;2;2;2;3;12;1;3;635;32;32;1;0;0;3;5;635;0;6336;5;2;
/org.eclipse.jface/src/org/eclipse/jface/viewers/AbstractTreeViewer.java;3;2;21;2;8;7;8;13;2720;2;11;789;4113;4113;2;2;1;13;21;972;3;6199;18;3;
/org.eclipse.team.ui/src/org/eclipse/team/ui/synchronize/SynchronizeInput.java;1;0;1;1;1;1;1;0;0;0;0;5134;0;0;1;0;0;0;1;5134;0;5134;1;1;
/org.eclipse.ui.tests/Eclipse UI Tests/org/eclipse/ui/tests/intro/IntroPartTest.java;1;1;5;1;3;3;3;2;33;1;2;4649;55;55;1;0;0;2;5;4649;0;6319;5;1;
/org.eclipse.jdt.core.tests.model/workspace/Formatter/test446/A_in.java;1;0;1;1;0;0;0;1;0;0;1;3611;0;0;1;0;0;1;1;3611;0;3611;1;1;
/org.eclipse.swt/Eclipse SWT PI/win32/org/eclipse/swt/internal/win32/SHELLEXECUTEINFO.java;1;0;1;1;0;0;0;1;3;0;1;2915;3;3;1;0;0;1;1;2915;0;2915;1;1;
/org.eclipse.jface.text/src/org/eclipse/jface/text/IDocumentAdapter.java;2;1;2;1;2;2;2;0;28;0;0;6340;30;30;1;0;0;0;2;6340;0;6359;2;2;
/org.eclipse.ui.workbench/Eclipse UI/org/eclipse/ui/internal/csm/activities/ActivityMessages.java;1;0;2;1;0;0;0;2;0;0;1;2443;0;0;2;1;0;2;2;2443;1;2443;1;1;
/org.eclipse.help.base/src/org/eclipse/help/internal/base/DisplayUtils.java;1;1;3;1;3;3;3;0;6;0;0;5788;8;8;1;0;0;0;3;5788;0;6337;3;1;
/org.eclipse.pde.core/src/org/eclipse/pde/core/IEditableModel.java;2;1;5;1;4;4;4;1;29;0;1;2501;39;39;1;0;0;1;5;2501;0;6336;5;2;
/org.eclipse.jdt.ui.tests.refactoring/resources/ExtractInterface/test97/out/A.java;1;0;1;1;0;0;0;1;0;0;1;1315;0;0;1;0;0;1;1;1315;0;1315;1;1;
/org.eclipse.jdt.debug.ui/ui/org/eclipse/jdt/internal/debug/ui/actions/AbstractBreakpointRulerAction.java;2;0;2;1;1;1;1;1;4;0;1;4557;5;5;1;0;0;1;2;4557;0;6336;2;2;
/org.eclipse.pde.ui/src_OSGi/org/eclipse/pde/internal/ui/osgi/OSGiLabelProvider.java;2;0;5;1;0;0;0;5;59;1;5;2244;70;70;1;0;0;5;5;2244;0;4203;5;2;
/org.eclipse.jdt.ui/core refactoring/org/eclipse/jdt/internal/corext/refactoring/participants/xml/Property.java;1;0;2;1;0;0;0;2;0;1;2;4091;0;0;1;0;0;2;2;4091;0;4108;2;1;
/org.eclipse.core.runtime.osgi/src/org/eclipse/core/runtime/jobs/ISchedulingRule.java;1;0;1;1;0;0;0;1;0;0;1;3013;0;0;1;0;0;1;1;3013;0;3013;1;1;
/org.eclipse.help/src/org/eclipse/help/internal/search/ProgressDistributor.java;1;0;1;1;0;0;0;1;0;0;1;2732;0;0;1;0;0;1;1;2732;0;2732;1;1;
/org.eclipse.jface.text/src/org/eclipse/jface/text/source/IAnnotationHoverExtension.java;2;1;8;1;5;5;5;3;40;1;3;719;95;95;1;0;0;3;8;719;0;6361;8;2;
/org.eclipse.jdt.core.tests.model/workspace/Formatter/test129/A_in.java;1;0;1;1;0;0;0;1;0;0;1;2425;0;0;1;0;0;1;1;2425;0;2425;1;1;
/org.eclipse.core.runtime.osgi/src/org/eclipse/core/internal/jobs/InternalJob.java;1;0;2;1;0;0;0;2;15;1;2;3013;15;15;1;0;0;2;2;3013;0;3028;2;1;
/org.eclipse.debug.ui/ui/org/eclipse/debug/internal/ui/actions/ViewManagementAction.java;2;1;2;1;2;2;2;0;30;0;0;5515;30;30;1;0;0;0;2;5515;0;5529;2;2;
/org.eclipse.ui.workbench/Eclipse UI/org/eclipse/ui/internal/commands/api/older/IContextBinding.java;1;0;2;1;0;0;0;2;0;0;1;2562;0;0;2;1;0;2;2;2562;1;2562;1;1;
/org.eclipse.team.core/src/org/eclipse/team/core/sync/ContentComparisonCriteria.java;1;0;1;1;0;0;0;1;0;0;1;431;0;0;1;0;0;1;1;431;0;431;1;1;
/org.eclipse.debug.ui/ui/org/eclipse/debug/internal/ui/IDebugHelpContextIds.java;4;0;16;1;1;1;1;15;17;1;15;205;46;46;1;0;0;15;16;205;0;5366;16;4;
/org.eclipse.ant.ui/Ant Editor/org/eclipse/ant/internal/ui/dtd/schema/AntDTDSchemaMessages.java;1;0;1;1;0;0;0;1;0;0;1;1811;0;0;1;0;0;1;1;1811;0;1811;1;1;
/org.eclipse.ant.ui/Ant Editor/org/eclipse/ant/internal/ui/editor/outline/XMLCore.java;1;0;3;1;1;1;1;2;4;1;2;1811;7;7;1;0;0;2;3;1811;0;6336;3;1;
/org.eclipse.jdt.ui.tests.refactoring/test cases/org/eclipse/jdt/ui/tests/refactoring/MultiMoveTests.java;1;0;5;1;0;0;0;5;333;1;5;130;348;348;1;0;0;5;5;130;0;1111;5;1;
/org.eclipse.team.ui/src/org/eclipse/team/internal/ui/TeamUIPlugin.java;2;1;47;2;10;10;10;37;185;2;35;790;1118;1118;2;2;0;37;47;1171;2;6337;45;2;
/org.eclipse.jdt.ui.tests.refactoring/resources/Delete/testDeleteWithinCu18/out/A.java;1;0;1;1;0;0;0;1;0;0;1;442;0;0;1;0;0;1;1;442;0;442;1;1;
/org.eclipse.team.cvs.ui/src/org/eclipse/team/internal/ccvs/ui/operations/FetchMembersOperation.java;2;1;11;1;3;3;3;8;23;2;7;1891;73;73;2;1;0;8;11;1891;1;6337;10;2;
/org.eclipse.update.core/src/org/eclipse/update/search/UpdateSearchRequest.java;3;1;15;1;5;5;5;10;31;2;9;825;102;102;2;1;0;10;15;963;1;6336;14;3;
/org.eclipse.jdt.ui.tests.refactoring/resources/MoveInnerToTopLevel/test11/out/Inner.java;1;0;1;1;0;0;0;1;2;0;1;305;2;2;1;0;0;1;1;305;0;305;1;1;
/org.eclipse.jdt.core.tests.model/workspace/Converter/src/test0254/Test.java;1;0;1;1;0;0;0;1;0;0;1;3714;0;0;1;0;0;1;1;3714;0;3714;1;1;
/org.eclipse.jdt.launching.macosx/macosx/org/eclipse/jdt/internal/ui/macbundler/MacBundleWizard.java;1;0;1;1;0;0;0;1;0;0;1;3622;0;0;1;0;0;1;1;3622;0;3622;1;1;
/org.eclipse.jdt.core/model/org/eclipse/jdt/internal/core/util/PublicScanner.java;5;1;42;1;6;6;6;36;1283;4;31;13;2587;2587;4;5;0;36;42;2118;5;6162;37;5;
/org.eclipse.pde.build/src/org/eclipse/pde/internal/build/Utils.java;2;1;16;1;4;4;4;12;685;2;11;447;4006;4006;2;1;0;12;16;2083;1;6252;15;2;
/org.eclipse.jdt.core.tests.model/src/org/eclipse/jdt/core/tests/rewrite/describing/ASTRewritingTest.java;4;1;6;2;3;3;3;3;32;2;2;4711;48;48;2;1;0;3;6;4711;1;6336;5;4;
/org.eclipse.debug.core/core/org/eclipse/debug/core/ILaunchListener2.java;3;0;3;1;0;0;0;3;2;1;3;4194;2;2;1;0;0;3;3;4194;0;4627;3;3;
/org.eclipse.swt/Eclipse SWT/motif/org/eclipse/swt/widgets/ToolItem.java;5;0;15;2;1;1;1;14;18;2;12;83;103;103;2;2;0;14;15;281;2;6352;13;5;
/org.eclipse.help.webapp/src_servlets/org/eclipse/help/internal/webapp/servlet/CookieUtil.java;1;2;7;1;4;3;4;3;209;2;2;399;372;372;2;1;1;3;7;399;2;6337;5;1;
/org.eclipse.core.tests.resources/src/org/eclipse/core/tests/internal/resources/EarthNature.java;1;0;1;1;1;1;1;0;18;0;0;5147;18;18;1;0;0;0;1;5147;0;5147;1;1;
/org.eclipse.swt.tools/JNI Generation/org/eclipse/swt/tools/internal/CleanupConstants.java;3;0;3;1;0;0;0;3;7;1;3;4175;8;8;1;0;0;3;3;4175;0;4563;3;3;
/org.eclipse.ui.ide/src/org/eclipse/ui/internal/dialogs/ZipFileResourceExporter.java;2;0;2;1;0;0;0;2;0;1;2;1526;0;0;1;0;0;2;2;1526;0;2263;2;2;
/org.eclipse.pde.core/src_OSGi/org/eclipse/pde/internal/core/bundle/WorkspaceBundleModel.java;1;0;2;1;0;0;0;2;0;1;2;2193;0;0;1;0;0;2;2;2193;0;2229;2;1;
/org.eclipse.ui.externaltools/Ant Tools Support/org/eclipse/ui/externaltools/internal/ant/preferences/AntPreferencesMessages.java;1;0;1;1;0;0;0;1;0;0;1;282;0;0;1;0;0;1;1;282;0;282;1;1;
/org.eclipse.jdt.core.tests.model/workspace/JavaSearch/src/r8/A.java;1;0;1;1;0;0;0;1;0;0;1;547;0;0;1;0;0;1;1;547;0;547;1;1;
/org.eclipse.jdt.core.tests.model/src/org/eclipse/jdt/core/tests/model/MementoTests.java;2;0;7;1;1;1;1;6;136;1;6;576;301;301;1;0;0;6;7;576;0;5185;7;2;
/org.eclipse.swt.examples/src/org/eclipse/swt/examples/controlexample/ProgressBarTab.java;1;0;1;1;0;0;0;1;2;0;1;1560;2;2;1;0;0;1;1;1560;0;1560;1;1;
/org.eclipse.jdt.ui.tests.refactoring/resources/InlineMethodWorkspace/TestCases/import_out/Provider.java;1;0;1;1;0;0;0;1;7;0;1;788;7;7;1;0;0;1;1;788;0;788;1;1;
/org.eclipse.ui.workbench/Eclipse UI/org/eclipse/ui/dialogs/FileEditorMappingLabelProvider.java;1;0;1;1;0;0;0;1;1;0;1;1;1;1;1;0;0;1;1;1;0;1;1;1;
/org.eclipse.jdt.core.tests.model/workspace/Converter/src/test0439/E.java;1;0;1;1;0;0;0;1;0;0;1;3714;0;0;1;0;0;1;1;3714;0;3714;1;1;
/org.eclipse.ant.ui/Ant Tools Support/org/eclipse/ant/internal/ui/launchConfigurations/AntWorkingDirectoryBlock.java;2;1;6;1;2;2;2;4;65;2;2;1993;150;150;2;2;0;4;6;1993;2;6247;4;2;
/org.eclipse.jdt.core/dom/org/eclipse/jdt/core/internal/dom/rewrite/SourceModifier.java;2;0;3;2;0;0;0;3;1;2;2;4711;1;1;2;1;0;3;3;4711;1;4802;2;2;
/org.eclipse.jdt.ui.tests.refactoring/resources/RenamePackage/testImportFromMultiRoots2/in/srcPrg/p/p/A.java;1;0;2;1;0;0;0;2;5;1;2;3219;5;5;1;0;0;2;2;3219;0;4105;2;1;
/org.eclipse.ant.ui/Ant Editor/org/eclipse/ant/ui/internal/editor/outline/XMLCore.java;1;0;2;1;0;0;0;2;0;1;2;250;0;0;1;0;0;2;2;250;0;1811;2;1;
/org.eclipse.ui.workbench/Eclipse UI/org/eclipse/ui/internal/presentations/EditorStackPresentation.java;1;0;1;1;0;0;0;1;0;0;1;4517;0;0;1;0;0;1;1;4517;0;4517;1;1;
/org.eclipse.core.tools/src/org/eclipse/core/tools/runtime/LoadedClassesViewLabelProvider.java;1;0;1;1;1;1;1;0;0;0;0;6302;0;0;1;0;0;0;1;6302;0;6302;1;1;
/org.eclipse.jdt.core.tests.model/workspace/Formatter/test167/A_in.java;1;0;1;1;0;0;0;1;0;0;1;2425;0;0;1;0;0;1;1;2425;0;2425;1;1;
/org.eclipse.team.ui/src/org/eclipse/team/ui/sync/actions/SyncInfoFilter.java;1;0;1;1;0;0;0;1;0;0;1;2378;0;0;1;0;0;1;1;2378;0;2378;1;1;
/org.eclipse.team.ui/src/org/eclipse/team/internal/ui/registry/SynchronizeWizardRegistry.java;2;1;3;1;3;3;3;0;51;0;0;5532;52;52;1;0;0;0;3;5532;0;5661;3;2;
/org.eclipse.jdt.core.tests.model/workspace/Formatter/test214/A_in.java;1;0;1;1;0;0;0;1;0;0;1;2426;0;0;1;0;0;1;1;2426;0;2426;1;1;
/org.eclipse.core.runtime.osgi/src/org/eclipse/core/runtime/IPath.java;1;0;2;1;0;0;0;2;810;1;2;3013;810;810;1;0;0;2;2;3013;0;3030;2;1;
/org.eclipse.jdt.ui/core refactoring/org/eclipse/jdt/internal/corext/refactoring/participants/xml/JavaMethodExtender.java;1;0;5;1;0;0;0;5;21;1;5;2546;37;37;1;0;0;5;5;2546;0;4941;5;1;
/org.eclipse.core.runtime/src/org/eclipse/core/runtime/registry/IRegistryChangeEvent.java;4;0;7;2;0;0;0;7;114;2;6;2105;264;264;2;1;0;7;7;3164;1;3164;6;4;
/org.eclipse.ui.workbench/Eclipse UI/org/eclipse/ui/commands/old/ICommand.java;1;0;2;1;0;0;0;2;0;0;1;1222;0;0;2;1;0;2;2;1222;1;1222;1;1;
/org.eclipse.ui.ide/src/org/eclipse/ui/internal/ide/registry/ProjectImageRegistry.java;1;0;1;1;0;0;0;1;0;0;1;2264;0;0;1;0;0;1;1;2264;0;2264;1;1;
/org.eclipse.jdt.core.tests.model/workspace/Converter/src/javadoc/test016/TestD2.java;1;0;2;1;0;0;0;2;0;1;2;4311;0;0;1;0;0;2;2;4311;0;4390;2;1;
/org.eclipse.jdt.core.tests.model/workspace/Converter/src/test0428/A.java;1;0;1;1;0;0;0;1;0;0;1;3714;0;0;1;0;0;1;1;3714;0;3714;1;1;
/org.eclipse.jdt.core.tests.model/workspace/Formatter/test266/A_in.java;1;0;1;1;0;0;0;1;0;0;1;2442;0;0;1;0;0;1;1;2442;0;2442;1;1;
/org.eclipse.webdav/src/kernel/org/eclipse/webdav/internal/kernel/DAVRuntimeException.java;1;0;1;1;1;1;1;0;189;0;0;5151;189;189;1;0;0;0;1;5151;0;5151;1;1;
/org.eclipse.jdt.core.tests.compiler/src/org/eclipse/jdt/core/tests/compiler/parser/SourceType.java;1;0;2;1;0;0;0;2;25;1;2;241;27;27;1;0;0;2;2;241;0;3560;2;1;
/org.eclipse.jdt.launching/launching/org/eclipse/jdt/internal/launching/JavaLocalApplicationLaunchConfigurationDelegate.java;5;1;9;1;2;2;2;7;8;1;7;1455;38;38;1;0;0;7;9;1455;0;6336;9;5;
/org.eclipse.ui.intro/src/org/eclipse/ui/intro/internal/extensions/BaseExtensionPointManager.java;1;0;8;1;0;0;0;8;510;2;7;4429;629;629;2;1;0;8;8;4612;1;4948;7;1;
/org.eclipse.update.core/src/org/eclipse/update/core/model/FeatureModel.java;2;1;6;1;5;5;5;1;10;0;1;890;41;41;1;0;0;1;6;890;0;5946;6;2;
/org.eclipse.team.core/src/org/eclipse/team/internal/core/ResourceVariantCacheEntry.java;2;0;5;1;1;1;1;4;217;1;4;4088;225;225;1;0;0;4;5;4088;0;6336;5;2;
/org.eclipse.jdt.core.tests.model/workspace/Converter/src/test0252/Test.java;1;0;1;1;0;0;0;1;0;0;1;3714;0;0;1;0;0;1;1;3714;0;3714;1;1;
/org.eclipse.jdt.core/codeassist/org/eclipse/jdt/internal/codeassist/select/SelectionOnFieldReference.java;2;0;2;1;0;0;0;2;32;1;2;991;34;34;1;0;0;2;2;991;0;3560;2;2;
/org.eclipse.core.resources/src/org/eclipse/core/internal/dtree/DeltaDataTree.java;2;0;3;1;2;1;2;1;1800;0;1;178;1837;1837;2;0;1;1;3;5146;1;5146;2;2;
/org.eclipse.jdt.core/dom/org/eclipse/jdt/core/dom/DefaultBindingResolver.java;5;1;24;2;5;5;5;19;114;2;16;72;569;569;2;3;0;19;24;2562;3;5939;21;5;
/org.eclipse.jdt.ui.tests.refactoring/resources/MoveInnerToTopLevel/test_nonstatic_11/out/Inner.java;2;0;2;1;1;1;1;1;2;0;1;305;4;4;1;0;0;1;2;305;0;5854;2;2;
/org.eclipse.jdt.ui.tests.refactoring/resources/ExtractMethodWorkSpace/ExtractMethodTests/expression_in/A_test611.java;1;0;1;1;0;0;0;1;2;0;1;844;2;2;1;0;0;1;1;844;0;844;1;1;
/org.eclipse.core.runtime/src/org/eclipse/core/runtime/preferences/InstanceScope.java;2;1;7;1;2;2;2;5;4;2;4;4351;15;15;2;1;0;5;7;4351;1;5541;6;2;
/org.eclipse.jdt.ui/core refactoring/org/eclipse/jdt/internal/corext/refactoring/reorg2/DeleteRefactoring2.java;1;0;19;1;0;0;0;19;406;3;12;444;1217;1217;3;7;0;19;19;706;7;1111;12;1;
/org.eclipse.pde.ui/src/org/eclipse/pde/internal/ui/editor/build/BinSection.java;2;2;15;1;9;8;9;6;304;1;6;1727;695;695;2;0;1;6;15;5246;1;6336;14;2;
/org.eclipse.core.tests.runtime/src/org/eclipse/core/tests/runtime/jobs/TestJobFamily.java;2;0;2;1;1;1;1;1;12;0;1;2160;12;12;1;0;0;1;2;2160;0;5149;2;2;
/org.eclipse.jdt.ui/ui/org/eclipse/jdt/internal/ui/wizards/TypedElementSelectionValidator.java;1;0;1;1;1;1;1;0;2;0;0;6340;2;2;1;0;0;0;1;6340;0;6340;1;1;
/org.eclipse.ui.tests/Eclipse UI Tests/org/eclipse/ui/tests/dnd/ViewTabDropTarget.java;1;0;1;1;1;1;1;0;0;0;0;5825;0;0;1;0;0;0;1;5825;0;5825;1;1;
/org.eclipse.pde.core/src/org/eclipse/pde/internal/core/feature/WorkspaceFeatureModel.java;3;3;9;1;8;5;8;1;246;0;1;2501;278;278;3;0;3;1;9;5798;3;6336;6;3;
/org.eclipse.pde.core/src/org/eclipse/pde/internal/core/ischema/ISchemaAttribute.java;2;1;2;1;2;2;2;0;4;0;0;5799;6;6;1;0;0;0;2;5799;0;6336;2;2;
/org.eclipse.ui.tests/Eclipse UI Tests/org/eclipse/ui/tests/api/IActionFilterTest.java;1;0;2;1;0;0;0;2;3;1;2;3091;5;5;1;0;0;2;2;3091;0;3166;2;1;
/org.eclipse.core.runtime.osgi/src/org/eclipse/core/runtime/PlatformObject.java;1;0;2;1;0;0;0;2;49;1;2;3013;49;49;1;0;0;2;2;3013;0;3030;2;1;
/org.eclipse.swt.graphics.text/org.eclipse.swt/Eclipse SWT PI/gtk/org/eclipse/swt/internal/gtk/PangoGlyphString.java;1;0;1;1;0;0;0;1;0;0;1;2267;0;0;1;0;0;1;1;2267;0;2267;1;1;
/org.eclipse.core.runtime/src/org/eclipse/core/internal/runtime/CipherOutputStream.java;2;1;5;1;2;2;2;3;97;1;3;3013;199;199;1;0;0;3;5;3013;0;6340;5;2;
/org.eclipse.debug.ui/ui/org/eclipse/debug/internal/ui/views/variables/VariablesViewMessages.java;1;0;1;1;0;0;0;1;0;0;1;648;0;0;1;0;0;1;1;648;0;648;1;1;
/org.eclipse.jdt.ui.tests.refactoring/resources/PushDown/test21/out/C.java;1;0;1;1;0;0;0;1;4;0;1;344;4;4;1;0;0;1;1;344;0;344;1;1;
/org.eclipse.pde.ui/src_Forms/org/eclipse/pde/internal/ui/neweditor/site/BuiltFeaturesWizardPage.java;2;0;2;1;1;1;1;1;0;0;1;4832;0;0;1;0;0;1;2;4832;0;5431;2;2;
/org.eclipse.pde.ui/src/org/eclipse/pde/internal/ui/editor/build/BuildSourceOutlinePage.java;1;0;2;1;0;0;0;2;4;1;2;648;4;4;1;0;0;2;2;648;0;1727;2;1;
/org.eclipse.ui.workbench/Eclipse UI/org/eclipse/ui/commands/IGestureConfiguration.java;1;0;2;1;0;0;0;2;0;1;2;1321;0;0;1;0;0;2;2;1321;0;1340;2;1;
/org.eclipse.team.ui/src/org/eclipse/team/ui/TeamImages.java;1;1;6;1;2;2;2;4;104;1;4;790;131;131;1;0;0;4;6;790;0;6337;6;1;
/org.eclipse.update.ui/src/org/eclipse/update/internal/ui/pages/UpdateFormPage.java;1;0;1;1;0;0;0;1;0;0;1;755;0;0;1;0;0;1;1;755;0;755;1;1;
/org.eclipse.jdt.ui/core refactoring/org/eclipse/jdt/internal/corext/refactoring/reorg2/ReorgCopyWizard.java;2;0;3;1;0;0;0;3;5;1;3;802;5;5;1;0;0;3;3;802;0;1114;3;2;
/org.eclipse.ui.tests/Eclipse RCP Tests/org/eclipse/ui/rcp/tests/PlatformUITest.java;1;0;1;1;0;0;0;1;0;0;1;4930;0;0;1;0;0;1;1;4930;0;4930;1;1;
/org.eclipse.ui.editors/src/org/eclipse/ui/texteditor/_DefaultAnnotationPresentation.java;1;0;1;1;0;0;0;1;0;0;1;2874;0;0;1;0;0;1;1;2874;0;2874;1;1;
/org.eclipse.ant.ui/Ant Tools Support/org/eclipse/ant/internal/ui/datatransfer/AntBuildfileImportWizard.java;1;0;2;1;1;1;1;1;2;0;1;4809;2;2;1;0;0;1;2;4809;0;5487;2;1;
/org.eclipse.ui.workbench/Eclipse UI/org/eclipse/ui/internal/contexts/registry/ContextRegistryEvent.java;1;0;4;1;0;0;0;4;14;2;3;1396;14;14;2;1;0;4;4;1396;1;1724;3;1;
/org.eclipse.osgi/osgi/src/org/osgi/framework/SynchronousBundleListener.java;2;0;2;1;1;1;1;1;3;0;1;3013;3;3;1;0;0;1;2;3013;0;5536;2;2;
/org.eclipse.jdt.ui.examples.javafamily/coresearch-experiment/org/eclipse/search/internal/core/JobManager.java;1;0;2;1;0;0;0;2;0;1;2;1380;0;0;1;0;0;2;2;1380;0;3214;2;1;
/org.eclipse.core.tests.resources/src/org/eclipse/core/tests/resources/MarkerAttributeChangeListener.java;2;0;3;1;2;1;2;1;17;0;1;1744;19;19;2;0;1;1;3;5147;1;5147;2;2;
/org.eclipse.jdt.ui.tests.refactoring/resources/RenamePackage/testImportFromMultiRoots7/out/srcPrj.ref/pack/man/StarImporter.java;1;0;2;1;0;0;0;2;1;1;2;4105;1;1;1;0;0;2;2;4105;0;4818;2;1;
/org.eclipse.jdt.ui/core refactoring/org/eclipse/jdt/internal/corext/refactoring/code/flow/WhileFlowInfo.java;1;0;1;1;1;1;1;0;2;0;0;6340;2;2;1;0;0;0;1;6340;0;6340;1;1;
/org.eclipse.jdt.ui/ui/org/eclipse/jdt/internal/ui/callhierarchy/CallHierarchyViewer.java;3;0;11;1;1;1;1;10;15;1;10;155;48;48;1;0;0;10;11;155;0;6340;11;3;
/org.eclipse.text/src/org/eclipse/jface/text/IDocumentExtension2.java;1;0;1;1;1;1;1;0;11;0;0;6296;11;11;1;0;0;0;1;6296;0;6296;1;1;
/org.eclipse.ui.workbench/Eclipse UI/org/eclipse/ui/IMemento.java;1;0;1;1;0;0;0;1;2;0;1;1;2;2;1;0;0;1;1;1;0;1;1;1;
/org.eclipse.ui.workbench.texteditor/src/org/eclipse/ui/texteditor/BasicMarkerUpdater.java;1;0;1;1;0;0;0;1;0;0;1;2741;0;0;1;0;0;1;1;2741;0;2741;1;1;
/org.eclipse.jdt.debug.tests/tests/org/eclipse/jdt/debug/tests/eval/IntOperatorsTests.java;1;0;1;1;0;0;0;1;222;0;1;1274;222;222;1;0;0;1;1;1274;0;1274;1;1;
/org.eclipse.swt/Eclipse SWT Mozilla/common/org/eclipse/swt/internal/mozilla/nsITooltipListener.java;2;0;2;1;1;1;1;1;2;0;1;5086;2;2;1;0;0;1;2;5086;0;6342;2;2;
/org.eclipse.team.cvs.ui/src/org/eclipse/team/internal/ccvs/ui/model/ModulesCategory.java;2;0;2;1;0;0;0;2;4;1;2;66;6;6;1;0;0;2;2;66;0;990;2;2;
/org.eclipse.jdt.core.tests.model/workspace/Formatter/test237/A_in.java;1;0;1;1;0;0;0;1;0;0;1;2437;0;0;1;0;0;1;1;2437;0;2437;1;1;
/org.eclipse.jdt.core.tests.model/workspace/Formatter/test026/A_in.java;1;0;1;1;0;0;0;1;0;0;1;2425;0;0;1;0;0;1;1;2425;0;2425;1;1;
/org.eclipse.jdt.ui.tests.refactoring/test cases/org/eclipse/jdt/ui/tests/refactoring/SurroundWithTestSetup.java;5;1;8;2;3;3;3;5;15;2;4;4259;42;42;2;1;0;5;8;4839;1;6340;7;5;
/org.eclipse.swt.tests/JUnit Tests/org/eclipse/swt/tests/junit/Test_org_eclipse_swt_widgets_Scale.java;1;0;1;1;0;0;0;1;314;0;1;2123;314;314;1;0;0;1;1;2123;0;2123;1;1;
/org.eclipse.jdt.core.tests.model/workspace/Converter/src/test0408/A.java;1;0;1;1;0;0;0;1;0;0;1;3714;0;0;1;0;0;1;1;3714;0;3714;1;1;
/org.eclipse.update.ui.forms/Eclipse Forms/org/eclipse/ui/forms/internal/widgets/RichTextModel.java;1;0;2;1;0;0;0;2;0;1;2;3138;0;0;1;0;0;2;2;3138;0;4157;2;1;
/org.eclipse.pde.core/src_OSGi/org/eclipse/pde/internal/core/osgi/OSGiRuntimeSupport.java;2;0;7;1;0;0;0;7;31;2;6;2229;73;73;2;1;0;7;7;3008;1;4203;6;2;
/org.eclipse.jdt.junit/src/org/eclipse/jdt/internal/junit/runner/RemoteTestRunner.java;1;0;4;1;0;0;0;4;21;1;4;417;42;42;1;0;0;4;4;417;0;1578;4;1;
/org.eclipse.ui.workbench/Eclipse UI/org/eclipse/ui/internal/skins/newlook/DefaultStackPresentationSite.java;1;0;2;1;0;0;0;2;0;1;2;4438;0;0;1;0;0;2;2;4438;0;4460;2;1;
/org.eclipse.jdt.ui/core refactoring/org/eclipse/jdt/internal/corext/refactoring/reorg2/IConfirmQuery.java;1;0;3;1;0;0;0;3;3;1;3;444;3;3;1;0;0;3;3;444;0;1114;3;1;
/org.eclipse.core.resources/src/org/eclipse/core/internal/resources/Marker.java;2;1;10;1;2;2;2;8;517;1;8;180;614;614;1;0;0;8;10;180;0;5146;10;2;
/org.eclipse.team.cvs.core/src/org/eclipse/team/internal/ccvs/core/CVSTag.java;2;1;6;1;2;2;2;4;26;1;4;276;66;66;1;0;0;4;6;276;0;6337;6;2;
/org.eclipse.jdt.core/dom/org/eclipse/jdt/core/internal/dom/rewrite/GenericVisitor.java;2;0;3;2;0;0;0;3;1;2;2;4711;1;1;2;1;0;3;3;4711;1;4802;2;2;
/org.eclipse.webdav/src/client/org/eclipse/webdav/client/ResourceHandle.java;1;0;1;1;1;1;1;0;8;0;0;5151;8;8;1;0;0;0;1;5151;0;5151;1;1;
/org.eclipse.debug.ui/ui/org/eclipse/debug/ui/ILaunchFilter.java;1;0;2;1;1;1;1;1;0;0;1;3927;0;0;1;0;0;1;2;3927;0;5182;2;1;
/org.eclipse.pde.ui/src/org/eclipse/pde/internal/ui/editor/manifest/PluginSpecSection.java;1;0;4;1;1;1;1;3;35;1;3;1618;58;58;1;0;0;3;4;1618;0;5431;4;1;
/org.eclipse.jdt.ui.tests.refactoring/resources/ChangeSignature/canModify/A_testImport02_in.java;1;0;1;1;0;0;0;1;0;0;1;3820;0;0;1;0;0;1;1;3820;0;3820;1;1;
/org.eclipse.ui.editors/src/org/eclipse/ui/internal/editors/text/QuickDiffPreferencePage.java;1;0;1;1;1;1;1;0;0;0;0;5508;0;0;1;0;0;0;1;5508;0;5508;1;1;
/org.eclipse.jdt.ui.tests.refactoring/resources/ChangeTypeRefactoring/negative/A_testOverriddenBinaryMethod_out.java;1;0;1;1;0;0;0;1;0;0;1;2844;0;0;1;0;0;1;1;2844;0;2844;1;1;
/org.eclipse.jdt.debug.tests/tests/org/eclipse/jdt/debug/tests/eval/NestedTypeFieldValue_417.java;1;0;1;1;0;0;0;1;78;0;1;1274;78;78;1;0;0;1;1;1274;0;1274;1;1;
/org.eclipse.jdt.ui/core refactoring/org/eclipse/jdt/internal/corext/refactoring/reorg/IReorgDestinationValidator.java;1;0;1;1;1;1;1;0;0;0;0;5616;0;0;1;0;0;0;1;5616;0;5616;1;1;
/org.eclipse.jdt.ui.tests.refactoring/test cases/org/eclipse/jdt/ui/tests/nls/NLSSourceModificationTest.java;1;1;2;1;2;2;2;0;0;0;0;5186;0;0;1;0;0;0;2;5186;0;5248;2;1;
/org.eclipse.jdt.core.tests.model/workspace/Formatter/test312/A_out.java;1;0;2;1;0;0;0;2;6;1;2;2442;6;6;1;0;0;2;2;2442;0;3029;2;1;
/org.eclipse.ui.views/src/org/eclipse/ui/views/navigator/ToggleLinkingAction.java;1;0;1;1;0;0;0;1;0;0;1;2738;0;0;1;0;0;1;1;2738;0;2738;1;1;
/org.eclipse.jdt.ui.tests.refactoring/resources/ExtractMethodWorkSpace/ExtractMethodTests/locals_out/A_test558.java;1;0;1;1;0;0;0;1;4;0;1;844;4;4;1;0;0;1;1;844;0;844;1;1;
/org.eclipse.swt/Eclipse SWT Drag and Drop/motif/org/eclipse/swt/dnd/TransferData.java;1;1;2;1;2;2;2;0;10;0;0;5606;14;14;1;0;0;0;2;5606;0;6352;2;1;
/org.eclipse.pde.ui/src/org/eclipse/pde/internal/ui/editor/plugin/OverviewPage.java;3;1;7;1;7;7;7;0;44;0;0;5431;104;104;1;0;0;0;7;5431;0;6366;7;3;
/org.eclipse.jface.text/src/org/eclipse/jface/text/contentassist/ContextInformation.java;1;2;3;1;3;2;3;0;9;0;0;6340;11;11;2;0;1;0;3;6353;1;6353;2;1;
/org.eclipse.update.ui/src/org/eclipse/update/internal/ui/search/UnifiedSearchObject.java;1;0;2;1;0;0;0;2;0;1;2;200;0;0;1;0;0;2;2;200;0;369;2;1;
/org.eclipse.debug.ui/ui/org/eclipse/debug/ui/launchVariables/expanders/WorkspaceExpander.java;1;0;2;1;0;0;0;2;0;1;2;562;0;0;1;0;0;2;2;562;0;737;2;1;
/org.eclipse.ui.views/src/org/eclipse/ui/views/internal/markers/DialogMarkerProperties.java;1;0;2;1;0;0;0;2;0;0;1;749;0;0;2;1;0;2;2;749;1;749;1;1;
/org.eclipse.ltk.ui.refactoring/src/org/eclipse/ltk/internal/ui/refactoring/RefactoringStatusDialog.java;1;1;3;1;2;2;2;1;2;0;1;4988;4;4;1;0;0;1;3;4988;0;6340;3;1;
/org.eclipse.jdt.ui/ui/org/eclipse/jdt/internal/ui/JavaPerspectiveFactory.java;6;1;12;1;9;9;9;3;13;1;3;1378;58;58;1;0;0;3;12;1378;0;6340;12;6;
/org.eclipse.help.base/src/org/eclipse/help/internal/standalone/StandaloneHelp.java;1;1;6;1;3;3;3;3;80;2;2;1740;131;131;2;1;0;3;6;1740;1;6337;5;1;
/org.eclipse.jdt.ui/ui/org/eclipse/jdt/internal/ui/preferences/formatter/FormatterMessages.java;1;0;2;1;0;0;0;2;2;1;2;3103;2;2;1;0;0;2;2;3103;0;3943;2;1;
/org.eclipse.swt/Eclipse SWT PI/gtk/org/eclipse/swt/internal/gtk/GtkTargetPair.java;3;0;4;1;1;1;1;3;17;1;3;1653;23;23;1;0;0;3;4;1653;0;6352;4;3;
/org.eclipse.jdt.ui/ui/org/eclipse/jdt/internal/ui/wizards/NewProjectCreationWizard.java;1;0;1;1;0;0;0;1;0;0;1;3830;0;0;1;0;0;1;1;3830;0;3830;1;1;
/org.eclipse.ui.workbench/Eclipse UI/org/eclipse/ui/internal/commands/ws/CommandCallback.java;1;1;3;1;3;3;3;0;46;0;0;5252;48;48;1;0;0;0;3;5252;0;5484;3;1;
/org.eclipse.ui.workbench/Eclipse UI/org/eclipse/ui/internal/contexts/activationservice/AbstractContextActivationService.java;1;0;2;1;0;0;0;2;0;1;2;3066;0;0;1;0;0;2;2;3066;0;3109;2;1;
/org.eclipse.team.ui/src/org/eclipse/team/internal/ui/target/SiteExplorerView.java;2;0;3;1;0;0;0;3;19;1;3;917;22;22;1;0;0;3;3;917;0;2495;3;2;
/org.eclipse.team.webdav/src/org/eclipse/team/internal/target/subscriber/TargetResourceVariantTree.java;1;0;2;1;0;0;0;2;0;1;2;4259;0;0;1;0;0;2;2;4259;0;4349;2;1;
/org.eclipse.jdt.debug/jdi interfaces/com/sun/jdi/ReferenceType.java;1;0;1;1;0;0;0;1;3;0;1;4267;3;3;1;0;0;1;1;4267;0;4267;1;1;
/org.eclipse.core.runtime.compatibility/src-runtime/org/eclipse/core/internal/plugins/events/PluginEvent.java;2;0;2;1;0;0;0;2;0;1;2;3013;0;0;1;0;0;2;2;3013;0;3169;2;2;
/org.eclipse.swt/Eclipse SWT Drag and Drop/common/org/eclipse/swt/dnd/DropTargetAdapter.java;2;0;2;1;1;1;1;1;12;0;1;3899;16;16;1;0;0;1;2;3899;0;6352;2;2;
/org.eclipse.team.cvs.ui/src/org/eclipse/team/internal/ccvs/ui/operations/AddOperation.java;1;0;2;1;1;1;1;1;7;0;1;4780;7;7;1;0;0;1;2;4780;0;6067;2;1;
/org.eclipse.compare/compare/org/eclipse/compare/IModificationDate.java;1;0;1;1;0;0;0;1;2;0;1;3935;2;2;1;0;0;1;1;3935;0;3935;1;1;
/org.eclipse.jdt.ui/ui/org/eclipse/jdt/internal/ui/text/folding/DefaultJavaFoldingStructureProvider.java;3;1;5;1;5;5;5;0;12;0;0;5440;23;23;1;0;0;0;5;5440;0;6340;5;3;
/org.eclipse.pde.core/src/org/eclipse/pde/internal/core/CoreUtility.java;1;1;5;1;3;3;3;2;65;1;2;3794;81;81;1;0;0;2;5;3794;0;6336;5;1;
/org.eclipse.ui.workbench/Eclipse UI/org/eclipse/ui/internal/contexts/AbstractRegistry.java;1;0;4;1;0;0;0;4;6;1;4;1356;8;8;1;0;0;4;4;1356;0;1396;4;1;
/org.eclipse.jdt.ui/ui/org/eclipse/jdt/internal/ui/actions/JDTQuickMenuAction.java;1;1;4;1;3;3;3;1;5;0;1;5052;11;11;1;0;0;1;4;5052;0;6140;4;1;
/org.eclipse.update.tests.core/src/org/eclipse/update/tests/core/boot/TestPlatCfgAPI.java;1;0;5;1;1;1;1;4;30;1;4;4095;57;57;1;0;0;4;5;4095;0;6336;5;1;
/org.eclipse.update.configurator/src/org/eclipse/update/configurator/FragmentEntry.java;1;0;2;1;0;0;0;2;0;1;2;3319;0;0;1;0;0;2;2;3319;0;4135;2;1;
/org.eclipse.core.tests.resources/src/org/eclipse/core/tests/internal/indexing/StandAloneIndexedStoreTest.java;1;0;1;1;1;1;1;0;6;0;0;5147;6;6;1;0;0;0;1;5147;0;5147;1;1;
/org.eclipse.jdt.ui.tests.refactoring/test cases/org/eclipse/jdt/ui/tests/reorg/MockReorgQueries.java;3;1;4;1;2;2;2;2;32;1;2;821;52;52;1;0;0;2;4;821;0;6340;4;3;
/org.eclipse.ant.ui/Ant Tools Support/org/eclipse/ant/internal/ui/model/IAntUIHelpContextIds.java;2;1;4;1;2;2;2;2;9;1;2;1811;14;14;1;0;0;2;4;1811;0;6336;4;2;
/org.eclipse.search/new search/org/eclipse/search2/internal/ui/text/EditorAccessHighlighter.java;1;2;4;1;4;3;4;0;22;0;0;5815;29;29;2;0;1;0;4;5815;1;6116;3;1;
/org.eclipse.jdt.ui/ui/org/eclipse/jdt/internal/ui/preferences/SpellingPreferencePage.java;2;0;2;1;1;1;1;1;5;0;1;3829;5;5;1;0;0;1;2;3829;0;5506;2;2;
/org.eclipse.jdt.ui.tests.refactoring/resources/IntroduceParameter/invalid/PartString.java;1;0;1;1;0;0;0;1;0;0;1;2281;0;0;1;0;0;1;1;2281;0;2281;1;1;
/org.eclipse.swt.graphics.text/Examples/examples/SetTextDialog.java;1;0;1;1;0;0;0;1;0;0;1;2937;0;0;1;0;0;1;1;2937;0;2937;1;1;
/org.eclipse.jdt.ui.tests.refactoring/resources/MoveInstanceMethod/canMove/test18/in/Shape.java;1;0;1;1;0;0;0;1;0;0;1;1570;0;0;1;0;0;1;1;1570;0;1570;1;1;
/org.eclipse.team.cvs.core/src/org/eclipse/team/internal/ccvs/core/syncinfo/ReentrantLock.java;2;2;17;1;4;3;4;13;200;3;10;1933;744;744;3;3;1;13;17;2097;4;6337;13;2;
/org.eclipse.jdt.ui.tests.refactoring/resources/ExtractMethodWorkSpace/ExtractMethodTests/try_in/A_test454.java;1;0;2;1;0;0;0;2;2;1;2;130;4;4;1;0;0;2;2;130;0;844;2;1;
/org.eclipse.ui.workbench/Eclipse UI/org/eclipse/ui/internal/commands/registry/IActiveKeyConfigurationDefinition.java;1;0;2;1;0;0;0;2;0;1;2;1422;0;0;1;0;0;2;2;1422;0;1724;2;1;
/org.eclipse.core.runtime/src/org/eclipse/core/runtime/registry/IExtensionDelta.java;4;0;5;2;0;0;0;5;98;2;4;2105;196;196;2;1;0;5;5;3164;1;3164;4;4;
/org.eclipse.update.core/src/org/eclipse/update/core/model/FeatureParser.java;1;0;1;1;0;0;0;1;0;0;1;2634;0;0;1;0;0;1;1;2634;0;2634;1;1;
/org.eclipse.core.tests.harness/src/org/eclipse/core/tests/harness/BundleTestingHelper.java;1;0;1;1;1;1;1;0;0;0;0;6201;0;0;1;0;0;0;1;6201;0;6201;1;1;
/org.eclipse.team.ui/src/org/eclipse/team/internal/ui/synchronize/SynchronizeViewDefaultPage.java;2;1;3;1;3;3;3;0;89;0;0;5579;89;89;1;0;0;0;3;5579;0;5736;3;2;
/org.eclipse.team.cvs.ui/src/org/eclipse/team/internal/ccvs/ui/wizards/ModuleSelectionPage.java;2;2;10;1;6;5;6;4;245;2;3;2381;434;434;2;1;1;4;10;4875;2;6337;8;2;
/org.eclipse.search/search/org/eclipse/search/internal/ui/text/ReplaceAction2.java;2;1;6;1;3;3;3;3;80;1;3;4045;202;202;1;0;0;3;6;4045;0;6340;6;2;
/org.eclipse.ui.views/src/org/eclipse/ui/views/markers/internal/ActionRevealMarker.java;2;0;3;1;0;0;0;3;2;1;3;755;2;2;1;0;0;3;3;755;0;2738;3;2;
/org.eclipse.ui.workbench/Eclipse UI/org/eclipse/ui/internal/commands/registry/IMutableRegistry.java;1;0;5;1;0;0;0;5;99;2;4;1077;166;166;2;1;0;5;5;1396;1;1396;4;1;
/org.eclipse.jdt.ui/ui/org/eclipse/jdt/internal/ui/search/IQueryParticipant.java;1;0;2;1;0;0;0;2;0;1;2;4625;0;0;1;0;0;2;2;4625;0;5075;2;1;
/org.eclipse.jdt.core.tests.model/workspace/Formatter/test055/A_out.java;1;0;1;1;0;0;0;1;0;0;1;2425;0;0;1;0;0;1;1;2425;0;2425;1;1;
/org.eclipse.ui.workbench/Eclipse UI/org/eclipse/ui/internal/presentations/DefaultEditorPresentation.java;5;2;9;2;9;7;9;0;53;0;0;5539;112;112;2;0;2;0;9;6101;2;6248;7;5;
/org.eclipse.pde.core/src/org/eclipse/pde/internal/core/plugin/WorkspaceFragmentModel.java;1;0;2;1;1;1;1;1;4;0;1;4203;7;7;1;0;0;1;2;4203;0;6336;2;1;
/org.eclipse.jdt.core.tests.model/workspace/Converter/src/junit/runner/TestRunListener.java;1;0;1;1;0;0;0;1;0;0;1;3714;0;0;1;0;0;1;1;3714;0;3714;1;1;
/org.eclipse.core.runtime/src/org/eclipse/core/internal/plugins/FragmentDescriptor.java;1;0;1;1;0;0;0;1;0;0;1;3013;0;0;1;0;0;1;1;3013;0;3013;1;1;
/org.eclipse.jdt.ui/core refactoring/org/eclipse/jdt/internal/corext/refactoring/nls/NLSRefactoring.java;5;3;40;2;17;14;17;23;1224;3;20;122;4115;4115;3;3;3;23;40;1951;6;6340;34;5;
/org.eclipse.pde.ui/templates_3.0/editor/java/$editorClass$.java;1;0;1;1;0;0;0;1;0;0;1;2786;0;0;1;0;0;1;1;2786;0;2786;1;1;
/org.eclipse.update.ui/src/org/eclipse/update/internal/ui/forms/UIProblemHandler.java;1;0;1;1;0;0;0;1;0;0;1;755;0;0;1;0;0;1;1;755;0;755;1;1;
/org.eclipse.jdt.ui.tests.refactoring/resources/InlineMethodWorkspace/TestCases/simple_out/TestTypeArray.java;1;0;1;1;0;0;0;1;2;0;1;845;2;2;1;0;0;1;1;845;0;845;1;1;
/org.eclipse.ant.ui/Ant Tools Support/org/eclipse/ant/internal/ui/model/AntImageDescriptor.java;1;0;5;1;0;0;0;5;19;1;5;1811;41;41;1;0;0;5;5;1811;0;4587;5;1;
/org.eclipse.ui.workbench/Eclipse UI/org/eclipse/ui/internal/registry/NavigatorRootContentDescriptor.java;1;0;1;1;0;0;0;1;0;0;1;1014;0;0;1;0;0;1;1;1014;0;1014;1;1;
/org.eclipse.ui.views/src/org/eclipse/ui/views/markers/internal/TableView.java;2;0;3;1;0;0;0;3;49;1;3;755;49;49;1;0;0;3;3;755;0;2738;3;2;
/org.eclipse.jdt.core.tests.model/workspace/Formatter/test374/A_in.java;1;0;2;1;0;0;0;2;1;1;2;3146;1;1;1;0;0;2;2;3146;0;3172;2;1;
/org.eclipse.jdt.ui.tests.refactoring/resources/PasteSourceReference/test2/in/A.java;1;0;1;1;0;0;0;1;0;0;1;1311;0;0;1;0;0;1;1;1311;0;1311;1;1;
/org.eclipse.pde.build/src/org/eclipse/pde/internal/build/FragmentBuildScriptGenerator.java;2;0;5;1;0;0;0;5;0;1;5;447;0;0;1;0;0;5;5;447;0;1113;5;2;
/org.eclipse.jdt.ui/ui/org/eclipse/jdt/internal/ui/dialogs/MultiElementListSelectionDialog.java;2;1;3;1;2;2;2;1;5;0;1;1235;9;9;1;0;0;1;3;1235;0;6340;3;2;
/org.eclipse.jdt.ui/ui/org/eclipse/jdt/internal/ui/preferences/ColorEditor.java;1;0;1;1;1;1;1;0;2;0;0;6340;2;2;1;0;0;0;1;6340;0;6340;1;1;
/org.eclipse.pde.ui/src_Forms/org/eclipse/pde/internal/ui/model/plugin/PluginElementNode.java;3;1;10;1;6;6;6;4;48;1;4;4438;170;170;1;0;0;4;10;4438;0;6336;10;3;
/org.eclipse.swt/Eclipse SWT/gtk1x/org/eclipse/swt/widgets/Widget.java;1;0;1;1;0;0;0;1;0;0;1;2327;0;0;1;0;0;1;1;2327;0;2327;1;1;
/org.eclipse.team.ui/src/org/eclipse/team/internal/ui/widgets/SelectableFormLabel.java;1;0;1;1;0;0;0;1;0;0;1;3176;0;0;1;0;0;1;1;3176;0;3176;1;1;
/org.eclipse.ant.ui/Ant Tools Support/org/eclipse/ant/internal/ui/preferences/AntClasspathLabelProvider2.java;1;0;4;1;0;0;0;4;5;1;4;2182;10;10;1;0;0;4;4;2182;0;2550;4;1;
/org.eclipse.jdt.ui/core refactoring/org/eclipse/ltk/refactoring/core/ValidationStateChangedEvent.java;1;0;3;1;0;0;0;3;8;1;3;3708;8;8;1;0;0;3;3;3708;0;4510;3;1;
/org.eclipse.pde.ui/src/org/eclipse/pde/internal/ui/editor/PropertiesAction.java;2;1;4;1;3;3;3;1;45;0;1;4986;54;54;1;0;0;1;4;4986;0;6336;4;2;
/org.eclipse.jdt.ui/ui/org/eclipse/jdt/internal/ui/text/correction/CorrectionContext.java;1;0;1;1;0;0;0;1;0;0;1;1034;0;0;1;0;0;1;1;1034;0;1034;1;1;
/org.eclipse.jdt.core.tests.compiler/src/org/eclipse/jdt/core/tests/compiler/parser/AbstractCompletionTest.java;5;0;8;1;1;1;1;7;27;1;7;69;68;68;1;0;0;7;8;69;0;5853;8;5;
/org.eclipse.jdt.core.tests.model/workspace/Converter/src/test0040/Test.java;1;0;1;1;0;0;0;1;0;0;1;3714;0;0;1;0;0;1;1;3714;0;3714;1;1;
/org.eclipse.pde.ui/src/org/eclipse/pde/internal/ui/editor/manifest/ExtensionElementPropertySource.java;2;1;7;1;2;2;2;5;8;1;5;368;25;25;1;0;0;5;7;368;0;5431;7;2;
/org.eclipse.compare.examples.xml/src/org/eclipse/compare/examples/xml/XMLPlugin.java;1;0;2;1;0;0;0;2;2;1;2;1106;2;2;1;0;0;2;2;1106;0;3938;2;1;
/org.eclipse.update.ui/src/org/eclipse/update/internal/ui/UpdateLabelProvider.java;2;0;2;1;1;1;1;1;8;0;1;890;11;11;1;0;0;1;2;890;0;6339;2;2;
/org.eclipse.ui.forms/src/org/eclipse/ui/forms/widgets/ColumnLayout.java;2;0;7;2;0;0;0;7;42;2;6;4068;65;65;2;1;0;7;7;4148;1;5044;6;2;
/org.eclipse.jdt.ui.examples.javafamily/src/org/eclipse/jface/text/source/AnnotationTextHover.java;1;0;3;1;0;0;0;3;17;2;2;1152;17;17;2;1;0;3;3;1152;1;1642;2;1;
/org.eclipse.jdt.ui.tests.refactoring/resources/MoveInnerToTopLevel/test_nonstatic_31/in/A.java;1;0;1;1;0;0;0;1;12;0;1;305;12;12;1;0;0;1;1;305;0;305;1;1;
/org.eclipse.team.webdav/src/org/eclipse/team/internal/ui/target/GetSyncAction.java;2;0;2;1;0;0;0;2;0;1;2;2495;0;0;1;0;0;2;2;2495;0;4216;2;2;
/org.eclipse.ui.workbench.texteditor/src/org/eclipse/ui/internal/texteditor/quickdiff/DocumentLineDiffer.java;4;1;28;1;5;5;5;23;1451;2;21;1644;2762;2762;2;2;0;23;28;1967;2;6340;26;4;
/org.eclipse.ui.ide/src/org/eclipse/ui/views/tasklist/TaskListMessages.java;1;0;1;1;0;0;0;1;0;0;1;2208;0;0;1;0;0;1;1;2208;0;2208;1;1;
/org.eclipse.update/src/org/eclipse/update/internal/ui/UMWizardPageLocations.java;1;0;1;1;1;1;1;0;0;0;0;6339;0;0;1;0;0;0;1;6339;0;6339;1;1;
/org.eclipse.update.configurator/src/org/eclipse/update/internal/configurator/VersionedIdentifier.java;1;0;4;1;1;1;1;3;16;1;3;3243;34;34;1;0;0;3;4;3243;0;5424;4;1;
/org.eclipse.jdt.core.tests.model/workspace/Converter/src/test0537/C.java;1;0;1;1;0;0;0;1;0;0;1;3873;0;0;1;0;0;1;1;3873;0;3873;1;1;
/org.eclipse.help/src/org/eclipse/help/internal/HelpSystem.java;1;0;5;1;0;0;0;5;19;1;5;392;38;38;1;0;0;5;5;392;0;2732;5;1;
/org.eclipse.jdt.ui.tests.refactoring/resources/ExtractMethodWorkSpace/ExtractMethodTests/return_in/A_test701.java;1;0;1;1;0;0;0;1;2;0;1;844;2;2;1;0;0;1;1;844;0;844;1;1;
/org.eclipse.team.webdav/src/org/eclipse/team/internal/target/subscriber/RemoteResourceVariantByteStore.java;1;0;2;1;0;0;0;2;0;1;2;4259;0;0;1;0;0;2;2;4259;0;4349;2;1;
/org.eclipse.jdt.core.tests.model/workspace/Converter/src/test0424/A.java;1;0;1;1;0;0;0;1;0;0;1;3714;0;0;1;0;0;1;1;3714;0;3714;1;1;
/org.eclipse.jdt.core.tests.model/workspace/Converter/test0177/Test.java;1;0;1;1;0;0;0;1;0;0;1;3714;0;0;1;0;0;1;1;3714;0;3714;1;1;
/org.eclipse.jdt.ui.examples.javafamily/coresearch-experiment/org/eclipse/search/internal/core/ReadWriteLock.java;1;0;2;1;0;0;0;2;0;1;2;1380;0;0;1;0;0;2;2;1380;0;3214;2;1;
/org.eclipse.ua.tests/src/org/eclipse/ui/examples/cheatsheets/pattern/dialogs/CustomizePatternDialog.java;1;0;1;1;1;1;1;0;0;0;0;6081;0;0;1;0;0;0;1;6081;0;6081;1;1;
/org.eclipse.ant.ui/Ant Tools Support/org/eclipse/ant/internal/ui/preferences/AntPreviewerUpdater.java;1;1;3;1;3;3;3;0;26;0;0;5721;30;30;1;0;0;0;3;5721;0;6336;3;1;
/org.eclipse.team.core/src/org/eclipse/team/internal/core/SaveContext.java;2;0;4;1;0;0;0;4;138;1;4;684;142;142;1;0;0;4;4;684;0;2632;4;2;
/org.eclipse.ui.ide/src/org/eclipse/ui/internal/dialogs/ExportWizard.java;2;0;7;1;0;0;0;7;10;1;7;1526;25;25;1;0;0;7;7;1526;0;2263;7;2;
/org.eclipse.ui.workbench/Eclipse UI/org/eclipse/ui/internal/themes/WorkbenchPreview.java;4;1;13;2;4;4;4;9;71;4;6;4563;176;176;4;3;0;9;13;4603;3;5894;10;4;
/org.eclipse.ant.ui/Ant Editor/org/eclipse/ant/internal/ui/editor/outline/FilterImportedElementsAction.java;1;0;1;1;0;0;0;1;0;0;1;4349;0;0;1;0;0;1;1;4349;0;4349;1;1;
/org.eclipse.ui.workbench/Eclipse UI/org/eclipse/ui/internal/commands/api/older/IActionServiceEvent.java;1;0;1;1;0;0;0;1;0;0;1;2562;0;0;1;0;0;1;1;2562;0;2562;1;1;
/org.eclipse.osgi/osgi/src/org/eclipse/osgi/service/environment/Constants.java;2;0;3;1;0;0;0;3;10;1;3;3013;10;10;1;0;0;3;3;3013;0;3147;3;2;
/org.eclipse.ui.workbench/Eclipse UI/org/eclipse/ui/internal/csm/roles/ActivityBindingDefinition.java;1;0;4;1;0;0;0;4;50;2;3;2225;50;50;2;1;0;4;4;2370;1;2412;3;1;
/org.eclipse.pde.core/src/org/eclipse/pde/internal/core/plugin/PluginParent.java;2;1;4;1;2;2;2;2;10;1;2;4203;22;22;1;0;0;2;4;4203;0;6336;4;2;
/org.eclipse.jdt.core.tests.model/workspace/Converter/test0331/Test.java;1;0;1;1;0;0;0;1;0;0;1;3714;0;0;1;0;0;1;1;3714;0;3714;1;1;
/org.eclipse.jface.text/src/org/eclipse/jface/text/contentassist/AbstractControlContentAssistSubjectAdapter.java;1;0;9;1;2;1;2;7;977;1;7;3672;1857;1857;2;0;1;7;9;5177;1;5177;8;1;
/org.eclipse.jdt.core/compiler/org/eclipse/jdt/internal/compiler/classfmt/MethodInfo.java;3;0;3;1;1;1;1;2;2;1;2;2094;6;6;1;0;0;2;3;2094;0;5916;3;3;
/org.eclipse.pde.ui/src_Forms/org/eclipse/pde/internal/ui/neweditor/MultiSourceEditor.java;2;2;10;1;5;4;5;5;45;1;5;3777;112;112;2;0;1;5;10;5341;1;5431;9;2;
/org.eclipse.jdt.core/eval/org/eclipse/jdt/internal/eval/CodeSnippetEnvironment.java;1;0;1;1;0;0;0;1;2;0;1;3560;2;2;1;0;0;1;1;3560;0;3560;1;1;
/org.eclipse.ui.externaltools/External Tools Base/org/eclipse/ui/externaltools/internal/ui/StatusInfo.java;1;0;1;1;0;0;0;1;0;0;1;282;0;0;1;0;0;1;1;282;0;282;1;1;
/org.eclipse.osgi/eclipseAdaptor/src/org/eclipse/osgi/service/pluginconversion/PluginConverter.java;4;1;12;1;5;5;5;7;44;2;6;3134;133;133;2;1;0;7;12;3134;1;6337;11;4;
/org.eclipse.jdt.ui.tests.refactoring/resources/MoveMembers/test29/in/A.java;1;0;1;1;0;0;0;1;0;0;1;1651;0;0;1;0;0;1;1;1651;0;1651;1;1;
/org.eclipse.ui.workbench/Eclipse UI/org/eclipse/ui/internal/presentations/DefaultPartPresentation.java;5;4;24;2;24;14;24;0;390;0;0;5539;745;745;4;0;10;0;24;5917;10;6270;14;5;
/org.eclipse.ui.workbench/Eclipse UI/org/eclipse/ui/progress/UIJob.java;3;1;21;1;5;5;5;16;249;1;16;972;689;689;1;0;0;16;21;972;0;6338;21;3;
/org.eclipse.core.resources/src/org/eclipse/core/resources/IWorkspaceRunnable.java;1;0;2;1;1;1;1;1;36;0;1;4994;38;38;1;0;0;1;2;4994;0;5146;2;1;
/org.eclipse.core.runtime.osgi/src/org/eclipse/core/runtime/IProgressMonitor.java;1;0;2;1;0;0;0;2;138;1;2;3013;138;138;1;0;0;2;2;3013;0;3030;2;1;
/org.eclipse.update.core/srcnew/org/eclipse/update/search/IUpdateSearchCategory.java;2;0;2;1;0;0;0;2;0;1;2;574;0;0;1;0;0;2;2;574;0;825;2;2;
/org.eclipse.pde.ui/src_Forms/org/eclipse/pde/internal/ui/neweditor/schema/ElementPropertySource.java;1;0;2;1;0;0;0;2;0;1;2;4856;0;0;1;0;0;2;2;4856;0;4879;2;1;
/org.eclipse.update.configurator/src/org/eclipse/update/configurator/IPlatformConfiguration.java;2;1;4;1;3;3;3;1;18;0;1;3014;37;37;1;0;0;1;4;3014;0;5518;4;2;
/org.eclipse.swt/Eclipse SWT Browser/win32/org/eclipse/swt/browser/Browser.java;2;1;42;1;8;8;8;34;213;3;24;1654;1590;1590;3;10;0;34;42;3007;10;6352;32;2;
/org.eclipse.jdt.core/eval/org/eclipse/jdt/internal/eval/CodeSnippetToCuMapper.java;2;1;5;1;2;2;2;3;72;1;3;241;142;142;1;0;0;3;5;241;0;6222;5;2;
/org.eclipse.jdt.debug.ui/ui/org/eclipse/jdt/internal/debug/ui/actions/JavaBreakpointPreferenceStore.java;1;0;1;1;0;0;0;1;0;0;1;1484;0;0;1;0;0;1;1;1484;0;1484;1;1;
/org.eclipse.jdt.core.tests.model/workspace/Converter/src/javadoc/test100/TestB1.java;1;0;1;1;0;0;0;1;0;0;1;4390;0;0;1;0;0;1;1;4390;0;4390;1;1;
/org.eclipse.jdt.core/compiler/org/eclipse/jdt/internal/compiler/ast/SingleParameterizedTypeReference.java;1;0;1;1;0;0;0;1;0;0;1;2749;0;0;1;0;0;1;1;2749;0;2749;1;1;
/org.eclipse.jdt.core/model/org/eclipse/jdt/internal/core/util/SimpleDocument.java;2;0;4;1;0;0;0;4;52;1;4;2280;78;78;1;0;0;4;4;2280;0;3560;4;2;
/org.eclipse.ui.workbench/Eclipse UI/org/eclipse/ui/internal/registry/PerspectiveRegistry.java;5;1;16;1;6;6;6;10;775;2;9;1952;1059;1059;2;1;0;10;16;1952;1;6338;15;5;
/org.eclipse.jdt.core.tests.model/workspace/Formatter/test311/A_in.java;1;0;1;1;0;0;0;1;0;0;1;2442;0;0;1;0;0;1;1;2442;0;2442;1;1;
/org.eclipse.ui.workbench/Eclipse UI/org/eclipse/ui/actions/OpenWithMenu.java;1;0;1;1;0;0;0;1;0;0;1;2737;0;0;1;0;0;1;1;2737;0;2737;1;1;
/org.eclipse.jdt.core.tests.model/workspace/Converter/test0126/Test.java;1;0;1;1;0;0;0;1;0;0;1;3714;0;0;1;0;0;1;1;3714;0;3714;1;1;
/org.eclipse.jdt.core.tests.model/workspace/Formatter/test295/A_out.java;1;0;1;1;0;0;0;1;0;0;1;2444;0;0;1;0;0;1;1;2444;0;2444;1;1;
/org.eclipse.jface.text/src/org/eclipse/jface/contentassist/ISubjectControlContentAssistant.java;1;1;2;1;2;2;2;0;20;0;0;5199;33;33;1;0;0;0;2;5199;0;6340;2;1;
/org.eclipse.jdt.debug.ui/ui/org/eclipse/jdt/internal/debug/ui/monitors/ThreadsViewContentProvider.java;1;0;1;1;0;0;0;1;2;0;1;1275;2;2;1;0;0;1;1;1275;0;1275;1;1;
/org.eclipse.jdt.core.tests.model/workspace/Formatter/test142/A_out.java;1;0;1;1;0;0;0;1;0;0;1;2425;0;0;1;0;0;1;1;2425;0;2425;1;1;
/org.eclipse.ant.ui/Ant Tools Support/org/eclipse/ant/ui/internal/console/JavacLineTracker.java;1;0;2;1;0;0;0;2;0;1;2;558;0;0;1;0;0;2;2;558;0;1811;2;1;
/org.eclipse.team.webdav/src/org/eclipse/team/ui/subscriber/TeamNonblockingRunnableContext.java;1;0;1;1;0;0;0;1;0;0;1;3373;0;0;1;0;0;1;1;3373;0;3373;1;1;
/org.eclipse.pde.ui/src/org/eclipse/pde/internal/ui/wizards/templates/MultiPageEditorTemplate.java;3;2;15;1;8;6;8;7;72;2;6;2184;185;185;2;1;2;7;15;3435;3;6336;12;3;
/org.eclipse.pde.ui/src/org/eclipse/pde/internal/ui/editor/context/XMLInputContext.java;2;1;5;1;5;5;5;0;14;0;0;5431;30;30;1;0;0;0;5;5431;0;6336;5;2;
/org.eclipse.jdt.ui/ui/org/eclipse/jdt/ui/actions/AddUnimplementedConstructorsAction.java;3;1;22;1;5;5;5;17;203;1;17;592;535;535;1;0;0;17;22;592;0;6340;22;3;
/org.eclipse.ui.views/src/org/eclipse/ui/views/tasklist/NewTaskAction.java;1;0;1;1;0;0;0;1;0;0;1;2738;0;0;1;0;0;1;1;2738;0;2738;1;1;
/org.eclipse.team.webdav/src/org/eclipse/team/internal/ui/target/subscriber/DeploymentProviderLabelProvider.java;2;0;5;1;1;1;1;4;58;1;4;3494;68;68;1;0;0;4;5;3494;0;6337;5;2;
/org.eclipse.ui.externaltools/External Tools Base/org/eclipse/ui/externaltools/internal/model/AntImageDescriptor.java;1;0;1;1;0;0;0;1;0;0;1;282;0;0;1;0;0;1;1;282;0;282;1;1;
/org.eclipse.osgi/defaultAdaptor/src/org/eclipse/osgi/framework/internal/defaultadaptor/MetaData.java;4;1;5;1;2;2;2;3;62;1;3;3013;106;106;1;0;0;3;5;3013;0;6337;5;4;
/org.eclipse.jdt.debug.tests/tests/org/eclipse/jdt/debug/tests/eval/LongOperatorsTests.java;1;0;1;1;0;0;0;1;222;0;1;1274;222;222;1;0;0;1;1;1274;0;1274;1;1;
/org.eclipse.ui.workbench/Eclipse UI/org/eclipse/ui/internal/commands/KeyConfigurationEvent.java;1;0;4;1;0;0;0;4;40;2;3;1500;40;40;2;1;0;4;4;2562;1;2823;3;1;
/org.eclipse.ui.workbench/Eclipse UI/org/eclipse/ui/internal/commands/old/ImageFactory.java;1;0;2;1;0;0;0;2;0;1;2;1222;0;0;1;0;0;2;2;1222;0;1695;2;1;
/org.eclipse.ui.workbench/Eclipse UI/org/eclipse/ui/commands/IActiveKeyConfigurationDefinition.java;1;0;4;1;0;0;0;4;2;2;3;1389;2;2;2;1;0;4;4;1417;1;1417;3;1;
/org.eclipse.ui.workbench/Eclipse UI/org/eclipse/ui/activities/DisposedException.java;1;0;2;1;0;0;0;2;0;1;2;2728;0;0;1;0;0;2;2;2728;0;2800;2;1;
/org.eclipse.swt.tests/JUnit Tests/org/eclipse/swt/tests/junit/Test_org_eclipse_swt_widgets_Menu.java;2;0;3;1;0;0;0;3;146;1;3;2123;250;250;1;0;0;3;3;2123;0;2648;3;2;
/org.eclipse.team.ftp/src/org/eclipse/team/internal/ftp/ui/subscriber/FTPSynchronizeParticipant.java;2;2;13;2;7;5;7;6;60;1;6;3240;185;185;2;0;2;6;13;5358;2;6337;11;2;
/org.eclipse.ltk.ui.refactoring/src/org/eclipse/ltk/ui/refactoring/RefactoringWizard.java;1;3;13;1;10;8;10;3;697;1;3;4965;915;915;3;0;2;3;13;5181;2;6352;11;1;
/org.eclipse.update.core/src/org/eclipse/update/core/SiteFeatureReferenceModel.java;2;1;3;1;2;2;2;1;6;0;1;890;12;12;1;0;0;1;3;890;0;6336;3;2;
/org.eclipse.ui.ide/src/org/eclipse/ui/views/markers/internal/Util.java;3;0;3;1;0;0;0;3;6;1;3;2208;8;8;1;0;0;3;3;2208;0;3214;3;3;
/org.eclipse.jdt.ui/ui/org/eclipse/jdt/internal/ui/packageview/GotoPackageAction.java;1;0;1;1;1;1;1;0;2;0;0;6340;2;2;1;0;0;0;1;6340;0;6340;1;1;
/org.eclipse.ui.intro/src/org/eclipse/ui/intro/internal/model/viewer/IntroModelContentProvider.java;1;0;3;1;1;1;1;2;115;1;2;4429;115;115;1;0;0;2;3;4429;0;5115;3;1;
/org.eclipse.team.cvs.core/src/org/eclipse/team/internal/ccvs/core/resources/CVSRemoteSyncElement.java;2;0;4;1;0;0;0;4;4;1;4;790;8;8;1;0;0;4;4;790;0;4216;4;2;
/org.eclipse.jdt.core/search/org/eclipse/jdt/internal/core/search/indexing/AbstractIndexer.java;3;0;9;1;1;1;1;8;592;1;8;91;816;816;1;0;0;8;9;91;0;5272;9;3;
/org.eclipse.jface/src/org/eclipse/jface/preference/JFacePreferences.java;4;1;4;1;2;2;2;2;20;1;2;4015;56;56;1;0;0;2;4;4015;0;6338;4;4;
/org.eclipse.jdt.core/model/org/eclipse/jdt/internal/core/hierarchy/IHierarchyRequestor.java;1;0;1;1;0;0;0;1;2;0;1;3560;2;2;1;0;0;1;1;3560;0;3560;1;1;
/org.eclipse.ui.externaltools/Ant Tools Support/org/eclipse/ui/externaltools/internal/ant/view/actions/AntOpenWithMenu.java;1;0;1;1;0;0;0;1;0;0;1;282;0;0;1;0;0;1;1;282;0;282;1;1;
/org.eclipse.jface.text/src/org/eclipse/jface/text/IInformationControl.java;3;1;4;1;2;2;2;2;35;1;2;3827;44;44;1;0;0;2;4;3827;0;6359;4;3;
/org.eclipse.ui.editors/src/org/eclipse/ui/internal/editors/quickdiff/QuickDiffMessages.java;3;0;4;1;1;1;1;3;40;1;3;1214;46;46;1;0;0;3;4;1214;0;6340;4;3;
/org.eclipse.ui.externaltools/Ant Tools Support/org/eclipse/ui/externaltools/internal/ant/launchConfigurations/AntConsoleColorProvider.java;1;0;1;1;0;0;0;1;0;0;1;282;0;0;1;0;0;1;1;282;0;282;1;1;
/org.eclipse.jdt.ui.tests.refactoring/resources/ExtractMethodWorkSpace/ExtractMethodTests/locals_in/A_test526.java;1;0;1;1;0;0;0;1;4;0;1;844;4;4;1;0;0;1;1;844;0;844;1;1;
/org.eclipse.ui.workbench/Eclipse UI/org/eclipse/ui/internal/activities/ActivityRequirementBindingDefinition.java;2;1;3;1;3;3;3;0;8;0;0;5760;10;10;1;0;0;0;3;5760;0;6338;3;2;
/org.eclipse.team.ui/src/org/eclipse/team/internal/ui/sync/actions/SyncAllAction.java;2;0;4;1;0;0;0;4;13;1;4;1155;16;16;1;0;0;4;4;1155;0;2632;4;2;
/org.eclipse.ui.workbench/Eclipse UI/org/eclipse/ui/internal/ILayoutContainer.java;4;1;6;2;3;3;3;3;18;2;2;4015;32;32;2;1;0;3;6;4015;1;6338;5;4;
/org.eclipse.ui.workbench/Eclipse UI/org/eclipse/ui/internal/commands/KeySupport.java;1;0;4;1;0;0;0;4;166;1;4;686;166;166;1;0;0;4;4;686;0;1077;4;1;
/org.eclipse.ui.externaltools/External Tools Base/org/eclipse/ui/externaltools/internal/model/ToolUtil.java;2;0;6;1;0;0;0;6;171;2;4;265;250;250;2;2;0;6;6;300;2;350;4;2;
/org.eclipse.team.ftp/src/org/eclipse/team/internal/ftp/subscriber/RemoteSynchronizationCache.java;1;0;1;1;0;0;0;1;0;0;1;3221;0;0;1;0;0;1;1;3221;0;3221;1;1;
/org.eclipse.jdt.ui/ui/org/eclipse/jdt/internal/ui/viewsupport/ImageDescriptorRegistry.java;2;0;2;1;1;1;1;1;2;0;1;4847;4;4;1;0;0;1;2;4847;0;6340;2;2;
/org.eclipse.team.webdav/src/org/eclipse/team/internal/ui/target/TargetAction.java;2;0;3;1;1;1;1;2;18;1;2;2495;20;20;1;0;0;2;3;2495;0;6337;3;2;
/org.eclipse.pde.ui/src/org/eclipse/pde/internal/ui/wizards/templates/HelloWorldNewWizard.java;3;1;5;1;4;4;4;1;12;0;1;3986;31;31;1;0;0;1;5;3986;0;6336;5;3;
/org.eclipse.jdt.core.tests.model/workspace/Formatter/test181/A_out.java;1;0;1;1;0;0;0;1;0;0;1;2425;0;0;1;0;0;1;1;2425;0;2425;1;1;
/org.eclipse.jdt.ui/core extension/org/eclipse/text/edits/TextEditCopier.java;1;0;3;1;0;0;0;3;14;2;2;1953;14;14;2;1;0;3;3;1985;1;1985;2;1;
/org.eclipse.team.webdav/src/org/eclipse/team/core/target/TargetOperation.java;1;0;1;1;0;0;0;1;0;0;1;3387;0;0;1;0;0;1;1;3387;0;3387;1;1;
/org.eclipse.jdt.core/codeassist/org/eclipse/jdt/internal/codeassist/complete/CompletionOnClassLiteralAccess.java;2;0;2;1;0;0;0;2;38;1;2;991;40;40;1;0;0;2;2;991;0;3560;2;2;
/org.eclipse.ui.workbench/Eclipse UI/org/eclipse/ui/internal/registry/Category.java;6;0;10;2;1;1;1;9;31;2;8;2279;115;115;2;1;0;9;10;3061;1;6338;9;6;
/org.eclipse.jdt.core.tests.model/workspace/Converter/src/test0042/Test.java;1;0;1;1;0;0;0;1;0;0;1;3714;0;0;1;0;0;1;1;3714;0;3714;1;1;
/org.eclipse.debug.ui/ui/org/eclipse/debug/internal/ui/views/console/ConsoleDocumentManager.java;3;1;13;2;3;3;3;10;124;1;10;1277;470;470;1;0;0;10;13;1277;0;5642;13;3;
/org.eclipse.jdt.ui/ui/org/eclipse/jdt/ui/jarpackager/IJarDescriptionWriter.java;1;0;1;1;1;1;1;0;2;0;0;6340;2;2;1;0;0;0;1;6340;0;6340;1;1;
/org.eclipse.jdt.junit.runtime/src/org/eclipse/jdt/internal/junit/runner/JUnitMessages.java;2;0;2;1;1;1;1;1;4;0;1;1359;4;4;1;0;0;1;2;1359;0;6340;2;2;
/org.eclipse.ui.workbench/Eclipse UI/org/eclipse/ui/internal/about/AboutBundleGroupData.java;2;2;3;1;3;2;3;0;21;0;0;5483;28;28;2;0;1;0;3;5483;1;6321;2;2;
/org.eclipse.jdt.core.tests.model/workspace/Converter/src/javadoc/testBug52908/X.java;1;0;1;1;0;0;0;1;0;0;1;4311;0;0;1;0;0;1;1;4311;0;4311;1;1;
/org.eclipse.jdt.ui.tests.refactoring/resources/IntroduceParameter/simple/NewInstance1.java;1;0;1;1;0;0;0;1;0;0;1;2281;0;0;1;0;0;1;1;2281;0;2281;1;1;
/org.eclipse.team.cvs.ui/src/org/eclipse/team/internal/ccvs/ui/subscriber/OverrideAndUpdateSubscriberOperation.java;2;1;6;1;3;3;3;3;10;1;3;4450;32;32;1;0;0;3;6;4450;0;6337;6;2;
/org.eclipse.jdt.core.tests.model/workspace/Formatter/test135/A_out.java;2;0;2;1;0;0;0;2;8;1;2;2424;8;8;1;0;0;2;2;2424;0;3362;2;2;
/org.eclipse.jdt.ui/ui/org/eclipse/jdt/ui/actions/OrganizeImportsAction.java;3;2;17;2;8;7;8;9;87;1;9;592;338;338;2;0;1;9;17;5651;1;6340;16;3;
/org.eclipse.jdt.core.tests.model/workspace/Converter/test0075/Test.java;1;0;1;1;0;0;0;1;0;0;1;3714;0;0;1;0;0;1;1;3714;0;3714;1;1;
/org.eclipse.jdt.core.tests.model/workspace/Formatter/test016/A_in.java;1;0;1;1;0;0;0;1;0;0;1;2425;0;0;1;0;0;1;1;2425;0;2425;1;1;
/org.eclipse.jdt.ui/ui/org/eclipse/jdt/internal/ui/text/JavaColorManager.java;1;0;1;1;1;1;1;0;2;0;0;6340;2;2;1;0;0;0;1;6340;0;6340;1;1;
/org.eclipse.core.resources/src/org/eclipse/core/internal/resources/ProjectDescription.java;3;2;9;1;6;5;6;3;359;1;3;3356;717;717;2;0;1;3;9;5530;1;5897;8;3;
/org.eclipse.debug.core/core/org/eclipse/debug/internal/core/sourcelookup/containers/ZipEntryStorage.java;1;0;2;1;0;0;0;2;0;1;2;4091;0;0;1;0;0;2;2;4091;0;4949;2;1;
/org.eclipse.jdt.ui.examples.javafamily/src/org/eclipse/jsp/launching/ToggleJspBreakpointRulerActionDelegate.java;1;0;1;1;0;0;0;1;0;0;1;1385;0;0;1;0;0;1;1;1385;0;1385;1;1;
/org.eclipse.jdt.ui.tests.refactoring/resources/InlineMethodWorkspace/TestCases/cast_in/TestHierarchyOverloadedPrimitives.java;1;0;1;1;0;0;0;1;0;0;1;955;0;0;1;0;0;1;1;955;0;955;1;1;
/org.eclipse.jdt.core.tests.model/workspace/JavaSearch/src/j1/JavadocSearched.java;1;0;1;1;0;0;0;1;0;0;1;3081;0;0;1;0;0;1;1;3081;0;3081;1;1;
/org.eclipse.help.tests/src/org/eclipse/help/tests/base/TestHTMLParser.java;1;1;3;1;2;2;2;1;28;0;1;2781;50;50;1;0;0;1;3;2781;0;6337;3;1;
/org.eclipse.jdt.ui.tests.refactoring/resources/ChangeTypeRefactoring/positive/A_testLocalVarDecl_in.java;1;0;1;1;0;0;0;1;0;0;1;2844;0;0;1;0;0;1;1;2844;0;2844;1;1;
/org.eclipse.core.runtime/src/org/eclipse/core/runtime/ILog.java;2;0;8;1;2;1;2;6;108;1;6;3013;234;234;2;0;1;6;8;5117;1;5117;7;2;
/org.eclipse.jdt.ui/ui/org/eclipse/jdt/internal/ui/compare/JavaTextViewerCreator.java;1;0;1;1;1;1;1;0;2;0;0;6340;2;2;1;0;0;0;1;6340;0;6340;1;1;
/org.eclipse.update.ui.forms/src/org/eclipse/ui/forms/internal/parts/RichTextModel.java;1;0;5;1;0;0;0;5;10;2;4;2898;23;23;2;1;0;5;5;3095;1;3095;4;1;
/org.eclipse.jdt.ui/core extension/org/eclipse/jdt/internal/corext/dom/fragments/Util.java;2;1;2;1;2;2;2;0;33;0;0;6051;35;35;1;0;0;0;2;6051;0;6340;2;2;
/org.eclipse.ui.workbench/Eclipse UI/org/eclipse/ui/activities/ws/WorkbenchActivityHelper.java;1;0;1;1;0;0;0;1;4;0;1;3066;4;4;1;0;0;1;1;3066;0;3066;1;1;
/org.eclipse.jdt.core.tests.model/workspace/Formatter/test231/A_out.java;1;0;1;1;0;0;0;1;0;0;1;2437;0;0;1;0;0;1;1;2437;0;2437;1;1;
/org.eclipse.pde.ui/src_Forms/org/eclipse/pde/internal/ui/neweditor/runtime/ExportSection.java;2;0;4;1;0;0;0;4;4;1;4;4406;6;6;1;0;0;4;4;4406;0;4919;4;2;
/org.eclipse.jdt.ui.tests.refactoring/resources/ExtractMethodWorkSpace/ExtractMethodTests/branch_in/A_test753.java;1;0;2;1;0;0;0;2;4;1;2;844;4;4;1;0;0;2;2;844;0;2256;2;1;
/org.eclipse.core.runtime/src/org/eclipse/core/internal/registry/ExtensionDelta.java;4;1;9;2;3;3;3;6;108;2;5;2105;226;226;2;1;0;6;9;3164;1;6340;8;4;
/org.eclipse.jdt.core/dom/org/eclipse/jdt/core/dom/ContinueStatement.java;3;0;7;1;1;1;1;6;66;1;6;3560;83;83;1;0;0;6;7;3560;0;5272;7;3;
/org.eclipse.jdt.ui.tests.refactoring/resources/InlineMethodWorkspace/TestCases/import_out/TestUseInLocalClass.java;1;0;1;1;0;0;0;1;4;0;1;845;4;4;1;0;0;1;1;845;0;845;1;1;
/org.eclipse.ui.externaltools/Ant Editor/org/eclipse/ui/externaltools/internal/ant/editor/text/XMLAnnotationIterator.java;1;0;1;1;0;0;0;1;0;0;1;282;0;0;1;0;0;1;1;282;0;282;1;1;
/org.eclipse.pde.build/src/org/eclipse/pde/internal/build/SourceFeatureInformation.java;2;0;7;1;1;1;1;6;5;1;6;447;10;10;1;0;0;6;7;447;0;5145;7;2;
/org.eclipse.jdt.core.tests.compiler/src/org/eclipse/jdt/core/tests/runtime/AbstractReader.java;1;0;1;1;0;0;0;1;2;0;1;3560;2;2;1;0;0;1;1;3560;0;3560;1;1;
/org.eclipse.update.ui/src/org/eclipse/update/internal/ui/wizards/CurrentActivitiesTableViewer.java;1;0;2;1;0;0;0;2;0;1;2;4434;0;0;1;0;0;2;2;4434;0;4523;2;1;
/org.eclipse.team.cvs.ui/src/org/eclipse/team/internal/ccvs/ui/subscriber/CVSMergeSubscriberPage.java;1;0;1;1;0;0;0;1;0;0;1;2446;0;0;1;0;0;1;1;2446;0;2446;1;1;
/org.eclipse.jdt.ui.tests.refactoring/resources/TypeConstraints/A_testConstraints15.java;1;0;1;1;0;0;0;1;0;0;1;65;0;0;1;0;0;1;1;65;0;65;1;1;
/org.eclipse.ui.tests/Eclipse JFace Tests/org/eclipse/jface/preference/StringConverterTest.java;2;0;3;2;0;0;0;3;24;2;2;4235;24;24;2;1;0;3;3;4560;1;4560;2;2;
/org.eclipse.jdt.core.tests.model/workspace/Formatter/test045/A_out.java;1;0;2;1;0;0;0;2;3;1;2;2425;3;3;1;0;0;2;2;2425;0;4173;2;1;
/org.eclipse.pde.core/src/org/eclipse/pde/internal/core/ibundle/IBundleFragment.java;1;1;2;1;2;2;2;0;4;0;0;5445;4;4;1;0;0;0;2;5445;0;6336;2;1;
/org.eclipse.jface/src/org/eclipse/jface/util/TransferDropTargetListener.java;1;0;1;1;0;0;0;1;0;0;1;179;0;0;1;0;0;1;1;179;0;179;1;1;
/org.eclipse.ui.ide/src/org/eclipse/ui/views/markers/internal/DeferredQueue.java;1;0;1;1;0;0;0;1;0;0;1;3214;0;0;1;0;0;1;1;3214;0;3214;1;1;
/org.eclipse.swt/Eclipse SWT/common/org/eclipse/swt/layout/FormData.java;1;0;4;1;0;0;0;4;123;1;4;880;237;237;1;0;0;4;4;880;0;2285;4;1;
/org.eclipse.compare/compare/org/eclipse/compare/internal/CompareAction.java;1;0;4;1;1;1;1;3;13;1;3;662;25;25;1;0;0;3;4;662;0;6354;4;1;
/org.eclipse.update.ui.forms/Eclipse Forms/org/eclipse/ui/forms/parts/Form.java;1;0;4;1;0;0;0;4;298;3;2;3119;298;298;3;2;0;4;4;3133;2;3133;2;1;
/org.eclipse.pde.core/srcnew/org/eclipse/pde/internal/core/plugin/AbstractModelUpdateStrategy.java;1;0;1;1;1;1;1;0;0;0;0;5431;0;0;1;0;0;0;1;5431;0;5431;1;1;
/org.eclipse.ant.ui/Ant Editor/org/eclipse/ant/ui/internal/editor/text/IReconcilingParticipant.java;1;0;2;1;0;0;0;2;0;1;2;250;0;0;1;0;0;2;2;250;0;1811;2;1;
/org.eclipse.ui.workbench/Eclipse UI/org/eclipse/ui/presentations/IPresentablePart.java;5;2;15;2;5;3;5;10;51;2;8;4469;158;158;2;2;2;10;15;4521;4;6039;11;5;
/org.eclipse.team.ui/src/org/eclipse/team/internal/ui/ProjectSetImportWizard.java;1;0;2;1;0;0;0;2;4;1;2;917;4;4;1;0;0;2;2;917;0;993;2;1;
/org.eclipse.jdt.ui.tests.refactoring/resources/ExtractMethodWorkSpace/ExtractMethodTests/branch_out/A_test754.java;1;0;4;1;0;0;0;4;6;1;4;844;6;6;1;0;0;4;4;844;0;2256;4;1;
/org.eclipse.text.tests/src/org/eclipse/text/tests/link/InclusivePositionUpdaterTest.java;1;0;2;1;1;1;1;1;6;0;1;5082;6;6;1;0;0;1;2;5082;0;6340;2;1;
/org.eclipse.text/src/org/eclipse/jface/text/source/IAnnotationModelListenerExtension.java;1;1;3;1;2;2;2;1;30;0;1;2243;38;38;1;0;0;1;3;2243;0;6300;3;1;
/org.eclipse.team.cvs.ui/src/org/eclipse/team/internal/ccvs/ui/TagConfigurationDialog.java;2;1;8;1;3;3;3;5;70;1;5;276;123;123;1;0;0;5;8;276;0;6337;8;2;
/org.eclipse.team.ui/src/org/eclipse/team/ui/synchronize/StructuredViewerAdvisor.java;2;0;4;2;2;1;2;2;539;1;2;4632;549;549;2;0;1;2;4;5358;1;5358;3;2;
/org.eclipse.pde.ui/src_Forms/org/eclipse/pde/internal/ui/neweditor/runtime/PackagePrefixesSection.java;2;0;3;1;0;0;0;3;2;1;3;4406;2;2;1;0;0;3;3;4406;0;4906;3;2;
/org.eclipse.ui.workbench/Eclipse UI/org/eclipse/ui/internal/themes/IViewThemeDescriptor.java;2;0;2;1;0;0;0;2;0;1;2;3684;0;0;1;0;0;2;2;3684;0;4471;2;2;
/org.eclipse.jdt.core/compiler/org/eclipse/jdt/internal/compiler/ast/MessageSend.java;2;0;16;1;1;1;1;15;27;2;14;41;115;115;2;1;0;15;16;1329;1;6129;15;2;
/org.eclipse.ui.workbench/Eclipse UI/org/eclipse/ui/keys/FormatManager.java;1;0;4;1;0;0;0;4;29;2;3;3169;29;29;2;1;0;4;4;3214;1;3236;3;1;
/org.eclipse.team.cvs.core/src/org/eclipse/team/internal/ccvs/core/client/RDiff.java;1;0;2;1;0;0;0;2;46;1;2;2497;46;46;1;0;0;2;2;2497;0;2529;2;1;
/org.eclipse.jdt.core/search/org/eclipse/jdt/internal/core/index/EntryResult.java;2;0;4;1;0;0;0;4;88;1;4;3385;92;92;1;0;0;4;4;3385;0;4449;4;2;
/org.eclipse.swt.tests/JUnit Tests/org/eclipse/swt/tests/junit/Test_org_eclipse_swt_events_ControlAdapter.java;1;0;1;1;0;0;0;1;16;0;1;2175;16;16;1;0;0;1;1;2175;0;2175;1;1;
/org.eclipse.jdt.junit/src/org/eclipse/jdt/internal/junit/ui/RemoteTestRunnerClient.java;2;1;7;1;2;2;2;5;249;1;5;3417;306;306;1;0;0;5;7;3417;0;6340;7;2;
/org.eclipse.jdt.ui.tests.refactoring/resources/SurroundWithWorkSpace/SurroundWithTests/trycatch_in/TestWrappedLocal4.java;1;0;2;1;0;0;0;2;5;1;2;155;7;7;1;0;0;2;2;155;0;845;2;1;
/org.eclipse.help.tests/src/org/eclipse/help/tests/AllHelpTests.java;1;1;2;1;2;2;2;0;16;0;0;5827;32;32;1;0;0;0;2;5827;0;6337;2;1;
/org.eclipse.ui.workbench.texteditor.tests/src/org/eclipse/ui/workbench/texteditor/tests/WorkbenchTextEditorTestSuite.java;1;0;1;1;1;1;1;0;0;0;0;5239;0;0;1;0;0;0;1;5239;0;5239;1;1;
/org.eclipse.jdt.core.tests.model/workspace/Converter/src/test0004/Test.java;1;0;1;1;0;0;0;1;0;0;1;3714;0;0;1;0;0;1;1;3714;0;3714;1;1;
/org.eclipse.ui.workbench/Eclipse UI/org/eclipse/ui/internal/presentations/SizeCache.java;1;0;2;1;0;0;0;2;0;1;2;4691;0;0;1;0;0;2;2;4691;0;5003;2;1;
/org.eclipse.debug.ui/ui/org/eclipse/debug/internal/ui/views/expression/ExpressionViewContentProvider.java;3;0;10;1;0;0;0;10;21;1;10;534;92;92;1;0;0;10;10;534;0;2564;10;3;
/org.eclipse.core.runtime.osgi/src/org/eclipse/core/runtime/Path.java;1;0;2;1;0;0;0;2;1487;1;2;3013;1487;1487;1;0;0;2;2;3013;0;3030;2;1;
/org.eclipse.team.ui/src/org/eclipse/team/internal/ui/synchronize/actions/AbstractParticipantActionContribution.java;1;0;1;1;0;0;0;1;0;0;1;5093;0;0;1;0;0;1;1;5093;0;5093;1;1;
/org.eclipse.help.base/src/org/eclipse/help/internal/search/SmartAnalyzer.java;1;1;4;1;3;3;3;1;15;0;1;1740;23;23;1;0;0;1;4;1740;0;6337;4;1;
/org.eclipse.jdt.ui.tests/ui/org/eclipse/jdt/ui/tests/dialogs/WizardsTest.java;3;1;4;1;2;2;2;2;17;1;2;3830;33;33;1;0;0;2;4;3830;0;6340;4;3;
/org.eclipse.team.cvs.ui/src/org/eclipse/team/internal/ccvs/ui/CVSRemoveResolutionGenerator.java;1;0;1;1;0;0;0;1;0;0;1;885;0;0;1;0;0;1;1;885;0;885;1;1;
/org.eclipse.ui.externaltools/Ant Tools Support/org/eclipse/ui/externaltools/internal/ant/launchConfigurations/AntClasspathTab.java;2;0;3;1;0;0;0;3;11;1;3;125;19;19;1;0;0;3;3;125;0;282;3;2;
/org.eclipse.team.examples.filesystem/src/org/eclipse/team/examples/filesystem/deployment/FileSystemDeploymentProvider.java;2;0;3;1;0;0;0;3;55;1;3;2806;55;55;1;0;0;3;3;2806;0;4633;3;2;
/org.eclipse.jdt.core.tests.model/workspace/Formatter/test176/A_in.java;1;0;1;1;0;0;0;1;0;0;1;2425;0;0;1;0;0;1;1;2425;0;2425;1;1;
/org.eclipse.ui.workbench/Eclipse UI/org/eclipse/ui/commands/ICommandListener.java;2;0;10;1;1;1;1;9;29;2;8;1119;98;98;2;1;0;9;10;2562;1;5231;9;2;
/org.eclipse.jdt.ui/core extension/org/eclipse/jdt/internal/corext/codemanipulation/CompositeCodeBlock.java;1;0;1;1;0;0;0;1;0;0;1;155;0;0;1;0;0;1;1;155;0;155;1;1;
/org.eclipse.jdt.ui.tests.refactoring/resources/MoveMembers/test14/out/B.java;1;0;1;1;0;0;0;1;1;0;1;1522;1;1;1;0;0;1;1;1522;0;1522;1;1;
/org.eclipse.swt/Eclipse SWT/win32/org/eclipse/swt/widgets/WidgetTable.java;1;0;1;1;0;0;0;1;0;0;1;1173;0;0;1;0;0;1;1;1173;0;1173;1;1;
/org.eclipse.ltk.core.refactoring/src/org/eclipse/ltk/core/refactoring/IUndoManagerListener.java;1;2;5;1;3;2;3;2;25;1;2;4845;46;46;2;0;1;2;5;6338;1;6338;4;1;
/org.eclipse.update.ui/srcnew/org/eclipse/update/internal/ui/views/FindUpdatesAction.java;3;0;4;3;0;0;0;4;58;3;2;751;58;58;3;2;0;4;4;751;2;825;2;3;
/org.eclipse.core.tests.runtime/src/org/eclipse/core/tests/internal/plugins/PluginResolveTest_30.java;1;0;1;1;0;0;0;1;0;0;1;3014;0;0;1;0;0;1;1;3014;0;3014;1;1;
/org.eclipse.update.core/src/org/eclipse/update/core/IPluginEntry.java;2;1;3;1;2;2;2;1;6;0;1;890;12;12;1;0;0;1;3;890;0;6336;3;2;
/org.eclipse.jdt.ui.tests.refactoring/test cases/org/eclipse/jdt/ui/tests/refactoring/infra/RefactoringTestPlugin.java;1;0;1;1;1;1;1;0;2;0;0;6340;2;2;1;0;0;0;1;6340;0;6340;1;1;
/org.eclipse.ant.tests.ui/Ant Editor Tests/org/eclipse/ant/tests/ui/editor/formatter/XmlTagFormatterTest.java;1;1;6;1;2;2;2;4;14;2;2;4583;24;24;2;2;0;4;6;4583;2;5865;4;1;
/org.eclipse.ui.workbench/Eclipse UI/org/eclipse/ui/ICapabilityWizard.java;1;0;1;1;0;0;0;1;0;0;1;2737;0;0;1;0;0;1;1;2737;0;2737;1;1;
/org.eclipse.jdt.core/dom/org/eclipse/jdt/core/dom/SingleVariableDeclaration.java;4;2;20;1;6;4;6;14;276;2;12;3560;680;680;2;2;2;14;20;4489;4;5781;16;4;
/org.eclipse.ui.workbench/Eclipse UI/org/eclipse/ui/internal/WorkbenchPage.java;13;2;81;3;24;21;24;57;5419;4;48;368;7668;7668;4;9;3;57;81;4758;12;6338;69;13;
/org.eclipse.search/new search/org/eclipse/search2/internal/ui/basic/views/ToggleModeAction.java;1;0;3;1;0;0;0;3;8;1;3;3474;8;8;1;0;0;3;3;3474;0;4045;3;1;
/org.eclipse.compare/compare/org/eclipse/compare/rangedifferencer/RangeDifferencer.java;1;0;3;1;1;1;1;2;2;1;2;1289;5;5;1;0;0;2;3;1289;0;6322;3;1;
/org.eclipse.ui.workbench/Eclipse UI/org/eclipse/ui/internal/registry/NavigatorRegistryReader.java;1;0;1;1;0;0;0;1;0;0;1;947;0;0;1;0;0;1;1;947;0;947;1;1;
/org.eclipse.swt/Eclipse SWT PI/win32/org/eclipse/swt/internal/win32/OSVERSIONINFOW.java;2;0;2;1;0;0;0;2;1;1;2;957;1;1;1;0;0;2;2;957;0;2915;2;2;
/org.eclipse.core.runtime/src/org/eclipse/core/runtime/preferences/IPreferenceNodeVisitor.java;1;0;3;1;0;0;0;3;6;1;3;4384;8;8;1;0;0;3;3;4384;0;5084;3;1;
/org.eclipse.ui.workbench/Eclipse UI/org/eclipse/ui/commands/internal/CoreRegistry.java;1;0;2;1;0;0;0;2;0;1;2;786;0;0;1;0;0;2;2;786;0;956;2;1;
/org.eclipse.ant.ui/Ant Tools Support/org/eclipse/ant/internal/ui/model/ColorManager.java;1;1;4;1;2;2;2;2;4;1;2;1811;4;4;1;0;0;2;4;1811;0;6336;4;1;
/org.eclipse.jdt.ui/ui/org/eclipse/jdt/internal/ui/preferences/CodeStylePreferencePage.java;2;0;2;1;1;1;1;1;2;0;1;4629;2;2;1;0;0;1;2;4629;0;6340;2;2;
/org.eclipse.ui.workbench/Eclipse UI/org/eclipse/ui/presentations/IPresentationSite.java;2;0;3;2;0;0;0;3;2;2;2;4469;2;2;2;1;0;3;3;4469;1;4504;2;2;
/org.eclipse.update.core/src/org/eclipse/update/internal/api/operations/IRevertConfigurationOperation.java;1;0;2;1;0;0;0;2;0;1;2;3270;0;0;1;0;0;2;2;3270;0;4928;2;1;
/org.eclipse.pde.core/src/org/eclipse/pde/internal/core/NLResourceHelper.java;2;1;4;1;3;3;3;1;22;0;1;4203;42;42;1;0;0;1;4;4203;0;6336;4;2;
/org.eclipse.jdt.ui/core refactoring/org/eclipse/ltk/core/refactoring/Refactoring.java;2;0;4;1;0;0;0;4;123;1;4;4575;129;129;1;0;0;4;4;4575;0;4864;4;2;
/org.eclipse.team.core/src/org/eclipse/team/internal/core/subscribers/WorkingSetFilteredSyncInfoCollector.java;2;2;3;2;3;2;3;0;14;0;0;5362;15;15;2;0;1;0;3;5362;1;5596;2;2;
/org.eclipse.swt/Eclipse SWT Mozilla/common/org/eclipse/swt/internal/mozilla/XPCOM.java;2;1;16;1;3;3;3;13;231;1;13;1654;348;348;1;0;0;13;16;1654;0;6342;16;2;
/org.eclipse.text/src/org/eclipse/jface/text/IDocumentPartitionerExtension2.java;2;0;3;1;1;1;1;2;84;1;2;1520;148;148;1;0;0;2;3;1520;0;6296;3;2;
/org.eclipse.pde.ui/src/org/eclipse/pde/internal/ui/wizards/extension/NewExtensionTemplateWizard.java;3;1;7;1;5;5;5;2;6;1;2;2184;16;16;1;0;0;2;7;2184;0;6336;7;3;
/org.eclipse.jdt.ui/ui/org/eclipse/jdt/internal/ui/util/TabFolderLayout.java;1;0;1;1;1;1;1;0;2;0;0;6340;2;2;1;0;0;0;1;6340;0;6340;1;1;
/org.eclipse.jface.text/src/org/eclipse/jface/text/IMarkRegionTarget.java;1;0;1;1;1;1;1;0;2;0;0;6340;2;2;1;0;0;0;1;6340;0;6340;1;1;
/org.eclipse.jdt.debug/jdi interfaces/com/sun/jdi/LocalVariable.java;1;0;1;1;0;0;0;1;3;0;1;4267;3;3;1;0;0;1;1;4267;0;4267;1;1;
/org.eclipse.ui.workbench/Eclipse UI/org/eclipse/ui/internal/KeyTable.java;1;0;1;1;0;0;0;1;0;0;1;2179;0;0;1;0;0;1;1;2179;0;2179;1;1;
/org.eclipse.jdt.core.tests.model/workspace/JavaSearch/src/j1/AnnValidRef.java;1;0;2;1;0;0;0;2;0;1;2;2661;0;0;1;0;0;2;2;2661;0;3081;2;1;
/org.eclipse.jdt.core.tests.model/workspace/Formatter/test364/A_out.java;1;0;1;1;0;0;0;1;0;0;1;3128;0;0;1;0;0;1;1;3128;0;3128;1;1;
/org.eclipse.update.ui/srcnew/org/eclipse/update/internal/ui/forms/ConfigurationPreviewForm.java;3;0;8;1;0;0;0;8;69;3;6;480;77;77;3;2;0;8;8;489;2;825;6;3;
/org.eclipse.jface.text/src/org/eclipse/jface/text/rules/WordRule.java;1;1;2;1;2;2;2;0;4;0;0;5123;6;6;1;0;0;0;2;5123;0;6340;2;1;
/org.eclipse.jdt.ui/ui/org/eclipse/jdt/internal/ui/preferences/formatter/ModifyDialogTabPage.java;1;1;14;1;2;2;2;12;288;2;11;3103;833;833;2;1;0;12;14;3103;1;5890;13;1;
/org.eclipse.jdt.core/search/org/eclipse/jdt/internal/core/search/Util.java;3;0;3;1;0;0;0;3;87;1;3;729;88;88;1;0;0;3;3;729;0;3194;3;3;
/org.eclipse.swt.tests/JUnit Tests/org/eclipse/swt/tests/junit/Test_org_eclipse_swt_events_ShellListener.java;1;0;1;1;0;0;0;1;16;0;1;2175;16;16;1;0;0;1;1;2175;0;2175;1;1;
/org.eclipse.ui.workbench/Eclipse UI/org/eclipse/ui/activities/IActivationServiceEvent.java;1;0;2;1;0;0;0;2;0;1;2;2728;0;0;1;0;0;2;2;2728;0;2800;2;1;
/org.eclipse.ui.workbench.texteditor/src/org/eclipse/ui/internal/texteditor/LinearLayouter.java;2;0;3;1;1;1;1;2;58;1;2;2564;64;64;1;0;0;2;3;2564;0;6340;3;2;
/org.eclipse.osgi/core/framework/org/eclipse/osgi/framework/internal/core/Filter.java;3;0;4;1;1;1;1;3;3189;1;3;3013;3191;3191;1;0;0;3;4;3013;0;5116;4;3;
/org.eclipse.jdt.debug/model/org/eclipse/jdt/internal/debug/core/JDIDebugMessages.java;2;0;1;2;0;0;0;1;15;0;1;3969;15;15;1;0;0;1;1;3969;0;3969;1;2;
/org.eclipse.jdt.ui/core refactoring/org/eclipse/jdt/internal/corext/refactoring/typeconstraints/StrictSubtypeOperator.java;1;0;3;1;0;0;0;3;2;1;3;64;2;2;1;0;0;3;3;64;0;1600;3;1;
/org.eclipse.ui.workbench/Eclipse UI/org/eclipse/ui/ISaveablePart.java;3;1;4;1;3;3;3;1;4;0;1;2919;10;10;1;0;0;1;4;2919;0;6338;4;3;
/org.eclipse.osgi/eclipseAdaptor/src/org/eclipse/core/runtime/adaptor/EclipseLog.java;3;1;13;2;6;6;6;7;335;2;5;3892;455;455;2;2;0;7;13;3892;2;6150;11;3;
/org.eclipse.jdt.core.tests.model/workspace/Converter/test0110/Test.java;1;0;1;1;0;0;0;1;0;0;1;3714;0;0;1;0;0;1;1;3714;0;3714;1;1;
/org.eclipse.swt/Eclipse SWT/win32/org/eclipse/swt/widgets/DirectoryDialog.java;4;1;11;2;3;3;3;8;37;2;6;148;133;133;2;2;0;8;11;148;2;6352;9;4;
/org.eclipse.ui.ide/extensions/org/eclipse/ui/actions/OpenFileAction.java;1;0;1;1;0;0;0;1;0;0;1;2263;0;0;1;0;0;1;1;2263;0;2263;1;1;
/org.eclipse.ui.workbench.texteditor/src/org/eclipse/ui/texteditor/TextEditorAction.java;2;2;8;2;4;3;4;4;56;1;4;1520;99;99;2;0;1;4;8;6334;1;6334;7;2;
/org.eclipse.jdt.debug/model/org/eclipse/jdt/debug/core/IJavaBreakpointListener.java;3;0;4;1;0;0;0;4;57;2;3;2210;114;114;2;1;0;4;4;2227;1;2970;3;3;
/org.eclipse.core.variables/src/VariablesPlugin.java;1;0;1;1;0;0;0;1;0;0;1;2271;0;0;1;0;0;1;1;2271;0;2271;1;1;
/org.eclipse.core.tests.resources/src/org/eclipse/core/tests/resources/regression/Bug_29116.java;1;0;1;1;1;1;1;0;9;0;0;5147;9;9;1;0;0;0;1;5147;0;5147;1;1;
/org.eclipse.ui.workbench/Eclipse UI/org/eclipse/ui/internal/skins/StackDragListener.java;1;0;2;1;0;0;0;2;0;1;2;4328;0;0;1;0;0;2;2;4328;0;4438;2;1;
/org.eclipse.core.tests.resources/src/org/eclipse/core/tests/resources/IPathVariableTest.java;2;0;3;1;2;1;2;1;35;0;1;2465;44;44;2;0;1;1;3;5147;1;5147;2;2;
/org.eclipse.ant.ui/Ant Tools Support/org/eclipse/ant/ui/internal/launchConfigurations/AntBuilderTabGroup.java;2;0;4;1;0;0;0;4;4;1;4;250;7;7;1;0;0;4;4;250;0;1811;4;2;
/org.eclipse.ui.views/src/org/eclipse/ui/views/markers/internal/TableSorter.java;2;0;3;1;0;0;0;3;10;1;3;755;10;10;1;0;0;3;3;755;0;2738;3;2;
/org.eclipse.pde.ui/src/org/eclipse/pde/internal/ui/editor/manifest/PointUsageSection.java;2;0;6;1;1;1;1;5;10;1;5;648;22;22;1;0;0;5;6;648;0;5431;6;2;
/org.eclipse.pde.core/src/org/eclipse/pde/core/osgi/bundle/IBundlePluginModel.java;2;1;4;1;3;3;3;1;16;0;1;4203;24;24;1;0;0;1;4;4203;0;5445;4;2;
/org.eclipse.update.ui/src/org/eclipse/update/internal/ui/model/IFeatureAdapter.java;1;0;1;1;0;0;0;1;5;0;1;890;5;5;1;0;0;1;1;890;0;890;1;1;
/org.eclipse.help/src/org/eclipse/help/internal/context/PluginsContexts.java;1;0;2;1;1;1;1;1;6;0;1;4893;6;6;1;0;0;1;2;4893;0;6337;2;1;
/org.eclipse.jdt.ui.tests.refactoring/resources/ExtractMethodWorkSpace/ExtractMethodTests/expression_out/A_test603.java;1;0;3;1;0;0;0;3;4;1;3;844;4;4;1;0;0;3;3;844;0;1474;3;1;
/org.eclipse.jdt.core.tests.model/workspace/Converter/src/javadoc/testBug65253/TestD.java;1;0;1;1;1;1;1;0;0;0;0;6100;0;0;1;0;0;0;1;6100;0;6100;1;1;
/org.eclipse.jdt.ui.tests.refactoring/resources/ConvertAnonymousToNested/canConvert/A_test28_out.java;2;0;2;1;0;0;0;2;8;1;2;3291;8;8;1;0;0;2;2;3291;0;3434;2;2;
/org.eclipse.jdt.core/codeassist/org/eclipse/jdt/internal/codeassist/complete/CompletionOnClassReference.java;1;0;2;1;0;0;0;2;8;1;2;991;10;10;1;0;0;2;2;991;0;3557;2;1;
/org.eclipse.team.cvs.core/src/org/eclipse/team/internal/ccvs/core/CVSRevisionOnBranchCompareCriteria.java;1;0;1;1;0;0;0;1;0;0;1;2711;0;0;1;0;0;1;1;2711;0;2711;1;1;
/org.eclipse.pde.runtime/src/org/eclipse/pde/internal/runtime/registry/RegistrySearchMenu.java;1;0;3;1;0;0;0;3;50;1;3;3933;50;50;1;0;0;3;3;3933;0;4090;3;1;
/org.eclipse.ui.workbench/Eclipse UI/org/eclipse/ui/commands/ICommandManager.java;3;1;35;2;2;2;2;33;752;2;25;1119;2315;2315;2;8;0;33;35;1222;8;6338;27;3;
/org.eclipse.swt/Eclipse SWT/win32/org/eclipse/swt/widgets/Display.java;7;5;81;3;19;14;19;62;187;3;45;13;1954;1954;5;17;5;62;81;5527;22;6352;59;7;
/org.eclipse.core.expressions.tests/src/org/eclipse/core/internal/expressions/tests/PropertyTesterTests.java;1;1;5;1;3;3;3;2;62;1;2;4108;112;112;1;0;0;2;5;4108;0;6340;5;1;
/org.eclipse.pde.build/src_ant/org/eclipse/pde/internal/build/tasks/PluginVersionReplaceTask.java;2;2;9;1;7;6;7;2;143;1;2;4175;201;201;2;0;1;2;9;6340;1;6340;8;2;
/org.eclipse.ui.workbench/Eclipse UI/org/eclipse/ui/internal/presentations/SystemMenuMoveView.java;2;0;2;1;1;1;1;1;0;0;1;4680;0;0;1;0;0;1;2;4680;0;5173;2;2;
/org.eclipse.pde.ui/src/org/eclipse/pde/internal/ui/search/PluginSearchLabelProvider.java;3;1;4;1;2;2;2;2;4;1;2;2184;14;14;1;0;0;2;4;2184;0;6336;4;3;
/org.eclipse.ui.ide/src/org/eclipse/ui/internal/ide/registry/Capability.java;1;0;2;1;0;0;0;2;2;1;2;2264;2;2;1;0;0;2;2;2264;0;2616;2;1;
/org.eclipse.ltk.ui.refactoring/src/org/eclipse/ltk/internal/ui/refactoring/ChangeExceptionHandler.java;1;1;4;1;3;3;3;1;3;0;1;4965;7;7;1;0;0;1;4;4965;0;5710;4;1;
/org.eclipse.jdt.core.tests.model/workspace/Converter/junit/swingui/TestRunner.java;1;0;2;1;0;0;0;2;311;1;2;787;311;311;1;0;0;2;2;787;0;3714;2;1;
/org.eclipse.team.core/src/org/eclipse/team/core/subscribers/ISubscriberChangeListener.java;2;1;5;1;3;3;3;2;44;1;2;3966;70;70;1;0;0;2;5;3966;0;6336;5;2;
/org.eclipse.jdt.ui/ui refactoring/org/eclipse/jdt/internal/ui/refactoring/contentassist/TempNameProcessor.java;1;0;1;1;1;1;1;0;0;0;0;5224;0;0;1;0;0;0;1;5224;0;5224;1;1;
/org.eclipse.jdt.ui/ui/org/eclipse/jdt/internal/ui/actions/ConfigureContainerAction.java;2;1;3;1;2;2;2;1;39;0;1;4407;55;55;1;0;0;1;3;4407;0;5438;3;2;
/org.eclipse.jdt.ui.tests.refactoring/resources/ExtractMethodWorkSpace/ExtractMethodTests/locals_out/A_test538.java;1;0;2;1;0;0;0;2;4;1;2;130;5;5;1;0;0;2;2;130;0;844;2;1;
/org.eclipse.jdt.ui.tests.refactoring/resources/RenameVirtualMethodInClass/test36/in/A.java;1;0;1;1;0;0;0;1;0;0;1;1653;0;0;1;0;0;1;1;1653;0;1653;1;1;
/org.eclipse.ui.workbench/Eclipse UI/org/eclipse/ui/internal/chris/roles/AbstractMutableRoleRegistry.java;1;0;4;1;0;0;0;4;4;2;3;1952;8;8;2;1;0;4;4;2207;1;2207;3;1;
/org.eclipse.team.tests.cvs.core/src/org/eclipse/team/tests/ccvs/core/AllCoreTests.java;1;0;1;1;0;0;0;1;0;0;1;2632;0;0;1;0;0;1;1;2632;0;2632;1;1;
/org.eclipse.jdt.core/model/org/eclipse/jdt/internal/core/eval/GlobalVariableWrapper.java;1;0;1;1;0;0;0;1;2;0;1;3560;2;2;1;0;0;1;1;3560;0;3560;1;1;
/org.eclipse.sdk.tests-feature/plugins/org.eclipse.perfmsr.core/src/org/eclipse/perfmsr/core/ConstantsCore.java;2;1;3;1;2;2;2;1;10;0;1;4845;16;16;1;0;0;1;3;4845;0;6342;3;2;
/org.eclipse.jdt.ui/ui/org/eclipse/jdt/internal/ui/preferences/TodoTaskPreferencePage.java;2;1;3;1;2;2;2;1;4;0;1;2460;8;8;1;0;0;1;3;2460;0;6340;3;2;
/org.eclipse.jdt.core.tests.compiler/src/org/eclipse/jdt/core/tests/compiler/parser/SelectionTest2.java;3;0;7;1;0;0;0;7;7;1;7;69;27;27;1;0;0;7;7;69;0;3560;7;3;
/org.eclipse.team.webdav/src/org/eclipse/team/ui/target/subscriber/TeamBlockingRunnableContext.java;1;0;1;1;0;0;0;1;0;0;1;3379;0;0;1;0;0;1;1;3379;0;3379;1;1;
/org.eclipse.jdt.core.tests.model/workspace/Converter/src/test0362/Test.java;1;0;1;1;0;0;0;1;0;0;1;3714;0;0;1;0;0;1;1;3714;0;3714;1;1;
/org.eclipse.jdt.core/codeassist/org/eclipse/jdt/internal/codeassist/select/SelectionOnQualifiedSuperReference.java;2;0;2;1;0;0;0;2;13;1;2;991;15;15;1;0;0;2;2;991;0;3560;2;2;
/org.eclipse.team.ui/src/org/eclipse/team/ui/synchronize/actions/ComparisonCriteriaActionGroup.java;1;0;1;1;0;0;0;1;0;0;1;2535;0;0;1;0;0;1;1;2535;0;2535;1;1;
/org.eclipse.osgi/core/adaptor/org/eclipse/osgi/framework/adaptor/IBundleStats.java;2;0;2;1;0;0;0;2;0;1;2;3013;0;0;1;0;0;2;2;3013;0;5085;2;2;
/org.eclipse.jdt.ui.tests.refactoring/resources/ExtractMethodWorkSpace/ExtractMethodTests/return_in/A_test722.java;1;0;1;1;0;0;0;1;4;0;1;844;4;4;1;0;0;1;1;844;0;844;1;1;
/org.eclipse.ui.tests/Eclipse UI Tests/org/eclipse/ui/tests/dnd/EditorAreaDropTarget.java;1;0;1;1;0;0;0;1;0;0;1;5007;0;0;1;0;0;1;1;5007;0;5007;1;1;
/org.eclipse.jdt.ui/core extension/org/eclipse/jdt/internal/corext/util/UnresolvableTypeInfo.java;1;0;1;1;1;1;1;0;2;0;0;6340;2;2;1;0;0;0;1;6340;0;6340;1;1;
/org.eclipse.debug.core/core/org/eclipse/debug/internal/core/sourcelookup/containers/FolderSourceContainer.java;1;0;3;1;0;0;0;3;4;1;3;3678;4;4;1;0;0;3;3;3678;0;4949;3;1;
/org.eclipse.ui.intro/src/org/eclipse/ui/internal/intro/impl/parts/PageForm.java;1;4;12;1;12;8;12;0;88;0;0;5115;186;186;4;0;4;0;12;5533;4;5714;8;1;
/org.eclipse.jdt.core.tests.model/workspace/Converter/test0419/A.java;1;0;1;1;0;0;0;1;0;0;1;3714;0;0;1;0;0;1;1;3714;0;3714;1;1;
/org.eclipse.jdt.ui/ui refactoring/org/eclipse/jdt/internal/ui/refactoring/UserInputWizardPage.java;3;0;7;1;0;0;0;7;19;1;7;1036;31;31;1;0;0;7;7;1036;0;4965;7;3;
/org.eclipse.jdt.core.tests.model/workspace/Formatter/test449/A_out.java;1;0;1;1;0;0;0;1;0;0;1;3611;0;0;1;0;0;1;1;3611;0;3611;1;1;
/org.eclipse.jdt.core.tests.model/workspace/Formatter/test320/A_out.java;1;0;2;1;0;0;0;2;3;1;2;2462;3;3;1;0;0;2;2;2462;0;4173;2;1;
/org.eclipse.jdt.core/compiler/org/eclipse/jdt/internal/compiler/codegen/CodeStream.java;5;1;21;2;2;2;2;19;2722;2;16;25;3501;3501;2;3;0;19;21;146;3;5940;18;5;
/org.eclipse.jdt.core.tests.model/workspace/Formatter/test171/A_in.java;1;0;1;1;0;0;0;1;0;0;1;2425;0;0;1;0;0;1;1;2425;0;2425;1;1;
/org.eclipse.team.cvs.ui/src/org/eclipse/team/internal/ccvs/ui/subscriber/ChangeLogModelManager.java;1;1;6;1;6;6;6;0;91;0;0;5466;118;118;1;0;0;0;6;5466;0;6337;6;1;
/org.eclipse.osgi/eclipseAdaptor/src/org/eclipse/core/runtime/adaptor/PluginConverter.java;1;0;2;1;0;0;0;2;0;0;1;3132;0;0;2;1;0;2;2;3132;1;3132;1;1;
/org.eclipse.jdt.ui.tests.refactoring/resources/RenamePrivateField/test3/in/A.java;1;0;1;1;0;0;0;1;6;0;1;4560;6;6;1;0;0;1;1;4560;0;4560;1;1;
/org.eclipse.update.core/srcnew/org/eclipse/update/operations/ISingleOperation.java;1;0;2;1;0;0;0;2;0;1;2;569;0;0;1;0;0;2;2;569;0;602;2;1;
/org.eclipse.jface.text/src/org/eclipse/jface/text/IFindReplaceTargetExtension.java;2;1;2;1;2;2;2;0;9;0;0;6340;11;11;1;0;0;0;2;6340;0;6359;2;2;
/org.eclipse.jdt.ui/ui refactoring/org/eclipse/jdt/internal/ui/refactoring/TextChangePreviewViewer.java;3;0;10;1;0;0;0;10;21;2;9;1033;78;78;2;1;0;10;10;3655;1;4965;9;3;
/org.eclipse.team.cvs.ui/src/org/eclipse/team/internal/ccvs/ui/repo/EncodingFieldEditor.java;1;0;1;1;0;0;0;1;0;0;1;4851;0;0;1;0;0;1;1;4851;0;4851;1;1;
/org.eclipse.jdt.ui/core extension/org/eclipse/text/edits/MoveSourceEdit.java;1;0;4;1;0;0;0;4;186;2;3;1953;293;293;2;1;0;4;4;1985;1;1985;3;1;
/org.eclipse.update.core/src/org/eclipse/update/core/model/ImportModel.java;1;1;2;1;2;2;2;0;6;0;0;5423;10;10;1;0;0;0;2;5423;0;6336;2;1;
/org.eclipse.ui.ide/src/org/eclipse/ui/internal/misc/ProjectCapabilitySelectionGroup.java;2;0;6;2;0;0;0;6;119;3;4;1526;135;135;3;2;0;6;6;1536;2;2263;4;2;
/org.eclipse.swt/Eclipse SWT/gtk/org/eclipse/swt/widgets/TrayItem.java;4;1;5;1;3;3;3;2;144;1;2;4519;153;153;1;0;0;2;5;4519;0;6081;5;4;
/org.eclipse.core.runtime/src/org/eclipse/core/runtime/model/PluginModel.java;2;0;3;1;0;0;0;3;50;1;3;536;60;60;1;0;0;3;3;536;0;3013;3;2;
/org.eclipse.core.runtime/src/org/eclipse/core/runtime/model/PluginModelObject.java;2;0;2;1;0;0;0;2;31;1;2;536;31;31;1;0;0;2;2;536;0;3013;2;2;
/org.eclipse.ltk.core.refactoring/src/org/eclipse/ltk/core/refactoring/UndoTextFileChange.java;1;2;8;1;5;4;5;3;29;1;3;4845;65;65;2;0;1;3;8;6338;1;6338;7;1;
/org.eclipse.team.tests.cvs.core/src/org/eclipse/team/tests/ccvs/core/subscriber/TestMarkAsMergedAction.java;2;0;4;1;0;0;0;4;2;1;4;1970;4;4;1;0;0;4;4;1970;0;4450;4;2;
/org.eclipse.text/src/org/eclipse/jface/text/templates/TemplateContext.java;3;1;5;1;3;3;3;2;6;1;2;4259;16;16;1;0;0;2;5;4259;0;6340;5;3;
/org.eclipse.jdt.ui/core refactoring/org/eclipse/jdt/internal/corext/refactoring/typeconstraints/IContext.java;2;0;2;1;1;1;1;1;2;0;1;3710;2;2;1;0;0;1;2;3710;0;6340;2;2;
/org.eclipse.jdt.launching/launching/org/eclipse/jdt/internal/launching/LaunchingPlugin.java;2;1;11;2;2;2;2;9;100;2;8;1240;255;255;2;1;0;9;11;3810;1;6150;10;2;
/org.eclipse.team.cvs.core/src/org/eclipse/team/internal/ccvs/core/client/RLog.java;2;1;3;1;2;2;2;1;59;0;1;4953;80;80;1;0;0;1;3;4953;0;5874;3;2;
/org.eclipse.core.resources/src/org/eclipse/core/internal/resources/ComputeProjectOrder.java;2;1;3;1;2;2;2;1;154;0;1;2967;175;175;1;0;0;1;3;2967;0;5897;3;2;
/org.eclipse.ui.workbench/Eclipse UI/org/eclipse/ui/XMLMemento.java;4;1;7;2;2;2;2;5;68;3;3;1;84;84;3;2;0;5;7;2608;2;6338;5;4;
/org.eclipse.ant.tests.core/tests/org/eclipse/ant/tests/core/AbstractAntTest.java;1;0;7;1;0;0;0;7;25;1;7;148;57;57;1;0;0;7;7;148;0;2665;7;1;
/org.eclipse.jdt.core.tests.model/workspace/Converter/test0473/A.java;1;0;2;1;0;0;0;2;0;1;2;787;0;0;1;0;0;2;2;787;0;3714;2;1;
/org.eclipse.jdt.core.tests.model/workspace/Formatter/test073/A_out.java;1;0;1;1;0;0;0;1;0;0;1;2425;0;0;1;0;0;1;1;2425;0;2425;1;1;
/org.eclipse.jdt.core/model/org/eclipse/jdt/core/IClassFile.java;1;0;3;1;0;0;0;3;27;1;3;2583;32;32;1;0;0;3;3;2583;0;3560;3;1;
/org.eclipse.pde.ui/src/org/eclipse/pde/internal/ui/wizards/plugin/NewProjectCreationOperation.java;3;2;16;1;11;9;11;5;128;1;5;3986;422;422;2;0;2;5;16;5321;2;6336;14;3;
/org.eclipse.ui.workbench/Eclipse UI/org/eclipse/ui/internal/commands/registry/Context.java;1;0;2;1;0;0;0;2;0;1;2;1077;0;0;1;0;0;2;2;1077;0;1222;2;1;
/org.eclipse.ui.workbench/Eclipse UI/org/eclipse/ui/commands/IKeyStroke.java;1;0;5;1;0;0;0;5;59;2;3;1239;100;100;2;2;0;5;5;1239;2;1294;3;1;
/org.eclipse.core.expressions/src/org/eclipse/core/expressions/ElementHandler.java;1;1;4;1;3;3;3;1;10;0;1;4108;23;23;1;0;0;1;4;4108;0;6340;4;1;
/org.eclipse.pde.ui/src/org/eclipse/pde/internal/ui/editor/manifest/PackagePrefixesSection.java;1;0;2;1;1;1;1;1;3;0;1;2751;3;3;1;0;0;1;2;2751;0;5431;2;1;
/org.eclipse.jdt.ui/core refactoring/org/eclipse/jdt/internal/corext/refactoring/base/JDTChange.java;2;1;8;1;3;3;3;5;23;1;5;3930;85;85;1;0;0;5;8;3930;0;6340;8;2;
/org.eclipse.jdt.ui/ui/org/eclipse/jdt/internal/ui/text/correction/UnresolvedElementsSubProcessor.java;5;3;67;2;16;13;16;51;335;3;42;269;2234;2234;3;9;3;51;67;1952;12;6340;55;5;
/org.eclipse.ui.workbench/Eclipse UI/org/eclipse/ui/commands/ICommandService.java;1;0;4;1;0;0;0;4;77;1;4;2569;79;79;1;0;0;4;4;2569;0;4144;4;1;
/org.eclipse.webdav/src/client/org/eclipse/webdav/http/client/Message.java;1;0;2;1;2;1;2;0;212;0;0;5151;212;212;2;0;1;0;2;5151;1;5151;1;1;
/org.eclipse.debug.ui/ui/org/eclipse/debug/internal/ui/console/ProcessConsolePage.java;1;0;4;1;0;0;0;4;54;1;4;1294;76;76;1;0;0;4;4;1294;0;1415;4;1;
/org.eclipse.update.tests.core/src/org/eclipse/update/tests/model/FeatureMain.java;2;0;3;1;1;1;1;2;268;1;2;4173;279;279;1;0;0;2;3;4173;0;6336;3;2;
/org.eclipse.core.runtime.compatibility/src-runtime/org/eclipse/core/internal/plugins/Policy.java;2;1;3;1;2;2;2;1;12;0;1;3013;14;14;1;0;0;1;3;3013;0;6340;3;2;
/org.eclipse.jdt.core.tests.model/workspace/Completion/src3/test0001/Test.java;1;0;1;1;0;0;0;1;0;0;1;5010;0;0;1;0;0;1;1;5010;0;5010;1;1;
/org.eclipse.core.tests.runtime/src/org/eclipse/core/tests/internal/plugins/RegressionResolveTest_10.java;1;0;1;1;0;0;0;1;0;0;1;3014;0;0;1;0;0;1;1;3014;0;3014;1;1;
/org.eclipse.jdt.ui/ui/org/eclipse/jdt/internal/ui/preferences/CompilerConfigurationBlock.java;2;1;28;1;4;4;4;24;312;2;23;364;1273;1273;2;1;0;24;28;1239;1;6340;27;2;
/org.eclipse.team.ui/src/org/eclipse/team/ui/synchronize/subscriber/OpenCompareDialogAction.java;1;0;1;1;0;0;0;1;0;0;1;4389;0;0;1;0;0;1;1;4389;0;4389;1;1;
/org.eclipse.jface.text/src/org/eclipse/jface/text/IMarkSelection.java;2;1;2;1;2;2;2;0;10;0;0;6340;12;12;1;0;0;0;2;6340;0;6359;2;2;
/org.eclipse.core.resources/src/org/eclipse/core/resources/IProject.java;2;1;9;2;3;3;3;6;1275;1;6;44;1470;1470;1;0;0;6;9;44;0;5489;9;2;
/org.eclipse.team.examples.filesystem/src/org/eclipse/team/examples/filesystem/FileModificationValidator.java;2;0;4;1;1;1;1;3;18;1;3;1708;27;27;1;0;0;3;4;1708;0;6337;4;2;
/org.eclipse.team.ui/src/org/eclipse/team/ui/synchronize/actions/ShowSynchronizeParticipantAction.java;1;0;1;1;0;0;0;1;0;0;1;3848;0;0;1;0;0;1;1;3848;0;3848;1;1;
/org.eclipse.ui.forms/src/org/eclipse/ui/forms/events/ExpansionAdapter.java;1;0;5;1;1;1;1;4;31;1;4;4068;45;45;1;0;0;4;5;4068;0;6336;5;1;
/org.eclipse.core.tests.runtime/src/org/eclipse/core/tests/internal/runtimetests/SampleNFB.java;1;0;1;1;1;1;1;0;21;0;0;5149;21;21;1;0;0;0;1;5149;0;5149;1;1;
/org.eclipse.ui.workbench/Eclipse UI/org/eclipse/ui/commands/IMutableCommandHandlerService.java;1;0;3;1;0;0;0;3;26;1;3;3131;26;26;1;0;0;3;3;3131;0;4144;3;1;
/org.eclipse.jdt.core/model/org/eclipse/jdt/internal/core/util/CharArrayBuffer.java;2;0;2;1;1;1;1;1;2;0;1;3560;4;4;1;0;0;1;2;3560;0;5916;2;2;
/org.eclipse.jdt.core.tests.model/workspace/Formatter/test217/A_in.java;1;0;1;1;0;0;0;1;0;0;1;2426;0;0;1;0;0;1;1;2426;0;2426;1;1;
/org.eclipse.jdt.ui/ui/org/eclipse/jdt/internal/ui/viewsupport/ListContentProvider.java;1;0;1;1;1;1;1;0;2;0;0;6340;2;2;1;0;0;0;1;6340;0;6340;1;1;
/org.eclipse.jdt.core.tests.model/workspace/Formatter/test355/A_out.java;2;0;2;1;0;0;0;2;10;1;2;3086;10;10;1;0;0;2;2;3086;0;3362;2;2;
/org.eclipse.jdt.ui.tests.refactoring/resources/ExtractInterface/test100/in/A.java;1;0;1;1;0;0;0;1;0;0;1;3942;0;0;1;0;0;1;1;3942;0;3942;1;1;
/org.eclipse.jdt.core/compiler/org/eclipse/jdt/internal/compiler/ast/Block.java;3;0;12;2;0;0;0;12;52;4;7;937;108;108;4;5;0;12;12;1299;5;3560;7;3;
/org.eclipse.jdt.core.tests.model/workspace/Converter/test0231/Test.java;1;0;1;1;0;0;0;1;0;0;1;3714;0;0;1;0;0;1;1;3714;0;3714;1;1;
/org.eclipse.ui.workbench/Eclipse UI/org/eclipse/ui/internal/presentations/SystemMenuFastView.java;2;1;4;1;2;2;2;2;74;1;2;4680;98;98;1;0;0;2;4;4680;0;5517;4;2;
/org.eclipse.ui.forms/src/org/eclipse/ui/forms/internal/widgets/TextSegment.java;1;0;5;1;0;0;0;5;49;1;5;4068;93;93;1;0;0;5;5;4068;0;5044;5;1;
/org.eclipse.debug.ui/ui/org/eclipse/debug/ui/launchVariables/StringPromptExpander.java;1;0;2;1;0;0;0;2;0;1;2;550;0;0;1;0;0;2;2;550;0;562;2;1;
/org.eclipse.jdt.debug/jdi/org/eclipse/jdi/internal/LocalVariableImpl.java;2;0;3;1;0;0;0;3;19;1;3;3383;37;37;1;0;0;3;3;3383;0;4394;3;2;
/org.eclipse.ui.workbench/Eclipse UI/org/eclipse/ui/internal/ClassicWorkbenchWindow.java;1;0;1;1;0;0;0;1;0;0;1;2728;0;0;1;0;0;1;1;2728;0;2728;1;1;
/org.eclipse.ui.workbench/Eclipse UI/org/eclipse/ui/IWorkbenchPage.java;7;2;27;2;5;4;5;22;1000;2;18;1220;1501;1501;2;4;1;22;27;2732;5;6338;22;7;
/org.eclipse.update.ui/srcnew/org/eclipse/update/internal/ui/ConfigurationManagerWindow.java;2;0;8;2;0;0;0;8;11;2;7;480;27;27;2;1;0;8;8;480;1;825;7;2;
/org.eclipse.osgi/osgi/src/org/osgi/util/tracker/ServiceTracker.java;2;2;5;1;4;3;4;1;641;0;1;5079;757;757;2;0;1;1;5;5688;1;5734;4;2;
/org.eclipse.team.cvs.core/src/org/eclipse/team/internal/ccvs/core/IUserAuthenticator.java;1;0;4;1;1;1;1;3;75;1;3;3113;110;110;1;0;0;3;4;3113;0;6337;4;1;
/org.eclipse.debug.ui/ui/org/eclipse/debug/internal/ui/views/console/ConsoleView.java;1;0;5;1;0;0;0;5;46;1;5;1008;74;74;1;0;0;5;5;1008;0;1414;5;1;
/org.eclipse.swt.tests/JUnit Tests/org/eclipse/swt/tests/junit/junitGen.java;2;0;3;1;0;0;0;3;5;1;3;2176;6;6;1;0;0;3;3;2176;0;3383;3;2;
/org.eclipse.jdt.core/model/org/eclipse/jdt/internal/core/util/DefaultBytecodeVisitor.java;2;1;8;1;2;2;2;6;1462;1;6;163;1641;1641;1;0;0;6;8;163;0;6250;8;2;
/org.eclipse.ant.ui/Ant Tools Support/org/eclipse/ant/ui/internal/preferences/MessageDialogWithToggle.java;1;0;2;1;0;0;0;2;0;1;2;1321;0;0;1;0;0;2;2;1321;0;1811;2;1;
/org.eclipse.ui.workbench/Eclipse UI/org/eclipse/ui/internal/ShowViewAction.java;2;0;3;2;0;0;0;3;111;2;2;3010;135;135;2;1;0;3;3;3061;1;3061;2;2;
/org.eclipse.jdt.ui/ui/org/eclipse/jdt/internal/ui/actions/FoldingToggleRulerAction.java;2;1;2;1;2;2;2;0;6;0;0;5612;6;6;1;0;0;0;2;5612;0;6340;2;2;
/org.eclipse.core.resources/src/org/eclipse/core/internal/properties/IndexedStoreWrapper.java;1;0;1;1;1;1;1;0;370;0;0;5146;370;370;1;0;0;0;1;5146;0;5146;1;1;
/org.eclipse.debug.core/core/org/eclipse/debug/core/IBreakpointManagerListener.java;2;0;2;1;1;1;1;1;9;0;1;4235;9;9;1;0;0;1;2;4235;0;5106;2;2;
/org.eclipse.ant.ui/Ant Tools Support/org/eclipse/ant/ui/internal/launchConfigurations/RunAntStatusHandler.java;1;0;2;1;0;0;0;2;0;1;2;250;0;0;1;0;0;2;2;250;0;1811;2;1;
/org.eclipse.core.tests.resources/src/org/eclipse/core/tests/resources/IResourceTest.java;2;3;8;2;5;2;5;3;3256;1;3;2057;4283;4283;3;0;3;3;8;5147;3;6127;5;2;
/org.eclipse.ant.ui/Ant Tools Support/org/eclipse/ant/ui/internal/launchConfigurations/AntTargetContentProvider.java;1;0;3;1;0;0;0;3;2;1;3;250;2;2;1;0;0;3;3;250;0;1811;3;1;
/org.eclipse.ui.workbench/Eclipse UI/org/eclipse/ui/internal/activities/ActivityEvent.java;1;0;4;1;0;0;0;4;23;2;3;2444;31;31;2;1;0;4;4;2800;1;2800;3;1;
/org.eclipse.ui.tests/Eclipse UI Tests/org/eclipse/ui/tests/dnd/DragTestSuite.java;1;0;3;1;1;1;1;2;27;1;2;5007;37;37;1;0;0;2;3;5007;0;5825;3;1;
/org.eclipse.jdt.core.tests.model/workspace/Converter/src/test0356/A.java;1;0;1;1;0;0;0;1;0;0;1;3714;0;0;1;0;0;1;1;3714;0;3714;1;1;
/org.eclipse.pde.ui/sandbox/org/eclipse/pde/internal/ui/editor/standalone/text/XMLAnnotationHover.java;1;0;2;1;0;0;0;2;0;1;2;2320;0;0;1;0;0;2;2;2320;0;2906;2;1;
/org.eclipse.jdt.core.tests.compiler/src/org/eclipse/jdt/core/tests/junit/extension/StopableTestCase.java;1;0;2;1;0;0;0;2;16;1;2;2389;18;18;1;0;0;2;2;2389;0;3560;2;1;
/org.eclipse.ui.ide/src/org/eclipse/ui/views/markers/internal/BookmarkFilter.java;2;0;2;1;0;0;0;2;14;1;2;2208;14;14;1;0;0;2;2;2208;0;3214;2;2;
/org.eclipse.help.tests/src/org/eclipse/help/tests/HelpSystemTestCase.java;1;1;6;1;3;3;3;3;188;2;2;3429;226;226;2;1;0;3;6;4615;1;6337;5;1;
/org.eclipse.update.core/src/org/eclipse/update/internal/core/InstallConfiguration.java;3;2;38;1;9;8;9;29;134;3;25;890;728;728;3;4;1;29;38;4217;5;6336;33;3;
/org.eclipse.core.runtime/src/org/eclipse/core/runtime/preferences/IScopeContext.java;2;1;10;1;4;4;4;6;17;1;6;4033;47;47;1;0;0;6;10;4033;0;5576;10;2;
/org.eclipse.jdt.core/compiler/org/eclipse/jdt/internal/compiler/ast/Break.java;1;0;1;1;0;0;0;1;0;0;1;148;0;0;1;0;0;1;1;148;0;148;1;1;
/org.eclipse.team.ui/src/org/eclipse/team/internal/ui/synchronize/actions/LogicalViewActionGroup.java;1;0;1;1;0;0;0;1;0;0;1;3734;0;0;1;0;0;1;1;3734;0;3734;1;1;
/org.eclipse.team.ui/src/org/eclipse/team/internal/ui/sync/pages/SynchronizePartnerDescriptor.java;1;0;1;1;0;0;0;1;0;0;1;2487;0;0;1;0;0;1;1;2487;0;2487;1;1;
/org.eclipse.core.runtime/src/org/eclipse/core/internal/jobs/InternalJob.java;3;1;43;1;7;7;7;36;531;3;31;320;2131;2131;3;5;0;36;43;5086;5;6361;38;3;
/org.eclipse.ant.ui/Ant Tools Support/org/eclipse/ant/internal/ui/views/AntView.java;3;0;16;1;0;0;0;16;43;3;12;1811;172;172;3;4;0;16;16;3147;4;4356;12;3;
/org.eclipse.swt/Eclipse SWT Custom Widgets/common/org/eclipse/swt/custom/StyledTextRenderer.java;4;2;16;2;7;5;7;9;593;2;7;1890;931;931;2;2;2;9;16;1890;4;6352;12;4;
/org.eclipse.pde.ui/src_Forms/org/eclipse/pde/internal/ui/neweditor/schema/ElementSection.java;2;1;4;1;2;2;2;2;13;1;2;4856;19;19;1;0;0;2;4;4856;0;5431;4;2;
/org.eclipse.jdt.core/compiler/org/eclipse/jdt/internal/compiler/codegen/DoubleCache.java;1;0;1;1;0;0;0;1;2;0;1;3560;2;2;1;0;0;1;1;3560;0;3560;1;1;
/org.eclipse.jdt.ui.tests.refactoring/resources/ExtractMethodWorkSpace/ExtractMethodTests/expression_out/A_test615.java;1;0;3;1;0;0;0;3;4;1;3;844;4;4;1;0;0;3;3;844;0;1474;3;1;
/org.eclipse.debug.ui/ui/org/eclipse/debug/ui/variables/ProjectNameExpander.java;1;0;4;1;0;0;0;4;48;3;2;316;48;48;3;2;0;4;4;316;2;550;2;1;
/org.eclipse.team.core/src/org/eclipse/team/core/variants/ThreeWayResourceComparator.java;1;0;2;1;1;1;1;1;9;0;1;4349;9;9;1;0;0;1;2;4349;0;6125;2;1;
/org.eclipse.jdt.core/eval/org/eclipse/jdt/internal/eval/CodeSnippetTypeDeclaration.java;2;0;3;1;1;1;1;2;46;1;2;3324;50;50;1;0;0;2;3;3324;0;5615;3;2;
/org.eclipse.ui.workbench/Eclipse UI/org/eclipse/ui/internal/dialogs/PropertyPageNode.java;2;0;4;2;0;0;0;4;127;2;3;2861;170;170;2;1;0;4;4;3061;1;3061;3;2;
/org.eclipse.sdk.tests-feature/plugins/org.eclipse.perfmsr.core/src/org/eclipse/perfmsr/core/PropertyHolder.java;2;1;5;1;4;4;4;1;10;0;1;4845;20;20;1;0;0;1;5;4845;0;6342;5;2;
/org.eclipse.jdt.ui/ui/org/eclipse/jdt/internal/ui/text/comment/CommentLine.java;2;0;8;1;1;1;1;7;286;1;7;1589;598;598;1;0;0;7;8;1589;0;6340;8;2;
/org.eclipse.jdt.core.tests.model/workspace/Completion/src3/test0008/Test.java;1;0;1;1;0;0;0;1;0;0;1;5010;0;0;1;0;0;1;1;5010;0;5010;1;1;
/org.eclipse.core.runtime/src/org/eclipse/core/internal/registry/IRegistryElement.java;3;1;5;2;2;2;2;3;52;2;2;3049;62;62;2;1;0;3;5;3164;1;5531;4;3;
/org.eclipse.ui.workbench/Eclipse UI/org/eclipse/ui/internal/registry/FileEditorMapping.java;3;0;11;1;0;0;0;11;398;2;9;1951;602;602;2;2;0;11;11;2279;2;3008;9;3;
/org.eclipse.ltk.ui.refactoring/src/org/eclipse/ltk/internal/ui/refactoring/RefactoringPluginImages.java;1;0;3;1;1;1;1;2;10;1;2;4965;16;16;1;0;0;2;3;4965;0;5380;3;1;
/org.eclipse.ui.workbench/Eclipse UI/org/eclipse/ui/commands/registry/IActiveKeyConfigurationDefinition.java;1;0;3;1;0;0;0;3;2;2;2;1400;2;2;2;1;0;3;3;1400;1;1417;2;1;
/org.eclipse.jdt.ui.tests.refactoring/resources/ExtractMethodWorkSpace/ExtractMethodTests/semicolon_out/A_test410.java;1;0;2;1;0;0;0;2;6;1;2;130;7;7;1;0;0;2;2;130;0;844;2;1;
/org.eclipse.team.ui/src/org/eclipse/team/ui/sync/actions/RemoveSynchronizeViewPageAction.java;1;0;1;1;0;0;0;1;0;0;1;2446;0;0;1;0;0;1;1;2446;0;2446;1;1;
/org.eclipse.jdt.core.tests.model/workspace/Converter/src/javadoc/test007/Test.java;1;0;1;1;0;0;0;1;0;0;1;3813;0;0;1;0;0;1;1;3813;0;3813;1;1;
/org.eclipse.jdt.core.tests.model/workspace/Formatter/test206/A_in.java;1;0;1;1;0;0;0;1;0;0;1;2424;0;0;1;0;0;1;1;2424;0;2424;1;1;
/org.eclipse.ant.ui/Ant Tools Support/org/eclipse/ant/ui/internal/views/elements/ProjectNode.java;1;0;2;1;0;0;0;2;0;1;2;250;0;0;1;0;0;2;2;250;0;1811;2;1;
/org.eclipse.team.webdav/src/org/eclipse/team/core/target/PutOperation.java;1;0;1;1;0;0;0;1;0;0;1;3387;0;0;1;0;0;1;1;3387;0;3387;1;1;
/org.eclipse.ui.workbench/Eclipse UI/org/eclipse/ui/internal/IWorkbenchDragDropPart.java;3;0;3;1;0;0;0;3;59;1;3;3092;59;59;1;0;0;3;3;3092;0;4600;3;3;
/org.eclipse.update.core/src/org/eclipse/update/core/model/PluginEntry.java;1;0;1;1;0;0;0;1;0;0;1;2634;0;0;1;0;0;1;1;2634;0;2634;1;1;
/org.eclipse.swt/Eclipse SWT Mozilla/common/org/eclipse/swt/internal/mozilla/nsIProfile.java;1;0;2;1;0;0;0;2;10;1;2;1654;10;10;1;0;0;2;2;1654;0;2568;2;1;
/org.eclipse.jdt.core.tests.model/workspace/Converter/test0313/Test.java;1;0;1;1;0;0;0;1;0;0;1;3714;0;0;1;0;0;1;1;3714;0;3714;1;1;
/org.eclipse.ant.ui/Ant Tools Support/org/eclipse/ant/ui/internal/preferences/AntTypesPage.java;1;0;8;1;0;0;0;8;39;2;6;250;90;90;2;2;0;8;8;262;2;1811;6;1;
/org.eclipse.ui.views/src/org/eclipse/ui/views/properties/ResourcePropertySource.java;2;0;2;1;0;0;0;2;4;1;2;852;4;4;1;0;0;2;2;852;0;2738;2;2;
/org.eclipse.team.ui/src/org/eclipse/team/ui/synchronize/SynchronizeModelOperation.java;2;1;5;1;4;4;4;1;27;0;1;4632;61;61;1;0;0;1;5;4632;0;6337;5;2;
/org.eclipse.ui.workbench/Eclipse UI/org/eclipse/ui/internal/presentations/BasicStackList.java;5;2;11;1;11;10;11;0;23;0;0;5363;121;121;2;0;1;0;11;5481;1;6338;10;5;
/org.eclipse.jface.text/src/org/eclipse/jface/text/source/ILineDiffInfo.java;3;1;4;1;2;2;2;2;5;1;2;1118;9;9;1;0;0;2;4;1118;0;6340;4;3;
/org.eclipse.jdt.core/compiler/org/eclipse/jdt/internal/compiler/ast/WhileStatement.java;3;0;11;2;2;1;2;9;26;2;7;953;71;71;2;2;1;9;11;989;3;5339;8;3;
/org.eclipse.core.runtime/src/org/eclipse/core/runtime/jobs/JobAdapter.java;1;0;1;1;0;0;0;1;0;0;1;635;0;0;1;0;0;1;1;635;0;635;1;1;
/org.eclipse.ui.externaltools/External Tools Base/org/eclipse/ui/externaltools/internal/variable/AbstractVariableComponent.java;2;0;3;1;0;0;0;3;8;1;3;244;16;16;1;0;0;3;3;244;0;321;3;2;
/org.eclipse.pde.ui/src/org/eclipse/pde/internal/ui/editor/build/BuildSourcePage.java;1;1;3;1;2;2;2;1;81;0;1;1727;93;93;1;0;0;1;3;1727;0;6336;3;1;
/org.eclipse.jdt.ui/core extension/org/eclipse/text/edits/ISourceModifier.java;1;0;3;1;0;0;0;3;16;2;2;1953;16;16;2;1;0;3;3;1985;1;1985;2;1;
/org.eclipse.jdt.ui.tests.refactoring/resources/ExtractMethodWorkSpace/ExtractMethodTests/duplicates_in/A_test956.java;1;0;3;1;0;0;0;3;0;1;3;1442;0;0;1;0;0;3;3;1442;0;1474;3;1;
/org.eclipse.ui.workbench/Eclipse UI/org/eclipse/ui/internal/themes/ColorDefinition.java;2;0;7;1;1;1;1;6;30;2;5;4392;61;61;2;1;0;6;7;4870;1;6338;6;2;
/org.eclipse.jdt.core/eval/org/eclipse/jdt/internal/eval/EvaluationResult.java;1;0;1;1;0;0;0;1;2;0;1;3560;2;2;1;0;0;1;1;3560;0;3560;1;1;
/org.eclipse.jdt.ui/core extension/org/eclipse/jdt/internal/corext/callhierarchy/CallHierarchy.java;3;1;9;1;2;2;2;7;25;2;6;169;77;77;2;1;0;7;9;169;1;6340;8;3;
/org.eclipse.ui.workbench/Eclipse UI/org/eclipse/ui/application/IWorkbenchWindowConfigurer.java;5;1;14;1;3;3;3;11;245;1;11;1259;587;587;1;0;0;11;14;1259;0;6338;14;5;
/org.eclipse.team.core/src/org/eclipse/team/core/synchronize/SyncInfoTree.java;2;1;6;1;3;3;3;3;348;1;3;4045;403;403;1;0;0;3;6;4045;0;6336;6;2;
/org.eclipse.jdt.launching/launching/org/eclipse/jdt/launching/AbstractVMInstall.java;2;0;2;1;0;0;0;2;24;1;2;2988;43;43;1;0;0;2;2;2988;0;4493;2;2;
/org.eclipse.swt/Eclipse SWT PI/motif/org/eclipse/swt/internal/motif/XmTextVerifyCallbackStruct.java;1;0;1;1;0;0;0;1;12;0;1;825;12;12;1;0;0;1;1;825;0;825;1;1;
/org.eclipse.ui.workbench/Eclipse UI/org/eclipse/ui/internal/WorkbenchContextActiviationService.java;1;0;2;1;0;0;0;2;0;1;2;3066;0;0;1;0;0;2;2;3066;0;3109;2;1;
/org.eclipse.team.ui/src/org/eclipse/team/internal/ui/synchronize/actions/LogicalViewAction.java;1;0;1;1;0;0;0;1;0;0;1;3734;0;0;1;0;0;1;1;3734;0;3734;1;1;
/org.eclipse.jdt.debug.ui/ui/org/eclipse/jdt/internal/debug/ui/CreateStepFilterDialog.java;2;0;7;1;0;0;0;7;74;2;6;3516;180;180;2;1;0;7;7;4834;1;4834;6;2;
/org.eclipse.team.cvs.ui/src/org/eclipse/team/internal/ccvs/ui/wizards/KSubstWizardSharedFilesPage.java;1;0;1;1;0;0;0;1;2;0;1;2381;2;2;1;0;0;1;1;2381;0;2381;1;1;
/org.eclipse.debug.core/core/org/eclipse/debug/internal/core/memory/IMemoryRenderingInfo.java;1;0;1;1;1;1;1;0;0;0;0;5254;0;0;1;0;0;0;1;5254;0;5254;1;1;
/org.eclipse.core.tests.runtime/src/org/eclipse/core/tests/runtime/compatibility/PluginCompatibilityTests.java;1;1;4;1;4;4;4;0;20;0;0;5170;23;23;1;0;0;0;4;5170;0;6201;4;1;
/org.eclipse.ui.workbench/Eclipse UI/org/eclipse/ui/internal/ProductInfo.java;2;0;2;1;1;1;1;1;139;0;1;4681;139;139;1;0;0;1;2;4681;0;6012;2;2;
/org.eclipse.jdt.core.tests.model/workspace/Converter/src/javadoc/testBug53757/Test.java;1;0;1;1;0;0;0;1;0;0;1;4390;0;0;1;0;0;1;1;4390;0;4390;1;1;
/org.eclipse.jdt.ui.tests.refactoring/resources/Delete/testDeleteWithinCu16/out/A.java;1;0;1;1;0;0;0;1;0;0;1;442;0;0;1;0;0;1;1;442;0;442;1;1;
/org.eclipse.jdt.core.tests.model/workspace/Formatter/test440/A_in.java;1;0;1;1;0;0;0;1;0;0;1;3513;0;0;1;0;0;1;1;3513;0;3513;1;1;
/org.eclipse.jdt.core.tests.model/workspace/Formatter/test451/Format_in.java;1;0;3;1;0;0;0;3;2;1;3;3714;2;2;1;0;0;3;3;3714;0;3742;3;1;
/org.eclipse.jdt.core.tests.model/workspace/Converter/src/test0297/Test.java;1;0;1;1;0;0;0;1;0;0;1;3714;0;0;1;0;0;1;1;3714;0;3714;1;1;
/org.eclipse.jdt.ui.tests.refactoring/resources/IntroduceFactory/Bugzilla/46189B/TestClass.java;1;0;2;1;1;1;1;1;2;0;1;2846;2;2;1;0;0;1;2;2846;0;5659;2;1;
/org.eclipse.pde.ui/src_Forms/org/eclipse/pde/internal/ui/neweditor/PDEFormPage.java;2;1;14;1;2;2;2;12;61;2;11;3795;172;172;2;1;0;12;14;4832;1;5431;13;2;
/org.eclipse.debug.core/core/org/eclipse/debug/internal/core/variables/ContainerExpander.java;2;0;2;1;0;0;0;2;0;1;2;737;0;0;1;0;0;2;2;737;0;2120;2;2;
/org.eclipse.jdt.ui/ui/org/eclipse/jdt/internal/ui/preferences/PreferencesMessages.java;1;0;1;1;1;1;1;0;2;0;0;6340;2;2;1;0;0;0;1;6340;0;6340;1;1;
/org.eclipse.jdt.core.tests.model/src/org/eclipse/jdt/core/tests/dom/SampleASTs.java;1;0;4;1;1;1;1;3;21;1;3;4202;31;31;1;0;0;3;4;4202;0;5272;4;1;
/org.eclipse.jdt.ui/ui/org/eclipse/jdt/internal/ui/PersistableJavaElementFactory.java;1;0;1;1;1;1;1;0;2;0;0;6340;2;2;1;0;0;0;1;6340;0;6340;1;1;
/org.eclipse.ui.workbench/Eclipse UI/org/eclipse/ui/internal/presentation/CascadingColorRegistry.java;1;0;3;1;0;0;0;3;2;1;3;4263;2;2;1;0;0;3;3;4263;0;4392;3;1;
/org.eclipse.swt/Eclipse SWT/common/org/eclipse/swt/widgets/Dialog.java;1;0;3;1;0;0;0;3;16;1;3;268;23;23;1;0;0;3;3;268;0;1657;3;1;
/org.eclipse.core.tests.resources/src/org/eclipse/core/tests/resources/session/TestClosedProjectLocation.java;1;0;1;1;1;1;1;0;101;0;0;5147;101;101;1;0;0;0;1;5147;0;5147;1;1;
/org.eclipse.ui.workbench/Eclipse UI/org/eclipse/ui/actions/CopyProjectOperation.java;1;0;1;1;0;0;0;1;0;0;1;2737;0;0;1;0;0;1;1;2737;0;2737;1;1;
/org.eclipse.jdt.ui/core refactoring/org/eclipse/jdt/internal/corext/refactoring/participants/xml/FilePropertyTester.java;1;0;4;1;0;0;0;4;15;1;4;1125;17;17;1;0;0;4;4;1125;0;2546;4;1;
/org.eclipse.ui.workbench/Eclipse UI/org/eclipse/ui/wizards/datatransfer/FileSystemExportOperation.java;2;0;2;1;0;0;0;2;18;1;2;1316;18;18;1;0;0;2;2;1316;0;2737;2;2;
/org.eclipse.pde.ui/src_Forms/org/eclipse/pde/internal/ui/model/bundle/ManifestHeader.java;3;1;6;1;6;6;6;0;10;0;0;5425;22;22;1;0;0;0;6;5425;0;6336;6;3;
/org.eclipse.ui.workbench/Eclipse UI/org/eclipse/ui/internal/ViewIntroAdapterSite.java;1;1;5;1;3;3;3;2;34;1;2;3632;40;40;1;0;0;2;5;3632;0;5533;5;1;
/org.eclipse.update.ui/src/org/eclipse/update/internal/ui/forms/MultipleSelectionForm.java;1;0;1;1;0;0;0;1;0;0;1;755;0;0;1;0;0;1;1;755;0;755;1;1;
/org.eclipse.jdt.core/eval/org/eclipse/jdt/internal/eval/VariablesInfo.java;2;0;2;1;0;0;0;2;10;1;2;662;12;12;1;0;0;2;2;662;0;3560;2;2;
/org.eclipse.jdt.core.tests.model/workspace/Converter/test0378/A.java;1;0;1;1;0;0;0;1;0;0;1;3714;0;0;1;0;0;1;1;3714;0;3714;1;1;
/org.eclipse.help.tests/src/org/eclipse/help/tests/browsers/AllHelpBrowsersTests.java;1;1;2;1;2;2;2;0;16;0;0;5827;32;32;1;0;0;0;2;5827;0;6337;2;1;
/org.eclipse.jdt.ui/ui/org/eclipse/jdt/internal/ui/viewsupport/ImageDisposer.java;1;0;1;1;1;1;1;0;2;0;0;6340;2;2;1;0;0;0;1;6340;0;6340;1;1;
/org.eclipse.jface.text/src/org/eclipse/jface/text/source/ChangeRulerColumn.java;3;1;13;1;6;6;6;7;67;1;7;1240;222;222;1;0;0;7;13;1240;0;6361;13;3;
/org.eclipse.jdt.core.tests.model/workspace/Formatter/test145/A_in.java;1;0;1;1;0;0;0;1;0;0;1;2425;0;0;1;0;0;1;1;2425;0;2425;1;1;
/org.eclipse.pde.ui/templates/newWizard/java/$wizardPageClassName$.java;1;0;2;1;0;0;0;2;10;1;2;851;12;12;1;0;0;2;2;851;0;867;2;1;
/org.eclipse.jdt.core.tests.model/workspace/Formatter/test301/A_in.java;1;0;1;1;0;0;0;1;0;0;1;2444;0;0;1;0;0;1;1;2444;0;2444;1;1;
/org.eclipse.jdt.ui/ui/org/eclipse/jdt/internal/ui/javaeditor/SemanticHighlightingManager.java;3;1;6;1;6;6;6;0;185;0;0;5272;332;332;1;0;0;0;6;5272;0;6144;6;3;
/org.eclipse.ui.workbench/Eclipse UI/org/eclipse/ui/progress/IProgressManager.java;1;0;3;1;0;0;0;3;29;1;3;2177;29;29;1;0;0;3;3;2177;0;2765;3;1;
/org.eclipse.swt/Eclipse SWT Drag and Drop/motif/org/eclipse/swt/dnd/RTFTransfer.java;1;0;1;1;0;0;0;1;59;0;1;328;59;59;1;0;0;1;1;328;0;328;1;1;
/org.eclipse.jdt.ui.tests.refactoring/resources/ChangeSignature/canModify/A_testInStatic01_out.java;1;0;1;1;0;0;0;1;0;0;1;3216;0;0;1;0;0;1;1;3216;0;3216;1;1;
/org.eclipse.ui.externaltools/External Tools Base/org/eclipse/ui/externaltools/internal/variable/SpecificFolderResourceComponent.java;1;0;1;1;0;0;0;1;0;0;1;321;0;0;1;0;0;1;1;321;0;321;1;1;
/org.eclipse.core.tests.runtime/src/org/eclipse/core/tests/internal/runtimetests/SampleHPR.java;1;0;1;1;1;1;1;0;21;0;0;5149;21;21;1;0;0;0;1;5149;0;5149;1;1;
/org.eclipse.jdt.ui.tests.refactoring/resources/ExtractMethodWorkSpace/ExtractMethodTests/return_out/A_test724.java;1;0;1;1;0;0;0;1;1;0;1;130;1;1;1;0;0;1;1;130;0;130;1;1;
/org.eclipse.ui.console/src/org/eclipse/ui/internal/console/ConsoleView.java;4;2;11;2;5;4;5;6;76;1;6;1988;131;131;2;0;1;6;11;5874;1;5874;10;4;
/org.eclipse.update.ui.forms/src/org/eclipse/update/ui/forms/internal/richtext/IObjectReference.java;1;0;2;1;0;0;0;2;0;1;2;2849;0;0;1;0;0;2;2;2849;0;2898;2;1;
/org.eclipse.ui.views/src/org/eclipse/ui/views/navigator/ResourceSelectionUtil.java;2;0;2;1;0;0;0;2;6;1;2;1;6;6;1;0;0;2;2;1;0;2738;2;2;
/org.eclipse.core.tests.resources/src/org/eclipse/core/tests/resources/usecase/Snapshot5Test.java;1;0;2;1;2;1;2;0;81;0;0;5147;81;81;2;0;1;0;2;5147;1;5147;1;1;
/org.eclipse.team.cvs.ui/src/org/eclipse/team/internal/ccvs/ui/repo/RepositoryManager.java;2;1;15;1;3;3;3;12;96;1;12;866;364;364;1;0;0;12;15;866;0;6337;15;2;
/org.eclipse.debug.ui/ui/org/eclipse/debug/internal/ui/views/memory/MemoryViewCellModifier.java;2;1;2;1;2;2;2;0;6;0;0;5254;6;6;1;0;0;0;2;5254;0;5364;2;2;
/org.eclipse.core.tests.runtime/src/org/eclipse/core/tests/internal/plugin/a/ExtensionDirectCompilerReferenceToPluginClass.java;1;0;1;1;1;1;1;0;18;0;0;5149;18;18;1;0;0;0;1;5149;0;5149;1;1;
/org.eclipse.jdt.ui/core extension/org/eclipse/jdt/internal/corext/dom/CompilationUnitBuffer.java;2;0;2;1;1;1;1;1;8;0;1;2131;10;10;1;0;0;1;2;2131;0;6340;2;2;
/org.eclipse.jdt.core.tests.model/workspace/Formatter/test485/A_in.java;1;0;1;1;1;1;1;0;0;0;0;5132;0;0;1;0;0;0;1;5132;0;5132;1;1;
/org.eclipse.team.cvs.ui/src/org/eclipse/team/internal/ccvs/ui/sync/CVSSyncCompareUnsharedInput.java;1;0;1;1;0;0;0;1;0;0;1;4217;0;0;1;0;0;1;1;4217;0;4217;1;1;
/org.eclipse.jdt.ui.tests.refactoring/resources/Paste/test2/in/B.java;1;0;1;1;0;0;0;1;0;0;1;1311;0;0;1;0;0;1;1;1311;0;1311;1;1;
/org.eclipse.ui.workbench/Eclipse UI/org/eclipse/ui/dialogs/FileSelectionDialog.java;2;0;3;1;0;0;0;3;20;1;3;1;24;24;1;0;0;3;3;1;0;2737;3;2;
/org.eclipse.jdt.ui/ui refactoring/org/eclipse/jdt/internal/ui/refactoring/actions/InlineMethodAction.java;3;0;5;1;1;1;1;4;118;1;4;144;137;137;1;0;0;4;5;144;0;6340;5;3;
/org.eclipse.jdt.core.tests.model/workspace/Formatter/test235/A_out.java;1;0;1;1;0;0;0;1;0;0;1;2437;0;0;1;0;0;1;1;2437;0;2437;1;1;
/org.eclipse.ltk.core.refactoring/src/org/eclipse/ltk/core/refactoring/PerformRefactoringOperation.java;1;1;7;1;4;4;4;3;36;1;3;4845;60;60;1;0;0;3;7;4845;0;6338;7;1;
/org.eclipse.jdt.ui/ui/org/eclipse/jdt/internal/ui/javadocexport/RecentSettingsStore.java;1;0;1;1;0;0;0;1;0;0;1;4047;0;0;1;0;0;1;1;4047;0;4047;1;1;
/org.eclipse.pde.ui/src/org/eclipse/pde/internal/ui/launcher/RuntimeWorkbenchArgumentsTab.java;1;0;4;1;0;0;0;4;45;1;4;1459;61;61;1;0;0;4;4;1459;0;3732;4;1;
/org.eclipse.update.core/src/org/eclipse/update/core/SiteContentProvider.java;4;1;7;2;4;4;4;3;7;2;2;0;24;24;2;1;0;3;7;0;1;6336;6;4;
/org.eclipse.team.ui/src/org/eclipse/team/internal/ui/jobs/IJobListener.java;2;0;3;1;0;0;0;3;26;1;3;2007;26;26;1;0;0;3;3;2007;0;4216;3;2;
/org.eclipse.swt/Eclipse SWT PI/motif/org/eclipse/swt/internal/motif/XWindowChanges.java;1;0;1;1;0;0;0;1;6;0;1;829;6;6;1;0;0;1;1;829;0;829;1;1;
/org.eclipse.jdt.ui/ui/org/eclipse/jdt/internal/ui/wizards/buildpaths/BuildPathSupport.java;1;0;1;1;0;0;0;1;0;0;1;4407;0;0;1;0;0;1;1;4407;0;4407;1;1;
/org.eclipse.jdt.ui.tests.refactoring/resources/MoveInnerToTopLevel/test_nonstatic_1/out/Inner.java;2;0;2;1;1;1;1;1;2;0;1;305;4;4;1;0;0;1;2;305;0;5854;2;2;
/org.eclipse.jdt.ui/core refactoring/org/eclipse/jdt/internal/corext/refactoring/reorg2/ICopyPolicy.java;1;0;5;1;0;0;0;5;16;2;3;516;23;23;2;2;0;5;5;516;2;802;3;1;
/org.eclipse.ltk.ui.refactoring/src/org/eclipse/ltk/internal/ui/refactoring/RefactoringUIMessages.java;1;0;2;1;1;1;1;1;2;0;1;4845;2;2;1;0;0;1;2;4845;0;6340;2;1;
/org.eclipse.update.ui.win32/src/org/eclipse/update/internal/ui/win32/views/BrowserControlSite.java;1;0;1;1;0;0;0;1;0;0;1;889;0;0;1;0;0;1;1;889;0;889;1;1;
/org.eclipse.ui.workbench/Eclipse UI/org/eclipse/ui/internal/commands/old/CoreRegistry.java;1;0;4;1;0;0;0;4;12;1;4;1322;13;13;1;0;0;4;4;1322;0;1695;4;1;
/org.eclipse.update.ui/src/org/eclipse/update/internal/ui/wizards/NewWebSiteDialog.java;3;0;3;1;0;0;0;3;20;1;3;825;30;30;1;0;0;3;3;825;0;4949;3;3;
/org.eclipse.update.core/src/org/eclipse/update/internal/search/Sorter.java;2;0;2;1;0;0;0;2;0;1;2;825;0;0;1;0;0;2;2;825;0;4698;2;2;
/org.eclipse.update.core/srcnew/org/eclipse/update/internal/operations/FeatureOperation.java;1;0;4;1;0;0;0;4;10;1;4;616;18;18;1;0;0;4;4;616;0;825;4;1;
/org.eclipse.ui.ide/src/org/eclipse/ui/internal/dialogs/FileSystemResourceExporter.java;2;0;2;1;0;0;0;2;0;1;2;1526;0;0;1;0;0;2;2;1526;0;2263;2;2;
/org.eclipse.pde.ui/src_Forms/org/eclipse/pde/internal/ui/neweditor/site/SiteEditor.java;3;2;7;2;4;3;4;3;36;2;2;4832;54;54;2;1;1;3;7;4832;2;5431;5;3;
/org.eclipse.jdt.core.tests.model/workspace/Converter/test0089/Test.java;1;0;1;1;0;0;0;1;0;0;1;3714;0;0;1;0;0;1;1;3714;0;3714;1;1;
/org.eclipse.ui.workbench/Eclipse UI/org/eclipse/ui/contexts/IContextContextBinding.java;2;0;5;1;0;0;0;5;31;1;5;3066;45;45;1;0;0;5;5;3066;0;4969;5;2;
/org.eclipse.swt/Eclipse SWT Mozilla/common/org/eclipse/swt/internal/mozilla/nsIComponentManager.java;1;0;1;1;0;0;0;1;0;0;1;1654;0;0;1;0;0;1;1;1654;0;1654;1;1;
/org.eclipse.ltk.core.refactoring/src/org/eclipse/ltk/internal/core/refactoring/BufferValidationState.java;1;1;6;1;5;5;5;1;23;0;1;4845;58;58;1;0;0;1;6;4845;0;6317;6;1;
/org.eclipse.pde.ui/src_Forms/org/eclipse/pde/internal/ui/neweditor/schema/TypeRestrictionDescriptor.java;1;0;2;1;0;0;0;2;0;1;2;4856;0;0;1;0;0;2;2;4856;0;4879;2;1;
/org.eclipse.jdt.debug.ui/ui/org/eclipse/jdt/internal/debug/core/refactoring/LaunchConfigurationITypeMoveParticipant.java;3;1;4;1;3;3;3;1;10;0;1;5001;20;20;1;0;0;1;4;5001;0;6339;4;3;
/org.eclipse.jdt.ui/core extension/org/eclipse/jdt/internal/corext/util/SuperTypeHierarchyCache.java;3;0;6;1;1;1;1;5;101;1;5;1336;129;129;1;0;0;5;6;1336;0;6340;6;3;
/org.eclipse.ant.ui/Ant Editor/org/eclipse/ant/internal/ui/editor/templates/BuildFileContextType.java;2;0;2;1;1;1;1;1;22;0;1;4916;22;22;1;0;0;1;2;4916;0;5187;2;2;
/org.eclipse.ui.workbench/Eclipse UI/org/eclipse/ui/activities/service/IMutableActivityService.java;1;0;2;1;0;0;0;2;0;1;2;2896;0;0;1;0;0;2;2;2896;0;3066;2;1;
/org.eclipse.jdt.ui/ui/org/eclipse/jdt/ui/actions/SelectionDispatchAction.java;2;0;4;2;1;1;1;3;24;1;3;592;45;45;1;0;0;3;4;592;0;6340;4;2;
/org.eclipse.ui.workbench.texteditor/src/org/eclipse/ui/texteditor/FindReplaceTarget.java;1;1;4;1;2;2;2;2;31;1;2;1346;39;39;1;0;0;2;4;1346;0;6340;4;1;
/org.eclipse.ui.views/src/org/eclipse/ui/views/internal/markers/tasks/Completion.java;1;0;3;1;0;0;0;3;4;1;3;265;4;4;1;0;0;3;3;265;0;749;3;1;
/org.eclipse.ui.ide/src/org/eclipse/ui/views/markers/internal/SortUtil.java;1;0;1;1;0;0;0;1;0;0;1;3214;0;0;1;0;0;1;1;3214;0;3214;1;1;
/org.eclipse.search/search/org/eclipse/search/internal/ui/SearchDialog.java;2;1;13;1;3;3;3;10;107;2;9;1346;431;431;2;1;0;10;13;2907;1;5681;12;2;
/org.eclipse.swt.graphics.text/Eclipse SWT PI/gtk/org/eclipse/swt/internal/gtk/PangoAttrInt.java;2;0;2;1;0;0;0;2;0;1;2;3874;0;0;1;0;0;2;2;3874;0;4213;2;2;
/org.eclipse.jdt.core.tests.model/workspace/Converter/test0164/Test.java;1;0;1;1;0;0;0;1;0;0;1;3714;0;0;1;0;0;1;1;3714;0;3714;1;1;
/org.eclipse.jdt.core.tests.model/workspace/Formatter/test487/A_in.java;1;0;1;1;1;1;1;0;0;0;0;5188;0;0;1;0;0;0;1;5188;0;5188;1;1;
/org.eclipse.osgi/supplement/src/org/eclipse/osgi/framework/util/SecureAction.java;3;1;6;1;3;3;3;3;58;1;3;4471;99;99;1;0;0;3;6;4471;0;6337;6;3;
/org.eclipse.core.tests.runtime/src/org/eclipse/core/tests/internal/plugins/SoftPrereqTest_1.java;1;0;1;1;0;0;0;1;0;0;1;3014;0;0;1;0;0;1;1;3014;0;3014;1;1;
/org.eclipse.jdt.core.tests.model/workspace/Formatter/test329/A_in.java;1;0;1;1;0;0;0;1;0;0;1;2640;0;0;1;0;0;1;1;2640;0;2640;1;1;
/org.eclipse.jdt.ui/core refactoring/org/eclipse/jdt/internal/corext/refactoring/participants/xml/PropertyTester.java;1;0;4;1;0;0;0;4;56;1;4;1125;56;56;1;0;0;4;4;1125;0;4108;4;1;
/org.eclipse.jdt.ui/ui/org/eclipse/jdt/ui/wizards/IClasspathContainerPageExtension2.java;1;0;2;1;1;1;1;1;6;0;1;4407;6;6;1;0;0;1;2;4407;0;5130;2;1;
/org.eclipse.jdt.ui/ui/org/eclipse/jdt/internal/ui/text/correction/JavadocTagsSubProcessor.java;3;2;19;1;8;6;8;11;400;1;11;2506;1144;1144;2;0;2;11;19;5226;2;6340;17;3;
/org.eclipse.jdt.ui/ui/org/eclipse/jdt/internal/ui/text/link/ExclusivePositionUpdater.java;1;0;3;1;0;0;0;3;102;1;3;2838;102;102;1;0;0;3;3;2838;0;4214;3;1;
/org.eclipse.ui.tests/Eclipse UI Tests/org/eclipse/ui/tests/intro/IntroTest.java;1;1;4;1;2;2;2;2;34;1;2;4649;77;77;1;0;0;2;4;4649;0;6319;4;1;
/org.eclipse.jdt.core/compiler/org/eclipse/jdt/internal/compiler/env/IBinaryField.java;1;0;1;1;0;0;0;1;2;0;1;3560;2;2;1;0;0;1;1;3560;0;3560;1;1;
/org.eclipse.jdt.ui.tests/ui/org/eclipse/jdt/ui/tests/core/CoreTests.java;4;1;20;2;4;4;4;16;108;2;14;219;284;284;2;2;0;16;20;219;2;6340;18;4;
/org.eclipse.jdt.core/compiler/org/eclipse/jdt/internal/compiler/ast/InstanceOfExpression.java;3;0;6;1;0;0;0;6;248;1;6;991;297;297;1;0;0;6;6;991;0;4910;6;3;
/org.eclipse.jdt.ui/core refactoring/org/eclipse/jdt/internal/corext/refactoring/reorg2/ReorgCopyStarter.java;1;0;3;1;0;0;0;3;2;2;2;849;2;2;2;1;0;3;3;1112;1;1112;2;1;
/org.eclipse.swt/Eclipse SWT PI/win32/org/eclipse/swt/internal/ole/win32/STGMEDIUM.java;1;0;1;1;0;0;0;1;4;0;1;2915;4;4;1;0;0;1;1;2915;0;2915;1;1;
/org.eclipse.jdt.core.tests.compiler/src/org/eclipse/jdt/core/tests/compiler/regression/ScannerTest.java;3;0;5;1;0;0;0;5;26;2;4;2101;70;70;2;1;0;5;5;2119;1;3560;4;3;
/org.eclipse.team.core/src/org/eclipse/team/core/subscribers/helpers/SynchronizationSyncBytesCache.java;1;0;1;1;0;0;0;1;0;0;1;3240;0;0;1;0;0;1;1;3240;0;3240;1;1;
/org.eclipse.debug.ui/ui/org/eclipse/debug/ui/variables/LaunchConfigurationVariable.java;2;0;3;1;0;0;0;3;3;1;3;323;3;3;1;0;0;3;3;323;0;550;3;2;
/org.eclipse.pde.ui/src_Forms/org/eclipse/pde/internal/ui/neweditor/runtime/LibrarySection.java;2;0;4;1;0;0;0;4;10;1;4;4406;18;18;1;0;0;4;4;4406;0;4919;4;2;
/org.eclipse.help/src/org/eclipse/help/browser/IBrowserFactory.java;1;0;1;1;0;0;0;1;0;0;1;2732;0;0;1;0;0;1;1;2732;0;2732;1;1;
/org.eclipse.text/src/org/eclipse/jface/text/TextUtilities.java;3;1;10;1;3;3;3;7;129;2;6;1510;301;301;2;1;0;7;10;1589;1;6298;9;3;
/org.eclipse.ui.workbench/Eclipse UI/org/eclipse/ui/internal/commands/old/LocalRegistry.java;1;0;2;1;0;0;0;2;1;1;2;1322;1;1;1;0;0;2;2;1322;0;1356;2;1;
/org.eclipse.ui.ide/src/org/eclipse/ui/internal/ide/actions/BuildSetMenu.java;1;0;2;1;1;1;1;1;6;0;1;4651;6;6;1;0;0;1;2;4651;0;5183;2;1;
/org.eclipse.ui.cheatsheets/src/org/eclipse/ui/internal/cheatsheets/views/IntroItem.java;2;1;12;1;4;4;4;8;38;2;7;4428;130;130;2;1;0;8;12;4701;1;5944;11;2;
/org.eclipse.ui.tests/Eclipse JFace Tests/org/eclipse/jface/tests/viewers/CheckboxTreeViewerMissingTest.java;1;0;1;1;1;1;1;0;0;0;0;5916;0;0;1;0;0;0;1;5916;0;5916;1;1;
/org.eclipse.update/src/org/eclipse/update/internal/ui/UMWizardPageURLInstallable.java;1;0;1;1;1;1;1;0;0;0;0;6339;0;0;1;0;0;0;1;6339;0;6339;1;1;
/org.eclipse.jdt.ui/ui/org/eclipse/jdt/internal/ui/actions/ActionMessages.java;2;1;2;1;2;2;2;0;10;0;0;5360;12;12;1;0;0;0;2;5360;0;6340;2;2;
/org.eclipse.ui.workbench/Eclipse UI/org/eclipse/ui/internal/presentations/EditorPresentation.java;6;3;34;2;15;10;15;19;200;4;13;4517;998;998;4;6;5;19;34;4517;11;5532;23;6;
/org.eclipse.jdt.ui/ui/org/eclipse/jdt/internal/ui/text/correction/ASTRewriteCorrectionProposal.java;2;0;16;1;1;1;1;15;59;2;14;85;316;316;2;1;0;15;16;1952;1;5406;15;2;
/org.eclipse.debug.core/core/org/eclipse/debug/core/ILaunchManager.java;1;0;11;1;1;1;1;10;32;2;9;463;158;158;2;1;0;10;11;4949;1;5106;10;1;
/org.eclipse.pde.ui/src/org/eclipse/pde/internal/ui/editor/plugin/PackageSelectionDialog.java;2;1;4;1;4;4;4;0;10;0;0;5431;20;20;1;0;0;0;4;5431;0;6336;4;2;
/org.eclipse.ui.ide/src/org/eclipse/ui/internal/ide/EditorAreaDropAdapter.java;2;0;3;1;0;0;0;3;188;1;3;2264;201;201;1;0;0;3;3;2264;0;2898;3;2;
/org.eclipse.jdt.core.tests.model/src/org/eclipse/jdt/core/tests/model/ModifyingResourceTests.java;4;0;10;2;1;1;1;9;40;2;8;487;95;95;2;1;0;9;10;2514;1;5853;9;4;
/org.eclipse.core.runtime/src/org/eclipse/core/internal/runtime/Log.java;4;1;8;1;3;3;3;5;164;1;5;3013;344;344;1;0;0;5;8;3013;0;6340;8;4;
/org.eclipse.jdt.debug.tests/tests/org/eclipse/jdt/debug/tests/eval/ShortOperatorsTests.java;1;0;1;1;0;0;0;1;222;0;1;1274;222;222;1;0;0;1;1;1274;0;1274;1;1;
/org.eclipse.ui.externaltools/Ant Editor/org/eclipse/ui/externaltools/internal/ant/editor/utils/ProjectHelperImpl.java;1;0;2;1;0;0;0;2;6;1;2;245;6;6;1;0;0;2;2;245;0;282;2;1;
/org.eclipse.ui.editors/src/org/eclipse/ui/internal/editors/quickdiff/compare/rangedifferencer/IRangeComparator.java;2;0;2;1;0;0;0;2;0;1;2;1118;0;0;1;0;0;2;2;1118;0;1644;2;2;
/org.eclipse.swt.graphics.text/Eclipse SWT Custom Widgets/common/org/eclipse/swt/custom/StyledText.java;3;0;29;2;0;0;0;29;2428;3;23;2896;6252;6252;3;6;0;29;29;4472;6;5063;23;3;
/org.eclipse.team.tests.core/src/org/eclipse/team/tests/core/SyncElementTest.java;1;0;1;1;0;0;0;1;0;0;1;2495;0;0;1;0;0;1;1;2495;0;2495;1;1;
/org.eclipse.ui.workbench/Eclipse UI/org/eclipse/ui/IElementFactory.java;1;0;1;1;0;0;0;1;1;0;1;2737;1;1;1;0;0;1;1;2737;0;2737;1;1;
/org.eclipse.ui.workbench/Eclipse UI/org/eclipse/ui/commands/ICategoryEvent.java;1;0;4;1;0;0;0;4;31;2;3;1435;31;31;2;1;0;4;4;2562;1;2824;3;1;
/org.eclipse.ui.ide/src/org/eclipse/ui/internal/dialogs/WizardNewProjectNameAndLocationPage.java;2;0;3;1;0;0;0;3;32;1;3;1526;32;32;1;0;0;3;3;1526;0;2263;3;2;
/org.eclipse.ui.workbench/Eclipse UI/org/eclipse/ui/internal/commands/CommandServiceForWindows.java;1;0;2;1;0;0;0;2;0;1;2;618;0;0;1;0;0;2;2;618;0;689;2;1;
/org.eclipse.jdt.ui.examples.javafamily/sample/Date2.java;1;0;1;1;0;0;0;1;0;0;1;1033;0;0;1;0;0;1;1;1033;0;1033;1;1;
/org.eclipse.jdt.ui.tests.refactoring/resources/ExtractMethodWorkSpace/ExtractMethodTests/duplicates_out/A_test954.java;1;0;1;1;0;0;0;1;0;0;1;1219;0;0;1;0;0;1;1;1219;0;1219;1;1;
/org.eclipse.search/search/org/eclipse/search/internal/ui/util/FileLabelProvider.java;1;0;1;1;1;1;1;0;2;0;0;6340;2;2;1;0;0;0;1;6340;0;6340;1;1;
/org.eclipse.pde.core/src/org/eclipse/pde/core/IModelChangeProvider.java;2;1;3;1;3;3;3;0;57;0;0;5115;93;93;1;0;0;0;3;5115;0;6336;3;2;
/org.eclipse.pde.ui/sandbox/org/eclipse/pde/internal/ui/editor/standalone/text/XMLScanner.java;1;0;2;1;0;0;0;2;0;1;2;2320;0;0;1;0;0;2;2;2320;0;2906;2;1;
/org.eclipse.ui.workbench/Eclipse UI/org/eclipse/ui/internal/registry/StickyViewDescriptor.java;1;1;3;1;3;3;3;0;41;0;0;5110;61;61;1;0;0;0;3;5110;0;5590;3;1;
/org.eclipse.ui.externaltools/Ant Editor/org/eclipse/ui/externaltools/internal/ant/editor/outline/XMLCore.java;1;0;1;1;0;0;0;1;0;0;1;282;0;0;1;0;0;1;1;282;0;282;1;1;
/org.eclipse.ui.ide/src/org/eclipse/ui/wizards/datatransfer/DataTransferMessages.java;1;0;1;1;0;0;0;1;0;0;1;1511;0;0;1;0;0;1;1;1511;0;1511;1;1;
/org.eclipse.ui.ide/src/org/eclipse/ui/internal/dialogs/ProjectReferencePage.java;2;0;4;1;0;0;0;4;10;1;4;1526;14;14;1;0;0;4;4;1526;0;2263;4;2;
/org.eclipse.swt/Eclipse SWT Drag and Drop/motif/org/eclipse/swt/dnd/Transfer.java;1;1;2;1;2;2;2;0;4;0;0;5606;6;6;1;0;0;0;2;5606;0;6352;2;1;
/org.eclipse.pde.ui/src/org/eclipse/pde/internal/ui/wizards/plugin/NewFragmentProjectWizard.java;3;2;9;1;6;5;6;3;94;1;3;3840;160;160;2;0;1;3;9;5204;1;6336;8;3;
/org.eclipse.jdt.core/compiler/org/eclipse/jdt/internal/compiler/ast/StringLiteral.java;3;1;5;1;2;2;2;3;36;1;3;991;52;52;1;0;0;3;5;991;0;5635;5;3;
/org.eclipse.core.runtime/src/org/eclipse/core/internal/locks/Lock.java;1;0;1;1;0;0;0;1;0;0;1;320;0;0;1;0;0;1;1;320;0;320;1;1;
/org.eclipse.jdt.core/compiler/org/eclipse/jdt/internal/compiler/impl/Constant.java;1;0;1;1;0;0;0;1;2;0;1;3560;2;2;1;0;0;1;1;3560;0;3560;1;1;
/org.eclipse.update.ui/src/org/eclipse/update/internal/ui/views/SwapVersionAction.java;3;0;4;1;0;0;0;4;24;1;4;825;26;26;1;0;0;4;4;825;0;1242;4;3;
/org.eclipse.jdt.ui/ui/org/eclipse/jdt/internal/ui/text/spelling/WordCompletionProcessor.java;2;0;2;1;1;1;1;1;2;0;1;3930;2;2;1;0;0;1;2;3930;0;6340;2;2;
/org.eclipse.jdt.ui.tests.refactoring/resources/ExtractMethodWorkSpace/ExtractMethodTests/locals_in/A_test530.java;1;0;1;1;0;0;0;1;2;0;1;844;2;2;1;0;0;1;1;844;0;844;1;1;
/org.eclipse.jdt.ui/ui/org/eclipse/jdt/internal/ui/typehierarchy/HierarchyInformationControl.java;3;1;22;1;2;2;2;20;172;2;19;505;918;918;2;1;0;20;22;505;1;6340;21;3;
/org.eclipse.jdt.ui/ui/org/eclipse/jdt/internal/ui/CompatibilityTemplateStore.java;2;1;6;1;3;3;3;3;50;1;3;4826;110;110;1;0;0;3;6;4826;0;6340;6;2;
/org.eclipse.jdt.ui.tests.refactoring/resources/InlineMethodWorkspace/TestCases/argument_in/TestArray.java;1;0;1;1;0;0;0;1;0;0;1;2136;0;0;1;0;0;1;1;2136;0;2136;1;1;
/org.eclipse.jdt.core/search/org/eclipse/jdt/internal/core/search/matching/SuperInterfaceReferencePattern.java;1;0;1;1;0;0;0;1;0;0;1;1177;0;0;1;0;0;1;1;1177;0;1177;1;1;
/org.eclipse.jdt.core/search/org/eclipse/jdt/core/search/ISearchPattern.java;1;1;5;1;2;2;2;3;4;1;3;1819;11;11;1;0;0;3;5;1819;0;5200;5;1;
/org.eclipse.jdt.ui/ui/org/eclipse/jdt/internal/ui/callhierarchy/SearchScopeAction.java;2;1;3;1;2;2;2;1;4;0;1;4047;6;6;1;0;0;1;3;4047;0;6340;3;2;
/org.eclipse.swt/Eclipse SWT PI/motif/org/eclipse/swt/internal/motif/XIconSize.java;2;0;2;1;1;1;1;1;4;0;1;3616;4;4;1;0;0;1;2;3616;0;6352;2;2;
/org.eclipse.team.webdav/src/org/eclipse/team/internal/core/target/LocationMapping.java;2;0;3;1;1;1;1;2;2;1;2;2495;3;3;1;0;0;2;3;2495;0;6337;3;2;
/org.eclipse.team.core/src/org/eclipse/team/core/variants/ISynchronizerChangeListener.java;1;0;2;1;1;1;1;1;6;0;1;4349;6;6;1;0;0;1;2;4349;0;6125;2;1;
/org.eclipse.update.ui/srcnew/org/eclipse/update/internal/ui/wizards/TargetPage2.java;2;0;2;1;0;0;0;2;0;1;2;367;0;0;1;0;0;2;2;367;0;478;2;2;
/org.eclipse.pde.ui/src_Forms/org/eclipse/pde/internal/ui/model/plugin/PluginModelFactory2.java;1;0;2;1;0;0;0;2;0;1;2;4438;0;0;1;0;0;2;2;4438;0;4919;2;1;
/org.eclipse.jdt.core.tests.model/workspace/Converter/test0426/A.java;1;0;1;1;0;0;0;1;0;0;1;3714;0;0;1;0;0;1;1;3714;0;3714;1;1;
/org.eclipse.core.runtime.compatibility/src-runtime/org/eclipse/core/internal/plugins/DefaultPlugin.java;2;1;4;1;2;2;2;2;2;1;2;3013;5;5;1;0;0;2;4;3013;0;6340;4;2;
/org.eclipse.ui.workbench/Eclipse UI/org/eclipse/ui/commands/ICategoryDefinitionHandle.java;1;0;2;1;0;0;0;2;0;1;2;1389;0;0;1;0;0;2;2;1389;0;1400;2;1;
/org.eclipse.ui.workbench/Eclipse UI/org/eclipse/ui/commands/internal/ActionAndContextManager.java;1;0;5;1;0;0;0;5;243;3;3;774;253;253;3;2;0;5;5;774;2;956;3;1;
/org.eclipse.core.runtime.compatibility/src-runtime/org/eclipse/core/internal/plugins/RegistryAdapters.java;2;0;2;1;0;0;0;2;0;1;2;3013;0;0;1;0;0;2;2;3013;0;3169;2;2;
/org.eclipse.jdt.core.tests.model/workspace/Formatter/test257/A_out.java;1;0;1;1;0;0;0;1;0;0;1;2442;0;0;1;0;0;1;1;2442;0;2442;1;1;
/org.eclipse.jdt.ui/ui/org/eclipse/jdt/internal/ui/actions/OpenTypeAction.java;2;1;3;1;3;3;3;0;13;0;0;5651;23;23;1;0;0;0;3;5651;0;6340;3;2;
/org.eclipse.team.ui/src/org/eclipse/team/ui/synchronize/TeamSubscriberRefreshSchedule.java;1;0;1;1;0;0;0;1;0;0;1;3900;0;0;1;0;0;1;1;3900;0;3900;1;1;
/org.eclipse.jdt.debug.ui/ui/org/eclipse/jdt/internal/debug/ui/actions/AddExceptionDialog.java;2;0;4;1;0;0;0;4;14;1;4;1240;21;21;1;0;0;4;4;1240;0;3093;4;2;
/org.eclipse.core.tests.runtime/src/org/eclipse/core/tests/internal/plugins/RegressionResolveTest_3.java;1;0;1;1;0;0;0;1;0;0;1;3014;0;0;1;0;0;1;1;3014;0;3014;1;1;
/org.eclipse.ui.workbench/Eclipse UI/org/eclipse/ui/internal/registry/MarkerQueryResult.java;1;0;1;1;0;0;0;1;0;0;1;2737;0;0;1;0;0;1;1;2737;0;2737;1;1;
/org.eclipse.core.tests.resources/src/org/eclipse/core/tests/internal/indexing/TestPage.java;1;0;1;1;1;1;1;0;11;0;0;5147;11;11;1;0;0;0;1;5147;0;5147;1;1;
/org.eclipse.webdav/src/kernel/org/eclipse/webdav/internal/kernel/utils/DateTime.java;1;1;2;1;2;2;2;0;184;0;0;5151;196;196;1;0;0;0;2;5151;0;5760;2;1;
/org.eclipse.ui.workbench/Eclipse UI/org/eclipse/ui/internal/model/ResourceFactory.java;1;0;1;1;0;0;0;1;0;0;1;2737;0;0;1;0;0;1;1;2737;0;2737;1;1;
/org.eclipse.jdt.core/model/org/eclipse/jdt/internal/core/util/LocalVariableTypeAttribute.java;1;0;1;1;0;0;0;1;0;0;1;4394;0;0;1;0;0;1;1;4394;0;4394;1;1;
/org.eclipse.swt/Eclipse SWT/motif/org/eclipse/swt/graphics/GCData.java;5;0;6;2;1;1;1;5;11;1;5;0;29;29;1;0;0;5;6;0;0;6352;6;5;
/org.eclipse.ui.ide/src/org/eclipse/ui/views/navigator/ResourceNavigator.java;4;1;9;1;3;3;3;6;20;1;6;2208;51;51;1;0;0;6;9;2208;0;6338;9;4;
/org.eclipse.jdt.ui.tests.refactoring/resources/MoveInnerToTopLevel/test_nonstatic_36/in/A.java;1;0;1;1;0;0;0;1;1;0;1;901;1;1;1;0;0;1;1;901;0;901;1;1;
/org.eclipse.team.ui/src/org/eclipse/team/ui/synchronize/ISyncInfoSet.java;1;0;1;1;0;0;0;1;0;0;1;3286;0;0;1;0;0;1;1;3286;0;3286;1;1;
/org.eclipse.jdt.core.tests.model/workspace/Converter/junit/swingui/DefaultFailureDetailView.java;1;0;2;1;0;0;0;2;86;1;2;787;86;86;1;0;0;2;2;787;0;3714;2;1;
/org.eclipse.jdt.ui.tests.refactoring/resources/ExtractMethodWorkSpace/ExtractMethodTests/try_in/A_test459.java;1;0;1;1;0;0;0;1;4;0;1;844;4;4;1;0;0;1;1;844;0;844;1;1;
/org.eclipse.jdt.ui/ui/org/eclipse/jdt/ui/actions/InlineTempAction.java;3;0;9;1;1;1;1;8;35;2;7;122;70;70;2;1;0;8;9;518;1;6340;8;3;
/org.eclipse.jdt.ui/ui/org/eclipse/jdt/ui/text/IColorManagerExtension.java;1;1;2;1;2;2;2;0;9;0;0;6322;11;11;1;0;0;0;2;6322;0;6337;2;1;
/org.eclipse.swt/Eclipse SWT/photon/org/eclipse/swt/widgets/MessageBox.java;3;1;4;2;2;2;2;2;20;0;1;2824;31;31;2;1;0;2;4;2824;1;6352;3;3;
/org.eclipse.ui.workbench/Eclipse UI/org/eclipse/ui/internal/commands/KeyConfigurationHandle.java;1;0;4;1;0;0;0;4;0;1;4;1321;0;0;1;0;0;4;4;1321;0;1417;4;1;
/org.eclipse.ui.workbench/Eclipse UI/org/eclipse/ui/commands/ICommandHandlerServiceListener.java;1;0;5;1;0;0;0;5;18;1;5;1223;22;22;1;0;0;5;5;1223;0;4144;5;1;
/org.eclipse.ltk.core.refactoring/src/org/eclipse/ltk/core/refactoring/participants/DeleteRefactoring.java;1;1;5;1;3;3;3;2;19;1;2;4845;29;29;1;0;0;2;5;4845;0;6340;5;1;
/org.eclipse.jdt.core/model/org/eclipse/jdt/internal/core/util/ClassFileReader.java;1;0;2;1;0;0;0;2;4;1;2;103;6;6;1;0;0;2;2;103;0;3560;2;1;
/org.eclipse.pde.build/src/org/eclipse/pde/internal/build/AbstractBuildScriptGenerator.java;2;0;5;1;0;0;0;5;0;1;5;447;0;0;1;0;0;5;5;447;0;1113;5;2;
/org.eclipse.pde.ui/src/org/eclipse/pde/internal/ui/editor/EmptyOutlinePage.java;1;1;2;1;2;2;2;0;10;0;0;5431;10;10;1;0;0;0;2;5431;0;6336;2;1;
/org.eclipse.core.tests.runtime/src/org/eclipse/core/tests/runtime/compatibility/AllTests.java;1;0;1;1;1;1;1;0;0;0;0;5987;0;0;1;0;0;0;1;5987;0;5987;1;1;
/org.eclipse.jdt.ui.tests.refactoring/resources/ChangeTypeRefactoring/positive/A_testArray_in.java;1;0;1;1;0;0;0;1;0;0;1;2844;0;0;1;0;0;1;1;2844;0;2844;1;1;
/org.eclipse.jdt.debug.tests/tests/org/eclipse/jdt/debug/tests/eval/TypeHierarchy_68_1.java;1;0;1;1;0;0;0;1;16;0;1;1274;16;16;1;0;0;1;1;1274;0;1274;1;1;
/org.eclipse.text/projection/org/eclipse/jface/text/projection/ProjectionDocumentEvent.java;2;1;5;1;3;3;3;2;80;1;2;4516;103;103;1;0;0;2;5;4516;0;6340;5;2;
/org.eclipse.jdt.ui/ui/org/eclipse/jdt/internal/ui/viewsupport/MemberFilter.java;2;0;4;1;1;1;1;3;23;1;3;2307;39;39;1;0;0;3;4;2307;0;6340;4;2;
/org.eclipse.ui.externaltools/Ant Editor/org/eclipse/ui/externaltools/internal/ant/editor/AntEditorSourceViewerConfiguration.java;1;0;2;1;0;0;0;2;8;1;2;178;8;8;1;0;0;2;2;178;0;282;2;1;
/org.eclipse.jdt.debug.ui/ui/org/eclipse/jdt/internal/debug/ui/launchConfigurations/AbstractClasspathEntry.java;1;0;2;1;0;0;0;2;0;0;1;2685;0;0;2;1;0;2;2;2685;1;2685;1;1;
/org.eclipse.jdt.ui/ui/org/eclipse/jdt/internal/ui/search/TextSearchLabelProvider.java;3;1;4;1;3;3;3;1;9;0;1;4888;12;12;1;0;0;1;4;4888;0;6340;4;3;
/org.eclipse.jface.text/src/org/eclipse/jface/text/rules/SingleLineRule.java;1;1;3;1;2;2;2;1;23;0;1;4190;26;26;1;0;0;1;3;4190;0;6340;3;1;
/org.eclipse.jdt.ui.tests/leaks/org/eclipse/jdt/ui/leaktest/LeakTestSetup.java;2;0;2;1;1;1;1;1;2;0;1;3124;2;2;1;0;0;1;2;3124;0;6340;2;2;
/org.eclipse.pde/src/org/eclipse/pde/internal/builders/FeatureConsistencyChecker.java;3;1;7;1;4;4;4;3;49;1;3;2229;180;180;1;0;0;3;7;2229;0;6336;7;3;
/org.eclipse.team.ui/src/org/eclipse/team/internal/ui/synchronize/SynchronizeManager.java;2;2;29;1;9;8;9;20;1806;2;19;2535;3630;3630;2;1;1;20;29;2932;2;6337;27;2;
/org.eclipse.ui.workbench/Eclipse UI/org/eclipse/ui/internal/csm/activities/api/IActivityManagerEvent.java;1;0;3;1;0;0;0;3;22;2;2;2225;22;22;2;1;0;3;3;2238;1;2238;2;1;
/org.eclipse.jdt.core.tests.model/workspace/Formatter/test096/A_in.java;1;0;1;1;0;0;0;1;0;0;1;2425;0;0;1;0;0;1;1;2425;0;2425;1;1;
/org.eclipse.jdt.ui.tests.refactoring/resources/MoveMembers/test41/in/B.java;1;0;1;1;0;0;0;1;0;0;1;4630;0;0;1;0;0;1;1;4630;0;4630;1;1;
/org.eclipse.jdt.core.tests.model/workspace/Converter/test0420/A.java;1;0;1;1;0;0;0;1;0;0;1;3714;0;0;1;0;0;1;1;3714;0;3714;1;1;
/org.eclipse.jdt.core/compiler/org/eclipse/jdt/internal/compiler/ast/OperatorIds.java;1;0;1;1;0;0;0;1;2;0;1;3560;2;2;1;0;0;1;1;3560;0;3560;1;1;
/org.eclipse.jdt.ui.examples.javafamily/src/org/eclipse/jdt/internal/ui/examples/jspeditor/JavaReconcilePipeParticipant.java;1;0;6;1;0;0;0;6;246;2;5;1071;264;264;2;1;0;6;6;1150;1;1629;5;1;
/org.eclipse.jdt.ui/core extension/org/eclipse/jdt/internal/corext/codemanipulation/IOverrideMethodQuery.java;1;0;1;1;0;0;0;1;0;0;1;576;0;0;1;0;0;1;1;576;0;576;1;1;
/org.eclipse.jface/src/org/eclipse/jface/viewers/IContentProvider.java;3;1;3;1;2;2;2;1;4;0;1;1;8;8;1;0;0;1;3;1;0;6338;3;3;
/org.eclipse.update.ui.forms/src/org/eclipse/update/ui/forms/internal/FormLabel.java;1;0;1;1;0;0;0;1;5;0;1;907;5;5;1;0;0;1;1;907;0;907;1;1;
/org.eclipse.swt.opengl.examples/src/org/eclipse/swt/opengl/examples/SelectionTab.java;1;0;1;1;0;0;0;1;0;0;1;1175;0;0;1;0;0;1;1;1175;0;1175;1;1;
/org.eclipse.team.cvs.ui/src/org/eclipse/team/internal/ccvs/ui/actions/CompareWithRemoteAction.java;2;1;13;1;5;5;5;8;109;1;8;1133;275;275;1;0;0;8;13;1133;0;6337;13;2;
/org.eclipse.ant.ui/Ant Editor/org/eclipse/ant/internal/ui/editor/derived/SubstitutionTextReader.java;1;1;3;1;2;2;2;1;29;0;1;1811;33;33;1;0;0;1;3;1811;0;6336;3;1;
/org.eclipse.jdt.core/compiler/org/eclipse/jdt/internal/compiler/ast/AnnotationTypeDeclaration.java;1;0;1;1;0;0;0;1;0;0;1;4473;0;0;1;0;0;1;1;4473;0;4473;1;1;
/org.eclipse.jdt.debug.ui/ui/org/eclipse/jdt/internal/debug/ui/JavaDetailFormattersPreferencePage.java;4;0;4;1;0;0;0;4;25;1;4;121;39;39;1;0;0;4;4;121;0;3114;4;4;
/org.eclipse.jdt.ui.tests.refactoring/resources/DeleteSourceReference/test16/in/A.java;1;0;1;1;0;0;0;1;0;0;1;1652;0;0;1;0;0;1;1;1652;0;1652;1;1;
/org.eclipse.core.resources/src/org/eclipse/core/resources/ISaveParticipant.java;1;0;3;1;1;1;1;2;289;1;2;44;297;297;1;0;0;2;3;44;0;5146;3;1;
/org.eclipse.search/new search/org/eclipse/search2/internal/ui/basic/views/SearchResultTreeModel.java;1;0;2;1;0;0;0;2;0;1;2;3474;0;0;1;0;0;2;2;3474;0;3711;2;1;
/org.eclipse.core.runtime/src/org/eclipse/core/runtime/IPluginRegistry.java;3;1;13;1;5;5;5;8;296;2;7;3013;428;428;2;1;0;8;13;3195;1;6363;12;3;
/org.eclipse.osgi/core/adaptor/org/eclipse/osgi/framework/adaptor/FrameworkAdaptor.java;6;1;18;1;7;7;7;11;45;1;11;3013;171;171;1;0;0;11;18;3013;0;6337;18;6;
/org.eclipse.team.examples.filesystem/src/org/eclipse/team/examples/pessimistic/IPessimisticFilesystemConstants.java;1;0;2;1;1;1;1;1;64;0;1;3368;64;64;1;0;0;1;2;3368;0;6103;2;1;
/org.eclipse.jdt.core.tests.model/workspace/Formatter/test366/A_in.java;1;0;1;1;0;0;0;1;0;0;1;3128;0;0;1;0;0;1;1;3128;0;3128;1;1;
/org.eclipse.jdt.ui.tests.refactoring/resources/InlineMethodWorkspace/TestCases/argument_in/TestParameterNameUsed1.java;1;0;1;1;0;0;0;1;2;0;1;845;2;2;1;0;0;1;1;845;0;845;1;1;
/org.eclipse.pde.core/src/org/eclipse/pde/internal/core/util/PropertiesUtil.java;3;1;8;1;4;4;4;4;20;1;4;2184;57;57;1;0;0;4;8;2184;0;6336;8;3;
/org.eclipse.core.runtime/src/org/eclipse/core/internal/preferences/LookupOrder.java;1;0;4;1;1;1;1;3;3;2;2;4351;7;7;2;1;0;3;4;4351;1;5150;3;1;
/org.eclipse.jdt.ui.tests.refactoring/resources/MoveMembers/test35/in/A.java;1;0;1;1;0;0;0;1;0;0;1;1856;0;0;1;0;0;1;1;1856;0;1856;1;1;
/org.eclipse.jdt.core.tests.model/workspace/Converter/src/test0417/A.java;1;0;1;1;0;0;0;1;0;0;1;3714;0;0;1;0;0;1;1;3714;0;3714;1;1;
/org.eclipse.jdt.core.tests.model/workspace/Converter/test0228/Test.java;1;0;1;1;0;0;0;1;0;0;1;3714;0;0;1;0;0;1;1;3714;0;3714;1;1;
/org.eclipse.jdt.ui.tests.refactoring/resources/MoveInnerToTopLevel/testFail_nonstatic_3/in/A.java;1;0;1;1;1;1;1;0;0;0;0;6034;0;0;1;0;0;0;1;6034;0;6034;1;1;
/org.eclipse.ui.workbench/Eclipse UI/org/eclipse/ui/internal/commands/AbstractActionService.java;1;0;2;1;0;0;0;2;0;1;2;956;0;0;1;0;0;2;2;956;0;1065;2;1;
/org.eclipse.jdt.core.tests.model/workspace/Converter/test0080/Test.java;1;0;1;1;0;0;0;1;0;0;1;3714;0;0;1;0;0;1;1;3714;0;3714;1;1;
/org.eclipse.jdt.core.tests.model/src/org/eclipse/jdt/core/tests/dom/RunAllTests.java;4;0;6;1;1;1;1;5;8;1;5;3560;17;17;1;0;0;5;6;3560;0;5528;6;4;
/org.eclipse.ui.views/src/org/eclipse/ui/views/internal/markers/ActionCopyMarker.java;1;0;2;1;0;0;0;2;0;0;1;749;0;0;2;1;0;2;2;749;1;749;1;1;
/org.eclipse.update.core/src/org/eclipse/update/core/model/NonPluginEntryModel.java;1;1;2;1;2;2;2;0;6;0;0;5423;10;10;1;0;0;0;2;5423;0;6336;2;1;
/org.eclipse.help/src/org/eclipse/help/internal/toc/TocFileParser.java;1;1;6;1;3;3;3;3;50;1;3;2407;148;148;1;0;0;3;6;2407;0;6337;6;1;
/org.eclipse.ui.workbench/Eclipse UI/org/eclipse/ui/internal/progress/WorkbenchUIJob.java;1;0;3;1;0;0;0;3;57;1;3;860;57;57;1;0;0;3;3;860;0;954;3;1;
/org.eclipse.pde.core/src/org/eclipse/pde/internal/core/PDEState.java;3;2;13;2;6;5;6;7;19;4;4;4726;66;66;4;3;1;7;13;4726;4;6336;9;3;
/org.eclipse.team.core/src/org/eclipse/team/core/subscribers/MutableSyncInfoSet.java;1;0;1;1;0;0;0;1;0;0;1;3550;0;0;1;0;0;1;1;3550;0;3550;1;1;
/org.eclipse.jdt.core/codeassist/org/eclipse/jdt/internal/codeassist/select/SelectionParser.java;5;0;18;2;1;1;1;17;50;3;14;69;168;168;3;3;0;17;18;2604;3;5731;15;5;
/org.eclipse.jdt.core.tests.model/workspace/Formatter/test346/A_in.java;1;0;1;1;0;0;0;1;0;0;1;2893;0;0;1;0;0;1;1;2893;0;2893;1;1;
/org.eclipse.jdt.ui.tests.refactoring/resources/DeleteSourceReference/test18/in/A.java;1;0;1;1;0;0;0;1;0;0;1;1652;0;0;1;0;0;1;1;1652;0;1652;1;1;
/org.eclipse.jdt.ui/ui/org/eclipse/jdt/internal/ui/text/comment/CommentFormattingStrategy.java;3;0;16;1;1;1;1;15;135;2;14;1589;519;519;2;1;0;15;16;4886;1;6340;15;3;
/org.eclipse.team.ui/src/org/eclipse/team/internal/ui/synchronize/actions/WorkingSetMenuContributionItem.java;2;0;6;1;1;1;1;5;82;1;5;2535;151;151;1;0;0;5;6;2535;0;5596;6;2;
/org.eclipse.pde.ui/src_Forms/org/eclipse/pde/internal/ui/neweditor/build/EmptyOutlinePage.java;2;1;2;1;2;2;2;0;0;0;0;5344;0;0;1;0;0;0;2;5344;0;5393;2;2;
/org.eclipse.jdt.ui/core refactoring/org/eclipse/jdt/internal/corext/refactoring/participants/IProcessorBasedRefactoring.java;1;0;2;1;0;0;0;2;0;1;2;1709;0;0;1;0;0;2;2;1709;0;4624;2;1;
/org.eclipse.swt/Eclipse SWT/common/org/eclipse/swt/graphics/Drawable.java;2;2;4;1;3;2;3;1;20;0;1;4127;28;28;2;0;1;1;4;6193;1;6352;3;2;
/org.eclipse.update.ui/srcnew/org/eclipse/update/internal/ui/wizards/RevertConfigurationWizard.java;3;0;3;1;0;0;0;3;4;1;3;542;4;4;1;0;0;3;3;542;0;825;3;3;
/org.eclipse.jdt.ui.tests.refactoring/resources/IntroduceParameter/simple/Javadoc2.java;1;0;1;1;1;1;1;0;2;0;0;5851;2;2;1;0;0;0;1;5851;0;5851;1;1;
/org.eclipse.jdt.ui/ui/org/eclipse/jdt/internal/ui/text/javadoc/IHtmlTagConstants.java;2;0;2;1;1;1;1;1;6;0;1;3829;6;6;1;0;0;1;2;3829;0;6340;2;2;
/org.eclipse.jdt.ui.tests.refactoring/resources/RenamePrivateField/test4/in/A.java;1;0;1;1;0;0;0;1;10;0;1;4560;10;10;1;0;0;1;1;4560;0;4560;1;1;
/org.eclipse.core.expressions/src/org/eclipse/core/internal/expressions/EnablementExpression.java;1;0;2;1;1;1;1;1;2;0;1;4108;2;2;1;0;0;1;2;4108;0;6340;2;1;
/org.eclipse.jdt.debug.tests/test plugin/org/eclipse/jdt/debug/testplugin/SampleDynamicVariableResolver.java;3;0;3;1;0;0;0;3;4;1;3;2140;7;7;1;0;0;3;3;2140;0;2514;3;3;
/org.eclipse.ui.workbench/Eclipse UI/org/eclipse/ui/internal/commands/api/older/IKeyConfigurationListener.java;1;0;2;1;0;0;0;2;0;0;1;2562;0;0;2;1;0;2;2;2562;1;2562;1;1;
/org.eclipse.jdt.core.tests.model/workspace/Formatter/test056/A_out.java;1;0;1;1;0;0;0;1;0;0;1;2425;0;0;1;0;0;1;1;2425;0;2425;1;1;
/org.eclipse.jdt.core.tests.model/workspace/Converter/test0364/A.java;1;0;1;1;0;0;0;1;0;0;1;3714;0;0;1;0;0;1;1;3714;0;3714;1;1;
/org.eclipse.ui.workbench/Eclipse UI/org/eclipse/ui/internal/commands/old/NotDelegatedException.java;1;0;2;1;0;0;0;2;0;1;2;1341;0;0;1;0;0;2;2;1341;0;1430;2;1;
/org.eclipse.jdt.ui/ui/org/eclipse/jdt/internal/ui/typehierarchy/ITypeHierarchyLifeCycleListener.java;1;0;1;1;1;1;1;0;2;0;0;6340;2;2;1;0;0;0;1;6340;0;6340;1;1;
/org.eclipse.pde.ui/src/org/eclipse/pde/internal/ui/editor/site/FeatureProjectSection.java;2;0;4;1;0;0;0;4;6;1;4;368;12;12;1;0;0;4;4;368;0;2311;4;2;
/org.eclipse.jface.text/src/org/eclipse/jface/text/contentassist/ContextInformationPopup.java;3;3;18;1;10;8;10;8;147;2;7;1347;435;435;3;1;2;8;18;6353;3;6353;15;3;
/org.eclipse.jdt.core/search/org/eclipse/jdt/core/search/LocalVariableReferenceMatch.java;3;1;9;1;5;5;5;4;38;1;4;3913;116;116;1;0;0;4;9;3913;0;5912;9;3;
/org.eclipse.ui.workbench/Eclipse UI/org/eclipse/ui/internal/model/WorkbenchWorkspace.java;1;0;1;1;0;0;0;1;0;0;1;2737;0;0;1;0;0;1;1;2737;0;2737;1;1;
/org.eclipse.ui.workbench/Eclipse UI/org/eclipse/ui/activities/IActivityService.java;1;0;4;1;0;0;0;4;67;1;4;2491;67;67;1;0;0;4;4;2491;0;2896;4;1;
/org.eclipse.jdt.core.tests.model/workspace/Converter/test0361/X.java;1;0;1;1;0;0;0;1;0;0;1;3714;0;0;1;0;0;1;1;3714;0;3714;1;1;
/org.eclipse.ui.workbench/Eclipse UI/org/eclipse/ui/actions/MoveFilesAndFoldersOperation.java;1;0;1;1;0;0;0;1;0;0;1;2737;0;0;1;0;0;1;1;2737;0;2737;1;1;
/org.eclipse.core.resources/src/org/eclipse/core/internal/events/BuildCommand.java;1;0;2;1;2;1;2;0;145;0;0;5146;145;145;2;0;1;0;2;5146;1;5146;1;1;
/org.eclipse.jdt.core/model/org/eclipse/jdt/internal/core/util/CommentRecorderParser.java;4;1;8;1;2;2;2;6;164;1;6;3861;244;244;1;0;0;6;8;3861;0;5878;8;4;
/org.eclipse.jdt.core/compiler/org/eclipse/jdt/internal/compiler/classfmt/ClassFileStruct.java;3;1;4;1;2;2;2;2;15;1;2;1129;30;30;1;0;0;2;4;1129;0;5657;4;3;
/org.eclipse.jdt.ui.tests.refactoring/resources/ExtractMethodWorkSpace/ExtractMethodTests/try_out/A_test456.java;1;0;2;1;0;0;0;2;4;1;2;130;6;6;1;0;0;2;2;130;0;844;2;1;
/org.eclipse.jdt.core/compiler/org/eclipse/jdt/internal/compiler/lookup/BaseTypeBinding.java;2;0;2;1;0;0;0;2;314;1;2;530;316;316;1;0;0;2;2;530;0;3560;2;2;
/org.eclipse.swt.tests/JUnit Tests/org/eclipse/swt/tests/junit/Test_org_eclipse_swt_events_SelectionListener.java;1;0;1;1;0;0;0;1;25;0;1;2175;25;25;1;0;0;1;1;2175;0;2175;1;1;
/org.eclipse.jdt.debug.ui/ui/org/eclipse/jdt/internal/debug/ui/snippeteditor/SnippetDocumentFactory.java;1;0;1;1;0;0;0;1;0;0;1;5067;0;0;1;0;0;1;1;5067;0;5067;1;1;
/org.eclipse.search/search/org/eclipse/search/internal/ui/text/FileContentProvider.java;2;0;3;1;1;1;1;2;6;1;2;3711;8;8;1;0;0;2;3;3711;0;6340;3;2;
/org.eclipse.osgi/defaultAdaptor/src/org/eclipse/osgi/framework/internal/defaultadaptor/PermissionStorage.java;4;0;5;1;1;1;1;4;627;1;4;3013;631;631;1;0;0;4;5;3013;0;5116;5;4;
/org.eclipse.update/src/org/eclipse/update/internal/ui/UMWizardProductComponentNew.java;1;0;1;1;1;1;1;0;0;0;0;6339;0;0;1;0;0;0;1;6339;0;6339;1;1;
/org.eclipse.core.tests.runtime/src/org/eclipse/core/tests/internal/registrycache/CacheHelpers.java;1;0;2;1;0;0;0;2;8;1;2;208;8;8;1;0;0;2;2;208;0;3014;2;1;
/org.eclipse.ui.workbench/Eclipse UI/org/eclipse/ui/internal/progress/WorkbenchMonitorProvider.java;3;0;15;1;1;1;1;14;347;2;10;2119;867;867;2;4;0;14;15;2119;4;6338;11;3;
/org.eclipse.core.tests.resources/src/org/eclipse/core/tests/internal/indexing/IntegratedObjectStoreTest.java;1;0;2;1;2;1;2;0;8;0;0;5147;8;8;2;0;1;0;2;5147;1;5147;1;1;
/org.eclipse.team.examples.filesystem/src/org/eclipse/team/examples/pessimistic/ui/CheckInAction.java;1;0;2;1;1;1;1;1;45;0;1;3368;45;45;1;0;0;1;2;3368;0;6103;2;1;
/org.eclipse.jdt.core.tests.model/workspace/Converter/test0206/Test.java;1;0;1;1;0;0;0;1;0;0;1;3714;0;0;1;0;0;1;1;3714;0;3714;1;1;
/org.eclipse.osgi/core/framework/org/eclipse/osgi/framework/debug/DebugOptions.java;4;1;10;1;5;5;5;5;59;1;5;3013;103;103;1;0;0;5;10;3013;0;6337;10;4;
/org.eclipse.debug.ui/ui/org/eclipse/debug/internal/ui/VariablesViewModelPresentation.java;1;0;1;1;0;0;0;1;2;0;1;1239;2;2;1;0;0;1;1;1239;0;1239;1;1;
/org.eclipse.core.runtime/src/org/eclipse/core/internal/registry/IModel.java;2;1;4;1;2;2;2;2;180;1;2;3049;182;182;1;0;0;2;4;3049;0;5531;4;2;
/org.eclipse.update.ui/src/org/eclipse/update/internal/ui/model/MyComputerDirectory.java;2;0;7;1;0;0;0;7;96;1;7;745;166;166;1;0;0;7;7;745;0;2085;7;2;
/org.eclipse.jdt.core/search/org/eclipse/jdt/internal/core/search/indexing/AddCompilationUnitToIndex.java;2;0;2;1;0;0;0;2;1;1;2;1893;1;1;1;0;0;2;2;1893;0;3211;2;2;
/org.eclipse.debug.core/core/org/eclipse/debug/core/sourcelookup/ISourcePathComputerDelegate.java;1;0;2;1;1;1;1;1;24;0;1;4949;24;24;1;0;0;1;2;4949;0;5109;2;1;
/org.eclipse.jdt.core/model/org/eclipse/jdt/internal/core/SourceRefElement.java;3;0;16;2;1;1;1;15;44;3;13;761;141;141;3;2;0;15;16;1784;2;5185;14;3;
/org.eclipse.swt.tests/JUnit Tests/org/eclipse/swt/tests/junit/Test_org_eclipse_swt_browser_VisibilityAdapter.java;1;0;3;1;0;0;0;3;13;2;2;2862;13;13;2;1;0;3;3;2862;1;3166;2;1;
/org.eclipse.debug.ui/ui/org/eclipse/debug/internal/ui/actions/LaunchShortcutAction.java;2;1;2;1;2;2;2;0;21;0;0;5511;25;25;1;0;0;0;2;5511;0;6336;2;2;
/org.eclipse.jdt.core.tests.model/workspace/Formatter/test370/A_in.java;1;0;1;1;0;0;0;1;0;0;1;3130;0;0;1;0;0;1;1;3130;0;3130;1;1;
/org.eclipse.jdt.core.tests.model/workspace/Formatter/test046/A_out.java;1;0;1;1;0;0;0;1;0;0;1;2425;0;0;1;0;0;1;1;2425;0;2425;1;1;
/org.eclipse.ui.views/src/org/eclipse/ui/views/internal/markers/MarkerTypesModel.java;1;0;3;1;0;0;0;3;5;2;2;265;5;5;2;1;0;3;3;749;1;749;2;1;
/org.eclipse.team.core/src/org/eclipse/team/internal/core/DeploymentProviderManager.java;1;0;3;1;0;0;0;3;447;1;3;2793;447;447;1;0;0;3;3;2793;0;4633;3;1;
/org.eclipse.jdt.debug.ui/ui/org/eclipse/jdt/internal/debug/ui/actions/AddJarAction.java;2;0;6;1;0;0;0;6;27;1;6;1191;80;80;1;0;0;6;6;1191;0;2691;6;2;
/org.eclipse.ui.workbench/Eclipse UI/org/eclipse/ui/internal/commands/XCapture.java;1;0;2;1;0;0;0;2;0;1;2;1695;0;0;1;0;0;2;2;1695;0;1721;2;1;
/org.eclipse.jdt.core.tests.model/workspace/Converter/test0456/A.java;1;0;1;1;0;0;0;1;0;0;1;3714;0;0;1;0;0;1;1;3714;0;3714;1;1;
/org.eclipse.search/search/org/eclipse/search/internal/core/text/TextSearchScope.java;2;1;5;1;2;2;2;3;71;1;3;122;218;218;1;0;0;3;5;122;0;6340;5;2;
/org.eclipse.jdt.ui.tests.refactoring/resources/IntroduceFactory/positive/MultipleCallers_FFF.java;1;0;2;1;1;1;1;1;2;0;1;2862;2;2;1;0;0;1;2;2862;0;5659;2;1;
/org.eclipse.ui.ide/src/org/eclipse/ui/internal/ide/AboutData.java;2;0;3;1;1;1;1;2;7;1;2;4936;7;7;1;0;0;2;3;4936;0;5483;3;2;
/org.eclipse.update.core/srcnew/org/eclipse/update/operations/IOperationValidator.java;2;0;4;1;0;0;0;4;2;1;4;600;3;3;1;0;0;4;4;600;0;825;4;2;
/org.eclipse.jdt.text.tests/src/org/eclipse/jdt/text/tests/PartitionTokenScannerTest.java;1;1;2;1;2;2;2;0;2;0;0;5129;2;2;1;0;0;0;2;5129;0;6340;2;1;
/org.eclipse.jdt.core/compiler/org/eclipse/jdt/internal/compiler/util/SuffixConstants.java;1;0;3;1;0;0;0;3;18;2;2;259;20;20;2;1;0;3;3;259;1;3560;2;1;
/org.eclipse.jdt.debug.tests/test plugin/org/eclipse/jdt/debug/testplugin/JavaTestPlugin.java;2;1;2;1;2;2;2;0;11;0;0;5476;17;17;1;0;0;0;2;5476;0;6337;2;2;
/org.eclipse.ui.tests/Eclipse UI Tests/org/eclipse/ui/tests/keys/Bug43800Test.java;3;0;5;1;0;0;0;5;23;1;5;2266;31;31;1;0;0;5;5;2266;0;3214;5;3;
/org.eclipse.core.resources/src/org/eclipse/core/internal/resources/SyncInfoReader_3.java;1;0;1;1;1;1;1;0;124;0;0;5146;124;124;1;0;0;0;1;5146;0;5146;1;1;
/org.eclipse.swt/Eclipse SWT/motif/org/eclipse/swt/widgets/FileDialog.java;3;1;10;1;2;2;2;8;30;2;6;270;123;123;2;2;0;8;10;2663;2;6352;8;3;
/org.eclipse.core.tests.runtime/src/org/eclipse/core/tests/internal/plugin/a/PluginClass.java;1;0;1;1;1;1;1;0;19;0;0;5149;19;19;1;0;0;0;1;5149;0;5149;1;1;
/org.eclipse.pde.ui/sandbox/org/eclipse/pde/internal/ui/editor/standalone/XMLOutlinePageLabelProvider2.java;1;0;2;1;0;0;0;2;0;1;2;2320;0;0;1;0;0;2;2;2320;0;2906;2;1;
/org.eclipse.team.ui/src/org/eclipse/team/internal/ui/synchronize/compare/SyncInfoCompareInput.java;1;0;3;1;0;0;0;3;206;1;3;2535;206;206;1;0;0;3;3;2535;0;4216;3;1;
/org.eclipse.search/search/org/eclipse/search/ui/ISearchResultView.java;2;1;3;1;3;3;3;0;3;0;0;6116;7;7;1;0;0;0;3;6116;0;6340;3;2;
/org.eclipse.pde.build/src/org/eclipse/pde/internal/build/site/PDEState.java;2;2;19;1;16;15;16;3;387;1;3;4089;604;604;2;0;1;3;19;5308;1;6218;18;2;
/org.eclipse.jdt.ui.tests.refactoring/test cases/org/eclipse/jdt/ui/tests/nls/PropertyFileDocumentModellTest.java;4;1;8;1;7;7;7;1;365;0;1;4930;665;665;1;0;0;1;8;4930;0;6340;8;4;
/org.eclipse.swt/Eclipse SWT PI/carbon/org/eclipse/swt/internal/carbon/ControlTabInfoRecV1.java;1;2;3;1;3;2;3;0;16;0;0;5534;20;20;2;0;1;0;3;5534;1;5614;2;1;
/org.eclipse.jdt.ui.tests.refactoring/resources/MoveInstanceMethod/canMove/test19/out/Shape.java;1;0;1;1;0;0;0;1;0;0;1;1570;0;0;1;0;0;1;1;1570;0;1570;1;1;
/org.eclipse.team.examples.filesystem/src/org/eclipse/team/examples/pessimistic/ui/PessimisticDecorator.java;1;0;2;1;1;1;1;1;130;0;1;3368;130;130;1;0;0;1;2;3368;0;6103;2;1;
/org.eclipse.jdt.ui.tests.refactoring/resources/TypeConstraints/A_testBad0.java;1;0;2;1;0;0;0;2;0;1;2;53;0;0;1;0;0;2;2;53;0;74;2;1;
/org.eclipse.ui.workbench/Eclipse UI/org/eclipse/ui/internal/csm/commands/api/IKeyConfiguration.java;1;0;4;1;0;0;0;4;36;2;3;2532;48;48;2;1;0;4;4;2549;1;2562;3;1;
/org.eclipse.jdt.core.tests.compiler/src/org/eclipse/jdt/core/tests/compiler/regression/BatchCompilerTest.java;1;0;1;1;0;0;0;1;2;0;1;3560;2;2;1;0;0;1;1;3560;0;3560;1;1;
/org.eclipse.jdt.core.tests.model/workspace/Converter/src/test0292/Test.java;1;0;1;1;0;0;0;1;0;0;1;3714;0;0;1;0;0;1;1;3714;0;3714;1;1;
/org.eclipse.jdt.core/compiler/org/eclipse/jdt/internal/compiler/lookup/VariableBinding.java;1;0;1;1;0;0;0;1;2;0;1;3560;2;2;1;0;0;1;1;3560;0;3560;1;1;
/org.eclipse.jdt.ui/core refactoring/org/eclipse/jdt/internal/corext/refactoring/typeconstraints/StrictSubtypeConstraint.java;1;0;3;1;0;0;0;3;3;1;3;42;3;3;1;0;0;3;3;42;0;64;3;1;
/org.eclipse.ui.ide/src/org/eclipse/ui/internal/ide/dialogs/WelcomeEditorInput.java;3;1;7;1;2;2;2;5;7;1;5;2264;18;18;1;0;0;5;7;2264;0;6338;7;3;
/org.eclipse.jdt.ui/ui/org/eclipse/jdt/internal/ui/jarpackager/JarOptionsPage.java;1;1;3;1;2;2;2;1;8;0;1;1350;13;13;1;0;0;1;3;1350;0;6340;3;1;
/org.eclipse.pde.ui/src/org/eclipse/pde/internal/ui/wizards/tools/UpdateBuildpathWizardPage.java;2;1;4;1;3;3;3;1;8;0;1;3840;18;18;1;0;0;1;4;3840;0;6336;4;2;
/org.eclipse.jdt.core.tests.model/workspace/Completion/src/CompletionNonStaticFieldRelevance.java;1;0;1;1;1;1;1;0;0;0;0;5636;0;0;1;0;0;0;1;5636;0;5636;1;1;
/org.eclipse.ui.forms/src/org/eclipse/ui/forms/editor/IFormPage.java;1;1;5;1;2;2;2;3;154;1;3;4068;184;184;1;0;0;3;5;4068;0;6336;5;1;
/org.eclipse.jdt.core.tests.model/workspace/Formatter/test356/A_out.java;1;0;1;1;0;0;0;1;3;0;1;3086;3;3;1;0;0;1;1;3086;0;3086;1;1;
/org.eclipse.jdt.ui/ui/org/eclipse/jdt/internal/ui/text/correction/LinkedNamesAssistProposal.java;4;2;19;1;6;5;6;13;75;1;13;218;260;260;2;0;1;13;19;5127;1;6340;18;4;
/org.eclipse.jdt.ui/ui/org/eclipse/jdt/internal/ui/wizards/buildpaths/MultipleFolderSelectionDialog.java;2;0;4;1;1;1;1;3;4;1;3;3830;7;7;1;0;0;3;4;3830;0;6340;4;2;
/org.eclipse.update.core/src/org/eclipse/update/core/model/InstallAbortedException.java;1;1;4;1;4;4;4;0;7;0;0;5406;14;14;1;0;0;0;4;5406;0;6336;4;1;
/org.eclipse.ui.workbench/Eclipse UI/org/eclipse/ui/presentations/WorkbenchPresentationFactory.java;5;1;9;1;5;5;5;4;42;1;4;4508;116;116;1;0;0;4;9;4508;0;6338;9;5;
/org.eclipse.update.core/src/org/eclipse/update/core/SiteFeatureReference.java;4;1;6;2;3;3;3;3;14;2;2;0;32;32;2;1;0;3;6;0;1;6336;5;4;
/org.eclipse.jdt.ui.tests.refactoring/resources/ExtractMethodWorkSpace/ExtractMethodTests/expression_out/A.java;1;0;2;1;0;0;0;2;0;1;2;1465;0;0;1;0;0;2;2;1465;0;1474;2;1;
/org.eclipse.jdt.ui/ui/org/eclipse/jdt/internal/ui/compare/JavaReplaceWithPreviousEditionAction.java;2;0;2;1;1;1;1;1;2;0;1;1730;4;4;1;0;0;1;2;1730;0;6340;2;2;
/org.eclipse.pde.ui/src/org/eclipse/pde/internal/ui/wizards/templates/MultiPageEditorNewWizard.java;3;3;8;1;6;4;6;2;37;1;2;3986;64;64;3;0;2;2;8;5916;2;6336;6;3;
/org.eclipse.team.ui/src/org/eclipse/team/internal/ui/sync/views/SyncSetInputFromSyncSet.java;1;0;3;1;0;0;0;3;100;1;3;488;100;100;1;0;0;3;3;488;0;1354;3;1;
/org.eclipse.jface.text/src/org/eclipse/jface/text/templates/TemplateMessages.java;2;1;4;1;2;2;2;2;2;0;1;4258;2;2;2;1;0;2;4;4258;1;5304;3;2;
/org.eclipse.text/src/org/eclipse/jface/text/source/AnnotationMap.java;2;1;3;1;3;3;3;0;8;0;0;5382;10;10;1;0;0;0;3;5382;0;6340;3;2;
/org.eclipse.update.tests.core/src/org/eclipse/update/tests/regularInstall/TestExecutablePackagedInstall.java;2;0;3;1;1;1;1;2;8;1;2;3813;16;16;1;0;0;2;3;3813;0;6336;3;2;
/org.eclipse.jdt.ui/core refactoring/org/eclipse/jdt/internal/corext/refactoring/sef/AccessAnalyzer.java;3;0;7;1;1;1;1;6;135;1;6;882;180;180;1;0;0;6;7;882;0;6340;7;3;
/org.eclipse.update.tests.core/src/org/eclipse/update/tests/mirror/MirrorManagerTestCase.java;2;1;5;1;2;2;2;3;7;2;2;2104;21;21;2;1;0;3;5;2104;1;6336;4;2;
/org.eclipse.jdt.ui.tests/examples/org/eclipse/jdt/ui/examples/TwoPaneElementSelectorExample.java;1;0;1;1;1;1;1;0;2;0;0;6340;2;2;1;0;0;0;1;6340;0;6340;1;1;
/org.eclipse.jdt.ui/ui/org/eclipse/jdt/ui/jarpackager/IManifestProvider.java;2;0;2;2;2;1;2;0;6;0;0;6334;6;6;2;0;1;0;2;6334;1;6334;1;2;
/org.eclipse.ant.ui/Ant Editor/org/eclipse/ant/internal/ui/editor/derived/HTMLTextPresenter.java;1;0;3;1;1;1;1;2;4;1;2;1811;8;8;1;0;0;2;3;1811;0;6336;3;1;
/org.eclipse.core.resources/src/org/eclipse/core/internal/resources/PlatformURLResourceConnection.java;1;1;2;1;2;2;2;0;92;0;0;5111;98;98;1;0;0;0;2;5111;0;5146;2;1;
/org.eclipse.jdt.ui.tests.refactoring/test cases/org/eclipse/jdt/ui/tests/actions/StructureSelectionActionTests.java;4;1;4;1;2;2;2;2;29;1;2;469;62;62;1;0;0;2;4;469;0;6340;4;4;
/org.eclipse.ui.workbench/Eclipse UI/org/eclipse/ui/contexts/SimpleContextService.java;1;0;2;1;0;0;0;2;0;1;2;1119;0;0;1;0;0;2;2;1119;0;1135;2;1;
/org.eclipse.ui.views/src/org/eclipse/ui/views/navigator/ResourceNavigatorMoveAction.java;1;0;1;1;0;0;0;1;0;0;1;2738;0;0;1;0;0;1;1;2738;0;2738;1;1;
/org.eclipse.jdt.debug.ui/ui/org/eclipse/jdt/internal/debug/ui/actions/TerminateEvaluationAction.java;1;0;1;1;0;0;0;1;3;0;1;1240;3;3;1;0;0;1;1;1240;0;1240;1;1;
/org.eclipse.team.cvs.ssh/src/org/eclipse/team/internal/ccvs/ssh/KnownHosts.java;2;0;5;1;1;1;1;4;15;1;4;866;43;43;1;0;0;4;5;866;0;6337;5;2;
/org.eclipse.ui.ide/src/org/eclipse/ui/internal/dialogs/WizardCollectionElement.java;2;0;4;1;0;0;0;4;60;1;4;1526;64;64;1;0;0;4;4;1526;0;2263;4;2;
/org.eclipse.jdt.debug.ui/ui/org/eclipse/jdt/internal/debug/ui/actions/AddFolderAction.java;3;0;6;1;1;1;1;5;16;1;5;1240;35;35;1;0;0;5;6;1240;0;6336;6;3;
/org.eclipse.pde.core/src/org/eclipse/pde/core/IModelProviderListener.java;2;1;3;1;2;2;2;1;29;0;1;2229;35;35;1;0;0;1;3;2229;0;6336;3;2;
/org.eclipse.pde.ui/src/org/eclipse/pde/internal/ui/editor/manifest/MatchSection.java;1;0;4;1;1;1;1;3;100;1;3;368;124;124;1;0;0;3;4;368;0;5431;4;1;
/org.eclipse.help/src/org/eclipse/help/internal/util/PluginVersionInfo.java;1;0;1;1;0;0;0;1;0;0;1;2732;0;0;1;0;0;1;1;2732;0;2732;1;1;
/org.eclipse.ui.workbench/Eclipse UI/org/eclipse/ui/commands/ICommandActivationService.java;1;0;2;1;0;0;0;2;0;0;1;1222;0;0;2;1;0;2;2;1222;1;1222;1;1;
/org.eclipse.jdt.core.tests.model/workspace/Converter/junit/framework/TestListener.java;1;0;1;1;0;0;0;1;0;0;1;3714;0;0;1;0;0;1;1;3714;0;3714;1;1;
/org.eclipse.swt/Eclipse SWT PI/carbon/org/eclipse/swt/internal/carbon/ATSUTab.java;2;2;4;1;3;2;3;1;16;0;1;1974;20;20;2;0;1;1;4;5534;1;5614;3;2;
/org.eclipse.debug.ui/ui/org/eclipse/debug/internal/ui/actions/TextViewerAction.java;1;0;1;1;0;0;0;1;0;0;1;2060;0;0;1;0;0;1;1;2060;0;2060;1;1;
/org.eclipse.pde.core/src/org/eclipse/pde/internal/core/bundle/BundlePlugin.java;3;1;6;1;6;6;6;0;34;0;0;5445;66;66;1;0;0;0;6;5445;0;6336;6;3;
/org.eclipse.ui.workbench/Eclipse UI/org/eclipse/ui/internal/presentations/PresentationUtil.java;2;0;2;2;0;0;0;2;0;0;1;4469;0;0;2;1;0;2;2;4469;1;4469;1;2;
/org.eclipse.team.ui/src/org/eclipse/team/internal/ui/wizards/GlobalSynchronizeWizard.java;2;1;8;1;4;4;4;4;83;1;4;4449;259;259;1;0;0;4;8;4449;0;6337;8;2;
/org.eclipse.pde.ui/sandbox/org/eclipse/pde/internal/ui/editor/standalone/text/XMLDocumentProvider.java;1;0;2;1;0;0;0;2;0;1;2;2320;0;0;1;0;0;2;2;2320;0;2906;2;1;
/org.eclipse.pde.ui/src/org/eclipse/pde/internal/ui/editor/schema/TypeRestrictionCellEditor.java;2;1;2;1;2;2;2;0;4;0;0;5781;8;8;1;0;0;0;2;5781;0;6336;2;2;
/org.eclipse.jdt.debug.ui/ui/org/eclipse/jdt/internal/debug/ui/actions/BreakpointLocationVerifierJob.java;3;1;14;2;2;2;2;12;36;2;10;1610;109;109;2;2;0;12;14;1652;2;5802;12;3;
/org.eclipse.jdt.ui.tests.refactoring/resources/ExtractMethodWorkSpace/ExtractMethodTests/locals_out/A_test550.java;1;0;1;1;0;0;0;1;4;0;1;844;4;4;1;0;0;1;1;844;0;844;1;1;
/org.eclipse.pde.ui/src/org/eclipse/pde/internal/ui/editor/manifest/PluginUndoManager.java;1;0;1;1;1;1;1;0;0;0;0;5431;0;0;1;0;0;0;1;5431;0;5431;1;1;
/org.eclipse.jdt.ui.tests.refactoring/resources/InlineMethodWorkspace/TestCases/cast_out/TestReceiverCast.java;1;0;1;1;0;0;0;1;0;0;1;1446;0;0;1;0;0;1;1;1446;0;1446;1;1;
/org.eclipse.jdt.ui.tests.refactoring/resources/InlineMethodWorkspace/TestCases/controlStatement_out/TestForOne.java;1;0;1;1;0;0;0;1;2;0;1;845;2;2;1;0;0;1;1;845;0;845;1;1;
/org.eclipse.ltk.ui.refactoring.tests/src/org/eclipse/ltk/ui/refactoring/tests/AllTests.java;1;0;3;1;1;1;1;2;2;1;2;4845;4;4;1;0;0;2;3;4845;0;6340;3;1;
/org.eclipse.jdt.ui/ui/org/eclipse/jdt/internal/ui/typehierarchy/TypeHierarchyLifeCycle.java;2;0;6;1;1;1;1;5;82;1;5;1386;155;155;1;0;0;5;6;1386;0;6340;6;2;
/org.eclipse.update.ui/src/org/eclipse/update/internal/ui/pages/DetailsPage.java;1;0;1;1;0;0;0;1;0;0;1;755;0;0;1;0;0;1;1;755;0;755;1;1;
/org.eclipse.ui.workbench/Eclipse UI/org/eclipse/ui/internal/progress/StatusLineProgressListener.java;1;0;8;1;0;0;0;8;73;2;7;1707;127;127;2;1;0;8;8;1707;1;2119;7;1;
/org.eclipse.jdt.core.tests.model/workspace/Formatter/test396/A_out.java;1;0;1;1;0;0;0;1;0;0;1;3435;0;0;1;0;0;1;1;3435;0;3435;1;1;
/org.eclipse.jdt.core.tests.model/workspace/Converter/src/test0099/Test.java;1;0;1;1;0;0;0;1;0;0;1;3714;0;0;1;0;0;1;1;3714;0;3714;1;1;
/org.eclipse.swt.tests/JUnit Tests/org/eclipse/swt/tests/junit/Test_org_eclipse_swt_browser_VisibilityWindowAdapter.java;1;0;2;1;0;0;0;2;14;0;1;3166;14;14;2;1;0;2;2;3166;1;3166;1;1;
/org.eclipse.core.runtime/src/org/eclipse/core/internal/dependencies/SatisfactionVisitor.java;2;0;2;1;0;0;0;2;0;1;2;2105;0;0;1;0;0;2;2;2105;0;3013;2;2;
/org.eclipse.ui.workbench/Eclipse UI/org/eclipse/ui/internal/commands/ContextBindingElement.java;1;0;2;1;0;0;0;2;0;1;2;1244;0;0;1;0;0;2;2;1244;0;1321;2;1;
/org.eclipse.ui.workbench.texteditor/src/org/eclipse/ui/texteditor/DefaultMarkerAnnotationAccess.java;3;0;5;1;0;0;0;5;27;1;5;1572;78;78;1;0;0;5;5;1572;0;2741;5;3;
/org.eclipse.jdt.ui.tests.refactoring/resources/ExtractTemp/canExtract/A_test79_in.java;1;0;1;1;1;1;1;0;0;0;0;5909;0;0;1;0;0;0;1;5909;0;5909;1;1;
/org.eclipse.jdt.ui/ui/org/eclipse/jdt/ui/actions/OverrideMethodsAction.java;3;1;13;1;4;4;4;9;682;2;8;576;812;812;2;1;0;9;13;576;1;6340;12;3;
/org.eclipse.pde.ui/src/org/eclipse/pde/internal/ui/editor/feature/ReferencePropertySource.java;3;1;5;1;2;2;2;3;15;1;3;2229;42;42;1;0;0;3;5;2229;0;6336;5;3;
/org.eclipse.jdt.ui.tests.refactoring/resources/IntroduceFactory/Bugzilla/48504/p1/B_out.java;1;1;2;1;2;2;2;0;2;0;0;5629;2;2;1;0;0;0;2;5629;0;5659;2;1;
/org.eclipse.ui.workbench/Eclipse UI/org/eclipse/ui/actions/CloseResourceAction.java;2;0;3;1;0;0;0;3;38;1;3;66;76;76;1;0;0;3;3;66;0;2737;3;2;
/org.eclipse.debug.core/core/org/eclipse/debug/core/ILaunchConfiguration.java;3;0;4;1;1;1;1;3;53;1;3;1539;69;69;1;0;0;3;4;1539;0;6336;4;3;
/org.eclipse.jdt.ui/ui/org/eclipse/jdt/internal/ui/typehierarchy/ShowInheritedMembersAction.java;1;0;1;1;1;1;1;0;2;0;0;6340;2;2;1;0;0;0;1;6340;0;6340;1;1;
/org.eclipse.jdt.debug.ui/ui/org/eclipse/jdt/internal/debug/ui/classpath/ClasspathModel.java;3;0;6;1;1;1;1;5;27;2;4;2691;56;56;2;1;0;5;6;3353;1;6336;5;3;
/org.eclipse.jdt.core.tests.compiler/src/org/eclipse/jdt/core/tests/compiler/parser/SingleCompletionTest.java;1;0;1;1;0;0;0;1;2;0;1;3560;2;2;1;0;0;1;1;3560;0;3560;1;1;
/org.eclipse.jdt.ui.tests.refactoring/resources/ExtractMethodWorkSpace/ExtractMethodTests/wiki_in/A_test2005.java;1;0;2;1;0;0;0;2;4;1;2;130;5;5;1;0;0;2;2;130;0;844;2;1;
/org.eclipse.debug.core/core/org/eclipse/debug/internal/core/stringsubstitution/ContextVariable.java;1;0;2;1;0;0;0;2;0;1;2;2032;0;0;1;0;0;2;2;2032;0;2140;2;1;
/org.eclipse.ui.workbench/Eclipse UI/org/eclipse/ui/wizards/datatransfer/ZipFileExporter.java;1;0;1;1;0;0;0;1;0;0;1;2737;0;0;1;0;0;1;1;2737;0;2737;1;1;
/org.eclipse.ui.workbench/Eclipse UI/org/eclipse/ui/part/ViewPart.java;7;2;10;2;9;6;9;1;180;0;1;4703;417;417;2;0;3;1;10;5467;3;6338;7;7;
/org.eclipse.core.runtime/src/org/eclipse/core/internal/plugins/RegistryWriter.java;1;0;1;1;0;0;0;1;0;0;1;3013;0;0;1;0;0;1;1;3013;0;3013;1;1;
/org.eclipse.ant.ui/Ant Tools Support/org/eclipse/ant/internal/ui/launchConfigurations/AntClasspathTab2.java;1;0;3;1;0;0;0;3;15;2;2;4332;30;30;2;1;0;3;3;4332;1;4357;2;1;
/org.eclipse.team.ui/src/org/eclipse/team/ui/synchronize/subscribers/SubscriberConfiguration.java;1;0;1;1;0;0;0;1;0;0;1;4982;0;0;1;0;0;1;1;4982;0;4982;1;1;
/org.eclipse.jdt.core.tests.model/workspace/TypeHierarchy/src/p7/X.java;1;0;1;1;0;0;0;1;0;0;1;2136;0;0;1;0;0;1;1;2136;0;2136;1;1;
/org.eclipse.team.ui/src/org/eclipse/team/internal/ui/synchronize/CompressedFoldersModelProvider.java;2;1;12;1;7;7;7;5;282;1;5;4414;374;374;1;0;0;5;12;4414;0;6337;12;2;
/org.eclipse.core.resources/src/org/eclipse/core/internal/resources/XMLWriter.java;1;0;2;1;1;1;1;1;181;0;1;2967;185;185;1;0;0;1;2;2967;0;5146;2;1;
/org.eclipse.jdt.ui.tests.refactoring/resources/Paste/test0/in/A.java;1;0;1;1;0;0;0;1;0;0;1;1311;0;0;1;0;0;1;1;1311;0;1311;1;1;
/org.eclipse.team.tests.cvs.core/src/org/eclipse/team/tests/ccvs/core/subscriber/TestUpdateAction.java;2;0;4;1;0;0;0;4;2;1;4;2206;4;4;1;0;0;4;4;2206;0;4450;4;2;
/org.eclipse.jdt.ui/ui/org/eclipse/jdt/internal/ui/dialogs/OptionalMessageDialog.java;1;0;1;1;1;1;1;0;2;0;0;6340;2;2;1;0;0;0;1;6340;0;6340;1;1;
/org.eclipse.ui.tutorials.rcp.part3/src/org/eclipse/ui/tutorials/rcp/part3/RcpPerspective.java;1;0;1;1;1;1;1;0;0;0;0;5118;0;0;1;0;0;0;1;5118;0;5118;1;1;
/org.eclipse.pde.ui/src/org/eclipse/pde/internal/ui/editor/feature/SynchronizeVersionsAction.java;3;1;6;1;5;5;5;1;90;0;1;4203;156;156;1;0;0;1;6;4203;0;6336;6;3;
/org.eclipse.jdt.core.tests.model/workspace/Converter/src/test0419/A.java;1;0;1;1;0;0;0;1;0;0;1;3714;0;0;1;0;0;1;1;3714;0;3714;1;1;
/org.eclipse.ui.workbench/Eclipse UI/org/eclipse/ui/internal/activities/AbstractActivityRegistry.java;3;1;12;1;2;2;2;10;29;2;9;2444;113;113;2;1;0;10;12;2800;1;6338;11;3;
/org.eclipse.jdt.core.tests.model/workspace/Converter/src/test0115/Test.java;1;0;1;1;0;0;0;1;0;0;1;3714;0;0;1;0;0;1;1;3714;0;3714;1;1;
/org.eclipse.ant.ui/Ant Editor/org/eclipse/ant/internal/ui/dtd/util/SortedMap.java;1;0;1;1;0;0;0;1;0;0;1;1811;0;0;1;0;0;1;1;1811;0;1811;1;1;
/org.eclipse.pde.ui/src_Forms/org/eclipse/pde/internal/ui/neweditor/plugin/BuildPage.java;1;0;5;1;0;0;0;5;11;1;5;3777;17;17;1;0;0;5;5;3777;0;4406;5;1;
/org.eclipse.team.core/src/org/eclipse/team/internal/core/streams/TimeoutOutputStream.java;1;0;2;1;0;0;0;2;18;1;2;350;21;21;1;0;0;2;2;350;0;367;2;1;
/org.eclipse.team.webdav/src/org/eclipse/team/internal/core/target/ITargetRunnable.java;1;0;1;1;0;0;0;1;0;0;1;2495;0;0;1;0;0;1;1;2495;0;2495;1;1;
/org.eclipse.ant.tests.ui/Ant Editor Tests/org/eclipse/ui/externaltools/internal/ant/editor/support/TestProblemRequestor.java;1;0;2;1;0;0;0;2;10;1;2;283;10;10;1;0;0;2;2;283;0;1274;2;1;
/org.eclipse.jdt.core/dom/org/eclipse/jdt/core/dom/ForStatement.java;3;1;9;1;2;2;2;7;146;1;7;2872;189;189;1;0;0;7;9;2872;0;5272;9;3;
/org.eclipse.jdt.core.tests.model/workspace/Formatter/test491/BundleChain_in.java;1;0;1;1;1;1;1;0;0;0;0;5253;0;0;1;0;0;0;1;5253;0;5253;1;1;
/org.eclipse.update.ui.forms/Eclipse Forms/org/eclipse/ui/forms/editor/FormPage.java;1;0;6;1;0;0;0;6;107;1;6;3179;185;185;1;0;0;6;6;3179;0;4157;6;1;
/org.eclipse.update.core/srcnew/org/eclipse/update/internal/operations/FeatureInstallOperation.java;1;0;3;1;0;0;0;3;112;2;2;433;112;112;2;1;0;3;3;433;1;442;2;1;
/org.eclipse.jdt.core.tests.model/workspace/Formatter/test217/A_out.java;1;0;1;1;0;0;0;1;0;0;1;2426;0;0;1;0;0;1;1;2426;0;2426;1;1;
/org.eclipse.jdt.ui.tests.refactoring/resources/ConvertAnonymousToNested/cannotConvert/A_testFail4.java;1;0;1;1;0;0;0;1;0;0;1;3434;0;0;1;0;0;1;1;3434;0;3434;1;1;
/org.eclipse.pde.ui/src/org/eclipse/pde/internal/ui/editor/manifest/IReconcilingParticipant.java;1;0;2;1;1;1;1;1;0;0;1;2320;0;0;1;0;0;1;2;2320;0;5431;2;1;
/org.eclipse.ui.editors/src/org/eclipse/ui/internal/editors/text/OpenExternalFileAction.java;3;0;6;1;1;1;1;5;36;1;5;2224;91;91;1;0;0;5;6;2224;0;6340;6;3;
/org.eclipse.jdt.core.tests.model/workspace/Formatter/test138/A_out.java;1;0;1;1;0;0;0;1;0;0;1;2425;0;0;1;0;0;1;1;2425;0;2425;1;1;
/org.eclipse.ui.tests/Eclipse UI Tests/org/eclipse/ui/tests/api/NullTitleTest.java;1;0;2;1;1;1;1;1;0;0;1;4855;0;0;1;0;0;1;2;4855;0;6101;2;1;
/org.eclipse.swt/Eclipse SWT/motif/org/eclipse/swt/widgets/Slider.java;3;1;5;1;2;2;2;3;30;1;3;269;54;54;1;0;0;3;5;269;0;6352;5;3;
/org.eclipse.help.tests/src/org/eclipse/help/tests/dynamic/DynamicTopics.java;1;1;3;1;2;2;2;1;19;0;1;1010;25;25;1;0;0;1;3;1010;0;6337;3;1;
/org.eclipse.jdt.core/model/org/eclipse/jdt/core/IJavaElement.java;2;0;8;1;0;0;0;8;13;1;8;549;41;41;1;0;0;8;8;549;0;3509;8;2;
/org.eclipse.jdt.ui.examples.javafamily/src/org/eclipse/jsp/copied_from_jdtcore/SourceIndexerRequestor.java;1;0;3;1;0;0;0;3;4;1;3;1033;4;4;1;0;0;3;3;1033;0;3235;3;1;
/org.eclipse.ant.ui/Ant Editor/org/eclipse/ant/internal/ui/editor/templates/AntTemplateProposal.java;1;0;1;1;1;1;1;0;0;0;0;5260;0;0;1;0;0;0;1;5260;0;5260;1;1;
/org.eclipse.swt/Eclipse SWT Mozilla/common/org/eclipse/swt/internal/mozilla/nsIAppShell.java;1;0;2;1;0;0;0;2;2;1;2;1654;2;2;1;0;0;2;2;1654;0;2568;2;1;
/org.eclipse.pde.core/src/org/eclipse/pde/core/plugin/IPluginModelBase.java;2;1;10;1;4;4;4;6;48;1;6;2184;144;144;1;0;0;6;10;2184;0;6336;10;2;
/org.eclipse.jdt.ui/core refactoring/org/eclipse/jdt/internal/corext/refactoring/participants/RenameTypeProcessor.java;1;0;4;1;0;0;0;4;48;1;4;591;68;68;1;0;0;4;4;591;0;1125;4;1;
/org.eclipse.swt/Eclipse SWT Drag and Drop/photon/org/eclipse/swt/dnd/RTFTransfer.java;1;0;1;1;0;0;0;1;4;0;1;2364;4;4;1;0;0;1;1;2364;0;2364;1;1;
/org.eclipse.pde.core/src/org/eclipse/pde/internal/core/ifeature/IFeatureObject.java;2;1;3;1;2;2;2;1;6;0;1;4203;12;12;1;0;0;1;3;4203;0;6336;3;2;
/org.eclipse.jdt.core.tests.model/workspace/Converter/test0010/Test.java;1;0;1;1;0;0;0;1;0;0;1;3714;0;0;1;0;0;1;1;3714;0;3714;1;1;
/org.eclipse.ui.workbench/Eclipse UI/org/eclipse/ui/internal/commands/keys/CharacterKey.java;1;0;4;1;0;0;0;4;31;3;2;1264;31;31;3;2;0;4;4;1264;2;1294;2;1;
/org.eclipse.jdt.core.tests.compiler/src/org/eclipse/jdt/core/tests/compiler/regression/RegressionTestSetup.java;3;0;5;1;0;0;0;5;55;1;5;241;70;70;1;0;0;5;5;241;0;4369;5;3;
/org.eclipse.pde.ui/src/org/eclipse/pde/internal/ui/editor/plugin/ExtensionPointDetails.java;3;2;10;1;10;8;10;0;38;0;0;5431;102;102;2;0;2;0;10;5514;2;6336;8;3;
/org.eclipse.ui.editors/src/org/eclipse/ui/internal/texteditor/DelegatingAnnotationPreference.java;2;1;2;1;2;2;2;0;4;0;0;5177;4;4;1;0;0;0;2;5177;0;6340;2;2;
/org.eclipse.ui.intro/src/org/eclipse/ui/internal/intro/impl/presentations/TextIntroPartImplementation.java;1;1;6;1;6;6;6;0;18;0;0;5115;46;46;1;0;0;0;6;5115;0;5937;6;1;
/org.eclipse.ui.workbench/Eclipse UI/org/eclipse/ui/progress/IWorkbenchSiteProgressService.java;1;2;15;1;4;3;4;11;33;2;8;2842;165;165;2;3;1;11;15;4346;4;6340;11;1;
/org.eclipse.ant.ui/Ant Tools Support/org/eclipse/ant/ui/internal/launchConfigurations/TargetTableLabelProvider.java;1;0;5;1;0;0;0;5;20;3;3;250;20;20;3;2;0;5;5;263;2;1811;3;1;
/org.eclipse.ui.cheatsheets/src/org/eclipse/ui/internal/cheatsheets/registry/Sorter.java;2;0;2;1;0;0;0;2;17;1;2;4428;17;17;1;0;0;2;2;4428;0;4626;2;2;
/org.eclipse.jdt.core/search/org/eclipse/jdt/internal/core/index/IIndexerOutput.java;1;0;2;1;0;0;0;2;6;1;2;3240;6;6;1;0;0;2;2;3240;0;3384;2;1;
/org.eclipse.update.ui.forms/src/org/eclipse/update/ui/forms/internal/HTMLTableLayout.java;1;0;2;1;0;0;0;2;844;1;2;925;859;859;1;0;0;2;2;925;0;2849;2;1;
/org.eclipse.jdt.core.tests.model/workspace/Converter/test0279/Test.java;1;0;1;1;0;0;0;1;0;0;1;3714;0;0;1;0;0;1;1;3714;0;3714;1;1;
/org.eclipse.jdt.debug.tests/tests/org/eclipse/jdt/debug/tests/core/ExternalArchiveSourceContainerTests.java;1;0;4;1;1;1;1;3;47;1;3;4652;61;61;1;0;0;3;4;4652;0;5900;4;1;
/org.eclipse.jdt.ui/ui/org/eclipse/jdt/ui/text/folding/IJavaFoldingPreferenceBlock.java;1;1;3;1;3;3;3;0;4;0;0;5440;8;8;1;0;0;0;3;5440;0;6340;3;1;
/org.eclipse.jdt.ui.tests.refactoring/resources/IntroduceFactory/positive/multiUnit1A_FFF_out.java;1;0;2;1;0;0;0;2;0;1;2;2846;0;0;1;0;0;2;2;2846;0;2862;2;1;
/org.eclipse.core.tests.runtime/src/org/eclipse/core/tests/runtime/locks/AllTests.java;1;0;2;1;0;0;0;2;0;1;2;698;0;0;1;0;0;2;2;698;0;850;2;1;
/org.eclipse.jdt.core.tests.model/workspace/Resolve/src/ResolveLocalClass5.java;1;0;1;1;0;0;0;1;0;0;1;1968;0;0;1;0;0;1;1;1968;0;1968;1;1;
/org.eclipse.swt/Eclipse SWT PI/carbon/org/eclipse/swt/internal/carbon/RGBColor.java;1;2;3;1;3;2;3;0;16;0;0;5534;20;20;2;0;1;0;3;5534;1;5614;2;1;
/org.eclipse.update.ui.forms/Eclipse Forms/org/eclipse/ui/forms/events/ExpansionEvent.java;1;0;2;1;0;0;0;2;0;1;2;3096;0;0;1;0;0;2;2;3096;0;4157;2;1;
/org.eclipse.swt.tests/JUnit Tests/org/eclipse/swt/tests/junit/Test_org_eclipse_swt_dnd_DragSourceAdapter.java;1;0;1;1;0;0;0;1;13;0;1;2176;13;13;1;0;0;1;1;2176;0;2176;1;1;
/org.eclipse.swt.graphics.text/Eclipse SWT/win32/org/eclipse/swt/graphics/text/StyleItem.java;1;0;2;1;0;0;0;2;0;1;2;3132;0;0;1;0;0;2;2;3132;0;4189;2;1;
/org.eclipse.core.tests.resources/src/org/eclipse/core/tests/internal/resources/SnowNature.java;1;0;2;1;2;1;2;0;88;0;0;5147;88;88;2;0;1;0;2;5147;1;5147;1;1;
/org.eclipse.jdt.junit/src/org/eclipse/jdt/internal/junit/util/Resources.java;2;1;2;1;2;2;2;0;4;0;0;5434;6;6;1;0;0;0;2;5434;0;6340;2;2;
/org.eclipse.ui.workbench.texteditor/src/org/eclipse/ui/texteditor/IDocumentProviderOperation.java;1;0;1;1;0;0;0;1;0;0;1;1983;0;0;1;0;0;1;1;1983;0;1983;1;1;
/org.eclipse.pde.ui/src_Forms/org/eclipse/pde/internal/ui/newparts/ComboPart.java;2;0;5;1;1;1;1;4;40;1;4;3846;52;52;1;0;0;4;5;3846;0;5431;5;2;
/org.eclipse.swt/Eclipse SWT/common/org/eclipse/swt/internal/image/JPEGScanHeader.java;1;0;2;1;1;1;1;1;6;0;1;3903;10;10;1;0;0;1;2;3903;0;6352;2;1;
/org.eclipse.ui.workbench/Eclipse UI/org/eclipse/ui/actions/OpenSystemEditorAction.java;1;0;1;1;0;0;0;1;0;0;1;2737;0;0;1;0;0;1;1;2737;0;2737;1;1;
/org.eclipse.ui.workbench/Eclipse UI/org/eclipse/ui/internal/PartPluginAction.java;3;1;3;1;2;2;2;1;9;0;1;53;16;16;1;0;0;1;3;53;0;6338;3;3;
/org.eclipse.ui.forms/src/org/eclipse/ui/forms/widgets/ExpandableComposite.java;1;0;11;1;0;0;0;11;145;3;9;4068;315;315;3;2;0;11;11;4808;2;5044;9;1;
/org.eclipse.ua.tests/src/org/eclipse/ui/examples/cheatsheets/pattern/actions/OpenJavaClassWizardWithMain.java;1;0;1;1;1;1;1;0;0;0;0;6081;0;0;1;0;0;0;1;6081;0;6081;1;1;
/org.eclipse.jdt.core/compiler/org/eclipse/jdt/internal/compiler/IAbstractSyntaxTreeVisitor.java;3;0;7;1;0;0;0;7;36;1;7;148;80;80;1;0;0;7;7;148;0;2974;7;3;
/org.eclipse.help.base/src/org/eclipse/help/internal/base/HelpBaseResources.java;1;1;4;1;2;2;2;2;96;1;2;1747;104;104;1;0;0;2;4;1747;0;6337;4;1;
/org.eclipse.core.tools.resources/src/org/eclipse/core/tools/resources/ProjectContentProvider.java;1;0;1;1;1;1;1;0;0;0;0;6302;0;0;1;0;0;0;1;6302;0;6302;1;1;
/org.eclipse.jdt.ui.tests.refactoring/resources/TypeConstraints/A_testConstraints3.java;1;0;1;1;0;0;0;1;0;0;1;53;0;0;1;0;0;1;1;53;0;53;1;1;
/org.eclipse.jdt.core/compiler/org/eclipse/jdt/internal/compiler/problem/ProblemSeverities.java;1;0;1;1;0;0;0;1;2;0;1;3560;2;2;1;0;0;1;1;3560;0;3560;1;1;
/org.eclipse.jface.text/src/org/eclipse/jface/text/source/IAnnotationListener.java;2;0;2;1;1;1;1;1;0;0;1;3825;0;0;1;0;0;1;2;3825;0;5177;2;2;
/org.eclipse.search/new search/org/eclipse/search/ui/SearchJobEvent.java;1;0;2;1;0;0;0;2;0;1;2;3474;0;0;1;0;0;2;2;3474;0;3711;2;1;
/org.eclipse.jdt.core.tests.model/workspace/Formatter/test382/A_in.java;1;0;1;1;0;0;0;1;0;0;1;3163;0;0;1;0;0;1;1;3163;0;3163;1;1;
/org.eclipse.team.ui/src/org/eclipse/team/internal/ui/synchronize/views/ILogicalView.java;1;0;1;1;0;0;0;1;0;0;1;3796;0;0;1;0;0;1;1;3796;0;3796;1;1;
/org.eclipse.jdt.core.tests.model/workspace/Formatter/test325/A_out.java;2;0;3;1;0;0;0;3;38;1;3;2528;43;43;1;0;0;3;3;2528;0;3362;3;2;
/org.eclipse.ui.workbench/Eclipse UI/org/eclipse/ui/internal/CTabPartDragDrop.java;1;0;1;1;0;0;0;1;0;0;1;4015;0;0;1;0;0;1;1;4015;0;4015;1;1;
/org.eclipse.jdt.core.tests.model/workspace/Formatter/test453/A_out.java;1;0;1;1;0;0;0;1;0;0;1;3772;0;0;1;0;0;1;1;3772;0;3772;1;1;
/org.eclipse.ui.examples.job/src/org/eclipse/ui/examples/jobs/actions/ForegroundAction.java;2;1;2;1;2;2;2;0;4;0;0;5126;4;4;1;0;0;0;2;5126;0;5800;2;2;
/org.eclipse.osgi.tests/src/org/eclipse/osgi/tests/OSGiTestsPlugin.java;1;1;3;1;3;3;3;0;2;0;0;5993;2;2;1;0;0;0;3;5993;0;6227;3;1;
/org.eclipse.core.runtime/src/org/eclipse/core/internal/dependencies/IDependency.java;2;0;2;1;0;0;0;2;0;1;2;2105;0;0;1;0;0;2;2;2105;0;3013;2;2;
/org.eclipse.update.ui/src/org/eclipse/update/internal/ui/wizards/EditSiteDialog.java;2;0;4;1;0;0;0;4;20;1;4;825;24;24;1;0;0;4;4;825;0;4949;4;2;
/org.eclipse.ui.workbench/Eclipse UI/org/eclipse/ui/internal/commands/api/IKeyBindingDefinition.java;1;0;5;1;0;0;0;5;4;2;4;1724;4;4;2;1;0;5;5;2515;1;2532;4;1;
/org.eclipse.ui.ide/src/org/eclipse/ui/internal/ide/IDEWorkbenchAdvisor.java;9;2;42;2;18;14;18;24;241;4;21;2901;1099;1099;4;3;4;24;42;4647;7;6338;35;9;
/org.eclipse.swt/Eclipse SWT PI/motif/org/eclipse/swt/internal/motif/XmDropFinishCallback.java;1;0;1;1;0;0;0;1;0;0;1;829;0;0;1;0;0;1;1;829;0;829;1;1;
/org.eclipse.jdt.core/formatter/org/eclipse/jdt/code/formatter/DefaultCodeFormatterConstants.java;1;0;1;1;0;0;0;1;0;0;1;2178;0;0;1;0;0;1;1;2178;0;2178;1;1;
/org.eclipse.core.expressions/src/org/eclipse/core/internal/expressions/NotExpression.java;1;0;2;1;1;1;1;1;8;0;1;4108;8;8;1;0;0;1;2;4108;0;6340;2;1;
/org.eclipse.jdt.core/eval/org/eclipse/jdt/internal/eval/CodeSnippetSuperReference.java;1;0;1;1;0;0;0;1;2;0;1;3560;2;2;1;0;0;1;1;3560;0;3560;1;1;
/org.eclipse.jdt.ui.tests.refactoring/test cases/org/eclipse/jdt/ui/tests/changes/AllTests.java;1;0;1;1;1;1;1;0;2;0;0;6340;2;2;1;0;0;0;1;6340;0;6340;1;1;
/org.eclipse.core.resources/src/org/eclipse/core/resources/refresh/RefreshProvider.java;2;1;4;1;2;2;2;2;41;1;2;3681;47;47;1;0;0;2;4;3681;0;5275;4;2;
/org.eclipse.ant.ui/Ant Editor/org/eclipse/ant/ui/internal/editor/outline/IDocumentModelListener.java;1;0;2;1;0;0;0;2;0;1;2;250;0;0;1;0;0;2;2;250;0;1811;2;1;
/org.eclipse.jdt.ui.tests.refactoring/resources/ChangeSignature/canModify/A_testImport01_out.java;1;0;1;1;0;0;0;1;0;0;1;3820;0;0;1;0;0;1;1;3820;0;3820;1;1;
/org.eclipse.jdt.ui.tests.refactoring/resources/InlineMethodWorkspace/TestCases/receiver_out/TestNameThisReceiver.java;1;0;1;1;0;0;0;1;2;0;1;845;2;2;1;0;0;1;1;845;0;845;1;1;
/org.eclipse.jdt.debug.ui/ui/org/eclipse/jdt/internal/debug/ui/actions/EditWatchExpressionAction.java;2;0;3;1;0;0;0;3;4;1;3;1175;6;6;1;0;0;3;3;1175;0;1516;3;2;
/org.eclipse.osgi/osgi/src/org/osgi/framework/Bundle.java;6;2;12;1;6;5;6;6;269;1;6;3013;458;458;2;0;1;6;12;5207;1;6041;11;6;
/org.eclipse.ui.examples.javaeditor/Template Editor Example/org/eclipse/ui/examples/templateeditor/editors/XMLWhitespaceDetector.java;2;0;2;1;1;1;1;1;10;0;1;4644;10;10;1;0;0;1;2;4644;0;6340;2;2;
/org.eclipse.jdt.core.tests.model/workspace/Converter/src/test0312/Test.java;1;0;1;1;0;0;0;1;0;0;1;3714;0;0;1;0;0;1;1;3714;0;3714;1;1;
/org.eclipse.search/new search/org/eclipse/search2/internal/ui/SearchDropDownAction.java;2;1;8;1;3;3;3;5;20;1;5;3474;52;52;1;0;0;5;8;3474;0;6340;8;2;
/org.eclipse.core.runtime/src/org/eclipse/core/internal/jobs/JobFamily.java;1;0;1;1;0;0;0;1;0;0;1;351;0;0;1;0;0;1;1;351;0;351;1;1;
/org.eclipse.text/src/org/eclipse/jface/text/TypedPosition.java;1;0;1;1;1;1;1;0;17;0;0;6298;17;17;1;0;0;0;1;6298;0;6298;1;1;
/org.eclipse.ui.intro/src/org/eclipse/ui/internal/intro/impl/html/IntroHTMLGenerator.java;3;2;14;2;14;11;14;0;304;0;0;5115;628;628;2;0;3;0;14;5134;3;6222;11;3;
/org.eclipse.jdt.core.tests.model/workspace/Converter/src/test0241/Test.java;1;0;1;1;0;0;0;1;0;0;1;3714;0;0;1;0;0;1;1;3714;0;3714;1;1;
/org.eclipse.help.ide/src/org/eclipse/help/ui/internal/HelpIdeResources.java;1;0;2;1;0;0;0;2;181;1;2;1738;181;181;1;0;0;2;2;1738;0;1778;2;1;
/org.eclipse.pde.ui/src/org/eclipse/pde/ui/templates/OptionTemplateWizardPage.java;3;3;10;1;8;6;8;2;45;1;2;2519;123;123;3;0;2;2;10;5204;2;6336;8;3;
/org.eclipse.update.ui.forms/Eclipse Forms/org/eclipse/ui/forms/internal/parts/Locator.java;1;0;2;1;0;0;0;2;0;1;2;3096;0;0;1;0;0;2;2;3096;0;3138;2;1;
/org.eclipse.osgi/osgi/src/org/osgi/framework/BundleListener.java;2;0;2;1;1;1;1;1;3;0;1;3013;3;3;1;0;0;1;2;3013;0;5536;2;2;
/org.eclipse.pde.ui/src/org/eclipse/pde/internal/ui/editor/manifest/ManifestDependenciesPage.java;1;0;1;1;1;1;1;0;0;0;0;5431;0;0;1;0;0;0;1;5431;0;5431;1;1;
/org.eclipse.swt.graphics.text/Eclipse SWT/common/org/eclipse/swt/graphics/TextStyle.java;2;0;2;1;0;0;0;2;19;1;2;4830;19;19;1;0;0;2;2;4830;0;4869;2;2;
/org.eclipse.jdt.debug.ui/ui/org/eclipse/jdt/internal/debug/ui/launcher/AppletLaunchConfigurationUtils.java;3;1;7;1;4;4;4;3;30;1;3;192;52;52;1;0;0;3;7;192;0;6336;7;3;
/org.eclipse.jdt.ui.tests.refactoring/resources/ExtractMethodWorkSpace/ExtractMethodTests/locals_in/A_test538.java;1;0;1;1;0;0;0;1;2;0;1;844;2;2;1;0;0;1;1;844;0;844;1;1;
/org.eclipse.ui.workbench/Eclipse UI/org/eclipse/ui/internal/CoolBarManager.java;2;0;6;1;0;0;0;6;809;1;6;368;868;868;1;0;0;6;6;368;0;3220;6;2;
/org.eclipse.core.runtime/src/org/eclipse/core/runtime/IRegistryChangeListener.java;3;1;5;1;2;2;2;3;43;1;3;3134;57;57;1;0;0;3;5;3134;0;6340;5;3;
/org.eclipse.ant.ui/Ant Tools Support/org/eclipse/ant/internal/ui/views/actions/AddBuildFileAction.java;1;0;3;1;0;0;0;3;5;1;3;1811;5;5;1;0;0;3;3;1811;0;3147;3;1;
/org.eclipse.jdt.ui/ui/org/eclipse/jdt/ui/actions/RefactorActionGroup.java;6;2;19;2;4;3;4;15;198;2;13;7;559;559;2;2;1;15;19;2844;3;6334;16;6;
/org.eclipse.osgi.tests/src/org/eclipse/osgi/tests/internal/plugins/InstallTests.java;2;1;6;1;5;5;5;1;124;0;1;5066;216;216;1;0;0;1;6;5066;0;6227;6;2;
/org.eclipse.jdt.core.tests.model/workspace/Formatter/test482/A_out.java;1;0;1;1;0;0;0;1;0;0;1;4173;0;0;1;0;0;1;1;4173;0;4173;1;1;
/org.eclipse.update/src/org/eclipse/update/internal/ui/AuthorizationDatabase.java;1;0;1;1;1;1;1;0;0;0;0;6339;0;0;1;0;0;0;1;6339;0;6339;1;1;
/org.eclipse.ui.tests/Eclipse UI Tests/org/eclipse/ui/tests/api/workbenchpart/CustomTitleView.java;1;0;1;1;1;1;1;0;0;0;0;6101;0;0;1;0;0;0;1;6101;0;6101;1;1;
/org.eclipse.ui.workbench/Eclipse UI/org/eclipse/ui/internal/progress/SubTaskInfo.java;3;1;9;1;2;2;2;7;20;2;6;1094;61;61;2;1;0;7;9;1152;1;6338;8;3;
/org.eclipse.jdt.ui.tests.refactoring/resources/MoveMembers/test37/in/A.java;1;0;1;1;0;0;0;1;0;0;1;2093;0;0;1;0;0;1;1;2093;0;2093;1;1;
/org.eclipse.pde.ui/src_Forms/org/eclipse/pde/internal/ui/model/plugin/PluginObjectNode.java;3;2;16;1;10;9;10;6;138;1;6;4438;371;371;2;0;1;6;16;5495;1;6336;15;3;
/org.eclipse.team.cvs.core/src/org/eclipse/team/internal/ccvs/core/client/listeners/TagListener.java;1;0;1;1;0;0;0;1;3;0;1;3107;3;3;1;0;0;1;1;3107;0;3107;1;1;
/org.eclipse.update.ui.forms/src/org/eclipse/ui/forms/parts/ScrollableRichText.java;1;0;5;1;0;0;0;5;29;2;4;2898;63;63;2;1;0;5;5;3095;1;3095;4;1;
/org.eclipse.ui.forms.examples/src/org/eclipse/ui/forms/examples/internal/rcp/ScrolledPropertiesPage.java;1;0;4;1;1;1;1;3;16;1;3;4075;22;22;1;0;0;3;4;4075;0;5781;4;1;
/org.eclipse.swt/Eclipse SWT/win32/org/eclipse/swt/internal/Platform.java;1;0;2;1;0;0;0;2;0;1;2;1955;0;0;1;0;0;2;2;1955;0;1969;2;1;
/org.eclipse.ui.workbench/Eclipse UI/org/eclipse/ui/internal/dialogs/ImportWizard.java;5;0;10;2;1;1;1;9;81;1;9;1950;282;282;1;0;0;9;10;1950;0;6338;10;5;
/org.eclipse.swt.tests/JUnit Tests/org/eclipse/swt/tests/junit/Test_org_eclipse_swt_dnd_DropTargetAdapter.java;1;0;1;1;0;0;0;1;11;0;1;2176;11;11;1;0;0;1;1;2176;0;2176;1;1;
/org.eclipse.debug.core/core/org/eclipse/debug/internal/core/stringsubstitution/DynamicVariable.java;2;0;2;1;0;0;0;2;0;1;2;2140;0;0;1;0;0;2;2;2140;0;2514;2;2;
/org.eclipse.ant.ui/Ant Tools Support/org/eclipse/ant/internal/ui/views/elements/TargetNode.java;1;0;3;1;1;1;1;2;6;1;2;1811;10;10;1;0;0;2;3;1811;0;6336;3;1;
/org.eclipse.jdt.core.tests.model/workspace/JavaSearch/src/f1/X.java;1;0;1;1;0;0;0;1;0;0;1;2514;0;0;1;0;0;1;1;2514;0;2514;1;1;
/org.eclipse.pde.core/src/org/eclipse/pde/internal/core/ifeature/IFeature.java;2;0;2;1;1;1;1;1;28;0;1;4203;32;32;1;0;0;1;2;4203;0;5798;2;2;
/org.eclipse.update.ui.forms/src/org/eclipse/ui/forms/FormColors.java;1;0;4;1;0;0;0;4;11;2;3;3071;19;19;2;1;0;4;4;3095;1;3095;3;1;
/org.eclipse.sdk.tests-feature/plugins/org.eclipse.perfmsr.ui.client/src/org/eclipse/perfmsr/ui/client/ClientUIConstants.java;1;1;3;1;3;3;3;0;10;0;0;5443;11;11;1;0;0;0;3;5443;0;5803;3;1;
/org.eclipse.debug.ui/ui/org/eclipse/debug/internal/ui/sourcelookup/BasicContainerContentProvider.java;1;0;1;1;0;0;0;1;0;0;1;3770;0;0;1;0;0;1;1;3770;0;3770;1;1;
/org.eclipse.jdt.core.tests.compiler/src/org/eclipse/jdt/core/tests/compiler/regression/GenericTypeTest.java;1;0;1;1;0;0;0;1;0;0;1;3579;0;0;1;0;0;1;1;3579;0;3579;1;1;
/org.eclipse.jdt.core/codeassist/org/eclipse/jdt/internal/codeassist/SelectionEngine.java;5;1;21;1;3;3;3;18;132;2;17;69;582;582;2;1;0;18;21;1870;1;6222;20;5;
/org.eclipse.swt/Eclipse SWT/win32/org/eclipse/swt/widgets/Sash.java;1;0;2;1;0;0;0;2;4;1;2;268;6;6;1;0;0;2;2;268;0;2407;2;1;
/org.eclipse.jdt.ui/core refactoring/org/eclipse/jdt/internal/corext/refactoring/reorg/ReorgPolicyFactory.java;5;2;43;2;17;15;17;26;188;3;22;1114;1171;1171;3;4;2;26;43;1588;6;6340;37;5;
/org.eclipse.swt/Eclipse SWT/photon/org/eclipse/swt/widgets/Label.java;2;0;3;1;0;0;0;3;29;1;3;269;38;38;1;0;0;3;3;269;0;3355;3;2;
/org.eclipse.pde.ui/src/org/eclipse/pde/internal/ui/wizards/templates/NewWizardTemplate.java;3;3;15;1;9;6;9;6;86;2;5;2184;174;174;3;1;3;6;15;5204;4;6336;11;3;
/org.eclipse.ui.forms.examples/src/org/eclipse/ui/forms/examples/internal/rcp/TypeTwo.java;1;0;2;1;1;1;1;1;16;0;1;4075;16;16;1;0;0;1;2;4075;0;5781;2;1;
/org.eclipse.jdt.core/compiler/org/eclipse/jdt/internal/compiler/env/IGenericMethod.java;2;0;2;1;0;0;0;2;2;1;2;3560;4;4;1;0;0;2;2;3560;0;4041;2;2;
/org.eclipse.ui.ide/src/org/eclipse/ui/dialogs/WizardNewFolderMainPage.java;2;0;3;1;0;0;0;3;26;1;3;1511;26;26;1;0;0;3;3;1511;0;2263;3;2;
/org.eclipse.ant.ui/Ant Tools Support/org/eclipse/ant/internal/ui/model/AntUtil.java;2;1;21;1;2;2;2;19;112;3;16;1811;389;389;3;3;0;19;21;2575;3;5860;18;2;
/org.eclipse.jdt.core.tests.model/workspace/Formatter/test053/A_out.java;1;0;1;1;0;0;0;1;0;0;1;2425;0;0;1;0;0;1;1;2425;0;2425;1;1;
/org.eclipse.pde.ui/src/org/eclipse/pde/internal/ui/editor/PDEEditorContributor.java;1;0;5;1;1;1;1;4;68;1;4;648;82;82;1;0;0;4;5;648;0;5431;5;1;
/org.eclipse.ui.workbench/Eclipse UI/org/eclipse/ui/contexts/registry/IContextRegistry.java;1;0;2;1;0;0;0;2;0;1;2;1400;0;0;1;0;0;2;2;1400;0;1417;2;1;
/org.eclipse.jdt.ui/ui/org/eclipse/jdt/internal/ui/wizards/buildpaths/ClasspathContainerWizard.java;2;1;4;1;3;3;3;1;39;0;1;4407;78;78;1;0;0;1;4;4407;0;6340;4;2;
/org.eclipse.pde.ui/src_samples/org/eclipse/pde/ui/internal/samples/SampleStandbyContent.java;3;3;11;2;9;7;9;2;82;1;2;4633;232;232;3;0;2;2;11;5797;2;6336;9;3;
/org.eclipse.core.tests.runtime/src/org/eclipse/core/tests/internal/osgi/AllTests.java;2;1;3;1;2;2;2;1;6;0;1;4430;6;6;1;0;0;1;3;4430;0;5339;3;2;
/org.eclipse.jdt.core/codeassist/org/eclipse/jdt/internal/codeassist/ISearchableNameEnvironment.java;1;0;1;1;0;0;0;1;2;0;1;3560;2;2;1;0;0;1;1;3560;0;3560;1;1;
/org.eclipse.jdt.debug/model/org/eclipse/jdt/internal/debug/core/logicalstructures/LogicalObjectStructureValue.java;2;0;2;1;0;0;0;2;4;1;2;2647;4;4;1;0;0;2;2;2647;0;2996;2;2;
/org.eclipse.ant.tests.ui/Ant Editor Tests/org/eclipse/ant/tests/ui/editor/formatter/FormattingPreferencesTest.java;1;0;3;1;0;0;0;3;0;2;2;4317;0;0;2;1;0;3;3;4604;1;4604;2;1;
/org.eclipse.pde.runtime/src/org/eclipse/pde/internal/runtime/registry/RegistryBrowserLabelProvider.java;2;1;11;1;2;2;2;9;56;2;8;924;179;179;2;1;0;9;11;4113;1;6336;10;2;
/org.eclipse.team.ui/src/org/eclipse/team/ui/sync/actions/AutomergableFilter.java;1;0;1;1;0;0;0;1;0;0;1;2378;0;0;1;0;0;1;1;2378;0;2378;1;1;
/org.eclipse.ui.tests/Eclipse UI Tests/org/eclipse/ui/tests/dialogs/UIDialogs.java;4;1;6;1;2;2;2;4;109;1;4;830;151;151;1;0;0;4;6;830;0;6338;6;4;
/org.eclipse.jdt.core.tests.model/workspace/Formatter/test093/A_in.java;1;0;1;1;0;0;0;1;0;0;1;2425;0;0;1;0;0;1;1;2425;0;2425;1;1;
/org.eclipse.jdt.junit/src/org/eclipse/jdt/internal/junit/refactoring/JUnitRenameParticipant.java;3;1;4;1;3;3;3;1;10;0;1;5041;16;16;1;0;0;1;4;5041;0;6340;4;3;
/org.eclipse.jdt.core/search/org/eclipse/jdt/internal/core/search/JavaSearchParticipant.java;2;2;7;1;4;3;4;3;83;1;3;3211;127;127;2;0;1;3;7;5266;1;5659;6;2;
/org.eclipse.swt/Eclipse SWT Mozilla/common/org/eclipse/swt/internal/mozilla/nsIMemory.java;1;0;2;1;0;0;0;2;4;1;2;1654;4;4;1;0;0;2;2;1654;0;2568;2;1;
/org.eclipse.jdt.ui/ui refactoring/org/eclipse/jdt/internal/ui/refactoring/nls/SourceFolderSelectionDialogButtonField.java;3;1;5;1;4;4;4;1;86;0;1;4930;146;146;1;0;0;1;5;4930;0;6340;5;3;
/org.eclipse.ui.externaltools/Ant Editor/org/eclipse/ui/externaltools/internal/ant/editor/text/AntEditorDocumentProvider.java;1;0;4;1;0;0;0;4;12;1;4;178;14;14;1;0;0;4;4;178;0;282;4;1;
/org.eclipse.ui.views/src/org/eclipse/ui/views/internal/tableview/TableViewLabelProvider.java;1;0;2;1;0;0;0;2;0;1;2;267;0;0;1;0;0;2;2;267;0;749;2;1;
/org.eclipse.jdt.core.tests.model/workspace/Formatter/test226/A_out.java;1;0;1;1;0;0;0;1;0;0;1;2426;0;0;1;0;0;1;1;2426;0;2426;1;1;
/org.eclipse.pde.ui/src/org/eclipse/pde/internal/ui/wizards/Category.java;2;1;2;1;2;2;2;0;8;0;0;5783;12;12;1;0;0;0;2;5783;0;6336;2;2;
/org.eclipse.ui.tutorials.rcp.part2/src/org/eclipse/ui/tutorials/rcp/part2/Messages.java;1;0;1;1;1;1;1;0;0;0;0;5118;0;0;1;0;0;0;1;5118;0;5118;1;1;
/org.eclipse.jdt.core.tests.model/workspace/Converter/junit/swingui/ProgressBar.java;1;0;2;1;0;0;0;2;68;1;2;787;68;68;1;0;0;2;2;787;0;3714;2;1;
/org.eclipse.osgi/eclipseAdaptor/src/org/eclipse/core/runtime/adaptor/EclipseAdaptor.java;6;2;69;2;26;20;26;43;128;3;35;3013;1184;1184;3;8;6;43;69;4304;14;6245;55;6;
/org.eclipse.ui.workbench/Eclipse UI/org/eclipse/ui/contexts/ContextActivationServiceEvent.java;2;0;4;1;0;0;0;4;4;1;4;3109;7;7;1;0;0;4;4;3109;0;4144;4;2;
/org.eclipse.jdt.core/search/org/eclipse/jdt/internal/core/index/DiskIndex.java;2;0;7;1;1;1;1;6;799;1;6;3843;824;824;1;0;0;6;7;3843;0;6079;7;2;
/org.eclipse.jdt.core/dom/org/eclipse/jdt/core/dom/Type.java;2;1;6;1;2;2;2;4;112;1;4;3560;127;127;1;0;0;4;6;3560;0;5335;6;2;
/org.eclipse.jface.text/src/org/eclipse/jface/text/source/ISourceViewerExtension2.java;2;0;3;1;1;1;1;2;13;1;2;3940;20;20;1;0;0;2;3;3940;0;6361;3;2;
/org.eclipse.jface.text/src/org/eclipse/jface/text/ITextViewerExtension3.java;2;2;5;2;4;3;4;1;19;0;1;4689;39;39;2;0;1;1;5;6340;1;6340;4;2;
/org.eclipse.jdt.ui.tests.refactoring/resources/InlineMethodWorkspace/TestCases/argument_in/TestWrite.java;1;0;1;1;0;0;0;1;2;0;1;845;2;2;1;0;0;1;1;845;0;845;1;1;
/org.eclipse.jface.text/src/org/eclipse/jface/text/IInformationControlExtension.java;2;1;2;1;2;2;2;0;12;0;0;6340;14;14;1;0;0;0;2;6340;0;6359;2;2;
/org.eclipse.core.resources/src/org/eclipse/core/internal/resources/LocalMetaArea.java;2;1;6;1;4;4;4;2;598;1;2;2967;638;638;1;0;0;2;6;2967;0;6206;6;2;
/org.eclipse.jdt.ui.tests.refactoring/resources/MoveMembers/test38/in/A.java;1;0;1;1;0;0;0;1;0;0;1;2093;0;0;1;0;0;1;1;2093;0;2093;1;1;
/org.eclipse.core.tests.resources/src/org/eclipse/core/tests/resources/regression/Bug_44106.java;1;0;1;1;1;1;1;0;115;0;0;5486;115;115;1;0;0;0;1;5486;0;5486;1;1;
/org.eclipse.core.runtime.osgi/src/org/eclipse/core/runtime/IPlatform.java;2;0;3;2;0;0;0;3;34;2;2;3013;34;34;2;1;0;3;3;3030;1;3030;2;2;
/org.eclipse.jdt.core/search/org/eclipse/jdt/internal/core/search/matching/PackageReferencePattern.java;2;3;20;1;5;3;5;15;459;2;14;786;917;917;3;1;2;15;20;5207;3;5335;17;2;
/org.eclipse.jdt.core.tests.model/workspace/Formatter/test330/A_in.java;1;0;1;1;0;0;0;1;0;0;1;2640;0;0;1;0;0;1;1;2640;0;2640;1;1;
/org.eclipse.search/new search/org/eclipse/search/ui/ISearchResultPageContainer.java;1;0;2;1;0;0;0;2;0;1;2;3474;0;0;1;0;0;2;2;3474;0;3711;2;1;
/org.eclipse.pde.ui/templates/newWizard/java/$wizardClassName$.java;1;0;1;1;0;0;0;1;10;0;1;851;10;10;1;0;0;1;1;851;0;851;1;1;
/org.eclipse.jdt.core/model/org/eclipse/jdt/internal/core/util/RecordedParsingInformation.java;2;0;3;2;0;0;0;3;16;2;2;3862;16;16;2;1;0;3;3;3886;1;3886;2;2;
/org.eclipse.jdt.core.tests.model/workspace/Formatter/test189/A_out.java;1;0;2;1;0;0;0;2;5;1;2;2425;5;5;1;0;0;2;2;2425;0;3029;2;1;
/org.eclipse.debug.ui/ui/org/eclipse/debug/internal/ui/actions/CollapseAllAction.java;1;0;2;1;0;0;0;2;3;0;1;976;3;3;2;1;0;2;2;976;1;976;1;1;
/org.eclipse.jdt.core.tests.model/workspace/Converter/test0436/A.java;1;0;1;1;0;0;0;1;0;0;1;3714;0;0;1;0;0;1;1;3714;0;3714;1;1;
/org.eclipse.jdt.core.tests.model/workspace/Converter/test0019/Test.java;1;0;1;1;0;0;0;1;0;0;1;3714;0;0;1;0;0;1;1;3714;0;3714;1;1;
/org.eclipse.ui.console/src/org/eclipse/ui/console/ConsolePlugin.java;2;0;4;1;1;1;1;3;21;1;3;1988;29;29;1;0;0;3;4;1988;0;5475;4;2;
/org.eclipse.jdt.core.tests.model/workspace/Formatter/test204/A_in.java;1;0;2;1;0;0;0;2;1;1;2;2424;1;1;1;0;0;2;2;2424;0;2643;2;1;
/org.eclipse.jdt.core/model/org/eclipse/jdt/core/util/IExceptionAttribute.java;1;0;1;1;0;0;0;1;2;0;1;3560;2;2;1;0;0;1;1;3560;0;3560;1;1;
/org.eclipse.team.cvs.core/src/org/eclipse/team/internal/ccvs/core/CVSSyncInfo.java;2;0;18;1;1;1;1;17;327;2;16;488;577;577;2;1;0;17;18;3254;1;6337;17;2;
/org.eclipse.core.filebuffers/src/org/eclipse/core/internal/filebuffers/FileBuffersMessages.java;1;1;3;1;3;3;3;0;6;0;0;5335;8;8;1;0;0;0;3;5335;0;6330;3;1;
/org.eclipse.ui.workbench/Eclipse UI/org/eclipse/ui/internal/chris/roles/ContextBinding.java;1;0;4;1;0;0;0;4;4;3;2;1961;4;4;3;2;0;4;4;2202;2;2202;2;1;
/org.eclipse.jdt.ui.tests.refactoring/resources/IntroduceFactory/positive/UnmovableArg2.java;1;0;2;1;1;1;1;1;2;0;1;2846;2;2;1;0;0;1;2;2846;0;5659;2;1;
/org.eclipse.swt.tests/JUnit Tests/org/eclipse/swt/tests/junit/Test_org_eclipse_swt_widgets_Display.java;3;0;6;1;1;1;1;5;165;1;5;1242;325;325;1;0;0;5;6;1242;0;6352;6;3;
/org.eclipse.jdt.ui/core refactoring/org/eclipse/jdt/internal/corext/refactoring/participants/xml/ExpressionTagNames.java;1;0;2;1;0;0;0;2;0;1;2;4091;0;0;1;0;0;2;2;4091;0;4108;2;1;
/org.eclipse.jdt.core/compiler/org/eclipse/jdt/internal/compiler/IDebugRequestor.java;1;0;1;1;0;0;0;1;2;0;1;3560;2;2;1;0;0;1;1;3560;0;3560;1;1;
/org.eclipse.osgi/eclipseAdaptor/src/org/eclipse/osgi/service/pluginconversion/IPluginConverter.java;1;0;2;1;0;0;0;2;0;0;1;3133;0;0;2;1;0;2;2;3133;1;3133;1;1;
/org.eclipse.jdt.ui/ui/org/eclipse/jdt/internal/ui/packageview/PackageExplorerElementComparer.java;1;0;1;1;1;1;1;0;2;0;0;6340;2;2;1;0;0;0;1;6340;0;6340;1;1;
/org.eclipse.compare/compare/org/eclipse/compare/ZipFileStructureCreator.java;1;0;7;1;1;1;1;6;13;1;6;1289;41;41;1;0;0;6;7;1289;0;5199;7;1;
/org.eclipse.ui.ide/src/org/eclipse/ui/IMarkerResolution.java;2;0;2;1;0;0;0;2;0;1;2;1511;0;0;1;0;0;2;2;1511;0;2263;2;2;
/org.eclipse.ui.workbench/Eclipse UI/org/eclipse/ui/internal/csm/activities/SwapActivityHelper.java;1;0;2;1;0;0;0;2;0;0;1;2443;0;0;2;1;0;2;2;2443;1;2443;1;1;
/org.eclipse.ui.workbench/Eclipse UI/org/eclipse/ui/commands/ICommandHandle.java;1;0;2;1;0;0;0;2;0;1;2;1321;0;0;1;0;0;2;2;1321;0;1417;2;1;
/org.eclipse.ui.workbench/Eclipse UI/org/eclipse/ui/internal/presentation/ColorDefinition.java;1;0;2;1;0;0;0;2;0;1;2;4237;0;0;1;0;0;2;2;4237;0;4392;2;1;
/org.eclipse.jdt.ui.tests.refactoring/resources/MoveInstanceMethod/canMove/test20/out/B.java;1;0;1;1;0;0;0;1;0;0;1;1586;0;0;1;0;0;1;1;1586;0;1586;1;1;
/org.eclipse.jdt.debug.ui/ui/org/eclipse/jdt/internal/debug/ui/IJDIPreferencesConstants.java;4;1;7;1;2;2;2;5;10;1;5;2568;54;54;1;0;0;5;7;2568;0;6336;7;4;
/org.eclipse.jdt.junit/src/org/eclipse/jdt/internal/junit/ui/IJUnitPreferencesConstants.java;1;0;1;1;1;1;1;0;2;0;0;6340;2;2;1;0;0;0;1;6340;0;6340;1;1;
/org.eclipse.team.webdav/src/org/eclipse/team/internal/webdav/core/subscriber/WebDavRefreshOperation.java;1;0;1;1;0;0;0;1;0;0;1;3477;0;0;1;0;0;1;1;3477;0;3477;1;1;
/org.eclipse.team.tests.cvs.core/src/org/eclipse/team/tests/ccvs/ui/old/LoggingTestResult.java;1;0;2;1;0;0;0;2;0;1;2;2632;0;0;1;0;0;2;2;2632;0;4216;2;1;
/org.eclipse.ui.workbench/Eclipse UI/org/eclipse/ui/internal/commands/old/ContextBinding.java;1;0;3;1;0;0;0;3;73;2;2;1321;73;73;2;1;0;3;3;1321;1;1695;2;1;
/org.eclipse.jdt.core.tests.model/workspace/Converter/src/test0017/Test.java;1;0;1;1;0;0;0;1;0;0;1;3714;0;0;1;0;0;1;1;3714;0;3714;1;1;
/org.eclipse.jdt.launching/launching/org/eclipse/jdt/launching/sourcelookup/containers/ClasspathContainerSourceContainer.java;2;1;4;1;2;2;2;2;5;1;2;4971;11;11;1;0;0;2;4;4971;0;5581;4;2;
/org.eclipse.jdt.core/model/org/eclipse/jdt/internal/core/SortElementBuilder.java;5;1;13;1;3;3;3;10;44;1;10;61;124;124;1;0;0;10;13;61;0;5916;13;5;
/org.eclipse.help.ui/src/org/eclipse/help/ui/internal/HelpUIEventLoop.java;1;1;4;1;4;4;4;0;30;0;0;5490;60;60;1;0;0;0;4;5490;0;6337;4;1;
/org.eclipse.swt.tests/JUnit Tests/org/eclipse/swt/tests/junit/Test_org_eclipse_swt_awt_SWT_AWT.java;1;0;1;1;0;0;0;1;0;0;1;3373;0;0;1;0;0;1;1;3373;0;3373;1;1;
/org.eclipse.compare/compare/org/eclipse/compare/internal/CompareDialog.java;1;0;1;1;0;0;0;1;2;0;1;1289;2;2;1;0;0;1;1;1289;0;1289;1;1;
/org.eclipse.osgi/eclipseAdaptor/src/org/eclipse/core/runtime/adaptor/EclipseAdaptorConstants.java;2;1;6;1;4;4;4;2;36;1;2;4633;68;68;1;0;0;2;6;4633;0;5543;6;2;
/org.eclipse.jface.text/src/org/eclipse/jface/text/source/IAnnotationPresentation.java;3;1;6;1;3;3;3;3;7;1;3;3217;16;16;1;0;0;3;6;3217;0;6361;6;3;
/org.eclipse.jdt.ui/ui/org/eclipse/jdt/internal/ui/callhierarchy/CalleeMethodWrapper.java;1;0;2;1;0;0;0;2;0;1;2;155;0;0;1;0;0;2;2;155;0;169;2;1;
/org.eclipse.pde.ui/src/org/eclipse/pde/internal/ui/editor/schema/SchemaEditorContributor.java;2;1;3;1;3;3;3;0;5;0;0;5431;13;13;1;0;0;0;3;5431;0;6336;3;2;
/org.eclipse.ui.examples.javaeditor/Template Editor Example/org/eclipse/ui/examples/templateeditor/preferences/TemplatesPreferencePage.java;2;0;3;1;1;1;1;2;14;1;2;4644;16;16;1;0;0;2;3;4644;0;6340;3;2;
/org.eclipse.webdav/src/client/org/eclipse/webdav/http/client/HttpConnection.java;1;0;2;1;2;1;2;0;322;0;0;5151;322;322;2;0;1;0;2;5151;1;5151;1;1;
/org.eclipse.ui.workbench/Eclipse UI/org/eclipse/ui/internal/HiddenSash.java;1;0;2;1;0;0;0;2;0;1;2;4668;0;0;1;0;0;2;2;4668;0;4725;2;1;
/org.eclipse.jdt.ui/ui/org/eclipse/jdt/internal/ui/search/SearchViewSiteAdapter.java;2;1;5;1;2;2;2;3;20;1;3;1350;32;32;1;0;0;3;5;1350;0;6340;5;2;
/org.eclipse.debug.ui/ui/org/eclipse/debug/internal/ui/views/expression/ExpressionPopupContentProvider.java;1;0;1;1;0;0;0;1;0;0;1;3828;0;0;1;0;0;1;1;3828;0;3828;1;1;
/org.eclipse.debug.ui/ui/org/eclipse/debug/internal/ui/IInternalDebugUIConstants.java;4;3;25;1;6;4;6;19;78;1;19;618;226;226;3;0;2;19;25;5182;2;5766;23;4;
/org.eclipse.ant.ui/Ant Editor/org/eclipse/ant/internal/ui/editor/outline/LocationProvider.java;1;0;3;1;0;0;0;3;24;1;3;1811;45;45;1;0;0;3;3;1811;0;5047;3;1;
/org.eclipse.swt/Eclipse SWT PI/gtk/org/eclipse/swt/internal/gtk/PangoLayoutLine.java;2;0;2;1;1;1;1;1;2;0;1;4563;2;2;1;0;0;1;2;4563;0;6352;2;2;
/org.eclipse.jdt.core.tests.model/workspace/Formatter/test353/A_in.java;1;0;1;1;0;0;0;1;0;0;1;3029;0;0;1;0;0;1;1;3029;0;3029;1;1;
/org.eclipse.ant.ui/Remote Ant Support/org/eclipse/ant/ui/internal/antsupport/InternalAntRunner.java;1;0;3;1;0;0;0;3;54;1;3;1696;54;54;1;0;0;3;3;1696;0;1811;3;1;
/org.eclipse.ui.editors/src/org/eclipse/ui/texteditor/BasicMarkerUpdater.java;2;1;4;1;2;2;2;2;98;1;2;1983;106;106;1;0;0;2;4;1983;0;6334;4;2;
/org.eclipse.jdt.ui.tests.refactoring/resources/ExtractMethodWorkSpace/ExtractMethodTests/error_out/A_test802.java;1;0;3;1;0;0;0;3;4;1;3;844;4;4;1;0;0;3;3;844;0;1474;3;1;
/org.eclipse.jdt.core.tests.model/workspace/Converter/test0095/Test.java;1;0;1;1;0;0;0;1;0;0;1;3714;0;0;1;0;0;1;1;3714;0;3714;1;1;
/org.eclipse.ui.ide/src/org/eclipse/ui/views/tasklist/DefaultTaskListResourceAdapter.java;1;0;1;1;0;0;0;1;0;0;1;2208;0;0;1;0;0;1;1;2208;0;2208;1;1;
/org.eclipse.jdt.core.tests.model/workspace/Converter/src/test0317/Test.java;1;0;1;1;0;0;0;1;0;0;1;3714;0;0;1;0;0;1;1;3714;0;3714;1;1;
/org.eclipse.jface.text/src/org/eclipse/jface/text/contentassist/TextContentAssistSubjectAdapter.java;1;0;5;1;2;1;2;3;75;1;3;3672;107;107;2;0;1;3;5;5177;1;5177;4;1;
/org.eclipse.update.core/src/org/eclipse/update/core/model/CategoryModel.java;2;1;4;1;3;3;3;1;7;0;1;890;19;19;1;0;0;1;4;890;0;6336;4;2;
/org.eclipse.jdt.junit/src/org/eclipse/jdt/internal/junit/ui/ShowNextFailureAction.java;3;0;3;1;1;1;1;2;2;1;2;498;4;4;1;0;0;2;3;498;0;6340;3;3;
/org.eclipse.ant.ui/Ant Editor/org/eclipse/ant/internal/ui/editor/xml/XmlElement.java;1;0;5;1;0;0;0;5;122;1;5;1811;149;149;1;0;0;5;5;1811;0;3661;5;1;
/org.eclipse.ui.workbench/Eclipse UI/org/eclipse/ui/internal/commands/old/IContextListener.java;1;0;2;1;0;0;0;2;0;0;1;1430;0;0;2;1;0;2;2;1430;1;1430;1;1;
/org.eclipse.pde.ui/src_Forms/org/eclipse/pde/internal/ui/neweditor/feature/NewFeatureRequireWizardPage.java;2;1;3;1;2;2;2;1;8;0;1;4926;8;8;1;0;0;1;3;4926;0;5431;3;2;
/org.eclipse.pde.ui/src_Forms/org/eclipse/pde/internal/ui/neweditor/plugin/ExtensionAttributeRow.java;1;0;5;1;0;0;0;5;13;1;5;3834;18;18;1;0;0;5;5;3834;0;4354;5;1;
/org.eclipse.team.ui/src/org/eclipse/team/ui/sync/ISynchronizeView.java;1;0;5;1;0;0;0;5;68;2;4;1297;91;91;2;1;0;5;5;1354;1;2632;4;1;
/org.eclipse.jdt.core.tests.model/workspace/Formatter/test497/ClockCmd_out.java;1;0;2;1;2;1;2;0;2;0;0;5617;2;2;2;0;1;0;2;5617;1;5617;1;1;
/org.eclipse.jdt.ui/ui/org/eclipse/jdt/internal/ui/dialogs/ProblemDialog.java;2;1;3;1;3;3;3;0;10;0;0;5612;16;16;1;0;0;0;3;5612;0;6340;3;2;
/org.eclipse.jdt.core.tests.model/workspace/Converter/src/test0338/Test.java;1;0;1;1;0;0;0;1;0;0;1;3714;0;0;1;0;0;1;1;3714;0;3714;1;1;
/org.eclipse.ui.views/src/org/eclipse/ui/views/internal/tableview/TableSortDialog.java;1;0;2;1;0;0;0;2;0;1;2;267;0;0;1;0;0;2;2;267;0;749;2;1;
/org.eclipse.jdt.ui.tests.refactoring/test cases/org/eclipse/jdt/ui/tests/refactoring/TestRenameParticipantSingle.java;1;0;1;1;0;0;0;1;0;0;1;4913;0;0;1;0;0;1;1;4913;0;4913;1;1;
/org.eclipse.help/src/org/eclipse/help/internal/toc/Toc.java;1;1;11;1;3;3;3;8;152;1;8;600;397;397;1;0;0;8;11;600;0;6337;11;1;
/org.eclipse.jdt.ui.tests.refactoring/test cases/org/eclipse/jdt/ui/tests/actions/DeleteSourceReferenceEditTests.java;1;0;1;1;0;0;0;1;0;0;1;1111;0;0;1;0;0;1;1;1111;0;1111;1;1;
/org.eclipse.ui.workbench/Eclipse UI/org/eclipse/ui/internal/csm/activities/api/IPatternBinding.java;1;0;3;1;0;0;0;3;8;0;1;2231;8;8;3;2;0;3;3;2231;2;2231;1;1;
/org.eclipse.ui.externaltools/External Tools Base/org/eclipse/ui/externaltools/internal/model/IExternalToolConstants.java;2;0;15;1;0;0;0;15;137;2;13;53;312;312;2;2;0;15;15;282;2;2899;13;2;
/org.eclipse.swt/Eclipse SWT PI/gtk/org/eclipse/swt/internal/gtk/GdkColor.java;3;0;3;1;1;1;1;2;17;1;2;1653;21;21;1;0;0;2;3;1653;0;6352;3;3;
/org.eclipse.jface.text/src/org/eclipse/jface/text/formatter/IContentFormatterExtension2.java;1;0;5;1;1;1;1;4;54;1;4;1998;105;105;1;0;0;4;5;1998;0;5180;5;1;
/org.eclipse.ui.externaltools/External Tools Base/org/eclipse/ui/externaltools/internal/variables/BuildProjectResolver.java;1;0;1;1;0;0;0;1;0;0;1;4975;0;0;1;0;0;1;1;4975;0;4975;1;1;
/org.eclipse.update.core/src/org/eclipse/update/internal/operations/RevertConfigurationOperation.java;1;0;6;1;1;1;1;5;4;1;5;825;12;12;1;0;0;5;6;825;0;6336;6;1;
/org.eclipse.jdt.core.tests.model/workspace/Converter/src/test0507/A.java;1;0;1;1;0;0;0;1;0;0;1;3714;0;0;1;0;0;1;1;3714;0;3714;1;1;
/org.eclipse.pde.ui/src/org/eclipse/pde/internal/ui/editor/schema/SchemaSpecSection.java;3;1;6;1;5;5;5;1;218;0;1;368;248;248;1;0;0;1;6;368;0;6336;6;3;
/org.eclipse.jdt.core.tests.model/workspace/Formatter/test064/A_in.java;1;0;1;1;0;0;0;1;0;0;1;2425;0;0;1;0;0;1;1;2425;0;2425;1;1;
/org.eclipse.ltk.core.refactoring/src/org/eclipse/ltk/core/refactoring/participants/MoveRefactoring.java;1;1;4;1;2;2;2;2;21;1;2;4845;26;26;1;0;0;2;4;4845;0;6338;4;1;
/org.eclipse.swt/Eclipse SWT PI/gtk1x/org/eclipse/swt/internal/gtk/GtkFileSelection.java;1;0;1;1;0;0;0;1;0;0;1;2327;0;0;1;0;0;1;1;2327;0;2327;1;1;
/org.eclipse.jdt.ui/ui/org/eclipse/jdt/internal/ui/wizards/buildpaths/CPListLabelProvider.java;2;1;6;1;2;2;2;4;22;1;4;3404;70;70;1;0;0;4;6;3404;0;6340;6;2;
/org.eclipse.jdt.ui/ui/org/eclipse/jdt/internal/ui/text/JavaCommentScanner.java;2;2;10;1;6;5;6;4;201;1;4;1350;412;412;2;0;1;4;10;5501;1;6340;9;2;
/org.eclipse.jface/src/org/eclipse/jface/resource/JFaceResources.java;2;0;5;1;1;1;1;4;527;2;3;3215;571;571;2;1;0;4;5;3215;1;6338;4;2;
/org.eclipse.search/search/org/eclipse/search/internal/ui/ShowNextResultAction.java;1;0;2;1;1;1;1;1;2;0;1;1647;3;3;1;0;0;1;2;1647;0;6340;2;1;
/org.eclipse.ui.ide/src/org/eclipse/ui/views/markers/internal/DialogMarkerProperties.java;3;1;3;1;2;2;2;1;92;0;1;2208;94;94;1;0;0;1;3;2208;0;6338;3;3;
/org.eclipse.ui.workbench/Eclipse UI/org/eclipse/ui/actions/OpenInNewWindowAction.java;2;0;2;1;0;0;0;2;38;1;2;2737;40;40;1;0;0;2;2;2737;0;3331;2;2;
/org.eclipse.pde.ui/src/org/eclipse/pde/internal/ui/editor/plugin/JarSelectionValidator.java;2;1;3;1;3;3;3;0;10;0;0;5431;14;14;1;0;0;0;3;5431;0;6336;3;2;
/org.eclipse.pde.ui/src_Forms/org/eclipse/pde/internal/ui/neweditor/TreeSection.java;2;1;4;1;2;2;2;2;7;1;2;3795;9;9;1;0;0;2;4;3795;0;5431;4;2;
/org.eclipse.jdt.ui/ui/org/eclipse/jdt/internal/ui/jarpackager/ContainerFilter.java;1;0;1;1;1;1;1;0;2;0;0;6340;2;2;1;0;0;0;1;6340;0;6340;1;1;
/org.eclipse.ui.workbench/Eclipse UI/org/eclipse/ui/IViewSite.java;2;1;4;1;2;2;2;2;12;0;1;3816;16;16;2;1;0;2;4;3816;1;6338;3;2;
/org.eclipse.osgi/defaultAdaptor/src/org/eclipse/osgi/framework/internal/protocol/reference/ReferenceURLConnection.java;4;1;6;1;3;3;3;3;157;1;3;3013;223;223;1;0;0;3;6;3013;0;5523;6;4;
/org.eclipse.jdt.core/dom/org/eclipse/jdt/core/dom/CatchClause.java;4;1;9;1;2;2;2;7;112;1;7;3560;164;164;1;0;0;7;9;3560;0;5272;9;4;
/org.eclipse.jdt.core/formatter/org/eclipse/jdt/internal/formatter/CascadingMethodInvocationFragmentBuilder.java;3;0;4;1;0;0;0;4;16;1;4;2368;28;28;1;0;0;4;4;2368;0;3560;4;3;
/org.eclipse.pde.ui/src/org/eclipse/pde/internal/ui/editor/schema/EnumerationRestrictionPage.java;2;1;2;1;2;2;2;0;10;0;0;5781;14;14;1;0;0;0;2;5781;0;6336;2;2;
/org.eclipse.debug.ui/ui/org/eclipse/debug/internal/ui/views/console/WorkspaceOperationRunner.java;2;1;2;1;2;2;2;0;4;0;0;5187;4;4;1;0;0;0;2;5187;0;6336;2;2;
/org.eclipse.help.ui/src/org/eclipse/help/ui/internal/workingset/HelpWorkingSet.java;1;0;1;1;0;0;0;1;0;0;1;2732;0;0;1;0;0;1;1;2732;0;2732;1;1;
/org.eclipse.jdt.core.tests.model/workspace/Converter/test0125/Test.java;1;0;1;1;0;0;0;1;0;0;1;3714;0;0;1;0;0;1;1;3714;0;3714;1;1;
/org.eclipse.test/src/org/eclipse/test/UITestApplication.java;2;1;3;1;2;2;2;1;189;0;1;2749;193;193;1;0;0;1;3;2749;0;6297;3;2;
/org.eclipse.swt/Eclipse SWT/motif/org/eclipse/swt/widgets/DirectoryDialog.java;3;1;8;1;2;2;2;6;25;2;5;270;71;71;2;1;0;6;8;3011;1;6352;7;3;
/org.eclipse.pde.ui/src/org/eclipse/pde/internal/ui/launcher/BasicLauncherTab.java;3;1;23;1;4;4;4;19;666;2;17;368;1533;1533;2;2;0;19;23;733;2;6336;21;3;
/org.eclipse.swt.tests/JUnit Tests/org/eclipse/swt/tests/junit/Test_org_eclipse_swt_browser_LocationListener.java;1;0;2;1;0;0;0;2;16;1;2;2104;16;16;1;0;0;2;2;2104;0;2863;2;1;
/org.eclipse.jdt.ui.examples.javafamily/coresearch-experiment/org/eclipse/search/internal/core/OrQuery.java;2;0;3;1;0;0;0;3;2;1;3;1380;2;2;1;0;0;3;3;1380;0;3214;3;2;
/org.eclipse.core.variables/src/org/eclipse/core/variables/VariablesPlugin.java;4;1;6;1;2;2;2;4;33;1;4;2271;61;61;1;0;0;4;6;2271;0;6336;6;4;
/org.eclipse.ui.workbench.texteditor/src/org/eclipse/ui/texteditor/SourceViewerDecorationSupport.java;4;2;19;2;7;5;7;12;188;1;12;1346;542;542;2;0;2;12;19;5123;2;6334;17;4;
/org.eclipse.core.tests.runtime/src/org/eclipse/core/tests/internal/plugins/FragmentResolveTest_9.java;1;0;1;1;0;0;0;1;0;0;1;3014;0;0;1;0;0;1;1;3014;0;3014;1;1;
/org.eclipse.swt/Eclipse SWT PI/motif/org/eclipse/swt/internal/motif/XClientMessageEvent.java;1;0;1;1;0;0;0;1;0;0;1;1450;0;0;1;0;0;1;1;1450;0;1450;1;1;
/org.eclipse.ui.ide/src/org/eclipse/ui/internal/dialogs/WizardStep.java;2;0;2;1;0;0;0;2;0;1;2;1526;0;0;1;0;0;2;2;1526;0;2263;2;2;
/org.eclipse.jdt.debug.tests/tests/org/eclipse/jdt/debug/tests/eval/NestedTypeFieldValue_381.java;1;0;1;1;0;0;0;1;74;0;1;1274;74;74;1;0;0;1;1;1274;0;1274;1;1;
/org.eclipse.pde.ui/sandbox/org/eclipse/pde/internal/ui/editor/standalone/text/TagRule.java;1;0;2;1;0;0;0;2;0;1;2;2320;0;0;1;0;0;2;2;2320;0;2906;2;1;
/org.eclipse.core.tools/src/org/eclipse/core/tools/CoreToolsPlugin.java;1;0;1;1;1;1;1;0;0;0;0;6302;0;0;1;0;0;0;1;6302;0;6302;1;1;
/org.eclipse.team.ui/src/org/eclipse/team/internal/ui/sync/views/SyncViewer.java;2;0;33;2;0;0;0;33;728;5;18;488;1619;1619;5;15;0;33;33;1153;15;1354;18;2;
/org.eclipse.jdt.ui/ui/org/eclipse/jdt/internal/ui/javaeditor/ClipboardOperationAction.java;1;1;6;1;6;6;6;0;80;0;0;5439;163;163;1;0;0;0;6;5439;0;6123;6;1;
/org.eclipse.ui.examples.javaeditor/Template Editor Example/org/eclipse/ui/examples/templateeditor/editors/XMLDocumentProvider.java;2;0;2;1;1;1;1;1;10;0;1;4644;10;10;1;0;0;1;2;4644;0;6340;2;2;
/org.eclipse.jdt.ui/core refactoring/org/eclipse/ltk/core/refactoring/participants/RenameRefactoring.java;1;0;4;1;0;0;0;4;151;1;4;4654;155;155;1;0;0;4;4;4654;0;4864;4;1;
/org.eclipse.jdt.ui/core refactoring/org/eclipse/jdt/internal/corext/refactoring/changes/UndoTextChange.java;1;0;4;1;0;0;0;4;6;1;4;1869;11;11;1;0;0;4;4;1869;0;3646;4;1;
/org.eclipse.jdt.core.tests.model/workspace/Converter/src/test0079/Test.java;1;0;1;1;0;0;0;1;0;0;1;3714;0;0;1;0;0;1;1;3714;0;3714;1;1;
/org.eclipse.ui.workbench/Eclipse UI/org/eclipse/ui/internal/csm/roles/ActivityBinding.java;1;0;7;1;0;0;0;7;22;2;5;2213;32;32;2;2;0;7;7;2225;2;2444;5;1;
/org.eclipse.ui.cheatsheets/src/org/eclipse/ui/internal/cheatsheets/dialogs/CheatSheetCategoryBasedSelectionDialog.java;2;0;4;1;1;1;1;3;17;1;3;4428;35;35;1;0;0;3;4;4428;0;5738;4;2;
/org.eclipse.jdt.ui.tests.refactoring/resources/InlineMethodWorkspace/TestCases/argument_out/TestLocalReferenceUnused.java;1;0;1;1;0;0;0;1;4;0;1;845;4;4;1;0;0;1;1;845;0;845;1;1;
/org.eclipse.debug.ui/ui/org/eclipse/debug/internal/ui/SWTUtil.java;1;0;1;1;0;0;0;1;5;0;1;550;5;5;1;0;0;1;1;550;0;550;1;1;
/org.eclipse.webdav/src/interface/org/eclipse/webdav/dom/Update.java;1;0;2;1;2;1;2;0;271;0;0;5151;271;271;2;0;1;0;2;5151;1;5151;1;1;
/org.eclipse.jdt.core.tests.model/workspace/Converter/src/test0235/Test.java;1;0;1;1;0;0;0;1;0;0;1;3714;0;0;1;0;0;1;1;3714;0;3714;1;1;
/org.eclipse.jdt.ui.tests.refactoring/resources/ExtractConstant/nameGuessing/testGuessFromGetterName1.java;1;0;1;1;0;0;0;1;0;0;1;1191;0;0;1;0;0;1;1;1191;0;1191;1;1;
/org.eclipse.team.cvs.ui/src/org/eclipse/team/internal/ccvs/ui/jobs/IDeferredWorkbenchAdapter.java;1;0;3;1;0;0;0;3;65;1;3;977;65;65;1;0;0;3;3;977;0;1064;3;1;
/org.eclipse.ui.workbench/Eclipse UI/org/eclipse/ui/internal/commands/old/AbstractHandlerService.java;1;0;2;1;0;0;0;2;0;0;1;1222;0;0;2;1;0;2;2;1222;1;1222;1;1;
/org.eclipse.swt.tools/JNI Generation/org/eclipse/swt/tools/internal/ClassData.java;1;0;1;1;0;0;0;1;0;0;1;4175;0;0;1;0;0;1;1;4175;0;4175;1;1;
/org.eclipse.jdt.ui.tests.refactoring/resources/InlineMethodWorkspace/TestCases/argument_out/TestOneRead.java;1;0;1;1;0;0;0;1;2;0;1;845;2;2;1;0;0;1;1;845;0;845;1;1;
/org.eclipse.update.ui/src/org/eclipse/update/internal/ui/views/BaseTreeView.java;1;0;1;1;0;0;0;1;0;0;1;755;0;0;1;0;0;1;1;755;0;755;1;1;
/org.eclipse.jdt.core.tests.model/workspace/Converter/src/test0431/A.java;1;0;1;1;0;0;0;1;0;0;1;3714;0;0;1;0;0;1;1;3714;0;3714;1;1;
/org.eclipse.jdt.ui/ui/org/eclipse/jdt/internal/ui/text/JavaOutlineInformationControl.java;4;1;27;1;4;4;4;23;665;3;19;122;1911;1911;3;4;0;23;27;4485;4;6340;23;4;
/org.eclipse.ui.workbench/Eclipse UI/org/eclipse/ui/internal/activities/MutableActivityManager.java;5;1;25;2;4;4;4;21;329;2;16;2805;1330;1330;2;5;0;21;25;2989;5;6338;20;5;
/org.eclipse.pde.runtime/src/org/eclipse/pde/internal/runtime/registry/RegistryBrowser.java;2;2;17;2;4;3;4;13;436;2;12;831;1393;1393;2;1;1;13;17;4256;2;6336;15;2;
/org.eclipse.jdt.core.tests.model/workspace/Converter/src/test0155/Test.java;1;0;1;1;0;0;0;1;0;0;1;3714;0;0;1;0;0;1;1;3714;0;3714;1;1;
/org.eclipse.jdt.debug.ui/ui/org/eclipse/jdt/internal/debug/ui/jres/StandardVMCommandTab.java;3;1;4;1;3;3;3;1;37;0;1;1136;62;62;1;0;0;1;4;1136;0;6336;4;3;
/org.eclipse.team.ui/src/org/eclipse/team/internal/ui/sync/actions/SyncViewerActions.java;2;0;26;2;0;0;0;26;481;3;23;488;1195;1195;3;3;0;26;26;1154;3;2632;23;2;
/org.eclipse.core.runtime/src/org/eclipse/core/runtime/IExtensionPoint.java;4;2;11;1;4;3;4;7;169;1;7;3013;275;275;2;0;1;7;11;5117;1;6363;10;4;
/org.eclipse.ui.workbench/Eclipse UI/org/eclipse/ui/internal/dialogs/WorkingSetNewWizard.java;2;0;2;1;1;1;1;1;2;0;1;4968;4;4;1;0;0;1;2;4968;0;6338;2;2;
/org.eclipse.team.cvs.core/src/org/eclipse/team/internal/ccvs/core/client/UpdateWithOverwrite.java;1;0;1;1;0;0;0;1;0;0;1;3130;0;0;1;0;0;1;1;3130;0;3130;1;1;
/org.eclipse.team.core/src/org/eclipse/team/core/sync/ComparisonCriteria.java;1;0;1;1;0;0;0;1;0;0;1;431;0;0;1;0;0;1;1;431;0;431;1;1;
/org.eclipse.jdt.ui.tests.refactoring/test cases/org/eclipse/jdt/ui/tests/refactoring/ExtractMethodTestSetup.java;2;1;8;1;4;4;4;4;11;1;4;1219;49;49;1;0;0;4;8;1219;0;6340;8;2;
/org.eclipse.jdt.ui.tests.refactoring/resources/UseSupertypeWherePossible/test64/out/Inter.java;1;0;1;1;0;0;0;1;2;0;1;1166;2;2;1;0;0;1;1;1166;0;1166;1;1;
/org.eclipse.jdt.ui/ui/org/eclipse/jdt/internal/ui/text/ITypingRunListener.java;2;1;2;1;2;2;2;0;8;0;0;5226;8;8;1;0;0;0;2;5226;0;6340;2;2;
/org.eclipse.pde.ui/src_Forms/org/eclipse/pde/internal/ui/model/plugin/PluginDocumentNode.java;3;1;14;1;5;5;5;9;67;3;7;4552;241;241;3;2;0;9;14;4933;2;6336;12;3;
/org.eclipse.jdt.ui.tests.refactoring/resources/ConvertAnonymousToNested/canConvert/A_test26_in.java;1;0;1;1;0;0;0;1;0;0;1;3195;0;0;1;0;0;1;1;3195;0;3195;1;1;
/org.eclipse.debug.core/core/org/eclipse/debug/internal/core/LaunchConfigurationInfo.java;3;1;8;1;2;2;2;6;101;1;6;976;161;161;1;0;0;6;8;976;0;6336;8;3;
/org.eclipse.core.tests.harness/src/org/eclipse/core/tests/harness/TestJob.java;2;1;3;1;2;2;2;1;9;0;1;5085;10;10;1;0;0;1;3;5085;0;5617;3;2;
/org.eclipse.ltk.core.refactoring/src/org/eclipse/ltk/core/refactoring/participants/RenameParticipant.java;1;1;5;1;3;3;3;2;18;1;2;4845;40;40;1;0;0;2;5;4845;0;6340;5;1;
/org.eclipse.update.core/src/org/eclipse/update/internal/operations/BatchInstallOperation.java;2;2;13;1;4;3;4;9;13;1;9;825;56;56;2;0;1;9;13;6335;1;6335;12;2;
/org.eclipse.ui.workbench/Eclipse UI/org/eclipse/ui/internal/commands/ImageBindingDefinition.java;2;0;14;1;1;1;1;13;95;5;8;1389;288;288;5;5;0;13;14;1389;5;5231;9;2;
/org.eclipse.jdt.core.tests.model/workspace/Formatter/test391/A_in.java;1;0;1;1;0;0;0;1;0;0;1;3172;0;0;1;0;0;1;1;3172;0;3172;1;1;
/org.eclipse.jdt.ui.tests.refactoring/resources/ExtractMethodWorkSpace/ExtractMethodTests/locals_in/A_test516.java;1;0;1;1;0;0;0;1;2;0;1;844;2;2;1;0;0;1;1;844;0;844;1;1;
/org.eclipse.ui.views/src/org/eclipse/ui/views/markers/internal/TableSortDialog.java;2;0;2;1;0;0;0;2;0;1;2;755;0;0;1;0;0;2;2;755;0;2738;2;2;
/org.eclipse.debug.core/core/org/eclipse/debug/internal/core/sourcelookup/IPersistableSourceLocator2.java;1;0;2;1;0;0;0;2;0;1;2;3653;0;0;1;0;0;2;2;3653;0;4949;2;1;
/org.eclipse.ant.ui/Ant Tools Support/org/eclipse/ant/internal/ui/preferences/ColorEditor.java;1;0;1;1;0;0;0;1;0;0;1;1811;0;0;1;0;0;1;1;1811;0;1811;1;1;
/org.eclipse.osgi/eclipseAdaptor/src/org/eclipse/core/runtime/adaptor/EclipseAdaptorMsg.java;4;1;9;1;6;6;6;3;46;1;3;3773;96;96;1;0;0;3;9;3773;0;6133;9;4;
/org.eclipse.jdt.core/dom/org/eclipse/jdt/core/dom/AnnotationTypeDeclaration.java;2;2;10;1;3;2;3;7;145;1;7;4054;311;311;2;0;1;7;10;5268;1;5335;9;2;
/org.eclipse.core.tests.resources/src/org/eclipse/core/tests/internal/dtree/DeltaDataTreeTest.java;1;0;2;1;2;1;2;0;1032;0;0;5147;1032;1032;2;0;1;0;2;5147;1;5147;1;1;
/org.eclipse.update.ui.forms/src/org/eclipse/ui/forms/events/HyperlinkAdapter.java;1;0;2;1;0;0;0;2;0;0;1;3095;0;0;2;1;0;2;2;3095;1;3095;1;1;
/org.eclipse.team.core/src/org/eclipse/team/internal/core/subscribers/caches/IResourceVariantTree.java;1;0;5;1;0;0;0;5;54;2;4;4216;91;91;2;1;0;5;5;4233;1;4349;4;1;
/org.eclipse.ui.workbench/Eclipse UI/org/eclipse/ui/internal/roles/ICategoryRegistry.java;1;0;2;1;0;0;0;2;0;0;1;2864;0;0;2;1;0;2;2;2864;1;2864;1;1;
/org.eclipse.swt.tests/JUnit Tests/org/eclipse/swt/tests/junit/Test_org_eclipse_swt_SWTError.java;1;0;1;1;0;0;0;1;33;0;1;2176;33;33;1;0;0;1;1;2176;0;2176;1;1;
/org.eclipse.jdt.core/search/org/eclipse/jdt/internal/core/search/PatternSearchJob.java;3;1;13;1;3;3;3;10;218;4;7;1308;378;378;4;3;0;10;13;2835;3;5678;10;3;
/org.eclipse.team.cvs.ui/src/org/eclipse/team/internal/ccvs/ui/actions/SyncAllAction.java;1;0;1;1;0;0;0;1;0;0;1;1155;0;0;1;0;0;1;1;1155;0;1155;1;1;
/org.eclipse.ui.externaltools/Ant Editor/org/eclipse/ui/externaltools/internal/ant/editor/text/PlantyPartitionScanner.java;1;0;1;1;0;0;0;1;0;0;1;178;0;0;1;0;0;1;1;178;0;178;1;1;
/org.eclipse.jdt.ui.tests.refactoring/test cases/org/eclipse/jdt/ui/tests/refactoring/RefactoringTest.java;5;1;16;1;3;3;3;13;251;2;12;469;635;635;2;1;0;13;16;1006;1;6340;15;5;
/org.eclipse.jdt.ui/ui/org/eclipse/jdt/internal/ui/callhierarchy/SearchScopeWorkspaceAction.java;2;1;4;1;3;3;3;1;10;0;1;4047;14;14;1;0;0;1;4;4047;0;6340;4;2;
/org.eclipse.team.cvs.ui/src/org/eclipse/team/internal/ccvs/ui/wizards/UpdateWizard.java;2;1;6;1;4;4;4;2;105;1;2;866;135;135;1;0;0;2;6;866;0;6337;6;2;
/org.eclipse.jdt.core.tests.model/workspace/Formatter/test439/A_out.java;1;0;1;1;0;0;0;1;0;0;1;3498;0;0;1;0;0;1;1;3498;0;3498;1;1;
/org.eclipse.jdt.core.tests.model/workspace/Converter/src/test0393/A.java;1;0;1;1;0;0;0;1;0;0;1;3714;0;0;1;0;0;1;1;3714;0;3714;1;1;
/org.eclipse.jdt.core/codeassist/org/eclipse/jdt/internal/codeassist/select/SelectionOnQualifiedTypeReference.java;2;0;2;1;0;0;0;2;13;1;2;991;15;15;1;0;0;2;2;991;0;3560;2;2;
/org.eclipse.pde.core/src/org/eclipse/pde/internal/core/ischema/ISchemaInclude.java;2;1;3;1;2;2;2;1;6;0;1;4203;10;10;1;0;0;1;3;4203;0;6336;3;2;
/org.eclipse.jdt.debug/jdi interfaces/com/sun/jdi/Method.java;1;0;1;1;0;0;0;1;4;0;1;4267;4;4;1;0;0;1;1;4267;0;4267;1;1;
/org.eclipse.ui.workbench/Eclipse UI/org/eclipse/ui/internal/commands/api/ICommandManagerEvent.java;1;0;3;1;0;0;0;3;23;0;1;2562;23;23;3;2;0;3;3;2562;2;2562;1;1;
/org.eclipse.ui.workbench/Eclipse UI/org/eclipse/ui/internal/ActiveEditorAction.java;1;0;1;1;0;0;0;1;40;0;1;2737;40;40;1;0;0;1;1;2737;0;2737;1;1;
/org.eclipse.update.ui.forms/src/org/eclipse/ui/forms/parts/TableData.java;1;0;3;1;0;0;0;3;76;1;3;3038;76;76;1;0;0;3;3;3038;0;3096;3;1;
/org.eclipse.ui.workbench/Eclipse UI/org/eclipse/ui/internal/contexts/ContextServiceEvent.java;1;0;2;1;0;0;0;2;0;1;2;1137;0;0;1;0;0;2;2;1137;0;1220;2;1;
/org.eclipse.jface.text/src/org/eclipse/jface/text/rules/RuleBasedPartitioner.java;4;1;5;1;3;3;3;2;115;1;2;1521;197;197;1;0;0;2;5;1521;0;6358;5;4;
/org.eclipse.core.tests.runtime/src/org/eclipse/core/tests/internal/plugins/ConflictResolveTest_3.java;1;0;1;1;0;0;0;1;0;0;1;3014;0;0;1;0;0;1;1;3014;0;3014;1;1;
/org.eclipse.jdt.ui/ui refactoring/org/eclipse/jdt/internal/ui/refactoring/PullUpWizard.java;5;1;13;1;2;2;2;11;1323;2;10;518;1448;1448;2;1;0;11;13;1034;1;6340;12;5;
/org.eclipse.team.ui/src/org/eclipse/team/ui/synchronize/ISynchronizePage.java;2;1;3;1;2;2;2;1;59;0;1;5036;89;89;1;0;0;1;3;5036;0;6131;3;2;
/org.eclipse.jdt.core.tests.model/workspace/Formatter/test080/A_out.java;1;0;1;1;0;0;0;1;0;0;1;2425;0;0;1;0;0;1;1;2425;0;2425;1;1;
/org.eclipse.swt/Eclipse SWT PI/photon/org/eclipse/swt/internal/photon/PhRegion_t.java;1;0;1;1;0;0;0;1;1;0;1;808;1;1;1;0;0;1;1;808;0;808;1;1;
/org.eclipse.jdt.ui.tests.refactoring/resources/PasteSourceReference/test0/out/A.java;1;0;1;1;0;0;0;1;0;0;1;1311;0;0;1;0;0;1;1;1311;0;1311;1;1;
/org.eclipse.team.cvs.ui/src/org/eclipse/team/internal/uijobs/DeferredWorkbenchContentProvider.java;1;0;1;1;0;0;0;1;0;0;1;976;0;0;1;0;0;1;1;976;0;976;1;1;
/org.eclipse.jdt.debug/model/org/eclipse/jdt/internal/debug/core/model/JDIArrayType.java;2;0;3;1;0;0;0;3;15;1;3;1276;19;19;1;0;0;3;3;1276;0;2269;3;2;
/org.eclipse.jdt.core/model/org/eclipse/jdt/internal/core/Openable.java;3;1;31;1;2;2;2;29;179;3;25;85;628;628;3;4;0;29;31;1946;4;5911;27;3;
/org.eclipse.jdt.text.tests/src/org/eclipse/jdt/text/tests/comments/CommentFormatterUtil.java;1;1;2;1;2;2;2;0;2;0;0;5129;2;2;1;0;0;0;2;5129;0;6340;2;1;
/org.eclipse.jdt.core.tests.model/workspace/Formatter/test240/A_in.java;1;0;1;1;0;0;0;1;0;0;1;2437;0;0;1;0;0;1;1;2437;0;2437;1;1;
/org.eclipse.jdt.ui/ui refactoring/org/eclipse/jdt/internal/ui/refactoring/ChangeElement.java;1;0;2;1;0;0;0;2;12;1;2;1033;12;12;1;0;0;2;2;1033;0;4965;2;1;
/org.eclipse.jdt.core.tests.model/workspace/Formatter/test059/Parser_in.java;1;0;1;1;0;0;0;1;0;0;1;2425;0;0;1;0;0;1;1;2425;0;2425;1;1;
/org.eclipse.pde.ui/src/org/eclipse/pde/ui/IFragmentFieldData.java;2;1;6;1;5;5;5;1;42;0;1;3986;85;85;1;0;0;1;6;3986;0;6336;6;2;
/org.eclipse.ui.workbench/Eclipse UI/org/eclipse/ui/internal/commands/ws/CommandContributionItem.java;3;1;6;1;4;4;4;2;131;1;2;4927;154;154;1;0;0;2;6;4927;0;6338;6;3;
/org.eclipse.pde.ui/src_Forms/org/eclipse/pde/internal/ui/neweditor/TableSection.java;2;1;5;1;3;3;3;2;7;1;2;3795;15;15;1;0;0;2;5;3795;0;5431;5;2;
/org.eclipse.jdt.ui.tests.refactoring/resources/ExtractTemp/canExtract/A_test76_in.java;1;0;1;1;0;0;0;1;0;0;1;1569;0;0;1;0;0;1;1;1569;0;1569;1;1;
/org.eclipse.ui.workbench/Eclipse UI/org/eclipse/ui/internal/progress/ProgressFloatingWindow.java;2;0;34;1;1;1;1;33;226;3;19;3499;1069;1069;3;14;0;33;34;4083;14;5186;20;2;
/org.eclipse.core.boot/src/org/eclipse/core/internal/boot/PlatformURLConnection.java;1;0;3;1;0;0;0;3;135;1;3;790;140;140;1;0;0;3;3;790;0;3013;3;1;
/org.eclipse.jdt.ui/ui/org/eclipse/jdt/internal/ui/search/JavaStructureProvider.java;1;0;1;1;0;0;0;1;0;0;1;3488;0;0;1;0;0;1;1;3488;0;3488;1;1;
/org.eclipse.ui.views/src/org/eclipse/ui/views/properties/PropertySheetPageContextComputer.java;1;0;1;1;0;0;0;1;0;0;1;1218;0;0;1;0;0;1;1;1218;0;1218;1;1;
/org.eclipse.jdt.core/model/org/eclipse/jdt/internal/core/builder/StringSet.java;2;0;4;1;1;1;1;3;11;1;3;2788;21;21;1;0;0;3;4;2788;0;5802;4;2;
/org.eclipse.jdt.debug/jdi/org/eclipse/jdi/internal/ReferenceTypeImpl.java;3;0;9;1;0;0;0;9;822;1;9;566;1015;1015;1;0;0;9;9;566;0;4267;9;3;
/org.eclipse.ant.ui/Remote Ant Support/org/eclipse/ant/internal/ui/antsupport/AntSecurityManager.java;1;0;1;1;0;0;0;1;0;0;1;1811;0;0;1;0;0;1;1;1811;0;1811;1;1;
/org.eclipse.ui.workbench/Eclipse UI/org/eclipse/ui/internal/ObjectPluginAction.java;2;1;2;1;2;2;2;0;4;0;0;5310;6;6;1;0;0;0;2;5310;0;6338;2;2;
/org.eclipse.webdav/src/kernel/org/eclipse/webdav/internal/kernel/Message.java;1;0;1;1;1;1;1;0;4;0;0;5151;4;4;1;0;0;0;1;5151;0;5151;1;1;
/org.eclipse.jdt.ui/ui/org/eclipse/jdt/internal/ui/wizards/JavaProjectWizard.java;2;1;8;1;2;2;2;6;20;1;6;3830;67;67;1;0;0;6;8;3830;0;6340;8;2;
/org.eclipse.jdt.ui/core refactoring/org/eclipse/jdt/internal/corext/refactoring/structure/UseSupertypeWherePossibleRefactoring.java;3;1;14;1;3;3;3;11;102;1;11;1166;176;176;1;0;0;11;14;1166;0;6340;14;3;
/org.eclipse.jdt.ui.tests.refactoring/resources/ChangeSignature/cannotModify/A_testFailImport01.java;1;0;1;1;0;0;0;1;0;0;1;3820;0;0;1;0;0;1;1;3820;0;3820;1;1;
/org.eclipse.ui.workbench.texteditor/src/org/eclipse/ui/texteditor/SelectMarkerRulerAction2.java;2;0;3;1;1;1;1;2;98;1;2;2560;98;98;1;0;0;2;3;2560;0;5177;3;2;
/org.eclipse.jdt.core.tests.model/workspace/Formatter/test433/A_out.java;1;0;1;1;0;0;0;1;0;0;1;3495;0;0;1;0;0;1;1;3495;0;3495;1;1;
/org.eclipse.pde.core/src/org/eclipse/pde/internal/core/plugin/AbstractExtensionsModel.java;3;1;12;2;3;3;3;9;45;2;8;2184;104;104;2;1;0;9;12;2936;1;6336;11;3;
/org.eclipse.update.ui.forms/src/org/eclipse/update/ui/forms/internal/engine/FormEngineLayout.java;2;0;2;1;0;0;0;2;30;1;2;925;31;31;1;0;0;2;2;925;0;944;2;2;
/org.eclipse.jdt.core/search/org/eclipse/jdt/internal/core/search/matching/PackageDeclarationLocator.java;3;0;3;2;0;0;0;3;2;2;2;1986;4;4;2;1;0;3;3;1986;1;3560;2;3;
/org.eclipse.osgi/core/framework/org/eclipse/osgi/framework/internal/core/SystemBundleData.java;3;0;4;1;0;0;0;4;31;1;4;3013;34;34;1;0;0;4;4;3013;0;4336;4;3;
/org.eclipse.core.tests.resources/src/org/eclipse/core/tests/resources/usecase/Snapshot2Test.java;1;0;3;1;3;1;3;0;186;0;0;5147;186;186;3;0;2;0;3;5147;2;5147;1;1;
/org.eclipse.jface.text/src/org/eclipse/jface/contentassist/IContentAssistSubject.java;1;1;2;1;2;2;2;0;0;0;0;5181;0;0;1;0;0;0;2;5181;0;5199;2;1;
/org.eclipse.pde.ui/src_Forms/org/eclipse/pde/internal/ui/newparts/EditableTablePart.java;2;0;2;1;1;1;1;1;0;0;1;3795;0;0;1;0;0;1;2;3795;0;5431;2;2;
/org.eclipse.jdt.ui/core refactoring/org/eclipse/jdt/internal/corext/refactoring/reorg2/OverwriteHelper.java;1;0;3;1;0;0;0;3;1;1;3;808;1;1;1;0;0;3;3;808;0;1114;3;1;
/org.eclipse.update.tests.core/src/org/eclipse/update/tests/regularInstall/TestInstall.java;2;0;6;1;1;1;1;5;42;1;5;2048;68;68;1;0;0;5;6;2048;0;6336;6;2;
/org.eclipse.swt/Eclipse SWT PI/carbon/org/eclipse/swt/internal/carbon/BitMap.java;1;2;3;1;3;2;3;0;16;0;0;5534;20;20;2;0;1;0;3;5534;1;5614;2;1;
/org.eclipse.jdt.ui/core refactoring/org/eclipse/ltk/internal/core/refactoring/StatusConstants.java;1;0;2;1;0;0;0;2;0;1;2;4510;0;0;1;0;0;2;2;4510;0;4624;2;1;
/org.eclipse.debug.core/core/org/eclipse/debug/internal/core/variables/LaunchVariableMessages.java;3;0;3;1;0;0;0;3;9;1;3;737;9;9;1;0;0;3;3;737;0;2120;3;3;
/org.eclipse.jdt.ui/ui/org/eclipse/jdt/internal/ui/javaeditor/filebuffers/JavaDocumentSetupParticipant.java;2;0;3;1;0;0;0;3;2;1;3;1581;2;2;1;0;0;3;3;1581;0;4425;3;2;
/org.eclipse.ui.workbench/Eclipse UI/org/eclipse/ui/internal/roles/Persistence.java;1;0;5;1;0;0;0;5;125;2;4;2444;173;173;2;1;0;5;5;2864;1;2864;4;1;
/org.eclipse.jdt.ui.tests.refactoring/resources/IntroduceFactory/positive/multiUnit1C_in.java;1;0;2;1;0;0;0;2;0;1;2;2846;0;0;1;0;0;2;2;2846;0;2862;2;1;
/org.eclipse.pde.ui/src/org/eclipse/pde/internal/ui/editor/schema/NewAttributeAction.java;2;1;2;1;2;2;2;0;12;0;0;5781;16;16;1;0;0;0;2;5781;0;6336;2;2;
/org.eclipse.ui.workbench/Eclipse UI/org/eclipse/ui/internal/commands/util/old/Sequence.java;1;0;3;1;0;0;0;3;2;2;2;1222;2;2;2;1;0;3;3;1321;1;1321;2;1;
/org.eclipse.jdt.debug.ui/ui/org/eclipse/jdt/internal/debug/ui/classpath/AbstractClasspathEntry.java;1;0;1;1;0;0;0;1;0;0;1;2691;0;0;1;0;0;1;1;2691;0;2691;1;1;
/org.eclipse.jdt.core/model/org/eclipse/jdt/internal/core/builder/SourceFile.java;3;0;5;1;0;0;0;5;34;1;5;2733;52;52;1;0;0;5;5;2733;0;4731;5;3;
/org.eclipse.ant.ui/Ant Editor/org/eclipse/ant/internal/ui/dtd/Parser.java;1;0;5;1;0;0;0;5;26;1;5;1811;39;39;1;0;0;5;5;1811;0;3809;5;1;
/org.eclipse.webdav/src/client/org/eclipse/webdav/internal/authentication/AuthenticationInfo.java;1;0;1;1;1;1;1;0;147;0;0;5151;147;147;1;0;0;0;1;5151;0;5151;1;1;
/org.eclipse.jdt.ui.examples.javafamily/src/org/eclipse/jface/text/source/ITranslatorResultCollector.java;1;0;2;1;0;0;0;2;0;1;2;1190;0;0;1;0;0;2;2;1190;0;1642;2;1;
/org.eclipse.ui.workbench/Eclipse UI/org/eclipse/ui/internal/presentations/SystemMenuMoveEditor.java;2;0;2;1;1;1;1;1;0;0;1;4680;0;0;1;0;0;1;2;4680;0;5173;2;2;
/org.eclipse.pde.ui/src/org/eclipse/pde/internal/ui/editor/text/PDEPartitionScanner.java;1;0;1;1;0;0;0;1;0;0;1;3795;0;0;1;0;0;1;1;3795;0;3795;1;1;
/org.eclipse.osgi/eclipseAdaptor/src/org/eclipse/core/runtime/adaptor/IModel.java;3;1;5;1;3;3;3;2;4;1;2;3244;10;10;1;0;0;2;5;3244;0;6337;5;3;
/org.eclipse.search/search/org/eclipse/search/internal/ui/text/FileMatch.java;1;0;1;1;0;0;0;1;0;0;1;4045;0;0;1;0;0;1;1;4045;0;4045;1;1;
/org.eclipse.update.ui/src/org/eclipse/update/internal/ui/preferences/UpdateSettingsPreferencePage.java;3;1;6;1;2;2;2;4;10;1;4;825;32;32;1;0;0;4;6;825;0;6336;6;3;
/org.eclipse.ui.ide/src/org/eclipse/ui/views/markers/internal/ActionResolveMarker.java;3;1;3;1;2;2;2;1;4;0;1;2208;6;6;1;0;0;1;3;2208;0;6338;3;3;
/org.eclipse.swt.graphics.text/Eclipse SWT PI/gtk/org/eclipse/swt/internal/gtk/OS.java;2;0;8;1;0;0;0;8;1469;2;6;2919;1552;1552;2;2;0;8;8;3874;2;4213;6;2;
/org.eclipse.ltk.ui.refactoring/src/org/eclipse/ltk/internal/ui/refactoring/PseudoJavaChangeElement.java;1;1;6;1;4;4;4;2;12;1;2;4965;34;34;1;0;0;2;6;4965;0;6340;6;1;
/org.eclipse.jdt.ui.examples.javafamily/src/org/eclipse/jsp/JspIndexParser.java;2;0;6;1;1;1;1;5;60;1;5;1033;78;78;1;0;0;5;6;1033;0;5607;6;2;
/org.eclipse.jdt.core.tests.model/workspace/Converter/test0154/Test.java;1;0;1;1;0;0;0;1;0;0;1;3714;0;0;1;0;0;1;1;3714;0;3714;1;1;
/org.eclipse.ant.ui/Ant Tools Support/org/eclipse/ant/internal/ui/model/IAntUIPreferenceConstants.java;2;0;13;2;0;0;0;13;14;2;12;1811;68;68;2;1;0;13;13;1915;1;4606;12;2;
/org.eclipse.swt/Eclipse SWT PI/win32/org/eclipse/swt/internal/ole/win32/COM.java;3;1;10;1;5;5;5;5;10;1;5;2246;36;36;1;0;0;5;10;2246;0;6352;10;3;
/org.eclipse.jdt.core/compiler/org/eclipse/jdt/core/compiler/InvalidInputException.java;1;0;1;1;0;0;0;1;2;0;1;3560;2;2;1;0;0;1;1;3560;0;3560;1;1;
/org.eclipse.team.ui/src/org/eclipse/team/ui/synchronize/SyncInfoSet.java;1;0;1;1;0;0;0;1;0;0;1;3530;0;0;1;0;0;1;1;3530;0;3530;1;1;
/org.eclipse.update.tests.core/src/org/eclipse/update/tests/mirror/AllMirrorTests.java;1;0;1;1;0;0;0;1;0;0;1;2104;0;0;1;0;0;1;1;2104;0;2104;1;1;
/org.eclipse.swt/Eclipse SWT/win32/org/eclipse/swt/widgets/Scale.java;3;1;4;1;2;2;2;2;28;1;2;2708;54;54;1;0;0;2;4;2708;0;6352;4;3;
/org.eclipse.jdt.core/model/org/eclipse/jdt/internal/core/util/LineNumberAttribute.java;1;0;1;1;0;0;0;1;2;0;1;3560;2;2;1;0;0;1;1;3560;0;3560;1;1;
/org.eclipse.ui.workbench/Eclipse UI/org/eclipse/ui/internal/commands/api/ICommandService.java;1;0;2;1;0;0;0;2;2;0;1;2562;2;2;2;1;0;2;2;2562;1;2562;1;1;
/org.eclipse.update.ui.win32/src/org/eclipse/welcome/internal/webbrowser/GlobalActionHandler.java;1;0;1;1;0;0;0;1;0;0;1;907;0;0;1;0;0;1;1;907;0;907;1;1;
/org.eclipse.pde.ui/src_Forms/org/eclipse/pde/internal/ui/neweditor/build/BuildUtil.java;2;0;2;1;1;1;1;1;0;0;1;4406;0;0;1;0;0;1;2;4406;0;5431;2;2;
/org.eclipse.swt/Eclipse SWT AWT/motif/org/eclipse/swt/awt/SWT_AWT.java;4;2;14;2;10;8;10;4;42;2;3;3013;182;182;2;1;2;4;14;3013;3;6352;11;4;
/org.eclipse.update.ui/srcnew/org/eclipse/update/internal/ui/views/SiteStateAction2.java;3;0;6;2;0;0;0;6;39;2;5;429;66;66;2;1;0;6;6;602;1;767;5;3;
/org.eclipse.debug.ui/ui/org/eclipse/debug/internal/ui/views/memory/ITableMemoryViewTab.java;1;0;1;1;1;1;1;0;0;0;0;5254;0;0;1;0;0;0;1;5254;0;5254;1;1;
/org.eclipse.jdt.ui.tests.refactoring/resources/ExtractMethodWorkSpace/ExtractMethodTests/wiki_out/A_test2004.java;1;0;2;1;0;0;0;2;7;1;2;130;11;11;1;0;0;2;2;130;0;844;2;1;
/org.eclipse.jdt.ui/core extension/org/eclipse/jdt/internal/corext/template/CodeTemplates.java;2;0;4;1;0;0;0;4;6;1;4;664;12;12;1;0;0;4;4;664;0;4258;4;2;
/org.eclipse.core.resources/src/org/eclipse/core/internal/utils/EmptyEnumeration.java;1;1;2;1;2;2;2;0;55;0;0;5108;59;59;1;0;0;0;2;5108;0;5146;2;1;
/org.eclipse.ui.workbench/Eclipse UI/org/eclipse/ui/contexts/EnabledSubmission.java;2;1;10;1;2;2;2;8;151;2;7;4106;540;540;2;1;0;8;10;4950;1;5731;9;2;
/org.eclipse.jdt.ui.tests.refactoring/resources/MoveInstanceMethod/canMove/test19/in/Rectangle.java;1;0;1;1;0;0;0;1;0;0;1;1570;0;0;1;0;0;1;1;1570;0;1570;1;1;
/org.eclipse.jdt.ui/core refactoring/org/eclipse/ltk/internal/core/refactoring/RenameFieldData.java;1;0;2;1;0;0;0;2;0;1;2;4510;0;0;1;0;0;2;2;4510;0;4624;2;1;
/org.eclipse.jdt.core.tests.model/workspace/Formatter/test457/A_out.java;1;0;1;1;0;0;0;1;0;0;1;3861;0;0;1;0;0;1;1;3861;0;3861;1;1;
/org.eclipse.core.runtime.compatibility/src-model/org/eclipse/core/runtime/model/URLModel.java;3;2;6;1;4;3;4;2;10;1;2;3013;19;19;2;0;1;2;6;5117;1;6340;5;3;
/org.eclipse.osgi/core/framework/org/eclipse/osgi/framework/internal/core/AliasMapper.java;4;1;7;1;3;3;3;4;305;1;4;3013;386;386;1;0;0;4;7;3013;0;6337;7;4;
/org.eclipse.core.resources/src/org/eclipse/core/internal/events/DeltaFilter.java;1;0;1;1;1;1;1;0;40;0;0;5146;40;40;1;0;0;0;1;5146;0;5146;1;1;
/org.eclipse.swt/Eclipse SWT Mozilla/common/org/eclipse/swt/internal/mozilla/nsIWidget.java;1;0;2;1;0;0;0;2;3;1;2;1691;3;3;1;0;0;2;2;1691;0;2725;2;1;
/org.eclipse.help/src/org/eclipse/help/internal/RuntimeHelpStatus.java;1;1;5;1;3;3;3;2;131;1;2;1791;198;198;1;0;0;2;5;1791;0;6337;5;1;
/org.eclipse.pde.core/src/org/eclipse/pde/core/build/IBuildModelFactory.java;2;1;2;1;2;2;2;0;12;0;0;5115;16;16;1;0;0;0;2;5115;0;6336;2;2;
/org.eclipse.jdt.ui.tests.refactoring/resources/RenameType/test57/in/A.java;1;0;1;1;0;0;0;1;3;0;1;4577;3;3;1;0;0;1;1;4577;0;4577;1;1;
/org.eclipse.debug.ui/ui/org/eclipse/debug/internal/ui/launchVariables/StringPromptExpander.java;2;0;3;1;0;0;0;3;3;1;3;771;3;3;1;0;0;3;3;771;0;2120;3;2;
/org.eclipse.jdt.core/dom/org/eclipse/jdt/core/dom/EnumDeclaration.java;3;2;13;1;4;3;4;9;196;1;9;4054;386;386;2;0;1;9;13;5268;1;6094;12;3;
/org.eclipse.osgi/osgi/src/org/osgi/service/startlevel/StartLevel.java;2;0;2;1;1;1;1;1;3;0;1;3013;3;3;1;0;0;1;2;3013;0;5536;2;2;
/org.eclipse.jdt.core.tests.model/workspace/Formatter/test150/A_out.java;1;0;1;1;0;0;0;1;0;0;1;2425;0;0;1;0;0;1;1;2425;0;2425;1;1;
/org.eclipse.ui.workbench/Eclipse UI/org/eclipse/ui/internal/csm/roles/api/IRoleManager.java;1;0;3;1;0;0;0;3;17;1;3;2213;17;17;1;0;0;3;3;2213;0;2240;3;1;
/org.eclipse.jdt.ui.tests.refactoring/resources/InlineMethodWorkspace/TestCases/expression_out/TestSimpleBody.java;1;0;1;1;0;0;0;1;2;0;1;845;2;2;1;0;0;1;1;845;0;845;1;1;
/org.eclipse.jdt.core.tests.model/src/org/eclipse/jdt/core/tests/model/JavaProjectTests.java;3;2;18;1;3;2;3;15;47;2;13;191;202;202;2;2;1;15;18;453;3;6078;15;3;
/org.eclipse.compare/compare/org/eclipse/compare/contentmergeviewer/ContentMergeViewer.java;1;0;3;1;0;0;0;3;66;1;3;1289;76;76;1;0;0;3;3;1289;0;4421;3;1;
/org.eclipse.search/new search/org/eclipse/search2/internal/ui/basic/views/IContextMenuConstants.java;1;0;2;1;0;0;0;2;0;1;2;3474;0;0;1;0;0;2;2;3474;0;3711;2;1;
/org.eclipse.update.ui/srcnew/org/eclipse/update/internal/ui/wizards/MoreInfoGenerator.java;2;0;4;1;0;0;0;4;14;1;4;332;24;24;1;0;0;4;4;332;0;825;4;2;
/org.eclipse.ui.workbench/Eclipse UI/org/eclipse/ui/internal/commands/older/CategoryEvent.java;1;0;2;1;0;0;0;2;4;0;1;2562;4;4;2;1;0;2;2;2562;1;2562;1;1;
/org.eclipse.ui.ide/src/org/eclipse/ui/views/markers/internal/MarkerFilter.java;5;1;8;1;3;3;3;5;376;1;5;2208;410;410;1;0;0;5;8;2208;0;6338;8;5;
/org.eclipse.osgi/resolver/src/org/eclipse/osgi/internal/resolver/Eclipse21SelectionPolicy.java;4;1;4;1;3;3;3;1;36;0;1;3013;55;55;1;0;0;1;4;3013;0;5408;4;4;
/org.eclipse.ui.ide/src/org/eclipse/ui/internal/EditorAreaDropAdapter.java;2;0;3;1;0;0;0;3;2;1;3;1561;2;2;1;0;0;3;3;1561;0;2263;3;2;
/org.eclipse.jdt.ui.tests.refactoring/resources/IntroduceFactory/positive/multiUnit1A_in.java;1;0;2;1;0;0;0;2;0;1;2;2846;0;0;1;0;0;2;2;2846;0;2862;2;1;
/org.eclipse.jdt.ui/ui/org/eclipse/jdt/ui/CodeGeneration.java;1;0;6;1;1;1;1;5;67;1;5;664;194;194;1;0;0;5;6;664;0;6334;6;1;
/org.eclipse.jdt.ui/core refactoring/org/eclipse/jdt/internal/corext/refactoring/nls/NLSScanner.java;3;1;4;1;2;2;2;2;58;1;2;1464;79;79;1;0;0;2;4;1464;0;6340;4;3;
/org.eclipse.jface/src/org/eclipse/jface/dialogs/ProgressIndicator.java;1;0;3;1;1;1;1;2;49;1;2;4974;101;101;1;0;0;2;3;4974;0;5468;3;1;
/org.eclipse.ui.workbench/Eclipse UI/org/eclipse/ui/IWorkingSet.java;1;0;1;1;0;0;0;1;6;0;1;3206;6;6;1;0;0;1;1;3206;0;3206;1;1;
/org.eclipse.team.ui/src/org/eclipse/team/internal/ui/widgets/IHyperlinkListener.java;1;0;1;1;0;0;0;1;0;0;1;3176;0;0;1;0;0;1;1;3176;0;3176;1;1;
/org.eclipse.ui.workbench/Eclipse UI/org/eclipse/ui/internal/dialogs/CreateProjectStep.java;1;0;1;1;0;0;0;1;0;0;1;2737;0;0;1;0;0;1;1;2737;0;2737;1;1;
/org.eclipse.team.ui/src/org/eclipse/team/internal/ui/registry/LogicalViewRegistry.java;1;0;1;1;0;0;0;1;0;0;1;3734;0;0;1;0;0;1;1;3734;0;3734;1;1;
/org.eclipse.ui.ide/src/org/eclipse/ui/internal/ide/IDEInternalPreferences.java;5;1;6;1;3;3;3;3;8;1;3;1659;18;18;1;0;0;3;6;1659;0;6338;6;5;
/org.eclipse.ui.tests/Eclipse RCP Tests/org/eclipse/ui/rcp/tests/WorkbenchConfigurerTest.java;1;0;1;1;0;0;0;1;0;0;1;4930;0;0;1;0;0;1;1;4930;0;4930;1;1;
/org.eclipse.jdt.core.tests.model/workspace/Converter/src/test0501/JavaEditor.java;1;0;1;1;0;0;0;1;0;0;1;3714;0;0;1;0;0;1;1;3714;0;3714;1;1;
/org.eclipse.pde.core/src/org/eclipse/pde/internal/core/SourceAttachmentManager.java;2;1;4;1;2;2;2;2;16;1;2;4203;26;26;1;0;0;2;4;4203;0;6336;4;2;
/org.eclipse.ui.views/src/org/eclipse/ui/views/markers/internal/ProblemFilter.java;2;0;2;1;0;0;0;2;0;1;2;755;0;0;1;0;0;2;2;755;0;2738;2;2;
/org.eclipse.pde.ui/src/org/eclipse/pde/internal/ui/launcher/TracingPropertySource.java;2;2;6;1;4;3;4;2;323;1;2;3265;614;614;2;0;1;2;6;6047;1;6336;5;2;
/org.eclipse.jface.text/src/org/eclipse/jface/text/contentassist/AdditionalInfoController.java;3;2;8;1;4;3;4;4;44;1;4;787;88;88;2;0;1;4;8;6353;1;6353;7;3;
/org.eclipse.jdt.debug.ui/ui/org/eclipse/jdt/internal/debug/ui/actions/AddExceptionAction.java;1;0;2;1;0;0;0;2;3;1;2;1240;3;3;1;0;0;2;2;1240;0;3093;2;1;
/org.eclipse.jdt.debug.tests/tests/org/eclipse/jdt/debug/tests/eval/ByteOperatorsTests.java;1;0;1;1;0;0;0;1;222;0;1;1274;222;222;1;0;0;1;1;1274;0;1274;1;1;
/org.eclipse.swt/Eclipse SWT PI/photon/org/eclipse/swt/internal/photon/PhClipHeader.java;1;0;2;1;0;0;0;2;9;1;2;808;12;12;1;0;0;2;2;808;0;921;2;1;
/org.eclipse.jdt.core.tests.model/workspace/Converter/src/test0366/A.java;1;0;1;1;0;0;0;1;0;0;1;3714;0;0;1;0;0;1;1;3714;0;3714;1;1;
/org.eclipse.ui.tests/Eclipse UI Tests/org/eclipse/ui/tests/internal/TextSelectionActionExpressionTest.java;1;0;2;1;0;0;0;2;3;1;2;2738;6;6;1;0;0;2;2;2738;0;3091;2;1;
/org.eclipse.jdt.ui/core refactoring/org/eclipse/jdt/internal/corext/refactoring/util/ResourceUtil.java;3;0;4;1;1;1;1;3;4;1;3;2081;9;9;1;0;0;3;4;2081;0;6340;4;3;
/org.eclipse.swt/Eclipse SWT PI/win32/org/eclipse/swt/internal/win32/MARGINS.java;2;1;2;1;2;2;2;0;4;0;0;5135;4;4;1;0;0;0;2;5135;0;6352;2;2;
/org.eclipse.update.core/src/org/eclipse/update/internal/configuration/ConfiguredSite.java;1;0;1;1;0;0;0;1;0;0;1;2828;0;0;1;0;0;1;1;2828;0;2828;1;1;
/org.eclipse.jdt.ui/ui/org/eclipse/jdt/internal/ui/preferences/MockupPreferenceStore.java;1;0;2;1;0;0;0;2;136;1;2;4128;136;136;1;0;0;2;2;4128;0;4183;2;1;
/org.eclipse.team.cvs.ui/src/org/eclipse/team/internal/ccvs/ui/actions/ShowEditorsAction.java;1;0;2;1;1;1;1;1;9;0;1;1133;16;16;1;0;0;1;2;1133;0;5428;2;1;
/org.eclipse.compare/compare/org/eclipse/compare/IStreamMerger.java;1;1;4;1;4;4;4;0;3;0;0;5165;7;7;1;0;0;0;4;5165;0;6322;4;1;
/org.eclipse.ui.ide/extensions/org/eclipse/ui/ICapabilityInstallWizard.java;1;0;1;1;0;0;0;1;0;0;1;2263;0;0;1;0;0;1;1;2263;0;2263;1;1;
/org.eclipse.team.cvs.ui/src/org/eclipse/team/internal/uijobs/DeferredElementCollector.java;1;0;1;1;0;0;0;1;0;0;1;976;0;0;1;0;0;1;1;976;0;976;1;1;
/org.eclipse.ui.workbench/Eclipse UI/org/eclipse/ui/internal/roles/IActivityManagerListener.java;2;0;3;1;0;0;0;3;7;1;3;2060;7;7;1;0;0;3;3;2060;0;2443;3;2;
/org.eclipse.jdt.ui/ui/org/eclipse/jdt/internal/ui/jarpackager/JarPackagerMessages.java;1;0;1;1;1;1;1;0;2;0;0;6340;2;2;1;0;0;0;1;6340;0;6340;1;1;
/org.eclipse.jdt.core/search/org/eclipse/jdt/internal/core/search/matching/JavaSearchNameEnvironment.java;2;0;8;1;1;1;1;7;50;1;7;77;132;132;1;0;0;7;8;77;0;5375;8;2;
/org.eclipse.jdt.core.tests.model/workspace/Converter/src/test0257/Test.java;1;0;1;1;0;0;0;1;0;0;1;3714;0;0;1;0;0;1;1;3714;0;3714;1;1;
/org.eclipse.jdt.ui.tests.refactoring/resources/IntroduceParameter/simple/out/Constructor1.java;1;0;1;1;1;1;1;0;0;0;0;5851;0;0;1;0;0;0;1;5851;0;5851;1;1;
/org.eclipse.ui.views/src/org/eclipse/ui/views/markers/internal/ActionMarkCompleted.java;2;0;2;1;0;0;0;2;0;1;2;755;0;0;1;0;0;2;2;755;0;2738;2;2;
/org.eclipse.pde.ui/src/org/eclipse/pde/internal/ui/wizards/exports/PluginExportWizard.java;2;2;20;2;6;4;6;14;121;2;13;94;317;317;2;1;2;14;20;1255;3;6336;17;2;
/org.eclipse.ui.workbench/Eclipse UI/org/eclipse/ui/internal/misc/TestPartListener.java;1;0;1;1;0;0;0;1;1;0;1;2737;1;1;1;0;0;1;1;2737;0;2737;1;1;
/org.eclipse.ui.ide/src/org/eclipse/ui/ICapabilityWizard.java;1;0;2;1;0;0;0;2;0;1;2;1511;0;0;1;0;0;2;2;1511;0;1520;2;1;
/org.eclipse.pde.ui/src/org/eclipse/pde/internal/ui/launcher/ILauncherSettings.java;2;1;17;1;4;4;4;13;46;2;12;605;104;104;2;1;0;13;17;3732;1;6336;16;2;
/org.eclipse.jdt.ui.tests.refactoring/resources/ChangeSignature/canModify/A_test12_out.java;1;0;1;1;0;0;0;1;4;0;1;824;4;4;1;0;0;1;1;824;0;824;1;1;
/org.eclipse.jdt.ui.tests.refactoring/resources/Copy/test_method_yes_initializer/out/A.java;1;0;1;1;0;0;0;1;2;0;1;685;2;2;1;0;0;1;1;685;0;685;1;1;
/org.eclipse.text/src/org/eclipse/jface/text/source/IAnnotationModelListener.java;1;1;3;1;2;2;2;1;31;0;1;2243;56;56;1;0;0;1;3;2243;0;6300;3;1;
/org.eclipse.ui.tests/Eclipse UI Tests/org/eclipse/ui/tests/api/StartupClass.java;1;0;1;1;0;0;0;1;0;0;1;3012;0;0;1;0;0;1;1;3012;0;3012;1;1;
/org.eclipse.ui.ide/extensions/org/eclipse/ui/dialogs/ResourceSelectionDialog.java;1;0;2;1;0;0;0;2;3;1;2;2263;3;3;1;0;0;2;2;2263;0;2611;2;1;
/org.eclipse.jdt.core.tests.model/workspace/Converter/src/test0416/A.java;1;0;1;1;0;0;0;1;0;0;1;3714;0;0;1;0;0;1;1;3714;0;3714;1;1;
/org.eclipse.ui.workbench/Eclipse UI/org/eclipse/ui/internal/contexts/registry/Persistence.java;1;0;5;1;0;0;0;5;18;2;4;1396;20;20;2;1;0;5;5;1396;1;1724;4;1;
/org.eclipse.swt.examples.browser/src/org/eclipse/swt/examples/browserexample/BrowserView.java;1;0;1;1;0;0;0;1;0;0;1;3114;0;0;1;0;0;1;1;3114;0;3114;1;1;
/org.eclipse.jdt.ui/ui/org/eclipse/jdt/ui/JavaUI.java;5;2;7;2;3;2;3;4;54;1;4;1581;144;144;2;0;1;4;7;6334;1;6334;6;5;
/org.eclipse.swt/Eclipse SWT PI/gtk1x/org/eclipse/swt/internal/gtk/GdkEventButton.java;1;0;1;1;0;0;0;1;0;0;1;2327;0;0;1;0;0;1;1;2327;0;2327;1;1;
/org.eclipse.jdt.core.tests.compiler/src/org/eclipse/jdt/core/tests/compiler/parser/FieldAccessCompletionTest.java;3;0;4;1;0;0;0;4;6;2;3;991;14;14;2;1;0;4;4;1314;1;3560;3;3;
/org.eclipse.jdt.ui/ui/org/eclipse/jdt/internal/ui/browsing/MembersView.java;2;0;5;1;1;1;1;4;15;1;4;556;24;24;1;0;0;4;5;556;0;6340;5;2;
/org.eclipse.jdt.core.tests.model/workspace/Converter/test0406/A.java;1;0;1;1;0;0;0;1;0;0;1;3714;0;0;1;0;0;1;1;3714;0;3714;1;1;
/org.eclipse.compare/compare/org/eclipse/compare/internal/patch/CompareWithPatchAction.java;1;0;4;1;0;0;0;4;20;1;4;257;28;28;1;0;0;4;4;257;0;3938;4;1;
/org.eclipse.ui.workbench.texteditor/src/org/eclipse/ui/texteditor/ITextEditorActionConstants.java;3;2;10;2;4;3;4;6;118;1;6;436;238;238;2;0;1;6;10;6334;1;6334;9;3;
/org.eclipse.jface.text/src/org/eclipse/jface/text/contentassist/IContentAssistSubject.java;2;0;4;1;1;1;1;3;27;1;3;2281;35;35;1;0;0;3;4;2281;0;5181;4;2;
/org.eclipse.swt/Eclipse SWT Mozilla/common/org/eclipse/swt/internal/mozilla/nsIWebBrowser.java;1;0;2;1;0;0;0;2;10;1;2;1654;10;10;1;0;0;2;2;1654;0;2568;2;1;
/org.eclipse.core.tests.harness/src/org/eclipse/core/tests/harness/TestBarrier.java;2;0;3;1;1;1;1;2;13;0;1;5085;16;16;2;1;0;2;3;5085;1;5146;2;2;
/org.eclipse.pde.ui/src/org/eclipse/pde/internal/ui/editor/manifest/NullMenuManager.java;1;0;1;1;0;0;0;1;0;0;1;3235;0;0;1;0;0;1;1;3235;0;3235;1;1;
/org.eclipse.update.ui.win32/src/org/eclipse/welcome/internal/portal/PortalSection.java;1;0;2;1;0;0;0;2;226;1;2;912;226;226;1;0;0;2;2;912;0;925;2;1;
/org.eclipse.jdt.ui.tests.refactoring/resources/Copy/test_fields_declared_in_multi_yes_type/out/A.java;1;0;3;1;0;0;0;3;2;1;3;686;4;4;1;0;0;3;3;686;0;1644;3;1;
/org.eclipse.team.tests.cvs.core/src/org/eclipse/team/tests/ccvs/ui/unit/HeadlessCVSRunnableContext.java;2;0;3;1;0;0;0;3;21;1;3;1840;21;21;1;0;0;3;3;1840;0;2632;3;2;
/org.eclipse.jdt.ui/core refactoring/org/eclipse/jdt/internal/corext/refactoring/rename/RenameVirtualMethodRefactoring.java;2;0;4;1;0;0;0;4;28;1;4;122;45;45;1;0;0;4;4;122;0;1125;4;2;
/org.eclipse.jdt.core.tests.model/workspace/Formatter/test262/A_out.java;1;0;1;1;0;0;0;1;0;0;1;2442;0;0;1;0;0;1;1;2442;0;2442;1;1;
/org.eclipse.pde.ui/src_Forms/org/eclipse/pde/internal/ui/neweditor/plugin/LibrarySection.java;3;1;8;1;2;2;2;6;113;2;5;4919;176;176;2;1;0;6;8;4959;1;5431;7;3;
/org.eclipse.jdt.ui.tests.refactoring/resources/ChangeSignature/canModify/A_testName01_out.java;1;0;1;1;0;0;0;1;0;0;1;3801;0;0;1;0;0;1;1;3801;0;3801;1;1;
/org.eclipse.team.ui/src/org/eclipse/team/internal/ui/synchronize/CompareView.java;2;1;2;1;2;2;2;0;52;0;0;5520;52;52;1;0;0;0;2;5520;0;5596;2;2;
/org.eclipse.jdt.ui.tests.refactoring/resources/Paste/testPastingTypedResources3/in/A.java;1;0;1;1;0;0;0;1;0;0;1;1646;0;0;1;0;0;1;1;1646;0;1646;1;1;
/org.eclipse.jdt.core.tests.model/workspace/Completion/src/CompletionStaticMethodDeclaration3.java;1;0;1;1;0;0;0;1;0;0;1;3039;0;0;1;0;0;1;1;3039;0;3039;1;1;
/org.eclipse.jface.text/src/org/eclipse/jface/text/source/_IAnnotationPresentation.java;1;0;1;1;0;0;0;1;0;0;1;2874;0;0;1;0;0;1;1;2874;0;2874;1;1;
/org.eclipse.osgi/core/framework/org/eclipse/osgi/framework/internal/protocol/URLStreamHandlerProxy.java;5;1;7;1;3;3;3;4;191;1;4;3013;229;229;1;0;0;4;7;3013;0;6337;7;5;
/org.eclipse.ui.views/src/org/eclipse/ui/views/internal/markers/OpenMarkerAction.java;1;0;2;1;0;0;0;2;0;1;2;265;0;0;1;0;0;2;2;265;0;749;2;1;
/org.eclipse.ui.externaltools/Ant Editor/org/eclipse/ui/externaltools/internal/ant/dtd/util/MapHolder.java;1;0;1;1;0;0;0;1;0;0;1;282;0;0;1;0;0;1;1;282;0;282;1;1;
/org.eclipse.tomcat/src/org/eclipse/tomcat/internal/WebAppClassLoader.java;1;1;3;1;2;2;2;1;28;0;1;2334;36;36;1;0;0;1;3;2334;0;6337;3;1;
/org.eclipse.team.ui/src/org/eclipse/team/internal/ui/sync/views/SynchronizeViewNode.java;2;0;4;1;0;0;0;4;4;1;4;1477;6;6;1;0;0;4;4;1477;0;2632;4;2;
/org.eclipse.jdt.ui/core refactoring/org/eclipse/ltk/internal/core/refactoring/ListenerList.java;1;0;3;1;0;0;0;3;2;1;3;4510;2;2;1;0;0;3;3;4510;0;4864;3;1;
/org.eclipse.jdt.core/search/org/eclipse/jdt/core/search/IJavaSearchResultCollector.java;2;1;6;1;3;3;3;3;12;1;3;3211;25;25;1;0;0;3;6;3211;0;5200;6;2;
/org.eclipse.help/src/org/eclipse/help/internal/context/ContextProxy.java;1;0;1;1;0;0;0;1;0;0;1;2732;0;0;1;0;0;1;1;2732;0;2732;1;1;
/org.eclipse.osgi/defaultAdaptor/src/org/eclipse/osgi/framework/adaptor/core/BundleResourceHandler.java;2;2;6;1;4;3;4;2;339;1;2;4336;435;435;2;0;1;2;6;5116;1;6133;5;2;
/org.eclipse.jdt.ui/ui/org/eclipse/jdt/ui/text/java/IInvocationContext.java;3;1;8;1;3;3;3;5;25;1;5;1232;60;60;1;0;0;5;8;1232;0;6340;8;3;
/org.eclipse.debug.ui/ui/org/eclipse/debug/ui/ILaunchShortcut.java;2;0;2;1;1;1;1;1;32;0;1;3927;36;36;1;0;0;1;2;3927;0;6336;2;2;
/org.eclipse.ui.examples.job/org/eclipse/ui/examples/jobs/BusyShowWhileDialog.java;1;0;2;1;2;1;2;0;0;0;0;5125;0;0;2;0;1;0;2;5125;1;5125;1;1;
/org.eclipse.jdt.ui.tests.refactoring/resources/IntroduceFactory/positive/ProtectConstructor1_in.java;1;0;2;1;1;1;1;1;2;0;1;2846;2;2;1;0;0;1;2;2846;0;5659;2;1;
/org.eclipse.core.tests.runtime/src/org/eclipse/core/tests/plugintests/SavePreferencesTests.java;1;0;1;1;0;0;0;1;0;0;1;3014;0;0;1;0;0;1;1;3014;0;3014;1;1;
/org.eclipse.swt/Eclipse SWT/common/org/eclipse/swt/graphics/RGB.java;3;1;3;1;2;2;2;1;6;0;1;4062;14;14;1;0;0;1;3;4062;0;6352;3;3;
/org.eclipse.jdt.core.tests.model/workspace/Formatter/test430/A_out.java;1;0;1;1;0;0;0;1;0;0;1;3478;0;0;1;0;0;1;1;3478;0;3478;1;1;
/org.eclipse.team.ui/src/org/eclipse/team/internal/ui/registry/SynchronizeWizardDescription.java;1;1;2;1;2;2;2;0;88;0;0;5532;88;88;1;0;0;0;2;5532;0;5596;2;1;
/org.eclipse.ui.workbench/Eclipse UI/org/eclipse/ui/internal/NewConfigurationInfo.java;1;0;1;1;0;0;0;1;0;0;1;2737;0;0;1;0;0;1;1;2737;0;2737;1;1;
/org.eclipse.core.resources/src/org/eclipse/core/internal/indexing/ObjectHeader.java;1;0;1;1;1;1;1;0;13;0;0;5146;13;13;1;0;0;0;1;5146;0;5146;1;1;
/org.eclipse.ant.ui/Ant Editor/org/eclipse/ant/ui/internal/editor/AntEditorSourceViewerConfiguration.java;1;0;5;1;0;0;0;5;43;1;5;250;67;67;1;0;0;5;5;250;0;1811;5;1;
/org.eclipse.jdt.ui/core refactoring/org/eclipse/jdt/internal/corext/refactoring/reorg/IReorgEnablementPolicy.java;2;0;2;1;1;1;1;1;2;0;1;1114;2;2;1;0;0;1;2;1114;0;6340;2;2;
/org.eclipse.update.ui/src/org/eclipse/update/internal/ui/UpdateManagerAction.java;1;0;1;1;0;0;0;1;0;0;1;772;0;0;1;0;0;1;1;772;0;772;1;1;
/org.eclipse.update/src/org/eclipse/update/internal/ui/UMApplicationWindow.java;1;0;1;1;1;1;1;0;0;0;0;6339;0;0;1;0;0;0;1;6339;0;6339;1;1;
/org.eclipse.jdt.core/search/org/eclipse/jdt/internal/core/search/pattern/InternalSearchPattern.java;2;1;12;2;3;3;3;9;268;2;6;3211;622;622;2;3;0;9;12;3211;3;5207;9;2;
/org.eclipse.jdt.core.tests.compiler/src/org/eclipse/jdt/core/tests/compiler/parser/CompletionRecoveryTest.java;2;0;2;1;0;0;0;2;8;1;2;991;10;10;1;0;0;2;2;991;0;3560;2;2;
/org.eclipse.pde.ui/src/org/eclipse/pde/internal/ui/DefaultRuntimeUISupport.java;2;0;2;1;0;0;0;2;0;1;2;2244;0;0;1;0;0;2;2;2244;0;4428;2;2;
/org.eclipse.update.tests.core/src/org/eclipse/update/tests/api/TestPluginContainerAPI.java;1;0;2;1;1;1;1;1;4;0;1;4928;6;6;1;0;0;1;2;4928;0;6336;2;1;
/org.eclipse.jdt.ui/ui/org/eclipse/jdt/ui/actions/ImplementorsSearchGroup.java;3;1;5;1;2;2;2;3;11;1;3;1350;22;22;1;0;0;3;5;1350;0;6340;5;3;
/org.eclipse.team.ui/src/org/eclipse/team/ui/synchronize/viewers/SyncInfoDiffNodeRoot.java;1;0;1;1;0;0;0;1;0;0;1;3972;0;0;1;0;0;1;1;3972;0;3972;1;1;
/org.eclipse.ui.workbench/Eclipse UI/org/eclipse/ui/internal/dialogs/ErrorPreferencePage.java;1;0;1;1;0;0;0;1;0;0;1;3113;0;0;1;0;0;1;1;3113;0;3113;1;1;
/org.eclipse.ui.workbench/Eclipse UI/org/eclipse/ui/internal/dialogs/PathVariableDialog.java;1;0;1;1;0;0;0;1;0;0;1;2737;0;0;1;0;0;1;1;2737;0;2737;1;1;
/org.eclipse.jdt.ui/ui/org/eclipse/jdt/internal/ui/viewsupport/StorageLabelProvider.java;1;0;1;1;1;1;1;0;2;0;0;6340;2;2;1;0;0;0;1;6340;0;6340;1;1;
/org.eclipse.jdt.ui.tests.refactoring/resources/ChangeTypeRefactoring/positive/A_testFieldName_out.java;1;0;1;1;0;0;0;1;0;0;1;2844;0;0;1;0;0;1;1;2844;0;2844;1;1;
/org.eclipse.jdt.ui.tests.refactoring/resources/ExtractMethodWorkSpace/ExtractMethodTests/locals_in/A_test517.java;1;0;1;1;0;0;0;1;5;0;1;844;5;5;1;0;0;1;1;844;0;844;1;1;
/org.eclipse.jdt.ui.examples.javafamily/coresearch-experiment/org/eclipse/search/core/SearchQuery.java;1;0;2;1;0;0;0;2;0;1;2;1380;0;0;1;0;0;2;2;1380;0;3214;2;1;
/org.eclipse.jdt.core/codeassist/org/eclipse/jdt/internal/codeassist/complete/CompletionOnPackageReference.java;2;0;3;1;0;0;0;3;15;1;3;85;19;19;1;0;0;3;3;85;0;3560;3;2;
/org.eclipse.ui.workbench/Eclipse UI/org/eclipse/ui/internal/chris/roles/RoleManagerEvent.java;1;0;4;1;0;0;0;4;8;3;2;1952;8;8;3;2;0;4;4;2202;2;2202;2;1;
/org.eclipse.text/src/org/eclipse/jface/text/FindReplaceDocumentAdapter.java;2;1;13;1;5;5;5;8;36;1;8;2121;111;111;1;0;0;8;13;2121;0;6298;13;2;
/org.eclipse.pde.core/src_OSGi/org/eclipse/pde/internal/core/osgi/bundle/BundlePlugin.java;2;0;9;1;0;0;0;9;469;2;8;2247;868;868;2;1;0;9;9;2295;1;4203;8;2;
/org.eclipse.jdt.core/compiler/org/eclipse/jdt/internal/compiler/codegen/Opcodes.java;1;0;1;1;0;0;0;1;2;0;1;3560;2;2;1;0;0;1;1;3560;0;3560;1;1;
/org.eclipse.core.tests.resources/src/org/eclipse/core/tests/internal/localstore/UnifiedTreeTest.java;2;0;5;1;3;1;3;2;385;1;2;2444;405;405;3;0;2;2;5;5147;2;5147;3;2;
/org.eclipse.core.tests.runtime/src/org/eclipse/core/tests/internal/plugins/PluginVersionTest.java;1;0;1;1;0;0;0;1;0;0;1;3014;0;0;1;0;0;1;1;3014;0;3014;1;1;
/org.eclipse.core.tests.runtime/src/org/eclipse/core/tests/runtime/jobs/IdentityRule.java;2;0;3;1;1;1;1;2;7;1;2;850;10;10;1;0;0;2;3;850;0;5149;3;2;
/org.eclipse.ui.workbench/Eclipse UI/org/eclipse/ui/internal/WorkbenchConfigurationInfo.java;1;0;1;1;0;0;0;1;0;0;1;2737;0;0;1;0;0;1;1;2737;0;2737;1;1;
/org.eclipse.jface/src/org/eclipse/jface/window/Window.java;5;2;11;2;3;2;3;8;108;2;7;2931;326;326;2;1;1;8;11;4110;2;6338;9;5;
/org.eclipse.jdt.ui.tests.refactoring/resources/InlineMethodWorkspace/TestCases/receiver_out/TestExpressionOneImplicitReceiver.java;1;0;1;1;0;0;0;1;2;0;1;845;2;2;1;0;0;1;1;845;0;845;1;1;
/org.eclipse.ui.ide/src/org/eclipse/ui/views/navigator/ToggleLinkingAction.java;1;0;1;1;0;0;0;1;0;0;1;2208;0;0;1;0;0;1;1;2208;0;2208;1;1;
/org.eclipse.update.core/srcnew/org/eclipse/update/internal/operations/IUpdateModelChangedListener.java;1;0;2;1;0;0;0;2;0;1;2;367;0;0;1;0;0;2;2;367;0;757;2;1;
/org.eclipse.ui.workbench/Eclipse UI/org/eclipse/ui/internal/ProductProperties.java;2;1;4;1;4;4;4;0;141;0;0;5485;218;218;1;0;0;0;4;5485;0;6318;4;2;
/org.eclipse.jdt.core/model/org/eclipse/jdt/internal/core/ClassFileWorkingCopy.java;4;1;22;1;2;2;2;20;78;2;17;818;319;319;2;3;0;20;22;818;3;5916;19;4;
/org.eclipse.debug.core/core/org/eclipse/debug/core/variables/ILaunchVariableConstants.java;2;0;4;1;0;0;0;4;8;2;3;737;10;10;2;1;0;4;4;845;1;845;3;2;
/org.eclipse.update.configurator/src/org/eclipse/update/internal/configurator/PlatformConfigurationFactory.java;1;0;2;1;0;0;0;2;11;1;2;3243;11;11;1;0;0;2;2;3243;0;4095;2;1;
/org.eclipse.team.tests.cvs.core/src/org/eclipse/team/tests/ccvs/ui/old/AllTests.java;1;0;2;1;0;0;0;2;0;1;2;2632;0;0;1;0;0;2;2;2632;0;4216;2;1;
/org.eclipse.ui.workbench/Eclipse UI/org/eclipse/ui/internal/PerspectiveHelper.java;5;3;7;2;7;5;7;0;51;0;0;5540;87;87;3;0;2;0;7;6219;2;6338;5;5;
/org.eclipse.jdt.ui.tests.refactoring/resources/ExtractMethodWorkSpace/ExtractMethodTests/expression_in/A_test615.java;1;0;1;1;0;0;0;1;2;0;1;844;2;2;1;0;0;1;1;844;0;844;1;1;
/org.eclipse.jdt.core.tests.compiler/src/org/eclipse/jdt/core/tests/eval/EvaluationSetup.java;2;0;5;1;0;0;0;5;186;1;5;241;202;202;1;0;0;5;5;241;0;3560;5;2;
/org.eclipse.ui.views/src/org/eclipse/ui/views/internal/markers/FieldFolder.java;1;0;2;1;0;0;0;2;0;0;1;749;0;0;2;1;0;2;2;749;1;749;1;1;
/org.eclipse.jdt.ui/ui/org/eclipse/jdt/internal/ui/dialogs/OverrideMethodDialog.java;3;0;8;1;1;1;1;7;16;1;7;582;48;48;1;0;0;7;8;582;0;6340;8;3;
/org.eclipse.jdt.core/search/org/eclipse/jdt/internal/core/search/matching/MethodLocator.java;5;2;20;2;4;3;4;16;47;3;13;1986;223;223;3;3;1;16;20;2000;4;5916;16;5;
/org.eclipse.debug.ui/ui/org/eclipse/debug/internal/ui/sourcelookup/EditSourceLookupPathDialog.java;1;0;4;1;0;0;0;4;6;2;3;3770;8;8;2;1;0;4;4;4949;1;4949;3;1;
/org.eclipse.ui.workbench/Eclipse UI/org/eclipse/ui/internal/contexts/IMutableContextRegistry.java;1;0;3;1;0;0;0;3;3;2;2;1400;3;3;2;1;0;3;3;1417;1;1417;2;1;
/org.eclipse.jdt.ui.tests.refactoring/resources/MoveInnerToTopLevel/test_nonstatic_25/out/Inner.java;1;0;1;1;0;0;0;1;1;0;1;305;1;1;1;0;0;1;1;305;0;305;1;1;
/org.eclipse.jdt.core.tests.model/workspace/Converter/src/test0118/Test.java;1;0;1;1;0;0;0;1;0;0;1;3714;0;0;1;0;0;1;1;3714;0;3714;1;1;
/org.eclipse.team.core/src/org/eclipse/team/core/subscribers/ISyncSetChangedListener.java;1;0;1;1;0;0;0;1;0;0;1;3550;0;0;1;0;0;1;1;3550;0;3550;1;1;
/org.eclipse.core.runtime/src/org/eclipse/core/runtime/IConfigurationElement.java;4;2;8;1;3;2;3;5;387;1;5;2081;425;425;2;0;1;5;8;5117;1;5360;7;4;
/org.eclipse.ui.externaltools/Ant Editor/org/eclipse/ui/externaltools/internal/ant/dtd/schema/AntDTDSchemaMessages.java;1;0;1;1;0;0;0;1;0;0;1;282;0;0;1;0;0;1;1;282;0;282;1;1;
/org.eclipse.team.webdav/src/org/eclipse/team/ui/target/subscriber/ErrorHandler.java;1;0;1;1;0;0;0;1;0;0;1;3379;0;0;1;0;0;1;1;3379;0;3379;1;1;
/org.eclipse.jdt.ui/ui/org/eclipse/jdt/internal/ui/util/ViewSiteDecorator.java;1;0;1;1;0;0;0;1;0;0;1;4575;0;0;1;0;0;1;1;4575;0;4575;1;1;
/org.eclipse.ui.workbench/Eclipse UI/org/eclipse/ui/activities/support/FilterableObject.java;2;0;2;2;0;0;0;2;0;0;1;3061;0;0;2;1;0;2;2;3061;1;3061;1;2;
/org.eclipse.jdt.ui/ui/org/eclipse/jdt/internal/ui/text/CombinedWordRule.java;2;1;2;1;2;2;2;0;2;0;0;5892;2;2;1;0;0;0;2;5892;0;6340;2;2;
/org.eclipse.pde.ui/src/org/eclipse/pde/internal/ui/editor/plugin/ExtensionDetails.java;3;2;11;1;11;8;11;0;27;0;0;5431;75;75;2;0;3;0;11;5514;3;6336;8;3;
/org.eclipse.releng.basebuilder/plugins/org.eclipse.build.tools/src/org/eclipse/releng/BuildProperties.java;1;0;3;1;0;0;0;3;64;2;2;993;64;64;2;1;0;3;3;3593;1;3593;2;1;
/org.eclipse.ui.workbench/Eclipse UI/org/eclipse/ui/commands/old/ICommandHandlerService.java;1;0;2;1;0;0;0;2;0;0;1;1222;0;0;2;1;0;2;2;1222;1;1222;1;1;
/org.eclipse.jdt.core/dom/org/eclipse/jdt/core/dom/ExtendedModifier.java;1;0;3;1;0;0;0;3;63;1;3;4054;63;63;1;0;0;3;3;4054;0;4495;3;1;
/org.eclipse.jdt.core.tests.model/workspace/Converter/test0102/Test.java;1;0;1;1;0;0;0;1;0;0;1;3714;0;0;1;0;0;1;1;3714;0;3714;1;1;
/org.eclipse.jdt.ui/ui/org/eclipse/jdt/internal/ui/callhierarchy/CallHierarchyImageDescriptor.java;4;0;4;1;1;1;1;3;29;1;3;236;55;55;1;0;0;3;4;236;0;6340;4;4;
/org.eclipse.ui.views/src/org/eclipse/ui/views/properties/StandardPropertiesAdapterFactory.java;1;0;1;1;0;0;0;1;0;0;1;2738;0;0;1;0;0;1;1;2738;0;2738;1;1;
/org.eclipse.jdt.debug.ui/ui/org/eclipse/jdt/internal/debug/ui/actions/OpenDeclaringTypeHierarchyAction.java;1;0;1;1;0;0;0;1;3;0;1;2497;3;3;1;0;0;1;1;2497;0;2497;1;1;
/org.eclipse.jface.text/src/org/eclipse/jface/text/source/AnnotationMap.java;1;0;2;1;1;1;1;1;0;0;1;4425;0;0;1;0;0;1;2;4425;0;5382;2;1;
/org.eclipse.team.cvs.ui/src/org/eclipse/team/internal/ccvs/ui/operations/ReplaceOperation.java;2;1;10;1;2;2;2;8;131;2;7;1137;245;245;2;1;0;8;10;3126;1;6337;9;2;
/org.eclipse.jdt.ui/core refactoring/org/eclipse/jdt/internal/corext/refactoring/typeconstraints/ExtractInterfaceConstraintCreator.java;1;0;2;1;0;0;0;2;0;0;1;74;0;0;2;1;0;2;2;74;1;74;1;1;
/org.eclipse.ui.views/src/org/eclipse/ui/views/markers/internal/TableViewLabelProvider.java;2;0;2;1;0;0;0;2;0;1;2;755;0;0;1;0;0;2;2;755;0;2738;2;2;
/org.eclipse.ui.ide/src/org/eclipse/ui/internal/dialogs/ProjectPerspectiveChoiceDialog.java;2;0;3;1;0;0;0;3;18;1;3;1526;18;18;1;0;0;3;3;1526;0;2263;3;2;
/org.eclipse.jdt.ui.tests.refactoring/resources/MoveMembers/test34/out/A.java;1;0;1;1;0;0;0;1;0;0;1;1856;0;0;1;0;0;1;1;1856;0;1856;1;1;
/org.eclipse.jdt.text.tests/src/org/eclipse/jdt/text/tests/comments/SingleLineTestCase.java;1;1;2;1;2;2;2;0;6;0;0;5129;6;6;1;0;0;0;2;5129;0;6340;2;1;
/org.eclipse.pde.core/src/org/eclipse/pde/internal/core/isite/ISiteDescription.java;2;1;3;1;2;2;2;1;4;0;1;4203;10;10;1;0;0;1;3;4203;0;6336;3;2;
/org.eclipse.jdt.ui.tests.refactoring/resources/IntroduceFactory/positive/DifferentArgs.java;1;0;2;1;1;1;1;1;2;0;1;2862;2;2;1;0;0;1;2;2862;0;5659;2;1;
/org.eclipse.ui.workbench/Eclipse UI/org/eclipse/ui/internal/progress/IJobBusyListener.java;1;0;1;1;0;0;0;1;0;0;1;4898;0;0;1;0;0;1;1;4898;0;4898;1;1;
/org.eclipse.jdt.ui/ui/org/eclipse/jdt/internal/ui/wizards/buildpaths/CPUserLibraryElement.java;2;1;5;1;4;4;4;1;82;0;1;4407;91;91;1;0;0;1;5;4407;0;6340;5;2;
/org.eclipse.pde/src/org/eclipse/pde/internal/builders/IMarkerFactory.java;1;0;2;1;1;1;1;1;4;0;1;4203;6;6;1;0;0;1;2;4203;0;6336;2;1;
/org.eclipse.ui.workbench.texteditor/src/org/eclipse/ui/texteditor/RevertToSavedAction.java;1;1;2;1;2;2;2;0;2;0;0;5123;4;4;1;0;0;0;2;5123;0;6340;2;1;
/org.eclipse.jdt.core.tests.compiler/src/org/eclipse/jdt/core/tests/compiler/regression/DeprecatedTest.java;3;0;3;1;0;0;0;3;35;1;3;22;42;42;1;0;0;3;3;22;0;3560;3;3;
/org.eclipse.jdt.ui.tests.refactoring/resources/InlineMethodWorkspace/TestCases/import_out/TestUseInDecl3.java;1;0;2;1;0;0;0;2;2;1;2;788;2;2;1;0;0;2;2;788;0;845;2;1;
/org.eclipse.ui.workbench/Eclipse UI/org/eclipse/ui/internal/commands/api/older/ICommand.java;1;0;3;1;0;0;0;3;2;0;1;2562;2;2;3;2;0;3;3;2562;2;2562;1;1;
/org.eclipse.jdt.core/search/org/eclipse/jdt/internal/core/search/indexing/SourceIndexer.java;6;0;12;1;1;1;1;11;94;1;11;130;131;131;1;0;0;11;12;130;0;5938;12;6;
/org.eclipse.jdt.ui/core refactoring/org/eclipse/jdt/internal/corext/refactoring/reorg/CopyRefactoring.java;4;1;19;1;4;4;4;15;302;1;15;130;458;458;1;0;0;15;19;130;0;6340;19;4;
/org.eclipse.ui.forms/src/org/eclipse/ui/forms/widgets/FormEntry.java;1;0;3;1;0;0;0;3;2;1;3;4068;2;2;1;0;0;3;3;4068;0;4260;3;1;
/org.eclipse.team.ui/src/org/eclipse/team/internal/ui/sync/views/SyncFile.java;1;0;1;1;0;0;0;1;0;0;1;550;0;0;1;0;0;1;1;550;0;550;1;1;
/org.eclipse.jdt.core/model/org/eclipse/jdt/internal/core/jdom/ILineStartFinder.java;1;0;1;1;0;0;0;1;2;0;1;3560;2;2;1;0;0;1;1;3560;0;3560;1;1;
/org.eclipse.ui.workbench/Eclipse UI/org/eclipse/ui/internal/AbstractActionBarConfigurer.java;3;0;3;1;0;0;0;3;123;1;3;2357;215;215;1;0;0;3;3;2357;0;3220;3;3;
/org.eclipse.debug.ui/ui/org/eclipse/debug/ui/launchVariables/IContextLaunchVariable.java;1;0;2;1;0;0;0;2;0;1;2;550;0;0;1;0;0;2;2;550;0;562;2;1;
/org.eclipse.ui.workbench/Eclipse UI/org/eclipse/ui/commands/old/ICommandHandler.java;1;0;2;1;0;0;0;2;0;0;1;1222;0;0;2;1;0;2;2;1222;1;1222;1;1;
/org.eclipse.jdt.ui/ui/org/eclipse/jdt/internal/ui/text/JavaWordFinder.java;1;0;1;1;1;1;1;0;2;0;0;6340;2;2;1;0;0;0;1;6340;0;6340;1;1;
/org.eclipse.osgi/core/framework/org/eclipse/osgi/framework/internal/core/UnresolvedPermissionCollection.java;4;1;4;1;2;2;2;2;141;1;2;3013;150;150;1;0;0;2;4;3013;0;6337;4;4;
/org.eclipse.core.boot/src/org/eclipse/core/internal/boot/ResourceLoader.java;1;0;1;1;0;0;0;1;0;0;1;3013;0;0;1;0;0;1;1;3013;0;3013;1;1;
/org.eclipse.jdt.core/codeassist/org/eclipse/jdt/internal/codeassist/select/SelectionOnArgumentName.java;2;0;2;1;0;0;0;2;34;1;2;991;36;36;1;0;0;2;2;991;0;3560;2;2;
/org.eclipse.team.cvs.ui/src/org/eclipse/team/internal/ccvs/ui/wizards/CheckoutAsWizard.java;2;1;9;1;2;2;2;7;232;2;6;276;371;371;2;1;0;7;9;4869;1;6337;8;2;
/org.eclipse.debug.core/core/org/eclipse/debug/core/variables/ISimpleLaunchVariableRegistry.java;1;0;2;1;0;0;0;2;0;1;2;618;0;0;1;0;0;2;2;618;0;754;2;1;
/org.eclipse.jdt.debug.ui/ui/org/eclipse/jdt/internal/debug/ui/TerminateErrorDialog.java;2;0;3;2;0;0;0;3;22;2;2;1857;22;22;2;1;0;3;3;1857;1;2064;2;2;
/org.eclipse.ui.views/src/org/eclipse/ui/views/internal/markers/Folder.java;1;0;2;1;0;0;0;2;0;1;2;265;0;0;1;0;0;2;2;265;0;749;2;1;
/org.eclipse.ui.workbench.texteditor/src/org/eclipse/ui/texteditor/CaseAction.java;2;1;6;1;4;4;4;2;29;1;2;436;64;64;1;0;0;2;6;436;0;6340;6;2;
/org.eclipse.ui.cheatsheets/src/org/eclipse/ui/internal/cheatsheets/views/Button.java;2;0;3;1;0;0;0;3;17;1;3;4428;17;17;1;0;0;3;3;4428;0;4701;3;2;
/org.eclipse.jdt.debug/model/org/eclipse/jdt/debug/core/IJavaReferenceType.java;1;0;2;1;0;0;0;2;35;1;2;2176;35;35;1;0;0;2;2;2176;0;2269;2;1;
/org.eclipse.jdt.core.tests.model/workspace/Converter/src/test0411/A.java;1;0;1;1;0;0;0;1;0;0;1;3714;0;0;1;0;0;1;1;3714;0;3714;1;1;
/org.eclipse.jdt.core/compiler/org/eclipse/jdt/internal/compiler/lookup/SourceTypeBinding.java;3;0;10;1;1;1;1;9;140;1;9;25;212;212;1;0;0;9;10;25;0;5871;10;3;
/org.eclipse.jdt.debug.tests/tests/org/eclipse/jdt/debug/tests/eval/NestedTypeFieldValue_592.java;1;0;1;1;0;0;0;1;60;0;1;1274;60;60;1;0;0;1;1;1274;0;1274;1;1;
/org.eclipse.ui.workbench/Eclipse UI/org/eclipse/ui/IActiveContextService.java;1;0;2;1;0;0;0;2;0;1;2;618;0;0;1;0;0;2;2;618;0;689;2;1;
/org.eclipse.debug.ui/ui/org/eclipse/debug/ui/actions/ToggleMethodBreakpointActionDelegate.java;1;0;2;1;1;1;1;1;3;0;1;4496;3;3;1;0;0;1;2;4496;0;5134;2;1;
/org.eclipse.ui.ide/src/org/eclipse/ui/views/markers/TaskView.java;3;0;5;1;0;0;0;5;109;2;4;2208;147;147;2;1;0;5;5;3260;1;3939;4;3;
/org.eclipse.pde.ui/src/org/eclipse/pde/internal/ui/search/DependencyExtentSearchOperation.java;2;1;3;1;2;2;2;1;14;0;1;2950;30;30;1;0;0;1;3;2950;0;6336;3;2;
/org.eclipse.team.ui/src/org/eclipse/team/ui/synchronize/SynchronizePageActionGroup.java;2;1;4;1;3;3;3;1;200;0;1;5093;460;460;1;0;0;1;4;5093;0;6305;4;2;
/org.eclipse.jdt.ui.tests.refactoring/resources/MoveInnerToTopLevel/test_nonstatic_4/out/Inner.java;2;0;2;1;1;1;1;1;2;0;1;305;4;4;1;0;0;1;2;305;0;5854;2;2;
/org.eclipse.update.core/src/org/eclipse/update/core/IVerificationListener.java;1;1;2;1;2;2;2;0;6;0;0;5423;10;10;1;0;0;0;2;5423;0;6336;2;1;
/org.eclipse.pde.core/srcnew/org/eclipse/pde/internal/core/plugin/XMLDocumentModelBuilder.java;2;0;3;1;0;0;0;3;25;1;3;368;29;29;1;0;0;3;3;368;0;2906;3;2;
/org.eclipse.swt/Eclipse SWT PI/win32/org/eclipse/swt/internal/win32/LOGFONT.java;1;0;1;1;0;0;0;1;14;0;1;957;14;14;1;0;0;1;1;957;0;957;1;1;
/org.eclipse.team.webdav/src/org/eclipse/team/internal/ui/target/GetAsAction.java;2;0;2;1;0;0;0;2;0;1;2;2495;0;0;1;0;0;2;2;2495;0;4216;2;2;
/org.eclipse.jdt.ui/ui/org/eclipse/jdt/internal/ui/javaeditor/OverrideIndicatorImageProvider.java;1;1;3;1;2;2;2;1;8;0;1;4940;10;10;1;0;0;1;3;4940;0;6340;3;1;
/org.eclipse.jdt.ui.tests.refactoring/resources/ChangeTypeRefactoring/positive/A_testParameterDeclWithOverride_in.java;1;0;1;1;0;0;0;1;0;0;1;2844;0;0;1;0;0;1;1;2844;0;2844;1;1;
/org.eclipse.jdt.core/model/org/eclipse/jdt/core/util/IEnclosingMethodAttribute.java;2;0;2;1;0;0;0;2;77;1;2;3791;77;77;1;0;0;2;2;3791;0;4843;2;2;
/org.eclipse.jdt.core/model/org/eclipse/jdt/internal/core/util/AstNodeFinder.java;3;0;5;1;0;0;0;5;36;1;5;1872;54;54;1;0;0;5;5;1872;0;2974;5;3;
/org.eclipse.pde.ui/src/org/eclipse/pde/internal/ui/editor/build/VariableSection.java;2;0;3;1;0;0;0;3;3;1;3;648;5;5;1;0;0;3;3;648;0;1727;3;2;
/org.eclipse.jdt.debug.ui/ui/org/eclipse/jdt/internal/debug/ui/snippeteditor/SnippetOpenHierarchyOnSelectionAction.java;1;0;1;1;0;0;0;1;3;0;1;1240;3;3;1;0;0;1;1;1240;0;1240;1;1;
/org.eclipse.team.core/src/org/eclipse/team/core/subscribers/helpers/SyncBytesSubscriberResourceTree.java;1;0;1;1;0;0;0;1;0;0;1;3240;0;0;1;0;0;1;1;3240;0;3240;1;1;
/org.eclipse.jdt.ui/ui/org/eclipse/jdt/internal/ui/viewsupport/LibraryFilter.java;2;0;2;1;1;1;1;1;2;0;1;4847;3;3;1;0;0;1;2;4847;0;6340;2;2;
/org.eclipse.jdt.ui.tests.refactoring/resources/RenamePackage/testImportFromMultiRoots2/out/srcTest/p/p/ATest.java;1;0;2;1;0;0;0;2;12;1;2;3219;12;12;1;0;0;2;2;3219;0;4105;2;1;
/org.eclipse.jdt.core.tests.compiler/src/org/eclipse/jdt/core/tests/compiler/regression/SwitchTest.java;2;0;3;1;0;0;0;3;30;1;3;1785;32;32;1;0;0;3;3;1785;0;2389;3;2;
/org.eclipse.ui.workbench.texteditor/src/org/eclipse/ui/texteditor/AddMarkerAction.java;3;0;3;1;0;0;0;3;19;1;3;1805;25;25;1;0;0;3;3;1805;0;2741;3;3;
/org.eclipse.jdt.core.tests.model/workspace/Formatter/test431/A_out.java;1;0;1;1;0;0;0;1;0;0;1;3479;0;0;1;0;0;1;1;3479;0;3479;1;1;
/org.eclipse.ui.workbench/Eclipse UI/org/eclipse/ui/internal/dialogs/ProductInfoDialog.java;2;1;3;1;2;2;2;1;36;0;1;2737;38;38;1;0;0;1;3;2737;0;6338;3;2;
/org.eclipse.jdt.core/model/org/eclipse/jdt/internal/core/CompilationUnitElementInfo.java;1;0;3;1;0;0;0;3;10;1;3;818;15;15;1;0;0;3;3;818;0;3560;3;1;
/org.eclipse.pde.ui/src/org/eclipse/pde/ui/ClasspathUtil.java;2;0;5;2;0;0;0;5;12;2;4;3008;23;23;2;1;0;5;5;3045;1;3986;4;2;
/org.eclipse.jdt.ui.tests.refactoring/resources/ExtractMethodWorkSpace/ExtractMethodTests/locals_out/A_test551.java;1;0;1;1;0;0;0;1;4;0;1;844;4;4;1;0;0;1;1;844;0;844;1;1;
/org.eclipse.swt.tests/JUnit Tests/org/eclipse/swt/tests/junit/Test_org_eclipse_swt_widgets_Synchronizer.java;1;0;1;1;0;0;0;1;13;0;1;2123;13;13;1;0;0;1;1;2123;0;2123;1;1;
/org.eclipse.search/new search/org/eclipse/search/ui/ISearchResult.java;3;1;9;1;4;4;4;5;57;2;4;3474;191;191;2;1;0;5;9;4841;1;6340;8;3;
/org.eclipse.debug.core/core/org/eclipse/debug/core/model/IWatchExpressionListener.java;1;0;3;1;0;0;0;3;13;2;2;1516;13;13;2;1;0;3;3;1538;1;1538;2;1;
/org.eclipse.jdt.ui.tests.refactoring/resources/Delete/testDeleteWithinCu17/out/A.java;1;0;1;1;0;0;0;1;0;0;1;442;0;0;1;0;0;1;1;442;0;442;1;1;
/org.eclipse.update.core/src/org/eclipse/update/internal/core/Policy.java;1;0;1;1;0;0;0;1;10;0;1;890;10;10;1;0;0;1;1;890;0;890;1;1;
/org.eclipse.core.tests.runtime/src/org/eclipse/core/tests/runtime/jobs/CustomTestJob.java;2;0;4;1;1;1;1;3;11;1;3;2160;15;15;1;0;0;3;4;2160;0;5149;4;2;
/org.eclipse.ui.workbench/Eclipse UI/org/eclipse/ui/internal/model/WorkbenchRootResource.java;1;0;1;1;0;0;0;1;0;0;1;2737;0;0;1;0;0;1;1;2737;0;2737;1;1;
/org.eclipse.jdt.ui.tests/examples/org/eclipse/jdt/ui/examples/ASTNodeConstantsGenerator.java;1;0;2;1;1;1;1;1;0;0;1;3830;0;0;1;0;0;1;2;3830;0;5422;2;1;
/org.eclipse.help.ide/src/org/eclipse/help/ui/internal/search/HelpSearchPage.java;1;1;11;1;2;2;2;9;313;4;6;1738;523;523;4;3;0;9;11;1738;3;5590;8;1;
/org.eclipse.jdt.core.tests.model/workspace/Converter/src/test0435/A.java;1;0;1;1;0;0;0;1;0;0;1;3714;0;0;1;0;0;1;1;3714;0;3714;1;1;
/org.eclipse.ui.editors/src/org/eclipse/ui/internal/editors/text/FileEditorInputAdapterFactory.java;2;0;5;1;1;1;1;4;22;1;4;2224;55;55;1;0;0;4;5;2224;0;6340;5;2;
/org.eclipse.jdt.core.tests.model/workspace/Converter/src/javadoc/test104/TestD2.java;1;0;1;1;0;0;0;1;0;0;1;4390;0;0;1;0;0;1;1;4390;0;4390;1;1;
/org.eclipse.update.ui.forms/Eclipse Forms/org/eclipse/ui/forms/parts/TableData.java;1;0;2;1;0;0;0;2;0;1;2;3096;0;0;1;0;0;2;2;3096;0;3116;2;1;
/org.eclipse.jdt.ui.tests.refactoring/resources/ExtractMethodWorkSpace/ExtractMethodTests/expression_out/A_test611.java;1;0;3;1;0;0;0;3;4;1;3;844;4;4;1;0;0;3;3;844;0;1474;3;1;
/org.eclipse.ui.ide/src/org/eclipse/ui/wizards/datatransfer/WizardFileSystemExportPage1.java;1;0;1;1;0;0;0;1;0;0;1;1511;0;0;1;0;0;1;1;1511;0;1511;1;1;
/org.eclipse.jface/src/org/eclipse/jface/wizard/IWizardContainer.java;2;0;2;1;1;1;1;1;2;0;1;5087;4;4;1;0;0;1;2;5087;0;6338;2;2;
/org.eclipse.swt.graphics.text/org.eclipse.swt/Eclipse SWT PI/gtk/org/eclipse/swt/internal/gtk/PangoGlyphItem.java;1;0;1;1;0;0;0;1;0;0;1;2267;0;0;1;0;0;1;1;2267;0;2267;1;1;
/org.eclipse.swt.opengl.examples/src/org/eclipse/swt/opengl/examples/ReflectionTab.java;1;0;1;1;0;0;0;1;0;0;1;1175;0;0;1;0;0;1;1;1175;0;1175;1;1;
/org.eclipse.pde.ui/src_Forms/org/eclipse/pde/internal/ui/neweditor/feature/PortabilitySection.java;2;0;2;1;1;1;1;1;0;0;1;4926;0;0;1;0;0;1;2;4926;0;5431;2;2;
/org.eclipse.jdt.core.tests.model/workspace/Converter/src/test0198/Test.java;1;0;1;1;0;0;0;1;0;0;1;3714;0;0;1;0;0;1;1;3714;0;3714;1;1;
/org.eclipse.jdt.ui.tests.refactoring/resources/ExtractMethodWorkSpace/ExtractMethodTests/locals_in/A_test568.java;1;0;1;1;0;0;0;1;4;0;1;844;4;4;1;0;0;1;1;844;0;844;1;1;
/org.eclipse.ui.forms/src/org/eclipse/ui/forms/widgets/ScrolledPageBook.java;1;1;6;1;2;2;2;4;172;1;4;4068;195;195;1;0;0;4;6;4068;0;5736;6;1;
/org.eclipse.debug.ui/ui/org/eclipse/debug/internal/ui/views/console/ConsoleDocumentPartitioner.java;4;1;16;2;2;2;2;14;82;3;10;1317;289;289;3;4;0;14;16;2100;4;6336;12;4;
/org.eclipse.jdt.ui.tests.refactoring/test cases/org/eclipse/jdt/ui/tests/nls/NlsRefactoringCreateChangeTest.java;4;2;12;1;10;9;10;2;343;1;2;4930;846;846;2;0;1;2;12;5375;1;6340;11;4;
/org.eclipse.osgi.tests/src/org/eclipse/osgi/tests/services/resolver/StateResolverTest.java;1;0;1;1;1;1;1;0;0;0;0;5993;0;0;1;0;0;0;1;5993;0;5993;1;1;
/org.eclipse.pde.ui/src/org/eclipse/pde/internal/ui/editor/PDEDetails.java;3;1;4;1;4;4;4;0;10;0;0;5517;17;17;1;0;0;0;4;5517;0;6336;4;3;
/org.eclipse.ui.workbench/Eclipse UI/org/eclipse/ui/internal/WWinActionBars.java;2;0;2;1;0;0;0;2;27;1;2;830;34;34;1;0;0;2;2;830;0;3220;2;2;
/org.eclipse.jdt.ui.tests.refactoring/resources/ChangeSignature/canModify/A_testAll42_out.java;1;0;1;1;0;0;0;1;2;0;1;2093;2;2;1;0;0;1;1;2093;0;2093;1;1;
/org.eclipse.pde.core/src_OSGi/org/eclipse/pde/core/osgi/bundle/IBundleFragment.java;2;0;2;1;0;0;0;2;0;1;2;2485;0;0;1;0;0;2;2;2485;0;4203;2;2;
/org.eclipse.ui.forms/src/org/eclipse/ui/forms/WizardForm.java;1;0;3;1;0;0;0;3;23;1;3;4354;23;23;1;0;0;3;3;4354;0;5044;3;1;
/org.eclipse.jdt.ui.tests.refactoring/resources/DeleteSourceReferenceEdit/A_test3_out.java;1;0;1;1;0;0;0;1;0;0;1;1652;0;0;1;0;0;1;1;1652;0;1652;1;1;
/org.eclipse.swt/Eclipse SWT/carbon/org/eclipse/swt/widgets/ColorDialog.java;1;1;2;1;2;2;2;0;4;0;0;5606;8;8;1;0;0;0;2;5606;0;6352;2;1;
/org.eclipse.pde.ui/src/org/eclipse/pde/internal/ui/wizards/tools/MigrationAction.java;1;1;4;1;2;2;2;2;10;1;2;3840;24;24;1;0;0;2;4;3840;0;6336;4;1;
/org.eclipse.jdt.ui/ui/org/eclipse/jdt/internal/ui/viewsupport/ProblemTreeViewer.java;3;1;7;2;3;3;3;4;110;2;3;1386;148;148;2;1;0;4;7;3961;1;6340;6;3;
/org.eclipse.jdt.ui/ui/org/eclipse/jdt/internal/ui/javaeditor/AddClassFileMarkerAction.java;1;0;1;1;1;1;1;0;2;0;0;6340;2;2;1;0;0;0;1;6340;0;6340;1;1;
/org.eclipse.osgi/core/framework/org/eclipse/osgi/framework/internal/protocol/URLStreamHandlerSetter.java;4;0;4;1;1;1;1;3;37;1;3;3013;42;42;1;0;0;3;4;3013;0;6337;4;4;
/org.eclipse.ui.ide/src/org/eclipse/ui/internal/dialogs/NewWizard.java;2;0;6;1;0;0;0;6;8;1;6;1526;25;25;1;0;0;6;6;1526;0;2263;6;2;
/org.eclipse.ui.workbench/Eclipse UI/org/eclipse/ui/internal/commands/CommandElement.java;1;0;3;1;0;0;0;3;12;1;3;1222;12;12;1;0;0;3;3;1222;0;1321;3;1;
/org.eclipse.help.base/src/org/eclipse/help/internal/workingset/IHelpWorkingSetManager.java;1;1;3;1;2;2;2;1;17;0;1;1740;23;23;1;0;0;1;3;1740;0;6337;3;1;
/org.eclipse.jdt.core.tests.model/workspace/Formatter/test011/A_out.java;1;0;1;1;0;0;0;1;0;0;1;2425;0;0;1;0;0;1;1;2425;0;2425;1;1;
/org.eclipse.pde.ui/src_Forms/org/eclipse/pde/internal/ui/neweditor/feature/FeatureOutlinePage.java;2;1;4;1;2;2;2;2;101;0;1;4926;109;109;2;1;0;2;4;4926;1;5431;3;2;
/org.eclipse.core.resources/src/org/eclipse/core/internal/watson/ElementTreeIterator.java;1;0;1;1;1;1;1;0;37;0;0;5146;37;37;1;0;0;0;1;5146;0;5146;1;1;
/org.eclipse.osgi/core/framework/org/eclipse/osgi/framework/internal/core/ManifestLocalization.java;5;2;15;1;10;9;10;5;129;1;5;4050;308;308;2;0;1;5;15;5116;1;5800;14;5;
/org.eclipse.core.runtime.osgi/src/org/eclipse/core/runtime/ILogListener.java;1;0;2;1;0;0;0;2;16;1;2;3013;16;16;1;0;0;2;2;3013;0;3030;2;1;
/org.eclipse.help.tests/src/org/eclipse/help/tests/standalone/AllHelpStandaloneTests.java;1;1;3;1;2;2;2;1;16;0;1;882;33;33;1;0;0;1;3;882;0;6337;3;1;
/org.eclipse.pde.ui/sandbox/org/eclipse/pde/internal/ui/editor/standalone/extensions/ExtensionsSourceEditor.java;1;0;2;1;0;0;0;2;0;1;2;2320;0;0;1;0;0;2;2;2320;0;2906;2;1;
/org.eclipse.jdt.ui.tests.refactoring/resources/MoveMembers/test7/out/B.java;1;0;1;1;0;0;0;1;1;0;1;1522;1;1;1;0;0;1;1;1522;0;1522;1;1;
/org.eclipse.ui.workbench/Eclipse UI/org/eclipse/ui/internal/roles/ActivityManagerEvent.java;2;0;3;1;0;0;0;3;13;1;3;2060;13;13;1;0;0;3;3;2060;0;2443;3;2;
/org.eclipse.osgi/osgi/src/org/eclipse/osgi/service/resolver/StateChangeListener.java;3;1;3;1;2;2;2;1;4;0;1;3013;6;6;1;0;0;1;3;3013;0;6337;3;3;
/org.eclipse.ui.workbench/Eclipse UI/org/eclipse/ui/gestures/Gesture.java;1;0;2;1;0;0;0;2;0;1;2;1294;0;0;1;0;0;2;2;1294;0;1321;2;1;
/org.eclipse.jdt.ui.examples.javafamily/coresearch-experiment/org/eclipse/search/core/SearchQueryRequestor.java;1;0;2;1;0;0;0;2;0;1;2;1380;0;0;1;0;0;2;2;1380;0;3214;2;1;
/org.eclipse.swt.tests/JUnit Tests/org/eclipse/swt/tests/junit/Test_org_eclipse_swt_widgets_DirectoryDialog.java;2;0;3;1;0;0;0;3;41;2;2;2123;51;51;2;1;0;3;3;2824;1;2824;2;2;
/org.eclipse.jdt.ui/ui/org/eclipse/jdt/internal/ui/filters/FieldsFilter.java;1;0;2;1;1;1;1;1;2;0;1;2273;2;2;1;0;0;1;2;2273;0;6340;2;1;
/org.eclipse.ant.ui/Ant Tools Support/org/eclipse/ant/ui/internal/launchConfigurations/AntRunActionDelegate.java;2;0;4;1;0;0;0;4;10;1;4;250;12;12;1;0;0;4;4;250;0;1811;4;2;
/org.eclipse.team.cvs.core/src/org/eclipse/team/internal/ccvs/core/client/listeners/ServerMessageLineMatcher.java;1;0;2;1;0;0;0;2;99;1;2;2478;99;99;1;0;0;2;2;2478;0;2529;2;1;
/org.eclipse.ui.forms/src/org/eclipse/ui/internal/forms/FormWizardDialog.java;1;0;2;1;1;1;1;1;4;0;1;5044;4;4;1;0;0;1;2;5044;0;6336;2;1;
/org.eclipse.ant.tests.ui/test plugin/org/eclipse/ant/tests/ui/testplugin/ProjectCreationDecorator.java;3;0;21;2;1;1;1;20;132;2;15;1388;373;373;2;5;0;20;21;1610;5;6336;16;3;
/org.eclipse.ant.ui/Ant Editor/org/eclipse/ant/ui/internal/editor/derived/SingleCharReader.java;1;0;2;1;0;0;0;2;0;1;2;250;0;0;1;0;0;2;2;250;0;1811;2;1;
/org.eclipse.ui.workbench/Eclipse UI/org/eclipse/ui/commands/registry/ICommandRegistryEvent.java;1;0;2;1;0;0;0;2;0;1;2;1400;0;0;1;0;0;2;2;1400;0;1417;2;1;
/org.eclipse.core.resources/src/org/eclipse/core/internal/localstore/RefreshLocalVisitor.java;3;1;3;1;2;2;2;1;487;0;1;2124;493;493;1;0;0;1;3;2124;0;5733;3;3;
/org.eclipse.pde.ui/src/org/eclipse/pde/internal/ui/editor/manifest/ManifestTemplatePage.java;1;0;1;1;1;1;1;0;0;0;0;5431;0;0;1;0;0;0;1;5431;0;5431;1;1;
/org.eclipse.ui.workbench/Eclipse UI/org/eclipse/ui/internal/dnd/DragUtil.java;3;0;11;1;1;1;1;10;265;2;9;3677;486;486;2;1;0;10;11;4807;1;5111;10;3;
/org.eclipse.ui.workbench/Eclipse UI/org/eclipse/ui/internal/IDEWorkbenchWindow.java;1;0;1;1;0;0;0;1;0;0;1;2728;0;0;1;0;0;1;1;2728;0;2728;1;1;
/org.eclipse.jdt.ui/core extension/org/eclipse/jdt/internal/corext/template/java/CompilationUnitContext.java;4;1;6;1;2;2;2;4;27;1;4;2308;46;46;1;0;0;4;6;2308;0;6340;6;4;
/org.eclipse.pde.ui/src/org/eclipse/pde/internal/ui/wizards/templates/ControlStack.java;2;1;2;1;2;2;2;0;6;0;0;5785;12;12;1;0;0;0;2;5785;0;6336;2;2;
/org.eclipse.ltk.ui.refactoring/src/org/eclipse/ltk/internal/ui/refactoring/ExceptionHandler.java;1;0;3;1;1;1;1;2;3;1;2;4965;5;5;1;0;0;2;3;4965;0;6340;3;1;
/org.eclipse.ui.workbench/Eclipse UI/org/eclipse/ui/internal/OverlayIcon.java;3;1;3;1;3;3;3;0;23;0;0;5996;25;25;1;0;0;0;3;5996;0;6338;3;3;
/org.eclipse.jdt.core.tests.model/workspace/Converter/test0005/Test.java;1;0;1;1;0;0;0;1;0;0;1;3714;0;0;1;0;0;1;1;3714;0;3714;1;1;
/org.eclipse.update.core/src/org/eclipse/update/core/model/InstallHandlerEntryModel.java;2;1;3;1;2;2;2;1;6;0;1;890;13;13;1;0;0;1;3;890;0;6336;3;2;
/org.eclipse.jdt.ui/ui/org/eclipse/jdt/internal/ui/javaeditor/OverrideIndicatorManager.java;2;1;13;2;8;8;8;5;154;2;3;4940;384;384;2;2;0;5;13;4940;2;6340;11;2;
/org.eclipse.jdt.core/search/org/eclipse/jdt/internal/core/index/impl/Util.java;2;0;2;1;0;0;0;2;1;1;2;1308;1;1;1;0;0;2;2;1308;0;3194;2;2;
/org.eclipse.jdt.ui.tests/ui/org/eclipse/jdt/ui/tests/packageview/ContentProviderTests4.java;2;1;2;1;2;2;2;0;3;0;0;5422;5;5;1;0;0;0;2;5422;0;6340;2;2;
/org.eclipse.jdt.core/model/org/eclipse/jdt/core/util/IRuntimeInvisibleAnnotationsAttribute.java;2;0;2;1;0;0;0;2;36;1;2;4466;36;36;1;0;0;2;2;4466;0;4843;2;2;
/org.eclipse.jdt.ui/core refactoring/org/eclipse/jdt/internal/corext/refactoring/participants/xml/VariablePool.java;1;0;3;1;0;0;0;3;23;1;3;2682;23;23;1;0;0;3;3;2682;0;4091;3;1;
/org.eclipse.update.ui/src/org/eclipse/update/internal/ui/forms/PreserveSection.java;1;0;1;1;0;0;0;1;0;0;1;755;0;0;1;0;0;1;1;755;0;755;1;1;
/org.eclipse.jdt.ui/core extension/org/eclipse/jdt/internal/corext/dom/ASTRewriteFormatter.java;1;0;20;1;1;1;1;19;161;2;18;1558;563;563;2;1;0;19;20;1803;1;5406;19;1;
/org.eclipse.team.cvs.ui/src/org/eclipse/team/internal/ccvs/ui/wizards/CheckoutIntoWizard.java;1;0;1;1;0;0;0;1;0;0;1;851;0;0;1;0;0;1;1;851;0;851;1;1;
/org.eclipse.update.ui/src/org/eclipse/update/internal/ui/pages/CategoryPage.java;1;0;1;1;0;0;0;1;0;0;1;755;0;0;1;0;0;1;1;755;0;755;1;1;
/org.eclipse.team.cvs.ui/src/org/eclipse/team/internal/ccvs/ui/RemoteFileStorage.java;1;0;1;1;1;1;1;0;0;0;0;5683;0;0;1;0;0;0;1;5683;0;5683;1;1;
/org.eclipse.jdt.core.tests.model/workspace/Formatter/test247/A_out.java;1;0;1;1;0;0;0;1;0;0;1;2442;0;0;1;0;0;1;1;2442;0;2442;1;1;
/org.eclipse.jdt.core.tests.model/workspace/Converter/src/test0293/Test.java;1;0;1;1;0;0;0;1;0;0;1;3714;0;0;1;0;0;1;1;3714;0;3714;1;1;
/org.eclipse.jface.text/src/org/eclipse/jface/internal/text/link/contentassist/SubstitutionTextReader.java;2;0;2;1;1;1;1;1;2;0;1;4214;2;2;1;0;0;1;2;4214;0;6340;2;2;
/org.eclipse.team.ui/src/org/eclipse/team/ui/synchronize/subscribers/ISubscriberPageConfiguration.java;1;0;1;1;0;0;0;1;0;0;1;5048;0;0;1;0;0;1;1;5048;0;5048;1;1;
/org.eclipse.osgi/eclipseAdaptor/src/org/eclipse/core/runtime/adaptor/URLConverterImpl.java;3;1;6;1;2;2;2;4;17;1;4;3620;38;38;1;0;0;4;6;3620;0;6133;6;3;
/org.eclipse.ui.workbench/Eclipse UI/org/eclipse/ui/internal/roles/ActivityDeltaCalculator.java;2;0;3;1;0;0;0;3;33;1;3;2060;33;33;1;0;0;3;3;2060;0;2443;3;2;
/org.eclipse.jdt.core.tests.model/workspace/Converter/test0401/A.java;1;0;1;1;0;0;0;1;0;0;1;3714;0;0;1;0;0;1;1;3714;0;3714;1;1;
/org.eclipse.jdt.core/compiler/org/eclipse/jdt/internal/compiler/ast/JavadocImportReference.java;1;0;1;1;1;1;1;0;0;0;0;5713;0;0;1;0;0;0;1;5713;0;5713;1;1;
/org.eclipse.jdt.core.tests.model/workspace/Converter/src/test0065/Test.java;1;0;1;1;0;0;0;1;0;0;1;3714;0;0;1;0;0;1;1;3714;0;3714;1;1;
/org.eclipse.jdt.core.tests.model/workspace/Completion/src/z1/z2/qla0/Qla4.java;1;0;1;1;0;0;0;1;0;0;1;3253;0;0;1;0;0;1;1;3253;0;3253;1;1;
/org.eclipse.jdt.core.tests.model/workspace/Converter/test0161/Test.java;1;0;1;1;0;0;0;1;0;0;1;3714;0;0;1;0;0;1;1;3714;0;3714;1;1;
/org.eclipse.jdt.core.tests.model/workspace/Formatter/test413/A_out.java;1;0;1;1;0;0;0;1;0;0;1;3460;0;0;1;0;0;1;1;3460;0;3460;1;1;
/org.eclipse.help/src/org/eclipse/help/internal/search/AnalyzerDescriptor.java;1;0;2;1;0;0;0;2;6;1;2;1160;6;6;1;0;0;2;2;1160;0;2732;2;1;
/org.eclipse.ui.workbench/Eclipse UI/org/eclipse/ui/internal/CyclePerspectiveAction.java;1;0;1;1;0;0;0;1;60;0;1;2737;60;60;1;0;0;1;1;2737;0;2737;1;1;
/org.eclipse.ant.tests.ui/EclipseCon/org/eclipse/ant/internal/ui/demo/AntBuildfileImportWizard.java;1;0;3;1;0;0;0;3;2;2;2;3750;2;2;2;1;0;3;3;3750;1;4809;2;1;
/org.eclipse.help.ui/src/org/eclipse/help/ui/internal/util/ErrorUtil.java;1;1;4;1;3;3;3;1;28;0;1;2732;64;64;1;0;0;1;4;2732;0;6337;4;1;
/org.eclipse.pde.core/srcnew/org/eclipse/pde/internal/core/plugin/DocumentModel.java;2;0;6;1;1;1;1;5;250;1;5;2633;377;377;1;0;0;5;6;2633;0;5431;6;2;
/org.eclipse.team.cvs.core/src/org/eclipse/team/internal/ccvs/core/resources/RemoteFile.java;2;0;20;1;1;1;1;19;368;2;18;790;964;964;2;1;0;19;20;2406;1;6337;19;2;
/org.eclipse.pde.core/src/org/eclipse/pde/core/plugin/IFragment.java;3;1;6;1;4;4;4;2;60;1;2;4203;80;80;1;0;0;2;6;4203;0;6336;6;3;
/org.eclipse.swt/Eclipse SWT PI/gtk1x/org/eclipse/swt/internal/gtk/GtkItem.java;1;0;1;1;0;0;0;1;0;0;1;2327;0;0;1;0;0;1;1;2327;0;2327;1;1;
/org.eclipse.pde.ui/src/org/eclipse/pde/internal/ui/editor/plugin/ManifestOutlinePage.java;2;2;3;2;3;2;3;0;18;0;0;5431;28;28;2;0;1;0;3;5431;1;6336;2;2;
/org.eclipse.help.webapp/src_servlets/org/eclipse/help/internal/webapp/data/ToolbarButton.java;1;1;5;1;4;4;4;1;37;0;1;5043;55;55;1;0;0;1;5;5043;0;6337;5;1;
/org.eclipse.jdt.core.tests.model/src/org/eclipse/jdt/core/tests/dom/BindingsCollectorVisitor.java;3;0;5;1;1;1;1;4;194;1;4;3560;257;257;1;0;0;4;5;3560;0;5273;5;3;
/org.eclipse.core.resources/src/org/eclipse/core/internal/refresh/InternalRefreshProvider.java;1;0;1;1;1;1;1;0;0;0;0;5275;0;0;1;0;0;0;1;5275;0;5275;1;1;
/org.eclipse.ui.workbench/Eclipse UI/org/eclipse/ui/internal/roles/IDERoleManager.java;2;0;6;1;0;0;0;6;152;2;4;2061;205;205;2;2;0;6;6;2078;2;2443;4;2;
/org.eclipse.debug.ui/ui/org/eclipse/debug/internal/ui/views/variables/IndexedVariablePartition.java;2;0;2;1;0;0;0;2;10;1;2;2564;10;10;1;0;0;2;2;2564;0;2594;2;2;
/org.eclipse.swt/Eclipse SWT/gtk1x/org/eclipse/swt/widgets/UtilFuncs.java;1;0;1;1;0;0;0;1;0;0;1;2327;0;0;1;0;0;1;1;2327;0;2327;1;1;
/org.eclipse.pde.core/src/org/eclipse/pde/internal/core/ischema/ISchemaObject.java;2;1;3;1;2;2;2;1;4;0;1;4203;12;12;1;0;0;1;3;4203;0;6336;3;2;
/org.eclipse.debug.ui/ui/org/eclipse/debug/ui/variables/ExternalToolVariableRegistry.java;1;0;3;1;0;0;0;3;158;0;1;316;158;158;3;2;0;3;3;316;2;316;1;1;
/org.eclipse.ui.ide/src/org/eclipse/ui/actions/NewWizardAction.java;2;0;6;1;0;0;0;6;53;1;6;1511;74;74;1;0;0;6;6;1511;0;2263;6;2;
/org.eclipse.ant.ui/Ant Tools Support/org/eclipse/ant/internal/ui/views/AntProjectContentProvider.java;2;0;5;1;1;1;1;4;34;1;4;1811;57;57;1;0;0;4;5;1811;0;6336;5;2;
/org.eclipse.update.core/src/org/eclipse/update/core/InstalledSite.java;1;0;1;1;0;0;0;1;0;0;1;2634;0;0;1;0;0;1;1;2634;0;2634;1;1;
/org.eclipse.update.ui.forms/Eclipse Forms/org/eclipse/ui/forms/internal/parts/TextSegment.java;1;0;3;1;0;0;0;3;8;2;2;3096;8;8;2;1;0;3;3;3137;1;3137;2;1;
/org.eclipse.ui.workbench/Eclipse UI/org/eclipse/ui/commands/GestureSequence.java;1;0;3;1;0;0;0;3;110;2;2;1321;110;110;2;1;0;3;3;1339;1;1339;2;1;
/org.eclipse.search/search/org/eclipse/search/internal/ui/text/PathSorter.java;1;0;1;1;0;0;0;1;0;0;1;3711;0;0;1;0;0;1;1;3711;0;3711;1;1;
/org.eclipse.jface/src/org/eclipse/jface/viewers/IDelayedLabelDecorator.java;1;0;2;1;1;1;1;1;4;0;1;4587;4;4;1;0;0;1;2;4587;0;6340;2;1;
/org.eclipse.jdt.ui.tests.refactoring/resources/UseSupertypeWherePossible/testNew14/out/B.java;1;0;1;1;0;0;0;1;2;0;1;1166;2;2;1;0;0;1;1;1166;0;1166;1;1;
/org.eclipse.jdt.ui.tests.refactoring/resources/ExtractMethodWorkSpace/ExtractMethodTests/locals_in/A_test509.java;1;0;1;1;0;0;0;1;4;0;1;844;4;4;1;0;0;1;1;844;0;844;1;1;
/org.eclipse.swt/Eclipse SWT PI/gtk1x/org/eclipse/swt/internal/gtk/GtkAllocation.java;1;0;1;1;0;0;0;1;0;0;1;2327;0;0;1;0;0;1;1;2327;0;2327;1;1;
/org.eclipse.jdt.ui/ui/org/eclipse/jdt/internal/ui/text/java/JavaCompletionProposal.java;4;2;21;2;6;4;6;15;61;2;14;862;264;264;2;1;2;15;21;3166;3;6340;18;4;
/org.eclipse.jdt.ui.tests.refactoring/resources/DeleteSourceReferenceEdit/A_test4_out.java;1;0;1;1;0;0;0;1;0;0;1;1652;0;0;1;0;0;1;1;1652;0;1652;1;1;
/org.eclipse.ui.externaltools/External Tools Base/org/eclipse/ui/externaltools/internal/variable/ResourceExpander.java;1;0;1;1;0;0;0;1;0;0;1;321;0;0;1;0;0;1;1;321;0;321;1;1;
/org.eclipse.jdt.ui/core refactoring/org/eclipse/jdt/internal/corext/refactoring/base/RefactoringStatusEntry.java;2;0;4;1;0;0;0;4;334;1;4;882;348;348;1;0;0;4;4;882;0;4575;4;2;
/org.eclipse.jdt.core.tests.model/workspace/Converter/test0047/Test.java;1;0;1;1;0;0;0;1;0;0;1;3714;0;0;1;0;0;1;1;3714;0;3714;1;1;
/org.eclipse.swt/Eclipse SWT/motif/org/eclipse/swt/widgets/ToolDrawable.java;1;0;1;1;0;0;0;1;0;0;1;669;0;0;1;0;0;1;1;669;0;669;1;1;
/org.eclipse.jdt.core.tests.model/workspace/Converter/test0379/Test.java;1;0;1;1;0;0;0;1;0;0;1;3714;0;0;1;0;0;1;1;3714;0;3714;1;1;
/org.eclipse.jdt.ui/ui/org/eclipse/jdt/internal/ui/search/MatchPositionSorter.java;1;0;1;1;1;1;1;0;2;0;0;6340;2;2;1;0;0;0;1;6340;0;6340;1;1;
/org.eclipse.ant.ui/Ant Tools Support/org/eclipse/ant/internal/ui/launchConfigurations/AntLaunchDelegate.java;3;1;30;2;6;6;6;24;123;2;20;1811;444;444;2;4;0;24;30;1811;4;6219;26;3;
/org.eclipse.jdt.core.tests.model/workspace/Converter/src/javadoc/test015/Test.java;1;0;1;1;0;0;0;1;0;0;1;4311;0;0;1;0;0;1;1;4311;0;4311;1;1;
/org.eclipse.core.runtime.osgi/src/org/eclipse/core/internal/jobs/Worker.java;1;0;2;1;0;0;0;2;2;1;2;3013;2;2;1;0;0;2;2;3013;0;3028;2;1;
/org.eclipse.ui.ide/src/org/eclipse/ui/views/navigator/StringMatcher.java;3;1;3;1;2;2;2;1;2;0;1;2208;4;4;1;0;0;1;3;2208;0;6338;3;3;
/org.eclipse.jdt.core.tests.model/workspace/Converter/src/test0213/Test.java;1;0;1;1;0;0;0;1;0;0;1;3714;0;0;1;0;0;1;1;3714;0;3714;1;1;
/org.eclipse.jdt.debug/eval/org/eclipse/jdt/internal/debug/eval/ast/instructions/Pop.java;1;0;1;1;0;0;0;1;3;0;1;2497;3;3;1;0;0;1;1;2497;0;2497;1;1;
/org.eclipse.core.tests.resources/src/org/eclipse/core/tests/internal/indexing/AllTests.java;1;0;1;1;1;1;1;0;6;0;0;5147;6;6;1;0;0;0;1;5147;0;5147;1;1;
/org.eclipse.jdt.core.tests.model/workspace/Formatter/test381/A_in.java;1;0;1;1;0;0;0;1;0;0;1;3148;0;0;1;0;0;1;1;3148;0;3148;1;1;
/org.eclipse.ui.ide/src/org/eclipse/ui/internal/ide/dialogs/FileStatesPage.java;3;1;3;1;2;2;2;1;3;0;1;2264;5;5;1;0;0;1;3;2264;0;6338;3;3;
/org.eclipse.jdt.core.tests.model/workspace/Formatter/test352/A_out.java;1;0;2;1;0;0;0;2;2;1;2;3029;2;2;1;0;0;2;2;3029;0;4173;2;1;
/org.eclipse.jdt.core.tests.model/workspace/Formatter/test418/A_in.java;1;0;1;1;0;0;0;1;0;0;1;3461;0;0;1;0;0;1;1;3461;0;3461;1;1;
/org.eclipse.ui.ide/src/org/eclipse/ui/internal/ide/IDEInternalWorkbenchImages.java;3;0;4;1;1;1;1;3;104;1;3;1656;119;119;1;0;0;3;4;1656;0;6338;4;3;
/org.eclipse.pde.ui/src/org/eclipse/pde/internal/ui/wizards/RequiredPluginsContainerPage.java;3;1;6;2;3;3;3;3;11;1;3;2751;32;32;1;0;0;3;6;2751;0;6336;6;3;
/org.eclipse.jdt.ui/core refactoring/org/eclipse/jdt/internal/corext/refactoring/rename/TempDeclarationFinder.java;2;0;3;1;1;1;1;2;9;0;1;1952;11;11;2;1;0;2;3;1952;1;6340;2;2;
/org.eclipse.team.ui/src/org/eclipse/team/ui/synchronize/subscriber/TeamSubscriberPageDiffTreeViewerConfiguration.java;1;0;1;1;0;0;0;1;0;0;1;3972;0;0;1;0;0;1;1;3972;0;3972;1;1;
/org.eclipse.swt/Eclipse SWT/gtk1x/org/eclipse/swt/internal/Converter.java;1;0;1;1;0;0;0;1;0;0;1;2327;0;0;1;0;0;1;1;2327;0;2327;1;1;
/org.eclipse.jdt.core.tests.model/workspace/Converter/src/test0264/Test.java;1;0;1;1;0;0;0;1;0;0;1;3714;0;0;1;0;0;1;1;3714;0;3714;1;1;
/org.eclipse.jdt.ui/ui/org/eclipse/jdt/internal/ui/callhierarchy/CallHierarchyMessages.java;2;0;2;1;1;1;1;1;2;0;1;155;2;2;1;0;0;1;2;155;0;6340;2;2;
/org.eclipse.sdk.tests-feature/plugins/org.eclipse.perfmsr.ui/src/org/eclipse/perfmsr/ui/actions/GlobalSnapShot.java;2;1;5;1;4;4;4;1;12;0;1;4845;30;30;1;0;0;1;5;4845;0;6342;5;2;
/org.eclipse.ui.ide/src/org/eclipse/ui/wizards/datatransfer/WizardFileSystemImportPage1.java;1;0;1;1;0;0;0;1;0;0;1;1511;0;0;1;0;0;1;1;1511;0;1511;1;1;
/org.eclipse.jdt.ui.tests.refactoring/resources/ConvertAnonymousToNested/cannotConvert/A_testFail3.java;1;0;1;1;0;0;0;1;0;0;1;3434;0;0;1;0;0;1;1;3434;0;3434;1;1;
/org.eclipse.jdt.ui.tests.refactoring/resources/ExtractMethodWorkSpace/ExtractMethodTests/branch_out/A_test752.java;1;0;4;1;0;0;0;4;6;1;4;844;6;6;1;0;0;4;4;844;0;2256;4;1;
/org.eclipse.jdt.ui/ui/org/eclipse/jdt/internal/ui/text/link/contentassist/PopupCloser2.java;2;0;3;1;0;0;0;3;7;1;3;1132;7;7;1;0;0;3;3;1132;0;4214;3;2;
/org.eclipse.core.tests.resources/src/org/eclipse/core/tests/resources/session/FindDeletedMembersTest.java;1;0;2;1;2;1;2;0;678;0;0;5147;678;678;2;0;1;0;2;5147;1;5147;1;1;
/org.eclipse.jdt.ui.examples.javafamily/coresearch-experiment/org/eclipse/search/internal/core/IndexAddition.java;1;0;2;1;0;0;0;2;0;1;2;1380;0;0;1;0;0;2;2;1380;0;3214;2;1;
/org.eclipse.webdav/src/interface/org/eclipse/webdav/dom/Namespaces.java;1;0;1;1;1;1;1;0;66;0;0;5151;66;66;1;0;0;0;1;5151;0;5151;1;1;
/org.eclipse.jdt.ui/ui/org/eclipse/jdt/internal/ui/javadocexport/JavadocConsoleLineTracker.java;1;0;1;1;0;0;0;1;0;0;1;5015;0;0;1;0;0;1;1;5015;0;5015;1;1;
/org.eclipse.jdt.ui/core refactoring/org/eclipse/jdt/internal/corext/refactoring/changes/DocumentChange.java;1;0;6;1;0;0;0;6;30;1;6;3646;43;43;1;0;0;6;6;3646;0;4624;6;1;
/org.eclipse.ui.workbench/Eclipse UI/org/eclipse/ui/internal/csm/commands/api/KeyConfigurationNotDefinedException.java;1;0;1;1;0;0;0;1;0;0;1;2532;0;0;1;0;0;1;1;2532;0;2532;1;1;
/org.eclipse.team.cvs.ui/src/org/eclipse/team/internal/ccvs/ui/actions/CheckoutWizardAction.java;1;0;1;1;0;0;0;1;0;0;1;4875;0;0;1;0;0;1;1;4875;0;4875;1;1;
/org.eclipse.jdt.debug.ui/ui/org/eclipse/jdt/internal/debug/ui/JavaUtilCollectionVariablesContentProvider.java;1;0;5;1;0;0;0;5;9;1;5;670;21;21;1;0;0;5;5;670;0;861;5;1;
/org.eclipse.ant.ui/Ant Editor/org/eclipse/ant/ui/internal/editor/AntEditorActionContributor.java;1;0;3;1;0;0;0;3;4;1;3;250;4;4;1;0;0;3;3;250;0;1811;3;1;
/org.eclipse.core.tests.runtime/src/org/eclipse/core/tests/plugintests/PluginTests.java;1;0;1;1;0;0;0;1;0;0;1;3014;0;0;1;0;0;1;1;3014;0;3014;1;1;
/org.eclipse.swt/Eclipse SWT/carbon/org/eclipse/swt/graphics/TextLayout.java;3;2;24;1;17;15;17;7;532;1;7;4562;969;969;2;0;2;7;24;5535;2;6352;22;3;
/org.eclipse.update.core/src/org/eclipse/update/core/model/ArchiveReferenceModel.java;2;1;4;1;3;3;3;1;6;0;1;890;15;15;1;0;0;1;4;890;0;6336;4;2;
/org.eclipse.jdt.ui.tests.refactoring/resources/DeleteSourceReference/test17/out/A.java;1;0;1;1;0;0;0;1;0;0;1;1652;0;0;1;0;0;1;1;1652;0;1652;1;1;
/org.eclipse.jdt.ui/ui/org/eclipse/jdt/internal/ui/search/MethodExitsFinder.java;2;1;4;1;4;4;4;0;14;0;0;5485;29;29;1;0;0;0;4;5485;0;5909;4;2;
/org.eclipse.ui.workbench/Eclipse UI/org/eclipse/ui/part/PluginDropAdapter.java;2;0;2;1;1;1;1;1;2;0;1;4609;4;4;1;0;0;1;2;4609;0;6338;2;2;
/org.eclipse.ui.views/src/org/eclipse/ui/views/internal/markers/ActionOpenMarker.java;1;0;2;1;0;0;0;2;0;0;1;749;0;0;2;1;0;2;2;749;1;749;1;1;
/org.eclipse.pde.ui/src/org/eclipse/pde/internal/ui/editor/site/FeaturePage.java;1;0;1;1;0;0;0;1;0;0;1;2311;0;0;1;0;0;1;1;2311;0;2311;1;1;
/org.eclipse.swt/Eclipse SWT PI/gtk1x/org/eclipse/swt/internal/gtk/GtkContainer.java;1;0;1;1;0;0;0;1;0;0;1;2327;0;0;1;0;0;1;1;2327;0;2327;1;1;
/org.eclipse.jdt.core.tests.model/workspace/Converter/src/test0525/A.java;1;0;1;1;0;0;0;1;0;0;1;3714;0;0;1;0;0;1;1;3714;0;3714;1;1;
/org.eclipse.ui.workbench/Eclipse UI/org/eclipse/ui/internal/ObjectActionContributor.java;3;1;3;1;2;2;2;1;57;0;1;2737;60;60;1;0;0;1;3;2737;0;6338;3;3;
/org.eclipse.jdt.ui.tests.refactoring/resources/InlineMethodWorkspace/TestCases/argument_in/TestOneRead.java;1;0;1;1;0;0;0;1;2;0;1;845;2;2;1;0;0;1;1;845;0;845;1;1;
/org.eclipse.core.tests.resources/src/org/eclipse/core/tests/internal/indexing/StandAloneTestEnvironment.java;1;0;1;1;1;1;1;0;28;0;0;5147;28;28;1;0;0;0;1;5147;0;5147;1;1;
/org.eclipse.core.resources/src/org/eclipse/core/internal/watson/IElementInfoFlattener.java;1;0;1;1;1;1;1;0;42;0;0;5146;42;42;1;0;0;0;1;5146;0;5146;1;1;
/org.eclipse.swt.examples/src/org/eclipse/swt/examples/controlexample/SliderTab.java;1;0;1;1;0;0;0;1;2;0;1;1560;2;2;1;0;0;1;1;1560;0;1560;1;1;
/org.eclipse.jdt.ui.tests.refactoring/resources/MoveMembers/test27/in/B.java;1;0;1;1;0;0;0;1;0;0;1;1522;0;0;1;0;0;1;1;1522;0;1522;1;1;
/org.eclipse.jdt.core/model/org/eclipse/jdt/internal/core/util/ElementInfoConverter.java;2;0;6;1;0;0;0;6;248;2;5;2035;318;318;2;1;0;6;6;2035;1;3560;5;2;
/org.eclipse.ui.ide/src/org/eclipse/ui/views/tasklist/FiltersAction.java;1;0;1;1;0;0;0;1;0;0;1;2208;0;0;1;0;0;1;1;2208;0;2208;1;1;
/org.eclipse.webdav/src/kernel/org/eclipse/webdav/internal/kernel/utils/MergedEnumeration.java;1;0;2;1;2;1;2;0;57;0;0;5151;57;57;2;0;1;0;2;5151;1;5151;1;1;
/org.eclipse.jdt.ui/core refactoring/org/eclipse/jdt/internal/corext/refactoring/reorg/JavaMoveProcessor.java;3;1;9;1;6;6;6;3;89;1;3;4688;154;154;1;0;0;3;9;4688;0;6340;9;3;
/org.eclipse.jface.text/src/org/eclipse/jface/text/templates/persistence/TemplateReaderWriter.java;2;1;9;1;5;5;5;4;60;3;2;4627;144;144;3;2;0;4;9;4627;2;6353;7;2;
/org.eclipse.ui.workbench/Eclipse UI/org/eclipse/ui/commands/IContextServiceListener.java;1;0;4;1;0;0;0;4;9;2;3;772;9;9;2;1;0;4;4;1064;1;1119;3;1;
/org.eclipse.ant.ui/Ant Editor/org/eclipse/ant/ui/internal/editor/text/AntEditorDocumentProvider.java;2;0;6;1;0;0;0;6;38;2;5;250;54;54;2;1;0;6;6;315;1;1811;5;2;
/org.eclipse.webdav/src/kernel/org/eclipse/webdav/internal/kernel/Condition.java;1;0;2;1;2;1;2;0;26;0;0;5151;26;26;2;0;1;0;2;5151;1;5151;1;1;
/org.eclipse.pde.ui/src/org/eclipse/pde/internal/ui/wizards/plugin/ProjectCodeGeneratorsPage.java;1;0;2;1;0;0;0;2;0;1;2;3840;0;0;1;0;0;2;2;3840;0;3986;2;1;
/org.eclipse.core.runtime/src/org/eclipse/core/internal/registry/NestedRegistryModelObject.java;3;3;5;1;5;3;5;0;12;0;0;5210;14;14;3;0;2;0;5;5637;2;6340;3;3;
/org.eclipse.update.ui.forms/src/org/eclipse/ui/forms/events/HyperlinkListener.java;1;0;2;1;0;0;0;2;0;0;1;3095;0;0;2;1;0;2;2;3095;1;3095;1;1;
/org.eclipse.pde.ui/src/org/eclipse/pde/internal/ui/editor/feature/FeatureEditor.java;3;2;11;1;9;8;9;2;321;1;2;1618;455;455;2;0;1;2;11;5431;1;6336;10;3;
/org.eclipse.jdt.core.tests.compiler/src/org/eclipse/jdt/core/tests/compiler/regression/BooleanTest.java;2;0;4;1;0;0;0;4;87;1;4;1785;151;151;1;0;0;4;4;1785;0;3106;4;2;
/org.eclipse.jdt.core.tests.model/workspace/Converter/src/test0097/Test.java;1;0;1;1;0;0;0;1;0;0;1;3714;0;0;1;0;0;1;1;3714;0;3714;1;1;
/org.eclipse.jdt.core.tests.model/workspace/Converter/test0152/Test.java;1;0;1;1;0;0;0;1;0;0;1;3714;0;0;1;0;0;1;1;3714;0;3714;1;1;
/org.eclipse.jdt.core.tests.model/workspace/Formatter/test075/A_out.java;1;0;1;1;0;0;0;1;0;0;1;2425;0;0;1;0;0;1;1;2425;0;2425;1;1;
/org.eclipse.jdt.core.tests.builder/src/org/eclipse/jdt/core/tests/builder/Tests.java;3;0;6;1;0;0;0;6;7;1;6;312;22;22;1;0;0;6;6;312;0;3560;6;3;
/org.eclipse.ui.workbench/Eclipse UI/org/eclipse/ui/internal/progress/IJobCompletionListener.java;1;0;1;1;0;0;0;1;0;0;1;532;0;0;1;0;0;1;1;532;0;532;1;1;
/org.eclipse.pde.runtime/src/org/eclipse/pde/internal/runtime/registry/ListingMenu.java;1;0;2;1;0;0;0;2;0;1;2;3933;0;0;1;0;0;2;2;3933;0;4035;2;1;
/org.eclipse.osgi/osgi/src/org/eclipse/osgi/service/resolver/HostSpecification.java;4;2;7;2;3;2;3;4;14;1;4;3013;36;36;2;0;1;4;7;6337;1;6337;6;4;
/org.eclipse.jdt.core.tests.model/workspace/Formatter/test390/A_out.java;1;0;1;1;0;0;0;1;0;0;1;3172;0;0;1;0;0;1;1;3172;0;3172;1;1;
/org.eclipse.jdt.ui.tests.refactoring/resources/MoveMembers/test21/out/B.java;1;0;1;1;0;0;0;1;1;0;1;1856;1;1;1;0;0;1;1;1856;0;1856;1;1;
/org.eclipse.ui.views/src/org/eclipse/ui/views/internal/table/TableView.java;1;0;2;1;0;0;0;2;0;0;1;749;0;0;2;1;0;2;2;749;1;749;1;1;
/org.eclipse.ui.workbench/Eclipse UI/org/eclipse/ui/internal/commands/older/KeyBindingMachine.java;1;0;2;1;0;0;0;2;2;0;1;2562;2;2;2;1;0;2;2;2562;1;2562;1;1;
/org.eclipse.jdt.ui/ui refactoring/org/eclipse/jdt/internal/ui/refactoring/actions/RenameResourceAction.java;3;0;9;1;1;1;1;8;94;2;7;122;180;180;2;1;0;8;9;1125;1;6340;8;3;
/org.eclipse.team.examples.filesystem/src/org/eclipse/team/examples/filesystem/ui/GetSynchronizeAction.java;1;0;1;1;1;1;1;0;0;0;0;6206;0;0;1;0;0;0;1;6206;0;6206;1;1;
/org.eclipse.team.webdav/src/org/eclipse/team/core/target/RemoteSynchronizationCache.java;1;0;1;1;0;0;0;1;0;0;1;3477;0;0;1;0;0;1;1;3477;0;3477;1;1;
/org.eclipse.team.cvs.core/src/org/eclipse/team/internal/ccvs/core/syncinfo/FolderSyncInfo.java;2;1;7;1;3;3;3;4;61;1;4;751;97;97;1;0;0;4;7;751;0;6337;7;2;
/org.eclipse.ui.workbench.texteditor/src/org/eclipse/ui/texteditor/EditorStatusLine.java;1;1;5;1;2;2;2;3;7;1;3;1346;20;20;1;0;0;3;5;1346;0;6340;5;1;
/org.eclipse.ui.tests/UI Test Utils/org/eclipse/ui/tests/util/CallHistory.java;2;1;2;1;2;2;2;0;9;0;0;5345;13;13;1;0;0;0;2;5345;0;6338;2;2;
/org.eclipse.pde.runtime/src/org/eclipse/pde/internal/runtime/logview/EvenDetailsDialogAction.java;1;0;3;1;0;0;0;3;1;2;2;3630;1;1;2;1;0;3;3;3630;1;4212;2;1;
/org.eclipse.jdt.core.tests.model/workspace/Converter/test0398/A.java;1;0;1;1;0;0;0;1;0;0;1;3714;0;0;1;0;0;1;1;3714;0;3714;1;1;
/org.eclipse.jface/src/org/eclipse/jface/preference/PreferenceStore.java;2;1;3;1;2;2;2;1;1071;0;1;1;1081;1081;1;0;0;1;3;1;0;6338;3;2;
/org.eclipse.team.webdav/src/org/eclipse/team/internal/core/target/ISiteListener.java;1;0;1;1;0;0;0;1;0;0;1;2495;0;0;1;0;0;1;1;2495;0;2495;1;1;
/org.eclipse.swt/Eclipse SWT/emulated/treetable/org/eclipse/swt/widgets/TreeItem.java;4;1;9;1;3;3;3;6;62;1;6;269;99;99;1;0;0;6;9;269;0;6352;9;4;
/org.eclipse.compare/compare/org/eclipse/compare/internal/OverlayPreferenceStore.java;1;0;1;1;0;0;0;1;6;0;1;1289;6;6;1;0;0;1;1;1289;0;1289;1;1;
/org.eclipse.swt/Eclipse SWT Mozilla/common/org/eclipse/swt/internal/mozilla/nsIWindowWatcher.java;1;0;2;1;0;0;0;2;20;1;2;1855;20;20;1;0;0;2;2;1855;0;2568;2;1;
/org.eclipse.update.ui/srcnew/org/eclipse/update/internal/ui/wizards/NewWebSiteDialog.java;2;0;2;1;0;0;0;2;0;1;2;705;0;0;1;0;0;2;2;705;0;825;2;2;
/org.eclipse.ant.ui/Ant Tools Support/org/eclipse/ant/ui/internal/views/actions/RemoveAllAction.java;1;0;3;1;0;0;0;3;8;2;2;263;8;8;2;1;0;3;3;263;1;1811;2;1;
/org.eclipse.swt.tests/JUnit Tests/org/eclipse/swt/tests/junit/Test_org_eclipse_swt_SWTException.java;1;0;1;1;0;0;0;1;32;0;1;2176;32;32;1;0;0;1;1;2176;0;2176;1;1;
/org.eclipse.jdt.ui/ui refactoring/org/eclipse/jdt/internal/ui/refactoring/IPreviewWizardPage.java;1;0;3;1;0;0;0;3;4;1;3;3930;6;6;1;0;0;3;3;3930;0;4965;3;1;
/org.eclipse.jdt.ui.tests.refactoring/resources/ExtractMethodWorkSpace/ExtractMethodTests/error_in/A_test800.java;1;0;3;1;0;0;0;3;2;1;3;844;2;2;1;0;0;3;3;844;0;1474;3;1;
/org.eclipse.swt/Eclipse SWT PI/win32/org/eclipse/swt/internal/ole/win32/VARDESC2.java;2;0;3;2;0;0;0;3;15;2;2;2915;21;21;2;1;0;3;3;2915;1;2930;2;2;
/org.eclipse.swt/Eclipse SWT Browser/mozilla/org/eclipse/swt/browser/WindowCreator.java;3;1;8;1;4;4;4;4;57;1;4;2849;82;82;1;0;0;4;8;2849;0;6352;8;3;
/org.eclipse.pde.ui/src/org/eclipse/pde/internal/ui/editor/feature/AdvancedForm.java;1;0;2;1;1;1;1;1;5;0;1;4203;5;5;1;0;0;1;2;4203;0;5431;2;1;
/org.eclipse.jdt.core/dom/org/eclipse/jdt/core/dom/ReturnStatement.java;3;0;7;1;1;1;1;6;67;1;6;3560;84;84;1;0;0;6;7;3560;0;5272;7;3;
/org.eclipse.jdt.debug.ui/ui/org/eclipse/jdt/internal/debug/ui/jres/DefaultJREDescriptor.java;2;0;3;1;0;0;0;3;7;1;3;1065;7;7;1;0;0;3;3;1065;0;4849;3;2;
/org.eclipse.jdt.ui/ui/org/eclipse/jdt/internal/ui/text/java/JavaParameterListValidator.java;1;0;1;1;1;1;1;0;2;0;0;6340;2;2;1;0;0;0;1;6340;0;6340;1;1;
/org.eclipse.ltk.ui.refactoring/src/org/eclipse/ltk/internal/ui/refactoring/RefactoringStatusEntryLabelProvider.java;1;0;2;1;1;1;1;1;2;0;1;4965;2;2;1;0;0;1;2;4965;0;6340;2;1;
/org.eclipse.ui.workbench/Eclipse UI/org/eclipse/ui/roles/IRoleActivationServiceListener.java;1;0;2;1;0;0;0;2;0;1;2;1952;0;0;1;0;0;2;2;1952;0;2202;2;1;
/org.eclipse.jdt.ui.tests.refactoring/resources/InlineMethodWorkspace/TestCases/argument_in/TestParameterNameUsed2.java;1;0;1;1;0;0;0;1;2;0;1;845;2;2;1;0;0;1;1;845;0;845;1;1;
/org.eclipse.jdt.ui.tests.refactoring/test cases/org/eclipse/jdt/ui/tests/nls/SimpleLineReaderTest.java;3;1;3;1;2;2;2;1;24;0;1;4930;26;26;1;0;0;1;3;4930;0;6340;3;3;
/org.eclipse.jdt.debug/eval/org/eclipse/jdt/internal/debug/eval/ast/instructions/PushArrayLength.java;1;0;1;1;0;0;0;1;2;0;1;1276;2;2;1;0;0;1;1;1276;0;1276;1;1;
/org.eclipse.update.core/srcnew/org/eclipse/update/internal/operations/SingleOperation.java;1;0;4;1;0;0;0;4;6;2;3;569;6;6;2;1;0;4;4;602;1;616;3;1;
/org.eclipse.team.core/src/org/eclipse/team/internal/core/streams/PollingOutputStream.java;2;1;3;1;2;2;2;1;34;0;1;1541;41;41;1;0;0;1;3;1541;0;6336;3;2;
/org.eclipse.pde.ui/src_Forms/org/eclipse/pde/internal/ui/neweditor/site/SiteInputContext.java;2;0;5;2;1;1;1;4;14;2;3;4832;28;28;2;1;0;4;5;4856;1;5431;4;2;
/org.eclipse.debug.ui/ui/org/eclipse/debug/internal/ui/sourcelookup/Prompter.java;1;0;1;1;0;0;0;1;0;0;1;4609;0;0;1;0;0;1;1;4609;0;4609;1;1;
/org.eclipse.jdt.ui/ui/org/eclipse/jdt/ui/actions/FindDeclarationsInProjectsAction.java;1;0;2;1;0;0;0;2;0;1;2;1586;0;0;1;0;0;2;2;1586;0;1624;2;1;
/org.eclipse.update.core/srcnew/org/eclipse/update/operations/IInstallOperation.java;1;0;3;1;0;0;0;3;2;1;3;569;2;2;1;0;0;3;3;569;0;602;3;1;
/org.eclipse.ui.workbench/Eclipse UI/org/eclipse/ui/internal/dnd/IDropTarget.java;2;0;2;1;0;0;0;2;46;1;2;3677;46;46;1;0;0;2;2;3677;0;4015;2;2;
/org.eclipse.ui.editors/src/org/eclipse/ui/editors/text/EncodingActionGroup.java;1;1;5;1;4;4;4;1;123;0;1;1347;172;172;1;0;0;1;5;1347;0;6334;5;1;
/org.eclipse.osgi/osgi/src/org/osgi/service/packageadmin/SymbolicBundle.java;1;0;3;1;0;0;0;3;66;1;3;3982;66;66;1;0;0;3;3;3982;0;4311;3;1;
/org.eclipse.ui.ide/src/org/eclipse/ui/internal/actions/BuildContributionItem.java;2;0;2;1;0;0;0;2;0;1;2;1937;0;0;1;0;0;2;2;1937;0;2263;2;2;
/org.eclipse.jdt.core.tests.model/workspace/Resolve/src/ResolveDuplicateTypeDeclaration3.java;1;0;1;1;1;1;1;0;0;0;0;6222;0;0;1;0;0;0;1;6222;0;6222;1;1;
/org.eclipse.jdt.ui.tests.refactoring/resources/ExtractMethodWorkSpace/ExtractMethodTests/locals_out/A_test528.java;1;0;2;1;0;0;0;2;6;1;2;130;10;10;1;0;0;2;2;130;0;844;2;1;
/org.eclipse.core.tools/src/org/eclipse/core/tools/runtime/PreferenceStatsView.java;1;0;1;1;1;1;1;0;0;0;0;6302;0;0;1;0;0;0;1;6302;0;6302;1;1;
/org.eclipse.ui.workbench/Eclipse UI/org/eclipse/ui/internal/keys/CompactKeyFormatter.java;1;0;1;1;0;0;0;1;0;0;1;3310;0;0;1;0;0;1;1;3310;0;3310;1;1;
/org.eclipse.jdt.ui/ui refactoring/org/eclipse/jdt/internal/ui/refactoring/nls/search/Properties.java;1;0;1;1;1;1;1;0;2;0;0;6340;2;2;1;0;0;0;1;6340;0;6340;1;1;
/org.eclipse.help/src/org/eclipse/help/internal/util/IErrorUtil.java;1;0;1;1;0;0;0;1;0;0;1;2732;0;0;1;0;0;1;1;2732;0;2732;1;1;
/org.eclipse.ui.examples.javaeditor/Template Editor Example/org/eclipse/ui/examples/templateeditor/editors/XMLDoubleClickStrategy.java;2;0;2;1;1;1;1;1;10;0;1;4644;10;10;1;0;0;1;2;4644;0;6340;2;2;
/org.eclipse.team.tests.cvs.core/src/org/eclipse/team/tests/ccvs/ui/old/SequenceGenerator.java;1;0;2;1;0;0;0;2;0;1;2;2632;0;0;1;0;0;2;2;2632;0;4216;2;1;
/org.eclipse.sdk.tests-feature/plugins/org.eclipse.perfmsr.ui.client/src/org/eclipse/perfmsr/ui/client/SelectValuesAction.java;1;1;2;1;2;2;2;0;10;0;0;5443;10;10;1;0;0;0;2;5443;0;5513;2;1;
/org.eclipse.debug.ui/ui/org/eclipse/debug/internal/ui/actions/RetargetMethodBreakpointAction.java;1;0;2;1;0;0;0;2;1;0;1;4492;1;1;2;1;0;2;2;4492;1;4492;1;1;
/org.eclipse.osgi/core/framework/org/eclipse/osgi/framework/internal/protocol/NullURLStreamHandlerService.java;4;1;5;1;3;3;3;2;59;1;2;3013;99;99;1;0;0;2;5;3013;0;6337;5;4;
/org.eclipse.update.ui.forms/src/org/eclipse/update/ui/forms/internal/TableData.java;1;0;1;1;0;0;0;1;8;0;1;3038;8;8;1;0;0;1;1;3038;0;3038;1;1;
/org.eclipse.pde.ui/src/org/eclipse/pde/internal/ui/feature/PluginListPage.java;2;0;2;1;0;0;0;2;12;1;2;2229;12;12;1;0;0;2;2;2229;0;3840;2;2;
/org.eclipse.jdt.debug.ui/ui/org/eclipse/jdt/internal/debug/ui/actions/WatchAction.java;2;0;3;1;0;0;0;3;15;1;3;1175;34;34;1;0;0;3;3;1175;0;1524;3;2;
/org.eclipse.ui.intro/src/org/eclipse/ui/internal/intro/impl/parts/FormStyleManager.java;1;1;6;1;6;6;6;0;125;0;0;5115;179;179;1;0;0;0;6;5115;0;5449;6;1;
/org.eclipse.pde.ui/src_Forms/org/eclipse/pde/internal/ui/neweditor/site/BuiltFeaturesWizard.java;2;0;2;1;1;1;1;1;0;0;1;4832;0;0;1;0;0;1;2;4832;0;5431;2;2;
/org.eclipse.jdt.ui/ui refactoring/org/eclipse/jdt/internal/ui/refactoring/IErrorContextViewer.java;1;0;1;1;0;0;0;1;0;0;1;882;0;0;1;0;0;1;1;882;0;882;1;1;
/org.eclipse.jdt.ui.tests.refactoring/resources/InlineMethodWorkspace/TestCases/import_out/TestUseArray.java;1;0;1;1;0;0;0;1;2;0;1;845;2;2;1;0;0;1;1;845;0;845;1;1;
/org.eclipse.team.ui/src/org/eclipse/team/ui/sync/actions/PseudoConflictFilter.java;1;0;1;1;0;0;0;1;0;0;1;2378;0;0;1;0;0;1;1;2378;0;2378;1;1;
/org.eclipse.pde.ui/src/org/eclipse/pde/internal/ui/editor/plugin/PluginInputContextManager.java;2;2;6;1;6;5;6;0;33;0;0;5431;70;70;2;0;1;0;6;5557;1;6336;5;2;
/org.eclipse.ui.workbench/Eclipse UI/org/eclipse/ui/internal/fonts/FontDefinition.java;1;0;4;1;0;0;0;4;135;2;3;3877;227;227;2;1;0;4;4;4235;1;4263;3;1;
/org.eclipse.jdt.debug/model/org/eclipse/jdt/internal/debug/core/model/JDIArrayEntryVariable.java;1;0;1;1;0;0;0;1;19;0;1;2564;19;19;1;0;0;1;1;2564;0;2564;1;1;
/org.eclipse.core.resources/src/org/eclipse/core/internal/utils/ArrayEnumeration.java;1;0;1;1;1;1;1;0;70;0;0;5146;70;70;1;0;0;0;1;5146;0;5146;1;1;
/org.eclipse.ui.views/src/org/eclipse/ui/views/markers/internal/IMarkerResourceAdapter.java;2;0;2;1;0;0;0;2;0;1;2;755;0;0;1;0;0;2;2;755;0;2738;2;2;
/org.eclipse.pde.ui/src/org/eclipse/pde/internal/ui/editor/manifest/FragmentManifestEditor.java;1;0;1;1;1;1;1;0;0;0;0;5431;0;0;1;0;0;0;1;5431;0;5431;1;1;
/org.eclipse.ui.workbench/Eclipse UI/org/eclipse/ui/internal/dialogs/ProjectPerspectiveChoiceDialog.java;1;0;1;1;0;0;0;1;0;0;1;2737;0;0;1;0;0;1;1;2737;0;2737;1;1;
/org.eclipse.pde.ui/sandbox/org/eclipse/pde/internal/ui/editor/standalone/manifest/FragmentSourceLabelProvider.java;1;0;2;1;0;0;0;2;0;1;2;2320;0;0;1;0;0;2;2;2320;0;2906;2;1;
/org.eclipse.jdt.debug.ui/Snippet Support/org/eclipse/jdt/internal/debug/ui/snippeteditor/ScrapbookMain.java;1;0;1;1;0;0;0;1;0;0;1;724;0;0;1;0;0;1;1;724;0;724;1;1;
/org.eclipse.jdt.ui/core refactoring/org/eclipse/jdt/internal/corext/refactoring/reorg/CreateCopyOfCompilationUnitChange.java;5;1;17;2;6;6;6;11;30;3;8;614;131;131;3;3;0;11;17;3646;3;6340;14;5;
/org.eclipse.ui.editors/src/org/eclipse/ui/internal/editors/text/NextPulldownActionDelegate.java;2;0;3;1;1;1;1;2;29;1;2;2080;31;31;1;0;0;2;3;2080;0;6340;3;2;
/org.eclipse.core.runtime/src/org/eclipse/core/runtime/BundleHelper.java;3;0;3;2;0;0;0;3;594;2;2;3049;594;594;2;1;0;3;3;3164;1;3164;2;3;
/org.eclipse.jdt.debug.ui/ui/org/eclipse/jdt/internal/debug/ui/actions/ControlAccessibleListener.java;1;1;3;1;3;3;3;0;10;0;0;5534;18;18;1;0;0;0;3;5534;0;6336;3;1;
/org.eclipse.core.runtime/src/org/eclipse/core/internal/registry/RegistryWriter.java;5;3;10;2;6;4;6;4;380;2;3;3049;463;463;3;1;2;4;10;5637;3;6340;7;5;
/org.eclipse.ui.workbench/Eclipse UI/org/eclipse/ui/dialogs/WizardNewFileCreationPage.java;2;0;2;1;0;0;0;2;38;1;2;534;38;38;1;0;0;2;2;534;0;2737;2;2;
/org.eclipse.osgi/resolver/src/org/eclipse/osgi/internal/resolver/StateDeltaImpl.java;4;2;8;1;5;4;5;3;45;1;3;3013;145;145;2;0;1;3;8;5341;1;6337;7;4;
/org.eclipse.jdt.core/model/org/eclipse/jdt/internal/core/JavaElementDeltaBuilder.java;2;0;2;1;0;0;0;2;10;1;2;377;12;12;1;0;0;2;2;377;0;3560;2;2;
/org.eclipse.jdt.debug/model/org/eclipse/jdt/internal/debug/core/hcr/Differencer.java;1;0;1;1;0;0;0;1;15;0;1;1277;15;15;1;0;0;1;1;1277;0;1277;1;1;
/org.eclipse.ltk.core.refactoring/src/org/eclipse/ltk/core/refactoring/CheckConditionsOperation.java;1;1;6;1;3;3;3;3;19;1;3;4845;36;36;1;0;0;3;6;4845;0;6338;6;1;
/org.eclipse.jdt.core.tests.model/src/org/eclipse/jdt/core/tests/model/CompilationUnitTests.java;4;0;10;1;0;0;0;10;51;1;10;100;161;161;1;0;0;10;10;100;0;5022;10;4;
/org.eclipse.jdt.core.tests.model/workspace/Converter/test0183/Test.java;1;0;1;1;0;0;0;1;0;0;1;3714;0;0;1;0;0;1;1;3714;0;3714;1;1;
/org.eclipse.team.cvs.ui/src/org/eclipse/team/internal/ccvs/ui/actions/SyncAction.java;2;1;17;1;5;5;5;12;70;2;11;1155;291;291;2;1;0;12;17;1354;1;6337;16;2;
/org.eclipse.jdt.core/dom/org/eclipse/jdt/core/dom/TypeBinding.java;3;2;13;2;6;4;6;7;115;1;7;2742;421;421;2;0;2;7;13;5272;2;5939;11;3;
/org.eclipse.jdt.ui.tests.refactoring/resources/ExtractMethodWorkSpace/ExtractMethodTests/try_in/A_test453.java;1;0;2;1;0;0;0;2;4;1;2;130;8;8;1;0;0;2;2;130;0;844;2;1;
/org.eclipse.pde.ui/src/org/eclipse/pde/internal/ui/editor/schema/GrammarSection.java;2;1;4;1;3;3;3;1;84;0;1;2751;115;115;1;0;0;1;4;2751;0;6336;4;2;
/org.eclipse.update.ui/srcnew/org/eclipse/update/internal/ui/views/FeatureStateAction.java;3;0;19;2;0;0;0;19;99;3;13;339;356;356;3;6;0;19;19;407;6;825;13;3;
/org.eclipse.jface.text/src/org/eclipse/jface/text/contentassist/IContextInformation.java;1;2;3;1;3;2;3;0;21;0;0;6340;23;23;2;0;1;0;3;6353;1;6353;2;1;
/org.eclipse.ui.workbench/Eclipse UI/org/eclipse/ui/roles/NotDefinedException.java;1;0;6;1;0;0;0;6;19;1;6;1952;48;48;1;0;0;6;6;1952;0;2867;6;1;
/org.eclipse.osgi/resolver/src/org/eclipse/osgi/internal/resolver/StateBuilder.java;5;1;15;2;3;3;3;12;40;3;9;3013;180;180;3;3;0;12;15;4492;3;5408;12;5;
/org.eclipse.core.runtime/src/org/eclipse/core/internal/registry/ExtensionRegistry.java;6;3;27;2;9;6;9;18;2214;2;16;2105;6462;6462;3;2;3;18;27;5637;5;5686;22;6;
/org.eclipse.swt.tests/JUnit Tests/org/eclipse/swt/tests/junit/Test_org_eclipse_swt_events_MouseAdapter.java;1;0;1;1;0;0;0;1;16;0;1;2175;16;16;1;0;0;1;1;2175;0;2175;1;1;
/org.eclipse.jdt.core.tests.model/src/org/eclipse/jdt/core/tests/rewrite/describing/ASTRewritingTypeDeclTest.java;5;1;6;1;4;4;4;2;82;1;2;4711;153;153;1;0;0;2;6;4711;0;6336;6;5;
/org.eclipse.pde.core/src/org/eclipse/pde/internal/core/DefaultRuntimeSupport.java;2;0;7;1;0;0;0;7;18;2;6;2229;46;46;2;1;0;7;7;3008;1;4203;6;2;
/org.eclipse.ui.views/src/org/eclipse/ui/views/bookmarkexplorer/BookmarkPropertiesDialog.java;1;0;1;1;0;0;0;1;0;0;1;2738;0;0;1;0;0;1;1;2738;0;2738;1;1;
/org.eclipse.update.core/src/org/eclipse/update/search/IUpdateSearchQuery.java;2;1;6;1;2;2;2;4;10;1;4;825;26;26;1;0;0;4;6;825;0;6336;6;2;
/org.eclipse.core.runtime.osgi/src/org/eclipse/core/internal/jobs/JobListeners.java;1;0;2;1;0;0;0;2;10;1;2;3013;10;10;1;0;0;2;2;3013;0;3028;2;1;
/org.eclipse.jface.text/src/org/eclipse/jface/text/information/IInformationPresenter.java;1;2;4;1;4;3;4;0;38;0;0;5107;42;42;2;0;1;0;4;6352;1;6352;3;1;
/org.eclipse.jdt.core.tests.model/workspace/Formatter/test067/A_in.java;1;0;1;1;0;0;0;1;0;0;1;2425;0;0;1;0;0;1;1;2425;0;2425;1;1;
/org.eclipse.jdt.core.tests.model/workspace/Converter/src/test0539/A.java;1;0;1;1;0;0;0;1;0;0;1;4369;0;0;1;0;0;1;1;4369;0;4369;1;1;
/org.eclipse.pde.ui/src/org/eclipse/pde/internal/ui/editor/schema/ElementPropertySource.java;2;1;2;1;2;2;2;0;16;0;0;5781;20;20;1;0;0;0;2;5781;0;6336;2;2;
/org.eclipse.jdt.core.tests.model/workspace/Converter/test0446/A.java;1;0;1;1;0;0;0;1;0;0;1;3714;0;0;1;0;0;1;1;3714;0;3714;1;1;
/org.eclipse.ui.workbench/Eclipse UI/org/eclipse/ui/commands/ICommandActivationServiceEvent.java;1;0;2;1;0;0;0;2;0;0;1;1222;0;0;2;1;0;2;2;1222;1;1222;1;1;
/org.eclipse.jdt.core.tests.model/workspace/Converter/src/javadoc/test018b/TestB2.java;1;0;2;1;0;0;0;2;0;1;2;4311;0;0;1;0;0;2;2;4311;0;4390;2;1;
/org.eclipse.jdt.core/compiler/org/eclipse/jdt/internal/compiler/parser/SourceMethodDeclaration.java;2;0;2;1;0;0;0;2;2;1;2;3560;2;2;1;0;0;2;2;3560;0;4461;2;2;
/org.eclipse.webdav/src/kernel/org/eclipse/webdav/internal/kernel/WebDAVException.java;1;0;1;1;1;1;1;0;4;0;0;5151;4;4;1;0;0;0;1;5151;0;5151;1;1;
/org.eclipse.jdt.core.tests.model/workspace/Formatter/test253/A_out.java;1;0;2;1;0;0;0;2;4;1;2;2442;4;4;1;0;0;2;2;2442;0;3029;2;1;
/org.eclipse.swt.tools/JNI Generation/org/eclipse/swt/tools/internal/StructTest.java;2;0;2;1;0;0;0;2;0;1;2;4175;0;0;1;0;0;2;2;4175;0;4270;2;2;
/org.eclipse.team.cvs.core/src/org/eclipse/team/internal/ccvs/core/resources/RemoteFolderMemberFetcher.java;1;0;4;1;0;0;0;4;13;1;4;1891;19;19;1;0;0;4;4;1891;0;2043;4;1;
/org.eclipse.osgi/defaultAdaptor/src/org/eclipse/osgi/framework/adaptor/core/AbstractClassLoader.java;2;1;5;1;2;2;2;3;33;2;2;4650;70;70;2;1;0;3;5;4650;1;5507;4;2;
/org.eclipse.pde.build/src/org/eclipse/pde/internal/build/site/PluginPathFinder.java;2;1;4;1;2;2;2;2;60;1;2;4740;83;83;1;0;0;2;4;4740;0;5754;4;2;
/org.eclipse.ui.workbench/Eclipse UI/org/eclipse/ui/internal/activities/IActivityRegistry.java;3;1;9;1;2;2;2;7;10;1;7;2444;28;28;1;0;0;7;9;2444;0;6338;9;3;
/org.eclipse.ui.examples.multipageeditor/Eclipse UI Examples MultiPageEditor/org/eclipse/ui/examples/multipageeditor/MultiPageContributor.java;1;0;1;1;0;0;0;1;23;0;1;2738;23;23;1;0;0;1;1;2738;0;2738;1;1;
/org.eclipse.jdt.debug.ui/ui/org/eclipse/jdt/internal/debug/ui/jres/JREsPreferencePage.java;4;0;12;1;1;1;1;11;243;3;8;1035;370;370;3;3;0;11;12;1035;3;5669;9;4;
/org.eclipse.ui.ide/extensions/org/eclipse/ui/dialogs/ProjectLocationMoveDialog.java;1;0;1;1;0;0;0;1;0;0;1;2263;0;0;1;0;0;1;1;2263;0;2263;1;1;
/org.eclipse.jdt.core/model/org/eclipse/jdt/internal/core/UserLibraryClasspathContainer.java;1;1;2;1;2;2;2;0;14;0;0;5199;14;14;1;0;0;0;2;5199;0;5225;2;1;
/org.eclipse.ui.views/src/org/eclipse/ui/views/internal/markers/problems/ProblemRegistry.java;1;0;3;1;0;0;0;3;2;2;2;265;2;2;2;1;0;3;3;265;1;728;2;1;
/org.eclipse.core.boot/src/org/eclipse/core/internal/boot/ClassloaderStats.java;2;0;3;1;0;0;0;3;67;1;3;2118;69;69;1;0;0;3;3;2118;0;3013;3;2;
/org.eclipse.jdt.core.tests.model/workspace/JavaSearch/src/ann01/XXXX.java;1;0;3;1;0;0;0;3;2;1;3;2586;2;2;1;0;0;3;3;2586;0;2661;3;1;
/org.eclipse.core.runtime/src/org/eclipse/core/runtime/IPluginEvent.java;2;0;2;1;0;0;0;2;0;1;2;2105;0;0;1;0;0;2;2;2105;0;3013;2;2;
/org.eclipse.jdt.launching/launching/org/eclipse/jdt/internal/launching/PackageFragmentRootSourceContainer.java;1;0;7;1;0;0;0;7;12;2;5;4109;35;35;2;2;0;7;7;4109;2;4971;5;1;
/org.eclipse.pde.core/src/org/eclipse/pde/internal/core/ibundle/IBundlePluginModelBase.java;1;1;2;1;2;2;2;0;6;0;0;5445;6;6;1;0;0;0;2;5445;0;6336;2;1;
/org.eclipse.pde.ui/src/org/eclipse/pde/internal/ui/editor/plugin/PluginInputContext.java;3;1;8;1;8;8;8;0;27;0;0;5431;78;78;1;0;0;0;8;5431;0;6336;8;3;
/org.eclipse.jdt.core/model/org/eclipse/jdt/internal/core/ModelUpdater.java;1;0;5;1;0;0;0;5;10;1;5;549;27;27;1;0;0;5;5;549;0;3765;5;1;
/org.eclipse.core.tests.runtime/src/org/eclipse/core/tests/internal/plugins/PluginVersionTest_2.java;1;0;1;1;0;0;0;1;0;0;1;3014;0;0;1;0;0;1;1;3014;0;3014;1;1;
/org.eclipse.osgi/resolver/src/org/eclipse/osgi/internal/resolver/HostSpecificationImpl.java;4;1;4;1;2;2;2;2;6;1;2;3013;15;15;1;0;0;2;4;3013;0;6337;4;4;
/org.eclipse.ui.workbench/Eclipse UI/org/eclipse/ui/internal/ExceptionHandler.java;4;1;5;2;3;3;3;2;234;1;2;2737;275;275;1;0;0;2;5;2737;0;6338;5;4;
/org.eclipse.jdt.core.tests.model/workspace/Converter/test0344/Test.java;1;0;1;1;0;0;0;1;0;0;1;3714;0;0;1;0;0;1;1;3714;0;3714;1;1;
/org.eclipse.jdt.ui.tests.refactoring/resources/Copy/test_fields_declared_in_multi_yes_type_1/out/A.java;1;0;3;1;0;0;0;3;2;2;2;1186;4;4;2;1;0;3;3;1186;1;1644;2;1;
/org.eclipse.jdt.core.tests.model/workspace/Formatter/test441/A_out.java;1;0;1;1;0;0;0;1;0;0;1;3513;0;0;1;0;0;1;1;3513;0;3513;1;1;
/org.eclipse.ui.workbench/Eclipse UI/org/eclipse/ui/internal/presentation/GradientDefinition.java;1;0;2;1;0;0;0;2;0;1;2;4237;0;0;1;0;0;2;2;4237;0;4392;2;1;
/org.eclipse.ui.views/src/org/eclipse/ui/views/markers/internal/IItemsChangedListener.java;2;0;2;1;0;0;0;2;0;1;2;755;0;0;1;0;0;2;2;755;0;2738;2;2;
/org.eclipse.osgi/core/framework/org/eclipse/osgi/framework/internal/core/SingleSourcePackage.java;4;1;6;1;3;3;3;3;10;1;3;3013;26;26;1;0;0;3;6;3013;0;6337;6;4;
/org.eclipse.core.resources/src/org/eclipse/core/internal/indexing/IndexedStoreObjectPolicy.java;1;0;1;1;1;1;1;0;38;0;0;5146;38;38;1;0;0;0;1;5146;0;5146;1;1;
/org.eclipse.core.runtime/src/org/eclipse/core/internal/runtime/Policy.java;2;1;7;1;2;2;2;5;178;1;5;621;388;388;1;0;0;5;7;621;0;6340;7;2;
/org.eclipse.swt/Eclipse SWT PI/carbon/org/eclipse/swt/internal/carbon/FontSelectionQDStyle.java;1;2;3;1;3;2;3;0;16;0;0;5534;20;20;2;0;1;0;3;5534;1;5614;2;1;
/org.eclipse.jdt.ui.tests.refactoring/resources/ChangeTypeRefactoring/positive/A_testReturnTypeWithCall_out.java;1;0;1;1;0;0;0;1;0;0;1;2844;0;0;1;0;0;1;1;2844;0;2844;1;1;
/org.eclipse.ui.workbench/Eclipse UI/org/eclipse/ui/dialogs/ResourceSelectionDialog.java;1;0;1;1;0;0;0;1;0;0;1;2737;0;0;1;0;0;1;1;2737;0;2737;1;1;
/org.eclipse.jdt.debug.ui/ui/org/eclipse/jdt/internal/debug/ui/jres/VMLibraryBlock.java;2;0;6;1;0;0;0;6;51;2;5;1039;84;84;2;1;0;6;6;1894;1;3203;5;2;
/org.eclipse.swt.tests/JUnit Tests/org/eclipse/swt/tests/junit/Test_org_eclipse_swt_graphics_Rectangle.java;1;0;1;1;0;0;0;1;71;0;1;2175;71;71;1;0;0;1;1;2175;0;2175;1;1;
/org.eclipse.core.tools.resources/src/org/eclipse/core/tools/metadata/DumpTool.java;1;0;1;1;1;1;1;0;0;0;0;6302;0;0;1;0;0;0;1;6302;0;6302;1;1;
/org.eclipse.core.tests.runtime/src/org/eclipse/core/tests/runtime/jobs/OrderedLockTest.java;2;0;6;1;1;1;1;5;142;1;5;850;283;283;1;0;0;5;6;850;0;5149;6;2;
/org.eclipse.jdt.core.tests.model/workspace/Converter/test0176/Test.java;1;0;1;1;0;0;0;1;0;0;1;3714;0;0;1;0;0;1;1;3714;0;3714;1;1;
/org.eclipse.ui.workbench/Eclipse UI/org/eclipse/ui/internal/csm/activities/IActivityDefinition.java;1;0;3;1;0;0;0;3;38;1;3;2225;38;38;1;0;0;3;3;2225;0;2444;3;1;
/org.eclipse.jdt.ui.tests.refactoring/resources/ExtractTemp/canExtract/A_test81_out.java;1;0;1;1;1;1;1;0;0;0;0;5911;0;0;1;0;0;0;1;5911;0;5911;1;1;
/org.eclipse.jdt.core/search/org/eclipse/jdt/internal/core/search/matching/PossibleMatch.java;4;1;14;1;3;3;3;11;33;2;10;2010;138;138;2;1;0;11;14;3149;1;6242;13;4;
/org.eclipse.ui.ide/src/org/eclipse/ui/views/bookmarkexplorer/OpenBookmarkAction.java;1;0;1;1;0;0;0;1;0;0;1;2208;0;0;1;0;0;1;1;2208;0;2208;1;1;
/org.eclipse.ui.workbench/Eclipse UI/org/eclipse/ui/internal/PerspectiveListenerList.java;2;1;2;1;2;2;2;0;24;0;0;5339;26;26;1;0;0;0;2;5339;0;6338;2;2;
/org.eclipse.core.resources/src/org/eclipse/core/internal/properties/ResourceName.java;1;0;1;1;1;1;1;0;67;0;0;5146;67;67;1;0;0;0;1;5146;0;5146;1;1;
/org.eclipse.jdt.ui/ui/org/eclipse/jdt/internal/ui/javadocexport/CreateJavadocActionDelegate.java;2;1;2;1;2;2;2;0;27;0;0;5710;29;29;1;0;0;0;2;5710;0;6340;2;2;
/org.eclipse.core.tests.resources/src/org/eclipse/core/tests/internal/resources/ModelObjectReaderWriterTest.java;3;2;5;1;4;3;4;1;1385;0;1;4085;1403;1403;2;0;1;1;5;5147;1;5168;4;3;
/org.eclipse.ui.ide/src/org/eclipse/ui/IFileEditorInput.java;2;0;3;1;0;0;0;3;5;1;3;1511;5;5;1;0;0;3;3;1511;0;2263;3;2;
/org.eclipse.team.ui/src/org/eclipse/team/ui/synchronize/ISynchronizePageConfiguration.java;2;1;7;1;6;6;6;1;404;0;1;5039;488;488;1;0;0;1;7;5039;0;6337;7;2;
/org.eclipse.debug.core/core/org/eclipse/debug/core/IExpressionManager.java;2;1;6;1;2;2;2;4;16;1;4;1516;62;62;1;0;0;4;6;1516;0;5635;6;2;
/org.eclipse.swt.tests/JUnit Tests/org/eclipse/swt/tests/junit/Test_org_eclipse_swt_dnd_TextTransfer.java;1;0;1;1;0;0;0;1;12;0;1;2176;12;12;1;0;0;1;1;2176;0;2176;1;1;
/org.eclipse.jdt.debug/jdi/org/eclipse/jdi/internal/LocationImpl.java;1;0;1;1;0;0;0;1;19;0;1;566;19;19;1;0;0;1;1;566;0;566;1;1;
/org.eclipse.pde.ui/src_Forms/org/eclipse/pde/internal/ui/neweditor/site/ArchiveSection.java;3;1;4;1;2;2;2;2;188;1;2;4832;190;190;1;0;0;2;4;4832;0;5431;4;3;
/org.eclipse.update.tests.core/src/org/eclipse/update/tests/api/TestSiteManagerAPI.java;2;0;4;1;1;1;1;3;6;1;3;3813;16;16;1;0;0;3;4;3813;0;6336;4;2;
/org.eclipse.ui.workbench/Eclipse UI/org/eclipse/ui/internal/roles/api/IRole.java;1;0;2;1;0;0;0;2;0;0;1;2202;0;0;2;1;0;2;2;2202;1;2202;1;1;
/org.eclipse.search/new search/org/eclipse/search/ui/text/ISearchEditorAccess.java;2;1;3;1;3;3;3;0;14;0;0;5815;21;21;1;0;0;0;3;5815;0;5917;3;2;
/org.eclipse.jdt.core/compiler/org/eclipse/jdt/internal/compiler/ast/QualifiedTypeReference.java;2;0;3;1;0;0;0;3;91;1;3;991;99;99;1;0;0;3;3;991;0;3560;3;2;
/org.eclipse.core.resources/src/org/eclipse/core/internal/resources/AutoBuildJob.java;1;0;11;1;0;0;0;11;190;2;9;629;435;435;2;2;0;11;11;1541;2;2057;9;1;
/org.eclipse.pde.ui/src/org/eclipse/pde/internal/ui/editor/plugin/BundleInputContext.java;3;2;8;1;8;7;8;0;82;0;0;5431;143;143;2;0;1;0;8;5450;1;6336;7;3;
/org.eclipse.jdt.ui/ui/org/eclipse/jdt/internal/ui/callhierarchy/RefreshAction.java;3;1;5;1;2;2;2;3;5;1;3;155;13;13;1;0;0;3;5;155;0;6340;5;3;
/org.eclipse.osgi/eclipseAdaptor/src/org/eclipse/core/runtime/adaptor/BasicLocation.java;5;2;23;2;11;9;11;12;80;2;10;4113;461;461;2;2;2;12;23;4113;4;6133;19;5;
/org.eclipse.update/src/org/eclipse/update/internal/ui/UMWizardProductComponentURLInstall.java;1;0;1;1;1;1;1;0;0;0;0;6339;0;0;1;0;0;0;1;6339;0;6339;1;1;
/org.eclipse.core.filebuffers/src/org/eclipse/core/filebuffers/IFileBufferManager.java;2;2;11;2;3;2;3;8;96;1;8;1522;360;360;2;0;1;8;11;6333;1;6333;10;2;
/org.eclipse.ui.workbench/Eclipse UI/org/eclipse/ui/internal/progress/ProgressAnimationProcessor.java;2;0;3;1;1;1;1;2;9;1;2;4427;11;11;1;0;0;2;3;4427;0;6145;3;2;
/org.eclipse.jdt.core.tests.model/workspace/Converter/src/junit/extensions/ActiveTestSuite.java;1;0;1;1;0;0;0;1;0;0;1;3714;0;0;1;0;0;1;1;3714;0;3714;1;1;
/org.eclipse.jdt.core.tests.compiler/src/org/eclipse/jdt/core/tests/eval/target/CodeSnippetRunner.java;3;0;3;1;1;1;1;2;103;1;2;993;107;107;1;0;0;2;3;993;0;5853;3;3;
/org.eclipse.ui.workbench/Eclipse UI/org/eclipse/ui/commands/internal/Manager.java;1;0;2;1;0;0;0;2;0;1;2;786;0;0;1;0;0;2;2;786;0;956;2;1;
/org.eclipse.debug.ui/ui/org/eclipse/debug/ui/launchVariables/FolderPromptExpander.java;1;0;2;1;0;0;0;2;0;1;2;550;0;0;1;0;0;2;2;550;0;562;2;1;
/org.eclipse.jdt.core.tests.model/workspace/Converter/src/javadoc/test013/Test.java;1;0;2;1;0;0;0;2;2;1;2;3890;2;2;1;0;0;2;2;3890;0;3899;2;1;
/org.eclipse.jdt.core.tests.model/workspace/Converter/src/test0349/Test2.java;1;0;1;1;0;0;0;1;0;0;1;3714;0;0;1;0;0;1;1;3714;0;3714;1;1;
/org.eclipse.swt/Eclipse SWT/win32/org/eclipse/swt/widgets/TableColumn.java;2;0;5;1;1;1;1;4;26;1;4;268;64;64;1;0;0;4;5;268;0;6352;5;2;
/org.eclipse.jdt.ui.tests.refactoring/resources/ExtractMethodWorkSpace/ExtractMethodTests/wiki_in/A_test2002.java;1;0;1;1;0;0;0;1;4;0;1;844;4;4;1;0;0;1;1;844;0;844;1;1;
/org.eclipse.update.ui/src/org/eclipse/update/internal/ui/wizards/IDynamicPage.java;2;0;5;1;1;1;1;4;9;1;4;755;20;20;1;0;0;4;5;755;0;6336;5;2;
/org.eclipse.team.cvs.ui/src/org/eclipse/team/internal/ccvs/ui/wizards/CheckoutIntoProjectSelectionPage.java;1;0;1;1;0;0;0;1;0;0;1;851;0;0;1;0;0;1;1;851;0;851;1;1;
/org.eclipse.swt/Eclipse SWT/gtk/org/eclipse/swt/widgets/Shell.java;6;2;51;3;16;14;16;35;143;3;27;70;977;977;3;8;2;35;51;1275;10;6362;41;6;
/org.eclipse.jdt.core.tests.model/workspace/Converter/src/javadoc/test018/TestD1.java;1;0;2;1;0;0;0;2;0;1;2;4311;0;0;1;0;0;2;2;4311;0;4390;2;1;
/org.eclipse.ui.views/src/org/eclipse/ui/views/internal/table/TableViewLabelProvider.java;1;0;2;1;0;0;0;2;0;0;1;749;0;0;2;1;0;2;2;749;1;749;1;1;
/org.eclipse.ui.views/src/org/eclipse/ui/views/navigator/IResourceNavigator.java;1;0;1;1;0;0;0;1;0;0;1;2738;0;0;1;0;0;1;1;2738;0;2738;1;1;
/org.eclipse.ui.workbench/Eclipse UI/org/eclipse/ui/internal/roles/IRoleDefinition.java;1;0;3;1;0;0;0;3;6;1;3;2444;6;6;1;0;0;3;3;2444;0;2864;3;1;
/org.eclipse.swt.graphics.text/Eclipse SWT Custom Widgets/common/org/eclipse/swt/custom/StyleRange.java;1;0;3;1;0;0;0;3;2;1;3;4394;4;4;1;0;0;3;3;4394;0;4830;3;1;
/org.eclipse.ui.views/src/org/eclipse/ui/views/internal/markers/bookmarks/BookmarkFilter.java;1;0;3;1;0;0;0;3;128;1;3;265;128;128;1;0;0;3;3;265;0;749;3;1;
/org.eclipse.team.core/src/org/eclipse/team/core/subscribers/SynchronizationSyncBytesCache.java;1;0;1;1;0;0;0;1;0;0;1;3193;0;0;1;0;0;1;1;3193;0;3193;1;1;
/org.eclipse.pde.build/src_ant/org/eclipse/pde/internal/build/tasks/BuildScriptGeneratorTask.java;2;3;12;2;4;2;4;8;158;1;8;447;889;889;3;0;2;8;12;6336;2;6336;10;2;
/org.eclipse.core.runtime/src/org/eclipse/core/runtime/registry/IRegistryChangeListener.java;4;0;6;2;0;0;0;6;86;2;5;2105;178;178;2;1;0;6;6;3164;1;3164;5;4;
/org.eclipse.jdt.ui.tests.refactoring/resources/ChangeTypeRefactoring/positive/A_testMultiCUInterface2.java;1;0;1;1;0;0;0;1;0;0;1;2844;0;0;1;0;0;1;1;2844;0;2844;1;1;
/org.eclipse.debug.core/core/org/eclipse/debug/core/ILaunchMode.java;1;0;1;1;1;1;1;0;0;0;0;5106;0;0;1;0;0;0;1;5106;0;5106;1;1;
/org.eclipse.swt/Eclipse SWT/gtk1x/org/eclipse/swt/widgets/TabItem.java;1;0;1;1;0;0;0;1;0;0;1;2327;0;0;1;0;0;1;1;2327;0;2327;1;1;
/org.eclipse.jdt.core.tests.model/workspace/Formatter/test251/A_in.java;1;0;1;1;0;0;0;1;0;0;1;2442;0;0;1;0;0;1;1;2442;0;2442;1;1;
/org.eclipse.jdt.core.tests.model/workspace/Converter/test0439/E.java;1;0;1;1;0;0;0;1;0;0;1;3714;0;0;1;0;0;1;1;3714;0;3714;1;1;
/org.eclipse.core.runtime/src/org/eclipse/core/internal/jobs/Queue.java;3;0;8;1;1;1;1;7;472;1;7;351;1204;1204;1;0;0;7;8;351;0;5150;8;3;
/org.eclipse.ui.workbench/Eclipse UI/org/eclipse/ui/internal/chris/roles/api/IRole.java;1;0;2;1;0;0;0;2;0;0;1;2207;0;0;2;1;0;2;2;2207;1;2207;1;1;
/org.eclipse.pde.core/src/org/eclipse/pde/internal/core/ibundle/IBundlePlugin.java;1;1;2;1;2;2;2;0;4;0;0;5445;4;4;1;0;0;0;2;5445;0;6336;2;1;
/org.eclipse.jdt.core/model/org/eclipse/jdt/internal/core/CreateCompilationUnitOperation.java;3;0;9;1;0;0;0;9;16;2;8;2722;52;52;2;1;0;9;9;3509;1;4731;8;3;
/org.eclipse.jdt.ui.tests.refactoring/resources/ExtractMethodWorkSpace/ExtractMethodTests/expression_in/A_test603.java;1;0;1;1;0;0;0;1;2;0;1;844;2;2;1;0;0;1;1;844;0;844;1;1;
/org.eclipse.ui.workbench/Eclipse UI/org/eclipse/ui/IPersistableElement.java;1;0;1;1;0;0;0;1;4;0;1;1;4;4;1;0;0;1;1;1;0;1;1;1;
/org.eclipse.jdt.ui.tests.refactoring/resources/MoveInstanceMethod/canMove/test18/in/Rectangle.java;1;0;1;1;0;0;0;1;0;0;1;1570;0;0;1;0;0;1;1;1570;0;1570;1;1;
/org.eclipse.ui.workbench/Eclipse UI/org/eclipse/ui/internal/WorkbenchWindowConfigurer.java;8;2;24;1;10;9;10;14;425;1;14;1259;870;870;2;0;1;14;24;5565;1;6338;23;8;
/org.eclipse.jdt.core/model/org/eclipse/jdt/core/IJavaModelStatus.java;1;0;1;1;0;0;0;1;2;0;1;3560;2;2;1;0;0;1;1;3560;0;3560;1;1;
/org.eclipse.ui.workbench/Eclipse UI/org/eclipse/ui/internal/chris/roles/Role.java;1;0;4;1;0;0;0;4;16;3;2;1952;16;16;3;2;0;4;4;2202;2;2202;2;1;
/org.eclipse.jdt.core.tests.model/workspace/Formatter/test146/A_in.java;1;0;1;1;0;0;0;1;0;0;1;2425;0;0;1;0;0;1;1;2425;0;2425;1;1;
/org.eclipse.jdt.ui.tests.refactoring/resources/SurroundWithWorkSpace/SurroundWithTests/trycatch_in/TestNested.java;1;0;1;1;0;0;0;1;2;0;1;845;2;2;1;0;0;1;1;845;0;845;1;1;
/org.eclipse.core.tests.resources/src/org/eclipse/core/tests/resources/usecase/IFileTest.java;1;0;1;1;1;1;1;0;352;0;0;5147;352;352;1;0;0;0;1;5147;0;5147;1;1;
/org.eclipse.jdt.ui.tests.refactoring/resources/ExtractMethodWorkSpace/ExtractMethodTests/duplicates_out/A_test961.java;1;1;2;1;2;2;2;0;2;0;0;5650;2;2;1;0;0;0;2;5650;0;5681;2;1;
/org.eclipse.pde.core/src/org/eclipse/pde/internal/core/schema/SchemaAttribute.java;2;1;3;1;2;2;2;1;60;0;1;4203;66;66;1;0;0;1;3;4203;0;6336;3;2;
/org.eclipse.ui.ide/extensions/org/eclipse/ui/actions/OpenSystemEditorAction.java;1;0;2;1;0;0;0;2;2;1;2;2263;2;2;1;0;0;2;2;2263;0;2611;2;1;
/org.eclipse.jdt.debug.ui/ui/org/eclipse/jdt/internal/debug/ui/HotCodeReplaceErrorDialog.java;2;0;2;1;0;0;0;2;40;1;2;2064;40;40;1;0;0;2;2;2064;0;4352;2;2;
/org.eclipse.swt.tests/JUnit Tests/org/eclipse/swt/tests/junit/Test_org_eclipse_swt_layout_FillLayout.java;2;0;2;1;0;0;0;2;19;1;2;2144;26;26;1;0;0;2;2;2144;0;2176;2;2;
/org.eclipse.jdt.core.tests.compiler/src/org/eclipse/jdt/core/tests/util/Util.java;4;0;10;1;1;1;1;9;87;2;8;1111;276;276;2;1;0;9;10;2007;1;5853;9;4;
/org.eclipse.jdt.ui.tests.refactoring/resources/PushDown/testEnablement2/in/A.java;1;0;1;1;0;0;0;1;0;0;1;1312;0;0;1;0;0;1;1;1312;0;1312;1;1;
/org.eclipse.jface.text/src/org/eclipse/jface/text/IViewportListener.java;2;1;3;1;3;3;3;0;17;0;0;5106;21;21;1;0;0;0;3;5106;0;6359;3;2;
/org.eclipse.jdt.ui/core refactoring/org/eclipse/jdt/internal/corext/refactoring/participants/xml/JavaElementPropertyTester.java;1;0;4;1;0;0;0;4;59;1;4;1271;77;77;1;0;0;4;4;1271;0;2546;4;1;
/org.eclipse.pde.core/src/org/eclipse/pde/core/build/IBuildModel.java;2;1;4;1;3;3;3;1;24;0;1;4203;33;33;1;0;0;1;4;4203;0;6336;4;2;
/org.eclipse.jdt.core.tests.model/workspace/Converter/test0421/A.java;1;0;1;1;0;0;0;1;0;0;1;3714;0;0;1;0;0;1;1;3714;0;3714;1;1;
/org.eclipse.jdt.debug/eval/org/eclipse/jdt/internal/debug/eval/ast/engine/EvaluationSourceGenerator.java;4;1;8;1;3;3;3;5;8;1;5;1240;38;38;1;0;0;5;8;1240;0;6336;8;4;
/org.eclipse.team.ui/src/org/eclipse/team/internal/ui/sync/pages/SubscriberSynchronizeViewPage.java;1;0;1;1;0;0;0;1;0;0;1;2406;0;0;1;0;0;1;1;2406;0;2406;1;1;
/org.eclipse.jdt.debug.tests/tests/org/eclipse/jdt/debug/tests/eval/TypeHierarchy_32_6.java;1;0;1;1;0;0;0;1;6;0;1;1274;6;6;1;0;0;1;1;1274;0;1274;1;1;
/org.eclipse.webdav/src/client/org/eclipse/webdav/internal/authentication/Base64Encoder.java;1;0;2;1;2;1;2;0;25;0;0;5151;25;25;2;0;1;0;2;5151;1;5151;1;1;
/org.eclipse.jface.text/src/org/eclipse/jface/text/reconciler/AbstractReconciler.java;3;2;13;1;8;6;8;5;58;1;5;708;166;166;2;0;2;5;13;5731;2;6353;11;3;
/org.eclipse.team.examples.filesystem/src/org/eclipse/team/examples/pessimistic/ui/BlankPage.java;1;0;2;1;1;1;1;1;38;0;1;3368;38;38;1;0;0;1;2;3368;0;6103;2;1;
/org.eclipse.swt/Eclipse SWT PI/motif/org/eclipse/swt/internal/motif/XRectangle.java;1;0;1;1;0;0;0;1;8;0;1;829;8;8;1;0;0;1;1;829;0;829;1;1;
/org.eclipse.pde.ui/src/org/eclipse/pde/internal/ui/editor/plugin/AlertSection.java;2;1;4;1;4;4;4;0;10;0;0;5431;19;19;1;0;0;0;4;5431;0;6336;4;2;
/org.eclipse.ui.ide/src/org/eclipse/ui/views/navigator/NavigatorFrameSource.java;1;0;1;1;0;0;0;1;0;0;1;2208;0;0;1;0;0;1;1;2208;0;2208;1;1;
/org.eclipse.jdt.core/eval/org/eclipse/jdt/internal/eval/CodeSnippetEvaluator.java;3;0;5;1;1;1;1;4;12;1;4;25;20;20;1;0;0;4;5;25;0;5916;5;3;
/org.eclipse.jdt.core/model/org/eclipse/jdt/internal/core/util/AnonymousFileSource.java;3;0;3;1;0;0;0;3;4;1;3;1114;7;7;1;0;0;3;3;1114;0;3560;3;3;
/org.eclipse.jdt.core/compiler/org/eclipse/jdt/internal/compiler/Compiler.java;4;3;16;2;5;3;5;11;56;1;11;30;226;226;3;0;2;11;16;5608;2;5871;14;4;
/org.eclipse.team.webdav/src/org/eclipse/team/internal/ui/target/subscriber/ImportTargetSelectionPage.java;2;0;3;1;1;1;1;2;29;1;2;3805;31;31;1;0;0;2;3;3805;0;6337;3;2;
/org.eclipse.ui.workbench/Eclipse UI/org/eclipse/ui/internal/csm/activities/ActivityPatternBindingDefinition.java;1;0;5;1;0;0;0;5;93;2;4;2225;93;93;2;1;0;5;5;2412;1;2444;4;1;
/org.eclipse.jdt.ui.tests.refactoring/resources/MoveMembers/test31/in/B.java;1;0;1;1;0;0;0;1;0;0;1;1651;0;0;1;0;0;1;1;1651;0;1651;1;1;
/org.eclipse.ui.workbench/Eclipse UI/org/eclipse/ui/internal/dialogs/ZipFileResourceExportOperation.java;1;0;1;1;0;0;0;1;0;0;1;2737;0;0;1;0;0;1;1;2737;0;2737;1;1;
/org.eclipse.jdt.core.tests.model/workspace/Converter/src/test0381/A.java;1;0;1;1;0;0;0;1;0;0;1;3714;0;0;1;0;0;1;1;3714;0;3714;1;1;
/org.eclipse.core.runtime/src/org/eclipse/core/internal/locks/Semaphore.java;1;0;1;1;0;0;0;1;0;0;1;320;0;0;1;0;0;1;1;320;0;320;1;1;
/org.eclipse.jdt.core.tests.model/workspace/Formatter/test284/A_out.java;1;0;1;1;0;0;0;1;0;0;1;2443;0;0;1;0;0;1;1;2443;0;2443;1;1;
/org.eclipse.jdt.ui.tests.refactoring/resources/TypeConstraints/A_testBad1.java;1;0;2;1;0;0;0;2;0;1;2;53;0;0;1;0;0;2;2;53;0;74;2;1;
/org.eclipse.jdt.ui.tests.refactoring/resources/Delete/testDeleteWithinCu11/out/A.java;1;0;1;1;0;0;0;1;0;0;1;442;0;0;1;0;0;1;1;442;0;442;1;1;
/org.eclipse.pde.ui/src_Forms/org/eclipse/pde/internal/ui/neweditor/manifest/JavaAttributeWizardPage.java;2;0;5;1;1;1;1;4;66;2;3;4952;105;105;2;1;0;4;5;4952;1;5431;4;2;
/org.eclipse.jdt.core.tests.model/workspace/Converter/src/test0459/A.java;1;0;1;1;0;0;0;1;0;0;1;3714;0;0;1;0;0;1;1;3714;0;3714;1;1;
/org.eclipse.core.runtime/src/org/eclipse/core/internal/plugins/DefaultPlugin.java;1;0;1;1;0;0;0;1;0;0;1;3013;0;0;1;0;0;1;1;3013;0;3013;1;1;
/org.eclipse.pde.ui/src_Forms/org/eclipse/pde/internal/ui/neweditor/plugin/GeneralInfoSection.java;3;2;24;1;6;5;6;18;381;4;12;4243;1318;1318;4;6;1;18;24;4537;7;5431;17;3;
/org.eclipse.jdt.ui.tests.refactoring/resources/InlineMethodWorkspace/TestCases/cast_in/TestOverloaded.java;1;0;1;1;0;0;0;1;0;0;1;955;0;0;1;0;0;1;1;955;0;955;1;1;
/org.eclipse.ui.ide/src/org/eclipse/ui/actions/WorkspaceModifyOperation.java;2;0;3;1;0;0;0;3;4;1;3;1511;4;4;1;0;0;3;3;1511;0;2263;3;2;
/org.eclipse.ui.workbench/Eclipse UI/org/eclipse/ui/internal/activities/ActivityActivityBinding.java;4;0;5;1;1;1;1;4;4;1;4;2896;6;6;1;0;0;4;5;2896;0;5760;5;4;
/org.eclipse.ui.editors/src/org/eclipse/ui/texteditor/BookmarkRulerAction.java;2;0;3;1;1;1;1;2;31;1;2;1983;39;39;1;0;0;2;3;1983;0;6334;3;2;
/org.eclipse.jdt.ui.tests.refactoring/resources/MoveInstanceMethod/canMove/test19/out/Rectangle.java;1;0;1;1;0;0;0;1;0;0;1;1570;0;0;1;0;0;1;1;1570;0;1570;1;1;
/org.eclipse.debug.ui/ui/org/eclipse/debug/internal/ui/actions/RemoveAllTerminatedAction.java;2;1;2;1;2;2;2;0;5;0;0;5634;9;9;1;0;0;0;2;5634;0;6336;2;2;
/org.eclipse.ltk.ui.refactoring/src/org/eclipse/ltk/internal/ui/refactoring/InternalAPI.java;1;1;3;1;2;2;2;1;2;0;1;5052;3;3;1;0;0;1;3;5052;0;6340;3;1;
/org.eclipse.jdt.debug.tests/test plugin/org/eclipse/jdt/debug/testplugin/DebugEventWaiter.java;3;0;3;1;0;0;0;3;10;1;3;995;16;16;1;0;0;3;3;995;0;1610;3;3;
/org.eclipse.ui.workbench/Eclipse UI/org/eclipse/ui/internal/commands/ActionHandler.java;2;0;15;1;0;0;0;15;23;2;14;1065;101;101;2;1;0;15;15;2562;1;4088;14;2;
/org.eclipse.core.runtime/src/org/eclipse/core/runtime/IExtension.java;4;2;11;1;4;3;4;7;135;1;7;3013;254;254;2;0;1;7;11;5117;1;6363;10;4;
/org.eclipse.jdt.core.tests.compiler/src/org/eclipse/jdt/core/tests/compiler/parser/LabelStatementCompletionTest.java;1;0;3;1;0;0;0;3;3;1;3;989;7;7;1;0;0;3;3;989;0;3560;3;1;
/org.eclipse.jdt.ui.tests.refactoring/resources/InlineMethodWorkspace/TestCases/simple_out/TestFieldInitializer2.java;1;0;1;1;0;0;0;1;0;0;1;2281;0;0;1;0;0;1;1;2281;0;2281;1;1;
/org.eclipse.jdt.debug.ui/ui/org/eclipse/jdt/internal/debug/ui/ActionFilterAdapterFactory.java;1;0;1;1;0;0;0;1;2;0;1;1516;2;2;1;0;0;1;1;1516;0;1516;1;1;
/org.eclipse.update.ui/src/org/eclipse/update/internal/ui/wizards/MultiOptionalFeaturesPage.java;1;0;1;1;0;0;0;1;0;0;1;755;0;0;1;0;0;1;1;755;0;755;1;1;
/org.eclipse.update.core/src/org/eclipse/update/internal/standalone/UpdateCommand.java;3;0;12;1;0;0;0;12;90;2;11;828;255;255;2;1;0;12;12;4585;1;4928;11;3;
/org.eclipse.compare.examples/src/org/eclipse/compare/examples/structurecreator/KeyValuePairStructureCreator.java;1;0;3;1;0;0;0;3;7;1;3;1326;12;12;1;0;0;3;3;1326;0;3938;3;1;
/org.eclipse.team.webdav/src/org/eclipse/team/internal/target/subscriber/TargetDeploymentProvider.java;2;1;6;1;2;2;2;4;157;1;4;3494;204;204;1;0;0;4;6;3494;0;6337;6;2;
/org.eclipse.ant.ui/Ant Editor/org/eclipse/ant/ui/internal/dtd/schema/Schema.java;1;0;2;1;0;0;0;2;0;1;2;250;0;0;1;0;0;2;2;250;0;1811;2;1;
/org.eclipse.pde.core/src/org/eclipse/pde/internal/core/osgi/bundle/BundlePluginModel.java;1;0;2;1;1;1;1;1;0;0;1;4203;0;0;1;0;0;1;2;4203;0;5445;2;1;
/org.eclipse.debug.core/core/org/eclipse/debug/internal/core/sourcelookup/SourceLookupMessages.java;2;0;2;2;0;0;0;2;4;0;1;3678;4;4;2;1;0;2;2;3678;1;3678;1;2;
/org.eclipse.jdt.core/compiler/org/eclipse/jdt/internal/compiler/ast/CastExpression.java;3;0;23;2;1;1;1;22;196;3;16;592;647;647;3;6;0;22;23;1169;6;5615;17;3;
/org.eclipse.jdt.debug.tests/testprograms/WatchItemTests.java;1;0;1;1;0;0;0;1;0;0;1;1794;0;0;1;0;0;1;1;1794;0;1794;1;1;
/org.eclipse.jdt.debug.tests/test plugin/org/eclipse/jdt/debug/testplugin/EmptyClasspathProvider.java;1;0;1;1;0;0;0;1;5;0;1;2497;5;5;1;0;0;1;1;2497;0;2497;1;1;
/org.eclipse.ui.ide/src/org/eclipse/ui/internal/ide/model/WorkbenchAdapterBuilder.java;1;0;1;1;0;0;0;1;0;0;1;2264;0;0;1;0;0;1;1;2264;0;2264;1;1;
/org.eclipse.core.tests.runtime/src/org/eclipse/core/tests/runtime/content/XMLContentDescriberTest.java;3;1;4;1;4;4;4;0;8;0;0;5185;16;16;1;0;0;0;4;5185;0;6206;4;3;
/org.eclipse.ui.views/src/org/eclipse/ui/views/tasklist/MarkerType.java;1;0;1;1;0;0;0;1;0;0;1;2738;0;0;1;0;0;1;1;2738;0;2738;1;1;
/org.eclipse.debug.ui/ui/org/eclipse/debug/ui/variables/SpecificFolderResourceComponent.java;1;0;4;1;0;0;0;4;109;3;2;316;109;109;3;2;0;4;4;316;2;550;2;1;
/org.eclipse.debug.ui/ui/org/eclipse/debug/internal/ui/actions/StatusInfo.java;1;0;1;1;0;0;0;1;0;0;1;1516;0;0;1;0;0;1;1;1516;0;1516;1;1;
/org.eclipse.jdt.core/antadapter/org/eclipse/jdt/internal/antadapter/AntAdapterMessages.java;1;0;2;1;0;0;0;2;2;1;2;3194;2;2;1;0;0;2;2;3194;0;3560;2;1;
/org.eclipse.core.tests.resources/src/org/eclipse/core/tests/resources/usecase/ConcurrentOperation.java;1;2;3;1;3;2;3;0;217;0;0;5147;220;220;2;0;1;0;3;5147;1;5686;2;1;
/org.eclipse.help.base/src/org/eclipse/help/internal/search/QueryWordsPhrase.java;1;1;4;1;3;3;3;1;14;0;1;1740;24;24;1;0;0;1;4;1740;0;6337;4;1;
/org.eclipse.jface.text/src/org/eclipse/jface/text/contentassist/JFaceTextMessages.java;1;1;2;1;2;2;2;0;9;0;0;6340;11;11;1;0;0;0;2;6340;0;6353;2;1;
/org.eclipse.ui.examples.javaeditor/Eclipse Java Editor Example/org/eclipse/ui/examples/javaeditor/spelling/PlatformSpellDictionary.java;1;0;1;1;0;0;0;1;0;0;1;2565;0;0;1;0;0;1;1;2565;0;2565;1;1;
/org.eclipse.jdt.debug/jdi/org/eclipse/jdi/internal/event/VMDeathEventImpl.java;1;0;1;1;0;0;0;1;3;0;1;2497;3;3;1;0;0;1;1;2497;0;2497;1;1;
/org.eclipse.jdt.core/search/org/eclipse/jdt/internal/core/search/indexing/AddFileToIndex.java;2;0;2;1;0;0;0;2;2;1;2;937;2;2;1;0;0;2;2;937;0;3211;2;2;
/org.eclipse.ui.workbench/Eclipse UI/org/eclipse/ui/commands/NotDelegatedException.java;1;0;2;1;0;0;0;2;0;1;2;1321;0;0;1;0;0;2;2;1321;0;1341;2;1;
/org.eclipse.jdt.ui/ui/org/eclipse/jdt/internal/ui/text/java/JavaCodeScanner.java;3;1;8;1;4;4;4;4;149;1;4;1586;384;384;1;0;0;4;8;1586;0;6340;8;3;
/org.eclipse.ui.workbench/Eclipse UI/org/eclipse/ui/internal/csm/commands/api/IKeyConfigurationListener.java;1;0;2;1;0;0;0;2;0;1;2;2532;0;0;1;0;0;2;2;2532;0;2562;2;1;
/org.eclipse.pde.ui/src/org/eclipse/pde/internal/ui/wizards/feature/BasePluginListPage.java;2;1;2;1;2;2;2;0;4;0;0;5563;4;4;1;0;0;0;2;5563;0;6336;2;2;
/org.eclipse.ui.forms/src/org/eclipse/ui/forms/widgets/ImageHyperlink.java;1;1;8;1;2;2;2;6;51;2;5;4068;108;108;2;1;0;6;8;4212;1;6255;7;1;
/org.eclipse.jdt.core/model/org/eclipse/jdt/internal/core/builder/BuildNotifier.java;2;0;3;1;0;0;0;3;6;1;3;110;10;10;1;0;0;3;3;110;0;3560;3;2;
/org.eclipse.core.runtime/src/org/eclipse/core/internal/plugins/ExtensionPointWrapper.java;2;0;3;1;0;0;0;3;2;1;3;2105;2;2;1;0;0;3;3;2105;0;3013;3;2;
/org.eclipse.ui.workbench/Eclipse UI/org/eclipse/ui/internal/commands/util/old/KeyFilter.java;1;0;3;1;0;0;0;3;15;1;3;1264;15;15;1;0;0;3;3;1264;0;1322;3;1;
/org.eclipse.team.ui/src/org/eclipse/team/internal/ui/widgets/SelectableControl.java;1;0;1;1;0;0;0;1;0;0;1;3171;0;0;1;0;0;1;1;3171;0;3171;1;1;
/org.eclipse.jdt.text.tests/src/org/eclipse/jdt/text/tests/JavaDoc2HTMLTextReaderTester.java;1;1;2;1;2;2;2;0;2;0;0;5129;2;2;1;0;0;0;2;5129;0;6340;2;1;
/org.eclipse.ltk.ui.refactoring/src/org/eclipse/ltk/internal/ui/refactoring/IPreviewWizardPage.java;1;0;2;1;1;1;1;1;2;0;1;4965;2;2;1;0;0;1;2;4965;0;6340;2;1;
/org.eclipse.jdt.ui.tests.refactoring/resources/Copy/test_field_declared_in_multi_yes_type/in/A.java;1;0;1;1;0;0;0;1;0;0;1;685;0;0;1;0;0;1;1;685;0;685;1;1;
/org.eclipse.jdt.core.tests.model/workspace/Formatter/test499/A_in.java;1;0;1;1;1;1;1;0;0;0;0;5624;0;0;1;0;0;0;1;5624;0;5624;1;1;
/org.eclipse.core.tests.runtime/src/org/eclipse/core/tests/internal/plugins/SoftPrereqTest_11.java;1;0;1;1;0;0;0;1;0;0;1;3014;0;0;1;0;0;1;1;3014;0;3014;1;1;
/org.eclipse.team.cvs.ssh2/src/org/eclipse/team/ccvs/ssh2/CVSSSH2ServerConnection.java;3;0;9;2;0;0;0;9;172;2;8;2956;393;393;2;1;0;9;9;3027;1;4825;8;3;
/org.eclipse.pde.core/src/org/eclipse/pde/internal/core/ibundle/IBundle.java;1;1;2;1;2;2;2;0;10;0;0;5454;10;10;1;0;0;0;2;5454;0;6336;2;1;
/org.eclipse.ui.externaltools/External Tools Base/org/eclipse/ui/externaltools/internal/model/VariableContextManager.java;1;0;1;1;0;0;0;1;0;0;1;321;0;0;1;0;0;1;1;321;0;321;1;1;
/org.eclipse.ant.ui/Ant Tools Support/org/eclipse/ant/ui/internal/model/AntImageDescriptor.java;1;0;2;1;0;0;0;2;0;1;2;264;0;0;1;0;0;2;2;264;0;1811;2;1;
/org.eclipse.jdt.core.tests.model/workspace/Converter/src/junit/framework/TestCase.java;1;0;1;1;0;0;0;1;0;0;1;3714;0;0;1;0;0;1;1;3714;0;3714;1;1;
/org.eclipse.ui.externaltools/Ant Tools Support/org/eclipse/ui/externaltools/internal/ant/preferences/IAntBlockContainer.java;1;0;1;1;0;0;0;1;0;0;1;282;0;0;1;0;0;1;1;282;0;282;1;1;
/org.eclipse.jdt.core/search/org/eclipse/jdt/internal/core/search/IndexSearchAdapter.java;2;0;2;1;0;0;0;2;11;1;2;1893;11;11;1;0;0;2;2;1893;0;3384;2;2;
/org.eclipse.jdt.ui.tests.refactoring/resources/ExtractMethodWorkSpace/ExtractMethodTests/locals_in/A_test542.java;1;0;1;1;0;0;0;1;2;0;1;844;2;2;1;0;0;1;1;844;0;844;1;1;
/org.eclipse.swt/Eclipse SWT/carbon/org/eclipse/swt/widgets/Widget.java;5;2;32;2;3;2;3;29;112;2;28;17;683;683;2;1;1;29;32;4216;2;6352;30;5;
/org.eclipse.ui.ide/src/org/eclipse/ui/views/bookmarkexplorer/BookmarkAction.java;1;0;1;1;0;0;0;1;0;0;1;2208;0;0;1;0;0;1;1;2208;0;2208;1;1;
/org.eclipse.pde.ui/src/org/eclipse/pde/internal/ui/wizards/project/ProjectStructurePage.java;3;0;10;1;0;0;0;10;181;1;10;368;280;280;1;0;0;10;10;368;0;3840;10;3;
/org.eclipse.debug.ui/ui/org/eclipse/debug/internal/ui/views/launch/LaunchViewEventHandler.java;5;1;20;1;4;4;4;16;31;2;15;122;242;242;2;1;0;16;20;982;1;6336;19;5;
/org.eclipse.jdt.core.tests.model/workspace/Converter/test0041/Test.java;1;0;1;1;0;0;0;1;0;0;1;3714;0;0;1;0;0;1;1;3714;0;3714;1;1;
/org.eclipse.core.tests.runtime/src/org/eclipse/core/tests/internal/plugins/PluginResolveTest_9.java;1;0;1;1;0;0;0;1;0;0;1;3014;0;0;1;0;0;1;1;3014;0;3014;1;1;
/org.eclipse.compare/compare/org/eclipse/compare/structuremergeviewer/DocumentRangeNode.java;1;0;4;1;0;0;0;4;17;1;4;1289;32;32;1;0;0;4;4;1289;0;3954;4;1;
/org.eclipse.ui.ide/src/org/eclipse/ui/actions/AddBookmarkAction.java;2;0;7;1;0;0;0;7;21;1;7;1511;34;34;1;0;0;7;7;1511;0;2263;7;2;
/org.eclipse.team.ui/src/org/eclipse/team/ui/synchronize/views/TeamOperationInput.java;1;0;1;1;0;0;0;1;0;0;1;3764;0;0;1;0;0;1;1;3764;0;3764;1;1;
/org.eclipse.ui.workbench.texteditor/src/org/eclipse/ui/texteditor/IElementStateListenerExtension.java;2;0;2;2;2;1;2;0;4;0;0;6334;4;4;2;0;1;0;2;6334;1;6334;1;2;
/org.eclipse.ui.workbench/Eclipse UI/org/eclipse/ui/internal/commands/old/CommandEnvelope.java;1;0;3;1;0;0;0;3;2;1;3;1222;2;2;1;0;0;3;3;1222;0;1695;3;1;
/org.eclipse.jdt.ui/core refactoring/org/eclipse/jdt/internal/corext/refactoring/rename/RenameJavaProjectProcessor.java;2;1;16;1;4;4;4;12;21;1;12;1125;118;118;1;0;0;12;16;1125;0;6340;16;2;
/org.eclipse.debug.ui/ui/org/eclipse/debug/internal/ui/launchConfigurations/CreateLaunchConfigurationAction.java;1;0;1;1;0;0;0;1;6;0;1;473;6;6;1;0;0;1;1;473;0;473;1;1;
/org.eclipse.jdt.ui.tests.refactoring/resources/ExtractMethodWorkSpace/ExtractMethodTests/duplicates_out/A_test957.java;1;1;2;1;2;2;2;0;2;0;0;5650;2;2;1;0;0;0;2;5650;0;5681;2;1;
/org.eclipse.core.resources/src/org/eclipse/core/internal/resources/SaveContext.java;1;0;1;1;1;1;1;0;204;0;0;5146;204;204;1;0;0;0;1;5146;0;5146;1;1;
/org.eclipse.jdt.ui.tests/ui/org/eclipse/jdt/ui/tests/quickfix/UnresolvedTypesQuickFixTest.java;4;1;13;1;4;4;4;9;191;1;9;299;413;413;1;0;0;9;13;299;0;6340;13;4;
/org.eclipse.jdt.core.tests.model/workspace/Formatter/test304/A_out.java;1;0;1;1;0;0;0;1;0;0;1;2442;0;0;1;0;0;1;1;2442;0;2442;1;1;
/org.eclipse.ui.workbench/Eclipse UI/org/eclipse/ui/internal/PartListenerList.java;2;1;2;1;2;2;2;0;30;0;0;5339;32;32;1;0;0;0;2;5339;0;6338;2;2;
/org.eclipse.update.ui/src/org/eclipse/update/internal/ui/properties/FeatureStatusPropertyPage.java;3;1;8;1;2;2;2;6;28;1;6;825;70;70;1;0;0;6;8;825;0;6336;8;3;
/org.eclipse.compare/compare/org/eclipse/compare/Splitter.java;1;0;1;1;0;0;0;1;2;0;1;3935;2;2;1;0;0;1;1;3935;0;3935;1;1;
/org.eclipse.swt/Eclipse SWT Mozilla/common/org/eclipse/swt/internal/mozilla/nsIObserver.java;1;0;1;1;0;0;0;1;0;0;1;1654;0;0;1;0;0;1;1;1654;0;1654;1;1;
/org.eclipse.pde.ui/src/org/eclipse/pde/internal/ui/editor/XMLSourcePage.java;2;1;4;1;3;3;3;1;57;0;1;909;69;69;1;0;0;1;4;909;0;6336;4;2;
/org.eclipse.core.tests.runtime/src/org/eclipse/core/tests/internal/plugins/SoftPrereqTest_3.java;1;0;1;1;0;0;0;1;0;0;1;3014;0;0;1;0;0;1;1;3014;0;3014;1;1;
/org.eclipse.pde/src/org/eclipse/pde/internal/builders/ISchemaTransformer.java;2;0;5;1;1;1;1;4;6;1;4;964;18;18;1;0;0;4;5;964;0;6336;5;2;
/org.eclipse.ui.workbench/Eclipse UI/org/eclipse/ui/commands/NoSuchAttributeException.java;1;0;2;1;0;0;0;2;0;1;2;4144;0;0;1;0;0;2;2;4144;0;4968;2;1;
/org.eclipse.debug.core/core/org/eclipse/debug/core/variables/ISimpleVariableRegistry.java;1;0;4;1;0;0;0;4;25;3;2;550;25;25;3;2;0;4;4;616;2;616;2;1;
/org.eclipse.search/new search/org/eclipse/search/ui/text/AbstractTextSearchResult.java;2;2;14;1;7;5;7;7;141;4;4;3711;572;572;4;3;2;7;14;4841;5;5652;9;2;
/org.eclipse.swt/Eclipse SWT AWT/motif/org/eclipse/swt/internal/awt/motif/SWT_AWT.java;1;0;3;1;0;0;0;3;35;1;3;1561;35;35;1;0;0;3;3;1561;0;1650;3;1;
/org.eclipse.pde.ui/src/org/eclipse/pde/internal/ui/editor/site/CategoryDefinitionSection.java;1;0;1;1;0;0;0;1;0;0;1;2311;0;0;1;0;0;1;1;2311;0;2311;1;1;
/org.eclipse.ant.ui/Ant Tools Support/org/eclipse/ant/ui/internal/model/AntUIModelMessages.java;1;0;2;1;0;0;0;2;0;1;2;262;0;0;1;0;0;2;2;262;0;1811;2;1;
/org.eclipse.ui.editors/src/org/eclipse/ui/texteditor/AddMarkerAction.java;2;1;8;1;4;4;4;4;324;1;4;1983;357;357;1;0;0;4;8;1983;0;6334;8;2;
/org.eclipse.jdt.core.tests.model/workspace/Formatter/test348/A_in.java;1;0;1;1;0;0;0;1;0;0;1;3029;0;0;1;0;0;1;1;3029;0;3029;1;1;
/org.eclipse.compare/compare/org/eclipse/compare/CompareViewerSwitchingPane.java;1;0;1;1;0;0;0;1;2;0;1;3935;2;2;1;0;0;1;1;3935;0;3935;1;1;
/org.eclipse.jdt.core.tests.model/workspace/Converter/test0013/Test.java;1;0;1;1;0;0;0;1;0;0;1;3714;0;0;1;0;0;1;1;3714;0;3714;1;1;
/org.eclipse.ui.workbench/Eclipse UI/org/eclipse/ui/commands/IActiveKeyConfiguration.java;1;0;2;1;0;0;0;2;0;1;2;1354;0;0;1;0;0;2;2;1354;0;1389;2;1;
/org.eclipse.jdt.ui/ui/org/eclipse/jdt/internal/ui/search/JavaSearchOperation.java;3;1;4;1;2;2;2;2;15;1;2;2156;26;26;1;0;0;2;4;2156;0;6340;4;3;
/org.eclipse.ui.examples.javaeditor/Template Editor Example/org/eclipse/ui/examples/templateeditor/template/XMLContextType.java;3;1;3;1;2;2;2;1;22;0;1;4644;24;24;1;0;0;1;3;4644;0;6340;3;3;
/org.eclipse.pde.core/src/org/eclipse/pde/internal/core/site/AbstractSiteBuildModel.java;3;1;8;2;2;2;2;6;18;2;5;2906;38;38;2;1;0;6;8;2936;1;6336;7;3;
/org.eclipse.pde.ui/src/org/eclipse/pde/internal/ui/launcher/ConfigurationTab.java;2;2;12;2;9;8;9;3;229;1;3;3775;343;343;2;0;1;3;12;5916;1;6336;11;2;
/org.eclipse.jdt.debug.ui/ui/org/eclipse/jdt/internal/debug/ui/launcher/MainMethodFinder.java;2;0;3;1;0;0;0;3;2;1;3;1275;4;4;1;0;0;3;3;1275;0;4192;3;2;
/org.eclipse.jdt.core.tests.model/workspace/Completion/src3/test0028/Test.java;1;0;1;1;1;1;1;0;0;0;0;5329;0;0;1;0;0;0;1;5329;0;5329;1;1;
/org.eclipse.pde.ui/src/org/eclipse/pde/internal/ui/editor/feature/FeatureFormPage.java;2;2;5;1;4;3;4;1;73;0;1;4203;85;85;2;0;1;1;5;5431;1;6336;4;2;
/org.eclipse.core.tests.runtime/src/org/eclipse/core/tests/internal/plugins/PluginResolveTest_26.java;1;0;1;1;0;0;0;1;0;0;1;3014;0;0;1;0;0;1;1;3014;0;3014;1;1;
/org.eclipse.jdt.core/dom/org/eclipse/jdt/core/internal/dom/rewrite/CodeFormatterUtil.java;2;0;3;2;0;0;0;3;3;2;2;4711;3;3;2;1;0;3;3;4711;1;4802;2;2;
/org.eclipse.ui.tests/Eclipse UI Tests/org/eclipse/ui/tests/navigator/HeavyNullImageDecorator.java;3;1;3;1;2;2;2;1;12;0;1;4238;22;22;1;0;0;1;3;4238;0;6338;3;3;
/org.eclipse.jdt.core.tests.model/workspace/Formatter/test439/A_in.java;1;0;1;1;0;0;0;1;0;0;1;3498;0;0;1;0;0;1;1;3498;0;3498;1;1;
/org.eclipse.jdt.core.tests.model/workspace/Converter/src/javadoc/test100/TestD2.java;1;0;1;1;0;0;0;1;0;0;1;4390;0;0;1;0;0;1;1;4390;0;4390;1;1;
/org.eclipse.update.core/srcnew/org/eclipse/update/internal/search/IUpdateSearchQuery.java;2;0;4;2;0;0;0;4;19;3;2;553;19;19;3;2;0;4;4;569;2;569;2;2;
/org.eclipse.osgi/defaultAdaptor/src/org/eclipse/osgi/framework/internal/protocol/bundle/BundleURLConnection.java;3;0;3;1;0;0;0;3;390;1;3;3013;390;390;1;0;0;3;3;3013;0;3620;3;3;
/org.eclipse.jdt.core.tests.model/workspace/Converter/junit/runner/Sorter.java;1;0;2;1;0;0;0;2;1;1;2;787;1;1;1;0;0;2;2;787;0;3714;2;1;
/org.eclipse.jdt.ui.tests.refactoring/resources/ExtractMethodWorkSpace/ExtractMethodTests/nested_in/A_test653.java;1;0;1;1;0;0;0;1;2;0;1;844;2;2;1;0;0;1;1;844;0;844;1;1;
/org.eclipse.debug.core/core/org/eclipse/debug/core/variables/ILaunchVariableInitializer.java;2;0;4;1;0;0;0;4;14;1;4;616;28;28;1;0;0;4;4;616;0;2120;4;2;
/org.eclipse.jdt.core.tests.model/workspace/Converter/src/test0260/Test.java;1;0;1;1;0;0;0;1;0;0;1;3714;0;0;1;0;0;1;1;3714;0;3714;1;1;
/org.eclipse.jdt.core.tests.model/workspace/Converter/test0450/A.java;1;0;1;1;0;0;0;1;0;0;1;3714;0;0;1;0;0;1;1;3714;0;3714;1;1;
/org.eclipse.swt/Eclipse SWT/gtk1x/org/eclipse/swt/graphics/Device.java;1;0;1;1;0;0;0;1;0;0;1;2327;0;0;1;0;0;1;1;2327;0;2327;1;1;
/org.eclipse.ui.editors/src/org/eclipse/ui/editors/text/IStorageDocumentProvider.java;1;0;1;1;1;1;1;0;5;0;0;6334;5;5;1;0;0;0;1;6334;0;6334;1;1;
/org.eclipse.jdt.core.tests.model/workspace/Converter/src/test0385/A.java;1;0;1;1;0;0;0;1;0;0;1;3714;0;0;1;0;0;1;1;3714;0;3714;1;1;
/org.eclipse.ant.ui/Ant Editor/org/eclipse/ant/internal/ui/editor/outline/XEErrorHandler.java;1;0;2;1;0;0;0;2;0;1;2;1811;0;0;1;0;0;2;2;1811;0;3661;2;1;
/org.eclipse.webdav/src/interface/org/eclipse/webdav/Policy.java;1;0;1;1;1;1;1;0;14;0;0;5151;14;14;1;0;0;0;1;5151;0;5151;1;1;
/org.eclipse.pde.build/src_ant/org/eclipse/pde/internal/build/tasks/FetchFileGeneratorTask.java;2;2;10;1;4;3;4;6;29;1;6;447;42;42;2;0;1;6;10;6340;1;6340;9;2;
/org.eclipse.ui.ide/src/org/eclipse/ui/internal/ide/registry/MarkerHelpRegistryReader.java;2;0;3;1;0;0;0;3;6;1;3;2264;10;10;1;0;0;3;3;2264;0;2793;3;2;
/org.eclipse.swt/Eclipse SWT Browser/win32/org/eclipse/swt/browser/WebSite.java;3;2;13;1;11;9;11;2;100;0;1;2728;360;360;2;1;2;2;13;2728;3;6352;10;3;
/org.eclipse.swt.opengl.examples/src/org/eclipse/swt/opengl/examples/IColorSelectionListener.java;1;0;1;1;0;0;0;1;0;0;1;1175;0;0;1;0;0;1;1;1175;0;1175;1;1;
/org.eclipse.ui.workbench/Eclipse UI/org/eclipse/ui/IMarkerResolutionGenerator2.java;1;0;1;1;0;0;0;1;0;0;1;2737;0;0;1;0;0;1;1;2737;0;2737;1;1;
/org.eclipse.core.tests.resources/src/org/eclipse/core/tests/internal/builders/BuilderNatureTest.java;2;0;5;1;3;1;3;2;414;1;2;1098;473;473;3;0;2;2;5;5147;2;5147;3;2;
/org.eclipse.jdt.debug.ui/ui/org/eclipse/jdt/internal/debug/ui/actions/AddLibraryAction.java;2;1;2;1;2;2;2;0;3;0;0;5536;3;3;1;0;0;0;2;5536;0;5582;2;2;
/org.eclipse.jdt.ui.tests.refactoring/resources/ExtractInterface/testConditional2/out/X.java;1;0;1;1;0;0;0;1;0;0;1;3902;0;0;1;0;0;1;1;3902;0;3902;1;1;
/org.eclipse.jdt.junit/src/org/eclipse/jdt/internal/junit/wizards/NewTestCaseCreationWizardPage.java;4;1;20;1;7;7;7;13;148;2;12;161;440;440;2;1;0;13;20;183;1;6340;19;4;
/org.eclipse.jdt.core.tests.model/workspace/Converter/src/test0546/A.java;1;0;1;1;1;1;1;0;0;0;0;5314;0;0;1;0;0;0;1;5314;0;5314;1;1;
/org.eclipse.team.cvs.ui/src/org/eclipse/team/internal/ccvs/ui/operations/CVSSubscriberNonblockingContext.java;2;0;4;1;0;0;0;4;3;1;4;2021;5;5;1;0;0;4;4;2021;0;4216;4;2;
/org.eclipse.debug.ui/ui/org/eclipse/debug/internal/ui/launchConfigurations/LaunchGroupExtension.java;2;1;3;1;2;2;2;1;29;0;1;2312;56;56;1;0;0;1;3;2312;0;5476;3;2;
/org.eclipse.pde.ui/sandbox/org/eclipse/pde/internal/ui/editor/standalone/feature/FeatureSourceEditor.java;1;0;2;1;0;0;0;2;0;1;2;2320;0;0;1;0;0;2;2;2320;0;2906;2;1;
/org.eclipse.ui.views/src/org/eclipse/ui/views/markers/MarkerViewUtil.java;1;0;2;1;0;0;0;2;0;1;2;758;0;0;1;0;0;2;2;758;0;2738;2;1;
/org.eclipse.jdt.core.tests.model/workspace/Formatter/test271/A_out.java;1;0;1;1;0;0;0;1;0;0;1;2442;0;0;1;0;0;1;1;2442;0;2442;1;1;
/org.eclipse.update.ui/src/org/eclipse/update/internal/ui/parts/OverlayIcon.java;1;0;1;1;0;0;0;1;7;0;1;890;7;7;1;0;0;1;1;890;0;890;1;1;
/org.eclipse.jdt.debug.ui/ui/org/eclipse/jdt/internal/debug/ui/snippeteditor/SnippetEditorStorageDocumentProvider.java;1;0;1;1;0;0;0;1;0;0;1;5067;0;0;1;0;0;1;1;5067;0;5067;1;1;
/org.eclipse.ui.ide/src/org/eclipse/ui/internal/ide/dialogs/MultiStepReviewWizardPage.java;2;1;3;1;2;2;2;1;24;0;1;2264;26;26;1;0;0;1;3;2264;0;6338;3;2;
/org.eclipse.core.tests.resources/src/org/eclipse/core/tests/resources/regression/Bug_61277.java;1;1;2;1;2;2;2;0;2;0;0;5512;2;2;1;0;0;0;2;5512;0;5572;2;1;
/org.eclipse.jdt.core.tests.model/workspace/Converter/src/javadoc/test102/TestD2.java;1;0;1;1;0;0;0;1;0;0;1;4390;0;0;1;0;0;1;1;4390;0;4390;1;1;
/org.eclipse.help.ui/src/org/eclipse/help/ui/internal/browser/SystemBrowserAdapter.java;1;1;5;1;3;3;3;2;20;1;2;2732;48;48;1;0;0;2;5;2732;0;6337;5;1;
/org.eclipse.help.appserver/src/org/eclipse/help/internal/appserver/PluginClassLoaderWrapper.java;1;2;11;1;7;6;7;4;171;2;3;4616;390;390;2;1;1;4;11;4616;2;6337;9;1;
/org.eclipse.ant.tests.ui/test plugin/org/eclipse/ant/tests/ui/testplugin/ConsoleLineTracker.java;2;0;5;1;0;0;0;5;26;1;5;1796;58;58;1;0;0;5;5;1796;0;2315;5;2;
/org.eclipse.core.runtime.osgi/src/org/eclipse/core/internal/registry/ExtensionDelta.java;1;0;2;1;0;0;0;2;7;1;2;3013;7;7;1;0;0;2;2;3013;0;3030;2;1;
/org.eclipse.jdt.core.tests.model/workspace/Converter/test0437/A.java;1;0;1;1;0;0;0;1;0;0;1;3714;0;0;1;0;0;1;1;3714;0;3714;1;1;
/org.eclipse.jdt.core/model/org/eclipse/jdt/internal/core/MultiOperation.java;3;0;5;1;1;1;1;4;64;1;4;134;99;99;1;0;0;4;5;134;0;5916;5;3;
/org.eclipse.jdt.ui.tests.refactoring/resources/ExtractInterface/test95/in/A.java;1;0;1;1;0;0;0;1;0;0;1;1153;0;0;1;0;0;1;1;1153;0;1153;1;1;
/org.eclipse.jdt.core.tests.model/workspace/Formatter/test183/A_in.java;1;0;1;1;0;0;0;1;0;0;1;2425;0;0;1;0;0;1;1;2425;0;2425;1;1;
/org.eclipse.jdt.ui.tests.refactoring/resources/InlineMethodWorkspace/TestCases/invalid/TestInvalidFieldInitializer3.java;1;0;1;1;0;0;0;1;0;0;1;2491;0;0;1;0;0;1;1;2491;0;2491;1;1;
/org.eclipse.jdt.core.tests.model/workspace/Converter/src/test0513/A.java;1;0;1;1;0;0;0;1;0;0;1;3714;0;0;1;0;0;1;1;3714;0;3714;1;1;
/org.eclipse.jdt.ui.tests.refactoring/resources/DeleteSourceReference/test13/in/A.java;1;0;1;1;0;0;0;1;0;0;1;1652;0;0;1;0;0;1;1;1652;0;1652;1;1;
/org.eclipse.jdt.debug.ui/ui/org/eclipse/jdt/debug/ui/launchConfigurations/JavaSourceLookupTab.java;3;0;3;1;1;1;1;2;8;1;2;3313;14;14;1;0;0;2;3;3313;0;6336;3;3;
/org.eclipse.debug.ui/ui/org/eclipse/debug/internal/ui/launchVariables/FolderPromptExpander.java;2;0;2;1;0;0;0;2;0;1;2;771;0;0;1;0;0;2;2;771;0;2120;2;2;
/org.eclipse.jdt.ui/ui/org/eclipse/jdt/ui/actions/GenerateNewConstructorUsingFieldsAction.java;3;1;17;1;5;5;5;12;95;1;12;1537;423;423;1;0;0;12;17;1537;0;6340;17;3;
/org.eclipse.releng.basebuilder/plugins/org.eclipse.build.tools/org.eclipse.build.tools/src/org/eclipse/releng/Mailer.java;1;0;1;1;1;1;1;0;0;0;0;5735;0;0;1;0;0;0;1;5735;0;5735;1;1;
/org.eclipse.ant.ui/Ant Editor/org/eclipse/ant/internal/ui/editor/utils/AntEditorUtilsMessages.java;1;0;2;1;0;0;0;2;0;1;2;1811;0;0;1;0;0;2;2;1811;0;4473;2;1;
/org.eclipse.jdt.core.tests.model/workspace/Formatter/test199/A_in.java;1;0;1;1;0;0;0;1;0;0;1;2424;0;0;1;0;0;1;1;2424;0;2424;1;1;
/org.eclipse.jdt.ui.tests.refactoring/resources/RenamePackage/testImportFromMultiRoots7/out/srcPrj.other/pack/Namesake.java;1;0;1;1;0;0;0;1;0;0;1;4105;0;0;1;0;0;1;1;4105;0;4105;1;1;
/org.eclipse.debug.ui/ui/org/eclipse/debug/ui/launchVariables/VariableContextManager.java;1;0;3;1;0;0;0;3;1;1;3;550;1;1;1;0;0;3;3;550;0;771;3;1;
/org.eclipse.jdt.core.tests.model/workspace/Formatter/test488/A_out.java;1;0;1;1;1;1;1;0;0;0;0;5188;0;0;1;0;0;0;1;5188;0;5188;1;1;
/org.eclipse.webdav/src/kernel/org/eclipse/webdav/internal/kernel/utils/SimpleRFC1123DateFormat.java;1;2;3;1;3;2;3;0;293;0;0;5151;293;293;2;0;1;0;3;5151;1;5760;2;1;
/org.eclipse.jdt.core.tests.model/workspace/Converter/test0224/Test.java;1;0;1;1;0;0;0;1;0;0;1;3714;0;0;1;0;0;1;1;3714;0;3714;1;1;
/org.eclipse.ui.workbench/Eclipse UI/org/eclipse/ui/internal/commands/older/KeyConfiguration.java;1;0;2;1;0;0;0;2;8;0;1;2562;8;8;2;1;0;2;2;2562;1;2562;1;1;
/org.eclipse.jdt.core/model/org/eclipse/jdt/internal/core/ClassFile.java;4;1;32;1;2;2;2;30;100;1;30;130;490;490;1;0;0;30;32;130;0;5185;32;4;
/org.eclipse.jdt.debug.ui/ui/org/eclipse/jdt/internal/debug/ui/actions/ActionDelegateHelper.java;4;1;7;2;3;3;3;4;12;2;3;1739;29;29;2;1;0;4;7;1739;1;6336;6;4;
/org.eclipse.jdt.core.tests.model/workspace/Converter/src/test0354/Test.java;1;0;1;1;0;0;0;1;0;0;1;3714;0;0;1;0;0;1;1;3714;0;3714;1;1;
/org.eclipse.jdt.ui/core refactoring/org/eclipse/jdt/internal/corext/refactoring/participants/ResourceExtender.java;2;1;2;1;2;2;2;0;8;0;0;5269;8;8;1;0;0;0;2;5269;0;6340;2;2;
/org.eclipse.jdt.core.tests.model/workspace/Converter/src/test0301/Test.java;1;0;1;1;0;0;0;1;0;0;1;3714;0;0;1;0;0;1;1;3714;0;3714;1;1;
/org.eclipse.jdt.ui/ui/org/eclipse/jdt/ui/jarpackager/JarWriter.java;2;2;6;2;4;3;4;2;10;1;2;394;32;32;2;0;1;2;6;6334;1;6334;5;2;
/org.eclipse.pde.core/src/org/eclipse/pde/internal/core/CoreArraySorter.java;1;0;1;1;0;0;0;1;0;0;1;3490;0;0;1;0;0;1;1;3490;0;3490;1;1;
/org.eclipse.core.tests.runtime/src/org/eclipse/core/tests/internal/registrycache/RegistryCacheTest.java;4;3;16;2;14;10;14;2;26;1;2;4018;124;124;3;0;4;2;16;5637;4;6151;12;4;
/org.eclipse.ui.ide/extensions/org/eclipse/ui/actions/CopyResourceAction.java;4;1;5;1;2;2;2;3;38;1;3;2263;56;56;1;0;0;3;5;2263;0;6338;5;4;
/org.eclipse.core.tests.runtime/src/org/eclipse/core/tests/runtime/stream/InputStreamRegistry.java;1;0;2;1;1;1;1;1;4;0;1;2512;4;4;1;0;0;1;2;2512;0;5149;2;1;
/org.eclipse.jdt.ui/ui/org/eclipse/jdt/ui/PreferenceConstants.java;8;4;76;4;28;17;28;48;164;2;40;500;1801;1801;4;8;11;48;76;6140;19;6333;57;8;
/org.eclipse.core.runtime.compatibility/src-boot/org/eclipse/core/internal/boot/OldPlatformConfiguration.java;4;1;6;1;2;2;2;4;14;2;3;3013;24;24;2;1;0;4;6;3116;1;5254;5;4;
/org.eclipse.jdt.ui.tests.refactoring/resources/PromoteTempToField/canPromote/A_test20_in.java;1;0;1;1;0;0;0;1;0;0;1;3576;0;0;1;0;0;1;1;3576;0;3576;1;1;
/org.eclipse.ui.workbench/Eclipse UI/org/eclipse/ui/internal/csm/commands/CommandManagerEvent.java;1;0;3;1;0;0;0;3;22;1;3;2515;22;22;1;0;0;3;3;2515;0;2562;3;1;
/org.eclipse.ant.ui/Remote Ant Support/org/eclipse/ant/ui/internal/antsupport/InternalAntMessages.java;1;0;2;1;0;0;0;2;0;1;2;1696;0;0;1;0;0;2;2;1696;0;1811;2;1;
/org.eclipse.core.boot/src/org/eclipse/core/internal/boot/InternalBootLoader.java;1;0;4;1;0;0;0;4;29;1;4;621;52;52;1;0;0;4;4;621;0;3013;4;1;
/org.eclipse.ui.tests/UI Test Utils/org/eclipse/ui/tests/util/UITestCase.java;4;1;7;1;4;4;4;3;111;1;3;217;203;203;1;0;0;3;7;217;0;6338;7;4;
/org.eclipse.pde.ui/src/org/eclipse/pde/internal/ui/wizards/WizardElement.java;3;1;4;1;4;4;4;0;193;0;0;5496;230;230;1;0;0;0;4;5496;0;6336;4;3;
/org.eclipse.ui.workbench/Eclipse UI/org/eclipse/ui/internal/commands/util/GestureSupport.java;1;0;2;1;0;0;0;2;0;1;2;1077;0;0;1;0;0;2;2;1077;0;1222;2;1;
/org.eclipse.ui.cheatsheets/src/org/eclipse/ui/internal/cheatsheets/views/CheatSheetViewEvent.java;1;0;2;1;0;0;0;2;0;1;2;4428;0;0;1;0;0;2;2;4428;0;4625;2;1;
/org.eclipse.jdt.ui.tests.refactoring/resources/ChangeTypeRefactoring/positive/A_testImport_out.java;1;0;1;1;0;0;0;1;0;0;1;2844;0;0;1;0;0;1;1;2844;0;2844;1;1;
/org.eclipse.jdt.ui.tests.refactoring/test cases/org/eclipse/jdt/ui/tests/refactoring/InlineMethodTestSetup.java;3;1;8;1;3;3;3;5;11;1;5;345;45;45;1;0;0;5;8;345;0;6340;8;3;
/org.eclipse.search/search/org/eclipse/search/internal/ui/SearchPluginImages.java;3;1;8;1;4;4;4;4;3;2;3;4045;14;14;2;1;0;4;8;4345;1;6340;7;3;
/org.eclipse.osgi/supplement/src/org/eclipse/osgi/service/localization/BundleLocalization.java;3;0;3;1;1;1;1;2;4;1;2;4780;8;8;1;0;0;2;3;4780;0;5117;3;3;
/org.eclipse.ui.externaltools/Ant Editor/org/eclipse/ui/externaltools/internal/ant/editor/text/NonRuleBasedDamagerRepairer.java;1;0;1;1;0;0;0;1;0;0;1;282;0;0;1;0;0;1;1;282;0;282;1;1;
/org.eclipse.team.ui/src/org/eclipse/team/internal/ui/ProjectSetContentHandler.java;1;0;1;1;0;0;0;1;27;0;1;2402;27;27;1;0;0;1;1;2402;0;2402;1;1;
/org.eclipse.webdav/src/kernel/org/eclipse/webdav/internal/kernel/IDocumentMarshaler.java;1;0;2;1;1;1;1;1;4;0;1;2549;7;7;1;0;0;1;2;2549;0;5151;2;1;
/org.eclipse.sdk.tests-feature/plugins/org.eclipse.perfmsr.ui.client/src/org/eclipse/perfmsr/ui/client/RunGroup.java;1;1;2;1;2;2;2;0;10;0;0;5443;10;10;1;0;0;0;2;5443;0;5513;2;1;
/org.eclipse.jdt.core.tests.model/workspace/Converter/src/test0533/A.java;1;0;1;1;0;0;0;1;0;0;1;3748;0;0;1;0;0;1;1;3748;0;3748;1;1;
/org.eclipse.ant.ui/Ant Tools Support/org/eclipse/ui/ant/internal/views/actions/SearchForBuildFilesAction.java;1;0;2;1;0;0;0;2;0;1;2;250;0;0;1;0;0;2;2;250;0;263;2;1;
/org.eclipse.ui.workbench/Eclipse UI/org/eclipse/ui/internal/contexts/registry/PreferenceRegistry.java;1;0;2;1;0;0;0;2;0;0;1;1396;0;0;2;1;0;2;2;1396;1;1396;1;1;
/org.eclipse.ui.tests/Eclipse UI Tests/org/eclipse/ui/tests/datatransfer/ImportOperationTest.java;2;0;2;1;0;0;0;2;8;1;2;217;9;9;1;0;0;2;2;217;0;3091;2;2;
/org.eclipse.pde.core/src/org/eclipse/pde/internal/core/ibundle/IBundlePluginModelProvider.java;1;1;2;1;2;2;2;0;6;0;0;5445;6;6;1;0;0;0;2;5445;0;6336;2;1;
/org.eclipse.ui.workbench/Eclipse UI/org/eclipse/ui/internal/csm/commands/CommandRegistryEvent.java;1;0;2;1;0;0;0;2;0;1;2;2515;0;0;1;0;0;2;2;2515;0;2562;2;1;
/org.eclipse.jdt.ui.tests.refactoring/resources/ExtractMethodWorkSpace/ExtractMethodTests/locals_out/A_test539.java;1;0;2;1;0;0;0;2;4;1;2;130;5;5;1;0;0;2;2;130;0;844;2;1;
/org.eclipse.core.runtime/src/org/eclipse/core/runtime/registry/IExtensionPoint.java;4;0;7;2;0;0;0;7;180;2;6;2105;360;360;2;1;0;7;7;3164;1;3164;6;4;
/org.eclipse.pde.core/src/org/eclipse/pde/internal/core/feature/FeaturePlugin.java;3;1;5;1;3;3;3;2;31;1;2;2229;63;63;1;0;0;2;5;2229;0;6336;5;3;
/org.eclipse.update/src/org/eclipse/update/internal/core/IUMLock.java;1;0;1;1;1;1;1;0;0;0;0;6339;0;0;1;0;0;0;1;6339;0;6339;1;1;
/org.eclipse.jdt.ui/ui refactoring/org/eclipse/jdt/internal/ui/refactoring/contentassist/ControlContentAssistSubjectAdapter.java;2;0;3;2;0;0;0;3;96;2;2;3648;96;96;2;1;0;3;3;3667;1;3667;2;2;
/org.eclipse.jdt.ui/ui/org/eclipse/jdt/internal/ui/browsing/PackagesViewLabelProvider.java;3;0;4;2;1;1;1;3;19;2;2;506;37;37;2;1;0;3;4;506;1;6340;3;3;
/org.eclipse.jface.text/src/org/eclipse/jface/text/ITextOperationTarget.java;2;1;2;1;2;2;2;0;19;0;0;6340;21;21;1;0;0;0;2;6340;0;6359;2;2;
/org.eclipse.jdt.core.tests.model/workspace/Converter/test0360/X.java;1;0;1;1;0;0;0;1;0;0;1;3714;0;0;1;0;0;1;1;3714;0;3714;1;1;
/org.eclipse.pde.core/src/org/eclipse/pde/internal/core/site/SiteCategoryDefinition.java;2;1;3;1;2;2;2;1;16;0;1;4203;27;27;1;0;0;1;3;4203;0;6336;3;2;
/org.eclipse.update/src/org/eclipse/update/internal/core/UpdateManagerStrings.java;1;0;1;1;1;1;1;0;0;0;0;6339;0;0;1;0;0;0;1;6339;0;6339;1;1;
/org.eclipse.ui.intro/src/org/eclipse/ui/internal/intro/impl/util/Util.java;1;1;9;1;9;9;9;0;48;0;0;5115;113;113;1;0;0;0;9;5115;0;5881;9;1;
/org.eclipse.jdt.core.tests.model/workspace/Converter/src/test0302/Test.java;1;0;1;1;0;0;0;1;0;0;1;3714;0;0;1;0;0;1;1;3714;0;3714;1;1;
/org.eclipse.ui.workbench/Eclipse UI/org/eclipse/ui/commands/CommandManagerEvent.java;2;0;6;1;1;1;1;5;271;2;3;2823;583;583;2;2;0;5;6;2823;2;5231;4;2;
/org.eclipse.jdt.ui/ui/org/eclipse/jdt/ui/text/spelling/engine/ISpellCheckEngine.java;1;0;2;1;0;0;0;2;0;1;2;3829;0;0;1;0;0;2;2;3829;0;3930;2;1;
/org.eclipse.swt/Eclipse SWT/carbon/org/eclipse/swt/widgets/Scale.java;3;1;4;1;2;2;2;2;22;1;2;268;31;31;1;0;0;2;4;268;0;6352;4;3;
/org.eclipse.jdt.core.tests.model/workspace/Formatter/test005/A_out.java;1;0;1;1;0;0;0;1;0;0;1;2425;0;0;1;0;0;1;1;2425;0;2425;1;1;
/org.eclipse.ant.ui/Ant Editor/org/eclipse/ant/ui/internal/editor/EnclosingTargetSearchingHandler.java;1;0;3;1;0;0;0;3;15;1;3;250;15;15;1;0;0;3;3;250;0;1811;3;1;
/org.eclipse.ui.workbench/Eclipse UI/org/eclipse/ui/internal/contexts/ContextDefinitionHandle.java;1;0;2;1;0;0;0;2;0;1;2;1388;0;0;1;0;0;2;2;1388;0;1396;2;1;
/org.eclipse.jdt.core.tests.model/workspace/Converter/src/test0554/A.java;1;0;1;1;1;1;1;0;0;0;0;5639;0;0;1;0;0;0;1;5639;0;5639;1;1;
/org.eclipse.ui.tests/Eclipse UI Tests/org/eclipse/ui/tests/dialogs/UIWizards.java;2;0;2;1;1;1;1;1;6;0;1;4969;8;8;1;0;0;1;2;4969;0;6338;2;2;
/org.eclipse.ui.workbench/Eclipse UI/org/eclipse/ui/IMarkerResolution.java;1;0;1;1;0;0;0;1;0;0;1;2737;0;0;1;0;0;1;1;2737;0;2737;1;1;
/org.eclipse.ui.workbench/Eclipse UI/org/eclipse/ui/internal/ConfigurationInfo.java;1;0;1;1;0;0;0;1;0;0;1;2737;0;0;1;0;0;1;1;2737;0;2737;1;1;
/org.eclipse.jdt.core.tests.model/workspace/Formatter/test087/A_out.java;1;0;1;1;0;0;0;1;0;0;1;2425;0;0;1;0;0;1;1;2425;0;2425;1;1;
/org.eclipse.jdt.ui.tests.refactoring/resources/Move/testDestination_yes_initializerToOtherType/in/A.java;1;0;1;1;0;0;0;1;0;0;1;1008;0;0;1;0;0;1;1;1008;0;1008;1;1;
/org.eclipse.jdt.core.tests.model/src/org/eclipse/jdt/core/tests/model/CompletionTests.java;3;1;19;1;5;5;5;14;169;3;11;858;518;518;3;3;0;14;19;3039;3;6094;16;3;
/org.eclipse.jdt.ui.tests.refactoring/resources/MoveMembers/testFail20/in/B.java;1;0;1;1;0;0;0;1;0;0;1;1856;0;0;1;0;0;1;1;1856;0;1856;1;1;
/org.eclipse.osgi/core/adaptor/org/eclipse/osgi/framework/log/FrameworkLogEntry.java;3;0;5;1;1;1;1;4;21;1;4;3879;45;45;1;0;0;4;5;3879;0;5117;5;3;
/org.eclipse.jdt.core.tests.model/workspace/Converter/src/test0230/Test.java;1;0;1;1;0;0;0;1;0;0;1;3714;0;0;1;0;0;1;1;3714;0;3714;1;1;
/org.eclipse.team.tests.cvs.core/src/org/eclipse/team/tests/ccvs/ui/old/PrintCSVSummaryVisitor.java;1;0;2;1;0;0;0;2;0;1;2;2632;0;0;1;0;0;2;2;2632;0;4216;2;1;
/org.eclipse.jdt.core.tests.model/workspace/Converter/src/test0012/Test.java;1;0;1;1;0;0;0;1;0;0;1;3714;0;0;1;0;0;1;1;3714;0;3714;1;1;
/org.eclipse.team.cvs.core/src/org/eclipse/team/internal/ccvs/core/syncinfo/MergedSynchronizer.java;2;0;4;1;0;0;0;4;31;1;4;1686;33;33;1;0;0;4;4;1686;0;4216;4;2;
/org.eclipse.pde.ui/src/org/eclipse/pde/internal/ui/wizards/feature/BaseFeatureSpecPage.java;2;2;9;1;9;8;9;0;193;0;0;5563;516;516;2;0;1;0;9;6108;1;6336;8;2;
/org.eclipse.core.resources/src/org/eclipse/core/internal/properties/StoreKey.java;2;0;2;1;1;1;1;1;281;0;1;1656;290;290;1;0;0;1;2;1656;0;5146;2;2;
/org.eclipse.jdt.core.tests.model/workspace/Formatter/test017/A_out.java;1;0;1;1;0;0;0;1;0;0;1;2425;0;0;1;0;0;1;1;2425;0;2425;1;1;
/org.eclipse.ui.ide/src/org/eclipse/ui/internal/dialogs/InternalErrorDialog.java;2;0;2;1;0;0;0;2;0;1;2;1760;0;0;1;0;0;2;2;1760;0;2263;2;2;
/org.eclipse.jdt.ui/core refactoring/org/eclipse/jdt/internal/corext/refactoring/base/RefactoringStatusContext.java;1;0;2;1;0;0;0;2;0;1;2;3536;0;0;1;0;0;2;2;3536;0;4575;2;1;
/org.eclipse.swt.tests/JUnit Tests/org/eclipse/swt/tests/junit/Test_org_eclipse_swt_events_MenuEvent.java;1;0;2;1;1;1;1;1;7;0;1;3444;11;11;1;0;0;1;2;3444;0;6352;2;1;
/org.eclipse.core.runtime.osgi/src/org/eclipse/core/internal/registry/ConfigurationElement.java;1;0;2;1;0;0;0;2;52;1;2;3013;52;52;1;0;0;2;2;3013;0;3030;2;1;
/org.eclipse.jdt.core.tests.model/workspace/Formatter/test293/A_in.java;1;0;1;1;0;0;0;1;0;0;1;2444;0;0;1;0;0;1;1;2444;0;2444;1;1;
/org.eclipse.jdt.launching/launching/org/eclipse/jdt/launching/sourcelookup/JavaProjectSourceLocation.java;3;0;4;1;1;1;1;3;21;1;3;2449;48;48;1;0;0;3;4;2449;0;6336;4;3;
/org.eclipse.jdt.launching/launching/org/eclipse/jdt/internal/launching/ClasspathVariableSourceContainerTypeDelegate.java;2;0;5;1;1;1;1;4;17;2;3;4167;23;23;2;1;0;4;5;4949;1;5581;4;2;
/org.eclipse.swt/Eclipse SWT PI/carbon/org/eclipse/swt/internal/carbon/AlertStdCFStringAlertParamRec.java;1;2;3;1;3;2;3;0;16;0;0;5534;20;20;2;0;1;0;3;5534;1;5614;2;1;
/org.eclipse.ui.workbench/Eclipse UI/org/eclipse/ui/internal/EditorsInformationControl.java;3;0;3;1;0;0;0;3;9;1;3;2620;9;9;1;0;0;3;3;2620;0;4521;3;3;
/org.eclipse.jdt.text.tests/src/org/eclipse/jdt/text/tests/PairMatcherTest.java;1;1;2;1;2;2;2;0;2;0;0;5129;2;2;1;0;0;0;2;5129;0;6340;2;1;
/org.eclipse.ui.workbench/Eclipse UI/org/eclipse/ui/commands/CommandEvent.java;2;0;9;1;1;1;1;8;291;2;6;1119;716;716;2;2;0;8;9;2823;2;5231;7;2;
/org.eclipse.team.ui/src/org/eclipse/team/internal/ui/synchronize/aa.java;1;0;1;1;0;0;0;1;0;0;1;3228;0;0;1;0;0;1;1;3228;0;3228;1;1;
/org.eclipse.debug.ui/ui/org/eclipse/debug/internal/ui/views/registers/RegistersViewMessages.java;1;0;1;1;0;0;0;1;0;0;1;4348;0;0;1;0;0;1;1;4348;0;4348;1;1;
/org.eclipse.pde.ui/templates_3.0/editor/java/TagRule.java;1;0;1;1;0;0;0;1;0;0;1;2786;0;0;1;0;0;1;1;2786;0;2786;1;1;
/org.eclipse.jdt.debug.ui/ui/org/eclipse/jdt/internal/debug/ui/actions/ShowStaticVariablesAction.java;1;0;1;1;0;0;0;1;4;0;1;3296;4;4;1;0;0;1;1;3296;0;3296;1;1;
/org.eclipse.ui.workbench/Eclipse UI/org/eclipse/ui/internal/dialogs/FilteredPreferenceDialog.java;2;0;10;1;1;1;1;9;104;2;8;3131;289;289;2;1;0;9;10;4068;1;6338;9;2;
/org.eclipse.jdt.core.tests.model/workspace/Formatter/test032/A_in.java;1;0;1;1;0;0;0;1;0;0;1;2425;0;0;1;0;0;1;1;2425;0;2425;1;1;
/org.eclipse.jdt.core.tests.model/workspace/Formatter/test257/A_in.java;1;0;1;1;0;0;0;1;0;0;1;2442;0;0;1;0;0;1;1;2442;0;2442;1;1;
/org.eclipse.jdt.core/dom/org/eclipse/jdt/core/dom/TypeParameter.java;4;2;13;1;5;4;5;8;165;1;8;2867;310;310;2;0;1;8;13;5268;1;6336;12;4;
/org.eclipse.ui.workbench/Eclipse UI/org/eclipse/ui/internal/chris/roles/api/IRoleManagerEvent.java;1;0;2;1;0;0;0;2;0;0;1;2207;0;0;2;1;0;2;2;2207;1;2207;1;1;
/org.eclipse.ui.forms/src/org/eclipse/ui/forms/widgets/FormContent.java;1;0;3;1;0;0;0;3;3;2;2;4068;3;3;2;1;0;3;3;4068;1;4135;2;1;
/org.eclipse.update.ui/src/org/eclipse/update/internal/ui/wizards/ReplaceFeatureVersionWizard.java;1;0;1;1;0;0;0;1;0;0;1;1242;0;0;1;0;0;1;1;1242;0;1242;1;1;
/org.eclipse.ui.workbench/Eclipse UI/org/eclipse/ui/commands/IKeySequenceBinding.java;3;1;4;1;2;2;2;2;6;1;2;2569;16;16;1;0;0;2;4;2569;0;6338;4;3;
/org.eclipse.jdt.core.tests.model/workspace/Converter/test0236/Test.java;1;0;1;1;0;0;0;1;0;0;1;3714;0;0;1;0;0;1;1;3714;0;3714;1;1;
/org.eclipse.jdt.ui/ui refactoring/org/eclipse/jdt/internal/ui/refactoring/reorg/DestinationContentProvider.java;5;1;5;1;2;2;2;3;43;1;3;1112;74;74;1;0;0;3;5;1112;0;6340;5;5;
/org.eclipse.team.cvs.ui/src/org/eclipse/team/internal/ccvs/ui/subscriber/MergeDialog.java;2;0;6;1;0;0;0;6;47;2;5;709;81;81;2;1;0;6;6;1132;1;1132;5;2;
/org.eclipse.pde.ui/src/org/eclipse/pde/internal/ui/editor/manifest/TemplateForm.java;1;0;2;1;1;1;1;1;3;0;1;368;3;3;1;0;0;1;2;368;0;5431;2;1;
/org.eclipse.jdt.debug.tests/tests/org/eclipse/jdt/debug/tests/core/HcrTests.java;2;1;4;1;3;3;3;1;32;0;1;629;50;50;1;0;0;1;4;629;0;6337;4;2;
/org.eclipse.jdt.ui/ui/org/eclipse/jdt/internal/ui/packageview/PackageExplorerActionGroup.java;6;1;14;2;4;4;4;10;71;2;9;1271;279;279;2;1;0;10;14;4440;1;6340;13;6;
/org.eclipse.team.core/src/org/eclipse/team/internal/core/registry/DeploymentProviderDescriptor.java;2;0;3;1;0;0;0;3;80;1;3;2806;80;80;1;0;0;3;3;2806;0;4633;3;2;
/org.eclipse.ui.workbench/Eclipse UI/org/eclipse/ui/internal/commands/ws/WidgetMethodHandler.java;3;1;5;1;4;4;4;1;14;0;1;4968;42;42;1;0;0;1;5;4968;0;6338;5;3;
/org.eclipse.team.tests.cvs.core/src/org/eclipse/team/tests/ccvs/core/subscriber/TestOverrideAndUpdateOperation.java;2;0;2;1;1;1;1;1;10;0;1;4450;10;10;1;0;0;1;2;4450;0;6337;2;2;
/org.eclipse.ui.workbench/Eclipse UI/org/eclipse/ui/internal/commands/util/Util.java;1;0;4;1;0;0;0;4;188;2;2;1077;209;209;2;2;0;4;4;1077;2;1220;2;1;
/org.eclipse.team.core/src/org/eclipse/team/core/variants/CachedResourceVariant.java;2;1;6;1;5;5;5;1;45;0;1;4349;103;103;1;0;0;1;6;4349;0;6336;6;2;
/org.eclipse.jdt.core.tests.model/workspace/Formatter/test046/A_in.java;1;0;1;1;0;0;0;1;0;0;1;2425;0;0;1;0;0;1;1;2425;0;2425;1;1;
/org.eclipse.ltk.core.refactoring/src/org/eclipse/ltk/core/refactoring/RefactoringStatusContext.java;2;1;5;1;3;3;3;2;8;1;2;4845;20;20;1;0;0;2;5;4845;0;6352;5;2;
/org.eclipse.jdt.ui/ui/org/eclipse/jdt/ui/text/spelling/SpellReconcileDictionary.java;1;0;2;1;0;0;0;2;0;1;2;3829;0;0;1;0;0;2;2;3829;0;3930;2;1;
/org.eclipse.jdt.core.tests.model/workspace/Converter/src/test0024/Test.java;1;0;1;1;0;0;0;1;0;0;1;3714;0;0;1;0;0;1;1;3714;0;3714;1;1;
/org.eclipse.ui.ide/src/org/eclipse/ui/internal/dialogs/ProjectCapabilityEditingPropertyPage.java;2;0;3;1;0;0;0;3;26;1;3;1526;26;26;1;0;0;3;3;1526;0;2263;3;2;
/org.eclipse.jdt.core.tests.model/workspace/Formatter/test143/A_in.java;1;0;1;1;0;0;0;1;0;0;1;2425;0;0;1;0;0;1;1;2425;0;2425;1;1;
/org.eclipse.jdt.ui.tests.refactoring/resources/ChangeSignature/canModify/A_testImport07_in.java;1;0;1;1;1;1;1;0;0;0;0;5434;0;0;1;0;0;0;1;5434;0;5434;1;1;
/org.eclipse.help.ide/src/org/eclipse/help/ui/internal/search/HelpSearchQuery.java;1;1;4;1;4;4;4;0;10;0;0;5216;16;16;1;0;0;0;4;5216;0;5827;4;1;
/org.eclipse.team.cvs.core/src/org/eclipse/team/internal/ccvs/core/util/ResourceStateChangeListeners.java;1;0;2;1;0;0;0;2;27;1;2;2458;27;27;1;0;0;2;2;2458;0;2603;2;1;
/org.eclipse.ui.workbench/Eclipse UI/org/eclipse/ui/internal/presentations/PresentationFactoryUtil.java;3;1;3;1;3;3;3;0;9;0;0;5672;11;11;1;0;0;0;3;5672;0;6248;3;3;
/org.eclipse.team.ftp/src/org/eclipse/team/internal/ftp/deployment/PutOperation.java;1;0;1;1;0;0;0;1;0;0;1;3304;0;0;1;0;0;1;1;3304;0;3304;1;1;
/org.eclipse.update.ui/src/org/eclipse/update/internal/ui/views/IEmbeddedWebBrowser.java;1;0;1;1;0;0;0;1;0;0;1;786;0;0;1;0;0;1;1;786;0;786;1;1;
/org.eclipse.jdt.ui.tests.refactoring/resources/DeleteSourceReference/test15/in/A.java;1;0;1;1;0;0;0;1;0;0;1;1652;0;0;1;0;0;1;1;1652;0;1652;1;1;
/org.eclipse.jdt.ui.tests.refactoring/resources/Copy/test_method_yes_cu_with_main_type/in/A.java;1;0;1;1;0;0;0;1;2;0;1;685;2;2;1;0;0;1;1;685;0;685;1;1;
/org.eclipse.help.webapp/src_servlets/org/eclipse/help/internal/webapp/data/LayoutData.java;1;1;10;1;3;3;3;7;61;2;5;644;178;178;2;2;0;7;10;644;2;6337;8;1;
/org.eclipse.jdt.core.tests.model/workspace/Converter/src/NO_WORKING.java;1;0;1;1;0;0;0;1;0;0;1;3714;0;0;1;0;0;1;1;3714;0;3714;1;1;
/org.eclipse.pde.ui/src_Forms/org/eclipse/pde/internal/ui/neweditor/plugin/OverviewPage.java;3;2;20;1;4;3;4;16;328;2;13;3777;988;988;2;3;1;16;20;4219;4;5425;16;3;
/org.eclipse.jdt.ui/ui refactoring/org/eclipse/jdt/internal/ui/refactoring/reorg/CutSourceReferencesToClipboardAction.java;2;0;5;1;0;0;0;5;20;1;5;1112;30;30;1;0;0;5;5;1112;0;1650;5;2;
/org.eclipse.ant.ui/Ant Editor/org/eclipse/ant/ui/internal/editor/text/XMLReconcilingStrategy.java;1;0;2;1;0;0;0;2;0;1;2;250;0;0;1;0;0;2;2;250;0;1811;2;1;
/org.eclipse.ui.workbench/Eclipse UI/org/eclipse/ui/internal/skins/PartPresentation.java;1;0;2;1;0;0;0;2;0;1;2;4328;0;0;1;0;0;2;2;4328;0;4438;2;1;
/org.eclipse.core.tests.runtime/src/org/eclipse/core/tests/plugintests/CmdLinePreferencesTest.java;1;0;1;1;0;0;0;1;0;0;1;3014;0;0;1;0;0;1;1;3014;0;3014;1;1;
/org.eclipse.update.ui/src/org/eclipse/update/internal/ui/views/DetectedChangesAction.java;2;0;3;1;1;1;1;2;1;1;2;1180;1;1;1;0;0;2;3;1180;0;5518;3;2;
/org.eclipse.jdt.core.tests.model/workspace/Converter/test0298/Test.java;1;0;1;1;0;0;0;1;0;0;1;3714;0;0;1;0;0;1;1;3714;0;3714;1;1;
/org.eclipse.core.resources/src/org/eclipse/core/internal/localstore/DeleteVisitor.java;1;1;3;1;2;2;2;1;202;0;1;2967;212;212;1;0;0;1;3;2967;0;5486;3;1;
/org.eclipse.ui.workbench/Eclipse UI/org/eclipse/ui/internal/decorators/FullTextDecoratorRunnable.java;1;0;1;1;0;0;0;1;0;0;1;4237;0;0;1;0;0;1;1;4237;0;4237;1;1;
/org.eclipse.ui.ide/src/org/eclipse/ui/internal/actions/OpenWorkspaceFileAction.java;2;0;5;1;0;0;0;5;12;2;4;1520;20;20;2;1;0;5;5;1520;1;2263;4;2;
/org.eclipse.jdt.debug.ui/ui/org/eclipse/jdt/internal/debug/ui/snippeteditor/SnippetFileDocumentProvider.java;1;0;1;1;0;0;0;1;26;0;1;5067;26;26;1;0;0;1;1;5067;0;5067;1;1;
/org.eclipse.core.tests.runtime/src/org/eclipse/core/tests/internal/plugins/PluginResolveTest_27.java;1;0;1;1;0;0;0;1;0;0;1;3014;0;0;1;0;0;1;1;3014;0;3014;1;1;
/org.eclipse.pde.ui/templates/editor/java/XMLScanner.java;1;0;1;1;0;0;0;1;10;0;1;851;10;10;1;0;0;1;1;851;0;851;1;1;
/org.eclipse.osgi/core/framework/org/eclipse/osgi/framework/eventmgr/EventThread.java;4;1;7;1;4;4;4;3;301;1;3;3013;390;390;1;0;0;3;7;3013;0;5688;7;4;
/org.eclipse.jdt.ui.tests.refactoring/resources/ChangeSignature/canModify/A_testException05_out.java;1;0;1;1;1;1;1;0;0;0;0;5630;0;0;1;0;0;0;1;5630;0;5630;1;1;
/org.eclipse.jdt.core/search/org/eclipse/jdt/internal/core/index/Index.java;2;0;7;1;1;1;1;6;201;2;4;3384;249;249;2;2;0;6;7;3384;2;5272;5;2;
/org.eclipse.jdt.ui/core refactoring/org/eclipse/jdt/internal/corext/refactoring/base/IUndoManager.java;1;0;4;1;0;0;0;4;26;1;4;2682;45;45;1;0;0;4;4;2682;0;4575;4;1;
/org.eclipse.jdt.core/compiler/org/eclipse/jdt/internal/compiler/lookup/TypeVariableBinding.java;1;0;1;1;0;0;0;1;0;0;1;3579;0;0;1;0;0;1;1;3579;0;3579;1;1;
/org.eclipse.team.ui/src/org/eclipse/team/ui/sync/SyncInfoChangeTypeFilter.java;2;0;3;1;0;0;0;3;44;1;3;595;44;44;1;0;0;3;3;595;0;2632;3;2;
/org.eclipse.jdt.ui.examples.javafamily/src/org/eclipse/jsp/JspSearchEngine.java;2;0;3;1;0;0;0;3;4;1;3;1033;6;6;1;0;0;3;3;1033;0;1255;3;2;
/org.eclipse.jdt.core.tests.model/workspace/Converter/src/test0529/A.java;1;0;1;1;0;0;0;1;0;0;1;3714;0;0;1;0;0;1;1;3714;0;3714;1;1;
/org.eclipse.ui.ide/src/org/eclipse/ui/internal/ide/dialogs/ZipFileResourceExportOperation.java;1;0;1;1;0;0;0;1;0;0;1;2264;0;0;1;0;0;1;1;2264;0;2264;1;1;
/org.eclipse.core.tests.harness/src/org/eclipse/core/tests/harness/ExampleWorkspaceTest.java;1;0;1;1;1;1;1;0;224;0;0;5146;224;224;1;0;0;0;1;5146;0;5146;1;1;
/org.eclipse.jdt.core/dom/org/eclipse/jdt/internal/core/dom/rewrite/TrackedNodePosition.java;2;0;2;1;1;1;1;1;20;0;1;4802;20;20;1;0;0;1;2;4802;0;5404;2;2;
/org.eclipse.jface.text/src/org/eclipse/jface/text/DefaultUndoManager.java;2;1;8;1;5;5;5;3;192;1;3;849;426;426;1;0;0;3;8;849;0;6359;8;2;
/org.eclipse.search/search/org/eclipse/search/internal/ui/SelectAllAction.java;1;0;1;1;1;1;1;0;2;0;0;6340;2;2;1;0;0;0;1;6340;0;6340;1;1;
/org.eclipse.jdt.core/compiler/org/eclipse/jdt/internal/compiler/ast/ParameterizedExplicitConstructorCall.java;1;0;1;1;0;0;0;1;0;0;1;2729;0;0;1;0;0;1;1;2729;0;2729;1;1;
/org.eclipse.ui.externaltools/Ant Editor/org/eclipse/ui/externaltools/internal/ant/editor/AntEditorSaxDefaultHandler.java;1;0;2;1;0;0;0;2;0;1;2;178;0;0;1;0;0;2;2;178;0;282;2;1;
/org.eclipse.jdt.debug.ui/ui/org/eclipse/jdt/internal/debug/ui/display/DisplayViewerConfiguration.java;2;0;2;1;0;0;0;2;37;1;2;1240;39;39;1;0;0;2;2;1240;0;4130;2;2;
/org.eclipse.jdt.core.tests.model/workspace/Formatter/test308/A_out.java;1;0;1;1;0;0;0;1;0;0;1;2442;0;0;1;0;0;1;1;2442;0;2442;1;1;
/org.eclipse.ui.workbench/Eclipse UI/org/eclipse/ui/internal/CoolBarContributionItem.java;2;0;5;1;0;0;0;5;37;1;5;368;61;61;1;0;0;5;5;368;0;3220;5;2;
/org.eclipse.pde.core/src/org/eclipse/pde/internal/core/AbstractModel.java;3;2;12;2;6;5;6;6;22;1;6;2906;105;105;2;0;1;6;12;5536;1;6336;11;3;
/org.eclipse.update.core/src/org/eclipse/update/core/VersionedIdentifier.java;3;2;6;1;4;3;4;2;8;1;2;0;27;27;2;0;1;2;6;5663;1;6336;5;3;
/org.eclipse.jdt.ui.tests.refactoring/resources/PushDown/testEnablement1/in/A.java;1;0;1;1;0;0;0;1;0;0;1;1312;0;0;1;0;0;1;1;1312;0;1312;1;1;
/org.eclipse.ui.workbench/Eclipse UI/org/eclipse/ui/internal/chris/roles/api/IRoleManagerListener.java;1;0;2;1;0;0;0;2;0;0;1;2207;0;0;2;1;0;2;2;2207;1;2207;1;1;
/org.eclipse.ui.ide/src/org/eclipse/ui/views/navigator/ResourceNavigatorMoveAction.java;1;0;1;1;0;0;0;1;0;0;1;2208;0;0;1;0;0;1;1;2208;0;2208;1;1;
/org.eclipse.ltk.ui.refactoring.tests/src/org/eclipse/ltk/ui/refactoring/tests/RefactoringUITestPlugin.java;1;0;2;1;1;1;1;1;7;0;1;4845;7;7;1;0;0;1;2;4845;0;5380;2;1;
/org.eclipse.pde.core/src/org/eclipse/pde/internal/core/feature/FeatureData.java;2;1;3;1;2;2;2;1;32;0;1;4203;44;44;1;0;0;1;3;4203;0;6336;3;2;
/org.eclipse.debug.ui/ui/org/eclipse/debug/internal/ui/views/variables/ObjectBrowserManager.java;2;0;3;1;0;0;0;3;2;1;3;861;2;2;1;0;0;3;3;861;0;2647;3;2;
/org.eclipse.jdt.core.tests.model/workspace/Formatter/test358/A_in.java;1;0;1;1;0;0;0;1;0;0;1;3087;0;0;1;0;0;1;1;3087;0;3087;1;1;
/org.eclipse.pde.ui/src/org/eclipse/pde/internal/ui/wizards/imports/SourceCodeLocationsPreferenceNode.java;1;0;2;1;0;0;0;2;0;1;2;655;0;0;1;0;0;2;2;655;0;3986;2;1;
/org.eclipse.ui.workbench/Eclipse UI/org/eclipse/ui/internal/ExampleExceptionHandler.java;1;0;1;1;0;0;0;1;0;0;1;1259;0;0;1;0;0;1;1;1259;0;1259;1;1;
/org.eclipse.jdt.core.tests.model/workspace/Converter/test0042/Test.java;1;0;1;1;0;0;0;1;0;0;1;3714;0;0;1;0;0;1;1;3714;0;3714;1;1;
/org.eclipse.ant.ui/Ant Editor/org/eclipse/ant/internal/ui/editor/model/AntModelMessages.java;1;0;1;1;0;0;0;1;0;0;1;3661;0;0;1;0;0;1;1;3661;0;3661;1;1;
/org.eclipse.ui.views/src/org/eclipse/ui/views/framelist/ForwardAction.java;1;0;1;1;0;0;0;1;0;0;1;2738;0;0;1;0;0;1;1;2738;0;2738;1;1;
/org.eclipse.ui.workbench/Eclipse UI/org/eclipse/ui/internal/progress/JobInfoWithProgress.java;1;0;6;1;0;0;0;6;69;2;5;333;131;131;2;1;0;6;6;956;1;1094;5;1;
/org.eclipse.sdk.tests-feature/plugins/org.eclipse.perfmsr.core/src/org/eclipse/perfmsr/core/Upload.java;2;1;4;1;3;3;3;1;10;0;1;4845;14;14;1;0;0;1;4;4845;0;6342;4;2;
/org.eclipse.jdt.core/eval/org/eclipse/jdt/internal/eval/CodeSnippetMessageSend.java;3;0;9;1;0;0;0;9;162;1;9;41;190;190;1;0;0;9;9;41;0;3560;9;3;
/org.eclipse.debug.ui/ui/org/eclipse/debug/internal/ui/preferences/DebugPreferencePage.java;5;1;21;2;4;4;4;17;81;2;16;267;288;288;2;1;0;17;21;4854;1;5731;20;5;
/org.eclipse.ui.workbench/Eclipse UI/org/eclipse/ui/internal/commands/KeyBindingDefinition.java;1;0;10;1;0;0;0;10;85;5;5;1389;164;164;5;5;0;10;10;1389;5;2532;5;1;
/org.eclipse.jdt.core.tests.model/workspace/Resolve/src/ResolveLocalName.java;1;0;1;1;0;0;0;1;19;0;1;2420;19;19;1;0;0;1;1;2420;0;2420;1;1;
/org.eclipse.jdt.ui.tests.refactoring/resources/Paste/test0/out/A.java;1;0;1;1;0;0;0;1;0;0;1;1311;0;0;1;0;0;1;1;1311;0;1311;1;1;
/org.eclipse.ui.editors/src/org/eclipse/ui/internal/editors/quickdiff/compare/rangedifferencer/DocLineComparator.java;2;0;2;1;0;0;0;2;0;1;2;1118;0;0;1;0;0;2;2;1118;0;1644;2;2;
/org.eclipse.core.tests.runtime/src/org/eclipse/core/tests/internal/registrycache/SimpleCacheTests.java;1;0;3;1;0;0;0;3;144;1;3;208;150;150;1;0;0;3;3;208;0;3014;3;1;
/org.eclipse.team.examples.filesystem/src/org/eclipse/team/examples/filesystem/SimpleAccessOperations.java;2;0;3;1;0;0;0;3;267;1;3;2780;267;267;1;0;0;3;3;2780;0;4368;3;2;
/org.eclipse.jdt.core.tests.model/workspace/TypeHierarchy/src/p8/X.java;1;0;1;1;0;0;0;1;0;0;1;2360;0;0;1;0;0;1;1;2360;0;2360;1;1;
/org.eclipse.help.tests/src/org/eclipse/help/tests/manual/StandaloneTest.java;1;1;2;1;2;2;2;0;12;0;0;5827;21;21;1;0;0;0;2;5827;0;6337;2;1;
/org.eclipse.jdt.core.tests.model/workspace/Converter/src/test0545/Third.java;1;0;1;1;1;1;1;0;0;0;0;5313;0;0;1;0;0;0;1;5313;0;5313;1;1;
/org.eclipse.pde.runtime/src/org/eclipse/pde/internal/runtime/logview/LogEntryPropertyPage.java;2;0;4;1;0;0;0;4;12;1;4;924;13;13;1;0;0;4;4;924;0;3621;4;2;
/org.eclipse.ui.intro/src/org/eclipse/ui/intro/internal/model/AbstractIntroPart.java;1;0;3;1;0;0;0;3;413;1;3;4429;413;413;1;0;0;3;3;4429;0;4609;3;1;
/org.eclipse.team.examples.filesystem/src/org/eclipse/team/examples/pessimistic/PessimisticModificationValidator.java;1;1;3;1;2;2;2;1;326;0;1;3368;355;355;1;0;0;1;3;3368;0;6262;3;1;
/org.eclipse.ui.editors/src/org/eclipse/ui/internal/editors/quickdiff/LastSaveReferenceProvider.java;3;1;19;1;6;6;6;13;236;2;12;1214;802;802;2;1;0;13;19;1250;1;6340;18;3;
/org.eclipse.jdt.ui.tests.refactoring/resources/ExtractMethodWorkSpace/ExtractMethodTests/locals_out/A_test531.java;1;0;1;1;0;0;0;1;4;0;1;844;4;4;1;0;0;1;1;844;0;844;1;1;
/org.eclipse.ui.views/src/org/eclipse/ui/views/navigator/StringMatcher.java;2;0;2;1;0;0;0;2;6;1;2;1442;6;6;1;0;0;2;2;1442;0;2738;2;2;
/org.eclipse.ui.workbench/Eclipse UI/org/eclipse/ui/internal/activities/ui/SwapActivityHelper.java;2;0;9;1;0;0;0;9;287;2;8;2444;349;349;2;1;0;9;9;2864;1;3066;8;2;
/org.eclipse.ui.workbench/Eclipse UI/org/eclipse/ui/internal/commands/api/older/IAction.java;1;0;1;1;0;0;0;1;0;0;1;2562;0;0;1;0;0;1;1;2562;0;2562;1;1;
/org.eclipse.jdt.ui.tests.refactoring/resources/ChangeTypeRefactoring/negative/A_testMultiDeclaration_in.java;1;0;1;1;0;0;0;1;0;0;1;2844;0;0;1;0;0;1;1;2844;0;2844;1;1;
/org.eclipse.jdt.core.tests.model/src/org/eclipse/jdt/core/tests/dom/ASTStructuralPropertyTest.java;1;0;3;1;1;1;1;2;51;1;2;4202;59;59;1;0;0;2;3;4202;0;5272;3;1;
/org.eclipse.pde.ui/src/org/eclipse/pde/internal/ui/wizards/project/ProjectCodeGeneratorsPage.java;3;0;11;2;0;0;0;11;116;2;9;867;248;248;2;2;0;11;11;3045;2;3840;9;3;
/org.eclipse.jdt.core/model/org/eclipse/jdt/internal/core/SourceMapper.java;5;1;19;1;4;4;4;15;53;2;14;61;232;232;2;1;0;15;19;148;1;6243;18;5;
/org.eclipse.jdt.debug.tests/testprograms/org/eclipse/debug/tests/targets/CallStack.java;1;0;1;1;0;0;0;1;0;0;1;584;0;0;1;0;0;1;1;584;0;584;1;1;
/org.eclipse.core.runtime/src/org/eclipse/core/internal/registry/IRegistryConstants.java;3;1;5;1;2;2;2;3;34;1;3;3049;37;37;1;0;0;3;5;3049;0;5531;5;3;
/org.eclipse.core.tools.resources/src/org/eclipse/core/tools/metadata/MetadataPerspective.java;1;0;1;1;1;1;1;0;0;0;0;6302;0;0;1;0;0;0;1;6302;0;6302;1;1;
/org.eclipse.ui.tests/Eclipse UI Tests/org/eclipse/ui/tests/themes/ThemePropertyListener.java;1;0;1;1;0;0;0;1;0;0;1;5025;0;0;1;0;0;1;1;5025;0;5025;1;1;
/org.eclipse.pde.ui/src_Forms/org/eclipse/pde/internal/ui/neweditor/plugin/rows/TextAttributeRow.java;2;1;5;1;2;2;2;3;14;2;2;4354;22;22;2;1;0;3;5;4354;1;5431;4;2;
/org.eclipse.jdt.core/compiler/org/eclipse/jdt/internal/compiler/util/HashtableOfPackage.java;2;0;3;1;0;0;0;3;6;1;3;3560;10;10;1;0;0;3;3;3560;0;4469;3;2;
/org.eclipse.jdt.ui/core refactoring/org/eclipse/jdt/internal/corext/refactoring/code/CallContext.java;2;0;2;1;1;1;1;1;6;0;1;1952;8;8;1;0;0;1;2;1952;0;6340;2;2;
/org.eclipse.ui.workbench/Eclipse UI/org/eclipse/ui/dialogs/PropertyPage.java;1;0;1;1;1;1;1;0;77;0;0;5467;77;77;1;0;0;0;1;5467;0;5467;1;1;
/org.eclipse.team.ui/src/org/eclipse/team/internal/ui/ImportProjectSetMainPage.java;1;0;1;1;0;0;0;1;0;0;1;993;0;0;1;0;0;1;1;993;0;993;1;1;
/org.eclipse.jdt.ui.tests.refactoring/test cases/org/eclipse/jdt/ui/tests/reorg/DeleteSourceReferenceActionTests.java;1;0;3;1;0;0;0;3;1;1;3;1111;1;1;1;0;0;3;3;1111;0;1650;3;1;
/org.eclipse.compare/compare/org/eclipse/compare/internal/CompareNavigator.java;1;0;1;1;0;0;0;1;34;0;1;1735;34;34;1;0;0;1;1;1735;0;1735;1;1;
/org.eclipse.update.ui/srcnew/org/eclipse/update/internal/ui/views/NewConfigurationView.java;3;0;40;3;0;0;0;40;651;6;23;299;2769;2769;6;17;0;40;40;743;17;766;23;3;
/org.eclipse.jface.text/src/org/eclipse/jface/text/TextPresentation.java;4;1;14;1;6;6;6;8;139;1;8;1347;426;426;1;0;0;8;14;1347;0;6359;14;4;
/org.eclipse.pde.ui/sandbox/org/eclipse/pde/internal/ui/editor/standalone/parser/IDocumentNode.java;1;0;2;1;0;0;0;2;0;1;2;2320;0;0;1;0;0;2;2;2320;0;2906;2;1;
/org.eclipse.team.ui/src/org/eclipse/team/ui/synchronize/presentation/DiffNodeController.java;1;0;1;1;0;0;0;1;0;0;1;4077;0;0;1;0;0;1;1;4077;0;4077;1;1;
/org.eclipse.core.resources/src/org/eclipse/core/resources/IFile.java;3;2;20;2;11;10;11;9;1576;1;9;44;2024;2024;2;0;1;9;20;5168;1;6339;19;3;
/org.eclipse.ui.workbench/Eclipse UI/org/eclipse/ui/internal/csm/roles/api/RoleDefinition.java;1;0;2;1;0;0;0;2;0;1;2;2213;0;0;1;0;0;2;2;2213;0;2225;2;1;
/org.eclipse.jdt.core.tests.model/workspace/Formatter/test199/A_out.java;1;0;1;1;0;0;0;1;0;0;1;2424;0;0;1;0;0;1;1;2424;0;2424;1;1;
/org.eclipse.team.cvs.ui/src/org/eclipse/team/internal/ccvs/ui/wizards/TagSelectionWizardPage.java;1;1;5;1;4;4;4;1;51;0;1;4869;93;93;1;0;0;1;5;4869;0;6015;5;1;
/org.eclipse.swt.tests/JUnit Tests/org/eclipse/swt/tests/junit/AllTests.java;4;0;12;1;1;1;1;11;32;2;10;97;65;65;2;1;0;11;12;3007;1;6352;11;4;
/org.eclipse.jface.text/projection/org/eclipse/jface/text/source/projection/ProjectionRulerColumn.java;2;2;12;1;9;8;9;3;75;1;3;4516;240;240;2;0;1;3;12;5677;1;6362;11;2;
/org.eclipse.jdt.ui.tests.refactoring/resources/IntroduceFactory/positive/differentArgs1_in.java;1;0;2;1;0;0;0;2;0;1;2;2846;0;0;1;0;0;2;2;2846;0;2862;2;1;
/org.eclipse.ui.ide/src/org/eclipse/ui/wizards/datatransfer/PopulateElementOperation.java;1;0;1;1;0;0;0;1;0;0;1;1511;0;0;1;0;0;1;1;1511;0;1511;1;1;
/org.eclipse.jdt.ui.tests.refactoring/resources/MoveInnerToTopLevel/test_nonstatic_31/out/Inner.java;2;0;2;1;1;1;1;1;8;0;1;305;10;10;1;0;0;1;2;305;0;5854;2;2;
/org.eclipse.jdt.ui.tests.refactoring/resources/RenameVirtualMethodInClass/testFail35/in/A.java;1;0;1;1;1;1;1;0;0;0;0;5524;0;0;1;0;0;0;1;5524;0;5524;1;1;
/org.eclipse.jface/src/org/eclipse/jface/viewers/TableTreeViewer.java;2;0;3;1;1;1;1;2;10;1;2;4235;17;17;1;0;0;2;3;4235;0;6338;3;2;
/org.eclipse.update.tests.core/src/org/eclipse/update/tests/configurations/TestBackward.java;2;0;7;1;1;1;1;6;11;1;6;3813;31;31;1;0;0;6;7;3813;0;6336;7;2;
/org.eclipse.jdt.ui.tests.refactoring/test cases/org/eclipse/jdt/ui/tests/xml/TypeExtenderTests.java;1;0;4;1;0;0;0;4;30;1;4;2204;37;37;1;0;0;4;4;2204;0;4091;4;1;
/org.eclipse.update.configurator/src/org/eclipse/update/configurator/ConfiguratorUtils.java;1;2;4;1;3;2;3;1;7;0;1;3544;14;14;2;0;1;1;4;6336;1;6336;3;1;
/org.eclipse.jdt.debug.jdi.tests/tests/org/eclipse/debug/jdi/tests/program/TestClazz8.java;1;0;1;1;1;1;1;0;3;0;0;6339;3;3;1;0;0;0;1;6339;0;6339;1;1;
/org.eclipse.update.core/src/org/eclipse/update/core/ISiteFactory.java;2;1;3;1;2;2;2;1;6;0;1;890;16;16;1;0;0;1;3;890;0;6336;3;2;
/org.eclipse.pde.ui/src_Forms/org/eclipse/pde/internal/ui/neweditor/runtime/RuntimePage.java;2;0;4;1;0;0;0;4;11;1;4;4406;15;15;1;0;0;4;4;4406;0;4919;4;2;
/org.eclipse.jdt.ui.tests.refactoring/resources/ConvertAnonymousToNested/canConvert/A_test26_out.java;1;0;1;1;0;0;0;1;0;0;1;3195;0;0;1;0;0;1;1;3195;0;3195;1;1;
/org.eclipse.ant.tests.ui/Ant Editor Tests/org/eclipse/ant/ui/internal/editor/support/TestUtils.java;1;0;2;1;0;0;0;2;0;1;2;1274;0;0;1;0;0;2;2;1274;0;1388;2;1;
/org.eclipse.ui.externaltools/Ant Tools Support/org/eclipse/ui/externaltools/internal/ant/preferences/AntEditorPreferenceConstants.java;1;0;3;1;0;0;0;3;69;2;2;178;69;69;2;1;0;3;3;178;1;282;2;1;
/org.eclipse.update.core/src/org/eclipse/update/configuration/IConfiguredSiteChangedListener.java;1;0;1;1;0;0;0;1;2;0;1;890;2;2;1;0;0;1;1;890;0;890;1;1;
/org.eclipse.jdt.core.tests.model/workspace/Converter/test0324/Test.java;1;0;1;1;0;0;0;1;0;0;1;3714;0;0;1;0;0;1;1;3714;0;3714;1;1;
/org.eclipse.jdt.ui.examples.projects/examples/org/eclipse/jdt/internal/ui/exampleprojects/ExampleProjectCreationWizard.java;2;0;2;1;1;1;1;1;3;0;1;2756;5;5;1;0;0;1;2;2756;0;6340;2;2;
/org.eclipse.ant.ui/Ant Editor/org/eclipse/ant/ui/internal/dtd/util/SortedMapFactory.java;1;0;2;1;0;0;0;2;0;1;2;250;0;0;1;0;0;2;2;250;0;1811;2;1;
/org.eclipse.jdt.core/compiler/org/eclipse/jdt/internal/compiler/ast/ParameterizedQualifiedTypeReference.java;1;0;1;1;0;0;0;1;0;0;1;2728;0;0;1;0;0;1;1;2728;0;2728;1;1;
/org.eclipse.swt/Eclipse SWT/motif/org/eclipse/swt/widgets/Decorations.java;5;1;11;2;3;3;3;8;116;2;7;83;310;310;2;1;0;8;11;2627;1;6352;10;5;
/org.eclipse.swt/Eclipse SWT PI/gtk1x/org/eclipse/swt/internal/gtk/GtkWindow.java;1;0;1;1;0;0;0;1;0;0;1;2327;0;0;1;0;0;1;1;2327;0;2327;1;1;
/org.eclipse.jdt.launching/launching/org/eclipse/jdt/launching/sourcelookup/containers/JavaSourceLookupParticipant.java;2;1;5;1;3;3;3;2;56;1;2;4971;72;72;1;0;0;2;5;4971;0;6041;5;2;
/org.eclipse.pde.core/src/org/eclipse/pde/internal/core/site/SiteBuild.java;2;1;4;1;3;3;3;1;39;0;1;4203;80;80;1;0;0;1;4;4203;0;6336;4;2;
/org.eclipse.jdt.core.tests.model/workspace/Formatter/test018/A_out.java;1;0;1;1;0;0;0;1;0;0;1;2425;0;0;1;0;0;1;1;2425;0;2425;1;1;
/org.eclipse.jdt.ui/ui refactoring/org/eclipse/jdt/internal/ui/refactoring/ComboSelectionDialog.java;1;0;1;1;1;1;1;0;2;0;0;6340;2;2;1;0;0;0;1;6340;0;6340;1;1;
/org.eclipse.jdt.core/compiler/org/eclipse/jdt/internal/compiler/codegen/FieldNameAndTypeCache.java;2;0;2;1;1;1;1;1;2;0;1;3560;4;4;1;0;0;1;2;3560;0;5916;2;2;
/org.eclipse.ui.workbench/Eclipse UI/org/eclipse/ui/internal/activities/ActivityManagerEvent.java;1;0;4;1;0;0;0;4;8;2;3;2444;10;10;2;1;0;4;4;2800;1;2800;3;1;
/org.eclipse.jdt.core/dom/org/eclipse/jdt/core/dom/rewrite/NewASTRewrite.java;2;0;4;2;0;0;0;4;317;2;3;4711;323;323;2;1;0;4;4;4711;1;4802;3;2;
/org.eclipse.core.tests.resources/src/org/eclipse/core/tests/resources/IProjectTest.java;2;3;9;1;4;2;4;5;4270;1;5;177;4464;4464;3;0;2;5;9;5147;2;5408;7;2;
/org.eclipse.ui.examples.job/org/eclipse/ui/examples/jobs/views/DeferredContentProvider.java;1;0;2;1;2;1;2;0;0;0;0;5125;0;0;2;0;1;0;2;5125;1;5125;1;1;
/org.eclipse.ant.ui/Ant Tools Support/org/eclipse/ant/internal/ui/preferences/AntRuntimePreferencePage.java;1;0;7;1;0;0;0;7;29;2;6;1811;79;79;2;1;0;7;7;1811;1;3148;6;1;
/org.eclipse.team.core/src/org/eclipse/team/core/sync/IRemoteSyncElement.java;1;0;1;1;0;0;0;1;0;0;1;4217;0;0;1;0;0;1;1;4217;0;4217;1;1;
/org.eclipse.swt/Eclipse SWT/common_j2me/org/eclipse/swt/internal/Compatibility.java;3;1;4;1;2;2;2;2;15;1;2;4167;27;27;1;0;0;2;4;4167;0;6352;4;3;
/org.eclipse.ui.ide/src/org/eclipse/ui/dialogs/ResourceListSelectionDialog.java;2;0;5;1;0;0;0;5;10;1;5;1511;14;14;1;0;0;5;5;1511;0;2263;5;2;
/org.eclipse.ui.tests/Eclipse UI Tests/org/eclipse/ui/tests/commands/Bug66182Test.java;2;1;3;1;3;3;3;0;72;0;0;6224;76;76;1;0;0;0;3;6224;0;6338;3;2;
/org.eclipse.ui.workbench/Eclipse UI/org/eclipse/ui/ICapabilityUninstallWizard.java;1;0;1;1;0;0;0;1;0;0;1;2737;0;0;1;0;0;1;1;2737;0;2737;1;1;
/org.eclipse.jface.text/src/org/eclipse/jface/text/source/IVerticalRulerExtension.java;2;1;2;1;2;2;2;0;7;0;0;6340;9;9;1;0;0;0;2;6340;0;6361;2;2;
/org.eclipse.core.tools/src/org/eclipse/core/tools/CopyStructuredSelectionAction.java;1;0;1;1;1;1;1;0;0;0;0;6302;0;0;1;0;0;0;1;6302;0;6302;1;1;
/org.eclipse.update.ui/src/org/eclipse/update/internal/ui/ConfigurationManagerWindow.java;4;1;8;1;4;4;4;4;229;1;4;825;290;290;1;0;0;4;8;825;0;6336;8;4;
/org.eclipse.update.ui.forms/Eclipse Forms/org/eclipse/ui/forms/internal/parts/BulletParagraph.java;1;0;2;1;0;0;0;2;0;1;2;3096;0;0;1;0;0;2;2;3096;0;3138;2;1;
/org.eclipse.jdt.core.tests.model/workspace/Converter/test0291/Test.java;1;0;1;1;0;0;0;1;0;0;1;3714;0;0;1;0;0;1;1;3714;0;3714;1;1;
/org.eclipse.jdt.core/compiler/org/eclipse/jdt/internal/compiler/flow/ExceptionHandlingFlowContext.java;2;0;6;1;0;0;0;6;29;1;6;485;50;50;1;0;0;6;6;485;0;3651;6;2;
/org.eclipse.jdt.ui/ui/org/eclipse/jdt/internal/ui/packageview/PackagesFrameSource.java;1;0;1;1;1;1;1;0;2;0;0;6340;2;2;1;0;0;0;1;6340;0;6340;1;1;
/org.eclipse.jdt.core.tests.model/workspace/Formatter/test222/A_out.java;1;0;1;1;0;0;0;1;0;0;1;2426;0;0;1;0;0;1;1;2426;0;2426;1;1;
/org.eclipse.debug.ui/ui/org/eclipse/debug/ui/variables/ResourceExpander.java;1;0;4;1;0;0;0;4;136;3;2;316;136;136;3;2;0;4;4;316;2;550;2;1;
/org.eclipse.jdt.core/model/org/eclipse/jdt/core/util/IConstantValueAttribute.java;1;0;1;1;0;0;0;1;2;0;1;3560;2;2;1;0;0;1;1;3560;0;3560;1;1;
/org.eclipse.jdt.ui.tests.refactoring/test cases/org/eclipse/jdt/ui/tests/nls/OrderedMapTester.java;2;0;2;1;1;1;1;1;50;0;1;4930;52;52;1;0;0;1;2;4930;0;6340;2;2;
/org.eclipse.jdt.ui.tests/leaks/org/eclipse/jdt/ui/tests/ProfileNatives.java;2;0;1;2;0;0;0;1;0;0;1;3124;0;0;1;0;0;1;1;3124;0;3124;1;2;
/org.eclipse.ui.workbench/Eclipse UI/org/eclipse/ui/internal/decorators/DecorationResult.java;2;2;3;1;3;2;3;0;23;0;0;6143;25;25;2;0;1;0;3;6143;1;6338;2;2;
/org.eclipse.update.core/src/org/eclipse/update/internal/operations/DuplicateConflictsValidator.java;1;1;7;1;4;4;4;3;30;1;3;825;45;45;1;0;0;3;7;825;0;6336;7;1;
/org.eclipse.swt/Eclipse SWT Mozilla/common/org/eclipse/swt/internal/mozilla/NsWidgetsCID.java;1;0;2;1;0;0;0;2;0;1;2;1654;0;0;1;0;0;2;2;1654;0;1674;2;1;
/org.eclipse.jdt.ui/ui/org/eclipse/jdt/internal/ui/preferences/NameConventionConfigurationBlock.java;2;0;11;1;1;1;1;10;29;1;10;882;124;124;1;0;0;10;11;882;0;6340;11;2;
/org.eclipse.jdt.ui.tests.refactoring/resources/Paste/test4/out/A.java;1;0;1;1;0;0;0;1;0;0;1;1311;0;0;1;0;0;1;1;1311;0;1311;1;1;
/org.eclipse.jdt.core.tests.model/src/org/eclipse/jdt/core/tests/model/NameLookupTests2.java;1;0;6;1;1;1;1;5;46;2;4;549;118;118;2;1;0;5;6;3606;1;5855;5;1;
/org.eclipse.pde.ui/src_Forms/org/eclipse/pde/internal/ui/neweditor/feature/ReferenceWizardPage.java;2;0;2;1;1;1;1;1;0;0;1;4926;0;0;1;0;0;1;2;4926;0;5431;2;2;
/org.eclipse.core.tests.resources/src/org/eclipse/core/tests/resources/TeamPrivateMemberTest.java;1;0;3;1;3;1;3;0;1567;0;0;5147;1567;1567;3;0;2;0;3;5147;2;5147;1;1;
/org.eclipse.jdt.ui.tests.refactoring/resources/RenamePackage/test0/in/r/A.java;1;0;1;1;0;0;0;1;6;0;1;4585;6;6;1;0;0;1;1;4585;0;4585;1;1;
/org.eclipse.pde.ui/src_Forms/org/eclipse/pde/internal/ui/neweditor/plugin/ExtensionPointDetails.java;3;3;24;2;6;4;6;18;222;2;13;3812;728;728;3;5;2;18;24;5282;7;5431;17;3;
/org.eclipse.jdt.junit/src/org/eclipse/jdt/internal/junit/refactoring/LaunchConfigProjectChange.java;2;0;2;1;1;1;1;1;10;0;1;5041;10;10;1;0;0;1;2;5041;0;6340;2;2;
/org.eclipse.jdt.ui/ui/org/eclipse/jdt/internal/ui/jarpackager/JarPackageWriter.java;2;1;4;1;2;2;2;2;40;1;2;2452;53;53;1;0;0;2;4;2452;0;6340;4;2;
/org.eclipse.ui.externaltools/Ant Editor/org/eclipse/ui/externaltools/internal/ant/dtd/schema/Attribute.java;1;0;1;1;0;0;0;1;0;0;1;282;0;0;1;0;0;1;1;282;0;282;1;1;
/org.eclipse.ui.ide/src/org/eclipse/ui/views/navigator/RefactorActionGroup.java;5;0;6;1;1;1;1;5;20;1;5;2208;50;50;1;0;0;5;6;2208;0;6338;6;5;
/org.eclipse.ui.workbench/Eclipse UI/org/eclipse/ui/commands/IActionServiceEvent.java;1;0;5;1;0;0;0;5;2;2;4;1419;2;2;2;1;0;5;5;2562;1;3129;4;1;
/org.eclipse.jdt.core/codeassist/org/eclipse/jdt/internal/codeassist/ISelectionRequestor.java;2;1;3;1;2;2;2;1;42;0;1;3560;61;61;1;0;0;1;3;3560;0;6222;3;2;
/org.eclipse.ui.examples.javaeditor/Eclipse Java Editor Example/org/eclipse/ui/examples/javaeditor/util/JavaWhitespaceDetector.java;1;0;1;1;1;1;1;0;2;0;0;6340;2;2;1;0;0;0;1;6340;0;6340;1;1;
/org.eclipse.pde.ui/src/org/eclipse/pde/internal/ui/wizards/tools/PluginToBundleAction.java;1;0;3;1;0;0;0;3;12;1;3;3840;12;12;1;0;0;3;3;3840;0;4139;3;1;
/org.eclipse.ui.workbench.texteditor/src/org/eclipse/ui/texteditor/InfoForm.java;2;1;3;1;3;3;3;0;5;0;0;5123;8;8;1;0;0;0;3;5123;0;6340;3;2;
/org.eclipse.ui.ide/src/org/eclipse/ui/views/framelist/IFrameListHelpContextIds.java;1;0;1;1;0;0;0;1;0;0;1;2208;0;0;1;0;0;1;1;2208;0;2208;1;1;
/org.eclipse.core.tests.runtime/src/org/eclipse/core/tests/internal/runtimetests/SampleNPB.java;1;0;1;1;1;1;1;0;21;0;0;5149;21;21;1;0;0;0;1;5149;0;5149;1;1;
/org.eclipse.ui.ide/src/org/eclipse/ui/views/markers/internal/IField.java;2;0;2;1;0;0;0;2;5;1;2;2208;5;5;1;0;0;2;2;2208;0;3214;2;2;
/org.eclipse.ui.workbench/Eclipse UI/org/eclipse/ui/internal/actions/ActivityEnablerAction.java;4;0;14;2;1;1;1;13;137;3;9;2844;342;342;3;4;0;13;14;3457;4;5872;10;4;
/org.eclipse.pde.ui/src/org/eclipse/pde/internal/ui/editor/plugin/rows/BooleanAttributeRow.java;3;1;5;1;5;5;5;0;23;0;0;5431;47;47;1;0;0;0;5;5431;0;6336;5;3;
/org.eclipse.ui.workbench/Eclipse UI/org/eclipse/ui/internal/dialogs/SimpleListContentProvider.java;1;0;1;1;0;0;0;1;0;0;1;2737;0;0;1;0;0;1;1;2737;0;2737;1;1;
/org.eclipse.update.ui.forms/src/org/eclipse/ui/forms/HyperlinkManager.java;1;0;2;1;0;0;0;2;0;1;2;3038;0;0;1;0;0;2;2;3038;0;3051;2;1;
/org.eclipse.ui.workbench/Eclipse UI/org/eclipse/ui/internal/commands/older/CommandEvent.java;1;0;2;1;0;0;0;2;4;0;1;2562;4;4;2;1;0;2;2;2562;1;2562;1;1;
/org.eclipse.jdt.core.tests.model/workspace/Converter/src/test0323/Test.java;1;0;1;1;0;0;0;1;0;0;1;3714;0;0;1;0;0;1;1;3714;0;3714;1;1;
/org.eclipse.text/src/org/eclipse/jface/text/IDocumentInformationMapping.java;2;1;3;1;2;2;2;1;12;0;1;4232;16;16;1;0;0;1;3;4232;0;6340;3;2;
/org.eclipse.jdt.core.tests.model/workspace/Converter/src/test0140/Test.java;1;0;1;1;0;0;0;1;0;0;1;3714;0;0;1;0;0;1;1;3714;0;3714;1;1;
/org.eclipse.team.cvs.ui/src/org/eclipse/team/internal/ccvs/ui/repo/RefreshRemoteProjectWizard.java;2;1;2;1;2;2;2;0;31;0;0;6150;33;33;1;0;0;0;2;6150;0;6337;2;2;
/org.eclipse.jdt.ui.tests.refactoring/test cases/org/eclipse/jdt/ui/tests/typeconstraints/TypeConstraintTests.java;3;1;15;1;2;2;2;13;319;5;9;53;416;416;5;4;0;13;15;65;4;6340;11;3;
/org.eclipse.jdt.core.tests.model/workspace/Formatter/test500/A_in.java;1;0;1;1;1;1;1;0;0;0;0;5871;0;0;1;0;0;0;1;5871;0;5871;1;1;
/org.eclipse.update.core/srcnew/org/eclipse/update/internal/search/UpdateSearchInput.java;1;0;3;1;0;0;0;3;24;2;2;553;24;24;2;1;0;3;3;572;1;572;2;1;
/org.eclipse.ui.workbench/Eclipse UI/org/eclipse/ui/internal/commands/util/old/Point.java;1;0;2;1;0;0;0;2;0;1;2;1222;0;0;1;0;0;2;2;1222;0;1322;2;1;
/org.eclipse.team.ui/src/org/eclipse/team/internal/ui/sync/actions/CancelSubscription.java;1;0;7;1;0;0;0;7;17;1;7;848;59;59;1;0;0;7;7;848;0;2632;7;1;
/org.eclipse.team.core/src/org/eclipse/team/internal/core/subscribers/caches/PersistantResourceVariantByteStore.java;1;0;4;1;0;0;0;4;160;1;4;4216;190;190;1;0;0;4;4;4216;0;4349;4;1;
/org.eclipse.team.ui/src/org/eclipse/team/ui/synchronize/SyncInfoDiffTreeNavigator.java;1;0;1;1;0;0;0;1;0;0;1;3617;0;0;1;0;0;1;1;3617;0;3617;1;1;
/org.eclipse.debug.ui/ui/org/eclipse/debug/internal/ui/launchConfigurations/PerspectiveManager.java;4;1;24;1;8;8;8;16;242;1;16;618;1009;1009;1;0;0;16;24;618;0;6336;24;4;
/org.eclipse.jdt.ui/ui refactoring/org/eclipse/jdt/internal/ui/refactoring/InlineTempWizard.java;4;1;10;1;2;2;2;8;242;2;7;518;303;303;2;1;0;8;10;518;1;6340;9;4;
/org.eclipse.ui.ide/src/org/eclipse/ui/views/markers/internal/TableViewLabelProvider.java;1;0;1;1;0;0;0;1;0;0;1;2208;0;0;1;0;0;1;1;2208;0;2208;1;1;
/org.eclipse.pde.ui/src_Forms/org/eclipse/pde/internal/ui/neweditor/schema/NewCompositorAction.java;2;0;2;1;1;1;1;1;0;0;1;4856;0;0;1;0;0;1;2;4856;0;5431;2;2;
/org.eclipse.ui.workbench/Eclipse UI/org/eclipse/ui/keys/SWTKeySupport.java;3;1;4;1;2;2;2;2;100;1;2;3214;154;154;1;0;0;2;4;3214;0;6338;4;3;
/org.eclipse.team.tests.cvs.core/src/org/eclipse/team/tests/ccvs/ui/old/ILogEntryVisitor.java;1;0;2;1;0;0;0;2;0;1;2;2632;0;0;1;0;0;2;2;2632;0;4216;2;1;
/org.eclipse.pde.build/src/org/eclipse/pde/internal/build/AssembleScriptGenerator.java;2;1;9;1;2;2;2;7;9;1;7;447;21;21;1;0;0;7;9;447;0;6272;9;2;
/org.eclipse.jdt.ui.tests.refactoring/resources/Paste/test0/in/B.java;1;0;1;1;0;0;0;1;0;0;1;1311;0;0;1;0;0;1;1;1311;0;1311;1;1;
/org.eclipse.jdt.debug.tests/test plugin/org/eclipse/jdt/debug/testplugin/JavaProjectHelper.java;1;0;1;1;0;0;0;1;2;0;1;2497;2;2;1;0;0;1;1;2497;0;2497;1;1;
/org.eclipse.jdt.ui/core refactoring/org/eclipse/ltk/core/refactoring/IValidationStateListener.java;1;0;3;1;0;0;0;3;2;1;3;4510;2;2;1;0;0;3;3;4510;0;4864;3;1;
/org.eclipse.ant.ui/Ant Tools Support/org/eclipse/ant/internal/ui/preferences/AntObjectLabelProvider.java;2;0;3;1;0;0;0;3;3;1;3;1935;5;5;1;0;0;3;3;1935;0;2991;3;2;
/org.eclipse.swt.tests/JUnit Tests/org/eclipse/swt/tests/junit/Test_org_eclipse_swt_accessibility_Accessible.java;2;0;5;1;1;1;1;4;40;1;4;2104;113;113;1;0;0;4;5;2104;0;6352;5;2;
/org.eclipse.jdt.core.tests.model/workspace/Converter/test0111/Test.java;1;0;1;1;0;0;0;1;0;0;1;3714;0;0;1;0;0;1;1;3714;0;3714;1;1;
/org.eclipse.ui.externaltools/External Tools Base/org/eclipse/ui/externaltools/internal/launchConfigurations/ExternalToolsBuilderTab.java;3;0;29;2;0;0;0;29;129;2;24;283;498;498;2;5;0;29;29;283;5;4918;24;3;
/org.eclipse.core.resources.linux/src/org/eclipse/core/resources/refresh/linux/ResourceEvent.java;1;0;2;1;0;0;0;2;0;1;2;4346;0;0;1;0;0;2;2;4346;0;4851;2;1;
/org.eclipse.core.runtime/src/org/eclipse/core/internal/jobs/DeadlockDetector.java;3;2;19;1;4;3;4;15;2190;2;12;2823;5945;5945;2;3;1;15;19;2823;4;5642;15;3;
/org.eclipse.ui.workbench/Eclipse UI/org/eclipse/ui/internal/commands/SimpleHandlerService.java;1;0;5;1;0;0;0;5;25;1;5;1065;26;26;1;0;0;5;5;1065;0;1222;5;1;
/org.eclipse.pde.ui/src/org/eclipse/pde/internal/ui/parts/SharedPartWithButtons.java;1;1;2;1;2;2;2;0;82;0;0;5431;86;86;1;0;0;0;2;5431;0;6336;2;1;
/org.eclipse.team.ui/src/org/eclipse/team/internal/ui/synchronize/actions/ClearWorkingSetAction.java;2;0;3;1;1;1;1;2;48;1;2;2535;48;48;1;0;0;2;3;2535;0;5596;3;2;
/org.eclipse.core.tests.resources/src/org/eclipse/core/tests/resources/regression/Bug_28981.java;1;0;2;1;2;1;2;0;11;0;0;5147;11;11;2;0;1;0;2;5147;1;5147;1;1;
/org.eclipse.team.core/src/org/eclipse/team/internal/core/subscribers/SyncByteConverter.java;2;0;2;1;1;1;1;1;2;0;1;4349;2;2;1;0;0;1;2;4349;0;6336;2;2;
/org.eclipse.core.tests.resources/src/org/eclipse/core/tests/resources/ResourceMappingTest.java;2;1;2;1;2;2;2;0;204;0;0;5147;204;204;1;0;0;0;2;5147;0;5535;2;2;
/org.eclipse.ui.ide/src/org/eclipse/ui/views/framelist/FrameListMessages.java;1;0;1;1;0;0;0;1;0;0;1;2208;0;0;1;0;0;1;1;2208;0;2208;1;1;
/org.eclipse.ant.ui/Ant Tools Support/org/eclipse/ant/ui/internal/model/ImageDescriptorRegistry.java;1;0;2;1;0;0;0;2;0;1;2;262;0;0;1;0;0;2;2;262;0;1811;2;1;
/org.eclipse.pde.ui/src/org/eclipse/pde/internal/ui/wizards/extension/ExtensionTreeSelectionPage.java;2;2;3;2;3;2;3;0;22;0;0;5497;22;22;2;0;1;0;3;5780;1;5780;2;2;
/org.eclipse.ui.tests/Eclipse UI Tests/org/eclipse/ui/tests/themes/TestColorFactory.java;1;0;1;1;0;0;0;1;0;0;1;5025;0;0;1;0;0;1;1;5025;0;5025;1;1;
/org.eclipse.jdt.ui/core refactoring/org/eclipse/jdt/internal/corext/refactoring/nls/NLSLine.java;2;0;2;1;1;1;1;1;4;0;1;1464;6;6;1;0;0;1;2;1464;0;6340;2;2;
/org.eclipse.swt/Eclipse SWT Drag and Drop/motif/org/eclipse/swt/dnd/DropTarget.java;4;1;9;1;2;2;2;7;642;1;7;0;770;770;1;0;0;7;9;0;0;6352;9;4;
/org.eclipse.jdt.ui.tests.refactoring/resources/ChangeSignature/canModify/A_testException03_out.java;1;0;1;1;0;0;0;1;0;0;1;4045;0;0;1;0;0;1;1;4045;0;4045;1;1;
/org.eclipse.jdt.debug.ui/ui/org/eclipse/jdt/internal/debug/ui/SWTCompositeObjectBrowser.java;3;0;5;1;0;0;0;5;6;1;5;861;9;9;1;0;0;5;5;861;0;2647;5;3;
/org.eclipse.ui.tests/Eclipse UI Tests/org/eclipse/ui/tests/zoom/OpenEditorTest.java;2;0;2;1;1;1;1;1;16;0;1;4567;18;18;1;0;0;1;2;4567;0;6338;2;2;
/org.eclipse.team.ui/src/org/eclipse/team/internal/ui/synchronize/views/CompressedFolderLabelProvider.java;1;0;1;1;0;0;0;1;0;0;1;3734;0;0;1;0;0;1;1;3734;0;3734;1;1;
/org.eclipse.jdt.core.tests.model/workspace/Formatter/test036/A_out.java;1;0;1;1;0;0;0;1;0;0;1;2425;0;0;1;0;0;1;1;2425;0;2425;1;1;
/org.eclipse.ltk.ui.refactoring/src/org/eclipse/ltk/internal/ui/refactoring/util/ViewerPane.java;1;0;3;1;1;1;1;2;4;1;2;4965;6;6;1;0;0;2;3;4965;0;6340;3;1;
/org.eclipse.jdt.ui.tests.refactoring/resources/ExtractMethodWorkSpace/ExtractMethodTests/locals_in/A_test562.java;1;0;1;1;0;0;0;1;2;0;1;844;2;2;1;0;0;1;1;844;0;844;1;1;
/org.eclipse.core.tests.runtime/src/org/eclipse/core/tests/runtime/jobs/AsynchTestJob.java;2;0;6;1;1;1;1;5;14;1;5;2160;37;37;1;0;0;5;6;2160;0;5149;6;2;
/org.eclipse.text.tests/src/org/eclipse/text/tests/LineTrackerTest4.java;1;2;4;1;3;2;3;1;8;0;1;5082;10;10;2;0;1;1;4;5100;1;6340;3;1;
/org.eclipse.debug.ui/ui/org/eclipse/debug/ui/launchVariables/expanders/LaunchVariableMessages.java;1;0;2;1;0;0;0;2;0;1;2;754;0;0;1;0;0;2;2;754;0;771;2;1;
/org.eclipse.jdt.core/search/org/eclipse/jdt/internal/core/search/matching/TypeReferencePattern.java;3;3;22;2;5;3;5;17;751;2;14;786;1522;1522;3;3;2;17;22;5207;5;5335;17;3;
/org.eclipse.jdt.ui/core refactoring/org/eclipse/jdt/internal/corext/refactoring/changes/RenameJavaProjectChange.java;3;0;5;1;1;1;1;4;26;1;4;458;44;44;1;0;0;4;5;458;0;6340;5;3;
/org.eclipse.swt/Eclipse SWT/carbon/org/eclipse/swt/graphics/Region.java;3;1;7;1;2;2;2;5;87;1;5;1657;229;229;1;0;0;5;7;1657;0;6352;7;3;
/org.eclipse.jdt.core.tests.model/workspace/Formatter/test459/A_out.java;1;0;1;1;0;0;0;1;0;0;1;3890;0;0;1;0;0;1;1;3890;0;3890;1;1;
/org.eclipse.debug.ui/ui/org/eclipse/debug/internal/ui/preferences/ComboFieldEditor.java;1;0;1;1;0;0;0;1;0;0;1;618;0;0;1;0;0;1;1;618;0;618;1;1;
/org.eclipse.ui.ide/src/org/eclipse/ui/internal/dialogs/ImportWizard.java;2;0;8;1;0;0;0;8;10;1;8;1526;33;33;1;0;0;8;8;1526;0;2263;8;2;
/org.eclipse.pde.core/src/org/eclipse/pde/internal/core/isite/ISite.java;2;1;3;1;2;2;2;1;6;0;1;4203;12;12;1;0;0;1;3;4203;0;6336;3;2;
/org.eclipse.jdt.core.tests.model/workspace/Formatter/test014/A_in.java;1;0;1;1;0;0;0;1;0;0;1;2425;0;0;1;0;0;1;1;2425;0;2425;1;1;
/org.eclipse.jdt.ui/core extension/org/eclipse/text/edits/TextEditGroup.java;2;0;4;2;0;0;0;4;95;3;2;3545;95;95;3;2;0;4;4;3646;2;3646;2;2;
/org.eclipse.team.ui/src/org/eclipse/team/ui/synchronize/presentation/SyncInfoDiffNodeSorter.java;1;0;1;1;0;0;0;1;0;0;1;4077;0;0;1;0;0;1;1;4077;0;4077;1;1;
/org.eclipse.pde.ui/src/org/eclipse/pde/internal/ui/editor/site/SiteArchiveSection.java;1;0;1;1;0;0;0;1;0;0;1;2311;0;0;1;0;0;1;1;2311;0;2311;1;1;
/org.eclipse.ant.ui/Ant Editor/org/eclipse/ant/ui/internal/dtd/util/FactoryObject.java;1;0;2;1;0;0;0;2;0;1;2;250;0;0;1;0;0;2;2;250;0;1811;2;1;
/org.eclipse.ui.workbench/Eclipse UI/org/eclipse/ui/internal/presentations/SystemMenuRestore.java;3;0;3;1;1;1;1;2;45;1;2;4680;47;47;1;0;0;2;3;4680;0;5173;3;3;
/org.eclipse.jdt.ui/core extension/org/eclipse/jdt/internal/corext/codemanipulation/ImportEdit.java;2;0;8;1;0;0;0;8;47;2;6;245;166;166;2;2;0;8;8;1869;2;1946;6;2;
/org.eclipse.update.core/src/org/eclipse/update/internal/core/SiteURLContentProvider.java;2;1;3;1;2;2;2;1;7;0;1;890;13;13;1;0;0;1;3;890;0;6336;3;2;
/org.eclipse.jdt.ui.tests.refactoring/resources/SurroundWithWorkSpace/SurroundWithTests/A.java;1;0;1;1;0;0;0;1;22;0;1;155;22;22;1;0;0;1;1;155;0;155;1;1;
/org.eclipse.debug.ui/ui/org/eclipse/debug/internal/ui/launchConfigurations/LaunchConfigurationTreeContentProvider.java;3;1;9;1;4;4;4;5;34;1;5;2645;141;141;1;0;0;5;9;2645;0;6336;9;3;
/org.eclipse.update.ui/srcnew/org/eclipse/update/internal/ui/properties/ConfigurationActivitiesPreferencePage.java;2;0;3;1;0;0;0;3;29;1;3;584;29;29;1;0;0;3;3;584;0;755;3;2;
/org.eclipse.team.cvs.ui/src/org/eclipse/team/internal/ccvs/ui/subscriber/OverrideAndCommitAction.java;2;1;11;1;2;2;2;9;33;2;8;1481;99;99;2;1;0;9;11;1481;1;6337;10;2;
/org.eclipse.text/src/org/eclipse/jface/text/templates/TemplateBuffer.java;2;1;4;1;2;2;2;2;8;1;2;4259;13;13;1;0;0;2;4;4259;0;6340;4;2;
/org.eclipse.compare.examples.xml/src/org/eclipse/compare/examples/xml/SWTUtil.java;1;0;2;1;0;0;0;2;2;1;2;1106;2;2;1;0;0;2;2;1106;0;3938;2;1;
/org.eclipse.jdt.ui.tests.refactoring/resources/InlineConstant/canInline/test14/in/GrueziWohl.java;1;0;1;1;0;0;0;1;2;0;1;1446;2;2;1;0;0;1;1;1446;0;1446;1;1;
/org.eclipse.jdt.ui/ui/org/eclipse/jdt/internal/ui/text/comment/CommentFormattingContext.java;2;0;5;1;1;1;1;4;13;1;4;2017;27;27;1;0;0;4;5;2017;0;6340;5;2;
/org.eclipse.update/src/org/eclipse/update/internal/ui/UMWizardPageURLInstalling.java;1;0;1;1;1;1;1;0;0;0;0;6339;0;0;1;0;0;0;1;6339;0;6339;1;1;
/org.eclipse.help.tests/src/org/eclipse/help/tests/launching/DisplayHelpResource_tocHref.java;1;1;3;1;2;2;2;1;57;0;1;2732;65;65;1;0;0;1;3;2732;0;6337;3;1;
/org.eclipse.pde.ui/src_Forms/org/eclipse/pde/internal/ui/neweditor/schema/IRestrictionPage.java;1;0;2;1;0;0;0;2;0;1;2;4856;0;0;1;0;0;2;2;4856;0;4879;2;1;
/org.eclipse.team.ui/src/org/eclipse/team/ui/synchronize/content/SyncInfoSetContentProvider.java;1;0;1;1;0;0;0;1;0;0;1;3748;0;0;1;0;0;1;1;3748;0;3748;1;1;
/org.eclipse.jdt.core/model/org/eclipse/jdt/internal/compiler/parser/SourceMethodDeclaration.java;1;0;1;1;0;0;0;1;0;0;1;4461;0;0;1;0;0;1;1;4461;0;4461;1;1;
/org.eclipse.ui.workbench/Eclipse UI/org/eclipse/ui/internal/themes/FontDefinition.java;2;1;7;1;2;2;2;5;192;2;4;4392;215;215;2;1;0;5;7;4867;1;6338;6;2;
/org.eclipse.jdt.core.tests.model/workspace/Converter/junit/swingui/CounterPanel.java;1;0;2;1;0;0;0;2;99;1;2;787;99;99;1;0;0;2;2;787;0;3714;2;1;
/org.eclipse.jdt.ui/core refactoring/org/eclipse/jdt/internal/corext/refactoring/code/flow/FlowInfo.java;2;0;2;1;1;1;1;1;10;0;1;597;12;12;1;0;0;1;2;597;0;6340;2;2;
/org.eclipse.team.ui/src/org/eclipse/team/internal/ui/synchronize/sets/SyncSetInputFromSyncSet.java;1;0;3;1;0;0;0;3;81;1;3;2535;81;81;1;0;0;3;3;2535;0;4216;3;1;
/org.eclipse.update.ui.forms/src/org/eclipse/ui/forms/parts/HyperlinkEvent.java;1;0;3;1;0;0;0;3;38;1;3;3038;38;38;1;0;0;3;3;3038;0;3095;3;1;
/org.eclipse.jdt.ui.tests.refactoring/resources/Paste/test4/in/B.java;1;0;1;1;0;0;0;1;0;0;1;1311;0;0;1;0;0;1;1;1311;0;1311;1;1;
/org.eclipse.swt.graphics.text/Examples/examples/TextEditor.java;1;0;6;1;0;0;0;6;742;1;6;2937;1512;1512;1;0;0;6;6;2937;0;3678;6;1;
/org.eclipse.jdt.ui.tests.refactoring/resources/ConvertAnonymousToNested/canConvert/A_test27_out.java;1;0;1;1;0;0;0;1;0;0;1;3195;0;0;1;0;0;1;1;3195;0;3195;1;1;
/org.eclipse.jdt.ui/core refactoring/org/eclipse/jdt/internal/corext/refactoring/nls/SourceModification.java;2;0;2;1;1;1;1;1;0;0;1;4930;0;0;1;0;0;1;2;4930;0;5186;2;2;
/org.eclipse.pde.core/src/org/eclipse/pde/internal/core/plugin/PluginLibrary.java;3;1;8;1;3;3;3;5;40;1;5;2226;83;83;1;0;0;5;8;2226;0;6336;8;3;
/org.eclipse.core.runtime.osgi/src/org/eclipse/core/runtime/jobs/IJobChangeEvent.java;1;0;1;1;0;0;0;1;0;0;1;3013;0;0;1;0;0;1;1;3013;0;3013;1;1;
/org.eclipse.ui.examples.javaeditor/Eclipse Java Editor Example/org/eclipse/ui/examples/javaeditor/JavaDocumentSetupParticipant.java;2;0;2;1;1;1;1;1;20;0;1;1581;20;20;1;0;0;1;2;1581;0;6340;2;2;
/org.eclipse.jdt.core/search/org/eclipse/jdt/internal/core/index/impl/IndexedFileHashedArray.java;2;0;3;1;0;0;0;3;4;1;3;3240;6;6;1;0;0;3;3;3240;0;4060;3;2;
/org.eclipse.jdt.ui/ui/org/eclipse/jdt/internal/ui/javaeditor/JavaSourceViewer.java;5;2;19;2;10;9;10;9;120;1;9;505;450;450;2;0;1;9;19;5124;1;6340;18;5;
/org.eclipse.team.ui/src/org/eclipse/team/internal/ui/synchronize/actions/SynchronizePageDropDownAction.java;2;2;11;2;6;5;6;5;130;1;5;2535;260;260;2;0;1;5;11;5596;1;6337;10;2;
/org.eclipse.update.core/src/org/eclipse/update/search/IUpdateSearchFilter.java;3;1;7;2;2;2;2;5;7;2;4;825;17;17;2;1;0;5;7;825;1;6336;6;3;
/org.eclipse.team.cvs.ui/src/org/eclipse/team/internal/ccvs/ui/CVSLocalCompareEditorInput.java;2;0;2;1;0;0;0;2;6;1;2;1672;6;6;1;0;0;2;2;1672;0;4216;2;2;
/org.eclipse.pde.ui/src_Forms/org/eclipse/pde/internal/ui/neweditor/plugin/rows/ReferenceAttributeRow.java;3;1;6;1;3;3;3;3;13;2;2;4354;22;22;2;1;0;3;6;4354;1;5431;5;3;
/org.eclipse.jdt.ui/core extension/org/eclipse/jdt/internal/corext/javadoc/JavaDocTag.java;1;0;2;1;0;0;0;2;0;1;2;2547;0;0;1;0;0;2;2;2547;0;3938;2;1;
/org.eclipse.ui.workbench/Eclipse UI/org/eclipse/ui/ide/IDE.java;1;0;1;1;0;0;0;1;0;0;1;1259;0;0;1;0;0;1;1;1259;0;1259;1;1;
/org.eclipse.jdt.ui.tests/ui/org/eclipse/jdt/ui/tests/quickfix/AssistQuickFixTest.java;2;2;29;1;9;8;9;20;1003;2;19;823;3194;3194;2;1;1;20;29;1671;2;6340;27;2;
/org.eclipse.team.cvs.ssh2/src/org/eclipse/team/internal/ccvs/ssh2/CVSSSH2ServerConnection.java;2;1;5;1;3;3;3;2;111;1;2;4825;227;227;1;0;0;2;5;4825;0;5876;5;2;
/org.eclipse.sdk.tests-feature/plugins/org.eclipse.perfmsr.ui.client/src/org/eclipse/perfmsr/ui/client/RunsTableTreeExpandAllAction.java;1;1;2;1;2;2;2;0;10;0;0;5443;10;10;1;0;0;0;2;5443;0;5513;2;1;
/org.eclipse.jdt.core.tests.model/workspace/Converter/src/javadoc/test019/TestB1.java;1;0;2;1;0;0;0;2;0;1;2;4311;0;0;1;0;0;2;2;4311;0;4390;2;1;
/org.eclipse.jdt.core.tests.model/workspace/Formatter/test131/A_out.java;1;0;1;1;0;0;0;1;0;0;1;2425;0;0;1;0;0;1;1;2425;0;2425;1;1;
/org.eclipse.jdt.core/model/org/eclipse/jdt/internal/core/builder/MissingSourceFileException.java;1;0;1;1;0;0;0;1;2;0;1;3560;2;2;1;0;0;1;1;3560;0;3560;1;1;
/org.eclipse.jdt.core.tests.model/workspace/Converter/test0336/SorterTest.java;1;0;1;1;0;0;0;1;0;0;1;3714;0;0;1;0;0;1;1;3714;0;3714;1;1;
/org.eclipse.swt/Eclipse SWT Accessibility/gtk/org/eclipse/swt/accessibility/AccessibleObject.java;4;1;34;1;6;6;6;28;749;4;18;1104;3118;3118;4;10;0;28;34;1104;10;6352;24;4;
/org.eclipse.update.core/src/org/eclipse/update/internal/api/operations/IOperationValidator.java;1;0;3;1;0;0;0;3;22;1;3;3270;22;22;1;0;0;3;3;3270;0;4928;3;1;
/org.eclipse.jdt.core/model/org/eclipse/jdt/internal/core/CreateMethodOperation.java;3;1;5;1;2;2;2;3;42;1;3;377;55;55;1;0;0;3;5;377;0;5916;5;3;
/org.eclipse.jdt.ui.tests/examples/org/eclipse/jdt/ui/examples/MultiElementListSelectorExample.java;1;0;1;1;1;1;1;0;2;0;0;6340;2;2;1;0;0;0;1;6340;0;6340;1;1;
/org.eclipse.pde.ui/src/org/eclipse/pde/internal/ui/wizards/extension/NewExtensionPointWizard.java;3;1;5;1;4;4;4;1;27;0;1;5063;49;49;1;0;0;1;5;5063;0;6336;5;3;
/org.eclipse.jdt.ui/ui/org/eclipse/jdt/internal/ui/util/BusyIndicatorRunnableContext.java;1;0;1;1;1;1;1;0;2;0;0;6340;2;2;1;0;0;0;1;6340;0;6340;1;1;
/org.eclipse.pde.ui/src/org/eclipse/pde/internal/ui/editor/text/IPDEColorConstants.java;2;1;2;1;2;2;2;0;10;0;0;5781;14;14;1;0;0;0;2;5781;0;6336;2;2;
/org.eclipse.ua.tests/src/org/eclipse/ui/tests/cheatsheets/actions/TestOpeningURL.java;1;0;1;1;1;1;1;0;0;0;0;6081;0;0;1;0;0;0;1;6081;0;6081;1;1;
/org.eclipse.team.cvs.ssh/src/org/eclipse/team/internal/ccvs/ssh/SSHServerConnection.java;1;0;1;1;0;0;0;1;2;0;1;3113;2;2;1;0;0;1;1;3113;0;3113;1;1;
/org.eclipse.jdt.core/compiler/org/eclipse/jdt/internal/compiler/ast/Case.java;1;0;1;1;0;0;0;1;0;0;1;148;0;0;1;0;0;1;1;148;0;148;1;1;
/org.eclipse.swt.tests/JUnit Tests/org/eclipse/swt/tests/junit/performance/PerformanceTests.java;2;1;2;1;2;2;2;0;4;0;0;6037;4;4;1;0;0;0;2;6037;0;6352;2;2;
/org.eclipse.update.tests.core/src/org/eclipse/update/tests/configurations/TestRevert.java;2;1;8;1;2;2;2;6;9;1;6;3813;29;29;1;0;0;6;8;3813;0;6336;8;2;
/org.eclipse.jdt.core/model/org/eclipse/jdt/internal/core/CreateWorkingCopyOperation.java;1;0;1;1;0;0;0;1;0;0;1;818;0;0;1;0;0;1;1;818;0;818;1;1;
/org.eclipse.update.ui/src/org/eclipse/update/internal/ui/UnifiedWizardAction.java;2;0;5;1;0;0;0;5;17;2;4;196;25;25;2;1;0;5;5;890;1;890;4;2;
/org.eclipse.swt/Eclipse SWT Browser/common/org/eclipse/swt/browser/NewWindowEvent.java;1;0;2;1;0;0;0;2;0;1;2;2849;0;0;1;0;0;2;2;2849;0;3007;2;1;
/org.eclipse.ui.intro/src/org/eclipse/ui/internal/intro/impl/model/AbstractIntroPartImplementation.java;2;2;16;1;16;12;16;0;125;0;0;5115;459;459;2;0;4;0;16;5797;4;6188;12;2;
/org.eclipse.pde.ui/src/org/eclipse/pde/internal/ui/wizards/convert/PluginToBundleWizard.java;1;0;2;1;0;0;0;2;0;0;1;3839;0;0;2;1;0;2;2;3839;1;3839;1;1;
/org.eclipse.ui.ide/src/org/eclipse/ui/wizards/newresource/BasicNewProjectResourceWizard.java;8;2;24;2;4;3;4;20;918;2;17;1511;1304;1304;2;3;1;20;24;1536;4;6338;20;8;
/org.eclipse.team.webdav/src/org/eclipse/team/internal/ui/target/subscriber/ImportWizard.java;2;1;5;1;2;2;2;3;180;1;3;3805;194;194;1;0;0;3;5;3805;0;6337;5;2;
/org.eclipse.core.runtime.osgi/src/org/eclipse/core/internal/boot/PlatformURLHandler.java;1;0;2;1;0;0;0;2;84;1;2;3013;84;84;1;0;0;2;2;3013;0;3028;2;1;
/org.eclipse.jface.text/src/org/eclipse/jface/text/reconciler/IReconcileStep.java;1;3;5;1;4;2;4;1;64;0;1;1629;68;68;3;0;2;1;5;6353;2;6353;3;1;
/org.eclipse.jdt.core.tests.model/workspace/Converter/src/test0332/LocalSelectionTransfer.java;1;0;1;1;0;0;0;1;0;0;1;3714;0;0;1;0;0;1;1;3714;0;3714;1;1;
/org.eclipse.ui.workbench/Eclipse UI/org/eclipse/ui/keys/IKeyManagerEvent.java;1;0;2;1;0;0;0;2;0;1;2;1294;0;0;1;0;0;2;2;1294;0;1321;2;1;
/org.eclipse.swt/Eclipse SWT/gtk1x/org/eclipse/swt/widgets/Sash.java;1;0;1;1;0;0;0;1;0;0;1;2327;0;0;1;0;0;1;1;2327;0;2327;1;1;
/org.eclipse.jdt.core/model/org/eclipse/jdt/internal/core/WorkingCopy.java;2;0;9;2;0;0;0;9;145;2;8;61;317;317;2;1;0;9;9;78;1;818;8;2;
/org.eclipse.jdt.debug.ui/ui/org/eclipse/jdt/internal/debug/core/refactoring/JavaBreakpointIPackageFragmentMoveParticipant.java;2;1;2;1;2;2;2;0;8;0;0;5621;8;8;1;0;0;0;2;5621;0;6339;2;2;
/org.eclipse.ui.externaltools/Ant Editor/org/eclipse/ui/externaltools/internal/ant/editor/xml/AntEditorXMLMessages.java;1;0;1;1;0;0;0;1;0;0;1;282;0;0;1;0;0;1;1;282;0;282;1;1;
/org.eclipse.ui.workbench/Eclipse UI/org/eclipse/ui/activities/IActivityEvent.java;1;0;6;1;0;0;0;6;35;2;5;2240;80;80;2;1;0;6;6;2800;1;2800;5;1;
/org.eclipse.jface/src/org/eclipse/jface/preference/ListEditor.java;2;1;2;1;2;2;2;0;13;0;0;5463;15;15;1;0;0;0;2;5463;0;6338;2;2;
/org.eclipse.pde/src/org/eclipse/pde/internal/FeatureProject.java;1;0;2;1;1;1;1;1;4;0;1;4203;6;6;1;0;0;1;2;4203;0;6336;2;1;
/org.eclipse.jdt.ui/ui/org/eclipse/jdt/internal/ui/wizards/dialogfields/Separator.java;2;0;2;1;1;1;1;1;2;0;1;1446;4;4;1;0;0;1;2;1446;0;6340;2;2;
/org.eclipse.webdav/src/kernel/org/eclipse/webdav/internal/kernel/ClientException.java;1;0;1;1;1;1;1;0;41;0;0;5151;41;41;1;0;0;0;1;5151;0;5151;1;1;
/org.eclipse.jdt.core.tests.model/workspace/Formatter/test495/A_out.java;1;0;1;1;1;1;1;0;0;0;0;5381;0;0;1;0;0;0;1;5381;0;5381;1;1;
/org.eclipse.team.core/src/org/eclipse/team/internal/core/target/ResourceState.java;1;0;2;1;0;0;0;2;2;1;2;866;2;2;1;0;0;2;2;866;0;2495;2;1;
/org.eclipse.ant.ui/Ant Tools Support/org/eclipse/ant/ui/internal/preferences/AntPropertiesLabelProvider.java;1;0;5;1;0;0;0;5;14;1;5;250;27;27;1;0;0;5;5;250;0;1811;5;1;
/org.eclipse.jdt.ui/core refactoring/org/eclipse/jdt/internal/corext/refactoring/tagging/INameUpdating.java;2;0;2;1;1;1;1;1;2;0;1;4654;2;2;1;0;0;1;2;4654;0;6340;2;2;
/org.eclipse.jdt.ui.tests.refactoring/resources/RenamePackage/testImportFromMultiRoots2/out/srcTest/p/p/TestHelper.java;1;0;2;1;0;0;0;2;7;1;2;3219;7;7;1;0;0;2;2;3219;0;4105;2;1;
/org.eclipse.jdt.ui/core extension/org/eclipse/jdt/internal/corext/dom/fragments/IExpressionFragment.java;1;0;1;1;1;1;1;0;2;0;0;6340;2;2;1;0;0;0;1;6340;0;6340;1;1;
/org.eclipse.jdt.ui.tests.refactoring/resources/MoveMembers/test30/in/B.java;1;0;1;1;0;0;0;1;0;0;1;1651;0;0;1;0;0;1;1;1651;0;1651;1;1;
/org.eclipse.jdt.ui/core extension/org/eclipse/jdt/internal/corext/Corext.java;2;0;2;1;1;1;1;1;2;0;1;3536;2;2;1;0;0;1;2;3536;0;6340;2;2;
/org.eclipse.ant.ui/Ant Editor/org/eclipse/ant/internal/ui/editor/text/AntDocumentSetupParticipant.java;2;1;4;1;3;3;3;1;17;0;1;5047;39;39;1;0;0;1;4;5047;0;6147;4;2;
/org.eclipse.ui.examples.javaeditor/Eclipse Java Editor Example/org/eclipse/ui/examples/javaeditor/JavaEditor.java;3;2;5;2;3;2;3;2;135;1;2;1581;143;143;2;0;1;2;5;5777;1;6340;4;3;
/org.eclipse.jdt.core.tests.model/workspace/Formatter/test034/A_out.java;1;0;1;1;0;0;0;1;0;0;1;2425;0;0;1;0;0;1;1;2425;0;2425;1;1;
/org.eclipse.jdt.core.tests.model/workspace/Converter/test0285/Test.java;1;0;1;1;0;0;0;1;0;0;1;3714;0;0;1;0;0;1;1;3714;0;3714;1;1;
/org.eclipse.update.core/src/org/eclipse/update/internal/search/QueryUpdateSiteAdapter.java;2;0;5;1;1;1;1;4;6;1;4;825;15;15;1;0;0;4;5;825;0;6336;5;2;
/org.eclipse.update.ui.forms/src/org/eclipse/update/ui/forms/internal/richtext/BulletParagraph.java;1;0;2;1;0;0;0;2;0;1;2;2849;0;0;1;0;0;2;2;2849;0;2898;2;1;
/org.eclipse.ui.workbench/Eclipse UI/org/eclipse/ui/internal/commands/XPropertyListener.java;1;0;2;1;0;0;0;2;0;1;2;1695;0;0;1;0;0;2;2;1695;0;1724;2;1;
/org.eclipse.update.ui.forms/Eclipse Forms/org/eclipse/ui/forms/parts/BoxToggle.java;1;0;2;1;0;0;0;2;0;0;1;3096;0;0;2;1;0;2;2;3096;1;3096;1;1;
/org.eclipse.jdt.core.tests.model/workspace/Converter/junit/runner/FailureDetailView.java;1;0;1;1;0;0;0;1;0;0;1;3714;0;0;1;0;0;1;1;3714;0;3714;1;1;
/org.eclipse.jdt.ui/core refactoring/org/eclipse/jdt/internal/corext/refactoring/typeconstraints/TypeVariable.java;2;0;7;1;1;1;1;6;32;2;5;42;89;89;2;1;0;6;7;50;1;6340;6;2;
/org.eclipse.jdt.ui/ui/org/eclipse/jdt/internal/ui/filters/EmptyPackageFilter.java;1;0;1;1;1;1;1;0;2;0;0;6340;2;2;1;0;0;0;1;6340;0;6340;1;1;
/org.eclipse.jface.text.tests/src/org/eclipse/jface/text/tests/TestTextViewer.java;1;1;3;1;2;2;2;1;4;0;1;5082;6;6;1;0;0;1;3;5082;0;6340;3;1;
/org.eclipse.ui.workbench/Eclipse UI/org/eclipse/ui/internal/csm/commands/KeyConfiguration.java;1;0;3;1;0;0;0;3;31;2;2;2549;31;31;2;1;0;3;3;2549;1;2562;2;1;
/org.eclipse.jdt.ui.tests.refactoring/resources/TypeConstraints/A_testConstraints6.java;1;0;1;1;0;0;0;1;0;0;1;60;0;0;1;0;0;1;1;60;0;60;1;1;
/org.eclipse.team.examples.filesystem/src/org/eclipse/team/examples/filesystem/FileSystemProvider.java;2;1;6;1;2;2;2;4;45;1;4;1708;65;65;1;0;0;4;6;1708;0;6337;6;2;
/org.eclipse.jdt.ui/ui/org/eclipse/jdt/internal/ui/wizards/buildpaths/VariablePathDialogField.java;1;0;2;1;1;1;1;1;3;0;1;1350;5;5;1;0;0;1;2;1350;0;6340;2;1;
/org.eclipse.help.ide/src/org/eclipse/help/ui/internal/search/SWTUtil.java;1;1;3;1;2;2;2;1;18;0;1;1782;24;24;1;0;0;1;3;1782;0;6337;3;1;
/org.eclipse.core.runtime/src/org/eclipse/core/internal/jobs/WorkerPool.java;3;1;40;1;5;5;5;35;496;3;29;323;2529;2529;3;6;0;35;40;2057;6;6018;34;3;
/org.eclipse.debug.ui/ui/org/eclipse/debug/internal/ui/views/memory/MemoryViewContentProvider.java;2;1;3;1;3;3;3;0;29;0;0;5254;38;38;1;0;0;0;3;5254;0;5475;3;2;
/org.eclipse.jdt.ui/ui/org/eclipse/jdt/internal/ui/text/template/contentassist/PositionBasedCompletionProposal.java;2;1;3;1;2;2;2;1;33;0;1;4927;35;35;1;0;0;1;3;4927;0;6340;3;2;
/org.eclipse.search/new search/org/eclipse/search2/internal/ui/basic/views/SearchResultTreeContentProvider.java;1;0;2;1;0;0;0;2;0;1;2;3474;0;0;1;0;0;2;2;3474;0;3711;2;1;
/org.eclipse.compare.examples.xml/tests/org/eclipse/compare/examples/xml/TestGeneralMatching.java;1;0;3;1;0;0;0;3;2;1;3;1106;2;2;1;0;0;3;3;1106;0;4711;3;1;
/org.eclipse.team.cvs.ui/src/org/eclipse/team/internal/ccvs/ui/subscriber/ConfirmMergedAction.java;2;1;3;1;3;3;3;0;39;0;0;5490;43;43;1;0;0;0;3;5490;0;6337;3;2;
/org.eclipse.ui.workbench/Eclipse UI/org/eclipse/ui/internal/activities/IActivityBindingDefinition.java;1;0;2;1;0;0;0;2;0;1;2;2867;0;0;1;0;0;2;2;2867;0;2896;2;1;
/org.eclipse.jdt.core.tests.model/workspace/Formatter/test270/A_out.java;1;0;1;1;0;0;0;1;0;0;1;2442;0;0;1;0;0;1;1;2442;0;2442;1;1;
/org.eclipse.jdt.ui/ui refactoring/org/eclipse/jdt/internal/ui/refactoring/nls/PackageBrowseAdapter.java;2;0;2;1;1;1;1;1;26;0;1;4930;26;26;1;0;0;1;2;4930;0;5401;2;2;
/org.eclipse.update.tests.core/webserver/bundleSitesrc/com.example.bundle.plugin/src/com/example/bundle/plugin/PluginPlugin.java;2;0;2;1;1;1;1;1;10;0;1;4134;10;10;1;0;0;1;2;4134;0;6336;2;2;
/org.eclipse.update.ui/src/org/eclipse/update/internal/ui/wizards/NewFolderWizardPage.java;1;0;1;1;0;0;0;1;0;0;1;755;0;0;1;0;0;1;1;755;0;755;1;1;
/org.eclipse.ui.ide/extensions/org/eclipse/ui/dialogs/SaveAsDialog.java;1;0;1;1;0;0;0;1;0;0;1;2263;0;0;1;0;0;1;1;2263;0;2263;1;1;
/org.eclipse.ant.ui/Ant Editor/org/eclipse/ant/internal/ui/editor/utils/ProjectHelper.java;1;2;26;1;7;6;7;19;272;2;18;1811;1086;1086;2;1;1;19;26;3661;2;5924;24;1;
/org.eclipse.jdt.ui/ui/org/eclipse/jdt/ui/wizards/NewElementWizardPage.java;1;0;1;1;1;1;1;0;2;0;0;6340;2;2;1;0;0;0;1;6340;0;6340;1;1;
/org.eclipse.team.cvs.ui/src/org/eclipse/team/internal/ccvs/ui/ConsoleDocument.java;1;0;1;1;0;0;0;1;0;0;1;3944;0;0;1;0;0;1;1;3944;0;3944;1;1;
/org.eclipse.jdt.ui/ui/org/eclipse/jdt/internal/ui/search/SearchMessages.java;1;0;1;1;1;1;1;0;2;0;0;6340;2;2;1;0;0;0;1;6340;0;6340;1;1;
/org.eclipse.jdt.ui.tests.refactoring/resources/MoveMembers/test29/out/B.java;1;0;1;1;0;0;0;1;0;0;1;1651;0;0;1;0;0;1;1;1651;0;1651;1;1;
/org.eclipse.team.core/src/org/eclipse/team/core/ProjectSetCapability.java;2;1;5;1;3;3;3;2;236;1;2;4216;285;285;1;0;0;2;5;4216;0;6111;5;2;
/org.eclipse.core.tests.runtime/src/org/eclipse/core/tests/internal/plugins/FragmentResolveTest_5.java;1;0;1;1;0;0;0;1;0;0;1;3014;0;0;1;0;0;1;1;3014;0;3014;1;1;
/org.eclipse.team.ui/src/org/eclipse/team/internal/ui/synchronize/ActionDelegateWrapper.java;1;1;3;1;2;2;2;1;65;0;1;4699;81;81;1;0;0;1;3;4699;0;5508;3;1;
/org.eclipse.ui.ide/extensions/org/eclipse/ui/IStorageEditorInput.java;1;0;1;1;0;0;0;1;0;0;1;2263;0;0;1;0;0;1;1;2263;0;2263;1;1;
/org.eclipse.swt/Eclipse SWT/carbon/org/eclipse/swt/widgets/FileDialog.java;3;1;4;2;2;2;2;2;19;0;1;2663;28;28;2;1;0;2;4;2663;1;6352;3;3;
/org.eclipse.ui.workbench/Eclipse UI/org/eclipse/ui/part/MultiPageEditorSite.java;3;0;4;1;1;1;1;3;90;1;3;2765;126;126;1;0;0;3;4;2765;0;6338;4;3;
/org.eclipse.jdt.core.tests.model/workspace/Converter/src/test0212/Test.java;1;0;1;1;0;0;0;1;0;0;1;3714;0;0;1;0;0;1;1;3714;0;3714;1;1;
/org.eclipse.core.tests.runtime/src/org/eclipse/core/tests/runtime/jobs/IJobManagerTest.java;2;3;39;1;10;6;10;29;1535;3;25;850;4352;4352;3;4;4;29;39;2308;8;5940;31;2;
/org.eclipse.swt/Eclipse SWT Mozilla/common/org/eclipse/swt/internal/mozilla/nsIBaseWindow.java;1;0;2;1;0;0;0;2;26;1;2;1654;26;26;1;0;0;2;2;1654;0;2568;2;1;
/org.eclipse.jdt.core/search/org/eclipse/jdt/internal/core/index/impl/GammaCompressedIndexBlock.java;2;0;4;1;0;0;0;4;18;1;4;262;22;22;1;0;0;4;4;262;0;4060;4;2;
/org.eclipse.jdt.ui/ui/org/eclipse/jdt/internal/ui/preferences/CodeFormatterPreferencePage.java;2;0;6;1;1;1;1;5;73;2;4;3103;154;154;2;1;0;5;6;3103;1;6340;5;2;
/org.eclipse.update.ui.forms/Eclipse Forms/org/eclipse/ui/forms/widgets/TableWrapData.java;1;0;3;1;0;0;0;3;63;1;3;3138;63;63;1;0;0;3;3;3138;0;4157;3;1;
/org.eclipse.team.cvs.ui/src/org/eclipse/team/internal/ccvs/ui/TagAsVersionDialog.java;2;0;4;2;0;0;0;4;57;2;3;990;66;66;2;1;0;4;4;990;1;2381;3;2;
/org.eclipse.ui.intro/src/org/eclipse/ui/internal/intro/impl/model/IntroImage.java;1;1;6;1;6;6;6;0;24;0;0;5115;47;47;1;0;0;0;6;5115;0;5760;6;1;
/org.eclipse.swt/Eclipse SWT/win32/org/eclipse/swt/widgets/Canvas.java;5;0;7;2;1;1;1;6;43;2;5;311;130;130;2;1;0;6;7;1525;1;6352;6;5;
/org.eclipse.ui.workbench/Eclipse UI/org/eclipse/ui/internal/commands/registry/PreferenceRegistry.java;1;0;6;1;0;0;0;6;58;2;4;1077;63;63;2;2;0;6;6;1077;2;1396;4;1;
/org.eclipse.swt/Eclipse SWT Drag and Drop/carbon/org/eclipse/swt/dnd/DragSource.java;4;1;6;1;2;2;2;4;158;1;4;0;183;183;1;0;0;4;6;0;0;6352;6;4;
/org.eclipse.jdt.core.tests.model/workspace/Converter/src/test0380/A.java;1;0;1;1;0;0;0;1;0;0;1;3714;0;0;1;0;0;1;1;3714;0;3714;1;1;
/org.eclipse.swt/Eclipse SWT Accessibility/gtk/org/eclipse/swt/accessibility/Accessible.java;3;1;10;1;2;2;2;8;158;1;8;1104;285;285;1;0;0;8;10;1104;0;6352;10;3;
/org.eclipse.swt.tests/JUnit Tests/org/eclipse/swt/tests/junit/Test_org_eclipse_swt_custom_LineBackgroundListener.java;1;0;1;1;0;0;0;1;18;0;1;2104;18;18;1;0;0;1;1;2104;0;2104;1;1;
/org.eclipse.jdt.ui/ui/org/eclipse/jdt/internal/ui/text/javadoc/JavaDoc2HTMLTextReader.java;3;0;5;1;1;1;1;4;2;1;4;1336;7;7;1;0;0;4;5;1336;0;6340;5;3;
/org.eclipse.ant.ui/Ant Editor/org/eclipse/ant/internal/ui/dtd/util/FactoryObject.java;1;0;1;1;0;0;0;1;0;0;1;1811;0;0;1;0;0;1;1;1811;0;1811;1;1;
/org.eclipse.osgi/supplement/src/org/eclipse/osgi/framework/internal/reliablefile/ReliableFileInputStream.java;5;1;6;1;3;3;3;3;144;1;3;3013;260;260;1;0;0;3;6;3013;0;5856;6;5;
/org.eclipse.update.core/src/org/eclipse/update/internal/standalone/CmdLineArgs.java;1;0;12;1;0;0;0;12;61;2;11;828;157;157;2;1;0;12;12;4715;1;4928;11;1;
/org.eclipse.jdt.ui.tests.refactoring/resources/ChangeSignature/canModify/A_testAll56_out.java;1;0;1;1;0;0;0;1;0;0;1;720;0;0;1;0;0;1;1;720;0;720;1;1;
/org.eclipse.team.ui/src/org/eclipse/team/internal/ui/target/TargetCatchupReleaseViewer.java;1;0;1;1;0;0;0;1;0;0;1;2495;0;0;1;0;0;1;1;2495;0;2495;1;1;
/org.eclipse.pde.ui/src/org/eclipse/pde/internal/ui/editor/text/XMLCommentScanner.java;3;1;3;1;2;2;2;1;4;0;1;3795;6;6;1;0;0;1;3;3795;0;6336;3;3;
/org.eclipse.ui.workbench/Eclipse UI/org/eclipse/ui/internal/csm/roles/RoleRegistryEvent.java;1;0;5;1;0;0;0;5;2;2;4;2213;3;3;2;1;0;5;5;2370;1;2444;4;1;
/org.eclipse.jdt.ui.tests.refactoring/resources/DeleteSourceReferenceEdit/A_test6_in.java;1;0;1;1;0;0;0;1;0;0;1;1652;0;0;1;0;0;1;1;1652;0;1652;1;1;
/org.eclipse.ant.ui/Ant Editor/org/eclipse/ant/ui/internal/dtd/Parser.java;1;0;2;1;0;0;0;2;0;1;2;250;0;0;1;0;0;2;2;250;0;1811;2;1;
/org.eclipse.ui.workbench/Eclipse UI/org/eclipse/ui/internal/WorkbenchPartLabelProvider.java;2;0;2;1;0;0;0;2;7;1;2;1220;7;7;1;0;0;2;2;1220;0;2737;2;2;
/org.eclipse.ui.workbench/Eclipse UI/org/eclipse/ui/internal/progress/ResourceCompletionListener.java;1;0;1;1;0;0;0;1;0;0;1;860;0;0;1;0;0;1;1;860;0;860;1;1;
/org.eclipse.jdt.ui.tests.refactoring/resources/ExtractMethodWorkSpace/ExtractMethodTests/locals_out/A_test520.java;1;0;2;1;0;0;0;2;4;1;2;130;5;5;1;0;0;2;2;130;0;844;2;1;
/org.eclipse.jdt.debug.tests/tests/org/eclipse/jdt/debug/tests/eval/BooleanAssignmentOperatorsTests.java;1;0;1;1;0;0;0;1;6;0;1;1274;6;6;1;0;0;1;1;1274;0;1274;1;1;
/org.eclipse.ui.forms/src/org/eclipse/ui/forms/widgets/FormText.java;1;1;13;1;2;2;2;11;460;3;9;4147;710;710;3;2;0;11;13;4147;2;6336;11;1;
/org.eclipse.jdt.ui/core refactoring/org/eclipse/ltk/refactoring/core/PerformRefactoringOperation.java;1;0;2;1;0;0;0;2;0;1;2;3930;0;0;1;0;0;2;2;3930;0;4510;2;1;
/org.eclipse.jdt.ui/ui/org/eclipse/jdt/ui/wizards/NewInterfaceWizardPage.java;1;0;1;1;1;1;1;0;2;0;0;6340;2;2;1;0;0;0;1;6340;0;6340;1;1;
/org.eclipse.update.core/srcnew/org/eclipse/update/search/IUpdateSiteAdapter.java;2;0;2;1;0;0;0;2;0;1;2;574;0;0;1;0;0;2;2;574;0;825;2;2;
/org.eclipse.jdt.core.tests.model/workspace/Converter/test0374/A.java;1;0;1;1;0;0;0;1;0;0;1;3714;0;0;1;0;0;1;1;3714;0;3714;1;1;
/org.eclipse.team.core/src/org/eclipse/team/core/variants/ThreeWaySubscriber.java;1;1;3;1;2;2;2;1;15;0;1;4349;19;19;1;0;0;1;3;4349;0;6206;3;1;
/org.eclipse.team.ui/src/org/eclipse/team/internal/ui/dialogs/IPromptCondition.java;1;0;2;1;0;0;0;2;31;0;1;987;31;31;2;1;0;2;2;987;1;987;1;1;
/org.eclipse.swt/Eclipse SWT PI/gtk1x/org/eclipse/swt/internal/gtk/GtkColorSelectionDialog.java;1;0;1;1;0;0;0;1;0;0;1;2327;0;0;1;0;0;1;1;2327;0;2327;1;1;
/org.eclipse.jdt.core.tests.model/workspace/Formatter/test287/A_in.java;1;0;1;1;0;0;0;1;0;0;1;2443;0;0;1;0;0;1;1;2443;0;2443;1;1;
/org.eclipse.jdt.ui/core refactoring/org/eclipse/jdt/internal/corext/refactoring/code/flow/DoWhileFlowInfo.java;1;0;1;1;1;1;1;0;2;0;0;6340;2;2;1;0;0;0;1;6340;0;6340;1;1;
/org.eclipse.swt/Eclipse SWT PI/win32/org/eclipse/swt/internal/win32/NMTTDISPINFO.java;1;0;1;1;0;0;0;1;8;0;1;957;8;8;1;0;0;1;1;957;0;957;1;1;
/org.eclipse.team.core/src/org/eclipse/team/core/subscribers/RemoteContentsCacheEntry.java;1;0;1;1;0;0;0;1;0;0;1;3171;0;0;1;0;0;1;1;3171;0;3171;1;1;
/org.eclipse.jdt.ui/ui/org/eclipse/jdt/internal/ui/filters/NonPublicTypeFilter.java;1;0;1;1;1;1;1;0;2;0;0;6340;2;2;1;0;0;0;1;6340;0;6340;1;1;
/org.eclipse.help.base/src/org/eclipse/help/internal/IndexToolApplication.java;1;0;3;1;0;0;0;3;1;0;1;1740;1;1;3;2;0;3;3;1740;2;1740;1;1;
/org.eclipse.ui.workbench/Eclipse UI/org/eclipse/ui/internal/dialogs/EditorsPreferencePage.java;4;0;6;1;1;1;1;5;156;1;5;2350;238;238;1;0;0;5;6;2350;0;6338;6;4;
/org.eclipse.jdt.ui.tests.refactoring/test cases/org/eclipse/jdt/ui/tests/xml/A_TypeExtender3.java;1;0;2;1;0;0;0;2;0;1;2;4091;0;0;1;0;0;2;2;4091;0;4108;2;1;
/org.eclipse.swt.tests/JUnit Tests/org/eclipse/swt/tests/junit/AllBrowserTests.java;2;1;11;1;4;4;4;7;28;2;6;2460;75;75;2;1;0;7;11;3007;1;6352;10;2;
/org.eclipse.core.runtime/src/org/eclipse/core/runtime/IPluginInfo.java;1;0;2;1;0;0;0;2;0;1;2;3087;0;0;1;0;0;2;2;3087;0;3169;2;1;
/org.eclipse.swt/Eclipse SWT Printing/photon/org/eclipse/swt/printing/PrintDialog.java;1;1;2;1;2;2;2;0;8;0;0;5606;12;12;1;0;0;0;2;5606;0;6352;2;1;
/org.eclipse.ui.externaltools/Ant Editor/org/eclipse/ui/externaltools/internal/ant/dtd/schema/NfmParser.java;1;0;1;1;0;0;0;1;0;0;1;282;0;0;1;0;0;1;1;282;0;282;1;1;
/org.eclipse.team.ui/src/org/eclipse/team/internal/ui/ITeamUIImages.java;1;1;3;1;3;3;3;0;11;0;0;5661;15;15;1;0;0;0;3;5661;0;6337;3;1;
/org.eclipse.osgi/core/framework/org/eclipse/osgi/framework/internal/core/PackageAdmin.java;5;0;22;3;3;1;3;19;206;2;17;3013;778;778;3;2;2;19;22;5107;4;5107;18;5;
/org.eclipse.ui.workbench/Eclipse UI/org/eclipse/ui/internal/activities/Persistence.java;4;1;15;1;2;2;2;13;305;1;13;2444;887;887;1;0;0;13;15;2444;0;6338;15;4;
/org.eclipse.swt.tests/JUnit Tests/org/eclipse/swt/tests/junit/Test_org_eclipse_swt_accessibility_AccessibleControlListener.java;1;0;1;1;0;0;0;1;0;0;1;2104;0;0;1;0;0;1;1;2104;0;2104;1;1;
/org.eclipse.text.tests/src/org/eclipse/text/tests/LineTrackerTest3.java;1;2;4;1;3;2;3;1;9;0;1;5082;11;11;2;0;1;1;4;5100;1;6340;3;1;
/org.eclipse.jdt.core.tests.model/workspace/Converter/src/test0519/A.java;1;0;2;1;0;0;0;2;5;1;2;3714;5;5;1;0;0;2;2;3714;0;3886;2;1;
/org.eclipse.search/new search/org/eclipse/search2/internal/ui/basic/views/DefaultSearchViewPage.java;1;0;4;1;0;0;0;4;10;2;3;3474;15;15;2;1;0;4;4;3474;1;3711;3;1;
/org.eclipse.jdt.core.tests.model/workspace/Formatter/test194/A_in.java;1;0;1;1;0;0;0;1;0;0;1;2424;0;0;1;0;0;1;1;2424;0;2424;1;1;
/org.eclipse.debug.core/core/org/eclipse/debug/internal/core/memory/MemoryRendering.java;1;0;1;1;1;1;1;0;0;0;0;5254;0;0;1;0;0;0;1;5254;0;5254;1;1;
/org.eclipse.jdt.core.tests.model/workspace/Converter/test0090/Test.java;1;0;1;1;0;0;0;1;0;0;1;3714;0;0;1;0;0;1;1;3714;0;3714;1;1;
/org.eclipse.team.examples.filesystem/src/org/eclipse/team/examples/filesystem/ui/PutSynchronizeAction.java;1;0;1;1;1;1;1;0;0;0;0;6206;0;0;1;0;0;0;1;6206;0;6206;1;1;
/org.eclipse.help/src/org/eclipse/help/internal/context/ContextManager.java;1;1;10;1;3;3;3;7;150;2;6;1175;240;240;2;1;0;7;10;4609;1;6337;9;1;
/org.eclipse.update.ui/src/org/eclipse/update/internal/ui/wizards/LicensePage.java;3;1;7;1;2;2;2;5;376;1;5;755;743;743;1;0;0;5;7;755;0;6336;7;3;
/org.eclipse.ui.views/src/org/eclipse/ui/views/internal/markers/Resource.java;1;0;2;1;0;0;0;2;0;1;2;265;0;0;1;0;0;2;2;265;0;749;2;1;
/org.eclipse.update.core/src/org/eclipse/update/core/BaseSiteFactory.java;2;1;3;1;2;2;2;1;8;0;1;890;18;18;1;0;0;1;3;890;0;6336;3;2;
/org.eclipse.team.ui/src/org/eclipse/team/internal/ui/NatureToPropertyAction.java;1;0;1;1;0;0;0;1;0;0;1;4216;0;0;1;0;0;1;1;4216;0;4216;1;1;
/org.eclipse.jdt.core/compiler/org/eclipse/jdt/internal/compiler/parser/AbstractCommentParser.java;3;3;23;2;9;6;9;14;371;3;12;3633;1240;1240;3;2;3;14;23;3813;5;6119;18;3;
/org.eclipse.jface.text/src/org/eclipse/jface/internal/text/link/contentassist/AdditionalInfoController2.java;3;1;4;1;2;2;2;2;42;1;2;4214;46;46;1;0;0;2;4;4214;0;6340;4;3;
/org.eclipse.jdt.ui/ui/org/eclipse/jdt/internal/ui/callhierarchy/SelectionProviderAdapter.java;2;0;2;1;0;0;0;2;0;1;2;217;0;0;1;0;0;2;2;217;0;2893;2;2;
/org.eclipse.ui.workbench.compatibility/src/org/eclipse/ui/internal/ICompatibleWorkbenchPage.java;2;0;2;1;1;1;1;1;36;0;1;3335;36;36;1;0;0;1;2;3335;0;6321;2;2;
/org.eclipse.jdt.ui.tests.refactoring/resources/ExtractTemp/canExtract/A_test74_out.java;1;0;1;1;0;0;0;1;0;0;1;1569;0;0;1;0;0;1;1;1569;0;1569;1;1;
/org.eclipse.update.core/src/org/eclipse/update/internal/core/TargetFeature.java;1;0;1;1;0;0;0;1;2;0;1;890;2;2;1;0;0;1;1;890;0;890;1;1;
/org.eclipse.update/src/org/eclipse/update/internal/ui/UMWizardPageURLComplete.java;1;0;1;1;1;1;1;0;0;0;0;6339;0;0;1;0;0;0;1;6339;0;6339;1;1;
/org.eclipse.osgi/core/framework/org/eclipse/osgi/framework/internal/core/SystemBundleActivator.java;4;2;9;1;5;4;5;4;156;1;4;3013;178;178;2;0;1;4;9;5116;1;6337;8;4;
/org.eclipse.pde.core/src/org/eclipse/pde/internal/core/ischema/ISchema.java;3;1;4;1;2;2;2;2;26;1;2;4203;40;40;1;0;0;2;4;4203;0;6336;4;3;
/org.eclipse.jdt.core.tests.model/workspace/Formatter/test106/A_in.java;1;0;1;1;0;0;0;1;0;0;1;2425;0;0;1;0;0;1;1;2425;0;2425;1;1;
/org.eclipse.debug.ui/ui/org/eclipse/debug/internal/ui/actions/AddToFavoritesAction.java;1;0;2;1;1;1;1;1;13;0;1;2590;13;13;1;0;0;1;2;2590;0;5207;2;1;
/org.eclipse.jdt.debug.tests/testprograms/OneToTenPrint.java;1;0;1;1;0;0;0;1;0;0;1;2149;0;0;1;0;0;1;1;2149;0;2149;1;1;
/org.eclipse.webdav/src/kernel/org/eclipse/webdav/internal/kernel/Context.java;1;0;2;1;2;1;2;0;176;0;0;5151;176;176;2;0;1;0;2;5151;1;5151;1;1;
/org.eclipse.team.cvs.ssh2/src/org/eclipse/team/ccvs/ssh2/CVSSSH2PreferencePage.java;3;0;28;1;0;0;0;28;574;3;22;2956;2765;2765;3;6;0;28;28;3734;6;4825;22;3;
/org.eclipse.ant.tests.ui/test plugin/org/eclipse/ant/tests/ui/testplugin/AbstractAntUITest.java;1;1;12;1;2;2;2;10;90;1;10;1388;221;221;1;0;0;10;12;1388;0;6336;12;1;
/org.eclipse.ui.workbench/Eclipse UI/org/eclipse/ui/internal/dialogs/EventLoopProgressMonitor.java;3;1;15;2;7;7;7;8;268;3;5;3651;493;493;3;3;0;8;15;4042;3;5891;12;3;
/org.eclipse.jdt.ui.tests.refactoring/resources/ExtractMethodWorkSpace/ExtractMethodTests/return_in/A_test728.java;1;0;1;1;0;0;0;1;4;0;1;844;4;4;1;0;0;1;1;844;0;844;1;1;
/org.eclipse.jdt.core.tests.model/workspace/Converter/src/test0514/A.java;1;0;1;1;0;0;0;1;0;0;1;3714;0;0;1;0;0;1;1;3714;0;3714;1;1;
/org.eclipse.ui.workbench/Eclipse UI/org/eclipse/ui/internal/commands/ws/WorkbenchPartSiteCommandSupport.java;1;0;3;1;0;0;0;3;23;1;3;3129;23;23;1;0;0;3;3;3129;0;4144;3;1;
/org.eclipse.debug.ui/ui/org/eclipse/debug/internal/ui/views/launch/DecorationManager.java;1;0;1;1;0;0;0;1;0;0;1;1220;0;0;1;0;0;1;1;1220;0;1220;1;1;
/org.eclipse.pde.ui/sandbox/org/eclipse/pde/internal/ui/editor/standalone/text/XMLTagScanner.java;1;0;2;1;0;0;0;2;0;1;2;2320;0;0;1;0;0;2;2;2320;0;2906;2;1;
/org.eclipse.jdt.ui/ui/org/eclipse/jdt/internal/ui/text/spelling/engine/SpellEvent.java;2;0;2;1;1;1;1;1;2;0;1;3930;2;2;1;0;0;1;2;3930;0;6340;2;2;
/org.eclipse.ui.ide/src/org/eclipse/ui/IProjectActionFilter.java;2;0;2;1;0;0;0;2;0;1;2;1511;0;0;1;0;0;2;2;1511;0;2263;2;2;
/org.eclipse.swt.tests/JUnit Tests/org/eclipse/swt/tests/junit/Test_org_eclipse_swt_events_SelectionAdapter.java;1;0;1;1;0;0;0;1;23;0;1;2175;23;23;1;0;0;1;1;2175;0;2175;1;1;
/org.eclipse.jdt.ui/core refactoring/org/eclipse/jdt/internal/corext/refactoring/rename/RenameNonVirtualMethodProcessor.java;4;1;16;1;5;5;5;11;54;1;11;1125;212;212;1;0;0;11;16;1125;0;6340;16;4;
/org.eclipse.pde.ui/src/org/eclipse/pde/internal/ui/editor/manifest/ManifestForm.java;1;0;2;1;1;1;1;1;4;0;1;724;4;4;1;0;0;1;2;724;0;5431;2;1;
/org.eclipse.ui.workbench/Eclipse UI/org/eclipse/ui/internal/SavePerspectiveAction.java;1;0;1;1;0;0;0;1;65;0;1;2737;65;65;1;0;0;1;1;2737;0;2737;1;1;
/org.eclipse.update.core/src/org/eclipse/update/core/SiteManager.java;4;1;9;2;5;5;5;4;45;2;3;0;114;114;2;1;0;4;9;0;1;6336;8;4;
/org.eclipse.help.base/src/org/eclipse/help/internal/standalone/StandaloneInfocenter.java;1;1;6;1;3;3;3;3;50;2;2;1740;70;70;2;1;0;3;6;1740;1;6337;5;1;
/org.eclipse.debug.ui/ui/org/eclipse/debug/internal/ui/views/launch/LaunchViewContentProvider.java;2;0;2;1;1;1;1;1;4;0;1;4779;6;6;1;0;0;1;2;4779;0;6336;2;2;
/org.eclipse.debug.core/core/org/eclipse/debug/core/variables/ILaunchVariableManager.java;2;0;8;1;0;0;0;8;65;3;5;754;104;104;3;3;0;8;8;845;3;2120;5;2;
/org.eclipse.update.core/src/org/eclipse/update/standalone/AddSiteCommand.java;1;1;6;1;5;5;5;1;33;0;1;4928;62;62;1;0;0;1;6;4928;0;6336;6;1;
/org.eclipse.ui.workbench/Eclipse UI/org/eclipse/ui/activities/ActivationServiceFactory.java;1;0;2;1;0;0;0;2;0;1;2;2728;0;0;1;0;0;2;2;2728;0;2800;2;1;
/org.eclipse.debug.ui/ui/org/eclipse/debug/internal/ui/views/memory/CopyViewTabToClipboardAction.java;2;1;2;1;2;2;2;0;5;0;0;5254;5;5;1;0;0;0;2;5254;0;5313;2;2;
/org.eclipse.help.webapp/src_servlets/org/eclipse/help/internal/webapp/data/SearchData.java;1;1;14;1;4;4;4;10;111;1;10;106;445;445;1;0;0;10;14;106;0;6337;14;1;
/org.eclipse.ui.views/src/org/eclipse/ui/views/internal/markers/tasks/AddGlobalTaskAction.java;1;0;2;1;0;0;0;2;0;1;2;267;0;0;1;0;0;2;2;267;0;749;2;1;
/org.eclipse.ui.workbench/Eclipse UI/org/eclipse/ui/internal/activities/service/IActivityService.java;1;0;2;1;0;0;0;2;0;1;2;2444;0;0;1;0;0;2;2;2444;0;2491;2;1;
/org.eclipse.search/new search/org/eclipse/search/ui/ISearchResultViewPart.java;3;1;9;1;5;5;5;4;30;2;3;3711;76;76;2;1;0;4;9;4841;1;6340;8;3;
/org.eclipse.jdt.core.tests.model/workspace/Converter/test0467/Assert.java;1;0;1;1;0;0;0;1;0;0;1;3714;0;0;1;0;0;1;1;3714;0;3714;1;1;
/org.eclipse.update.ui.forms/Eclipse Forms/org/eclipse/ui/forms/internal/widgets/BulletParagraph.java;1;0;2;1;0;0;0;2;0;1;2;3138;0;0;1;0;0;2;2;3138;0;4157;2;1;
/org.eclipse.core.tests.runtime/src/org/eclipse/core/tests/internal/plugins/PluginResolveTest_20.java;1;0;1;1;0;0;0;1;0;0;1;3014;0;0;1;0;0;1;1;3014;0;3014;1;1;
/org.eclipse.jdt.debug.tests/tests/org/eclipse/jdt/debug/tests/eval/NestedTypeFieldValue_315.java;1;0;1;1;0;0;0;1;112;0;1;1274;112;112;1;0;0;1;1;1274;0;1274;1;1;
/org.eclipse.help.webapp/src_servlets/org/eclipse/help/internal/webapp/servlet/HighlightFilter.java;1;1;3;1;3;3;3;0;46;0;0;5594;90;90;1;0;0;0;3;5594;0;6337;3;1;
/org.eclipse.debug.ui/ui/org/eclipse/debug/ui/launchVariables/LaunchVariableSelectionDialog.java;3;0;4;1;0;0;0;4;4;2;3;771;5;5;2;1;0;4;4;771;1;2120;3;3;
/org.eclipse.swt.tests/JUnit Tests/org/eclipse/swt/tests/junit/Test_org_eclipse_swt_custom_ScrolledComposite.java;1;0;1;1;0;0;0;1;31;0;1;2104;31;31;1;0;0;1;1;2104;0;2104;1;1;
/org.eclipse.update.ui/src/org/eclipse/update/internal/ui/search/BackgroundThread.java;1;0;1;1;0;0;0;1;0;0;1;825;0;0;1;0;0;1;1;825;0;825;1;1;
/org.eclipse.jdt.core.tests.model/workspace/Formatter/test272/A_out.java;1;0;2;1;0;0;0;2;4;1;2;2442;4;4;1;0;0;2;2;2442;0;2863;2;1;
/org.eclipse.ui.tests/Eclipse UI Tests/org/eclipse/ui/tests/api/IActionDelegateTest.java;1;0;1;1;0;0;0;1;3;0;1;3091;3;3;1;0;0;1;1;3091;0;3091;1;1;
/org.eclipse.team.ftp/src/org/eclipse/team/internal/ftp/ui/subscriber/FTPOverridePutAction.java;2;2;5;1;3;2;3;2;32;1;2;3383;42;42;2;0;1;2;5;5508;1;6337;4;2;
/org.eclipse.jdt.ui.tests.refactoring/resources/ChangeSignature/cannotModify/A_testFailDoAll8.java;1;0;1;1;0;0;0;1;0;0;1;4342;0;0;1;0;0;1;1;4342;0;4342;1;1;
/org.eclipse.jface/src/org/eclipse/jface/preference/PreferenceContentProvider.java;2;0;4;1;1;1;1;3;69;1;3;3131;93;93;1;0;0;3;4;3131;0;5463;4;2;
/org.eclipse.update.core/src/org/eclipse/update/internal/search/OptionalFeatureSearchCategory.java;3;1;7;1;2;2;2;5;8;1;5;825;27;27;1;0;0;5;7;825;0;6336;7;3;
/org.eclipse.team.ui/src/org/eclipse/team/internal/ui/sync/views/FilterSyncViewerAction.java;1;0;1;1;0;0;0;1;0;0;1;488;0;0;1;0;0;1;1;488;0;488;1;1;
/org.eclipse.jdt.core.tests.compiler/src/org/eclipse/jdt/core/tests/compiler/regression/XLargeTest.java;2;0;2;1;0;0;0;2;2;1;2;1785;2;2;1;0;0;2;2;1785;0;2389;2;2;
/org.eclipse.ui.editors/src/org/eclipse/ui/internal/texteditor/AnnotationTypeHierarchy.java;3;1;4;1;4;4;4;0;4;0;0;5177;10;10;1;0;0;0;4;5177;0;6340;4;3;
/org.eclipse.team.ftp/src/org/eclipse/team/internal/ftp/ui/ContainerSelectionPage.java;1;0;1;1;0;0;0;1;0;0;1;3240;0;0;1;0;0;1;1;3240;0;3240;1;1;
/org.eclipse.jdt.core.tests.model/src/org/eclipse/jdt/core/tests/dom/GetKeyVisitor.java;1;0;1;1;1;1;1;0;0;0;0;5313;0;0;1;0;0;0;1;5313;0;5313;1;1;
/org.eclipse.jdt.core/model/org/eclipse/jdt/internal/core/util/RuntimeVisibleAnnotationsAttribute.java;1;0;1;1;0;0;0;1;0;0;1;4466;0;0;1;0;0;1;1;4466;0;4466;1;1;
/org.eclipse.help/src/org/eclipse/help/internal/IndexToolApplication.java;1;0;2;1;0;0;0;2;26;1;2;925;26;26;1;0;0;2;2;925;0;2732;2;1;
/org.eclipse.jdt.debug.tests/tests/org/eclipse/jdt/debug/tests/eval/NestedTypeFieldValue_739.java;1;0;1;1;0;0;0;1;96;0;1;1274;96;96;1;0;0;1;1;1274;0;1274;1;1;
/org.eclipse.jdt.core.tests.model/workspace/Converter/src/test0504/A.java;1;0;1;1;0;0;0;1;0;0;1;3714;0;0;1;0;0;1;1;3714;0;3714;1;1;
/org.eclipse.swt/Eclipse SWT PI/win32/org/eclipse/swt/internal/win32/HIGHCONTRAST.java;1;0;1;1;0;0;0;1;0;0;1;4498;0;0;1;0;0;1;1;4498;0;4498;1;1;
/org.eclipse.team.core/src/org/eclipse/team/core/TeamProvider.java;1;0;1;1;0;0;0;1;0;0;1;2777;0;0;1;0;0;1;1;2777;0;2777;1;1;
/org.eclipse.jdt.ui/core refactoring/org/eclipse/jdt/internal/corext/refactoring/TypedSource.java;4;1;8;1;3;3;3;5;11;1;5;1670;30;30;1;0;0;5;8;1670;0;6340;8;4;
/org.eclipse.jdt.core.tests.model/workspace/Converter/test0517/A.java;1;0;2;1;0;0;0;2;0;1;2;3612;0;0;1;0;0;2;2;3612;0;3714;2;1;
/org.eclipse.jface.text/src/org/eclipse/jface/contentassist/IContentAssistProcessorExtension.java;1;1;2;1;2;2;2;0;0;0;0;5181;0;0;1;0;0;0;2;5181;0;5199;2;1;
/org.eclipse.update.core/src/org/eclipse/update/core/model/InstalledSite.java;1;0;1;1;0;0;0;1;0;0;1;2634;0;0;1;0;0;1;1;2634;0;2634;1;1;
/org.eclipse.jdt.core/compiler/org/eclipse/jdt/internal/compiler/lookup/MethodVerifier.java;3;0;11;1;1;1;1;10;110;1;10;24;235;235;1;0;0;10;11;24;0;5340;11;3;
/org.eclipse.team.ui/src/org/eclipse/team/ui/sync/OrSyncInfoFilter.java;2;0;3;1;0;0;0;3;34;1;3;709;34;34;1;0;0;3;3;709;0;2632;3;2;
/org.eclipse.ant.tests.ui/Ant Editor Tests/org/eclipse/ui/externaltools/internal/ant/editor/test/AntEditorTests.java;1;0;1;1;0;0;0;1;0;0;1;1274;0;0;1;0;0;1;1;1274;0;1274;1;1;
/org.eclipse.osgi/core/adaptor/org/eclipse/osgi/framework/util/PermissionStorage.java;2;1;2;1;2;2;2;0;0;0;0;5107;0;0;1;0;0;0;2;5107;0;5116;2;2;
/org.eclipse.core.runtime/src/org/eclipse/core/runtime/Plugin.java;4;3;44;2;22;14;22;22;1184;3;14;3013;2166;2166;3;8;8;22;44;3195;16;6363;28;4;
/org.eclipse.ant.ui/Ant Editor/org/eclipse/ant/ui/internal/editor/text/IXMLAnnotation.java;1;0;3;1;0;0;0;3;44;1;3;250;44;44;1;0;0;3;3;250;0;1811;3;1;
/org.eclipse.ant.ui/Ant Tools Support/org/eclipse/ant/internal/ui/preferences/AntTasksPage.java;1;0;8;1;0;0;0;8;64;2;6;1811;105;105;2;2;0;8;8;1860;2;2991;6;1;
/org.eclipse.jdt.ui/ui refactoring/org/eclipse/jdt/internal/ui/refactoring/reorg/PasteAction.java;5;1;29;1;5;5;5;24;412;2;23;1114;694;694;2;1;0;24;29;5083;1;6340;28;5;
/org.eclipse.debug.core/core/org/eclipse/debug/internal/core/ExpressionManager.java;4;2;17;1;6;5;6;11;123;4;8;1067;351;351;4;3;1;11;17;1591;4;6336;13;4;
/org.eclipse.jdt.ui/ui/org/eclipse/jdt/internal/ui/preferences/TypeFilterPreferencePage.java;2;1;5;1;3;3;3;2;4;1;2;3168;10;10;1;0;0;2;5;3168;0;6340;5;2;
/org.eclipse.ui.externaltools/Ant Editor/org/eclipse/ui/externaltools/internal/ant/editor/derived/SingleCharReader.java;1;0;1;1;0;0;0;1;0;0;1;282;0;0;1;0;0;1;1;282;0;282;1;1;
/org.eclipse.jdt.debug/jdi/org/eclipse/jdi/internal/ArrayTypeImpl.java;2;0;2;1;0;0;0;2;15;1;2;2497;17;17;1;0;0;2;2;2497;0;4267;2;2;
/org.eclipse.update.ui/src/org/eclipse/update/internal/ui/parts/ImageOverlayIcon.java;1;0;1;1;0;0;0;1;2;0;1;890;2;2;1;0;0;1;1;890;0;890;1;1;
/org.eclipse.debug.core/core/org/eclipse/debug/core/variables/RefreshScopeVariableRegistry.java;1;0;2;1;0;0;0;2;0;1;2;728;0;0;1;0;0;2;2;728;0;737;2;1;
/org.eclipse.ui.workbench/Eclipse UI/org/eclipse/ui/internal/commands/old/ContextBindingElement.java;1;0;1;1;0;0;0;1;0;0;1;1321;0;0;1;0;0;1;1;1321;0;1321;1;1;
/org.eclipse.ant.ui/Ant Editor/org/eclipse/ant/ui/internal/editor/outline/LocationProvider.java;1;0;3;1;0;0;0;3;1;1;3;250;1;1;1;0;0;3;3;250;0;1811;3;1;
/org.eclipse.ui.ide/src/org/eclipse/ui/internal/ide/NewWizardShortcutAction.java;6;1;8;2;3;3;3;5;21;2;4;2264;51;51;2;1;0;5;8;3061;1;6338;7;6;
/org.eclipse.team.ui/src/org/eclipse/team/ui/synchronize/DecoratingColorLabelProvider.java;2;0;2;1;1;1;1;1;0;0;1;4632;0;0;1;0;0;1;2;4632;0;5358;2;2;
/org.eclipse.jdt.ui/core refactoring/org/eclipse/jdt/internal/corext/refactoring/structure/ChangeSignatureRefactoring.java;6;2;70;2;24;21;24;46;905;2;41;122;3654;3654;2;5;3;46;70;130;8;6340;62;6;
/org.eclipse.ui.intro/src/org/eclipse/ui/internal/intro/impl/html/FormattedHTMLElement.java;1;1;2;1;2;2;2;0;2;0;0;5115;2;2;1;0;0;0;2;5115;0;5314;2;1;
/org.eclipse.help.ui/src/org/eclipse/help/ui/internal/workingset/HelpWorkingSetPage.java;1;0;1;1;0;0;0;1;0;0;1;2732;0;0;1;0;0;1;1;2732;0;2732;1;1;
/org.eclipse.jface/src/org/eclipse/jface/util/OpenStrategy.java;3;1;3;1;2;2;2;1;21;0;1;1399;24;24;1;0;0;1;3;1399;0;6338;3;3;
/org.eclipse.jdt.ui.examples.javafamily/src/org/eclipse/jface/text/source/ITranslator.java;1;0;3;1;0;0;0;3;51;1;3;1172;51;51;1;0;0;3;3;1172;0;1642;3;1;
/org.eclipse.ltk.core.refactoring/src/org/eclipse/ltk/internal/core/refactoring/ListenerList.java;1;0;2;1;1;1;1;1;2;0;1;4845;2;2;1;0;0;1;2;4845;0;6340;2;1;
/org.eclipse.pde.runtime/src/org/eclipse/pde/internal/runtime/logview/LogReader.java;2;2;17;1;5;4;5;12;203;1;12;831;434;434;2;0;1;12;17;5797;1;6336;16;2;
/org.eclipse.jdt.ui.tests.refactoring/test cases/org/eclipse/jdt/ui/tests/nls/NLSHintTest.java;3;1;10;1;8;8;8;2;54;1;2;4930;304;304;1;0;0;2;10;4930;0;6340;10;3;
/org.eclipse.ui.workbench/Eclipse UI/org/eclipse/ui/internal/progress/ProgressViewerContentProvider.java;1;0;4;1;1;1;1;3;16;1;3;4262;31;31;1;0;0;3;4;4262;0;5186;4;1;
/org.eclipse.debug.ui/ui/org/eclipse/debug/internal/ui/launchConfigurations/LaunchConfigurationDialog.java;1;0;2;1;0;0;0;2;4;1;2;643;5;5;1;0;0;2;2;643;0;3276;2;1;
/org.eclipse.pde.ui/src/org/eclipse/pde/internal/ui/editor/manifest/ResourceAttributeCellEditor.java;1;0;5;1;1;1;1;4;150;1;4;627;246;246;1;0;0;4;5;627;0;5431;5;1;
/org.eclipse.jdt.core/search/org/eclipse/jdt/internal/core/search/matching/ConstructorReferencePattern.java;1;0;2;1;0;0;0;2;19;1;2;786;19;19;1;0;0;2;2;786;0;1115;2;1;
/org.eclipse.swt.graphics.text/org.eclipse.swt/Eclipse SWT PI/gtk/org/eclipse/swt/internal/gtk/PangoLayoutLine.java;1;0;1;1;0;0;0;1;0;0;1;2267;0;0;1;0;0;1;1;2267;0;2267;1;1;
/org.eclipse.update/src/org/eclipse/update/internal/core/UMSessionManagerMessage.java;1;0;1;1;1;1;1;0;0;0;0;6339;0;0;1;0;0;0;1;6339;0;6339;1;1;
/org.eclipse.swt/Eclipse SWT/motif/org/eclipse/swt/widgets/MenuItem.java;6;1;15;2;3;3;3;12;67;2;10;127;207;207;2;2;0;12;15;1757;2;6352;13;6;
/org.eclipse.team.examples.filesystem/src/org/eclipse/team/examples/filesystem/deployment/NullAction.java;1;0;3;1;0;0;0;3;42;1;3;2810;42;42;1;0;0;3;3;2810;0;4633;3;1;
/org.eclipse.update.core/src/org/eclipse/update/configuration/IConfiguredSite.java;2;1;4;1;2;2;2;2;10;0;1;3383;17;17;2;1;0;2;4;3383;1;6336;3;2;
/org.eclipse.team.cvs.ui/src/org/eclipse/team/internal/ccvs/ui/CVSLightweightDecorator.java;2;1;24;1;5;5;5;19;51;2;17;866;268;268;2;2;0;19;24;2458;2;6337;22;2;
/org.eclipse.releng.tools/src/org/eclipse/releng/tools/CommitCommentPage.java;2;1;2;1;2;2;2;0;9;0;0;5183;9;9;1;0;0;0;2;5183;0;6105;2;2;
/org.eclipse.core.tests.runtime/src/org/eclipse/core/tests/internal/runtimetests/SampleMPR.java;1;0;1;1;1;1;1;0;21;0;0;5149;21;21;1;0;0;0;1;5149;0;5149;1;1;
/org.eclipse.ant.ui/Ant Editor/org/eclipse/ant/internal/ui/editor/text/AntEditorTextMessages.java;1;0;1;1;0;0;0;1;0;0;1;3737;0;0;1;0;0;1;1;3737;0;3737;1;1;
/org.eclipse.pde.ui/src/org/eclipse/pde/internal/ui/wizards/site/OpenProjectWizardAction.java;3;1;3;1;3;3;3;0;10;0;0;5387;12;12;1;0;0;0;3;5387;0;6336;3;3;
/org.eclipse.jdt.ui/ui/org/eclipse/jdt/internal/ui/wizards/buildpaths/ExclusionInclusionEntryDialog.java;2;0;2;1;1;1;1;1;2;0;1;4928;2;2;1;0;0;1;2;4928;0;6340;2;2;
/org.eclipse.core.runtime.osgi/src/org/eclipse/core/internal/runtime/PlatformURLPluginConnection.java;1;0;2;1;0;0;0;2;101;1;2;3013;101;101;1;0;0;2;2;3013;0;3030;2;1;
/org.eclipse.core.runtime.compatibility/src-runtime/org/eclipse/core/runtime/IPluginDescriptor.java;2;0;4;1;0;0;0;4;604;1;4;3013;631;631;1;0;0;4;4;3013;0;3169;4;2;
/org.eclipse.jdt.core/eval/org/eclipse/jdt/internal/eval/InstallException.java;1;0;1;1;0;0;0;1;2;0;1;3560;2;2;1;0;0;1;1;3560;0;3560;1;1;
/org.eclipse.jdt.ui/core refactoring/org/eclipse/jdt/internal/corext/refactoring/changes/AbstractTextChange.java;1;0;7;1;0;0;0;7;50;1;7;1869;102;102;1;0;0;7;7;1869;0;3708;7;1;
/org.eclipse.ui.workbench/Eclipse UI/org/eclipse/ui/wizards/datatransfer/IImportStructureProvider.java;1;0;1;1;0;0;0;1;0;0;1;2737;0;0;1;0;0;1;1;2737;0;2737;1;1;
/org.eclipse.team.cvs.ui/src/org/eclipse/team/internal/ccvs/ui/wizards/RestoreFromRepositoryFileSelectionPage.java;2;1;5;1;2;2;2;3;51;1;3;848;110;110;1;0;0;3;5;848;0;6337;5;2;
/org.eclipse.jdt.core/dom/org/eclipse/jdt/core/dom/TypeDeclaration.java;5;2;19;1;5;4;5;14;414;1;14;80;922;922;2;0;1;14;19;5268;1;5781;18;5;
/org.eclipse.jdt.junit/src/org/eclipse/jdt/internal/junit/ui/GotoReferencedTestAction.java;2;1;2;1;2;2;2;0;8;0;0;5112;10;10;1;0;0;0;2;5112;0;6340;2;2;
/org.eclipse.jdt.ui.tests.refactoring/resources/InlineMethodWorkspace/TestCases/import_out/TestUseInClassLiteral.java;1;0;1;1;0;0;0;1;2;0;1;845;2;2;1;0;0;1;1;845;0;845;1;1;
/org.eclipse.ui.tests/Eclipse UI Tests/org/eclipse/ui/tests/api/IWorkbenchPartTest.java;3;1;4;1;3;3;3;1;6;0;1;3091;12;12;1;0;0;1;4;3091;0;6338;4;3;
/org.eclipse.jdt.core.tests.model/workspace/Converter/test0143/Test.java;1;0;1;1;0;0;0;1;0;0;1;3714;0;0;1;0;0;1;1;3714;0;3714;1;1;
/org.eclipse.team.tests.cvs.core/src/org/eclipse/team/tests/ccvs/ui/old/PerformanceTimer.java;1;0;2;1;0;0;0;2;0;1;2;2632;0;0;1;0;0;2;2;2632;0;4216;2;1;
/org.eclipse.team.ftp/src/org/eclipse/team/internal/ftp/subscriber/FTPDeploymentProvider.java;2;1;5;1;2;2;2;3;376;1;3;3494;388;388;1;0;0;3;5;3494;0;6337;5;2;
/org.eclipse.jdt.core/formatter/org/eclipse/jdt/internal/formatter/AbortFormatting.java;2;0;3;1;0;0;0;3;2;1;3;535;4;4;1;0;0;3;3;535;0;3560;3;2;
/org.eclipse.jdt.ui.tests/ui/org/eclipse/jdt/ui/tests/dialogs/DialogsTest2.java;1;0;1;1;1;1;1;0;2;0;0;6340;2;2;1;0;0;0;1;6340;0;6340;1;1;
/org.eclipse.ui.workbench/Eclipse UI/org/eclipse/ui/wizards/datatransfer/WizardFileSystemResourceImportPage1.java;2;0;2;1;0;0;0;2;4;1;2;1080;4;4;1;0;0;2;2;1080;0;2737;2;2;
/org.eclipse.pde.ui/src_ant/org/eclipse/pde/internal/ui/ant/PluginExportTask.java;1;0;2;1;1;1;1;1;10;0;1;4686;10;10;1;0;0;1;2;4686;0;6336;2;1;
/org.eclipse.jdt.ui/ui/org/eclipse/jdt/internal/ui/preferences/SemanticHighlightingPreferencePage.java;3;2;3;2;3;2;3;0;13;0;0;5272;13;13;2;0;1;0;3;5481;1;5481;2;3;
/org.eclipse.core.runtime.compatibility/src-model/org/eclipse/core/internal/model/IModel.java;2;1;3;1;2;2;2;1;2;0;1;3013;4;4;1;0;0;1;3;3013;0;6340;3;2;
/org.eclipse.jdt.ui/ui/org/eclipse/jdt/internal/ui/text/correction/ReturnTypeSubProcessor.java;2;1;25;1;4;4;4;21;50;2;20;311;406;406;2;1;0;21;25;2814;1;6340;24;2;
/org.eclipse.team.webdav/src/org/eclipse/team/internal/webdav/core/DavRemoteTargetResource.java;2;0;5;1;1;1;1;4;70;1;4;917;135;135;1;0;0;4;5;917;0;6337;5;2;
/org.eclipse.jdt.core.tests.model/workspace/Formatter/test198/A_out.java;1;0;1;1;0;0;0;1;0;0;1;2424;0;0;1;0;0;1;1;2424;0;2424;1;1;
/org.eclipse.help/src/org/eclipse/help/internal/ITocsChangedListener.java;1;1;3;1;2;2;2;1;16;0;1;4972;32;32;1;0;0;1;3;4972;0;6337;3;1;
/org.eclipse.team.core/src/org/eclipse/team/core/IMemento.java;1;0;1;1;0;0;0;1;0;0;1;2793;0;0;1;0;0;1;1;2793;0;2793;1;1;
/org.eclipse.ui.workbench/Eclipse UI/org/eclipse/ui/internal/EditorArea.java;6;1;11;2;2;2;2;9;59;2;8;471;210;210;2;1;0;9;11;4015;1;5539;10;6;
/org.eclipse.team.ui/src/org/eclipse/team/internal/ui/synchronize/sets/SubscriberEventHandler.java;2;0;5;1;0;0;0;5;303;1;5;2535;343;343;1;0;0;5;5;2535;0;4216;5;2;
/org.eclipse.jface.text/src/org/eclipse/jface/text/ITextInputListener.java;2;1;2;1;2;2;2;0;8;0;0;6340;10;10;1;0;0;0;2;6340;0;6359;2;2;
/org.eclipse.jdt.core.tests.model/workspace/Converter/test0286/Test.java;1;0;1;1;0;0;0;1;0;0;1;3714;0;0;1;0;0;1;1;3714;0;3714;1;1;
/org.eclipse.team.examples.filesystem/src/org/eclipse/team/examples/pessimistic/ui/PessimisticProviderAction.java;1;0;2;1;1;1;1;1;231;0;1;3368;231;231;1;0;0;1;2;3368;0;6103;2;1;
/org.eclipse.jdt.core.tests.model/workspace/Formatter/test388/A_in.java;1;0;1;1;0;0;0;1;0;0;1;3172;0;0;1;0;0;1;1;3172;0;3172;1;1;
/org.eclipse.swt/Eclipse SWT PI/gtk/org/eclipse/swt/internal/gtk/AtkObjectFactoryClass.java;1;0;2;1;0;0;0;2;0;1;2;1102;0;0;1;0;0;2;2;1102;0;1214;2;1;
/org.eclipse.update.ui/srcnew/org/eclipse/update/internal/ui/wizards/UnifiedModeSelectionPage.java;3;0;12;2;0;0;0;12;31;3;9;478;108;108;3;3;0;12;12;572;3;825;9;3;
/org.eclipse.pde.ui/src/org/eclipse/pde/internal/ui/parts/ComboPart.java;1;1;2;1;2;2;2;0;10;0;0;5431;10;10;1;0;0;0;2;5431;0;6336;2;1;
/org.eclipse.jdt.ui/core extension/org/eclipse/jdt/internal/corext/dom/ITrackedNodePosition.java;1;0;3;1;1;1;1;2;16;1;2;4493;16;16;1;0;0;2;3;4493;0;5406;3;1;
/org.eclipse.ui.examples.javaeditor/Eclipse Java Editor Example/org/eclipse/ui/examples/javaeditor/java/JavaDoubleClickSelector.java;2;0;2;1;1;1;1;1;5;0;1;2741;7;7;1;0;0;1;2;2741;0;6340;2;2;
/org.eclipse.jdt.core.tests.model/workspace/Converter/test0270/Test.java;1;0;1;1;0;0;0;1;0;0;1;3714;0;0;1;0;0;1;1;3714;0;3714;1;1;
/org.eclipse.ui.workbench/Eclipse UI/org/eclipse/ui/internal/progress/ProgressMessages.java;1;0;2;1;0;0;0;2;13;0;1;956;13;13;2;1;0;2;2;956;1;956;1;1;
/org.eclipse.jdt.core/model/org/eclipse/jdt/internal/core/util/PerThreadObject.java;2;0;2;1;0;0;0;2;4;1;2;90;4;4;1;0;0;2;2;90;0;3062;2;2;
/org.eclipse.ui.workbench/Eclipse UI/org/eclipse/ui/internal/roles/Activity.java;2;0;8;1;0;0;0;8;152;3;5;2005;250;250;3;3;0;8;8;2078;3;2443;5;2;
/org.eclipse.jdt.text.tests/src/org/eclipse/jdt/text/tests/ComilationUnitDocumentProviderTest.java;1;1;3;1;3;3;3;0;11;0;0;5129;13;13;1;0;0;0;3;5129;0;6340;3;1;
/org.eclipse.text.tests/projection/org/eclipse/text/tests/ProjectionDocumentTest.java;2;1;4;1;3;3;3;1;90;0;1;5082;143;143;1;0;0;1;4;5082;0;6340;4;2;
/org.eclipse.jdt.ui.tests.refactoring/resources/InlineMethodWorkspace/TestCases/import_in/Provider.java;1;0;1;1;0;0;0;1;7;0;1;788;7;7;1;0;0;1;1;788;0;788;1;1;
/org.eclipse.jdt.ui.tests/ui/org/eclipse/jdt/ui/tests/search/TestParticipant.java;2;1;2;1;2;2;2;0;10;0;0;5590;10;10;1;0;0;0;2;5590;0;6340;2;2;
/org.eclipse.jdt.core.tests.model/workspace/Resolve/src/ResolveLocalClass1.java;1;0;1;1;0;0;0;1;0;0;1;1968;0;0;1;0;0;1;1;1968;0;1968;1;1;
/org.eclipse.debug.core/core/org/eclipse/debug/internal/core/stringsubstitution/IValueVariableInitializer.java;2;0;2;1;0;0;0;2;0;1;2;2032;0;0;1;0;0;2;2;2032;0;2514;2;2;
/org.eclipse.team.ui/src/org/eclipse/team/ui/synchronize/subscriber/TeamSubscriberRefreshSchedule.java;1;0;1;1;0;0;0;1;0;0;1;3972;0;0;1;0;0;1;1;3972;0;3972;1;1;
/org.eclipse.swt/Eclipse SWT PI/win32/org/eclipse/swt/internal/win32/MSG.java;1;0;1;1;0;0;0;1;2;0;1;2915;2;2;1;0;0;1;1;2915;0;2915;1;1;
/org.eclipse.swt/Eclipse SWT PI/gtk/org/eclipse/swt/internal/gtk/AtkComponentIface.java;1;0;2;1;0;0;0;2;0;1;2;1102;0;0;1;0;0;2;2;1102;0;1214;2;1;
/org.eclipse.help.ui/src/org/eclipse/help/ui/internal/browser/embedded/EmbeddedBrowserDialog.java;1;1;10;1;2;2;2;8;41;1;8;2898;113;113;1;0;0;8;10;2898;0;5463;10;1;
/org.eclipse.jdt.ui/ui/org/eclipse/jdt/internal/ui/javaeditor/JavaOutlinePage.java;7;1;26;2;5;5;5;21;68;2;20;1050;462;462;2;1;0;21;26;4440;1;6340;25;7;
/org.eclipse.jdt.ui.tests.refactoring/resources/SurroundWithWorkSpace/SurroundWithTests/trycatch_out/TestSuperCall.java;1;0;1;1;0;0;0;1;6;0;1;845;6;6;1;0;0;1;1;845;0;845;1;1;
/org.eclipse.core.resources/src/org/eclipse/core/resources/IMarker.java;2;0;4;1;1;1;1;3;572;1;3;44;662;662;1;0;0;3;4;44;0;5146;4;2;
/org.eclipse.jdt.ui.tests.refactoring/resources/MoveInstanceMethod/canMove/test15/out/A.java;1;0;1;1;0;0;0;1;0;0;1;1570;0;0;1;0;0;1;1;1570;0;1570;1;1;
/org.eclipse.ui.workbench/Eclipse UI/org/eclipse/ui/internal/commands/api/ICategoryEvent.java;1;0;2;1;0;0;0;2;2;0;1;2562;2;2;2;1;0;2;2;2562;1;2562;1;1;
/org.eclipse.jdt.ui/ui/org/eclipse/jdt/ui/actions/ExternalizeStringsAction.java;5;2;10;2;4;3;4;6;19;1;6;122;91;91;2;0;1;6;10;5375;1;6340;9;5;
/org.eclipse.search/search/org/eclipse/search/internal/core/ISearchScope.java;1;0;1;1;1;1;1;0;2;0;0;6340;2;2;1;0;0;0;1;6340;0;6340;1;1;
/org.eclipse.jface.text/src/org/eclipse/jface/text/source/AnnotationPresentation.java;1;0;1;1;0;0;0;1;0;0;1;2243;0;0;1;0;0;1;1;2243;0;2243;1;1;
/org.eclipse.jdt.ui/ui/org/eclipse/jdt/internal/ui/preferences/CodeAssistConfigurationBlock.java;1;1;2;1;2;2;2;0;3;0;0;5506;3;3;1;0;0;0;2;5506;0;5525;2;1;
/org.eclipse.help/src/org/eclipse/help/internal/workingset/WorkingSetManager.java;1;0;4;1;0;0;0;4;74;2;3;401;89;89;2;1;0;4;4;2407;1;2732;3;1;
/org.eclipse.jdt.ui/core refactoring/org/eclipse/jdt/internal/corext/refactoring/code/InlineConstantRefactoring.java;5;1;30;1;7;7;7;23;69;2;22;48;338;338;2;1;0;23;30;1952;1;6340;29;5;
/org.eclipse.ui.workbench/Eclipse UI/org/eclipse/ui/internal/chris/roles/api/secondstage/IContextBindingDefinition.java;1;0;2;1;0;0;0;2;0;0;1;2207;0;0;2;1;0;2;2;2207;1;2207;1;1;
/org.eclipse.ui.externaltools/External Tools Base/org/eclipse/ui/externaltools/internal/ui/TreeAndListGroup.java;2;0;4;1;1;1;1;3;11;1;3;3147;29;29;1;0;0;3;4;3147;0;5489;4;2;
/org.eclipse.team.cvs.core/src/org/eclipse/team/internal/ccvs/core/syncinfo/RemoteTagSynchronizer.java;2;0;15;1;0;0;0;15;76;2;13;884;285;285;2;2;0;15;15;1691;2;4216;13;2;
/org.eclipse.ant.ui/Ant Editor/org/eclipse/ant/internal/ui/editor/text/IXMLAnnotation.java;1;0;3;1;1;1;1;2;4;1;2;1811;6;6;1;0;0;2;3;1811;0;6336;3;1;
/org.eclipse.jdt.core.tests.model/workspace/Converter/src/test0453/A.java;1;0;1;1;0;0;0;1;0;0;1;3714;0;0;1;0;0;1;1;3714;0;3714;1;1;
/org.eclipse.jdt.core.tests.model/workspace/Formatter/test235/A_in.java;1;0;1;1;0;0;0;1;0;0;1;2437;0;0;1;0;0;1;1;2437;0;2437;1;1;
/org.eclipse.jdt.core.tests.model/workspace/Formatter/test423/A_in.java;1;0;1;1;0;0;0;1;0;0;1;3478;0;0;1;0;0;1;1;3478;0;3478;1;1;
/org.eclipse.pde.ui/src/org/eclipse/pde/internal/ui/wizards/templates/FirstTemplateWizardPage.java;3;0;22;2;0;0;0;22;86;3;19;368;332;332;3;3;0;22;22;3435;3;3986;19;3;
/org.eclipse.swt.opengl/gtk/org/eclipse/swt/opengl/internal/gtk/XVisualInfo.java;1;0;1;1;0;0;0;1;0;0;1;2143;0;0;1;0;0;1;1;2143;0;2143;1;1;
/org.eclipse.jdt.core.tests.model/workspace/Formatter/test312/A_in.java;1;0;1;1;0;0;0;1;0;0;1;2442;0;0;1;0;0;1;1;2442;0;2442;1;1;
/org.eclipse.ui.workbench/Eclipse UI/org/eclipse/ui/INavigationHistory.java;2;1;2;1;2;2;2;0;2;0;0;5510;4;4;1;0;0;0;2;5510;0;6338;2;2;
/org.eclipse.ui.workbench/Eclipse UI/org/eclipse/ui/internal/csm/commands/CommandServiceEvent.java;1;0;2;1;0;0;0;2;0;1;2;2515;0;0;1;0;0;2;2;2515;0;2562;2;1;
/org.eclipse.jdt.core.tests.model/workspace/Converter/test0063/Test.java;1;0;1;1;0;0;0;1;0;0;1;3714;0;0;1;0;0;1;1;3714;0;3714;1;1;
/org.eclipse.jdt.core.tests.model/src/org/eclipse/jdt/core/tests/model/TestBuffer.java;2;0;3;1;0;0;0;3;3;1;3;1032;5;5;1;0;0;3;3;1032;0;3560;3;2;
/org.eclipse.debug.ui/ui/org/eclipse/debug/internal/ui/console/MessageConsoleStream.java;2;0;6;1;0;0;0;6;27;3;4;1418;32;32;3;2;0;6;6;1418;2;2060;4;2;
/org.eclipse.debug.ui/ui/org/eclipse/debug/internal/ui/InstructionPointerManager.java;2;0;4;1;0;0;0;4;18;1;4;134;32;32;1;0;0;4;4;134;0;2892;4;2;
/org.eclipse.ui.workbench/Eclipse UI/org/eclipse/ui/internal/registry/ShowViewHandler.java;1;0;1;1;1;1;1;0;0;0;0;5942;0;0;1;0;0;0;1;5942;0;5942;1;1;
/org.eclipse.core.runtime.osgi/src/org/eclipse/core/internal/jobs/Queue.java;1;0;2;1;0;0;0;2;10;1;2;3013;10;10;1;0;0;2;2;3013;0;3028;2;1;
/org.eclipse.pde.core/src/org/eclipse/pde/core/plugin/IBundlePluginModelProvider.java;2;1;2;1;2;2;2;0;0;0;0;5211;0;0;1;0;0;0;2;5211;0;5445;2;2;
/org.eclipse.update.ui/src/org/eclipse/update/internal/ui/properties/SiteBookmarkPropertyPage.java;1;0;1;1;0;0;0;1;0;0;1;794;0;0;1;0;0;1;1;794;0;794;1;1;
/org.eclipse.jdt.debug.ui/ui/org/eclipse/jdt/internal/debug/ui/actions/ManageBreakpointRulerAction.java;5;1;19;1;3;3;3;16;255;2;15;232;640;640;2;1;0;16;19;1915;1;6336;18;5;
/org.eclipse.jface.text/src/org/eclipse/jface/text/link/LinkedPositionAnnotations.java;2;1;5;1;3;3;3;2;51;1;2;4214;65;65;1;0;0;2;5;4214;0;6340;5;2;
/org.eclipse.jdt.core.tests.model/workspace/Formatter/test368/A_out.java;2;0;2;1;0;0;0;2;12;1;2;3130;12;12;1;0;0;2;2;3130;0;3362;2;2;
/org.eclipse.ui.workbench/Eclipse UI/org/eclipse/ui/roles/ICategoryListener.java;1;0;2;1;0;0;0;2;0;0;1;2864;0;0;2;1;0;2;2;2864;1;2864;1;1;
/org.eclipse.swt.tests/JUnit Tests/org/eclipse/swt/tests/junit/Test_org_eclipse_swt_graphics_Color.java;3;0;5;1;1;1;1;4;26;2;3;2175;63;63;2;1;0;4;5;2227;1;6352;4;3;
/org.eclipse.ui.workbench/Eclipse UI/org/eclipse/ui/internal/commands/api/IMutableCommandRegistry.java;1;0;4;1;0;0;0;4;2;2;3;1724;2;2;2;1;0;4;4;2515;1;2532;3;1;
/org.eclipse.core.runtime/src/org/eclipse/core/runtime/registry/IConfigurationElement.java;4;0;8;2;0;0;0;8;440;2;6;2105;910;910;2;2;0;8;8;2118;2;3164;6;4;
/org.eclipse.jdt.core.tests.model/workspace/Converter/src/test0405/A.java;1;0;1;1;0;0;0;1;0;0;1;3714;0;0;1;0;0;1;1;3714;0;3714;1;1;
/org.eclipse.ant.ui/Ant Editor/org/eclipse/ant/ui/internal/dtd/IAttribute.java;1;0;3;1;0;0;0;3;2;1;3;250;2;2;1;0;0;3;3;250;0;1811;3;1;
/org.eclipse.jdt.core.tests.model/workspace/Formatter/test278/A_in.java;1;0;1;1;0;0;0;1;0;0;1;2443;0;0;1;0;0;1;1;2443;0;2443;1;1;
/org.eclipse.jdt.core.tests.model/workspace/Converter/src/javadoc/test016/TestD1.java;1;0;2;1;0;0;0;2;0;1;2;4311;0;0;1;0;0;2;2;4311;0;4390;2;1;
/org.eclipse.jdt.ui/ui/org/eclipse/jdt/internal/ui/text/CustomSourceInformationControl.java;3;2;8;2;5;4;5;3;67;1;3;1118;187;187;2;0;1;3;8;5360;1;6340;7;3;
/org.eclipse.team.ui/src/org/eclipse/team/ui/synchronize/SyncInfoDiffTreeViewerConfiguration.java;1;0;1;1;0;0;0;1;0;0;1;3619;0;0;1;0;0;1;1;3619;0;3619;1;1;
/org.eclipse.osgi/core/framework/org/eclipse/osgi/framework/eventmgr/ListenerQueue.java;2;1;5;1;4;4;4;1;54;0;1;5097;80;80;1;0;0;1;5;5097;0;5892;5;2;
/org.eclipse.jdt.debug/eval/org/eclipse/jdt/internal/debug/eval/ast/instructions/PushFieldVariable.java;2;0;2;1;0;0;0;2;3;1;2;1240;5;5;1;0;0;2;2;1240;0;1276;2;2;
/org.eclipse.osgi/supplement/src/org/eclipse/osgi/service/debug/DebugOptions.java;2;1;4;1;3;3;3;1;4;0;1;3147;11;11;1;0;0;1;4;3147;0;6337;4;2;
/org.eclipse.jdt.ui/ui/org/eclipse/jdt/internal/ui/actions/WorkbenchRunnableAdapter.java;3;1;6;1;2;2;2;4;39;1;4;4064;83;83;1;0;0;4;6;4064;0;6340;6;3;
/org.eclipse.ui.workbench/Eclipse UI/org/eclipse/ui/internal/dialogs/DialogUtil.java;1;0;1;1;0;0;0;1;4;0;1;2737;4;4;1;0;0;1;1;2737;0;2737;1;1;
/org.eclipse.jdt.ui/ui/org/eclipse/jdt/internal/ui/workingsets/WorkingSetMessages.java;1;0;1;1;1;1;1;0;2;0;0;6340;2;2;1;0;0;0;1;6340;0;6340;1;1;
/org.eclipse.ui.workbench/Eclipse UI/org/eclipse/ui/internal/progress/IconAnimationItem.java;1;0;2;1;1;1;1;1;0;0;1;4427;0;0;1;0;0;1;2;4427;0;5186;2;1;
/org.eclipse.jdt.core/compiler/org/eclipse/jdt/internal/compiler/ast/ClassLiteralAccess.java;2;0;3;1;0;0;0;3;12;1;3;991;18;18;1;0;0;3;3;991;0;3560;3;2;
/org.eclipse.jdt.ui.tests.refactoring/resources/ExtractMethodWorkSpace/ExtractMethodTests/wiki_out/A_test2005.java;1;0;2;1;0;0;0;2;7;1;2;130;11;11;1;0;0;2;2;130;0;844;2;1;
/org.eclipse.jdt.core.tests.model/workspace/Converter/junit/awtui/ProgressBar.java;1;0;1;1;0;0;0;1;0;0;1;3714;0;0;1;0;0;1;1;3714;0;3714;1;1;
/org.eclipse.ui.workbench/Eclipse UI/org/eclipse/ui/internal/contexts/PluginRegistry.java;1;0;4;1;0;0;0;4;22;1;4;1356;26;26;1;0;0;4;4;1356;0;1396;4;1;
/org.eclipse.core.runtime.compatibility/src-model/org/eclipse/core/runtime/model/LibraryModel.java;3;2;6;1;4;3;4;2;27;1;2;3013;36;36;2;0;1;2;6;5117;1;6340;5;3;
/org.eclipse.ui.tests/Eclipse UI Tests/org/eclipse/ui/tests/api/ISelectionServiceTest.java;1;0;1;1;0;0;0;1;3;0;1;3091;3;3;1;0;0;1;1;3091;0;3091;1;1;
/org.eclipse.team.cvs.core/src/org/eclipse/team/internal/ccvs/core/resources/CVSWorkspaceRoot.java;2;0;13;1;1;1;1;12;262;2;11;790;697;697;2;1;0;12;13;2460;1;6337;12;2;
/org.eclipse.jdt.core/compiler/org/eclipse/jdt/internal/compiler/ast/CompilationUnitDeclaration.java;4;0;10;1;1;1;1;9;38;1;9;25;81;81;1;0;0;9;10;25;0;5615;10;4;
/org.eclipse.team.cvs.ui/src/org/eclipse/team/internal/ccvs/ui/Policy.java;1;0;2;1;0;0;0;2;5;1;2;790;9;9;1;0;0;2;2;790;0;2632;2;1;
/org.eclipse.jdt.ui/ui/org/eclipse/jdt/internal/ui/actions/FoldingActionGroup.java;2;1;3;1;3;3;3;0;24;0;0;5360;36;36;1;0;0;0;3;5360;0;6340;3;2;
/org.eclipse.ui.workbench/Eclipse UI/org/eclipse/ui/commands/ExecutionException.java;3;1;3;1;2;2;2;1;10;0;1;4088;16;16;1;0;0;1;3;4088;0;6338;3;3;
/org.eclipse.jdt.core/search/org/eclipse/jdt/internal/core/search/matching/OrNameCombiner.java;2;0;2;1;0;0;0;2;37;1;2;1893;37;37;1;0;0;2;2;1893;0;2837;2;2;
/org.eclipse.pde.core/src/org/eclipse/pde/internal/core/ischema/IPluginLocationProvider.java;2;1;3;1;2;2;2;1;8;0;1;4912;12;12;1;0;0;1;3;4912;0;6336;3;2;
/org.eclipse.jdt.core/dom/org/eclipse/jdt/internal/core/dom/rewrite/ASTRewriteFormatter.java;2;0;2;1;1;1;1;1;389;0;1;4802;389;389;1;0;0;1;2;4802;0;5404;2;2;
/org.eclipse.jdt.ui.tests/ui/org/eclipse/jdt/ui/tests/core/ImportOrganizeTest.java;3;1;14;1;7;7;7;7;112;1;7;428;389;389;1;0;0;7;14;428;0;6340;14;3;
/org.eclipse.jdt.core.tests.model/workspace/Completion/src3/test0004/Test.java;1;0;1;1;0;0;0;1;0;0;1;5010;0;0;1;0;0;1;1;5010;0;5010;1;1;
/org.eclipse.ui.workbench/Eclipse UI/org/eclipse/ui/commands/NotDefinedException.java;3;1;11;1;2;2;2;9;40;2;8;1137;105;105;2;1;0;9;11;2562;1;6338;10;3;
/org.eclipse.ui.views/src/org/eclipse/ui/views/markers/internal/ActionRemoveMarker.java;3;0;3;1;0;0;0;3;1;1;3;755;1;1;1;0;0;3;3;755;0;2738;3;3;
/org.eclipse.jdt.core/compiler/org/eclipse/jdt/internal/compiler/ISourceElementRequestor.java;2;0;3;1;0;0;0;3;4;1;3;85;6;6;1;0;0;3;3;85;0;4461;3;2;
/org.eclipse.jdt.ui.tests.refactoring/resources/InlineMethodWorkspace/TestCases/expression_out/TestAssignment.java;1;0;1;1;0;0;0;1;2;0;1;845;2;2;1;0;0;1;1;845;0;845;1;1;
/org.eclipse.jdt.ui/ui/org/eclipse/jdt/internal/ui/javaeditor/PartiallySynchronizedDocument.java;2;0;4;1;1;1;1;3;84;1;3;1581;129;129;1;0;0;3;4;1581;0;6340;4;2;
/org.eclipse.debug.ui/ui/org/eclipse/debug/internal/ui/preferences/SimpleVariablePreferencePage.java;3;0;26;2;0;0;0;26;131;4;14;550;575;575;4;12;0;26;26;1196;12;1480;14;3;
/org.eclipse.jdt.ui/core extension/org/eclipse/jdt/internal/corext/CorextMessages.java;1;0;1;1;1;1;1;0;2;0;0;6340;2;2;1;0;0;0;1;6340;0;6340;1;1;
/org.eclipse.jdt.core.tests.model/workspace/Converter/src/junit/framework/Assert.java;1;0;1;1;0;0;0;1;0;0;1;3714;0;0;1;0;0;1;1;3714;0;3714;1;1;
/org.eclipse.ui.ide/src/org/eclipse/ui/internal/ide/dialogs/OpenResourceDialog.java;3;1;3;1;2;2;2;1;11;0;1;2264;13;13;1;0;0;1;3;2264;0;6338;3;3;
/org.eclipse.jdt.ui.tests.refactoring/resources/MoveMembers/test33/out/A.java;1;0;1;1;0;0;0;1;0;0;1;1856;0;0;1;0;0;1;1;1856;0;1856;1;1;
/org.eclipse.debug.ui/ui/org/eclipse/debug/internal/ui/sourcelookup/AddSourceContainerDialog.java;1;1;8;1;2;2;2;6;107;2;5;3770;144;144;2;1;0;6;8;4949;1;5688;7;1;
/org.eclipse.debug.ui/ui/org/eclipse/debug/ui/launchVariables/components/WorkingSetComponent.java;1;0;2;1;0;0;0;2;0;1;2;562;0;0;1;0;0;2;2;562;0;647;2;1;
/org.eclipse.core.runtime/src/org/eclipse/core/internal/plugins/PluginHost.java;2;0;2;1;0;0;0;2;0;1;2;2105;0;0;1;0;0;2;2;2105;0;3013;2;2;
/org.eclipse.ui.ide/src/org/eclipse/ui/internal/model/WorkspaceFactory.java;2;0;2;1;0;0;0;2;0;1;2;1511;0;0;1;0;0;2;2;1511;0;2263;2;2;
/org.eclipse.jdt.debug.tests/tests/org/eclipse/jdt/debug/tests/eval/TypeHierarchy_146_1.java;1;0;1;1;0;0;0;1;116;0;1;1274;116;116;1;0;0;1;1;1274;0;1274;1;1;
/org.eclipse.swt/Eclipse SWT/gtk1x/org/eclipse/swt/widgets/Button.java;1;0;1;1;0;0;0;1;0;0;1;2327;0;0;1;0;0;1;1;2327;0;2327;1;1;
/org.eclipse.jdt.ui/ui/org/eclipse/jdt/internal/ui/callhierarchy/CallHierarchyViewPart.java;6;1;31;1;5;5;5;26;182;3;21;155;902;902;3;5;0;26;31;169;5;6340;26;6;
/org.eclipse.jdt.core.tests.model/workspace/Formatter/test412/A_in.java;1;0;1;1;0;0;0;1;0;0;1;3460;0;0;1;0;0;1;1;3460;0;3460;1;1;
/org.eclipse.ui.workbench/Eclipse UI/org/eclipse/ui/internal/presentations/SystemMenuMinimize.java;3;0;3;1;1;1;1;2;44;1;2;4680;46;46;1;0;0;2;3;4680;0;5173;3;3;
/org.eclipse.jface.text/src/org/eclipse/jface/text/rules/NumberRule.java;2;1;2;1;2;2;2;0;2;0;0;6340;4;4;1;0;0;0;2;6340;0;6358;2;2;
/org.eclipse.swt/Eclipse SWT Browser/motif/org/eclipse/swt/browser/PromptService.java;2;0;3;1;1;1;1;2;226;1;2;4853;232;232;1;0;0;2;3;4853;0;6352;3;2;
/org.eclipse.jdt.ui/ui/org/eclipse/jdt/internal/ui/search/JavaElementMatch.java;1;1;2;1;2;2;2;0;20;0;0;5106;20;20;1;0;0;0;2;5106;0;5396;2;1;
/org.eclipse.jdt.core/compiler/org/eclipse/jdt/internal/compiler/impl/CharConstant.java;2;0;3;1;1;1;1;2;79;1;2;1111;87;87;1;0;0;2;3;1111;0;5587;3;2;
/org.eclipse.ui.workbench/Eclipse UI/org/eclipse/ui/internal/activities/service/ActivityServiceAdapter.java;1;0;2;1;0;0;0;2;0;1;2;2896;0;0;1;0;0;2;2;2896;0;3066;2;1;
/org.eclipse.swt/Eclipse SWT OLE Win32/win32/org/eclipse/swt/ole/win32/OleFile.java;1;0;1;1;0;0;0;1;0;0;1;1496;0;0;1;0;0;1;1;1496;0;1496;1;1;
/org.eclipse.debug.ui/ui/org/eclipse/debug/internal/ui/launchConfigurations/CompileErrorPromptStatusHandler.java;2;1;7;1;7;7;7;0;44;0;0;5135;76;76;1;0;0;0;7;5135;0;5871;7;2;
/org.eclipse.swt/Eclipse SWT Custom Widgets/common/org/eclipse/swt/custom/StyledTextBidi.java;4;0;6;1;0;0;0;6;118;1;6;507;203;203;1;0;0;6;6;507;0;4636;6;4;
/org.eclipse.swt/Eclipse SWT Mozilla/common/org/eclipse/swt/internal/mozilla/nsIDOMLocation.java;1;0;2;1;0;0;0;2;36;1;2;1654;36;36;1;0;0;2;2;1654;0;2568;2;1;
/org.eclipse.ui.workbench/Eclipse UI/org/eclipse/ui/part/MultiPageSelectionProvider.java;2;1;2;1;2;2;2;0;6;0;0;5339;8;8;1;0;0;0;2;5339;0;6338;2;2;
/org.eclipse.update.core/src/org/eclipse/update/standalone/CmdLineArgs.java;1;2;12;1;9;7;9;3;124;2;2;825;268;268;2;1;2;3;12;825;3;6336;9;1;
/org.eclipse.jdt.core.tests.model/workspace/Converter/test0166/Test.java;1;0;1;1;0;0;0;1;0;0;1;3714;0;0;1;0;0;1;1;3714;0;3714;1;1;
/org.eclipse.team.ui/src/org/eclipse/team/internal/ui/synchronize/actions/GlobalRefreshAction.java;2;1;14;2;8;8;8;6;186;1;6;4389;462;462;1;0;0;6;14;4389;0;6337;14;2;
/org.eclipse.debug.core/core/org/eclipse/debug/core/variables/ExpandVariableContext.java;2;0;4;1;0;0;0;4;15;1;4;562;16;16;1;0;0;4;4;562;0;2120;4;2;
/org.eclipse.jdt.core.tests.compiler/src/org/eclipse/jdt/core/tests/eval/NegativeVariableTest.java;2;0;2;1;0;0;0;2;4;1;2;764;6;6;1;0;0;2;2;764;0;3560;2;2;
/org.eclipse.pde.ui/src/org/eclipse/pde/internal/ui/editor/FormOutlinePage.java;1;1;2;1;2;2;2;0;212;0;0;5431;216;216;1;0;0;0;2;5431;0;6336;2;1;
/org.eclipse.webdav/src/interface/org/eclipse/webdav/dom/MalformedElementException.java;1;0;2;1;2;1;2;0;24;0;0;5151;24;24;2;0;1;0;2;5151;1;5151;1;1;
/org.eclipse.jdt.debug.tests/tests/org/eclipse/jdt/debug/tests/eval/NestedTypeFieldValue_406.java;1;0;1;1;0;0;0;1;74;0;1;1274;74;74;1;0;0;1;1;1274;0;1274;1;1;
/org.eclipse.swt/Eclipse SWT/win32/org/eclipse/swt/widgets/TrayIcon.java;2;0;9;2;0;0;0;9;198;5;3;4450;385;385;5;6;0;9;9;4468;6;4517;3;2;
/org.eclipse.team.webdav/src/org/eclipse/team/ui/subscriber/ErrorHandler.java;1;0;1;1;0;0;0;1;0;0;1;3373;0;0;1;0;0;1;1;3373;0;3373;1;1;
/org.eclipse.core.runtime/src/org/eclipse/core/internal/plugins/RegistryCacheWriter.java;1;0;2;1;0;0;0;2;8;1;2;2660;8;8;1;0;0;2;2;2660;0;3013;2;1;
/org.eclipse.jdt.core.tests.model/workspace/Converter/src/junit/swingui/ProgressBar.java;1;0;1;1;0;0;0;1;0;0;1;3714;0;0;1;0;0;1;1;3714;0;3714;1;1;
/org.eclipse.ui.forms/src/org/eclipse/ui/forms/events/HyperlinkAdapter.java;1;0;5;1;1;1;1;4;38;1;4;4068;49;49;1;0;0;4;5;4068;0;6336;5;1;
/org.eclipse.ui.workbench/Eclipse UI/org/eclipse/ui/internal/DragCursors.java;2;0;2;1;0;0;0;2;170;1;2;3677;170;170;1;0;0;2;2;3677;0;4015;2;2;
/org.eclipse.ui.workbench/Eclipse UI/org/eclipse/ui/commands/internal/IActionServiceObserver.java;1;0;2;1;0;0;0;2;0;0;1;767;0;0;2;1;0;2;2;767;1;767;1;1;
/org.eclipse.pde.build/src-temp/Test1.java;2;1;4;1;2;2;2;2;13;1;2;4328;23;23;1;0;0;2;4;4328;0;5755;4;2;
/org.eclipse.osgi/core/adaptor/org/eclipse/osgi/framework/log/FrameworkLog.java;3;1;4;1;2;2;2;2;15;1;2;3879;25;25;1;0;0;2;4;3879;0;5249;4;3;
/org.eclipse.jdt.ui.tests.refactoring/test cases/org/eclipse/jdt/ui/tests/nls/NLSRefactoringTester.java;1;0;1;1;0;0;0;1;0;0;1;1951;0;0;1;0;0;1;1;1951;0;1951;1;1;
/org.eclipse.core.runtime/src/org/eclipse/core/internal/dependencies/IElementChange.java;2;0;2;1;0;0;0;2;0;1;2;2105;0;0;1;0;0;2;2;2105;0;3013;2;2;
/org.eclipse.update.ui.forms/src/org/eclipse/update/ui/forms/internal/SectionChangeManager.java;1;0;1;1;0;0;0;1;44;0;1;3071;44;44;1;0;0;1;1;3071;0;3071;1;1;
/org.eclipse.team.ui/src/org/eclipse/team/internal/ui/sync/actions/FilterSyncViewerAction.java;1;0;3;1;0;0;0;3;63;1;3;496;63;63;1;0;0;3;3;496;0;848;3;1;
/org.eclipse.jdt.ui/ui/org/eclipse/jdt/internal/ui/preferences/JavadocPreferencePage.java;1;0;4;1;0;0;0;4;37;1;4;780;50;50;1;0;0;4;4;780;0;4412;4;1;
/org.eclipse.osgi/osgi/src/org/osgi/framework/Configurable.java;2;0;2;1;1;1;1;1;3;0;1;3013;3;3;1;0;0;1;2;3013;0;5536;2;2;
/org.eclipse.pde.ui/src_Forms/org/eclipse/pde/internal/ui/neweditor/feature/FeatureFormPage.java;2;0;2;1;1;1;1;1;0;0;1;4926;0;0;1;0;0;1;2;4926;0;5431;2;2;
/org.eclipse.jdt.ui/core refactoring/org/eclipse/jdt/internal/corext/refactoring/ListenerList.java;1;0;1;1;1;1;1;0;2;0;0;6340;2;2;1;0;0;0;1;6340;0;6340;1;1;
/org.eclipse.compare/compare/org/eclipse/compare/internal/merge/TextStreamMerger.java;1;1;2;1;2;2;2;0;10;0;0;5185;10;10;1;0;0;0;2;5185;0;6354;2;1;
/org.eclipse.jdt.ui/core refactoring/org/eclipse/ltk/internal/refactoring/core/RefactoringCorePlugin.java;1;0;4;1;0;0;0;4;4;1;4;3708;6;6;1;0;0;4;4;3708;0;4510;4;1;
/org.eclipse.swt/Eclipse SWT/carbon/org/eclipse/swt/widgets/Table.java;5;2;45;2;11;10;11;34;1251;2;30;231;2763;2763;2;4;1;34;45;231;5;6352;40;5;
/org.eclipse.team.ui/src/org/eclipse/team/internal/ui/synchronize/sets/SubscriberInputSyncInfoSet.java;1;0;1;1;0;0;0;1;0;0;1;3518;0;0;1;0;0;1;1;3518;0;3518;1;1;
/org.eclipse.swt.tests/JUnit Tests/org/eclipse/swt/tests/junit/Test_org_eclipse_swt_browser_VisibilityWindowListener.java;1;0;2;1;0;0;0;2;18;0;1;3166;18;18;2;1;0;2;2;3166;1;3166;1;1;
/org.eclipse.ui.workbench/Eclipse UI/org/eclipse/ui/internal/gestures/CaptureEvent.java;2;0;6;1;1;1;1;5;13;1;5;1721;35;35;1;0;0;5;6;1721;0;6338;6;2;
/org.eclipse.jdt.ui.tests.refactoring/resources/IntroduceParameter/invalid/NotInMethod3.java;1;0;1;1;0;0;0;1;0;0;1;2281;0;0;1;0;0;1;1;2281;0;2281;1;1;
/org.eclipse.jdt.core.tests.model/workspace/Converter/test0363/A.java;1;0;1;1;0;0;0;1;0;0;1;3714;0;0;1;0;0;1;1;3714;0;3714;1;1;
/org.eclipse.swt.graphics.text/Eclipse SWT PI/gtk/org/eclipse/swt/internal/gtk/PangoLayoutRun.java;2;0;2;1;0;0;0;2;25;1;2;2919;25;25;1;0;0;2;2;2919;0;4213;2;2;
/org.eclipse.debug.ui/ui/org/eclipse/debug/ui/ILaunchConfigurationTab.java;1;0;2;1;0;0;0;2;64;1;2;1742;68;68;1;0;0;2;2;1742;0;2712;2;1;
/org.eclipse.jdt.core.tests.model/workspace/TypeHierarchy/src/p7/A.java;1;0;1;1;0;0;0;1;0;0;1;2136;0;0;1;0;0;1;1;2136;0;2136;1;1;
/org.eclipse.pde.ui/src/org/eclipse/pde/internal/ui/editor/manifest/ManifestEditorContributor.java;1;0;1;1;1;1;1;0;0;0;0;5431;0;0;1;0;0;0;1;5431;0;5431;1;1;
/org.eclipse.jdt.ui.tests.refactoring/resources/InlineMethodWorkspace/TestCases/controlStatement_out/TestForAssignmentTwo.java;2;0;2;1;0;0;0;2;9;1;2;845;11;11;1;0;0;2;2;845;0;1810;2;2;
/org.eclipse.jdt.ui.tests.refactoring/resources/MoveMembers/test7/out/A.java;1;0;1;1;0;0;0;1;3;0;1;1522;3;3;1;0;0;1;1;1522;0;1522;1;1;
/org.eclipse.jdt.core/compiler/org/eclipse/jdt/internal/compiler/lookup/TypeBinding.java;2;0;3;1;0;0;0;3;42;2;2;1165;44;44;2;1;0;3;3;1165;1;3560;2;2;
/org.eclipse.jdt.core.tests.model/workspace/Converter/test0506/A.java;1;0;2;1;0;0;0;2;0;1;2;3009;0;0;1;0;0;2;2;3009;0;3714;2;1;
/org.eclipse.core.resources/src/org/eclipse/core/internal/indexing/ObjectStore.java;1;0;1;1;1;1;1;0;118;0;0;5146;118;118;1;0;0;0;1;5146;0;5146;1;1;
/org.eclipse.jdt.ui/core extension/org/eclipse/jdt/internal/corext/textmanipulation/SimpleTextEdit.java;1;0;7;1;0;0;0;7;68;2;5;1012;137;137;2;2;0;7;7;1869;2;1946;5;1;
/org.eclipse.pde.ui/src/org/eclipse/pde/internal/ui/wizards/imports/FeatureImportWizardFirstPage.java;2;1;5;1;2;2;2;3;230;1;3;217;291;291;1;0;0;3;5;217;0;6336;5;2;
/org.eclipse.help.webapp/src_servlets/org/eclipse/help/internal/webapp/data/UrlUtil.java;1;2;19;1;4;3;4;15;136;2;13;95;726;726;2;2;1;15;19;644;3;6337;16;1;
/org.eclipse.core.tests.runtime/src/org/eclipse/core/tests/internal/plugin/c/ExportedClass.java;1;0;1;1;1;1;1;0;11;0;0;5149;11;11;1;0;0;0;1;5149;0;5149;1;1;
/org.eclipse.core.resources.linux/src/org/eclipse/core/resources/refresh/linux/LinuxMonitorFactory.java;1;0;2;1;0;0;0;2;6;1;2;3681;6;6;1;0;0;2;2;3681;0;3695;2;1;
/org.eclipse.jdt.ui.tests.refactoring/resources/InlineMethodWorkspace/TestCases/import_in/TestUseInDecl2.java;1;0;1;1;0;0;0;1;0;0;1;788;0;0;1;0;0;1;1;788;0;788;1;1;
/org.eclipse.jdt.core/compiler/org/eclipse/jdt/internal/compiler/ast/BreakStatement.java;2;0;4;1;0;0;0;4;10;1;4;148;18;18;1;0;0;4;4;148;0;3560;4;2;
/org.eclipse.swt.tests/JUnit Tests/org/eclipse/swt/tests/junit/Test_org_eclipse_swt_graphics_GC.java;4;0;9;2;1;1;1;8;399;2;7;2175;577;577;2;1;0;8;9;2175;1;6352;8;4;
/org.eclipse.pde.ui/src_Forms/org/eclipse/pde/internal/ui/neweditor/plugin/ExtensionsPage.java;3;1;17;1;4;4;4;13;45;1;13;3777;145;145;1;0;0;13;17;3777;0;5431;17;3;
/org.eclipse.ui.workbench/Eclipse UI/org/eclipse/ui/internal/contexts/CompoundContextActivationService.java;2;0;5;2;0;0;0;5;39;2;4;3109;59;59;2;1;0;5;5;3170;1;4144;4;2;
/org.eclipse.ui.workbench/Eclipse UI/org/eclipse/ui/internal/ContainerPlaceholder.java;3;0;3;2;1;1;1;2;191;0;1;4015;193;193;2;1;0;2;3;4015;1;6338;2;3;
/org.eclipse.jdt.ui.tests.refactoring/resources/InlineMethodWorkspace/TestCases/import_out/TestUseInArgument.java;1;0;1;1;0;0;0;1;2;0;1;845;2;2;1;0;0;1;1;845;0;845;1;1;
/org.eclipse.jdt.core.tests.model/src/org/eclipse/jdt/core/tests/dom/ASTConverter15Test.java;1;0;1;1;0;0;0;1;0;0;1;4601;0;0;1;0;0;1;1;4601;0;4601;1;1;
/org.eclipse.update.configurator/src/org/eclipse/update/internal/configurator/Messages.java;1;0;3;1;1;1;1;2;2;1;2;3280;4;4;1;0;0;2;3;3280;0;5519;3;1;
/org.eclipse.jdt.core.tests.model/workspace/Formatter/test349/A_out.java;1;0;1;1;0;0;0;1;0;0;1;3029;0;0;1;0;0;1;1;3029;0;3029;1;1;
/org.eclipse.core.boot/src/org/eclipse/core/internal/boot/PlatformURLHandler.java;1;0;1;1;0;0;0;1;0;0;1;3013;0;0;1;0;0;1;1;3013;0;3013;1;1;
/org.eclipse.ui.views/src/org/eclipse/ui/views/tasklist/PasteTaskAction.java;1;0;1;1;0;0;0;1;0;0;1;2738;0;0;1;0;0;1;1;2738;0;2738;1;1;
/org.eclipse.help.webapp/src/org/eclipse/help/internal/webapp/WebappResources.java;1;1;8;1;3;3;3;5;71;1;5;106;178;178;1;0;0;5;8;106;0;6337;8;1;
/org.eclipse.team.ui/src/org/eclipse/team/internal/ui/sync/sets/SyncInfoWorkingSetFilter.java;1;0;3;1;0;0;0;3;128;1;3;1289;128;128;1;0;0;3;3;1289;0;2632;3;1;
/org.eclipse.jdt.core/search/org/eclipse/jdt/internal/core/index/impl/JarFileEntryDocument.java;3;0;5;1;0;0;0;5;7;1;5;259;16;16;1;0;0;5;5;259;0;3240;5;3;
/org.eclipse.core.resources/src/org/eclipse/core/internal/dtree/NodeInfo.java;1;0;2;1;2;1;2;0;223;0;0;5146;223;223;2;0;1;0;2;5146;1;5146;1;1;
/org.eclipse.swt/Eclipse SWT PI/motif/org/eclipse/swt/internal/motif/XReparentEvent.java;1;0;1;1;0;0;0;1;0;0;1;1450;0;0;1;0;0;1;1;1450;0;1450;1;1;
/org.eclipse.jdt.ui/core refactoring/org/eclipse/jdt/internal/corext/refactoring/nls/changes/NLSChangesMessages.java;1;0;1;1;1;1;1;0;2;0;0;6340;2;2;1;0;0;0;1;6340;0;6340;1;1;
/org.eclipse.search/search/org/eclipse/search/ui/IContextMenuContributor.java;2;1;3;1;3;3;3;0;3;0;0;6116;7;7;1;0;0;0;3;6116;0;6340;3;2;
/org.eclipse.ui.ide/src/org/eclipse/ui/views/navigator/ResourceNavigatorMessages.java;1;0;1;1;0;0;0;1;0;0;1;2208;0;0;1;0;0;1;1;2208;0;2208;1;1;
/org.eclipse.osgi/defaultAdaptor/src/org/eclipse/osgi/framework/internal/protocol/bundleentry/Handler.java;2;0;4;1;2;1;2;2;36;1;2;3620;56;56;2;0;1;2;4;5116;1;5116;3;2;
/org.eclipse.ui.ide/src/org/eclipse/ui/internal/ide/model/WorkbenchFile.java;1;0;1;1;0;0;0;1;0;0;1;2264;0;0;1;0;0;1;1;2264;0;2264;1;1;
/org.eclipse.core.resources/src/org/eclipse/core/internal/localstore/IsSynchronizedVisitor.java;1;0;2;1;1;1;1;1;31;0;1;3063;32;32;1;0;0;1;2;3063;0;5146;2;1;
/org.eclipse.jdt.ui/core extension/org/eclipse/jdt/internal/corext/codemanipulation/AddMethodStubOperation.java;2;0;7;1;1;1;1;6;11;1;6;1558;26;26;1;0;0;6;7;1558;0;6340;7;2;
/org.eclipse.search/search/org/eclipse/search/ui/IReplacePage.java;1;0;2;1;1;1;1;1;2;0;1;2907;2;2;1;0;0;1;2;2907;0;6340;2;1;
/org.eclipse.ui.workbench.texteditor/src/org/eclipse/ui/texteditor/ITextEditorDropTargetListener.java;2;1;2;1;2;2;2;0;2;0;0;5731;2;2;1;0;0;0;2;5731;0;5747;2;2;
/org.eclipse.ui.examples.javaeditor/Eclipse Java Editor Example/org/eclipse/ui/examples/javaeditor/spelling/IPhoneticDistanceAlgorithm.java;1;0;1;1;0;0;0;1;0;0;1;2565;0;0;1;0;0;1;1;2565;0;2565;1;1;
/org.eclipse.jdt.ui/core refactoring/org/eclipse/jdt/internal/corext/refactoring/nls/NLSMessages.java;2;0;2;1;1;1;1;1;2;0;1;4930;4;4;1;0;0;1;2;4930;0;6340;2;2;
/org.eclipse.team.ftp/src/org/eclipse/team/internal/ftp/ui/subscriber/FTPParticipantPage.java;2;0;3;1;0;0;0;3;36;1;3;3373;36;36;1;0;0;3;3;3373;0;4588;3;2;
/org.eclipse.jdt.core/compiler/org/eclipse/jdt/internal/compiler/ast/Expression.java;3;0;6;2;0;0;0;6;29;2;5;991;56;56;2;1;0;6;6;2886;1;3560;5;3;
/org.eclipse.jdt.core.tests.model/src/org/eclipse/jdt/core/tests/model/ClasspathInitializerTests.java;4;1;16;1;7;7;7;9;213;2;8;1907;720;720;2;1;0;9;16;3560;1;5940;15;4;
/org.eclipse.ui.workbench/Eclipse UI/org/eclipse/ui/internal/dnd/CompatibilityDragTarget.java;3;0;8;1;0;0;0;8;234;1;8;3677;448;448;1;0;0;8;8;3677;0;4807;8;3;
/org.eclipse.team.ui/src/org/eclipse/team/internal/ui/synchronize/actions/SubscriberParticipantActionContribution.java;1;0;1;1;0;0;0;1;0;0;1;5082;0;0;1;0;0;1;1;5082;0;5082;1;1;
/org.eclipse.pde.ui/src/org/eclipse/pde/internal/ui/editor/PDEFormEditorContributor.java;3;1;6;1;6;6;6;0;10;0;0;5431;28;28;1;0;0;0;6;5431;0;6336;6;3;
/org.eclipse.swt.examples.browser/src/org/eclipse/swt/examples/browserexample/BrowserPlugin.java;1;0;1;1;0;0;0;1;0;0;1;3114;0;0;1;0;0;1;1;3114;0;3114;1;1;
/org.eclipse.swt/Eclipse SWT/carbon/org/eclipse/swt/widgets/ProgressBar.java;3;1;6;1;2;2;2;4;18;1;4;384;45;45;1;0;0;4;6;384;0;6352;6;3;
/org.eclipse.debug.core/core/org/eclipse/debug/internal/core/sourcelookup/ISourceContainerType.java;1;0;4;1;0;0;0;4;37;1;4;3169;45;45;1;0;0;4;4;3169;0;4949;4;1;
/org.eclipse.jdt.ui/core refactoring/org/eclipse/jdt/internal/corext/refactoring/typeconstraints/FullConstraintCreator.java;2;0;6;1;1;1;1;5;299;2;4;74;510;510;2;1;0;5;6;74;1;6340;5;2;
/org.eclipse.jdt.ui.tests.refactoring/test cases/org/eclipse/jdt/ui/tests/refactoring/IntroduceFactoryTests.java;2;3;12;1;6;4;6;6;157;1;6;2846;251;251;3;0;2;6;12;5656;2;6340;10;2;
/org.eclipse.team.ui/src/org/eclipse/team/ui/sync/actions/DirectionFilterActionGroup.java;1;0;1;1;0;0;0;1;0;0;1;2446;0;0;1;0;0;1;1;2446;0;2446;1;1;
/org.eclipse.pde.core/src/org/eclipse/pde/internal/core/ifeature/IEnvironment.java;2;1;3;1;2;2;2;1;6;0;1;4203;12;12;1;0;0;1;3;4203;0;6336;3;2;
/org.eclipse.pde.ui/src/org/eclipse/pde/internal/ui/feature/BuildFeatureAction.java;2;0;9;1;0;0;0;9;235;1;9;648;709;709;1;0;0;9;9;648;0;3840;9;2;
/org.eclipse.jdt.core.tests.compiler/src/org/eclipse/jdt/core/tests/compiler/regression/ClassFileReaderTest.java;3;0;13;2;0;0;0;13;4649;3;11;164;11843;11843;3;2;0;13;13;3063;2;5062;11;3;
/org.eclipse.update.core/src/org/eclipse/update/internal/standalone/InstallCommand.java;2;0;18;1;0;0;0;18;73;2;17;828;186;186;2;1;0;18;18;4585;1;4928;17;2;
/org.eclipse.help.base/src/org/eclipse/help/internal/standalone/EclipseConnection.java;1;1;5;1;3;3;3;2;88;1;2;1740;130;130;1;0;0;2;5;1740;0;6337;5;1;
/org.eclipse.jdt.core/compiler/org/eclipse/jdt/internal/compiler/ast/MagicLiteral.java;2;0;2;1;0;0;0;2;30;1;2;991;32;32;1;0;0;2;2;991;0;3560;2;2;
/org.eclipse.team.ui/src/org/eclipse/team/internal/ui/synchronize/views/SyncTableViewer.java;1;0;3;1;0;0;0;3;52;1;3;2535;52;52;1;0;0;3;3;2535;0;4216;3;1;
/org.eclipse.jdt.core.tests.model/src/org/eclipse/jdt/core/tests/rewrite/describing/ASTRewritingInsertBoundTest.java;5;1;9;2;5;5;5;4;168;2;3;4711;373;373;2;1;0;4;9;5083;1;6336;8;5;
/org.eclipse.pde.ui/src_Forms/org/eclipse/pde/internal/ui/newparts/ILinkLabelProvider.java;2;0;2;1;1;1;1;1;0;0;1;4219;0;0;1;0;0;1;2;4219;0;5431;2;2;
/org.eclipse.jdt.core.tests.model/workspace/Converter/src/test0165/Test.java;1;0;1;1;0;0;0;1;0;0;1;3714;0;0;1;0;0;1;1;3714;0;3714;1;1;
/org.eclipse.ui.workbench/Eclipse UI/org/eclipse/ui/model/AdaptableList.java;2;0;3;1;0;0;0;3;147;1;3;1561;151;151;1;0;0;3;3;1561;0;2832;3;2;
/org.eclipse.core.tools/src/org/eclipse/core/tools/ISorter.java;1;0;1;1;1;1;1;0;0;0;0;6302;0;0;1;0;0;0;1;6302;0;6302;1;1;
/org.eclipse.update.ui/srcnew/org/eclipse/update/internal/ui/wizards/NewWizard2.java;1;0;2;1;0;0;0;2;0;1;2;367;0;0;1;0;0;2;2;367;0;488;2;1;
/org.eclipse.jdt.ui.tests.refactoring/resources/ExtractMethodWorkSpace/ExtractMethodTests/return_out/A_test718.java;1;0;2;1;0;0;0;2;6;1;2;130;7;7;1;0;0;2;2;130;0;844;2;1;
/org.eclipse.jface.text/src/org/eclipse/jface/text/information/IInformationPresenterExtension.java;2;1;3;1;2;2;2;1;20;0;1;1511;24;24;1;0;0;1;3;1511;0;6352;3;2;
/org.eclipse.team.ui/src/org/eclipse/team/internal/ui/synchronize/DecoratingColorLabelProvider.java;2;1;4;1;4;4;4;0;98;0;0;5133;111;111;1;0;0;0;4;5133;0;6337;4;2;
/org.eclipse.core.resources/src/org/eclipse/core/internal/localstore/SafeChunkyOutputStream.java;1;0;1;1;1;1;1;0;78;0;0;5146;78;78;1;0;0;0;1;5146;0;5146;1;1;
/org.eclipse.jdt.core.tests.model/workspace/Converter/test0502/A.java;2;0;4;1;0;0;0;4;8;1;4;2729;11;11;1;0;0;4;4;2729;0;3714;4;2;
/org.eclipse.jdt.ui/ui/org/eclipse/jdt/internal/ui/callhierarchy/OpenDeclarationAction.java;3;0;4;1;1;1;1;3;55;1;3;155;63;63;1;0;0;3;4;155;0;6340;4;3;
/org.eclipse.team.ui/src/org/eclipse/team/ui/synchronize/WorkspaceScope.java;2;2;3;1;3;2;3;0;44;0;0;5594;45;45;2;0;1;0;3;5594;1;6305;2;2;
/org.eclipse.ui.workbench/Eclipse UI/org/eclipse/ui/internal/skins/IStackPresentationSite.java;2;0;3;1;0;0;0;3;7;1;3;4328;7;7;1;0;0;3;3;4328;0;4469;3;2;
/org.eclipse.ui.workbench/Eclipse UI/org/eclipse/ui/internal/csm/commands/Persistence.java;1;0;6;1;0;0;0;6;640;3;3;2515;770;770;3;3;0;6;6;2553;3;2553;3;1;
/org.eclipse.ui.editors/src/org/eclipse/ui/editors/text/TextEditorPreferenceConstants.java;3;1;9;1;2;2;2;7;97;1;7;1118;289;289;1;0;0;7;9;1118;0;6334;9;3;
/org.eclipse.jdt.core.tests.model/workspace/Converter/src/test0286/Test.java;1;0;1;1;0;0;0;1;0;0;1;3714;0;0;1;0;0;1;1;3714;0;3714;1;1;
/org.eclipse.osgi/resolver/src/org/eclipse/core/dependencies/IElement.java;3;1;3;1;2;2;2;1;5;0;1;3013;5;5;1;0;0;1;3;3013;0;5226;3;3;
/org.eclipse.jdt.core.tests.model/workspace/Converter/test0159/Test.java;1;0;1;1;0;0;0;1;0;0;1;3714;0;0;1;0;0;1;1;3714;0;3714;1;1;
/org.eclipse.debug.core/core/org/eclipse/debug/internal/core/ProcessMonitor.java;1;0;1;1;0;0;0;1;0;0;1;978;0;0;1;0;0;1;1;978;0;978;1;1;
/org.eclipse.ui.ide/src/org/eclipse/ui/IStorageEditorInput.java;2;0;3;1;0;0;0;3;10;1;3;1511;10;10;1;0;0;3;3;1511;0;2263;3;2;
/org.eclipse.team.ui/src/org/eclipse/team/ui/SaveablePartAdapter.java;2;1;4;1;4;4;4;0;92;0;0;5192;117;117;1;0;0;0;4;5192;0;6337;4;2;
/org.eclipse.jdt.core/search/org/eclipse/jdt/internal/core/search/matching/MatchLocator2.java;2;0;3;2;0;0;0;3;16;0;1;69;16;16;3;2;0;3;3;69;2;69;1;2;
/org.eclipse.team.cvs.ui/src/org/eclipse/team/internal/ccvs/ui/model/VersionCategory.java;2;1;6;1;2;2;2;4;114;1;4;66;175;175;1;0;0;4;6;66;0;6337;6;2;
/org.eclipse.jdt.core.tests.model/workspace/Formatter/test178/A_out.java;1;0;1;1;0;0;0;1;0;0;1;2425;0;0;1;0;0;1;1;2425;0;2425;1;1;
/org.eclipse.ui.workbench/Eclipse UI/org/eclipse/ui/internal/themes/IThemeDescriptor.java;2;0;8;1;0;0;0;8;63;2;6;3684;167;167;2;2;0;8;8;4235;2;4559;6;2;
/org.eclipse.ui.workbench/Eclipse UI/org/eclipse/ui/internal/dialogs/ActionSetDialogInput.java;1;0;1;1;0;0;0;1;0;0;1;830;0;0;1;0;0;1;1;830;0;830;1;1;
/org.eclipse.jdt.core/search/org/eclipse/jdt/internal/core/search/matching/ClassFileMatchLocator.java;4;2;12;2;3;2;3;9;26;1;9;1839;137;137;2;0;1;9;12;5207;1;5207;11;4;
/org.eclipse.team.ui/src/org/eclipse/team/ui/sync/actions/workingsets/WorkingSetFilterActionGroup.java;1;0;1;1;0;0;0;1;0;0;1;2451;0;0;1;0;0;1;1;2451;0;2451;1;1;
/org.eclipse.core.tests.runtime/src/org/eclipse/core/tests/plugintests/PreferencesRuntimeTests.java;1;0;1;1;0;0;0;1;0;0;1;3014;0;0;1;0;0;1;1;3014;0;3014;1;1;
/org.eclipse.ant.ui/Ant Tools Support/org/eclipse/ant/ui/internal/preferences/AntClasspathContentProvider.java;1;0;3;1;0;0;0;3;26;1;3;250;26;26;1;0;0;3;3;250;0;1811;3;1;
/org.eclipse.swt.tests/JUnit Tests/org/eclipse/swt/tests/junit/Test_org_eclipse_swt_dnd_Clipboard.java;2;0;3;1;1;1;1;2;23;1;2;2176;33;33;1;0;0;2;3;2176;0;6352;3;2;
/org.eclipse.swt/Eclipse SWT PI/win32/org/eclipse/swt/internal/ole/win32/GUID.java;1;0;1;1;0;0;0;1;4;0;1;2915;4;4;1;0;0;1;1;2915;0;2915;1;1;
/org.eclipse.debug.core/core/org/eclipse/debug/core/sourcelookup/containers/FolderSourceContainer.java;1;0;4;1;1;1;1;3;14;0;1;4949;23;23;3;2;0;3;4;4949;2;5109;2;1;
/org.eclipse.ui.cheatsheets/src/org/eclipse/ui/cheatsheets/events/ICheatSheetListener.java;1;0;2;1;0;0;0;2;0;1;2;4428;0;0;1;0;0;2;2;4428;0;4625;2;1;
/org.eclipse.ui.ide/src/org/eclipse/ui/views/markers/internal/MarkerView.java;6;2;18;2;7;5;7;11;611;2;10;2208;921;921;2;1;2;11;18;5035;3;6337;15;6;
/org.eclipse.jdt.ui.tests.refactoring/resources/ExtractMethodWorkSpace/ExtractMethodTests/duplicates_in/A_test953.java;1;0;3;1;0;0;0;3;0;1;3;1219;0;0;1;0;0;3;3;1219;0;1474;3;1;
/org.eclipse.jdt.core.tests.model/workspace/Converter/src/javadoc/testBug48489/TestD.java;1;0;2;1;0;0;0;2;2;1;2;3890;2;2;1;0;0;2;2;3890;0;3994;2;1;
/org.eclipse.osgi/core/framework/org/eclipse/osgi/framework/internal/core/AbstractBundle.java;3;2;11;1;11;10;11;0;85;0;0;5116;232;232;2;0;1;0;11;5116;1;5800;10;3;
/org.eclipse.jdt.core.tests.model/workspace/Converter/src/test0339/Test.java;1;0;1;1;0;0;0;1;0;0;1;3714;0;0;1;0;0;1;1;3714;0;3714;1;1;
/org.eclipse.ui.externaltools/Ant Runner Support/org/eclipse/ui/externaltools/internal/ant/logger/NullBuildLogger.java;1;0;1;1;0;0;0;1;0;0;1;282;0;0;1;0;0;1;1;282;0;282;1;1;
/org.eclipse.jdt.ui.tests.refactoring/resources/ExtractMethodWorkSpace/ExtractMethodTests/locals_in/A_test531.java;1;0;1;1;0;0;0;1;2;0;1;844;2;2;1;0;0;1;1;844;0;844;1;1;
/org.eclipse.jdt.ui.tests.refactoring/resources/IntroduceParameter/simple/ConstantExpression1.java;1;0;1;1;0;0;0;1;0;0;1;2281;0;0;1;0;0;1;1;2281;0;2281;1;1;
/org.eclipse.ui.examples.javaeditor/Template Editor Example/org/eclipse/ui/examples/templateeditor/editors/TagRule.java;2;0;2;1;1;1;1;1;10;0;1;4644;12;12;1;0;0;1;2;4644;0;6340;2;2;
/org.eclipse.jdt.core.tests.model/workspace/Formatter/test029/A_in.java;1;0;1;1;0;0;0;1;0;0;1;2425;0;0;1;0;0;1;1;2425;0;2425;1;1;
/org.eclipse.jdt.core.tests.model/workspace/Converter/test0142/Test.java;1;0;1;1;0;0;0;1;0;0;1;3714;0;0;1;0;0;1;1;3714;0;3714;1;1;
/org.eclipse.pde.ui/sandbox/org/eclipse/pde/internal/ui/editor/standalone/site/SiteMultiPageEditor.java;1;0;3;1;0;0;0;3;3;1;3;2320;3;3;1;0;0;3;3;2320;0;2906;3;1;
/org.eclipse.team.cvs.ui/src/org/eclipse/team/internal/ccvs/ui/subscriber/SubscriberUpdateAction.java;2;0;4;1;0;0;0;4;279;2;3;595;330;330;2;1;0;4;4;1132;1;1132;3;2;
/org.eclipse.ui.tests/Eclipse UI Tests/org/eclipse/ui/tests/api/workbenchpart/ViewPartTitleTest.java;1;0;1;1;1;1;1;0;0;0;0;6101;0;0;1;0;0;0;1;6101;0;6101;1;1;
/org.eclipse.jdt.ui.tests.refactoring/resources/IntroduceFactory/Bugzilla/59284/ArgTypeImport_out.java;1;0;1;1;1;1;1;0;2;0;0;5659;2;2;1;0;0;0;1;5659;0;5659;1;1;
/org.eclipse.ui.workbench/Eclipse UI/org/eclipse/ui/internal/csm/commands/api/ICommand.java;1;0;4;1;0;0;0;4;69;2;3;2515;129;129;2;1;0;4;4;2556;1;2556;3;1;
/org.eclipse.ui.ide/src/org/eclipse/ui/internal/ide/actions/OpenWorkspaceAction.java;2;1;3;1;3;3;3;0;13;0;0;5641;17;17;1;0;0;0;3;5641;0;6341;3;2;
/org.eclipse.jdt.ui/ui refactoring/org/eclipse/jdt/internal/ui/refactoring/reorg/TypedSourceTransfer.java;4;1;5;1;2;2;2;3;6;1;3;1112;15;15;1;0;0;3;5;1112;0;6340;5;4;
/org.eclipse.jdt.ui.tests.refactoring/resources/TypeConstraints/A_testUpdatableExtractInterfaceRanges0.java;1;0;1;1;0;0;0;1;0;0;1;64;0;0;1;0;0;1;1;64;0;64;1;1;
/org.eclipse.ui.ide/extensions/org/eclipse/ui/dialogs/WizardExportPage.java;1;0;1;1;0;0;0;1;0;0;1;2263;0;0;1;0;0;1;1;2263;0;2263;1;1;
/org.eclipse.jdt.ui/core refactoring/org/eclipse/jdt/internal/corext/refactoring/base/FileStatusContext.java;1;0;4;1;0;0;0;4;36;1;4;882;37;37;1;0;0;4;4;882;0;4965;4;1;
/org.eclipse.jdt.ui/core refactoring/org/eclipse/jdt/internal/corext/refactoring/typeconstraints/ConstraintVariable.java;2;0;6;1;1;1;1;5;36;1;5;42;56;56;1;0;0;5;6;42;0;6340;6;2;
/org.eclipse.help/src/org/eclipse/help/internal/workingset/PropertyChange.java;1;0;1;1;0;0;0;1;0;0;1;2732;0;0;1;0;0;1;1;2732;0;2732;1;1;
/org.eclipse.team.cvs.core/src/org/eclipse/team/internal/ccvs/core/client/Checkout.java;2;1;4;1;2;2;2;2;3;1;2;1843;8;8;1;0;0;2;4;1843;0;6337;4;2;
/org.eclipse.update.ui/src/org/eclipse/update/internal/ui/search/ExpressionSearchCategory.java;2;0;2;1;0;0;0;2;2;1;2;369;2;2;1;0;0;2;2;369;0;755;2;2;
/org.eclipse.update.core/src/org/eclipse/update/search/IUpdateSearchResultCollector.java;2;1;6;2;2;2;2;4;7;2;3;825;18;18;2;1;0;4;6;825;1;6336;5;2;
/org.eclipse.search/new search/org/eclipse/search2/internal/ui/text/WindowAnnotationManager.java;1;0;1;1;1;1;1;0;0;0;0;6035;0;0;1;0;0;0;1;6035;0;6035;1;1;
/org.eclipse.jdt.ui.tests.refactoring/test cases/org/eclipse/jdt/ui/tests/xml/ExpressionTests.java;1;0;3;1;0;0;0;3;26;1;3;3930;26;26;1;0;0;3;3;3930;0;4108;3;1;
/org.eclipse.jdt.core.tests.model/workspace/JavaSearch/src/j4/MF47209.java;1;0;1;1;0;0;0;1;0;0;1;3330;0;0;1;0;0;1;1;3330;0;3330;1;1;
/org.eclipse.jdt.ui.tests.refactoring/resources/ExtractTemp/cannotExtract/A_testFail29.java;1;0;1;1;0;0;0;1;0;0;1;1569;0;0;1;0;0;1;1;1569;0;1569;1;1;
/org.eclipse.ui.tutorials.rcp.part1/src/org/eclipse/ui/tutorials/rcp/part1/Part1Plugin.java;1;0;1;1;1;1;1;0;0;0;0;5118;0;0;1;0;0;0;1;5118;0;5118;1;1;
/org.eclipse.jdt.debug.tests/tests/org/eclipse/jdt/debug/tests/eval/NestedTypeFieldValue_529.java;1;0;1;1;0;0;0;1;102;0;1;1274;102;102;1;0;0;1;1;1274;0;1274;1;1;
/org.eclipse.jface.text/src/org/eclipse/jface/text/source/IAnnotationHoverExtension2.java;2;0;3;1;1;1;1;2;31;1;2;2544;31;31;1;0;0;2;3;2544;0;5099;3;2;
/org.eclipse.core.tests.resources/src/org/eclipse/core/tests/internal/indexing/StandAloneFieldTest.java;1;0;1;1;1;1;1;0;4;0;0;5147;4;4;1;0;0;0;1;5147;0;5147;1;1;
/org.eclipse.debug.core/core/org/eclipse/debug/internal/core/ILogicalStructureType.java;1;0;3;1;0;0;0;3;8;2;2;2647;8;8;2;1;0;3;3;2661;1;2661;2;1;
/org.eclipse.pde.ui/src_Forms/org/eclipse/pde/internal/ui/neweditor/plugin/ManifestOutlinePage.java;2;1;4;1;2;2;2;2;36;1;2;4610;37;37;1;0;0;2;4;4610;0;5431;4;2;
/org.eclipse.jdt.core.tests.model/workspace/Formatter/test137/A_in.java;1;0;1;1;0;0;0;1;0;0;1;2425;0;0;1;0;0;1;1;2425;0;2425;1;1;
/org.eclipse.debug.ui/ui/org/eclipse/debug/internal/ui/console/IConsoleManager.java;2;0;2;1;0;0;0;2;0;1;2;1294;0;0;1;0;0;2;2;1294;0;2060;2;2;
/org.eclipse.core.tests.runtime/src/org/eclipse/core/tests/internal/plugins/SoftPrereqTest_16.java;1;0;1;1;0;0;0;1;0;0;1;3014;0;0;1;0;0;1;1;3014;0;3014;1;1;
/org.eclipse.jdt.core/model/org/eclipse/jdt/core/IRegion.java;1;0;2;1;0;0;0;2;2;1;2;2583;4;4;1;0;0;2;2;2583;0;3560;2;1;
/org.eclipse.jdt.core.tests.model/workspace/Converter/test0044/Test.java;1;0;1;1;0;0;0;1;0;0;1;3714;0;0;1;0;0;1;1;3714;0;3714;1;1;
/org.eclipse.ui.ide/src/org/eclipse/ui/dialogs/ContainerSelectionDialog.java;2;0;4;1;0;0;0;4;10;1;4;1511;18;18;1;0;0;4;4;1511;0;2263;4;2;
/org.eclipse.ui.ide/src/org/eclipse/ui/views/markers/internal/MarkerRegistry.java;3;1;3;1;2;2;2;1;2;0;1;2208;4;4;1;0;0;1;3;2208;0;6338;3;3;
/org.eclipse.debug.ui/ui/org/eclipse/debug/ui/sourcelookup/ISourceContainerBrowser.java;1;0;2;1;1;1;1;1;14;0;1;4970;14;14;1;0;0;1;2;4970;0;5134;2;1;
/org.eclipse.ant.ui/Ant Tools Support/org/eclipse/ant/internal/ui/launchConfigurations/AntTabGroup.java;3;1;10;2;2;2;2;8;13;2;7;1811;41;41;2;1;0;8;10;1811;1;6336;9;3;
/org.eclipse.ui.intro/src/org/eclipse/ui/internal/intro/impl/model/loader/BaseExtensionPointManager.java;1;1;7;1;7;7;7;0;43;0;0;5115;83;83;1;0;0;0;7;5115;0;6251;7;1;
/org.eclipse.update.ui/src/org/eclipse/update/internal/ui/model/MyComputerFile.java;2;0;3;1;0;0;0;3;8;1;3;890;10;10;1;0;0;3;3;890;0;2085;3;2;
/org.eclipse.core.resources/src/org/eclipse/core/internal/indexing/FieldArray.java;1;0;1;1;1;1;1;0;24;0;0;5146;24;24;1;0;0;0;1;5146;0;5146;1;1;
/org.eclipse.core.resources/src/org/eclipse/core/internal/resources/ResourceInfo.java;2;0;2;1;1;1;1;1;600;0;1;2628;613;613;1;0;0;1;2;2628;0;5146;2;2;
/org.eclipse.jdt.ui/ui/org/eclipse/jdt/internal/ui/text/java/JavaCompletionProposalComparator.java;3;1;6;1;3;3;3;3;28;1;3;4258;68;68;1;0;0;3;6;4258;0;6340;6;3;
/org.eclipse.jdt.ui.tests.refactoring/resources/Copy/test_method_yes_initializer/in/A.java;1;0;1;1;0;0;0;1;2;0;1;685;2;2;1;0;0;1;1;685;0;685;1;1;
/org.eclipse.jdt.ui/ui refactoring/org/eclipse/jdt/internal/ui/refactoring/IStatusContextViewer.java;1;0;6;1;0;0;0;6;19;1;6;882;29;29;1;0;0;6;6;882;0;4965;6;1;
/org.eclipse.ui.ide/src/org/eclipse/ui/internal/ide/model/WorkbenchMarker.java;4;2;5;2;3;2;3;2;19;1;2;2264;24;24;2;0;1;2;5;6338;1;6338;4;4;
/org.eclipse.ant.ui/Ant Tools Support/org/eclipse/ant/ui/internal/views/actions/EditorImageDescriptor.java;1;0;2;1;0;0;0;2;0;1;2;263;0;0;1;0;0;2;2;263;0;1811;2;1;
/org.eclipse.jface/src/org/eclipse/jface/action/IStatusLineManager.java;3;2;4;2;3;2;3;1;4;0;1;2736;9;9;2;0;1;1;4;6338;1;6338;3;3;
/org.eclipse.core.tests.resources/src/org/eclipse/core/tests/internal/resources/ResourceSchedulingRuleTest.java;1;0;1;1;0;0;0;1;0;0;1;1137;0;0;1;0;0;1;1;1137;0;1137;1;1;
/org.eclipse.pde.ui/src/org/eclipse/pde/internal/ui/wizards/templates/PropertyPageTemplate.java;3;2;9;1;5;4;5;4;60;1;4;2184;107;107;2;0;1;4;9;5208;1;6336;8;3;
/org.eclipse.ui.workbench/Eclipse UI/org/eclipse/ui/commands/IKeyConfigurationDefinitionHandle.java;1;0;2;1;0;0;0;2;0;1;2;1389;0;0;1;0;0;2;2;1389;0;1400;2;1;
/org.eclipse.swt.tests/JUnit Tests/org/eclipse/swt/tests/junit/Test_org_eclipse_swt_dnd_DropTargetListener.java;1;0;1;1;0;0;0;1;24;0;1;2176;24;24;1;0;0;1;1;2176;0;2176;1;1;
/org.eclipse.pde.ui/sandbox/org/eclipse/pde/internal/ui/editor/standalone/XMLOutlinePageContentProvider2.java;1;0;2;1;0;0;0;2;0;1;2;2320;0;0;1;0;0;2;2;2320;0;2906;2;1;
/org.eclipse.jface.text/projection/org/eclipse/jface/text/source/projection/ProjectionAnnotationHover.java;2;1;8;1;6;6;6;2;74;1;2;4866;124;124;1;0;0;2;8;4866;0;6362;8;2;
/org.eclipse.team.webdav/src/org/eclipse/team/internal/ui/target/SiteRootsElement.java;1;0;1;1;0;0;0;1;0;0;1;2495;0;0;1;0;0;1;1;2495;0;2495;1;1;
/org.eclipse.ui.tests/Eclipse UI Tests/org/eclipse/ui/tests/propertysheet/PropertySheetTestSuite.java;1;0;1;1;0;0;0;1;1;0;1;3013;1;1;1;0;0;1;1;3013;0;3013;1;1;
/org.eclipse.core.runtime/src/org/eclipse/core/runtime/model/ConfigurationElementModel.java;2;0;2;1;0;0;0;2;13;1;2;536;13;13;1;0;0;2;2;536;0;3013;2;2;
/org.eclipse.jdt.core.tests.model/workspace/Formatter/test066/A_in.java;1;0;1;1;0;0;0;1;0;0;1;2425;0;0;1;0;0;1;1;2425;0;2425;1;1;
/org.eclipse.jdt.debug.tests/testprograms/ArgumentPrinter.java;2;0;3;1;0;0;0;3;1;1;3;2165;2;2;1;0;0;3;3;2165;0;2379;3;2;
/org.eclipse.ui.workbench/Eclipse UI/org/eclipse/ui/commands/KeyConfigurationEvent.java;3;1;6;1;2;2;2;4;176;2;3;2823;257;257;2;1;0;4;6;2823;1;6338;5;3;
/org.eclipse.jdt.ui/ui/org/eclipse/jdt/internal/ui/text/template/preferences/TemplateContentProvider.java;2;1;3;1;2;2;2;1;2;0;1;4258;4;4;1;0;0;1;3;4258;0;6340;3;2;
/org.eclipse.ui.workbench/Eclipse UI/org/eclipse/ui/commands/internal/Category.java;1;0;2;1;0;0;0;2;0;1;2;786;0;0;1;0;0;2;2;786;0;956;2;1;
/org.eclipse.pde.ui/templates_3.0/editor/java/NonRuleBasedDamagerRepairer.java;1;0;1;1;0;0;0;1;0;0;1;2786;0;0;1;0;0;1;1;2786;0;2786;1;1;
/org.eclipse.jdt.ui.tests.refactoring/resources/InlineMethodWorkspace/TestCases/argument_out/TestParameterNameUsed4.java;1;0;1;1;0;0;0;1;4;0;1;845;4;4;1;0;0;1;1;845;0;845;1;1;
/org.eclipse.help.ide/src/org/eclipse/help/ui/internal/IHelpIdeConstants.java;1;0;2;1;0;0;0;2;0;1;2;1747;0;0;1;0;0;2;2;1747;0;1778;2;1;
/org.eclipse.ui.workbench/Eclipse UI/org/eclipse/ui/internal/commands/registry/AbstractCommandRegistry.java;1;0;4;1;0;0;0;4;21;2;3;1422;21;21;2;1;0;4;4;1629;1;1724;3;1;
/org.eclipse.ant.ui/Ant Editor/org/eclipse/ant/ui/internal/editor/utils/ProjectHelperImpl.java;1;0;2;1;0;0;0;2;0;1;2;250;0;0;1;0;0;2;2;250;0;1811;2;1;
/org.eclipse.jdt.ui/ui/org/eclipse/jdt/internal/ui/filters/LocalTypesFilter.java;2;0;2;1;1;1;1;1;2;0;1;2327;2;2;1;0;0;1;2;2327;0;6340;2;2;
/org.eclipse.ui.workbench/Eclipse UI/org/eclipse/ui/IWorkbenchPart.java;4;2;9;2;6;5;6;3;23;1;3;1984;77;77;2;0;1;3;9;5467;1;6338;8;4;
/org.eclipse.team.webdav/src/org/eclipse/team/internal/target/subscriber/TargetSubscriber.java;2;0;7;1;1;1;1;6;196;1;6;3514;391;391;1;0;0;6;7;3514;0;6337;7;2;
/org.eclipse.ui.workbench.texteditor/src/org/eclipse/ui/texteditor/AnnotationEvent.java;1;0;1;1;0;0;0;1;0;0;1;2544;0;0;1;0;0;1;1;2544;0;2544;1;1;
/org.eclipse.jdt.debug.ui/ui/org/eclipse/jdt/internal/debug/ui/actions/InstanceFiltersAction.java;3;0;5;1;1;1;1;4;15;1;4;307;35;35;1;0;0;4;5;307;0;6336;5;3;
/org.eclipse.ui.forms/src/org/eclipse/ui/forms/events/IExpansionListener.java;1;0;2;1;1;1;1;1;6;0;1;5044;6;6;1;0;0;1;2;5044;0;6336;2;1;
/org.eclipse.update.ui/src/org/eclipse/update/internal/ui/properties/ConfigurationActivitiesPropertyPage.java;3;0;4;1;0;0;0;4;21;1;4;825;24;24;1;0;0;4;4;825;0;4434;4;3;
/org.eclipse.jdt.ui.examples.javafamily/src/org/eclipse/text/reconcilerpipe/IReconcileResult.java;1;0;2;1;0;0;0;2;0;1;2;1071;0;0;1;0;0;2;2;1071;0;1629;2;1;
/org.eclipse.ui.editors/src/org/eclipse/ui/editors/text/IEncodingActionsHelpContextIds.java;1;1;2;1;2;2;2;0;7;0;0;5918;14;14;1;0;0;0;2;5918;0;6334;2;1;
/org.eclipse.osgi/core/adaptor/org/eclipse/osgi/framework/adaptor/core/ServiceRegistry.java;2;0;2;1;0;0;0;2;0;1;2;3013;0;0;1;0;0;2;2;3013;0;4336;2;2;
/org.eclipse.swt.tests/JUnit Tests/org/eclipse/swt/tests/junit/Test_org_eclipse_swt_widgets_List.java;7;0;21;2;1;1;1;20;742;3;16;2123;2921;2921;3;4;0;20;21;2866;4;6352;17;7;
/org.eclipse.jdt.core.tests.model/workspace/Converter/test0458/A.java;1;0;1;1;0;0;0;1;0;0;1;3714;0;0;1;0;0;1;1;3714;0;3714;1;1;
/org.eclipse.ui.workbench/Eclipse UI/org/eclipse/ui/internal/contexts/registry/ContextDefinitionHandle.java;1;0;2;1;0;0;0;2;0;0;1;1396;0;0;2;1;0;2;2;1396;1;1396;1;1;
/org.eclipse.jdt.ui/ui/org/eclipse/jdt/internal/ui/text/ChainedPreferenceStore.java;2;1;2;1;2;2;2;0;0;0;0;5272;0;0;1;0;0;0;2;5272;0;5508;2;2;
/org.eclipse.ui.editors.tests/src/org/eclipse/ui/editors/tests/EditorsTestSuite.java;1;0;1;1;1;1;1;0;0;0;0;5239;0;0;1;0;0;0;1;5239;0;5239;1;1;
/org.eclipse.jdt.ui.tests/test plugin/org/eclipse/jdt/testplugin/JavaTestPlugin.java;1;0;1;1;1;1;1;0;2;0;0;6340;2;2;1;0;0;0;1;6340;0;6340;1;1;
/org.eclipse.jdt.ui.tests.refactoring/resources/RenamePackage/testImportFromMultiRoots2/in/srcTest/tests/AllTests.java;1;0;2;1;0;0;0;2;14;1;2;3219;14;14;1;0;0;2;2;3219;0;4105;2;1;
/org.eclipse.jdt.debug.ui/ui/org/eclipse/jdt/internal/debug/ui/actions/RemoveAction.java;1;0;2;1;0;0;0;2;14;1;2;1496;16;16;1;0;0;2;2;1496;0;2691;2;1;
/org.eclipse.core.resources/src/org/eclipse/core/internal/resources/File.java;3;2;37;2;18;15;18;19;693;1;19;178;1154;1154;2;0;3;19;37;5733;3;6339;34;3;
/org.eclipse.jdt.ui.examples.javafamily/src/org/eclipse/jsp/JspPluginImages.java;1;0;2;1;0;0;0;2;2;1;2;1355;2;2;1;0;0;2;2;1355;0;1373;2;1;
/org.eclipse.osgi/core/framework/org/eclipse/osgi/framework/internal/core/ServiceReferenceImpl.java;2;2;4;1;4;3;4;0;4;0;0;5116;11;11;2;0;1;0;4;5116;1;6337;3;2;
/org.eclipse.jdt.core.tests.model/workspace/Converter/src/javadoc/testBug55221/c/Test.java;2;0;3;2;0;0;0;3;0;0;1;4639;0;0;3;2;0;3;3;4639;2;4639;1;2;
/org.eclipse.jdt.core.tests.model/workspace/Converter/test0381/A.java;1;0;1;1;0;0;0;1;0;0;1;3714;0;0;1;0;0;1;1;3714;0;3714;1;1;
/org.eclipse.jdt.core.tests.model/workspace/Completion/src/CompletionStaticMethodDeclaration4.java;1;0;1;1;0;0;0;1;0;0;1;3039;0;0;1;0;0;1;1;3039;0;3039;1;1;
/org.eclipse.ui.workbench/Eclipse UI/org/eclipse/ui/internal/PlatformUIPreferenceListener.java;5;1;10;1;7;7;7;3;90;1;3;2737;235;235;1;0;0;3;10;2737;0;6338;10;5;
/org.eclipse.jdt.core.tests.model/workspace/Converter/src/test0226/Test.java;1;0;1;1;0;0;0;1;0;0;1;3714;0;0;1;0;0;1;1;3714;0;3714;1;1;
/org.eclipse.ui.cheatsheets/src/org/eclipse/ui/internal/cheatsheets/data/SubItem.java;1;1;3;1;2;2;2;1;79;0;1;4662;81;81;1;0;0;1;3;4662;0;5620;3;1;
/org.eclipse.ant.tests.core/test plugin/org/eclipse/ant/tests/core/testplugin/AntTestPlugin.java;1;1;2;1;2;2;2;0;8;0;0;5487;12;12;1;0;0;0;2;5487;0;6336;2;1;
/org.eclipse.jdt.ui/ui/org/eclipse/jdt/internal/ui/javaeditor/SemanticHighlightingReconciler.java;4;2;8;1;8;7;8;0;95;0;0;5272;220;220;2;0;1;0;8;5397;1;6144;7;4;
/org.eclipse.jdt.core.tests.model/workspace/Formatter/test446/A_out.java;1;0;1;1;0;0;0;1;0;0;1;3611;0;0;1;0;0;1;1;3611;0;3611;1;1;
/org.eclipse.swt.tools/JNI Generation/org/eclipse/swt/tools/internal/ParameterData.java;2;0;2;1;0;0;0;2;1;1;2;4175;1;1;1;0;0;2;2;4175;0;4287;2;2;
/org.eclipse.jdt.ui/ui/org/eclipse/jdt/internal/ui/text/correction/QuickAssistLightBulbUpdater.java;6;1;26;2;6;6;6;20;107;2;19;1094;495;495;2;1;0;20;26;1232;1;6340;25;6;
/org.eclipse.jdt.core/compiler/org/eclipse/jdt/internal/compiler/ast/ArrayInitializer.java;3;0;4;1;0;0;0;4;340;1;4;425;348;348;1;0;0;4;4;425;0;3560;4;3;
/org.eclipse.ui.forms.examples/src/org/eclipse/ui/forms/examples/internal/rcp/TypeOne.java;1;0;2;1;1;1;1;1;16;0;1;4075;16;16;1;0;0;1;2;4075;0;5781;2;1;
/org.eclipse.ui.ide/extensions/org/eclipse/ui/actions/DeleteResourceAction.java;5;1;8;1;2;2;2;6;130;1;6;2263;228;228;1;0;0;6;8;2263;0;6338;8;5;
/org.eclipse.search/new search/org/eclipse/search2/internal/ui/QueryManager.java;2;1;5;1;2;2;2;3;33;1;3;4345;55;55;1;0;0;3;5;4345;0;6340;5;2;
/org.eclipse.jdt.core.tests.model/workspace/Converter/test0330/Test.java;1;0;1;1;0;0;0;1;0;0;1;3714;0;0;1;0;0;1;1;3714;0;3714;1;1;
/org.eclipse.ui.ide/src/org/eclipse/ui/internal/ide/dialogs/WizardStep.java;1;0;1;1;0;0;0;1;0;0;1;2264;0;0;1;0;0;1;1;2264;0;2264;1;1;
/org.eclipse.pde.ui/src/org/eclipse/pde/internal/ui/wizards/plugin/OpenProjectWizardAction.java;3;2;7;1;6;5;6;1;30;0;1;4535;69;69;2;0;1;1;7;5363;1;6336;6;3;
/org.eclipse.jdt.ui.tests.refactoring/resources/IntroduceParameter/simple/ConstantString.java;1;0;1;1;0;0;0;1;0;0;1;2281;0;0;1;0;0;1;1;2281;0;2281;1;1;
/org.eclipse.update.core/src/org/eclipse/update/internal/core/SiteContentConsumer.java;1;0;1;1;0;0;0;1;2;0;1;890;2;2;1;0;0;1;1;890;0;890;1;1;
/org.eclipse.pde.ui/src/org/eclipse/pde/internal/ui/editor/site/FeatureBuildOperation.java;2;0;11;1;0;0;0;11;44;2;10;80;83;83;2;1;0;11;11;1770;1;2311;10;2;
/org.eclipse.ui.externaltools/Ant Editor/org/eclipse/ui/externaltools/internal/ant/editor/text/XMLAnnotationHover.java;1;0;1;1;0;0;0;1;0;0;1;282;0;0;1;0;0;1;1;282;0;282;1;1;
/org.eclipse.swt.tests/JUnit Tests/org/eclipse/swt/tests/junit/Test_org_eclipse_swt_events_TreeAdapter.java;1;0;1;1;0;0;0;1;16;0;1;2175;16;16;1;0;0;1;1;2175;0;2175;1;1;
/org.eclipse.ui.workbench/Eclipse UI/org/eclipse/ui/help/WorkbenchHelp.java;4;1;8;1;2;2;2;6;1209;1;6;1634;1295;1295;1;0;0;6;8;1634;0;6338;8;4;
/org.eclipse.team.ftp/src/org/eclipse/team/internal/ftp/ui/subscriber/ImportWizard.java;1;0;1;1;0;0;0;1;0;0;1;3494;0;0;1;0;0;1;1;3494;0;3494;1;1;
/org.eclipse.team.webdav/src/org/eclipse/team/internal/ui/target/GetAction.java;2;0;2;1;0;0;0;2;0;1;2;2495;0;0;1;0;0;2;2;2495;0;4216;2;2;
/org.eclipse.core.resources/src/org/eclipse/core/internal/resources/ContentDescriptionManager.java;2;2;7;2;7;6;7;0;133;0;0;5445;252;252;2;0;1;0;7;5733;1;5939;6;2;
/org.eclipse.core.runtime.compatibility/src-runtime/org/eclipse/core/internal/plugins/events/PluginEventDispatcher.java;2;0;2;1;0;0;0;2;0;1;2;3013;0;0;1;0;0;2;2;3013;0;3169;2;2;
/org.eclipse.jdt.ui/ui/org/eclipse/jdt/internal/ui/dialogs/BuildPathDialog.java;3;1;6;1;2;2;2;4;25;1;4;2838;43;43;1;0;0;4;6;2838;0;6340;6;3;
/org.eclipse.ui.workbench/Eclipse UI/org/eclipse/ui/internal/csm/commands/api/ICommandManagerEvent.java;1;0;3;1;0;0;0;3;15;1;3;2515;15;15;1;0;0;3;3;2515;0;2562;3;1;
/org.eclipse.debug.ui/ui/org/eclipse/debug/ui/variables/ContainerExpander.java;1;0;5;1;0;0;0;5;52;4;2;316;52;52;4;3;0;5;5;316;3;550;2;1;
/org.eclipse.jdt.ui/ui/org/eclipse/jdt/internal/ui/text/JavaReconciler.java;3;1;11;2;2;2;2;9;115;2;8;1350;344;344;2;1;0;9;11;4622;1;6340;10;3;
/org.eclipse.jface.text/src/org/eclipse/jface/text/presentation/IPresentationRepairer.java;2;1;2;1;2;2;2;0;26;0;0;6340;28;28;1;0;0;0;2;6340;0;6352;2;2;
/org.eclipse.core.resources/src/org/eclipse/core/internal/utils/WrappedRuntimeException.java;1;0;1;1;1;1;1;0;4;0;0;5146;4;4;1;0;0;0;1;5146;0;5146;1;1;
/org.eclipse.ui.cheatsheets/src/org/eclipse/ui/internal/cheatsheets/views/ToggleImage.java;2;0;3;1;0;0;0;3;17;1;3;4428;17;17;1;0;0;3;3;4428;0;4701;3;2;
/org.eclipse.debug.ui/ui/org/eclipse/debug/internal/ui/views/memory/ResetMemoryBlockAction.java;1;0;1;1;1;1;1;0;0;0;0;5254;0;0;1;0;0;0;1;5254;0;5254;1;1;
/org.eclipse.debug.core/core/org/eclipse/debug/core/model/IExpression.java;1;0;1;1;0;0;0;1;2;0;1;1448;2;2;1;0;0;1;1;1448;0;1448;1;1;
/org.eclipse.help.base/src/org/eclipse/help/internal/search/DefaultAnalyzer.java;1;1;6;1;3;3;3;3;30;2;2;1740;55;55;2;1;0;3;6;1740;1;6337;5;1;
/org.eclipse.jdt.debug/model/org/eclipse/jdt/debug/core/IJavaClassPrepareBreakpoint.java;1;0;1;1;0;0;0;1;0;0;1;4525;0;0;1;0;0;1;1;4525;0;4525;1;1;
/org.eclipse.jdt.ui/ui/org/eclipse/jdt/internal/ui/search/OccurrencesSearchQuery.java;2;0;3;1;1;1;1;2;15;1;2;4888;18;18;1;0;0;2;3;4888;0;5396;3;2;
/org.eclipse.jdt.core/dom/org/eclipse/jdt/core/internal/dom/rewrite/CommentMapper.java;1;0;2;1;0;0;0;2;0;1;2;4711;0;0;1;0;0;2;2;4711;0;4802;2;1;
/org.eclipse.jdt.ui.tests.refactoring/resources/IntroduceFactory/positive/ProtectConstructor1.java;1;0;2;1;1;1;1;1;2;0;1;2846;2;2;1;0;0;1;2;2846;0;5659;2;1;
/org.eclipse.pde.ui/src/org/eclipse/pde/internal/ui/editor/feature/ReferenceWizard.java;2;1;4;1;2;2;2;2;4;1;2;648;9;9;1;0;0;2;4;648;0;6336;4;2;
/org.eclipse.jdt.ui.examples.javafamily/src/org/eclipse/jsp/launching/JspLaunchDelegate.java;1;0;2;1;0;0;0;2;0;1;2;1355;0;0;1;0;0;2;2;1355;0;1373;2;1;
/org.eclipse.ui.workbench/Eclipse UI/org/eclipse/ui/commands/internal/KeyPreferencePage.java;1;0;2;1;0;0;0;2;0;1;2;786;0;0;1;0;0;2;2;786;0;956;2;1;
/org.eclipse.jdt.core.tests.model/workspace/Converter/test0512/A.java;1;0;2;1;0;0;0;2;0;1;2;3025;0;0;1;0;0;2;2;3025;0;3714;2;1;
/org.eclipse.jdt.core.tests.model/workspace/Converter/src/test0113/Test.java;1;0;1;1;0;0;0;1;0;0;1;3714;0;0;1;0;0;1;1;3714;0;3714;1;1;
/org.eclipse.jdt.core/eval/org/eclipse/jdt/internal/eval/CodeSnippetQualifiedNameReference.java;3;0;7;1;0;0;0;7;258;1;7;41;317;317;1;0;0;7;7;41;0;3560;7;3;
/org.eclipse.jdt.debug.tests/console tests/org/eclipse/jdt/debug/tests/console/TestShowConsoleActionDelegate.java;1;0;2;1;0;0;0;2;1;0;1;4474;1;1;2;1;0;2;2;4474;1;4474;1;1;
/org.eclipse.jdt.ui/core refactoring/org/eclipse/jdt/internal/corext/refactoring/participants/xml/TypePropertyTester.java;1;0;6;1;0;0;0;6;16;1;6;1033;40;40;1;0;0;6;6;1033;0;2546;6;1;
/org.eclipse.jdt.ui.tests.refactoring/resources/InlineMethodWorkspace/TestCases/cast_out/TestHierarchyOverloadedPrimitives.java;1;0;1;1;0;0;0;1;0;0;1;955;0;0;1;0;0;1;1;955;0;955;1;1;
/org.eclipse.core.resources/src/org/eclipse/core/internal/indexing/Referable.java;1;0;1;1;1;1;1;0;8;0;0;5146;8;8;1;0;0;0;1;5146;0;5146;1;1;
/org.eclipse.pde.ui/src/org/eclipse/pde/internal/ui/editor/feature/FeatureInputContextManager.java;2;1;3;1;3;3;3;0;10;0;0;5431;14;14;1;0;0;0;3;5431;0;6336;3;2;
/org.eclipse.jdt.ui.tests.refactoring/resources/ExtractMethodWorkSpace/ExtractMethodTests/locals_in/A_test552.java;1;0;1;1;0;0;0;1;2;0;1;844;2;2;1;0;0;1;1;844;0;844;1;1;
/org.eclipse.jdt.ui/core refactoring/org/eclipse/jdt/internal/corext/refactoring/rename/RenameTypeRefactoring.java;2;0;5;1;0;0;0;5;35;1;5;122;76;76;1;0;0;5;5;122;0;1125;5;2;
/org.eclipse.pde.ui/src/org/eclipse/pde/internal/ui/editor/site/BuiltFeaturesWizardPage.java;3;1;7;1;3;3;3;4;28;1;4;2229;81;81;1;0;0;4;7;2229;0;6336;7;3;
/org.eclipse.ui.workbench/Eclipse UI/org/eclipse/ui/internal/commands/api/older/ICategory.java;1;0;2;1;0;0;0;2;0;0;1;2562;0;0;2;1;0;2;2;2562;1;2562;1;1;
/org.eclipse.update.core/src/org/eclipse/update/internal/model/InstallConfigurationParser.java;2;1;11;1;2;2;2;9;257;1;9;890;348;348;1;0;0;9;11;890;0;6336;11;2;
/org.eclipse.jdt.core.tests.model/workspace/Converter/test0516/A.java;1;0;2;1;0;0;0;2;0;1;2;3612;0;0;1;0;0;2;2;3612;0;3714;2;1;
/org.eclipse.core.runtime/src/org/eclipse/core/runtime/IBundleGroupProvider.java;2;0;5;1;1;1;1;4;11;1;4;3680;25;25;1;0;0;4;5;3680;0;5117;5;2;
/org.eclipse.jdt.ui.examples.javafamily/src/org/eclipse/jsp/JspSourceIndexer.java;2;0;4;1;0;0;0;4;2;1;4;1033;3;3;1;0;0;4;4;1033;0;3235;4;2;
/org.eclipse.update.ui/src/org/eclipse/update/internal/ui/wizards/FeatureHierarchyElement.java;1;0;1;1;0;0;0;1;0;0;1;755;0;0;1;0;0;1;1;755;0;755;1;1;
/org.eclipse.debug.ui/ui/org/eclipse/debug/internal/ui/views/variables/AvailableLogicalStructuresAction.java;3;2;6;2;3;2;3;3;55;2;2;2687;72;72;2;1;1;3;6;3146;2;6336;4;3;
/org.eclipse.sdk.tests-feature/plugins/org.eclipse.perfmsr.core/src/org/eclipse/perfmsr/core/HTMLHelper.java;2;1;3;1;2;2;2;1;10;0;1;4845;14;14;1;0;0;1;3;4845;0;6342;3;2;
/org.eclipse.debug.ui/ui/org/eclipse/debug/ui/launchVariables/SpecificFolderResourceComponent.java;1;0;2;1;0;0;0;2;0;1;2;550;0;0;1;0;0;2;2;550;0;562;2;1;
/org.eclipse.ui.workbench.texteditor/src/org/eclipse/ui/internal/texteditor/AnnotationExpansionControl.java;3;1;5;2;2;2;2;3;801;2;2;2544;819;819;2;1;0;3;5;3825;1;6340;4;3;
/org.eclipse.team.tests.cvs.core/src/org/eclipse/team/tests/ccvs/ui/old/PrintTextDiffVisitor.java;1;0;2;1;0;0;0;2;0;1;2;2632;0;0;1;0;0;2;2;2632;0;4216;2;1;
/org.eclipse.osgi.tests/src/org/eclipse/osgi/tests/services/resolver/PlatformAdminTest.java;1;0;1;1;1;1;1;0;0;0;0;5993;0;0;1;0;0;0;1;5993;0;5993;1;1;
/org.eclipse.jdt.core.tests.model/workspace/Formatter/test396/A_in.java;1;0;1;1;0;0;0;1;0;0;1;3435;0;0;1;0;0;1;1;3435;0;3435;1;1;
/org.eclipse.ltk.core.refactoring/src/org/eclipse/ltk/core/refactoring/Refactoring.java;2;1;9;1;7;7;7;2;32;1;2;4845;156;156;1;0;0;2;9;4845;0;6352;9;2;
/org.eclipse.pde.ui/src/org/eclipse/pde/internal/ui/wizards/convert/PluginToBundleWizardPage.java;1;0;2;1;0;0;0;2;5;0;1;3839;5;5;2;1;0;2;2;3839;1;3839;1;1;
/org.eclipse.ui.views/src/org/eclipse/ui/views/navigator/SortViewAction.java;1;0;1;1;0;0;0;1;0;0;1;2738;0;0;1;0;0;1;1;2738;0;2738;1;1;
/org.eclipse.jdt.ui.tests.refactoring/resources/Delete/testDeleteWithinCu0/in/A.java;1;0;1;1;0;0;0;1;0;0;1;442;0;0;1;0;0;1;1;442;0;442;1;1;
/org.eclipse.team.tests.cvs.core/src/org/eclipse/team/tests/ccvs/ui/logformatter/PrintDiffVisitor.java;1;0;1;1;0;0;0;1;0;0;1;2632;0;0;1;0;0;1;1;2632;0;2632;1;1;
/org.eclipse.debug.ui/ui/org/eclipse/debug/internal/ui/preferences/IDebugPreferenceConstants.java;4;1;8;1;3;3;3;5;16;1;5;689;58;58;1;0;0;5;8;689;0;5701;8;4;
/org.eclipse.ui.ide/src/org/eclipse/ui/actions/CopyResourceAction.java;2;0;5;1;0;0;0;5;19;1;5;1511;24;24;1;0;0;5;5;1511;0;2263;5;2;
/org.eclipse.jdt.ui/ui/org/eclipse/jdt/internal/ui/preferences/MarkOccurrencesConfigurationBlock.java;2;2;8;2;8;7;8;0;32;0;0;5270;97;97;2;0;1;0;8;5482;1;6340;7;2;
/org.eclipse.ui.ide/src/org/eclipse/ui/views/markers/internal/MarkerLabelProvider.java;1;0;1;1;0;0;0;1;0;0;1;2208;0;0;1;0;0;1;1;2208;0;2208;1;1;
/org.eclipse.jdt.core.tests.model/workspace/Converter/test0282/Test.java;1;0;1;1;0;0;0;1;0;0;1;3714;0;0;1;0;0;1;1;3714;0;3714;1;1;
/org.eclipse.team.cvs.core/src/org/eclipse/team/internal/ccvs/core/util/CVSDateFormatter.java;2;0;5;1;1;1;1;4;77;1;4;1933;212;212;1;0;0;4;5;1933;0;6337;5;2;
/org.eclipse.ui.console/src/org/eclipse/ui/internal/console/PinConsoleAction.java;1;0;2;1;0;0;0;2;3;1;2;1988;3;3;1;0;0;2;2;1988;0;2024;2;1;
/org.eclipse.help/src/org/eclipse/help/internal/HelpCore.java;1;0;1;1;0;0;0;1;0;0;1;1740;0;0;1;0;0;1;1;1740;0;1740;1;1;
/org.eclipse.jdt.ui/ui/org/eclipse/jdt/internal/ui/javaeditor/SemanticHighlightingPresenter.java;4;1;8;1;8;8;8;0;62;0;0;5272;218;218;1;0;0;0;8;5272;0;6144;8;4;
/org.eclipse.search/search/org/eclipse/search/internal/ui/RemovePotentialMatchesAction.java;1;0;2;1;1;1;1;1;80;0;1;611;84;84;1;0;0;1;2;611;0;6340;2;1;
/org.eclipse.jdt.ui.tests.refactoring/resources/DeleteSourceReferenceEdit/A_test0_in.java;1;0;1;1;0;0;0;1;0;0;1;1652;0;0;1;0;0;1;1;1652;0;1652;1;1;
/org.eclipse.jdt.ui/ui/org/eclipse/jdt/internal/ui/search/PrettySignature.java;2;1;3;1;3;3;3;0;17;0;0;5396;20;20;1;0;0;0;3;5396;0;6340;3;2;
/org.eclipse.jdt.core.tests.model/workspace/Formatter/test478/A_out.java;1;0;1;1;0;0;0;1;0;0;1;4173;0;0;1;0;0;1;1;4173;0;4173;1;1;
/org.eclipse.jdt.ui/ui/org/eclipse/jdt/internal/ui/preferences/formatter/BlankLinesTabPage.java;1;0;12;1;0;0;0;12;106;2;10;3103;267;267;2;2;0;12;12;3103;2;3943;10;1;
/org.eclipse.jdt.debug.ui/ui/org/eclipse/jdt/internal/debug/ui/JavaThreadActionFilter.java;1;0;2;1;0;0;0;2;11;0;1;3217;11;11;2;1;0;2;2;3217;1;3217;1;1;
/org.eclipse.ui.intro/src/org/eclipse/ui/internal/intro/impl/parts/ContextHelpPart.java;2;2;7;1;7;6;7;0;46;0;0;5115;106;106;2;0;1;0;7;5210;1;5305;6;2;
/org.eclipse.jdt.core/codeassist/org/eclipse/jdt/internal/codeassist/complete/CompletionOnKeyword.java;2;0;2;1;0;0;0;2;2;1;2;991;3;3;1;0;0;2;2;991;0;3560;2;2;
/org.eclipse.jdt.ui.tests.refactoring/resources/Delete/testDeleteWithinCu9/out/A.java;1;0;1;1;0;0;0;1;0;0;1;442;0;0;1;0;0;1;1;442;0;442;1;1;
/org.eclipse.jdt.core.tests.model/workspace/Formatter/test074/A_out.java;1;0;1;1;0;0;0;1;0;0;1;2425;0;0;1;0;0;1;1;2425;0;2425;1;1;
/org.eclipse.core.resources/src/org/eclipse/core/internal/watson/ElementTreeReaderImpl_1.java;1;0;2;1;2;1;2;0;149;0;0;5146;149;149;2;0;1;0;2;5146;1;5146;1;1;
/org.eclipse.pde.runtime/src/org/eclipse/pde/internal/runtime/registry/ExtensionPointPropertySource.java;2;1;5;1;2;2;2;3;86;1;3;924;187;187;1;0;0;3;5;924;0;6336;5;2;
/org.eclipse.jdt.ui.tests.refactoring/resources/InlineMethodWorkspace/TestCases/simple_in/TestTypeArray.java;1;0;1;1;0;0;0;1;2;0;1;845;2;2;1;0;0;1;1;845;0;845;1;1;
/org.eclipse.team.cvs.core/src/org/eclipse/team/internal/ccvs/core/subscribers/CVSWorkspaceSubscriber.java;1;0;1;1;0;0;0;1;0;0;1;1427;0;0;1;0;0;1;1;1427;0;1427;1;1;
/org.eclipse.pde.ui/sandbox/org/eclipse/pde/internal/ui/editor/standalone/parser/XEDocumentScanner.java;1;0;2;1;0;0;0;2;0;1;2;2320;0;0;1;0;0;2;2;2320;0;2931;2;1;
/org.eclipse.jdt.core.tests.model/workspace/Completion/src3/test0007/Test.java;1;0;1;1;0;0;0;1;0;0;1;5010;0;0;1;0;0;1;1;5010;0;5010;1;1;
/org.eclipse.osgi/core/framework/org/eclipse/osgi/framework/debug/Debug.java;4;1;8;1;4;4;4;4;248;1;4;3013;390;390;1;0;0;4;8;3013;0;6337;8;4;
/org.eclipse.jdt.core.tests.model/workspace/Converter/src/test0538/A.java;1;0;2;1;0;0;0;2;3;1;2;4007;3;3;1;0;0;2;2;4007;0;4060;2;1;
/org.eclipse.ui.ide/src/org/eclipse/ui/views/markers/internal/DialogTaskProperties.java;4;2;4;2;3;2;3;1;27;0;1;2208;37;37;2;0;1;1;4;6338;1;6338;3;4;
/org.eclipse.jdt.core.tests.model/workspace/Converter/src/test0089/Test.java;1;0;1;1;0;0;0;1;0;0;1;3714;0;0;1;0;0;1;1;3714;0;3714;1;1;
/org.eclipse.jdt.core.tests.model/workspace/Converter/src/test0022/Test.java;1;0;1;1;0;0;0;1;0;0;1;3714;0;0;1;0;0;1;1;3714;0;3714;1;1;
/org.eclipse.jdt.ui.tests.refactoring/resources/InlineMethodWorkspace/TestCases/argument_out/TestParameterNameUsed3.java;1;0;1;1;0;0;0;1;4;0;1;845;4;4;1;0;0;1;1;845;0;845;1;1;
/org.eclipse.jdt.ui/core refactoring/org/eclipse/jdt/internal/corext/refactoring/participants/RenameGifFileParticipant.java;1;0;3;1;0;0;0;3;12;1;3;591;12;12;1;0;0;3;3;591;0;882;3;1;
/org.eclipse.jdt.core.tests.model/workspace/Converter/src/test0074/Test.java;1;0;1;1;0;0;0;1;0;0;1;3714;0;0;1;0;0;1;1;3714;0;3714;1;1;
/org.eclipse.ui.workbench.texteditor/src/org/eclipse/ui/internal/texteditor/quickdiff/compare/rangedifferencer/LinkedRangeDifference.java;1;1;3;1;2;2;2;1;3;0;1;1644;5;5;1;0;0;1;3;1644;0;6340;3;1;
/org.eclipse.jdt.ui/ui/org/eclipse/jdt/internal/ui/preferences/MembersOrderPreferencePage.java;2;0;3;1;1;1;1;2;252;1;2;3708;256;256;1;0;0;2;3;3708;0;6340;3;2;
/org.eclipse.ui.tests/Eclipse UI Tests/org/eclipse/ui/tests/dnd/EditorDropTarget.java;1;0;1;1;0;0;0;1;0;0;1;5007;0;0;1;0;0;1;1;5007;0;5007;1;1;
/org.eclipse.jdt.ui.tests.refactoring/resources/MoveMembers/test6/out/B.java;1;0;1;1;0;0;0;1;1;0;1;1522;1;1;1;0;0;1;1;1522;0;1522;1;1;
/org.eclipse.debug.core/core/org/eclipse/debug/core/sourcelookup/AbstractSourceLookupDirector.java;1;0;5;1;1;1;1;4;94;2;3;4949;147;147;2;1;0;4;5;4949;1;5790;4;1;
/org.eclipse.jdt.ui/ui/org/eclipse/jdt/internal/ui/javaeditor/JarEntryEditorInput.java;1;0;1;1;1;1;1;0;2;0;0;6340;2;2;1;0;0;0;1;6340;0;6340;1;1;
/org.eclipse.jdt.ui.tests.refactoring/resources/ExtractMethodWorkSpace/ExtractMethodTests/locals_out/A_test563.java;1;0;1;1;0;0;0;1;4;0;1;844;4;4;1;0;0;1;1;844;0;844;1;1;
/org.eclipse.jdt.ui.tests.refactoring/resources/ExtractTemp/canExtract/A_test65_out.java;1;0;1;1;0;0;0;1;0;0;1;87;0;0;1;0;0;1;1;87;0;87;1;1;
/org.eclipse.swt/Eclipse SWT/carbon/org/eclipse/swt/widgets/Sash.java;4;1;7;1;2;2;2;5;91;1;5;137;109;109;1;0;0;5;7;137;0;6352;7;4;
/org.eclipse.core.tests.resources/src/org/eclipse/core/tests/resources/regression/Bug_27271.java;1;0;2;1;2;1;2;0;10;0;0;5147;10;10;2;0;1;0;2;5147;1;5147;1;1;
/org.eclipse.compare/compare/org/eclipse/compare/IPropertyChangeNotifier.java;1;0;1;1;0;0;0;1;2;0;1;3935;2;2;1;0;0;1;1;3935;0;3935;1;1;
/org.eclipse.jdt.ui.tests.refactoring/resources/ExtractMethodWorkSpace/ExtractMethodTests/validSelection_out/A_test365.java;1;0;1;1;0;0;0;1;4;0;1;844;4;4;1;0;0;1;1;844;0;844;1;1;
/org.eclipse.jdt.core/compiler/org/eclipse/jdt/internal/compiler/lookup/ParameterizedGenericMethodBinding.java;1;0;1;1;0;0;0;1;0;0;1;5089;0;0;1;0;0;1;1;5089;0;5089;1;1;
/org.eclipse.swt/Eclipse SWT/carbon/org/eclipse/swt/widgets/Shell.java;4;1;35;2;7;7;7;28;173;3;23;5;681;681;3;5;0;28;35;4216;5;6352;30;4;
/org.eclipse.swt/Eclipse SWT PI/gtk/org/eclipse/swt/internal/gtk/GtkSelectionData.java;3;0;4;1;1;1;1;3;17;1;3;1653;29;29;1;0;0;3;4;1653;0;6352;4;3;
/org.eclipse.ui.workbench/Eclipse UI/org/eclipse/ui/internal/registry/EditorRegistryReader.java;3;0;4;1;1;1;1;3;41;1;3;2737;60;60;1;0;0;3;4;2737;0;6338;4;3;
/org.eclipse.jface.text/src/org/eclipse/jface/text/PropagatingFontFieldEditor.java;2;1;3;1;3;3;3;0;2;0;0;5177;5;5;1;0;0;0;3;5177;0;6359;3;2;
/org.eclipse.pde.core/src/org/eclipse/pde/internal/core/IModelProvider.java;1;0;1;1;0;0;0;1;0;0;1;2229;0;0;1;0;0;1;1;2229;0;2229;1;1;
/org.eclipse.ant.ui/Ant Tools Support/org/eclipse/ant/ui/internal/launchConfigurations/JavacLineTracker.java;1;0;2;1;0;0;0;2;0;1;2;250;0;0;1;0;0;2;2;250;0;558;2;1;
/org.eclipse.team.cvs.core/src/org/eclipse/team/internal/ccvs/core/syncinfo/SubscriberResourceTree.java;1;0;1;1;0;0;0;1;0;0;1;3430;0;0;1;0;0;1;1;3430;0;3430;1;1;
/org.eclipse.jdt.ui.tests.refactoring/resources/ExtractMethodWorkSpace/ExtractMethodTests/expression_out/A_test612.java;1;0;3;1;0;0;0;3;4;1;3;844;4;4;1;0;0;3;3;844;0;1474;3;1;
/org.eclipse.jdt.debug.tests/tests/org/eclipse/jdt/debug/tests/eval/NestedTypeFieldValue_69.java;1;0;1;1;0;0;0;1;80;0;1;1274;80;80;1;0;0;1;1;1274;0;1274;1;1;
/org.eclipse.ui.workbench/Eclipse UI/org/eclipse/ui/internal/csm/commands/IKeyConfigurationDefinition.java;1;0;3;1;0;0;0;3;38;2;2;2532;38;38;2;1;0;3;3;2532;1;2562;2;1;
/org.eclipse.ui.workbench/Eclipse UI/org/eclipse/ui/internal/activities/ws/ActivityContentProvider.java;3;0;3;1;1;1;1;2;2;1;2;3066;4;4;1;0;0;2;3;3066;0;6338;3;3;
/org.eclipse.swt/Eclipse SWT/carbon/org/eclipse/swt/widgets/FontDialog.java;5;1;10;2;3;3;3;7;44;3;4;166;115;115;3;3;0;7;10;166;3;6352;7;5;
/org.eclipse.jdt.ui.tests.refactoring/resources/ExtractMethodWorkSpace/ExtractMethodTests/locals_out/A_test566.java;1;0;2;1;0;0;0;2;6;1;2;130;7;7;1;0;0;2;2;130;0;844;2;1;
/org.eclipse.jdt.core.tests.model/workspace/Converter/test0354/Test.java;1;0;1;1;0;0;0;1;0;0;1;3714;0;0;1;0;0;1;1;3714;0;3714;1;1;
/org.eclipse.jdt.core.tests.model/workspace/Formatter/test081/A_out.java;1;0;1;1;0;0;0;1;0;0;1;2425;0;0;1;0;0;1;1;2425;0;2425;1;1;
/org.eclipse.swt/Eclipse SWT PI/gtk1x/org/eclipse/swt/internal/gtk/GtkCListColumn.java;1;0;1;1;0;0;0;1;0;0;1;2327;0;0;1;0;0;1;1;2327;0;2327;1;1;
/org.eclipse.core.tests.runtime/src/org/eclipse/core/tests/plugintests/CmdLineAndPrimaryFeatureTest.java;1;0;1;1;0;0;0;1;0;0;1;3014;0;0;1;0;0;1;1;3014;0;3014;1;1;
/org.eclipse.jdt.core.tests.model/workspace/Formatter/test127/A_out.java;1;0;1;1;0;0;0;1;0;0;1;2425;0;0;1;0;0;1;1;2425;0;2425;1;1;
/org.eclipse.jdt.core.tests.model/workspace/Formatter/test102/A_in.java;1;0;1;1;0;0;0;1;0;0;1;2425;0;0;1;0;0;1;1;2425;0;2425;1;1;
/org.eclipse.ui.workbench/Eclipse UI/org/eclipse/ui/wizards/datatransfer/WizardZipFileResourceImportPage1.java;1;0;1;1;0;0;0;1;0;0;1;2737;0;0;1;0;0;1;1;2737;0;2737;1;1;
/org.eclipse.jdt.ui/ui refactoring/org/eclipse/jdt/internal/ui/refactoring/MessageWizardPage.java;2;0;4;1;1;1;1;3;4;1;3;1668;8;8;1;0;0;3;4;1668;0;6340;4;2;
/org.eclipse.ltk.core.refactoring/src/org/eclipse/ltk/internal/core/refactoring/ContentStamps.java;1;1;4;1;4;4;4;0;19;0;0;5162;28;28;1;0;0;0;4;5162;0;5269;4;1;
/org.eclipse.jdt.ui/core extension/org/eclipse/jdt/internal/corext/dom/TrackedNodePosition.java;1;0;2;1;1;1;1;1;0;0;1;4493;0;0;1;0;0;1;2;4493;0;5406;2;1;
/org.eclipse.ui.workbench/Eclipse UI/org/eclipse/ui/internal/registry/ActionSetDescriptor.java;3;1;7;1;2;2;2;5;35;1;5;2737;122;122;1;0;0;5;7;2737;0;6338;7;3;
/org.eclipse.ui.ide/src/org/eclipse/ui/internal/ide/actions/AboutAction.java;3;0;6;1;1;1;1;5;39;1;5;2264;82;82;1;0;0;5;6;2264;0;5483;6;3;
/org.eclipse.team.ui/src/org/eclipse/team/ui/synchronize/ISynchronizeViewNode.java;1;0;1;1;0;0;0;1;0;0;1;2535;0;0;1;0;0;1;1;2535;0;2535;1;1;
/org.eclipse.jdt.core.tests.model/workspace/Converter/test0071/Test.java;1;0;1;1;0;0;0;1;0;0;1;3714;0;0;1;0;0;1;1;3714;0;3714;1;1;
/org.eclipse.debug.ui/ui/org/eclipse/debug/internal/ui/views/memory/MemoryViewUtil.java;1;0;1;1;1;1;1;0;0;0;0;5254;0;0;1;0;0;0;1;5254;0;5254;1;1;
/org.eclipse.jdt.core.tests.model/workspace/Converter/src/test0355/Foo.java;1;0;1;1;0;0;0;1;0;0;1;3714;0;0;1;0;0;1;1;3714;0;3714;1;1;
/org.eclipse.osgi.tests/src/org/eclipse/osgi/tests/internal/state/StateCycleTest.java;1;1;3;1;3;3;3;0;113;0;0;5521;113;113;1;0;0;0;3;5521;0;5993;3;1;
/org.eclipse.ui.workbench/Eclipse UI/org/eclipse/ui/internal/presentation/FontDefinition.java;1;0;2;1;0;0;0;2;0;1;2;4263;0;0;1;0;0;2;2;4263;0;4392;2;1;
/org.eclipse.core.tests.runtime/src/org/eclipse/core/tests/runtime/jobs/RuleSetA.java;2;0;2;1;0;0;0;2;0;1;2;2160;0;0;1;0;0;2;2;2160;0;3408;2;2;
/org.eclipse.swt/Eclipse SWT/emulated/treetable/org/eclipse/swt/widgets/Table.java;6;1;23;2;6;6;6;17;164;2;15;110;652;652;2;2;0;17;23;269;2;6352;21;6;
/org.eclipse.jdt.ui/core extension/org/eclipse/jdt/internal/corext/codemanipulation/AddImportsOperation.java;2;0;3;1;1;1;1;2;8;1;2;3074;12;12;1;0;0;2;3;3074;0;6340;3;2;
/org.eclipse.jdt.core.tests.model/workspace/Converter/src/test0311/Test.java;1;0;1;1;0;0;0;1;0;0;1;3714;0;0;1;0;0;1;1;3714;0;3714;1;1;
/org.eclipse.ui.ide/src/org/eclipse/ui/internal/IMarkerImageProvider.java;2;0;2;1;0;0;0;2;0;1;2;1520;0;0;1;0;0;2;2;1520;0;2263;2;2;
/org.eclipse.team.cvs.ui/src/org/eclipse/team/internal/ccvs/ui/operations/CompareOperation.java;1;0;1;1;0;0;0;1;0;0;1;2478;0;0;1;0;0;1;1;2478;0;2478;1;1;
/org.eclipse.debug.ui/ui/org/eclipse/debug/internal/ui/sourcelookup/SourceContainerAction.java;1;0;2;1;0;0;0;2;2;1;2;3770;2;2;1;0;0;2;2;3770;0;4949;2;1;
/org.eclipse.jdt.ui/ui/org/eclipse/jdt/internal/ui/browsing/PackagesViewTreeViewer.java;1;2;3;1;3;2;3;0;51;0;0;5847;53;53;2;0;1;0;3;5847;1;6340;2;1;
/org.eclipse.jdt.ui/ui/org/eclipse/jdt/internal/ui/text/java/IJavaCompletionProposal.java;1;0;1;1;0;0;0;1;0;0;1;1152;0;0;1;0;0;1;1;1152;0;1152;1;1;
/org.eclipse.ui.workbench/Eclipse UI/org/eclipse/ui/internal/chris/roles/api/IRoleActivationServiceEvent.java;1;0;2;1;0;0;0;2;0;0;1;2207;0;0;2;1;0;2;2;2207;1;2207;1;1;
/org.eclipse.search/search/org/eclipse/search/internal/ui/text/ResourceStructureProvider.java;1;0;3;1;0;0;0;3;86;1;3;3458;86;86;1;0;0;3;3;3458;0;3711;3;1;
/org.eclipse.team.cvs.ui/src/org/eclipse/team/internal/ccvs/ui/actions/ReplaceWithRevisionAction.java;2;1;9;1;3;3;3;6;79;2;5;4389;124;124;2;1;0;6;9;4559;1;6337;8;2;
/org.eclipse.search/new search/org/eclipse/search/ui/IQueryListener.java;3;1;9;1;4;4;4;5;34;3;3;4345;94;94;3;2;0;5;9;4841;2;6340;7;3;
/org.eclipse.core.runtime/src/org/eclipse/core/runtime/model/PluginFragmentModel.java;1;0;1;1;0;0;0;1;0;0;1;3013;0;0;1;0;0;1;1;3013;0;3013;1;1;
/org.eclipse.ui.workbench/Eclipse UI/org/eclipse/ui/internal/themes/CascadingFontRegistry.java;1;0;2;1;0;0;0;2;11;1;2;4392;11;11;1;0;0;2;2;4392;0;4802;2;1;
/org.eclipse.ui.examples.rcp.browser/src/org/eclipse/ui/examples/rcp/browser/BrowserApp.java;2;1;5;1;2;2;2;3;15;1;3;3532;40;40;1;0;0;3;5;3532;0;6169;5;2;
/org.eclipse.core.tests.runtime/src/org/eclipse/core/tests/internal/plugins/OrphanTest.java;1;0;1;1;0;0;0;1;0;0;1;3014;0;0;1;0;0;1;1;3014;0;3014;1;1;
/org.eclipse.jdt.ui.tests.refactoring/resources/ExtractTemp/canExtract/A_test75_out.java;1;0;1;1;0;0;0;1;0;0;1;1569;0;0;1;0;0;1;1;1569;0;1569;1;1;
/org.eclipse.core.tests.runtime/src/org/eclipse/core/tests/internal/plugins/PluginResolveTest_7.java;1;0;1;1;0;0;0;1;0;0;1;3014;0;0;1;0;0;1;1;3014;0;3014;1;1;
/org.eclipse.swt.tests/JUnit Tests/org/eclipse/swt/tests/junit/Test_org_eclipse_swt_dnd_RTFTransfer.java;1;0;1;1;0;0;0;1;13;0;1;2176;13;13;1;0;0;1;1;2176;0;2176;1;1;
/org.eclipse.jdt.core.tests.model/workspace/Formatter/test173/A_out.java;1;0;1;1;0;0;0;1;0;0;1;2425;0;0;1;0;0;1;1;2425;0;2425;1;1;
/org.eclipse.ui.ide/src/org/eclipse/ui/views/bookmarkexplorer/SelectAllAction.java;1;0;1;1;0;0;0;1;0;0;1;2208;0;0;1;0;0;1;1;2208;0;2208;1;1;
/org.eclipse.jdt.core.tests.model/workspace/Converter15/src/test0007/X.java;1;0;1;1;0;0;0;1;0;0;1;4651;0;0;1;0;0;1;1;4651;0;4651;1;1;
/org.eclipse.jdt.core.tests.model/workspace/Converter/src/junit/framework/TestResult.java;1;0;1;1;0;0;0;1;0;0;1;3714;0;0;1;0;0;1;1;3714;0;3714;1;1;
/org.eclipse.jdt.ui.tests.refactoring/resources/PullUp/test25/in/A.java;1;0;1;1;0;0;0;1;16;0;1;1738;16;16;1;0;0;1;1;1738;0;1738;1;1;
/org.eclipse.jdt.ui.tests.refactoring/resources/TypeConstraints/A_testNumber2.java;1;0;1;1;0;0;0;1;0;0;1;53;0;0;1;0;0;1;1;53;0;53;1;1;
/org.eclipse.pde.ui/src_Forms/org/eclipse/pde/internal/ui/neweditor/feature/IncludeFeaturesWizardPage.java;2;0;2;1;1;1;1;1;0;0;1;4926;0;0;1;0;0;1;2;4926;0;5431;2;2;
/org.eclipse.text/src/org/eclipse/jface/text/BadLocationException.java;1;0;1;1;1;1;1;0;6;0;0;6298;6;6;1;0;0;0;1;6298;0;6298;1;1;
/org.eclipse.pde.ui/src/org/eclipse/pde/internal/ui/editor/build/BuildPage.java;3;2;9;2;8;7;8;1;173;0;1;1727;235;235;2;0;1;1;9;5431;1;6336;8;3;
/org.eclipse.ui.workbench/Eclipse UI/org/eclipse/ui/contexts/IContextHandle.java;1;0;2;1;0;0;0;2;0;1;2;1294;0;0;1;0;0;2;2;1294;0;1417;2;1;
/org.eclipse.jdt.core/dom/org/eclipse/jdt/core/dom/Modifier.java;4;0;11;1;2;1;2;9;296;1;9;1395;396;396;2;0;1;9;11;5268;1;5268;10;4;
/org.eclipse.jdt.ui.tests.refactoring/resources/MoveInnerToTopLevel/test_nonstatic_37/out/A.java;1;0;1;1;0;0;0;1;0;0;1;1311;0;0;1;0;0;1;1;1311;0;1311;1;1;
/org.eclipse.pde.core/src_OSGi/org/eclipse/pde/internal/core/osgi/bundle/Bundle.java;2;0;16;2;0;0;0;16;120;2;13;2229;365;365;2;3;0;16;16;2467;3;4203;13;2;
/org.eclipse.jdt.ui.tests.refactoring/resources/MoveInstanceMethod/canMove/test15/in/A.java;1;0;1;1;0;0;0;1;0;0;1;1570;0;0;1;0;0;1;1;1570;0;1570;1;1;
/org.eclipse.jdt.core.tests.model/workspace/Formatter/test194/A_out.java;2;0;2;1;0;0;0;2;10;1;2;2424;10;10;1;0;0;2;2;2424;0;3362;2;2;
/org.eclipse.jdt.core/search/org/eclipse/jdt/internal/core/search/processing/JobManager.java;4;1;24;2;2;2;2;22;131;2;18;61;513;513;2;4;0;22;24;919;4;6120;20;4;
/org.eclipse.ant.ui/Remote Ant Support/org/eclipse/ant/internal/ui/antsupport/InternalAntRunner.java;1;1;16;1;7;7;7;9;182;1;9;1811;700;700;1;0;0;9;16;1811;0;6339;16;1;
/org.eclipse.jdt.ui/core refactoring/org/eclipse/ltk/core/refactoring/participants/ProcessorDescriptor.java;1;0;2;1;0;0;0;2;0;1;2;4624;0;0;1;0;0;2;2;4624;0;4864;2;1;
/org.eclipse.jdt.ui/core extension/org/eclipse/jdt/internal/corext/callhierarchy/MethodReferencesSearchRequestor.java;2;1;3;1;3;3;3;0;3;0;0;5264;5;5;1;0;0;0;3;5264;0;6340;3;2;
/org.eclipse.ui.workbench/Eclipse UI/org/eclipse/ui/internal/commands/IActiveKeyConfigurationDefinition.java;1;0;4;1;0;0;0;4;23;1;4;1422;25;25;1;0;0;4;4;1422;0;3128;4;1;
/org.eclipse.update.ui/src/org/eclipse/update/internal/ui/search/UpdatesSearchCategory.java;2;0;4;1;0;0;0;4;63;1;4;369;73;73;1;0;0;4;4;369;0;755;4;2;
/org.eclipse.osgi/supplement/src/org/eclipse/osgi/framework/log/FrameworkLogEntry.java;3;0;5;1;1;1;1;4;21;1;4;3879;45;45;1;0;0;4;5;3879;0;5117;5;3;
/org.eclipse.jdt.core.tests.model/workspace/Converter/test0406_a/A.java;1;0;1;1;0;0;0;1;0;0;1;3714;0;0;1;0;0;1;1;3714;0;3714;1;1;
/org.eclipse.core.runtime/src/org/eclipse/core/internal/jobs/JobQueue.java;3;0;13;1;1;1;1;12;232;1;12;688;661;661;1;0;0;12;13;688;0;5150;13;3;
/org.eclipse.swt/Eclipse SWT/win32/org/eclipse/swt/internal/BidiUtil.java;5;0;7;1;1;1;1;6;117;1;6;508;290;290;1;0;0;6;7;508;0;6352;7;5;
/org.eclipse.core.runtime/src/org/eclipse/core/internal/boot/PlatformURLBaseConnection.java;2;1;4;1;2;2;2;2;102;1;2;3049;110;110;1;0;0;2;4;3049;0;6340;4;2;
/org.eclipse.swt/Eclipse SWT/motif/org/eclipse/swt/graphics/TextStyle.java;1;0;2;1;0;0;0;2;0;1;2;4564;0;0;1;0;0;2;2;4564;0;4873;2;1;
/org.eclipse.ui.tests/Eclipse UI Tests/org/eclipse/ui/tests/stress/OpenCloseTest.java;3;0;3;1;1;1;1;2;4;1;2;4872;6;6;1;0;0;2;3;4872;0;6338;3;3;
/org.eclipse.jdt.ui.tests.refactoring/resources/ConvertAnonymousToNested/canConvert/A_test20_in.java;1;0;1;1;0;0;0;1;0;0;1;458;0;0;1;0;0;1;1;458;0;458;1;1;
/org.eclipse.jdt.ui.tests.refactoring/resources/ExtractMethodWorkSpace/ExtractMethodTests/expression_out/A_test600.java;1;0;3;1;0;0;0;3;4;1;3;844;4;4;1;0;0;3;3;844;0;1474;3;1;
/org.eclipse.jdt.core.tests.model/workspace/Converter/src/test0387/A.java;1;0;1;1;0;0;0;1;0;0;1;3714;0;0;1;0;0;1;1;3714;0;3714;1;1;
/org.eclipse.core.resources/src/org/eclipse/core/resources/IWorkspaceRoot.java;2;0;4;2;1;1;1;3;304;1;3;44;330;330;1;0;0;3;4;44;0;5146;4;2;
/org.eclipse.swt/Eclipse SWT/carbon/org/eclipse/swt/widgets/DirectoryDialog.java;3;1;5;1;2;2;2;3;25;2;2;902;48;48;2;1;0;3;5;2825;1;6352;4;3;
/org.eclipse.core.tools/src/org/eclipse/core/tools/runtime/VMClassloaderInfo.java;1;0;1;1;1;1;1;0;0;0;0;6302;0;0;1;0;0;0;1;6302;0;6302;1;1;
/org.eclipse.ui.workbench/Eclipse UI/org/eclipse/ui/internal/AboutInfo.java;5;1;9;1;3;3;3;6;339;1;6;29;605;605;1;0;0;6;9;29;0;6102;9;5;
/org.eclipse.pde.ui/src/org/eclipse/pde/internal/ui/launcher/OpenLogDialog.java;2;1;3;1;3;3;3;0;371;0;0;5947;377;377;1;0;0;0;3;5947;0;6336;3;2;
/org.eclipse.osgi/eclipseAdaptor/src/org/eclipse/osgi/service/runnable/ParameterizedRunnable.java;2;0;2;1;0;0;0;2;6;1;2;4215;6;6;1;0;0;2;2;4215;0;4954;2;2;
/org.eclipse.core.resources/src/org/eclipse/core/internal/resources/WorkManager.java;2;1;21;1;5;5;5;16;552;1;16;1485;1122;1122;1;0;0;16;21;1485;0;5895;21;2;
/org.eclipse.update.core/src/org/eclipse/update/search/IUpdateSiteAdapter.java;2;1;6;1;2;2;2;4;7;1;4;825;15;15;1;0;0;4;6;825;0;6336;6;2;
/org.eclipse.debug.core/core/org/eclipse/debug/core/ILaunchesListener2.java;2;0;2;1;0;0;0;2;4;1;2;4194;4;4;1;0;0;2;2;4194;0;4282;2;2;
/org.eclipse.team.cvs.ui/src/org/eclipse/team/internal/ccvs/ui/actions/UneditAction.java;2;1;3;1;2;2;2;1;8;0;1;1133;12;12;1;0;0;1;3;1133;0;6337;3;2;
/org.eclipse.jdt.debug.tests/tests/org/eclipse/jdt/debug/tests/eval/TestsOperators1.java;1;0;1;1;0;0;0;1;8;0;1;1274;8;8;1;0;0;1;1;1274;0;1274;1;1;
/org.eclipse.jdt.ui/ui refactoring/org/eclipse/jdt/internal/ui/refactoring/IPreviewViewer.java;1;0;1;1;0;0;0;1;0;0;1;4965;0;0;1;0;0;1;1;4965;0;4965;1;1;
/org.eclipse.jdt.ui.tests.refactoring/resources/ExtractMethodWorkSpace/ExtractMethodTests/return_out/A_test723.java;1;0;2;1;0;0;0;2;4;1;2;130;5;5;1;0;0;2;2;130;0;844;2;1;
/org.eclipse.core.resources.linux/src/org/eclipse/core/resources/refresh/linux/HandleContainer.java;1;0;2;1;0;0;0;2;0;1;2;4346;0;0;1;0;0;2;2;4346;0;4851;2;1;
/org.eclipse.jdt.core.tests.model/workspace/Converter/test0113/Test.java;1;0;1;1;0;0;0;1;0;0;1;3714;0;0;1;0;0;1;1;3714;0;3714;1;1;
/org.eclipse.core.tests.resources/src/org/eclipse/core/tests/resources/perf/MarkerPerformanceTest.java;1;0;3;1;3;1;3;0;29;0;0;5147;29;29;3;0;2;0;3;5147;2;5147;1;1;
/org.eclipse.jdt.ui.tests.refactoring/resources/ChangeTypeRefactoring/positive/A_testLocalSuperTypesOfArrayList_in.java;1;0;1;1;0;0;0;1;0;0;1;2844;0;0;1;0;0;1;1;2844;0;2844;1;1;
/org.eclipse.team.core/src/org/eclipse/team/internal/core/subscribers/SyncSetInput.java;2;0;4;1;1;1;1;3;93;1;3;3550;98;98;1;0;0;3;4;3550;0;6336;4;2;
/org.eclipse.jdt.core.tests.model/workspace/Converter/src/test0449/A.java;1;0;1;1;0;0;0;1;0;0;1;3714;0;0;1;0;0;1;1;3714;0;3714;1;1;
/org.eclipse.core.runtime/src/org/eclipse/core/internal/runtime/AdapterManager.java;5;1;15;2;5;5;5;10;426;2;8;44;1479;1479;2;2;0;10;15;3812;2;6097;13;5;
/org.eclipse.pde.ui/src/org/eclipse/pde/internal/ui/wizards/plugin/ProjectStructurePage.java;3;2;8;1;6;5;6;2;608;1;2;3840;692;692;2;0;1;2;8;5204;1;6147;7;3;
/org.eclipse.webdav/src/interface/org/eclipse/webdav/dom/ConflictReportResponse.java;1;0;2;1;2;1;2;0;44;0;0;5151;44;44;2;0;1;0;2;5151;1;5151;1;1;
/org.eclipse.swt/Eclipse SWT/common/org/eclipse/swt/internal/image/JPEGFileFormat.java;2;1;3;1;2;2;2;1;4;0;1;2648;10;10;1;0;0;1;3;2648;0;6352;3;2;
/org.eclipse.jdt.core.tests.model/workspace/Formatter/test258/A_in.java;1;0;1;1;0;0;0;1;0;0;1;2442;0;0;1;0;0;1;1;2442;0;2442;1;1;
/org.eclipse.jdt.ui/ui/org/eclipse/jdt/internal/ui/javaeditor/CompilationUnitDocumentProvider.java;4;2;43;2;6;5;6;37;590;2;33;857;1743;1743;2;4;1;37;43;1350;5;6338;38;4;
/org.eclipse.core.runtime/src/org/eclipse/core/internal/plugins/IncrementalRegistryResolver.java;2;0;2;1;0;0;0;2;0;1;2;2105;0;0;1;0;0;2;2;2105;0;3013;2;2;
/org.eclipse.jdt.ui.tests.refactoring/resources/ChangeSignature/canModify/A_testName01_in.java;1;0;1;1;0;0;0;1;0;0;1;3801;0;0;1;0;0;1;1;3801;0;3801;1;1;
/org.eclipse.pde.ui/src_Forms/org/eclipse/pde/internal/ui/neweditor/plugin/DependenciesPage.java;2;1;12;1;3;3;3;9;73;2;8;3777;258;258;2;1;0;9;12;4570;1;5431;11;2;
/org.eclipse.help.ui/src/org/eclipse/help/ui/internal/browser/embedded/EmbeddedBrowserResources.java;1;0;2;1;0;0;0;2;0;1;2;2898;0;0;1;0;0;2;2;2898;0;4559;2;1;
/org.eclipse.team.ui/src/org/eclipse/team/internal/ui/jobs/JobsContentProvider.java;1;0;2;1;0;0;0;2;0;1;2;1081;0;0;1;0;0;2;2;1081;0;1369;2;1;
/org.eclipse.jdt.ui.examples.javafamily/src/org/eclipse/core/indexsearch/IIndexQuery.java;1;0;2;1;0;0;0;2;5;1;2;1033;5;5;1;0;0;2;2;1033;0;3235;2;1;
/org.eclipse.jdt.core.tests.model/workspace/Formatter/test061/Parser_in.java;1;0;1;1;0;0;0;1;0;0;1;2425;0;0;1;0;0;1;1;2425;0;2425;1;1;
/org.eclipse.ui.workbench.texteditor/src/org/eclipse/ui/texteditor/ChainedPreferenceStore.java;2;1;5;1;3;3;3;2;156;1;2;4128;173;173;1;0;0;2;5;4128;0;5177;5;2;
/org.eclipse.pde.core/src/org/eclipse/pde/internal/core/TargetPlatform.java;3;2;44;2;12;9;12;32;87;3;27;1026;695;695;3;5;3;32;44;4244;8;6333;36;3;
/org.eclipse.pde.runtime/src/org/eclipse/pde/internal/runtime/logview/DetailsForm.java;2;0;10;2;0;0;0;10;120;2;8;985;282;282;2;2;0;10;10;993;2;3754;8;2;
/org.eclipse.update.ui.forms/Eclipse Forms/org/eclipse/ui/forms/parts/TableWrapData.java;1;0;2;1;0;0;0;2;0;1;2;3116;0;0;1;0;0;2;2;3116;0;3138;2;1;
/org.eclipse.team.core/src/org/eclipse/team/internal/core/Sorter.java;1;0;3;1;1;1;1;2;67;1;2;2777;71;71;1;0;0;2;3;2777;0;6336;3;1;
/org.eclipse.pde.core/src/org/eclipse/pde/internal/core/ExternalJavaSearchInitializer.java;2;1;2;1;2;2;2;0;6;0;0;5760;7;7;1;0;0;0;2;5760;0;6336;2;2;
/org.eclipse.team.ui/src/org/eclipse/team/ui/synchronize/subscriber/RefreshSubscriberJob.java;1;0;3;1;0;0;0;3;150;1;3;4518;150;150;1;0;0;3;3;4518;0;4632;3;1;
/org.eclipse.ui.cheatsheets/src/org/eclipse/ui/internal/cheatsheets/views/FastViewHackPartListener.java;2;0;3;1;0;0;0;3;17;1;3;4428;17;17;1;0;0;3;3;4428;0;4701;3;2;
/org.eclipse.jdt.core/search/org/eclipse/jdt/internal/core/search/matching/FieldDeclarationPattern.java;1;0;2;1;0;0;0;2;20;1;2;786;20;20;1;0;0;2;2;786;0;1115;2;1;
/org.eclipse.ant.ui/Ant Editor/org/eclipse/ant/ui/internal/dtd/AntDTDMessages.java;1;0;2;1;0;0;0;2;0;1;2;250;0;0;1;0;0;2;2;250;0;1811;2;1;
/org.eclipse.ui.workbench/Eclipse UI/org/eclipse/ui/internal/commands/api/older/IKeyConfigurationEvent.java;1;0;2;1;0;0;0;2;0;0;1;2562;0;0;2;1;0;2;2;2562;1;2562;1;1;
/org.eclipse.jdt.core/model/org/eclipse/jdt/core/IImportDeclaration.java;3;0;9;2;1;1;1;8;21;2;7;85;45;45;2;1;0;8;9;85;1;5269;8;3;
/org.eclipse.jdt.ui/ui refactoring/org/eclipse/jdt/internal/ui/refactoring/TextInputWizardPage.java;2;0;5;1;1;1;1;4;2;1;4;591;9;9;1;0;0;4;5;591;0;6340;5;2;
/org.eclipse.jdt.core.tests.model/workspace/Formatter/test147/A_in.java;1;0;1;1;0;0;0;1;0;0;1;2425;0;0;1;0;0;1;1;2425;0;2425;1;1;
/org.eclipse.core.tests.runtime/src/org/eclipse/core/tests/internal/plugins/ActivationTest_Base.java;1;0;1;1;0;0;0;1;0;0;1;3014;0;0;1;0;0;1;1;3014;0;3014;1;1;
/org.eclipse.jdt.ui.tests.refactoring/resources/ExtractInterface/test97/in/A.java;1;0;1;1;0;0;0;1;0;0;1;1315;0;0;1;0;0;1;1;1315;0;1315;1;1;
/org.eclipse.jdt.core.tests.model/workspace/Formatter/test224/A_in.java;1;0;1;1;0;0;0;1;0;0;1;2426;0;0;1;0;0;1;1;2426;0;2426;1;1;
/org.eclipse.pde.ui/src/org/eclipse/pde/internal/ui/editor/text/PDEScanner.java;1;0;1;1;0;0;0;1;0;0;1;3795;0;0;1;0;0;1;1;3795;0;3795;1;1;
/org.eclipse.jdt.ui.tests.refactoring/resources/ExtractMethodWorkSpace/ExtractMethodTests/destination_out/A_test1051.java;1;0;1;1;1;1;1;0;0;0;0;5353;0;0;1;0;0;0;1;5353;0;5353;1;1;
/org.eclipse.pde.ui/sandbox/org/eclipse/pde/internal/ui/editor/standalone/extensions/ExtensionsLabelProvider.java;1;0;2;1;0;0;0;2;0;1;2;2320;0;0;1;0;0;2;2;2320;0;2906;2;1;
/org.eclipse.core.expressions.tests/src/org/eclipse/core/internal/expressions/tests/A_TypeExtender2.java;1;0;2;1;1;1;1;1;2;0;1;4108;2;2;1;0;0;1;2;4108;0;6340;2;1;
/org.eclipse.jdt.debug.jdi.tests/tests/org/eclipse/debug/jdi/tests/StackFrameTest.java;1;0;2;1;0;0;0;2;13;0;1;1318;13;13;2;1;0;2;2;1318;1;1318;1;1;
/org.eclipse.update.core/src/org/eclipse/update/internal/core/IWritable.java;1;0;1;1;0;0;0;1;2;0;1;890;2;2;1;0;0;1;1;890;0;890;1;1;
/org.eclipse.jdt.ui.tests.refactoring/resources/TypeConstraints/A_testConstraints18.java;1;0;2;1;0;0;0;2;2;1;2;65;2;2;1;0;0;2;2;65;0;74;2;1;
/org.eclipse.jdt.core/model/org/eclipse/jdt/internal/core/util/LRUCache.java;1;0;2;1;0;0;0;2;6;1;2;1252;8;8;1;0;0;2;2;1252;0;3560;2;1;
/org.eclipse.pde.core/src/org/eclipse/pde/internal/core/IModelChangeProviderExtension.java;2;1;3;1;3;3;3;0;16;0;0;5536;22;22;1;0;0;0;3;5536;0;6336;3;2;
/org.eclipse.jdt.ui.examples.javafamily/coresearch-experiment/org/eclipse/search/internal/core/Index.java;1;0;2;1;0;0;0;2;0;1;2;1380;0;0;1;0;0;2;2;1380;0;3214;2;1;
/org.eclipse.sdk.tests-feature/plugins/org.eclipse.perfmsr.core/src/org/eclipse/perfmsr/core/LinuxProcStatM.java;2;1;2;1;2;2;2;0;10;0;0;5638;10;10;1;0;0;0;2;5638;0;6342;2;2;
/org.eclipse.update.core/srcnew/org/eclipse/update/internal/operations/RevertConfigurationOperation.java;1;0;5;1;0;0;0;5;10;2;4;589;14;14;2;1;0;5;5;602;1;825;4;1;
/org.eclipse.jface.text.tests/src/org/eclipse/jface/text/tests/rules/DefaultPartitionerTest.java;3;1;4;1;3;3;3;1;39;0;1;5083;62;62;1;0;0;1;4;5083;0;6340;4;3;
/org.eclipse.swt/Eclipse SWT PI/win32/org/eclipse/swt/internal/ole/win32/EXCEPINFO.java;1;0;1;1;0;0;0;1;4;0;1;2915;4;4;1;0;0;1;1;2915;0;2915;1;1;
/org.eclipse.jdt.ui.tests.refactoring/resources/StructureSelectionAction/A_testZeroLength4.java;1;0;1;1;1;1;1;0;0;0;0;6144;0;0;1;0;0;0;1;6144;0;6144;1;1;
/org.eclipse.jdt.ui/ui/org/eclipse/jdt/ui/text/folding/IJavaFoldingStructureProvider.java;1;1;3;1;3;3;3;0;11;0;0;5440;15;15;1;0;0;0;3;5440;0;6340;3;1;
/org.eclipse.jdt.ui/ui refactoring/org/eclipse/jdt/internal/ui/refactoring/actions/UndoRefactoringAction.java;1;0;4;1;1;1;1;3;21;1;3;3708;29;29;1;0;0;3;4;3708;0;5162;4;1;
/org.eclipse.jdt.ui.tests.refactoring/resources/RenameTemp/canRename/A_test40_in.java;1;0;1;1;0;0;0;1;1;0;1;4605;1;1;1;0;0;1;1;4605;0;4605;1;1;
/org.eclipse.pde.core/src/org/eclipse/pde/internal/core/IFileAdapterFactory.java;1;0;2;1;1;1;1;1;4;0;1;4203;6;6;1;0;0;1;2;4203;0;6336;2;1;
/org.eclipse.core.resources/src/org/eclipse/core/internal/watson/ElementTreeWriter.java;2;0;2;1;1;1;1;1;347;0;1;1477;353;353;1;0;0;1;2;1477;0;5146;2;2;
/org.eclipse.jdt.ui.examples.javafamily/src/org/eclipse/jface/text/source/translation/ITranslatorResultCollector.java;1;0;1;1;1;1;1;0;0;0;0;5122;0;0;1;0;0;0;1;5122;0;5122;1;1;
/org.eclipse.jdt.ui/ui/org/eclipse/jdt/ui/refactoring/RenameSupport.java;5;2;20;2;6;5;6;14;135;1;14;122;523;523;2;0;1;14;20;6334;1;6334;19;5;
/org.eclipse.ui.workbench/Eclipse UI/org/eclipse/ui/internal/roles/IActivityBindingDefinition.java;1;0;3;1;0;0;0;3;4;1;3;2533;4;4;1;0;0;3;3;2533;0;2867;3;1;
/org.eclipse.jdt.core/compiler/org/eclipse/jdt/internal/compiler/ast/ThrowStatement.java;2;0;4;1;0;0;0;4;14;1;4;991;24;24;1;0;0;4;4;991;0;3560;4;2;
/org.eclipse.jdt.core.tests.model/workspace/Formatter/test084/A_in.java;1;0;1;1;0;0;0;1;0;0;1;2425;0;0;1;0;0;1;1;2425;0;2425;1;1;
/org.eclipse.jdt.ui.tests.refactoring/resources/Delete/testDeleteWithinCu23/out/A.java;1;0;1;1;0;0;0;1;0;0;1;5058;0;0;1;0;0;1;1;5058;0;5058;1;1;
/org.eclipse.jdt.ui/core refactoring/org/eclipse/jdt/internal/corext/refactoring/util/QualifiedNameSearchResult.java;2;1;3;1;2;2;2;1;29;0;1;4624;35;35;1;0;0;1;3;4624;0;6340;3;2;
/org.eclipse.ui.externaltools/Ant Tools Support/org/eclipse/ui/externaltools/internal/ant/preferences/AntClasspathPage.java;1;0;1;1;0;0;0;1;0;0;1;282;0;0;1;0;0;1;1;282;0;282;1;1;
/org.eclipse.core.tests.resources/src/org/eclipse/core/tests/internal/indexing/TestObjectPolicy.java;1;0;1;1;1;1;1;0;9;0;0;5147;9;9;1;0;0;0;1;5147;0;5147;1;1;
/org.eclipse.core.runtime/src/org/eclipse/core/runtime/preferences/IExportedPreferences.java;1;1;5;1;2;2;2;3;6;1;3;4374;12;12;1;0;0;3;5;4374;0;5541;5;1;
/org.eclipse.jdt.core/codeassist/org/eclipse/jdt/internal/codeassist/complete/CompletionOnQualifiedClassReference.java;2;0;2;1;0;0;0;2;13;1;2;991;15;15;1;0;0;2;2;991;0;3560;2;2;
/org.eclipse.debug.ui/ui/org/eclipse/debug/internal/ui/launchVariables/WorkingSetComponent.java;3;0;9;2;0;0;0;9;23;3;7;647;43;43;3;2;0;9;9;771;2;2077;7;3;
/org.eclipse.ui.workbench/Eclipse UI/org/eclipse/ui/internal/commands/registry/ICommandRegistryEvent.java;1;0;2;1;0;0;0;2;0;1;2;1422;0;0;1;0;0;2;2;1422;0;1724;2;1;
/org.eclipse.team.ui/src/org/eclipse/team/internal/ui/synchronize/SynchronizeViewCompareConfiguration.java;1;0;1;1;0;0;0;1;0;0;1;3676;0;0;1;0;0;1;1;3676;0;3676;1;1;
/org.eclipse.debug.ui/ui/org/eclipse/debug/internal/ui/actions/WatchExpressionDialog.java;1;0;2;1;0;0;0;2;21;1;2;1516;21;21;1;0;0;2;2;1516;0;1524;2;1;
/org.eclipse.jdt.debug/model/org/eclipse/jdt/debug/core/JDIDebugModel.java;6;1;17;1;4;4;4;13;48;1;13;749;208;208;1;0;0;13;17;749;0;6336;17;6;
/org.eclipse.jface.text/src/org/eclipse/jface/text/reconciler/AbstractReconcileStep.java;2;2;7;1;4;3;4;3;27;1;3;1629;39;39;2;0;1;3;7;6353;1;6353;6;2;
/org.eclipse.ltk.core.refactoring/src/org/eclipse/ltk/core/refactoring/participants/DeleteParticipant.java;1;1;4;1;2;2;2;2;19;1;2;4845;48;48;1;0;0;2;4;4845;0;6340;4;1;
/org.eclipse.jdt.core.tests.model/workspace/JavaSearch/src/j1/JavadocInvalidRef.java;1;0;1;1;0;0;0;1;0;0;1;3081;0;0;1;0;0;1;1;3081;0;3081;1;1;
/org.eclipse.ui.intro/src/org/eclipse/ui/intro/internal/presentations/CustomizableIntroPart.java;1;0;10;1;1;1;1;9;302;2;8;4429;373;373;2;1;0;9;10;4724;1;5115;9;1;
/org.eclipse.jface/src/org/eclipse/jface/util/TransferDragSourceListener.java;1;0;1;1;0;0;0;1;0;0;1;179;0;0;1;0;0;1;1;179;0;179;1;1;
/org.eclipse.update.ui/src/org/eclipse/update/internal/ui/parts/Sorter.java;1;0;1;1;0;0;0;1;0;0;1;825;0;0;1;0;0;1;1;825;0;825;1;1;
/org.eclipse.ui.workbench/Eclipse UI/org/eclipse/ui/internal/SaveAllAction.java;3;0;4;1;1;1;1;3;102;1;3;2737;127;127;1;0;0;3;4;2737;0;6338;4;3;
/org.eclipse.ui.workbench/Eclipse UI/org/eclipse/ui/actions/ImportResourcesAction.java;4;0;6;2;3;1;3;3;114;1;3;2737;144;144;3;0;2;3;6;6338;2;6338;4;4;
/org.eclipse.jdt.ui/core refactoring/org/eclipse/ltk/internal/core/refactoring/UndoManager.java;1;0;2;1;0;0;0;2;0;1;2;4575;0;0;1;0;0;2;2;4575;0;4864;2;1;
/org.eclipse.update.ui.forms/Eclipse Forms/org/eclipse/ui/forms/parts/Hyperlink.java;1;0;4;1;0;0;0;4;3;2;2;3096;5;5;2;2;0;4;4;3096;2;3133;2;1;
/org.eclipse.ui.workbench/Eclipse UI/org/eclipse/ui/internal/chris/roles/RoleActivationServiceEvent.java;1;0;4;1;0;0;0;4;8;3;2;1952;8;8;3;2;0;4;4;2202;2;2202;2;1;
/org.eclipse.pde.ui/src_Forms/org/eclipse/pde/internal/ui/neweditor/context/UTF8InputContext.java;2;1;4;1;2;2;2;2;127;1;2;4313;128;128;1;0;0;2;4;4313;0;5431;4;2;
/org.eclipse.help.tests/src/org/eclipse/help/tests/launching/DisplayHelpResource_IHrefResource_topic.java;1;0;1;1;0;0;0;1;0;0;1;2732;0;0;1;0;0;1;1;2732;0;2732;1;1;
/org.eclipse.jface.text/src/org/eclipse/jface/text/source/ILineRestorer.java;1;0;2;1;0;0;0;2;0;1;2;1118;0;0;1;0;0;2;2;1118;0;1214;2;1;
/org.eclipse.debug.core/core/org/eclipse/debug/internal/core/sourcelookup/containers/ProjectSourceContainerType.java;2;0;6;2;1;1;1;5;21;3;2;3678;27;27;3;3;0;5;6;4949;3;5672;3;2;
/org.eclipse.jdt.ui.tests.refactoring/resources/RenameTemp/cannotRename/A_testFail32.java;1;0;1;1;0;0;0;1;0;0;1;3218;0;0;1;0;0;1;1;3218;0;3218;1;1;
/org.eclipse.pde.core/src/org/eclipse/pde/internal/core/ischema/ISchemaCompositor.java;2;1;2;1;2;2;2;0;4;0;0;5799;6;6;1;0;0;0;2;5799;0;6336;2;2;
/org.eclipse.swt/Eclipse SWT/common/org/eclipse/swt/internal/image/PngHuffmanTables.java;1;0;1;1;0;0;0;1;5;0;1;2160;5;5;1;0;0;1;1;2160;0;2160;1;1;
/org.eclipse.ant.ui/Ant Editor/org/eclipse/ant/internal/ui/dtd/IAttribute.java;1;0;1;1;0;0;0;1;0;0;1;1811;0;0;1;0;0;1;1;1811;0;1811;1;1;
/org.eclipse.text/src/org/eclipse/jface/text/templates/TemplateMessages.java;1;1;3;1;2;2;2;1;2;0;1;4259;2;2;1;0;0;1;3;4259;0;5304;3;1;
/org.eclipse.swt.graphics.text/Examples/examples/SetWidthDialog.java;1;0;1;1;0;0;0;1;0;0;1;2937;0;0;1;0;0;1;1;2937;0;2937;1;1;
/org.eclipse.update.ui.forms/src/org/eclipse/update/ui/forms/internal/FormSection.java;2;0;5;1;0;0;0;5;23;1;5;624;45;45;1;0;0;5;5;624;0;1751;5;2;
/org.eclipse.core.tests.resources/src/org/eclipse/core/tests/internal/utils/AllTests.java;2;1;2;1;2;2;2;0;35;0;0;5147;36;36;1;0;0;0;2;5147;0;5445;2;2;
/org.eclipse.core.tests.resources/src/org/eclipse/core/tests/resources/perf/BenchMiscWorkspace.java;1;0;2;1;2;1;2;0;76;0;0;5147;76;76;2;0;1;0;2;5147;1;5147;1;1;
/org.eclipse.jdt.ui/ui/org/eclipse/jdt/internal/ui/text/java/IReconcilingParticipant.java;1;0;2;1;1;1;1;1;2;0;1;4627;4;4;1;0;0;1;2;4627;0;6340;2;1;
/org.eclipse.ui.tests/Eclipse UI Tests/org/eclipse/ui/tests/api/workbenchpart/EmptyView.java;1;0;1;1;1;1;1;0;0;0;0;6101;0;0;1;0;0;0;1;6101;0;6101;1;1;
/org.eclipse.core.tests.resources/src/org/eclipse/core/tests/internal/builders/RefreshLocalJavaFileBuilder.java;1;0;2;1;2;1;2;0;51;0;0;5147;51;51;2;0;1;0;2;5147;1;5147;1;1;
/org.eclipse.jdt.core/search/org/eclipse/jdt/internal/core/search/matching/FieldLocator.java;5;2;21;2;4;3;4;17;65;2;14;1986;282;282;2;3;1;17;21;1986;4;5853;17;5;
/org.eclipse.jdt.core.tests.model/workspace/Converter/test0146/Test.java;1;0;1;1;0;0;0;1;0;0;1;3714;0;0;1;0;0;1;1;3714;0;3714;1;1;
/org.eclipse.swt.tests/JUnit Tests/org/eclipse/swt/tests/junit/Test_org_eclipse_swt_widgets_ToolBar.java;3;0;4;1;1;1;1;3;50;1;3;2123;71;71;1;0;0;3;4;2123;0;6352;4;3;
/org.eclipse.update.core/srcnew/org/eclipse/update/internal/search/UnifiedSiteSearchCategory.java;2;0;3;1;0;0;0;3;23;1;3;672;23;23;1;0;0;3;3;672;0;825;3;2;
/org.eclipse.jdt.core.tests.model/workspace/Formatter/test116/A_out.java;1;0;1;1;0;0;0;1;0;0;1;2425;0;0;1;0;0;1;1;2425;0;2425;1;1;
/org.eclipse.jdt.ui.tests.refactoring/resources/ExtractMethodWorkSpace/ExtractMethodTests/error_in/A_test802.java;1;0;3;1;0;0;0;3;2;1;3;844;2;2;1;0;0;3;3;844;0;1474;3;1;
/org.eclipse.debug.core/core/org/eclipse/debug/internal/core/stringsubstitution/IStringVariable.java;2;0;4;1;0;0;0;4;42;2;3;1118;52;52;2;1;0;4;4;1118;1;2514;3;2;
/org.eclipse.jdt.ui.tests.refactoring/resources/MoveInnerToTopLevel/test_nonstatic_38/out/A.java;1;0;1;1;0;0;0;1;0;0;1;1314;0;0;1;0;0;1;1;1314;0;1314;1;1;
/org.eclipse.jdt.ui/core refactoring/org/eclipse/jdt/internal/corext/refactoring/sef/EncapsulateWriteAccess.java;1;0;1;1;0;0;0;1;0;0;1;1492;0;0;1;0;0;1;1;1492;0;1492;1;1;
/org.eclipse.team.ftp/src/org/eclipse/team/internal/ftp/ui/subscriber/FTPSiteCreationPage.java;2;0;3;1;1;1;1;2;327;1;2;3494;329;329;1;0;0;2;3;3494;0;6337;3;2;
/org.eclipse.debug.ui/ui/org/eclipse/debug/internal/ui/launchConfigurations/LaunchConfigurationPresentationManager.java;3;1;6;1;2;2;2;4;64;1;4;473;83;83;1;0;0;4;6;473;0;6336;6;3;
/org.eclipse.ui.workbench/Eclipse UI/org/eclipse/ui/IReusableEditor.java;3;1;3;1;2;2;2;1;5;0;1;1;11;11;1;0;0;1;3;1;0;6338;3;3;
/org.eclipse.core.tests.resources/src/org/eclipse/core/tests/resources/IResourceDeltaTest.java;1;0;2;1;2;1;2;0;214;0;0;5147;214;214;2;0;1;0;2;5147;1;5147;1;1;
/org.eclipse.core.runtime/src/org/eclipse/core/internal/runtime/PluginConverter.java;1;0;3;1;0;0;0;3;2;2;2;3087;2;2;2;1;0;3;3;3168;1;3168;2;1;
/org.eclipse.core.tests.runtime/src/org/eclipse/core/tests/internal/preferences/IScopeContextTest.java;1;0;1;1;1;1;1;0;0;0;0;5576;0;0;1;0;0;0;1;5576;0;5576;1;1;
/org.eclipse.jdt.core.tests.model/workspace/Converter/src/test0285/Test.java;1;0;1;1;0;0;0;1;0;0;1;3714;0;0;1;0;0;1;1;3714;0;3714;1;1;
/org.eclipse.ant.ui/Ant Editor/org/eclipse/ant/ui/internal/editor/AntEditorSaxDefaultHandler.java;1;0;6;1;0;0;0;6;59;2;5;250;92;92;2;1;0;6;6;264;1;1811;5;1;
/org.eclipse.jdt.ui/ui/org/eclipse/jdt/ui/text/spelling/SpellCheckEngine.java;1;0;2;1;0;0;0;2;0;1;2;3829;0;0;1;0;0;2;2;3829;0;3930;2;1;
/org.eclipse.swt.tests/JUnit Tests/org/eclipse/swt/tests/junit/Test_org_eclipse_swt_printing_Printer.java;2;0;2;1;0;0;0;2;132;1;2;2175;237;237;1;0;0;2;2;2175;0;2473;2;2;
/org.eclipse.update.core/src/org/eclipse/update/core/InstallMonitor.java;2;1;6;1;4;4;4;2;30;1;2;890;53;53;1;0;0;2;6;890;0;6336;6;2;
/org.eclipse.jdt.core.tests.model/workspace/Converter/src/test0553/A.java;1;0;1;1;1;1;1;0;0;0;0;5639;0;0;1;0;0;0;1;5639;0;5639;1;1;
/org.eclipse.jdt.core.tests.model/workspace/Converter/src/javadoc/test004/Test.java;1;0;1;1;0;0;0;1;0;0;1;3792;0;0;1;0;0;1;1;3792;0;3792;1;1;
/org.eclipse.jdt.ui/ui refactoring/org/eclipse/jdt/internal/ui/refactoring/reorg/ReorgMessages.java;2;0;2;1;1;1;1;1;2;0;1;1112;2;2;1;0;0;1;2;1112;0;6340;2;2;
/org.eclipse.jdt.ui/ui/org/eclipse/jdt/ui/actions/FindImplementorsInProjectAction.java;3;1;11;1;4;4;4;7;21;1;7;1670;67;67;1;0;0;7;11;1670;0;6340;11;3;
/org.eclipse.ui.views/src/org/eclipse/ui/views/markers/internal/ActionProblemProperties.java;2;0;2;1;0;0;0;2;0;1;2;755;0;0;1;0;0;2;2;755;0;2738;2;2;
/org.eclipse.jdt.ui/core refactoring/org/eclipse/jdt/internal/corext/refactoring/changes/StatusCodes.java;1;0;2;1;0;0;0;2;0;1;2;3646;0;0;1;0;0;2;2;3646;0;4624;2;1;
/org.eclipse.ui.workbench/Eclipse UI/org/eclipse/ui/wizards/datatransfer/PopulateElementOperation.java;1;0;1;1;0;0;0;1;0;0;1;2737;0;0;1;0;0;1;1;2737;0;2737;1;1;
/org.eclipse.jdt.core.tests.model/workspace/Converter/src/test0282/Test.java;1;0;1;1;0;0;0;1;0;0;1;3714;0;0;1;0;0;1;1;3714;0;3714;1;1;
/org.eclipse.swt.opengl/gtk/org/eclipse/swt/opengl/internal/gtk/XGTK.java;1;0;1;1;0;0;0;1;0;0;1;2143;0;0;1;0;0;1;1;2143;0;2143;1;1;
/org.eclipse.ui.ide/src/org/eclipse/ui/internal/ide/dialogs/ProjectReferencePage.java;5;1;7;1;3;3;3;4;22;1;4;2264;45;45;1;0;0;4;7;2264;0;6338;7;5;
/org.eclipse.swt/Eclipse SWT Custom Widgets/common/org/eclipse/swt/custom/TreeEditor.java;3;1;6;1;2;2;2;4;110;2;3;866;128;128;2;1;0;4;6;923;1;6352;5;3;
/org.eclipse.jdt.ui.tests.refactoring/resources/InlineMethodWorkspace/TestCases/controlStatement_out/TestIfElseTwo.java;2;0;2;1;0;0;0;2;9;1;2;845;13;13;1;0;0;2;2;845;0;1805;2;2;
/org.eclipse.team.examples.filesystem/src/org/eclipse/team/examples/filesystem/subscriber/FileSystemSubscriber.java;2;1;4;1;3;3;3;1;11;0;1;4349;15;15;1;0;0;1;4;4349;0;6337;4;2;
/org.eclipse.jdt.core/compiler/org/eclipse/jdt/internal/compiler/env/ISourceImport.java;2;0;5;1;0;0;0;5;3;1;5;85;9;9;1;0;0;5;5;85;0;4087;5;2;
/org.eclipse.core.runtime.compatibility/src-runtime/org/eclipse/core/internal/plugins/DevClassPathHelper.java;1;0;1;1;1;1;1;0;0;0;0;5254;0;0;1;0;0;0;1;5254;0;5254;1;1;
/org.eclipse.jdt.core.tests.model/workspace/Formatter/test024/A_out.java;1;0;1;1;0;0;0;1;0;0;1;2425;0;0;1;0;0;1;1;2425;0;2425;1;1;
/org.eclipse.jdt.core/model/org/eclipse/jdt/internal/core/util/RuntimeInvisibleParameterAnnotationsAttribute.java;1;0;1;1;0;0;0;1;0;0;1;4466;0;0;1;0;0;1;1;4466;0;4466;1;1;
/org.eclipse.jdt.ui/ui/org/eclipse/jdt/internal/ui/text/HTMLTextPresenter.java;1;0;1;1;1;1;1;0;2;0;0;6340;2;2;1;0;0;0;1;6340;0;6340;1;1;
/org.eclipse.jdt.core.tests.model/workspace/Converter15/src/test0022/X.java;1;0;1;1;0;0;0;1;0;0;1;4828;0;0;1;0;0;1;1;4828;0;4828;1;1;
/org.eclipse.jdt.core.tests.model/workspace/Converter/src/test0147/Test.java;1;0;1;1;0;0;0;1;0;0;1;3714;0;0;1;0;0;1;1;3714;0;3714;1;1;
/org.eclipse.jdt.ui/ui refactoring/org/eclipse/jdt/internal/ui/refactoring/participants/RenameRefactoringAction.java;1;0;3;1;0;0;0;3;4;2;2;591;4;4;2;1;0;3;3;591;1;1047;2;1;
/org.eclipse.team.cvs.ui/src/org/eclipse/team/internal/ccvs/ui/model/PendingUpdateAdapter.java;1;0;1;1;0;0;0;1;0;0;1;961;0;0;1;0;0;1;1;961;0;961;1;1;
/org.eclipse.swt/Eclipse SWT PI/motif/org/eclipse/swt/internal/motif/XWindowAttributes.java;1;0;1;1;0;0;0;1;44;0;1;829;44;44;1;0;0;1;1;829;0;829;1;1;
/org.eclipse.ui.workbench/Eclipse UI/org/eclipse/ui/internal/chris/roles/RoleEvent.java;1;0;4;1;0;0;0;4;8;3;2;1952;8;8;3;2;0;4;4;2202;2;2202;2;1;
/org.eclipse.jdt.ui/core refactoring/org/eclipse/jdt/internal/corext/refactoring/code/ExtractMethodAnalyzer.java;4;1;15;1;3;3;3;12;49;2;11;130;202;202;2;1;0;12;15;1443;1;6340;14;4;
/org.eclipse.pde.core/srcnew/org/eclipse/pde/internal/core/plugin/SourceRange.java;1;0;2;1;1;1;1;1;91;0;1;2906;91;91;1;0;0;1;2;2906;0;5431;2;1;
/org.eclipse.ui.ide/src/org/eclipse/ui/internal/ide/dialogs/MultiStepWizard.java;1;0;1;1;0;0;0;1;0;0;1;2264;0;0;1;0;0;1;1;2264;0;2264;1;1;
/org.eclipse.ui.intro/src/org/eclipse/ui/internal/intro/impl/swt/PageForm.java;2;2;9;1;9;7;9;0;131;0;0;5714;252;252;2;0;2;0;9;5726;2;6280;7;2;
/org.eclipse.jface.text/src/org/eclipse/jface/internal/text/link/contentassist/ContentAssistant2.java;3;1;7;1;3;3;3;4;54;1;4;4214;71;71;1;0;0;4;7;4214;0;6340;7;3;
/org.eclipse.jdt.ui/ui refactoring/org/eclipse/jdt/internal/ui/refactoring/nls/SourceFirstPackageSelectionDialogField.java;3;1;7;1;6;6;6;1;90;0;1;4930;121;121;1;0;0;1;7;4930;0;6340;7;3;
/org.eclipse.ui.editors/src/org/eclipse/ui/internal/editors/text/ColorEditor.java;1;0;1;1;1;1;1;0;2;0;0;6340;2;2;1;0;0;0;1;6340;0;6340;1;1;
/org.eclipse.ant.ui/Ant Editor/org/eclipse/ant/internal/ui/editor/AntEditorSourceViewerConfiguration.java;2;1;19;1;5;5;5;14;86;2;13;1811;345;345;2;1;0;14;19;3916;1;5700;18;2;
/org.eclipse.ant.ui/Ant Tools Support/org/eclipse/ant/ui/internal/views/actions/AddBuildFileAction.java;1;0;3;1;0;0;0;3;10;2;2;263;10;10;2;1;0;3;3;263;1;1811;2;1;
/org.eclipse.ant.ui/Ant Editor/org/eclipse/ant/internal/ui/editor/text/TagRule.java;1;0;4;1;1;1;1;3;61;1;3;1811;71;71;1;0;0;3;4;1811;0;5581;4;1;
/org.eclipse.jdt.core.tests.model/workspace/Converter/src/test0044/Test.java;1;0;1;1;0;0;0;1;0;0;1;3714;0;0;1;0;0;1;1;3714;0;3714;1;1;
/org.eclipse.ui.ide/src/org/eclipse/ui/internal/dialogs/InstallCapabilityStep.java;2;0;3;1;0;0;0;3;4;1;3;1526;4;4;1;0;0;3;3;1526;0;2263;3;2;
/org.eclipse.core.tests.runtime/src/org/eclipse/core/tests/runtime/jobs/TestJob.java;1;0;4;1;0;0;0;4;10;1;4;850;17;17;1;0;0;4;4;850;0;5085;4;1;
/org.eclipse.team.cvs.ui/src/org/eclipse/team/internal/ccvs/ui/actions/TagAction.java;2;1;11;2;3;3;3;8;188;2;7;699;279;279;2;1;0;8;11;990;1;6337;10;2;
/org.eclipse.jdt.core/model/org/eclipse/jdt/core/IJavaElementDelta.java;2;0;6;2;1;1;1;5;47;2;4;1231;83;83;2;1;0;5;6;1231;1;5397;5;2;
/org.eclipse.team.ui/src/org/eclipse/team/ui/sync/actions/OrSyncInfoFilter.java;1;0;1;1;0;0;0;1;0;0;1;2378;0;0;1;0;0;1;1;2378;0;2378;1;1;
/org.eclipse.debug.ui/ui/org/eclipse/debug/ui/sourcelookup/SourceLookupDialog.java;2;1;4;1;2;2;2;2;9;1;2;4953;19;19;1;0;0;2;4;4953;0;5534;4;2;
/org.eclipse.jdt.ui.tests.refactoring/test cases/org/eclipse/jdt/ui/tests/refactoring/ExtractTempTests.java;5;3;25;1;6;4;6;19;1359;2;18;59;2908;2908;3;1;2;19;25;5909;3;6340;22;5;
/org.eclipse.jdt.core/compiler/org/eclipse/jdt/internal/compiler/ast/AnnotationSingleNameReference.java;1;0;3;1;0;0;0;3;15;1;3;2580;15;15;1;0;0;3;3;2580;0;2887;3;1;
/org.eclipse.core.tests.resources/src/org/eclipse/core/tests/resources/session/TestSaveSnap.java;1;0;1;1;1;1;1;0;115;0;0;5147;115;115;1;0;0;0;1;5147;0;5147;1;1;
/org.eclipse.ui.workbench/Eclipse UI/org/eclipse/ui/internal/WorkbenchEditorsAction.java;1;0;1;1;0;0;0;1;51;0;1;2737;51;51;1;0;0;1;1;2737;0;2737;1;1;
/org.eclipse.swt.tools/Preprocessor/org/eclipse/swt/tools/internal/SwtReplace.java;2;0;2;1;0;0;0;2;2;1;2;4175;2;2;1;0;0;2;2;4175;0;4563;2;2;
/org.eclipse.jdt.ui/core refactoring/org/eclipse/jdt/internal/corext/refactoring/participants/xml/FolderPropertyTester.java;1;0;3;1;0;0;0;3;15;1;3;1216;15;15;1;0;0;3;3;1216;0;2546;3;1;
/org.eclipse.jdt.ui.examples.javafamily/src/org/eclipse/jface/text/source/translation/ITagHandler.java;1;0;1;1;1;1;1;0;0;0;0;5122;0;0;1;0;0;0;1;5122;0;5122;1;1;
/org.eclipse.team.ui/src/org/eclipse/team/ui/synchronize/viewers/UnchangedResourceDiffNode.java;1;0;1;1;0;0;0;1;0;0;1;4118;0;0;1;0;0;1;1;4118;0;4118;1;1;
/org.eclipse.jdt.debug.tests/tests/org/eclipse/jdt/debug/tests/core/LineTrackerTests.java;4;1;9;2;2;2;2;7;89;1;7;2119;137;137;1;0;0;7;9;2119;0;6337;9;4;
/org.eclipse.debug.core/core/org/eclipse/debug/internal/core/stringsubstitution/IDynamicVariable.java;2;0;2;1;0;0;0;2;0;1;2;2140;0;0;1;0;0;2;2;2140;0;2514;2;2;
/org.eclipse.jdt.core/search/org/eclipse/jdt/internal/core/index/impl/Field.java;2;0;3;1;0;0;0;3;98;1;3;61;100;100;1;0;0;3;3;61;0;4060;3;2;
/org.eclipse.update.ui.forms/src/org/eclipse/ui/forms/parts/IRichTextHyperlink.java;1;0;2;1;0;0;0;2;0;1;2;2898;0;0;1;0;0;2;2;2898;0;3038;2;1;
/org.eclipse.ui.workbench/Eclipse UI/org/eclipse/ui/internal/intro/IIntroDescriptor.java;1;0;3;1;1;1;1;2;18;1;2;4649;25;25;1;0;0;2;3;4649;0;5489;3;1;
/org.eclipse.jface.text/src/org/eclipse/jface/text/source/LineRange.java;2;1;3;1;3;3;3;0;8;0;0;5099;10;10;1;0;0;0;3;5099;0;6361;3;2;
/org.eclipse.pde.ui/src/org/eclipse/pde/internal/ui/editor/feature/FeatureAdapterFactory.java;1;0;2;1;1;1;1;1;8;0;1;4203;12;12;1;0;0;1;2;4203;0;6336;2;1;
/org.eclipse.swt/Eclipse SWT PI/photon/org/eclipse/swt/internal/photon/PhCursorDef_t.java;1;0;2;1;0;0;0;2;10;0;1;808;10;10;2;1;0;2;2;808;1;808;1;1;
/org.eclipse.ui.workbench/Eclipse UI/org/eclipse/ui/internal/dialogs/AboutPluginsDialog.java;4;0;4;2;2;1;2;2;795;1;2;94;796;796;2;0;1;2;4;5483;1;5483;3;4;
/org.eclipse.pde.ui/src/org/eclipse/pde/internal/ui/view/OpenDependenciesAction.java;1;1;2;1;2;2;2;0;10;0;0;5703;14;14;1;0;0;0;2;5703;0;6336;2;1;
/org.eclipse.jdt.core.tests.model/workspace/Converter/src/test0458/A.java;1;0;1;1;0;0;0;1;0;0;1;3714;0;0;1;0;0;1;1;3714;0;3714;1;1;
/org.eclipse.swt/Eclipse SWT PI/motif/org/eclipse/swt/internal/motif/XConfigureEvent.java;1;0;2;1;0;0;0;2;11;1;2;868;18;18;1;0;0;2;2;868;0;1450;2;1;
/org.eclipse.ui.workbench/Eclipse UI/org/eclipse/ui/internal/themes/CascadingGradientRegistry.java;1;0;2;1;0;0;0;2;0;1;2;4392;0;0;1;0;0;2;2;4392;0;4560;2;1;
/org.eclipse.jdt.debug.ui/ui/org/eclipse/jdt/internal/debug/core/refactoring/LaunchConfigurationMainTypeNameChange.java;3;0;13;1;1;1;1;12;121;2;10;3750;259;259;2;2;0;12;13;3771;2;5515;11;3;
/org.eclipse.ui.workbench/Eclipse UI/org/eclipse/ui/commands/internal/LocalRegistry.java;1;0;2;1;0;0;0;2;0;1;2;786;0;0;1;0;0;2;2;786;0;956;2;1;
/org.eclipse.jdt.core.tests.model/workspace/Formatter/test164/A_out.java;2;0;4;1;0;0;0;4;9;2;3;2425;15;15;2;1;0;4;4;3029;1;3362;3;2;
/org.eclipse.ui.workbench/Eclipse UI/org/eclipse/ui/presentations/IPresentationSerializer.java;1;0;1;1;1;1;1;0;0;0;0;5672;0;0;1;0;0;0;1;5672;0;5672;1;1;
/org.eclipse.jdt.core/search/org/eclipse/jdt/internal/core/search/matching/PatternLocator.java;3;3;23;1;5;3;5;18;42;3;16;1986;248;248;3;2;2;18;23;2005;4;5335;19;3;
/org.eclipse.jdt.ui.tests.refactoring/resources/ChangeSignature/canModify/A_testAdd33_out.java;1;0;1;1;0;0;0;1;2;0;1;2093;2;2;1;0;0;1;1;2093;0;2093;1;1;
/org.eclipse.jdt.core.tests.model/workspace/Converter/src/test0554/B.java;1;0;1;1;1;1;1;0;0;0;0;5639;0;0;1;0;0;0;1;5639;0;5639;1;1;
/org.eclipse.jdt.core.tests.model/workspace/Converter/src/test0185/Test.java;1;0;1;1;0;0;0;1;0;0;1;3714;0;0;1;0;0;1;1;3714;0;3714;1;1;
/org.eclipse.debug.ui/ui/org/eclipse/debug/ui/launchVariables/expanders/FilePromptExpander.java;1;0;2;1;0;0;0;2;0;1;2;562;0;0;1;0;0;2;2;562;0;771;2;1;
/org.eclipse.jdt.ui/ui/org/eclipse/jdt/internal/ui/javaeditor/ToggleCommentAction.java;2;0;4;1;0;0;0;4;211;2;3;3706;235;235;2;1;0;4;4;3706;1;5081;3;2;
/org.eclipse.update.core/src/org/eclipse/update/internal/operations/PatchCleaner.java;1;0;1;1;0;0;0;1;0;0;1;1131;0;0;1;0;0;1;1;1131;0;1131;1;1;
/org.eclipse.jdt.ui.tests.refactoring/resources/MoveInstanceMethod/canMove/test19/in/Shape.java;1;0;1;1;0;0;0;1;0;0;1;1570;0;0;1;0;0;1;1;1570;0;1570;1;1;
/org.eclipse.help/src/org/eclipse/help/internal/util/Resources.java;1;0;3;1;0;0;0;3;37;1;3;105;39;39;1;0;0;3;3;105;0;2732;3;1;
/org.eclipse.team.cvs.core/src/org/eclipse/team/internal/ccvs/core/syncinfo/BaseSynchronizer.java;2;0;8;1;0;0;0;8;48;1;8;532;102;102;1;0;0;8;8;532;0;4216;8;2;
/org.eclipse.debug.ui/ui/org/eclipse/debug/internal/ui/launchConfigurations/LaunchConfigurationTypeContribution.java;1;0;1;1;1;1;1;0;0;0;0;5206;0;0;1;0;0;0;1;5206;0;5206;1;1;
/org.eclipse.jdt.ui.tests.refactoring/resources/ExtractMethodWorkSpace/ExtractMethodTests/return_out/A_test721.java;1;0;1;1;0;0;0;1;4;0;1;844;4;4;1;0;0;1;1;844;0;844;1;1;
/org.eclipse.ui.views/src/org/eclipse/ui/views/markers/internal/Util.java;3;0;3;1;0;0;0;3;2;1;3;755;2;2;1;0;0;3;3;755;0;2738;3;3;
/org.eclipse.jdt.ui.tests.refactoring/resources/Delete/testDeleteWithinCu14/in/A.java;1;0;1;1;0;0;0;1;0;0;1;442;0;0;1;0;0;1;1;442;0;442;1;1;
/org.eclipse.jdt.ui.tests.refactoring/resources/PasteSourceReference/test1/in/B.java;1;0;1;1;0;0;0;1;0;0;1;1311;0;0;1;0;0;1;1;1311;0;1311;1;1;
/org.eclipse.update.core/src/org/eclipse/update/internal/core/FragmentEntry.java;1;1;4;1;2;2;2;2;6;1;2;4135;12;12;1;0;0;2;4;4135;0;6336;4;1;
/org.eclipse.core.tests.runtime/src/org/eclipse/core/tests/runtime/jobs/StatusChecker.java;1;0;5;1;0;0;0;5;35;2;4;2286;38;38;2;1;0;5;5;2824;1;5085;4;1;
/org.eclipse.ui.workbench/Eclipse UI/org/eclipse/ui/internal/activities/CompoundActivityService.java;1;0;4;1;0;0;0;4;19;2;3;2800;20;20;2;1;0;4;4;2800;1;2896;3;1;
/org.eclipse.team.cvs.ui/src/org/eclipse/team/internal/ccvs/ui/wizards/SharingWizardPageActionGroup.java;2;1;4;1;4;4;4;0;81;0;0;5192;154;154;1;0;0;0;4;5192;0;5758;4;2;
/org.eclipse.ui.ide/extensions/org/eclipse/ui/part/FileEditorInput.java;2;0;2;1;0;0;0;2;1;1;2;2263;1;1;1;0;0;2;2;2263;0;2738;2;2;
/org.eclipse.swt/Eclipse SWT Mozilla/common/org/eclipse/swt/internal/mozilla/nsIContentViewer.java;1;0;1;1;0;0;0;1;0;0;1;2663;0;0;1;0;0;1;1;2663;0;2663;1;1;
/org.eclipse.jface.text/src/org/eclipse/jface/text/templates/Template.java;1;0;2;1;0;0;0;2;0;0;1;4258;0;0;2;1;0;2;2;4258;1;4258;1;1;
/org.eclipse.ui.workbench/Eclipse UI/org/eclipse/ui/internal/activities/ActivityDefinition.java;4;0;12;1;1;1;1;11;80;1;11;2444;231;231;1;0;0;11;12;2444;0;6338;12;4;
/org.eclipse.pde.ui/src/org/eclipse/pde/internal/ui/IHelpContextIds.java;2;1;2;1;2;2;2;0;170;0;0;5778;174;174;1;0;0;0;2;5778;0;6336;2;2;
/org.eclipse.debug.ui/ui/org/eclipse/debug/internal/ui/views/memory/MemoryViewTab.java;2;1;5;1;5;5;5;0;38;0;0;5254;94;94;1;0;0;0;5;5254;0;6147;5;2;
/org.eclipse.osgi.tests/src/org/eclipse/osgi/tests/internal/state/AllTests.java;2;1;5;1;4;4;4;1;6;0;1;4705;11;11;1;0;0;1;5;4705;0;5993;5;2;
/org.eclipse.search/search/org/eclipse/search/internal/ui/ScopePart.java;2;1;12;1;2;2;2;10;168;2;9;992;409;409;2;1;0;10;12;1667;1;6340;11;2;
/org.eclipse.jdt.ui.tests.refactoring/resources/InlineMethodWorkspace/TestCases/argument_in/TestLocalReferenceWrite.java;1;0;1;1;0;0;0;1;2;0;1;845;2;2;1;0;0;1;1;845;0;845;1;1;
/org.eclipse.jdt.core.tests.model/workspace/Formatter/test125/A_in.java;1;0;1;1;0;0;0;1;0;0;1;2425;0;0;1;0;0;1;1;2425;0;2425;1;1;
/org.eclipse.core.tools/src/org/eclipse/core/tools/runtime/ActivePluginsViewContentProvider.java;1;0;1;1;1;1;1;0;0;0;0;6302;0;0;1;0;0;0;1;6302;0;6302;1;1;
/org.eclipse.update.core/src/org/eclipse/update/internal/standalone/ListConfigFeaturesCommand.java;1;0;4;1;0;0;0;4;91;2;3;4704;91;91;2;1;0;4;4;4715;1;4928;3;1;
/org.eclipse.jdt.debug/model/org/eclipse/jdt/debug/core/IJavaStratumLineBreakpoint.java;2;1;3;1;2;2;2;1;44;0;1;805;46;46;1;0;0;1;3;805;0;5157;3;2;
/org.eclipse.ui.ide/src/org/eclipse/ui/views/markers/internal/BookmarkView.java;4;0;5;1;1;1;1;4;2;2;3;3260;3;3;2;1;0;4;5;3260;1;6338;4;4;
/org.eclipse.jdt.ui/ui/org/eclipse/jdt/ui/actions/OpenTypeHierarchyAction.java;3;0;3;1;1;1;1;2;10;1;2;592;13;13;1;0;0;2;3;592;0;6340;3;3;
/org.eclipse.core.runtime.osgi/src/org/eclipse/core/internal/runtime/InternalPlatform.java;1;0;2;1;0;0;0;2;95;1;2;3013;95;95;1;0;0;2;2;3013;0;3030;2;1;
/org.eclipse.jdt.core/codeassist/org/eclipse/jdt/internal/codeassist/CompletionEngine.java;6;1;31;2;7;7;7;24;140;2;22;69;571;571;2;2;0;24;31;69;2;6094;29;6;
/org.eclipse.core.tests.resources/src/org/eclipse/core/tests/internal/dtree/DataTreeTest.java;1;0;1;1;1;1;1;0;467;0;0;5147;467;467;1;0;0;0;1;5147;0;5147;1;1;
/org.eclipse.core.resources/src/org/eclipse/core/internal/resources/Resource.java;3;1;29;1;5;5;5;24;2836;2;22;44;3601;3601;2;2;0;24;29;1970;2;6145;27;3;
/org.eclipse.jdt.ui.tests.refactoring/resources/ExtractInterface/testConditional1/out/I.java;1;0;1;1;0;0;0;1;0;0;1;3902;0;0;1;0;0;1;1;3902;0;3902;1;1;
/org.eclipse.team.ui/src/org/eclipse/team/internal/ui/synchronize/actions/SelectWorkingSetAction.java;2;0;4;1;1;1;1;3;75;1;3;2535;76;76;1;0;0;3;4;2535;0;5596;4;2;
/org.eclipse.jdt.core.tests.model/workspace/Converter/junit/awtui/TestRunner.java;1;0;2;1;0;0;0;2;260;1;2;787;260;260;1;0;0;2;2;787;0;3714;2;1;
/org.eclipse.jdt.core/search/org/eclipse/jdt/internal/core/search/IndexSelector.java;2;2;8;1;5;4;5;3;78;1;3;2835;162;162;2;0;1;3;8;5207;1;5728;7;2;
/org.eclipse.core.filebuffers/src/org/eclipse/core/filebuffers/IFileBufferListener.java;2;2;7;2;3;2;3;4;55;1;4;1522;103;103;2;0;1;4;7;6298;1;6340;6;2;
/org.eclipse.jdt.core/model/org/eclipse/jdt/core/util/IClassFileAttribute.java;1;0;1;1;0;0;0;1;2;0;1;3560;2;2;1;0;0;1;1;3560;0;3560;1;1;
/org.eclipse.jdt.core.tests.compiler/src/org/eclipse/jdt/core/tests/compiler/regression/DebugAttributeTest.java;1;0;1;1;0;0;0;1;0;0;1;164;0;0;1;0;0;1;1;164;0;164;1;1;
/org.eclipse.jdt.core/model/org/eclipse/jdt/internal/core/CreateElementInCUOperation.java;3;1;12;1;2;2;2;10;33;2;8;1803;86;86;2;2;0;10;12;3509;2;5916;10;3;
/org.eclipse.help/src/org/eclipse/help/browser/IBrowser.java;1;0;1;1;0;0;0;1;0;0;1;2732;0;0;1;0;0;1;1;2732;0;2732;1;1;
/org.eclipse.swt/Eclipse SWT/emulated/textlayout/org/eclipse/swt/graphics/TextStyle.java;1;0;2;1;0;0;0;2;0;1;2;4565;0;0;1;0;0;2;2;4565;0;4873;2;1;
/org.eclipse.jdt.ui.tests.refactoring/resources/ExtractMethodWorkSpace/ExtractMethodTests/expression_in/A_test601.java;1;0;1;1;0;0;0;1;2;0;1;844;2;2;1;0;0;1;1;844;0;844;1;1;
/org.eclipse.team.ui/src/org/eclipse/team/internal/ui/sync/SyncSet.java;1;0;1;1;0;0;0;1;0;0;1;4216;0;0;1;0;0;1;1;4216;0;4216;1;1;
/org.eclipse.jdt.core.tests.model/workspace/Formatter/test273/A_in.java;1;0;1;1;0;0;0;1;0;0;1;2442;0;0;1;0;0;1;1;2442;0;2442;1;1;
/org.eclipse.ui.externaltools/Ant Editor/org/eclipse/ui/externaltools/internal/ant/editor/text/PlantyProcInstrScanner.java;1;0;1;1;0;0;0;1;0;0;1;178;0;0;1;0;0;1;1;178;0;178;1;1;
/org.eclipse.jdt.ui/core extension/org/eclipse/jdt/internal/corext/template/java/CompilationUnitCompletion.java;1;0;3;1;1;1;1;2;31;1;2;1349;39;39;1;0;0;2;3;1349;0;6340;3;1;
/org.eclipse.jdt.ui.tests.refactoring/resources/ExtractInterface/test98/out/IFoo.java;1;0;1;1;0;0;0;1;0;0;1;1571;0;0;1;0;0;1;1;1571;0;1571;1;1;
/org.eclipse.update.ui/srcnew/org/eclipse/update/internal/ui/views/RevertConfigurationAction.java;2;0;4;1;0;0;0;4;11;1;4;339;21;21;1;0;0;4;4;339;0;825;4;2;
/org.eclipse.core.expressions/src/org/eclipse/core/internal/expressions/EqualsExpression.java;1;0;1;1;0;0;0;1;0;0;1;4629;0;0;1;0;0;1;1;4629;0;4629;1;1;
/org.eclipse.jdt.launching.j9/j9/org/eclipse/jdt/internal/launching/j9/J9DebugVMRunner.java;3;1;11;1;2;2;2;9;372;1;9;345;457;457;1;0;0;9;11;345;0;5744;11;3;
/org.eclipse.team.ui/src/org/eclipse/team/internal/ui/ExportProjectSetMainPage.java;1;0;1;1;0;0;0;1;0;0;1;993;0;0;1;0;0;1;1;993;0;993;1;1;
/org.eclipse.pde.core/src/org/eclipse/pde/internal/core/bundle/BundleFragmentModel.java;1;1;2;1;2;2;2;0;10;0;0;5445;10;10;1;0;0;0;2;5445;0;6336;2;1;
/org.eclipse.update.configurator/src/org/eclipse/update/configurator/IPlatformConfigurationFactory.java;2;1;3;1;2;2;2;1;9;0;1;3014;13;13;1;0;0;1;3;3014;0;6336;3;2;
/org.eclipse.jdt.ui/core refactoring/org/eclipse/jdt/internal/corext/refactoring/typeconstraints/EqualsOperator.java;1;0;3;1;0;0;0;3;2;1;3;64;2;2;1;0;0;3;3;64;0;1600;3;1;
/org.eclipse.ui.workbench/Eclipse UI/org/eclipse/ui/internal/activities/ws/CategorizedActivity.java;3;1;5;1;2;2;2;3;7;1;3;3458;21;21;1;0;0;3;5;3458;0;6338;5;3;
/org.eclipse.ui.workbench/Eclipse UI/org/eclipse/ui/internal/commands/keys/KeySequence.java;1;0;3;1;0;0;0;3;130;1;3;1264;144;144;1;0;0;3;3;1264;0;1294;3;1;
/org.eclipse.update/src/org/eclipse/update/internal/ui/UMWizardPageInstalling.java;1;0;1;1;1;1;1;0;0;0;0;6339;0;0;1;0;0;0;1;6339;0;6339;1;1;
/org.eclipse.compare/compare/org/eclipse/compare/contentmergeviewer/DelayedProgressMonitor.java;1;0;2;1;1;1;1;1;2;0;1;3935;2;2;1;0;0;1;2;3935;0;5920;2;1;
/org.eclipse.text/projection/org/eclipse/jface/text/projection/Fragment.java;1;0;2;1;1;1;1;1;16;0;1;4516;16;16;1;0;0;1;2;4516;0;6301;2;1;
/org.eclipse.ui.views/src/org/eclipse/ui/views/tasklist/TaskSorter.java;1;0;1;1;0;0;0;1;0;0;1;2738;0;0;1;0;0;1;1;2738;0;2738;1;1;
/org.eclipse.jdt.debug.tests/tests/org/eclipse/jdt/debug/tests/eval/NestedTypeFieldValue_304.java;1;0;1;1;0;0;0;1;92;0;1;1274;92;92;1;0;0;1;1;1274;0;1274;1;1;
/org.eclipse.jdt.core.tests.model/workspace/Formatter/test339/A_in.java;1;0;1;1;0;0;0;1;0;0;1;2863;0;0;1;0;0;1;1;2863;0;2863;1;1;
/org.eclipse.jdt.ui/core extension/org/eclipse/jdt/internal/corext/callhierarchy/CallerMethodWrapper.java;3;1;9;1;2;2;2;7;23;2;6;169;62;62;2;1;0;7;9;169;1;6340;8;3;
/org.eclipse.team.ftp/src/org/eclipse/team/internal/ftp/target/FTPRemoteTargetResource.java;2;0;5;1;1;1;1;4;97;1;4;917;162;162;1;0;0;4;5;917;0;6337;5;2;
/org.eclipse.core.resources/src/org/eclipse/core/resources/IStorage.java;1;0;2;1;1;1;1;1;83;0;1;4994;85;85;1;0;0;1;2;4994;0;5146;2;1;
/org.eclipse.update.core/src/org/eclipse/update/core/IFeature.java;4;1;5;2;2;2;2;3;17;2;2;0;32;32;2;1;0;3;5;0;1;5423;4;4;
/org.eclipse.team.ui/src/org/eclipse/team/ui/synchronize/subscribers/DirectionFilterActionGroup.java;2;0;2;1;1;1;1;1;0;0;1;4632;0;0;1;0;0;1;2;4632;0;5358;2;2;
/org.eclipse.core.tests.runtime/src/org/eclipse/core/tests/internal/plugins/ActivationTest_DirectPluginRef.java;1;0;1;1;0;0;0;1;0;0;1;3014;0;0;1;0;0;1;1;3014;0;3014;1;1;
/org.eclipse.core.tests.resources/src/org/eclipse/core/tests/resources/usecase/Snapshot1Test.java;1;0;2;1;2;1;2;0;155;0;0;5147;155;155;2;0;1;0;2;5147;1;5147;1;1;
/org.eclipse.core.resources/src/org/eclipse/core/resources/WorkspaceJob.java;2;1;6;1;2;2;2;4;66;1;4;1133;80;80;1;0;0;4;6;1133;0;5977;6;2;
/org.eclipse.ui.workbench/Eclipse UI/org/eclipse/ui/internal/progress/AnimationItem.java;4;1;42;1;3;3;3;39;483;3;28;1079;2094;2094;3;11;0;39;42;4305;11;6338;31;4;
/org.eclipse.help/src/org/eclipse/help/internal/browser/BrowserLog.java;1;0;1;1;0;0;0;1;0;0;1;2732;0;0;1;0;0;1;1;2732;0;2732;1;1;
/org.eclipse.jdt.debug.ui/ui/org/eclipse/jdt/internal/debug/core/refactoring/JavaWatchpointTypeChange.java;2;1;4;1;4;4;4;0;14;0;0;5319;31;31;1;0;0;0;4;5319;0;6339;4;2;
/org.eclipse.jdt.core.tests.model/workspace/Converter/test0079/Test.java;1;0;1;1;0;0;0;1;0;0;1;3714;0;0;1;0;0;1;1;3714;0;3714;1;1;
/org.eclipse.osgi/resolver/src/org/eclipse/osgi/internal/resolver/StateMsg.java;3;1;3;1;2;2;2;1;5;0;1;3697;7;7;1;0;0;1;3;3697;0;5232;3;3;
/org.eclipse.swt/Eclipse SWT Drag and Drop/carbon/org/eclipse/swt/dnd/FileTransfer.java;1;0;3;1;0;0;0;3;180;2;2;298;184;184;2;1;0;3;3;298;1;440;2;1;
/org.eclipse.pde.core/src/org/eclipse/pde/internal/core/plugin/Extensions.java;3;2;9;1;5;4;5;4;14;1;4;2184;40;40;2;0;1;4;9;5799;1;6336;8;3;
/org.eclipse.jdt.core.tests.model/workspace/Formatter/test405/A_out.java;1;0;1;1;0;0;0;1;0;0;1;3438;0;0;1;0;0;1;1;3438;0;3438;1;1;
/org.eclipse.pde.ui/src_Forms/org/eclipse/pde/internal/ui/neweditor/build/BuildUndoManager.java;2;1;2;1;2;2;2;0;0;0;0;5391;0;0;1;0;0;0;2;5391;0;5431;2;2;
/org.eclipse.jdt.core.tests.model/workspace/Converter/test0385/A.java;1;0;1;1;0;0;0;1;0;0;1;3714;0;0;1;0;0;1;1;3714;0;3714;1;1;
/org.eclipse.core.runtime.compatibility/src-runtime/org/eclipse/core/internal/plugins/CompatibilityActivator.java;3;1;6;1;4;4;4;2;4;1;2;3203;12;12;1;0;0;2;6;3203;0;6340;6;3;
/org.eclipse.ui.workbench/Eclipse UI/org/eclipse/ui/internal/chris/roles/api/IRoleEvent.java;1;0;2;1;0;0;0;2;0;0;1;2207;0;0;2;1;0;2;2;2207;1;2207;1;1;
/org.eclipse.core.runtime/src/org/eclipse/core/internal/content/LazyReader.java;1;0;1;1;1;1;1;0;0;0;0;6225;0;0;1;0;0;0;1;6225;0;6225;1;1;
/org.eclipse.jdt.core.tests.model/workspace/Converter/test0371/A.java;1;0;1;1;0;0;0;1;0;0;1;3714;0;0;1;0;0;1;1;3714;0;3714;1;1;
/org.eclipse.ui.views/src/org/eclipse/ui/views/markers/internal/FiltersAction.java;3;0;3;1;0;0;0;3;1;1;3;755;1;1;1;0;0;3;3;755;0;2738;3;3;
/org.eclipse.pde.ui/src/org/eclipse/pde/internal/ui/wizards/templates/ViewNewWizard.java;3;1;6;1;4;4;4;2;12;1;2;3986;31;31;1;0;0;2;6;3986;0;6336;6;3;
/org.eclipse.swt.opengl/win32/org/eclipse/swt/opengl/internal/win32/LAYERPLANEDESCRIPTOR.java;1;0;1;1;0;0;0;1;0;0;1;1175;0;0;1;0;0;1;1;1175;0;1175;1;1;
/org.eclipse.team.core/src/org/eclipse/team/internal/core/subscribers/caches/SynchronizationSyncBytesCache.java;1;0;1;1;0;0;0;1;0;0;1;3966;0;0;1;0;0;1;1;3966;0;3966;1;1;
/org.eclipse.ui.workbench/Eclipse UI/org/eclipse/ui/application/WorkbenchAdvisor.java;5;2;19;2;8;6;8;11;95;2;10;2901;366;366;2;1;2;11;19;4952;3;6338;16;5;
/org.eclipse.ui.workbench/Eclipse UI/org/eclipse/ui/internal/dialogs/WorkingSetTypePage.java;1;0;1;1;0;0;0;1;2;0;1;2737;2;2;1;0;0;1;1;2737;0;2737;1;1;
/org.eclipse.jdt.ui/ui/org/eclipse/jdt/internal/ui/compare/JavaCompareUtilities.java;5;0;9;1;1;1;1;8;41;2;7;1289;123;123;2;1;0;8;9;4043;1;5377;8;5;
/org.eclipse.core.runtime/src/org/eclipse/core/runtime/jobs/ILock.java;3;1;11;2;2;2;2;9;186;2;8;351;526;526;2;1;0;9;11;5083;1;5976;10;3;
/org.eclipse.ui.workbench/Eclipse UI/org/eclipse/ui/internal/csm/activities/IActivityRegistry.java;1;0;4;1;0;0;0;4;30;1;4;2225;32;32;1;0;0;4;4;2225;0;2444;4;1;
/org.eclipse.jdt.debug/jdi/org/eclipse/jdi/internal/spy/JdwpCommandPacket.java;1;0;1;1;0;0;0;1;11;0;1;4267;11;11;1;0;0;1;1;4267;0;4267;1;1;
/org.eclipse.jdt.ui.tests.refactoring/resources/ChangeSignature/canModify/A_testAll57_out.java;1;0;1;1;0;0;0;1;0;0;1;1095;0;0;1;0;0;1;1;1095;0;1095;1;1;
/org.eclipse.pde.core/src/org/eclipse/pde/internal/core/FileAdapter.java;2;1;4;1;3;3;3;1;6;0;1;4203;16;16;1;0;0;1;4;4203;0;6336;4;2;
/org.eclipse.jdt.ui.tests.refactoring/resources/ExtractMethodWorkSpace/ExtractMethodTests/expression_in/A_test600.java;1;0;1;1;0;0;0;1;2;0;1;844;2;2;1;0;0;1;1;844;0;844;1;1;
/org.eclipse.update.core/src/org/eclipse/update/internal/core/URLKey.java;1;0;1;1;0;0;0;1;2;0;1;890;2;2;1;0;0;1;1;890;0;890;1;1;
/org.eclipse.ui.tests/Eclipse UI Tests/org/eclipse/ui/tests/api/IWorkingSetManagerTest.java;1;0;2;1;0;0;0;2;10;1;2;3091;14;14;1;0;0;2;2;3091;0;3206;2;1;
/org.eclipse.debug.ui/ui/org/eclipse/debug/ui/IDebugView.java;3;0;4;2;2;1;2;2;12;1;2;1240;32;32;2;0;1;2;4;6335;1;6335;3;3;
/org.eclipse.pde.core/srcnew/org/eclipse/pde/internal/core/plugin/PluginDocumentNode.java;1;0;2;1;1;1;1;1;28;0;1;2906;28;28;1;0;0;1;2;2906;0;5431;2;1;
/org.eclipse.ui.tests/Eclipse UI Tests/org/eclipse/ui/tests/adaptable/TestAdaptableWorkbenchAdapter.java;2;0;3;1;1;1;1;2;15;1;2;4064;32;32;1;0;0;2;3;4064;0;6338;3;2;
/org.eclipse.team.tests.cvs.core/src/org/eclipse/team/tests/ccvs/core/provider/LinkResourcesTest.java;1;0;2;1;0;0;0;2;7;1;2;1933;9;9;1;0;0;2;2;1933;0;2761;2;1;
/org.eclipse.swt/Eclipse SWT/motif/org/eclipse/swt/widgets/Menu.java;5;1;10;1;2;2;2;8;21;1;8;33;57;57;1;0;0;8;10;33;0;6352;10;5;
/org.eclipse.ui.workbench/Eclipse UI/org/eclipse/ui/activities/IActivityServiceEvent.java;1;0;2;1;0;0;0;2;0;1;2;2491;0;0;1;0;0;2;2;2491;0;2728;2;1;
/org.eclipse.ant.tests.ui/test plugin/org/eclipse/ant/tests/ui/testplugin/AntUITestPlugin.java;1;1;3;1;2;2;2;1;9;0;1;1388;13;13;1;0;0;1;3;1388;0;6336;3;1;
/org.eclipse.jdt.launching/launching/org/eclipse/jdt/launching/VMRunnerConfiguration.java;5;1;13;2;2;2;2;11;135;2;9;232;358;358;2;2;0;11;13;2606;2;6336;11;5;
/org.eclipse.jdt.core.tests.model/workspace/Resolve/src/ResolveLocalMemberTypeDeclaration1.java;1;0;1;1;0;0;0;1;0;0;1;1970;0;0;1;0;0;1;1;1970;0;1970;1;1;
/org.eclipse.jdt.launching/launching/org/eclipse/jdt/launching/JavaRuntime.java;5;2;29;2;8;7;8;21;293;3;16;112;743;743;3;5;1;21;29;4972;6;6336;23;5;
/org.eclipse.pde.ui/src/org/eclipse/pde/internal/ui/util/PixelConverter.java;1;0;1;1;0;0;0;1;1;0;1;368;1;1;1;0;0;1;1;368;0;368;1;1;
/org.eclipse.jdt.core/codeassist/org/eclipse/jdt/internal/codeassist/complete/CompletionOnImportReference.java;2;0;3;1;0;0;0;3;14;1;3;85;20;20;1;0;0;3;3;85;0;3560;3;2;
/org.eclipse.jdt.ui/ui/org/eclipse/jdt/internal/ui/actions/CompositeActionGroup.java;1;0;1;1;1;1;1;0;2;0;0;6340;2;2;1;0;0;0;1;6340;0;6340;1;1;
/org.eclipse.swt/Eclipse SWT Custom Widgets/common/org/eclipse/swt/custom/CTabFolder2Adapter.java;2;1;4;1;3;3;3;1;41;0;1;4232;55;55;1;0;0;1;4;4232;0;6352;4;2;
/org.eclipse.jdt.core/model/org/eclipse/jdt/core/jdom/IDOMInitializer.java;2;0;3;1;1;1;1;2;4;1;2;3560;9;9;1;0;0;2;3;3560;0;5584;3;2;
/org.eclipse.osgi/defaultAdaptor/src/org/eclipse/osgi/framework/adaptor/core/BundleFile.java;3;1;10;1;4;4;4;6;93;1;6;4336;230;230;1;0;0;6;10;4336;0;5806;10;3;
/org.eclipse.jface/src/org/eclipse/jface/instrumentation/IInstrumentationMenuListener.java;1;0;2;1;0;0;0;2;0;1;2;1634;0;0;1;0;0;2;2;1634;0;1674;2;1;
/org.eclipse.ui.ide/src/org/eclipse/ui/views/markers/internal/ProblemMarker.java;3;1;3;1;2;2;2;1;10;0;1;3214;12;12;1;0;0;1;3;3214;0;6338;3;3;
/org.eclipse.jdt.ui.tests.refactoring/resources/ExtractMethodWorkSpace/ExtractMethodTests/return_in/A_test703.java;1;0;1;1;0;0;0;1;4;0;1;844;4;4;1;0;0;1;1;844;0;844;1;1;
/org.eclipse.ui.examples.job/org/eclipse/ui/examples/jobs/views/ProgressExampleAdapterFactory.java;1;0;2;1;2;1;2;0;0;0;0;5125;0;0;2;0;1;0;2;5125;1;5125;1;1;
/org.eclipse.jdt.core.tests.model/workspace/Converter/test0088/Test.java;1;0;1;1;0;0;0;1;0;0;1;3714;0;0;1;0;0;1;1;3714;0;3714;1;1;
/org.eclipse.ui.ide/src/org/eclipse/ui/views/markers/internal/DialogBookmarkFilter.java;1;0;1;1;0;0;0;1;0;0;1;2208;0;0;1;0;0;1;1;2208;0;2208;1;1;
/org.eclipse.pde.core/src/org/eclipse/pde/internal/core/ibundle/IBundleModel.java;1;1;3;1;3;3;3;0;11;0;0;5445;17;17;1;0;0;0;3;5445;0;6336;3;1;
/org.eclipse.jdt.core.tests.compiler/src/org/eclipse/jdt/core/tests/compiler/regression/ArrayTest.java;3;0;3;1;0;0;0;3;13;1;3;1785;15;15;1;0;0;3;3;1785;0;5062;3;3;
/org.eclipse.jdt.ui.tests.refactoring/resources/SefWorkSpace/SefTests/base_out/TestFinal.java;1;0;1;1;0;0;0;1;0;0;1;2263;0;0;1;0;0;1;1;2263;0;2263;1;1;
/org.eclipse.core.runtime.compatibility/src-model/org/eclipse/core/internal/model/PluginMap.java;2;1;3;1;2;2;2;1;16;0;1;3013;18;18;1;0;0;1;3;3013;0;6340;3;2;
/org.eclipse.update.tests.core/src/org/eclipse/update/tests/UpdateManagerTestCase.java;2;0;5;1;1;1;1;4;9;2;3;2048;18;18;2;1;0;4;5;2521;1;6336;4;2;
/org.eclipse.jdt.ui.tests/ui/org/eclipse/jdt/ui/tests/core/AddUnimplementedConstructorsTest.java;4;1;15;1;6;6;6;9;948;2;8;1183;1162;1162;2;1;0;9;15;2273;1;6340;14;4;
/org.eclipse.ui.workbench/Eclipse UI/org/eclipse/ui/wizards/datatransfer/WizardZipFileResourceExportPage1.java;2;0;2;1;0;0;0;2;3;1;2;1336;3;3;1;0;0;2;2;1336;0;2737;2;2;
/org.eclipse.jdt.core.tests.compiler/src/org/eclipse/jdt/core/tests/compiler/regression/AnnotationTest.java;3;0;6;1;0;0;0;6;258;1;6;1826;273;273;1;0;0;6;6;1826;0;2887;6;3;
/org.eclipse.team.tests.cvs.core/src/org/eclipse/team/tests/ccvs/ui/CompareOperationTests.java;2;0;5;1;1;1;1;4;20;1;4;2632;34;34;1;0;0;4;5;2632;0;6337;5;2;
/org.eclipse.ant.ui/Ant Editor/org/eclipse/ant/ui/internal/dtd/util/MapHolder.java;1;0;2;1;0;0;0;2;0;1;2;250;0;0;1;0;0;2;2;250;0;1811;2;1;
/org.eclipse.jdt.core.tests.model/workspace/Converter/test0084/Test.java;1;0;1;1;0;0;0;1;0;0;1;3714;0;0;1;0;0;1;1;3714;0;3714;1;1;
/org.eclipse.team.core/src/org/eclipse/team/internal/core/target/IRemoteTargetResource.java;1;0;1;1;0;0;0;1;0;0;1;2495;0;0;1;0;0;1;1;2495;0;2495;1;1;
/org.eclipse.jdt.ui/ui/org/eclipse/jdt/internal/ui/wizards/TypedViewerFilter.java;2;1;2;1;2;2;2;0;2;0;0;5207;4;4;1;0;0;0;2;5207;0;6340;2;2;
/org.eclipse.update.ui/srcnew/org/eclipse/update/internal/ui/wizards/MultiOptionalFeaturesPage2.java;2;0;5;1;0;0;0;5;39;1;5;367;48;48;1;0;0;5;5;367;0;479;5;2;
/org.eclipse.swt/Eclipse SWT Custom Widgets/common/org/eclipse/swt/custom/CTabFolderExpandListener.java;1;0;3;1;0;0;0;3;24;1;3;2641;24;24;1;0;0;3;3;2641;0;3812;3;1;
/org.eclipse.update.core/src/org/eclipse/update/core/model/DefaultSiteParser.java;2;2;12;1;5;4;5;7;92;2;6;890;190;190;2;1;1;7;12;1671;2;6336;10;2;
/org.eclipse.ui.workbench/Eclipse UI/org/eclipse/ui/keys/IKeyConfiguration.java;1;0;2;1;0;0;0;2;0;1;2;1294;0;0;1;0;0;2;2;1294;0;1321;2;1;
/org.eclipse.jface/src/org/eclipse/jface/dialogs/ControlEnableState.java;2;1;3;1;3;3;3;0;184;0;0;5357;193;193;1;0;0;0;3;5357;0;6338;3;2;
/org.eclipse.ant.ui/Ant Editor/org/eclipse/ant/internal/ui/editor/ValidateBuildfileAction.java;1;0;2;1;0;0;0;2;0;1;2;3835;0;0;1;0;0;2;2;3835;0;4569;2;1;
/org.eclipse.osgi/eclipseAdaptor/src/org/eclipse/core/runtime/adaptor/EnvironmentInfo.java;4;1;8;1;4;4;4;4;39;1;4;3013;83;83;1;0;0;4;8;3013;0;6337;8;4;
/org.eclipse.ui.console/src/org/eclipse/ui/console/AbstractConsole.java;1;0;3;1;0;0;0;3;14;1;3;1988;18;18;1;0;0;3;3;1988;0;3569;3;1;
/org.eclipse.ui.ide/src/org/eclipse/ui/internal/dialogs/MultiStepWizard.java;2;0;3;1;0;0;0;3;4;1;3;1526;4;4;1;0;0;3;3;1526;0;2263;3;2;
/org.eclipse.pde.ui/sandbox/org/eclipse/pde/internal/ui/editor/standalone/manifest/PluginSourceContentProvider.java;1;0;2;1;0;0;0;2;0;1;2;2320;0;0;1;0;0;2;2;2320;0;2906;2;1;
/org.eclipse.pde.ui/src_Forms/org/eclipse/pde/internal/ui/neweditor/schema/SchemaContentProvider.java;2;0;2;1;1;1;1;1;0;0;1;4856;0;0;1;0;0;1;2;4856;0;5431;2;2;
/org.eclipse.jdt.core.tests.model/workspace/Converter/src/test0555/B.java;1;0;1;1;1;1;1;0;0;0;0;5641;0;0;1;0;0;0;1;5641;0;5641;1;1;
/org.eclipse.text/src/org/eclipse/text/edits/TextEditVisitor.java;1;1;3;1;2;2;2;1;42;0;1;2598;44;44;1;0;0;1;3;2598;0;6340;3;1;
/org.eclipse.ui.editors/src/org/eclipse/ui/internal/editors/quickdiff/compare/rangedifferencer/ITokenComparator.java;2;0;2;1;0;0;0;2;0;1;2;1118;0;0;1;0;0;2;2;1118;0;1644;2;2;
/org.eclipse.update.ui.forms/Eclipse Forms/org/eclipse/ui/forms/events/ExpansionAdapter.java;1;0;2;1;0;0;0;2;0;1;2;3096;0;0;1;0;0;2;2;3096;0;4157;2;1;
/org.eclipse.jdt.ui/core extension/org/eclipse/jdt/internal/corext/codemanipulation/IImportsStructure.java;2;1;2;1;2;2;2;0;12;0;0;5860;14;14;1;0;0;0;2;5860;0;6340;2;2;
/org.eclipse.ui.workbench/Eclipse UI/org/eclipse/ui/internal/commands/LocalRegistry.java;1;0;4;1;0;0;0;4;14;1;4;607;14;14;1;0;0;4;4;607;0;1077;4;1;
/org.eclipse.jdt.core.tests.model/workspace/Converter/test0481/A.java;1;0;2;1;0;0;0;2;0;1;2;1289;0;0;1;0;0;2;2;1289;0;3714;2;1;
/org.eclipse.jdt.core/compiler/org/eclipse/jdt/internal/compiler/parser/JavadocParser.java;3;2;19;2;5;4;5;14;1031;2;12;2887;2023;2023;2;2;1;14;19;3762;3;6119;16;3;
/org.eclipse.jdt.ui/core refactoring/org/eclipse/ltk/core/refactoring/participants/CopyArguments.java;1;0;2;1;0;0;0;2;0;1;2;4624;0;0;1;0;0;2;2;4624;0;4864;2;1;
/org.eclipse.team.webdav/src/org/eclipse/team/core/target/GetOperation.java;1;0;1;1;0;0;0;1;0;0;1;3387;0;0;1;0;0;1;1;3387;0;3387;1;1;
/org.eclipse.core.tests.harness/src/org/eclipse/core/tests/harness/FussyProgressMonitor.java;2;0;4;1;1;1;1;3;228;1;3;698;286;286;1;0;0;3;4;698;0;5146;4;2;
/org.eclipse.osgi/core/framework/org/eclipse/osgi/framework/internal/core/Msg.java;4;1;4;1;2;2;2;2;14;1;2;3013;25;25;1;0;0;2;4;3013;0;5232;4;4;
/org.eclipse.jdt.ui/ui/org/eclipse/jdt/internal/ui/browsing/PackagesViewTableViewer.java;1;0;1;1;1;1;1;0;2;0;0;6340;2;2;1;0;0;0;1;6340;0;6340;1;1;
/org.eclipse.jdt.ui/core refactoring/org/eclipse/ltk/internal/refactoring/core/DelegatingValidationStateChange.java;1;0;3;1;0;0;0;3;14;1;3;3708;14;14;1;0;0;3;3;3708;0;4510;3;1;
/org.eclipse.jdt.core.tests.model/workspace/Converter/src/Test0170.java;1;0;1;1;0;0;0;1;0;0;1;3714;0;0;1;0;0;1;1;3714;0;3714;1;1;
/org.eclipse.jdt.core.tests.model/workspace/Converter/test0149/Test.java;1;0;1;1;0;0;0;1;0;0;1;3714;0;0;1;0;0;1;1;3714;0;3714;1;1;
/org.eclipse.update.tests.core/src/org/eclipse/update/tests/regularInstall/TestLocalSite.java;2;1;6;1;2;2;2;4;46;1;4;3813;132;132;1;0;0;4;6;3813;0;6336;6;2;
/org.eclipse.swt/Eclipse SWT/photon/org/eclipse/swt/widgets/ScrollBar.java;4;1;7;1;2;2;2;5;37;1;5;19;136;136;1;0;0;5;7;19;0;6352;7;4;
/org.eclipse.debug.core/core/org/eclipse/debug/core/DebugEvent.java;2;0;3;1;0;0;0;3;54;1;3;995;70;70;1;0;0;3;3;995;0;1938;3;2;
/org.eclipse.ui.workbench/Eclipse UI/org/eclipse/ui/internal/LayoutTreeNode.java;5;1;9;1;5;5;5;4;109;1;4;4015;277;277;1;0;0;4;9;4015;0;6338;9;5;
/org.eclipse.jdt.launching/launching/org/eclipse/jdt/internal/launching/VariableClasspathResolver.java;2;0;2;1;0;0;0;2;15;1;2;4972;15;15;1;0;0;2;2;4972;0;4983;2;2;
/org.eclipse.ui.externaltools/Ant Tools Support/org/eclipse/ui/externaltools/internal/ant/preferences/AntTasksPage.java;1;0;2;1;0;0;0;2;4;1;2;253;4;4;1;0;0;2;2;253;0;298;2;1;
/org.eclipse.ui.tests/Eclipse RCP Tests/org/eclipse/ui/rcp/tests/ActionBarConfigurerTest.java;1;0;1;1;0;0;0;1;0;0;1;4930;0;0;1;0;0;1;1;4930;0;4930;1;1;
/org.eclipse.ui.tests/Eclipse UI Tests/org/eclipse/ui/tests/keys/Bug53489Test.java;2;0;2;1;1;1;1;1;4;0;1;4328;4;4;1;0;0;1;2;4328;0;6338;2;2;
/org.eclipse.core.filebuffers/src/org/eclipse/core/internal/filebuffers/TextFileBufferManager.java;3;1;10;1;3;3;3;7;175;1;7;1522;453;453;1;0;0;7;10;1522;0;6340;10;3;
/org.eclipse.debug.core/core/org/eclipse/debug/internal/core/ContributedDelegate.java;2;1;3;1;2;2;2;1;11;0;1;463;15;15;1;0;0;1;3;463;0;6336;3;2;
/org.eclipse.debug.ui/ui/org/eclipse/debug/internal/ui/actions/AbstractDebugActionDelegate.java;1;0;1;1;0;0;0;1;12;0;1;1610;12;12;1;0;0;1;1;1610;0;1610;1;1;
/org.eclipse.team.ui/src/org/eclipse/team/internal/ui/registry/ISynchronizeParticipantDescriptor.java;1;0;1;1;0;0;0;1;0;0;1;2610;0;0;1;0;0;1;1;2610;0;2610;1;1;
/org.eclipse.debug.core/core/org/eclipse/debug/internal/core/variables/SimpleLaunchVariableRegistry.java;3;0;8;1;0;0;0;8;37;2;7;754;68;68;2;1;0;8;8;848;1;2120;7;3;
/org.eclipse.ui.examples.job/src/org/eclipse/ui/examples/jobs/views/JobsView.java;3;2;10;1;10;9;10;0;253;0;0;5126;745;745;2;0;1;0;10;5126;1;6316;9;3;
/org.eclipse.ui.workbench/Eclipse UI/org/eclipse/ui/internal/keys/KeySequenceText.java;4;0;24;1;1;1;1;23;804;3;18;1714;1885;1885;3;5;0;23;24;1714;5;6338;19;4;
/org.eclipse.core.runtime.osgi/src/org/eclipse/core/internal/registry/RegistryCacheReader.java;2;0;3;2;0;0;0;3;33;2;2;3013;33;33;2;1;0;3;3;3030;1;3030;2;2;
/org.eclipse.pde.ui/src_Forms/org/eclipse/pde/internal/ui/neweditor/PDEFormEditorContributor.java;2;0;7;1;1;1;1;6;199;2;5;3812;226;226;2;1;0;6;7;4491;1;5431;6;2;
/org.eclipse.jdt.core.tests.model/workspace/Formatter/test354/A_in.java;1;0;2;1;0;0;0;2;3;1;2;3033;3;3;1;0;0;2;2;3033;0;3086;2;1;
/org.eclipse.update.ui.win32/src/org/eclipse/welcome/internal/WebBrowser.java;1;0;2;1;0;0;0;2;0;1;2;889;0;0;1;0;0;2;2;889;0;907;2;1;
/org.eclipse.jdt.ui.tests.refactoring/resources/ExtractMethodWorkSpace/ExtractMethodTests/duplicates_out/A_test955.java;1;0;1;1;0;0;0;1;0;0;1;1442;0;0;1;0;0;1;1;1442;0;1442;1;1;
/org.eclipse.core.runtime.osgi/src/org/eclipse/core/internal/registry/ExtensionPoint.java;2;0;5;2;0;0;0;5;60;4;2;3013;60;60;4;3;0;5;5;3030;3;3030;2;2;
/org.eclipse.core.tests.runtime/src/org/eclipse/core/tests/internal/plugins/SoftPrereqTest_7.java;1;0;1;1;0;0;0;1;0;0;1;3014;0;0;1;0;0;1;1;3014;0;3014;1;1;
/org.eclipse.jdt.ui.tests.refactoring/resources/MoveInstanceMethod/canMove/test21/out/A.java;1;0;1;1;0;0;0;1;0;0;1;1603;0;0;1;0;0;1;1;1603;0;1603;1;1;
/org.eclipse.swt/Eclipse SWT/photon/org/eclipse/swt/widgets/Monitor.java;1;0;3;1;0;0;0;3;9;2;2;21;9;9;2;1;0;3;3;29;1;29;2;1;
/org.eclipse.team.cvs.ui/src/org/eclipse/team/internal/ccvs/ui/model/DateTagCategory.java;2;1;5;1;3;3;3;2;61;1;2;2569;70;70;1;0;0;2;5;2569;0;6337;5;2;
/org.eclipse.jface.text/src/org/eclipse/jface/text/source/ISourceViewer.java;2;1;5;1;2;2;2;3;47;1;3;3940;67;67;1;0;0;3;5;3940;0;6361;5;2;
/org.eclipse.ant.ui/Ant Tools Support/org/eclipse/ant/internal/ui/launchConfigurations/AntRunActionDelegate.java;2;0;2;1;1;1;1;1;0;0;1;1811;0;0;1;0;0;1;2;1811;0;5447;2;2;
/org.eclipse.jdt.core.tests.model/workspace/Completion/src3/test0012/Test.java;1;0;1;1;1;1;1;0;0;0;0;5181;0;0;1;0;0;0;1;5181;0;5181;1;1;
/org.eclipse.swt/Eclipse SWT Mozilla/common/org/eclipse/swt/internal/mozilla/nsIDirectoryServiceProvider2.java;1;0;2;1;0;0;0;2;22;1;2;1654;22;22;1;0;0;2;2;1654;0;2568;2;1;
/org.eclipse.text/src/org/eclipse/jface/text/templates/SimpleTemplateVariable.java;1;0;2;1;0;0;0;2;0;1;2;4259;0;0;1;0;0;2;2;4259;0;4382;2;1;
/org.eclipse.pde.ui/src/org/eclipse/pde/internal/ui/editor/PDEMultiPageXMLEditor.java;2;0;2;1;1;1;1;1;8;0;1;3795;8;8;1;0;0;1;2;3795;0;5431;2;2;
/org.eclipse.jdt.ui.tests.refactoring/resources/IntroduceParameter/simple/out/Javadoc1.java;1;0;1;1;1;1;1;0;0;0;0;5851;0;0;1;0;0;0;1;5851;0;5851;1;1;
/org.eclipse.jdt.ui/ui/org/eclipse/jdt/internal/ui/search/QuerySpecification.java;1;0;4;1;2;1;2;2;3;1;2;4625;5;5;2;0;1;2;4;5396;1;5396;3;1;
/org.eclipse.jdt.core.tests.model/workspace/Resolve/src/ResolveDuplicateFieldDeclaration.java;1;0;1;1;1;1;1;0;0;0;0;6222;0;0;1;0;0;0;1;6222;0;6222;1;1;
/org.eclipse.ui/src/org/eclipse/ui/internal/UIPreferenceInitializer.java;3;1;8;1;8;8;8;0;7;0;0;5321;28;28;1;0;0;0;8;5321;0;6338;8;3;
/org.eclipse.jdt.core/codeassist/org/eclipse/jdt/internal/codeassist/IExtendedCompletionRequestor.java;1;0;1;1;1;1;1;0;0;0;0;5456;0;0;1;0;0;0;1;5456;0;5456;1;1;
/org.eclipse.ltk.core.refactoring/src/org/eclipse/ltk/core/refactoring/participants/CreateArguments.java;1;1;4;1;2;2;2;2;14;1;2;4845;19;19;1;0;0;2;4;4845;0;5184;4;1;
/org.eclipse.jdt.core/model/org/eclipse/jdt/internal/core/PackageFragmentRootInfo.java;4;1;8;1;2;2;2;6;14;1;6;132;35;35;1;0;0;6;8;132;0;5916;8;4;
/org.eclipse.jdt.ui.tests.refactoring/resources/ExtractMethodWorkSpace/ExtractMethodTests/duplicates_in/A_test954.java;1;0;3;1;0;0;0;3;0;1;3;1219;0;0;1;0;0;3;3;1219;0;1474;3;1;
/org.eclipse.jdt.ui/ui/org/eclipse/jdt/internal/ui/text/correction/IProblemLocation.java;1;0;2;1;0;0;0;2;0;1;2;1034;0;0;1;0;0;2;2;1034;0;1232;2;1;
/org.eclipse.jdt.ui/ui/org/eclipse/jdt/internal/ui/actions/IndentAction.java;2;2;22;1;5;4;5;17;176;3;14;1968;537;537;3;3;1;17;22;2133;4;6340;18;2;
/org.eclipse.jdt.text.tests/src/org/eclipse/jdt/text/tests/JavaWordIteratorTest.java;2;1;2;1;2;2;2;0;6;0;0;6072;6;6;1;0;0;0;2;6072;0;6340;2;2;
/org.eclipse.core.resources/src/org/eclipse/core/internal/indexing/ObjectAddress.java;1;0;1;1;1;1;1;0;33;0;0;5146;33;33;1;0;0;0;1;5146;0;5146;1;1;
/org.eclipse.jdt.ui/core refactoring/org/eclipse/jdt/internal/corext/refactoring/CompositeChange.java;2;0;8;1;0;0;0;8;393;2;7;596;489;489;2;1;0;8;8;596;1;4624;7;2;
/org.eclipse.swt.tests/JUnit Tests/org/eclipse/swt/tests/junit/Test_org_eclipse_swt_widgets_Group.java;2;0;3;1;1;1;1;2;16;1;2;2123;24;24;1;0;0;2;3;2123;0;6352;3;2;
/org.eclipse.core.resources/src/org/eclipse/core/internal/localstore/IHistoryStoreVisitor.java;1;0;1;1;1;1;1;0;16;0;0;5146;16;16;1;0;0;0;1;5146;0;5146;1;1;
/org.eclipse.jface/src/org/eclipse/jface/viewers/CheckboxTableViewer.java;2;1;4;1;3;3;3;1;26;0;1;2609;58;58;1;0;0;1;4;2609;0;6338;4;2;
/org.eclipse.jdt.ui/core refactoring/org/eclipse/jdt/internal/corext/refactoring/sef/SelfEncapsulateFieldRefactoring.java;4;1;33;1;6;6;6;27;385;2;25;122;845;845;2;2;0;27;33;1492;2;6072;31;4;
/org.eclipse.ui.ide/src/org/eclipse/ui/internal/ide/dialogs/ResourceSorter.java;1;0;1;1;0;0;0;1;0;0;1;2264;0;0;1;0;0;1;1;2264;0;2264;1;1;
/org.eclipse.core.runtime.osgi/src/org/eclipse/core/runtime/IShutdownHook.java;1;0;1;1;0;0;0;1;0;0;1;3013;0;0;1;0;0;1;1;3013;0;3013;1;1;
/org.eclipse.update.core/srcnew/org/eclipse/update/operations/IConfigOperation.java;1;0;2;1;0;0;0;2;0;1;2;569;0;0;1;0;0;2;2;569;0;602;2;1;
/org.eclipse.core.resources/src/org/eclipse/core/resources/IProjectDescription.java;3;1;8;1;2;2;2;6;483;1;6;44;635;635;1;0;0;6;8;44;0;5168;8;3;
/org.eclipse.ui.ide/src/org/eclipse/ui/internal/ide/dialogs/IDEStartupPreferencePage.java;2;1;4;1;2;2;2;2;12;0;1;4932;16;16;2;1;0;2;4;4932;1;6340;3;2;
/org.eclipse.swt.tools/Preprocessor/org/eclipse/swt/tools/internal/SwtJniGen.java;1;0;2;1;0;0;0;2;12;1;2;4194;12;12;1;0;0;2;2;4194;0;4237;2;1;
/org.eclipse.ui.externaltools/External Tools Base/org/eclipse/ui/externaltools/internal/model/BuilderUtils.java;2;1;6;1;3;3;3;3;33;1;3;4131;73;73;1;0;0;3;6;4131;0;6125;6;2;
/org.eclipse.ui.intro/src/org/eclipse/ui/internal/intro/impl/parts/CategoryForm.java;1;2;7;1;7;6;7;0;281;0;0;5115;344;344;2;0;1;0;7;5314;1;5449;6;1;
/org.eclipse.ui.workbench/Eclipse UI/org/eclipse/ui/INestableKeyBindingService.java;2;0;3;1;1;1;1;2;66;1;2;4193;70;70;1;0;0;2;3;4193;0;6338;3;2;
/org.eclipse.pde.ui/src/org/eclipse/pde/internal/ui/launcher/AbstractLauncherTab.java;1;0;4;1;0;0;0;4;39;1;4;2787;56;56;1;0;0;4;4;2787;0;3321;4;1;
/org.eclipse.ui.workbench/Eclipse UI/org/eclipse/ui/internal/model/WorkbenchFile.java;1;0;1;1;0;0;0;1;0;0;1;2737;0;0;1;0;0;1;1;2737;0;2737;1;1;
/org.eclipse.jdt.core.tests.model/workspace/Converter/src/javadoc/test011/Test.java;1;0;1;1;0;0;0;1;0;0;1;3813;0;0;1;0;0;1;1;3813;0;3813;1;1;
/org.eclipse.jdt.ui/ui/org/eclipse/jdt/internal/ui/search/ExceptionOccurrencesFinder.java;4;1;9;1;4;4;4;5;102;2;4;3759;242;242;2;1;0;5;9;3759;1;6116;8;4;
/org.eclipse.ui.workbench/Eclipse UI/org/eclipse/ui/internal/chris/roles/PreferenceRoleRegistry.java;1;0;2;1;0;0;0;2;0;1;2;1952;0;0;1;0;0;2;2;1952;0;2213;2;1;
/org.eclipse.jdt.core.tests.model/workspace/Converter/test0393/A.java;1;0;1;1;0;0;0;1;0;0;1;3714;0;0;1;0;0;1;1;3714;0;3714;1;1;
/org.eclipse.jdt.debug.ui/ui/org/eclipse/jdt/internal/debug/ui/actions/ThreadFilterViewer.java;2;0;2;1;0;0;0;2;4;1;2;1240;4;4;1;0;0;2;2;1240;0;1484;2;2;
/org.eclipse.ui.forms/src/org/eclipse/ui/forms/editor/MultiPageKeyBindingService.java;1;0;2;1;0;0;0;2;0;1;2;4068;0;0;1;0;0;2;2;4068;0;4470;2;1;
/org.eclipse.update/src/org/eclipse/update/internal/ui/UMWizardTreeItemComparator.java;1;0;1;1;1;1;1;0;0;0;0;6339;0;0;1;0;0;0;1;6339;0;6339;1;1;
/org.eclipse.core.runtime/src/org/eclipse/core/internal/runtime/PlatformMetaArea.java;3;0;5;2;0;0;0;5;427;2;4;3013;821;821;2;1;0;5;5;3164;1;3677;4;3;
/org.eclipse.jdt.debug/model/org/eclipse/jdt/internal/debug/core/hcr/CompilationUnitDelta.java;3;1;6;1;2;2;2;4;16;1;4;307;43;43;1;0;0;4;6;307;0;6336;6;3;
/org.eclipse.team.webdav/src/org/eclipse/team/internal/ui/target/subscriber/ToolTipMessageDialog.java;2;0;3;1;1;1;1;2;40;1;2;3494;42;42;1;0;0;2;3;3494;0;6337;3;2;
/org.eclipse.jdt.debug.ui/ui/org/eclipse/jdt/internal/debug/core/refactoring/JavaMethodBreakpointTypeChange.java;3;2;5;2;5;4;5;0;22;0;0;5319;38;38;2;0;1;0;5;6083;1;6339;4;3;
/org.eclipse.jdt.ui.tests.refactoring/resources/InlineMethodWorkspace/TestCases/argument_in/TestLocalReferenceRead2.java;1;0;1;1;0;0;0;1;2;0;1;845;2;2;1;0;0;1;1;845;0;845;1;1;
/org.eclipse.jdt.ui.tests.refactoring/resources/ExtractMethodWorkSpace/ExtractMethodTests/wiki_in/A_test2004.java;1;0;2;1;0;0;0;2;4;1;2;130;5;5;1;0;0;2;2;130;0;844;2;1;
/org.eclipse.jdt.core.tests.model/workspace/Converter/test0411/A.java;1;0;1;1;0;0;0;1;0;0;1;3714;0;0;1;0;0;1;1;3714;0;3714;1;1;
/org.eclipse.compare.examples.xml/src/org/eclipse/compare/examples/xml/XMLCompareMessages.java;1;0;3;1;0;0;0;3;5;1;3;1106;7;7;1;0;0;3;3;1106;0;3938;3;1;
/org.eclipse.ltk.ui.refactoring/src/org/eclipse/ltk/internal/ui/refactoring/IRefactoringHelpContextIds.java;1;0;2;1;1;1;1;1;4;0;1;4965;4;4;1;0;0;1;2;4965;0;5382;2;1;
/org.eclipse.pde.core/src/org/eclipse/pde/internal/core/site/AbstractSiteModel.java;3;1;7;2;2;2;2;5;35;2;4;2906;56;56;2;1;0;5;7;2936;1;6336;6;3;
/org.eclipse.jdt.ui.tests.refactoring/resources/RenamePackage/testImportFromMultiRoots3/in/srcPrg/p/p/ToQ.java;1;0;2;1;0;0;0;2;5;1;2;3219;5;5;1;0;0;2;2;3219;0;4105;2;1;
/org.eclipse.ui.workbench/Eclipse UI/org/eclipse/ui/internal/csm/commands/ImageBinding.java;1;0;4;1;0;0;0;4;16;2;2;2532;18;18;2;2;0;4;4;2532;2;2556;2;1;
/org.eclipse.core.expressions/src/org/eclipse/core/internal/expressions/ExpressionMessages.java;1;0;2;1;1;1;1;1;2;0;1;4108;2;2;1;0;0;1;2;4108;0;6340;2;1;
/org.eclipse.jdt.core.tests.model/workspace/Formatter/test351/A_in.java;1;0;1;1;0;0;0;1;0;0;1;3029;0;0;1;0;0;1;1;3029;0;3029;1;1;
/org.eclipse.compare/compare/org/eclipse/compare/internal/ComparePreferencePage.java;1;0;8;1;1;1;1;7;118;2;6;664;168;168;2;1;0;7;8;3415;1;6354;7;1;
/org.eclipse.swt/Eclipse SWT/carbon/org/eclipse/swt/widgets/Combo.java;6;1;24;1;8;8;8;16;63;2;15;110;364;364;2;1;0;16;24;2781;1;6352;23;6;
/org.eclipse.team.ftp/src/org/eclipse/team/internal/ftp/FTPException.java;1;0;2;1;1;1;1;1;6;0;1;4216;8;8;1;0;0;1;2;4216;0;6337;2;1;
/org.eclipse.jdt.ui.tests.refactoring/resources/ExtractInterface/test98/out/Foo.java;1;0;1;1;0;0;0;1;0;0;1;1571;0;0;1;0;0;1;1;1571;0;1571;1;1;
/org.eclipse.jdt.core/dom/org/eclipse/jdt/core/dom/FieldAccess.java;5;1;12;1;2;2;2;10;112;1;10;72;182;182;1;0;0;10;12;72;0;5272;12;5;
/org.eclipse.pde.ui/src/org/eclipse/pde/internal/ui/editor/site/BuildForm.java;1;0;1;1;0;0;0;1;0;0;1;2311;0;0;1;0;0;1;1;2311;0;2311;1;1;
/org.eclipse.jdt.core/dom/org/eclipse/jdt/core/dom/NormalAnnotation.java;2;2;9;1;3;2;3;6;123;1;6;4054;234;234;2;0;1;6;9;5268;1;5335;8;2;
/org.eclipse.jdt.core/model/org/eclipse/jdt/core/ElementChangedEvent.java;2;0;4;1;0;0;0;4;2;1;4;2046;6;6;1;0;0;4;4;2046;0;3560;4;2;
/org.eclipse.swt.tests/JUnit Tests/org/eclipse/swt/tests/junit/Test_org_eclipse_swt_events_PaintEvent.java;1;0;2;1;1;1;1;1;7;0;1;3444;11;11;1;0;0;1;2;3444;0;6352;2;1;
/org.eclipse.ui.workbench/Eclipse UI/org/eclipse/ui/internal/registry/MarkerHelpRegistry.java;1;0;1;1;0;0;0;1;0;0;1;2737;0;0;1;0;0;1;1;2737;0;2737;1;1;
/org.eclipse.jdt.core.tests.model/workspace/Formatter/test322/A_out.java;1;0;1;1;0;0;0;1;0;0;1;2462;0;0;1;0;0;1;1;2462;0;2462;1;1;
/org.eclipse.jdt.ui.tests.refactoring/test cases/org/eclipse/jdt/ui/tests/refactoring/InlineMethodTests.java;4;1;16;1;3;3;3;13;34;2;11;345;123;123;2;2;0;13;16;2277;2;6340;14;4;
/org.eclipse.update.ui/src/org/eclipse/update/internal/ui/pages/IUpdateFormPage.java;1;0;1;1;0;0;0;1;0;0;1;755;0;0;1;0;0;1;1;755;0;755;1;1;
/org.eclipse.jdt.core.tests.model/workspace/Converter/src/test0228/Test.java;1;0;1;1;0;0;0;1;0;0;1;3714;0;0;1;0;0;1;1;3714;0;3714;1;1;
/org.eclipse.ui.workbench.texteditor/src/org/eclipse/ui/texteditor/IDocumentProviderExtension2.java;2;0;2;2;2;1;2;0;4;0;0;6334;4;4;2;0;1;0;2;6334;1;6334;1;2;
/org.eclipse.core.expressions/src/org/eclipse/core/expressions/EvaluationResult.java;1;1;5;1;3;3;3;2;31;1;2;4108;65;65;1;0;0;2;5;4108;0;6301;5;1;
/org.eclipse.ui.ide/extensions/org/eclipse/ui/actions/ScrubLocalAction.java;1;0;1;1;0;0;0;1;0;0;1;2263;0;0;1;0;0;1;1;2263;0;2263;1;1;
/org.eclipse.team.cvs.ui/src/org/eclipse/team/internal/ccvs/ui/subscriber/ChangeLogModelProvider.java;2;4;33;1;28;19;28;5;280;1;5;4244;1341;1341;4;0;9;5;33;5637;9;6225;24;2;
/org.eclipse.ui.workbench/Eclipse UI/org/eclipse/ui/testing/TestableObject.java;1;0;3;1;0;0;0;3;81;1;3;2231;83;83;1;0;0;3;3;2231;0;2897;3;1;
/org.eclipse.update.ui/src/org/eclipse/update/internal/ui/model/BookmarkFolder.java;1;0;1;1;0;0;0;1;2;0;1;890;2;2;1;0;0;1;1;890;0;890;1;1;
/org.eclipse.debug.ui/ui/org/eclipse/debug/ui/launchVariables/components/SpecificFolderResourceComponent.java;1;0;2;1;0;0;0;2;0;1;2;562;0;0;1;0;0;2;2;562;0;647;2;1;
/org.eclipse.jdt.core.tests.model/workspace/Formatter/test470/A_in.java;1;0;1;1;0;0;0;1;0;0;1;3942;0;0;1;0;0;1;1;3942;0;3942;1;1;
/org.eclipse.ui.ide/src/org/eclipse/ui/IExportWizard.java;2;0;2;1;0;0;0;2;0;1;2;1511;0;0;1;0;0;2;2;1511;0;2263;2;2;
/org.eclipse.jface.text/src/org/eclipse/jface/text/source/ImageUtilities.java;2;1;2;1;2;2;2;0;2;0;0;5331;2;2;1;0;0;0;2;5331;0;6340;2;2;
/org.eclipse.ant.ui/Ant Runner Support/org/eclipse/ant/ui/internal/antsupport/inputhandler/AntInputHandler.java;1;0;3;1;0;0;0;3;5;1;3;250;5;5;1;0;0;3;3;250;0;1811;3;1;
/org.eclipse.update.tests.core/src/org/eclipse/update/tests/mirror/TestRemoteDoubleEmbeddedFeatureMirror.java;1;0;2;1;0;0;0;2;16;0;1;2104;16;16;2;1;0;2;2;2104;1;2104;1;1;
/org.eclipse.swt/Eclipse SWT PI/gtk1x/org/eclipse/swt/internal/gtk/GtkFontSelectionDialog.java;1;0;1;1;0;0;0;1;0;0;1;2327;0;0;1;0;0;1;1;2327;0;2327;1;1;
/org.eclipse.jdt.ui/ui/org/eclipse/jdt/internal/ui/text/java/GetterSetterCompletionProposal.java;1;1;3;1;3;3;3;0;26;0;0;5483;33;33;1;0;0;0;3;5483;0;5734;3;1;
/org.eclipse.ui.ide/extensions/org/eclipse/ui/actions/NewProjectAction.java;4;1;7;1;2;2;2;5;15;1;5;2263;35;35;1;0;0;5;7;2263;0;6338;7;4;
/org.eclipse.ui.ide/src/org/eclipse/ui/internal/ide/actions/QuickMenuAction.java;1;0;1;1;1;1;1;0;0;0;0;5942;0;0;1;0;0;0;1;5942;0;5942;1;1;
/org.eclipse.update.tests.core/src/org/eclipse/update/tests/api/TestLocalSiteAPI.java;2;0;4;1;1;1;1;3;32;1;3;4132;48;48;1;0;0;3;4;4132;0;6336;4;2;
/org.eclipse.pde.ui/src_Forms/org/eclipse/pde/internal/ui/neweditor/site/ArchivePage.java;3;1;3;1;2;2;2;1;1;0;1;4832;1;1;1;0;0;1;3;4832;0;5431;3;3;
/org.eclipse.search/search/org/eclipse/search/internal/ui/ShowPreviousResultAction.java;1;0;2;1;1;1;1;1;2;0;1;1647;3;3;1;0;0;1;2;1647;0;6340;2;1;
/org.eclipse.team.ui/src/org/eclipse/team/internal/ui/synchronize/SynchronizePageActions.java;1;0;1;1;0;0;0;1;0;0;1;5043;0;0;1;0;0;1;1;5043;0;5043;1;1;
/org.eclipse.jdt.core/compiler/org/eclipse/jdt/internal/compiler/parser/RecoveredLocalVariable.java;4;0;5;1;0;0;0;5;12;1;5;488;32;32;1;0;0;5;5;488;0;3560;5;4;
/org.eclipse.ui.tests/Eclipse RCP Tests/org/eclipse/ui/rcp/tests/util/WorkbenchAdvisorObserver.java;1;0;3;1;0;0;0;3;11;2;2;4930;11;11;2;1;0;3;3;4952;1;4952;2;1;
/org.eclipse.ui.tutorials.rcp.part3/src/org/eclipse/ui/tutorials/rcp/part3/Messages.java;1;0;1;1;1;1;1;0;0;0;0;5118;0;0;1;0;0;0;1;5118;0;5118;1;1;
/org.eclipse.core.tests.resources/src/org/eclipse/core/tests/resources/usecase/AllTests.java;1;1;4;1;4;4;4;0;54;0;0;5147;68;68;1;0;0;0;4;5147;0;5998;4;1;
/org.eclipse.ui.workbench/Eclipse UI/org/eclipse/ui/commands/internal/SimpleActionService.java;1;0;3;1;0;0;0;3;1;1;3;772;1;1;1;0;0;3;3;772;0;956;3;1;
/org.eclipse.ant.ui/Ant Editor/org/eclipse/ant/internal/ui/editor/templates/AntTemplatePreferencePage.java;1;2;4;1;4;3;4;0;150;0;0;5295;161;161;2;0;1;0;4;5295;1;5929;3;1;
/org.eclipse.jdt.core.tests.model/workspace/TypeHierarchy/src/p6/A.java;1;0;1;1;0;0;0;1;0;0;1;2053;0;0;1;0;0;1;1;2053;0;2053;1;1;
/org.eclipse.jdt.core.tests.model/workspace/Formatter/test185/A_out.java;1;0;2;1;1;1;1;1;49;0;1;2425;49;49;1;0;0;1;2;2425;0;5132;2;1;
/org.eclipse.ui.workbench/Eclipse UI/org/eclipse/ui/internal/WWinPluginAction.java;2;1;3;1;2;2;2;1;15;0;1;1527;21;21;1;0;0;1;3;1527;0;6338;3;2;
/org.eclipse.ui.editors/src/org/eclipse/ui/internal/editors/text/AnnotationsConfigurationBlock.java;1;2;5;1;5;4;5;0;6;0;0;5501;15;15;2;0;1;0;5;5501;1;6340;4;1;
/org.eclipse.ui.workbench/Eclipse UI/org/eclipse/ui/activities/ICompoundActivityService.java;1;0;2;1;0;0;0;2;0;1;2;2800;0;0;1;0;0;2;2;2800;0;2896;2;1;
/org.eclipse.jdt.ui/core refactoring/org/eclipse/jdt/internal/corext/refactoring/reorg/ASTNodeDeleteUtil.java;5;1;11;1;2;2;2;9;32;1;9;1114;103;103;1;0;0;9;11;1114;0;6340;11;5;
/org.eclipse.jdt.ui.tests.refactoring/resources/PasteSourceReference/test3/in/B.java;1;0;1;1;0;0;0;1;0;0;1;1311;0;0;1;0;0;1;1;1311;0;1311;1;1;
/org.eclipse.ui.ide/src/org/eclipse/ui/internal/ide/Semaphore.java;1;0;2;1;0;0;0;2;0;1;2;1760;0;0;1;0;0;2;2;1760;0;2059;2;1;
/org.eclipse.pde.ui/src/org/eclipse/pde/internal/ui/editor/IContextPart.java;2;1;4;1;4;4;4;0;10;0;0;5431;15;15;1;0;0;0;4;5431;0;6336;4;2;
/org.eclipse.jdt.core.tests.model/workspace/Converter/src/javadoc/test017/TestB1.java;1;0;2;1;0;0;0;2;0;1;2;4311;0;0;1;0;0;2;2;4311;0;4390;2;1;
/org.eclipse.core.runtime/src/org/eclipse/core/internal/runtime/DataArea.java;5;1;15;2;4;4;4;11;141;2;10;3677;370;370;2;1;0;11;15;4110;1;5683;14;5;
/org.eclipse.team.cvs.ui/src/org/eclipse/team/internal/ccvs/ui/operations/DisconnectOperation.java;2;1;5;1;3;3;3;2;8;1;2;2762;19;19;1;0;0;2;5;2762;0;6337;5;2;
/org.eclipse.jdt.ui/core extension/org/eclipse/jdt/internal/corext/dom/SimpleNameRenamer.java;1;0;1;1;0;0;0;1;0;0;1;377;0;0;1;0;0;1;1;377;0;377;1;1;
/org.eclipse.core.runtime/src/org/eclipse/core/internal/runtime/DevClassPathHelper.java;2;1;2;1;2;2;2;0;4;0;0;5466;4;4;1;0;0;0;2;5466;0;5543;2;2;
/org.eclipse.jdt.ui/ui/org/eclipse/jdt/ui/actions/FindWriteReferencesInProjectAction.java;3;1;11;1;4;4;4;7;21;1;7;1683;69;69;1;0;0;7;11;1683;0;6340;11;3;
/org.eclipse.jdt.core/model/org/eclipse/jdt/internal/core/JavaElementDelta.java;3;1;12;1;4;4;4;8;233;1;8;818;340;340;1;0;0;8;12;818;0;6079;12;3;
/org.eclipse.jdt.ui/core refactoring/org/eclipse/jdt/internal/corext/refactoring/base/JavaRefactorings.java;2;0;4;1;1;1;1;3;8;1;3;882;15;15;1;0;0;3;4;882;0;6340;4;2;
/org.eclipse.jdt.ui.tests.refactoring/resources/ExtractTemp/cannotExtract/A_testFail30.java;1;0;1;1;0;0;0;1;0;0;1;1569;0;0;1;0;0;1;1;1569;0;1569;1;1;
/org.eclipse.jface.text/src/org/eclipse/jface/text/ITextHover.java;2;1;2;1;2;2;2;0;28;0;0;6340;30;30;1;0;0;0;2;6340;0;6359;2;2;
/org.eclipse.core.resources/src/org/eclipse/core/resources/IMarkerDelta.java;2;0;2;1;1;1;1;1;301;0;1;180;310;310;1;0;0;1;2;180;0;5146;2;2;
/org.eclipse.ant.ui/Ant Tools Support/org/eclipse/ant/internal/ui/launchConfigurations/AntLaunchConfigurationMessages.java;1;0;1;1;0;0;0;1;0;0;1;1811;0;0;1;0;0;1;1;1811;0;1811;1;1;
/org.eclipse.jdt.core.tests.model/workspace/Converter/src/test0394/A.java;1;0;1;1;0;0;0;1;0;0;1;3714;0;0;1;0;0;1;1;3714;0;3714;1;1;
/org.eclipse.core.tests.runtime/src/org/eclipse/core/tests/runtime/jobs/VerboseJobListener.java;2;0;3;1;1;1;1;2;27;1;2;850;36;36;1;0;0;2;3;850;0;5149;3;2;
/org.eclipse.core.resources/src/org/eclipse/core/internal/properties/QueryResults.java;1;0;1;1;1;1;1;0;75;0;0;5146;75;75;1;0;0;0;1;5146;0;5146;1;1;
/org.eclipse.jdt.debug/jdi interfaces/com/sun/jdi/connect/spi/Connection.java;1;0;1;1;0;0;0;1;0;0;1;4267;0;0;1;0;0;1;1;4267;0;4267;1;1;
/org.eclipse.ui.cheatsheets/src/org/eclipse/ui/internal/cheatsheets/CheatSheetHistory.java;2;1;4;1;2;2;2;2;17;1;2;4428;25;25;1;0;0;2;4;4428;0;5759;4;2;
/org.eclipse.ui.workbench/Eclipse UI/org/eclipse/ui/internal/ActionSetMenuManager.java;2;1;2;1;2;2;2;0;15;0;0;6145;17;17;1;0;0;0;2;6145;0;6338;2;2;
/org.eclipse.ui.views/src/org/eclipse/ui/views/markers/internal/ActionMarkerProperties.java;2;0;2;1;0;0;0;2;0;1;2;755;0;0;1;0;0;2;2;755;0;2738;2;2;
/org.eclipse.jdt.ui.tests.refactoring/resources/DeleteSourceReferenceEdit/A_test2_in.java;1;0;1;1;0;0;0;1;0;0;1;1652;0;0;1;0;0;1;1;1652;0;1652;1;1;
/org.eclipse.help.appserver/src/org/eclipse/help/internal/appserver/AppserverPlugin.java;1;1;7;1;4;4;4;3;81;1;3;1741;162;162;1;0;0;3;7;1741;0;6337;7;1;
/org.eclipse.jdt.core/formatter/org/eclipse/jdt/internal/formatter/Scribe.java;4;1;70;1;4;4;4;66;680;5;51;535;2293;2293;5;15;0;66;70;878;15;5871;55;4;
/org.eclipse.text/src/org/eclipse/text/edits/UndoCollector.java;2;1;3;1;2;2;2;1;5;0;1;2113;7;7;1;0;0;1;3;2113;0;6340;3;2;
/org.eclipse.ui.workbench/Eclipse UI/org/eclipse/ui/internal/commands/registry/old/IRegistryListener.java;1;0;3;1;0;0;0;3;4;1;3;1222;4;4;1;0;0;3;3;1222;0;1322;3;1;
/org.eclipse.osgi/core/adaptor/org/eclipse/osgi/framework/adaptor/ClassLoaderDelegate.java;3;1;5;1;2;2;2;3;123;1;3;3013;131;131;1;0;0;3;5;3013;0;5249;5;3;
/org.eclipse.ant.ui/Remote Ant Support/org/eclipse/ant/internal/ui/antsupport/logger/RemoteAntBuildLogger.java;1;1;7;1;2;2;2;5;123;1;5;1811;264;264;1;0;0;5;7;1811;0;6336;7;1;
/org.eclipse.ui.workbench/Eclipse UI/org/eclipse/ui/internal/registry/IStickyViewDescriptor.java;1;1;3;1;3;3;3;0;14;0;0;5110;28;28;1;0;0;0;3;5110;0;5590;3;1;
/org.eclipse.ui.forms/src/org/eclipse/ui/forms/widgets/ScrolledFormText.java;1;0;3;1;0;0;0;3;5;1;3;4154;8;8;1;0;0;3;3;4154;0;5044;3;1;
/org.eclipse.core.resources/src/org/eclipse/core/internal/dtree/AbstractDataTreeNode.java;2;0;3;1;2;1;2;1;1049;0;1;178;1064;1064;2;0;1;1;3;5146;1;5146;2;2;
/org.eclipse.update.ui/src/org/eclipse/update/internal/ui/search/SearchCategoryRegistryReader.java;1;0;1;1;0;0;0;1;0;0;1;755;0;0;1;0;0;1;1;755;0;755;1;1;
/org.eclipse.jdt.ui/core extension/org/eclipse/text/edits/EditProcessor.java;1;0;2;1;0;0;0;2;0;1;2;1953;0;0;1;0;0;2;2;1953;0;1972;2;1;
/org.eclipse.jdt.core.tests.model/workspace/TypeHierarchy/src/q4/Y.java;1;0;1;1;1;1;1;0;0;0;0;6073;0;0;1;0;0;0;1;6073;0;6073;1;1;
/org.eclipse.pde.ui/templates/editor/java/XMLDoubleClickStrategy.java;1;0;1;1;0;0;0;1;10;0;1;851;10;10;1;0;0;1;1;851;0;851;1;1;
/org.eclipse.core.tests.runtime/src/org/eclipse/core/tests/internal/plugins/AllTests.java;1;0;1;1;0;0;0;1;0;0;1;3014;0;0;1;0;0;1;1;3014;0;3014;1;1;
/org.eclipse.jdt.ui/ui/org/eclipse/jdt/internal/ui/text/correction/AssignToVariableAssistProposal.java;2;1;31;1;8;8;8;23;135;2;22;311;837;837;2;1;0;23;31;1152;1;6340;30;2;
/org.eclipse.ui.ide/src/org/eclipse/ui/views/markers/internal/DialogTaskFilter.java;1;0;1;1;0;0;0;1;0;0;1;2208;0;0;1;0;0;1;1;2208;0;2208;1;1;
/org.eclipse.update.tests.core/src/org/eclipse/update/tests/standalone/StandaloneManagerTestCase.java;1;1;8;1;2;2;2;6;101;2;5;2463;153;153;2;1;0;6;8;2521;1;6336;7;1;
/org.eclipse.jdt.ui.tests.refactoring/resources/IntroduceFactory/positive/CtorThrows.java;1;0;2;1;1;1;1;1;2;0;1;2846;2;2;1;0;0;1;2;2846;0;5659;2;1;
/org.eclipse.team.cvs.core/src/org/eclipse/team/internal/ccvs/core/client/RTag.java;2;1;4;1;2;2;2;2;3;1;2;1672;11;11;1;0;0;2;4;1672;0;6337;4;2;
/org.eclipse.jdt.core.tests.model/workspace/Formatter/test155/A_in.java;1;0;1;1;0;0;0;1;0;0;1;2425;0;0;1;0;0;1;1;2425;0;2425;1;1;
/org.eclipse.ant.ui/Ant Tools Support/org/eclipse/ant/internal/ui/views/AntViewDropAdapter.java;1;0;1;1;0;0;0;1;13;0;1;2122;13;13;1;0;0;1;1;2122;0;2122;1;1;
/org.eclipse.swt.tests/JUnit Tests/org/eclipse/swt/tests/junit/Test_org_eclipse_swt_widgets_MessageBox.java;2;0;2;1;0;0;0;2;26;1;2;2123;36;36;1;0;0;2;2;2123;0;2824;2;2;
/org.eclipse.ltk.core.refactoring/src/org/eclipse/ltk/core/refactoring/participants/RefactoringParticipant.java;1;1;9;1;5;5;5;4;160;1;4;4845;267;267;1;0;0;4;9;4845;0;6351;9;1;
/org.eclipse.jdt.ui.examples.javafamily/src/org/eclipse/text/reconcilerpipe/DefaultAnnotationHover.java;1;0;2;1;0;0;0;2;0;1;2;1134;0;0;1;0;0;2;2;1134;0;1150;2;1;
/org.eclipse.jdt.core/compiler/org/eclipse/jdt/internal/compiler/ast/PrefixExpression.java;3;0;4;1;1;1;1;3;12;1;3;991;20;20;1;0;0;3;4;991;0;5916;4;3;
/org.eclipse.team.tests.cvs.core/src/org/eclipse/team/tests/ccvs/ui/old/LoggingTestCase.java;1;0;2;1;0;0;0;2;0;1;2;2632;0;0;1;0;0;2;2;2632;0;4216;2;1;
/org.eclipse.swt/Eclipse SWT/gtk1x/org/eclipse/swt/graphics/GC.java;1;0;1;1;0;0;0;1;0;0;1;2327;0;0;1;0;0;1;1;2327;0;2327;1;1;
/org.eclipse.update.ui/srcnew/org/eclipse/update/internal/ui/search/UnifiedSearchCategory.java;2;0;4;1;0;0;0;4;6;1;4;369;7;7;1;0;0;4;4;369;0;824;4;2;
/org.eclipse.jdt.ui/ui/org/eclipse/jdt/internal/ui/typehierarchy/HierarchyOverrideIndicatorLabelDecorator.java;1;0;3;1;0;0;0;3;4;1;3;435;4;4;1;0;0;3;3;435;0;4849;3;1;
/org.eclipse.jface.text/src/org/eclipse/jface/text/ITextViewerExtension2.java;2;0;2;2;2;1;2;0;44;0;0;6340;44;44;2;0;1;0;2;6340;1;6340;1;2;
/org.eclipse.jdt.ui/core refactoring/org/eclipse/ltk/core/refactoring/DocumentChange.java;1;0;2;1;0;0;0;2;0;1;2;4624;0;0;1;0;0;2;2;4624;0;4864;2;1;
/org.eclipse.core.tests.runtime/src/org/eclipse/core/tests/runtime/jobs/ReadWriteMonitor.java;2;0;2;1;1;1;1;1;18;0;1;1219;18;18;1;0;0;1;2;1219;0;5149;2;2;
/org.eclipse.jdt.core.tests.model/workspace/Converter/src/test0330/Test.java;1;0;1;1;0;0;0;1;0;0;1;3714;0;0;1;0;0;1;1;3714;0;3714;1;1;
/org.eclipse.jdt.core.tests.model/workspace/Converter/src/test0036/Test.java;1;0;1;1;0;0;0;1;0;0;1;3714;0;0;1;0;0;1;1;3714;0;3714;1;1;
/org.eclipse.ui.tutorials.rcp.part1/src/org/eclipse/ui/tutorials/rcp/part1/RcpWorkbenchAdvisor.java;1;0;1;1;1;1;1;0;0;0;0;5118;0;0;1;0;0;0;1;5118;0;5118;1;1;
/org.eclipse.jdt.ui.tests.refactoring/resources/MoveInnerToTopLevel/test_nonstatic_2/out/Inner.java;2;0;2;1;1;1;1;1;2;0;1;305;4;4;1;0;0;1;2;305;0;5854;2;2;
/org.eclipse.swt/Eclipse SWT/carbon/org/eclipse/swt/widgets/Slider.java;4;1;7;1;2;2;2;5;30;1;5;268;66;66;1;0;0;5;7;268;0;6352;7;4;
/org.eclipse.jdt.ui/ui/org/eclipse/jdt/internal/ui/typehierarchy/TypeHierarchyViewPart.java;6;2;27;1;8;7;8;19;190;1;19;312;703;703;2;0;1;19;27;5176;1;6340;26;6;
/org.eclipse.ui.workbench/Eclipse UI/org/eclipse/ui/internal/csm/activities/ActivityRegistryEvent.java;1;0;2;1;0;0;0;2;0;1;2;2225;0;0;1;0;0;2;2;2225;0;2444;2;1;
/org.eclipse.jdt.ui.tests.refactoring/resources/InlineMethodWorkspace/TestCases/import_out/TestUseInDecl.java;1;0;1;1;0;0;0;1;2;0;1;845;2;2;1;0;0;1;1;845;0;845;1;1;
/org.eclipse.jdt.ui.tests.refactoring/test cases/org/eclipse/jdt/ui/tests/refactoring/RenameParametersTests.java;4;1;7;1;2;2;2;5;28;1;5;130;50;50;1;0;0;5;7;130;0;6340;7;4;
/org.eclipse.jdt.ui.tests.refactoring/resources/ExtractMethodWorkSpace/ExtractMethodTests/locals_out/A_test518.java;1;0;2;1;0;0;0;2;4;1;2;130;5;5;1;0;0;2;2;130;0;844;2;1;
/org.eclipse.jdt.core/dom/org/eclipse/jdt/core/dom/BindingResolver.java;5;2;11;2;3;2;3;8;139;1;8;72;305;305;2;0;1;8;11;5268;1;5916;10;5;
/org.eclipse.ui.externaltools/Ant Editor/org/eclipse/ui/externaltools/internal/ant/editor/outline/IProblem.java;1;0;1;1;0;0;0;1;0;0;1;282;0;0;1;0;0;1;1;282;0;282;1;1;
/org.eclipse.swt/Eclipse SWT PI/gtk/org/eclipse/swt/internal/gtk/AtkSelectionIface.java;1;0;2;1;0;0;0;2;0;1;2;1102;0;0;1;0;0;2;2;1102;0;1214;2;1;
/org.eclipse.jdt.ui.tests.refactoring/resources/ExtractMethodWorkSpace/ExtractMethodTests/validSelection_out/A_test362.java;1;0;2;1;0;0;0;2;6;1;2;130;12;12;1;0;0;2;2;130;0;844;2;1;
/org.eclipse.ui.intro/src/org/eclipse/ui/internal/intro/impl/util/DialogUtil.java;1;1;5;1;5;5;5;0;44;0;0;5115;98;98;1;0;0;0;5;5115;0;5643;5;1;
/org.eclipse.ui.externaltools/External Tools Base/org/eclipse/ui/externaltools/internal/variables/BuildTypeExpander.java;2;0;5;1;0;0;0;5;23;2;4;317;31;31;2;1;0;5;5;317;1;2120;4;2;
/org.eclipse.pde/src/org/eclipse/pde/internal/builders/ManifestParser.java;1;0;2;1;0;0;0;2;2;1;2;910;2;2;1;0;0;2;2;910;0;2906;2;1;
/org.eclipse.jdt.ui/ui refactoring/org/eclipse/jdt/internal/ui/refactoring/reorg/RenameRefactoringAction.java;1;0;6;1;0;0;0;6;170;1;6;1047;316;316;1;0;0;6;6;1047;0;4507;6;1;
/org.eclipse.jdt.core.tests.model/src/org/eclipse/jdt/core/tests/rewrite/modifying/ASTRewritingModifyingOtherTest.java;3;0;3;1;1;1;1;2;7;1;2;4711;12;12;1;0;0;2;3;4711;0;5853;3;3;
/org.eclipse.debug.core/core/org/eclipse/debug/internal/core/sourcelookup/SourceLocatorMementoComparator.java;2;0;2;1;1;1;1;1;5;0;1;4113;5;5;1;0;0;1;2;4113;0;5672;2;2;
/org.eclipse.jdt.core.tests.model/workspace/Converter/test0409/A.java;1;0;1;1;0;0;0;1;0;0;1;3714;0;0;1;0;0;1;1;3714;0;3714;1;1;
/org.eclipse.jdt.debug.ui/ui/org/eclipse/jdt/internal/debug/ui/launcher/JREContainerWizardPage.java;1;0;1;1;0;0;0;1;0;0;1;1063;0;0;1;0;0;1;1;1063;0;1063;1;1;
/org.eclipse.update.core/srcnew/org/eclipse/update/operations/IUnconfigOperation.java;1;0;2;1;0;0;0;2;0;1;2;569;0;0;1;0;0;2;2;569;0;602;2;1;
/org.eclipse.jdt.core.tests.model/workspace/Formatter/test360/A_in.java;1;0;1;1;0;0;0;1;0;0;1;3087;0;0;1;0;0;1;1;3087;0;3087;1;1;
/org.eclipse.jdt.core.tests.model/src/org/eclipse/jdt/core/tests/model/RenameTests.java;2;0;9;1;1;1;1;8;26;1;8;100;81;81;1;0;0;8;9;100;0;5397;9;2;
/org.eclipse.core.runtime/src/org/eclipse/core/internal/jobs/JobStatus.java;1;0;1;1;1;1;1;0;0;0;0;5310;0;0;1;0;0;0;1;5310;0;5310;1;1;
/org.eclipse.help.base/src/org/eclipse/help/internal/browser/macosx/DefaultBrowserFactory.java;1;1;4;1;2;2;2;2;25;1;2;1740;45;45;1;0;0;2;4;1740;0;6337;4;1;
/org.eclipse.pde.ui/src/org/eclipse/pde/internal/ui/editor/feature/FeatureAdvancedPage.java;2;2;5;1;4;3;4;1;74;0;1;4203;84;84;2;0;1;1;5;5431;1;6336;4;2;
/org.eclipse.jface/src/org/eclipse/jface/action/ICommandResolver.java;1;0;2;1;0;0;0;2;0;1;2;2161;0;0;1;0;0;2;2;2161;0;2176;2;1;
/org.eclipse.team.webdav/src/org/eclipse/team/internal/webdav/core/WebDavSite.java;2;0;3;1;1;1;1;2;14;1;2;1708;23;23;1;0;0;2;3;1708;0;6337;3;2;
/org.eclipse.pde.ui/src_Forms/org/eclipse/pde/internal/ui/neweditor/plugin/rows/ChoiceAttributeRow.java;2;1;5;1;2;2;2;3;20;2;2;4354;27;27;2;1;0;3;5;4354;1;5431;4;2;
/org.eclipse.pde.ui/src/org/eclipse/pde/internal/ui/editor/SystemFileEditorInput.java;2;1;2;1;2;2;2;0;4;0;0;5778;8;8;1;0;0;0;2;5778;0;6336;2;2;
/org.eclipse.ui.workbench/Eclipse UI/org/eclipse/ui/internal/presentations/BasicStackPresentation.java;8;2;51;6;24;17;24;27;329;6;12;4469;1643;1643;6;15;7;27;51;4691;22;5539;29;8;
/org.eclipse.jdt.ui.tests.refactoring/resources/ExtractMethodWorkSpace/ExtractMethodTests/duplicates_in/A_test961.java;1;1;2;1;2;2;2;0;2;0;0;5650;2;2;1;0;0;0;2;5650;0;5681;2;1;
/org.eclipse.jdt.core.tests.model/workspace/Converter/src/test0433/A.java;1;0;1;1;0;0;0;1;0;0;1;3714;0;0;1;0;0;1;1;3714;0;3714;1;1;
/org.eclipse.ui.editors/src/org/eclipse/ui/internal/editors/text/QuickDiffConfigurationBlock.java;1;2;4;1;4;3;4;0;4;0;0;5502;10;10;2;0;1;0;4;5502;1;6340;3;1;
/org.eclipse.core.runtime.compatibility/src-runtime/org/eclipse/core/internal/plugins/PluginPrerequisite.java;5;1;8;1;3;3;3;5;114;2;4;3013;195;195;2;1;0;5;8;4215;1;6340;7;5;
/org.eclipse.jface.text/src/org/eclipse/jface/text/contentassist/IContentAssistRequestor.java;1;0;3;1;0;0;0;3;37;2;2;2263;37;37;2;1;0;3;3;2280;1;2280;2;1;
/org.eclipse.jdt.debug.ui/ui/org/eclipse/jdt/internal/debug/ui/actions/ManageBreakpointRulerActionDelegate.java;2;0;2;1;1;1;1;1;21;0;1;4471;25;25;1;0;0;1;2;4471;0;6336;2;2;
/org.eclipse.team.cvs.ui/src/org/eclipse/team/internal/ccvs/ui/operations/TagOperation.java;2;1;8;1;2;2;2;6;31;1;6;994;75;75;1;0;0;6;8;994;0;6337;8;2;
/org.eclipse.jdt.ui.tests/ui/org/eclipse/jdt/ui/tests/LeakTestSuite.java;2;0;4;2;0;0;0;4;8;2;3;4388;10;10;2;1;0;4;4;4817;1;4817;3;2;
/org.eclipse.osgi/resolver/src/org/eclipse/core/internal/dependencies/DependencySystem.java;4;2;9;1;7;6;7;2;106;1;2;3013;318;318;2;0;1;2;9;5529;1;5529;8;4;
/org.eclipse.jdt.core.tests.model/workspace/Converter/test0415/A.java;1;0;1;1;0;0;0;1;0;0;1;3714;0;0;1;0;0;1;1;3714;0;3714;1;1;
/org.eclipse.ui.workbench/Eclipse UI/org/eclipse/ui/internal/commands/old/Command2.java;1;0;2;1;0;0;0;2;0;1;2;1322;0;0;1;0;0;2;2;1322;0;1356;2;1;
/org.eclipse.ui.workbench/Eclipse UI/org/eclipse/ui/internal/model/WorkspaceFactory.java;1;0;1;1;0;0;0;1;0;0;1;2737;0;0;1;0;0;1;1;2737;0;2737;1;1;
/org.eclipse.pde.ui/sandbox/org/eclipse/pde/internal/ui/editor/standalone/text/SynchronizedUTF8FileDocumentProvider.java;1;0;2;1;0;0;0;2;0;1;2;2320;0;0;1;0;0;2;2;2320;0;2906;2;1;
/org.eclipse.jface.text/src/org/eclipse/jface/contentassist/ContentAssistant.java;1;1;2;1;2;2;2;0;0;0;0;5181;0;0;1;0;0;0;2;5181;0;5199;2;1;
/org.eclipse.jdt.core.tests.model/workspace/Converter/test0338/Test.java;1;0;1;1;0;0;0;1;0;0;1;3714;0;0;1;0;0;1;1;3714;0;3714;1;1;
/org.eclipse.team.ui/src/org/eclipse/team/internal/ui/synchronize/views/SyncSetContentProvider.java;2;0;4;1;0;0;0;4;293;1;4;2535;338;338;1;0;0;4;4;2535;0;4216;4;2;
/org.eclipse.jdt.core/search/org/eclipse/jdt/internal/core/search/matching/LocalVariablePattern.java;2;0;13;2;2;1;2;11;105;2;10;2514;237;237;2;1;1;11;13;2545;2;5208;11;2;
/org.eclipse.swt/Eclipse SWT Mozilla/common/org/eclipse/swt/internal/mozilla/nsIDirectoryServiceProvider.java;1;0;2;1;0;0;0;2;25;1;2;1654;25;25;1;0;0;2;2;1654;0;2568;2;1;
/org.eclipse.jdt.ui.tests.refactoring/resources/Delete/testDeleteWithinCu14/out/A.java;1;0;1;1;0;0;0;1;0;0;1;442;0;0;1;0;0;1;1;442;0;442;1;1;
/org.eclipse.jface.text/src/org/eclipse/jface/text/formatter/IFormattingStrategyExtension.java;2;0;3;1;1;1;1;2;33;1;2;1998;39;39;1;0;0;2;3;1998;0;6340;3;2;
/org.eclipse.compare/compare/org/eclipse/compare/EditionSelectionDialog.java;1;1;7;1;3;3;3;4;60;1;4;1289;92;92;1;0;0;4;7;1289;0;6322;7;1;
/org.eclipse.ui.examples.javaeditor/Eclipse Java Editor Example/org/eclipse/ui/examples/javaeditor/java/JavaCompletionProcessor.java;1;0;2;1;1;1;1;1;2;0;1;1349;4;4;1;0;0;1;2;1349;0;6340;2;1;
/org.eclipse.ui.ide/src/org/eclipse/ui/views/markers/internal/DialogProblemProperties.java;1;0;1;1;0;0;0;1;0;0;1;2208;0;0;1;0;0;1;1;2208;0;2208;1;1;
/org.eclipse.jdt.core.tests.model/workspace/Converter/junit/extensions/TestSetup.java;1;0;1;1;0;0;0;1;0;0;1;3714;0;0;1;0;0;1;1;3714;0;3714;1;1;
/org.eclipse.debug.ui/ui/org/eclipse/debug/internal/ui/launchVariables/LaunchVariableMessages.java;3;0;3;1;0;0;0;3;3;1;3;728;3;3;1;0;0;3;3;728;0;2120;3;3;
/org.eclipse.jdt.core.tests.model/workspace/Converter/test0035/Test.java;1;0;1;1;0;0;0;1;0;0;1;3714;0;0;1;0;0;1;1;3714;0;3714;1;1;
/org.eclipse.jdt.ui/ui refactoring/org/eclipse/jdt/internal/ui/refactoring/ChangePreviewViewerDescriptor.java;1;0;3;1;0;0;0;3;1;1;3;1033;1;1;1;0;0;3;3;1033;0;4965;3;1;
/org.eclipse.ui.workbench/Eclipse UI/org/eclipse/ui/internal/commands/api/IKeyConfiguration.java;1;0;2;1;0;0;0;2;2;0;1;2562;2;2;2;1;0;2;2;2562;1;2562;1;1;
/org.eclipse.pde.ui/src/org/eclipse/pde/internal/ui/preferences/TargetPlatformPreferencePage.java;2;1;9;1;3;3;3;6;224;2;5;217;320;320;2;1;0;6;9;2672;1;6336;8;2;
/org.eclipse.ui.workbench/Eclipse UI/org/eclipse/ui/internal/dnd/IDragOverListener.java;2;0;2;1;0;0;0;2;34;1;2;3677;34;34;1;0;0;2;2;3677;0;4015;2;2;
/org.eclipse.jdt.core.tests.model/workspace/Formatter/test095/A_out.java;1;0;1;1;0;0;0;1;0;0;1;2425;0;0;1;0;0;1;1;2425;0;2425;1;1;
/org.eclipse.jface.text/src/org/eclipse/jface/text/information/IInformationProvider.java;1;2;3;1;3;2;3;0;26;0;0;6340;28;28;2;0;1;0;3;6352;1;6352;2;1;
/org.eclipse.jdt.ui.tests.refactoring/resources/ExtractTemp/canExtract/A_test78_in.java;1;0;1;1;0;0;0;1;0;0;1;4171;0;0;1;0;0;1;1;4171;0;4171;1;1;
/org.eclipse.ui.workbench/Eclipse UI/org/eclipse/ui/internal/csm/commands/ActiveKeyConfigurationDefinition.java;1;0;3;1;0;0;0;3;16;2;2;2532;16;16;2;1;0;3;3;2532;1;2562;2;1;
/org.eclipse.team.cvs.ui/src/org/eclipse/team/internal/ccvs/ui/actions/MoveRemoteTagAction.java;1;0;2;1;0;0;0;2;47;1;2;994;49;49;1;0;0;2;2;994;0;1014;2;1;
/org.eclipse.debug.ui/ui/org/eclipse/debug/internal/ui/views/memory/SetDefaultColumnSizePrefAction.java;1;0;1;1;1;1;1;0;0;0;0;5409;0;0;1;0;0;0;1;5409;0;5409;1;1;
/org.eclipse.debug.ui/ui/org/eclipse/debug/ui/CommonTab.java;3;1;13;1;2;2;2;11;281;2;10;618;426;426;2;1;0;11;13;1953;1;5893;12;3;
/org.eclipse.team.cvs.ssh2/src/org/eclipse/team/ccvs/ssh2/CVSSSH2Method.java;3;0;5;1;0;0;0;5;48;1;5;2956;53;53;1;0;0;5;5;2956;0;4825;5;3;
/org.eclipse.jdt.core.tests.compiler/src/org/eclipse/jdt/core/tests/compiler/regression/JavadocTestMixed.java;1;1;23;1;7;7;7;16;392;1;16;2887;2388;2388;1;0;0;16;23;2887;0;6152;23;1;
/org.eclipse.pde.build/src/org/eclipse/pde/internal/build/site/BuildTimeFeature.java;2;0;6;1;1;1;1;5;4;1;5;447;4;4;1;0;0;5;6;447;0;5145;6;2;
/org.eclipse.jdt.debug/model/org/eclipse/jdt/debug/core/IJavaArray.java;1;0;1;1;0;0;0;1;3;0;1;2564;3;3;1;0;0;1;1;2564;0;2564;1;1;
/org.eclipse.ui.workbench/Eclipse UI/org/eclipse/ui/internal/activities/ws/CategoryLabelProvider.java;2;0;3;1;0;0;0;3;18;1;3;3066;18;18;1;0;0;3;3;3066;0;4651;3;2;
/org.eclipse.help.base/src/org/eclipse/help/internal/search/QueryWordsExactPhrase.java;1;1;4;1;3;3;3;1;12;0;1;1740;24;24;1;0;0;1;4;1740;0;6337;4;1;
/org.eclipse.team.tests.cvs.core/src/org/eclipse/team/tests/ccvs/core/subscriber/TestUpdateOperation.java;2;0;2;1;1;1;1;1;2;0;1;4450;2;2;1;0;0;1;2;4450;0;6337;2;2;
/org.eclipse.ua.tests/src/org/eclipse/ui/tests/cheatsheets/actions/TestCheatSheetParserAction.java;1;0;1;1;1;1;1;0;0;0;0;6081;0;0;1;0;0;0;1;6081;0;6081;1;1;
/org.eclipse.jdt.debug.ui/ui/org/eclipse/jdt/internal/debug/ui/launcher/SourceElementLabelProvider.java;2;0;2;1;1;1;1;1;4;0;1;5081;8;8;1;0;0;1;2;5081;0;6336;2;2;
/org.eclipse.help.tests/src/org/eclipse/help/tests/livehelp/LiveHelpAction.java;1;1;2;1;2;2;2;0;6;0;0;5827;12;12;1;0;0;0;2;5827;0;6337;2;1;
/org.eclipse.jdt.core.tests.model/workspace/Formatter/test375/A_in.java;1;0;2;1;0;0;0;2;1;1;2;3146;1;1;1;0;0;2;2;3146;0;3172;2;1;
/org.eclipse.jdt.core.tests.compiler/src/org/eclipse/jdt/core/tests/eval/EvaluationTest.java;3;0;10;1;0;0;0;10;791;1;10;13;893;893;1;0;0;10;10;13;0;3560;10;3;
/org.eclipse.jdt.debug.ui/ui/org/eclipse/jdt/internal/debug/ui/ImageDescriptorRegistry.java;2;0;2;1;1;1;1;1;4;0;1;3962;6;6;1;0;0;1;2;3962;0;6336;2;2;
/org.eclipse.jface.text/src/org/eclipse/jface/text/reconciler/IReconciler.java;1;2;3;1;3;2;3;0;36;0;0;6340;38;38;2;0;1;0;3;6353;1;6353;2;1;
/org.eclipse.team.ui/src/org/eclipse/team/ui/synchronize/actions/AndSyncInfoFilter.java;1;0;1;1;0;0;0;1;0;0;1;2535;0;0;1;0;0;1;1;2535;0;2535;1;1;
/org.eclipse.osgi/resolver/src/org/eclipse/core/internal/dependencies/ComputeNodeOrder.java;3;1;4;1;3;3;3;1;284;0;1;3013;437;437;1;0;0;1;4;3013;0;5529;4;3;
/org.eclipse.pde.ui/sandbox/org/eclipse/pde/internal/ui/editor/standalone/manifest/FragmentSourceContentProvider.java;1;0;2;1;0;0;0;2;0;1;2;2320;0;0;1;0;0;2;2;2320;0;2906;2;1;
/org.eclipse.jdt.ui.tests.refactoring/resources/ExtractMethodWorkSpace/ExtractMethodTests/parameterName_out/A_test906.java;1;0;1;1;0;0;0;1;0;0;1;4698;0;0;1;0;0;1;1;4698;0;4698;1;1;
/org.eclipse.jdt.core.tests.model/workspace/Converter/src/test0041/Test.java;1;0;1;1;0;0;0;1;0;0;1;3714;0;0;1;0;0;1;1;3714;0;3714;1;1;
/org.eclipse.core.resources/src/org/eclipse/core/internal/events/NotificationManager.java;2;3;24;2;10;7;10;14;282;2;12;1485;1089;1089;3;2;3;14;24;5484;5;5808;19;2;
/org.eclipse.jdt.ui/core extension/org/eclipse/jdt/internal/corext/dom/GenericVisitor.java;3;1;4;1;2;2;2;2;224;1;2;3801;299;299;1;0;0;2;4;3801;0;6340;4;3;
/org.eclipse.ui.workbench/Eclipse UI/org/eclipse/ui/internal/commands/ICommandRegistryEvent.java;1;0;3;1;0;0;0;3;18;1;3;1422;18;18;1;0;0;3;3;1422;0;2823;3;1;
/org.eclipse.jdt.ui.tests.refactoring/resources/ExtractMethodWorkSpace/ExtractMethodTests/expression_in/A_test602.java;1;0;1;1;0;0;0;1;2;0;1;844;2;2;1;0;0;1;1;844;0;844;1;1;
/org.eclipse.jdt.ui.tests.refactoring/resources/InlineMethodWorkspace/TestCases/nameconflict_out/TestSameTypeAfter.java;1;0;1;1;0;0;0;1;4;0;1;845;4;4;1;0;0;1;1;845;0;845;1;1;
/org.eclipse.pde.ui/src/org/eclipse/pde/internal/ui/editor/feature/FeatureForm.java;1;0;2;1;1;1;1;1;4;0;1;4203;4;4;1;0;0;1;2;4203;0;5431;2;1;
/org.eclipse.jdt.ui/ui/org/eclipse/jdt/internal/ui/javadocexport/JavadocReader.java;2;1;3;1;2;2;2;1;38;0;1;4047;50;50;1;0;0;1;3;4047;0;6340;3;2;
/org.eclipse.core.tests.runtime/src/org/eclipse/core/tests/plugintests/CmdLineAndStateTest.java;1;0;1;1;0;0;0;1;0;0;1;3014;0;0;1;0;0;1;1;3014;0;3014;1;1;
/org.eclipse.update.ui.win32/src/org/eclipse/update/internal/ui/win32/views/IEmbeddedWebBrowser.java;2;0;2;1;0;0;0;2;0;1;2;786;0;0;1;0;0;2;2;786;0;889;2;2;
/org.eclipse.pde.ui/src/org/eclipse/pde/internal/ui/editor/PDEFormSection.java;1;0;1;1;1;1;1;0;0;0;0;5431;0;0;1;0;0;0;1;5431;0;5431;1;1;
/org.eclipse.ui.workbench/Eclipse UI/org/eclipse/ui/commands/ICommandDelegate.java;1;0;2;1;0;0;0;2;0;1;2;1321;0;0;1;0;0;2;2;1321;0;1419;2;1;
/org.eclipse.core.tools.resources/src/org/eclipse/core/tools/resources/ProjectView.java;1;0;1;1;1;1;1;0;0;0;0;6302;0;0;1;0;0;0;1;6302;0;6302;1;1;
/org.eclipse.swt/Eclipse SWT Drag and Drop/win32/org/eclipse/swt/dnd/RTFTransfer.java;1;0;1;1;0;0;0;1;83;0;1;307;83;83;1;0;0;1;1;307;0;307;1;1;
/org.eclipse.jdt.ui.tests.refactoring/resources/ExtractMethodWorkSpace/ExtractMethodTests/semicolon_out/A_test407.java;1;0;2;1;0;0;0;2;4;1;2;130;5;5;1;0;0;2;2;130;0;844;2;1;
/org.eclipse.jface.text/src/org/eclipse/jface/text/link/TabStopIterator.java;2;1;3;1;2;2;2;1;8;0;1;4214;12;12;1;0;0;1;3;4214;0;6340;3;2;
/org.eclipse.ui.cheatsheets/src/org/eclipse/ui/internal/cheatsheets/registry/CheatSheetListenerElement.java;2;0;3;1;0;0;0;3;17;1;3;4428;17;17;1;0;0;3;3;4428;0;4662;3;2;
/org.eclipse.ui.workbench/Eclipse UI/org/eclipse/ui/internal/ide/StatusUtil.java;1;0;1;1;0;0;0;1;0;0;1;1259;0;0;1;0;0;1;1;1259;0;1259;1;1;
/org.eclipse.ui.workbench/Eclipse UI/org/eclipse/ui/handles/IHandleEvent.java;1;0;3;1;0;0;0;3;2;1;3;1294;2;2;1;0;0;3;3;1294;0;1507;3;1;
/org.eclipse.team.cvs.ui/src/org/eclipse/team/internal/uijobs/IDeferredWorkbenchAdapter.java;1;0;1;1;0;0;0;1;0;0;1;976;0;0;1;0;0;1;1;976;0;976;1;1;
/org.eclipse.jdt.core/compiler/org/eclipse/jdt/internal/compiler/lookup/UnresolvedReferenceBinding.java;2;0;2;1;0;0;0;2;2;1;2;80;3;3;1;0;0;2;2;80;0;3560;2;2;
/org.eclipse.ui.ide/src/org/eclipse/ui/views/framelist/BackAction.java;3;0;4;1;1;1;1;3;4;1;3;2208;9;9;1;0;0;3;4;2208;0;6338;4;3;
/org.eclipse.jdt.debug/model/org/eclipse/jdt/internal/debug/core/logicalstructures/LogicalObjectStructureClassType.java;1;0;1;1;0;0;0;1;0;0;1;2709;0;0;1;0;0;1;1;2709;0;2709;1;1;
/org.eclipse.swt/Eclipse SWT/win32/org/eclipse/swt/widgets/FileDialog.java;5;1;10;2;2;2;2;8;21;2;6;34;107;107;2;2;0;8;10;34;2;6352;8;5;
/org.eclipse.jdt.ui/core refactoring/org/eclipse/jdt/internal/corext/refactoring/typeconstraints/CompilationUnitRange.java;3;0;6;1;1;1;1;5;31;2;4;51;60;60;2;1;0;5;6;51;1;6340;5;3;
/org.eclipse.swt/Eclipse SWT/gtk1x/org/eclipse/swt/widgets/DirectoryDialog.java;1;0;1;1;0;0;0;1;0;0;1;2327;0;0;1;0;0;1;1;2327;0;2327;1;1;
/org.eclipse.jdt.junit/src/org/eclipse/jdt/internal/junit/ui/FailureTrace.java;2;1;2;1;2;2;2;0;2;0;0;5633;2;2;1;0;0;0;2;5633;0;6340;2;2;
/org.eclipse.team.cvs.ui/src/org/eclipse/team/internal/ccvs/ui/TagSelectionDialog.java;2;1;7;1;5;5;5;2;134;1;2;2381;204;204;1;0;0;2;7;2381;0;6337;7;2;
/org.eclipse.releng.basebuilder/plugins/org.eclipse.build.tools/org.eclipse.build.tools/src/org/eclipse/releng/ElementParser.java;1;0;1;1;1;1;1;0;0;0;0;5735;0;0;1;0;0;0;1;5735;0;5735;1;1;
/org.eclipse.core.tests.runtime/src/org/eclipse/core/tests/internal/runtimetests/SampleKFR.java;1;0;1;1;1;1;1;0;21;0;0;5149;21;21;1;0;0;0;1;5149;0;5149;1;1;
/org.eclipse.jdt.ui/ui refactoring/org/eclipse/jdt/internal/ui/refactoring/actions/RedoRefactoringAction.java;1;0;4;1;1;1;1;3;21;1;3;3708;29;29;1;0;0;3;4;3708;0;5162;4;1;
/org.eclipse.jdt.ui/ui/org/eclipse/jdt/internal/ui/text/java/hover/JavaEditorTextHoverDescriptor.java;2;1;6;1;2;2;2;4;50;2;3;600;139;139;2;1;0;4;6;612;1;6340;5;2;
/org.eclipse.jdt.core.tests.model/workspace/Formatter/test286/A_in.java;1;0;1;1;0;0;0;1;0;0;1;2443;0;0;1;0;0;1;1;2443;0;2443;1;1;
/org.eclipse.team.ftp/src/org/eclipse/team/internal/ftp/ui/FTPMainPage.java;1;0;1;1;0;0;0;1;0;0;1;4216;0;0;1;0;0;1;1;4216;0;4216;1;1;
/org.eclipse.search/new search/org/eclipse/search2/internal/ui/SearchResultsManager.java;1;0;4;1;0;0;0;4;14;1;4;3474;24;24;1;0;0;4;4;3474;0;4345;4;1;
/org.eclipse.update.core/srcnew/org/eclipse/update/internal/search/UnifiedUpdatesSearchCategory.java;2;0;12;2;0;0;0;12;54;2;9;572;128;128;2;3;0;12;12;572;3;825;9;2;
/org.eclipse.ui.workbench/Eclipse UI/org/eclipse/ui/internal/csm/commands/CommandEvent.java;1;0;4;1;0;0;0;4;18;2;3;2515;34;34;2;1;0;4;4;2556;1;2556;3;1;
/org.eclipse.ant.ui/Ant Editor/org/eclipse/ant/internal/ui/dtd/schema/Nfm.java;1;0;2;1;0;0;0;2;10;1;2;1811;10;10;1;0;0;2;2;1811;0;3614;2;1;
/org.eclipse.ui.workbench/Eclipse UI Editor Support/org/eclipse/ui/internal/editorsupport/ComponentSupport.java;2;0;4;1;1;1;1;3;54;1;3;2737;99;99;1;0;0;3;4;2737;0;6338;4;2;
/org.eclipse.team.cvs.core/src/org/eclipse/team/internal/ccvs/core/client/Command.java;2;0;12;2;1;1;1;11;40;2;10;784;93;93;2;1;0;11;12;784;1;6337;11;2;
/org.eclipse.jdt.ui/ui/org/eclipse/jdt/internal/ui/text/link/InclusivePositionUpdater.java;1;0;3;1;0;0;0;3;104;1;3;2838;104;104;1;0;0;3;3;2838;0;4214;3;1;
/org.eclipse.releng.basebuilder/plugins/org.eclipse.build.tools/org.eclipse.build.tools/src/org/eclipse/releng/FindMachineTask.java;1;0;1;1;1;1;1;0;0;0;0;5735;0;0;1;0;0;0;1;5735;0;5735;1;1;
/org.eclipse.team.cvs.ui/src/org/eclipse/team/internal/ccvs/ui/operations/CVSNonblockingRunnableContext.java;2;0;4;1;0;0;0;4;22;1;4;1840;26;26;1;0;0;4;4;1840;0;4216;4;2;
/org.eclipse.pde.ui/src/org/eclipse/pde/internal/ui/editor/plugin/rows/TextAttributeRow.java;2;1;4;1;4;4;4;0;10;0;0;5431;16;16;1;0;0;0;4;5431;0;6336;4;2;
/org.eclipse.swt/Eclipse SWT/common/org/eclipse/swt/graphics/PaletteData.java;1;1;2;1;2;2;2;0;4;0;0;6193;6;6;1;0;0;0;2;6193;0;6352;2;1;
/org.eclipse.pde.ui/src_Forms/org/eclipse/pde/internal/ui/neweditor/plugin/PluginUndoManager.java;2;2;4;2;4;3;4;0;46;0;0;5338;57;57;2;0;1;0;4;5426;1;5426;3;2;
/org.eclipse.search/new search/org/eclipse/search2/internal/ui/ShowSearchesAction.java;2;1;5;1;2;2;2;3;64;1;3;3474;121;121;1;0;0;3;5;3474;0;6340;5;2;
/org.eclipse.osgi/eclipseAdaptor/src/org/eclipse/core/runtime/adaptor/BundleStopper.java;5;2;12;2;10;9;10;2;169;1;2;4678;278;278;2;0;1;2;12;5313;1;6248;11;5;
/org.eclipse.ui.workbench/Eclipse UI/org/eclipse/ui/internal/intro/IntroRegistryReader.java;3;0;7;2;0;0;0;7;21;2;6;3632;39;39;2;1;0;7;7;4609;1;4825;6;3;
/org.eclipse.jdt.debug.jdi.tests/tests/org/eclipse/debug/jdi/tests/program/TestClass7.java;1;0;1;1;1;1;1;0;3;0;0;6339;3;3;1;0;0;0;1;6339;0;6339;1;1;
/org.eclipse.jdt.core.tests.model/workspace/Converter/test0318/Test.java;1;0;1;1;0;0;0;1;0;0;1;3714;0;0;1;0;0;1;1;3714;0;3714;1;1;
/org.eclipse.ant.ui/Ant Tools Support/org/eclipse/ui/ant/internal/views/actions/RemoveProjectAction.java;1;0;2;1;0;0;0;2;0;1;2;250;0;0;1;0;0;2;2;250;0;263;2;1;
/org.eclipse.jdt.core.tests.model/workspace/Converter/src/test0281/Test.java;1;0;1;1;0;0;0;1;0;0;1;3714;0;0;1;0;0;1;1;3714;0;3714;1;1;
/org.eclipse.help/src/org/eclipse/help/internal/search/LazyProgressMonitor.java;1;0;1;1;0;0;0;1;0;0;1;2732;0;0;1;0;0;1;1;2732;0;2732;1;1;
/org.eclipse.update.core/src/org/eclipse/update/core/IFeatureContentConsumer.java;2;1;4;1;3;3;3;1;6;0;1;890;19;19;1;0;0;1;4;890;0;6336;4;2;
/org.eclipse.jdt.core/codeassist/org/eclipse/jdt/internal/codeassist/impl/AssistParser.java;6;1;21;1;2;2;2;19;89;1;19;69;261;261;1;0;0;19;21;69;0;5878;21;6;
/org.eclipse.jdt.core.tests.model/workspace/Formatter/test494/A_in.java;1;0;1;1;1;1;1;0;0;0;0;5381;0;0;1;0;0;0;1;5381;0;5381;1;1;
/org.eclipse.update.ui.forms/src/org/eclipse/update/ui/forms/internal/richtext/HyperlinkSegment.java;1;0;3;1;0;0;0;3;4;2;2;2849;4;4;2;1;0;3;3;2849;1;2898;2;1;
/org.eclipse.jdt.ui/ui/org/eclipse/jdt/internal/ui/text/correction/NewMethodCompletionProposal.java;3;1;30;2;7;7;7;23;317;1;23;299;951;951;1;0;0;23;30;299;0;6340;30;3;
/org.eclipse.jdt.core.tests.model/workspace/Resolve/src/ResolveMethodDeclarationInAnonymous.java;1;0;1;1;0;0;0;1;0;0;1;2623;0;0;1;0;0;1;1;2623;0;2623;1;1;
/org.eclipse.jface.text/src/org/eclipse/jface/text/templates/PositionBasedCompletionProposal.java;2;1;4;1;2;2;2;2;40;1;2;4650;44;44;1;0;0;2;4;4650;0;6340;4;2;
/org.eclipse.webdav/src/interface/org/eclipse/webdav/IResponse.java;1;0;1;1;1;1;1;0;4;0;0;5151;4;4;1;0;0;0;1;5151;0;5151;1;1;
/org.eclipse.jdt.debug.ui/ui/org/eclipse/jdt/internal/debug/ui/launcher/JavaAppletLaunchShortcut.java;3;1;11;2;3;3;3;8;89;2;7;648;214;214;2;1;0;8;11;3806;1;6336;10;3;
/org.eclipse.debug.ui/ui/org/eclipse/debug/internal/ui/DialogSettingsHelper.java;1;0;1;1;0;0;0;1;0;0;1;4837;0;0;1;0;0;1;1;4837;0;4837;1;1;
/org.eclipse.jdt.ui/ui refactoring/org/eclipse/jdt/internal/ui/refactoring/reorg/RenameCuWizard.java;2;0;6;1;1;1;1;5;9;2;4;1047;26;26;2;1;0;5;6;1125;1;6340;5;2;
/org.eclipse.ui.workbench/Eclipse UI/org/eclipse/ui/internal/commands/old/RegistryEvent.java;1;0;2;1;0;0;0;2;0;1;2;1322;0;0;1;0;0;2;2;1322;0;1356;2;1;
/org.eclipse.pde.ui/src/org/eclipse/pde/internal/ui/editor/plugin/ExtensionsSection.java;3;2;14;2;14;12;14;0;120;0;0;5431;226;226;2;0;2;0;14;5558;2;6336;12;3;
/org.eclipse.ui.workbench/Eclipse UI/org/eclipse/ui/internal/csm/roles/FileRoleRegistry.java;1;0;2;1;0;0;0;2;0;1;2;2213;0;0;1;0;0;2;2;2213;0;2371;2;1;
/org.eclipse.swt/Eclipse SWT/common/org/eclipse/swt/layout/RowLayout.java;3;1;7;1;2;2;2;5;135;2;4;263;268;268;2;1;0;5;7;899;1;6352;6;3;
/org.eclipse.jdt.core.tests.model/workspace/Formatter/test276/A_in.java;1;0;1;1;0;0;0;1;0;0;1;2443;0;0;1;0;0;1;1;2443;0;2443;1;1;
/org.eclipse.ui.workbench/Eclipse UI/org/eclipse/ui/activities/ActivityServiceEvent.java;1;0;3;1;0;0;0;3;4;1;3;2800;4;4;1;0;0;3;3;2800;0;2896;3;1;
/org.eclipse.ui.workbench.texteditor/src/org/eclipse/ui/texteditor/ISchedulingRuleProvider.java;2;0;2;1;1;1;1;1;2;0;1;4760;2;2;1;0;0;1;2;4760;0;6340;2;2;
/org.eclipse.debug.core/core/org/eclipse/debug/internal/core/sourcelookup/containers/SourceLookupMessages.java;2;0;2;2;0;0;0;2;0;0;1;3678;0;0;2;1;0;2;2;3678;1;3678;1;2;
/org.eclipse.core.tests.runtime/src/org/eclipse/core/tests/runtime/jobs/FussyProgressProvider.java;2;0;3;1;1;1;1;2;8;1;2;850;14;14;1;0;0;2;3;850;0;5149;3;2;
/org.eclipse.jdt.ui/core extension/org/eclipse/jdt/internal/corext/codemanipulation/DeleteNodeEdit.java;1;0;1;1;0;0;0;1;0;0;1;188;0;0;1;0;0;1;1;188;0;188;1;1;
/org.eclipse.jdt.ui/ui/org/eclipse/jdt/internal/ui/preferences/CodeAssistPreferencePage.java;1;0;1;1;1;1;1;0;0;0;0;5506;0;0;1;0;0;0;1;5506;0;5506;1;1;
/org.eclipse.jdt.debug.tests/tests/org/eclipse/jdt/debug/tests/eval/DoubleOperatorsTests.java;1;0;1;1;0;0;0;1;160;0;1;1274;160;160;1;0;0;1;1;1274;0;1274;1;1;
/org.eclipse.jface.text/src/org/eclipse/jface/internal/text/link/contentassist/PopupCloser2.java;2;0;2;1;1;1;1;1;2;0;1;4214;2;2;1;0;0;1;2;4214;0;6340;2;2;
/org.eclipse.ant.core/src/org/eclipse/ant/core/IAntClasspathEntry.java;1;0;4;1;1;1;1;3;8;1;3;2575;15;15;1;0;0;3;4;2575;0;6336;4;1;
/org.eclipse.team.cvs.ui/src/org/eclipse/team/internal/ccvs/ui/subscriber/CVSParticipant.java;2;2;4;2;3;2;3;1;91;0;1;5081;149;149;2;0;1;1;4;5358;1;5596;3;2;
/org.eclipse.team.ui/src/org/eclipse/team/internal/ui/synchronize/sets/SyncSetInputFromSubscriber.java;1;0;3;1;0;0;0;3;44;1;3;2535;44;44;1;0;0;3;3;2535;0;4216;3;1;
/org.eclipse.text/src/org/eclipse/text/edits/Updater.java;1;0;3;1;0;0;0;3;38;1;3;1986;38;38;1;0;0;3;3;1986;0;2113;3;1;
/org.eclipse.jdt.core.tests.model/workspace/Formatter/test116/A_in.java;1;0;1;1;0;0;0;1;0;0;1;2425;0;0;1;0;0;1;1;2425;0;2425;1;1;
/org.eclipse.ui.workbench/Eclipse UI/org/eclipse/ui/internal/WorkingSetManager.java;1;0;2;1;0;0;0;2;145;1;2;2737;147;147;1;0;0;2;2;2737;0;3206;2;1;
/org.eclipse.jdt.core/dom/org/eclipse/jdt/internal/core/dom/rewrite/GenericVisitor.java;2;0;2;1;1;1;1;1;4;0;1;4802;4;4;1;0;0;1;2;4802;0;6336;2;2;
/org.eclipse.core.tests.resources/src/org/eclipse/core/tests/internal/localstore/SafeChunkyInputOutputStreamTest.java;2;2;3;1;3;2;3;0;474;0;0;5147;476;476;2;0;1;0;3;5147;1;6206;2;2;
/org.eclipse.search.tests/src/org/eclipse/search/core/tests/QueryManagerTest.java;1;0;2;1;0;0;0;2;6;1;2;4345;6;6;1;0;0;2;2;4345;0;4693;2;1;
/org.eclipse.jdt.ui/core extension/org/eclipse/jdt/internal/corext/util/JavaModelUtil.java;5;1;28;1;5;5;5;23;156;2;22;170;802;802;2;1;0;23;28;4064;1;6340;27;5;
/org.eclipse.jdt.core.tests.model/workspace/Formatter/test065/A_out.java;1;0;1;1;0;0;0;1;0;0;1;2425;0;0;1;0;0;1;1;2425;0;2425;1;1;
/org.eclipse.ui.workbench/Eclipse UI/org/eclipse/ui/contexts/IContextDefinitionHandle.java;1;0;2;1;0;0;0;2;0;1;2;1388;0;0;1;0;0;2;2;1388;0;1400;2;1;
/org.eclipse.jdt.core.tests.model/workspace/Formatter/test216/A_out.java;1;0;1;1;0;0;0;1;0;0;1;2426;0;0;1;0;0;1;1;2426;0;2426;1;1;
/org.eclipse.team.ui/src/org/eclipse/team/internal/ui/sync/actions/SyncViewerToolbarDropDownAction.java;2;0;6;1;0;0;0;6;86;1;6;629;120;120;1;0;0;6;6;629;0;2632;6;2;
/org.eclipse.ui.workbench/Eclipse UI/org/eclipse/ui/internal/dialogs/IndentedTableViewer.java;1;0;1;1;0;0;0;1;0;0;1;830;0;0;1;0;0;1;1;830;0;830;1;1;
/org.eclipse.jdt.ui/ui/org/eclipse/jdt/internal/ui/text/java/SmartSemicolonAutoEditStrategy.java;3;1;23;1;5;5;5;18;839;2;17;500;1369;1369;2;1;0;18;23;2888;1;6340;22;3;
/org.eclipse.team.ui/src/org/eclipse/team/internal/ui/PromptingDialog.java;2;0;2;1;0;0;0;2;29;1;2;228;29;29;1;0;0;2;2;228;0;993;2;2;
/org.eclipse.pde.ui/src/org/eclipse/pde/internal/ui/editor/build/JavadocPackagesSection.java;1;0;3;1;0;0;0;3;20;2;2;1777;20;20;2;1;0;3;3;1777;1;1791;2;1;
/org.eclipse.jdt.core/model/org/eclipse/jdt/internal/core/util/ConstantPool.java;1;0;1;1;0;0;0;1;2;0;1;3560;2;2;1;0;0;1;1;3560;0;3560;1;1;
/org.eclipse.update.core/src/org/eclipse/update/internal/api/search/IUpdateSearchCategory.java;1;0;2;1;0;0;0;2;0;1;2;3270;0;0;1;0;0;2;2;3270;0;4928;2;1;
/org.eclipse.swt/Eclipse SWT PI/motif/org/eclipse/swt/internal/motif/XmDragProcCallbackStruct.java;1;0;2;1;0;0;0;2;4;1;2;829;4;4;1;0;0;2;2;829;0;868;2;1;
/org.eclipse.ui.workbench/Eclipse UI/org/eclipse/ui/internal/commands/SequenceMachine.java;1;0;6;1;0;0;0;6;129;2;5;607;133;133;2;1;0;6;6;1077;1;1222;5;1;
/org.eclipse.pde.core/src/org/eclipse/pde/internal/core/osgi/bundle/BundlePlugin.java;1;1;4;1;2;2;2;2;22;1;2;4203;28;28;1;0;0;2;4;4203;0;5445;4;1;
/org.eclipse.update.ui/src/org/eclipse/update/internal/ui/wizards/BaseNewWizardPage.java;1;0;1;1;0;0;0;1;0;0;1;755;0;0;1;0;0;1;1;755;0;755;1;1;
/org.eclipse.ui.tests/Eclipse UI Tests/org/eclipse/ui/tests/dnd/DragOperations.java;1;1;3;1;2;2;2;1;17;0;1;5007;21;21;1;0;0;1;3;5007;0;5825;3;1;
/org.eclipse.help/src/org/eclipse/help/standalone/Infocenter.java;1;0;1;1;0;0;0;1;0;0;1;2732;0;0;1;0;0;1;1;2732;0;2732;1;1;
/org.eclipse.ui.workbench/Eclipse UI/org/eclipse/ui/internal/dialogs/WizardNewProjectNameAndLocationPage.java;1;0;1;1;0;0;0;1;0;0;1;2737;0;0;1;0;0;1;1;2737;0;2737;1;1;
/org.eclipse.jdt.ui/core refactoring/org/eclipse/jdt/internal/corext/refactoring/reorg2/IReorgPolicy.java;1;0;4;1;0;0;0;4;6;2;2;802;10;10;2;2;0;4;4;802;2;1111;2;1;
/org.eclipse.ui.ide/src/org/eclipse/ui/views/navigator/GotoResourceDialog.java;1;0;1;1;0;0;0;1;0;0;1;2208;0;0;1;0;0;1;1;2208;0;2208;1;1;
/org.eclipse.ui.workbench/Eclipse UI/org/eclipse/ui/keys/ParseException.java;3;1;11;1;2;2;2;9;25;3;7;1341;74;74;3;2;0;9;11;2202;2;6338;9;3;
/org.eclipse.jdt.ui/core refactoring/org/eclipse/ltk/internal/refactoring/core/RefactoringCoreMessages.java;1;0;2;1;0;0;0;2;0;1;2;3930;0;0;1;0;0;2;2;3930;0;4510;2;1;
/org.eclipse.jdt.ui.tests.refactoring/resources/MoveMembers/test7/in/A.java;1;0;1;1;0;0;0;1;1;0;1;1522;1;1;1;0;0;1;1;1522;0;1522;1;1;
/org.eclipse.osgi/resolver/src/org/eclipse/core/internal/dependencies/ResolutionVisitor.java;4;1;5;1;4;4;4;1;19;0;1;3013;31;31;1;0;0;1;5;3013;0;5529;5;4;
/org.eclipse.debug.ui/ui/org/eclipse/debug/internal/ui/views/breakpoints/BreakpointsViewEventHandler.java;5;1;11;2;2;2;2;9;48;2;8;1434;124;124;2;1;0;9;11;1608;1;6336;10;5;
/org.eclipse.jdt.core.tests.model/workspace/Formatter/test310/A_in.java;1;0;1;1;0;0;0;1;0;0;1;2442;0;0;1;0;0;1;1;2442;0;2442;1;1;
/org.eclipse.jdt.debug/model/org/eclipse/jdt/internal/debug/core/logicalstructures/MapStructureType.java;2;1;4;1;2;2;2;2;10;1;2;2647;18;18;1;0;0;2;4;2647;0;6336;4;2;
/org.eclipse.team.ui/src/org/eclipse/team/ui/synchronize/ITeamSubscriberSyncInfoSets.java;1;0;1;1;0;0;0;1;0;0;1;3286;0;0;1;0;0;1;1;3286;0;3286;1;1;
/org.eclipse.ui.forms/src/org/eclipse/ui/forms/editor/FormPage.java;1;1;13;1;2;2;2;11;240;2;10;4068;308;308;2;1;0;11;13;4284;1;6336;12;1;
/org.eclipse.pde.runtime/src/org/eclipse/pde/internal/runtime/logview/LogEntry.java;2;1;4;1;2;2;2;2;16;1;2;831;30;30;1;0;0;2;4;831;0;6336;4;2;
/org.eclipse.jdt.ui.examples.javafamily/src/org/eclipse/jdt/internal/ui/examples/jspeditor/JSPEditor.java;1;0;2;1;0;0;0;2;0;1;2;1045;0;0;1;0;0;2;2;1045;0;1071;2;1;
/org.eclipse.jdt.ui/core refactoring/org/eclipse/jdt/internal/corext/refactoring/reorg2/IReorgQueries.java;1;0;6;1;0;0;0;6;12;1;6;444;22;22;1;0;0;6;6;444;0;1114;6;1;
/org.eclipse.ant.tests.core/tests/org/eclipse/ant/tests/core/tests/OptionTests.java;1;0;22;1;0;0;0;22;92;3;19;135;321;321;3;3;0;22;22;3495;3;4076;19;1;
/org.eclipse.ui.intro/src/org/eclipse/ui/intro/config/IntroURLFactory.java;2;1;4;1;4;4;4;0;67;0;0;5277;79;79;1;0;0;0;4;5277;0;6343;4;2;
/org.eclipse.ant.ui/Ant Editor/org/eclipse/ant/internal/ui/editor/outline/IProblemRequestor.java;1;0;1;1;0;0;0;1;0;0;1;1811;0;0;1;0;0;1;1;1811;0;1811;1;1;
/org.eclipse.jdt.core.tests.model/workspace/Formatter/test430/A_in.java;1;0;1;1;0;0;0;1;0;0;1;3478;0;0;1;0;0;1;1;3478;0;3478;1;1;
/org.eclipse.help.ui/src/org/eclipse/help/ui/internal/search/SearchQueryData.java;1;0;4;1;0;0;0;4;51;1;4;105;108;108;1;0;0;4;4;105;0;2732;4;1;
/org.eclipse.jdt.core/model/org/eclipse/jdt/internal/core/SortJavaElement.java;2;0;2;1;0;0;0;2;6;1;2;61;8;8;1;0;0;2;2;61;0;3560;2;2;
/org.eclipse.ui.workbench/Eclipse UI/org/eclipse/ui/internal/commands/ImageFactory.java;4;0;13;1;1;1;1;12;17;1;12;786;60;60;1;0;0;12;13;786;0;6338;13;4;
/org.eclipse.ui.workbench/Eclipse UI/org/eclipse/ui/internal/commands/IActivityBindingDefinition.java;1;0;3;1;0;0;0;3;2;1;3;2562;2;2;1;0;0;3;3;2562;0;3128;3;1;
/org.eclipse.update.ui/srcnew/org/eclipse/update/internal/ui/UpdateWebSitesAction.java;2;0;4;1;0;0;0;4;32;2;3;699;39;39;2;1;0;4;4;699;1;825;3;2;
/org.eclipse.update.core/srcnew/org/eclipse/update/search/EnvironmentFilter.java;2;0;4;1;0;0;0;4;18;2;3;580;20;20;2;1;0;4;4;580;1;825;3;2;
/org.eclipse.ui.workbench/Eclipse UI/org/eclipse/ui/model/WorkbenchAdapter.java;4;0;6;1;1;1;1;5;60;1;5;2616;93;93;1;0;0;5;6;2616;0;6338;6;4;
/org.eclipse.jdt.core.tests.model/workspace/Converter/test0484/A.java;1;0;2;1;0;0;0;2;0;1;2;1289;0;0;1;0;0;2;2;1289;0;3714;2;1;
/org.eclipse.debug.ui/ui/org/eclipse/debug/ui/actions/AbstractLaunchToolbarAction.java;1;0;2;1;0;0;0;2;4;1;2;2312;6;6;1;0;0;2;2;2312;0;2589;2;1;
/org.eclipse.ui.workbench/Eclipse UI/org/eclipse/ui/IMarkerResolutionGenerator.java;1;0;1;1;0;0;0;1;0;0;1;2737;0;0;1;0;0;1;1;2737;0;2737;1;1;
/org.eclipse.debug.core/core/org/eclipse/debug/internal/core/variables/ProjectNameExpander.java;2;0;2;1;0;0;0;2;0;1;2;737;0;0;1;0;0;2;2;737;0;2120;2;2;
/org.eclipse.jdt.ui/core extension/org/eclipse/jdt/internal/corext/textmanipulation/Regions.java;1;0;3;1;0;0;0;3;6;2;2;1607;6;6;2;1;0;3;3;1946;1;1946;2;1;
/org.eclipse.ui.workbench/Eclipse UI/org/eclipse/ui/commands/ICommandDelegateServiceListener.java;1;0;2;1;0;0;0;2;0;1;2;1321;0;0;1;0;0;2;2;1321;0;1419;2;1;
/org.eclipse.jdt.core.tests.compiler/src/org/eclipse/jdt/core/tests/compiler/parser/ComplianceParserTest.java;1;0;1;1;0;0;0;1;0;0;1;4422;0;0;1;0;0;1;1;4422;0;4422;1;1;
/org.eclipse.team.ftp/src/org/eclipse/team/internal/ftp/deployment/FTPOperation.java;1;0;1;1;0;0;0;1;0;0;1;3221;0;0;1;0;0;1;1;3221;0;3221;1;1;
/org.eclipse.ui.workbench/Eclipse UI/org/eclipse/ui/contexts/IContextManagerEvent.java;1;0;4;1;0;0;0;4;4;1;4;1137;6;6;1;0;0;4;4;1137;0;2425;4;1;
/org.eclipse.jdt.core.tests.compiler/src/org/eclipse/jdt/core/tests/compiler/parser/SourceField.java;1;0;2;1;0;0;0;2;25;1;2;241;27;27;1;0;0;2;2;241;0;3560;2;1;
/org.eclipse.team.core/src/org/eclipse/team/core/subscribers/utils/DescendantSynchronizationCache.java;1;0;1;1;0;0;0;1;0;0;1;3563;0;0;1;0;0;1;1;3563;0;3563;1;1;
/org.eclipse.core.resources/src/org/eclipse/core/internal/resources/IManager.java;1;0;1;1;1;1;1;0;9;0;0;5146;9;9;1;0;0;0;1;5146;0;5146;1;1;
/org.eclipse.ui.workbench.texteditor/src/org/eclipse/ui/texteditor/AbstractTextEditor.java;4;3;84;2;26;21;26;58;479;4;42;227;3454;3454;4;16;5;58;84;692;21;6334;63;4;
/org.eclipse.ui.workbench/Eclipse UI/org/eclipse/ui/keys/KeyStroke.java;3;1;27;1;2;2;2;25;545;3;22;1294;2119;2119;3;3;0;25;27;2202;3;6338;24;3;
/org.eclipse.jdt.ui.tests.refactoring/resources/DeleteSourceReferenceEdit/A_test7_out.java;1;0;1;1;0;0;0;1;0;0;1;1652;0;0;1;0;0;1;1;1652;0;1652;1;1;
/org.eclipse.jdt.core.tests.model/workspace/Formatter/test458/A_in.java;1;0;1;1;0;0;0;1;0;0;1;3861;0;0;1;0;0;1;1;3861;0;3861;1;1;
/org.eclipse.ui.console/src/org/eclipse/ui/console/actions/ClearOutputAction.java;2;0;3;1;0;0;0;3;11;1;3;1988;18;18;1;0;0;3;3;1988;0;2108;3;2;
/org.eclipse.jdt.core.tests.model/workspace/Formatter/test107/A_in.java;1;0;1;1;0;0;0;1;0;0;1;2425;0;0;1;0;0;1;1;2425;0;2425;1;1;
/org.eclipse.team.ui/src/org/eclipse/team/internal/ui/ExceptionCollector.java;1;0;3;1;0;0;0;3;99;1;3;1324;99;99;1;0;0;3;3;1324;0;1433;3;1;
/org.eclipse.ui.workbench/Eclipse UI/org/eclipse/ui/internal/commands/CoreRegistry.java;1;0;4;1;0;0;0;4;173;1;4;607;173;173;1;0;0;4;4;607;0;1077;4;1;
/org.eclipse.jdt.core/compiler/org/eclipse/jdt/internal/compiler/ast/BinaryExpression.java;2;0;7;1;0;0;0;7;61;1;7;693;171;171;1;0;0;7;7;693;0;3560;7;2;
/org.eclipse.jdt.ui.tests.refactoring/resources/Paste/test3/in/B.java;1;0;1;1;0;0;0;1;0;0;1;1311;0;0;1;0;0;1;1;1311;0;1311;1;1;
/org.eclipse.jdt.core.tests.model/workspace/Formatter/test371/A_out.java;2;0;2;1;0;0;0;2;12;1;2;3130;12;12;1;0;0;2;2;3130;0;3362;2;2;
/org.eclipse.jdt.core.tests.model/workspace/Formatter/test211/A_out.java;1;0;1;1;0;0;0;1;0;0;1;2424;0;0;1;0;0;1;1;2424;0;2424;1;1;
/org.eclipse.jdt.ui/ui/org/eclipse/jdt/ui/actions/ChangeTypeAction.java;3;1;10;1;3;3;3;7;123;1;7;2844;276;276;1;0;0;7;10;2844;0;6340;10;3;
/org.eclipse.debug.ui/ui/org/eclipse/debug/internal/ui/console/MessageConsolePage.java;2;0;4;1;0;0;0;4;52;2;3;1418;68;68;2;1;0;4;4;1418;1;2060;3;2;
/org.eclipse.jdt.core/model/org/eclipse/jdt/internal/core/util/SimpleWordSet.java;2;0;3;1;0;0;0;3;8;1;3;3423;10;10;1;0;0;3;3;3423;0;4327;3;2;
/org.eclipse.team.ui/src/org/eclipse/team/internal/ui/widgets/HyperlinkHandler.java;1;0;1;1;0;0;0;1;0;0;1;3176;0;0;1;0;0;1;1;3176;0;3176;1;1;
/org.eclipse.ui.intro/src/org/eclipse/ui/internal/intro/impl/swt/RootPageForm.java;1;3;9;1;9;7;9;0;179;0;0;5714;224;224;3;0;2;0;9;5766;2;5937;7;1;
/org.eclipse.releng.tests/src/org/eclipse/releng/tests/perfms/UITest.java;2;1;5;1;2;2;2;3;40;1;3;4852;106;106;1;0;0;3;5;4852;0;6300;5;2;
/org.eclipse.jdt.ui.tests.refactoring/resources/ExtractMethodWorkSpace/ExtractMethodTests/locals_in/A_test569.java;1;0;1;1;0;0;0;1;2;0;1;844;2;2;1;0;0;1;1;844;0;844;1;1;
/org.eclipse.core.tests.runtime/src/org/eclipse/core/tests/runtime/jobs/RuleSetD.java;2;0;2;1;0;0;0;2;0;1;2;2160;0;0;1;0;0;2;2;2160;0;3408;2;2;
/org.eclipse.core.resources/src/org/eclipse/core/internal/localstore/BlobStore.java;2;1;4;1;3;3;3;1;325;0;1;93;390;390;1;0;0;1;4;93;0;6127;4;2;
/org.eclipse.team.cvs.ui/src/org/eclipse/team/internal/ccvs/ui/wizards/CheckoutAsMainPage.java;2;1;9;1;2;2;2;7;229;2;6;276;271;271;2;1;0;7;9;4869;1;6337;8;2;
/org.eclipse.team.core/src/org/eclipse/team/core/subscribers/SyncInfoTree.java;1;0;1;1;0;0;0;1;0;0;1;4017;0;0;1;0;0;1;1;4017;0;4017;1;1;
/org.eclipse.team.cvs.ui/src/org/eclipse/team/internal/ccvs/ui/actions/CheckoutAction.java;2;0;6;1;1;1;1;5;172;1;5;228;314;314;1;0;0;5;6;228;0;6337;6;2;
/org.eclipse.pde.ui/src_Forms/org/eclipse/pde/internal/ui/neweditor/plugin/MatchSection.java;2;0;10;1;1;1;1;9;141;2;8;4265;239;239;2;1;0;9;10;4354;1;5431;9;2;
/org.eclipse.pde.ui/templates_3.0/multiPageEditor/java/$contributorClassName$.java;2;0;2;1;0;0;0;2;35;1;2;2786;35;35;1;0;0;2;2;2786;0;2831;2;2;
/org.eclipse.jdt.core/model/org/eclipse/jdt/internal/core/JavaElementInfo.java;2;0;4;1;0;0;0;4;29;1;4;530;39;39;1;0;0;4;4;530;0;3560;4;2;
/org.eclipse.help.base/src/org/eclipse/help/internal/browser/BrowserDescriptor.java;1;1;5;1;2;2;2;3;30;1;3;1740;51;51;1;0;0;3;5;1740;0;6337;5;1;
/org.eclipse.jdt.ui/core extension/org/eclipse/jdt/internal/corext/dom/fragments/AssociativeInfixExpressionFragment.java;3;1;3;1;2;2;2;1;4;0;1;1309;7;7;1;0;0;1;3;1309;0;6340;3;3;
/org.eclipse.jdt.core/search/org/eclipse/jdt/internal/core/index/impl/PropertyDocument.java;1;0;1;1;0;0;0;1;0;0;1;883;0;0;1;0;0;1;1;883;0;883;1;1;
/org.eclipse.team.cvs.core/src/org/eclipse/team/internal/ccvs/core/util/MoveDeleteHook.java;1;0;7;1;0;0;0;7;95;1;7;866;116;116;1;0;0;7;7;866;0;2445;7;1;
/org.eclipse.jdt.ui.tests.refactoring/resources/Paste/test3/in/A.java;1;0;1;1;0;0;0;1;0;0;1;1311;0;0;1;0;0;1;1;1311;0;1311;1;1;
/org.eclipse.ui.workbench/Eclipse UI/org/eclipse/ui/internal/roles/api/IRoleManagerListener.java;1;0;2;1;0;0;0;2;0;0;1;2202;0;0;2;1;0;2;2;2202;1;2202;1;1;
/org.eclipse.jdt.core.tests.model/workspace/Converter/test0076/Test.java;1;0;1;1;0;0;0;1;0;0;1;3714;0;0;1;0;0;1;1;3714;0;3714;1;1;
/org.eclipse.releng.basebuilder/plugins/org.eclipse.build.tools/src/org/eclipse/releng/VersionNumberStripper.java;1;0;1;1;0;0;0;1;10;0;1;3597;10;10;1;0;0;1;1;3597;0;3597;1;1;
/org.eclipse.jdt.ui.tests.refactoring/resources/MoveInstanceMethod/canMove/test17/in/Rectangle.java;1;0;1;1;0;0;0;1;0;0;1;1570;0;0;1;0;0;1;1;1570;0;1570;1;1;
/org.eclipse.pde.ui/src/org/eclipse/pde/internal/ui/wizards/ListUtil.java;1;0;1;1;0;0;0;1;4;0;1;1111;4;4;1;0;0;1;1;1111;0;1111;1;1;
/org.eclipse.team.ui/src/org/eclipse/team/internal/ui/jobs/RefreshChangeListener.java;1;0;3;1;0;0;0;3;55;1;3;3436;55;55;1;0;0;3;3;3436;0;4518;3;1;
/org.eclipse.ui.views/src/org/eclipse/ui/views/internal/markers/ActionResolveMarker.java;1;0;2;1;0;0;0;2;0;0;1;749;0;0;2;1;0;2;2;749;1;749;1;1;
/org.eclipse.ui.workbench/Eclipse UI/org/eclipse/ui/internal/activities/ICategoryDefinition.java;1;0;2;1;0;0;0;2;0;1;2;2867;0;0;1;0;0;2;2;2867;0;3066;2;1;
/org.eclipse.jdt.core/compiler/org/eclipse/jdt/internal/compiler/codegen/QualifiedNamesConstants.java;2;0;2;1;0;0;0;2;3;1;2;446;5;5;1;0;0;2;2;446;0;3560;2;2;
/org.eclipse.jdt.debug.tests/tests/org/eclipse/jdt/debug/tests/eval/TestsTypeHierarchy1.java;1;0;1;1;0;0;0;1;42;0;1;1274;42;42;1;0;0;1;1;1274;0;1274;1;1;
/org.eclipse.ui.workbench/Eclipse UI/org/eclipse/ui/themes/RGBBlendColorFactory.java;1;0;2;1;1;1;1;1;14;0;1;4423;14;14;1;0;0;1;2;4423;0;5247;2;1;
/org.eclipse.jdt.debug.jdi.tests/tests/org/eclipse/debug/jdi/tests/ThreadReferenceTest.java;1;0;2;1;0;0;0;2;21;1;2;1320;24;24;1;0;0;2;2;1320;0;4264;2;1;
/org.eclipse.jdt.ui/ui/org/eclipse/jdt/internal/ui/javaeditor/WorkingCopyManager.java;2;0;2;1;1;1;1;1;6;0;1;1582;8;8;1;0;0;1;2;1582;0;6340;2;2;
/org.eclipse.ant.ui/Ant Editor/org/eclipse/ant/internal/ui/editor/AntEditorActionContributor.java;1;0;9;1;0;0;0;9;38;3;7;1811;108;108;3;2;0;9;9;3916;2;4560;7;1;
/org.eclipse.debug.ui/ui/org/eclipse/debug/ui/actions/AbstractLaunchHistoryAction.java;3;0;5;1;1;1;1;4;32;1;4;2645;59;59;1;0;0;4;5;2645;0;5207;5;3;
/org.eclipse.jdt.debug.tests/tests/org/eclipse/jdt/debug/tests/ProjectCreationDecorator.java;5;2;19;1;6;5;6;13;29;2;12;584;104;104;2;1;1;13;19;629;2;6337;17;5;
/org.eclipse.jdt.core/model/org/eclipse/jdt/core/JavaConventions.java;3;0;16;2;0;0;0;16;432;2;14;30;607;607;2;2;0;16;16;530;2;4843;14;3;
/org.eclipse.update.ui.win32/src/org/eclipse/welcome/internal/IEmbeddedWebBrowser.java;1;0;3;1;0;0;0;3;1;2;2;889;1;1;2;1;0;3;3;889;1;907;2;1;
/org.eclipse.jdt.ui.tests.refactoring/resources/SurroundWithWorkSpace/SurroundWithTests/trycatch_in/TestWrappedLocal3.java;1;0;1;1;0;0;0;1;5;0;1;845;5;5;1;0;0;1;1;845;0;845;1;1;
/org.eclipse.core.boot/src/org/eclipse/core/internal/boot/PlatformClassLoader.java;1;0;1;1;0;0;0;1;0;0;1;3013;0;0;1;0;0;1;1;3013;0;3013;1;1;
/org.eclipse.jdt.ui.tests.refactoring/resources/IntroduceFactory/positive/selectConstructor.java;1;0;2;1;0;0;0;2;0;1;2;2846;0;0;1;0;0;2;2;2846;0;2862;2;1;
/org.eclipse.jdt.ui.examples.javafamily/src/org/eclipse/jsp/JspJavaSourceIndexer.java;2;0;7;1;0;0;0;7;6;2;6;1033;13;13;2;1;0;7;7;1168;1;3235;6;2;
/org.eclipse.ui.workbench/Eclipse UI/org/eclipse/ui/contexts/IContextRegistry.java;1;0;4;1;0;0;0;4;13;2;3;1388;13;13;2;1;0;4;4;1417;1;1417;3;1;
/org.eclipse.update.ui/src/org/eclipse/update/internal/ui/wizards/SwapFeatureWizardPage.java;2;0;3;1;0;0;0;3;11;2;2;1228;11;11;2;1;0;3;3;1228;1;1242;2;2;
/org.eclipse.jdt.core.tests.model/workspace/Converter/Test462.java;1;0;1;1;0;0;0;1;0;0;1;3714;0;0;1;0;0;1;1;3714;0;3714;1;1;
/org.eclipse.ant.ui/Remote Ant Support/org/eclipse/ant/internal/ui/antsupport/logger/MessageIds.java;1;0;1;1;0;0;0;1;0;0;1;1811;0;0;1;0;0;1;1;1811;0;1811;1;1;
/org.eclipse.pde.ui/src/org/eclipse/pde/internal/ui/editor/manifest/NotifyingReconciler.java;1;0;2;1;1;1;1;1;0;0;1;2320;0;0;1;0;0;1;2;2320;0;5431;2;1;
/org.eclipse.pde.core/src/org/eclipse/pde/core/IModel.java;2;1;7;1;4;4;4;3;167;1;3;2936;315;315;1;0;0;3;7;2936;0;6336;7;2;
/org.eclipse.jdt.ui/core refactoring/org/eclipse/jdt/internal/corext/refactoring/reorg/IConfirmQuery.java;2;0;2;1;1;1;1;1;4;0;1;1114;4;4;1;0;0;1;2;1114;0;6340;2;2;
/org.eclipse.jdt.ui.tests.refactoring/resources/MoveInnerToTopLevel/test_nonstatic_28/out/Inner.java;2;0;2;1;1;1;1;1;2;0;1;305;3;3;1;0;0;1;2;305;0;5854;2;2;
/org.eclipse.swt.opengl.examples/src/org/eclipse/swt/opengl/examples/AntialiasingTab.java;1;0;1;1;0;0;0;1;0;0;1;1175;0;0;1;0;0;1;1;1175;0;1175;1;1;
/org.eclipse.jdt.core.tests.model/workspace/Converter/test0007/Test.java;1;0;1;1;0;0;0;1;0;0;1;3714;0;0;1;0;0;1;1;3714;0;3714;1;1;
/org.eclipse.ui.workbench/Eclipse UI/org/eclipse/ui/internal/commands/api/ICategory.java;1;0;2;1;0;0;0;2;2;0;1;2562;2;2;2;1;0;2;2;2562;1;2562;1;1;
/org.eclipse.jdt.core.tests.model/workspace/Formatter/test095/A_in.java;1;0;1;1;0;0;0;1;0;0;1;2425;0;0;1;0;0;1;1;2425;0;2425;1;1;
/org.eclipse.ui.examples.javaeditor/Eclipse Java Editor Example/org/eclipse/ui/examples/javaeditor/JavaEditorEnvironment.java;1;0;1;1;0;0;0;1;0;0;1;1581;0;0;1;0;0;1;1;1581;0;1581;1;1;
/org.eclipse.update.ui/src/org/eclipse/update/internal/ui/security/JarVerificationDialog.java;2;1;5;1;3;3;3;2;13;1;2;890;37;37;1;0;0;2;5;890;0;6336;5;2;
/org.eclipse.core.tests.runtime/src/org/eclipse/core/tests/plugintests/CmdLineAndStateAndPrimaryFeatureTest.java;1;0;1;1;0;0;0;1;0;0;1;3014;0;0;1;0;0;1;1;3014;0;3014;1;1;
/org.eclipse.team.ui/src/org/eclipse/team/internal/ui/target/RemoteResourceElement.java;2;0;3;1;0;0;0;3;5;1;3;990;6;6;1;0;0;3;3;990;0;2495;3;2;
/org.eclipse.jdt.core.tests.model/workspace/Converter/src/test0455/A.java;1;0;1;1;0;0;0;1;0;0;1;3714;0;0;1;0;0;1;1;3714;0;3714;1;1;
/org.eclipse.pde.runtime/src/org/eclipse/pde/internal/runtime/logview/LogSession.java;2;1;5;1;2;2;2;3;78;1;3;831;94;94;1;0;0;3;5;831;0;6336;5;2;
/org.eclipse.debug.ui/ui/org/eclipse/debug/ui/console/ConsoleColorProvider.java;2;0;6;1;1;1;1;5;18;1;5;977;48;48;1;0;0;5;6;977;0;5701;6;2;
/org.eclipse.jdt.core.tests.model/workspace/Formatter/test301/A_out.java;1;0;1;1;0;0;0;1;0;0;1;2444;0;0;1;0;0;1;1;2444;0;2444;1;1;
/org.eclipse.jdt.ui/core refactoring/org/eclipse/ltk/internal/ui/refactoring/ChangeExceptionHandler.java;1;0;4;1;0;0;0;4;5;1;4;4510;7;7;1;0;0;4;4;4510;0;4965;4;1;
/org.eclipse.osgi/core/framework/org/eclipse/osgi/framework/security/action/PermissionStorage.java;2;0;3;1;1;1;1;2;138;1;2;3013;138;138;1;0;0;2;3;3013;0;5107;3;2;
/org.eclipse.jdt.core.tests.model/workspace/Converter/test0357/A.java;1;0;1;1;0;0;0;1;0;0;1;3714;0;0;1;0;0;1;1;3714;0;3714;1;1;
/org.eclipse.update.core/src/org/eclipse/update/internal/core/InstallHandlerProxy.java;2;2;6;1;4;3;4;2;78;1;2;890;113;113;2;0;1;2;6;5664;1;6336;5;2;
/org.eclipse.core.resources/src/org/eclipse/core/internal/resources/DelayedSnapshotJob.java;2;1;8;1;3;3;3;5;50;2;4;1083;114;114;2;1;0;5;8;1541;1;6018;7;2;
/org.eclipse.ui.workbench/Eclipse UI/org/eclipse/ui/internal/commands/older/ImageFactory.java;1;0;1;1;0;0;0;1;0;0;1;2562;0;0;1;0;0;1;1;2562;0;2562;1;1;
/org.eclipse.ui.workbench/Eclipse UI/org/eclipse/ui/internal/IMarkerImageProvider.java;1;0;1;1;0;0;0;1;0;0;1;2737;0;0;1;0;0;1;1;2737;0;2737;1;1;
/org.eclipse.jdt.core.tests.model/workspace/Formatter/test242/A_in.java;1;0;1;1;0;0;0;1;0;0;1;2437;0;0;1;0;0;1;1;2437;0;2437;1;1;
/org.eclipse.jdt.core.tests.model/workspace/Converter/src/test0509/A.java;1;0;1;1;0;0;0;1;0;0;1;3714;0;0;1;0;0;1;1;3714;0;3714;1;1;
/org.eclipse.jdt.ui.tests.refactoring/resources/UseSupertypeWherePossible/testNew13/out/B.java;1;0;1;1;0;0;0;1;2;0;1;1166;2;2;1;0;0;1;1;1166;0;1166;1;1;
/org.eclipse.jdt.debug/jdi/org/eclipse/jdi/internal/VirtualMachineImpl.java;3;0;8;1;1;1;1;7;51;1;7;566;124;124;1;0;0;7;8;566;0;5620;8;3;
/org.eclipse.swt/Eclipse SWT PI/carbon/org/eclipse/swt/internal/carbon/ControlTabEntry.java;1;2;3;1;3;2;3;0;16;0;0;5534;20;20;2;0;1;0;3;5534;1;5614;2;1;
/org.eclipse.jdt.core.tests.model/workspace/Formatter/test267/A_out.java;1;0;1;1;0;0;0;1;0;0;1;2442;0;0;1;0;0;1;1;2442;0;2442;1;1;
/org.eclipse.jdt.core/compiler/org/eclipse/jdt/internal/compiler/ast/EnumDeclaration.java;1;0;1;1;0;0;0;1;0;0;1;2843;0;0;1;0;0;1;1;2843;0;2843;1;1;
/org.eclipse.swt/Eclipse SWT PI/win32/org/eclipse/swt/internal/win32/NONCLIENTMETRICSA.java;2;0;2;1;0;0;0;2;1;1;2;957;1;1;1;0;0;2;2;957;0;2915;2;2;
/org.eclipse.ant.ui/Ant Editor/org/eclipse/ant/internal/ui/editor/text/XMLProblemAnnotation.java;1;0;3;1;0;0;0;3;35;1;3;1811;38;38;1;0;0;3;3;1811;0;3584;3;1;
/org.eclipse.swt.tests/JUnit Tests/org/eclipse/swt/tests/junit/Test_org_eclipse_swt_dnd_DragSource.java;1;0;1;1;0;0;0;1;12;0;1;2176;12;12;1;0;0;1;1;2176;0;2176;1;1;
/org.eclipse.pde.ui/src/org/eclipse/pde/internal/ui/editor/site/DescriptionSection.java;3;1;8;1;5;5;5;3;283;1;3;2311;458;458;1;0;0;3;8;2311;0;6336;8;3;
/org.eclipse.jdt.core/model/org/eclipse/jdt/internal/core/util/MethodInfo.java;2;0;2;1;1;1;1;1;12;0;1;3560;14;14;1;0;0;1;2;3560;0;5916;2;2;
/org.eclipse.update.ui.win32/src/org/eclipse/welcome/internal/WelcomePortal.java;1;0;4;1;0;0;0;4;44;2;2;889;84;84;2;2;0;4;4;889;2;907;2;1;
/org.eclipse.ui.views/src/org/eclipse/ui/views/markers/internal/DialogBookmarkFilter.java;2;0;2;1;0;0;0;2;0;1;2;755;0;0;1;0;0;2;2;755;0;2738;2;2;
/org.eclipse.team.core/src/org/eclipse/team/core/synchronize/ISyncInfoTreeChangeEvent.java;2;1;4;1;2;2;2;2;52;1;2;4045;55;55;1;0;0;2;4;4045;0;6336;4;2;
/org.eclipse.ui.console/src/org/eclipse/ui/console/IConsoleManager.java;5;1;5;1;2;2;2;3;9;1;3;1988;29;29;1;0;0;3;5;1988;0;6336;5;5;
/org.eclipse.text/src/org/eclipse/jface/text/source/AnnotationModel.java;3;1;6;1;5;5;5;1;727;0;1;2243;847;847;1;0;0;1;6;2243;0;6300;6;3;
/org.eclipse.core.filebuffers/src/org/eclipse/core/internal/filebuffers/AbstractDocumentProvider2.java;1;0;2;1;0;0;0;2;0;1;2;1522;0;0;1;0;0;2;2;1522;0;1574;2;1;
/org.eclipse.ui.workbench/Eclipse UI/org/eclipse/ui/internal/progress/ProgressAnimationItem.java;3;5;31;2;27;15;27;4;202;1;4;4427;724;724;5;0;12;4;31;5122;12;6265;19;3;
/org.eclipse.ui.workbench/Eclipse UI/org/eclipse/ui/dialogs/WizardDataTransferPage.java;1;0;1;1;0;0;0;1;0;0;1;2737;0;0;1;0;0;1;1;2737;0;2737;1;1;
/org.eclipse.jdt.ui/core refactoring/org/eclipse/jdt/internal/corext/refactoring/code/SourceProvider.java;3;1;21;1;3;3;3;18;43;3;16;218;265;265;3;2;0;18;21;1946;2;6340;19;3;
/org.eclipse.jdt.ui/ui/org/eclipse/jdt/internal/ui/callhierarchy/OpenLocationAction.java;4;0;7;1;1;1;1;6;17;1;6;155;32;32;1;0;0;6;7;155;0;6340;7;4;
/org.eclipse.ui.views/src/org/eclipse/ui/views/navigator/RefactorActionGroup.java;1;0;1;1;0;0;0;1;0;0;1;2738;0;0;1;0;0;1;1;2738;0;2738;1;1;
/org.eclipse.team.cvs.core/src/org/eclipse/team/internal/ccvs/core/client/Update.java;2;0;4;1;1;1;1;3;17;1;3;1672;28;28;1;0;0;3;4;1672;0;6337;4;2;
/org.eclipse.webdav/src/client/org/eclipse/webdav/client/AbstractResourceHandle.java;1;0;2;1;2;1;2;0;141;0;0;5151;141;141;2;0;1;0;2;5151;1;5151;1;1;
/org.eclipse.jdt.ui.tests.refactoring/resources/InlineMethodWorkspace/TestCases/simple_out/TestPrimitiveArray.java;1;0;1;1;0;0;0;1;2;0;1;845;2;2;1;0;0;1;1;845;0;845;1;1;
/org.eclipse.core.tools/src/org/eclipse/core/tools/Policy.java;1;0;1;1;1;1;1;0;0;0;0;6302;0;0;1;0;0;0;1;6302;0;6302;1;1;
/org.eclipse.jdt.core/codeassist/org/eclipse/jdt/internal/codeassist/RelevanceConstants.java;2;0;4;1;1;1;1;3;2;1;3;3039;7;7;1;0;0;3;4;3039;0;5636;4;2;
/org.eclipse.update.ui/src/org/eclipse/update/internal/ui/search/DefaultUpdatesSearchObject.java;1;0;1;1;0;0;0;1;0;0;1;755;0;0;1;0;0;1;1;755;0;755;1;1;
/org.eclipse.pde.core/src/org/eclipse/pde/internal/core/bundle/BundlePluginBase.java;2;3;13;1;13;10;13;0;273;0;0;5445;440;440;3;0;3;0;13;5445;3;6336;10;2;
/org.eclipse.jdt.ui.tests/ui/org/eclipse/jdt/ui/tests/browsing/TestDelta.java;1;0;1;1;1;1;1;0;2;0;0;6340;2;2;1;0;0;0;1;6340;0;6340;1;1;
/org.eclipse.jdt.ui/core refactoring/org/eclipse/jdt/internal/corext/refactoring/structure/JavaElementCommentFinder.java;1;0;1;1;1;1;1;0;2;0;0;6340;2;2;1;0;0;0;1;6340;0;6340;1;1;
/org.eclipse.jdt.ui/ui/org/eclipse/jdt/internal/ui/browsing/TopLevelTypeProblemsLabelDecorator.java;1;0;2;1;1;1;1;1;16;0;1;403;18;18;1;0;0;1;2;403;0;6340;2;1;
/org.eclipse.jdt.ui/core extension/org/eclipse/jdt/internal/corext/textmanipulation/CopyRangeMarker.java;1;0;5;1;0;0;0;5;33;2;3;1686;60;60;2;2;0;5;5;1869;2;1946;3;1;
/org.eclipse.jdt.ui/ui/org/eclipse/jdt/internal/ui/dnd/TransferDropTargetListener.java;1;0;1;1;1;1;1;0;2;0;0;6340;2;2;1;0;0;0;1;6340;0;6340;1;1;
/org.eclipse.jdt.ui.tests.refactoring/resources/ExtractMethodWorkSpace/ExtractMethodTests/expression_in/A_test610.java;1;0;1;1;0;0;0;1;2;0;1;844;2;2;1;0;0;1;1;844;0;844;1;1;
/org.eclipse.pde.ui/src/org/eclipse/pde/internal/ui/editor/context/InputContextManager.java;3;1;4;1;4;4;4;0;16;0;0;5431;32;32;1;0;0;0;4;5431;0;6336;4;3;
/org.eclipse.jdt.core/model/org/eclipse/jdt/core/compiler/IScanner.java;2;0;3;1;0;0;0;3;4;1;3;2118;7;7;1;0;0;3;3;2118;0;3976;3;2;
/org.eclipse.webdav/src/interface/org/eclipse/webdav/dom/Bindings.java;1;0;2;1;2;1;2;0;138;0;0;5151;138;138;2;0;1;0;2;5151;1;5151;1;1;
/org.eclipse.ui.workbench/Eclipse UI/org/eclipse/ui/internal/commands/registry/ConfigurationElementMemento.java;1;0;2;1;0;0;0;2;0;1;2;1077;0;0;1;0;0;2;2;1077;0;1222;2;1;
/org.eclipse.jdt.core.tests.model/workspace/Converter/test0510/A.java;1;0;2;1;0;0;0;2;0;1;2;3009;0;0;1;0;0;2;2;3009;0;3714;2;1;
/org.eclipse.core.runtime/src/org/eclipse/core/internal/runtime/NoDefaultDataArea.java;2;0;3;1;0;0;0;3;6;1;3;3677;6;6;1;0;0;3;3;3677;0;4113;3;2;
/org.eclipse.ui.workbench/Eclipse UI/org/eclipse/ui/internal/csm/commands/api/ICategoryListener.java;1;0;2;1;0;0;0;2;0;1;2;2532;0;0;1;0;0;2;2;2532;0;2562;2;1;
/org.eclipse.pde.ui/src_Forms/org/eclipse/pde/internal/ui/model/plugin/NodeOffsetHandler.java;1;1;2;1;2;2;2;0;10;0;0;5703;10;10;1;0;0;0;2;5703;0;6336;2;1;
/org.eclipse.ui.forms/src/org/eclipse/ui/forms/events/HyperlinkListener.java;1;0;4;1;0;0;0;4;50;1;4;4068;53;53;1;0;0;4;4;4068;0;5044;4;1;
/org.eclipse.jdt.launching/launching/org/eclipse/jdt/launching/sourcelookup/ZipEntryStorage.java;2;0;3;1;1;1;1;2;120;1;2;2988;145;145;1;0;0;2;3;2988;0;5236;3;2;
/org.eclipse.jdt.debug.tests/tests/org/eclipse/jdt/debug/tests/core/ExceptionBreakpointTests.java;2;1;2;1;2;2;2;0;4;0;0;6023;6;6;1;0;0;0;2;6023;0;6337;2;2;
/org.eclipse.jdt.ui.tests.refactoring/resources/RenameType/test61/in/A.java;1;0;1;1;0;0;0;1;0;0;1;4913;0;0;1;0;0;1;1;4913;0;4913;1;1;
/org.eclipse.update.ui/src/org/eclipse/update/internal/ui/model/DiscoveryFolder.java;1;0;4;1;0;0;0;4;6;1;4;478;13;13;1;0;0;4;4;478;0;900;4;1;
/org.eclipse.jdt.ui/core refactoring/org/eclipse/jdt/internal/corext/refactoring/structure/MoveStaticMemberAnalyzer.java;5;1;11;1;4;4;4;7;30;1;7;1522;112;112;1;0;0;7;11;1522;0;6340;11;5;
/org.eclipse.jdt.core/compiler/org/eclipse/jdt/internal/compiler/env/ISourceType.java;2;0;3;1;0;0;0;3;31;1;3;85;41;41;1;0;0;3;3;85;0;3560;3;2;
/org.eclipse.team.ui/src/org/eclipse/team/ui/synchronize/actions/MenuActionContributionItem.java;1;0;1;1;0;0;0;1;0;0;1;2535;0;0;1;0;0;1;1;2535;0;2535;1;1;
/org.eclipse.update.ui/src/org/eclipse/update/internal/ui/wizards/RevertConfigurationWizard.java;3;0;5;1;1;1;1;4;16;1;4;825;27;27;1;0;0;4;5;825;0;6336;5;3;
/org.eclipse.ui.ide/src/org/eclipse/ui/views/markers/internal/FieldResource.java;4;2;5;2;3;2;3;2;37;1;2;2208;78;78;2;0;1;2;5;6338;1;6338;4;4;
/org.eclipse.jdt.ui.tests.refactoring/resources/MoveInnerToTopLevel/test_nonstatic_15/out/Inner.java;2;0;2;1;1;1;1;1;2;0;1;305;4;4;1;0;0;1;2;305;0;5854;2;2;
/org.eclipse.pde.ui/src/org/eclipse/pde/internal/ui/wizards/project/MigratePluginWizardPage.java;1;0;4;1;0;0;0;4;78;1;4;2653;86;86;1;0;0;4;4;2653;0;3839;4;1;
/org.eclipse.help.ui/src/org/eclipse/help/ui/internal/util/SWTUtil.java;1;0;1;1;0;0;0;1;0;0;1;2732;0;0;1;0;0;1;1;2732;0;2732;1;1;
/org.eclipse.jdt.core.tests.model/workspace/Converter/test0040/Test.java;1;0;1;1;0;0;0;1;0;0;1;3714;0;0;1;0;0;1;1;3714;0;3714;1;1;
/org.eclipse.ui.views/src/org/eclipse/ui/views/navigator/INavigatorHelpContextIds.java;1;0;1;1;0;0;0;1;0;0;1;2738;0;0;1;0;0;1;1;2738;0;2738;1;1;
/org.eclipse.jdt.core/model/org/eclipse/jdt/internal/core/util/ParameterAnnotation.java;1;0;1;1;0;0;0;1;0;0;1;4466;0;0;1;0;0;1;1;4466;0;4466;1;1;
/org.eclipse.jdt.ui.tests.refactoring/resources/ChangeTypeRefactoring/positive/A_testParameterTypeWithOverriding_in.java;1;0;1;1;0;0;0;1;0;0;1;2844;0;0;1;0;0;1;1;2844;0;2844;1;1;
/org.eclipse.swt/Eclipse SWT Drag and Drop/win32/org/eclipse/swt/dnd/ByteArrayTransfer.java;1;0;1;1;0;0;0;1;61;0;1;307;61;61;1;0;0;1;1;307;0;307;1;1;
/org.eclipse.jdt.ui.tests.refactoring/resources/Copy/test_field_yes_field/in/A.java;1;0;1;1;0;0;0;1;0;0;1;685;0;0;1;0;0;1;1;685;0;685;1;1;
/org.eclipse.jdt.core/model/org/eclipse/jdt/internal/core/util/RuntimeInvisibleAnnotationsAttribute.java;1;0;1;1;0;0;0;1;0;0;1;4466;0;0;1;0;0;1;1;4466;0;4466;1;1;
/org.eclipse.ui.workbench/Eclipse UI/org/eclipse/ui/internal/progress/StatusWithResult.java;1;0;1;1;0;0;0;1;0;0;1;532;0;0;1;0;0;1;1;532;0;532;1;1;
/org.eclipse.debug.ui/ui/org/eclipse/debug/internal/ui/actions/WatchExpressionAction.java;1;0;1;1;0;0;0;1;0;0;1;1516;0;0;1;0;0;1;1;1516;0;1516;1;1;
/org.eclipse.jdt.core.tests.model/workspace/Resolve/src/ResolveDuplicateMethodDeclaration11.java;1;0;1;1;1;1;1;0;0;0;0;6222;0;0;1;0;0;0;1;6222;0;6222;1;1;
/org.eclipse.jdt.core.tests.model/workspace/Converter/test0029/Test.java;1;0;1;1;0;0;0;1;0;0;1;3714;0;0;1;0;0;1;1;3714;0;3714;1;1;
/org.eclipse.jdt.ui/ui/org/eclipse/jdt/internal/ui/compare/JavaTextViewer.java;4;1;4;1;2;2;2;2;9;1;2;1582;20;20;1;0;0;2;4;1582;0;6340;4;4;
/org.eclipse.jdt.core.tests.model/workspace/Converter/test0341/A.java;1;0;1;1;0;0;0;1;0;0;1;3714;0;0;1;0;0;1;1;3714;0;3714;1;1;
/org.eclipse.jdt.core.tests.model/workspace/Converter/test0059/Test.java;1;0;1;1;0;0;0;1;0;0;1;3714;0;0;1;0;0;1;1;3714;0;3714;1;1;
/org.eclipse.jdt.core/model/org/eclipse/jdt/internal/core/util/ASTNodeFinder.java;2;0;4;1;0;0;0;4;4;1;4;2974;8;8;1;0;0;4;4;2974;0;3560;4;2;
/org.eclipse.jdt.ui.tests.refactoring/resources/Copy/test_fields_declared_in_multi_yes_type_1/in/A.java;1;0;1;1;0;0;0;1;0;0;1;1186;0;0;1;0;0;1;1;1186;0;1186;1;1;
/org.eclipse.jdt.core.tests.model/workspace/Converter/src/test0050/Test.java;1;0;1;1;0;0;0;1;0;0;1;3714;0;0;1;0;0;1;1;3714;0;3714;1;1;
/org.eclipse.team.webdav/src/org/eclipse/team/internal/core/target/DeploymentProviderManager.java;2;0;3;1;1;1;1;2;10;1;2;4633;14;14;1;0;0;2;3;4633;0;6337;3;2;
/org.eclipse.jdt.ui/ui refactoring/org/eclipse/jdt/internal/ui/refactoring/RefactoringWizardPage.java;1;0;2;1;0;0;0;2;2;1;2;4575;2;2;1;0;0;2;2;4575;0;4965;2;1;
/org.eclipse.pde.build/src/org/eclipse/pde/internal/build/ant/ZipFileSet.java;2;0;3;1;1;1;1;2;52;1;2;4700;58;58;1;0;0;2;3;4700;0;5145;3;2;
/org.eclipse.jdt.debug.ui/ui/org/eclipse/jdt/internal/debug/ui/PackageSelectionDialog.java;3;0;3;1;1;1;1;2;56;1;2;3585;60;60;1;0;0;2;3;3585;0;6336;3;3;
/org.eclipse.swt/Eclipse SWT/common/org/eclipse/swt/layout/GridLayout.java;3;0;4;1;1;1;1;3;8;1;3;3310;19;19;1;0;0;3;4;3310;0;6352;4;3;
/org.eclipse.core.tests.runtime/src/org/eclipse/core/tests/internal/runtimetests/SampleJFB.java;1;0;1;1;1;1;1;0;21;0;0;5149;21;21;1;0;0;0;1;5149;0;5149;1;1;
/org.eclipse.pde.ui/src_Forms/org/eclipse/pde/internal/ui/neweditor/SourceOutlinePage.java;1;1;3;1;3;3;3;0;5;0;0;5298;5;5;1;0;0;0;3;5298;0;5431;3;1;
/org.eclipse.pde.core/src/org/eclipse/pde/internal/core/ifeature/IFeatureChild.java;2;1;3;1;2;2;2;1;10;0;1;4203;20;20;1;0;0;1;3;4203;0;6336;3;2;
/org.eclipse.jdt.core.tests.model/workspace/Formatter/test468/A_in.java;1;0;2;1;0;0;0;2;3;1;2;3915;3;3;1;0;0;2;2;3915;0;3940;2;1;
/org.eclipse.jdt.core.tests.model/workspace/Converter/src/test0373/A.java;1;0;1;1;0;0;0;1;0;0;1;3714;0;0;1;0;0;1;1;3714;0;3714;1;1;
/org.eclipse.update.ui/src/org/eclipse/update/internal/ui/wizards/LocalSiteSelector.java;2;1;5;1;2;2;2;3;28;1;3;2085;35;35;1;0;0;3;5;2085;0;6336;5;2;
/org.eclipse.pde.core/src/org/eclipse/pde/core/plugin/IPluginModel.java;2;1;3;1;3;3;3;0;45;0;0;5115;53;53;1;0;0;0;3;5115;0;6336;3;2;
/org.eclipse.jdt.core.tests.model/workspace/Converter/src/test0288/Test.java;1;0;1;1;0;0;0;1;0;0;1;3714;0;0;1;0;0;1;1;3714;0;3714;1;1;
/org.eclipse.jdt.ui/core refactoring/org/eclipse/jdt/internal/corext/refactoring/rename/UpdateMethodReferenceEdit.java;1;0;1;1;0;0;0;1;0;0;1;1576;0;0;1;0;0;1;1;1576;0;1576;1;1;
/org.eclipse.core.tests.harness/src/org/eclipse/core/tests/harness/ExampleTest.java;1;0;1;1;1;1;1;0;62;0;0;5146;62;62;1;0;0;0;1;5146;0;5146;1;1;
/org.eclipse.jdt.core.tests.model/workspace/Converter/test0160/Test.java;1;0;1;1;0;0;0;1;0;0;1;3714;0;0;1;0;0;1;1;3714;0;3714;1;1;
/org.eclipse.jdt.core/search/org/eclipse/jdt/internal/core/search/matching/JavaSearchPattern.java;1;0;1;1;1;1;1;0;0;0;0;5335;0;0;1;0;0;0;1;5335;0;5335;1;1;
/org.eclipse.jdt.core.tests.model/workspace/Formatter/test212/A_in.java;1;0;1;1;0;0;0;1;0;0;1;2425;0;0;1;0;0;1;1;2425;0;2425;1;1;
/org.eclipse.jdt.junit/src/org/eclipse/jdt/internal/junit/ui/JUnitPlugin.java;2;1;8;1;3;3;3;5;53;1;5;450;148;148;1;0;0;5;8;450;0;6340;8;2;
/org.eclipse.compare/compare/org/eclipse/compare/contentmergeviewer/IDocumentRange.java;1;0;1;1;0;0;0;1;2;0;1;3935;2;2;1;0;0;1;1;3935;0;3935;1;1;
/org.eclipse.team.ui/src/org/eclipse/team/ui/synchronize/actions/IRefreshSubscriberListener.java;1;0;1;1;0;0;0;1;0;0;1;3709;0;0;1;0;0;1;1;3709;0;3709;1;1;
/org.eclipse.jdt.core.tests.builder/src/org/eclipse/jdt/core/tests/builder/TestingEnvironment.java;4;0;9;1;1;1;1;8;43;2;7;1059;117;117;2;1;0;8;9;2075;1;5853;8;4;
/org.eclipse.jdt.core.tests.model/workspace/Converter/src/junit/runner/LoadingTestCollector.java;1;0;1;1;0;0;0;1;0;0;1;3714;0;0;1;0;0;1;1;3714;0;3714;1;1;
/org.eclipse.ui.workbench/Eclipse UI/org/eclipse/ui/contexts/ws/IWorkbenchPartSiteContextSupport.java;1;0;1;1;0;0;0;1;0;0;1;3066;0;0;1;0;0;1;1;3066;0;3066;1;1;
/org.eclipse.ui.workbench/Eclipse UI/org/eclipse/ui/internal/PageLayout.java;6;2;19;2;7;6;7;12;980;2;11;628;1625;1625;2;1;1;12;19;3828;2;6338;17;6;
/org.eclipse.search/new search/org/eclipse/search2/internal/ui/basic/views/SetLayoutAction.java;2;0;3;1;1;1;1;2;13;1;2;4045;15;15;1;0;0;2;3;4045;0;6340;3;2;
/org.eclipse.jdt.debug/jdi/org/eclipse/jdi/internal/FieldImpl.java;1;0;1;1;0;0;0;1;31;0;1;4267;31;31;1;0;0;1;1;4267;0;4267;1;1;
/org.eclipse.swt.graphics.text/Eclipse SWT/carbon/org/eclipse/swt/graphics/text/TextStyle.java;2;0;2;1;0;0;0;2;116;1;2;2744;116;116;1;0;0;2;2;2744;0;4535;2;2;
/org.eclipse.jdt.ui/ui refactoring/org/eclipse/jdt/internal/ui/refactoring/PerformRefactoringUtil.java;2;0;7;1;0;0;0;7;96;1;7;42;146;146;1;0;0;7;7;42;0;4965;7;2;
/org.eclipse.ui.ide/src/org/eclipse/ui/views/markers/internal/ActionRevealMarker.java;3;1;3;1;2;2;2;1;4;0;1;2208;6;6;1;0;0;1;3;2208;0;6338;3;3;
/org.eclipse.team.core/src/org/eclipse/team/internal/core/SaveContextXMLContentHandler.java;2;0;5;1;0;0;0;5;76;1;5;684;116;116;1;0;0;5;5;684;0;2632;5;2;
/org.eclipse.jface.text/src/org/eclipse/jface/text/reconciler/IReconcilingStrategy.java;1;3;4;1;4;2;4;0;30;0;0;6340;32;32;3;0;2;0;4;6353;2;6353;2;1;
/org.eclipse.jdt.ui.tests.refactoring/resources/SurroundWithWorkSpace/SurroundWithTests/trycatch_in/TestWrappedLocal5.java;1;0;1;1;0;0;0;1;5;0;1;845;5;5;1;0;0;1;1;845;0;845;1;1;
/org.eclipse.pde.ui/src_Forms/org/eclipse/pde/internal/ui/neweditor/site/FeaturePropertiesDialog.java;2;0;2;1;1;1;1;1;0;0;1;4832;0;0;1;0;0;1;2;4832;0;5431;2;2;
/org.eclipse.jdt.ui/core refactoring/org/eclipse/jdt/internal/corext/refactoring/reorg2/PasteAction.java;1;0;4;1;0;0;0;4;117;2;3;826;132;132;2;1;0;4;4;826;1;1114;3;1;
/org.eclipse.jdt.ui/ui/org/eclipse/jdt/internal/ui/javadocexport/JavadocOptionsManager.java;2;1;13;1;2;2;2;11;752;2;10;661;1289;1289;2;1;0;11;13;4322;1;5936;12;2;
/org.eclipse.jdt.core.tests.model/workspace/Converter15/src/test0015/X.java;1;0;1;1;0;0;0;1;0;0;1;4716;0;0;1;0;0;1;1;4716;0;4716;1;1;
/org.eclipse.ui.examples.readmetool/Eclipse UI Examples Readme Tool/org/eclipse/ui/examples/readmetool/ReadmePreferencePage.java;1;0;1;1;0;0;0;1;3;0;1;2738;3;3;1;0;0;1;1;2738;0;2738;1;1;
/org.eclipse.pde.ui/src_ant/org/eclipse/pde/internal/ui/ant/ExportBuildListener.java;1;0;3;1;1;1;1;2;4;1;2;2571;12;12;1;0;0;2;3;2571;0;6336;3;1;
/org.eclipse.jdt.core.tests.model/workspace/Formatter/test337/A_out.java;1;0;4;1;0;0;0;4;13;2;3;2743;13;13;2;1;0;4;4;2759;1;3029;3;1;
/org.eclipse.jdt.core/dom/org/eclipse/jdt/core/dom/ASTMatcher.java;5;2;21;2;3;2;3;18;612;3;14;1114;1088;1088;3;4;1;18;21;3683;5;5335;16;5;
/org.eclipse.jface.text/src/org/eclipse/jface/text/source/ISharedTextColors.java;2;1;2;1;2;2;2;0;8;0;0;6340;10;10;1;0;0;0;2;6340;0;6361;2;2;
/org.eclipse.jdt.core/dom/org/eclipse/jdt/internal/core/dom/rewrite/Indents.java;1;1;2;1;2;2;2;0;26;0;0;5404;26;26;1;0;0;0;2;5404;0;5482;2;1;
/org.eclipse.jdt.ui.tests.refactoring/resources/RenamePackage/test0/out/p1/A.java;1;0;1;1;0;0;0;1;6;0;1;4585;6;6;1;0;0;1;1;4585;0;4585;1;1;
/org.eclipse.ui.ide/src/org/eclipse/ui/internal/ide/misc/WizardStepGroup.java;4;1;4;1;2;2;2;2;24;1;2;2264;28;28;1;0;0;2;4;2264;0;6338;4;4;
/org.eclipse.debug.ui/ui/org/eclipse/debug/internal/ui/sourcelookup/containers/WorkingSetSourceContainerType.java;1;0;4;1;0;0;0;4;18;2;3;3770;18;18;2;1;0;4;4;4949;1;4970;3;1;
/org.eclipse.jdt.core.tests.model/workspace/Converter/src/test0527/A.java;1;0;1;1;0;0;0;1;0;0;1;3714;0;0;1;0;0;1;1;3714;0;3714;1;1;
/org.eclipse.jdt.ui/ui/org/eclipse/jdt/ui/actions/RenameAction.java;3;0;3;1;1;1;1;2;4;1;2;42;8;8;1;0;0;2;3;42;0;6340;3;3;
/org.eclipse.jdt.core.tests.model/workspace/Converter/src/test0441/A.java;1;0;1;1;0;0;0;1;0;0;1;3714;0;0;1;0;0;1;1;3714;0;3714;1;1;
/org.eclipse.jdt.core.tests.model/workspace/Converter/src/test0308/Test.java;1;0;1;1;0;0;0;1;0;0;1;3714;0;0;1;0;0;1;1;3714;0;3714;1;1;
/org.eclipse.debug.core/core/org/eclipse/debug/core/DebugException.java;1;0;1;1;0;0;0;1;8;0;1;976;8;8;1;0;0;1;1;976;0;976;1;1;
/org.eclipse.ui.workbench/Eclipse UI/org/eclipse/ui/internal/contexts/registry/IContextRegistryListener.java;1;0;2;1;0;0;0;2;0;1;2;1422;0;0;1;0;0;2;2;1422;0;1724;2;1;
/org.eclipse.core.runtime.compatibility/src-runtime/org/eclipse/core/internal/plugins/Utils.java;2;0;2;1;0;0;0;2;0;1;2;3013;0;0;1;0;0;2;2;3013;0;3169;2;2;
/org.eclipse.pde.ui/src/org/eclipse/pde/internal/ui/search/SearchGoToAction.java;1;1;3;1;2;2;2;1;4;0;1;2751;9;9;1;0;0;1;3;2751;0;6336;3;1;
/org.eclipse.jdt.ui/core refactoring/org/eclipse/jdt/internal/corext/refactoring/changes/Utils.java;1;0;1;1;1;1;1;0;2;0;0;6340;2;2;1;0;0;0;1;6340;0;6340;1;1;
/org.eclipse.core.resources/src/org/eclipse/core/internal/resources/WorkspaceRoot.java;3;1;7;1;4;4;4;3;459;1;3;2057;600;600;1;0;0;3;7;2057;0;6339;7;3;
/org.eclipse.jdt.core.tests.model/src/org/eclipse/jdt/core/tests/model/EncodingTests.java;3;2;18;2;8;6;8;10;500;2;8;1877;1363;1363;2;2;2;10;18;4731;4;6293;14;3;
/org.eclipse.debug.ui/ui/org/eclipse/debug/ui/variables/RefreshScopeVariableRegistry.java;1;0;1;1;0;0;0;1;0;0;1;316;0;0;1;0;0;1;1;316;0;316;1;1;
/org.eclipse.jdt.core.tests.model/workspace/Converter/src/test0205/Test.java;1;0;1;1;0;0;0;1;0;0;1;3714;0;0;1;0;0;1;1;3714;0;3714;1;1;
/org.eclipse.jdt.ui/core refactoring/org/eclipse/jdt/internal/corext/refactoring/ParameterInfo.java;4;0;7;1;1;1;1;6;14;1;6;738;43;43;1;0;0;6;7;738;0;6340;7;4;
/org.eclipse.jdt.core.tests.model/workspace/Formatter/test395/A_out.java;1;0;1;1;0;0;0;1;0;0;1;3435;0;0;1;0;0;1;1;3435;0;3435;1;1;
/org.eclipse.jdt.ui.tests.refactoring/resources/ChangeSignature/canModify/A_testName02_in.java;1;0;1;1;0;0;0;1;0;0;1;3801;0;0;1;0;0;1;1;3801;0;3801;1;1;
/org.eclipse.jdt.core/compiler/org/eclipse/jdt/internal/compiler/ast/AnnotationFieldReference.java;2;0;6;1;0;0;0;6;31;2;5;2397;64;64;2;1;0;6;6;2580;1;2887;5;2;
/org.eclipse.core.tools.resources/src/org/eclipse/core/tools/resources/ResourceContentProvider.java;1;0;1;1;1;1;1;0;0;0;0;6302;0;0;1;0;0;0;1;6302;0;6302;1;1;
/org.eclipse.jdt.ui/core refactoring/org/eclipse/ltk/internal/refactoring/core/RenameFieldData.java;1;0;2;1;0;0;0;2;0;1;2;3930;0;0;1;0;0;2;2;3930;0;4510;2;1;
/org.eclipse.update.core/src/org/eclipse/update/core/IPlatformEnvironment.java;2;1;4;1;3;3;3;1;6;0;1;890;15;15;1;0;0;1;4;890;0;6336;4;2;
/org.eclipse.pde.ui/src/org/eclipse/pde/internal/ui/editor/text/PDECommentScanner.java;1;0;1;1;0;0;0;1;0;0;1;3795;0;0;1;0;0;1;1;3795;0;3795;1;1;
/org.eclipse.swt/Eclipse SWT Drag and Drop/win32/org/eclipse/swt/dnd/TextTransfer.java;1;0;2;1;0;0;0;2;129;1;2;307;135;135;1;0;0;2;2;307;0;2364;2;1;
/org.eclipse.jdt.ui/ui refactoring/org/eclipse/jdt/internal/ui/refactoring/reorg/QualifiedNameComponent.java;2;0;4;1;1;1;1;3;4;1;3;1047;8;8;1;0;0;3;4;1047;0;6340;4;2;
/org.eclipse.jdt.ui/ui/org/eclipse/jdt/internal/ui/text/correction/QuickTemplateProcessor.java;4;1;15;1;2;2;2;13;145;1;13;1011;237;237;1;0;0;13;15;1011;0;6340;15;4;
/org.eclipse.jdt.ui.tests.refactoring/resources/InlineMethodWorkspace/TestCases/import_out/TestUseInDeclClash.java;1;0;1;1;0;0;0;1;2;0;1;845;2;2;1;0;0;1;1;845;0;845;1;1;
/org.eclipse.debug.ui/ui/org/eclipse/debug/internal/ui/actions/EnableWatchExpressionAction.java;1;0;1;1;0;0;0;1;0;0;1;1516;0;0;1;0;0;1;1;1516;0;1516;1;1;
/org.eclipse.pde.ui/src/org/eclipse/pde/internal/ui/wizards/plugin/WizardListSelectionPage.java;2;2;6;1;4;3;4;2;37;1;2;3986;75;75;2;0;1;2;6;5204;1;5514;5;2;
/org.eclipse.jdt.core/search/org/eclipse/jdt/internal/core/index/impl/SafeRandomAccessFile.java;1;0;2;1;0;0;0;2;2;1;2;3560;2;2;1;0;0;2;2;3560;0;4060;2;1;
/org.eclipse.ui.workbench/Eclipse UI/org/eclipse/ui/internal/ExtensionEventHandler.java;5;1;31;3;2;2;2;29;268;4;17;3500;845;845;4;12;0;29;31;3876;12;6271;19;5;
/org.eclipse.ui.workbench/Eclipse UI/org/eclipse/ui/internal/dialogs/CheckboxSingleListGroup.java;1;0;1;1;0;0;0;1;0;0;1;2737;0;0;1;0;0;1;1;2737;0;2737;1;1;
/org.eclipse.jdt.core.tests.model/workspace/Converter/test0288/Test.java;1;0;1;1;0;0;0;1;0;0;1;3714;0;0;1;0;0;1;1;3714;0;3714;1;1;
/org.eclipse.ant.ui/Ant Tools Support/org/eclipse/ant/ui/internal/model/IAntUIPreferenceConstants.java;1;0;5;1;0;0;0;5;14;2;4;250;17;17;2;1;0;5;5;262;1;1811;4;1;
/org.eclipse.swt/Eclipse SWT/win32/org/eclipse/swt/widgets/TabFolder.java;4;0;11;1;1;1;1;10;40;2;8;234;141;141;2;2;0;10;11;3254;2;6352;9;4;
/org.eclipse.jface.text/projection/org/eclipse/jface/text/source/projection/ProjectionViewer.java;4;3;47;3;38;25;38;9;361;2;8;4516;2631;2631;3;1;13;9;47;5218;14;6362;33;4;
/org.eclipse.search/search/org/eclipse/search/internal/ui/util/StringMatcher.java;1;0;4;1;0;0;0;4;6;1;4;122;6;6;1;0;0;4;4;122;0;1981;4;1;
/org.eclipse.ui.workbench/Eclipse UI/org/eclipse/ui/internal/presentations/LayoutCache.java;1;0;2;1;0;0;0;2;0;1;2;4691;0;0;1;0;0;2;2;4691;0;5003;2;1;
/org.eclipse.core.runtime.osgi/src/org/eclipse/core/internal/boot/PlatformURLBaseConnection.java;1;0;2;1;0;0;0;2;56;1;2;3013;56;56;1;0;0;2;2;3013;0;3028;2;1;
/org.eclipse.jdt.core.tests.model/workspace/Converter/test0025/Test.java;1;0;1;1;0;0;0;1;0;0;1;3714;0;0;1;0;0;1;1;3714;0;3714;1;1;
/org.eclipse.osgi/eclipseAdaptor/src/org/eclipse/core/runtime/adaptor/EclipseBundleInstaller.java;2;1;3;1;2;2;2;1;3;0;1;4238;5;5;1;0;0;1;3;4238;0;6133;3;2;
/org.eclipse.jdt.core.tests.model/workspace/Converter/src/test0100/Test.java;1;0;1;1;0;0;0;1;0;0;1;3714;0;0;1;0;0;1;1;3714;0;3714;1;1;
/org.eclipse.jdt.ui.tests.refactoring/resources/ExtractMethodWorkSpace/ExtractMethodTests/locals_out/A_test559.java;1;0;1;1;0;0;0;1;4;0;1;844;4;4;1;0;0;1;1;844;0;844;1;1;
/org.eclipse.core.resources/src/org/eclipse/core/internal/watson/DeltaIterator.java;1;0;1;1;1;1;1;0;237;0;0;5146;237;237;1;0;0;0;1;5146;0;5146;1;1;
/org.eclipse.team.core/src/org/eclipse/team/internal/core/subscribers/WorkingSetSyncSetInput.java;1;0;3;1;1;1;1;2;36;1;2;3550;38;38;1;0;0;2;3;3550;0;6336;3;1;
/org.eclipse.update.ui.forms/src/org/eclipse/ui/forms/parts/BoxToggle.java;1;0;2;1;0;0;0;2;0;0;1;3095;0;0;2;1;0;2;2;3095;1;3095;1;1;
/org.eclipse.ui.intro/src/org/eclipse/ui/intro/internal/model/loader/BaseExtensionPointManager.java;1;0;3;1;1;1;1;2;4;1;2;4948;4;4;1;0;0;2;3;4948;0;5115;3;1;
/org.eclipse.ui.workbench/Eclipse UI/org/eclipse/ui/contexts/IContextActivationService.java;2;0;8;1;0;0;0;8;54;1;8;1220;121;121;1;0;0;8;8;1220;0;4144;8;2;
/org.eclipse.team.ui/src/org/eclipse/team/ui/synchronize/actions/ExpandAllAction.java;1;0;1;1;0;0;0;1;0;0;1;2535;0;0;1;0;0;1;1;2535;0;2535;1;1;
/org.eclipse.jdt.debug.ui/ui/org/eclipse/jdt/internal/debug/ui/actions/AddExternalJarAction.java;1;0;1;1;0;0;0;1;15;0;1;2691;15;15;1;0;0;1;1;2691;0;2691;1;1;
/org.eclipse.swt/Eclipse SWT Browser/common/org/eclipse/swt/browser/ProgressAdapter.java;2;0;4;1;1;1;1;3;30;1;3;1675;39;39;1;0;0;3;4;1675;0;6352;4;2;
/org.eclipse.swt/Eclipse SWT/win32/org/eclipse/swt/graphics/Region.java;4;1;5;1;2;2;2;3;145;1;3;1657;206;206;1;0;0;3;5;1657;0;6352;5;4;
/org.eclipse.jdt.core.tests.model/src/org/eclipse/jdt/core/tests/model/JavaModelTests.java;2;0;3;1;0;0;0;3;50;1;3;2094;55;55;1;0;0;3;3;2094;0;3511;3;2;
/org.eclipse.pde.core/src_OSGi/org/eclipse/pde/internal/core/osgi/bundle/WorkspaceBundleModel.java;2;0;5;1;0;0;0;5;5;1;5;2229;9;9;1;0;0;5;5;2229;0;4203;5;2;
/org.eclipse.team.ui/src/org/eclipse/team/internal/ui/sync/views/SyncSetInputFromSubscriberWorkingSet.java;2;0;5;1;0;0;0;5;127;1;5;629;134;134;1;0;0;5;5;629;0;1354;5;2;
/org.eclipse.pde.ui/src/org/eclipse/pde/internal/ui/editor/text/PDETagScanner.java;1;0;1;1;0;0;0;1;0;0;1;3795;0;0;1;0;0;1;1;3795;0;3795;1;1;
/org.eclipse.osgi/eclipseAdaptor/src/org/eclipse/core/runtime/adaptor/testsupport/SimpleBundleInstaller.java;2;0;2;1;1;1;1;1;4;0;1;4239;4;4;1;0;0;1;2;4239;0;5117;2;2;
/org.eclipse.jdt.ui.tests.refactoring/resources/MoveMembers/test1/out/B.java;2;0;2;1;1;1;1;1;5;0;1;1522;6;6;1;0;0;1;2;1522;0;5676;2;2;
/org.eclipse.update.ui.forms/src/org/eclipse/ui/forms/parts/HyperlinkLabel.java;1;0;3;1;0;0;0;3;60;1;3;3038;60;60;1;0;0;3;3;3038;0;3071;3;1;
/org.eclipse.jdt.core.tests.model/workspace/Formatter/test007/A_in.java;1;0;1;1;0;0;0;1;0;0;1;2425;0;0;1;0;0;1;1;2425;0;2425;1;1;
/org.eclipse.jdt.core.tests.model/src/org/eclipse/jdt/core/tests/dom/ASTParserTest.java;1;0;4;1;1;1;1;3;104;2;2;4149;122;122;2;1;0;3;4;4149;1;5272;3;1;
/org.eclipse.pde.ui/sandbox/org/eclipse/pde/internal/ui/editor/standalone/parser/IProblem.java;1;0;2;1;0;0;0;2;0;1;2;2320;0;0;1;0;0;2;2;2320;0;2931;2;1;
/org.eclipse.osgi/defaultAdaptor/src/org/eclipse/osgi/framework/adaptor/core/SystemBundleData.java;4;2;10;2;5;4;5;5;317;1;5;4336;404;404;2;0;1;5;10;5523;1;5523;9;4;
/org.eclipse.jdt.core.tests.model/workspace/Converter/test0171/Test.java;1;0;1;1;0;0;0;1;0;0;1;3714;0;0;1;0;0;1;1;3714;0;3714;1;1;
/org.eclipse.jdt.ui.tests.refactoring/resources/InlineMethodWorkspace/TestCases/cast_out/TestOverloaded.java;1;0;1;1;0;0;0;1;0;0;1;955;0;0;1;0;0;1;1;955;0;955;1;1;
/org.eclipse.jdt.debug/eval/org/eclipse/jdt/internal/debug/eval/ast/instructions/LocalVariableCreation.java;1;0;1;1;0;0;0;1;8;0;1;363;8;8;1;0;0;1;1;363;0;363;1;1;
/org.eclipse.jface/src/org/eclipse/jface/viewers/TableViewer.java;5;1;6;1;2;2;2;4;21;1;4;2609;34;34;1;0;0;4;6;2609;0;6231;6;5;
/org.eclipse.jdt.ui/ui refactoring/org/eclipse/jdt/internal/ui/refactoring/nls/PackageAndProjectSelectionValidator.java;2;0;2;1;1;1;1;1;0;0;1;4930;0;0;1;0;0;1;2;4930;0;5375;2;2;
/org.eclipse.ui.ide/src/org/eclipse/ui/views/markers/internal/FieldPriority.java;2;0;3;1;1;1;1;2;46;1;2;2208;81;81;1;0;0;2;3;2208;0;6340;3;2;
/org.eclipse.ui.workbench/Eclipse UI/org/eclipse/ui/internal/WorkbookEditorsAction.java;2;1;2;1;2;2;2;0;2;0;0;5635;2;2;1;0;0;0;2;5635;0;6338;2;2;
/org.eclipse.search/new search/org/eclipse/search/ui/text/ISearchElementPresentation.java;1;0;2;1;0;0;0;2;0;1;2;3474;0;0;1;0;0;2;2;3474;0;3711;2;1;
/org.eclipse.update/src/org/eclipse/update/internal/core/UMSessionManagerEntry.java;1;0;1;1;1;1;1;0;0;0;0;6339;0;0;1;0;0;0;1;6339;0;6339;1;1;
/org.eclipse.jdt.core/search/org/eclipse/jdt/internal/core/search/matching/PotentialMatchSet.java;1;0;2;1;0;0;0;2;72;1;2;1429;72;72;1;0;0;2;2;1429;0;2010;2;1;
/org.eclipse.debug.core/core/org/eclipse/debug/internal/core/memory/IDynamicRenderingInfo.java;1;0;1;1;1;1;1;0;0;0;0;5254;0;0;1;0;0;0;1;5254;0;5254;1;1;
/org.eclipse.debug.ui/ui/org/eclipse/debug/internal/ui/views/memory/MonitorMemoryBlockDialog.java;2;1;2;1;2;2;2;0;4;0;0;5254;4;4;1;0;0;0;2;5254;0;5364;2;2;
/org.eclipse.team.ui/src/org/eclipse/team/internal/ui/synchronize/actions/StatusLineCLabelContribution.java;1;0;6;1;1;1;1;5;108;1;5;2535;171;171;1;0;0;5;6;2535;0;6337;6;1;
/org.eclipse.jdt.ui/ui/org/eclipse/jdt/ui/actions/ShowInPackageViewAction.java;4;0;4;1;1;1;1;3;76;1;3;592;93;93;1;0;0;3;4;592;0;6340;4;4;
/org.eclipse.team.webdav/src/org/eclipse/team/internal/ui/target/TargetSyncAction.java;2;0;2;1;0;0;0;2;0;1;2;2495;0;0;1;0;0;2;2;2495;0;4216;2;2;
/org.eclipse.ui.workbench/Eclipse UI/org/eclipse/ui/internal/commands/old/StatusLineContributionItem.java;1;0;2;1;0;0;0;2;0;1;2;1222;0;0;1;0;0;2;2;1222;0;1695;2;1;
/org.eclipse.jface.text/src/org/eclipse/jface/text/templates/JFaceTextTemplateMessages.java;2;1;2;1;2;2;2;0;2;0;0;5304;4;4;1;0;0;0;2;5304;0;6340;2;2;
/org.eclipse.core.resources/src/org/eclipse/core/internal/indexing/LogWriter.java;1;1;2;1;2;2;2;0;19;0;0;5146;32;32;1;0;0;0;2;5146;0;5507;2;1;
/org.eclipse.team.cvs.ssh2/src/org/eclipse/team/ccvs/ssh2/CVSSSH2Plugin.java;3;0;4;1;0;0;0;4;87;1;4;2956;89;89;1;0;0;4;4;2956;0;4825;4;3;
/org.eclipse.swt/Eclipse SWT PI/gtk/org/eclipse/swt/internal/gtk/GtkRequisition.java;3;0;3;1;1;1;1;2;17;1;2;1653;21;21;1;0;0;2;3;1653;0;6352;3;3;
/org.eclipse.team.tests.cvs.core/src/org/eclipse/team/tests/ccvs/ui/old/TaskEntry.java;1;0;2;1;0;0;0;2;0;1;2;2632;0;0;1;0;0;2;2;2632;0;4216;2;1;
/org.eclipse.jdt.ui/ui refactoring/org/eclipse/jdt/internal/ui/refactoring/PullUpInputPage2.java;1;0;1;1;0;0;0;1;0;0;1;518;0;0;1;0;0;1;1;518;0;518;1;1;
/org.eclipse.core.runtime.osgi/src/org/eclipse/core/internal/runtime/PlatformLogWriter.java;1;0;2;1;0;0;0;2;436;1;2;3013;436;436;1;0;0;2;2;3013;0;3030;2;1;
/org.eclipse.ui.workbench/Eclipse UI/org/eclipse/ui/internal/presentations/AbstractTableInformationControl.java;6;1;10;1;7;7;7;3;73;1;3;4521;165;165;1;0;0;3;10;4521;0;6338;10;6;
/org.eclipse.jdt.ui.examples.projects/examples/org/eclipse/jdt/internal/ui/exampleprojects/ExampleProjectCreationWizardPage.java;2;0;2;1;1;1;1;1;2;0;1;4823;4;4;1;0;0;1;2;4823;0;6340;2;2;
/org.eclipse.pde.core/src/org/eclipse/pde/internal/core/ibundle/IBundleFragmentModel.java;1;1;2;1;2;2;2;0;4;0;0;5445;4;4;1;0;0;0;2;5445;0;6336;2;1;
/org.eclipse.team.ui/src/org/eclipse/team/internal/ui/sync/views/SyncResource.java;2;0;5;1;0;0;0;5;149;1;5;550;228;228;1;0;0;5;5;550;0;1477;5;2;
/org.eclipse.jdt.ui.tests.refactoring/resources/MoveMembers/test20/out/A.java;1;0;1;1;0;0;0;1;2;0;1;1522;2;2;1;0;0;1;1;1522;0;1522;1;1;
/org.eclipse.core.tests.runtime/src/org/eclipse/core/tests/internal/plugins/SoftPrereqTest_15.java;1;0;1;1;0;0;0;1;0;0;1;3014;0;0;1;0;0;1;1;3014;0;3014;1;1;
/org.eclipse.ui.externaltools/Ant Editor/org/eclipse/ui/externaltools/internal/ant/editor/text/PlantyWhitespaceDetector.java;1;0;1;1;0;0;0;1;0;0;1;178;0;0;1;0;0;1;1;178;0;178;1;1;
/org.eclipse.jdt.core.tests.model/workspace/JavaSearch/src/j4/TF47209.java;1;0;1;1;0;0;0;1;0;0;1;3330;0;0;1;0;0;1;1;3330;0;3330;1;1;
/org.eclipse.jdt.ui.tests.refactoring/resources/ExtractMethodWorkSpace/ExtractMethodTests/duplicates_out/A_test950.java;1;0;1;1;0;0;0;1;0;0;1;1219;0;0;1;0;0;1;1;1219;0;1219;1;1;
/org.eclipse.jdt.core/search/org/eclipse/jdt/internal/core/search/matching/TypeDeclarationLocator.java;4;0;8;2;1;1;1;7;23;2;5;1986;38;38;2;2;0;7;8;1986;2;5207;6;4;
/org.eclipse.jdt.debug.tests/tests/org/eclipse/jdt/debug/tests/eval/DoubleAssignmentOperatorsTests.java;1;0;1;1;0;0;0;1;70;0;1;1274;70;70;1;0;0;1;1;1274;0;1274;1;1;
/org.eclipse.jdt.core.tests.model/workspace/Formatter/test345/A_in.java;1;0;1;1;0;0;0;1;0;0;1;2865;0;0;1;0;0;1;1;2865;0;2865;1;1;
/org.eclipse.core.runtime/src/org/eclipse/core/internal/plugins/Library.java;1;0;1;1;0;0;0;1;0;0;1;3013;0;0;1;0;0;1;1;3013;0;3013;1;1;
/org.eclipse.jdt.core.tests.model/workspace/Converter/src/javadoc/testBug52908a/Test.java;1;0;1;1;0;0;0;1;0;0;1;4390;0;0;1;0;0;1;1;4390;0;4390;1;1;
/org.eclipse.ui.cheatsheets/src/org/eclipse/ui/internal/cheatsheets/views/CheatSheetViewer.java;2;2;25;2;24;20;24;1;360;0;1;5093;1675;1675;2;0;4;1;25;5107;4;6322;21;2;
/org.eclipse.jdt.ui/core extension/org/eclipse/jdt/internal/corext/dom/LinkedNodeFinder.java;2;0;6;1;1;1;1;5;250;1;5;377;276;276;1;0;0;5;6;377;0;6340;6;2;
/org.eclipse.jdt.ui.tests.refactoring/resources/PromoteTempToField/canPromote/A_test18_in.java;1;0;1;1;0;0;0;1;10;0;1;1134;10;10;1;0;0;1;1;1134;0;1134;1;1;
/org.eclipse.jdt.debug.tests/tests/org/eclipse/jdt/debug/tests/core/RefreshTabTests.java;2;0;4;1;0;0;0;4;25;2;3;2068;37;37;2;1;0;4;4;3224;1;3224;3;2;
/org.eclipse.debug.ui/ui/org/eclipse/debug/internal/ui/preferences/LaunchHistoryPreferencePage.java;2;0;2;1;0;0;0;2;6;1;2;205;6;6;1;0;0;2;2;205;0;2589;2;2;
/org.eclipse.jdt.ui.tests.refactoring/resources/MoveMembers/test36/in/B.java;1;0;1;1;0;0;0;1;0;0;1;2093;0;0;1;0;0;1;1;2093;0;2093;1;1;
/org.eclipse.ui.workbench/Eclipse UI/org/eclipse/ui/internal/dialogs/ColorThemeDemo.java;3;0;8;1;0;0;0;8;204;1;8;3047;362;362;1;0;0;8;8;3047;0;4471;8;3;
/org.eclipse.swt/Eclipse SWT/common/org/eclipse/swt/internal/image/TIFFDirectory.java;1;0;2;1;0;0;0;2;1;1;2;364;1;1;1;0;0;2;2;364;0;728;2;1;
/org.eclipse.jdt.core.tests.model/workspace/Formatter/test231/A_in.java;1;0;1;1;0;0;0;1;0;0;1;2437;0;0;1;0;0;1;1;2437;0;2437;1;1;
/org.eclipse.compare.tests/JUnit Tests/org/eclipse/compare/tests/DocLineComparatorTest.java;1;0;4;1;0;0;0;4;20;1;4;560;34;34;1;0;0;4;4;560;0;3938;4;1;
/org.eclipse.jdt.core.tests.model/workspace/Converter15/src/test0010/X.java;1;0;1;1;0;0;0;1;0;0;1;4651;0;0;1;0;0;1;1;4651;0;4651;1;1;
/org.eclipse.core.tests.resources/src/org/eclipse/core/tests/internal/builders/BuilderTest.java;2;2;8;1;3;2;3;5;1591;1;5;1098;1847;1847;2;0;1;5;8;5147;1;5534;7;2;
/org.eclipse.jdt.core.tests.compiler/src/org/eclipse/jdt/core/tests/runtime/LocalVirtualMachine.java;3;0;3;1;1;1;1;2;48;1;2;1059;52;52;1;0;0;2;3;1059;0;5853;3;3;
/org.eclipse.jdt.core/search/org/eclipse/jdt/internal/core/index/impl/Block.java;2;0;3;1;0;0;0;3;2;1;3;1892;3;3;1;0;0;3;3;1892;0;4060;3;2;
/org.eclipse.core.runtime.compatibility/src-runtime/org/eclipse/core/internal/plugins/InternalPlatform.java;3;1;7;1;4;4;4;3;12;1;3;3013;27;27;1;0;0;3;7;3013;0;6340;7;3;
/org.eclipse.jdt.ui.tests.refactoring/resources/DeleteSourceReference/test9/in/A.java;1;0;1;1;0;0;0;1;0;0;1;1652;0;0;1;0;0;1;1;1652;0;1652;1;1;
/org.eclipse.ui.workbench/Eclipse UI/org/eclipse/ui/internal/dialogs/WelcomeEditor.java;4;0;4;2;0;0;0;4;95;2;3;1859;162;162;2;1;0;4;4;2608;1;2737;3;4;
/org.eclipse.jdt.core.tests.model/workspace/Converter/test0124/Test.java;1;0;1;1;0;0;0;1;0;0;1;3714;0;0;1;0;0;1;1;3714;0;3714;1;1;
/org.eclipse.pde.ui/src/org/eclipse/pde/internal/ui/launcher/WorkbenchSourcePathProvider.java;1;1;7;1;2;2;2;5;130;1;5;368;159;159;1;0;0;5;7;368;0;6336;7;1;
/org.eclipse.core.tests.runtime/src/org/eclipse/core/tests/internal/plugins/FragmentResolveTest_13.java;1;0;1;1;0;0;0;1;0;0;1;3014;0;0;1;0;0;1;1;3014;0;3014;1;1;
/org.eclipse.team.tests.cvs.core/src/org/eclipse/team/tests/ccvs/ui/Waiter.java;1;0;1;1;0;0;0;1;0;0;1;2632;0;0;1;0;0;1;1;2632;0;2632;1;1;
/org.eclipse.jdt.ui.tests.refactoring/resources/RenameStaticMethod/test10/in/B.java;1;0;1;1;0;0;0;1;0;0;1;1347;0;0;1;0;0;1;1;1347;0;1347;1;1;
/org.eclipse.jdt.ui/ui refactoring/org/eclipse/jdt/internal/ui/refactoring/IntroduceFactoryWizard.java;2;0;5;1;1;1;1;4;4;1;4;2846;9;9;1;0;0;4;5;2846;0;6340;5;2;
/org.eclipse.jdt.core.tests.model/workspace/Converter/test0052/Test.java;1;0;1;1;0;0;0;1;0;0;1;3714;0;0;1;0;0;1;1;3714;0;3714;1;1;
/org.eclipse.team.cvs.ui/src/org/eclipse/team/internal/ccvs/ui/UserValidationDialog.java;2;1;8;1;3;3;3;5;115;2;4;1013;166;166;2;1;0;5;8;5083;1;6337;7;2;
/org.eclipse.jdt.core.tests.model/workspace/Formatter/test261/A_in.java;1;0;1;1;0;0;0;1;0;0;1;2442;0;0;1;0;0;1;1;2442;0;2442;1;1;
/org.eclipse.jdt.core.tests.model/workspace/Formatter/test441/A_in.java;1;0;1;1;0;0;0;1;0;0;1;3513;0;0;1;0;0;1;1;3513;0;3513;1;1;
/org.eclipse.pde.core/srcnew/org/eclipse/pde/internal/core/plugin/XMLCore.java;2;0;3;1;1;1;1;2;11;1;2;2283;15;15;1;0;0;2;3;2283;0;5431;3;2;
/org.eclipse.ui.editors/src/org/eclipse/ui/internal/editors/quickdiff/engine/DocumentLineDiffer.java;1;0;2;1;0;0;0;2;0;1;2;1118;0;0;1;0;0;2;2;1118;0;1214;2;1;
/org.eclipse.ui.views/src/org/eclipse/ui/views/internal/tableview/Messages.java;1;0;2;1;0;0;0;2;0;1;2;267;0;0;1;0;0;2;2;267;0;749;2;1;
/org.eclipse.jdt.ui.tests.refactoring/resources/TypeConstraints/A_testConstraints9.java;1;0;1;1;0;0;0;1;0;0;1;60;0;0;1;0;0;1;1;60;0;60;1;1;
/org.eclipse.debug.ui/ui/org/eclipse/debug/internal/ui/views/launch/LaunchViewLabelDecorator.java;3;0;14;2;0;0;0;14;87;2;11;2387;314;314;2;3;0;14;14;2556;3;3495;11;3;
/org.eclipse.jdt.ui.tests.refactoring/resources/TypeConstraints/A_testConstraints14.java;1;0;1;1;0;0;0;1;0;0;1;65;0;0;1;0;0;1;1;65;0;65;1;1;
/org.eclipse.team.core/src/org/eclipse/team/core/sync/RemoteContentsCache.java;2;0;7;1;0;0;0;7;277;1;7;1632;319;319;1;0;0;7;7;1632;0;4217;7;2;
/org.eclipse.ui.externaltools/Ant Tools Support/org/eclipse/ui/externaltools/internal/ant/view/actions/EditorImageDescriptor.java;1;0;1;1;0;0;0;1;0;0;1;282;0;0;1;0;0;1;1;282;0;282;1;1;
/org.eclipse.jdt.core.tests.model/workspace/Converter/src/test0227/Test.java;1;0;1;1;0;0;0;1;0;0;1;3714;0;0;1;0;0;1;1;3714;0;3714;1;1;
/org.eclipse.jdt.core/compiler/org/eclipse/jdt/internal/compiler/parser/SourceConstructorDeclaration.java;2;0;2;1;0;0;0;2;2;1;2;3560;2;2;1;0;0;2;2;3560;0;4461;2;2;
/org.eclipse.swt/Eclipse SWT Program/gtk/org/eclipse/swt/program/Program.java;5;1;17;2;5;5;5;12;401;2;10;445;654;654;2;2;0;12;17;3067;2;6352;15;5;
/org.eclipse.jdt.launching/launching/org/eclipse/jdt/launching/StandardClasspathProvider.java;3;1;6;1;2;2;2;4;38;1;4;1275;82;82;1;0;0;4;6;1275;0;6336;6;3;
/org.eclipse.core.runtime.compatibility/src-model/org/eclipse/core/runtime/model/ExtensionModel.java;3;2;6;1;4;3;4;2;26;1;2;3013;35;35;2;0;1;2;6;5117;1;6340;5;3;
/org.eclipse.team.cvs.ui/src/org/eclipse/team/internal/ccvs/ui/model/CVSTagElement.java;2;1;14;1;4;4;4;10;97;2;7;66;248;248;2;3;0;10;14;1064;3;6337;11;2;
/org.eclipse.jdt.ui/core extension/org/eclipse/jdt/internal/corext/codemanipulation/AddGetterSetterOperation.java;3;1;20;2;2;2;2;18;169;2;16;312;482;482;2;2;0;18;20;579;2;6340;18;3;
/org.eclipse.ui.workbench/Eclipse UI/org/eclipse/ui/internal/commands/registry/IImageBindingDefinition.java;1;0;2;1;0;0;0;2;0;1;2;1422;0;0;1;0;0;2;2;1422;0;1724;2;1;
/org.eclipse.ant.ui/Remote Ant Support/org/eclipse/ant/ui/internal/antsupport/AntSecurityManager.java;1;0;2;1;0;0;0;2;0;1;2;1696;0;0;1;0;0;2;2;1696;0;1811;2;1;
/org.eclipse.help.ui/src/org/eclipse/help/ui/internal/HelpActivitySupport.java;1;2;8;1;5;4;5;3;87;2;2;3319;256;256;2;1;1;3;8;3319;2;6337;6;1;
/org.eclipse.jdt.ui/ui/org/eclipse/jdt/internal/ui/text/comment/CommentRegion.java;2;0;16;1;1;1;1;15;509;2;14;1589;1356;1356;2;1;0;15;16;2097;1;6340;15;2;
/org.eclipse.jdt.core.tests.model/workspace/Converter/src/test0507/B.java;1;0;1;1;0;0;0;1;0;0;1;3714;0;0;1;0;0;1;1;3714;0;3714;1;1;
/org.eclipse.jdt.debug.ui/ui/org/eclipse/jdt/internal/debug/ui/launcher/DebugModePromptStatusHandler.java;1;0;2;1;0;0;0;2;0;0;1;4631;0;0;2;1;0;2;2;4631;1;4631;1;1;
/org.eclipse.update.core/src/org/eclipse/update/internal/configuration/InstallConfigurationParser.java;1;0;1;1;0;0;0;1;0;0;1;2828;0;0;1;0;0;1;1;2828;0;2828;1;1;
/org.eclipse.jdt.ui.tests.refactoring/resources/DeleteSourceReference/test8/out/A.java;1;0;1;1;0;0;0;1;0;0;1;1652;0;0;1;0;0;1;1;1652;0;1652;1;1;
/org.eclipse.swt/Eclipse SWT/motif/org/eclipse/swt/graphics/Region.java;3;1;4;1;2;2;2;2;87;1;2;1657;213;213;1;0;0;2;4;1657;0;6352;4;3;
/org.eclipse.update.ui/src/org/eclipse/update/internal/ui/wizards/ResizableWizardDialog.java;3;0;4;1;1;1;1;3;7;1;3;755;7;7;1;0;0;3;4;755;0;5767;4;3;
/org.eclipse.ui.workbench/Eclipse UI/org/eclipse/ui/internal/layout/ICachingLayout.java;1;0;1;1;1;1;1;0;0;0;0;5452;0;0;1;0;0;0;1;5452;0;5452;1;1;
/org.eclipse.jdt.core.tests.model/workspace/Formatter/test311/A_out.java;1;0;1;1;0;0;0;1;0;0;1;2442;0;0;1;0;0;1;1;2442;0;2442;1;1;
/org.eclipse.pde.ui/src/org/eclipse/pde/internal/ui/wizards/imports/UpdateClasspathAction.java;2;0;13;2;0;0;0;13;58;2;11;1111;232;232;2;2;0;13;13;2534;2;3840;11;2;
/org.eclipse.debug.ui/ui/org/eclipse/debug/ui/variables/IGroupDialogPage.java;1;0;3;1;0;0;0;3;49;0;1;316;49;49;3;2;0;3;3;316;2;316;1;1;
/org.eclipse.team.ftp/src/org/eclipse/team/internal/ftp/client/LSDirectoryEntryParserWithUsernameOnly.java;2;0;2;1;1;1;1;1;16;0;1;4268;16;16;1;0;0;1;2;4268;0;6337;2;2;
/org.eclipse.jdt.core.tests.model/workspace/Converter/test0464/A.java;1;0;1;1;0;0;0;1;0;0;1;3714;0;0;1;0;0;1;1;3714;0;3714;1;1;
/org.eclipse.core.runtime.osgi/src/org/eclipse/core/internal/registry/Factory.java;1;0;2;1;0;0;0;2;144;1;2;3013;144;144;1;0;0;2;2;3013;0;3030;2;1;
/org.eclipse.jdt.core.tests.model/workspace/Converter/src/test0083/Test.java;1;0;1;1;0;0;0;1;0;0;1;3714;0;0;1;0;0;1;1;3714;0;3714;1;1;
/org.eclipse.jdt.ui/ui/org/eclipse/jdt/internal/ui/actions/OverrideMethodQuery.java;1;0;1;1;0;0;0;1;0;0;1;576;0;0;1;0;0;1;1;576;0;576;1;1;
/org.eclipse.jdt.ui/ui/org/eclipse/jdt/internal/ui/text/Symbols.java;2;0;4;1;1;1;1;3;8;0;1;1968;12;12;3;2;0;3;4;1968;2;6340;2;2;
/org.eclipse.text/src/org/eclipse/jface/text/ISlaveDocumentManager.java;1;0;1;1;1;1;1;0;21;0;0;6297;21;21;1;0;0;0;1;6297;0;6297;1;1;
/org.eclipse.jdt.ui.examples.javafamily/src/org/eclipse/text/reconcilerpipe/ITextModel.java;1;0;2;1;0;0;0;2;0;1;2;1071;0;0;1;0;0;2;2;1071;0;1629;2;1;
/org.eclipse.ui.workbench/Eclipse UI/org/eclipse/ui/internal/contexts/ContextContextBindingDefinition.java;2;0;4;1;1;1;1;3;18;1;3;3066;26;26;1;0;0;3;4;3066;0;5273;4;2;
/org.eclipse.ui.tests/Eclipse UI Tests/org/eclipse/ui/tests/dialogs/UINewWorkingSetWizardAuto.java;3;0;3;2;0;0;0;3;37;2;2;374;44;44;2;1;0;3;3;374;1;3091;2;3;
/org.eclipse.team.webdav/src/org/eclipse/team/internal/ui/target/ProjectTargetMappingPropertiesPage.java;2;0;3;1;1;1;1;2;14;1;2;2495;16;16;1;0;0;2;3;2495;0;6337;3;2;
/org.eclipse.jdt.ui.tests.refactoring/resources/TypeConstraints/A_testConstraints11.java;1;0;1;1;0;0;0;1;0;0;1;65;0;0;1;0;0;1;1;65;0;65;1;1;
/org.eclipse.jdt.core/codeassist/org/eclipse/jdt/internal/codeassist/select/SelectionScanner.java;2;0;4;1;0;0;0;4;4;1;4;530;11;11;1;0;0;4;4;530;0;4443;4;2;
/org.eclipse.team.cvs.ui/src/org/eclipse/team/internal/ccvs/ui/FileModificationValidator.java;2;1;6;1;5;5;5;1;69;0;1;3744;128;128;1;0;0;1;6;3744;0;6337;6;2;
/org.eclipse.team.tests.cvs.core/src/org/eclipse/team/tests/ccvs/ui/old/GroupEntry.java;1;0;2;1;0;0;0;2;0;1;2;2632;0;0;1;0;0;2;2;2632;0;4216;2;1;
/org.eclipse.team.cvs.ui/src/org/eclipse/team/internal/ccvs/ui/CVSPerspective.java;1;1;2;1;2;2;2;0;7;0;0;5677;9;9;1;0;0;0;2;5677;0;6337;2;1;
/org.eclipse.jdt.ui/core refactoring/org/eclipse/jdt/internal/corext/refactoring/participants/RenameFileProcessor.java;1;0;3;1;0;0;0;3;29;1;3;591;29;29;1;0;0;3;3;591;0;1125;3;1;
/org.eclipse.swt/Eclipse SWT Drag and Drop/gtk/org/eclipse/swt/dnd/ClipboardProxy.java;4;1;6;1;3;3;3;3;28;1;3;318;54;54;1;0;0;3;6;318;0;6352;6;4;
/org.eclipse.update.ui.forms/Eclipse Forms/org/eclipse/ui/forms/internal/parts/FormsResources.java;1;0;2;1;0;0;0;2;0;1;2;3098;0;0;1;0;0;2;2;3098;0;3138;2;1;
/org.eclipse.team.cvs.ui/src/org/eclipse/team/internal/ccvs/ui/ExtMethodPreferencePage.java;2;1;4;1;3;3;3;1;137;0;1;276;148;148;1;0;0;1;4;276;0;6337;4;2;
/org.eclipse.ua.tests/src/org/eclipse/ui/examples/cheatsheets/pattern/actions/PatternGenerator.java;1;0;1;1;1;1;1;0;0;0;0;6081;0;0;1;0;0;0;1;6081;0;6081;1;1;
/org.eclipse.ui.workbench/Eclipse UI/org/eclipse/ui/roles/IRole.java;1;0;7;1;0;0;0;7;129;1;7;1952;261;261;1;0;0;7;7;1952;0;2864;7;1;
/org.eclipse.pde.ui/src/org/eclipse/pde/internal/ui/editor/manifest/ManifestSourcePage.java;1;0;2;1;1;1;1;1;15;0;1;909;15;15;1;0;0;1;2;909;0;5431;2;1;
/org.eclipse.ui.views/src/org/eclipse/ui/views/markers/internal/ActionDeleteCompleted.java;2;0;2;1;0;0;0;2;0;1;2;755;0;0;1;0;0;2;2;755;0;2738;2;2;
/org.eclipse.ui.views/src/org/eclipse/ui/views/internal/markers/problems/ResolveMarkerAction.java;1;0;2;1;0;0;0;2;0;1;2;265;0;0;1;0;0;2;2;265;0;749;2;1;
/org.eclipse.jdt.ui/core refactoring/org/eclipse/jdt/internal/corext/refactoring/structure/ImportEditManager.java;1;0;1;1;0;0;0;1;0;0;1;1952;0;0;1;0;0;1;1;1952;0;1952;1;1;
/org.eclipse.ui.tests/Eclipse UI Tests/org/eclipse/ui/tests/api/ViewPerspective.java;1;0;1;1;1;1;1;0;0;0;0;5635;0;0;1;0;0;0;1;5635;0;5635;1;1;
/org.eclipse.jdt.core.tests.model/src/org/eclipse/jdt/core/tests/model/CreateMethodSourceExamplesTests.java;1;0;2;1;1;1;1;1;3;0;1;3560;5;5;1;0;0;1;2;3560;0;5584;2;1;
/org.eclipse.jdt.ui.examples.javafamily/src/org/eclipse/jsp/launching/JspTab.java;1;0;2;1;0;0;0;2;0;1;2;1355;0;0;1;0;0;2;2;1355;0;1373;2;1;
/org.eclipse.core.tests.resources/src/org/eclipse/core/tests/resources/IResourceChangeEventTest.java;1;0;3;1;3;1;3;0;377;0;0;5147;377;377;3;0;2;0;3;5147;2;5147;1;1;
/org.eclipse.jdt.ui/ui refactoring/org/eclipse/jdt/internal/ui/refactoring/ChangeParametersControl.java;4;2;20;2;6;5;6;14;281;2;12;1035;556;556;2;2;1;14;20;3249;3;6340;17;4;
/org.eclipse.pde.core/src/org/eclipse/pde/internal/core/site/SiteCategory.java;2;1;3;1;2;2;2;1;8;0;1;4203;20;20;1;0;0;1;3;4203;0;6336;3;2;
/org.eclipse.update.ui/src/org/eclipse/update/internal/ui/search/ISearchQuery.java;1;0;2;1;0;0;0;2;2;1;2;369;2;2;1;0;0;2;2;369;0;825;2;1;
/org.eclipse.jdt.core/search/org/eclipse/jdt/internal/core/search/indexing/ReadWriteMonitor.java;2;0;3;1;0;0;0;3;50;1;3;1893;54;54;1;0;0;3;3;1893;0;4060;3;2;
/org.eclipse.pde.core/src/org/eclipse/pde/core/plugin/IExtensionsModel.java;2;1;7;1;5;5;5;2;24;1;2;2184;58;58;1;0;0;2;7;2184;0;6336;7;2;
/org.eclipse.ui.views/src/org/eclipse/ui/views/markers/internal/MarkerTypesModel.java;2;0;2;1;0;0;0;2;0;1;2;755;0;0;1;0;0;2;2;755;0;2738;2;2;
/org.eclipse.jdt.debug.ui/ui/org/eclipse/jdt/internal/debug/ui/actions/AddProjectAction.java;3;1;4;1;2;2;2;2;13;1;2;1240;24;24;1;0;0;2;4;1240;0;6336;4;3;
/org.eclipse.jdt.core.tests.model/workspace/Formatter/test405/A_in.java;1;0;1;1;0;0;0;1;0;0;1;3438;0;0;1;0;0;1;1;3438;0;3438;1;1;
/org.eclipse.ui.workbench/Eclipse UI/org/eclipse/ui/internal/SaveAsAction.java;3;0;4;1;1;1;1;3;28;1;3;2737;53;53;1;0;0;3;4;2737;0;6338;4;3;
/org.eclipse.jdt.ui.tests.refactoring/resources/Copy/test_import_container_yes_cu/out/C.java;1;0;1;1;0;0;0;1;0;0;1;696;0;0;1;0;0;1;1;696;0;696;1;1;
/org.eclipse.jdt.ui.tests.refactoring/resources/ExtractMethodWorkSpace/ExtractMethodTests/locals_out/A_test564.java;1;0;2;1;0;0;0;2;4;1;2;130;5;5;1;0;0;2;2;130;0;844;2;1;
/org.eclipse.jdt.ui.tests.refactoring/resources/ExtractMethodWorkSpace/ExtractMethodTests/destination_in/A_test1050.java;1;0;1;1;1;1;1;0;0;0;0;5353;0;0;1;0;0;0;1;5353;0;5353;1;1;
/org.eclipse.pde.build/src/org/eclipse/pde/internal/build/BundleHelper.java;2;1;4;1;2;2;2;2;91;1;2;4490;138;138;1;0;0;2;4;4490;0;5754;4;2;
/org.eclipse.pde.ui/src/org/eclipse/pde/internal/ui/editor/build/VariableSelectionDialog.java;1;0;1;1;0;0;0;1;0;0;1;1727;0;0;1;0;0;1;1;1727;0;1727;1;1;
/org.eclipse.pde.ui/src_Forms/org/eclipse/pde/internal/ui/neweditor/site/SiteUndoManager.java;2;0;3;1;1;1;1;2;24;0;1;4832;24;24;2;1;0;2;3;4832;1;5431;2;2;
/org.eclipse.team.cvs.ui/src/org/eclipse/team/internal/ccvs/ui/subscriber/WorkspaceSynchronizeAdvisor.java;2;0;5;1;1;1;1;4;21;1;4;4588;27;27;1;0;0;4;5;4588;0;5358;5;2;
/org.eclipse.jdt.ui/ui/org/eclipse/jdt/ui/actions/OpenEditorActionGroup.java;2;0;2;1;1;1;1;1;2;0;1;4307;3;3;1;0;0;1;2;4307;0;6340;2;2;
/org.eclipse.jdt.ui.tests.refactoring/resources/ExtractMethodWorkSpace/ExtractMethodTests/branch_in/A_test754.java;1;0;2;1;0;0;0;2;4;1;2;844;4;4;1;0;0;2;2;844;0;2256;2;1;
/org.eclipse.team.cvs.ui/src/org/eclipse/team/internal/ccvs/ui/model/TagCategory.java;2;0;3;1;1;1;1;2;72;1;2;2569;74;74;1;0;0;2;3;2569;0;6337;3;2;
/org.eclipse.debug.core/core/org/eclipse/debug/core/sourcelookup/containers/ArchiveSourceContainer.java;2;1;5;1;2;2;2;3;12;0;1;4949;19;19;3;2;0;3;5;4949;2;6335;3;2;
/org.eclipse.swt/Eclipse SWT/gtk1x/org/eclipse/swt/widgets/TableItem.java;1;0;1;1;0;0;0;1;0;0;1;2327;0;0;1;0;0;1;1;2327;0;2327;1;1;
/org.eclipse.pde.ui/src/org/eclipse/pde/ui/IFieldData.java;2;1;4;1;4;4;4;0;114;0;0;5152;187;187;1;0;0;0;4;5152;0;6336;4;2;
/org.eclipse.jdt.core/model/org/eclipse/jdt/internal/core/UserLibraryManager.java;1;1;3;1;3;3;3;0;18;0;0;5199;22;22;1;0;0;0;3;5199;0;5713;3;1;
/org.eclipse.ui.ide/src/org/eclipse/ui/views/tasklist/TaskAction.java;1;0;1;1;0;0;0;1;0;0;1;2208;0;0;1;0;0;1;1;2208;0;2208;1;1;
/org.eclipse.pde.core/src/org/eclipse/pde/internal/core/plugin/PluginExtension.java;3;1;6;1;4;4;4;2;32;1;2;4203;76;76;1;0;0;2;6;4203;0;6336;6;3;
/org.eclipse.jface/src/org/eclipse/jface/viewers/TextCellEditor.java;3;0;4;2;1;1;1;3;43;1;3;3012;76;76;1;0;0;3;4;3012;0;6338;4;3;
/org.eclipse.jdt.ui/ui/org/eclipse/jdt/internal/ui/compare/JavaStructureDiffViewer.java;1;0;1;1;1;1;1;0;2;0;0;6340;2;2;1;0;0;0;1;6340;0;6340;1;1;
/org.eclipse.pde.ui/src_Forms/org/eclipse/pde/internal/ui/neweditor/IContextPart.java;2;0;4;1;1;1;1;3;3;2;2;4338;3;3;2;1;0;3;4;4354;1;5431;3;2;
/org.eclipse.jdt.core.tests.model/workspace/JavaSearch/src/j2/Bug47968.java;1;0;1;1;0;0;0;1;0;0;1;3129;0;0;1;0;0;1;1;3129;0;3129;1;1;
/org.eclipse.swt/Eclipse SWT Mozilla/common/org/eclipse/swt/internal/mozilla/nsIIOService.java;1;0;1;1;0;0;0;1;0;0;1;2663;0;0;1;0;0;1;1;2663;0;2663;1;1;
/org.eclipse.ui.ide/src/org/eclipse/ui/internal/ide/registry/MarkerImageProviderRegistry.java;4;1;4;1;2;2;2;2;2;1;2;2264;6;6;1;0;0;2;4;2264;0;6338;4;4;
/org.eclipse.ant.tests.ui/Ant Editor Tests/org/eclipse/ui/externaltools/internal/ant/editor/support/TestLocationProvider.java;1;0;2;1;0;0;0;2;4;1;2;283;4;4;1;0;0;2;2;283;0;1274;2;1;
/org.eclipse.ui.workbench/Eclipse UI/org/eclipse/ui/commands/registry/IContextBindingDefinition.java;1;0;3;1;0;0;0;3;2;2;2;1400;2;2;2;1;0;3;3;1400;1;1417;2;1;
/org.eclipse.core.filebuffers/src/org/eclipse/core/internal/filebuffers/ElementStateListener.java;1;0;2;1;0;0;0;2;0;1;2;1522;0;0;1;0;0;2;2;1522;0;1574;2;1;
/org.eclipse.swt.tests/JUnit Tests/org/eclipse/swt/tests/junit/Test_org_eclipse_swt_ole_win32_OleFrame.java;1;0;1;1;0;0;0;1;0;0;1;2176;0;0;1;0;0;1;1;2176;0;2176;1;1;
/org.eclipse.jdt.ui.tests.refactoring/test cases/org/eclipse/jdt/ui/tests/refactoring/infra/AbstractCUTestCase.java;2;0;4;1;1;1;1;3;15;1;3;130;21;21;1;0;0;3;4;130;0;6340;4;2;
/org.eclipse.jdt.ui/core extension/org/eclipse/jdt/internal/corext/dom/MoveIndentedSourceEdit.java;2;0;5;2;0;0;0;5;104;2;4;957;208;208;2;1;0;5;5;1009;1;1626;4;2;
/org.eclipse.jdt.core.tests.model/src/org/eclipse/jdt/core/tests/model/TypeHierarchyTests.java;2;1;19;1;4;4;4;15;366;2;12;100;738;738;2;3;0;15;19;2136;3;6073;16;2;
/org.eclipse.jdt.ui.tests.refactoring/resources/RenameStaticMethod/test11/out/B.java;1;0;1;1;0;0;0;1;0;0;1;1535;0;0;1;0;0;1;1;1535;0;1535;1;1;
/org.eclipse.help.base/src/org/eclipse/help/internal/base/IndexToolApplication.java;2;1;13;1;3;3;3;10;74;2;9;1747;130;130;2;1;0;10;13;1747;1;6337;12;2;
/org.eclipse.core.tests.resources/src/org/eclipse/core/tests/resources/session/TestMasterTableCleanup.java;2;0;3;1;2;1;2;1;14;0;1;230;14;14;2;0;1;1;3;5147;1;5147;2;2;
/org.eclipse.jdt.core/model/org/eclipse/jdt/internal/core/builder/AbstractImageBuilder.java;5;0;19;1;1;1;1;18;74;2;17;76;164;164;2;1;0;18;19;3560;1;5946;18;5;
/org.eclipse.jface.text/src/org/eclipse/jface/text/contentassist/IContentAssistant.java;1;2;3;1;3;2;3;0;36;0;0;6340;38;38;2;0;1;0;3;6353;1;6353;2;1;
/org.eclipse.jdt.core.tests.model/workspace/Converter/test0490/A.java;1;0;2;1;0;0;0;2;0;1;2;1590;0;0;1;0;0;2;2;1590;0;3714;2;1;
/org.eclipse.ui.tests/Eclipse UI Tests/org/eclipse/ui/tests/api/TitleTestView.java;1;2;3;1;3;2;3;0;17;0;0;5805;17;17;2;0;1;0;3;5805;1;6101;2;1;
/org.eclipse.ui.externaltools/Ant Tools Support/org/eclipse/ui/externaltools/internal/ant/preferences/AntPage.java;1;0;1;1;0;0;0;1;0;0;1;282;0;0;1;0;0;1;1;282;0;282;1;1;
/org.eclipse.swt.tests/JUnit Tests/org/eclipse/swt/tests/junit/Test_org_eclipse_swt_widgets_Slider.java;3;0;6;1;0;0;0;6;382;2;4;2123;583;583;2;2;0;6;6;2175;2;3198;4;3;
/org.eclipse.jdt.ui/ui/org/eclipse/jdt/internal/ui/browsing/PackagesViewFlatContentProvider.java;1;2;5;1;4;3;4;1;24;0;1;274;48;48;2;0;1;1;5;6097;1;6340;4;1;
/org.eclipse.debug.ui/ui/org/eclipse/debug/internal/ui/stringsubstitution/IArgumentSelector.java;2;0;3;1;0;0;0;3;5;1;3;2088;7;7;1;0;0;3;3;2088;0;2514;3;2;
/org.eclipse.jdt.core/dom/org/eclipse/jdt/core/dom/NodeSearcher.java;3;0;4;1;0;0;0;4;10;1;4;1289;14;14;1;0;0;4;4;1289;0;3560;4;3;
/org.eclipse.jdt.ui.tests.refactoring/resources/ExtractMethodWorkSpace/ExtractMethodTests/locals_out/A_test565.java;1;0;1;1;0;0;0;1;1;0;1;130;1;1;1;0;0;1;1;130;0;130;1;1;
/org.eclipse.osgi/eclipseAdaptor/src/org/eclipse/osgi/service/environment/EnvironmentInfo.java;3;1;5;1;3;3;3;2;35;1;2;3147;64;64;1;0;0;2;5;3147;0;6337;5;3;
/org.eclipse.jdt.ui/ui/org/eclipse/jdt/internal/ui/text/spelling/WordQuickFixProcessor.java;2;0;3;1;1;1;1;2;2;1;2;3930;4;4;1;0;0;2;3;3930;0;6340;3;2;
/org.eclipse.jdt.core.tests.model/workspace/Converter/test0301/Test.java;1;0;1;1;0;0;0;1;0;0;1;3714;0;0;1;0;0;1;1;3714;0;3714;1;1;
/org.eclipse.swt.graphics.text/org.eclipse.swt/Eclipse SWT PI/gtk/org/eclipse/swt/internal/gtk/OS.java;1;0;5;1;0;0;0;5;19;2;4;2267;53;53;2;1;0;5;5;2267;1;2645;4;1;
/org.eclipse.jdt.core/compiler/org/eclipse/jdt/internal/compiler/parser/RecoveredField.java;4;0;7;1;2;1;2;5;12;1;5;488;43;43;2;0;1;5;7;5405;1;5405;6;4;
/org.eclipse.jdt.core/formatter/org/eclipse/jdt/internal/formatter/old/CodeFormatter.java;2;0;5;1;1;1;1;4;114;1;4;3673;143;143;1;0;0;4;5;3673;0;6077;5;2;
/org.eclipse.jdt.core.tests.model/workspace/Converter15/src/test0024/X.java;1;0;1;1;0;0;0;1;0;0;1;4849;0;0;1;0;0;1;1;4849;0;4849;1;1;
/org.eclipse.ant.ui/Ant Tools Support/org/eclipse/ui/ant/internal/views/actions/SearchForBuildFilesDialog.java;1;0;2;1;0;0;0;2;0;1;2;250;0;0;1;0;0;2;2;250;0;263;2;1;
/org.eclipse.jdt.core.tests.model/workspace/Completion/src/CompletionInsideStaticMethod.java;1;0;1;1;1;1;1;0;0;0;0;5681;0;0;1;0;0;0;1;5681;0;5681;1;1;
/org.eclipse.ui.workbench/Eclipse UI/org/eclipse/ui/part/IntroPart.java;1;1;5;1;5;5;5;0;315;0;0;5187;355;355;1;0;0;0;5;5187;0;6218;5;1;
/org.eclipse.pde.core/src/org/eclipse/pde/core/ISourceObject.java;2;1;3;1;3;3;3;0;41;0;0;5115;49;49;1;0;0;0;3;5115;0;6336;3;2;
/org.eclipse.jdt.debug.ui/ui/org/eclipse/jdt/internal/debug/core/refactoring/JavaBreakpointITypeRenameParticipant.java;2;1;2;1;2;2;2;0;6;0;0;5319;6;6;1;0;0;0;2;5319;0;6339;2;2;
/org.eclipse.ui.workbench/Eclipse UI/org/eclipse/ui/internal/contexts/ws/WorkbenchWindowContextSupport.java;2;0;5;1;0;0;0;5;14;1;5;3066;35;35;1;0;0;5;5;3066;0;4144;5;2;
/org.eclipse.ui.externaltools/Ant Editor/org/eclipse/ui/externaltools/internal/ant/dtd/ISchema.java;1;0;2;1;0;0;0;2;3;1;2;245;3;3;1;0;0;2;2;245;0;282;2;1;
/org.eclipse.osgi/core/framework/org/eclipse/osgi/framework/internal/core/BundleContext.java;6;0;15;2;2;1;2;13;2685;2;12;3013;2941;2941;2;1;1;13;15;5058;2;5109;13;6;
/org.eclipse.jdt.ui/ui refactoring/org/eclipse/jdt/internal/ui/refactoring/participants/RenameRefactoringWizard2.java;1;0;2;1;0;0;0;2;0;1;2;591;0;0;1;0;0;2;2;591;0;1047;2;1;
/org.eclipse.ui.workbench/Eclipse UI/org/eclipse/ui/internal/util/BundleUtility.java;3;1;5;1;3;3;3;2;13;1;2;4609;35;35;1;0;0;2;5;4609;0;6338;5;3;
/org.eclipse.swt.tests/JUnit Tests/org/eclipse/swt/tests/junit/Test_org_eclipse_swt_widgets_Dialog.java;3;0;3;1;0;0;0;3;47;1;3;2123;61;61;1;0;0;3;3;2123;0;2824;3;3;
/org.eclipse.sdk.tests-feature/plugins/org.eclipse.perfmsr.core/src/org/eclipse/perfmsr/core/DumpPluginInfo.java;2;1;4;1;4;4;4;0;16;0;0;5754;28;28;1;0;0;0;4;5754;0;6342;4;2;
/org.eclipse.jdt.ui/ui/org/eclipse/jdt/internal/ui/wizards/AbstractOpenWizardAction.java;2;1;2;1;2;2;2;0;5;0;0;5614;7;7;1;0;0;0;2;5614;0;6340;2;2;
/org.eclipse.ant.ui/Ant Editor/org/eclipse/ant/internal/ui/editor/outline/FilterTopLevelAction.java;1;0;1;1;0;0;0;1;0;0;1;4481;0;0;1;0;0;1;1;4481;0;4481;1;1;
/org.eclipse.update.ui.forms/Eclipse Forms/org/eclipse/ui/forms/editor/MultiPageKeyBindingEditorSite.java;1;0;3;1;0;0;0;3;10;1;3;3499;10;10;1;0;0;3;3;3499;0;4157;3;1;
/org.eclipse.jdt.ui/ui/org/eclipse/jdt/internal/ui/javaeditor/filebuffers/DocumentAdapter2.java;3;0;11;2;0;0;0;11;147;3;9;1581;343;343;3;2;0;11;11;1581;2;4425;9;3;
/org.eclipse.team.cvs.ui/src/org/eclipse/team/internal/ccvs/ui/operations/CVSBlockingRunnableContext.java;2;0;6;1;0;0;0;6;11;1;6;1840;25;25;1;0;0;6;6;1840;0;4216;6;2;
/org.eclipse.ui.ide/src/org/eclipse/ui/views/tasklist/MarkerUtil.java;3;0;3;1;1;1;1;2;10;1;2;2208;12;12;1;0;0;2;3;2208;0;6338;3;3;
/org.eclipse.team.webdav/src/org/eclipse/team/internal/ui/target/subscriber/TeamNonblockingRunnableContext.java;2;0;3;1;0;0;0;3;109;1;3;3494;109;109;1;0;0;3;3;3494;0;4720;3;2;
/org.eclipse.jdt.ui.tests.refactoring/resources/MoveMembers/test26/out/B.java;2;0;2;1;0;0;0;2;1;1;2;347;1;1;1;0;0;2;2;347;0;1522;2;2;
/org.eclipse.tomcat/src/org/eclipse/tomcat/internal/JdtJasperCompiler.java;1;0;1;1;0;0;0;1;0;0;1;379;0;0;1;0;0;1;1;379;0;379;1;1;
/org.eclipse.pde.ui/src/org/eclipse/pde/internal/ui/wizards/imports/UpdateBuildpathWizard.java;2;0;4;1;0;0;0;4;3;1;4;571;7;7;1;0;0;4;4;571;0;3840;4;2;
/org.eclipse.ui.workbench/Eclipse UI/org/eclipse/ui/internal/commands/registry/ICommandDefinition.java;1;0;3;1;0;0;0;3;21;1;3;1422;21;21;1;0;0;3;3;1422;0;1724;3;1;
/org.eclipse.ui.workbench/Eclipse UI/org/eclipse/ui/internal/progress/AwaitingFeedbackInfo.java;1;0;1;1;0;0;0;1;0;0;1;1854;0;0;1;0;0;1;1;1854;0;1854;1;1;
/org.eclipse.ui.workbench/Eclipse UI/org/eclipse/ui/internal/roles/api/IRoleEvent.java;1;0;2;1;0;0;0;2;0;0;1;2202;0;0;2;1;0;2;2;2202;1;2202;1;1;
/org.eclipse.pde.ui/src_Forms/org/eclipse/pde/internal/ui/model/bundle/EclipseAutoStartHeader.java;3;1;4;1;4;4;4;0;10;0;0;5425;16;16;1;0;0;0;4;5425;0;6336;4;3;
/org.eclipse.ui.ide/src/org/eclipse/ui/views/markers/internal/FieldLineNumber.java;2;0;3;1;1;1;1;2;47;1;2;2208;82;82;1;0;0;2;3;2208;0;6340;3;2;
/org.eclipse.jdt.ui/ui/org/eclipse/jdt/internal/ui/text/java/hover/AbstractAnnotationHover.java;1;1;2;1;2;2;2;0;2;0;0;5655;2;2;1;0;0;0;2;5655;0;5749;2;1;
/org.eclipse.jdt.core.tests.model/workspace/Converter/test0131/Test.java;1;0;1;1;0;0;0;1;0;0;1;3714;0;0;1;0;0;1;1;3714;0;3714;1;1;
/org.eclipse.core.tests.resources/src/org/eclipse/core/tests/resources/regression/Bug_26294.java;2;2;6;1;3;2;3;3;61;1;3;3382;136;136;2;0;1;3;6;5147;1;5685;5;2;
/org.eclipse.jdt.core.tests.model/workspace/Converter/src/test0493/A.java;1;0;1;1;0;0;0;1;0;0;1;3714;0;0;1;0;0;1;1;3714;0;3714;1;1;
/org.eclipse.core.resources/src/org/eclipse/core/internal/resources/SyncInfoReader.java;1;0;1;1;1;1;1;0;99;0;0;5146;99;99;1;0;0;0;1;5146;0;5146;1;1;
/org.eclipse.jdt.core.tests.model/workspace/Converter/src/test0327/Test.java;1;0;1;1;0;0;0;1;0;0;1;3714;0;0;1;0;0;1;1;3714;0;3714;1;1;
/org.eclipse.ui.ide/src/org/eclipse/ui/internal/model/WorkbenchFolder.java;2;0;4;1;0;0;0;4;5;1;4;1511;6;6;1;0;0;4;4;1511;0;2263;4;2;
/org.eclipse.ui.workbench/Eclipse UI/org/eclipse/ui/internal/AssociatedWindow.java;3;0;12;2;1;1;1;11;409;2;9;3511;1261;1261;2;2;0;11;12;4015;2;5594;10;3;
/org.eclipse.jdt.core.tests.model/workspace/Converter/src/test0081/Test.java;1;0;1;1;0;0;0;1;0;0;1;3714;0;0;1;0;0;1;1;3714;0;3714;1;1;
/org.eclipse.swt.tests/JUnit Tests/org/eclipse/swt/tests/junit/Test_org_eclipse_swt_widgets_Table.java;4;0;8;1;1;1;1;7;343;1;7;2123;864;864;1;0;0;7;8;2123;0;6352;8;4;
/org.eclipse.ui.examples.javaeditor/Eclipse Java Editor Example/org/eclipse/ui/examples/javaeditor/spelling/SpellReconcileDictionary.java;1;0;1;1;0;0;0;1;0;0;1;2565;0;0;1;0;0;1;1;2565;0;2565;1;1;
/org.eclipse.ui.examples.javaeditor/Eclipse Java Editor Example/org/eclipse/ui/examples/javaeditor/spelling/DefaultPhoneticHashProvider.java;1;0;1;1;0;0;0;1;0;0;1;2565;0;0;1;0;0;1;1;2565;0;2565;1;1;
/org.eclipse.swt/Eclipse SWT/win32/org/eclipse/swt/widgets/FontDialog.java;5;1;11;2;2;2;2;9;46;3;6;166;117;117;3;3;0;9;11;166;3;6352;8;5;
/org.eclipse.ui.workbench.texteditor/src/org/eclipse/ui/texteditor/TextUtilities.java;1;0;1;1;0;0;0;1;0;0;1;1589;0;0;1;0;0;1;1;1589;0;1589;1;1;
/org.eclipse.pde.junit/src/org/eclipse/pde/internal/junit/ui/RemotePluginTestRunner.java;1;0;1;1;0;0;0;1;3;0;1;1578;3;3;1;0;0;1;1;1578;0;1578;1;1;
/org.eclipse.search/search/org/eclipse/search/internal/core/text/MatchLocator.java;2;1;6;1;2;2;2;4;17;1;4;2888;43;43;1;0;0;4;6;2888;0;6340;6;2;
/org.eclipse.pde.ui/src/org/eclipse/pde/internal/ui/editor/manifest/NewDependencyWizardPage.java;2;0;6;1;0;0;0;6;5;1;6;368;16;16;1;0;0;6;6;368;0;3393;6;2;
/org.eclipse.jdt.core.tests.model/workspace/Converter/test0015/Test.java;1;0;1;1;0;0;0;1;0;0;1;3714;0;0;1;0;0;1;1;3714;0;3714;1;1;
/org.eclipse.ui.workbench/Eclipse UI/org/eclipse/ui/internal/CloseAllPerspectivesAction.java;1;0;1;1;0;0;0;1;46;0;1;2737;46;46;1;0;0;1;1;2737;0;2737;1;1;
/org.eclipse.jdt.debug.ui/ui/org/eclipse/jdt/internal/debug/ui/actions/WatchExpressionAction.java;2;0;2;1;0;0;0;2;23;1;2;1175;23;23;1;0;0;2;2;1175;0;1516;2;2;
/org.eclipse.jdt.ui/core extension/org/eclipse/text/edits/MultiTextEdit.java;1;0;3;1;0;0;0;3;22;2;2;1953;22;22;2;1;0;3;3;1985;1;1985;2;1;
/org.eclipse.swt/Eclipse SWT Mozilla/common/org/eclipse/swt/internal/mozilla/nsIWebBrowserChromeFocus.java;1;0;1;1;0;0;0;1;0;0;1;1654;0;0;1;0;0;1;1;1654;0;1654;1;1;
/org.eclipse.ui.intro/src/org/eclipse/ui/internal/intro/impl/model/viewer/IntroModelContentProvider.java;1;1;2;1;2;2;2;0;2;0;0;5115;2;2;1;0;0;0;2;5115;0;5314;2;1;
/org.eclipse.jdt.junit/src/org/eclipse/jdt/internal/junit/ui/ScrollLockAction.java;3;0;3;1;1;1;1;2;2;1;2;418;4;4;1;0;0;2;3;418;0;6340;3;3;
/org.eclipse.debug.ui/ui/org/eclipse/debug/internal/ui/console/ConsoleTerminateAction.java;1;0;2;1;0;0;0;2;0;1;2;1294;0;0;1;0;0;2;2;1294;0;1415;2;1;
/org.eclipse.jdt.ui.tests.refactoring/resources/ExtractMethodWorkSpace/ExtractMethodTests/locals_out/A_test504.java;1;0;2;1;0;0;0;2;4;1;2;130;5;5;1;0;0;2;2;130;0;844;2;1;
/org.eclipse.ui.ide/src/org/eclipse/ui/internal/ide/IMarkerImageProvider.java;1;0;1;1;0;0;0;1;0;0;1;2264;0;0;1;0;0;1;1;2264;0;2264;1;1;
/org.eclipse.core.boot/src/org/eclipse/core/internal/boot/PlatformURLBaseConnection.java;1;0;1;1;0;0;0;1;0;0;1;3013;0;0;1;0;0;1;1;3013;0;3013;1;1;
/org.eclipse.pde.ui/src/org/eclipse/pde/internal/ui/parts/ILinkLabelProvider.java;1;1;2;1;2;2;2;0;10;0;0;5431;10;10;1;0;0;0;2;5431;0;6336;2;1;
/org.eclipse.swt/Eclipse SWT PI/win32/org/eclipse/swt/internal/win32/LRESULT.java;1;0;1;1;0;0;0;1;2;0;1;2915;2;2;1;0;0;1;1;2915;0;2915;1;1;
/org.eclipse.jdt.ui.tests.refactoring/resources/MoveMembers/test41/out/A.java;1;0;1;1;0;0;0;1;0;0;1;4630;0;0;1;0;0;1;1;4630;0;4630;1;1;
/org.eclipse.jdt.core/codeassist/org/eclipse/jdt/internal/codeassist/complete/CompletionOnExceptionReference.java;2;0;2;1;0;0;0;2;16;1;2;991;18;18;1;0;0;2;2;991;0;3560;2;2;
/org.eclipse.debug.ui/ui/org/eclipse/debug/internal/ui/actions/TerminateAllAction.java;1;0;1;1;0;0;0;1;2;0;1;1276;2;2;1;0;0;1;1;1276;0;1276;1;1;
/org.eclipse.pde.ui/templates_3.0/view/java/$className$.java;2;0;5;1;0;0;0;5;3;1;5;2786;11;11;1;0;0;5;5;2786;0;4072;5;2;
/org.eclipse.jdt.ui.tests.refactoring/resources/ExtractMethodWorkSpace/ExtractMethodTests/locals_out/A_test503.java;1;0;2;1;0;0;0;2;4;1;2;130;5;5;1;0;0;2;2;130;0;844;2;1;
/org.eclipse.ui.tests/Eclipse UI Tests/org/eclipse/ui/tests/api/TitleTestEditor.java;1;1;2;1;2;2;2;0;0;0;0;5806;0;0;1;0;0;0;2;5806;0;6101;2;1;
/org.eclipse.jdt.ui/ui/org/eclipse/jdt/internal/ui/javaeditor/AnnotationType.java;1;0;1;1;0;0;0;1;0;0;1;1573;0;0;1;0;0;1;1;1573;0;1573;1;1;
/org.eclipse.jdt.ui.tests.refactoring/resources/ExtractInterface/test100/out/I.java;3;0;5;2;0;0;0;5;6;2;4;3942;11;11;2;1;0;5;5;4182;1;4306;4;3;
/org.eclipse.team.ui/src/org/eclipse/team/ui/synchronize/subscribers/IRefreshSubscriberListenerFactory.java;1;0;4;1;0;0;0;4;3;1;4;4632;4;4;1;0;0;4;4;4632;0;5043;4;1;
/org.eclipse.jdt.ui/core refactoring/org/eclipse/jdt/internal/corext/refactoring/structure/MemberMoveUtil.java;1;0;1;1;0;0;0;1;0;0;1;347;0;0;1;0;0;1;1;347;0;347;1;1;
/org.eclipse.jdt.core/compiler/org/eclipse/jdt/internal/compiler/ast/TypeDeclaration.java;4;2;23;2;4;3;4;19;251;3;15;13;675;675;3;4;1;19;23;2415;5;5871;18;4;
/org.eclipse.ui.workbench/Eclipse UI/org/eclipse/ui/internal/csm/commands/PatternBinding.java;1;0;2;1;0;0;0;2;0;1;2;2515;0;0;1;0;0;2;2;2515;0;2532;2;1;
/org.eclipse.team.webdav/src/org/eclipse/team/internal/ui/target/SiteLazyContentProvider.java;1;0;1;1;0;0;0;1;0;0;1;2495;0;0;1;0;0;1;1;2495;0;2495;1;1;
/org.eclipse.team.core/src/org/eclipse/team/core/variants/ResourceVariantByteStore.java;1;1;3;1;2;2;2;1;23;0;1;4349;30;30;1;0;0;1;3;4349;0;6125;3;1;
/org.eclipse.swt/Eclipse SWT PI/carbon/org/eclipse/swt/internal/carbon/TXNBackground.java;2;2;4;1;3;2;3;1;16;0;1;82;20;20;2;0;1;1;4;5534;1;5614;3;2;
/org.eclipse.team.cvs.ui/src/org/eclipse/team/internal/ccvs/ui/sync/UpdateSyncAction.java;1;0;1;1;0;0;0;1;0;0;1;4217;0;0;1;0;0;1;1;4217;0;4217;1;1;
/org.eclipse.ui.tests/Eclipse UI Tests/org/eclipse/ui/tests/activities/DynamicTest.java;3;1;3;1;2;2;2;1;6;0;1;4853;8;8;1;0;0;1;3;4853;0;6338;3;3;
/org.eclipse.debug.core/core/org/eclipse/debug/internal/core/stringsubstitution/IContextVariableResolver.java;1;0;2;1;0;0;0;2;0;1;2;2032;0;0;1;0;0;2;2;2032;0;2140;2;1;
/org.eclipse.swt/Eclipse SWT Printing/carbon/org/eclipse/swt/printing/PrintDialog.java;2;1;4;1;2;2;2;2;96;1;2;2764;121;121;1;0;0;2;4;2764;0;6352;4;2;
/org.eclipse.help.ui/src/org/eclipse/help/ui/internal/browser/BrowsersPreferencePage.java;1;1;12;1;3;3;3;9;299;3;7;460;425;425;3;2;0;9;12;4589;2;6337;10;1;
/org.eclipse.jdt.core.tests.model/workspace/Formatter/test130/A_out.java;1;0;1;1;0;0;0;1;0;0;1;2425;0;0;1;0;0;1;1;2425;0;2425;1;1;
/org.eclipse.team.tests.cvs.core/src/org/eclipse/team/tests/ccvs/core/provider/IsModifiedTests.java;2;0;9;1;1;1;1;8;63;2;7;276;124;124;2;1;0;8;9;2863;1;6337;8;2;
/org.eclipse.debug.ui/ui/org/eclipse/debug/ui/launchVariables/expanders/ResourceExpander.java;1;0;2;1;0;0;0;2;0;1;2;562;0;0;1;0;0;2;2;562;0;737;2;1;
/org.eclipse.update.ui.win32/src/org/eclipse/welcome/internal/WebBrowserEditor.java;1;0;2;1;0;0;0;2;0;1;2;892;0;0;1;0;0;2;2;892;0;907;2;1;
/org.eclipse.jdt.ui/core refactoring/org/eclipse/jdt/internal/corext/refactoring/participants/xml/ResourceExtender.java;1;0;4;1;1;1;1;3;16;1;3;2546;18;18;1;0;0;3;4;2546;0;5269;4;1;
/org.eclipse.ui.forms.examples/src/org/eclipse/ui/forms/examples/internal/rcp/TypeOneDetailsPage.java;1;1;7;1;2;2;2;5;16;2;4;4075;41;41;2;1;0;5;7;4284;1;6269;6;1;
/org.eclipse.pde.ui/src/org/eclipse/pde/internal/ui/launcher/WorkbenchLauncherTabGroup.java;3;1;10;1;4;4;4;6;40;1;6;1611;138;138;1;0;0;6;10;1611;0;6336;10;3;
/org.eclipse.pde.ui/src/org/eclipse/pde/internal/ui/wizards/feature/FeatureSpecPage.java;3;2;8;1;7;5;7;1;262;0;1;3840;376;376;2;0;2;1;8;5387;2;6336;6;3;
/org.eclipse.core.tests.resources/src/org/eclipse/core/tests/resources/usecase/BuilderUseCaseTest.java;1;2;3;1;3;2;3;0;298;0;0;5147;298;298;2;0;1;0;3;5147;1;5687;2;1;
/org.eclipse.jdt.core/codeassist/org/eclipse/jdt/internal/codeassist/complete/CompletionScanner.java;4;1;11;1;3;3;3;8;425;1;8;530;491;491;1;0;0;8;11;530;0;6162;11;4;
/org.eclipse.jdt.ui/ui/org/eclipse/jdt/internal/ui/preferences/formatter/CompilationUnitPreview.java;2;0;3;1;1;1;1;2;24;1;2;3809;30;30;1;0;0;2;3;3809;0;5180;3;2;
/org.eclipse.team.ui/src/org/eclipse/team/ui/synchronize/viewers/ISynchronizeModelProvider.java;1;0;4;1;0;0;0;4;67;1;4;4414;71;71;1;0;0;4;4;4414;0;4632;4;1;
/org.eclipse.jdt.core/model/org/eclipse/jdt/internal/core/jdom/DOMNode.java;2;1;4;1;2;2;2;2;10;1;2;3194;16;16;1;0;0;2;4;3194;0;5916;4;2;
/org.eclipse.ui.tests/Eclipse UI Tests/org/eclipse/ui/tests/intro/IntroTestSuite.java;1;0;2;1;1;1;1;1;1;0;1;4649;1;1;1;0;0;1;2;4649;0;5384;2;1;
/org.eclipse.jdt.core/model/org/eclipse/jdt/internal/core/util/LocalVariableTypeTableEntry.java;1;0;1;1;0;0;0;1;0;0;1;4394;0;0;1;0;0;1;1;4394;0;4394;1;1;
/org.eclipse.ui.cheatsheets/src/org/eclipse/ui/cheatsheets/CheatSheetViewerFactory.java;2;0;2;2;1;1;1;1;5;0;1;5093;9;9;1;0;0;1;2;5093;0;5107;2;2;
/org.eclipse.debug.ui/ui/org/eclipse/debug/internal/ui/launchConfigurations/LaunchConfigurationTabGroupExtension.java;4;0;6;1;1;1;1;5;45;1;5;473;115;115;1;0;0;5;6;473;0;6336;6;4;
/org.eclipse.pde/src/org/eclipse/pde/internal/builders/SchemaMarkerFactory.java;2;1;3;1;2;2;2;1;4;0;1;4203;10;10;1;0;0;1;3;4203;0;6336;3;2;
/org.eclipse.webdav/src/kernel/org/eclipse/webdav/internal/kernel/DAVException.java;1;0;2;1;2;1;2;0;5;0;0;5151;5;5;2;0;1;0;2;5151;1;5151;1;1;
/org.eclipse.team.webdav/src/org/eclipse/team/internal/target/subscriber/SyncByteConverter.java;2;0;3;1;0;0;0;3;152;1;3;3494;152;152;1;0;0;3;3;3494;0;4349;3;2;
/org.eclipse.core.runtime/src/org/eclipse/core/internal/registry/IExtensionLinker.java;4;1;7;2;2;2;2;5;40;2;4;2105;80;80;2;1;0;5;7;3164;1;5531;6;4;
/org.eclipse.jdt.core.tests.model/workspace/Converter/test0271/Test.java;1;0;1;1;0;0;0;1;0;0;1;3714;0;0;1;0;0;1;1;3714;0;3714;1;1;
/org.eclipse.pde/src/org/eclipse/pde/internal/builders/ManifestConsistencyChecker.java;3;1;16;1;8;8;8;8;472;2;7;910;930;930;2;1;0;8;16;3351;1;6336;15;3;
/org.eclipse.team.ui/src/org/eclipse/team/internal/ui/sync/actions/SyncViewerAction.java;1;0;4;1;0;0;0;4;37;1;4;488;39;39;1;0;0;4;4;488;0;2632;4;1;
/org.eclipse.jdt.junit/src/org/eclipse/jdt/junit/JUnitCore.java;2;1;4;1;3;3;3;1;11;0;1;1637;17;17;1;0;0;1;4;1637;0;6340;4;2;
/org.eclipse.ui.cheatsheets/src/org/eclipse/ui/internal/cheatsheets/views/CheatSheetExpandRestoreAction.java;2;0;3;1;0;0;0;3;26;1;3;4428;43;43;1;0;0;3;3;4428;0;5093;3;2;
/org.eclipse.swt/Eclipse SWT/gtk/org/eclipse/swt/widgets/ToolBar.java;7;2;22;2;6;5;6;16;68;2;14;45;237;237;2;2;1;16;22;57;3;6352;19;7;
/org.eclipse.jdt.debug.ui/ui/org/eclipse/jdt/internal/debug/ui/launcher/SelectDefaultSystemLibraryQuickFix.java;3;1;4;1;2;2;2;2;6;1;2;307;17;17;1;0;0;2;4;307;0;6336;4;3;
/org.eclipse.jdt.core.tests.model/workspace/Formatter/test495/A_in.java;1;0;1;1;1;1;1;0;0;0;0;5381;0;0;1;0;0;0;1;5381;0;5381;1;1;
/org.eclipse.team.tests.cvs.core/src/org/eclipse/team/tests/ccvs/ui/old/LogEntry.java;1;0;2;1;0;0;0;2;0;1;2;2632;0;0;1;0;0;2;2;2632;0;4216;2;1;
/org.eclipse.ui.cheatsheets/src/org/eclipse/ui/internal/cheatsheets/views/ErrorPage.java;1;1;5;1;2;2;2;3;59;2;2;4701;110;110;2;1;0;3;5;4701;1;5722;4;1;
/org.eclipse.ui.ide/extensions/org/eclipse/ui/part/ResourceTransfer.java;1;0;1;1;0;0;0;1;0;0;1;2263;0;0;1;0;0;1;1;2263;0;2263;1;1;
/org.eclipse.swt/Eclipse SWT/win32/org/eclipse/swt/widgets/ColorDialog.java;3;0;6;1;1;1;1;5;15;1;5;268;27;27;1;0;0;5;6;268;0;6352;6;3;
/org.eclipse.ltk.ui.refactoring/src/org/eclipse/ltk/ui/refactoring/RefactoringWizardPage.java;1;1;6;1;4;4;4;2;31;1;2;4965;53;53;1;0;0;2;6;4965;0;6340;6;1;
/org.eclipse.jdt.debug.ui/ui/org/eclipse/jdt/internal/debug/ui/EvaluationContextStatusHandler.java;2;0;2;1;0;0;0;2;3;1;2;2648;3;3;1;0;0;2;2;2648;0;2997;2;2;
/org.eclipse.jdt.core.tests.model/workspace/Formatter/test285/A_in.java;1;0;1;1;0;0;0;1;0;0;1;2443;0;0;1;0;0;1;1;2443;0;2443;1;1;
/org.eclipse.webdav/src/client/org/eclipse/webdav/http/client/IRequestBodyWriter.java;1;0;2;1;2;1;2;0;22;0;0;5151;22;22;2;0;1;0;2;5151;1;5151;1;1;
/org.eclipse.compare/compare/org/eclipse/compare/IEditableContent.java;1;0;1;1;0;0;0;1;2;0;1;3935;2;2;1;0;0;1;1;3935;0;3935;1;1;
/org.eclipse.swt/Eclipse SWT/carbon/org/eclipse/swt/widgets/Tree.java;5;2;32;2;11;10;11;21;844;2;18;231;1250;1250;2;3;1;21;32;231;4;6352;28;5;
/org.eclipse.jdt.ui.tests.refactoring/resources/ExtractTemp/canExtract/A_test68_in.java;1;0;1;1;0;0;0;1;0;0;1;1309;0;0;1;0;0;1;1;1309;0;1309;1;1;
/org.eclipse.jdt.ui/ui/org/eclipse/jdt/internal/ui/javaeditor/SemanticHighlightings.java;3;3;11;1;11;9;11;0;329;0;0;5272;664;664;3;0;2;0;11;5524;2;6339;9;3;
/org.eclipse.jdt.core.tests.model/workspace/Converter/src/test0451/A.java;1;0;1;1;0;0;0;1;0;0;1;3714;0;0;1;0;0;1;1;3714;0;3714;1;1;
/org.eclipse.ltk.core.refactoring/src/org/eclipse/ltk/core/refactoring/IRefactoringCoreStatusCodes.java;1;1;5;1;3;3;3;2;6;1;2;4845;14;14;1;0;0;2;5;4845;0;5184;5;1;
/org.eclipse.jdt.core.tests.model/workspace/Converter/src/junit/awtui/TestRunner.java;1;0;1;1;0;0;0;1;0;0;1;3714;0;0;1;0;0;1;1;3714;0;3714;1;1;
/org.eclipse.swt/Eclipse SWT/win32/org/eclipse/swt/widgets/Table.java;7;2;71;3;13;11;13;58;468;4;46;34;2715;2715;4;12;2;58;71;4366;14;6352;57;7;
/org.eclipse.ant.ui/Remote Ant Support/org/eclipse/ant/internal/ui/antsupport/InputHandlerSetter.java;1;0;1;1;0;0;0;1;0;0;1;1811;0;0;1;0;0;1;1;1811;0;1811;1;1;
/org.eclipse.core.runtime.osgi/src/org/eclipse/core/internal/jobs/DeadlockDetector.java;1;0;2;1;0;0;0;2;3;1;2;3013;3;3;1;0;0;2;2;3013;0;3028;2;1;
/org.eclipse.ui.workbench/Eclipse UI/org/eclipse/ui/roles/CategoryManagerFactory.java;1;0;2;1;0;0;0;2;0;0;1;2864;0;0;2;1;0;2;2;2864;1;2864;1;1;
/org.eclipse.jdt.core/compiler/org/eclipse/jdt/internal/compiler/ast/Initializer.java;3;0;8;1;0;0;0;8;29;1;8;62;60;60;1;0;0;8;8;62;0;3560;8;3;
/org.eclipse.jdt.core/compiler/org/eclipse/jdt/internal/compiler/classfmt/FieldInfo.java;4;0;6;1;0;0;0;6;22;1;6;25;39;39;1;0;0;6;6;25;0;3560;6;4;
/org.eclipse.pde.core/src/org/eclipse/pde/internal/core/PlatformConfiguration.java;2;1;5;1;2;2;2;3;4;1;3;4058;11;11;1;0;0;3;5;4058;0;6336;5;2;
/org.eclipse.team.cvs.ui/src/org/eclipse/team/internal/ccvs/ui/sync/IgnoreAction.java;2;0;2;1;0;0;0;2;2;1;2;866;2;2;1;0;0;2;2;866;0;4217;2;2;
/org.eclipse.jdt.ui.tests.refactoring/resources/ExtractMethodWorkSpace/ExtractMethodTests/semicolon_out/A_test403.java;1;0;1;1;0;0;0;1;1;0;1;130;1;1;1;0;0;1;1;130;0;130;1;1;
/org.eclipse.jdt.ui/core refactoring/org/eclipse/jdt/internal/corext/refactoring/structure/ASTRewriteManager.java;1;0;1;1;0;0;0;1;0;0;1;344;0;0;1;0;0;1;1;344;0;344;1;1;
/org.eclipse.jdt.core/model/org/eclipse/jdt/internal/core/INamingRequestor.java;1;0;1;1;0;0;0;1;2;0;1;3557;2;2;1;0;0;1;1;3557;0;3557;1;1;
/org.eclipse.jface.text/src/org/eclipse/jface/text/reconciler/Reconciler.java;3;2;5;1;3;2;3;2;72;1;2;1511;95;95;2;0;1;2;5;6353;1;6353;4;3;
/org.eclipse.pde.ui/src/org/eclipse/pde/internal/ui/editor/site/FeaturePropertiesDialog.java;2;1;3;1;2;2;2;1;25;0;1;3721;35;35;1;0;0;1;3;3721;0;6336;3;2;
/org.eclipse.jdt.ui.tests.refactoring/resources/ExtractMethodWorkSpace/ExtractMethodTests/locals_in/A_test553.java;1;0;1;1;0;0;0;1;2;0;1;844;2;2;1;0;0;1;1;844;0;844;1;1;
/org.eclipse.jdt.ui/ui/org/eclipse/jdt/ui/text/JavaTextTools.java;4;2;10;1;5;4;5;5;42;1;5;1336;192;192;2;0;1;5;10;6322;1;6322;9;4;
/org.eclipse.jdt.ui.examples.javafamily/src/org/eclipse/text/reconcilerpipe/TextModelAdapter.java;1;0;2;1;0;0;0;2;0;1;2;1071;0;0;1;0;0;2;2;1071;0;1629;2;1;
/org.eclipse.jdt.ui.tests.refactoring/test cases/org/eclipse/jdt/ui/tests/nls/NLSScannerTester.java;2;0;2;1;1;1;1;1;106;0;1;4930;108;108;1;0;0;1;2;4930;0;6340;2;2;
/org.eclipse.swt/Eclipse SWT PI/win32/org/eclipse/swt/internal/win32/NMLISTVIEW.java;1;0;1;1;0;0;0;1;2;0;1;2915;2;2;1;0;0;1;1;2915;0;2915;1;1;
/org.eclipse.jdt.ui/core refactoring/org/eclipse/jdt/internal/corext/refactoring/changes/CompilationUnitChange.java;4;1;13;1;4;4;4;9;45;1;9;1033;128;128;1;0;0;9;13;1033;0;6340;13;4;
/org.eclipse.update.ui/srcnew/org/eclipse/update/internal/ui/wizards/UIProblemHandler.java;2;0;2;1;0;0;0;2;0;1;2;755;0;0;1;0;0;2;2;755;0;825;2;2;
/org.eclipse.pde.ui/src/org/eclipse/pde/internal/ui/wizards/templates/PreferencePageTemplate.java;3;2;8;1;4;3;4;4;44;1;4;2184;89;89;2;0;1;4;8;5208;1;6336;7;3;
/org.eclipse.jdt.ui.tests.refactoring/resources/UseSupertypeWherePossible/test64/out/A.java;1;0;1;1;0;0;0;1;2;0;1;1166;2;2;1;0;0;1;1;1166;0;1166;1;1;
/org.eclipse.jdt.core.tests.model/workspace/Formatter/test272/A_in.java;1;0;1;1;0;0;0;1;0;0;1;2442;0;0;1;0;0;1;1;2442;0;2442;1;1;
/org.eclipse.help.webapp/src_servlets/org/eclipse/help/internal/webapp/servlet/EclipseConnector.java;2;1;14;1;3;3;3;11;52;2;9;644;207;207;2;2;0;11;14;644;2;6337;12;2;
/org.eclipse.jdt.ui/ui/org/eclipse/jdt/internal/ui/callhierarchy/LocationViewer.java;3;0;5;1;1;1;1;4;11;1;4;387;17;17;1;0;0;4;5;387;0;6340;5;3;
/org.eclipse.jdt.ui.tests.refactoring/resources/ChangeTypeRefactoring/negative/A_testFieldOfLocalType_out.java;1;0;1;1;0;0;0;1;0;0;1;3304;0;0;1;0;0;1;1;3304;0;3304;1;1;
/org.eclipse.jdt.core.tests.model/workspace/Formatter/test165/A_in.java;1;0;1;1;0;0;0;1;0;0;1;2425;0;0;1;0;0;1;1;2425;0;2425;1;1;
/org.eclipse.pde.core/src/org/eclipse/pde/internal/core/ibundle/IManifestHeader.java;1;1;2;1;2;2;2;0;4;0;0;5445;4;4;1;0;0;0;2;5445;0;6336;2;1;
/org.eclipse.jdt.ui/ui/org/eclipse/jdt/internal/ui/browsing/ProjectsView.java;1;0;2;1;1;1;1;1;17;0;1;644;19;19;1;0;0;1;2;644;0;6340;2;1;
/org.eclipse.ltk.core.refactoring/src/org/eclipse/ltk/core/refactoring/participants/ISharableParticipant.java;1;1;6;1;4;4;4;2;28;1;2;4845;42;42;1;0;0;2;6;4845;0;6340;6;1;
/org.eclipse.jdt.core.tests.model/workspace/JavaSearch/src/j7/qua/li/fied/Bug54962a.java;1;0;1;1;1;1;1;0;0;0;0;5912;0;0;1;0;0;0;1;5912;0;5912;1;1;
/org.eclipse.team.tests.cvs.core/src/org/eclipse/team/tests/ccvs/ui/benchmark/SyncTests.java;1;0;2;1;0;0;0;2;7;1;2;1417;7;7;1;0;0;2;2;1417;0;2632;2;1;
/org.eclipse.jdt.core.tests.model/workspace/Converter/src/test0400/A.java;1;0;1;1;0;0;0;1;0;0;1;3714;0;0;1;0;0;1;1;3714;0;3714;1;1;
/org.eclipse.jdt.ui.tests.refactoring/resources/RenameVirtualMethodInClass/test38/out/A.java;1;0;1;1;1;1;1;0;0;0;0;5453;0;0;1;0;0;0;1;5453;0;5453;1;1;
/org.eclipse.team.cvs.ui/src/org/eclipse/team/internal/ccvs/ui/subscriber/RefreshDirtyStateOperation.java;1;1;5;1;5;5;5;0;63;0;0;5345;92;92;1;0;0;0;5;5345;0;6206;5;1;
/org.eclipse.jdt.core.tests.model/workspace/Converter/src/javadoc/testBug50898/TestA.java;1;0;2;1;0;0;0;2;0;1;2;3890;0;0;1;0;0;2;2;3890;0;3899;2;1;
/org.eclipse.help.ui.win32/src/org/eclipse/help/ui/internal/browser/win32/IEResources.java;1;0;4;1;0;0;0;4;13;1;4;105;17;17;1;0;0;4;4;105;0;2898;4;1;
/org.eclipse.jdt.ui.tests.refactoring/resources/IntroduceFactory/positive/instanceContext_FFF.java;1;0;2;1;0;0;0;2;0;1;2;2846;0;0;1;0;0;2;2;2846;0;2862;2;1;
/org.eclipse.ui.workbench/Eclipse UI/org/eclipse/ui/IFileEditorInput.java;2;0;2;1;0;0;0;2;8;1;2;826;8;8;1;0;0;2;2;826;0;2737;2;2;
/org.eclipse.ui.workbench/Eclipse UI/org/eclipse/ui/internal/ide/WorkbenchConfigurationInfo.java;1;0;1;1;0;0;0;1;0;0;1;1259;0;0;1;0;0;1;1;1259;0;1259;1;1;
/org.eclipse.update.core/srcnew/org/eclipse/update/search/IUpdateSearchResultCollector.java;2;0;2;1;0;0;0;2;0;1;2;574;0;0;1;0;0;2;2;574;0;825;2;2;
/org.eclipse.team.core/src/org/eclipse/team/internal/core/target/SynchronizedTargetProvider.java;1;0;2;1;0;0;0;2;6;1;2;866;6;6;1;0;0;2;2;866;0;2495;2;1;
/org.eclipse.jdt.ui.tests/ui/org/eclipse/jdt/ui/tests/astrewrite/ASTRewritingTypeDeclTest.java;2;0;16;1;1;1;1;15;192;2;13;823;911;911;2;2;0;15;16;823;2;5406;14;2;
/org.eclipse.update.core/srcnew/org/eclipse/update/internal/operations/DuplicateConflictsValidator.java;2;0;7;1;0;0;0;7;11;1;7;367;22;22;1;0;0;7;7;367;0;825;7;2;
/org.eclipse.pde.ui/src_Forms/org/eclipse/pde/internal/ui/neweditor/feature/SynchronizeVersionsWizardPage.java;2;0;2;1;1;1;1;1;0;0;1;4926;0;0;1;0;0;1;2;4926;0;5431;2;2;
/org.eclipse.jdt.ui/ui/org/eclipse/jdt/ui/actions/FindOccurrencesInFileAction.java;2;0;4;1;1;1;1;3;8;1;3;592;17;17;1;0;0;3;4;592;0;6340;4;2;
/org.eclipse.ui.workbench/Eclipse UI/org/eclipse/ui/contexts/activationservice/IContextActivationService.java;1;0;2;1;0;0;0;2;0;1;2;3066;0;0;1;0;0;2;2;3066;0;3109;2;1;
/org.eclipse.core.runtime.compatibility/src-runtime/org/eclipse/core/internal/plugins/PluginDescriptor.java;5;3;40;2;14;10;14;26;289;2;20;3013;1240;1240;3;6;4;26;40;5134;10;5916;30;5;
/org.eclipse.team.core/src/org/eclipse/team/core/subscribers/trees/TreeTeamSubscriber.java;1;0;1;1;0;0;0;1;0;0;1;1427;0;0;1;0;0;1;1;1427;0;1427;1;1;
/org.eclipse.jdt.ui/ui refactoring/org/eclipse/jdt/internal/ui/refactoring/nls/search/NLSSearchResultCollector.java;5;1;8;1;2;2;2;6;21;1;6;1309;42;42;1;0;0;6;8;1309;0;6340;8;5;
/org.eclipse.team.ui/src/org/eclipse/team/ui/synchronize/ISynchronizeParticipant.java;2;1;11;1;5;5;5;6;120;1;6;2535;430;430;1;0;0;6;11;2535;0;6337;11;2;
/org.eclipse.team.ui/src/org/eclipse/team/ui/synchronize/viewers/SynchronizeModelOperation.java;1;0;2;1;0;0;0;2;0;1;2;4588;0;0;1;0;0;2;2;4588;0;4632;2;1;
/org.eclipse.update.ui/src/org/eclipse/update/internal/ui/forms/DetailsHistoryItem.java;1;0;1;1;0;0;0;1;0;0;1;755;0;0;1;0;0;1;1;755;0;755;1;1;
/org.eclipse.ui.workbench/Eclipse UI/org/eclipse/ui/internal/csm/commands/KeySequenceBinding.java;1;0;4;1;0;0;0;4;22;2;3;2532;30;30;2;1;0;4;4;2532;1;2562;3;1;
/org.eclipse.jdt.ui/core extension/org/eclipse/jdt/internal/corext/dom/ASTRewriteAnalyzer.java;2;0;56;1;1;1;1;55;809;4;47;85;6622;6622;4;8;0;55;56;1803;8;5406;48;2;
/org.eclipse.ui.tests/Eclipse UI Tests/org/eclipse/ui/tests/preferences/PreferencesTestSuite.java;1;0;1;1;0;0;0;1;0;0;1;2754;0;0;1;0;0;1;1;2754;0;2754;1;1;
/org.eclipse.pde.ui/src/org/eclipse/pde/internal/ui/wizards/templates/EditorNewWizard.java;3;1;6;1;4;4;4;2;12;1;2;3986;31;31;1;0;0;2;6;3986;0;6336;6;3;
/org.eclipse.jdt.debug.ui/ui/org/eclipse/jdt/internal/debug/ui/LocalFileStorageEditorInput.java;2;0;2;1;1;1;1;1;7;0;1;5081;11;11;1;0;0;1;2;5081;0;5316;2;2;
/org.eclipse.jdt.ui/ui/org/eclipse/jdt/internal/ui/search/OccurrencesSearchContentProvider.java;1;0;2;1;0;0;0;2;0;1;2;4888;0;0;1;0;0;2;2;4888;0;4943;2;1;
/org.eclipse.pde.runtime/src/org/eclipse/pde/internal/runtime/logview/LineReader.java;1;0;1;1;0;0;0;1;0;0;1;831;0;0;1;0;0;1;1;831;0;831;1;1;
/org.eclipse.jdt.ui.tests.refactoring/resources/MoveMembers/test38/out/A.java;1;0;1;1;0;0;0;1;0;0;1;2093;0;0;1;0;0;1;1;2093;0;2093;1;1;
/org.eclipse.ui.ide/src/org/eclipse/ui/actions/CopyProjectAction.java;2;0;4;1;0;0;0;4;21;1;4;1511;23;23;1;0;0;4;4;1511;0;2263;4;2;
/org.eclipse.ui.workbench/Eclipse UI/org/eclipse/ui/INavigationLocationProvider.java;2;1;2;1;2;2;2;0;2;0;0;5510;4;4;1;0;0;0;2;5510;0;6338;2;2;
/org.eclipse.ui.workbench/Eclipse UI/org/eclipse/ui/internal/registry/PerspectiveRegistryReader.java;4;0;5;1;1;1;1;4;8;1;4;1034;22;22;1;0;0;4;5;1034;0;6338;5;4;
/org.eclipse.jdt.ui.tests.refactoring/resources/ExtractMethodWorkSpace/ExtractMethodTests/locals_out/A_test511.java;1;0;2;1;0;0;0;2;4;1;2;130;5;5;1;0;0;2;2;130;0;844;2;1;
/org.eclipse.jdt.ui.tests.refactoring/resources/InlineMethodWorkspace/TestCases/cast_out/TestHierarchyOverloaded.java;1;0;1;1;0;0;0;1;0;0;1;955;0;0;1;0;0;1;1;955;0;955;1;1;
/org.eclipse.ui.workbench/Eclipse UI/org/eclipse/ui/internal/dialogs/FakeViewActionSet.java;1;0;1;1;0;0;0;1;0;0;1;830;0;0;1;0;0;1;1;830;0;830;1;1;
/org.eclipse.update.ui/src/org/eclipse/update/internal/ui/wizards/RevertConfigurationWizardPage.java;3;1;15;2;2;2;2;13;108;2;11;825;264;264;2;2;0;13;15;1219;2;6336;13;3;
/org.eclipse.ui.externaltools/External Tools Base/org/eclipse/ui/externaltools/internal/variables/VariableMessages.java;1;0;1;1;0;0;0;1;0;0;1;4975;0;0;1;0;0;1;1;4975;0;4975;1;1;
/org.eclipse.jdt.ui.tests.refactoring/resources/Delete/testDeleteWithinCu23/in/A.java;1;0;1;1;0;0;0;1;0;0;1;5058;0;0;1;0;0;1;1;5058;0;5058;1;1;
/org.eclipse.jdt.ui/ui/org/eclipse/jdt/internal/ui/compare/CompareMessages.java;1;0;1;1;1;1;1;0;2;0;0;6340;2;2;1;0;0;0;1;6340;0;6340;1;1;
/org.eclipse.jdt.ui.tests.refactoring/resources/ConvertAnonymousToNested/canConvert/A_test21_in.java;1;0;1;1;0;0;0;1;0;0;1;3195;0;0;1;0;0;1;1;3195;0;3195;1;1;
/org.eclipse.ui.tests/Eclipse UI Tests/org/eclipse/ui/tests/propertysheet/ComboBoxPropertyDescriptorTest.java;1;0;1;1;0;0;0;1;0;0;1;3013;0;0;1;0;0;1;1;3013;0;3013;1;1;
/org.eclipse.team.ui/src/org/eclipse/team/ui/synchronize/subscriber/IRefreshSubscriberListener.java;1;0;4;1;0;0;0;4;29;1;4;4319;45;45;1;0;0;4;4;4319;0;4632;4;1;
/org.eclipse.team.ftp/src/org/eclipse/team/internal/ftp/ui/ContainerContentProvider.java;1;0;1;1;0;0;0;1;0;0;1;3240;0;0;1;0;0;1;1;3240;0;3240;1;1;
/org.eclipse.update.ui.forms/Eclipse Forms/org/eclipse/ui/forms/parts/SectionChangeManager.java;1;0;2;1;0;0;0;2;0;1;2;3096;0;0;1;0;0;2;2;3096;0;3138;2;1;
/org.eclipse.help/src/org/eclipse/help/IHelpContentProducer.java;1;1;5;1;2;2;2;3;57;1;3;1010;68;68;1;0;0;3;5;1010;0;6337;5;1;
/org.eclipse.jdt.ui.tests.refactoring/resources/Delete/testDeleteWithinCu5/out/A.java;1;0;1;1;0;0;0;1;0;0;1;442;0;0;1;0;0;1;1;442;0;442;1;1;
/org.eclipse.pde.ui/src/org/eclipse/pde/internal/ui/editor/schema/AttributePropertySource.java;2;1;4;1;4;4;4;0;50;0;0;5781;68;68;1;0;0;0;4;5781;0;6336;4;2;
/org.eclipse.jdt.core.tests.model/workspace/Converter/src/p1/A.java;1;0;1;1;0;0;0;1;0;0;1;3714;0;0;1;0;0;1;1;3714;0;3714;1;1;
/org.eclipse.jdt.ui.tests.refactoring/resources/MoveMembers/test26/in/B.java;1;0;1;1;0;0;0;1;0;0;1;347;0;0;1;0;0;1;1;347;0;347;1;1;
/org.eclipse.jdt.ui/ui/org/eclipse/jdt/internal/ui/browsing/JavaBrowsingMessages.java;1;0;1;1;1;1;1;0;2;0;0;6340;2;2;1;0;0;0;1;6340;0;6340;1;1;
/org.eclipse.ant.tests.ui/test support/org/eclipse/ant/tests/ui/support/tasks/NestElementTask.java;1;0;1;1;1;1;1;0;0;0;0;5741;0;0;1;0;0;0;1;5741;0;5741;1;1;
/org.eclipse.pde.ui/src/org/eclipse/pde/internal/ui/editor/schema/SchemaFormPage.java;2;2;4;1;4;3;4;0;111;0;0;5431;121;121;2;0;1;0;4;5431;1;6336;3;2;
/org.eclipse.pde.core/src/org/eclipse/pde/internal/core/feature/FeatureInfo.java;2;1;3;1;2;2;2;1;16;0;1;4203;33;33;1;0;0;1;3;4203;0;6336;3;2;
/org.eclipse.ant.ui/Ant Tools Support/org/eclipse/ant/internal/ui/launchConfigurations/TaskLinkManager.java;1;0;3;1;1;1;1;2;8;1;2;1811;12;12;1;0;0;2;3;1811;0;6336;3;1;
/org.eclipse.ui.workbench/Eclipse UI/org/eclipse/ui/keys/GestureKey.java;1;0;4;1;0;0;0;4;24;1;4;1341;35;35;1;0;0;4;4;1341;0;2202;4;1;
/org.eclipse.jdt.ui/ui/org/eclipse/jdt/internal/ui/dialogs/ISourceActionContentProvider.java;1;0;2;1;0;0;0;2;0;1;2;861;0;0;1;0;0;2;2;861;0;916;2;1;
/org.eclipse.core.resources/src/org/eclipse/core/internal/resources/Folder.java;3;1;11;1;3;3;3;8;283;1;8;178;337;337;1;0;0;8;11;178;0;6149;11;3;
/org.eclipse.jdt.ui.tests.refactoring/resources/DeleteSourceReference/test9/out/A.java;1;0;1;1;0;0;0;1;0;0;1;1652;0;0;1;0;0;1;1;1652;0;1652;1;1;
/org.eclipse.search/new search/org/eclipse/search2/internal/ui/text/EditorAnnotationManager.java;1;1;2;1;2;2;2;0;4;0;0;6035;4;4;1;0;0;0;2;6035;0;6074;2;1;
/org.eclipse.jdt.ui/core extension/org/eclipse/jdt/internal/corext/codemanipulation/CodeBlockEdit.java;1;0;1;1;0;0;0;1;0;0;1;155;0;0;1;0;0;1;1;155;0;155;1;1;
/org.eclipse.team.webdav/src/org/eclipse/team/internal/webdav/ui/subscriber/WebDavPutAction.java;2;2;7;1;3;2;3;4;36;1;4;3499;61;61;2;0;1;4;7;5508;1;6337;6;2;
/org.eclipse.jdt.core.tests.model/workspace/Completion/src3/test0002/Test.java;1;0;1;1;0;0;0;1;0;0;1;5010;0;0;1;0;0;1;1;5010;0;5010;1;1;
/org.eclipse.jdt.ui/ui/org/eclipse/jdt/internal/ui/util/MainMethodSearchEngine.java;2;1;3;1;3;3;3;0;52;0;0;5375;56;56;1;0;0;0;3;5375;0;6340;3;2;
/org.eclipse.jdt.core/compiler/org/eclipse/jdt/internal/compiler/classfmt/ClassFormatException.java;2;0;4;1;1;1;1;3;140;1;3;173;152;152;1;0;0;3;4;173;0;5131;4;2;
/org.eclipse.jdt.core/model/org/eclipse/jdt/internal/core/JavaModelOperation.java;3;0;15;1;0;0;0;15;122;2;14;107;302;302;2;1;0;15;15;2003;1;3708;14;3;
/org.eclipse.jdt.core.tests.model/workspace/Formatter/test279/A_in.java;1;0;1;1;0;0;0;1;0;0;1;2443;0;0;1;0;0;1;1;2443;0;2443;1;1;
/org.eclipse.debug.ui/ui/org/eclipse/debug/ui/launchVariables/DefaultVariableExpander.java;1;0;2;1;0;0;0;2;0;1;2;550;0;0;1;0;0;2;2;550;0;562;2;1;
/org.eclipse.update.ui.forms/Eclipse Forms/org/eclipse/ui/forms/IDetailsPage.java;1;0;2;1;0;0;0;2;0;1;2;3733;0;0;1;0;0;2;2;3733;0;4157;2;1;
/org.eclipse.team.ui/src/org/eclipse/team/internal/ui/wizards/ProjectSetExportWizard.java;2;1;7;1;4;4;4;3;202;2;2;987;277;277;2;1;0;3;7;987;1;6337;6;2;
/org.eclipse.jdt.ui.tests.refactoring/resources/ExtractMethodWorkSpace/ExtractMethodTests/locals_in/A_test521.java;1;0;1;1;0;0;0;1;4;0;1;844;4;4;1;0;0;1;1;844;0;844;1;1;
/org.eclipse.help.base/src/org/eclipse/help/internal/base/HelpBasePreferenceInitializer.java;1;1;4;1;4;4;4;0;12;0;0;5531;28;28;1;0;0;0;4;5531;0;6337;4;1;
/org.eclipse.team.cvs.core/src/org/eclipse/team/internal/ccvs/core/connection/CVSRepositoryLocation.java;2;2;29;1;10;9;10;19;1373;1;19;866;2125;2125;2;0;1;19;29;5270;1;6337;28;2;
/org.eclipse.swt.opengl/win32/org/eclipse/swt/opengl/GLContext.java;1;0;1;1;0;0;0;1;0;0;1;1175;0;0;1;0;0;1;1;1175;0;1175;1;1;
/org.eclipse.debug.core/core/org/eclipse/debug/core/sourcelookup/IPersistableSourceLocator2.java;1;0;2;1;1;1;1;1;4;0;1;4949;4;4;1;0;0;1;2;4949;0;5109;2;1;
/org.eclipse.team.ui/src/org/eclipse/team/internal/ui/dialogs/PromptingDialog.java;1;0;2;1;0;0;0;2;126;0;1;987;126;126;2;1;0;2;2;987;1;987;1;1;
/org.eclipse.ui.workbench/Eclipse UI/org/eclipse/ui/internal/commands/api/IImageBindingDefinition.java;1;0;4;1;0;0;0;4;0;2;3;1724;0;0;2;1;0;4;4;2515;1;2532;3;1;
/org.eclipse.jdt.ui/ui/org/eclipse/jdt/internal/ui/callhierarchy/SearchScopeHierarchyAction.java;2;1;4;1;3;3;3;1;13;0;1;4047;17;17;1;0;0;1;4;4047;0;6340;4;2;
/org.eclipse.core.tests.runtime/src/org/eclipse/core/tests/internal/plugins/FragmentResolveTest_7.java;1;0;1;1;0;0;0;1;0;0;1;3014;0;0;1;0;0;1;1;3014;0;3014;1;1;
/org.eclipse.swt.opengl.examples/src/org/eclipse/swt/opengl/examples/OpenGLExample.java;1;0;1;1;0;0;0;1;0;0;1;1175;0;0;1;0;0;1;1;1175;0;1175;1;1;
/org.eclipse.ui.ide/extensions/org/eclipse/ui/dialogs/WizardNewFolderMainPage.java;3;1;3;1;2;2;2;1;18;0;1;2263;20;20;1;0;0;1;3;2263;0;6338;3;3;
/org.eclipse.ui.workbench/Eclipse UI/org/eclipse/ui/commands/internal/PreferenceRegistry.java;1;0;2;1;0;0;0;2;0;1;2;786;0;0;1;0;0;2;2;786;0;956;2;1;
/org.eclipse.jdt.ui.tests.refactoring/resources/ExtractMethodWorkSpace/ExtractMethodTests/locals_out/A_test512.java;1;0;2;1;0;0;0;2;6;1;2;130;7;7;1;0;0;2;2;130;0;844;2;1;
/org.eclipse.ant.ui/Ant Tools Support/org/eclipse/ant/internal/ui/preferences/AntClasspathPage.java;1;0;12;1;1;1;1;11;40;3;9;1811;100;100;3;2;0;11;12;2569;2;6336;10;1;
/org.eclipse.jdt.core/dom/org/eclipse/jdt/core/dom/SuperFieldAccess.java;5;1;10;1;2;2;2;8;102;1;8;72;155;155;1;0;0;8;10;72;0;5272;10;5;
/org.eclipse.update.ui.forms/src/org/eclipse/ui/forms/parts/RichText.java;1;0;6;1;0;0;0;6;129;2;5;2898;197;197;2;1;0;6;6;3095;1;3095;5;1;
/org.eclipse.jdt.ui/ui/org/eclipse/jdt/internal/ui/browsing/ProjectAndSourceFolderContentProvider.java;1;0;3;1;1;1;1;2;9;1;2;227;13;13;1;0;0;2;3;227;0;6340;3;1;
/org.eclipse.jdt.core.tests.model/workspace/Converter/src/test0263/Test.java;1;0;1;1;0;0;0;1;0;0;1;3714;0;0;1;0;0;1;1;3714;0;3714;1;1;
/org.eclipse.debug.ui/ui/org/eclipse/debug/internal/ui/console/ProcessConsole.java;1;0;3;1;0;0;0;3;109;1;3;1294;109;109;1;0;0;3;3;1294;0;1415;3;1;
/org.eclipse.team.core/src/org/eclipse/team/internal/core/streams/PollingInputStream.java;2;1;4;1;2;2;2;2;34;1;2;866;44;44;1;0;0;2;4;866;0;6336;4;2;
/org.eclipse.jdt.core/model/org/eclipse/jdt/internal/core/hierarchy/RegionBasedTypeHierarchy.java;2;0;9;1;0;0;0;9;34;1;9;61;92;92;1;0;0;9;9;61;0;3509;9;2;
/org.eclipse.sdk.tests-feature/plugins/org.eclipse.perfmsr.ui.client/src/org/eclipse/perfmsr/ui/client/RunsTableTreeCollapseAllAction.java;1;1;2;1;2;2;2;0;10;0;0;5443;10;10;1;0;0;0;2;5443;0;5513;2;1;
/org.eclipse.ant.ui/Ant Tools Support/org/eclipse/ant/internal/ui/preferences/TabFolderLayout.java;1;0;1;1;0;0;0;1;0;0;1;1811;0;0;1;0;0;1;1;1811;0;1811;1;1;
/org.eclipse.jdt.ui/ui/org/eclipse/jdt/internal/ui/dnd/DelegatingDragAdapter.java;1;0;1;1;1;1;1;0;2;0;0;6340;2;2;1;0;0;0;1;6340;0;6340;1;1;
/org.eclipse.core.runtime.osgi/src/org/eclipse/core/runtime/jobs/ProgressProvider.java;1;0;1;1;0;0;0;1;0;0;1;3013;0;0;1;0;0;1;1;3013;0;3013;1;1;
/org.eclipse.team.tests.cvs.core/src/org/eclipse/team/tests/ccvs/ui/old/Util.java;1;0;2;1;0;0;0;2;0;1;2;2632;0;0;1;0;0;2;2;2632;0;4216;2;1;
/org.eclipse.update.core/src/org/eclipse/update/configuration/IInstallDeltaHandler.java;1;1;4;1;4;4;4;0;4;0;0;5388;8;8;1;0;0;0;4;5388;0;6336;4;1;
/org.eclipse.jdt.core/search/org/eclipse/jdt/core/search/MethodDeclarationMatch.java;2;1;7;1;3;3;3;4;23;1;4;3913;59;59;1;0;0;4;7;3913;0;5242;7;2;
/org.eclipse.update.core/src/org/eclipse/update/internal/core/DeltaInstallHandler.java;3;1;10;1;4;4;4;6;47;2;5;1884;116;116;2;1;0;6;10;1884;1;6336;9;3;
/org.eclipse.ui.tests/Eclipse UI Tests/org/eclipse/ui/tests/api/workbenchpart/OverriddenTitleTest.java;1;0;1;1;1;1;1;0;0;0;0;6101;0;0;1;0;0;0;1;6101;0;6101;1;1;
/org.eclipse.core.runtime.compatibility/src-model/org/eclipse/core/internal/model/RegistryLoader.java;3;1;4;1;3;3;3;1;14;0;1;3013;19;19;1;0;0;1;4;3013;0;6340;4;3;
/org.eclipse.jdt.ui/core refactoring/org/eclipse/jdt/internal/corext/refactoring/rename/RenameMethodProcessor.java;4;2;37;2;13;12;13;24;279;3;19;1125;847;847;3;5;1;24;37;1946;6;6340;31;4;
/org.eclipse.pde.ui/src/org/eclipse/pde/internal/ui/wizards/WizardTreeSelectionPage.java;3;1;5;1;5;5;5;0;33;0;0;5497;47;47;1;0;0;0;5;5497;0;6336;5;3;
/org.eclipse.pde.ui/src_Forms/org/eclipse/pde/internal/ui/neweditor/text/XMLSourceViewerConfiguration.java;2;0;3;1;1;1;1;2;2;1;2;4438;2;2;1;0;0;2;3;4438;0;5431;3;2;
/org.eclipse.pde.core/src/org/eclipse/pde/internal/core/site/SiteObject.java;2;0;3;1;1;1;1;2;6;1;2;4203;12;12;1;0;0;2;3;4203;0;6336;3;2;
/org.eclipse.update.ui/src/org/eclipse/update/internal/ui/views/SiteStateAction.java;3;0;9;2;1;1;1;8;52;2;7;350;84;84;2;1;0;8;9;749;1;6336;8;3;
/org.eclipse.core.runtime.compatibility/src-runtime/org/eclipse/core/internal/plugins/ExtensionPoint.java;2;0;2;1;0;0;0;2;0;1;2;3013;0;0;1;0;0;2;2;3013;0;3169;2;2;
/org.eclipse.ui.intro/src/org/eclipse/ui/internal/intro/impl/html/HTMLUtil.java;2;2;7;2;7;6;7;0;120;0;0;5115;189;189;2;0;1;0;7;5134;1;5660;6;2;
/org.eclipse.debug.ui/ui/org/eclipse/debug/internal/ui/actions/KeyBindingFollowHyperlinkAction.java;3;1;3;1;2;2;2;1;18;0;1;1290;27;27;1;0;0;1;3;1290;0;6336;3;3;
/org.eclipse.ui.console/src/org/eclipse/ui/internal/console/IConsoleHelpContextIds.java;1;0;1;1;0;0;0;1;0;0;1;1988;0;0;1;0;0;1;1;1988;0;1988;1;1;
/org.eclipse.jdt.ui.examples.javafamily/src/org/eclipse/jsp/launching/ToggleJspBreakpointAction.java;1;0;3;1;1;1;1;2;2;0;1;1385;4;4;2;1;0;2;3;1385;1;5114;2;1;
/org.eclipse.swt/Eclipse SWT/photon/org/eclipse/swt/widgets/DirectoryDialog.java;3;1;4;1;2;2;2;2;25;1;2;902;36;36;1;0;0;2;4;902;0;6352;4;3;
/org.eclipse.ui.examples.job/src/org/eclipse/ui/examples/jobs/UITestJob.java;2;1;2;1;2;2;2;0;4;0;0;5126;4;4;1;0;0;0;2;5126;0;5800;2;2;
/org.eclipse.jdt.core.tests.model/workspace/Formatter/test263/A_out.java;1;0;1;1;0;0;0;1;0;0;1;2442;0;0;1;0;0;1;1;2442;0;2442;1;1;
/org.eclipse.jdt.core/search/org/eclipse/jdt/internal/core/index/impl/ILRUCacheable.java;1;0;2;1;0;0;0;2;2;1;2;3560;2;2;1;0;0;2;2;3560;0;4060;2;1;
/org.eclipse.ant.ui/Ant Tools Support/org/eclipse/ant/internal/ui/preferences/AntPropertiesFileSelectionDialog.java;1;0;1;1;0;0;0;1;37;0;1;4857;37;37;1;0;0;1;1;4857;0;4857;1;1;
/org.eclipse.ui.views/src/org/eclipse/ui/views/internal/markers/RemoveMarkerAction.java;1;0;2;1;0;0;0;2;0;1;2;265;0;0;1;0;0;2;2;265;0;749;2;1;
/org.eclipse.swt.tests/JUnit Tests/org/eclipse/swt/tests/junit/Test_org_eclipse_swt_ole_win32_OLE.java;1;0;1;1;0;0;0;1;0;0;1;2176;0;0;1;0;0;1;1;2176;0;2176;1;1;
/org.eclipse.team.cvs.ssh2/src/org/eclipse/team/internal/ccvs/ssh2/CVSSSH2Method.java;2;0;2;1;0;0;0;2;23;1;2;4825;23;23;1;0;0;2;2;4825;0;4952;2;2;
/org.eclipse.ui.tests/Eclipse RCP Tests/org/eclipse/ui/rcp/tests/WorkbenchWindowConfigurerTest.java;1;0;2;1;1;1;1;1;4;0;1;4930;4;4;1;0;0;1;2;4930;0;5449;2;1;
/org.eclipse.update.core/src/org/eclipse/update/internal/security/JarVerifier.java;2;1;5;1;2;2;2;3;14;1;3;890;35;35;1;0;0;3;5;890;0;6336;5;2;
/org.eclipse.jdt.ui/ui/org/eclipse/jdt/internal/ui/callhierarchy/CopyCallHierarchyAction.java;2;0;2;1;1;1;1;1;2;0;1;289;2;2;1;0;0;1;2;289;0;6340;2;2;
/org.eclipse.jdt.ui.tests.refactoring/resources/ExtractMethodWorkSpace/ExtractMethodTests/return_out/A_test703.java;1;0;2;1;0;0;0;2;6;1;2;130;7;7;1;0;0;2;2;130;0;844;2;1;
/org.eclipse.swt/Eclipse SWT Drag and Drop/motif/org/eclipse/swt/dnd/DragSource.java;3;0;4;1;0;0;0;4;10;1;4;0;22;22;1;0;0;4;4;0;0;868;4;3;
/org.eclipse.ant.ui/Ant Tools Support/org/eclipse/ant/ui/internal/launchConfigurations/AntLaunchDelegate.java;2;0;19;1;0;0;0;19;57;4;16;250;217;217;4;3;0;19;19;262;3;1811;16;2;
/org.eclipse.debug.ui/ui/org/eclipse/debug/internal/ui/views/memory/DefaultColumnSizeDialog.java;1;0;1;1;1;1;1;0;0;0;0;5409;0;0;1;0;0;0;1;5409;0;5409;1;1;
/org.eclipse.jdt.debug.tests/tests/org/eclipse/jdt/debug/tests/eval/NestedTypeFieldValue_455.java;1;0;1;1;0;0;0;1;74;0;1;1274;74;74;1;0;0;1;1;1274;0;1274;1;1;
/org.eclipse.ui.cheatsheets/src/org/eclipse/ui/internal/cheatsheets/data/ISubItemItem.java;1;1;2;1;2;2;2;0;2;0;0;5189;2;2;1;0;0;0;2;5189;0;5620;2;1;
/org.eclipse.update/src/org/eclipse/update/internal/ui/Installation.java;1;0;1;1;1;1;1;0;0;0;0;6339;0;0;1;0;0;0;1;6339;0;6339;1;1;
/org.eclipse.jdt.debug.ui/ui/org/eclipse/jdt/internal/debug/ui/JavaVariablesContentProvider.java;1;0;5;1;0;0;0;5;24;1;5;670;39;39;1;0;0;5;5;670;0;861;5;1;
/org.eclipse.jdt.ui.tests.refactoring/resources/UseSupertypeWherePossible/testNew13/in/Test.java;1;0;1;1;0;0;0;1;2;0;1;1166;2;2;1;0;0;1;1;1166;0;1166;1;1;
/org.eclipse.pde.core/src_OSGi/org/eclipse/pde/core/osgi/bundle/IBundlePluginModelBase.java;2;0;4;1;0;0;0;4;2;1;4;2247;3;3;1;0;0;4;4;2247;0;4203;4;2;
/org.eclipse.ui.workbench/Eclipse UI/org/eclipse/ui/activities/ActivityServiceFactory.java;1;0;3;1;0;0;0;3;4;2;2;2800;4;4;2;1;0;3;3;2800;1;2896;2;1;
/org.eclipse.jdt.core.tests.model/workspace/Formatter/test476/A_in.java;1;0;1;1;0;0;0;1;0;0;1;3996;0;0;1;0;0;1;1;3996;0;3996;1;1;
/org.eclipse.jdt.ui/ui/org/eclipse/jdt/internal/ui/javaeditor/JavaStorageDocumentProvider.java;2;0;2;1;1;1;1;1;20;0;1;4425;20;20;1;0;0;1;2;4425;0;6340;2;2;
/org.eclipse.pde.ui/src/org/eclipse/pde/internal/ui/editor/manifest/ExtensionPropertySource.java;1;0;1;1;1;1;1;0;0;0;0;5431;0;0;1;0;0;0;1;5431;0;5431;1;1;
/org.eclipse.swt/Eclipse SWT/motif/org/eclipse/swt/widgets/Composite.java;6;1;32;1;3;3;3;29;271;2;27;17;795;795;2;2;0;29;32;1497;2;6352;30;6;
/org.eclipse.jdt.core.tests.model/workspace/Formatter/test039/A_out.java;1;0;2;1;0;0;0;2;2;1;2;2425;2;2;1;0;0;2;2;2425;0;2462;2;1;
/org.eclipse.update.ui.forms/Eclipse Forms/org/eclipse/ui/forms/FormWizardDialog.java;1;0;3;1;0;0;0;3;50;2;2;3176;50;50;2;1;0;3;3;3176;1;4157;2;1;
/org.eclipse.ui.externaltools/Ant Editor/org/eclipse/ui/externaltools/internal/ant/editor/text/XMLTextHover.java;1;0;1;1;0;0;0;1;0;0;1;282;0;0;1;0;0;1;1;282;0;282;1;1;
/org.eclipse.update.core/srcnew/org/eclipse/update/internal/search/UpdateSearchCategory.java;2;0;4;1;0;0;0;4;10;2;3;553;10;10;2;1;0;4;4;572;1;825;3;2;
/org.eclipse.core.resources/src/org/eclipse/core/resources/ICommand.java;1;0;2;1;1;1;1;1;105;0;1;4994;113;113;1;0;0;1;2;4994;0;5146;2;1;
/org.eclipse.jdt.core/compiler/org/eclipse/jdt/internal/compiler/ast/ArrayReference.java;2;0;5;1;1;1;1;4;20;1;4;991;53;53;1;0;0;4;5;991;0;5587;5;2;
/org.eclipse.jdt.core.tests.model/workspace/Converter/test0476/A.java;1;0;2;1;0;0;0;2;0;1;2;957;0;0;1;0;0;2;2;957;0;3714;2;1;
/org.eclipse.ui.views/src/org/eclipse/ui/views/internal/tableview/ITableViewContentProvider.java;1;0;2;1;0;0;0;2;0;1;2;267;0;0;1;0;0;2;2;267;0;749;2;1;
/org.eclipse.core.expressions/src/org/eclipse/core/internal/expressions/CountExpression.java;1;1;3;1;2;2;2;1;14;0;1;4108;16;16;1;0;0;1;3;4108;0;6340;3;1;
/org.eclipse.jface/src/org/eclipse/jface/dialogs/DialogPage.java;1;1;4;1;2;2;2;2;707;1;2;1;717;717;1;0;0;2;4;1;0;5484;4;1;
/org.eclipse.update/src/org/eclipse/update/internal/ui/UserValidationDialog.java;1;0;1;1;1;1;1;0;0;0;0;6339;0;0;1;0;0;0;1;6339;0;6339;1;1;
/org.eclipse.update.ui.forms/src/org/eclipse/ui/forms/internal/parts/Locator.java;1;0;2;1;0;0;0;2;0;1;2;2898;0;0;1;0;0;2;2;2898;0;3096;2;1;
/org.eclipse.ant.ui/Ant Editor/org/eclipse/ant/ui/internal/editor/xml/XmlAttribute.java;1;0;2;1;0;0;0;2;0;1;2;250;0;0;1;0;0;2;2;250;0;1811;2;1;
/org.eclipse.debug.ui/ui/org/eclipse/debug/ui/AbstractLaunchConfigurationTabGroup.java;2;0;3;1;0;0;0;3;6;1;3;581;9;9;1;0;0;3;3;581;0;2878;3;2;
/org.eclipse.help.appserver/src/org/eclipse/help/internal/appserver/WebappManager.java;1;1;7;1;3;3;3;4;92;1;4;1843;140;140;1;0;0;4;7;1843;0;6337;7;1;
/org.eclipse.swt.tests/JUnit Tests/org/eclipse/swt/tests/junit/Test_org_eclipse_swt_custom_ViewForm.java;1;0;1;1;0;0;0;1;23;0;1;2104;23;23;1;0;0;1;1;2104;0;2104;1;1;
/org.eclipse.ui.intro/src/org/eclipse/ui/internal/intro/impl/parts/UIFormsFactory.java;1;1;2;1;2;2;2;0;0;0;0;5449;0;0;1;0;0;0;2;5449;0;5467;2;1;
/org.eclipse.text.tests/src/org/eclipse/text/tests/DocumentTest.java;1;2;4;1;3;2;3;1;9;0;1;5082;11;11;2;0;1;1;4;5100;1;6340;3;1;
/org.eclipse.core.filebuffers/src/org/eclipse/core/filebuffers/ISynchronizationContext.java;2;2;4;2;3;2;3;1;40;0;1;1933;50;50;2;0;1;1;4;6333;1;6333;3;2;
/org.eclipse.ui.forms/src/org/eclipse/ui/internal/forms/widgets/ParagraphSegment.java;1;0;2;1;1;1;1;1;6;0;1;5044;6;6;1;0;0;1;2;5044;0;6336;2;1;
/org.eclipse.jdt.ui/ui refactoring/org/eclipse/jdt/internal/ui/refactoring/contentassist/FieldNameProcessor.java;1;0;1;1;1;1;1;0;0;0;0;5224;0;0;1;0;0;0;1;5224;0;5224;1;1;
/org.eclipse.ui.workbench/Eclipse UI/org/eclipse/ui/internal/TrimDropTarget.java;4;0;11;2;0;0;0;11;178;2;10;3677;297;297;2;1;0;11;11;4015;1;5000;10;4;
/org.eclipse.ui.intro/src/org/eclipse/ui/intro/internal/util/Logger.java;1;0;3;1;1;1;1;2;179;1;2;4429;179;179;1;0;0;2;3;4429;0;5115;3;1;
/org.eclipse.update.ui/src_webapp/org/eclipse/update/internal/ui/servlets/ServletsUtil.java;2;0;3;1;1;1;1;2;6;1;2;890;18;18;1;0;0;2;3;890;0;6336;3;2;
/org.eclipse.pde.ui/src_OSGi/org/eclipse/pde/internal/ui/wizards/bundles/PluginToBundleWizard.java;1;0;2;1;0;0;0;2;0;1;2;2184;0;0;1;0;0;2;2;2184;0;2244;2;1;
/org.eclipse.jdt.core.tests.model/workspace/Converter/src/test0423/A.java;1;0;1;1;0;0;0;1;0;0;1;3714;0;0;1;0;0;1;1;3714;0;3714;1;1;
/org.eclipse.update.ui/src/org/eclipse/update/internal/ui/wizards/UnifiedReviewPage.java;1;0;4;1;0;0;0;4;201;3;2;196;201;201;3;2;0;4;4;196;2;329;2;1;
/org.eclipse.core.tests.runtime/src/org/eclipse/core/tests/internal/registrycache/AllTests.java;2;0;5;1;1;1;1;4;28;1;4;3014;36;36;1;0;0;4;5;3014;0;5149;5;2;
/org.eclipse.jface/src/org/eclipse/jface/viewers/TreeViewer.java;3;1;10;1;4;4;4;6;38;2;5;2442;161;161;2;1;0;6;10;2442;1;6199;9;3;
/org.eclipse.jdt.ui/ui/org/eclipse/jdt/internal/ui/viewsupport/FilterUpdater.java;1;0;1;1;1;1;1;0;2;0;0;6340;2;2;1;0;0;0;1;6340;0;6340;1;1;
/org.eclipse.help.base/src/org/eclipse/help/internal/search/IndexingOperation.java;1;1;10;1;4;4;4;6;94;2;5;1740;172;172;2;1;0;6;10;1740;1;6337;9;1;
/org.eclipse.jdt.core.tests.model/workspace/Converter/src/test0043/Test.java;1;0;1;1;0;0;0;1;0;0;1;3714;0;0;1;0;0;1;1;3714;0;3714;1;1;
/org.eclipse.jdt.ui.tests.refactoring/resources/ExtractMethodWorkSpace/ExtractMethodTests/duplicates_out/A_test951.java;1;0;1;1;0;0;0;1;0;0;1;1219;0;0;1;0;0;1;1;1219;0;1219;1;1;
/org.eclipse.jdt.core.tests.model/workspace/Formatter/test291/A_in.java;1;0;1;1;0;0;0;1;0;0;1;2444;0;0;1;0;0;1;1;2444;0;2444;1;1;
/org.eclipse.ui.ide/src/org/eclipse/ui/internal/model/WorkbenchAdapter.java;2;0;2;1;0;0;0;2;0;1;2;1511;0;0;1;0;0;2;2;1511;0;2263;2;2;
/org.eclipse.jdt.core.tests.model/workspace/Converter/src/test0206/Test.java;1;0;1;1;0;0;0;1;0;0;1;3714;0;0;1;0;0;1;1;3714;0;3714;1;1;
/org.eclipse.jdt.core.tests.model/workspace/Converter/junit/swingui/StatusLine.java;1;0;2;1;0;0;0;2;3;1;2;787;3;3;1;0;0;2;2;787;0;3714;2;1;
/org.eclipse.swt/Eclipse SWT/motif/org/eclipse/swt/widgets/Scale.java;3;1;5;1;2;2;2;3;22;1;3;269;60;60;1;0;0;3;5;269;0;6352;5;3;
/org.eclipse.update.ui/src/org/eclipse/update/internal/ui/wizards/InstallDeltaWizard.java;3;0;10;3;1;1;1;9;16;4;6;749;45;45;4;3;0;9;10;749;3;5518;7;3;
/org.eclipse.jdt.core/codeassist/org/eclipse/jdt/internal/codeassist/select/SelectionOnImportReference.java;2;0;3;1;0;0;0;3;14;1;3;85;20;20;1;0;0;3;3;85;0;3560;3;2;
/org.eclipse.jdt.core.tests.model/workspace/TypeHierarchy/lib53095/p53095/X53095.java;1;0;1;1;0;0;0;1;0;0;1;4606;0;0;1;0;0;1;1;4606;0;4606;1;1;
/org.eclipse.jdt.ui.tests.refactoring/resources/ConvertAnonymousToNested/canConvert/A_test25_in.java;1;0;1;1;0;0;0;1;0;0;1;3195;0;0;1;0;0;1;1;3195;0;3195;1;1;
/org.eclipse.team.ui/src/org/eclipse/team/ui/sync/AutomergableFilter.java;2;0;3;1;0;0;0;3;26;1;3;709;26;26;1;0;0;3;3;709;0;2632;3;2;
/org.eclipse.compare/compare/org/eclipse/compare/rangedifferencer/IRangeComparator.java;1;0;1;1;0;0;0;1;2;0;1;3938;2;2;1;0;0;1;1;3938;0;3938;1;1;
/org.eclipse.jdt.core/dom/org/eclipse/jdt/core/dom/TypeDeclarationStatement.java;3;2;14;1;5;4;5;9;104;1;9;3560;277;277;2;0;1;9;14;5116;1;5781;13;3;
/org.eclipse.jdt.ui.tests.refactoring/resources/TypeConstraints/A_testBad2.java;1;0;2;1;0;0;0;2;0;1;2;53;0;0;1;0;0;2;2;53;0;74;2;1;
/org.eclipse.jdt.core.tests.model/workspace/Converter/src/junit/framework/TestSuite.java;2;0;2;1;1;1;1;1;4;0;1;3714;4;4;1;0;0;1;2;3714;0;6352;2;2;
/org.eclipse.jdt.ui/core refactoring/org/eclipse/jdt/internal/corext/refactoring/participants/xml/ExpressionException.java;1;0;2;1;0;0;0;2;0;1;2;3930;0;0;1;0;0;2;2;3930;0;4091;2;1;
/org.eclipse.ui.ide/src/org/eclipse/ui/views/tasklist/TaskListContentProvider.java;1;0;1;1;0;0;0;1;0;0;1;2208;0;0;1;0;0;1;1;2208;0;2208;1;1;
/org.eclipse.ant.ui/Ant Tools Support/org/eclipse/ui/ant/internal/views/actions/AddBuildFileAction.java;1;0;2;1;0;0;0;2;0;1;2;250;0;0;1;0;0;2;2;250;0;263;2;1;
/org.eclipse.jdt.ui.tests.refactoring/resources/ExtractMethodWorkSpace/ExtractMethodTests/locals_out/A_test519.java;1;0;2;1;0;0;0;2;4;1;2;130;5;5;1;0;0;2;2;130;0;844;2;1;
/org.eclipse.swt/Eclipse SWT PI/photon/org/eclipse/swt/internal/photon/PtWebWindowCallback_t.java;2;0;2;1;1;1;1;1;4;0;1;3636;4;4;1;0;0;1;2;3636;0;6352;2;2;
/org.eclipse.ui.cheatsheets/src/org/eclipse/ui/internal/cheatsheets/data/CheatSheetXMLSaveHelper.java;2;1;8;2;2;2;2;6;92;2;5;4428;167;167;2;1;0;6;8;4625;1;5363;7;2;
/org.eclipse.jdt.core/dom/org/eclipse/jdt/core/dom/ImportDeclaration.java;3;2;12;1;4;3;4;8;143;1;8;3560;303;303;2;0;1;8;12;5268;1;5335;11;3;
/org.eclipse.swt/Eclipse SWT/photon/org/eclipse/swt/widgets/Decorations.java;4;1;5;1;2;2;2;3;61;1;3;110;88;88;1;0;0;3;5;110;0;6352;5;4;
/org.eclipse.team.ui/src/org/eclipse/team/internal/ui/synchronize/sets/SyncSet.java;2;0;4;1;0;0;0;4;334;1;4;2535;348;348;1;0;0;4;4;2535;0;4216;4;2;
/org.eclipse.core.resources/src_ant/org/eclipse/core/resources/ant/IncrementalBuild.java;1;0;2;1;1;1;1;1;131;0;1;5082;146;146;1;0;0;1;2;5082;0;5146;2;1;
/org.eclipse.jdt.core/dom/org/eclipse/jdt/core/dom/SynchronizedStatement.java;3;1;8;1;2;2;2;6;111;1;6;3560;159;159;1;0;0;6;8;3560;0;5272;8;3;
/org.eclipse.pde.core/src/org/eclipse/pde/internal/core/schema/Schema.java;3;2;11;1;4;3;4;7;379;2;6;1124;655;655;2;1;1;7;11;2943;2;6336;9;3;
/org.eclipse.swt.tests/JUnit Tests/org/eclipse/swt/tests/junit/Test_org_eclipse_swt_widgets_ToolItem.java;2;0;2;1;0;0;0;2;45;1;2;2123;57;57;1;0;0;2;2;2123;0;2824;2;2;
/org.eclipse.core.resources/src/org/eclipse/core/resources/ProjectScope.java;1;0;7;1;0;0;0;7;26;2;6;4351;54;54;2;1;0;7;7;4351;1;5066;6;1;
/org.eclipse.jdt.core/compiler/org/eclipse/jdt/internal/compiler/util/Util.java;4;1;11;1;3;3;3;8;45;1;8;13;242;242;1;0;0;8;11;13;0;5586;11;4;
/org.eclipse.pde.ui/sandbox/org/eclipse/pde/internal/ui/editor/standalone/parser/XEEntityManager.java;1;0;2;1;0;0;0;2;0;1;2;2320;0;0;1;0;0;2;2;2320;0;2931;2;1;
/org.eclipse.team.ui/src/org/eclipse/team/internal/ui/sync/actions/ChooseChangeFilterAction.java;1;0;2;1;0;0;0;2;0;1;2;1181;0;0;1;0;0;2;2;1181;0;2632;2;1;
/org.eclipse.jdt.ui/ui refactoring/org/eclipse/jdt/internal/ui/refactoring/reorg/ReorgActionFactory.java;2;0;4;1;0;0;0;4;3;2;3;1112;5;5;2;1;0;4;4;1112;1;1650;3;2;
/org.eclipse.team.ui/src/org/eclipse/team/internal/ui/target/SiteRootsElement.java;1;0;1;1;0;0;0;1;0;0;1;2495;0;0;1;0;0;1;1;2495;0;2495;1;1;
/org.eclipse.jdt.ui.tests.refactoring/resources/ExtractTemp/cannotExtract/A_testFail35.java;1;0;1;1;1;1;1;0;0;0;0;5916;0;0;1;0;0;0;1;5916;0;5916;1;1;
/org.eclipse.jdt.core.tests.model/workspace/Converter/test0188/Test.java;1;0;1;1;0;0;0;1;0;0;1;3714;0;0;1;0;0;1;1;3714;0;3714;1;1;
/org.eclipse.ui.workbench/Eclipse UI/org/eclipse/ui/internal/commands/CommandHandle.java;1;0;2;1;0;0;0;2;0;1;2;1321;0;0;1;0;0;2;2;1321;0;1417;2;1;
/org.eclipse.team.ui/src/org/eclipse/team/ui/sync/actions/workingsets/SelectWorkingSetAction.java;1;0;1;1;0;0;0;1;0;0;1;2451;0;0;1;0;0;1;1;2451;0;2451;1;1;
/org.eclipse.ui.presentations.r21/src/org/eclipse/ui/internal/presentations/R21EditorStackPresentation.java;2;1;2;1;2;2;2;0;3;0;0;6075;3;3;1;0;0;0;2;6075;0;6231;2;2;
/org.eclipse.jdt.ui/core refactoring/org/eclipse/jdt/internal/corext/refactoring/reorg/JavaElementTransfer.java;3;0;3;1;1;1;1;2;6;1;2;1114;8;8;1;0;0;2;3;1114;0;6340;3;3;
/org.eclipse.update.ui.forms/src/org/eclipse/update/ui/forms/internal/TableLayoutTest.java;1;0;6;1;0;0;0;6;46;2;5;925;89;89;2;1;0;6;6;2849;1;3038;5;1;
/org.eclipse.ui.workbench/Eclipse UI/org/eclipse/ui/internal/activities/service/IActivityServiceEvent.java;1;0;2;1;0;0;0;2;0;1;2;2444;0;0;1;0;0;2;2;2444;0;2491;2;1;
/org.eclipse.ui.ide/src/org/eclipse/ui/internal/dialogs/PathVariableSelectionDialog.java;2;0;3;1;0;0;0;3;12;1;3;1526;12;12;1;0;0;3;3;1526;0;2263;3;2;
/org.eclipse.jdt.ui.examples.javafamily/src/org/eclipse/core/indexsearch/IIndexer.java;1;0;1;1;0;0;0;1;0;0;1;3235;0;0;1;0;0;1;1;3235;0;3235;1;1;
/org.eclipse.jdt.debug.ui/ui/org/eclipse/jdt/internal/debug/ui/snippeteditor/SnippetEditorPropertyPage.java;3;1;5;1;3;3;3;2;65;1;2;1136;115;115;1;0;0;2;5;1136;0;6336;5;3;
/org.eclipse.pde.ui/src/org/eclipse/pde/internal/ui/search/DependencyExtentSearchResultCollector.java;3;1;4;1;2;2;2;2;20;1;2;2184;29;29;1;0;0;2;4;2184;0;6336;4;3;
/org.eclipse.jdt.ui/ui/org/eclipse/jdt/internal/ui/text/link/contentassist/IContentAssistListener2.java;2;0;2;1;0;0;0;2;0;1;2;1132;0;0;1;0;0;2;2;1132;0;4214;2;2;
/org.eclipse.jdt.ui.tests.refactoring/resources/ExtractMethodWorkSpace/ExtractMethodTests/expression_in/A_test612.java;1;0;1;1;0;0;0;1;2;0;1;844;2;2;1;0;0;1;1;844;0;844;1;1;
/org.eclipse.webdav/src/kernel/org/eclipse/webdav/internal/kernel/RedirectionException.java;1;0;1;1;1;1;1;0;41;0;0;5151;41;41;1;0;0;0;1;5151;0;5151;1;1;
/org.eclipse.ui.externaltools/Ant Tools Support/org/eclipse/ui/externaltools/internal/ant/console/TaskLineTracker.java;1;0;1;1;0;0;0;1;0;0;1;282;0;0;1;0;0;1;1;282;0;282;1;1;
/org.eclipse.update.core/src/org/eclipse/update/standalone/InstallCommand.java;1;2;9;1;6;5;6;3;146;2;2;825;211;211;2;1;1;3;9;825;2;6335;7;1;
/org.eclipse.swt/Eclipse SWT Drag and Drop/motif/org/eclipse/swt/dnd/TableDragUnderEffect.java;1;0;1;1;0;0;0;1;80;0;1;804;80;80;1;0;0;1;1;804;0;804;1;1;
/org.eclipse.help/src/org/eclipse/help/IHelpResource.java;1;1;4;1;3;3;3;1;53;0;1;663;71;71;1;0;0;1;4;663;0;6337;4;1;
/org.eclipse.team.cvs.ui/src/org/eclipse/team/internal/ccvs/ui/subscriber/MergeUpdateOperation.java;2;1;4;1;2;2;2;2;20;1;2;4450;33;33;1;0;0;2;4;4450;0;6337;4;2;
/org.eclipse.jface/src/org/eclipse/jface/action/StatusLine.java;4;0;4;1;1;1;1;3;9;1;3;2100;20;20;1;0;0;3;4;2100;0;6338;4;4;
/org.eclipse.ui.ide/extensions/org/eclipse/ui/actions/QuickStartAction.java;4;2;12;2;6;5;6;6;23;1;6;2263;65;65;2;0;1;6;12;5532;1;6338;11;4;
/org.eclipse.team.cvs.ui/src/org/eclipse/team/internal/ccvs/ui/actions/EditorsAction.java;1;0;2;1;1;1;1;1;36;0;1;3744;62;62;1;0;0;1;2;3744;0;6034;2;1;
/org.eclipse.ant.ui/Ant Editor/org/eclipse/ant/ui/internal/editor/text/PartiallySynchronizedDocument.java;2;0;3;1;0;0;0;3;2;1;3;250;2;2;1;0;0;3;3;250;0;1811;3;2;
/org.eclipse.jdt.core.tests.model/workspace/Formatter/test077/A_in.java;1;0;1;1;0;0;0;1;0;0;1;2425;0;0;1;0;0;1;1;2425;0;2425;1;1;
/org.eclipse.jdt.ui.tests.refactoring/resources/IntroduceFactory/positive/DifferentArgs3_in.java;1;0;2;1;1;1;1;1;2;0;1;2846;2;2;1;0;0;1;2;2846;0;5659;2;1;
/org.eclipse.jface/src/org/eclipse/jface/viewers/ArrayContentProvider.java;1;0;1;1;0;0;0;1;9;0;1;3111;9;9;1;0;0;1;1;3111;0;3111;1;1;
/org.eclipse.pde.ui/src/org/eclipse/pde/internal/ui/editor/manifest/LibrarySection.java;2;0;5;1;1;1;1;4;8;1;4;648;15;15;1;0;0;4;5;648;0;5431;5;2;
/org.eclipse.pde.core/src/org/eclipse/pde/core/plugin/IMatchRules.java;3;1;3;1;3;3;3;0;78;0;0;5115;94;94;1;0;0;0;3;5115;0;6336;3;3;
/org.eclipse.jface/src/org/eclipse/jface/action/ActionContributionItem.java;7;2;39;3;10;9;10;29;1406;5;18;34;2817;2817;5;11;1;29;39;2589;12;6338;27;7;
/org.eclipse.ui.tests/Eclipse UI Tests/org/eclipse/ui/tests/keys/KeysTestSuite.java;4;0;16;1;1;1;1;15;6;3;11;2266;34;34;3;4;0;15;16;2280;4;6338;12;4;
/org.eclipse.core.tools.resources/src/org/eclipse/core/tools/resources/EventsSorter.java;1;0;1;1;1;1;1;0;0;0;0;6302;0;0;1;0;0;0;1;6302;0;6302;1;1;
/org.eclipse.ui.workbench/Eclipse UI/org/eclipse/ui/internal/csm/activities/service/ActivityServiceEvent.java;1;0;2;1;0;0;0;2;0;1;2;2370;0;0;1;0;0;2;2;2370;0;2444;2;1;
/org.eclipse.core.runtime/src/org/osgi/service/prefs/PreferencesService.java;1;0;1;1;1;1;1;0;0;0;0;5484;0;0;1;0;0;0;1;5484;0;5484;1;1;
/org.eclipse.jdt.core.tests.model/workspace/Converter/src/test0169/Test.java;1;0;1;1;0;0;0;1;0;0;1;3714;0;0;1;0;0;1;1;3714;0;3714;1;1;
/org.eclipse.jdt.ui/ui/org/eclipse/jdt/internal/ui/preferences/CodeTemplatePreferencePage.java;2;0;2;1;1;1;1;1;645;0;1;4629;647;647;1;0;0;1;2;4629;0;6340;2;2;
/org.eclipse.ui.workbench/Eclipse UI/org/eclipse/ui/internal/commands/registry/PluginRegistry.java;1;0;2;1;0;0;0;2;0;0;1;1396;0;0;2;1;0;2;2;1396;1;1396;1;1;
/org.eclipse.jface.text/src/org/eclipse/jface/contentassist/TextContentAssistSubjectAdapter.java;1;2;4;1;4;3;4;0;62;0;0;5181;68;68;2;0;1;0;4;6340;1;6340;3;1;
/org.eclipse.jdt.core/search/org/eclipse/jdt/internal/core/search/matching/TypeDeclarationPattern.java;3;3;17;2;4;2;4;13;300;2;12;547;1099;1099;3;1;2;13;17;5207;3;5335;14;3;
/org.eclipse.debug.ui/ui/org/eclipse/debug/ui/launchVariables/IVariableConstants.java;2;0;4;1;0;0;0;4;47;1;4;550;52;52;1;0;0;4;4;550;0;2120;4;2;
/org.eclipse.jdt.ui.tests/ui/org/eclipse/jdt/ui/tests/text/PartitionTokenScannerTest.java;1;0;1;1;0;0;0;1;0;0;1;4516;0;0;1;0;0;1;1;4516;0;4516;1;1;
/org.eclipse.jdt.ui.tests.refactoring/resources/Move/testDestination_yes_fieldToOtherType/in/A.java;1;0;1;1;0;0;0;1;0;0;1;1008;0;0;1;0;0;1;1;1008;0;1008;1;1;
/org.eclipse.jdt.ui.tests.refactoring/resources/ChangeSignature/canModify/A_testAll40_out.java;1;0;1;1;0;0;0;1;6;0;1;2093;6;6;1;0;0;1;1;2093;0;2093;1;1;
/org.eclipse.team.ui/src/org/eclipse/team/ui/synchronize/ITeamSubscriberParticipantNode.java;1;0;3;1;0;0;0;3;53;1;3;2561;53;53;1;0;0;3;3;2561;0;4216;3;1;
/org.eclipse.jdt.ui/core refactoring/org/eclipse/jdt/internal/corext/refactoring/changes/PackageFragmentRootReorgChange.java;4;1;8;1;2;2;2;6;45;2;5;596;80;80;2;1;0;6;8;596;1;6340;7;4;
/org.eclipse.jdt.debug.tests/tests/org/eclipse/jdt/debug/tests/core/ProjectSourceContainerTests.java;1;0;4;1;0;0;0;4;50;1;4;3679;62;62;1;0;0;4;4;3679;0;4949;4;1;
/org.eclipse.ui.workbench/Eclipse UI/org/eclipse/ui/internal/PageEventAction.java;1;0;2;1;0;0;0;2;58;1;2;2737;61;61;1;0;0;2;2;2737;0;2853;2;1;
/org.eclipse.jdt.core/eval/org/eclipse/jdt/internal/eval/CodeSnippetAllocationExpression.java;3;0;6;1;0;0;0;6;86;1;6;41;134;134;1;0;0;6;6;41;0;3560;6;3;
/org.eclipse.core.runtime.osgi/src/org/eclipse/core/internal/runtime/AdapterManager.java;1;0;2;1;0;0;0;2;321;1;2;3013;321;321;1;0;0;2;2;3013;0;3030;2;1;
/org.eclipse.ui.workbench/Eclipse UI/org/eclipse/ui/contexts/ContextManagerEvent.java;4;1;10;1;2;2;2;8;231;2;6;1135;459;459;2;2;0;8;10;1135;2;6338;8;4;
/org.eclipse.swt.tests/JUnit Tests/org/eclipse/swt/tests/junit/Test_org_eclipse_swt_widgets_Sash.java;1;0;1;1;0;0;0;1;23;0;1;2123;23;23;1;0;0;1;1;2123;0;2123;1;1;
/org.eclipse.debug.core/core/org/eclipse/debug/core/sourcelookup/containers/CompositeSourceContainer.java;1;1;4;1;2;2;2;2;40;1;2;4949;72;72;1;0;0;2;4;4949;0;5920;4;1;
/org.eclipse.update.core/src/org/eclipse/update/core/model/ArchiveReference.java;1;0;1;1;0;0;0;1;0;0;1;2634;0;0;1;0;0;1;1;2634;0;2634;1;1;
/org.eclipse.jdt.debug.tests/tests/org/eclipse/jdt/debug/tests/ManualSuite.java;1;0;1;1;0;0;0;1;0;0;1;2709;0;0;1;0;0;1;1;2709;0;2709;1;1;
/org.eclipse.jdt.core/search/org/eclipse/jdt/core/search/LocalVariableDeclarationMatch.java;2;1;7;1;3;3;3;4;23;1;4;3913;59;59;1;0;0;4;7;3913;0;5242;7;2;
/org.eclipse.jdt.core.tests.model/workspace/Formatter/test453/A_in.java;1;0;1;1;0;0;0;1;0;0;1;3772;0;0;1;0;0;1;1;3772;0;3772;1;1;
/org.eclipse.jdt.ui.tests.refactoring/resources/ExtractMethodWorkSpace/ExtractMethodTests/parameterName_out/A_test904.java;1;0;2;1;0;0;0;2;4;1;2;130;5;5;1;0;0;2;2;130;0;844;2;1;
/org.eclipse.jdt.core.tests.model/workspace/Converter/test0391/A.java;1;0;1;1;0;0;0;1;0;0;1;3714;0;0;1;0;0;1;1;3714;0;3714;1;1;
/org.eclipse.ui.workbench/Eclipse UI/org/eclipse/ui/internal/PagePartSelectionTracker.java;2;1;3;1;2;2;2;1;21;0;1;1076;43;43;1;0;0;1;3;1076;0;6338;3;2;
/org.eclipse.ui.presentations.r21/src/org/eclipse/ui/internal/presentations/r21/R21PresentationPlugin.java;1;1;2;1;2;2;2;0;10;0;0;6075;10;10;1;0;0;0;2;6075;0;6338;2;1;
/org.eclipse.jdt.core.tests.model/workspace/Converter/src/test0168/test1/Test.java;1;0;1;1;0;0;0;1;0;0;1;3714;0;0;1;0;0;1;1;3714;0;3714;1;1;
/org.eclipse.compare.examples.xml/tests/org/eclipse/compare/examples/xml/TestXMLStructureCreator.java;1;0;4;1;0;0;0;4;14;1;4;1106;24;24;1;0;0;4;4;1106;0;3954;4;1;
/org.eclipse.swt.tests/JUnit Tests/org/eclipse/swt/tests/junit/Test_org_eclipse_swt_widgets_ColorDialog.java;1;0;1;1;0;0;0;1;11;0;1;2824;11;11;1;0;0;1;1;2824;0;2824;1;1;
/org.eclipse.ui.workbench/Eclipse UI/org/eclipse/ui/internal/progress/ProgressViewerLabelProvider.java;1;0;3;1;1;1;1;2;53;1;2;4305;55;55;1;0;0;2;3;4305;0;5270;3;1;
/org.eclipse.update.core/src/org/eclipse/update/internal/core/URLEncoder.java;1;0;1;1;0;0;0;1;9;0;1;890;9;9;1;0;0;1;1;890;0;890;1;1;
/org.eclipse.ui.views/src/org/eclipse/ui/views/internal/markers/Messages.java;1;0;3;1;0;0;0;3;39;1;3;265;39;39;1;0;0;3;3;265;0;755;3;1;
/org.eclipse.ui.cheatsheets/src/org/eclipse/ui/internal/cheatsheets/registry/CheatSheetElement.java;3;1;6;1;3;3;3;3;37;1;3;4428;87;87;1;0;0;3;6;4428;0;5976;6;3;
/org.eclipse.jdt.ui.tests.refactoring/resources/ExtractMethodWorkSpace/ExtractMethodTests/locals_out/A_test555.java;1;0;1;1;0;0;0;1;4;0;1;844;4;4;1;0;0;1;1;844;0;844;1;1;
/org.eclipse.team.cvs.core/src/org/eclipse/team/internal/ccvs/core/subscribers/CVSSubscriberFactory.java;1;0;1;1;0;0;0;1;0;0;1;1427;0;0;1;0;0;1;1;1427;0;1427;1;1;
/org.eclipse.text/src/org/eclipse/jface/text/templates/TemplateVariable.java;2;1;8;1;2;2;2;6;159;1;6;4259;273;273;1;0;0;6;8;4259;0;6340;8;2;
/org.eclipse.team.ui/src/org/eclipse/team/ui/synchronize/viewers/SyncInfoSetCompareInput.java;1;0;1;1;0;0;0;1;0;0;1;3972;0;0;1;0;0;1;1;3972;0;3972;1;1;
/org.eclipse.jdt.ui/ui/org/eclipse/jdt/internal/ui/text/template/TemplateVariableProposal.java;1;0;1;1;0;0;0;1;0;0;1;4258;0;0;1;0;0;1;1;4258;0;4258;1;1;
/org.eclipse.pde.core/srcnew/org/eclipse/pde/internal/core/plugin/XEParseException.java;1;0;1;1;0;0;0;1;0;0;1;2906;0;0;1;0;0;1;1;2906;0;2906;1;1;
/org.eclipse.jdt.ui/core refactoring/org/eclipse/ltk/core/refactoring/IUndoManager.java;1;0;2;1;0;0;0;2;0;1;2;4575;0;0;1;0;0;2;2;4575;0;4864;2;1;
/org.eclipse.debug.ui/ui/org/eclipse/debug/internal/ui/launchConfigurations/FavoritesDialog.java;3;0;5;1;1;1;1;4;42;1;4;2312;53;53;1;0;0;4;5;2312;0;5207;5;3;
/org.eclipse.ui.ide/src/org/eclipse/ui/model/IWorkbenchAdapter.java;1;0;2;1;0;0;0;2;0;1;2;1511;0;0;1;0;0;2;2;1511;0;1526;2;1;
/org.eclipse.pde.ui/src/org/eclipse/pde/internal/ui/wizards/feature/NewFeaturePatchWizard.java;2;2;11;2;11;10;11;0;1378;0;0;5563;1676;1676;2;0;1;0;11;6174;1;6336;10;2;
/org.eclipse.jdt.ui.examples.javafamily/coresearch-experiment/org/eclipse/search/internal/core/IndexQueryRequestor.java;1;0;2;1;0;0;0;2;0;1;2;1380;0;0;1;0;0;2;2;1380;0;3214;2;1;
/org.eclipse.jdt.core.tests.model/workspace/Converter/src/test0176/Test.java;1;0;1;1;0;0;0;1;0;0;1;3714;0;0;1;0;0;1;1;3714;0;3714;1;1;
/org.eclipse.text/src/org/eclipse/jface/text/AbstractLineTracker.java;2;0;2;1;1;1;1;1;37;0;1;1347;39;39;1;0;0;1;2;1347;0;6299;2;2;
/org.eclipse.jdt.core/search/org/eclipse/jdt/internal/core/search/indexing/RemoveFromIndex.java;2;0;6;1;1;1;1;5;13;1;5;937;29;29;1;0;0;5;6;937;0;5659;6;2;
/org.eclipse.jdt.core/compiler/org/eclipse/jdt/internal/compiler/ast/MemberValueArrayInitializer.java;1;0;1;1;0;0;0;1;0;0;1;4495;0;0;1;0;0;1;1;4495;0;4495;1;1;
/org.eclipse.jdt.core.tests.model/workspace/Converter/src/test0055/Test.java;1;0;1;1;0;0;0;1;0;0;1;3714;0;0;1;0;0;1;1;3714;0;3714;1;1;
/org.eclipse.pde.core/src/org/eclipse/pde/core/IIdentifiable.java;3;1;5;1;4;4;4;1;24;0;1;4203;34;34;1;0;0;1;5;4203;0;6336;5;3;
/org.eclipse.jdt.debug.ui/ui/org/eclipse/jdt/internal/debug/ui/actions/ManageWatchpointActionDelegate.java;3;0;5;1;0;0;0;5;168;2;4;1739;301;301;2;1;0;5;5;1739;1;4494;4;3;
/org.eclipse.core.filebuffers/src/org/eclipse/core/internal/filebuffers/FileDocumentProvider2.java;1;0;2;1;0;0;0;2;0;1;2;1522;0;0;1;0;0;2;2;1522;0;1574;2;1;
/org.eclipse.jdt.core.tests.model/workspace/TypeHierarchy/src/q2/Y.java;1;0;1;1;0;0;0;1;0;0;1;3471;0;0;1;0;0;1;1;3471;0;3471;1;1;
/org.eclipse.jdt.debug.tests/tests/org/eclipse/jdt/debug/tests/eval/QualifiedStaticFieldValueTests.java;1;0;1;1;0;0;0;1;18;0;1;1274;18;18;1;0;0;1;1;1274;0;1274;1;1;
/org.eclipse.core.tests.resources/src/org/eclipse/core/tests/internal/properties/AllTests.java;1;0;1;1;1;1;1;0;19;0;0;5147;19;19;1;0;0;0;1;5147;0;5147;1;1;
/org.eclipse.webdav/src/client/org/eclipse/webdav/internal/authentication/DigestAuthority.java;1;0;2;1;2;1;2;0;160;0;0;5151;160;160;2;0;1;0;2;5151;1;5151;1;1;
/org.eclipse.help/src/org/eclipse/help/internal/search/QueryWordsPhrase.java;1;0;1;1;0;0;0;1;0;0;1;2732;0;0;1;0;0;1;1;2732;0;2732;1;1;
/org.eclipse.jdt.ui.tests/ui/org/eclipse/jdt/ui/tests/quickfix/MarkerResolutionGenerator.java;3;1;3;1;3;3;3;0;6;0;0;5377;11;11;1;0;0;0;3;5377;0;6340;3;3;
/org.eclipse.jdt.ui/ui/org/eclipse/jdt/internal/ui/javaeditor/JavaSelectRulerAction.java;1;0;2;1;1;1;1;1;2;0;1;4940;4;4;1;0;0;1;2;4940;0;6340;2;1;
/org.eclipse.core.tests.runtime/src/org/eclipse/core/tests/internal/runtimetests/SampleMFR.java;1;0;1;1;1;1;1;0;21;0;0;5149;21;21;1;0;0;0;1;5149;0;5149;1;1;
/org.eclipse.jdt.debug/model/org/eclipse/jdt/internal/debug/core/hcr/JavaHotCodeReplaceManager.java;4;1;12;1;4;4;4;8;26;2;7;363;89;89;2;1;0;8;12;1276;1;6336;11;4;
/org.eclipse.ui.cheatsheets/src/org/eclipse/ui/cheatsheets/ICheatSheetAction.java;2;1;6;1;2;2;2;4;34;1;4;4428;80;80;1;0;0;4;6;4428;0;5230;6;2;
/org.eclipse.ui.workbench/Eclipse UI/org/eclipse/ui/internal/registry/IViewRegistry.java;3;1;3;1;2;2;2;1;4;0;1;2737;8;8;1;0;0;1;3;2737;0;6338;3;3;
/org.eclipse.jdt.ui/ui/org/eclipse/jdt/internal/ui/wizards/buildpaths/SourceContainerWorkbookPage.java;3;1;11;1;4;4;4;7;99;2;6;1336;244;244;2;1;0;7;11;3403;1;6340;10;3;
/org.eclipse.core.expressions/src/org/eclipse/core/internal/expressions/PropertyCache.java;1;1;3;1;2;2;2;1;12;0;1;4108;14;14;1;0;0;1;3;4108;0;6340;3;1;
/org.eclipse.jdt.core.tests.model/workspace/Formatter/test182/A_out.java;1;0;1;1;0;0;0;1;0;0;1;2425;0;0;1;0;0;1;1;2425;0;2425;1;1;
/org.eclipse.jdt.ui/core refactoring/org/eclipse/jdt/internal/corext/refactoring/AbstractJavaElementRenameChange.java;3;0;8;1;1;1;1;7;88;1;7;3708;310;310;1;0;0;7;8;3708;0;6340;8;3;
/org.eclipse.jdt.debug.tests/tests/org/eclipse/jdt/debug/tests/eval/generator/OtherTestsGenerator.java;1;0;1;1;0;0;0;1;4;0;1;1277;4;4;1;0;0;1;1;1277;0;1277;1;1;
/org.eclipse.debug.core/core/org/eclipse/debug/core/sourcelookup/containers/DirectorySourceContainer.java;1;0;4;1;1;1;1;3;12;0;1;4949;19;19;3;2;0;3;4;4949;2;5109;2;1;
/org.eclipse.pde.ui/src_Forms/org/eclipse/pde/internal/ui/neweditor/PropertiesAction.java;2;0;3;1;1;1;1;2;1;1;2;4877;1;1;1;0;0;2;3;4877;0;5431;3;2;
/org.eclipse.core.resources/src/org/eclipse/core/internal/events/ResourceComparator.java;2;1;3;1;2;2;2;1;224;0;1;2628;235;235;1;0;0;1;3;2628;0;5688;3;2;
/org.eclipse.jdt.ui/core refactoring/org/eclipse/ltk/core/refactoring/participants/DeleteParticipant.java;1;0;2;1;0;0;0;2;0;1;2;4624;0;0;1;0;0;2;2;4624;0;4864;2;1;
/org.eclipse.jdt.ui/core refactoring/org/eclipse/jdt/internal/corext/refactoring/code/flow/FlowContext.java;2;0;2;1;1;1;1;1;5;0;1;597;7;7;1;0;0;1;2;597;0;6340;2;2;
/org.eclipse.pde.core/src/org/eclipse/pde/internal/core/PDEPluginConverter.java;3;1;5;1;5;5;5;0;10;0;0;5577;20;20;1;0;0;0;5;5577;0;6336;5;3;
/org.eclipse.jdt.ui.examples.javafamily/src/org/eclipse/jdt/internal/ui/examples/jspeditor/JspSourceViewerConfiguration.java;1;0;5;1;0;0;0;5;11;2;4;1071;23;23;2;1;0;5;5;1150;1;1629;4;1;
/org.eclipse.debug.ui/ui/org/eclipse/debug/internal/ui/WorkingDirectoryStatusHandler.java;1;0;1;1;0;0;0;1;3;0;1;2497;3;3;1;0;0;1;1;2497;0;2497;1;1;
/org.eclipse.jdt.core.tests.model/workspace/Converter/test0369/A.java;1;0;1;1;0;0;0;1;0;0;1;3714;0;0;1;0;0;1;1;3714;0;3714;1;1;
/org.eclipse.jdt.core.tests.compiler/src/org/eclipse/jdt/core/tests/compiler/parser/MethodInvocationCompletionTest.java;1;0;1;1;0;0;0;1;2;0;1;3560;2;2;1;0;0;1;1;3560;0;3560;1;1;
/org.eclipse.jdt.ui.tests.refactoring/resources/ExtractMethodWorkSpace/ExtractMethodTests/locals_in/A_test558.java;1;0;1;1;0;0;0;1;2;0;1;844;2;2;1;0;0;1;1;844;0;844;1;1;
/org.eclipse.ui.workbench/Eclipse UI/org/eclipse/ui/internal/roles/IRoleActivityBindingDefinition.java;1;0;2;1;0;0;0;2;0;1;2;2444;0;0;1;0;0;2;2;2444;0;2533;2;1;
/org.eclipse.jdt.ui.tests.refactoring/resources/DeleteSourceReferenceEdit/A_testField2_out.java;1;0;1;1;0;0;0;1;0;0;1;1652;0;0;1;0;0;1;1;1652;0;1652;1;1;
/org.eclipse.jdt.ui.tests.refactoring/resources/IntroduceFactory/positive/multiUnit1B_in.java;1;0;2;1;0;0;0;2;0;1;2;2846;0;0;1;0;0;2;2;2846;0;2862;2;1;
/org.eclipse.osgi/eclipseAdaptor/src/org/eclipse/osgi/service/pluginconversion/IPluginInfo.java;1;0;2;1;0;0;0;2;0;0;1;3133;0;0;2;1;0;2;2;3133;1;3133;1;1;
/org.eclipse.jdt.core/formatter/org/eclipse/jdt/core/formatter/CodeFormatter.java;3;0;8;1;1;1;1;7;11;3;5;2178;22;22;3;2;0;7;8;2222;2;6077;6;3;
/org.eclipse.jdt.ui/core refactoring/org/eclipse/jdt/internal/corext/refactoring/participants/RefactoringStyles.java;1;0;3;1;0;0;0;3;2;1;3;1152;2;2;1;0;0;3;3;1152;0;4624;3;1;
/org.eclipse.ui.ide/src/org/eclipse/ui/internal/ide/dialogs/CreateLinkedResourceGroup.java;1;0;1;1;0;0;0;1;0;0;1;2264;0;0;1;0;0;1;1;2264;0;2264;1;1;
/org.eclipse.update.core/src/org/eclipse/update/core/PluginEntry.java;3;1;5;1;3;3;3;2;6;1;2;0;20;20;1;0;0;2;5;0;0;6336;5;3;
/org.eclipse.jface/src/org/eclipse/jface/action/IContextResolver.java;1;0;2;1;0;0;0;2;0;1;2;535;0;0;1;0;0;2;2;535;0;2161;2;1;
/org.eclipse.jdt.core.tests.model/workspace/Converter/junit/runner/TestRunListener.java;1;0;2;1;0;0;0;2;0;1;2;787;0;0;1;0;0;2;2;787;0;3714;2;1;
/org.eclipse.jdt.debug/jdi/org/eclipse/jdi/internal/jdwp/JdwpCommandPacket.java;1;0;2;1;0;0;0;2;7;1;2;215;10;10;1;0;0;2;2;215;0;4267;2;1;
/org.eclipse.help/src/org/eclipse/help/internal/util/TString.java;1;0;1;1;0;0;0;1;0;0;1;2732;0;0;1;0;0;1;1;2732;0;2732;1;1;
/org.eclipse.core.tests.runtime/src/org/eclipse/core/tests/internal/preferences/TestScope.java;2;1;13;2;6;6;6;7;68;2;6;4351;196;196;2;1;0;7;13;4953;1;5600;12;2;
/org.eclipse.jdt.ui.tests.refactoring/resources/RenamePackage/testImportFromMultiRoots4/in/srcPrg/p/B.java;1;0;2;1;0;0;0;2;15;1;2;3219;15;15;1;0;0;2;2;3219;0;4105;2;1;
/org.eclipse.ant.ui/Ant Editor/org/eclipse/ant/internal/ui/editor/derived/SingleCharReader.java;1;1;3;1;2;2;2;1;5;0;1;1811;9;9;1;0;0;1;3;1811;0;6336;3;1;
/org.eclipse.jdt.core/model/org/eclipse/jdt/core/CodeFormatter.java;1;0;8;1;0;0;0;8;44;2;6;822;132;132;2;2;0;8;8;822;2;2178;6;1;
/org.eclipse.ant.tests.core/tests/org/eclipse/ant/tests/core/tests/TargetTests.java;1;0;2;1;0;0;0;2;15;1;2;253;17;17;1;0;0;2;2;253;0;1973;2;1;
/org.eclipse.debug.ui/ui/org/eclipse/debug/ui/actions/OpenLaunchDialogAction.java;3;1;5;1;2;2;2;3;46;1;3;205;60;60;1;0;0;3;5;205;0;6336;5;3;
/org.eclipse.core.tests.runtime/src/org/eclipse/core/tests/internal/runtimetests/SampleFFB.java;1;0;1;1;1;1;1;0;19;0;0;5149;19;19;1;0;0;0;1;5149;0;5149;1;1;
/org.eclipse.jdt.core.tests.model/workspace/Converter15/src/test0016/X.java;1;0;1;1;0;0;0;1;0;0;1;4826;0;0;1;0;0;1;1;4826;0;4826;1;1;
/org.eclipse.ui.views/src/org/eclipse/ui/views/internal/table/ITableViewContentProvider.java;1;0;2;1;0;0;0;2;0;0;1;749;0;0;2;1;0;2;2;749;1;749;1;1;
/org.eclipse.jdt.debug/model/org/eclipse/jdt/internal/debug/core/model/JDIVoidValue.java;1;0;1;1;0;0;0;1;6;0;1;2497;6;6;1;0;0;1;1;2497;0;2497;1;1;
/org.eclipse.pde.ui/src/org/eclipse/pde/internal/ui/wizards/project/ConvertedProjectWizard.java;1;0;2;1;0;0;0;2;6;1;2;571;6;6;1;0;0;2;2;571;0;3839;2;1;
/org.eclipse.jdt.core/compiler/org/eclipse/jdt/internal/compiler/classfmt/InnerClassInfo.java;2;0;2;1;0;0;0;2;3;1;2;2094;5;5;1;0;0;2;2;2094;0;3560;2;2;
/org.eclipse.ui.tests/Eclipse UI Tests/org/eclipse/ui/tests/api/SessionPerspective.java;2;0;2;1;1;1;1;1;2;0;1;3691;4;4;1;0;0;1;2;3691;0;6338;2;2;
/org.eclipse.jdt.core/model/org/eclipse/jdt/internal/core/builder/IncrementalImageBuilder.java;4;0;16;1;0;0;0;16;34;2;15;108;164;164;2;1;0;16;16;108;1;4887;15;4;
/org.eclipse.pde.ui/src/org/eclipse/pde/internal/ui/wizards/exports/BaseExportJob.java;1;0;3;1;0;0;0;3;5;1;3;2571;5;5;1;0;0;3;3;2571;0;5044;3;1;
/org.eclipse.jdt.ui/ui/org/eclipse/jdt/internal/ui/wizards/OpenTypeWizardAction.java;2;1;2;1;2;2;2;0;3;0;0;5377;5;5;1;0;0;0;2;5377;0;6340;2;2;
/org.eclipse.jdt.ui/ui/org/eclipse/jdt/internal/ui/text/comment/IJavaDocTagConstants.java;3;0;7;1;0;0;0;7;14;1;7;1998;33;33;1;0;0;7;7;1998;0;3829;7;3;
/org.eclipse.update/src/org/eclipse/update/internal/core/UMSessionDefinerReferenceUpdate.java;1;0;1;1;1;1;1;0;0;0;0;6339;0;0;1;0;0;0;1;6339;0;6339;1;1;
/org.eclipse.team.webdav/src/org/eclipse/team/internal/ui/target/SyncAction.java;2;0;2;1;0;0;0;2;0;1;2;2495;0;0;1;0;0;2;2;2495;0;4216;2;2;
/org.eclipse.pde.ui/src/org/eclipse/pde/internal/ui/editor/plugin/PluginUndoManager.java;2;1;6;1;6;6;6;0;28;0;0;5431;44;44;1;0;0;0;6;5431;0;6336;6;2;
/org.eclipse.jdt.core.tests.model/workspace/Converter/src/test0535/A.java;1;0;1;1;0;0;0;1;0;0;1;3748;0;0;1;0;0;1;1;3748;0;3748;1;1;
/org.eclipse.jdt.ui/core refactoring/org/eclipse/jdt/internal/corext/refactoring/code/flow/GenericSequentialFlowInfo.java;1;0;1;1;1;1;1;0;2;0;0;6340;2;2;1;0;0;0;1;6340;0;6340;1;1;
/org.eclipse.ui.workbench/Eclipse UI/org/eclipse/ui/internal/dialogs/MultiStepCapabilityWizard.java;1;0;1;1;0;0;0;1;0;0;1;2737;0;0;1;0;0;1;1;2737;0;2737;1;1;
/org.eclipse.ui.ide/src/org/eclipse/ui/ide/WorkbenchResourceContentProvider.java;3;0;3;2;0;0;0;3;47;1;3;1988;50;50;1;0;0;3;3;1988;0;2611;3;3;
/org.eclipse.team.examples.filesystem/src/org/eclipse/team/examples/filesystem/ui/FileSystemAction.java;2;1;2;1;2;2;2;0;8;0;0;6206;10;10;1;0;0;0;2;6206;0;6337;2;2;
/org.eclipse.swt/Eclipse SWT/gtk1x/org/eclipse/swt/graphics/FontData.java;2;0;2;1;0;0;0;2;42;1;2;174;42;42;1;0;0;2;2;174;0;2327;2;2;
/org.eclipse.search/search/org/eclipse/search/internal/ui/text/FileSearchResult.java;1;0;4;1;2;1;2;2;30;1;2;3711;39;39;2;0;1;2;4;5178;1;5178;3;1;
/org.eclipse.swt/Eclipse SWT/photon/org/eclipse/swt/widgets/Tracker.java;5;1;20;2;3;3;3;17;186;3;14;110;398;398;3;3;0;17;20;110;3;6352;17;5;
/org.eclipse.jdt.ui.tests.refactoring/resources/MoveInnerToTopLevel/test_nonstatic_35/out/Inner.java;1;0;1;1;0;0;0;1;1;0;1;305;1;1;1;0;0;1;1;305;0;305;1;1;
/org.eclipse.core.resources/src/org/eclipse/core/internal/resources/Project.java;3;2;26;1;10;9;10;16;1764;2;14;177;2225;2225;2;2;1;16;26;177;3;6249;23;3;
/org.eclipse.debug.ui/ui/org/eclipse/debug/internal/ui/views/variables/IndexedValuePartition.java;3;0;4;1;1;1;1;3;13;1;3;2564;30;30;1;0;0;3;4;2564;0;6336;4;3;
/org.eclipse.ui.workbench/Eclipse UI/org/eclipse/ui/internal/keys/FormalKeyFormatter.java;1;0;2;1;0;0;0;2;7;1;2;3310;7;7;1;0;0;2;2;3310;0;3350;2;1;
/org.eclipse.team.ui/src/org/eclipse/team/ui/sync/actions/SubscriberAction.java;1;0;1;1;0;0;0;1;0;0;1;2378;0;0;1;0;0;1;1;2378;0;2378;1;1;
/org.eclipse.jdt.ui.tests.refactoring/resources/ChangeSignature/canModify/A_testAddRecursive1_out.java;2;0;2;1;0;0;0;2;2;1;2;2093;2;2;1;0;0;2;2;2093;0;3216;2;2;
/org.eclipse.jdt.core.tests.model/workspace/Formatter/test172/A_out.java;1;0;1;1;0;0;0;1;0;0;1;2425;0;0;1;0;0;1;1;2425;0;2425;1;1;
/org.eclipse.jdt.ui.tests.refactoring/resources/IntroduceFactory/positive/UnmovableArg1.java;1;0;2;1;1;1;1;1;2;0;1;2846;2;2;1;0;0;1;2;2846;0;5659;2;1;
/org.eclipse.jdt.debug.tests/tests/org/eclipse/jdt/debug/tests/eval/StringPlusAssignmentOpTests.java;1;0;1;1;0;0;0;1;18;0;1;1274;18;18;1;0;0;1;1;1274;0;1274;1;1;
/org.eclipse.jdt.debug.ui/ui/org/eclipse/jdt/internal/debug/ui/StatusInfo.java;2;0;2;1;1;1;1;1;4;0;1;3516;4;4;1;0;0;1;2;3516;0;6336;2;2;
/org.eclipse.jdt.core/search/org/eclipse/jdt/core/search/SearchDocument.java;3;1;10;1;5;5;5;5;69;1;5;3211;179;179;1;0;0;5;10;3211;0;6203;10;3;
/org.eclipse.core.tests.runtime/src/org/eclipse/core/tests/runtime/QualifiedNameTest.java;1;0;1;1;1;1;1;0;234;0;0;5149;234;234;1;0;0;0;1;5149;0;5149;1;1;
/org.eclipse.jdt.ui/ui refactoring/org/eclipse/jdt/internal/ui/refactoring/reorg/IRefactoringRenameSupport.java;2;0;3;1;0;0;0;3;2;1;3;1112;2;2;1;0;0;3;3;1112;0;4654;3;2;
/org.eclipse.pde.ui/src/org/eclipse/pde/internal/ui/launcher/AdvancedLauncherTab.java;2;1;15;1;2;2;2;13;367;1;13;368;1780;1780;1;0;0;13;15;368;0;6336;15;2;
/org.eclipse.jdt.core/model/org/eclipse/jdt/internal/core/util/ExceptionAttribute.java;1;0;1;1;0;0;0;1;2;0;1;3560;2;2;1;0;0;1;1;3560;0;3560;1;1;
/org.eclipse.ui.externaltools/External Tools Base/org/eclipse/ui/externaltools/internal/ui/ExternalToolsContentProvider.java;2;0;4;1;0;0;0;4;12;1;4;244;16;16;1;0;0;4;4;244;0;1935;4;2;
/org.eclipse.swt/Eclipse SWT/motif/org/eclipse/swt/widgets/Widget.java;6;0;19;2;1;1;1;18;205;2;17;83;660;660;2;1;0;18;19;281;1;6352;18;6;
/org.eclipse.pde.ui/src/org/eclipse/pde/internal/ui/view/PluginsView.java;3;2;14;2;6;5;6;8;16;1;8;368;70;70;2;0;1;8;14;5658;1;6336;13;3;
/org.eclipse.jdt.ui/core refactoring/org/eclipse/jdt/internal/corext/refactoring/participants/properties/PropertyInterface.java;1;0;2;1;0;0;0;2;0;1;2;825;0;0;1;0;0;2;2;825;0;1033;2;1;
/org.eclipse.ant.tests.ui/Ant Editor Tests/org/eclipse/ant/ui/internal/editor/test/CodeCompletionTest.java;1;0;10;1;0;0;0;10;302;2;8;1274;934;934;2;2;0;10;10;1302;2;1811;8;1;
/org.eclipse.ui.workbench/Eclipse UI/org/eclipse/ui/commands/internal/Path.java;1;0;2;1;0;0;0;2;0;1;2;786;0;0;1;0;0;2;2;786;0;956;2;1;
/org.eclipse.ui.workbench/Eclipse UI/org/eclipse/ui/internal/roles/IRoleRegistryListener.java;1;0;3;1;0;0;0;3;2;1;3;2444;2;2;1;0;0;3;3;2444;0;2864;3;1;
/org.eclipse.swt/Eclipse SWT PI/carbon/org/eclipse/swt/internal/carbon/NavDialogCreationOptions.java;1;2;3;1;3;2;3;0;16;0;0;5534;20;20;2;0;1;0;3;5534;1;5614;2;1;
/org.eclipse.team.cvs.core/src/org/eclipse/team/internal/ccvs/core/resources/EclipseSynchronizer.java;2;2;38;1;9;7;9;29;570;3;24;276;2048;2048;3;5;2;29;38;2100;7;6337;31;2;
/org.eclipse.pde.ui/src_Forms/org/eclipse/pde/internal/ui/neweditor/build/BuildContentsSection.java;2;1;8;1;6;6;6;2;137;1;2;4406;164;164;1;0;0;2;8;4406;0;5431;8;2;
/org.eclipse.update.core/src/org/eclipse/update/internal/core/FeaturePackagedFactory.java;1;0;1;1;0;0;0;1;12;0;1;890;12;12;1;0;0;1;1;890;0;890;1;1;
/org.eclipse.ui.workbench/Eclipse UI/org/eclipse/ui/internal/commands/XICommand.java;2;0;9;1;0;0;0;9;43;3;7;1695;74;74;3;2;0;9;9;2562;2;4088;7;2;
/org.eclipse.team.tests.cvs.core/src/org/eclipse/team/tests/ccvs/core/provider/CVSProviderTest.java;2;1;12;1;2;2;2;10;66;1;10;790;222;222;1;0;0;10;12;790;0;6337;12;2;
/org.eclipse.ui.workbench/Eclipse UI/org/eclipse/ui/internal/activities/ws/FilterableObject.java;2;0;4;2;0;0;0;4;40;2;3;3066;40;40;2;1;0;4;4;3130;1;5030;3;2;
/org.eclipse.jdt.ui.tests.refactoring/resources/ExtractMethodWorkSpace/ExtractMethodTests/expression_in/A_test622.java;1;0;1;1;0;0;0;1;2;0;1;844;2;2;1;0;0;1;1;844;0;844;1;1;
/org.eclipse.team.tests.cvs.core/src/org/eclipse/team/tests/ccvs/ui/old/PrintSummaryMain.java;1;0;2;1;0;0;0;2;0;1;2;2632;0;0;1;0;0;2;2;2632;0;4216;2;1;
/org.eclipse.jdt.core/dom/org/eclipse/jdt/core/dom/LabeledStatement.java;3;1;9;1;2;2;2;7;109;1;7;2872;165;165;1;0;0;7;9;2872;0;5272;9;3;
/org.eclipse.jdt.core.tests.model/workspace/Converter/test0235/Test.java;1;0;1;1;0;0;0;1;0;0;1;3714;0;0;1;0;0;1;1;3714;0;3714;1;1;
/org.eclipse.jdt.ui.tests.refactoring/resources/ChangeTypeRefactoring/negative/A_testObjectReturnType_out.java;1;0;1;1;1;1;1;0;0;0;0;5359;0;0;1;0;0;0;1;5359;0;5359;1;1;
/org.eclipse.ui.ide/src/org/eclipse/ui/actions/MoveProjectAction.java;2;0;3;1;0;0;0;3;20;1;3;1511;20;20;1;0;0;3;3;1511;0;2263;3;2;
/org.eclipse.jdt.ui/ui/org/eclipse/jdt/internal/ui/text/template/contentassist/TemplateInformationControlCreator.java;2;0;2;1;1;1;1;1;22;0;1;4258;22;22;1;0;0;1;2;4258;0;6340;2;2;
/org.eclipse.ui.views/src/org/eclipse/ui/views/navigator/WorkbenchResourceContentProvider.java;1;0;1;1;0;0;0;1;0;0;1;1934;0;0;1;0;0;1;1;1934;0;1934;1;1;
/org.eclipse.ui.workbench/Eclipse UI/org/eclipse/ui/internal/csm/activities/ActivityManager.java;1;0;14;1;0;0;0;14;122;5;7;2225;369;369;5;7;0;14;14;2405;7;2433;7;1;
/org.eclipse.swt/Eclipse SWT/gtk/org/eclipse/swt/widgets/TrayIcon.java;4;0;8;3;0;0;0;8;383;3;4;4445;439;439;3;4;0;8;8;4445;4;4521;4;4;
/org.eclipse.team.tests.cvs.core/src/org/eclipse/team/tests/ccvs/ui/unit/CVSOperationTest.java;2;0;3;1;0;0;0;3;30;1;3;2478;30;30;1;0;0;3;3;2478;0;2632;3;2;
/org.eclipse.webdav/src/interface/org/eclipse/webdav/dom/ResourceID.java;1;0;2;1;2;1;2;0;77;0;0;5151;77;77;2;0;1;0;2;5151;1;5151;1;1;
/org.eclipse.jdt.ui/core refactoring/org/eclipse/jdt/internal/corext/refactoring/reorg2/ReorgUserInputPage.java;1;0;3;1;0;0;0;3;2;2;2;802;2;2;2;1;0;3;3;1112;1;1112;2;1;
/org.eclipse.core.tests.runtime/src/org/eclipse/core/tests/internal/plugins/PluginResolveTest_6.java;1;0;1;1;0;0;0;1;0;0;1;3014;0;0;1;0;0;1;1;3014;0;3014;1;1;
/org.eclipse.jdt.core.tests.model/workspace/Converter/test0350/Test2.java;1;0;1;1;0;0;0;1;0;0;1;3714;0;0;1;0;0;1;1;3714;0;3714;1;1;
/org.eclipse.pde.runtime/src/org/eclipse/pde/internal/runtime/PDERuntimePluginImages.java;3;1;18;1;2;2;2;16;98;3;14;798;262;262;3;2;0;16;18;831;2;6336;16;3;
/org.eclipse.jdt.junit/src/org/eclipse/jdt/internal/junit/ui/FailureRunView.java;2;0;7;1;1;1;1;6;81;1;6;185;147;147;1;0;0;6;7;185;0;5633;7;2;
/org.eclipse.update.core/src/org/eclipse/update/core/model/PluginInstaller.java;1;0;1;1;0;0;0;1;0;0;1;2650;0;0;1;0;0;1;1;2650;0;2650;1;1;
/org.eclipse.pde.ui/src/org/eclipse/pde/internal/ui/util/SWTUtil.java;2;0;3;1;1;1;1;2;20;1;2;733;27;27;1;0;0;2;3;733;0;6336;3;2;
/org.eclipse.core.resources/src/org/eclipse/core/internal/resources/ResourceProxy.java;1;0;1;1;1;1;1;0;21;0;0;5146;21;21;1;0;0;0;1;5146;0;5146;1;1;
/org.eclipse.jdt.core.tests.model/workspace/Converter/src/javadoc/testBug53276/TestC.java;1;0;1;1;0;0;0;1;0;0;1;4311;0;0;1;0;0;1;1;4311;0;4311;1;1;
/org.eclipse.jdt.ui.tests.refactoring/resources/TypeConstraints/A_testConstraints23.java;1;0;2;1;0;0;0;2;9;1;2;1592;9;9;1;0;0;2;2;1592;0;1601;2;1;
/org.eclipse.core.tests.resources/src/org/eclipse/core/tests/resources/usecase/IProjectTest.java;1;0;3;1;3;1;3;0;502;0;0;5147;502;502;3;0;2;0;3;5147;2;5147;1;1;
/org.eclipse.debug.ui/ui/org/eclipse/debug/ui/launchVariables/ContextLaunchVariableRegistry.java;1;0;2;1;0;0;0;2;0;1;2;550;0;0;1;0;0;2;2;550;0;562;2;1;
/org.eclipse.swt/Eclipse SWT/carbon/org/eclipse/swt/widgets/TableColumn.java;3;1;7;1;2;2;2;5;305;1;5;231;366;366;1;0;0;5;7;231;0;6352;7;3;
/org.eclipse.ui.externaltools/Ant Tools Support/org/eclipse/ui/externaltools/internal/ant/launchConfigurations/AntBuilderTabGroup.java;1;0;1;1;0;0;0;1;0;0;1;282;0;0;1;0;0;1;1;282;0;282;1;1;
/org.eclipse.jdt.ui/core extension/org/eclipse/jdt/internal/corext/util/TypeInfo.java;1;0;1;1;1;1;1;0;2;0;0;6340;2;2;1;0;0;0;1;6340;0;6340;1;1;
/org.eclipse.jdt.core.tests.model/workspace/Converter/test0116/Test.java;1;0;1;1;0;0;0;1;0;0;1;3714;0;0;1;0;0;1;1;3714;0;3714;1;1;
/org.eclipse.ui.workbench/Eclipse UI/org/eclipse/ui/contexts/IContextManager.java;4;1;28;1;3;3;3;25;130;3;21;1119;375;375;3;4;0;25;28;4949;4;6338;24;4;
/org.eclipse.ui.workbench/Eclipse UI/org/eclipse/ui/internal/csm/commands/Match.java;1;0;1;1;0;0;0;1;0;0;1;2562;0;0;1;0;0;1;1;2562;0;2562;1;1;
/org.eclipse.webdav/src/interface/org/eclipse/webdav/dom/Prop.java;1;0;2;1;2;1;2;0;252;0;0;5151;252;252;2;0;1;0;2;5151;1;5151;1;1;
/org.eclipse.ui.ide/src/org/eclipse/ui/IMarkerActionFilter.java;2;0;2;1;0;0;0;2;0;1;2;1511;0;0;1;0;0;2;2;1511;0;2263;2;2;
/org.eclipse.update.ui/src/org/eclipse/update/internal/ui/model/SiteBookmark.java;3;1;10;1;3;3;3;7;31;1;7;200;122;122;1;0;0;7;10;200;0;6336;10;3;
/org.eclipse.ui.intro/src/org/eclipse/ui/internal/intro/impl/model/IntroLink.java;2;1;6;1;6;6;6;0;36;0;0;5115;69;69;1;0;0;0;6;5115;0;6251;6;2;
/org.eclipse.swt/Eclipse SWT/gtk/org/eclipse/swt/widgets/Menu.java;6;1;16;1;2;2;2;14;55;2;13;33;182;182;2;1;0;14;16;4128;1;6352;15;6;
/org.eclipse.jdt.debug.ui/ui/org/eclipse/jdt/internal/debug/ui/TypeNameResolver.java;2;0;2;1;0;0;0;2;2;1;2;4175;2;2;1;0;0;2;2;4175;0;4188;2;2;
/org.eclipse.debug.ui/ui/org/eclipse/debug/internal/ui/console/ShowConsoleAction.java;2;0;3;1;0;0;0;3;6;1;3;1317;6;6;1;0;0;3;3;1317;0;2060;3;2;
/org.eclipse.jdt.core.tests.model/workspace/Converter15/src/test0014/X.java;1;0;1;1;0;0;0;1;0;0;1;4716;0;0;1;0;0;1;1;4716;0;4716;1;1;
/org.eclipse.jdt.core.tests.model/workspace/Converter15/src/test0029/ArrayList.java;1;0;1;1;1;1;1;0;0;0;0;5182;0;0;1;0;0;0;1;5182;0;5182;1;1;
/org.eclipse.core.runtime.compatibility/src-runtime/org/eclipse/core/runtime/IPluginPrerequisite.java;2;0;4;1;0;0;0;4;182;1;4;3013;189;189;1;0;0;4;4;3013;0;3169;4;2;
/org.eclipse.jdt.core.tests.model/workspace/Converter/test0077/Test.java;1;0;1;1;0;0;0;1;0;0;1;3714;0;0;1;0;0;1;1;3714;0;3714;1;1;
/org.eclipse.jdt.ui/core refactoring/org/eclipse/jdt/internal/corext/refactoring/reorg/DeleteSourceReferenceEdit.java;2;0;7;1;0;0;0;7;23;2;6;305;68;68;2;1;0;7;7;1946;1;1946;6;2;
/org.eclipse.jdt.core.tests.model/workspace/Formatter/test469/A_in.java;1;0;1;1;0;0;0;1;0;0;1;3940;0;0;1;0;0;1;1;3940;0;3940;1;1;
/org.eclipse.jdt.debug.ui/ui/org/eclipse/jdt/internal/debug/ui/launchConfigurations/ClasspathContentProvider.java;1;0;3;1;0;0;0;3;44;0;1;2685;44;44;3;2;0;3;3;2685;2;2685;1;1;
/org.eclipse.core.tests.resources/src/org/eclipse/core/tests/internal/localstore/FileSystemResourceManagerTest.java;1;0;3;1;2;1;2;1;829;0;1;4972;853;853;2;0;1;1;3;5147;1;5147;2;1;
/org.eclipse.jdt.core/dom/org/eclipse/jdt/core/internal/dom/rewrite/NodeRewriteEvent.java;1;0;2;1;0;0;0;2;0;1;2;4711;0;0;1;0;0;2;2;4711;0;4802;2;1;
/org.eclipse.swt/Eclipse SWT Browser/mozilla/org/eclipse/swt/browser/PromptServiceFactory.java;2;0;2;1;1;1;1;1;6;0;1;4853;6;6;1;0;0;1;2;4853;0;6352;2;2;
/org.eclipse.compare/compare/org/eclipse/compare/internal/CompareUIPlugin.java;1;1;13;1;6;6;6;7;472;2;5;1217;926;926;2;2;0;7;13;1217;2;6354;11;1;
/org.eclipse.ui.workbench/Eclipse UI/org/eclipse/ui/internal/ViewTitleHandler.java;1;0;1;1;0;0;0;1;0;0;1;2742;0;0;1;0;0;1;1;2742;0;2742;1;1;
/org.eclipse.team.ui/src/org/eclipse/team/ui/synchronize/subscriber/SubscriberAction.java;2;0;3;1;0;0;0;3;184;1;3;3972;184;184;1;0;0;3;3;3972;0;4588;3;2;
/org.eclipse.jdt.core.tests.model/workspace/Converter/test0062/Test.java;1;0;1;1;0;0;0;1;0;0;1;3714;0;0;1;0;0;1;1;3714;0;3714;1;1;
/org.eclipse.jdt.core.tests.model/workspace/Resolve/src/ResolveMethodDeclarationInInterface.java;1;0;1;1;0;0;0;1;0;0;1;3254;0;0;1;0;0;1;1;3254;0;3254;1;1;
/org.eclipse.core.resources/src/org/eclipse/core/resources/ISavedState.java;1;0;2;1;1;1;1;1;130;0;1;4994;142;142;1;0;0;1;2;4994;0;5146;2;1;
/org.eclipse.jdt.core.tests.model/workspace/Converter/test0072/Test.java;1;0;1;1;0;0;0;1;0;0;1;3714;0;0;1;0;0;1;1;3714;0;3714;1;1;
/org.eclipse.jdt.core/search/org/eclipse/jdt/internal/core/index/IIndex.java;1;0;3;1;0;0;0;3;22;1;3;3218;25;25;1;0;0;3;3;3218;0;3384;3;1;
/org.eclipse.jdt.ui.tests.refactoring/resources/ChangeSignature/canModify/A_test13_out.java;1;0;1;1;0;0;0;1;6;0;1;824;6;6;1;0;0;1;1;824;0;824;1;1;
/org.eclipse.update.ui/srcnew/org/eclipse/update/internal/ui/wizards/DuplicateConflictsDialog2.java;3;0;5;1;0;0;0;5;69;1;5;367;81;81;1;0;0;5;5;367;0;825;5;3;
/org.eclipse.swt/Eclipse SWT Printing/win32/org/eclipse/swt/printing/PrintDialog.java;2;1;4;1;2;2;2;2;33;0;1;4331;45;45;2;1;0;2;4;4331;1;6352;3;2;
/org.eclipse.jdt.ui/core refactoring/org/eclipse/jdt/internal/corext/refactoring/changes/DynamicValidationStateChange.java;1;1;2;1;2;2;2;0;169;0;0;5244;169;169;1;0;0;0;2;5244;0;5269;2;1;
/org.eclipse.osgi.tests/src/org/eclipse/osgi/tests/services/datalocation/SimpleTests.java;2;1;5;1;4;4;4;1;104;0;1;4705;140;140;1;0;0;1;5;4705;0;5925;5;2;
/org.eclipse.jdt.core/model/org/eclipse/jdt/internal/core/SearchableEnvironment.java;4;1;9;2;4;4;4;5;23;2;4;1111;50;50;2;1;0;5;9;3606;1;5916;8;4;
/org.eclipse.team.cvs.ui/src/org/eclipse/team/internal/ccvs/ui/RemoteFileEditorInput.java;2;1;4;1;2;2;2;2;24;1;2;784;39;39;1;0;0;2;4;784;0;6337;4;2;
/org.eclipse.jface/src/org/eclipse/jface/viewers/CheckboxTreeViewer.java;2;1;4;1;3;3;3;1;40;0;1;2609;75;75;1;0;0;1;4;2609;0;6338;4;2;
/org.eclipse.team.ui/src/org/eclipse/team/ui/synchronize/AbstractSynchronizeLabelDecorator.java;2;2;3;2;3;2;3;0;60;0;0;5118;60;60;2;0;1;0;3;5358;1;5358;2;2;
/org.eclipse.jdt.core/formatter/org/eclipse/jdt/code/formatter/CodeFormatter.java;1;0;1;1;0;0;0;1;0;0;1;2178;0;0;1;0;0;1;1;2178;0;2178;1;1;
/org.eclipse.jdt.core/search/org/eclipse/jdt/internal/core/search/matching/SearchPattern.java;3;0;24;1;0;0;0;24;942;3;22;77;1500;1500;3;2;0;24;24;1172;2;3211;22;3;
/org.eclipse.pde.ui/src_ant/org/eclipse/pde/internal/ui/ant/SiteBuildListener.java;1;0;1;1;0;0;0;1;0;0;1;2319;0;0;1;0;0;1;1;2319;0;2319;1;1;
/org.eclipse.jdt.ui/core refactoring/org/eclipse/jdt/internal/corext/refactoring/base/StringContext.java;1;0;1;1;0;0;0;1;0;0;1;882;0;0;1;0;0;1;1;882;0;882;1;1;
/org.eclipse.ui.workbench/Eclipse UI/org/eclipse/ui/internal/keys/GnomeKeyFormatter.java;1;0;2;1;0;0;0;2;6;1;2;3329;6;6;1;0;0;2;2;3329;0;3350;2;1;
/org.eclipse.jdt.ui.tests.refactoring/resources/ExtractMethodWorkSpace/ExtractMethodTests/return_in/A_test711.java;1;0;1;1;0;0;0;1;4;0;1;844;4;4;1;0;0;1;1;844;0;844;1;1;
/org.eclipse.pde.ui/src/org/eclipse/pde/internal/ui/wizards/imports/PluginImportWizard.java;2;1;15;1;2;2;2;13;138;2;12;368;347;347;2;1;0;13;15;731;1;6336;14;2;
/org.eclipse.team.core/src/org/eclipse/team/core/synchronize/ResourceVariant.java;1;0;1;1;0;0;0;1;0;0;1;4072;0;0;1;0;0;1;1;4072;0;4072;1;1;
/org.eclipse.pde.ui/templates_3.0/editor/java/ColorManager.java;1;0;1;1;0;0;0;1;0;0;1;2786;0;0;1;0;0;1;1;2786;0;2786;1;1;
/org.eclipse.update.ui.win32/src/org/eclipse/welcome/internal/portal/WelcomeForm.java;1;0;2;1;0;0;0;2;0;0;1;907;0;0;2;1;0;2;2;907;1;907;1;1;
/org.eclipse.jdt.core.tests.model/workspace/Formatter/test324/A_in.java;1;0;1;1;0;0;0;1;0;0;1;2528;0;0;1;0;0;1;1;2528;0;2528;1;1;
/org.eclipse.jdt.ui.tests.refactoring/resources/IntroduceFactory/positive/differentArgs1.java;1;0;2;1;0;0;0;2;0;1;2;2846;0;0;1;0;0;2;2;2846;0;2862;2;1;
/org.eclipse.ui.workbench/Eclipse UI/org/eclipse/ui/internal/commands/old/ContextAndHandlerManager.java;1;0;11;1;0;0;0;11;225;3;7;1222;292;292;3;4;0;11;11;1222;4;1695;7;1;
/org.eclipse.team.core/src/org/eclipse/team/internal/core/subscribers/SubscriberEventHandler.java;2;1;10;1;3;3;3;7;431;1;7;3550;574;574;1;0;0;7;10;3550;0;6336;10;2;
/org.eclipse.ui.workbench/Eclipse UI/org/eclipse/ui/dialogs/WizardNewProjectReferencePage.java;1;0;1;1;0;0;0;1;0;0;1;2737;0;0;1;0;0;1;1;2737;0;2737;1;1;
/org.eclipse.debug.ui/ui/org/eclipse/debug/internal/ui/ColorManager.java;2;1;3;1;2;2;2;1;4;0;1;4496;4;4;1;0;0;1;3;4496;0;6336;3;2;
/org.eclipse.swt/Eclipse SWT/common/org/eclipse/swt/events/MouseAdapter.java;2;0;2;1;1;1;1;1;4;0;1;4062;6;6;1;0;0;1;2;4062;0;6352;2;2;
/org.eclipse.jface.text/src/org/eclipse/jface/text/source/IAnnotationAccess.java;2;1;4;1;2;2;2;2;17;1;2;3086;23;23;1;0;0;2;4;3086;0;6361;4;2;
/org.eclipse.ui.workbench/Eclipse UI/org/eclipse/ui/internal/WorkbenchWindowLayout.java;1;0;1;1;0;0;0;1;0;0;1;2708;0;0;1;0;0;1;1;2708;0;2708;1;1;
/org.eclipse.update.ui.forms/Eclipse Forms/org/eclipse/ui/forms/widgets/Section.java;1;0;2;1;0;0;0;2;0;1;2;3138;0;0;1;0;0;2;2;3138;0;4157;2;1;
/org.eclipse.jdt.ui/ui/org/eclipse/jdt/internal/ui/packageview/PackageFragmentProvider.java;3;0;3;1;1;1;1;2;4;1;2;1336;10;10;1;0;0;2;3;1336;0;6340;3;3;
/org.eclipse.jdt.ui/core extension/org/eclipse/text/edits/CopyRangeMarker.java;1;0;3;1;0;0;0;3;40;1;3;1953;40;40;1;0;0;3;3;1953;0;1985;3;1;
/org.eclipse.ui.tests/Eclipse UI Tests/org/eclipse/ui/tests/themes/ThemeAPITest.java;1;0;2;1;1;1;1;1;209;0;1;5025;209;209;1;0;0;1;2;5025;0;5938;2;1;
/org.eclipse.ui.workbench/Eclipse UI/org/eclipse/ui/keys/KeySequenceText.java;1;0;2;1;0;0;0;2;0;1;2;3009;0;0;1;0;0;2;2;3009;0;3048;2;1;
/org.eclipse.jdt.ui.examples.javafamily/coresearch-experiment/org/eclipse/search/core/SearchMatch.java;1;0;2;1;0;0;0;2;0;1;2;1380;0;0;1;0;0;2;2;1380;0;3214;2;1;
/org.eclipse.jdt.debug/model/org/eclipse/jdt/internal/debug/core/logicalstructures/MapEntryStructureType.java;1;0;2;1;0;0;0;2;4;1;2;2647;4;4;1;0;0;2;2;2647;0;2709;2;1;
/org.eclipse.jdt.core.tests.model/workspace/Formatter/test427/A_out.java;1;0;1;1;0;0;0;1;0;0;1;3478;0;0;1;0;0;1;1;3478;0;3478;1;1;
/org.eclipse.jdt.core/model/org/eclipse/jdt/core/ITypeHierarchy.java;1;0;3;1;0;0;0;3;14;1;3;2583;23;23;1;0;0;3;3;2583;0;3560;3;1;
/org.eclipse.jdt.core.tests.model/workspace/Formatter/test099/A_in.java;1;0;1;1;0;0;0;1;0;0;1;2425;0;0;1;0;0;1;1;2425;0;2425;1;1;
/org.eclipse.ui.workbench/Eclipse UI/org/eclipse/ui/dialogs/MarkerResolutionSelectionDialog.java;1;0;1;1;0;0;0;1;0;0;1;2737;0;0;1;0;0;1;1;2737;0;2737;1;1;
/org.eclipse.pde.ui/src/org/eclipse/pde/internal/ui/editor/schema/DescriptionSection.java;3;1;10;1;4;4;4;6;73;1;6;217;160;160;1;0;0;6;10;217;0;6336;10;3;
/org.eclipse.jdt.ui.tests.refactoring/resources/ExtractMethodWorkSpace/ExtractMethodTests/locals_out/A_test540.java;1;0;2;1;0;0;0;2;4;1;2;130;5;5;1;0;0;2;2;130;0;844;2;1;
/org.eclipse.jdt.core.tests.model/workspace/Converter/test0495/A.java;1;0;2;1;0;0;0;2;0;1;2;1950;0;0;1;0;0;2;2;1950;0;3714;2;1;
/org.eclipse.team.ui/src/org/eclipse/team/internal/ui/sync/actions/SyncViewerSubscriberActions.java;2;0;5;1;0;0;0;5;112;1;5;566;124;124;1;0;0;5;5;566;0;1477;5;2;
/org.eclipse.jdt.debug.tests/tests/org/eclipse/jdt/debug/tests/eval/TestsOperators2.java;1;0;1;1;0;0;0;1;8;0;1;1274;8;8;1;0;0;1;1;1274;0;1274;1;1;
/org.eclipse.ui.workbench/Eclipse UI/org/eclipse/ui/internal/actions/ActivityEnablementAction.java;3;0;5;2;0;0;0;5;8;2;3;2443;10;10;2;2;0;5;5;2443;2;4651;3;3;
/org.eclipse.ui.workbench/Eclipse UI/org/eclipse/ui/actions/BaseSelectionListenerAction.java;2;0;4;1;1;1;1;3;123;1;3;2611;181;181;1;0;0;3;4;2611;0;5823;4;2;
/org.eclipse.pde.ui/templates/editor/java/XMLWhitespaceDetector.java;1;0;1;1;0;0;0;1;10;0;1;851;10;10;1;0;0;1;1;851;0;851;1;1;
/org.eclipse.team.tests.cvs.core/src/org/eclipse/team/tests/ccvs/ui/old/CVSUITestCase.java;1;0;4;1;0;0;0;4;23;1;4;2632;25;25;1;0;0;4;4;2632;0;4216;4;1;
/org.eclipse.pde.ui/src_Forms/org/eclipse/pde/internal/ui/neweditor/plugin/ResourceAttributeRow.java;1;0;2;1;0;0;0;2;0;1;2;3834;0;0;1;0;0;2;2;3834;0;4354;2;1;
/org.eclipse.swt/Eclipse SWT/win32/org/eclipse/swt/graphics/Cursor.java;4;1;9;1;2;2;2;7;125;3;5;246;204;204;3;2;0;7;9;246;2;6352;7;4;
/org.eclipse.swt/Eclipse SWT/gtk1x/org/eclipse/swt/widgets/TreeItem.java;1;0;1;1;0;0;0;1;0;0;1;2327;0;0;1;0;0;1;1;2327;0;2327;1;1;
/org.eclipse.jdt.ui.tests.refactoring/resources/ChangeTypeRefactoring/positive/A_testFieldType_out.java;1;0;1;1;0;0;0;1;0;0;1;2844;0;0;1;0;0;1;1;2844;0;2844;1;1;
/org.eclipse.jdt.ui/core refactoring/org/eclipse/jdt/internal/corext/refactoring/participants/xml/JavaMemberExtender.java;1;0;5;1;0;0;0;5;17;1;5;2546;31;31;1;0;0;5;5;2546;0;4941;5;1;
/org.eclipse.jdt.debug.tests/testprograms/BreakpointsLocation.java;1;0;2;1;0;0;0;2;18;1;2;2555;18;18;1;0;0;2;2;2555;0;3276;2;1;
/org.eclipse.jdt.debug.tests/test plugin/org/eclipse/jdt/debug/testplugin/ExpressionWaiter.java;1;0;1;1;0;0;0;1;0;0;1;1794;0;0;1;0;0;1;1;1794;0;1794;1;1;
/org.eclipse.jdt.core.tests.model/workspace/Formatter/test383/A_out.java;1;0;1;1;0;0;0;1;0;0;1;3163;0;0;1;0;0;1;1;3163;0;3163;1;1;
/org.eclipse.jdt.ui.tests.refactoring/resources/MoveInstanceMethod/canMove/test24/in/StarDecorator.java;1;0;1;1;0;0;0;1;0;0;1;1627;0;0;1;0;0;1;1;1627;0;1627;1;1;
/org.eclipse.jdt.core.tests.model/workspace/Converter/test0218/Test.java;1;0;1;1;0;0;0;1;0;0;1;3714;0;0;1;0;0;1;1;3714;0;3714;1;1;
/org.eclipse.debug.core/core/org/eclipse/debug/core/variables/DefaultVariableExpander.java;3;0;4;1;0;0;0;4;13;1;4;562;18;18;1;0;0;4;4;562;0;2120;4;3;
/org.eclipse.jdt.ui/ui/org/eclipse/jdt/ui/actions/OpenJavaBrowsingPerspectiveAction.java;1;0;1;1;1;1;1;0;2;0;0;6340;2;2;1;0;0;0;1;6340;0;6340;1;1;
/org.eclipse.team.cvs.ui/src/org/eclipse/team/internal/ccvs/ui/sync/CVSSyncCompareInput.java;2;0;2;1;0;0;0;2;33;1;2;1672;33;33;1;0;0;2;2;1672;0;4217;2;2;
/org.eclipse.ui.workbench/Eclipse UI/org/eclipse/ui/internal/activities/ws/ActivityEnabler.java;3;1;11;1;3;3;3;8;283;1;8;3066;505;505;1;0;0;8;11;3066;0;6338;11;3;
/org.eclipse.jdt.debug.tests/tests/org/eclipse/jdt/debug/tests/eval/TypeHierarchy_68_2.java;1;0;1;1;0;0;0;1;16;0;1;1274;16;16;1;0;0;1;1;1274;0;1274;1;1;
/org.eclipse.core.tests.resources/src/org/eclipse/core/tests/resources/usecase/Snapshot4Test.java;1;0;3;1;3;1;3;0;259;0;0;5147;259;259;3;0;2;0;3;5147;2;5147;1;1;
/org.eclipse.jdt.core.tests.model/workspace/Converter/junit/runner/ReloadingTestSuiteLoader.java;1;0;2;1;0;0;0;2;12;1;2;787;12;12;1;0;0;2;2;787;0;3714;2;1;
/org.eclipse.jdt.ui/ui/org/eclipse/jdt/internal/ui/packageview/FileTransferDropAdapter.java;2;0;3;1;1;1;1;2;96;1;2;1183;104;104;1;0;0;2;3;1183;0;6340;3;2;
/org.eclipse.webdav/src/kernel/org/eclipse/webdav/internal/kernel/utils/SimpleISO8601DateFormat.java;1;1;2;1;2;2;2;0;425;0;0;5151;425;425;1;0;0;0;2;5151;0;5760;2;1;
/org.eclipse.pde.ui/src_Forms/org/eclipse/pde/internal/ui/neweditor/feature/RequiredFeaturesWizard.java;2;0;2;1;1;1;1;1;0;0;1;4926;0;0;1;0;0;1;2;4926;0;5431;2;2;
/org.eclipse.jdt.ui/core refactoring/org/eclipse/jdt/internal/corext/refactoring/reorg2/CopyToClipboardAction.java;2;0;11;1;0;0;0;11;155;3;7;469;368;368;3;4;0;11;11;483;4;1112;7;2;
/org.eclipse.ui.tests/Eclipse UI Tests/org/eclipse/ui/tests/adaptable/AdaptedResourceNavigator.java;2;1;2;1;2;2;2;0;7;0;0;5899;9;9;1;0;0;0;2;5899;0;6338;2;2;
/org.eclipse.debug.core/core/org/eclipse/debug/internal/core/sourcelookup/AbstractSourceLookupDirector.java;1;0;12;1;0;0;0;12;94;2;10;3678;316;316;2;2;0;12;12;4109;2;4949;10;1;
/org.eclipse.jdt.core.tests.model/workspace/Formatter/test154/A_in.java;1;0;1;1;0;0;0;1;0;0;1;2425;0;0;1;0;0;1;1;2425;0;2425;1;1;
/org.eclipse.jdt.ui/ui refactoring/org/eclipse/jdt/internal/ui/refactoring/contentassist/JavaPackageCompletionProcessor.java;5;2;9;2;5;4;5;4;29;1;4;3670;94;94;2;0;1;4;9;5197;1;6340;8;5;
/org.eclipse.team.cvs.ui/src/org/eclipse/team/internal/ccvs/ui/operations/UpdateOperation.java;2;1;14;1;6;6;6;8;86;1;8;1591;236;236;1;0;0;8;14;1591;0;6337;14;2;
/org.eclipse.ui.presentations.r21/src/org/eclipse/ui/internal/presentations/r21/widgets/CTabFolderEvent.java;1;1;2;1;2;2;2;0;2;0;0;6075;2;2;1;0;0;0;2;6075;0;6338;2;1;
/org.eclipse.help/src/org/eclipse/help/internal/context/ContextsFile.java;1;1;3;1;2;2;2;1;30;0;1;4468;50;50;1;0;0;1;3;4468;0;6337;3;1;
/org.eclipse.team.cvs.core/src/org/eclipse/team/internal/ccvs/core/CVSException.java;2;0;2;1;0;0;0;2;31;1;2;790;33;33;1;0;0;2;2;790;0;883;2;2;
/org.eclipse.team.core/src/org/eclipse/team/core/subscribers/TeamSubscriberSyncInfoCollector.java;1;0;1;1;0;0;0;1;0;0;1;3550;0;0;1;0;0;1;1;3550;0;3550;1;1;
/org.eclipse.pde.ui/src_Forms/org/eclipse/pde/internal/ui/model/IDocumentAttribute.java;2;1;5;1;3;3;3;2;10;1;2;4438;19;19;1;0;0;2;5;4438;0;6336;5;2;
/org.eclipse.jdt.ui.tests.refactoring/resources/ExtractInterface/test87/in/A.java;1;0;1;1;0;0;0;1;2;0;1;1166;2;2;1;0;0;1;1;1166;0;1166;1;1;
/org.eclipse.ui.workbench/Eclipse UI/org/eclipse/ui/internal/actions/ProjectPropertyDialogAction.java;1;0;1;1;0;0;0;1;0;0;1;2737;0;0;1;0;0;1;1;2737;0;2737;1;1;
/org.eclipse.team.cvs.ui/src/org/eclipse/team/internal/ccvs/ui/merge/TagRootElement.java;2;1;3;1;2;2;2;1;16;0;1;5039;20;20;1;0;0;1;3;5039;0;6337;3;2;
/org.eclipse.pde.core/src/org/eclipse/pde/internal/core/PDEClasspathContainer.java;2;1;2;1;2;2;2;0;4;0;0;5760;4;4;1;0;0;0;2;5760;0;6336;2;2;
/org.eclipse.ui.workbench/Eclipse UI/org/eclipse/ui/internal/dialogs/StartupPreferencePage.java;2;1;4;1;2;2;2;2;68;1;2;4719;97;97;1;0;0;2;4;4719;0;6338;4;2;
/org.eclipse.jdt.core/compiler/org/eclipse/jdt/internal/compiler/ast/FieldDeclaration.java;3;0;18;2;1;1;1;17;65;2;15;13;225;225;2;2;0;17;18;13;2;5225;16;3;
/org.eclipse.jface.text/src/org/eclipse/jface/text/source/IAnnotationAccessExtension.java;3;1;9;1;4;4;4;5;31;1;5;1702;89;89;1;0;0;5;9;1702;0;6361;9;3;
/org.eclipse.jdt.core.tests.model/workspace/Formatter/test243/A_in.java;1;0;1;1;0;0;0;1;0;0;1;2437;0;0;1;0;0;1;1;2437;0;2437;1;1;
/org.eclipse.pde.core/src/org/eclipse/pde/internal/core/osgi/bundle/BundleModel.java;2;0;5;1;1;1;1;4;119;1;4;4203;123;123;1;0;0;4;5;4203;0;5445;5;2;
/org.eclipse.ui.ide/src/org/eclipse/ui/wizards/datatransfer/Base64Encoder.java;1;0;1;1;0;0;0;1;0;0;1;1511;0;0;1;0;0;1;1;1511;0;1511;1;1;
/org.eclipse.pde.ui/src/org/eclipse/pde/ui/templates/AbstractTemplateSection.java;3;1;10;1;6;6;6;4;292;1;4;2584;534;534;1;0;0;4;10;2584;0;6336;10;3;
/org.eclipse.ui.workbench/Eclipse UI/org/eclipse/ui/internal/commands/old/KeyPreferencePage.java;1;0;6;1;0;0;0;6;37;2;5;1222;64;64;2;1;0;6;6;1321;1;1695;5;1;
/org.eclipse.ui.workbench.texteditor/src/org/eclipse/ui/texteditor/InsertLineAction.java;3;2;3;2;3;2;3;0;6;0;0;5177;6;6;2;0;1;0;3;6334;1;6334;2;3;
/org.eclipse.jdt.core/search/org/eclipse/jdt/internal/core/index/impl/FileDocument.java;2;0;2;1;0;0;0;2;3;1;2;883;3;3;1;0;0;2;2;883;0;3240;2;2;
/org.eclipse.jdt.core.tests.model/workspace/Converter/test0392/A.java;1;0;1;1;0;0;0;1;0;0;1;3714;0;0;1;0;0;1;1;3714;0;3714;1;1;
/org.eclipse.pde.runtime/src/org/eclipse/pde/internal/runtime/registry/LibraryPropertySource.java;2;1;5;1;2;2;2;3;96;1;3;924;215;215;1;0;0;3;5;924;0;6336;5;2;
/org.eclipse.team.examples.filesystem/src/org/eclipse/team/examples/pessimistic/ResourceChangeListener.java;1;0;2;1;1;1;1;1;294;0;1;3368;294;294;1;0;0;1;2;3368;0;6103;2;1;
/org.eclipse.jdt.core.tests.compiler/src/org/eclipse/jdt/core/tests/compiler/parser/SourceMethod.java;1;0;2;1;0;0;0;2;25;1;2;241;27;27;1;0;0;2;2;241;0;3560;2;1;
/org.eclipse.swt/Eclipse SWT PI/photon/org/eclipse/swt/internal/photon/PtTextCallback_t.java;1;0;1;1;0;0;0;1;2;0;1;808;2;2;1;0;0;1;1;808;0;808;1;1;
/org.eclipse.ui.workbench/Eclipse UI/org/eclipse/ui/internal/keys/EmacsKeyFormatter.java;1;0;2;1;0;0;0;2;6;1;2;3310;6;6;1;0;0;2;2;3310;0;3350;2;1;
/org.eclipse.debug.ui/ui/org/eclipse/debug/ui/variables/LaunchConfigurationVariableRegistry.java;1;0;2;1;0;0;0;2;2;1;2;323;2;2;1;0;0;2;2;323;0;550;2;1;
/org.eclipse.swt/Eclipse SWT/win32/org/eclipse/swt/graphics/GCData.java;2;0;3;1;0;0;0;3;2;1;3;332;6;6;1;0;0;3;3;332;0;2610;3;2;
/org.eclipse.pde.runtime/src/org/eclipse/pde/internal/runtime/OverlayIcon.java;1;0;1;1;0;0;0;1;7;0;1;924;7;7;1;0;0;1;1;924;0;924;1;1;
/org.eclipse.jdt.core/formatter/org/eclipse/jdt/internal/formatter/FormattingPreferences.java;2;0;21;1;0;0;0;21;547;3;17;535;732;732;3;4;0;21;21;881;4;2203;17;2;
/org.eclipse.team.ftp/src/org/eclipse/team/internal/ftp/subscriber/SyncBytesComparisonCriteria.java;1;0;1;1;0;0;0;1;0;0;1;3376;0;0;1;0;0;1;1;3376;0;3376;1;1;
/org.eclipse.jdt.ui.tests.refactoring/resources/SurroundWithWorkSpace/SurroundWithTests/trycatch_out/TestOneLine.java;2;0;3;1;0;0;0;3;4;1;3;845;12;12;1;0;0;3;3;845;0;4647;3;2;
/org.eclipse.core.tests.resources/src/org/eclipse/core/tests/internal/builders/DeltaVerifierBuilder.java;2;0;3;1;1;1;1;2;408;1;2;1098;432;432;1;0;0;2;3;1098;0;5147;3;2;
/org.eclipse.ui.ide/src/org/eclipse/ui/internal/ide/dialogs/InternalErrorDialog.java;1;0;1;1;0;0;0;1;0;0;1;2264;0;0;1;0;0;1;1;2264;0;2264;1;1;
/org.eclipse.debug.ui/ui/org/eclipse/debug/internal/ui/views/variables/ToggleObjectBrowsersAction.java;2;0;4;1;0;0;0;4;30;1;4;861;33;33;1;0;0;4;4;861;0;2647;4;2;
/org.eclipse.ui.workbench/Eclipse UI/org/eclipse/ui/contexts/ws/IWorkbenchPageContextSupport.java;1;0;1;1;0;0;0;1;0;0;1;3066;0;0;1;0;0;1;1;3066;0;3066;1;1;
/org.eclipse.core.tests.resources/src/org/eclipse/core/tests/resources/LinkedResourceTest.java;2;3;6;1;4;2;4;2;207;1;2;2549;322;322;3;0;2;2;6;5147;2;5897;4;2;
/org.eclipse.core.runtime.compatibility/src-runtime/org/eclipse/core/internal/plugins/Extension.java;2;0;3;1;0;0;0;3;1;1;3;3013;1;1;1;0;0;3;3;3013;0;3169;3;2;
/org.eclipse.core.tools/src/org/eclipse/core/tools/runtime/PluginDataSheetView.java;1;0;1;1;1;1;1;0;0;0;0;6302;0;0;1;0;0;0;1;6302;0;6302;1;1;
/org.eclipse.jdt.core/eval/org/eclipse/jdt/internal/eval/IRequestor.java;1;0;1;1;0;0;0;1;2;0;1;3560;2;2;1;0;0;1;1;3560;0;3560;1;1;
/org.eclipse.pde.ui/src/org/eclipse/pde/internal/ui/wizards/imports/FeatureImportWizardDetailedPage.java;2;1;6;1;3;3;3;3;283;1;3;368;314;314;1;0;0;3;6;368;0;6336;6;2;
/org.eclipse.ant.ui/Ant Tools Support/org/eclipse/ant/internal/ui/preferences/AntClasspathLabelProvider.java;1;1;6;1;2;2;2;4;99;1;4;1811;136;136;1;0;0;4;6;1811;0;5581;6;1;
/org.eclipse.help/src/org/eclipse/help/internal/context/ContextsFileParser.java;1;1;7;1;4;4;4;3;84;1;3;2407;182;182;1;0;0;3;7;2407;0;6337;7;1;
/org.eclipse.ui.workbench/Eclipse UI/org/eclipse/ui/internal/dialogs/MultiStepConfigureWizardPage.java;1;0;1;1;0;0;0;1;0;0;1;2737;0;0;1;0;0;1;1;2737;0;2737;1;1;
/org.eclipse.core.resources/src/org/eclipse/core/internal/resources/SyncInfoReader_2.java;1;0;1;1;1;1;1;0;124;0;0;5146;124;124;1;0;0;0;1;5146;0;5146;1;1;
/org.eclipse.swt/Eclipse SWT/photon/org/eclipse/swt/widgets/Slider.java;3;1;6;1;2;2;2;4;37;1;4;32;94;94;1;0;0;4;6;32;0;6352;6;3;
/org.eclipse.swt/Eclipse SWT Drag and Drop/gtk/org/eclipse/swt/dnd/RTFTransfer.java;3;0;4;1;1;1;1;3;61;2;2;317;69;69;2;1;0;3;4;317;1;6352;3;3;
/org.eclipse.ui.tutorials.rcp.part2/src/org/eclipse/ui/tutorials/rcp/part2/RcpWorkbenchAdvisor.java;1;1;2;1;2;2;2;0;2;0;0;5118;2;2;1;0;0;0;2;5118;0;5147;2;1;
/org.eclipse.core.runtime.osgi/src/org/eclipse/core/internal/runtime/CipherInputStream.java;1;0;2;1;0;0;0;2;123;1;2;3013;123;123;1;0;0;2;2;3013;0;3030;2;1;
/org.eclipse.team.examples.filesystem/src/org/eclipse/team/examples/localhistory/LocalHistoryPartipant.java;2;1;3;1;3;3;3;0;2;0;0;6305;3;3;1;0;0;0;3;6305;0;6337;3;2;
/org.eclipse.update.core/src/org/eclipse/update/search/BaseFilter.java;1;1;5;1;2;2;2;3;7;1;3;825;11;11;1;0;0;3;5;825;0;6336;5;1;
/org.eclipse.webdav/src/client/org/eclipse/webdav/client/LocalDAVClient.java;1;2;3;1;3;2;3;0;179;0;0;5151;233;233;2;0;1;0;3;5151;1;5969;2;1;
/org.eclipse.team.ui/src/org/eclipse/team/internal/ui/jobs/RefreshSubscriberInputJob.java;2;0;5;1;0;0;0;5;118;1;5;1155;131;131;1;0;0;5;5;1155;0;4216;5;2;
/org.eclipse.team.webdav/src/org/eclipse/team/internal/ui/target/TargetCatchupReleaseViewer.java;2;0;2;1;0;0;0;2;0;1;2;2495;0;0;1;0;0;2;2;2495;0;4216;2;2;
/org.eclipse.jdt.ui/ui/org/eclipse/jdt/internal/ui/viewsupport/MemberFilterAction.java;1;0;1;1;1;1;1;0;2;0;0;6340;2;2;1;0;0;0;1;6340;0;6340;1;1;
/org.eclipse.jdt.ui/ui/org/eclipse/jdt/internal/ui/text/comment/IBorderAttributes.java;2;0;2;1;1;1;1;1;6;0;1;1998;6;6;1;0;0;1;2;1998;0;6340;2;2;
/org.eclipse.team.ui/src/org/eclipse/team/internal/ui/synchronize/RefreshSubscriberJob.java;2;3;20;2;20;14;20;0;175;0;0;5362;491;491;3;0;6;0;20;5438;6;6337;14;2;
/org.eclipse.update.core/src/org/eclipse/update/core/FeatureReference.java;3;2;7;1;5;4;5;2;16;1;2;890;52;52;2;0;1;2;7;5664;1;6336;6;3;
/org.eclipse.swt/Eclipse SWT PI/motif/org/eclipse/swt/internal/motif/XCrossingEvent.java;1;0;2;1;0;0;0;2;12;1;2;825;23;23;1;0;0;2;2;825;0;868;2;1;
/org.eclipse.team.webdav/src/org/eclipse/team/internal/ui/target/subscriber/ImportResourceSelectionPage.java;2;0;3;1;1;1;1;2;29;1;2;3805;31;31;1;0;0;2;3;3805;0;6337;3;2;
/org.eclipse.update.configurator/src/org/eclipse/update/internal/configurator/FullFeatureParser.java;1;1;6;1;3;3;3;3;35;1;3;4951;66;66;1;0;0;3;6;4951;0;5664;6;1;
/org.eclipse.jdt.core/dom/org/eclipse/jdt/core/dom/MethodInvocation.java;3;2;11;1;4;3;4;7;125;1;7;3560;297;297;2;0;1;7;11;5268;1;5335;10;3;
/org.eclipse.swt/Eclipse SWT PI/gtk1x/org/eclipse/swt/internal/gtk/GtkEditable.java;1;0;1;1;0;0;0;1;0;0;1;2327;0;0;1;0;0;1;1;2327;0;2327;1;1;
/org.eclipse.jdt.core/search/org/eclipse/jdt/internal/core/search/PathCollector.java;1;0;2;1;0;0;0;2;127;1;2;3211;129;129;1;0;0;2;2;3211;0;3560;2;1;
/org.eclipse.pde.ui/src/org/eclipse/pde/internal/ui/editor/text/XMLSourceViewerConfiguration.java;1;1;3;1;3;3;3;0;10;0;0;5431;12;12;1;0;0;0;3;5431;0;6336;3;1;
/org.eclipse.jdt.ui/core refactoring/org/eclipse/jdt/internal/corext/refactoring/rename/JavaRenameProcessor.java;1;1;6;1;2;2;2;4;39;1;4;4624;141;141;1;0;0;4;6;4624;0;5176;6;1;
/org.eclipse.team.ui/src/org/eclipse/team/internal/ui/jobs/JobDoneElement.java;1;0;2;1;0;0;0;2;0;1;2;1081;0;0;1;0;0;2;2;1081;0;1369;2;1;
/org.eclipse.ui.ide/src/org/eclipse/ui/wizards/datatransfer/ImportOperation.java;1;0;1;1;0;0;0;1;0;0;1;1511;0;0;1;0;0;1;1;1511;0;1511;1;1;
/org.eclipse.jdt.core.tests.model/workspace/Converter/src/javadoc/test002/Test.java;1;0;1;1;0;0;0;1;0;0;1;3792;0;0;1;0;0;1;1;3792;0;3792;1;1;
/org.eclipse.jdt.core.tests.model/workspace/Converter/src/test0418/A.java;1;0;1;1;0;0;0;1;0;0;1;3714;0;0;1;0;0;1;1;3714;0;3714;1;1;
/org.eclipse.team.tests.cvs.core/src/org/eclipse/team/tests/ccvs/ui/AllUITests.java;2;0;2;1;0;0;0;2;1;1;2;2632;1;1;1;0;0;2;2;2632;0;2762;2;2;
/org.eclipse.jdt.core.tests.model/workspace/Converter/src/test0109/Test.java;1;0;1;1;0;0;0;1;0;0;1;3714;0;0;1;0;0;1;1;3714;0;3714;1;1;
/org.eclipse.update.ui.forms/src/org/eclipse/update/ui/forms/internal/richtext/Paragraph.java;1;0;3;1;0;0;0;3;1;2;2;2849;1;1;2;1;0;3;3;2849;1;2898;2;1;
/org.eclipse.ui.workbench/Eclipse UI/org/eclipse/ui/actions/ExportResourcesAction.java;4;0;5;2;2;1;2;3;118;1;3;2737;147;147;2;0;1;3;5;6338;1;6338;4;4;
/org.eclipse.jdt.core.tests.model/workspace/Completion/src2/CompletionKeywordThis15.java;1;0;1;1;1;1;1;0;0;0;0;5589;0;0;1;0;0;0;1;5589;0;5589;1;1;
/org.eclipse.ui.workbench/Eclipse UI/org/eclipse/ui/internal/roles/Role.java;2;0;12;1;0;0;0;12;279;2;9;1938;570;570;2;3;0;12;12;2443;3;2864;9;2;
/org.eclipse.swt/Eclipse SWT/gtk/org/eclipse/swt/widgets/Button.java;7;1;21;1;3;3;3;18;67;1;18;55;238;238;1;0;0;18;21;55;0;6352;21;7;
/org.eclipse.jdt.core.tests.model/workspace/Converter/src/javadoc/test005/Test.java;1;0;2;1;0;0;0;2;2;0;1;3806;2;2;2;1;0;2;2;3806;1;3806;1;1;
/org.eclipse.ui.workbench/Eclipse UI/org/eclipse/ui/progress/ProgressFeedbackManager.java;1;0;2;1;0;0;0;2;0;1;2;1854;0;0;1;0;0;2;2;1854;0;2177;2;1;
/org.eclipse.swt/Eclipse SWT Printing/common/org/eclipse/swt/printing/PrinterData.java;1;0;2;1;0;0;0;2;2;1;2;2327;4;4;1;0;0;2;2;2327;0;2472;2;1;
/org.eclipse.jdt.core/compiler/org/eclipse/jdt/internal/compiler/impl/DoubleConstant.java;2;0;3;1;1;1;1;2;6;1;2;1111;10;10;1;0;0;2;3;1111;0;5587;3;2;
/org.eclipse.ui.ide/extensions/org/eclipse/ui/dialogs/WizardDataTransferPage.java;3;1;3;1;2;2;2;1;2;0;1;2263;4;4;1;0;0;1;3;2263;0;6338;3;3;
/org.eclipse.jdt.core.tests.model/workspace/Formatter/test002/A_in.java;1;0;1;1;0;0;0;1;0;0;1;2425;0;0;1;0;0;1;1;2425;0;2425;1;1;
/org.eclipse.ui.workbench/Eclipse UI/org/eclipse/ui/internal/TrimLayoutData.java;3;0;4;1;0;0;0;4;60;1;4;4019;63;63;1;0;0;4;4;4019;0;5000;4;3;
/org.eclipse.jdt.debug.tests/tests/org/eclipse/jdt/debug/tests/eval/NestedTypeFieldValue_252.java;1;0;1;1;0;0;0;1;116;0;1;1274;116;116;1;0;0;1;1;1274;0;1274;1;1;
/org.eclipse.jdt.ui/core refactoring/org/eclipse/jdt/internal/corext/refactoring/participants/ObjectStateExpression.java;1;0;4;1;0;0;0;4;20;1;4;591;34;34;1;0;0;4;4;591;0;1033;4;1;
/org.eclipse.ui.intro/src/org/eclipse/ui/intro/internal/model/loader/ModelUtil.java;1;0;2;1;0;0;0;2;0;1;2;4948;0;0;1;0;0;2;2;4948;0;5096;2;1;
/org.eclipse.jdt.ui.tests.refactoring/resources/ExtractMethodWorkSpace/ExtractMethodTests/locals_in/A_test501.java;1;0;1;1;0;0;0;1;4;0;1;844;4;4;1;0;0;1;1;844;0;844;1;1;
/org.eclipse.jdt.ui.tests.refactoring/resources/Copy/test_method_yes_field/in/A.java;1;0;1;1;0;0;0;1;2;0;1;685;2;2;1;0;0;1;1;685;0;685;1;1;
/org.eclipse.core.resources/src/org/eclipse/core/resources/IncrementalProjectBuilder.java;2;1;11;1;3;3;3;8;498;2;7;2011;594;594;2;1;0;8;11;4627;1;5895;10;2;
/org.eclipse.jdt.ui.tests.refactoring/resources/PromoteTempToField/canPromote/A_test21_in.java;1;0;1;1;0;0;0;1;0;0;1;4632;0;0;1;0;0;1;1;4632;0;4632;1;1;
/org.eclipse.jface.text/src/org/eclipse/jface/text/source/IAnnotationModelListener.java;1;0;1;1;1;1;1;0;0;0;0;5382;0;0;1;0;0;0;1;5382;0;5382;1;1;
/org.eclipse.jdt.core.tests.model/workspace/Formatter/test034/A_in.java;1;0;1;1;0;0;0;1;0;0;1;2425;0;0;1;0;0;1;1;2425;0;2425;1;1;
/org.eclipse.ui.workbench/Eclipse UI/org/eclipse/ui/commands/IContextService.java;1;0;5;1;0;0;0;5;14;2;3;767;22;22;2;2;0;5;5;767;2;1119;3;1;
/org.eclipse.team.ui/src/org/eclipse/team/internal/ui/ConfigurationWizardElement.java;1;0;1;1;0;0;0;1;0;0;1;993;0;0;1;0;0;1;1;993;0;993;1;1;
/org.eclipse.jdt.core/compiler/org/eclipse/jdt/internal/compiler/parser/Parser.java;6;1;96;3;7;7;7;89;3023;6;62;13;17349;17349;6;27;0;89;96;1299;27;6141;69;6;
/org.eclipse.ui.workbench/Eclipse UI/org/eclipse/ui/activities/ActivityNotDefinedException.java;1;0;2;1;0;0;0;2;0;1;2;2240;0;0;1;0;0;2;2;2240;0;2532;2;1;
/org.eclipse.jdt.ui.tests.refactoring/resources/DeleteSourceReference/test14/out/A.java;1;0;1;1;0;0;0;1;0;0;1;1652;0;0;1;0;0;1;1;1652;0;1652;1;1;
/org.eclipse.team.ui/src/org/eclipse/team/internal/ui/synchronize/views/CompressedFolder.java;1;0;3;1;0;0;0;3;52;1;3;2535;52;52;1;0;0;3;3;2535;0;4216;3;1;
/org.eclipse.jdt.debug.tests/testprograms/FloodConsole.java;1;0;1;1;0;0;0;1;0;0;1;2149;0;0;1;0;0;1;1;2149;0;2149;1;1;
/org.eclipse.ui.ide/src/org/eclipse/ui/internal/registry/MarkerHelpRegistryReader.java;2;0;6;1;0;0;0;6;13;1;6;1526;21;21;1;0;0;6;6;1526;0;2263;6;2;
/org.eclipse.core.resources/src/org/eclipse/core/resources/IResourceProxy.java;1;0;2;1;1;1;1;1;19;0;1;4994;37;37;1;0;0;1;2;4994;0;5146;2;1;
/org.eclipse.ui.workbench/Eclipse UI/org/eclipse/ui/internal/keys/NativeModifierKeyComparator.java;1;0;1;1;0;0;0;1;0;0;1;3310;0;0;1;0;0;1;1;3310;0;3310;1;1;
/org.eclipse.text/src/org/eclipse/jface/text/link/LinkedModeModel.java;3;2;6;1;6;5;6;0;23;0;0;5128;44;44;2;0;1;0;6;5177;1;6340;5;3;
/org.eclipse.core.tests.runtime/src/org/eclipse/core/tests/runtime/DynamicPluginTest.java;3;1;7;1;5;5;5;2;41;1;2;4941;75;75;1;0;0;2;7;4941;0;6201;7;3;
/org.eclipse.ui.workbench/Eclipse UI/org/eclipse/ui/commands/old/CommandHandlerServiceEvent.java;1;0;2;1;0;0;0;2;0;0;1;1222;0;0;2;1;0;2;2;1222;1;1222;1;1;
/org.eclipse.pde.core/src/org/eclipse/pde/internal/core/schema/SchemaCompositor.java;3;1;4;1;2;2;2;2;43;1;2;4203;55;55;1;0;0;2;4;4203;0;6336;4;3;
/org.eclipse.update.tests.core/src/org/eclipse/update/tests/sitevalidation/TestSiteValidation.java;1;3;8;1;7;5;7;1;23;0;1;3046;86;86;3;0;2;1;8;5250;2;6336;6;1;
/org.eclipse.update.ui/src/org/eclipse/update/internal/ui/forms/IUpdateForm.java;1;0;1;1;0;0;0;1;0;0;1;755;0;0;1;0;0;1;1;755;0;755;1;1;
/org.eclipse.ui.workbench.texteditor/src/org/eclipse/ui/internal/texteditor/quickdiff/QuickDiffMessages.java;2;0;3;1;1;1;1;2;6;1;2;1644;8;8;1;0;0;2;3;1644;0;6340;3;2;
/org.eclipse.update.core/src/org/eclipse/update/internal/operations/OperationValidator.java;2;2;29;1;6;5;6;23;303;3;20;825;1593;1593;3;3;1;23;29;3014;4;6336;25;2;
/org.eclipse.pde.ui/srcnew/org/eclipse/pde/internal/ui/editor/manifest/XMLReconcilingStrategy.java;1;0;1;1;0;0;0;1;0;0;1;2320;0;0;1;0;0;1;1;2320;0;2320;1;1;
/org.eclipse.jface.text/src/org/eclipse/jface/text/source/IOverviewRuler.java;2;1;2;1;2;2;2;0;6;0;0;6340;8;8;1;0;0;0;2;6340;0;6361;2;2;
/org.eclipse.update.ui/src/org/eclipse/update/internal/ui/DeltaWizardAction.java;1;0;2;1;0;0;0;2;10;1;2;890;10;10;1;0;0;2;2;890;0;1180;2;1;
/org.eclipse.help/src/org/eclipse/help/internal/search/HTMLDocParser.java;1;0;2;1;0;0;0;2;2;1;2;2609;2;2;1;0;0;2;2;2609;0;2732;2;1;
/org.eclipse.ant.ui/Ant Tools Support/org/eclipse/ant/internal/ui/launchConfigurations/TargetTableLabelProvider.java;1;0;4;1;1;1;1;3;4;1;3;1811;7;7;1;0;0;3;4;1811;0;6336;4;1;
/org.eclipse.text/src/org/eclipse/jface/text/SequentialRewriteTextStore.java;2;1;3;1;2;2;2;1;15;0;1;2116;18;18;1;0;0;1;3;2116;0;6299;3;2;
/org.eclipse.pde.ui/src/org/eclipse/pde/internal/ui/wizards/project/NewProjectWizard.java;3;0;5;1;0;0;0;5;37;1;5;2501;50;50;1;0;0;5;5;2501;0;3840;5;3;
/org.eclipse.jdt.ui/ui/org/eclipse/jdt/internal/ui/search/OccurrencesSearchLabelProvider.java;3;1;3;1;2;2;2;1;6;0;1;4888;8;8;1;0;0;1;3;4888;0;6340;3;3;
/org.eclipse.jdt.ui/ui/org/eclipse/jdt/internal/ui/actions/OpenTypeInHierarchyAction.java;1;0;1;1;1;1;1;0;2;0;0;6340;2;2;1;0;0;0;1;6340;0;6340;1;1;
/org.eclipse.team.cvs.ui/src/org/eclipse/team/internal/ccvs/ui/subscriber/WorkspaceUpdateOperation.java;2;1;4;1;2;2;2;2;10;1;2;4450;14;14;1;0;0;2;4;4450;0;6337;4;2;
/org.eclipse.jdt.core/model/org/eclipse/jdt/core/util/IConstantPool.java;1;0;1;1;0;0;0;1;2;0;1;3560;2;2;1;0;0;1;1;3560;0;3560;1;1;
/org.eclipse.ui.workbench/Eclipse UI/org/eclipse/ui/activities/IPatternBinding.java;1;0;5;1;0;0;0;5;14;1;5;2240;27;27;1;0;0;5;5;2240;0;2896;5;1;
/org.eclipse.ui.ide/src/org/eclipse/ui/internal/dialogs/FileFolderSelectionDialog.java;2;0;3;1;0;0;0;3;4;1;3;1526;4;4;1;0;0;3;3;1526;0;2263;3;2;
/org.eclipse.jdt.ui.examples.javafamily/coresearch-experiment/org/eclipse/search/core/SearchContext.java;1;0;2;1;0;0;0;2;0;1;2;1380;0;0;1;0;0;2;2;1380;0;3214;2;1;
/org.eclipse.ui.ide/extensions/org/eclipse/ui/dialogs/ProjectLocationSelectionDialog.java;2;1;3;1;2;2;2;1;22;0;1;2263;26;26;1;0;0;1;3;2263;0;6338;3;2;
/org.eclipse.ui.workbench/Eclipse UI/org/eclipse/ui/internal/util/PrefUtil.java;1;0;1;1;1;1;1;0;0;0;0;5449;0;0;1;0;0;0;1;5449;0;5449;1;1;
/org.eclipse.pde.ui/src/org/eclipse/pde/internal/ui/preferences/SourceCodeLocationsPreferenceNode.java;2;1;3;1;2;2;2;1;4;0;1;3986;8;8;1;0;0;1;3;3986;0;6336;3;2;
/org.eclipse.ui.workbench/Eclipse UI/org/eclipse/ui/commands/registry/ICategoryDefinition.java;1;0;3;1;0;0;0;3;2;2;2;1400;2;2;2;1;0;3;3;1400;1;1417;2;1;
/org.eclipse.jdt.ui/ui/org/eclipse/jdt/ui/actions/MemberFilterActionGroup.java;2;0;5;1;1;1;1;4;189;1;4;1350;231;231;1;0;0;4;5;1350;0;6340;5;2;
/org.eclipse.ui.intro/src/org/eclipse/ui/internal/intro/impl/presentations/FormIntroPartImplementation.java;2;3;25;1;25;20;25;0;193;0;0;5115;1020;1020;3;0;5;0;25;5877;5;6280;20;2;
/org.eclipse.update.tests.core/src/org/eclipse/update/tests/AllTests.java;2;0;8;1;1;1;1;7;48;1;7;1661;114;114;1;0;0;7;8;1661;0;6336;8;2;
/org.eclipse.pde.ui/src/org/eclipse/pde/internal/ui/wizards/plugin/PluginFieldData.java;2;1;3;1;2;2;2;1;10;0;1;3986;14;14;1;0;0;1;3;3986;0;6336;3;2;
/org.eclipse.ui.externaltools/Ant Tools Support/org/eclipse/ui/externaltools/internal/ant/launchConfigurations/AntStreamsProxy.java;1;0;1;1;0;0;0;1;0;0;1;282;0;0;1;0;0;1;1;282;0;282;1;1;
/org.eclipse.pde.ui/src/org/eclipse/pde/internal/ui/build/BuildSiteJob.java;2;1;6;1;4;4;4;2;51;1;2;5016;72;72;1;0;0;2;6;5016;0;6336;6;2;
/org.eclipse.sdk.tests-feature/plugins/org.eclipse.perfmsr.ui/src/org/eclipse/perfmsr/ui/InfoDialog.java;2;1;3;1;2;2;2;1;10;0;1;4845;20;20;1;0;0;1;3;4845;0;6342;3;2;
/org.eclipse.swt/Eclipse SWT Drag and Drop/gtk/org/eclipse/swt/dnd/TextTransfer.java;3;0;5;1;1;1;1;4;100;2;3;317;118;118;2;1;0;4;5;317;1;6352;4;3;
/org.eclipse.ui.ide/src/org/eclipse/ui/views/markers/internal/IFilter.java;1;0;1;1;0;0;0;1;0;0;1;2208;0;0;1;0;0;1;1;2208;0;2208;1;1;
/org.eclipse.jdt.ui/ui/org/eclipse/jdt/ui/text/spelling/SpellCheckIterator.java;1;0;2;1;0;0;0;2;0;1;2;3829;0;0;1;0;0;2;2;3829;0;3930;2;1;
/org.eclipse.ui.views/src/org/eclipse/ui/views/tasklist/TaskPropertiesDialog.java;1;0;1;1;0;0;0;1;0;0;1;2738;0;0;1;0;0;1;1;2738;0;2738;1;1;
/org.eclipse.jdt.debug/model/org/eclipse/jdt/debug/core/IJavaThread.java;3;1;4;1;2;2;2;2;15;1;2;1340;37;37;1;0;0;2;4;1340;0;6336;4;3;
/org.eclipse.jdt.ui/core refactoring/org/eclipse/jdt/internal/corext/refactoring/participants/xml/IEvaluationContext.java;1;0;2;1;0;0;0;2;0;1;2;4091;0;0;1;0;0;2;2;4091;0;4108;2;1;
/org.eclipse.jdt.ui/ui/org/eclipse/jdt/internal/ui/viewsupport/ISelectionListenerWithAST.java;2;0;2;1;1;1;1;1;2;0;1;2886;2;2;1;0;0;1;2;2886;0;6340;2;2;
/org.eclipse.jdt.core.tests.compiler/src/org/eclipse/jdt/core/tests/compiler/regression/AnnotationTestForMethod.java;1;0;3;1;0;0;0;3;10;1;3;2397;10;10;1;0;0;3;3;2397;0;2887;3;1;
/org.eclipse.ant.ui/Ant Tools Support/org/eclipse/ant/internal/ui/views/actions/EditorImageDescriptor.java;1;1;4;1;2;2;2;2;10;1;2;1811;23;23;1;0;0;2;4;1811;0;6336;4;1;
/org.eclipse.jdt.core.tests.model/workspace/Converter/src/test0395/A.java;1;0;1;1;0;0;0;1;0;0;1;3714;0;0;1;0;0;1;1;3714;0;3714;1;1;
/org.eclipse.help.ui/src/org/eclipse/help/ui/internal/HelpUIPlugin.java;1;1;15;1;4;4;4;11;111;1;11;1776;239;239;1;0;0;11;15;1776;0;6337;15;1;
/org.eclipse.ant.ui/Ant Editor/org/eclipse/ant/internal/ui/editor/outline/AntEditorContentOutlinePage.java;2;2;32;2;3;2;3;29;239;3;21;1811;1028;1028;3;8;1;29;32;3514;9;5599;23;2;
/org.eclipse.jdt.ui/ui/org/eclipse/jdt/internal/ui/javaeditor/selectionactions/SelectionHistory.java;1;0;1;1;1;1;1;0;2;0;0;6340;2;2;1;0;0;0;1;6340;0;6340;1;1;
/org.eclipse.debug.ui/ui/org/eclipse/debug/internal/ui/views/launch/LaunchViewer.java;5;0;7;2;1;1;1;6;45;2;5;1137;138;138;2;1;0;6;7;1137;1;6336;6;5;
/org.eclipse.ui.tests/Eclipse UI Tests/org/eclipse/ui/tests/adaptable/MarkerImageProviderTest.java;1;0;1;1;0;0;0;1;0;0;1;4245;0;0;1;0;0;1;1;4245;0;4245;1;1;
/org.eclipse.jdt.core/model/org/eclipse/jdt/internal/core/hierarchy/TypeHierarchy.java;4;1;26;2;2;2;2;24;200;3;21;61;719;719;3;3;0;24;26;988;3;5916;23;4;
/org.eclipse.jdt.ui.tests.refactoring/resources/RenamePackage/testImportFromMultiRoots4/in/srcPrg/p/A.java;1;0;2;1;0;0;0;2;11;1;2;3219;11;11;1;0;0;2;2;3219;0;4105;2;1;
/org.eclipse.pde.ui/src/org/eclipse/pde/ui/templates/OptionTemplateSection.java;3;1;6;1;5;5;5;1;216;0;1;2786;377;377;1;0;0;1;6;2786;0;6336;6;3;
/org.eclipse.jdt.ui/core refactoring/org/eclipse/jdt/internal/corext/refactoring/changes/RenameSourceFolderChange.java;2;0;5;1;1;1;1;4;21;1;4;3708;38;38;1;0;0;4;5;3708;0;6340;5;2;
/org.eclipse.jdt.core.tests.model/src/org/eclipse/jdt/core/tests/model/OptionTests.java;2;0;2;1;0;0;0;2;29;1;2;3560;31;31;1;0;0;2;2;3560;0;3671;2;2;
/org.eclipse.jdt.core.tests.model/workspace/Formatter/test068/A_out.java;1;0;1;1;0;0;0;1;0;0;1;2425;0;0;1;0;0;1;1;2425;0;2425;1;1;
/org.eclipse.jdt.core/model/org/eclipse/jdt/core/jdom/IDOMNode.java;2;0;3;1;1;1;1;2;40;1;2;3560;45;45;1;0;0;2;3;3560;0;5584;3;2;
/org.eclipse.team.core/src/org/eclipse/team/core/subscribers/ComparisonCriteria.java;2;0;6;1;0;0;0;6;87;2;5;649;95;95;2;1;0;6;6;1650;1;4216;5;2;
/org.eclipse.jdt.core.tests.model/workspace/Converter/junit/runner/ClassPathTestCollector.java;1;0;2;1;0;0;0;2;16;1;2;787;16;16;1;0;0;2;2;787;0;3714;2;1;
/org.eclipse.ui.tests/Eclipse UI Tests/org/eclipse/ui/tests/dnd/ViewDropTarget.java;1;0;1;1;0;0;0;1;0;0;1;5007;0;0;1;0;0;1;1;5007;0;5007;1;1;
/org.eclipse.ui.ide/src/org/eclipse/ui/wizards/datatransfer/ZipFileImportWizard.java;2;0;3;1;0;0;0;3;15;1;3;1511;17;17;1;0;0;3;3;1511;0;2280;3;2;
/org.eclipse.jdt.ui/ui refactoring/org/eclipse/jdt/internal/ui/refactoring/MoveMembersInputPage.java;1;0;1;1;0;0;0;1;0;0;1;518;0;0;1;0;0;1;1;518;0;518;1;1;
/org.eclipse.jdt.core/compiler/org/eclipse/jdt/internal/compiler/ast/ParameterizedQualifiedAllocationExpression.java;1;0;1;1;0;0;0;1;0;0;1;2729;0;0;1;0;0;1;1;2729;0;2729;1;1;
/org.eclipse.team.ui/src/org/eclipse/team/ui/synchronize/viewers/CompressedFolderDiffNodeRoot.java;1;0;1;1;0;0;0;1;0;0;1;3972;0;0;1;0;0;1;1;3972;0;3972;1;1;
/org.eclipse.jdt.ui/core extension/org/eclipse/jdt/internal/corext/codemanipulation/StubUtility.java;4;1;34;1;5;5;5;29;151;2;28;406;1000;1000;2;1;0;29;34;576;1;6340;33;4;
/org.eclipse.pde.ui/src/org/eclipse/pde/internal/ui/preferences/TargetEnvironmentPreferenceNode.java;2;1;3;1;2;2;2;1;4;0;1;3986;8;8;1;0;0;1;3;3986;0;6336;3;2;
/org.eclipse.ui.ide/src/org/eclipse/ui/views/markers/internal/TableSortAction.java;2;0;2;1;0;0;0;2;2;1;2;2208;2;2;1;0;0;2;2;2208;0;3214;2;2;
/org.eclipse.ant.ui/Ant Editor/org/eclipse/ant/ui/internal/dtd/schema/NfmNode.java;1;0;2;1;0;0;0;2;0;1;2;250;0;0;1;0;0;2;2;250;0;1811;2;1;
/org.eclipse.update.core/src/org/eclipse/update/internal/core/UpdateCore.java;3;2;19;1;5;4;5;14;94;2;13;460;340;340;2;1;1;14;19;4558;2;6336;17;3;
/org.eclipse.jdt.core.tests.model/workspace/Formatter/test480/A_in.java;1;0;1;1;0;0;0;1;0;0;1;4173;0;0;1;0;0;1;1;4173;0;4173;1;1;
/org.eclipse.team.tests.core/src/org/eclipse/team/tests/ui/synchronize/TestSubscriber.java;1;0;2;1;0;0;0;2;0;0;1;3715;0;0;2;1;0;2;2;3715;1;3715;1;1;
/org.eclipse.update.core/src/org/eclipse/update/core/ICategory.java;2;1;3;1;2;2;2;1;6;0;1;890;12;12;1;0;0;1;3;890;0;6336;3;2;
/org.eclipse.ui.tests/UI Test Utils/org/eclipse/ui/tests/util/PlatformUtil.java;1;0;1;1;0;0;0;1;0;0;1;1542;0;0;1;0;0;1;1;1542;0;1542;1;1;
/org.eclipse.ant.ui/Ant Tools Support/org/eclipse/ant/internal/ui/views/actions/FilterInternalTargetsAction.java;2;0;2;2;0;0;0;2;2;0;1;1939;2;2;2;1;0;2;2;1939;1;1939;1;2;
/org.eclipse.update.core/src/org/eclipse/update/internal/core/PluginEntryContentConsumer.java;2;1;3;1;2;2;2;1;6;0;1;890;14;14;1;0;0;1;3;890;0;6336;3;2;
/org.eclipse.jdt.core.tests.model/src/org/eclipse/jdt/core/tests/model/CopyMoveResourcesTests.java;2;0;7;1;0;0;0;7;117;2;5;1132;209;209;2;2;0;7;7;1983;2;3560;5;2;
/org.eclipse.jdt.ui.tests.refactoring/resources/MoveInnerToTopLevel/test_nonstatic_12/out/Inner.java;2;0;2;1;1;1;1;1;2;0;1;305;4;4;1;0;0;1;2;305;0;5854;2;2;
/org.eclipse.team.cvs.core/src/org/eclipse/team/internal/ccvs/core/syncinfo/CVSBaseResourceTree.java;1;0;1;1;0;0;0;1;0;0;1;3195;0;0;1;0;0;1;1;3195;0;3195;1;1;
/org.eclipse.ui.ide/src/org/eclipse/ui/internal/ide/dialogs/ProjectCapabilityEditingPropertyPage.java;3;0;3;1;1;1;1;2;32;1;2;2264;56;56;1;0;0;2;3;2264;0;6338;3;3;
/org.eclipse.core.resources/src/org/eclipse/core/internal/resources/SyncInfoWriter.java;1;0;1;1;1;1;1;0;174;0;0;5146;174;174;1;0;0;0;1;5146;0;5146;1;1;
/org.eclipse.ant.ui/Ant Tools Support/org/eclipse/ant/internal/ui/preferences/AntPreferencesMessages.java;1;0;1;1;0;0;0;1;0;0;1;1811;0;0;1;0;0;1;1;1811;0;1811;1;1;
/org.eclipse.jdt.ui.tests.refactoring/resources/MoveMembers/test4/in/A.java;1;0;1;1;0;0;0;1;1;0;1;1522;1;1;1;0;0;1;1;1522;0;1522;1;1;
/org.eclipse.releng.basebuilder/plugins/org.eclipse.build.tools/src/org/eclipse/releng/generators/TestVersionTracker.java;1;0;3;1;0;0;0;3;185;1;3;993;195;195;1;0;0;3;3;993;0;3597;3;1;
/org.eclipse.team.webdav/src/org/eclipse/team/internal/ui/target/CreateNewFolderAction.java;2;0;3;1;1;1;1;2;5;1;2;2495;7;7;1;0;0;2;3;2495;0;6337;3;2;
/org.eclipse.jdt.ui.tests.refactoring/resources/ExtractInterface/test67/out/Inter.java;1;0;1;1;0;0;0;1;2;0;1;1166;2;2;1;0;0;1;1;1166;0;1166;1;1;
/org.eclipse.pde.ui/src_Forms/org/eclipse/pde/internal/ui/neweditor/feature/ReferenceWizard.java;2;0;2;1;1;1;1;1;0;0;1;4926;0;0;1;0;0;1;2;4926;0;5431;2;2;
/org.eclipse.ui.workbench/Eclipse UI/org/eclipse/ui/internal/SystemSummaryEditorInput.java;1;0;1;1;0;0;0;1;0;0;1;2737;0;0;1;0;0;1;1;2737;0;2737;1;1;
/org.eclipse.jdt.core/model/org/eclipse/jdt/internal/core/CreateInitializerOperation.java;3;1;6;1;2;2;2;4;19;1;4;377;34;34;1;0;0;4;6;377;0;5916;6;3;
/org.eclipse.jdt.ui.tests.refactoring/resources/MoveMembers/test32/in/A.java;1;0;1;1;0;0;0;1;0;0;1;1683;0;0;1;0;0;1;1;1683;0;1683;1;1;
/org.eclipse.ui.workbench/Eclipse UI/org/eclipse/ui/commands/CategoryEvent.java;3;1;5;1;2;2;2;3;121;2;2;2823;174;174;2;1;0;3;5;2823;1;6338;4;3;
/org.eclipse.help.base/src/org/eclipse/help/internal/search/SearchQuery.java;1;1;5;1;3;3;3;2;29;1;2;1740;41;41;1;0;0;2;5;1740;0;6337;5;1;
/org.eclipse.debug.ui/ui/org/eclipse/debug/ui/console/IConsoleColorProvider.java;1;0;2;1;1;1;1;1;10;0;1;2060;14;14;1;0;0;1;2;2060;0;6335;2;1;
/org.eclipse.jdt.ui.tests.refactoring/resources/MoveMembers/test39/in/C.java;1;0;1;1;0;0;0;1;0;0;1;2093;0;0;1;0;0;1;1;2093;0;2093;1;1;
/org.eclipse.ui.views/src/org/eclipse/ui/views/internal/markers/ActionPasteMarker.java;1;0;2;1;0;0;0;2;0;0;1;749;0;0;2;1;0;2;2;749;1;749;1;1;
/org.eclipse.pde.core/src/org/eclipse/pde/internal/core/plugin/ExternalPluginModel.java;3;1;4;1;2;2;2;2;6;1;2;3278;14;14;1;0;0;2;4;3278;0;6336;4;3;
/org.eclipse.ui.workbench/Eclipse UI/org/eclipse/ui/internal/DefaultStackPresentationSite.java;3;1;10;2;5;5;5;5;22;2;4;4460;77;77;2;1;0;5;10;4469;1;5698;9;3;
/org.eclipse.jdt.core/model/org/eclipse/jdt/internal/core/JavaModelCache.java;1;0;1;1;0;0;0;1;2;0;1;3560;2;2;1;0;0;1;1;3560;0;3560;1;1;
/org.eclipse.swt/Eclipse SWT Browser/common/org/eclipse/swt/browser/LocationAdapter.java;2;0;4;1;1;1;1;3;28;1;3;2862;39;39;1;0;0;3;4;2862;0;6352;4;2;
/org.eclipse.jdt.ui.tests.refactoring/resources/ExtractInterface/test80/out/A.java;2;0;2;1;0;0;0;2;4;1;2;1166;5;5;1;0;0;2;2;1166;0;2274;2;2;
/org.eclipse.jdt.core.tests.model/workspace/Converter/src/test0246/Test.java;1;0;1;1;0;0;0;1;0;0;1;3714;0;0;1;0;0;1;1;3714;0;3714;1;1;
/org.eclipse.help.base/src/org/eclipse/help/internal/search/HTMLDocParser.java;1;1;6;1;3;3;3;3;138;2;2;1740;180;180;2;1;0;3;6;1740;1;6337;5;1;
/org.eclipse.jdt.ui/ui refactoring/org/eclipse/jdt/internal/ui/refactoring/nls/ExternalizeWizard.java;3;1;10;1;5;5;5;5;44;1;5;1047;129;129;1;0;0;5;10;1047;0;6340;10;3;
/org.eclipse.jdt.ui/ui/org/eclipse/jdt/internal/ui/callhierarchy/LocationContentProvider.java;1;0;2;1;0;0;0;2;0;0;1;155;0;0;2;1;0;2;2;155;1;155;1;1;
/org.eclipse.jdt.ui/ui/org/eclipse/jdt/internal/ui/text/java/hover/JavaEditorTextHoverProxy.java;2;1;3;1;2;2;2;1;50;0;1;692;58;58;1;0;0;1;3;692;0;6340;3;2;
/org.eclipse.jdt.ui.tests.refactoring/resources/InlineMethodWorkspace/TestCases/simple_out/TestConstructor1.java;1;0;1;1;0;0;0;1;0;0;1;2493;0;0;1;0;0;1;1;2493;0;2493;1;1;
/org.eclipse.jdt.ui.tests.refactoring/resources/InlineMethodWorkspace/TestCases/receiver_out/TestFieldReceiver.java;1;0;1;1;1;1;1;0;0;0;0;5747;0;0;1;0;0;0;1;5747;0;5747;1;1;
/org.eclipse.text/src/org/eclipse/jface/text/IDocumentPartitioningListenerExtension2.java;2;1;4;1;3;3;3;1;20;0;1;1510;41;41;1;0;0;1;4;1510;0;6340;4;2;
/org.eclipse.pde.core/src_OSGi/org/eclipse/pde/internal/core/osgi/bundle/FragmentUtil.java;2;0;3;1;0;0;0;3;4;1;3;2485;4;4;1;0;0;3;3;2485;0;4203;3;2;
/org.eclipse.osgi/osgi/src/org/eclipse/osgi/service/resolver/StateHelper.java;3;1;6;1;2;2;2;4;160;2;3;4491;182;182;2;1;0;4;6;4513;1;5313;5;3;
/org.eclipse.pde.ui/src_Forms/org/eclipse/pde/internal/ui/neweditor/FormOutlinePage.java;2;0;6;1;1;1;1;5;47;1;5;3795;70;70;1;0;0;5;6;3795;0;5431;6;2;
/org.eclipse.jdt.core.tests.model/workspace/Converter/test0140/Test.java;1;0;1;1;0;0;0;1;0;0;1;3714;0;0;1;0;0;1;1;3714;0;3714;1;1;
/org.eclipse.ui.workbench/Eclipse UI/org/eclipse/ui/internal/activities/IActivityRegistryListener.java;1;0;2;1;0;0;0;2;2;1;2;2444;2;2;1;0;0;2;2;2444;0;2805;2;1;
/org.eclipse.team.ui/src/org/eclipse/team/internal/ui/wizards/ConfigurationWizardNode.java;1;0;2;1;0;0;0;2;72;0;1;987;72;72;2;1;0;2;2;987;1;987;1;1;
/org.eclipse.jface.text/src/org/eclipse/jface/text/source/AnnotationRulerColumn.java;4;2;31;1;16;15;16;15;146;2;14;682;812;812;2;1;1;15;31;2584;2;6361;29;4;
/org.eclipse.search/search/org/eclipse/search/internal/ui/text/GroupByKeyComputer.java;1;0;1;1;1;1;1;0;2;0;0;6340;2;2;1;0;0;0;1;6340;0;6340;1;1;
/org.eclipse.team.cvs.ui/src/org/eclipse/team/internal/ccvs/ui/operations/CheckoutMultipleProjectsOperation.java;2;0;5;1;1;1;1;4;58;1;4;276;87;87;1;0;0;4;5;276;0;6337;5;2;
/org.eclipse.jdt.ui/ui/org/eclipse/jdt/internal/ui/viewsupport/ProblemTableViewer.java;2;1;5;1;2;2;2;3;109;1;3;1386;133;133;1;0;0;3;5;1386;0;6340;5;2;
/org.eclipse.jdt.core.tests.model/workspace/Converter/src/test0020/Test.java;1;0;1;1;0;0;0;1;0;0;1;3714;0;0;1;0;0;1;1;3714;0;3714;1;1;
/org.eclipse.swt/Eclipse SWT/motif/org/eclipse/swt/widgets/Tracker.java;5;1;26;1;4;4;4;22;354;3;17;110;626;626;3;5;0;22;26;110;5;6352;21;5;
/org.eclipse.pde.ui/src_Forms/org/eclipse/pde/internal/ui/neweditor/text/IReconcilingParticipant.java;1;0;2;1;1;1;1;1;0;0;1;4438;0;0;1;0;0;1;2;4438;0;5431;2;1;
/org.eclipse.text/projection/org/eclipse/jface/text/projection/IMinimalMapping.java;1;1;3;1;2;2;2;1;21;0;1;4516;23;23;1;0;0;1;3;4516;0;6301;3;1;
/org.eclipse.jdt.core.tests.model/workspace/Converter/src/test0141/Test.java;1;0;1;1;0;0;0;1;0;0;1;3714;0;0;1;0;0;1;1;3714;0;3714;1;1;
/org.eclipse.team.ui/src/org/eclipse/team/internal/ui/synchronize/actions/DefaultSynchronizePageActions.java;1;1;4;1;4;4;4;0;72;0;0;5105;104;104;1;0;0;0;4;5105;0;5799;4;1;
/org.eclipse.ui.forms/src/org/eclipse/ui/internal/forms/FormWizardPage.java;1;0;2;1;1;1;1;1;6;0;1;5044;6;6;1;0;0;1;2;5044;0;6336;2;1;
/org.eclipse.jdt.core/model/org/eclipse/jdt/internal/core/ClassFileInfo.java;2;0;13;1;0;0;0;13;59;1;13;259;127;127;1;0;0;13;13;259;0;4124;13;2;
/org.eclipse.jdt.ui.tests.refactoring/resources/ExtractMethodWorkSpace/ExtractMethodTests/return_out/A_test702.java;1;0;2;1;0;0;0;2;6;1;2;130;7;7;1;0;0;2;2;130;0;844;2;1;
/org.eclipse.jdt.core.tests.model/workspace/Formatter/test069/A_out.java;1;0;1;1;0;0;0;1;0;0;1;2425;0;0;1;0;0;1;1;2425;0;2425;1;1;
/org.eclipse.jdt.launching/launching/org/eclipse/jdt/internal/launching/JREContainerInitializer.java;3;1;4;1;2;2;2;2;61;1;2;685;69;69;1;0;0;2;4;685;0;6336;4;3;
/org.eclipse.jdt.ui/ui/org/eclipse/jdt/internal/ui/text/template/TemplateEngine.java;2;0;4;1;0;0;0;4;4;1;4;1005;10;10;1;0;0;4;4;1005;0;4258;4;2;
/org.eclipse.ui.tests/Eclipse UI Tests/org/eclipse/ui/tests/contexts/ExtensionTestCase.java;1;0;1;1;1;1;1;0;0;0;0;5531;0;0;1;0;0;0;1;5531;0;5531;1;1;
/org.eclipse.ui.intro/src/org/eclipse/ui/internal/intro/impl/model/AbstractIntroIdElement.java;1;0;1;1;1;1;1;0;0;0;0;5533;0;0;1;0;0;0;1;5533;0;5533;1;1;
/org.eclipse.update.core/src/org/eclipse/update/internal/operations/Operation.java;1;0;4;1;1;1;1;3;4;1;3;825;8;8;1;0;0;3;4;825;0;6336;4;1;
/org.eclipse.jdt.junit/src/org/eclipse/jdt/internal/junit/util/SocketUtil.java;1;0;1;1;0;0;0;1;0;0;1;329;0;0;1;0;0;1;1;329;0;329;1;1;
/org.eclipse.jdt.ui.tests.refactoring/resources/ExtractTemp/canExtract/A_testZeroLengthSelection0_in.java;1;0;1;1;0;0;0;1;0;0;1;1684;0;0;1;0;0;1;1;1684;0;1684;1;1;
/org.eclipse.ui.externaltools/External Tools Base/org/eclipse/ui/externaltools/internal/ui/BuilderLabelProvider.java;2;0;3;1;1;1;1;2;29;1;2;3676;31;31;1;0;0;2;3;3676;0;5487;3;2;
/org.eclipse.core.boot/src/org/eclipse/core/boot/IPlatformConfiguration.java;1;0;1;1;0;0;0;1;0;0;1;3013;0;0;1;0;0;1;1;3013;0;3013;1;1;
/org.eclipse.ui.workbench/Eclipse UI/org/eclipse/ui/roles/ICategoryManager.java;1;0;2;1;0;0;0;2;0;0;1;2864;0;0;2;1;0;2;2;2864;1;2864;1;1;
/org.eclipse.ant.ui/Ant Editor/org/eclipse/ant/internal/ui/editor/outline/ToggleSortAntOutlineAction.java;1;0;1;1;0;0;0;1;0;0;1;1992;0;0;1;0;0;1;1;1992;0;1992;1;1;
/org.eclipse.jface.text/src/org/eclipse/jface/text/reconciler/DirtyRegion.java;1;2;3;1;3;2;3;0;13;0;0;6340;15;15;2;0;1;0;3;6353;1;6353;2;1;
/org.eclipse.compare/compare/org/eclipse/compare/contentmergeviewer/ITokenComparator.java;1;0;1;1;0;0;0;1;2;0;1;3935;2;2;1;0;0;1;1;3935;0;3935;1;1;
/org.eclipse.pde.core/srcnew/org/eclipse/pde/internal/core/plugin/IProblem.java;1;0;1;1;0;0;0;1;0;0;1;2906;0;0;1;0;0;1;1;2906;0;2906;1;1;
/org.eclipse.compare/compare/org/eclipse/compare/internal/CompareEditorContributor.java;1;1;4;1;2;2;2;2;7;1;2;1735;15;15;1;0;0;2;4;1735;0;6354;4;1;
/org.eclipse.ui.externaltools/External Tools Base/org/eclipse/ui/externaltools/internal/launchConfigurations/VariableSelectionDialog.java;2;0;3;1;0;0;0;3;9;1;3;33;17;17;1;0;0;3;3;33;0;321;3;2;
/org.eclipse.jdt.ui/ui/org/eclipse/jdt/internal/ui/preferences/TemplatePreferencePage.java;5;0;17;1;0;0;0;17;104;3;13;597;279;279;3;4;0;17;17;2396;4;4826;13;5;
/org.eclipse.core.resources/src/org/eclipse/core/internal/indexing/AbstractObjectPolicy.java;1;0;1;1;1;1;1;0;6;0;0;5146;6;6;1;0;0;0;1;5146;0;5146;1;1;
/org.eclipse.jdt.core/codeassist/org/eclipse/jdt/internal/codeassist/complete/CompletionOnMethodName.java;2;0;2;1;0;0;0;2;54;1;2;991;56;56;1;0;0;2;2;991;0;3560;2;2;
/org.eclipse.ui.externaltools/Ant Editor/org/eclipse/ui/externaltools/internal/ant/editor/utils/ProjectHelper.java;1;0;1;1;0;0;0;1;0;0;1;282;0;0;1;0;0;1;1;282;0;282;1;1;
/org.eclipse.team.cvs.ui/src/org/eclipse/team/internal/ccvs/ui/subscriber/ChangeLogDiffNode.java;1;2;10;1;5;4;5;5;68;1;5;3530;134;134;2;0;1;5;10;5637;1;5904;9;1;
/org.eclipse.update.ui.win32/src/org/eclipse/welcome/internal/webbrowser/WebBrowserEditorContributor.java;1;0;1;1;0;0;0;1;0;0;1;907;0;0;1;0;0;1;1;907;0;907;1;1;
/org.eclipse.jdt.ui.tests.refactoring/resources/Delete/testDeleteWithinCu2/in/A.java;1;0;1;1;0;0;0;1;0;0;1;442;0;0;1;0;0;1;1;442;0;442;1;1;
/org.eclipse.jdt.ui/ui/org/eclipse/jdt/internal/ui/wizards/buildpaths/ClasspathOrderingWorkbookPage.java;2;1;2;1;2;2;2;0;2;0;0;5833;4;4;1;0;0;0;2;5833;0;6340;2;2;
/org.eclipse.jdt.core.tests.model/workspace/Converter/junit/awtui/Logo.java;1;0;1;1;0;0;0;1;0;0;1;3714;0;0;1;0;0;1;1;3714;0;3714;1;1;
/org.eclipse.ui.workbench.texteditor/src/org/eclipse/ui/internal/texteditor/quickdiff/DiffRegion.java;2;1;3;1;2;2;2;1;8;0;1;3574;9;9;1;0;0;1;3;3574;0;6340;3;2;
/org.eclipse.ui.intro/src/org/eclipse/ui/intro/internal/presentations/BrowserIntroPartLocationListener.java;1;0;4;1;1;1;1;3;104;1;3;4429;108;108;1;0;0;3;4;4429;0;5115;4;1;
/org.eclipse.swt.tests/JUnit Tests/org/eclipse/swt/tests/junit/Test_org_eclipse_swt_accessibility_AccessibleControlEvent.java;2;0;3;1;1;1;1;2;19;1;2;2104;23;23;1;0;0;2;3;2104;0;6352;3;2;
/org.eclipse.jdt.core.tests.model/workspace/Formatter/test059/Parser_out.java;1;0;1;1;0;0;0;1;0;0;1;2425;0;0;1;0;0;1;1;2425;0;2425;1;1;
/org.eclipse.update.ui.forms/src/org/eclipse/update/ui/forms/internal/AbstractForm.java;1;0;1;1;0;0;0;1;12;0;1;2751;12;12;1;0;0;1;1;2751;0;2751;1;1;
/org.eclipse.jdt.ui.tests.refactoring/resources/MoveMembers/test4/out/A.java;1;0;1;1;0;0;0;1;3;0;1;1522;3;3;1;0;0;1;1;1522;0;1522;1;1;
/org.eclipse.swt.tests/JUnit Tests/org/eclipse/swt/tests/junit/Test_org_eclipse_swt_printing_PrintDialog.java;1;0;1;1;0;0;0;1;64;0;1;2175;64;64;1;0;0;1;1;2175;0;2175;1;1;
/org.eclipse.jdt.ui/ui/org/eclipse/jdt/internal/ui/text/correction/CastCompletionProposal.java;2;1;3;1;3;3;3;0;2;0;0;5591;4;4;1;0;0;0;3;5591;0;6340;3;2;
/org.eclipse.jdt.ui/ui refactoring/org/eclipse/jdt/internal/ui/refactoring/nls/MultiStateCellEditor.java;1;0;1;1;1;1;1;0;2;0;0;5375;2;2;1;0;0;0;1;5375;0;5375;1;1;
/org.eclipse.jdt.ui.tests/examples/org/eclipse/jdt/ui/examples/DialogFieldExample.java;2;0;2;1;1;1;1;1;5;0;1;1349;7;7;1;0;0;1;2;1349;0;6340;2;2;
/org.eclipse.ui.workbench/Eclipse UI/org/eclipse/ui/activities/service/ActivityServiceFactory.java;1;0;2;1;0;0;0;2;0;1;2;2896;0;0;1;0;0;2;2;2896;0;3066;2;1;
/org.eclipse.jdt.ui.tests.refactoring/resources/ChangeSignature/canModify/A_testAll60_in.java;1;0;1;1;0;0;0;1;0;0;1;4486;0;0;1;0;0;1;1;4486;0;4486;1;1;
/org.eclipse.jdt.ui.tests.refactoring/resources/ChangeTypeRefactoring/positive/A_testInterfaceTypes_out.java;1;0;1;1;0;0;0;1;0;0;1;2844;0;0;1;0;0;1;1;2844;0;2844;1;1;
/org.eclipse.swt/Eclipse SWT Accessibility/common/org/eclipse/swt/accessibility/AccessibleTextEvent.java;2;0;2;1;0;0;0;2;11;1;2;2244;11;11;1;0;0;2;2;2244;0;2729;2;2;
/org.eclipse.jdt.debug.ui/ui/org/eclipse/jdt/internal/debug/ui/actions/RemoveDetailFormatterAction.java;1;0;1;1;0;0;0;1;0;0;1;3196;0;0;1;0;0;1;1;3196;0;3196;1;1;
/org.eclipse.jdt.core.tests.model/workspace/Converter/test0509/B.java;1;0;2;1;0;0;0;2;0;1;2;3009;0;0;1;0;0;2;2;3009;0;3714;2;1;
/org.eclipse.jdt.ui/ui/org/eclipse/jdt/internal/ui/text/folding/JavaFoldingStructureProviderRegistry.java;1;1;2;1;2;2;2;0;6;0;0;5440;6;6;1;0;0;0;2;5440;0;6340;2;1;
/org.eclipse.compare.examples.xml/src/org/eclipse/compare/examples/xml/XMLStructureCreator.java;1;0;5;1;1;1;1;4;1358;1;4;1106;1412;1412;1;0;0;4;5;1106;0;5212;5;1;
/org.eclipse.swt.opengl/common/org/eclipse/swt/opengl/Library.java;1;0;1;1;0;0;0;1;0;0;1;1175;0;0;1;0;0;1;1;1175;0;1175;1;1;
/org.eclipse.jdt.ui.tests.refactoring/resources/ExtractMethodWorkSpace/ExtractMethodTests/duplicates_out/A_test964.java;1;0;1;1;1;1;1;0;0;0;0;5681;0;0;1;0;0;0;1;5681;0;5681;1;1;
/org.eclipse.update.ui.forms/src/org/eclipse/ui/forms/parts/RichTextHTTPAction.java;1;0;2;1;0;0;0;2;0;1;2;2898;0;0;1;0;0;2;2;2898;0;3038;2;1;
/org.eclipse.ui.ide/src/org/eclipse/ui/internal/dialogs/IElementFilter.java;2;0;2;1;0;0;0;2;0;1;2;1526;0;0;1;0;0;2;2;1526;0;2263;2;2;
/org.eclipse.swt/Eclipse SWT/photon/org/eclipse/swt/widgets/Menu.java;4;1;6;1;2;2;2;4;9;1;4;33;28;28;1;0;0;4;6;33;0;6352;6;4;
/org.eclipse.jdt.ui/ui/org/eclipse/jdt/internal/ui/javaeditor/CompilationUnitEditorActionContributor.java;3;2;10;1;3;2;3;7;77;1;7;500;199;199;2;0;1;7;10;5434;1;6340;9;3;
/org.eclipse.jdt.core/dom/org/eclipse/jdt/internal/core/dom/rewrite/NodeRewriteEvent.java;3;1;3;1;2;2;2;1;22;0;1;4802;26;26;1;0;0;1;3;4802;0;6336;3;3;
/org.eclipse.jdt.ui/ui refactoring/org/eclipse/jdt/internal/ui/refactoring/IParameterListChangeListener.java;1;0;1;1;1;1;1;0;2;0;0;6340;2;2;1;0;0;0;1;6340;0;6340;1;1;
/org.eclipse.jdt.core.tests.model/workspace/Converter/src/test0007/Test.java;1;0;1;1;0;0;0;1;0;0;1;3714;0;0;1;0;0;1;1;3714;0;3714;1;1;
/org.eclipse.ui.externaltools/External Tools Base/org/eclipse/ui/externaltools/internal/variable/WorkingSetComponent.java;2;0;2;1;0;0;0;2;71;1;2;282;71;71;1;0;0;2;2;282;0;321;2;2;
/org.eclipse.ui.ide/src/org/eclipse/ui/internal/ide/TipsAndTricksAction.java;2;1;6;1;3;3;3;3;26;1;3;2264;64;64;1;0;0;3;6;2264;0;6338;6;2;
/org.eclipse.jface.text/src/org/eclipse/jface/text/link/LinkedModeUI.java;3;1;6;1;6;6;6;0;77;0;0;5128;134;134;1;0;0;0;6;5128;0;6340;6;3;
/org.eclipse.jdt.core.tests.model/src/org/eclipse/jdt/core/tests/model/CompletionTestsRequestor.java;1;0;1;1;0;0;0;1;2;0;1;3560;2;2;1;0;0;1;1;3560;0;3560;1;1;
/org.eclipse.pde.ui/src_Forms/org/eclipse/pde/internal/ui/neweditor/plugin/dummy/DummyExtensionElement.java;1;0;2;1;0;0;0;2;0;1;2;4223;0;0;1;0;0;2;2;4223;0;4354;2;1;
/org.eclipse.ui.workbench/Eclipse UI/org/eclipse/ui/activities/IActivity.java;5;1;22;2;3;3;3;19;181;2;17;2240;622;622;2;2;0;19;22;2896;2;6338;20;5;
/org.eclipse.text/projection/org/eclipse/jface/text/projection/ProjectionDocument.java;3;2;17;1;8;7;8;9;128;3;7;4516;460;460;3;2;1;9;17;4689;3;6301;14;3;
/org.eclipse.update/src/org/eclipse/update/internal/core/UpdateManagerURLComparator.java;1;0;1;1;1;1;1;0;0;0;0;6339;0;0;1;0;0;0;1;6339;0;6339;1;1;
/org.eclipse.jdt.core.tests.model/workspace/Formatter/test119/A_in.java;1;0;1;1;0;0;0;1;0;0;1;2425;0;0;1;0;0;1;1;2425;0;2425;1;1;
/org.eclipse.update.core/srcnew/org/eclipse/update/internal/operations/UnconfigOperation.java;2;0;15;2;0;0;0;15;83;2;11;442;219;219;2;4;0;15;15;442;4;825;11;2;
/org.eclipse.jdt.ui.tests.refactoring/test cases/org/eclipse/jdt/ui/tests/refactoring/ParticipantTesting.java;1;0;2;1;1;1;1;1;3;0;1;4913;3;3;1;0;0;1;2;4913;0;5190;2;1;
/org.eclipse.jface.text/src/org/eclipse/jface/text/source/Annotation.java;2;1;8;2;2;2;2;6;135;2;4;2003;242;242;2;2;0;6;8;2017;2;5382;6;2;
/org.eclipse.jdt.ui/ui refactoring/org/eclipse/jdt/internal/ui/refactoring/nls/search/NLSSearchResult.java;2;2;5;1;4;3;4;1;40;0;1;4943;80;80;2;0;1;1;5;5178;1;6006;4;2;
/org.eclipse.jdt.core.tests.model/workspace/Converter/test0438/D.java;1;0;1;1;0;0;0;1;0;0;1;3714;0;0;1;0;0;1;1;3714;0;3714;1;1;
/org.eclipse.sdk.tests-feature/plugins/org.eclipse.perfmsr.core/src/org/eclipse/perfmsr/core/LinuxMemInfo.java;2;1;2;1;2;2;2;0;10;0;0;5657;10;10;1;0;0;0;2;5657;0;6342;2;2;
/org.eclipse.ant.ui/Ant Editor/org/eclipse/ant/ui/internal/editor/AntEditorMessages.java;1;0;3;1;0;0;0;3;2;1;3;250;2;2;1;0;0;3;3;250;0;1811;3;1;
/org.eclipse.jdt.core/compiler/org/eclipse/jdt/internal/compiler/ast/QualifiedNameReference.java;3;0;13;1;0;0;0;13;46;1;13;41;163;163;1;0;0;13;13;41;0;3560;13;3;
/org.eclipse.ui.externaltools/Ant Editor/org/eclipse/ui/externaltools/internal/ant/editor/tools/TaskXMLFileMerger.java;1;0;1;1;0;0;0;1;0;0;1;282;0;0;1;0;0;1;1;282;0;282;1;1;
/org.eclipse.jdt.core.tests.model/workspace/Formatter/test307/A_in.java;1;0;1;1;0;0;0;1;0;0;1;2442;0;0;1;0;0;1;1;2442;0;2442;1;1;
/org.eclipse.jdt.core/dom/org/eclipse/jdt/core/dom/Block.java;3;0;6;1;1;1;1;5;60;1;5;3560;72;72;1;0;0;5;6;3560;0;5272;6;3;
/org.eclipse.jdt.ui/ui/org/eclipse/jdt/internal/ui/dnd/ResourceTransferDragAdapter.java;1;0;1;1;1;1;1;0;2;0;0;6340;2;2;1;0;0;0;1;6340;0;6340;1;1;
/org.eclipse.jdt.ui.tests.refactoring/resources/RenamePackage/testImportFromMultiRoots5/out/srcTest/q/ATest.java;1;0;1;1;0;0;0;1;0;0;1;4105;0;0;1;0;0;1;1;4105;0;4105;1;1;
/org.eclipse.jdt.junit/src/org/eclipse/jdt/internal/junit/ui/OpenTestAction.java;2;0;3;1;1;1;1;2;12;1;2;3424;18;18;1;0;0;2;3;3424;0;6340;3;2;
/org.eclipse.core.tests.runtime/src/org/eclipse/core/tests/internal/plugins/PluginResolveTest_8.java;1;0;1;1;0;0;0;1;0;0;1;3014;0;0;1;0;0;1;1;3014;0;3014;1;1;
/org.eclipse.update.core/src/org/eclipse/update/internal/core/SiteFileFactory.java;3;2;10;1;3;2;3;7;173;1;7;890;301;301;2;0;1;7;10;5664;1;5664;9;3;
/org.eclipse.team.ui/src/org/eclipse/team/internal/ui/target/AuthenticatedTargetSitePropertiesPage.java;1;0;2;1;0;0;0;2;3;1;2;1080;3;3;1;0;0;2;2;1080;0;2495;2;1;
/org.eclipse.update.ui.forms/src/org/eclipse/update/ui/forms/richtext/HyperlinkAction.java;1;0;2;1;0;0;0;2;0;0;1;2849;0;0;2;1;0;2;2;2849;1;2849;1;1;
/org.eclipse.help/src/org/eclipse/help/internal/HelpPlugin.java;1;1;11;1;3;3;3;8;150;2;7;2732;359;359;2;1;0;8;11;5000;1;6337;10;1;
/org.eclipse.text.tests/src/org/eclipse/text/tests/ChildDocumentTest.java;1;2;4;1;3;2;3;1;8;0;1;5082;10;10;2;0;1;1;4;5100;1;6340;3;1;
/org.eclipse.pde.core/src/org/eclipse/pde/internal/core/build/BuildObject.java;3;1;4;1;3;3;3;1;73;0;1;4203;99;99;1;0;0;1;4;4203;0;6336;4;3;
/org.eclipse.jdt.ui.tests.refactoring/resources/ExtractMethodWorkSpace/ExtractMethodTests/locals_out/A_test554.java;1;0;1;1;0;0;0;1;6;0;1;844;6;6;1;0;0;1;1;844;0;844;1;1;
/org.eclipse.ui.ide/src/org/eclipse/ui/actions/MoveFilesAndFoldersOperation.java;2;0;3;1;0;0;0;3;14;1;3;1511;14;14;1;0;0;3;3;1511;0;2263;3;2;
/org.eclipse.jdt.ui/ui refactoring/org/eclipse/jdt/internal/ui/refactoring/reorg/CutAction.java;3;1;13;1;3;3;3;10;88;3;7;1650;180;180;3;3;0;10;13;5083;3;6340;10;3;
/org.eclipse.jdt.core.tests.model/workspace/Formatter/test481/A_in.java;1;0;1;1;0;0;0;1;0;0;1;4173;0;0;1;0;0;1;1;4173;0;4173;1;1;
/org.eclipse.jdt.ui/ui/org/eclipse/jdt/internal/ui/compare/JavaTokenComparator.java;2;0;2;1;1;1;1;1;2;0;1;1289;3;3;1;0;0;1;2;1289;0;6340;2;2;
/org.eclipse.ui.workbench/Eclipse UI/org/eclipse/ui/internal/contexts/registry/IRegistry.java;1;0;2;1;0;0;0;2;0;0;1;1396;0;0;2;1;0;2;2;1396;1;1396;1;1;
/org.eclipse.jdt.core/compiler/org/eclipse/jdt/internal/compiler/lookup/TagBits.java;1;0;1;1;0;0;0;1;2;0;1;3560;2;2;1;0;0;1;1;3560;0;3560;1;1;
/org.eclipse.jdt.ui/ui/org/eclipse/jdt/internal/ui/packageview/PackageExplorerPart.java;5;2;29;2;10;9;10;19;280;3;17;450;1152;1152;3;2;1;19;29;2969;3;6340;26;5;
/org.eclipse.ant.ui/Ant Tools Support/org/eclipse/ant/internal/ui/launchConfigurations/AntJRETab.java;2;1;27;1;2;2;2;25;199;2;22;1811;728;728;2;3;0;25;27;1811;3;6336;24;2;
/org.eclipse.team.tests.core/src/org/eclipse/team/tests/ui/synchronize/TestDiffNodePresentationModel.java;2;3;11;2;5;3;5;6;209;1;6;4091;259;259;3;0;2;6;11;5358;2;6337;9;2;
/org.eclipse.jdt.core/compiler/org/eclipse/jdt/internal/compiler/env/ISourceField.java;1;0;1;1;0;0;0;1;2;0;1;3560;2;2;1;0;0;1;1;3560;0;3560;1;1;
/org.eclipse.jdt.ui.tests.refactoring/resources/Paste/test0/out/B.java;1;0;1;1;0;0;0;1;0;0;1;1311;0;0;1;0;0;1;1;1311;0;1311;1;1;
/org.eclipse.debug.ui/ui/org/eclipse/debug/internal/ui/actions/RemoveBreakpointAction.java;2;0;2;1;0;0;0;2;2;1;2;2447;4;4;1;0;0;2;2;2447;0;2740;2;2;
/org.eclipse.jdt.core/model/org/eclipse/jdt/internal/core/BufferCache.java;1;0;4;1;0;0;0;4;19;3;2;971;21;21;3;2;0;4;4;971;2;3560;2;1;
/org.eclipse.core.tests.resources/src/org/eclipse/core/tests/internal/watson/DeltaIteratorTest.java;1;0;2;1;2;1;2;0;130;0;0;5147;130;130;2;0;1;0;2;5147;1;5147;1;1;
/org.eclipse.ui.workbench/Eclipse UI/org/eclipse/ui/internal/commands/CommandEnvelope.java;1;0;7;1;0;0;0;7;22;1;7;786;25;25;1;0;0;7;7;786;0;1579;7;1;
/org.eclipse.jdt.core.tests.model/workspace/Formatter/test078/A_out.java;1;0;1;1;0;0;0;1;0;0;1;2425;0;0;1;0;0;1;1;2425;0;2425;1;1;
/org.eclipse.debug.ui/ui/org/eclipse/debug/internal/ui/views/DebugViewLabelDecorator.java;4;1;6;1;2;2;2;4;6;1;4;3495;16;16;1;0;0;4;6;3495;0;6336;6;4;
/org.eclipse.update.ui.forms/Eclipse Forms/org/eclipse/ui/forms/parts/TreeNode.java;1;0;3;1;0;0;0;3;5;1;3;3098;5;5;1;0;0;3;3;3098;0;3138;3;1;
/org.eclipse.swt/Eclipse SWT Program/photon/org/eclipse/swt/program/Program.java;2;1;3;1;2;2;2;1;16;0;1;2665;22;22;1;0;0;1;3;2665;0;6352;3;2;
/org.eclipse.jdt.core.tests.model/workspace/Formatter/test250/A_out.java;1;0;1;1;0;0;0;1;0;0;1;2442;0;0;1;0;0;1;1;2442;0;2442;1;1;
/org.eclipse.ui.examples.javaeditor/Eclipse Java Editor Example/org/eclipse/ui/examples/javaeditor/spelling/ISpellDictionary.java;1;0;1;1;0;0;0;1;0;0;1;2565;0;0;1;0;0;1;1;2565;0;2565;1;1;
/org.eclipse.jdt.ui.tests.refactoring/resources/MoveMembers/testFail23/in/B.java;1;0;1;1;0;0;0;1;0;0;1;1856;0;0;1;0;0;1;1;1856;0;1856;1;1;
/org.eclipse.jdt.core.tests.model/workspace/Converter/test0073/Test.java;1;0;1;1;0;0;0;1;0;0;1;3714;0;0;1;0;0;1;1;3714;0;3714;1;1;
/org.eclipse.ui.ide/src/org/eclipse/ui/internal/dialogs/WelcomeEditorCopyAction.java;2;0;3;1;0;0;0;3;4;1;3;1526;4;4;1;0;0;3;3;1526;0;2263;3;2;
/org.eclipse.swt/Eclipse SWT PI/win32/org/eclipse/swt/internal/win32/SCRIPT_CONTROL.java;2;0;2;1;1;1;1;1;4;0;1;4563;4;4;1;0;0;1;2;4563;0;6352;2;2;
/org.eclipse.ui.ide/src/org/eclipse/ui/internal/dialogs/OpenResourceDialog.java;2;0;3;1;0;0;0;3;6;1;3;1526;6;6;1;0;0;3;3;1526;0;2263;3;2;
/org.eclipse.jdt.debug/jdi interfaces/com/sun/jdi/VirtualMachine.java;1;0;1;1;0;0;0;1;3;0;1;4267;3;3;1;0;0;1;1;4267;0;4267;1;1;
/org.eclipse.debug.ui/ui/org/eclipse/debug/internal/ui/preferences/ViewManagementPreferencePage.java;2;3;8;2;8;5;8;0;56;0;0;5515;104;104;3;0;3;0;8;5800;3;6082;5;2;
/org.eclipse.jdt.core.tests.model/workspace/Formatter/test274/A_out.java;1;0;1;1;0;0;0;1;0;0;1;2443;0;0;1;0;0;1;1;2443;0;2443;1;1;
/org.eclipse.ui.workbench/Eclipse UI/org/eclipse/ui/IViewLayout.java;1;1;2;1;2;2;2;0;26;0;0;5514;26;26;1;0;0;0;2;5514;0;5555;2;1;
/org.eclipse.ui.workbench/Eclipse UI/org/eclipse/ui/actions/ReadOnlyStateChecker.java;1;0;1;1;0;0;0;1;0;0;1;2737;0;0;1;0;0;1;1;2737;0;2737;1;1;
/org.eclipse.jdt.core.tests.model/workspace/TypeHierarchyNotification/src/p3/A.java;1;0;1;1;0;0;0;1;0;0;1;4925;0;0;1;0;0;1;1;4925;0;4925;1;1;
/org.eclipse.jdt.core.tests.model/workspace/Converter/src/test0427/A.java;1;0;1;1;0;0;0;1;0;0;1;3714;0;0;1;0;0;1;1;3714;0;3714;1;1;
/org.eclipse.swt/Eclipse SWT/photon/org/eclipse/swt/widgets/TabItem.java;3;1;6;1;3;3;3;3;6;1;3;269;22;22;1;0;0;3;6;269;0;6352;6;3;
/org.eclipse.swt/Eclipse SWT PI/gtk/org/eclipse/swt/internal/gtk/GdkEvent.java;3;0;3;1;1;1;1;2;17;1;2;1653;21;21;1;0;0;2;3;1653;0;6352;3;3;
/org.eclipse.jdt.core.tests.model/workspace/Formatter/test243/A_out.java;1;0;1;1;0;0;0;1;0;0;1;2437;0;0;1;0;0;1;1;2437;0;2437;1;1;
/org.eclipse.jdt.ui.tests.refactoring/resources/RenameTemp/canRename/A_test40_out.java;1;0;1;1;0;0;0;1;1;0;1;4605;1;1;1;0;0;1;1;4605;0;4605;1;1;
/org.eclipse.jdt.core.tests.model/workspace/Converter/src/test0047/Test.java;1;0;1;1;0;0;0;1;0;0;1;3714;0;0;1;0;0;1;1;3714;0;3714;1;1;
/org.eclipse.jdt.core.tests.model/workspace/JavaSearch/src/ann01/YYYY.java;1;0;3;1;0;0;0;3;2;1;3;2586;2;2;1;0;0;3;3;2586;0;2661;3;1;
/org.eclipse.ui.cheatsheets/src/org/eclipse/ui/internal/cheatsheets/data/ActionItem.java;2;0;5;2;1;1;1;4;91;2;3;4428;164;164;2;1;0;4;5;4625;1;5189;4;2;
/org.eclipse.jdt.ui/ui/org/eclipse/jdt/internal/ui/preferences/formatter/NewLinesTabPage.java;1;0;11;1;1;1;1;10;67;2;9;3103;178;178;2;1;0;10;11;3103;1;5207;10;1;
/org.eclipse.ui.ide/src/org/eclipse/ui/views/bookmarkexplorer/BookmarkLabelProvider.java;1;0;1;1;0;0;0;1;0;0;1;2208;0;0;1;0;0;1;1;2208;0;2208;1;1;
/org.eclipse.jdt.core/compiler/org/eclipse/jdt/internal/compiler/impl/FloatConstant.java;2;0;3;1;1;1;1;2;6;1;2;1111;12;12;1;0;0;2;3;1111;0;5587;3;2;
/org.eclipse.jdt.ui.tests.refactoring/resources/MoveInnerToTopLevel/test_nonstatic_3/out/Inner.java;2;0;2;1;1;1;1;1;2;0;1;305;4;4;1;0;0;1;2;305;0;5854;2;2;
/org.eclipse.team.cvs.core/src/org/eclipse/team/internal/ccvs/core/syncinfo/CVSResourceVariantTree.java;2;2;10;2;6;5;6;4;166;2;3;4238;378;378;2;1;1;4;10;4238;2;6337;8;2;
/org.eclipse.swt.tests/JUnit Tests/org/eclipse/swt/tests/junit/Test_org_eclipse_swt_ole_win32_OleClientSite.java;1;0;1;1;0;0;0;1;0;0;1;2176;0;0;1;0;0;1;1;2176;0;2176;1;1;
/org.eclipse.team.ui/src/org/eclipse/team/internal/ui/jobs/JobsView.java;1;0;2;1;0;0;0;2;2;1;2;1081;2;2;1;0;0;2;2;1081;0;1369;2;1;
/org.eclipse.ui.workbench/Eclipse UI/org/eclipse/ui/internal/commands/IKeySequenceBindingDefinition.java;1;0;3;1;0;0;0;3;10;1;3;2562;12;12;1;0;0;3;3;2562;0;3128;3;1;
/org.eclipse.pde.core/src/org/eclipse/pde/internal/core/schema/SchemaEnumeration.java;2;1;3;1;2;2;2;1;12;0;1;4203;18;18;1;0;0;1;3;4203;0;6336;3;2;
/org.eclipse.jdt.ui/ui/org/eclipse/jdt/internal/ui/preferences/formatter/WhiteSpaceOptions.java;1;0;6;1;0;0;0;6;59;2;5;3809;101;101;2;1;0;6;6;4038;1;4821;5;1;
/org.eclipse.team.webdav/src/org/eclipse/team/internal/target/subscriber/TargetSynchronizer.java;2;0;4;1;0;0;0;4;416;1;4;3494;432;432;1;0;0;4;4;3494;0;4349;4;2;
/org.eclipse.jdt.core/compiler/org/eclipse/jdt/internal/compiler/ast/IntLiteralMinValue.java;1;0;1;1;0;0;0;1;2;0;1;3560;2;2;1;0;0;1;1;3560;0;3560;1;1;
/org.eclipse.update.core/srcnew/org/eclipse/update/internal/search/UpdateSiteAdapter.java;2;0;3;1;0;0;0;3;21;2;2;572;21;21;2;1;0;3;3;572;1;825;2;2;
/org.eclipse.debug.ui/ui/org/eclipse/debug/internal/ui/actions/RunContextualLaunchAction.java;1;0;1;1;1;1;1;0;0;0;0;5496;0;0;1;0;0;0;1;5496;0;5496;1;1;
/org.eclipse.help.appserver/src/org/eclipse/help/internal/appserver/AppserverResources.java;1;1;7;1;3;3;3;4;102;1;4;105;126;126;1;0;0;4;7;105;0;6337;7;1;
/org.eclipse.jdt.core.tests.model/workspace/JavaSearch/src/s4/X.java;1;0;1;1;0;0;0;1;0;0;1;4841;0;0;1;0;0;1;1;4841;0;4841;1;1;
/org.eclipse.team.webdav/src/org/eclipse/team/internal/webdav/core/subscriber/WebDavSubscriberResource.java;1;0;1;1;0;0;0;1;0;0;1;3477;0;0;1;0;0;1;1;3477;0;3477;1;1;
/org.eclipse.jdt.ui/core extension/org/eclipse/jdt/internal/corext/template/TemplateMessages.java;1;0;1;1;0;0;0;1;0;0;1;4258;0;0;1;0;0;1;1;4258;0;4258;1;1;
/org.eclipse.team.ui/src/org/eclipse/team/internal/ui/registry/LogicalViewDescriptor.java;1;0;1;1;0;0;0;1;0;0;1;3734;0;0;1;0;0;1;1;3734;0;3734;1;1;
/org.eclipse.swt/Eclipse SWT/win32/org/eclipse/swt/widgets/Shell.java;6;2;42;2;12;10;12;30;128;3;28;16;686;686;3;2;2;30;42;463;4;6352;38;6;
/org.eclipse.ui.intro/src/org/eclipse/ui/internal/intro/impl/swt/FormsWidgetFactory.java;1;1;2;1;2;2;2;0;0;0;0;5714;0;0;1;0;0;0;2;5714;0;5726;2;1;
/org.eclipse.jdt.core.tests.model/workspace/JavaSearch/src/j4/MT47209.java;1;0;1;1;0;0;0;1;0;0;1;3330;0;0;1;0;0;1;1;3330;0;3330;1;1;
/org.eclipse.jdt.ui/ui/org/eclipse/jdt/internal/ui/actions/AddMethodStubAction.java;3;1;6;1;3;3;3;3;19;1;3;1350;49;49;1;0;0;3;6;1350;0;6340;6;3;
/org.eclipse.update.ui.forms/Eclipse Forms/org/eclipse/ui/forms/widgets/LayoutComposite.java;1;0;4;1;0;0;0;4;8;2;3;3733;8;8;2;1;0;4;4;4017;1;4157;3;1;
/org.eclipse.jdt.core/compiler/org/eclipse/jdt/internal/compiler/lookup/ProblemReferenceBinding.java;2;0;2;1;0;0;0;2;6;1;2;2181;8;8;1;0;0;2;2;2181;0;3560;2;2;
/org.eclipse.ui.tests/Eclipse UI Tests/org/eclipse/ui/tests/api/IActionBarsTest.java;1;0;1;1;0;0;0;1;3;0;1;3091;3;3;1;0;0;1;1;3091;0;3091;1;1;
/org.eclipse.jdt.ui.tests.refactoring/resources/ChangeTypeRefactoring/negative/A_testInvalidSelection_in.java;1;0;1;1;0;0;0;1;0;0;1;2844;0;0;1;0;0;1;1;2844;0;2844;1;1;
/org.eclipse.ui.workbench/Eclipse UI/org/eclipse/ui/internal/commands/api/older/IActionServiceListener.java;1;0;1;1;0;0;0;1;0;0;1;2562;0;0;1;0;0;1;1;2562;0;2562;1;1;
/org.eclipse.ui.workbench/Eclipse UI/org/eclipse/ui/internal/activities/CategoryActivityBindingDefinition.java;3;0;6;1;1;1;1;5;18;1;5;2896;34;34;1;0;0;5;6;2896;0;6338;6;3;
/org.eclipse.pde.core/src/org/eclipse/pde/internal/core/PluginPathFinder.java;2;1;7;1;6;6;6;1;62;0;1;4203;130;130;1;0;0;1;7;4203;0;6336;7;2;
/org.eclipse.jdt.core.tests.model/workspace/Converter/src/test0171/Test.java;1;0;1;1;0;0;0;1;0;0;1;3714;0;0;1;0;0;1;1;3714;0;3714;1;1;
/org.eclipse.jdt.debug.jdi.tests/tests/org/eclipse/debug/jdi/tests/LocatableTest.java;1;0;2;1;0;0;0;2;11;0;1;1317;11;11;2;1;0;2;2;1317;1;1317;1;1;
/org.eclipse.jdt.ui/core refactoring/org/eclipse/jdt/internal/corext/refactoring/changes/ValidationStateChange.java;1;0;8;1;1;1;1;7;112;1;7;3708;192;192;1;0;0;7;8;3708;0;5244;8;1;
/org.eclipse.jdt.ui.tests.refactoring/resources/IntroduceParameter/invalid/NotInMethod1.java;1;0;1;1;0;0;0;1;0;0;1;2281;0;0;1;0;0;1;1;2281;0;2281;1;1;
/org.eclipse.jdt.core/model/org/eclipse/jdt/core/util/ILocalVariableAttribute.java;1;0;1;1;0;0;0;1;2;0;1;3560;2;2;1;0;0;1;1;3560;0;3560;1;1;
/org.eclipse.ui.workbench/Eclipse UI/org/eclipse/ui/internal/progress/JobTreeElement.java;2;0;7;1;1;1;1;6;23;1;6;1094;55;55;1;0;0;6;7;1094;0;6338;7;2;
/org.eclipse.team.ui/src/org/eclipse/team/internal/ui/synchronize/actions/GlobalRefreshResourceSelectionPage.java;1;0;1;1;0;0;0;1;0;0;1;4389;0;0;1;0;0;1;1;4389;0;4389;1;1;
/org.eclipse.ui.workbench/Eclipse UI/org/eclipse/ui/internal/commands/CommandDefinition.java;2;0;15;1;1;1;1;14;145;5;8;1389;556;556;5;6;0;14;15;1389;6;6338;9;2;
/org.eclipse.jdt.ui/core refactoring/org/eclipse/jdt/internal/corext/refactoring/changes/MovePackageFragmentRootChange.java;2;1;4;1;2;2;2;2;13;1;2;3930;24;24;1;0;0;2;4;3930;0;6340;4;2;
/org.eclipse.ant.ui/Ant Editor/org/eclipse/ant/ui/internal/dtd/util/IKeyHolder.java;1;0;2;1;0;0;0;2;0;1;2;250;0;0;1;0;0;2;2;250;0;1811;2;1;
/org.eclipse.update.ui/src/org/eclipse/update/internal/ui/forms/UpdateAdapterFactory.java;1;0;1;1;0;0;0;1;0;0;1;755;0;0;1;0;0;1;1;755;0;755;1;1;
/org.eclipse.jdt.core.tests.model/workspace/Converter/src/test0541/A.java;1;0;1;1;0;0;0;1;0;0;1;4872;0;0;1;0;0;1;1;4872;0;4872;1;1;
/org.eclipse.ui.examples.readmetool/Eclipse UI Examples Readme Tool/org/eclipse/ui/examples/readmetool/AdaptableList.java;1;0;2;1;0;0;0;2;13;1;2;4071;26;26;1;0;0;2;2;4071;0;4083;2;1;
/org.eclipse.core.runtime/src/org/eclipse/core/internal/runtime/InternalPlatform.java;6;3;117;3;33;27;33;84;2739;4;61;621;8954;8954;4;23;6;84;117;3195;29;6245;88;6;
/org.eclipse.ui.views/src/org/eclipse/ui/views/navigator/NavigatorDropAdapter.java;2;0;2;1;0;0;0;2;11;1;2;1;11;11;1;0;0;2;2;1;0;2738;2;2;
/org.eclipse.jdt.ui.tests.refactoring/resources/IntroduceFactory/positive/DifferentArgs1_in.java;1;0;2;1;1;1;1;1;2;0;1;2862;2;2;1;0;0;1;2;2862;0;5659;2;1;
/org.eclipse.ui.ide/src/org/eclipse/ui/internal/registry/IDERegistryReader.java;2;0;3;1;0;0;0;3;2;2;2;1762;2;2;2;1;0;3;3;1762;1;2263;2;2;
/org.eclipse.core.runtime/src/org/eclipse/core/internal/locks/LockManager.java;1;0;1;1;0;0;0;1;0;0;1;320;0;0;1;0;0;1;1;320;0;320;1;1;
/org.eclipse.jdt.ui.tests/ui/org/eclipse/jdt/ui/tests/quickfix/ReorgQuickFixTest.java;2;1;13;1;5;5;5;8;243;1;8;1033;709;709;1;0;0;8;13;1033;0;6340;13;2;
/org.eclipse.ui.workbench/Eclipse UI/org/eclipse/ui/actions/OpenResourceAction.java;2;0;3;1;0;0;0;3;37;1;3;66;74;74;1;0;0;3;3;66;0;2737;3;2;
/org.eclipse.jdt.ui.tests/ui/org/eclipse/jdt/ui/tests/quickfix/UnresolvedMethodsQuickFixTest.java;3;2;27;2;10;9;10;17;633;2;15;299;3399;3399;2;2;1;17;27;299;3;6340;24;3;
/org.eclipse.ui.workbench/Eclipse UI/org/eclipse/ui/internal/progress/JobInfo.java;2;2;31;1;4;3;4;27;264;4;22;333;1143;1143;4;5;1;27;31;1110;6;6338;25;2;
/org.eclipse.jdt.ui/core refactoring/org/eclipse/jdt/internal/corext/refactoring/reorg2/ReorgUtils2.java;1;0;13;1;0;0;0;13;152;2;9;444;445;445;2;4;0;13;13;516;4;1111;9;1;
/org.eclipse.jdt.ui/ui/org/eclipse/jdt/ui/text/spelling/engine/DefaultPhoneticHashProvider.java;1;0;2;1;0;0;0;2;0;1;2;3829;0;0;1;0;0;2;2;3829;0;3930;2;1;
/org.eclipse.jdt.debug/model/org/eclipse/jdt/debug/core/IJavaArrayType.java;1;0;1;1;0;0;0;1;14;0;1;2176;14;14;1;0;0;1;1;2176;0;2176;1;1;
/org.eclipse.debug.ui/ui/org/eclipse/debug/internal/ui/launchVariables/FilePromptExpander.java;2;0;2;1;0;0;0;2;0;1;2;771;0;0;1;0;0;2;2;771;0;2120;2;2;
/org.eclipse.ui.workbench/Eclipse UI/org/eclipse/ui/internal/commands/util/old/Capture.java;1;0;2;1;0;0;0;2;0;1;2;1222;0;0;1;0;0;2;2;1222;0;1322;2;1;
/org.eclipse.core.tests.runtime/src/org/eclipse/core/tests/runtime/jobs/RuleSetC.java;2;0;2;1;0;0;0;2;0;1;2;2160;0;0;1;0;0;2;2;2160;0;3408;2;2;
/org.eclipse.jdt.core.tests.model/workspace/Converter/test0465/A.java;1;0;1;1;0;0;0;1;0;0;1;3714;0;0;1;0;0;1;1;3714;0;3714;1;1;
/org.eclipse.pde.ui/src/org/eclipse/pde/internal/ui/codegen/JavaCodeGenerator.java;2;1;4;1;2;2;2;2;19;1;2;698;31;31;1;0;0;2;4;698;0;5963;4;2;
/org.eclipse.update.core/srcnew/org/eclipse/update/internal/search/UnifiedSearchCategory2.java;1;0;5;1;0;0;0;5;17;2;4;572;23;23;2;1;0;5;5;572;1;672;4;1;
/org.eclipse.ui.views/src/org/eclipse/ui/views/markers/ProblemView.java;3;0;7;1;0;0;0;7;138;1;7;755;398;398;1;0;0;7;7;755;0;2738;7;3;
/org.eclipse.jdt.core/model/org/eclipse/jdt/internal/core/util/StackMapAttribute.java;1;0;1;1;0;0;0;1;0;0;1;3791;0;0;1;0;0;1;1;3791;0;3791;1;1;
/org.eclipse.core.tests.runtime/src/org/eclipse/core/tests/runtime/IRegistryChangeEventTest.java;3;1;3;1;2;2;2;1;41;0;1;3716;73;73;1;0;0;1;3;3716;0;5532;3;3;
/org.eclipse.jdt.ui/core extension/org/eclipse/jdt/internal/corext/dom/LocalVariableIndex.java;2;0;3;1;1;1;1;2;29;1;2;2887;40;40;1;0;0;2;3;2887;0;6340;3;2;
/org.eclipse.jdt.core/model/org/eclipse/jdt/internal/core/hierarchy/HierarchyBuilder.java;3;0;12;1;0;0;0;12;112;1;12;131;300;300;1;0;0;12;12;131;0;4731;12;3;
/org.eclipse.team.ui/src/org/eclipse/team/internal/ui/sync/pages/StatusLineCLabelContribution.java;1;0;1;1;0;0;0;1;0;0;1;2517;0;0;1;0;0;1;1;2517;0;2517;1;1;
/org.eclipse.jdt.ui/ui/org/eclipse/jdt/internal/ui/jarpackager/CreateJarActionDelegate.java;2;1;2;1;2;2;2;0;17;0;0;5438;19;19;1;0;0;0;2;5438;0;6340;2;2;
/org.eclipse.jdt.core.tests.model/workspace/Converter/test0227/Test.java;1;0;1;1;0;0;0;1;0;0;1;3714;0;0;1;0;0;1;1;3714;0;3714;1;1;
/org.eclipse.jdt.core/search/org/eclipse/jdt/internal/core/index/impl/IndexedFile.java;2;0;5;1;0;0;0;5;9;1;5;3194;16;16;1;0;0;5;5;3194;0;4060;5;2;
/org.eclipse.update.ui.forms/Eclipse Forms/org/eclipse/ui/forms/parts/IFormEntryListener.java;1;0;2;1;0;0;0;2;0;0;1;3096;0;0;2;1;0;2;2;3096;1;3096;1;1;
/org.eclipse.jdt.ui/core refactoring/org/eclipse/jdt/internal/corext/refactoring/tagging/IQualifiedNameUpdating.java;2;0;2;1;1;1;1;1;2;0;1;1125;2;2;1;0;0;1;2;1125;0;6340;2;2;
/org.eclipse.jdt.core.tests.model/workspace/Formatter/test271/A_in.java;1;0;1;1;0;0;0;1;0;0;1;2442;0;0;1;0;0;1;1;2442;0;2442;1;1;
/org.eclipse.ui.externaltools/External Tools Base/org/eclipse/ui/externaltools/internal/variable/WorkspaceExpander.java;1;0;1;1;0;0;0;1;0;0;1;321;0;0;1;0;0;1;1;321;0;321;1;1;
/org.eclipse.swt.tests/JUnit Tests/org/eclipse/swt/tests/junit/Test_org_eclipse_swt_graphics_Image.java;4;0;9;2;1;1;1;8;334;3;6;2175;526;526;3;2;0;8;9;2175;2;6352;7;4;
/org.eclipse.jdt.ui/core refactoring/org/eclipse/jdt/internal/corext/refactoring/tagging/IRenameRefactoring.java;1;0;4;1;0;0;0;4;3;1;4;1125;7;7;1;0;0;4;4;1125;0;4654;4;1;
/org.eclipse.team.cvs.ui/src/org/eclipse/team/internal/ccvs/ui/IHelpContextIds.java;2;1;6;1;2;2;2;4;24;1;4;784;31;31;1;0;0;4;6;784;0;6337;6;2;
/org.eclipse.jdt.ui/core refactoring/org/eclipse/ltk/core/refactoring/participants/CreateArguments.java;1;0;2;1;0;0;0;2;0;1;2;4624;0;0;1;0;0;2;2;4624;0;4864;2;1;
/org.eclipse.core.tests.runtime/src/org/eclipse/core/tests/runtime/PreferenceForwarderTest.java;1;1;10;1;2;2;2;8;105;2;5;4351;302;302;2;3;0;8;10;4351;3;5752;7;1;
/org.eclipse.swt.tests/JUnit Tests/org/eclipse/swt/tests/junit/Test_org_eclipse_swt_events_TraverseListener.java;1;0;1;1;0;0;0;1;16;0;1;2175;16;16;1;0;0;1;1;2175;0;2175;1;1;
/org.eclipse.ant.ui/Ant Tools Support/org/eclipse/ant/ui/internal/views/AntViewLabelProvider.java;1;0;4;1;0;0;0;4;31;2;3;250;31;31;2;1;0;4;4;262;1;1811;3;1;
/org.eclipse.search/new search/org/eclipse/search2/internal/ui/basic/views/ExpandAllAction.java;2;1;2;1;2;2;2;0;4;0;0;5434;4;4;1;0;0;0;2;5434;0;6340;2;2;
/org.eclipse.core.runtime.osgi/src/org/eclipse/core/runtime/jobs/IJobChangeListener.java;1;0;1;1;0;0;0;1;0;0;1;3013;0;0;1;0;0;1;1;3013;0;3013;1;1;
/org.eclipse.core.resources.linux/src/org/eclipse/core/resources/refresh/linux/LinuxMonitor.java;1;0;7;1;0;0;0;7;118;2;6;3681;166;166;2;1;0;7;7;3709;1;4346;6;1;
/org.eclipse.ui.workbench/Eclipse UI/org/eclipse/ui/commands/IWorkbenchWindowCommandSupport.java;1;0;4;1;0;0;0;4;11;2;3;3129;13;13;2;1;0;4;4;3129;1;4144;3;1;
/org.eclipse.jdt.ui/ui/org/eclipse/jdt/internal/ui/dnd/DelegatingDropAdapter.java;1;0;1;1;1;1;1;0;2;0;0;6340;2;2;1;0;0;0;1;6340;0;6340;1;1;
/org.eclipse.jdt.debug.ui/ui/org/eclipse/jdt/internal/debug/ui/launcher/RemoteJavaApplicationTabGroup.java;2;0;3;2;0;0;0;3;14;2;2;4927;18;18;2;1;0;3;3;4927;1;4953;2;2;
/org.eclipse.jdt.launching/launching/org/eclipse/jdt/internal/launching/SocketAttachConnector.java;2;0;2;1;1;1;1;1;4;0;1;3812;8;8;1;0;0;1;2;3812;0;6336;2;2;
/org.eclipse.webdav/src/interface/org/eclipse/webdav/dom/PropertyUpdate.java;1;0;2;1;2;1;2;0;257;0;0;5151;257;257;2;0;1;0;2;5151;1;5151;1;1;
/org.eclipse.jdt.core.tests.model/workspace/Converter/test0207/Test.java;1;0;1;1;0;0;0;1;0;0;1;3714;0;0;1;0;0;1;1;3714;0;3714;1;1;
/org.eclipse.jdt.core/model/org/eclipse/jdt/internal/core/JarPackageFragment.java;3;1;13;1;2;2;2;11;37;1;11;130;133;133;1;0;0;11;13;130;0;6143;13;3;
/org.eclipse.pde.ui/src_Forms/org/eclipse/pde/internal/ui/neweditor/plugin/ExportSection.java;3;3;9;2;6;3;6;3;251;1;3;4919;541;541;3;0;3;3;9;5425;3;5425;6;3;
/org.eclipse.jdt.ui.tests.refactoring/resources/ExtractMethodWorkSpace/ExtractMethodTests/parameterName_in/A_test904.java;1;0;1;1;0;0;0;1;2;0;1;844;2;2;1;0;0;1;1;844;0;844;1;1;
/org.eclipse.ant.ui/Ant Tools Support/org/eclipse/ant/internal/ui/datatransfer/ExternalAntBuildfileImportPage.java;1;0;2;1;1;1;1;1;16;0;1;4809;16;16;1;0;0;1;2;4809;0;5581;2;1;
/org.eclipse.update.ui.forms/Eclipse Forms/org/eclipse/ui/forms/internal/parts/PartsTest.java;1;0;7;1;0;0;0;7;337;3;3;3096;862;862;3;4;0;7;7;3133;4;3133;3;1;
/org.eclipse.ui.cheatsheets/src/org/eclipse/ui/internal/cheatsheets/views/FastViewHackPerspectiveListener.java;2;0;3;1;0;0;0;3;17;1;3;4428;17;17;1;0;0;3;3;4428;0;4701;3;2;
/org.eclipse.jdt.core.tests.model/workspace/Converter/test0399/A.java;1;0;1;1;0;0;0;1;0;0;1;3714;0;0;1;0;0;1;1;3714;0;3714;1;1;
/org.eclipse.core.resources/src/org/eclipse/core/resources/refresh/IRefreshResult.java;2;0;4;1;1;1;1;3;8;1;3;3681;12;12;1;0;0;3;4;3681;0;5146;4;2;
/org.eclipse.ui.workbench/Eclipse UI/org/eclipse/ui/internal/dialogs/FileStatesPage.java;2;0;2;1;0;0;0;2;2;1;2;1671;2;2;1;0;0;2;2;1671;0;2737;2;2;
/org.eclipse.ui.workbench/Eclipse UI/org/eclipse/ui/internal/commands/old/Persistence.java;1;0;4;1;0;0;0;4;539;2;3;1321;542;542;2;1;0;4;4;1321;1;1695;3;1;
/org.eclipse.jdt.debug.ui/ui/org/eclipse/jdt/internal/debug/ui/actions/RunToLineAdapter.java;3;1;7;2;2;2;2;5;88;2;3;4425;110;110;2;2;0;5;7;4425;2;5642;5;3;
/org.eclipse.swt.opengl/motif/org/eclipse/swt/opengl/internal/motif/XVisualInfo.java;1;0;1;1;0;0;0;1;0;0;1;1175;0;0;1;0;0;1;1;1175;0;1175;1;1;
/org.eclipse.ui.workbench/Eclipse UI/org/eclipse/ui/PartInitException.java;1;0;1;1;0;0;0;1;2;0;1;1;2;2;1;0;0;1;1;1;0;1;1;1;
/org.eclipse.core.runtime/src/org/eclipse/core/runtime/model/ExtensionModel.java;1;0;1;1;0;0;0;1;0;0;1;3013;0;0;1;0;0;1;1;3013;0;3013;1;1;
/org.eclipse.jdt.debug/jdi/org/eclipse/jdi/internal/spy/VerbosePacketStream.java;2;0;5;1;0;0;0;5;291;1;5;149;303;303;1;0;0;5;5;149;0;4267;5;2;
/org.eclipse.jdt.ui.tests.refactoring/resources/ChangeSignature/canModify/A_testInStatic02_in.java;1;0;1;1;0;0;0;1;0;0;1;3216;0;0;1;0;0;1;1;3216;0;3216;1;1;
/org.eclipse.jdt.ui/ui/org/eclipse/jdt/internal/ui/javaeditor/ToggleSmartTypingAction.java;1;0;2;1;0;0;0;2;0;1;2;500;0;0;1;0;0;2;2;500;0;677;2;1;
/org.eclipse.jdt.ui/ui/org/eclipse/jdt/internal/ui/preferences/QuickDiffPreferencePage.java;1;0;3;1;3;1;3;0;5;0;0;5502;5;5;3;0;2;0;3;5502;2;5502;1;1;
/org.eclipse.pde.ui/src_Forms/org/eclipse/pde/internal/ui/neweditor/schema/SchemaObjectPropertySource.java;1;0;2;1;0;0;0;2;0;1;2;4856;0;0;1;0;0;2;2;4856;0;4879;2;1;
/org.eclipse.swt/Eclipse SWT Drag and Drop/common/org/eclipse/swt/dnd/DragSourceAdapter.java;2;0;2;1;1;1;1;1;6;0;1;3899;10;10;1;0;0;1;2;3899;0;6352;2;2;
/org.eclipse.core.runtime.compatibility/src-model/org/eclipse/core/runtime/model/ExtensionPointModel.java;3;2;6;1;4;3;4;2;23;1;2;3013;32;32;2;0;1;2;6;5117;1;6340;5;3;
/org.eclipse.ui.workbench/Eclipse UI/org/eclipse/ui/AboutInfo.java;1;0;1;1;0;0;0;1;0;0;1;1317;0;0;1;0;0;1;1;1317;0;1317;1;1;
/org.eclipse.core.tests.resources/src/org/eclipse/core/tests/internal/indexing/StandAloneObjectStoreTest.java;1;0;1;1;1;1;1;0;6;0;0;5147;6;6;1;0;0;0;1;5147;0;5147;1;1;
/org.eclipse.jdt.core.tests.compiler/src/org/eclipse/jdt/core/tests/compiler/regression/Compliance_1_4.java;6;1;21;2;4;4;4;17;307;2;16;530;1201;1201;2;1;0;17;21;1286;1;5500;20;6;
/org.eclipse.jdt.ui.tests.refactoring/resources/MoveMembers/testFail22/in/B.java;1;0;1;1;0;0;0;1;0;0;1;1856;0;0;1;0;0;1;1;1856;0;1856;1;1;
/org.eclipse.jdt.debug.ui/ui/org/eclipse/jdt/internal/debug/ui/breakpoints/AddClassPrepareBreakpointAction.java;4;0;4;1;1;1;1;3;10;1;3;4525;19;19;1;0;0;3;4;4525;0;6336;4;4;
/org.eclipse.jdt.core/search/org/eclipse/jdt/internal/core/search/matching/PotentialMatch.java;2;0;9;1;0;0;0;9;452;1;9;77;695;695;1;0;0;9;9;77;0;2010;9;2;
/org.eclipse.ui.workbench/Eclipse UI/org/eclipse/ui/commands/internal/SequenceNode.java;1;0;2;1;0;0;0;2;0;1;2;786;0;0;1;0;0;2;2;786;0;956;2;1;
/org.eclipse.jdt.ui/core extension/org/eclipse/jdt/internal/corext/textmanipulation/MalformedTreeException.java;1;0;2;1;0;0;0;2;0;0;1;1946;0;0;2;1;0;2;2;1946;1;1946;1;1;
/org.eclipse.ui.views/src/org/eclipse/ui/views/navigator/WorkspaceActionGroup.java;2;0;2;1;0;0;0;2;23;1;2;66;23;23;1;0;0;2;2;66;0;2738;2;2;
/org.eclipse.core.runtime.compatibility/src-runtime/org/eclipse/core/runtime/IExecutableExtension.java;2;0;4;1;0;0;0;4;173;1;4;3013;174;174;1;0;0;4;4;3013;0;3169;4;2;
/org.eclipse.ui.editors/src/org/eclipse/ui/internal/editors/quickdiff/compare/rangedifferencer/RangeDifference.java;2;0;2;1;0;0;0;2;0;1;2;1118;0;0;1;0;0;2;2;1118;0;1644;2;2;
/org.eclipse.jdt.core.tests.model/workspace/Converter/test0087/Test.java;1;0;1;1;0;0;0;1;0;0;1;3714;0;0;1;0;0;1;1;3714;0;3714;1;1;
/org.eclipse.jdt.core.tests.model/workspace/Formatter/test202/A_out.java;1;0;1;1;0;0;0;1;0;0;1;2424;0;0;1;0;0;1;1;2424;0;2424;1;1;
/org.eclipse.jdt.core.tests.model/workspace/Formatter/test487/A_out.java;1;0;1;1;1;1;1;0;0;0;0;5188;0;0;1;0;0;0;1;5188;0;5188;1;1;
/org.eclipse.jdt.ui/core refactoring/org/eclipse/jdt/internal/corext/refactoring/participants/xml/TestResult.java;1;0;6;1;0;0;0;6;54;1;6;1668;108;108;1;0;0;6;6;1668;0;4091;6;1;
/org.eclipse.team.core/src/org/eclipse/team/core/subscribers/helpers/DescendantSynchronizationCache.java;1;0;1;1;0;0;0;1;0;0;1;3240;0;0;1;0;0;1;1;3240;0;3240;1;1;
/org.eclipse.jdt.ui/core extension/org/eclipse/jdt/internal/corext/textmanipulation/InsertEdit.java;1;0;3;1;0;0;0;3;4;0;1;1946;4;4;3;2;0;3;3;1946;2;1946;1;1;
/org.eclipse.swt/Eclipse SWT Printing/gtk1x/org/eclipse/swt/printing/PrintDialog.java;1;0;1;1;0;0;0;1;0;0;1;2327;0;0;1;0;0;1;1;2327;0;2327;1;1;
/org.eclipse.core.tools.resources/src/org/eclipse/core/tools/resources/LocalHistoryBrowserView.java;1;0;1;1;1;1;1;0;0;0;0;6302;0;0;1;0;0;0;1;6302;0;6302;1;1;
/org.eclipse.core.tools/src/org/eclipse/core/tools/TreeContentProviderNode.java;1;0;1;1;1;1;1;0;0;0;0;6302;0;0;1;0;0;0;1;6302;0;6302;1;1;
/org.eclipse.pde.core/src/org/eclipse/pde/core/IEditable.java;2;1;4;1;3;3;3;1;34;0;1;4203;42;42;1;0;0;1;4;4203;0;6336;4;2;
/org.eclipse.pde.core/src/org/eclipse/pde/core/plugin/IPluginModelFactory.java;2;1;3;1;2;2;2;1;53;0;1;2184;75;75;1;0;0;1;3;2184;0;6336;3;2;
/org.eclipse.ui.ide/src/org/eclipse/ui/views/markers/internal/TableSortDialog.java;2;0;3;1;1;1;1;2;3;1;2;2208;6;6;1;0;0;2;3;2208;0;6340;3;2;
/org.eclipse.update.ui.forms/src/org/eclipse/ui/forms/parts/SectionPart.java;1;0;4;1;0;0;0;4;9;2;3;3071;14;14;2;1;0;4;4;3095;1;3095;3;1;
/org.eclipse.jdt.core.tests.model/workspace/Formatter/test278/A_out.java;1;0;1;1;0;0;0;1;0;0;1;2443;0;0;1;0;0;1;1;2443;0;2443;1;1;
/org.eclipse.ui.intro/src/org/eclipse/ui/internal/intro/impl/util/IntroModelSerializer.java;1;2;11;1;11;10;11;0;192;0;0;5115;310;310;2;0;1;0;11;5314;1;5937;10;1;
/org.eclipse.jdt.debug.ui/ui/org/eclipse/jdt/internal/debug/ui/actions/ManageMethodBreakpointActionDelegate.java;3;0;8;1;0;0;0;8;191;1;8;1240;489;489;1;0;0;8;8;1240;0;4492;8;3;
/org.eclipse.jdt.core/search/org/eclipse/jdt/internal/core/search/matching/QualifiedTypeDeclarationPattern.java;3;0;14;2;3;1;3;11;123;2;9;1115;373;373;3;2;2;11;14;5207;4;5207;10;3;
/org.eclipse.osgi/resolver/src/org/eclipse/core/internal/dependencies/IMatchRule.java;2;1;2;1;2;2;2;0;2;0;0;5226;2;2;1;0;0;0;2;5226;0;5408;2;2;
/org.eclipse.jdt.core/dom/org/eclipse/jdt/core/dom/MethodBinding.java;3;0;7;1;0;0;0;7;14;1;7;306;48;48;1;0;0;7;7;306;0;4977;7;3;
/org.eclipse.ui.intro/src/org/eclipse/ui/intro/internal/IntroPlugin.java;1;0;7;1;1;1;1;6;150;1;6;4429;179;179;1;0;0;6;7;4429;0;5115;7;1;
/org.eclipse.ui.workbench/Eclipse UI/org/eclipse/ui/internal/csm/commands/CommandPatternBindingDefinition.java;1;0;2;1;0;0;0;2;0;1;2;2515;0;0;1;0;0;2;2;2515;0;2532;2;1;
/org.eclipse.jdt.junit/src/org/eclipse/jdt/internal/junit/util/LayoutUtil.java;1;0;1;1;1;1;1;0;2;0;0;6340;2;2;1;0;0;0;1;6340;0;6340;1;1;
/org.eclipse.jdt.ui.tests.refactoring/test cases/org/eclipse/jdt/ui/tests/refactoring/TestMoveParticipantSingle.java;1;0;1;1;0;0;0;1;0;0;1;4913;0;0;1;0;0;1;1;4913;0;4913;1;1;
/org.eclipse.sdk.tests-feature/plugins/org.eclipse.perfmsr.ui/src/org/eclipse/perfmsr/ui/Helper.java;2;1;3;1;2;2;2;1;10;0;1;4845;14;14;1;0;0;1;3;4845;0;6342;3;2;
/org.eclipse.jdt.core/compiler/org/eclipse/jdt/internal/compiler/lookup/InnerEmulationDependency.java;1;0;1;1;0;0;0;1;2;0;1;3560;2;2;1;0;0;1;1;3560;0;3560;1;1;
/org.eclipse.ui.workbench/Eclipse UI/org/eclipse/ui/internal/commands/keys/ModifierKey.java;1;0;3;1;0;0;0;3;11;1;3;1264;21;21;1;0;0;3;3;1264;0;1294;3;1;
/org.eclipse.ant.tests.ui/test plugin/org/eclipse/ant/tests/ui/testplugin/ProjectHelper.java;1;0;3;1;0;0;0;3;16;1;3;1388;18;18;1;0;0;3;3;1388;0;2969;3;1;
/org.eclipse.ui.workbench/Eclipse UI/org/eclipse/ui/internal/activities/ExtensionActivityRegistry.java;4;1;15;2;2;2;2;13;121;2;12;2444;436;436;2;1;0;13;15;3170;1;6338;14;4;
/org.eclipse.jdt.core.tests.model/workspace/Converter/test0395/A.java;1;0;1;1;0;0;0;1;0;0;1;3714;0;0;1;0;0;1;1;3714;0;3714;1;1;
/org.eclipse.webdav/src/client/org/eclipse/webdav/internal/authentication/DigestOutputStream.java;1;0;2;1;2;1;2;0;11;0;0;5151;11;11;2;0;1;0;2;5151;1;5151;1;1;
/org.eclipse.team.ftp/src/org/eclipse/team/internal/ftp/subscriber/FTPSychronizer.java;1;0;1;1;0;0;0;1;0;0;1;3205;0;0;1;0;0;1;1;3205;0;3205;1;1;
/org.eclipse.jdt.core.tests.model/workspace/Formatter/test038/A_out.java;1;0;1;1;0;0;0;1;0;0;1;2425;0;0;1;0;0;1;1;2425;0;2425;1;1;
/org.eclipse.team.ui/src/org/eclipse/team/ui/synchronize/viewers/DiffNodeControllerHierarchical.java;1;0;1;1;0;0;0;1;0;0;1;4071;0;0;1;0;0;1;1;4071;0;4071;1;1;
/org.eclipse.team.webdav/src/org/eclipse/team/internal/target/subscriber/SyncBytesComparisonCriteria.java;2;0;3;1;0;0;0;3;83;1;3;3514;83;83;1;0;0;3;3;3514;0;4349;3;2;
/org.eclipse.jdt.ui.tests.refactoring/test cases/org/eclipse/jdt/ui/tests/refactoring/MoveInstanceMethodTests.java;4;0;14;1;1;1;1;13;62;2;12;345;193;193;2;1;0;13;14;1603;1;6340;13;4;
/org.eclipse.jdt.ui.tests.refactoring/resources/ExtractMethodWorkSpace/ExtractMethodTests/nested_out/A_test654.java;1;0;2;1;0;0;0;2;4;1;2;130;5;5;1;0;0;2;2;130;0;844;2;1;
/org.eclipse.ui.workbench/Eclipse UI/org/eclipse/ui/internal/skins/IPresentationSite.java;2;0;4;1;0;0;0;4;28;1;4;4328;35;35;1;0;0;4;4;4328;0;4469;4;2;
/org.eclipse.jdt.ui/ui/org/eclipse/jdt/internal/ui/reorg/ReorgMessages.java;1;0;1;1;0;0;0;1;0;0;1;1112;0;0;1;0;0;1;1;1112;0;1112;1;1;
/org.eclipse.core.runtime/src/org/eclipse/core/runtime/jobs/IProgressProvider.java;1;0;3;1;0;0;0;3;32;1;3;662;32;32;1;0;0;3;3;662;0;2781;3;1;
/org.eclipse.jdt.ui/core refactoring/org/eclipse/jdt/internal/corext/refactoring/structure/PushDownRefactoring.java;5;1;42;1;9;9;9;33;400;3;29;122;992;992;3;4;0;33;42;238;4;6340;38;5;
/org.eclipse.update.core/src/org/eclipse/update/internal/core/UpdateManagerUtils.java;3;2;28;2;8;7;8;20;168;3;16;890;444;444;3;4;1;20;28;3090;5;6336;23;3;
/org.eclipse.jdt.ui/core extension/org/eclipse/jdt/internal/corext/dom/ASTNodeFactory.java;4;1;9;1;3;3;3;6;61;2;5;130;144;144;2;1;0;6;9;343;1;6340;8;4;
/org.eclipse.pde.runtime/src/org/eclipse/pde/internal/runtime/IHelpContextIds.java;2;1;2;1;2;2;2;0;6;0;0;5797;10;10;1;0;0;0;2;5797;0;6336;2;2;
/org.eclipse.ui.examples.job/org/eclipse/ui/examples/jobs/views/SlowElement.java;1;0;2;1;2;1;2;0;0;0;0;5125;0;0;2;0;1;0;2;5125;1;5125;1;1;
/org.eclipse.ant.ui/Ant Tools Support/org/eclipse/ant/internal/ui/datatransfer/ProjectCreator.java;1;0;1;1;0;0;0;1;0;0;1;4809;0;0;1;0;0;1;1;4809;0;4809;1;1;
/org.eclipse.ui.ide/src/org/eclipse/ui/internal/LinkedResourceDecorator.java;2;0;5;1;0;0;0;5;31;1;5;1520;34;34;1;0;0;5;5;1520;0;2263;5;2;
/org.eclipse.ant.ui/Ant Tools Support/org/eclipse/ant/ui/internal/model/AntUIPlugin.java;2;0;10;1;0;0;0;10;96;3;7;250;137;137;3;3;0;10;10;1403;3;1811;7;2;
/org.eclipse.core.runtime/src/org/eclipse/core/runtime/Path.java;3;2;12;1;5;4;5;7;1704;1;7;1431;3481;3481;2;0;1;7;12;5379;1;6340;11;3;
/org.eclipse.jdt.ui/core refactoring/org/eclipse/jdt/internal/corext/refactoring/code/CallInliner.java;5;1;26;1;3;3;3;23;202;2;21;218;809;809;2;2;0;23;26;1952;2;6340;24;5;
/org.eclipse.update.core/src/org/eclipse/update/core/IInstallHandler.java;2;1;3;1;2;2;2;1;6;0;1;890;12;12;1;0;0;1;3;890;0;6336;3;2;
/org.eclipse.compare.examples.xml/src/org/eclipse/compare/examples/xml/XMLCompareEditOrderedDialog.java;1;0;3;1;0;0;0;3;73;1;3;1106;75;75;1;0;0;3;3;1106;0;3938;3;1;
/org.eclipse.ltk.core.refactoring.tests/src/org/eclipse/ltk/core/refactoring/tests/EmptySuite.java;1;0;1;1;0;0;0;1;0;0;1;4845;0;0;1;0;0;1;1;4845;0;4845;1;1;
/org.eclipse.jdt.core/compiler/org/eclipse/jdt/internal/compiler/IDocumentElementRequestor.java;2;0;2;1;0;0;0;2;2;1;2;3560;2;2;1;0;0;2;2;3560;0;4461;2;2;
/org.eclipse.pde.ui/src/org/eclipse/pde/internal/ui/util/ChoiceCellEditor.java;1;0;1;1;0;0;0;1;0;0;1;1962;0;0;1;0;0;1;1;1962;0;1962;1;1;
/org.eclipse.swt/Eclipse SWT/gtk/org/eclipse/swt/widgets/Display.java;7;5;83;3;33;22;33;50;366;3;40;0;2608;2608;5;10;11;50;83;5527;21;6362;62;7;
/org.eclipse.ui.workbench/Eclipse UI/org/eclipse/ui/part/TransferDropTargetListener.java;1;0;2;1;0;0;0;2;0;0;1;173;0;0;2;1;0;2;2;173;1;173;1;1;
/org.eclipse.pde.ui/templates_3.0/propertyPages/java/$className$.java;1;0;1;1;0;0;0;1;0;0;1;2786;0;0;1;0;0;1;1;2786;0;2786;1;1;
/org.eclipse.ua.tests/src/org/eclipse/ui/examples/cheatsheets/pattern/actions/LaunchPatternSelectionDialogAction.java;1;0;1;1;1;1;1;0;0;0;0;6081;0;0;1;0;0;0;1;6081;0;6081;1;1;
/org.eclipse.jface/src/org/eclipse/jface/viewers/CustomHashtable.java;2;1;2;1;2;2;2;0;16;0;0;5736;23;23;1;0;0;0;2;5736;0;6338;2;2;
/org.eclipse.core.tests.runtime/src/org/eclipse/core/tests/runtime/content/ContentDescriptionTest.java;1;1;2;1;2;2;2;0;12;0;0;5643;12;12;1;0;0;0;2;5643;0;5781;2;1;
/org.eclipse.compare.examples.xml/src/org/eclipse/compare/examples/xml/Mapping.java;1;0;3;1;0;0;0;3;2;1;3;1106;3;3;1;0;0;3;3;1106;0;3938;3;1;
/org.eclipse.update.ui.win32/src/org/eclipse/welcome/internal/portal/IFormContentProvider.java;1;0;1;1;0;0;0;1;0;0;1;925;0;0;1;0;0;1;1;925;0;925;1;1;
/org.eclipse.ant.ui/Ant Tools Support/org/eclipse/ant/internal/ui/launchConfigurations/AddVariableStringAction.java;1;0;2;1;0;0;0;2;136;0;1;4978;136;136;2;1;0;2;2;4978;1;4978;1;1;
/org.eclipse.team.ui/src/org/eclipse/team/internal/ui/wizards/ProjectSetImportWizard.java;2;1;10;1;5;5;5;5;159;2;4;987;223;223;2;1;0;5;10;987;1;6337;9;2;
/org.eclipse.jdt.ui.tests.refactoring/resources/ExtractMethodWorkSpace/ExtractMethodTests/validSelection_in/A_test361.java;1;0;1;1;0;0;0;1;4;0;1;844;4;4;1;0;0;1;1;844;0;844;1;1;
/org.eclipse.compare/compare/org/eclipse/compare/structuremergeviewer/DiffContainer.java;1;0;2;1;1;1;1;1;2;0;1;3938;3;3;1;0;0;1;2;3938;0;6322;2;1;
/org.eclipse.ui.ide/src/org/eclipse/ui/internal/model/WorkbenchMarker.java;2;0;5;1;0;0;0;5;4;1;5;1511;12;12;1;0;0;5;5;1511;0;2263;5;2;
/org.eclipse.jdt.ui/ui refactoring/org/eclipse/jdt/internal/ui/refactoring/RefactoringWizardDialog2.java;3;0;10;1;0;0;0;10;50;2;9;42;85;85;2;1;0;10;10;532;1;4965;9;3;
/org.eclipse.jdt.ui/ui/org/eclipse/jdt/internal/ui/viewsupport/ResourceToItemsMapper.java;2;0;3;1;1;1;1;2;42;1;2;2081;46;46;1;0;0;2;3;2081;0;6340;3;2;
/org.eclipse.osgi/core/framework/org/eclipse/osgi/framework/internal/core/PermissionAdminImpl.java;2;2;4;1;4;3;4;0;60;0;0;5116;76;76;2;0;1;0;4;5116;1;6337;3;2;
/org.eclipse.ui.views/src/org/eclipse/ui/views/bookmarkexplorer/BookmarkNavigator.java;1;0;1;1;0;0;0;1;0;0;1;2738;0;0;1;0;0;1;1;2738;0;2738;1;1;
/org.eclipse.ui.externaltools/Ant Tools Support/org/eclipse/ui/externaltools/internal/ant/preferences/TabFolderLayout.java;1;0;1;1;0;0;0;1;0;0;1;282;0;0;1;0;0;1;1;282;0;282;1;1;
/org.eclipse.jdt.ui.tests.refactoring/resources/InlineMethodWorkspace/TestCases/simple_out/TestLabeledStatement.java;1;0;1;1;0;0;0;1;0;0;1;2277;0;0;1;0;0;1;1;2277;0;2277;1;1;
/org.eclipse.team.ui/src/org/eclipse/team/internal/ui/sync/actions/RefreshAction.java;2;0;16;2;0;0;0;16;71;2;15;848;267;267;2;1;0;16;16;1013;1;2632;15;2;
/org.eclipse.update.core/srcnew/org/eclipse/update/internal/operations/PatchCleaner2.java;1;0;5;1;0;0;0;5;2;1;5;367;5;5;1;0;0;5;5;367;0;825;5;1;
/org.eclipse.jdt.core.tests.model/workspace/Converter/test0150/Test.java;1;0;1;1;0;0;0;1;0;0;1;3714;0;0;1;0;0;1;1;3714;0;3714;1;1;
/org.eclipse.jdt.core.tests.model/src/org/eclipse/jdt/core/tests/dom/ASTTest.java;4;0;29;2;1;1;1;28;2743;3;24;173;4999;4999;3;4;0;28;29;3683;4;5272;25;4;
/org.eclipse.team.core/src/org/eclipse/team/core/sync/RemoteSyncElement.java;2;0;3;1;0;0;0;3;2;1;3;790;3;3;1;0;0;3;3;790;0;4217;3;2;
/org.eclipse.jdt.debug.ui/ui/org/eclipse/jdt/internal/debug/core/refactoring/JavaMethodBreakpointMethodNameChange.java;2;0;3;1;1;1;1;2;8;1;2;4895;11;11;1;0;0;2;3;4895;0;6339;3;2;
/org.eclipse.jdt.core.tests.model/workspace/Converter/test0028/Test.java;1;0;1;1;0;0;0;1;0;0;1;3714;0;0;1;0;0;1;1;3714;0;3714;1;1;
/org.eclipse.jdt.ui/core extension/org/eclipse/jdt/internal/corext/dom/RewriteEventStore.java;2;0;11;1;1;1;1;10;241;1;10;2893;629;629;1;0;0;10;11;2893;0;5406;11;2;
/org.eclipse.ui.externaltools/External Tools Base/org/eclipse/ui/externaltools/internal/variable/PromptExpanderBase.java;2;0;3;1;0;0;0;3;204;1;3;245;204;204;1;0;0;3;3;245;0;321;3;2;
/org.eclipse.ui.workbench/Eclipse UI/org/eclipse/ui/internal/commands/gestures/Gesture.java;1;0;2;1;0;0;0;2;105;1;2;1277;105;105;1;0;0;2;2;1277;0;1294;2;1;
/org.eclipse.team.ui/src/org/eclipse/team/ui/synchronize/viewers/CompressedFoldersModelProvider.java;1;0;4;1;0;0;0;4;281;2;3;4213;287;287;2;1;0;4;4;4213;1;4449;3;1;
/org.eclipse.core.runtime/src/org/eclipse/core/internal/plugins/PluginMap.java;2;0;3;1;0;0;0;3;6;1;3;2105;6;6;1;0;0;3;3;2105;0;3013;3;2;
/org.eclipse.jdt.ui/core refactoring/org/eclipse/jdt/internal/corext/refactoring/participants/RefactoringProcessors.java;1;0;1;1;0;0;0;1;0;0;1;4654;0;0;1;0;0;1;1;4654;0;4654;1;1;
/org.eclipse.core.runtime/src/org/eclipse/core/internal/plugins/IPluginEventDispatcher.java;2;0;2;1;0;0;0;2;0;1;2;2105;0;0;1;0;0;2;2;2105;0;3013;2;2;
/org.eclipse.jdt.core.tests.model/workspace/Converter/src/junit/swingui/TestRunView.java;1;0;1;1;0;0;0;1;0;0;1;3714;0;0;1;0;0;1;1;3714;0;3714;1;1;
/org.eclipse.update.ui/src/org/eclipse/update/internal/ui/wizards/SwapFeatureWizard.java;2;0;2;1;0;0;0;2;0;1;2;1228;0;0;1;0;0;2;2;1228;0;1242;2;2;
/org.eclipse.jdt.core.tests.model/workspace/JavaSearch/src/d4/X.java;1;0;1;1;0;0;0;1;2;0;1;2581;2;2;1;0;0;1;1;2581;0;2581;1;1;
/org.eclipse.pde.ui/src_Forms/org/eclipse/pde/internal/ui/model/DocumentHandler.java;2;1;4;1;4;4;4;0;10;0;0;5703;27;27;1;0;0;0;4;5703;0;6336;4;2;
/org.eclipse.ui.workbench/Eclipse UI/org/eclipse/ui/internal/csm/commands/ContextBinding.java;1;0;2;1;0;0;0;2;0;0;1;2532;0;0;2;1;0;2;2;2532;1;2532;1;1;
/org.eclipse.ui.workbench.texteditor/src/org/eclipse/ui/texteditor/ExtendedTextEditor.java;3;0;13;1;0;0;0;13;101;2;11;1644;225;225;2;2;0;13;13;2215;2;2741;11;3;
/org.eclipse.team.ui/src/org/eclipse/team/internal/ui/synchronize/TeamSubscriberParticipantPage.java;1;0;1;1;0;0;0;1;0;0;1;2535;0;0;1;0;0;1;1;2535;0;2535;1;1;
/org.eclipse.jface.text/src/org/eclipse/jface/internal/text/link/contentassist/CompletionProposalPopup2.java;2;1;4;1;2;2;2;2;11;1;2;4214;17;17;1;0;0;2;4;4214;0;6340;4;2;
/org.eclipse.ui.cheatsheets/src/org/eclipse/ui/internal/cheatsheets/data/CheatSheet.java;1;0;1;1;1;1;1;0;0;0;0;5189;0;0;1;0;0;0;1;5189;0;5189;1;1;
/org.eclipse.ui.ide/src/org/eclipse/ui/internal/ide/dialogs/PathVariablesGroup.java;1;0;1;1;0;0;0;1;0;0;1;2264;0;0;1;0;0;1;1;2264;0;2264;1;1;
/org.eclipse.team.ui/src/org/eclipse/team/ui/synchronize/subscribers/RefreshSubscriberJob.java;2;2;10;2;6;4;6;4;57;1;4;4632;96;96;2;0;2;4;10;5104;2;5358;8;2;
/org.eclipse.debug.ui/ui/org/eclipse/debug/internal/ui/actions/WatchAction.java;2;1;4;1;2;2;2;2;19;1;2;1516;31;31;1;0;0;2;4;1516;0;6336;4;2;
/org.eclipse.team.cvs.ui/src/org/eclipse/team/internal/ccvs/ui/actions/UnmanageAction.java;2;0;3;1;1;1;1;2;76;1;2;2762;86;86;1;0;0;2;3;2762;0;6337;3;2;
/org.eclipse.pde.ui/src/org/eclipse/pde/internal/ui/editor/build/BuildInputContextManager.java;2;2;4;2;4;3;4;0;16;0;0;5431;26;26;2;0;1;0;4;5431;1;6336;3;2;
/org.eclipse.pde.ui/src/org/eclipse/pde/internal/ui/view/ModelEntryPropertySource.java;2;1;2;1;2;2;2;0;38;0;0;5783;42;42;1;0;0;0;2;5783;0;6336;2;2;
/org.eclipse.team.cvs.ui/src/org/eclipse/team/internal/ccvs/ui/repo/RemoveRootAction.java;2;1;10;1;3;3;3;7;37;1;7;990;94;94;1;0;0;7;10;990;0;6337;10;2;
/org.eclipse.ui.ide/src/org/eclipse/ui/views/properties/IDEPropertiesMessages.java;1;0;1;1;0;0;0;1;0;0;1;2208;0;0;1;0;0;1;1;2208;0;2208;1;1;
/org.eclipse.jface/src/org/eclipse/jface/viewers/IViewerLabelProvider.java;2;0;3;2;0;0;0;3;43;2;2;4587;43;43;2;1;0;3;3;4601;1;4601;2;2;
/org.eclipse.update.ui.forms/src/org/eclipse/update/ui/forms/internal/ExpandableGroup.java;1;0;1;1;0;0;0;1;3;0;1;645;3;3;1;0;0;1;1;645;0;645;1;1;
/org.eclipse.jdt.core.tests.model/workspace/Converter/src/test0159/Test.java;1;0;1;1;0;0;0;1;0;0;1;3714;0;0;1;0;0;1;1;3714;0;3714;1;1;
/org.eclipse.ui.forms/src/org/eclipse/ui/internal/forms/widgets/Locator.java;1;0;2;1;1;1;1;1;4;0;1;5044;4;4;1;0;0;1;2;5044;0;6336;2;1;
/org.eclipse.jdt.ui/core refactoring/org/eclipse/jdt/internal/corext/refactoring/participants/JavaProcessors.java;2;0;5;1;1;1;1;4;31;1;4;825;66;66;1;0;0;4;5;825;0;6340;5;2;
/org.eclipse.jdt.core.tests.compiler/src/org/eclipse/jdt/core/tests/compiler/parser/SyntaxErrorTest.java;4;0;12;1;0;0;0;12;72;1;12;69;107;107;1;0;0;12;12;69;0;4650;12;4;
/org.eclipse.pde/src/org/eclipse/pde/internal/builders/SchemaTransformer.java;3;1;25;2;3;3;3;22;500;1;22;910;2746;2746;1;0;0;22;25;910;0;6336;25;3;
/org.eclipse.search.tests/src/org/eclipse/search/core/tests/LineConversionTest.java;1;1;2;1;2;2;2;0;6;0;0;5852;6;6;1;0;0;0;2;5852;0;6124;2;1;
/org.eclipse.swt/Eclipse SWT PI/carbon/org/eclipse/swt/internal/carbon/PMResolution.java;2;2;4;1;3;2;3;1;16;0;1;2733;20;20;2;0;1;1;4;5534;1;5614;3;2;
/org.eclipse.search/search/org/eclipse/search/internal/ui/WorkingSetComparator.java;1;0;1;1;1;1;1;0;2;0;0;6340;2;2;1;0;0;0;1;6340;0;6340;1;1;
/org.eclipse.update.ui.win32/src/org/eclipse/welcome/internal/webbrowser/WebBrowser.java;1;0;1;1;0;0;0;1;0;0;1;907;0;0;1;0;0;1;1;907;0;907;1;1;
/org.eclipse.text/projection/org/eclipse/jface/text/projection/FragmentUpdater.java;1;1;4;1;2;2;2;2;38;1;2;4516;48;48;1;0;0;2;4;4516;0;6301;4;1;
/org.eclipse.swt/Eclipse SWT/gtk1x/org/eclipse/swt/widgets/TabFolder.java;1;0;1;1;0;0;0;1;0;0;1;2327;0;0;1;0;0;1;1;2327;0;2327;1;1;
/org.eclipse.jdt.core.tests.model/workspace/Converter/src/test0299/Test.java;1;0;1;1;0;0;0;1;0;0;1;3714;0;0;1;0;0;1;1;3714;0;3714;1;1;
/org.eclipse.jface/src/org/eclipse/jface/progress/UIJob.java;1;0;5;1;0;0;0;5;95;2;4;598;135;135;2;1;0;5;5;955;1;972;4;1;
/org.eclipse.jdt.ui/ui/org/eclipse/jdt/internal/ui/wizards/NewInterfaceCreationWizard.java;2;1;6;1;2;2;2;4;22;2;3;4064;54;54;2;1;0;4;6;4064;1;6340;5;2;
/org.eclipse.jdt.core.tests.model/workspace/Formatter/test019/A_2_in.java;1;0;1;1;0;0;0;1;0;0;1;2425;0;0;1;0;0;1;1;2425;0;2425;1;1;
/org.eclipse.compare.tests/JUnit Tests/org/eclipse/compare/tests/StreamMergerTest.java;1;1;2;1;2;2;2;0;4;0;0;5165;4;4;1;0;0;0;2;5165;0;5185;2;1;
/org.eclipse.ui.editors/src/org/eclipse/ui/editors/quickdiff/QuickDiffToggleAction.java;2;0;4;1;0;0;0;4;207;1;4;1214;267;267;1;0;0;4;4;1214;0;1644;4;2;
/org.eclipse.jdt.ui.tests.refactoring/resources/RenamePackage/testImportFromMultiRoots2/in/srcTest/tests/QualifiedTests.java;1;0;2;1;0;0;0;2;16;1;2;3219;16;16;1;0;0;2;2;3219;0;4105;2;1;
/org.eclipse.team.cvs.core/src/org/eclipse/team/internal/ccvs/core/connection/PServerConnection.java;2;1;5;1;2;2;2;3;7;1;3;276;17;17;1;0;0;3;5;276;0;6337;5;2;
/org.eclipse.jdt.ui/core extension/org/eclipse/jdt/internal/corext/codemanipulation/ImportReferencesCollector.java;2;1;2;1;2;2;2;0;2;0;0;5439;2;2;1;0;0;0;2;5439;0;6340;2;2;
/org.eclipse.ui.workbench/Eclipse UI/org/eclipse/ui/internal/commands/util/Stroke.java;1;0;2;1;0;0;0;2;0;1;2;1077;0;0;1;0;0;2;2;1077;0;1222;2;1;
/org.eclipse.jdt.ui.tests.refactoring/resources/ExtractTemp/canExtract/A_test73_in.java;1;0;1;1;0;0;0;1;0;0;1;1569;0;0;1;0;0;1;1;1569;0;1569;1;1;
/org.eclipse.team.examples.filesystem/src/org/eclipse/team/examples/filesystem/FileSystemSimpleAccessOperations.java;2;0;3;1;0;0;0;3;20;1;3;1708;29;29;1;0;0;3;3;1708;0;4368;3;2;
/org.eclipse.update.core/srcnew/org/eclipse/update/internal/operations/FeatureHierarchyElement2.java;2;0;5;1;0;0;0;5;57;1;5;460;70;70;1;0;0;5;5;460;0;825;5;2;
/org.eclipse.ltk.core.refactoring/src/org/eclipse/ltk/core/refactoring/participants/DeleteArguments.java;1;0;3;1;1;1;1;2;14;1;2;4845;17;17;1;0;0;2;3;4845;0;5184;3;1;
/org.eclipse.jdt.launching/launching/org/eclipse/jdt/launching/IRuntimeClasspathEntry2.java;1;0;1;1;0;0;0;1;0;0;1;4974;0;0;1;0;0;1;1;4974;0;4974;1;1;
/org.eclipse.team.ftp/src/org/eclipse/team/internal/ftp/FTPPlugin.java;2;0;3;1;1;1;1;2;14;1;2;866;28;28;1;0;0;2;3;866;0;6337;3;2;
/org.eclipse.debug.ui/ui/org/eclipse/debug/ui/IRootVariablesContentProvider.java;2;0;2;1;0;0;0;2;0;1;2;670;0;0;1;0;0;2;2;670;0;1989;2;2;
/org.eclipse.jdt.core.tests.model/workspace/Formatter/test147/A_out.java;1;0;1;1;0;0;0;1;0;0;1;2425;0;0;1;0;0;1;1;2425;0;2425;1;1;
/org.eclipse.search/new search/org/eclipse/search2/internal/ui/SearchMessages.java;2;0;2;1;1;1;1;1;2;0;1;3474;2;2;1;0;0;1;2;3474;0;6340;2;2;
/org.eclipse.update.tests.core/src/org/eclipse/update/tests/branding/AllBrandingTests.java;1;0;3;1;1;1;1;2;4;1;2;4613;6;6;1;0;0;2;3;4613;0;6336;3;1;
/org.eclipse.jdt.ui/core refactoring/org/eclipse/jdt/internal/corext/refactoring/participants/properties/IPropertyEvaluator.java;1;0;2;1;0;0;0;2;0;1;2;825;0;0;1;0;0;2;2;825;0;1033;2;1;
/org.eclipse.pde.ui/src/org/eclipse/pde/internal/ui/wizards/WizardListSelectionPage.java;3;1;6;1;3;3;3;3;263;1;3;867;298;298;1;0;0;3;6;867;0;6336;6;3;
/org.eclipse.jdt.core/model/org/eclipse/jdt/internal/compiler/parser/SourceFieldDeclaration.java;1;0;1;1;0;0;0;1;0;0;1;4461;0;0;1;0;0;1;1;4461;0;4461;1;1;
/org.eclipse.jdt.core.tests.model/workspace/Formatter/test456/A_out.java;1;0;1;1;0;0;0;1;0;0;1;3788;0;0;1;0;0;1;1;3788;0;3788;1;1;
/org.eclipse.jdt.debug.ui/ui/org/eclipse/jdt/internal/debug/ui/actions/ConvertToWatchExpressionAction.java;2;0;2;1;0;0;0;2;2;1;2;1175;2;2;1;0;0;2;2;1175;0;1516;2;2;
/org.eclipse.team.webdav/src/org/eclipse/team/internal/ui/target/subscriber/MappingSelectionPage.java;2;0;3;1;1;1;1;2;202;1;2;3494;204;204;1;0;0;2;3;3494;0;6337;3;2;
/org.eclipse.jdt.core.tests.model/workspace/JavaSearch/src/j1/JavadocHiddenRef.java;1;0;1;1;0;0;0;1;0;0;1;3081;0;0;1;0;0;1;1;3081;0;3081;1;1;
/org.eclipse.ant.ui/Ant Editor/org/eclipse/ant/ui/internal/editor/outline/AntEditorContentOutlinePage.java;1;0;8;1;0;0;0;8;77;4;5;250;83;83;4;3;0;8;8;262;3;1811;5;1;
/org.eclipse.pde.ui/src/org/eclipse/pde/internal/ui/editor/schema/SchemaFormOutlinePage.java;1;1;2;1;2;2;2;0;83;0;0;5431;99;99;1;0;0;0;2;5431;0;6336;2;1;
/org.eclipse.jdt.core.tests.model/workspace/Formatter/test387/A_in.java;1;0;1;1;0;0;0;1;0;0;1;3169;0;0;1;0;0;1;1;3169;0;3169;1;1;
/org.eclipse.pde.core/src/org/eclipse/pde/internal/core/BinaryRepositoryProvider.java;1;0;2;1;1;1;1;1;4;0;1;4203;6;6;1;0;0;1;2;4203;0;6336;2;1;
/org.eclipse.pde.ui/src_Forms/org/eclipse/pde/internal/ui/neweditor/build/BuildInputContextManager.java;2;1;2;1;2;2;2;0;0;0;0;5391;0;0;1;0;0;0;2;5391;0;5431;2;2;
/org.eclipse.team.webdav/src/org/eclipse/team/ui/target/subscriber/TeamNonblockingRunnableContext.java;1;0;1;1;0;0;0;1;0;0;1;3379;0;0;1;0;0;1;1;3379;0;3379;1;1;
/org.eclipse.jdt.ui/ui/org/eclipse/jdt/internal/ui/text/java/hover/AnnotationHover.java;2;1;11;1;4;4;4;7;109;2;6;1705;219;219;2;1;0;7;11;2635;1;6340;10;2;
/org.eclipse.update.ui.forms/Eclipse Forms/org/eclipse/ui/forms/MasterDetailsBlock.java;1;0;3;1;0;0;0;3;1;1;3;3812;1;1;1;0;0;3;3;3812;0;4157;3;1;
/org.eclipse.jdt.core/compiler/org/eclipse/jdt/internal/compiler/ast/TypeReference.java;4;0;5;1;0;0;0;5;27;1;5;1395;62;62;1;0;0;5;5;1395;0;3560;5;4;
/org.eclipse.jdt.ui.tests.refactoring/resources/DeleteSourceReferenceEdit/A_test3_in.java;1;0;1;1;0;0;0;1;0;0;1;1652;0;0;1;0;0;1;1;1652;0;1652;1;1;
/org.eclipse.ui.workbench/Eclipse UI/org/eclipse/ui/internal/dialogs/RemoveCapabilityStep.java;1;0;1;1;0;0;0;1;0;0;1;2737;0;0;1;0;0;1;1;2737;0;2737;1;1;
/org.eclipse.jdt.ui/core refactoring/org/eclipse/jdt/internal/corext/refactoring/changes/MoveResourceChange.java;2;1;4;1;2;2;2;2;9;1;2;3930;18;18;1;0;0;2;4;3930;0;6340;4;2;
/org.eclipse.jdt.launching.macosx/macosx/org/eclipse/jdt/internal/launching/macosx/MacOSXDebugVMRunner.java;1;0;2;1;0;0;0;2;4;1;2;2721;6;6;1;0;0;2;2;2721;0;3622;2;1;
/org.eclipse.pde.core/src/org/eclipse/pde/internal/core/site/SiteBuildFeature.java;3;1;5;1;2;2;2;3;14;1;3;2229;44;44;1;0;0;3;5;2229;0;6336;5;3;
/org.eclipse.jdt.core.tests.model/workspace/Converter/test0016/Test.java;1;0;1;1;0;0;0;1;0;0;1;3714;0;0;1;0;0;1;1;3714;0;3714;1;1;
/org.eclipse.swt.graphics.text/org.eclipse.swt/Eclipse SWT/gtk/org/eclipse/swt/graphics/GC.java;1;0;3;1;0;0;0;3;140;2;2;2267;144;144;2;1;0;3;3;2267;1;2335;2;1;
/org.eclipse.pde.ui/src/org/eclipse/pde/ui/IExtensionEditorWizard.java;2;1;3;1;3;3;3;0;13;0;0;5514;19;19;1;0;0;0;3;5514;0;6336;3;2;
/org.eclipse.core.expressions/src/org/eclipse/core/internal/expressions/CompositeExpression.java;1;0;2;1;1;1;1;1;8;0;1;4108;8;8;1;0;0;1;2;4108;0;6340;2;1;
/org.eclipse.core.resources/src/org/eclipse/core/internal/localstore/SafeChunkyInputStream.java;2;1;2;1;2;2;2;0;280;0;0;5146;407;407;1;0;0;0;2;5146;0;6206;2;2;
/org.eclipse.jdt.ui/ui refactoring/org/eclipse/jdt/internal/ui/refactoring/nls/SourceChangeListener.java;2;0;2;1;1;1;1;1;16;0;1;4930;16;16;1;0;0;1;2;4930;0;6340;2;2;
/org.eclipse.jdt.core.tests.model/workspace/Formatter/test352/A_in.java;1;0;1;1;0;0;0;1;0;0;1;3029;0;0;1;0;0;1;1;3029;0;3029;1;1;
/org.eclipse.jdt.ui/core refactoring/org/eclipse/jdt/internal/corext/refactoring/reorg2/ASTNodeDeleteUtil.java;1;0;2;1;0;0;0;2;2;1;2;802;2;2;1;0;0;2;2;802;0;1114;2;1;
/org.eclipse.swt.tests/JUnit Tests/org/eclipse/swt/tests/junit/Test_org_eclipse_swt_events_MouseEvent.java;1;0;2;1;1;1;1;1;7;0;1;3444;11;11;1;0;0;1;2;3444;0;6352;2;1;
/org.eclipse.swt/Eclipse SWT Browser/motif/org/eclipse/swt/browser/InputStream.java;1;0;1;1;0;0;0;1;0;0;1;2664;0;0;1;0;0;1;1;2664;0;2664;1;1;
/org.eclipse.help/src/org/eclipse/help/internal/util/URLCoder.java;1;1;5;1;3;3;3;2;19;1;2;105;39;39;1;0;0;2;5;105;0;6337;5;1;
/org.eclipse.jdt.ui.tests.refactoring/resources/InlineMethodWorkspace/TestCases/expression_out/TestSimpleExpression.java;1;0;1;1;0;0;0;1;2;0;1;845;2;2;1;0;0;1;1;845;0;845;1;1;
/org.eclipse.text/projection/org/eclipse/jface/text/projection/ProjectionDocumentManager.java;1;0;5;1;1;1;1;4;50;1;4;4516;129;129;1;0;0;4;5;4516;0;6301;5;1;
/org.eclipse.text/src/org/eclipse/jface/text/GapTextStore.java;1;0;1;1;1;1;1;0;13;0;0;6299;13;13;1;0;0;0;1;6299;0;6299;1;1;
/org.eclipse.jdt.core.tests.model/workspace/Converter/test0031/Test.java;1;0;1;1;0;0;0;1;0;0;1;3714;0;0;1;0;0;1;1;3714;0;3714;1;1;
/org.eclipse.swt.tests/JUnit Tests/org/eclipse/swt/tests/junit/Test_org_eclipse_swt_widgets_Combo.java;5;0;7;1;1;1;1;6;191;1;6;2105;467;467;1;0;0;6;7;2105;0;6352;7;5;
/org.eclipse.pde.ui/src/org/eclipse/pde/internal/ui/editor/manifest/PartiallySynchronizedDocument.java;1;0;2;1;1;1;1;1;0;0;1;2320;0;0;1;0;0;1;2;2320;0;5431;2;1;
/org.eclipse.ui.ide/extensions/org/eclipse/ui/dialogs/MarkerResolutionSelectionDialog.java;1;0;1;1;0;0;0;1;0;0;1;2263;0;0;1;0;0;1;1;2263;0;2263;1;1;
/org.eclipse.ui.workbench/Eclipse UI/org/eclipse/ui/internal/commands/registry/CommandDefinition.java;1;0;8;1;0;0;0;8;139;2;6;1396;305;305;2;2;0;8;8;1396;2;1724;6;1;
/org.eclipse.jdt.ui.examples.javafamily/src/org/eclipse/jdt/internal/ui/examples/jspeditor/DocumentAdapter.java;1;0;1;1;1;1;1;0;0;0;0;5177;0;0;1;0;0;0;1;5177;0;5177;1;1;
/org.eclipse.core.runtime/src/org/eclipse/core/internal/registry/RegistryChangeEvent.java;4;1;8;2;2;2;2;6;162;2;5;2105;335;335;2;1;0;6;8;3164;1;6340;7;4;
/org.eclipse.core.tools.resources/src/org/eclipse/core/tools/metadata/SyncInfoDumper.java;1;0;1;1;1;1;1;0;0;0;0;6302;0;0;1;0;0;0;1;6302;0;6302;1;1;
/org.eclipse.jdt.ui.tests/test plugin/org/eclipse/jdt/testplugin/util/FocusTestPass.java;1;0;1;1;1;1;1;0;2;0;0;6340;2;2;1;0;0;0;1;6340;0;6340;1;1;
/org.eclipse.jdt.ui/ui refactoring/org/eclipse/jdt/internal/ui/refactoring/PullPushCheckboxTableViewer.java;1;0;1;1;1;1;1;0;2;0;0;6340;2;2;1;0;0;0;1;6340;0;6340;1;1;
/org.eclipse.team.core/src/org/eclipse/team/core/RepositoryProviderSchedulingRule.java;1;0;1;1;0;0;0;1;0;0;1;1954;0;0;1;0;0;1;1;1954;0;1954;1;1;
/org.eclipse.jdt.debug.tests/tests/org/eclipse/jdt/debug/tests/eval/StringPlusOpTests.java;1;0;1;1;0;0;0;1;18;0;1;1274;18;18;1;0;0;1;1;1274;0;1274;1;1;
/org.eclipse.ui.editors/src/org/eclipse/ui/internal/editors/text/EditorsPlugin.java;3;1;13;1;5;5;5;8;72;1;8;1214;345;345;1;0;0;8;13;1214;0;6340;13;3;
/org.eclipse.jface.text/src/org/eclipse/jface/text/source/OverviewRulerHoverManager.java;2;1;2;1;2;2;2;0;2;0;0;6340;4;4;1;0;0;0;2;6340;0;6361;2;2;
/org.eclipse.update.configurator/src/org/eclipse/update/internal/configurator/SitePolicy.java;1;0;2;1;0;0;0;2;2;1;2;3243;2;2;1;0;0;2;2;3243;0;4095;2;1;
/org.eclipse.ui.workbench/Eclipse UI/org/eclipse/ui/commands/ICommandHandlerServiceEvent.java;1;0;3;1;0;0;0;3;4;1;3;1223;4;4;1;0;0;3;3;1223;0;1321;3;1;
/org.eclipse.core.tests.resources/src/org/eclipse/core/tests/resources/regression/SimpleBuilder.java;1;0;2;1;2;1;2;0;62;0;0;5147;62;62;2;0;1;0;2;5147;1;5147;1;1;
/org.eclipse.jdt.core.tests.model/workspace/Resolve/src/ResolveLocalMethodDeclaration.java;1;0;1;1;0;0;0;1;0;0;1;1970;0;0;1;0;0;1;1;1970;0;1970;1;1;
/org.eclipse.jdt.core.tests.model/workspace/Converter/test0358/A.java;1;0;1;1;0;0;0;1;0;0;1;3714;0;0;1;0;0;1;1;3714;0;3714;1;1;
/org.eclipse.jdt.ui.tests.refactoring/resources/SurroundWithWorkSpace/SurroundWithTests/trycatch_out/TestThenStatement.java;2;0;2;1;0;0;0;2;2;1;2;1206;2;2;1;0;0;2;2;1206;0;1806;2;2;
/org.eclipse.ui.workbench/Eclipse UI/org/eclipse/ui/commands/IKeyConfigurationHandle.java;1;0;4;1;0;0;0;4;0;1;4;1321;0;0;1;0;0;4;4;1321;0;1417;4;1;
/org.eclipse.webdav/src/interface/org/eclipse/webdav/dom/Label.java;1;0;2;1;2;1;2;0;65;0;0;5151;65;65;2;0;1;0;2;5151;1;5151;1;1;
/org.eclipse.pde.build/src/org/eclipse/pde/internal/build/IPDEBuildConstants.java;2;1;11;1;3;3;3;8;51;1;8;447;288;288;1;0;0;8;11;447;0;5682;11;2;
/org.eclipse.jdt.ui/ui/org/eclipse/jdt/internal/ui/preferences/JavaElementInfoPage.java;2;0;2;1;1;1;1;1;14;0;1;597;16;16;1;0;0;1;2;597;0;6340;2;2;
/org.eclipse.update.ui/src/org/eclipse/update/internal/ui/UpdatePerspective.java;1;0;1;1;0;0;0;1;0;0;1;772;0;0;1;0;0;1;1;772;0;772;1;1;
/org.eclipse.swt.graphics.text/org.eclipse.swt/Eclipse SWT PI/gtk/org/eclipse/swt/internal/gtk/PangoItem.java;1;0;1;1;0;0;0;1;0;0;1;2267;0;0;1;0;0;1;1;2267;0;2267;1;1;
/org.eclipse.debug.ui/ui/org/eclipse/debug/ui/launchVariables/WorkspaceExpander.java;1;0;2;1;0;0;0;2;0;1;2;550;0;0;1;0;0;2;2;550;0;562;2;1;
/org.eclipse.ui.examples.job/org/eclipse/ui/examples/jobs/ProgressExamplesPlugin.java;1;0;2;1;2;1;2;0;0;0;0;5125;0;0;2;0;1;0;2;5125;1;5125;1;1;
/org.eclipse.jdt.core.tests.model/workspace/Converter/test0499/A.java;1;0;2;1;0;0;0;2;0;1;2;2494;0;0;1;0;0;2;2;2494;0;3714;2;1;
/org.eclipse.jdt.ui/ui/org/eclipse/jdt/internal/ui/javaeditor/filebuffers/JavaDocumentFactory.java;1;0;2;1;0;0;0;2;0;1;2;1581;0;0;1;0;0;2;2;1581;0;4425;2;1;
/org.eclipse.update.core/src/org/eclipse/update/internal/core/InstallRegistry.java;1;1;11;1;3;3;3;8;69;2;7;1711;111;111;2;1;0;8;11;2027;1;6336;10;1;
/org.eclipse.jface/src/org/eclipse/jface/viewers/ViewerSorter.java;3;0;4;2;2;1;2;2;6;1;2;2208;14;14;2;0;1;2;4;6338;1;6338;3;3;
/org.eclipse.jdt.ui/ui/org/eclipse/jdt/internal/ui/wizards/OpenClassWizardAction.java;1;0;1;1;1;1;1;0;2;0;0;6340;2;2;1;0;0;0;1;6340;0;6340;1;1;
/org.eclipse.compare/compare/org/eclipse/compare/internal/patch/PatchErrorDialog.java;1;0;1;1;0;0;0;1;2;0;1;3938;2;2;1;0;0;1;1;3938;0;3938;1;1;
/org.eclipse.swt.tests/JUnit Tests/org/eclipse/swt/tests/junit/Test_org_eclipse_swt_custom_TreeEditor.java;1;0;1;1;0;0;0;1;14;0;1;2104;14;14;1;0;0;1;1;2104;0;2104;1;1;
/org.eclipse.search/search/org/eclipse/search/internal/ui/SearchResultViewEntryAdapterFactory.java;1;0;1;1;1;1;1;0;2;0;0;6340;2;2;1;0;0;0;1;6340;0;6340;1;1;
/org.eclipse.core.tests.runtime/src/org/eclipse/core/tests/internal/preferences/AllTests.java;1;1;4;1;2;2;2;2;2;1;2;4358;4;4;1;0;0;2;4;4358;0;5576;4;1;
/org.eclipse.jdt.ui/ui/org/eclipse/jdt/ui/actions/CustomFiltersActionGroup.java;3;1;12;1;2;2;2;10;190;1;10;2157;484;484;1;0;0;10;12;2157;0;6340;12;3;
/org.eclipse.osgi/core/adaptor/org/eclipse/osgi/framework/adaptor/BundleClassLoader.java;4;1;10;1;2;2;2;8;281;2;7;3013;425;425;2;1;0;8;10;4650;1;5441;9;4;
/org.eclipse.team.cvs.ui/src/org/eclipse/team/internal/ccvs/ui/CVSProjectPropertiesPage.java;2;0;6;1;1;1;1;5;83;1;5;276;109;109;1;0;0;5;6;276;0;6337;6;2;
/org.eclipse.jdt.core/search/org/eclipse/jdt/internal/core/index/impl/IndexBlock.java;2;0;3;1;0;0;0;3;2;1;3;1892;3;3;1;0;0;3;3;1892;0;4060;3;2;
/org.eclipse.jdt.core.tests.model/workspace/Converter/src/test0236/Test.java;1;0;1;1;0;0;0;1;0;0;1;3714;0;0;1;0;0;1;1;3714;0;3714;1;1;
/org.eclipse.ltk.core.refactoring/src/org/eclipse/ltk/core/refactoring/participants/CopyArguments.java;1;2;5;1;3;2;3;2;20;1;2;4845;26;26;2;0;1;2;5;5184;1;5184;4;1;
/org.eclipse.update.core/src/org/eclipse/update/internal/security/CertificatePair.java;1;0;1;1;0;0;0;1;2;0;1;890;2;2;1;0;0;1;1;890;0;890;1;1;
/org.eclipse.jdt.ui/ui refactoring/org/eclipse/jdt/internal/ui/refactoring/actions/RenameJavaElementAction.java;3;0;7;1;1;1;1;6;68;1;6;42;117;117;1;0;0;6;7;42;0;6340;7;3;
/org.eclipse.core.tests.runtime/src/org/eclipse/core/tests/internal/runtimetests/SampleLPB.java;1;0;1;1;1;1;1;0;21;0;0;5149;21;21;1;0;0;0;1;5149;0;5149;1;1;
/org.eclipse.ui.workbench/Eclipse UI/org/eclipse/ui/internal/contexts/registry/ContextRegistry.java;1;0;2;1;0;0;0;2;0;0;1;1396;0;0;2;1;0;2;2;1396;1;1396;1;1;
/org.eclipse.ui.views/src/org/eclipse/ui/views/internal/markers/MarkerSortDialog.java;1;0;2;1;0;0;0;2;0;0;1;265;0;0;2;1;0;2;2;265;1;265;1;1;
/org.eclipse.ui.externaltools/External Tools Base/org/eclipse/ui/externaltools/internal/ui/MessageDialogWithToggle.java;2;0;3;1;1;1;1;2;6;1;2;244;8;8;1;0;0;2;3;244;0;5802;3;2;
/org.eclipse.team.ui/src/org/eclipse/team/internal/ui/sync/views/SubscriberInput.java;1;0;7;1;0;0;0;7;97;1;7;494;153;153;1;0;0;7;7;494;0;1354;7;1;
/org.eclipse.swt.opengl/win32/org/eclipse/swt/opengl/internal/win32/POINTFLOAT.java;1;0;1;1;0;0;0;1;0;0;1;1175;0;0;1;0;0;1;1;1175;0;1175;1;1;
/org.eclipse.jdt.junit/src/org/eclipse/jdt/internal/junit/launcher/JUnitLaunchConfiguration.java;2;1;9;1;2;2;2;7;30;1;7;1578;127;127;1;0;0;7;9;1578;0;6340;9;2;
/org.eclipse.ui.views/src/org/eclipse/ui/views/internal/markers/DialogProblemProperties.java;1;0;2;1;0;0;0;2;0;0;1;749;0;0;2;1;0;2;2;749;1;749;1;1;
/org.eclipse.jdt.core/model/org/eclipse/jdt/internal/core/jdom/AbstractDOMBuilder.java;3;1;4;1;2;2;2;2;8;1;2;89;21;21;1;0;0;2;4;89;0;5916;4;3;
/org.eclipse.ui.workbench/Eclipse UI/org/eclipse/ui/IEditorRegistry.java;3;1;5;1;2;2;2;3;321;1;3;1;335;335;1;0;0;3;5;1;0;6338;5;3;
/org.eclipse.core.runtime/src/org/eclipse/core/runtime/IShutdownHook.java;3;0;3;1;0;0;0;3;46;1;3;3049;46;46;1;0;0;3;3;3049;0;4678;3;3;
/org.eclipse.team.ui/src/org/eclipse/team/internal/ui/wizards/ConfigureProjectWizardMainPage.java;1;1;7;1;3;3;3;4;187;2;3;987;247;247;2;1;0;4;7;987;1;6337;6;1;
/org.eclipse.core.resources/src/org/eclipse/core/resources/IResourceRuleFactory.java;2;0;4;2;1;1;1;3;8;2;2;3633;16;16;2;1;0;3;4;4994;1;5146;3;2;
/org.eclipse.jdt.debug.ui/ui/org/eclipse/jdt/internal/debug/ui/snippeteditor/SnippetOpenOnSelectionAction.java;1;0;2;1;0;0;0;2;3;1;2;596;5;5;1;0;0;2;2;596;0;1240;2;1;
/org.eclipse.swt/Eclipse SWT PI/motif/org/eclipse/swt/internal/motif/XKeyEvent.java;1;0;2;1;0;0;0;2;12;1;2;825;16;16;1;0;0;2;2;825;0;868;2;1;
/org.eclipse.jdt.ui.tests.refactoring/resources/MoveMembers/testFail22/in/A.java;1;0;1;1;0;0;0;1;0;0;1;1856;0;0;1;0;0;1;1;1856;0;1856;1;1;
/org.eclipse.team.webdav/src/org/eclipse/team/internal/webdav/ui/WebDavMainPage.java;1;0;2;1;1;1;1;1;25;0;1;4216;27;27;1;0;0;1;2;4216;0;6337;2;1;
/org.eclipse.pde.ui/src_Forms/org/eclipse/pde/internal/ui/neweditor/plugin/ExtensionDetails.java;3;0;13;1;1;1;1;12;110;2;9;3834;257;257;2;3;0;12;13;4284;3;5431;10;3;
/org.eclipse.update.ui/srcnew/org/eclipse/update/internal/ui/wizards/MultiTargetPage2.java;2;0;3;1;0;0;0;3;131;1;3;367;131;131;1;0;0;3;3;367;0;478;3;2;
/org.eclipse.jdt.ui/ui/org/eclipse/jdt/internal/ui/javaeditor/GotoMatchingBracketAction.java;2;1;2;1;2;2;2;0;5;0;0;5206;7;7;1;0;0;0;2;5206;0;6340;2;2;
/org.eclipse.team.webdav/src/org/eclipse/team/internal/ui/target/subscriber/TeamBlockingRunnableContext.java;2;0;3;1;0;0;0;3;125;1;3;3494;125;125;1;0;0;3;3;3494;0;4720;3;2;
/org.eclipse.jdt.core.tests.model/workspace/Converter/src/test0001/Test.java;1;0;1;1;0;0;0;1;0;0;1;3714;0;0;1;0;0;1;1;3714;0;3714;1;1;
/org.eclipse.jdt.ui/ui/org/eclipse/jdt/internal/ui/search/WorkingSetComparator.java;2;1;2;1;2;2;2;0;2;0;0;5396;3;3;1;0;0;0;2;5396;0;6340;2;2;
/org.eclipse.team.cvs.ui/src/org/eclipse/team/internal/ccvs/ui/repo/CVSRepositoryPropertiesPage.java;2;1;14;1;5;5;5;9;275;1;9;276;677;677;1;0;0;9;14;276;0;6337;14;2;
/org.eclipse.jdt.core/dom/org/eclipse/jdt/core/dom/NumberLiteral.java;5;0;9;1;1;1;1;8;67;1;8;1059;107;107;1;0;0;8;9;1059;0;5272;9;5;
/org.eclipse.ui.tests/Eclipse UI Tests/org/eclipse/ui/tests/internal/Bug41931Test.java;2;0;2;1;0;0;0;2;7;1;2;2351;7;7;1;0;0;2;2;2351;0;2738;2;2;
/org.eclipse.team.core/src/org/eclipse/team/internal/core/subscribers/caches/DescendantResourceVariantTree.java;2;0;3;1;0;0;0;3;148;1;3;4194;148;148;1;0;0;3;3;4194;0;4233;3;2;
/org.eclipse.jdt.core.tests.model/workspace/Formatter/test365/A_in.java;1;0;1;1;0;0;0;1;0;0;1;3128;0;0;1;0;0;1;1;3128;0;3128;1;1;
/org.eclipse.osgi/osgi/src/org/eclipse/osgi/service/resolver/Version.java;5;2;9;2;7;6;7;2;143;1;2;3013;372;372;2;0;1;2;9;6337;1;6337;8;5;
/org.eclipse.jdt.core/model/org/eclipse/jdt/core/IType.java;3;1;15;1;3;3;3;12;116;2;11;969;516;516;2;1;0;12;15;988;1;6196;14;3;
/org.eclipse.pde.ui/sandbox/org/eclipse/pde/internal/ui/editor/standalone/manifest/BaseSourceContentProvider.java;1;0;2;1;0;0;0;2;0;1;2;2320;0;0;1;0;0;2;2;2320;0;2906;2;1;
/org.eclipse.ui.workbench/Eclipse UI/org/eclipse/ui/internal/commands/Envelope.java;1;0;2;1;0;0;0;2;0;1;2;1579;0;0;1;0;0;2;2;1579;0;1634;2;1;
/org.eclipse.jdt.ui/ui/org/eclipse/jdt/internal/ui/preferences/formatter/SnippetPreview.java;1;0;2;1;0;0;0;2;17;1;2;3809;17;17;1;0;0;2;2;3809;0;3943;2;1;
/org.eclipse.jdt.core.tests.model/workspace/Resolve/src/ResolveLocalMethod.java;1;0;1;1;0;0;0;1;0;0;1;1970;0;0;1;0;0;1;1;1970;0;1970;1;1;
/org.eclipse.team.ui/src/org/eclipse/team/internal/ui/sync/dialogs/SyncViewerPreferencePage.java;1;0;1;1;0;0;0;1;0;0;1;984;0;0;1;0;0;1;1;984;0;984;1;1;
/org.eclipse.jdt.ui.tests.refactoring/resources/DeleteSourceReference/test11/out/A.java;1;0;1;1;0;0;0;1;0;0;1;1652;0;0;1;0;0;1;1;1652;0;1652;1;1;
/org.eclipse.jdt.ui/ui/org/eclipse/jdt/internal/ui/IJavaStatusConstants.java;1;0;1;1;1;1;1;0;2;0;0;6340;2;2;1;0;0;0;1;6340;0;6340;1;1;
/org.eclipse.team.core/src/org/eclipse/team/core/variants/SessionResourceVariantByteStore.java;1;0;2;1;1;1;1;1;17;0;1;4349;17;17;1;0;0;1;2;4349;0;6125;2;1;
/org.eclipse.core.tools.resources/src/org/eclipse/core/tools/metadata/WorkspaceView.java;1;0;1;1;1;1;1;0;0;0;0;6302;0;0;1;0;0;0;1;6302;0;6302;1;1;
/org.eclipse.jdt.core.tests.model/workspace/Converter/src/test0059/Test.java;1;0;1;1;0;0;0;1;0;0;1;3714;0;0;1;0;0;1;1;3714;0;3714;1;1;
/org.eclipse.jdt.core.tests.model/workspace/Formatter/test174/A_in.java;1;0;1;1;0;0;0;1;0;0;1;2425;0;0;1;0;0;1;1;2425;0;2425;1;1;
/org.eclipse.ui.editors/src/org/eclipse/ui/internal/editors/text/IEditorsStatusConstants.java;1;0;1;1;1;1;1;0;2;0;0;6340;2;2;1;0;0;0;1;6340;0;6340;1;1;
/org.eclipse.ui.cheatsheets/src/org/eclipse/ui/internal/cheatsheets/CheatSheetPlugin.java;2;1;11;2;4;4;4;7;96;2;6;4428;354;354;2;1;0;7;11;4625;1;5944;10;2;
/org.eclipse.pde.ui/templates/editor/java/IXMLColorConstants.java;1;0;1;1;0;0;0;1;10;0;1;851;10;10;1;0;0;1;1;851;0;851;1;1;
/org.eclipse.sdk.tests-feature/plugins/org.eclipse.perfmsr.ui.client/src/org/eclipse/perfmsr/ui/client/SelectLogFilesAction.java;1;1;3;1;3;3;3;0;10;0;0;5443;14;14;1;0;0;0;3;5443;0;5537;3;1;
/org.eclipse.search/new search/org/eclipse/search/ui/ISearchResultManager.java;1;0;3;1;0;0;0;3;45;1;3;3474;45;45;1;0;0;3;3;3474;0;4345;3;1;
/org.eclipse.jdt.ui.tests.refactoring/resources/SurroundWithWorkSpace/SurroundWithTests/trycatch_out/TestWrappedLocal4.java;1;0;2;1;0;0;0;2;7;1;2;155;9;9;1;0;0;2;2;155;0;845;2;1;
/org.eclipse.jdt.ui/core refactoring/org/eclipse/jdt/internal/corext/refactoring/code/flow/InputFlowAnalyzer.java;2;0;3;1;1;1;1;2;21;1;2;1953;30;30;1;0;0;2;3;1953;0;6340;3;2;
/org.eclipse.jdt.core.tests.model/workspace/Formatter/test365/A_out.java;1;0;1;1;0;0;0;1;0;0;1;3128;0;0;1;0;0;1;1;3128;0;3128;1;1;
/org.eclipse.jdt.ui/ui refactoring/org/eclipse/jdt/internal/ui/refactoring/reorg/DeleteWizard.java;3;1;12;1;2;2;2;10;124;1;10;1114;232;232;1;0;0;10;12;1114;0;6340;12;3;
/org.eclipse.core.resources/src/org/eclipse/core/internal/indexing/Field.java;1;0;1;1;1;1;1;0;16;0;0;5146;16;16;1;0;0;0;1;5146;0;5146;1;1;
/org.eclipse.jdt.core/compiler/org/eclipse/jdt/internal/compiler/ast/ParameterizedTypeReference.java;1;0;1;1;0;0;0;1;0;0;1;2728;0;0;1;0;0;1;1;2728;0;2728;1;1;
/org.eclipse.ant.ui/Ant Editor/org/eclipse/ant/ui/internal/dtd/IElement.java;1;0;3;1;0;0;0;3;8;1;3;250;8;8;1;0;0;3;3;250;0;1811;3;1;
/org.eclipse.ui.ide/src/org/eclipse/ui/internal/registry/MarkerQueryResult.java;2;0;3;1;0;0;0;3;8;1;3;1526;8;8;1;0;0;3;3;1526;0;2263;3;2;
/org.eclipse.pde.ui/src_Forms/org/eclipse/pde/internal/ui/model/IDocumentTextNode.java;2;1;4;1;4;4;4;0;10;0;0;5143;20;20;1;0;0;0;4;5143;0;6336;4;2;
/org.eclipse.team.ui/src/org/eclipse/team/internal/ui/wizards/ConfigurationWizardElement.java;1;1;5;1;2;2;2;3;143;2;2;987;169;169;2;1;0;3;5;987;1;6337;4;1;
/org.eclipse.jdt.ui/ui/org/eclipse/jdt/ui/actions/PullUpAction.java;4;0;13;2;2;1;2;11;150;2;10;42;264;264;2;1;1;11;13;142;2;6334;11;4;
/org.eclipse.jdt.core.tests.model/workspace/Formatter/test363/A_in.java;1;0;1;1;0;0;0;1;0;0;1;3089;0;0;1;0;0;1;1;3089;0;3089;1;1;
/org.eclipse.jdt.ui/core refactoring/org/eclipse/jdt/internal/corext/refactoring/participants/xml/PropertyTesterDescriptor.java;1;0;4;1;0;0;0;4;45;1;4;1033;45;45;1;0;0;4;4;1033;0;4108;4;1;
/org.eclipse.jdt.core/compiler/org/eclipse/jdt/internal/compiler/ast/QualifiedAllocationExpression.java;2;0;9;1;0;0;0;9;122;1;9;41;266;266;1;0;0;9;9;41;0;3560;9;2;
/org.eclipse.pde/src/org/eclipse/pde/internal/PluginProject.java;1;0;2;1;1;1;1;1;4;0;1;4203;6;6;1;0;0;1;2;4203;0;6336;2;1;
/org.eclipse.pde.ui/templates_3.0/preferences/java/$pageClassName$.java;2;0;2;1;0;0;0;2;2;1;2;2786;2;2;1;0;0;2;2;2786;0;3986;2;2;
/org.eclipse.jdt.core/dom/org/eclipse/jdt/core/dom/MarkerAnnotation.java;2;2;9;1;3;2;3;6;98;1;6;4054;188;188;2;0;1;6;9;5268;1;5335;8;2;
/org.eclipse.jdt.core.tests.model/workspace/Converter/src/javadoc/testBug53276/TestB.java;1;0;1;1;0;0;0;1;0;0;1;4311;0;0;1;0;0;1;1;4311;0;4311;1;1;
/org.eclipse.swt.opengl.examples/src/org/eclipse/swt/opengl/examples/BitmapTextTab.java;1;0;1;1;0;0;0;1;0;0;1;1175;0;0;1;0;0;1;1;1175;0;1175;1;1;
/org.eclipse.swt/Eclipse SWT/gtk1x/org/eclipse/swt/widgets/Group.java;2;0;2;1;0;0;0;2;4;1;2;110;4;4;1;0;0;2;2;110;0;2327;2;2;
/org.eclipse.team.cvs.ui/src/org/eclipse/team/internal/ccvs/ui/operations/RemoteCompareOperation.java;2;0;5;1;1;1;1;4;302;1;4;2497;382;382;1;0;0;4;5;2497;0;6337;5;2;
/org.eclipse.ui.ide/src/org/eclipse/ui/internal/dialogs/ResourceInfoPage.java;2;0;3;1;0;0;0;3;44;1;3;1526;44;44;1;0;0;3;3;1526;0;2263;3;2;
/org.eclipse.ui.ide/src/org/eclipse/ui/internal/dialogs/LinkedResourcesPreferencePage.java;2;0;4;1;0;0;0;4;12;1;4;1526;15;15;1;0;0;4;4;1526;0;2263;4;2;
/org.eclipse.jdt.ui/core refactoring/org/eclipse/jdt/internal/corext/refactoring/structure/MethodInvocationFinder.java;1;0;1;1;0;0;0;1;0;0;1;4895;0;0;1;0;0;1;1;4895;0;4895;1;1;
/org.eclipse.jdt.core/dom/org/eclipse/jdt/core/dom/SuperConstructorInvocation.java;3;2;10;1;3;2;3;7;99;1;7;3560;250;250;2;0;1;7;10;5268;1;5335;9;3;
/org.eclipse.ui.workbench/Eclipse UI/org/eclipse/ui/dialogs/NewFolderDialog.java;2;0;2;1;0;0;0;2;41;1;2;534;41;41;1;0;0;2;2;534;0;2737;2;2;
/org.eclipse.debug.ui/ui/org/eclipse/debug/internal/ui/console/PinConsoleAction.java;2;0;2;1;0;0;0;2;0;1;2;1294;0;0;1;0;0;2;2;1294;0;2060;2;2;
/org.eclipse.jdt.ui/ui/org/eclipse/jdt/internal/ui/javadocexport/JavadocMemberContentProvider.java;1;0;1;1;1;1;1;0;2;0;0;6340;2;2;1;0;0;0;1;6340;0;6340;1;1;
/org.eclipse.jdt.launching.macosx/macosx/org/eclipse/jdt/internal/ui/macbundler/Util.java;1;0;1;1;0;0;0;1;0;0;1;3622;0;0;1;0;0;1;1;3622;0;3622;1;1;
/org.eclipse.team.ui/src/org/eclipse/team/internal/ui/synchronize/actions/RefactorActionGroup.java;2;1;8;1;4;4;4;4;151;1;4;2561;270;270;1;0;0;4;8;2561;0;6337;8;2;
/org.eclipse.core.tests.resources/src/org/eclipse/core/tests/resources/regression/PR_1GHOM0N_Test.java;1;0;2;1;2;1;2;0;136;0;0;5147;136;136;2;0;1;0;2;5147;1;5147;1;1;
/org.eclipse.osgi/core/framework/org/eclipse/osgi/framework/internal/core/BundleLoader.java;6;2;38;2;9;8;9;29;616;2;25;3013;1571;1571;2;4;1;29;38;3418;5;6144;33;6;
/org.eclipse.core.resources/src/org/eclipse/core/internal/indexing/Log.java;1;0;1;1;1;1;1;0;59;0;0;5146;59;59;1;0;0;0;1;5146;0;5146;1;1;
/org.eclipse.jdt.ui/ui/org/eclipse/jdt/internal/ui/search/JavaSearchResult.java;2;3;14;1;7;5;7;7;47;2;6;3711;166;166;3;1;2;7;14;5178;3;6340;11;2;
/org.eclipse.ui.workbench/Eclipse UI/org/eclipse/ui/internal/commands/util/Point.java;1;0;2;1;0;0;0;2;0;1;2;1077;0;0;1;0;0;2;2;1077;0;1222;2;1;
/org.eclipse.ui.intro/src/org/eclipse/ui/internal/intro/impl/parts/FormsWidgetFactory.java;1;2;7;1;7;6;7;0;105;0;0;5467;163;163;2;0;1;0;7;5533;1;5714;6;1;
/org.eclipse.jdt.ui.tests.refactoring/resources/Delete/testDeleteWithinCu4/out/A.java;1;0;1;1;0;0;0;1;0;0;1;442;0;0;1;0;0;1;1;442;0;442;1;1;
/org.eclipse.jdt.core.tests.model/workspace/Converter/src/javadoc/test101/Test.java;1;0;1;1;0;0;0;1;0;0;1;4390;0;0;1;0;0;1;1;4390;0;4390;1;1;
/org.eclipse.pde.ui/src/org/eclipse/pde/internal/ui/IAlternativeRuntimeUISupport.java;2;0;2;1;0;0;0;2;0;1;2;2244;0;0;1;0;0;2;2;2244;0;4428;2;2;
/org.eclipse.ui.workbench/Eclipse UI/org/eclipse/ui/activities/ActivityEvent.java;3;1;13;2;3;3;3;10;50;2;9;2805;230;230;2;1;0;10;13;4651;1;6338;12;3;
/org.eclipse.ui.workbench.texteditor/src/org/eclipse/ui/internal/texteditor/quickdiff/compare/rangedifferencer/RangeDifferencer.java;4;1;6;1;4;4;4;2;31;1;2;1644;51;51;1;0;0;2;6;1644;0;6340;6;4;
/org.eclipse.jdt.core/model/org/eclipse/jdt/internal/core/SourceType.java;6;1;43;2;6;6;6;37;192;4;29;916;964;964;4;8;0;37;43;1946;8;6222;35;6;
/org.eclipse.swt/Eclipse SWT PI/photon/org/eclipse/swt/internal/photon/PhKeyEvent_t.java;1;0;1;1;0;0;0;1;2;0;1;808;2;2;1;0;0;1;1;808;0;808;1;1;
/org.eclipse.ant.ui/Ant Editor/org/eclipse/ant/internal/ui/editor/text/AntEditorProcInstrScanner.java;1;1;5;1;2;2;2;3;45;1;3;1811;113;113;1;0;0;3;5;1811;0;5721;5;1;
/org.eclipse.team.ui/src/org/eclipse/team/ui/synchronize/actions/RefreshAction.java;1;0;1;1;0;0;0;1;0;0;1;2535;0;0;1;0;0;1;1;2535;0;2535;1;1;
/org.eclipse.core.tests.runtime/src/org/eclipse/core/tests/internal/plugins/RegressionResolveTest_1.java;1;0;1;1;0;0;0;1;0;0;1;3014;0;0;1;0;0;1;1;3014;0;3014;1;1;
/org.eclipse.swt/Eclipse SWT PI/gtk1x/org/eclipse/swt/internal/gtk/GtkBin.java;1;0;1;1;0;0;0;1;0;0;1;2327;0;0;1;0;0;1;1;2327;0;2327;1;1;
/org.eclipse.jdt.core/codeassist/org/eclipse/jdt/internal/codeassist/select/SelectionOnSingleNameReference.java;2;0;3;1;0;0;0;3;5;1;3;991;9;9;1;0;0;3;3;991;0;3560;3;2;
/org.eclipse.debug.ui/ui/org/eclipse/debug/ui/variables/IVariableComponent.java;1;0;4;1;0;0;0;4;86;3;2;316;86;86;3;2;0;4;4;316;2;550;2;1;
/org.eclipse.ui.ide/extensions/org/eclipse/ui/actions/SelectionListenerAction.java;2;0;2;1;0;0;0;2;76;1;2;2611;76;76;1;0;0;2;2;2611;0;2832;2;2;
/org.eclipse.ltk.ui.refactoring/src/org/eclipse/ltk/internal/ui/refactoring/StatusContextViewerDescriptor.java;1;0;3;1;1;1;1;2;8;1;2;4965;10;10;1;0;0;2;3;4965;0;6340;3;1;
/org.eclipse.update.ui.forms/src/org/eclipse/ui/forms/parts/Hyperlink.java;1;0;3;1;0;0;0;3;231;2;2;3071;231;231;2;1;0;3;3;3095;1;3095;2;1;
/org.eclipse.swt/Eclipse SWT Browser/photon/org/eclipse/swt/browser/Browser.java;3;1;24;2;2;2;2;22;504;2;18;1654;1454;1454;2;4;0;22;24;2899;4;6352;20;3;
/org.eclipse.jdt.ui/ui/org/eclipse/jdt/ui/actions/InlineAction.java;4;1;5;1;2;2;2;3;31;1;3;122;52;52;1;0;0;3;5;122;0;6340;5;4;
/org.eclipse.ui.workbench/Eclipse UI/org/eclipse/ui/internal/csm/commands/api/ICommandService.java;1;0;2;1;0;0;0;2;0;1;2;2515;0;0;1;0;0;2;2;2515;0;2562;2;1;
/org.eclipse.team.ui/src/org/eclipse/team/internal/ui/sync/sets/SyncSet.java;2;0;10;1;0;0;0;10;306;2;9;1289;424;424;2;1;0;10;10;2059;1;2632;9;2;
/org.eclipse.team.webdav/src/org/eclipse/team/internal/core/target/IDeploymentProviderManager.java;1;0;2;1;1;1;1;1;4;0;1;4633;4;4;1;0;0;1;2;4633;0;6337;2;1;
/org.eclipse.team.cvs.ui/src/org/eclipse/team/internal/ccvs/ui/subscriber/SubscriberConfirmMergedOperation.java;1;0;2;1;1;1;1;1;0;0;1;4450;0;0;1;0;0;1;2;4450;0;5508;2;1;
/org.eclipse.jdt.debug.ui/ui/org/eclipse/jdt/internal/debug/ui/actions/ReevaluateWatchExpressionAction.java;2;0;2;1;0;0;0;2;5;1;2;1175;5;5;1;0;0;2;2;1175;0;1516;2;2;
/org.eclipse.jdt.core.tests.model/workspace/Formatter/test085/A_out.java;1;0;1;1;0;0;0;1;0;0;1;2425;0;0;1;0;0;1;1;2425;0;2425;1;1;
/org.eclipse.core.runtime/src/org/eclipse/core/internal/preferences/PreferencesService.java;3;2;30;2;10;8;10;20;736;3;14;4351;1707;1707;3;6;2;20;30;4351;8;5681;22;3;
/org.eclipse.jdt.ui.tests.refactoring/resources/MoveMembers/test2/out/B.java;1;0;1;1;0;0;0;1;2;0;1;1522;2;2;1;0;0;1;1;1522;0;1522;1;1;
/org.eclipse.jdt.core/model/org/eclipse/jdt/core/IJavaModelStatusConstants.java;2;0;6;1;0;0;0;6;10;1;6;530;25;25;1;0;0;6;6;530;0;4887;6;2;
/org.eclipse.team.ui/src/org/eclipse/team/internal/ui/sync/pages/ShowSynchronizeViewPage.java;1;0;1;1;0;0;0;1;0;0;1;2411;0;0;1;0;0;1;1;2411;0;2411;1;1;
/org.eclipse.jdt.ui/core refactoring/org/eclipse/jdt/internal/corext/refactoring/reorg2/ArrayTypeConverter.java;1;0;2;1;0;0;0;2;0;1;2;808;0;0;1;0;0;2;2;808;0;1114;2;1;
/org.eclipse.core.tests.runtime/src/org/eclipse/core/tests/internal/runtimetests/SampleB.java;1;0;1;1;1;1;1;0;19;0;0;5149;19;19;1;0;0;0;1;5149;0;5149;1;1;
/org.eclipse.update.ui.forms/src/org/eclipse/update/ui/forms/richtext/RichTextHyperlinkAction.java;1;0;2;1;0;0;0;2;0;1;2;2852;0;0;1;0;0;2;2;2852;0;2898;2;1;
/org.eclipse.jdt.ui/ui/org/eclipse/jdt/internal/ui/text/link/LinkedPositionAnnotations.java;2;0;5;1;0;0;0;5;59;1;5;3806;77;77;1;0;0;5;5;3806;0;4214;5;2;
/org.eclipse.osgi/console/src/org/eclipse/osgi/framework/internal/core/ConsoleMsg.java;3;0;3;1;1;1;1;2;14;1;2;3013;23;23;1;0;0;2;3;3013;0;5232;3;3;
/org.eclipse.jdt.debug/jdi/org/eclipse/jdi/internal/jdwp/JdwpString.java;1;0;1;1;0;0;0;1;4;0;1;1276;4;4;1;0;0;1;1;1276;0;1276;1;1;
/org.eclipse.jdt.ui.tests.refactoring/resources/RenameNonPrivateField/test3/in/A.java;1;0;1;1;0;0;0;1;10;0;1;4560;10;10;1;0;0;1;1;4560;0;4560;1;1;
/org.eclipse.team.core/src/org/eclipse/team/core/RepositoryProviderType.java;2;1;4;1;2;2;2;2;33;1;2;866;43;43;1;0;0;2;4;866;0;6336;4;2;
/org.eclipse.team.ui/src/org/eclipse/team/internal/ui/target/CreateNewFolderAction.java;2;0;3;1;0;0;0;3;7;1;3;990;8;8;1;0;0;3;3;990;0;2495;3;2;
/org.eclipse.update.ui/srcnew/org/eclipse/update/internal/ui/wizards/ActivitiesTableViewer.java;3;0;3;1;0;0;0;3;26;1;3;599;26;26;1;0;0;3;3;599;0;825;3;3;
/org.eclipse.jdt.core.tests.model/workspace/Formatter/test078/A_in.java;1;0;1;1;0;0;0;1;0;0;1;2425;0;0;1;0;0;1;1;2425;0;2425;1;1;
/org.eclipse.team.ui/src/org/eclipse/team/internal/ui/synchronize/ActionDelegateManager.java;2;0;3;1;0;0;0;3;1;1;3;4588;1;1;1;0;0;3;3;4588;0;4699;3;2;
/org.eclipse.team.ui/src/org/eclipse/team/ui/Utilities.java;1;0;3;1;0;0;0;3;78;1;3;2460;78;78;1;0;0;3;3;2460;0;2642;3;1;
/org.eclipse.ant.tests.ui/EclipseCon/org/eclipse/ant/internal/ui/demo/CreateProjectAction.java;1;0;4;1;0;0;0;4;9;3;2;3729;9;9;3;2;0;4;4;3729;2;3756;2;1;
/org.eclipse.jdt.core.tests.model/workspace/Converter/junit/swingui/TestTreeModel.java;1;0;2;1;0;0;0;2;4;1;2;787;4;4;1;0;0;2;2;787;0;3714;2;1;
/org.eclipse.pde.ui/src/org/eclipse/pde/internal/ui/wizards/site/SiteData.java;2;0;2;1;1;1;1;1;0;0;1;3840;0;0;1;0;0;1;2;3840;0;6086;2;2;
/org.eclipse.search/new search/org/eclipse/search2/internal/ui/basic/views/INavigate.java;2;0;2;1;1;1;1;1;2;0;1;3474;2;2;1;0;0;1;2;3474;0;6340;2;2;
/org.eclipse.jdt.ui/core refactoring/org/eclipse/jdt/internal/corext/refactoring/changes/TextEditChangeGroup.java;1;0;4;1;0;0;0;4;24;1;4;3656;25;25;1;0;0;4;4;3656;0;4864;4;1;
/org.eclipse.jdt.ui.tests.refactoring/resources/ExtractMethodWorkSpace/ExtractMethodTests/return_in/A_test700.java;1;0;1;1;0;0;0;1;2;0;1;844;2;2;1;0;0;1;1;844;0;844;1;1;
/org.eclipse.core.tools.resources/src/org/eclipse/core/tools/metadata/DumpSummaryView.java;1;0;1;1;1;1;1;0;0;0;0;6302;0;0;1;0;0;0;1;6302;0;6302;1;1;
/org.eclipse.pde.ui/src_Forms/org/eclipse/pde/internal/ui/neweditor/plugin/DependencyAnalysisSection.java;2;0;6;1;1;1;1;5;51;2;4;4570;59;59;2;1;0;5;6;4570;1;5431;5;2;
/org.eclipse.team.tests.cvs.core/src/org/eclipse/team/tests/ccvs/core/CVSUITestSetup.java;1;0;1;1;0;0;0;1;0;0;1;2947;0;0;1;0;0;1;1;2947;0;2947;1;1;
/org.eclipse.core.resources/src/org/eclipse/core/internal/indexing/Convert.java;1;0;1;1;1;1;1;0;12;0;0;5146;12;12;1;0;0;0;1;5146;0;5146;1;1;
/org.eclipse.search/search/org/eclipse/search/internal/ui/ISearchHelpContextIds.java;2;1;3;1;3;3;3;0;4;0;0;5748;8;8;1;0;0;0;3;5748;0;6340;3;2;
/org.eclipse.core.resources/src/org/eclipse/core/internal/resources/ModelObjectWriter.java;2;1;4;1;2;2;2;2;17;1;2;3063;24;24;1;0;0;2;4;3063;0;5168;4;2;
/org.eclipse.ui.workbench/Eclipse UI/org/eclipse/ui/internal/csm/commands/api/ICommandManagerListener.java;1;0;2;1;0;0;0;2;0;1;2;2515;0;0;1;0;0;2;2;2515;0;2562;2;1;
/org.eclipse.jdt.ui/ui/org/eclipse/jdt/ui/text/JavaSourceViewerConfiguration.java;4;2;41;2;9;7;9;32;161;2;29;505;1029;1029;2;3;2;32;41;3827;5;6322;36;4;
/org.eclipse.text/src/org/eclipse/jface/text/IDocumentPartitionerExtension.java;1;0;1;1;1;1;1;0;33;0;0;6296;33;33;1;0;0;0;1;6296;0;6296;1;1;
/org.eclipse.pde.ui/src_Forms/org/eclipse/pde/internal/ui/neweditor/feature/FeatureAdvancedPage.java;2;0;3;1;1;1;1;2;73;0;1;4926;73;73;2;1;0;2;3;4926;1;5431;2;2;
/org.eclipse.team.examples.filesystem/src/org/eclipse/team/examples/pessimistic/ResourceSetContentProvider.java;1;0;2;1;1;1;1;1;72;0;1;3368;72;72;1;0;0;1;2;3368;0;6103;2;1;
/org.eclipse.team.tests.cvs.core/src/org/eclipse/team/tests/ccvs/ui/old/CommandTests.java;1;0;3;1;0;0;0;3;2;1;3;2632;2;2;1;0;0;3;3;2632;0;4216;3;1;
/org.eclipse.core.resources/src/org/eclipse/core/internal/resources/SyncInfoSnapReader_3.java;1;0;1;1;1;1;1;0;87;0;0;5146;87;87;1;0;0;0;1;5146;0;5146;1;1;
/org.eclipse.jdt.ui/core refactoring/org/eclipse/jdt/internal/corext/refactoring/rename/TextMatchFinder2.java;1;0;2;1;0;0;0;2;0;0;1;1125;0;0;2;1;0;2;2;1125;1;1125;1;1;
/org.eclipse.swt/Eclipse SWT/common/org/eclipse/swt/internal/image/PNGFileFormat.java;3;1;4;1;2;2;2;2;13;1;2;2406;23;23;1;0;0;2;4;2406;0;6352;4;3;
/org.eclipse.ui.forms/src/org/eclipse/ui/forms/widgets/FormUtil.java;1;0;3;1;0;0;0;3;3;1;3;4068;3;3;1;0;0;3;3;4068;0;4260;3;1;
/org.eclipse.jdt.ui/ui/org/eclipse/jdt/internal/ui/workingsets/SelectWorkingSetAction.java;1;0;1;1;1;1;1;0;2;0;0;6340;2;2;1;0;0;0;1;6340;0;6340;1;1;
/org.eclipse.core.tests.runtime/src/org/eclipse/core/tests/runtime/jobs/DeadlockDetectionTest.java;2;1;15;1;5;5;5;10;650;1;10;2823;1963;1963;1;0;0;10;15;2823;0;6220;15;2;
/org.eclipse.core.runtime/src/org/eclipse/core/internal/runtime/Assert.java;2;1;5;1;2;2;2;3;208;1;3;3013;426;426;1;0;0;3;5;3013;0;6340;5;2;
/org.eclipse.swt/Eclipse SWT/common/org/eclipse/swt/internal/image/TIFFModifiedHuffmanCodec.java;1;0;1;1;0;0;0;1;0;0;1;364;0;0;1;0;0;1;1;364;0;364;1;1;
/org.eclipse.ui.workbench/Eclipse UI/org/eclipse/ui/progress/IElementCollector.java;2;1;4;1;4;4;4;0;35;0;0;5209;45;45;1;0;0;0;4;5209;0;6338;4;2;
/org.eclipse.osgi/supplement/src/org/eclipse/osgi/service/datalocation/Location.java;2;1;8;1;2;2;2;6;50;2;5;4113;119;119;2;1;0;6;8;4113;1;5193;7;2;
/org.eclipse.jdt.core.tests.model/workspace/Converter/test0432/A.java;1;0;1;1;0;0;0;1;0;0;1;3714;0;0;1;0;0;1;1;3714;0;3714;1;1;
/org.eclipse.jdt.core.tests.model/workspace/Converter/junit/swingui/AboutDialog.java;1;0;2;1;0;0;0;2;17;1;2;787;17;17;1;0;0;2;2;787;0;3714;2;1;
/org.eclipse.ant.ui/Ant Editor/org/eclipse/ant/ui/internal/dtd/IDfm.java;1;0;2;1;0;0;0;2;0;1;2;250;0;0;1;0;0;2;2;250;0;1811;2;1;
/org.eclipse.jdt.core.tests.model/workspace/Converter/junit/framework/TestCase.java;1;0;2;1;0;0;0;2;34;1;2;787;34;34;1;0;0;2;2;787;0;3714;2;1;
/org.eclipse.ui.workbench/Eclipse UI/org/eclipse/ui/internal/commands/registry/SequenceBinding.java;1;0;2;1;0;0;0;2;0;1;2;1077;0;0;1;0;0;2;2;1077;0;1222;2;1;
/org.eclipse.ui.ide/src/org/eclipse/ui/actions/BuildAction.java;2;0;4;1;0;0;0;4;21;1;4;1511;25;25;1;0;0;4;4;1511;0;2263;4;2;
/org.eclipse.jdt.ui.tests.refactoring/resources/ExtractMethodWorkSpace/ExtractMethodTests/expression_in/A_test616.java;1;0;1;1;0;0;0;1;2;0;1;844;2;2;1;0;0;1;1;844;0;844;1;1;
/org.eclipse.jdt.core.tests.model/workspace/Converter/src/test0421/A.java;1;0;1;1;0;0;0;1;0;0;1;3714;0;0;1;0;0;1;1;3714;0;3714;1;1;
/org.eclipse.ui.workbench/Eclipse UI/org/eclipse/ui/internal/progress/ErrorInfo.java;2;0;4;1;1;1;1;3;7;1;3;3477;15;15;1;0;0;3;4;3477;0;6338;4;2;
/org.eclipse.jface/src/org/eclipse/jface/instrumentation/IInstrumentationActionListener.java;1;0;2;1;0;0;0;2;0;1;2;1634;0;0;1;0;0;2;2;1634;0;1674;2;1;
/org.eclipse.ant.ui/Ant Tools Support/org/eclipse/ant/internal/ui/launchConfigurations/VariableInputDialog.java;1;0;1;1;0;0;0;1;0;0;1;4984;0;0;1;0;0;1;1;4984;0;4984;1;1;
/org.eclipse.jdt.core.tests.model/workspace/Converter/test0300/Test.java;1;0;1;1;0;0;0;1;0;0;1;3714;0;0;1;0;0;1;1;3714;0;3714;1;1;
/org.eclipse.pde.ui/src_OSGi/org/eclipse/pde/internal/ui/osgi/OSGiRuntimeUISupport.java;2;0;2;1;0;0;0;2;0;1;2;2244;0;0;1;0;0;2;2;2244;0;4203;2;2;
/org.eclipse.ui.ide/src/org/eclipse/ui/views/framelist/TreeFrame.java;1;0;3;1;0;0;0;3;26;2;2;2208;26;26;2;1;0;3;3;2286;1;2286;2;1;
/org.eclipse.ui.workbench/Eclipse UI/org/eclipse/ui/internal/PageListenerList.java;2;1;2;1;2;2;2;0;18;0;0;5339;20;20;1;0;0;0;2;5339;0;6338;2;2;
/org.eclipse.pde.core/src/org/eclipse/pde/internal/core/ischema/ISchemaSimpleType.java;1;0;2;1;1;1;1;1;4;0;1;4203;6;6;1;0;0;1;2;4203;0;6336;2;1;
/org.eclipse.ui.cheatsheets/src/org/eclipse/ui/internal/cheatsheets/data/CheatSheetDomParser.java;2;0;8;2;1;1;1;7;120;2;5;4428;185;185;2;2;0;7;8;4625;2;5189;6;2;
/org.eclipse.jdt.ui.tests/ui/org/eclipse/jdt/ui/tests/quickfix/ReturnTypeQuickFixTest.java;2;1;12;1;4;4;4;8;162;1;8;393;641;641;1;0;0;8;12;393;0;6340;12;2;
/org.eclipse.jdt.core.tests.model/workspace/Formatter/test490/A_in.java;1;0;1;1;1;1;1;0;0;0;0;5188;0;0;1;0;0;0;1;5188;0;5188;1;1;
/org.eclipse.team.ui/src/org/eclipse/team/ui/synchronize/subscriber/SynchronizeViewerAdvisor.java;1;0;8;1;0;0;0;8;20;1;8;4244;55;55;1;0;0;8;8;4244;0;4632;8;1;
/org.eclipse.jdt.core/dom/org/eclipse/jdt/core/dom/EnumConstantDeclaration.java;4;2;13;1;4;3;4;9;257;1;9;2867;455;455;2;0;1;9;13;5268;1;5335;12;4;
/org.eclipse.jdt.debug.tests/tests/org/eclipse/jdt/debug/tests/eval/NestedTypeFieldValue_120.java;1;0;1;1;0;0;0;1;84;0;1;1274;84;84;1;0;0;1;1;1274;0;1274;1;1;
/org.eclipse.jdt.ui/ui/org/eclipse/jdt/internal/ui/typehierarchy/TypeHierarchyMessages.java;1;0;1;1;1;1;1;0;2;0;0;6340;2;2;1;0;0;0;1;6340;0;6340;1;1;
/org.eclipse.core.resources/src/org/eclipse/core/internal/indexing/FieldDef.java;1;0;1;1;1;1;1;0;16;0;0;5146;16;16;1;0;0;0;1;5146;0;5146;1;1;
/org.eclipse.update.core/src/org/eclipse/update/internal/operations/UpdateManagerAuthenticator.java;2;0;3;1;0;0;0;3;2;1;3;825;2;2;1;0;0;3;3;825;0;1520;3;2;
/org.eclipse.jdt.core/dom/org/eclipse/jdt/core/dom/ExpressionStatement.java;3;1;8;1;2;2;2;6;78;1;6;3560;108;108;1;0;0;6;8;3560;0;5272;8;3;
/org.eclipse.jdt.debug.tests/tests/org/eclipse/jdt/debug/tests/eval/NestedTypeFieldValue_566.java;1;0;1;1;0;0;0;1;60;0;1;1274;60;60;1;0;0;1;1;1274;0;1274;1;1;
/org.eclipse.jdt.ui.tests.refactoring/resources/RenameVirtualMethodInClass/test37/out/A.java;1;0;1;1;0;0;0;1;0;0;1;1653;0;0;1;0;0;1;1;1653;0;1653;1;1;
/org.eclipse.debug.ui/ui/org/eclipse/debug/internal/ui/views/console/ProcessConsole.java;3;2;9;2;4;3;4;5;66;2;4;1415;140;140;2;1;1;5;9;1415;2;6336;7;3;
/org.eclipse.jdt.core.tests.model/workspace/Converter/test0257/Test.java;1;0;1;1;0;0;0;1;0;0;1;3714;0;0;1;0;0;1;1;3714;0;3714;1;1;
/org.eclipse.jdt.ui/ui refactoring/org/eclipse/jdt/internal/ui/refactoring/RenameFieldWizard.java;2;0;4;1;0;0;0;4;165;1;4;518;186;186;1;0;0;4;4;518;0;1125;4;2;
/org.eclipse.jdt.ui/ui/org/eclipse/jdt/ui/text/java/hover/IJavaEditorTextHover.java;1;0;1;1;1;1;1;0;6;0;0;6322;6;6;1;0;0;0;1;6322;0;6322;1;1;
/org.eclipse.ui.workbench.texteditor/src/org/eclipse/ui/texteditor/ShiftAction.java;2;2;6;1;3;2;3;3;34;1;3;1982;69;69;2;0;1;3;6;5123;1;6340;5;2;
/org.eclipse.debug.core/core/org/eclipse/debug/core/sourcelookup/ISourcePathComputer.java;1;0;2;1;1;1;1;1;24;0;1;4949;24;24;1;0;0;1;2;4949;0;5109;2;1;
/org.eclipse.jdt.ui.tests/ui/org/eclipse/jdt/ui/tests/packageview/MockPluginView.java;2;1;3;1;3;3;3;0;9;0;0;5422;16;16;1;0;0;0;3;5422;0;6340;3;2;
/org.eclipse.jdt.core.tests.model/workspace/Formatter/test259/A_out.java;1;0;1;1;0;0;0;1;0;0;1;2442;0;0;1;0;0;1;1;2442;0;2442;1;1;
/org.eclipse.team.ui/src/org/eclipse/team/ui/synchronize/subscriber/SubscriberOperation.java;2;0;4;1;0;0;0;4;2;1;4;4466;3;3;1;0;0;4;4;4466;0;4588;4;2;
/org.eclipse.pde.ui/src/org/eclipse/pde/internal/ui/preferences/BuildpathPreferencePage.java;1;0;4;1;0;0;0;4;20;1;4;571;41;41;1;0;0;4;4;571;0;3435;4;1;
/org.eclipse.pde.ui/src/org/eclipse/pde/internal/ui/editor/site/SiteDescriptionSection.java;1;0;3;1;0;0;0;3;11;1;3;368;15;15;1;0;0;3;3;368;0;2311;3;1;
/org.eclipse.update.ui.forms/src/org/eclipse/update/ui/forms/richtext/ScrollableRichText.java;1;0;2;1;0;0;0;2;0;1;2;2853;0;0;1;0;0;2;2;2853;0;2898;2;1;
/org.eclipse.jdt.ui.tests.refactoring/resources/ChangeTypeRefactoring/positive/A_testHashMap_in.java;1;0;1;1;0;0;0;1;0;0;1;2844;0;0;1;0;0;1;1;2844;0;2844;1;1;
/org.eclipse.swt/Eclipse SWT Browser/common/org/eclipse/swt/browser/TitleEvent.java;2;0;3;1;1;1;1;2;7;1;2;3698;13;13;1;0;0;2;3;3698;0;6352;3;2;
/org.eclipse.ui.workbench/Eclipse UI/org/eclipse/ui/actions/ActionFactory.java;7;2;21;2;7;5;7;14;1185;3;11;1622;2673;2673;3;3;2;14;21;3028;5;6338;16;7;
/org.eclipse.core.resources/src/org/eclipse/core/resources/IResourceStatus.java;3;1;7;1;3;3;3;4;196;2;3;44;248;248;2;1;0;4;7;2426;1;5520;6;3;
/org.eclipse.ui.externaltools/External Tools Base/org/eclipse/ui/externaltools/internal/model/StringMatcher.java;2;0;3;1;1;1;1;2;60;1;2;1442;73;73;1;0;0;2;3;1442;0;5489;3;2;
/org.eclipse.jdt.ui/core refactoring/org/eclipse/ltk/core/refactoring/participants/MoveArguments.java;1;0;3;1;0;0;0;3;18;1;3;4624;18;18;1;0;0;3;3;4624;0;4864;3;1;
/org.eclipse.jdt.debug.ui/ui/org/eclipse/jdt/internal/debug/ui/actions/RestoreDefaultEntriesAction.java;2;0;2;1;1;1;1;1;6;0;1;4332;6;6;1;0;0;1;2;4332;0;6336;2;2;
/org.eclipse.jdt.core.tests.model/workspace/Converter/src/test0088/Test.java;1;0;1;1;0;0;0;1;0;0;1;3714;0;0;1;0;0;1;1;3714;0;3714;1;1;
/org.eclipse.jdt.ui/ui/org/eclipse/jdt/ui/actions/ShowActionGroup.java;2;0;2;1;1;1;1;1;2;0;1;4307;4;4;1;0;0;1;2;4307;0;6340;2;2;
/org.eclipse.core.tests.runtime/src/org/eclipse/core/tests/internal/plugins/PluginResolveTest_32.java;1;0;1;1;0;0;0;1;0;0;1;3014;0;0;1;0;0;1;1;3014;0;3014;1;1;
/org.eclipse.jdt.core.tests.model/workspace/Converter/test0500/A.java;3;0;3;1;0;0;0;3;3;1;3;2559;3;3;1;0;0;3;3;2559;0;3714;3;3;
/org.eclipse.ui.workbench/Eclipse UI/org/eclipse/ui/internal/registry/ActionSetPartAssociationsReader.java;3;0;3;1;1;1;1;2;7;1;2;3500;13;13;1;0;0;2;3;3500;0;6338;3;3;
/org.eclipse.jdt.ui/core refactoring/org/eclipse/jdt/internal/corext/refactoring/participants/IReferenceUpdating.java;1;0;2;1;0;0;0;2;0;1;2;591;0;0;1;0;0;2;2;591;0;1125;2;1;
/org.eclipse.ui.tests/Eclipse UI Tests/org/eclipse/ui/tests/menus/BrokenWorkbenchWindowPulldownDelegate.java;2;1;2;1;2;2;2;0;28;0;0;5535;28;28;1;0;0;0;2;5535;0;6077;2;2;
/org.eclipse.jdt.core.tests.model/workspace/Formatter/test399/A_in.java;1;0;1;1;0;0;0;1;0;0;1;3436;0;0;1;0;0;1;1;3436;0;3436;1;1;
/org.eclipse.team.cvs.core/src/org/eclipse/team/internal/ccvs/core/client/Session.java;2;1;22;1;4;4;4;18;198;2;16;866;620;620;2;2;0;18;22;1985;2;6337;20;2;
/org.eclipse.core.tests.resources/src/org/eclipse/core/tests/internal/resources/ResourceInfoTest.java;1;0;3;1;2;1;2;1;232;0;1;4351;246;246;2;0;1;1;3;5147;1;5147;2;1;
/org.eclipse.debug.ui/ui/org/eclipse/debug/ui/variables/VariableContextManager.java;1;0;4;1;0;0;0;4;142;3;2;316;142;142;3;2;0;4;4;316;2;550;2;1;
/org.eclipse.core.runtime.osgi/src/org/eclipse/core/internal/runtime/SafeFileInputStream.java;1;0;2;1;0;0;0;2;41;1;2;3013;41;41;1;0;0;2;2;3013;0;3030;2;1;
/org.eclipse.jdt.ui/ui/org/eclipse/jdt/internal/ui/javaeditor/JavaEditorErrorTickUpdater.java;1;0;1;1;1;1;1;0;2;0;0;6340;2;2;1;0;0;0;1;6340;0;6340;1;1;
/org.eclipse.team.core/src/org/eclipse/team/core/subscribers/trees/RemoteHandleTree.java;1;0;1;1;0;0;0;1;0;0;1;1427;0;0;1;0;0;1;1;1427;0;1427;1;1;
/org.eclipse.jdt.junit/src/org/eclipse/jdt/internal/junit/launcher/TestSelectionDialog.java;2;1;3;1;3;3;3;0;29;0;0;5112;58;58;1;0;0;0;3;5112;0;6340;3;2;
/org.eclipse.osgi/osgi/src/org/osgi/framework/FrameworkListener.java;2;0;2;1;1;1;1;1;3;0;1;3013;3;3;1;0;0;1;2;3013;0;5536;2;2;
/org.eclipse.ui.workbench/Eclipse UI/org/eclipse/ui/commands/internal/ConfigurationElementMemento.java;1;0;2;1;0;0;0;2;0;1;2;786;0;0;1;0;0;2;2;786;0;956;2;1;
/org.eclipse.ui.ide/src/org/eclipse/ui/views/tasklist/MarkerTypesModel.java;1;0;1;1;0;0;0;1;0;0;1;2208;0;0;1;0;0;1;1;2208;0;2208;1;1;
/org.eclipse.pde.ui/src_samples/org/eclipse/pde/ui/internal/samples/ProjectNamesPage.java;3;1;4;1;3;3;3;1;22;0;1;4668;47;47;1;0;0;1;4;4668;0;6336;4;3;
/org.eclipse.swt/Eclipse SWT/carbon/org/eclipse/swt/widgets/TabFolder.java;6;1;11;1;2;2;2;9;28;1;9;34;108;108;1;0;0;9;11;34;0;6352;11;6;
/org.eclipse.ui.workbench/Eclipse UI/org/eclipse/ui/internal/FeatureSelectionDialog.java;1;0;1;1;0;0;0;1;0;0;1;2737;0;0;1;0;0;1;1;2737;0;2737;1;1;
/org.eclipse.jdt.ui/ui/org/eclipse/jdt/ui/actions/CreateNewConstructorAction.java;1;0;6;1;0;0;0;6;340;1;6;1044;481;481;1;0;0;6;6;1044;0;1537;6;1;
/org.eclipse.ui.ide/src/org/eclipse/ui/internal/ide/misc/WorkInProgressPreferencePage.java;2;1;9;1;2;2;2;7;374;2;5;3710;612;612;2;2;0;7;9;3710;2;5309;7;2;
/org.eclipse.search/search/org/eclipse/search/internal/ui/WorkInProgressPreferencePage.java;2;0;5;1;1;1;1;4;51;1;4;3458;81;81;1;0;0;4;5;3458;0;5500;5;2;
/org.eclipse.pde.core/src/org/eclipse/pde/internal/core/schema/SchemaElementReference.java;2;1;3;1;2;2;2;1;22;0;1;4203;33;33;1;0;0;1;3;4203;0;6336;3;2;
/org.eclipse.jdt.debug.tests/tests/org/eclipse/jdt/debug/tests/eval/ArrayInitializationTests.java;1;0;1;1;0;0;0;1;18;0;1;1274;18;18;1;0;0;1;1;1274;0;1274;1;1;
/org.eclipse.jdt.core.tests.model/workspace/Formatter/test218/A_in.java;1;0;1;1;0;0;0;1;0;0;1;2426;0;0;1;0;0;1;1;2426;0;2426;1;1;
/org.eclipse.ui.workbench/Eclipse UI/org/eclipse/ui/internal/commands/api/older/ICategoryEvent.java;1;0;2;1;0;0;0;2;0;0;1;2562;0;0;2;1;0;2;2;2562;1;2562;1;1;
/org.eclipse.search/search/org/eclipse/search/internal/ui/text/FileTableContentProvider.java;2;1;4;1;2;2;2;2;41;1;2;3711;52;52;1;0;0;2;4;3711;0;6340;4;2;
/org.eclipse.ui.ide/src/org/eclipse/ui/views/markers/internal/IMarkerResourceAdapter.java;1;0;1;1;0;0;0;1;0;0;1;2208;0;0;1;0;0;1;1;2208;0;2208;1;1;
/org.eclipse.ui.workbench/Eclipse UI/org/eclipse/ui/commands/IKeySequence.java;1;0;3;1;0;0;0;3;4;1;3;1239;4;4;1;0;0;3;3;1239;0;1294;3;1;
/org.eclipse.ui.intro/src/org/eclipse/ui/internal/intro/impl/model/IntroInclude.java;1;1;4;1;4;4;4;0;10;0;0;5115;18;18;1;0;0;0;4;5115;0;5314;4;1;
/org.eclipse.jdt.core.tests.model/workspace/Converter/src/test0481/A.java;1;0;1;1;0;0;0;1;0;0;1;3714;0;0;1;0;0;1;1;3714;0;3714;1;1;
/org.eclipse.core.tests.resources/src/org/eclipse/core/tests/internal/localstore/AllTests.java;1;1;2;1;2;2;2;0;34;0;0;5147;44;44;1;0;0;0;2;5147;0;5988;2;1;
/org.eclipse.jdt.ui/core extension/org/eclipse/jdt/internal/corext/callhierarchy/Utility.java;1;0;2;1;0;0;0;2;0;1;2;155;0;0;1;0;0;2;2;155;0;171;2;1;
/org.eclipse.pde.ui/src_Forms/org/eclipse/pde/internal/ui/neweditor/schema/GrammarPropertySource.java;1;0;2;1;0;0;0;2;0;1;2;4856;0;0;1;0;0;2;2;4856;0;4879;2;1;
/org.eclipse.jdt.core/model/org/eclipse/jdt/core/util/ILocalVariableTypeTableAttribute.java;2;0;2;1;0;0;0;2;40;1;2;4394;40;40;1;0;0;2;2;4394;0;4843;2;2;
/org.eclipse.jdt.ui/core refactoring/org/eclipse/jdt/internal/corext/refactoring/reorg/ReorgRefactoring.java;1;0;3;1;0;0;0;3;81;1;3;130;125;125;1;0;0;3;3;130;0;1111;3;1;
/org.eclipse.update.ui/srcnew/org/eclipse/update/internal/ui/views/UninstallFeatureAction.java;2;0;3;1;0;0;0;3;10;1;3;339;10;10;1;0;0;3;3;339;0;825;3;2;
/org.eclipse.debug.core/core/org/eclipse/debug/internal/core/memory/MemoryRenderingManager.java;2;1;5;1;5;5;5;0;66;0;0;5254;114;114;1;0;0;0;5;5254;0;5744;5;2;
/org.eclipse.pde.ui/src/org/eclipse/pde/internal/ui/editor/site/SiteEditor.java;3;1;12;1;8;8;8;4;251;1;4;1618;424;424;1;0;0;4;12;1618;0;6336;12;3;
/org.eclipse.jdt.core.tests.model/workspace/Converter/src/junit/framework/TestFailure.java;1;0;1;1;0;0;0;1;0;0;1;3714;0;0;1;0;0;1;1;3714;0;3714;1;1;
/org.eclipse.jdt.ui.tests.refactoring/resources/PromoteTempToField/canPromote/A_test19_in.java;1;0;1;1;0;0;0;1;0;0;1;3576;0;0;1;0;0;1;1;3576;0;3576;1;1;
/org.eclipse.ui.workbench/Eclipse UI/org/eclipse/ui/IEditorLauncher.java;3;1;3;1;2;2;2;1;14;0;1;2737;18;18;1;0;0;1;3;2737;0;6338;3;3;
/org.eclipse.swt/Eclipse SWT PI/gtk/org/eclipse/swt/internal/gtk/GdkEventKey.java;3;0;4;1;1;1;1;3;17;1;3;1653;25;25;1;0;0;3;4;1653;0;6352;4;3;
/org.eclipse.ui.workbench/Eclipse UI/org/eclipse/ui/internal/dialogs/AboutSystemDialog.java;1;1;3;1;3;3;3;0;49;0;0;5483;51;51;1;0;0;0;3;5483;0;6338;3;1;
/org.eclipse.ui.views/src/org/eclipse/ui/views/tasklist/TaskPropertiesAction.java;1;0;1;1;0;0;0;1;0;0;1;2738;0;0;1;0;0;1;1;2738;0;2738;1;1;
/org.eclipse.jdt.debug/model/org/eclipse/jdt/debug/core/IJavaInterfaceType.java;2;0;3;1;0;0;0;3;46;1;3;670;79;79;1;0;0;3;3;670;0;2269;3;2;
/org.eclipse.jdt.core.tests.model/workspace/Encoding/src2/testUTF8/Test.java;1;0;1;1;1;1;1;0;0;0;0;6218;0;0;1;0;0;0;1;6218;0;6218;1;1;
/org.eclipse.text/src/org/eclipse/jface/text/ChildDocument.java;2;0;4;1;1;1;1;3;2;1;3;1347;5;5;1;0;0;3;4;1347;0;5177;4;2;
/org.eclipse.ant.ui/Ant Editor/org/eclipse/ant/internal/ui/editor/text/IAntEditorColorConstants.java;1;0;3;1;1;1;1;2;34;1;2;1811;42;42;1;0;0;2;3;1811;0;5700;3;1;
/org.eclipse.jdt.core.tests.model/workspace/Formatter/test229/A_in.java;1;0;1;1;0;0;0;1;0;0;1;2437;0;0;1;0;0;1;1;2437;0;2437;1;1;
/org.eclipse.core.resources/src/org/eclipse/core/internal/resources/MarkerTypeDefinitionCache.java;1;1;2;1;2;2;2;0;106;0;0;5146;108;108;1;0;0;0;2;5146;0;5443;2;1;
/org.eclipse.team.ui/src/org/eclipse/team/internal/ui/synchronize/SynchronizeViewWorkbenchPart.java;1;0;5;1;1;1;1;4;125;1;4;2535;169;169;1;0;0;4;5;2535;0;6337;5;1;
/org.eclipse.jdt.core.tests.model/workspace/Converter/src/javadoc/testBug51476/X3.java;1;0;1;1;0;0;0;1;0;0;1;3994;0;0;1;0;0;1;1;3994;0;3994;1;1;
/org.eclipse.jdt.ui.tests.refactoring/resources/ExtractMethodWorkSpace/ExtractMethodTests/return_out/A_test725.java;1;0;1;1;0;0;0;1;4;0;1;844;4;4;1;0;0;1;1;844;0;844;1;1;
/org.eclipse.jdt.ui.tests.refactoring/resources/ExtractMethodWorkSpace/ExtractMethodTests/locals_in/A_test541.java;1;0;1;1;0;0;0;1;4;0;1;844;4;4;1;0;0;1;1;844;0;844;1;1;
/org.eclipse.ui.ide/src/org/eclipse/ui/dialogs/WizardDataTransferPage.java;2;0;3;1;0;0;0;3;16;1;3;1511;16;16;1;0;0;3;3;1511;0;2263;3;2;
/org.eclipse.core.runtime.osgi/src/org/eclipse/core/runtime/IStatus.java;1;0;2;1;0;0;0;2;208;1;2;3013;208;208;1;0;0;2;2;3013;0;3030;2;1;
/org.eclipse.ui.ide/src/org/eclipse/ui/internal/dialogs/NewWizardCollectionSorter.java;2;0;2;1;0;0;0;2;0;1;2;1526;0;0;1;0;0;2;2;1526;0;2263;2;2;
/org.eclipse.jdt.ui.tests/ui/org/eclipse/jdt/ui/tests/search/JUnitSourceSetup.java;3;1;5;1;4;4;4;1;21;0;1;4345;33;33;1;0;0;1;5;4345;0;6096;5;3;
/org.eclipse.ant.ui/Ant Tools Support/org/eclipse/ant/ui/internal/views/actions/AntOpenWithMenu.java;1;0;3;1;0;0;0;3;12;2;2;263;12;12;2;1;0;3;3;263;1;1811;2;1;
/org.eclipse.jdt.core.tests.model/workspace/Formatter/test100/A_out.java;1;0;1;1;0;0;0;1;0;0;1;2425;0;0;1;0;0;1;1;2425;0;2425;1;1;
/org.eclipse.jdt.core/compiler/org/eclipse/jdt/internal/compiler/problem/AbortMethod.java;2;0;2;1;1;1;1;1;5;0;1;3560;7;7;1;0;0;1;2;3560;0;5615;2;2;
/org.eclipse.swt/Eclipse SWT Mozilla/common/org/eclipse/swt/internal/mozilla/nsIInputStream.java;1;0;1;1;0;0;0;1;0;0;1;2663;0;0;1;0;0;1;1;2663;0;2663;1;1;
/org.eclipse.debug.ui/ui/org/eclipse/debug/internal/ui/views/expression/ExpressionInformationControl.java;2;1;4;1;4;4;4;0;49;0;0;5133;57;57;1;0;0;0;4;5133;0;5682;4;2;
/org.eclipse.pde.ui/src_Forms/org/eclipse/pde/internal/ui/neweditor/schema/CompositorPropertySource.java;1;0;2;1;0;0;0;2;0;1;2;4856;0;0;1;0;0;2;2;4856;0;4879;2;1;
/org.eclipse.swt/Eclipse SWT PI/gtk1x/org/eclipse/swt/internal/gtk/GdkEvent.java;1;0;1;1;0;0;0;1;0;0;1;2327;0;0;1;0;0;1;1;2327;0;2327;1;1;
/org.eclipse.ui.views/src/org/eclipse/ui/views/markers/internal/DialogProblemFilter.java;2;0;2;1;0;0;0;2;0;1;2;755;0;0;1;0;0;2;2;755;0;2738;2;2;
/org.eclipse.jdt.ui/ui/org/eclipse/jdt/ui/text/java/IQuickAssistProcessor.java;2;1;5;1;3;3;3;2;14;1;2;1232;39;39;1;0;0;2;5;1232;0;6322;5;2;
/org.eclipse.ui.workbench/Eclipse UI/org/eclipse/ui/internal/themes/ICategorizedThemeElementDefinition.java;1;0;1;1;0;0;0;1;0;0;1;4392;0;0;1;0;0;1;1;4392;0;4392;1;1;
/org.eclipse.ui.ide/src/org/eclipse/ui/actions/ScrubLocalAction.java;2;0;3;1;0;0;0;3;14;1;3;1511;14;14;1;0;0;3;3;1511;0;2263;3;2;
/org.eclipse.ui.workbench/Eclipse UI/org/eclipse/ui/part/EditorPart.java;5;3;8;2;6;4;6;2;193;1;2;883;292;292;3;0;2;2;8;5805;2;6338;6;5;
/org.eclipse.debug.ui/ui/org/eclipse/debug/internal/ui/views/console/ScrollLockAction.java;3;1;3;1;2;2;2;1;32;0;1;3964;38;38;1;0;0;1;3;3964;0;6336;3;3;
/org.eclipse.jdt.ui/ui/org/eclipse/jdt/internal/ui/text/SequenceCharacterIterator.java;2;1;2;1;2;2;2;0;8;0;0;6072;8;8;1;0;0;0;2;6072;0;6340;2;2;
/org.eclipse.team.ui/src/org/eclipse/team/internal/ui/synchronize/views/TreeViewerUtils.java;1;0;1;1;0;0;0;1;0;0;1;3796;0;0;1;0;0;1;1;3796;0;3796;1;1;
/org.eclipse.debug.ui/ui/org/eclipse/debug/internal/ui/stringsubstitution/WorkspaceResolver.java;3;0;4;1;0;0;0;4;4;1;4;2046;9;9;1;0;0;4;4;2046;0;2514;4;3;
/org.eclipse.ui.editors/src/org/eclipse/ui/internal/editors/quickdiff/QuickDiffRestoreAction.java;2;0;4;1;0;0;0;4;15;1;4;1214;19;19;1;0;0;4;4;1214;0;1644;4;2;
/org.eclipse.jdt.core.tests.model/workspace/Formatter/test228/A_in.java;1;0;1;1;0;0;0;1;0;0;1;2426;0;0;1;0;0;1;1;2426;0;2426;1;1;
/org.eclipse.pde.ui/src/org/eclipse/pde/internal/ui/editor/plugin/ExportSection.java;3;1;10;1;10;10;10;0;193;0;0;5431;271;271;1;0;0;0;10;5431;0;6336;10;3;
/org.eclipse.jdt.core.tests.model/workspace/Completion/src/Completion2InterfacesWithSameMethod.java;1;0;1;1;1;1;1;0;0;0;0;6094;0;0;1;0;0;0;1;6094;0;6094;1;1;
/org.eclipse.update.ui.forms/src/org/eclipse/update/ui/forms/internal/engine/IHyperlinkSegment.java;1;0;1;1;0;0;0;1;2;0;1;480;2;2;1;0;0;1;1;480;0;480;1;1;
/org.eclipse.ui.intro/src/org/eclipse/ui/internal/intro/impl/swt/PageStyleManager.java;1;5;16;1;16;9;16;0;197;0;0;5714;386;386;5;0;7;0;16;5760;7;6280;9;1;
/org.eclipse.update.ui.forms/Eclipse Forms/org/eclipse/ui/forms/parts/TraversableLabel.java;1;0;2;1;0;0;0;2;0;0;1;3096;0;0;2;1;0;2;2;3096;1;3096;1;1;
/org.eclipse.swt.tests/JUnit Tests/org/eclipse/swt/tests/junit/Test_org_eclipse_swt_widgets_TableItem.java;4;0;6;1;1;1;1;5;112;1;5;2123;194;194;1;0;0;5;6;2123;0;6352;6;4;
/org.eclipse.jdt.core.tests.model/workspace/Converter/test0264/Test.java;1;0;1;1;0;0;0;1;0;0;1;3714;0;0;1;0;0;1;1;3714;0;3714;1;1;
/org.eclipse.jdt.core.tests.model/workspace/Converter/test0414/A.java;1;0;1;1;0;0;0;1;0;0;1;3714;0;0;1;0;0;1;1;3714;0;3714;1;1;
/org.eclipse.ui.tests/Eclipse UI Tests/org/eclipse/ui/tests/performance/UIPerformanceTestSuite.java;2;1;3;1;3;3;3;0;2;0;0;5641;3;3;1;0;0;0;3;5641;0;6338;3;2;
/org.eclipse.jdt.ui.tests.refactoring/resources/RenamePackage/testImportFromMultiRoots6/in/srcTest/p/p/ATest.java;1;0;1;1;0;0;0;1;0;0;1;4105;0;0;1;0;0;1;1;4105;0;4105;1;1;
/org.eclipse.jdt.core/codeassist/org/eclipse/jdt/internal/codeassist/complete/CompletionOnSingleNameReference.java;2;0;2;1;0;0;0;2;39;1;2;991;41;41;1;0;0;2;2;991;0;3560;2;2;
/org.eclipse.update.ui/src/org/eclipse/update/internal/ui/preferences/AppServerPreferencePage.java;1;0;2;1;0;0;0;2;82;1;2;778;82;82;1;0;0;2;2;778;0;807;2;1;
/org.eclipse.update.ui/src/org/eclipse/update/internal/ui/search/PluginsSearchCategory.java;2;0;2;1;0;0;0;2;1;1;2;369;1;1;1;0;0;2;2;369;0;755;2;2;
/org.eclipse.ui.ide/src/org/eclipse/ui/dialogs/ResourceSelectionDialog.java;2;0;4;1;0;0;0;4;7;1;4;1511;10;10;1;0;0;4;4;1511;0;2263;4;2;
/org.eclipse.ui.workbench/Eclipse UI/org/eclipse/ui/internal/contexts/MutableContextManager.java;4;2;16;1;6;4;6;10;589;1;10;3066;1058;1058;2;0;2;10;16;5273;2;6338;14;4;
/org.eclipse.text/src/org/eclipse/jface/text/source/IAnnotationModelExtension.java;2;1;4;1;3;3;3;1;105;0;1;2243;145;145;1;0;0;1;4;2243;0;6340;4;2;
/org.eclipse.jdt.ui/ui/org/eclipse/jdt/internal/ui/wizards/JavaProjectWizardFirstPage.java;2;1;10;1;3;3;3;7;270;1;7;3830;417;417;1;0;0;7;10;3830;0;6340;10;2;
/org.eclipse.update.core/src/org/eclipse/update/operations/IBatchOperation.java;1;2;8;1;3;2;3;5;14;2;4;825;27;27;2;1;1;5;8;825;2;6336;6;1;
/org.eclipse.ant.tests.ui/Ant Editor Tests/org/eclipse/ant/ui/internal/editor/support/TestProblemRequestor.java;1;0;2;1;0;0;0;2;0;1;2;1274;0;0;1;0;0;2;2;1274;0;1811;2;1;
/org.eclipse.core.resources/src/org/eclipse/core/internal/properties/StoredProperty.java;1;0;1;1;1;1;1;0;29;0;0;5146;29;29;1;0;0;0;1;5146;0;5146;1;1;
/org.eclipse.jdt.ui.tests.refactoring/resources/ChangeTypeRefactoring/negative/A_testFieldOfLocalType_in.java;1;0;1;1;0;0;0;1;0;0;1;3304;0;0;1;0;0;1;1;3304;0;3304;1;1;
/org.eclipse.jdt.core.tests.model/workspace/Converter/src/test0106/Test.java;1;0;1;1;0;0;0;1;0;0;1;3714;0;0;1;0;0;1;1;3714;0;3714;1;1;
/org.eclipse.help.base/src/org/eclipse/help/internal/search/ParsedDocument.java;1;1;3;1;2;2;2;1;10;0;1;1740;16;16;1;0;0;1;3;1740;0;6337;3;1;
/org.eclipse.swt/Eclipse SWT/motif/org/eclipse/swt/internal/Converter.java;6;0;7;2;0;0;0;7;245;2;5;0;265;265;2;2;0;7;7;773;2;2706;5;6;
/org.eclipse.ui.workbench/Eclipse UI/org/eclipse/ui/internal/commands/old/SimpleHandlerService.java;1;0;2;1;0;0;0;2;0;0;1;1222;0;0;2;1;0;2;2;1222;1;1222;1;1;
/org.eclipse.jface/src/org/eclipse/jface/preference/PreferenceLabelProvider.java;1;0;1;1;0;0;0;1;0;0;1;3131;0;0;1;0;0;1;1;3131;0;3131;1;1;
/org.eclipse.jdt.core.tests.model/workspace/Converter/src/test0224/Test.java;1;0;1;1;0;0;0;1;0;0;1;3714;0;0;1;0;0;1;1;3714;0;3714;1;1;
/org.eclipse.ui.editors/src/org/eclipse/ui/texteditor/TaskRulerAction.java;1;1;3;1;2;2;2;1;3;0;1;1347;7;7;1;0;0;1;3;1347;0;6337;3;1;
/org.eclipse.search/new search/org/eclipse/search2/internal/ui/basic/views/SearchResultsTableViewer.java;1;0;2;1;1;1;1;1;0;0;1;3474;0;0;1;0;0;1;2;3474;0;5106;2;1;
/org.eclipse.ant.ui/Ant Editor/org/eclipse/ant/ui/internal/editor/outline/AntModel.java;1;0;4;1;0;0;0;4;51;1;4;250;57;57;1;0;0;4;4;250;0;1811;4;1;
/org.eclipse.ui.views/src/org/eclipse/ui/views/navigator/GotoActionGroup.java;2;0;2;1;0;0;0;2;27;1;2;66;27;27;1;0;0;2;2;66;0;2738;2;2;
/org.eclipse.ui.tests/Eclipse UI Tests/org/eclipse/ui/tests/contexts/ContextsTestCase2.java;2;0;2;1;1;1;1;1;0;0;1;4896;0;0;1;0;0;1;2;4896;0;5531;2;2;
/org.eclipse.ant.core/src/org/eclipse/ant/core/IAntPropertyValueProvider.java;1;0;3;1;0;0;0;3;2;1;3;1402;4;4;1;0;0;3;3;1402;0;2988;3;1;
/org.eclipse.jdt.ui.tests.refactoring/resources/MoveMembers/test34/out/B.java;1;0;1;1;0;0;0;1;0;0;1;1856;0;0;1;0;0;1;1;1856;0;1856;1;1;
/org.eclipse.jface/src/org/eclipse/jface/viewers/LabelProvider.java;2;1;2;1;2;2;2;0;6;0;0;5339;8;8;1;0;0;0;2;5339;0;6338;2;2;
/org.eclipse.team.ui/src/org/eclipse/team/ui/synchronize/ResourceScope.java;2;2;4;1;4;3;4;0;119;0;0;5594;127;127;2;0;1;0;4;5594;1;6305;3;2;
/org.eclipse.jdt.ui.tests.refactoring/resources/MoveMembers/test41/out/B.java;1;0;1;1;0;0;0;1;0;0;1;4630;0;0;1;0;0;1;1;4630;0;4630;1;1;
/org.eclipse.ant.ui/Ant Tools Support/org/eclipse/ant/ui/internal/launchConfigurations/AntLaunchConfigurationMessages.java;1;0;3;1;0;0;0;3;2;1;3;250;2;2;1;0;0;3;3;250;0;1811;3;1;
/org.eclipse.jdt.ui/ui/org/eclipse/jdt/internal/ui/preferences/TodoTaskConfigurationBlock.java;3;1;13;1;5;5;5;8;106;1;8;1134;227;227;1;0;0;8;13;1134;0;6340;13;3;
/org.eclipse.jdt.core/model/org/eclipse/jdt/internal/core/util/ReferenceInfoAdapter.java;2;0;2;1;0;0;0;2;28;1;2;1892;30;30;1;0;0;2;2;1892;0;3560;2;2;
/org.eclipse.jdt.debug.ui/ui/org/eclipse/jdt/internal/debug/ui/launcher/ZipLabelProvider.java;1;0;1;1;0;0;0;1;0;0;1;1510;0;0;1;0;0;1;1;1510;0;1510;1;1;
/org.eclipse.ui.workbench/Eclipse UI/org/eclipse/ui/roles/ICategory.java;1;0;2;1;0;0;0;2;0;0;1;2864;0;0;2;1;0;2;2;2864;1;2864;1;1;
/org.eclipse.ui.ide/src/org/eclipse/ui/internal/ide/ChooseWorkspaceDialog.java;5;1;6;1;2;2;2;4;54;1;4;4434;163;163;1;0;0;4;6;4434;0;5641;6;5;
/org.eclipse.team.core/src/org/eclipse/team/core/subscribers/helpers/SubscriberResourceTree.java;1;0;1;1;0;0;0;1;0;0;1;3240;0;0;1;0;0;1;1;3240;0;3240;1;1;
/org.eclipse.jdt.core.tests.model/workspace/Converter/test0278/Test.java;1;0;1;1;0;0;0;1;0;0;1;3714;0;0;1;0;0;1;1;3714;0;3714;1;1;
/org.eclipse.jdt.ui.tests.refactoring/resources/IntroduceFactory/Bugzilla/46608/p2/TT_out.java;1;0;1;1;0;0;0;1;0;0;1;2888;0;0;1;0;0;1;1;2888;0;2888;1;1;
/org.eclipse.update.core/src/org/eclipse/update/configuration/ISessionDelta.java;2;1;4;1;3;3;3;1;6;0;1;890;13;13;1;0;0;1;4;890;0;6336;4;2;
/org.eclipse.jdt.ui/core refactoring/org/eclipse/jdt/internal/corext/refactoring/structure/PullUpRefactoring.java;5;1;47;2;10;10;10;37;587;3;32;48;1624;1624;3;5;0;37;47;238;5;6340;42;5;
/org.eclipse.jdt.debug.ui/ui/org/eclipse/jdt/internal/debug/ui/propertypages/JavaBreakpointAdvancedPage.java;2;0;2;1;0;0;0;2;9;1;2;1358;9;9;1;0;0;2;2;1358;0;2497;2;2;
/org.eclipse.jdt.core/compiler/org/eclipse/jdt/internal/compiler/impl/ShortConstant.java;2;0;3;1;1;1;1;2;10;1;2;1111;18;18;1;0;0;2;3;1111;0;5587;3;2;
/org.eclipse.jface.text/src/org/eclipse/jface/text/source/IVerticalRulerInfo.java;2;1;3;1;2;2;2;1;22;0;1;849;25;25;1;0;0;1;3;849;0;6361;3;2;
/org.eclipse.jdt.core/model/org/eclipse/jdt/core/jdom/IDOMFactory.java;1;0;3;1;1;1;1;2;3;1;2;3560;7;7;1;0;0;2;3;3560;0;5584;3;1;
/org.eclipse.jdt.core/model/org/eclipse/jdt/internal/core/ASTHolderCUInfo.java;2;0;3;1;0;0;0;3;17;1;3;4007;18;18;1;0;0;3;3;4007;0;5093;3;2;
/org.eclipse.ant.ui/Ant Editor/org/eclipse/ant/internal/ui/editor/outline/IDocumentModelListener.java;1;0;1;1;0;0;0;1;0;0;1;1811;0;0;1;0;0;1;1;1811;0;1811;1;1;
/org.eclipse.ant.ui/Ant Tools Support/org/eclipse/ant/ui/internal/views/elements/RootNode.java;1;0;2;1;0;0;0;2;0;1;2;250;0;0;1;0;0;2;2;250;0;1811;2;1;
/org.eclipse.jdt.text.tests/src/org/eclipse/jdt/ui/text/tests/JavaDoc2HTMLTextReaderTester.java;1;1;3;1;2;2;2;1;11;0;1;5082;11;11;1;0;0;1;3;5082;0;5129;3;1;
/org.eclipse.jdt.ui.tests.refactoring/resources/ExtractInterface/test96/out/I.java;1;0;1;1;0;0;0;1;0;0;1;1153;0;0;1;0;0;1;1;1153;0;1153;1;1;
/org.eclipse.pde.core/src/org/eclipse/pde/internal/core/TempFileManager.java;1;0;1;1;0;0;0;1;0;0;1;5042;0;0;1;0;0;1;1;5042;0;5042;1;1;
/org.eclipse.swt/Eclipse SWT PI/gtk/org/eclipse/swt/internal/accessibility/gtk/GTypeInfo.java;4;0;5;1;1;1;1;4;14;1;4;1214;29;29;1;0;0;4;5;1214;0;6352;5;4;
/org.eclipse.core.runtime.compatibility/src-model/org/eclipse/core/runtime/model/PluginModel.java;3;2;7;1;4;3;4;3;32;1;3;3013;46;46;2;0;1;3;7;5117;1;6340;6;3;
/org.eclipse.jdt.core.tests.model/workspace/Formatter/test227/A_in.java;1;0;1;1;0;0;0;1;0;0;1;2426;0;0;1;0;0;1;1;2426;0;2426;1;1;
/org.eclipse.team.examples.filesystem/src/org/eclipse/team/examples/filesystem/deployment/UnDeployAction.java;1;0;3;1;0;0;0;3;54;1;3;2810;54;54;1;0;0;3;3;2810;0;4633;3;1;
/org.eclipse.core.resources/src/org/eclipse/core/internal/indexing/Pointer.java;1;0;2;1;2;1;2;0;37;0;0;5146;37;37;2;0;1;0;2;5146;1;5146;1;1;
/org.eclipse.ui.workbench/Eclipse UI/org/eclipse/ui/internal/presentations/SystemMenuPinEditor.java;2;0;2;1;1;1;1;1;100;0;1;4680;100;100;1;0;0;1;2;4680;0;5173;2;2;
/org.eclipse.ui.views/src/org/eclipse/ui/views/markers/internal/DialogMarkerFilter.java;2;0;2;1;0;0;0;2;0;1;2;755;0;0;1;0;0;2;2;755;0;2738;2;2;
/org.eclipse.team.examples.filesystem/src/org/eclipse/team/examples/filesystem/FileSystemSubscriber.java;2;0;4;1;0;0;0;4;86;2;3;4213;128;128;2;1;0;4;4;4213;1;4349;3;2;
/org.eclipse.ui.workbench/Eclipse UI/org/eclipse/ui/commands/internal/CaptureEvent.java;1;0;2;1;0;0;0;2;0;1;2;786;0;0;1;0;0;2;2;786;0;956;2;1;
/org.eclipse.swt/Eclipse SWT PI/gtk1x/org/eclipse/swt/internal/gtk/GdkVisual.java;1;0;1;1;0;0;0;1;0;0;1;2327;0;0;1;0;0;1;1;2327;0;2327;1;1;
/org.eclipse.debug.ui/ui/org/eclipse/debug/internal/ui/sourcelookup/SourceLookupUIMessages.java;2;0;2;1;1;1;1;1;4;0;1;3770;4;4;1;0;0;1;2;3770;0;6336;2;2;
/org.eclipse.ui.workbench/Eclipse UI/org/eclipse/ui/internal/commands/old/ActionHandler.java;1;0;5;1;0;0;0;5;10;2;4;1222;17;17;2;1;0;5;5;1222;1;1695;4;1;
/org.eclipse.jdt.core.tests.model/workspace/Converter/src/javadoc/test106/Test.java;1;0;1;1;0;0;0;1;0;0;1;4390;0;0;1;0;0;1;1;4390;0;4390;1;1;
/org.eclipse.jdt.ui.tests.refactoring/resources/ExtractMethodWorkSpace/ExtractMethodTests/nested_out/A_test650.java;1;0;2;1;0;0;0;2;4;1;2;130;5;5;1;0;0;2;2;130;0;844;2;1;
/org.eclipse.jdt.core.tests.model/workspace/Formatter/test039/A_in.java;1;0;1;1;0;0;0;1;0;0;1;2425;0;0;1;0;0;1;1;2425;0;2425;1;1;
/org.eclipse.ltk.ui.refactoring/src/org/eclipse/ltk/ui/refactoring/RefactoringWizardDialog.java;1;0;3;1;0;0;0;3;11;1;3;4965;11;11;1;0;0;3;3;4965;0;5052;3;1;
/org.eclipse.jdt.core.tests.model/workspace/Converter/test0070/Test.java;1;0;1;1;0;0;0;1;0;0;1;3714;0;0;1;0;0;1;1;3714;0;3714;1;1;
/org.eclipse.search/new search/org/eclipse/search/ui/ISearchJob.java;1;0;2;1;0;0;0;2;0;1;2;3474;0;0;1;0;0;2;2;3474;0;3711;2;1;
/org.eclipse.swt/Eclipse SWT PI/win32/org/eclipse/swt/internal/win32/SCRIPT_ITEM.java;2;0;2;1;1;1;1;1;4;0;1;4563;4;4;1;0;0;1;2;4563;0;6352;2;2;
/org.eclipse.jdt.core/compiler/org/eclipse/jdt/internal/compiler/codegen/LongCache.java;1;0;1;1;0;0;0;1;2;0;1;3560;2;2;1;0;0;1;1;3560;0;3560;1;1;
/org.eclipse.debug.ui/ui/org/eclipse/debug/internal/ui/console/ConsoleManager.java;2;0;2;1;0;0;0;2;0;1;2;1294;0;0;1;0;0;2;2;1294;0;2060;2;2;
/org.eclipse.jdt.ui.tests.refactoring/resources/ExtractMethodWorkSpace/ExtractMethodTests/destination_in/A_test1051.java;1;0;1;1;1;1;1;0;0;0;0;5353;0;0;1;0;0;0;1;5353;0;5353;1;1;
/org.eclipse.pde.core/src/org/eclipse/pde/core/plugin/IPluginImport.java;3;1;6;1;4;4;4;2;42;1;2;4203;66;66;1;0;0;2;6;4203;0;6336;6;3;
/org.eclipse.ui.tests/Eclipse UI Tests/org/eclipse/ui/tests/api/workbenchpart/RawIViewPart.java;1;0;1;1;1;1;1;0;0;0;0;6101;0;0;1;0;0;0;1;6101;0;6101;1;1;
/org.eclipse.update.core/src/org/eclipse/update/core/BaseFeatureFactory.java;2;1;3;1;2;2;2;1;6;0;1;890;15;15;1;0;0;1;3;890;0;6336;3;2;
/org.eclipse.ltk.core.refactoring/src/org/eclipse/ltk/core/refactoring/TextChange.java;2;2;13;2;11;9;11;2;113;1;2;4845;361;361;2;0;2;2;13;5463;2;6338;11;2;
/org.eclipse.jdt.core/compiler/org/eclipse/jdt/internal/compiler/DocumentElementParser.java;5;0;16;1;0;0;0;16;56;1;16;69;189;189;1;0;0;16;16;69;0;4461;16;5;
/org.eclipse.pde.ui/src/org/eclipse/pde/internal/ui/editor/feature/PortabilityChoicesDialog.java;2;1;5;1;2;2;2;3;23;1;3;368;43;43;1;0;0;3;5;368;0;6336;5;2;
/org.eclipse.webdav/src/kernel/org/eclipse/webdav/internal/kernel/DocumentMarshaler.java;1;1;3;1;2;2;2;1;33;0;1;2549;41;41;1;0;0;1;3;2549;0;6340;3;1;
/org.eclipse.help.base/src/org/eclipse/help/internal/HelpSystem.java;1;0;3;1;0;0;0;3;4;0;1;1740;4;4;3;2;0;3;3;1740;2;1740;1;1;
/org.eclipse.core.runtime/src/org/eclipse/core/internal/runtime/PluginParser.java;1;0;2;1;0;0;0;2;0;1;2;3087;0;0;1;0;0;2;2;3087;0;3169;2;1;
/org.eclipse.jdt.ui/ui/org/eclipse/jdt/internal/ui/javaeditor/AddImportOnSelectionAction.java;3;1;10;2;6;6;6;4;49;2;3;1350;155;155;2;1;0;4;10;1350;1;6340;9;3;
/org.eclipse.core.resources/src/org/eclipse/core/internal/watson/IElementComparator.java;1;0;1;1;1;1;1;0;5;0;0;5146;5;5;1;0;0;0;1;5146;0;5146;1;1;
/org.eclipse.ui.examples.job/org/eclipse/ui/examples/jobs/TestJob.java;1;0;2;1;2;1;2;0;0;0;0;5125;0;0;2;0;1;0;2;5125;1;5125;1;1;
/org.eclipse.jdt.ui.tests.refactoring/resources/MoveInnerToTopLevel/test_nonstatic_37/in/A.java;1;0;1;1;0;0;0;1;0;0;1;1311;0;0;1;0;0;1;1;1311;0;1311;1;1;
/org.eclipse.jdt.ui.tests/ui/org/eclipse/jdt/ui/tests/core/TextBufferTest.java;2;0;13;1;0;0;0;13;471;3;10;803;1204;1204;3;3;0;13;13;1946;3;1972;10;2;
/org.eclipse.team.ui/src/org/eclipse/team/internal/ui/target/TargetSiteContentHandler.java;1;0;1;1;0;0;0;1;0;0;1;2495;0;0;1;0;0;1;1;2495;0;2495;1;1;
/org.eclipse.core.resources/src/org/eclipse/core/resources/IResource.java;2;1;10;2;3;3;3;7;3621;1;7;44;3981;3981;1;0;0;7;10;44;0;5534;10;2;
/org.eclipse.jdt.ui/core refactoring/org/eclipse/jdt/internal/corext/refactoring/participants/xml/IElementHandler.java;1;0;3;1;0;0;0;3;3;1;3;1033;3;3;1;0;0;3;3;1033;0;4091;3;1;
/org.eclipse.jdt.core/compiler/org/eclipse/jdt/internal/compiler/codegen/CharArrayCache.java;2;0;2;1;1;1;1;1;2;0;1;3560;4;4;1;0;0;1;2;3560;0;5916;2;2;
/org.eclipse.team.cvs.ui/src/org/eclipse/team/internal/ccvs/ui/subscriber/MergeSynchronizeParticipant.java;2;1;22;1;12;12;12;10;162;1;10;2590;552;552;1;0;0;10;22;2590;0;6337;22;2;
/org.eclipse.team.cvs.ui/src/org/eclipse/team/internal/ccvs/ui/operations/ShareProjectOperation.java;2;1;9;1;3;3;3;6;132;2;5;2986;180;180;2;1;0;6;9;4699;1;6337;8;2;
/org.eclipse.ui.workbench/Eclipse UI/org/eclipse/ui/internal/registry/ProjectImageRegistry.java;1;0;1;1;0;0;0;1;0;0;1;2737;0;0;1;0;0;1;1;2737;0;2737;1;1;
/org.eclipse.ui.workbench/Eclipse UI/org/eclipse/ui/internal/contexts/registry/PluginRegistry.java;1;0;2;1;0;0;0;2;0;0;1;1396;0;0;2;1;0;2;2;1396;1;1396;1;1;
/org.eclipse.text/src/org/eclipse/jface/text/ILineTracker.java;1;0;1;1;1;1;1;0;20;0;0;6299;20;20;1;0;0;0;1;6299;0;6299;1;1;
/org.eclipse.search/new search/org/eclipse/search2/internal/ui/basic/views/RemoveMatchAction.java;2;0;3;1;1;1;1;2;13;1;2;3474;15;15;1;0;0;2;3;3474;0;6340;3;2;
/org.eclipse.jdt.core.tests.model/workspace/Converter15/src/test0004/X.java;1;0;1;1;0;0;0;1;0;0;1;4601;0;0;1;0;0;1;1;4601;0;4601;1;1;
/org.eclipse.team.ui/src/org/eclipse/team/ui/synchronize/content/SyncInfoDecoratingLabelProvider.java;1;0;1;1;0;0;0;1;0;0;1;3749;0;0;1;0;0;1;1;3749;0;3749;1;1;
/org.eclipse.jdt.ui/ui/org/eclipse/jdt/internal/ui/callhierarchy/TreeTermination.java;2;0;3;1;1;1;1;2;7;1;2;155;9;9;1;0;0;2;3;155;0;6340;3;2;
/org.eclipse.core.filebuffers/src/org/eclipse/core/internal/filebuffers/DefaultDocumentFactory.java;2;0;2;1;1;1;1;1;20;0;1;1522;20;20;1;0;0;1;2;1522;0;6340;2;2;
/org.eclipse.team.ui/src/org/eclipse/team/internal/ui/sync/views/SyncSetChangeFilter.java;1;0;1;1;0;0;0;1;0;0;1;488;0;0;1;0;0;1;1;488;0;488;1;1;
/org.eclipse.core.expressions.tests/src/org/eclipse/core/internal/expressions/tests/B_TypeExtender.java;1;0;2;1;1;1;1;1;2;0;1;4108;2;2;1;0;0;1;2;4108;0;6340;2;1;
/org.eclipse.jdt.ui/ui/org/eclipse/jdt/internal/ui/search/ExceptionOccurrencesGroupKey.java;1;0;1;1;0;0;0;1;0;0;1;4888;0;0;1;0;0;1;1;4888;0;4888;1;1;
/org.eclipse.pde.ui/src_Forms/org/eclipse/pde/internal/ui/neweditor/plugin/DummyExtensionElement.java;1;0;2;1;0;0;0;2;0;1;2;3834;0;0;1;0;0;2;2;3834;0;4223;2;1;
/org.eclipse.ui.workbench/Eclipse UI/org/eclipse/ui/internal/csm/activities/IActivityActivationServiceEvent.java;1;0;2;1;0;0;0;2;0;1;2;2225;0;0;1;0;0;2;2;2225;0;2310;2;1;
/org.eclipse.jdt.core.tests.model/workspace/Converter/test0444/A.java;1;0;1;1;0;0;0;1;0;0;1;3714;0;0;1;0;0;1;1;3714;0;3714;1;1;
/org.eclipse.jdt.core.tests.model/workspace/Formatter/test483/A_in.java;1;0;1;1;0;0;0;1;0;0;1;4173;0;0;1;0;0;1;1;4173;0;4173;1;1;
/org.eclipse.team.ui/src/org/eclipse/team/internal/ui/actions/ITeamRunnableContext.java;2;0;4;1;1;1;1;3;46;1;3;4071;58;58;1;0;0;3;4;4071;0;6337;4;2;
/org.eclipse.swt/Eclipse SWT PI/gtk1x/org/eclipse/swt/internal/gtk/GtkAdjustment.java;1;0;1;1;0;0;0;1;0;0;1;2327;0;0;1;0;0;1;1;2327;0;2327;1;1;
/org.eclipse.jface/src/org/eclipse/jface/preference/PreferenceNode.java;2;1;2;1;2;2;2;0;407;0;0;5463;411;411;1;0;0;0;2;5463;0;6338;2;2;
/org.eclipse.jdt.ui.examples.javafamily/stuff/Search.java;1;0;1;1;0;0;0;1;0;0;1;1033;0;0;1;0;0;1;1;1033;0;1033;1;1;
/org.eclipse.ui.workbench/Eclipse UI/org/eclipse/ui/internal/contexts/PreferenceContextRegistry.java;1;0;6;1;0;0;0;6;14;2;5;1400;20;20;2;1;0;6;6;1400;1;2425;5;1;
/org.eclipse.update.ui.win32/src/org/eclipse/welcome/internal/WelcomeEditorInputFactory.java;1;0;2;1;0;0;0;2;0;1;2;892;0;0;1;0;0;2;2;892;0;907;2;1;
/org.eclipse.swt/Eclipse SWT PI/win32/org/eclipse/swt/internal/ole/win32/STATSTG.java;1;0;1;1;0;0;0;1;9;0;1;2915;9;9;1;0;0;1;1;2915;0;2915;1;1;
/org.eclipse.ui.workbench/Eclipse UI/org/eclipse/ui/internal/activities/ActivityManagerFactory.java;2;0;2;1;1;1;1;1;4;0;1;4927;4;4;1;0;0;1;2;4927;0;6338;2;2;
/org.eclipse.ant.ui/Remote Ant Support/org/eclipse/ant/internal/ui/antsupport/InternalAntMessages.java;1;0;1;1;0;0;0;1;0;0;1;1811;0;0;1;0;0;1;1;1811;0;1811;1;1;
/org.eclipse.team.webdav/src/org/eclipse/team/internal/ui/target/SiteViewSorter.java;1;0;1;1;0;0;0;1;0;0;1;2495;0;0;1;0;0;1;1;2495;0;2495;1;1;
/org.eclipse.ui.externaltools/Ant Tools Support/org/eclipse/ui/externaltools/internal/ant/launchConfigurations/AntStreamMonitor.java;1;0;1;1;0;0;0;1;0;0;1;282;0;0;1;0;0;1;1;282;0;282;1;1;
/org.eclipse.ui.workbench/Eclipse UI/org/eclipse/ui/wizards/datatransfer/SelectFilesOperation.java;1;0;1;1;0;0;0;1;0;0;1;2737;0;0;1;0;0;1;1;2737;0;2737;1;1;
/org.eclipse.ui.workbench/Eclipse UI/org/eclipse/ui/internal/commands/api/ICommandRegistryListener.java;1;0;4;1;0;0;0;4;0;2;3;1724;0;0;2;1;0;4;4;2515;1;2532;3;1;
/org.eclipse.help.base/src/org/eclipse/help/internal/browser/CurrentBrowser.java;1;0;5;1;1;1;1;4;53;1;4;1740;63;63;1;0;0;4;5;1740;0;6337;5;1;
/org.eclipse.ui.workbench/Eclipse UI/org/eclipse/ui/wizards/newresource/BasicNewResourceWizard.java;1;0;1;1;0;0;0;1;0;0;1;2737;0;0;1;0;0;1;1;2737;0;2737;1;1;
/org.eclipse.ui.editors/src/org/eclipse/ui/editors/text/ISchedulingRuleProvider.java;2;0;4;2;1;1;1;3;18;2;2;2895;18;18;2;1;0;3;4;4760;1;5126;3;2;
/org.eclipse.pde.ui/src_Forms/org/eclipse/pde/internal/ui/model/plugin/AbstractPluginDocumentHandler.java;2;1;3;1;3;3;3;0;10;0;0;5703;14;14;1;0;0;0;3;5703;0;6336;3;2;
/org.eclipse.team.webdav/src/org/eclipse/team/internal/ui/target/subscriber/TargetSubscriberAction.java;1;0;1;1;0;0;0;1;0;0;1;3494;0;0;1;0;0;1;1;3494;0;3494;1;1;
/org.eclipse.jdt.debug.ui/ui/org/eclipse/jdt/internal/debug/ui/JavaBreakpointWorkbenchAdapterFactory.java;1;0;2;1;0;0;0;2;16;0;1;1432;16;16;2;1;0;2;2;1432;1;1432;1;1;
/org.eclipse.jdt.ui/core refactoring/org/eclipse/jdt/internal/corext/refactoring/base/IChange.java;1;0;3;1;0;0;0;3;8;1;3;3646;14;14;1;0;0;3;3;3646;0;3930;3;1;
/org.eclipse.jdt.core/compiler/org/eclipse/jdt/internal/compiler/ast/Continue.java;1;0;1;1;0;0;0;1;0;0;1;148;0;0;1;0;0;1;1;148;0;148;1;1;
/org.eclipse.jdt.core.tests.model/workspace/Converter/src/test0496/A.java;1;0;1;1;0;0;0;1;0;0;1;3714;0;0;1;0;0;1;1;3714;0;3714;1;1;
/org.eclipse.jdt.ui.tests.refactoring/resources/ChangeTypeRefactoring/positive/A_testReturnType2.java;1;0;1;1;0;0;0;1;0;0;1;2844;0;0;1;0;0;1;1;2844;0;2844;1;1;
/org.eclipse.jdt.core/codeassist/org/eclipse/jdt/internal/codeassist/complete/CompletionOnQualifiedAllocationExpression.java;2;0;2;1;0;0;0;2;12;1;2;991;14;14;1;0;0;2;2;991;0;3560;2;2;
/org.eclipse.jdt.ui.tests.refactoring/resources/ExtractMethodWorkSpace/ExtractMethodTests/locals_in/A_test567.java;1;0;1;1;0;0;0;1;2;0;1;844;2;2;1;0;0;1;1;844;0;844;1;1;
/org.eclipse.update.ui.forms/Eclipse Forms/org/eclipse/ui/forms/parts/ScrollableRichText.java;1;0;3;1;0;0;0;3;2;2;2;3096;2;2;2;1;0;3;3;3137;1;3137;2;1;
/org.eclipse.core.tests.resources/src/org/eclipse/core/tests/resources/regression/Bug_25457.java;1;3;4;1;4;2;4;0;17;0;0;5147;25;25;3;0;2;0;4;5147;2;5512;2;1;
/org.eclipse.core.tests.runtime/src/org/eclipse/core/tests/runtime/TestAdapter.java;2;0;2;1;1;1;1;1;2;0;1;3812;2;2;1;0;0;1;2;3812;0;5149;2;2;
/org.eclipse.jdt.ui/core extension/org/eclipse/jdt/internal/corext/dom/CommentMapper.java;1;0;3;1;0;0;0;3;1;1;3;3593;1;1;1;0;0;3;3;3593;0;4803;3;1;
/org.eclipse.search/new search/org/eclipse/search/ui/text/IEditorMatchAdapter.java;2;2;5;1;5;3;5;0;7;0;0;5178;15;15;2;0;2;0;5;5178;2;6311;3;2;
/org.eclipse.jdt.debug.ui/ui/org/eclipse/jdt/internal/debug/ui/actions/ShowSystemThreadsAction.java;3;1;5;1;2;2;2;3;64;1;3;3112;87;87;1;0;0;3;5;3112;0;6336;5;3;
/org.eclipse.jdt.debug.ui/ui/org/eclipse/jdt/internal/debug/ui/launcher/WorkingDirectoryBlock.java;4;1;9;1;3;3;3;6;228;1;6;1240;483;483;1;0;0;6;9;1240;0;6247;9;4;
/org.eclipse.team.cvs.ui/src/org/eclipse/team/internal/ccvs/ui/actions/CVSAction.java;2;1;11;1;4;4;4;7;60;1;7;790;241;241;1;0;0;7;11;790;0;6337;11;2;
/org.eclipse.jdt.core.tests.model/workspace/Converter/test0508/A.java;1;0;2;1;0;0;0;2;0;1;2;3009;0;0;1;0;0;2;2;3009;0;3714;2;1;
/org.eclipse.jdt.ui.tests.refactoring/resources/PasteSourceReference/test4/out/B.java;1;0;1;1;0;0;0;1;0;0;1;1311;0;0;1;0;0;1;1;1311;0;1311;1;1;
/org.eclipse.team.ui/src/org/eclipse/team/internal/ui/sync/pages/SynchronizePageDropDownAction.java;1;0;1;1;0;0;0;1;0;0;1;2411;0;0;1;0;0;1;1;2411;0;2411;1;1;
/org.eclipse.ui.workbench/Eclipse UI/org/eclipse/ui/commands/internal/SequenceMachine.java;1;0;2;1;0;0;0;2;0;1;2;786;0;0;1;0;0;2;2;786;0;956;2;1;
/org.eclipse.team.webdav/src/org/eclipse/team/internal/webdav/subscriber/WebDavSubscriberResource.java;2;1;7;1;3;3;3;4;219;1;4;3496;283;283;1;0;0;4;7;3496;0;6337;7;2;
/org.eclipse.team.ui/src/org/eclipse/team/internal/ui/sync/actions/ChooseSubscriberAction.java;1;0;3;1;0;0;0;3;3;1;3;1181;3;3;1;0;0;3;3;1181;0;2632;3;1;
/org.eclipse.team.tests.cvs.core/src/org/eclipse/team/tests/ccvs/ui/sync/AllTestsSynchronizeView.java;1;0;3;1;0;0;0;3;3;1;3;1417;3;3;1;0;0;3;3;1417;0;2632;3;1;
/org.eclipse.jdt.ui.tests.refactoring/resources/MoveInstanceMethod/canMove/test22/in/A.java;1;0;1;1;0;0;0;1;0;0;1;1603;0;0;1;0;0;1;1;1603;0;1603;1;1;
/org.eclipse.update.tests.core/src/org/eclipse/update/tests/branding/ProductTest.java;1;0;2;1;1;1;1;1;4;0;1;4613;4;4;1;0;0;1;2;4613;0;6336;2;1;
/org.eclipse.jdt.core.tests.model/workspace/Formatter/test157/A_out.java;1;0;2;1;0;0;0;2;2;1;2;2425;2;2;1;0;0;2;2;2425;0;4173;2;1;
/org.eclipse.jdt.ui/ui/org/eclipse/jdt/internal/ui/text/link/LinkedPositionGroup.java;1;0;5;1;0;0;0;5;506;1;5;2838;562;562;1;0;0;5;5;2838;0;4214;5;1;
/org.eclipse.core.resources/src/org/eclipse/core/internal/refresh/MonitorManager.java;2;1;11;1;2;2;2;9;36;1;9;3681;129;129;1;0;0;9;11;3681;0;5275;11;2;
/org.eclipse.update.core/src/org/eclipse/update/internal/api/operations/IOperationListener.java;1;0;2;1;0;0;0;2;0;1;2;3270;0;0;1;0;0;2;2;3270;0;4928;2;1;
/org.eclipse.ui.workbench/Eclipse UI/org/eclipse/ui/internal/csm/commands/api/IPatternBinding.java;1;0;2;1;0;0;0;2;0;1;2;2515;0;0;1;0;0;2;2;2515;0;2532;2;1;
/org.eclipse.jface.text/src/org/eclipse/jface/text/IInformationControlExtension3.java;3;1;6;1;2;2;2;4;41;1;4;2544;86;86;1;0;0;4;6;2544;0;6359;6;3;
/org.eclipse.jdt.ui.tests.refactoring/resources/IntroduceFactory/positive/differentArgs.java;1;0;2;1;0;0;0;2;0;1;2;2846;0;0;1;0;0;2;2;2846;0;2862;2;1;
/org.eclipse.jdt.core/compiler/org/eclipse/jdt/internal/compiler/ICompilerRequestor.java;1;0;1;1;0;0;0;1;2;0;1;3560;2;2;1;0;0;1;1;3560;0;3560;1;1;
/org.eclipse.ui.views/src/org/eclipse/ui/views/internal/tableview/TableSortAction.java;1;0;2;1;0;0;0;2;0;1;2;267;0;0;1;0;0;2;2;267;0;749;2;1;
/org.eclipse.jdt.debug.ui/ui/org/eclipse/jdt/internal/debug/ui/launchConfigurations/DefaultClasspathEntriesSelectionDialog.java;1;0;2;1;0;0;0;2;0;0;1;2685;0;0;2;1;0;2;2;2685;1;2685;1;1;
/org.eclipse.update.ui.forms/Eclipse Forms/org/eclipse/ui/forms/parts/ExpandableComposite.java;1;0;6;1;0;0;0;6;176;3;3;3096;325;325;3;3;0;6;6;3133;3;3133;3;1;
/org.eclipse.ui.workbench/Eclipse UI/org/eclipse/ui/IStartup.java;2;0;3;1;1;1;1;2;22;1;2;1526;26;26;1;0;0;2;3;1526;0;6338;3;2;
/org.eclipse.swt/Eclipse SWT/gtk1x/org/eclipse/swt/graphics/GCData.java;1;0;1;1;0;0;0;1;0;0;1;2327;0;0;1;0;0;1;1;2327;0;2327;1;1;
/org.eclipse.team.ftp/src/org/eclipse/team/internal/ftp/deployment/FTPPutOperation.java;1;0;1;1;0;0;0;1;0;0;1;3387;0;0;1;0;0;1;1;3387;0;3387;1;1;
/org.eclipse.jdt.debug.ui/ui/org/eclipse/jdt/internal/debug/ui/actions/ViewFilterAction.java;1;0;1;1;0;0;0;1;0;0;1;3296;0;0;1;0;0;1;1;3296;0;3296;1;1;
/org.eclipse.text.tests/src/org/eclipse/text/tests/DocumentExtensionTest.java;1;2;4;1;3;2;3;1;20;0;1;5082;28;28;2;0;1;1;4;5100;1;6340;3;1;
/org.eclipse.jdt.core/model/org/eclipse/jdt/core/ITypeHierarchyChangedListener.java;1;0;1;1;0;0;0;1;2;0;1;3560;2;2;1;0;0;1;1;3560;0;3560;1;1;
/org.eclipse.jdt.core.tests.model/src/org/eclipse/jdt/core/tests/model/WorkingCopyNotInClasspathTests.java;3;0;20;1;1;1;1;19;80;2;17;78;477;477;2;2;0;19;20;2037;2;5189;18;3;
/org.eclipse.pde.ui/src/org/eclipse/pde/internal/ui/wizards/FolderSelectionDialog.java;2;1;3;1;2;2;2;1;4;0;1;3393;6;6;1;0;0;1;3;3393;0;6336;3;2;
/org.eclipse.update.core/src/org/eclipse/update/internal/standalone/ScriptedCommand.java;1;0;10;1;0;0;0;10;37;1;10;828;110;110;1;0;0;10;10;828;0;4928;10;1;
/org.eclipse.ui.workbench/Eclipse UI/org/eclipse/ui/internal/roles/CategoryRegistryEvent.java;1;0;2;1;0;0;0;2;0;0;1;2864;0;0;2;1;0;2;2;2864;1;2864;1;1;
/org.eclipse.jface/src/org/eclipse/jface/resource/ResourceRegistry.java;1;0;1;1;0;0;0;1;0;0;1;4368;0;0;1;0;0;1;1;4368;0;4368;1;1;
/org.eclipse.jface/src/org/eclipse/jface/util/SafeRunnable.java;2;2;5;1;5;4;5;0;16;0;0;5339;38;38;2;0;1;0;5;5339;1;6338;4;2;
/org.eclipse.ant.ui/Ant Editor/org/eclipse/ant/ui/internal/dtd/schema/Attribute.java;1;0;4;1;0;0;0;4;20;1;4;250;28;28;1;0;0;4;4;250;0;1811;4;1;
/org.eclipse.jdt.core.tests.model/workspace/Formatter/test011/A_in.java;1;0;1;1;0;0;0;1;0;0;1;2425;0;0;1;0;0;1;1;2425;0;2425;1;1;
