filename;TotalPeopleInBurst;MaximumChangeBurstLate;NumberOfChanges;MaxPeopleInBurst;TotalBurstSizeLate;NumberOfChangeBurstsLate;NumberOfChangesLate;NumberOfChangesEarly;MaxChurnInBurst;MaximumChangeBurstEarly;NumberOfChangeBurstsEarly;TimeFirstBurst;TotalChurnInBurst;ChurnTotal;MaximumChangeBurst;NumberOfConsecutiveChangesEarly;NumberOfConsecutiveChangesLate;TotalBurstSizeEarly;TotalBurstSize;TimeMaxBurst;NumberOfConsecutiveChanges;TimeLastBurst;NumberOfChangeBursts;PeopleTotal;bugs
/org.eclipse.debug.ui/ui/org/eclipse/debug/internal/ui/actions/CopyVariablesToClipboardActionDelegate.java;2;0;2;1;0;0;0;2;40;1;2;122;64;64;1;0;0;2;2;122;0;147;2;2;0
/org.eclipse.update.ui/src/org/eclipse/update/internal/ui/wizards/ReplaceFeatureVersionWizardPage.java;1;0;6;1;1;1;1;5;37;1;5;76;54;54;1;0;0;5;6;76;0;336;6;1;1
/org.eclipse.osgi/osgi/src/org/osgi/framework/PackagePermission.java;2;0;2;1;1;1;1;1;3;0;1;171;3;3;1;0;0;1;2;171;0;296;2;2;0
/org.eclipse.pde.ui/src/org/eclipse/pde/internal/ui/editor/text/ReconcilingStrategy.java;1;1;2;1;2;2;2;0;10;0;0;292;10;10;1;0;0;0;2;292;0;336;2;1;0
/org.eclipse.core.resources/src/org/eclipse/core/internal/events/AutoBuildJob.java;2;9;23;2;10;2;12;11;109;5;7;122;324;324;9;4;10;13;23;292;14;332;9;2;1
/org.eclipse.jdt.ui/ui/org/eclipse/jdt/internal/ui/search/IOccurrencesFinder.java;3;0;3;1;1;1;1;2;14;1;2;209;28;28;1;0;0;2;3;209;0;290;3;3;0
/org.eclipse.swt/Eclipse SWT Printing/gtk/org/eclipse/swt/printing/Printer.java;4;1;7;2;2;2;2;5;15;2;4;0;37;37;2;1;0;5;7;144;1;337;6;4;0
/org.eclipse.pde.ui/src/org/eclipse/pde/internal/ui/PDEPlugin.java;3;1;18;2;5;5;5;13;48;2;9;26;238;238;2;4;0;13;18;131;4;336;14;3;0
/org.eclipse.ui.ide/src/org/eclipse/ui/views/bookmarkexplorer/RemoveBookmarkAction.java;1;0;1;1;0;0;0;1;0;0;1;129;0;0;1;0;0;1;1;129;0;129;1;1;0
/org.eclipse.ui.workbench/Eclipse UI/org/eclipse/ui/internal/ObjectContributorManager.java;2;0;3;2;0;0;0;3;271;2;2;157;478;478;2;1;0;3;3;157;1;178;2;2;0
/org.eclipse.search/search/org/eclipse/search/internal/ui/text/ResourcePathSorter.java;2;0;2;1;1;1;1;1;3;0;1;207;5;5;1;0;0;1;2;207;0;336;2;2;0
/org.eclipse.ant.ui/Ant Tools Support/org/eclipse/ant/internal/ui/preferences/AntClasspathBlock.java;2;1;26;2;3;3;3;23;768;7;8;108;1423;1423;7;15;0;23;26;108;15;309;11;2;1
/org.eclipse.jdt.debug/jdi/org/eclipse/jdi/internal/TypeImpl.java;1;0;1;1;0;0;0;1;156;0;1;235;156;156;1;0;0;1;1;235;0;235;1;1;0
/org.eclipse.search/search/org/eclipse/search/internal/core/text/TypedResourceVisitor.java;1;0;1;1;1;1;1;0;2;0;0;336;2;2;1;0;0;0;1;336;0;336;1;1;0
/org.eclipse.osgi/core/framework/org/eclipse/osgi/framework/internal/core/BundleRepository.java;5;1;12;3;2;2;6;6;139;5;4;171;300;300;5;2;4;10;12;267;6;301;6;5;0
/org.eclipse.swt/Eclipse SWT/motif/org/eclipse/swt/widgets/ColorDialog.java;3;1;5;1;2;2;2;3;16;1;3;19;35;35;1;0;0;3;5;19;0;337;5;3;0
/org.eclipse.core.runtime/src/org/eclipse/core/runtime/QualifiedName.java;2;1;5;2;2;2;2;3;438;0;1;171;448;448;3;2;0;3;5;171;2;336;3;2;0
/org.eclipse.ui.workbench/Eclipse UI/org/eclipse/ui/dialogs/FileEditorMappingContentProvider.java;1;0;1;1;0;0;0;1;1;0;1;0;1;1;1;0;0;1;1;0;0;0;1;1;0
/org.eclipse.pde.core/src/org/eclipse/pde/internal/core/bundle/BundlePluginModelBase.java;1;4;5;1;5;2;5;0;145;0;0;292;155;155;4;0;3;0;5;292;3;336;2;1;0
/org.eclipse.search/search/org/eclipse/search/internal/ui/text/SearchResultUpdater.java;2;1;2;1;2;2;2;0;4;0;0;280;4;4;1;0;0;0;2;280;0;336;2;2;0
/org.eclipse.team.cvs.core/src/org/eclipse/team/internal/ccvs/core/client/AbstractStructureVisitor.java;1;0;3;1;0;0;0;3;33;1;3;73;48;48;1;0;0;3;3;73;0;142;3;1;1
/org.eclipse.jdt.ui/ui/org/eclipse/jdt/internal/ui/text/spelling/engine/PersistentSpellDictionary.java;2;0;2;1;1;1;1;1;2;0;1;219;2;2;1;0;0;1;2;219;0;336;2;2;0
/org.eclipse.pde.build/src/org/eclipse/pde/internal/build/ant/TarFileSet.java;1;2;3;1;3;2;3;0;12;0;0;295;12;12;2;0;1;0;3;323;1;323;2;1;0
/org.eclipse.pde.ui/src/org/eclipse/pde/internal/ui/launcher/JUnitArgumentsTab.java;2;1;11;1;2;2;2;9;199;2;7;89;469;469;2;2;0;9;11;173;2;336;9;2;0
/org.eclipse.team.cvs.ui/src/org/eclipse/team/internal/ccvs/ui/AddToVersionControlDialog.java;1;0;3;1;0;0;0;3;15;1;3;52;18;18;1;0;0;3;3;52;0;138;3;1;0
/org.eclipse.ui.workbench/Eclipse UI/org/eclipse/ui/internal/dialogs/PreferenceImportExportFileSelectionPage.java;4;3;8;2;6;4;6;2;77;1;2;203;187;187;3;0;2;2;8;308;2;336;6;4;1
/org.eclipse.jdt.ui/ui/org/eclipse/jdt/ui/wizards/IClasspathContainerPageExtension.java;1;0;1;1;1;1;1;0;2;0;0;336;2;2;1;0;0;0;1;336;0;336;1;1;0
/org.eclipse.swt/Eclipse SWT PI/win32/org/eclipse/swt/internal/win32/DRAWITEMSTRUCT.java;1;0;1;1;0;0;0;1;2;0;1;166;2;2;1;0;0;1;1;166;0;166;1;1;0
/org.eclipse.update.ui/src/org/eclipse/update/internal/ui/wizards/ISearchProvider.java;2;0;6;2;0;0;0;6;23;2;4;15;30;30;2;2;0;6;6;50;2;267;4;2;0
/org.eclipse.jface/src/org/eclipse/jface/viewers/StructuredSelection.java;1;0;1;1;0;0;0;1;8;0;1;79;8;8;1;0;0;1;1;79;0;79;1;1;0
/org.eclipse.jface.text/projection/org/eclipse/jface/text/source/projection/ProjectionAnnotationModel.java;2;2;7;2;4;3;4;3;130;0;1;265;211;211;3;2;1;3;7;265;3;336;4;2;0
/org.eclipse.ui.workbench/Eclipse UI/org/eclipse/ui/internal/activities/ws/ActivityViewerFilter.java;1;0;1;1;1;1;1;0;0;0;0;312;0;0;1;0;0;0;1;312;0;312;1;1;0
/org.eclipse.jface.text/src/org/eclipse/jface/text/contentassist/ICompletionProposal.java;1;0;2;1;2;1;2;0;61;0;0;336;61;61;2;0;1;0;2;336;1;336;1;1;0
/org.eclipse.ui.workbench/Eclipse UI/org/eclipse/ui/internal/registry/ViewRegistryReader.java;5;1;6;2;2;2;2;4;26;2;3;65;79;79;2;1;0;4;6;250;1;336;5;5;0
/org.eclipse.debug.ui/ui/org/eclipse/debug/internal/ui/views/DebugViewInterimLabelProvider.java;2;0;3;2;0;0;0;3;11;0;1;196;11;11;3;2;0;3;3;196;2;196;1;2;0
/org.eclipse.jdt.launching.macosx/macosx/org/eclipse/jdt/internal/ui/macbundler/BundleWizardPage2.java;1;0;1;1;0;0;0;1;0;0;1;203;0;0;1;0;0;1;1;203;0;203;1;1;0
/org.eclipse.ui.workbench/Eclipse UI/org/eclipse/ui/internal/about/ConfigurationLogDefaultSection.java;1;1;2;1;2;2;2;0;2;0;0;294;2;2;1;0;0;0;2;294;0;336;2;1;0
/org.eclipse.jdt.debug/jdi/org/eclipse/jdi/internal/request/EventRequestManagerImpl.java;3;1;5;1;3;3;3;2;17;1;2;76;31;31;1;0;0;2;5;76;0;336;5;3;0
/org.eclipse.pde.core/src/org/eclipse/pde/internal/core/IEnvironmentVariables.java;2;1;2;1;2;2;2;0;8;0;0;309;12;12;1;0;0;0;2;309;0;336;2;2;0
/org.eclipse.search/search/org/eclipse/search/internal/ui/SearchPlugin.java;2;2;9;1;4;3;4;5;29;2;4;70;77;77;2;1;1;5;9;254;2;336;7;2;0
/org.eclipse.jdt.ui/ui/org/eclipse/jdt/internal/ui/packageview/CollapseAllAction.java;1;0;1;1;1;1;1;0;2;0;0;336;2;2;1;0;0;0;1;336;0;336;1;1;0
/org.eclipse.ui.ide/src/org/eclipse/ui/views/markers/internal/TaskMarker.java;3;1;4;1;2;2;2;2;13;0;1;181;17;17;2;1;0;2;4;181;1;336;3;3;0
/org.eclipse.jdt.core/search/org/eclipse/jdt/internal/core/search/indexing/AddFolderToIndex.java;3;1;12;2;2;2;3;9;65;3;7;60;96;96;3;2;1;10;12;178;3;324;9;3;0
/org.eclipse.jdt.core/compiler/org/eclipse/jdt/internal/compiler/parser/diagnose/LexStream.java;2;0;5;1;0;0;0;5;94;1;5;51;106;106;1;0;0;5;5;51;0;199;5;2;0
/org.eclipse.osgi/core/framework/org/eclipse/osgi/framework/internal/core/BundleSource.java;4;1;4;1;2;2;2;2;28;1;2;171;34;34;1;0;0;2;4;171;0;336;4;4;0
/org.eclipse.pde.ui/src/org/eclipse/pde/internal/ui/wizards/feature/FeatureSelectionDialog.java;2;1;3;1;3;3;3;0;8;0;0;298;12;12;1;0;0;0;3;298;0;336;3;2;0
/org.eclipse.jdt.debug.ui/ui/org/eclipse/jdt/internal/debug/ui/actions/DropToFrameButton.java;1;0;1;1;1;1;1;0;0;0;0;300;0;0;1;0;0;0;1;300;0;300;1;1;0
/org.eclipse.jdt.ui/ui refactoring/org/eclipse/jdt/internal/ui/refactoring/nls/search/NLSSearchResultRequestor.java;2;1;4;1;4;4;4;0;45;0;0;283;55;55;1;0;0;0;4;283;0;336;4;2;0
/org.eclipse.jdt.ui/ui refactoring/org/eclipse/jdt/internal/ui/refactoring/reorg/RenameMethodUserInterfaceStarter.java;2;0;8;1;1;1;2;6;13;3;4;103;30;30;3;2;1;7;8;247;3;336;5;2;0
/org.eclipse.jdt.ui/ui refactoring/org/eclipse/jdt/internal/ui/refactoring/IntroduceFactoryInputPage.java;2;0;8;1;1;1;2;6;124;2;4;162;225;225;2;2;1;7;8;162;3;336;5;2;0
/org.eclipse.jdt.core/model/org/eclipse/jdt/core/eval/ICodeSnippetRequestor.java;2;0;3;1;1;1;1;2;17;1;2;199;23;23;1;0;0;2;3;199;0;312;3;2;0
/org.eclipse.jdt.ui/ui refactoring/org/eclipse/jdt/internal/ui/refactoring/reorg/DeleteUserInterfaceManager.java;1;0;1;1;0;0;0;1;0;0;1;247;0;0;1;0;0;1;1;247;0;247;1;1;0
/org.eclipse.pde.core/src/org/eclipse/pde/core/IModelChangedListener.java;2;1;3;1;3;3;3;0;12;0;0;276;18;18;1;0;0;0;3;276;0;336;3;2;0
/org.eclipse.pde.ui/src/org/eclipse/pde/internal/ui/editor/schema/CompositorPropertySource.java;2;1;2;1;2;2;2;0;4;0;0;308;8;8;1;0;0;0;2;308;0;336;2;2;0
/org.eclipse.jdt.ui/ui refactoring/org/eclipse/jdt/internal/ui/refactoring/reorg/RenameFieldWizard.java;3;1;6;1;2;2;2;4;29;2;3;71;47;47;2;1;0;4;6;251;1;336;5;3;0
/org.eclipse.team.cvs.ui/src/org/eclipse/team/internal/ccvs/ui/model/CVSAdapterFactory.java;1;0;1;1;0;0;0;1;37;0;1;67;37;37;1;0;0;1;1;67;0;67;1;1;0
/org.eclipse.jdt.ui/ui/org/eclipse/jdt/internal/ui/text/correction/ReorgCorrectionsSubProcessor.java;3;1;16;2;4;4;4;12;115;4;6;65;207;207;4;6;0;12;16;65;6;336;10;3;0
/org.eclipse.ant.ui/Ant Editor/org/eclipse/ant/internal/ui/dtd/IModel.java;1;0;1;1;0;0;0;1;0;0;1;108;0;0;1;0;0;1;1;108;0;108;1;1;0
/org.eclipse.jdt.core/model/org/eclipse/jdt/internal/core/SourceFieldElementInfo.java;1;0;2;1;0;0;0;2;2;1;2;121;4;4;1;0;0;2;2;121;0;199;2;1;1
/org.eclipse.pde.ui/src/org/eclipse/pde/internal/ui/wizards/imports/PluginImportOperation.java;2;2;17;2;4;3;4;13;827;4;9;26;1216;1216;4;4;1;13;17;170;5;336;12;2;0
/org.eclipse.jface.text/src/org/eclipse/jface/text/IFindReplaceTargetExtension3.java;2;0;3;2;2;1;2;1;38;0;1;125;38;38;2;0;1;1;3;336;1;336;2;2;0
/org.eclipse.text/src/org/eclipse/jface/text/link/InclusivePositionUpdater.java;3;2;6;2;4;3;4;2;14;1;2;232;31;31;2;0;1;2;6;334;1;334;5;3;0
/org.eclipse.jdt.core/compiler/org/eclipse/jdt/internal/compiler/parser/Scanner.java;6;4;38;4;6;3;6;32;1572;7;12;1;2582;2582;7;20;3;32;38;51;23;327;15;6;7
/org.eclipse.jdt.core/compiler/org/eclipse/jdt/internal/compiler/util/CompoundNameVector.java;1;0;1;1;0;0;0;1;2;0;1;199;2;2;1;0;0;1;1;199;0;199;1;1;0
/org.eclipse.ui.workbench/Eclipse UI/org/eclipse/ui/keys/SpecialKey.java;3;1;15;2;2;2;2;13;557;5;5;79;1174;1174;5;8;0;13;15;158;8;336;7;3;0
/org.eclipse.jdt.core/search/org/eclipse/jdt/internal/core/search/matching/MatchLocatorParser.java;6;1;23;2;2;2;2;21;240;5;12;5;669;669;5;9;0;21;23;118;9;326;14;6;3
/org.eclipse.pde.ui/src/org/eclipse/pde/internal/ui/editor/site/FeaturesPage.java;2;2;5;1;4;3;4;1;59;0;1;208;89;89;2;0;1;1;5;303;1;336;4;2;0
/org.eclipse.update.core/src/org/eclipse/update/operations/IOperationValidator.java;1;2;7;1;3;2;3;4;22;1;4;54;54;54;2;0;1;4;7;292;1;336;6;1;0
/org.eclipse.swt/Eclipse SWT/motif/org/eclipse/swt/widgets/Label.java;5;0;11;2;1;1;1;10;61;2;9;19;192;192;2;1;0;10;11;261;1;337;10;5;1
/org.eclipse.pde.core/src/org/eclipse/pde/internal/core/feature/FeatureImport.java;2;1;3;1;2;2;2;1;36;0;1;232;53;53;1;0;0;1;3;232;0;336;3;2;0
/org.eclipse.pde.core/src/org/eclipse/pde/internal/core/PluginModelDelta.java;1;0;2;1;1;1;1;1;6;0;1;232;8;8;1;0;0;1;2;232;0;336;2;1;0
/org.eclipse.debug.core/core/org/eclipse/debug/internal/core/sourcelookup/containers/FolderSourceContainerType.java;2;0;3;2;1;1;1;2;20;1;2;205;26;26;1;0;0;2;3;205;0;303;3;2;0
/org.eclipse.jface.text/src/org/eclipse/jface/text/source/IVerticalRulerListener.java;2;2;3;2;3;2;3;0;13;0;0;279;17;17;2;0;1;0;3;336;1;336;2;2;0
/org.eclipse.swt/Eclipse SWT/win32/org/eclipse/swt/graphics/Device.java;4;3;9;2;5;3;5;4;50;1;4;61;151;151;3;0;2;4;9;299;2;337;7;4;1
/org.eclipse.swt/Eclipse SWT Browser/common/org/eclipse/swt/browser/VisibilityWindowListener.java;2;0;4;1;1;1;1;3;50;1;3;179;73;73;1;0;0;3;4;179;0;337;4;2;0
/org.eclipse.jdt.ui/ui/org/eclipse/jdt/ui/actions/IJavaEditorActionDefinitionIds.java;7;2;21;2;3;2;3;18;54;6;11;18;200;200;6;7;1;18;21;93;8;334;13;7;0
/org.eclipse.jdt.core/model/org/eclipse/jdt/internal/core/RenameResourceElementsOperation.java;2;0;3;2;0;0;0;3;4;1;3;127;7;7;1;0;0;3;3;127;0;199;3;2;0
/org.eclipse.tomcat/src/org/eclipse/tomcat/internal/EclipseErrorReportValve.java;2;0;4;1;1;1;1;3;506;1;3;34;516;516;1;0;0;3;4;34;0;336;4;2;0
/org.eclipse.jdt.ui/ui/org/eclipse/jdt/internal/ui/text/java/JavaTextMessages.java;2;1;2;1;2;2;2;0;10;0;0;295;12;12;1;0;0;0;2;295;0;336;2;2;0
/org.eclipse.pde.ui/src/org/eclipse/pde/internal/ui/wizards/exports/BaseExportWizard.java;2;2;14;1;5;4;5;9;317;2;8;7;797;797;2;1;1;9;14;70;2;336;12;2;0
/org.eclipse.help.base/src/org/eclipse/help/internal/standalone/EclipseLifeCycleListener.java;1;1;3;1;2;2;2;1;6;0;1;112;8;8;1;0;0;1;3;112;0;336;3;1;0
/org.eclipse.ui.ide/src/org/eclipse/ui/views/properties/FilePropertySource.java;1;0;1;1;0;0;0;1;0;0;1;129;0;0;1;0;0;1;1;129;0;129;1;1;0
/org.eclipse.ui.workbench/Eclipse UI/org/eclipse/ui/dialogs/SelectionDialog.java;2;1;3;1;2;2;2;1;339;0;1;20;345;345;1;0;0;1;3;20;0;336;3;2;0
/org.eclipse.jdt.core/search/org/eclipse/jdt/internal/core/search/matching/SuperTypeReferenceLocator.java;4;0;7;2;1;1;1;6;63;3;4;118;77;77;3;2;0;6;7;118;2;280;5;4;0
/org.eclipse.swt/Eclipse SWT PI/gtk/org/eclipse/swt/internal/accessibility/gtk/GTypeQuery.java;4;0;5;1;1;1;1;4;11;2;3;75;17;17;2;1;0;4;5;226;1;337;4;4;0
/org.eclipse.help/src/org/eclipse/help/internal/HelpResources.java;1;1;7;1;3;3;3;4;98;2;3;106;135;135;2;1;0;4;7;156;1;336;6;1;0
/org.eclipse.swt/Eclipse SWT PI/motif/org/eclipse/swt/internal/motif/XImage.java;1;0;1;1;0;0;0;1;19;0;1;54;19;19;1;0;0;1;1;54;0;54;1;1;0
/org.eclipse.ui.workbench/Eclipse UI/org/eclipse/ui/activities/IActivityManager.java;5;1;19;3;2;2;2;17;422;12;4;131;453;453;12;13;0;17;19;156;13;336;6;5;0
/org.eclipse.pde.ui/src/org/eclipse/pde/internal/ui/launcher/RuntimeWorkbenchShortcut.java;2;1;11;1;3;3;3;8;41;2;6;41;98;98;2;2;0;8;11;41;2;336;9;2;0
/org.eclipse.jdt.core/search/org/eclipse/jdt/internal/core/search/matching/SuperTypeReferencePattern.java;3;2;17;2;3;2;3;14;334;3;10;52;1260;1260;3;4;1;14;17;191;5;300;12;3;0
/org.eclipse.jface/src/org/eclipse/jface/preference/StringFieldEditor.java;2;1;4;1;2;2;2;2;20;0;1;86;23;23;2;1;0;2;4;86;1;336;3;2;0
/org.eclipse.jdt.launching/launching/org/eclipse/jdt/internal/launching/JRERuntimeClasspathEntryResolver.java;4;1;6;2;2;2;2;4;51;2;3;144;120;120;2;1;0;4;6;144;1;336;5;4;0
/org.eclipse.swt/Eclipse SWT Custom Widgets/common/org/eclipse/swt/custom/DisplayRenderer.java;5;0;9;2;1;1;1;8;369;2;5;35;531;531;2;3;0;8;9;35;3;337;6;5;0
/org.eclipse.jdt.ui/core refactoring/org/eclipse/jdt/internal/corext/refactoring/reorg/DeleteChangeCreator.java;5;2;19;3;3;2;3;16;31;3;8;70;132;132;3;8;1;16;19;70;9;336;10;5;0
/org.eclipse.jdt.core/compiler/org/eclipse/jdt/internal/compiler/ast/JavadocSingleNameReference.java;3;0;5;2;1;1;1;4;21;2;3;165;39;39;2;1;0;4;5;165;1;300;4;3;1
/org.eclipse.jdt.ui/ui refactoring/org/eclipse/jdt/internal/ui/refactoring/contentassist/JavaPackageFragmentRootCompletionProcessor.java;4;2;5;2;4;3;4;1;23;0;1;243;43;43;2;0;1;1;5;279;1;336;4;4;0
/org.eclipse.team.ui/src/org/eclipse/team/internal/ui/synchronize/PartNavigator.java;1;0;1;1;1;1;1;0;0;0;0;292;0;0;1;0;0;0;1;292;0;292;1;1;0
/org.eclipse.ltk.ui.refactoring/src/org/eclipse/ltk/internal/ui/refactoring/FileStatusContextViewer.java;1;1;5;1;2;2;4;1;36;0;1;269;50;50;3;0;2;3;5;269;2;336;3;1;0
/org.eclipse.jdt.core/codeassist/org/eclipse/jdt/internal/codeassist/complete/CompletionOnExplicitConstructorCall.java;2;0;2;1;0;0;0;2;77;1;2;63;79;79;1;0;0;2;2;63;0;199;2;2;0
/org.eclipse.jdt.core/dom/org/eclipse/jdt/core/dom/EnhancedForStatement.java;4;0;12;2;0;0;4;8;504;6;5;163;580;580;6;3;4;12;12;266;7;266;5;4;2
/org.eclipse.compare/compare/org/eclipse/compare/internal/patch/LineReader.java;1;0;2;1;0;0;0;2;2;1;2;79;4;4;1;0;0;2;2;79;0;219;2;1;0
/org.eclipse.ui.ide/src/org/eclipse/ui/internal/ide/model/StandardPropertiesAdapterFactory.java;1;0;1;1;0;0;0;1;0;0;1;132;0;0;1;0;0;1;1;132;0;132;1;1;0
/org.eclipse.ui.workbench/Eclipse UI/org/eclipse/ui/internal/PartPane.java;7;9;37;4;13;4;13;24;365;12;5;57;921;921;12;19;9;24;37;223;28;336;9;7;8
/org.eclipse.help.base/src/org/eclipse/help/internal/base/HelpDisplay.java;1;2;14;1;5;4;5;9;153;4;4;106;451;451;4;5;1;9;14;106;6;336;8;1;0
/org.eclipse.debug.ui/ui/org/eclipse/debug/internal/ui/views/console/ConsoleTerminateAction.java;1;0;1;1;0;0;0;1;0;0;1;86;0;0;1;0;0;1;1;86;0;86;1;1;0
/org.eclipse.swt/Eclipse SWT/photon/org/eclipse/swt/graphics/GC.java;3;1;15;1;4;4;4;11;87;2;8;24;284;284;2;3;0;11;15;53;3;337;12;3;1
/org.eclipse.jdt.ui/ui/org/eclipse/jdt/internal/ui/wizards/buildpaths/CPListElementSorter.java;2;1;2;1;2;2;2;0;11;0;0;271;13;13;1;0;0;0;2;271;0;336;2;2;0
/org.eclipse.core.resources/src/org/eclipse/core/internal/indexing/Reservation.java;1;0;1;1;1;1;1;0;31;0;0;277;31;31;1;0;0;0;1;277;0;277;1;1;0
/org.eclipse.jdt.core/model/org/eclipse/jdt/core/IClasspathContainer.java;3;1;4;1;2;2;2;2;29;1;2;149;46;46;1;0;0;2;4;149;0;312;4;3;0
/org.eclipse.debug.ui/ui/org/eclipse/debug/internal/ui/views/variables/VariablesViewEventHandler.java;2;0;4;2;0;0;0;4;7;3;2;118;9;9;3;2;0;4;4;240;2;240;2;2;0
/org.eclipse.jdt.launching/launching/org/eclipse/jdt/internal/launching/ClasspathContainerSourceContainerTypeDelegate.java;2;0;5;2;2;1;2;3;18;2;2;230;25;25;2;1;1;3;5;268;2;296;3;2;0
/org.eclipse.ui.workbench/Eclipse UI/org/eclipse/ui/internal/keys/NativeKeyFormatter.java;1;0;2;1;0;0;0;2;42;0;1;187;42;42;2;1;0;2;2;187;1;187;1;1;0
/org.eclipse.update.core/src/org/eclipse/update/internal/model/SiteLocalModel.java;2;1;10;1;4;4;4;6;69;2;5;58;111;111;2;1;0;6;10;250;1;336;9;2;0
/org.eclipse.swt/Eclipse SWT PI/photon/org/eclipse/swt/internal/photon/PhCursorInfo_t.java;1;0;2;1;0;0;0;2;15;0;1;53;15;15;2;1;0;2;2;53;1;53;1;1;0
/org.eclipse.jdt.core/search/org/eclipse/jdt/internal/core/search/matching/AndPattern.java;3;0;15;2;2;1;2;13;129;3;9;50;314;314;3;4;1;13;15;191;5;280;10;3;0
/org.eclipse.jdt.ui/ui/org/eclipse/jdt/internal/ui/javaeditor/JavaTextSelection.java;4;0;4;1;1;1;1;3;12;1;3;183;16;16;1;0;0;3;4;183;0;336;4;4;1
/org.eclipse.ui.workbench/Eclipse UI/org/eclipse/ui/internal/util/StatusLineContributionItem.java;5;0;8;2;1;1;1;7;49;2;5;104;132;132;2;2;0;7;8;124;2;336;6;5;0
/org.eclipse.ui.intro/src/org/eclipse/ui/internal/intro/impl/model/IntroHead.java;1;0;4;1;4;1;4;0;13;0;0;276;13;13;4;0;3;0;4;276;3;276;1;1;0
/org.eclipse.ant.ui/Ant Editor/org/eclipse/ant/internal/ui/editor/text/NotifyingReconciler.java;1;0;3;1;1;1;1;2;7;1;2;108;11;11;1;0;0;2;3;108;0;336;3;1;1
/org.eclipse.update.core/src/org/eclipse/update/operations/OperationsManager.java;1;2;9;1;3;2;3;6;75;2;5;54;173;173;2;1;1;6;9;75;2;336;7;1;1
/org.eclipse.search/search/org/eclipse/search/internal/ui/text/ReplaceAction.java;2;0;5;1;1;1;1;4;285;2;3;165;315;315;2;1;0;4;5;165;1;336;4;2;0
/org.eclipse.jdt.debug/eval/org/eclipse/jdt/internal/debug/eval/ast/engine/InterpreterVariable.java;1;0;1;1;0;0;0;1;26;0;1;144;26;26;1;0;0;1;1;144;0;144;1;1;1
/org.eclipse.jdt.ui/ui/org/eclipse/jdt/internal/ui/search/OccurrencesSearchResultPage.java;2;0;4;1;2;1;2;2;14;0;1;266;18;18;2;1;1;2;4;266;2;290;2;2;0
/org.eclipse.jdt.debug/eval/org/eclipse/jdt/internal/debug/eval/ast/engine/JavaObjectRuntimeContext.java;1;0;1;1;0;0;0;1;6;0;1;144;6;6;1;0;0;1;1;144;0;144;1;1;0
/org.eclipse.jdt.ui/core refactoring/org/eclipse/jdt/internal/corext/refactoring/reorg/ICreateTargetQuery.java;1;0;2;1;2;1;2;0;6;0;0;313;6;6;2;0;1;0;2;313;1;313;1;1;0
/org.eclipse.ui.console/src/org/eclipse/ui/internal/console/ConsoleMessages.java;1;0;1;1;0;0;0;1;0;0;1;118;0;0;1;0;0;1;1;118;0;118;1;1;0
/org.eclipse.compare/compare/org/eclipse/compare/contentmergeviewer/IMergeViewerContentProvider.java;1;0;1;1;0;0;0;1;2;0;1;219;2;2;1;0;0;1;1;219;0;219;1;1;0
/org.eclipse.debug.ui/ui/org/eclipse/debug/ui/actions/ILaunchable.java;1;0;1;1;1;1;1;0;0;0;0;295;0;0;1;0;0;0;1;295;0;295;1;1;0
/org.eclipse.swt/Eclipse SWT PI/win32/org/eclipse/swt/internal/win32/NMREBARCHEVRON.java;1;0;1;1;0;0;0;1;11;0;1;166;11;11;1;0;0;1;1;166;0;166;1;1;0
/org.eclipse.search/search/org/eclipse/search/internal/ui/text/SearchAgainConfirmationDialog.java;2;0;4;1;1;1;1;3;16;1;3;166;34;34;1;0;0;3;4;166;0;336;4;2;0
/org.eclipse.swt/Eclipse SWT/win32/org/eclipse/swt/widgets/Caret.java;3;1;5;1;2;2;2;3;17;1;3;19;36;36;1;0;0;3;5;19;0;337;5;3;1
/org.eclipse.swt/Eclipse SWT PI/carbon/org/eclipse/swt/internal/carbon/CFRange.java;1;0;2;1;2;1;2;0;20;0;0;296;20;20;2;0;1;0;2;296;1;296;1;1;0
/org.eclipse.swt/Eclipse SWT Drag and Drop/win32/org/eclipse/swt/dnd/Transfer.java;1;0;1;1;0;0;0;1;8;0;1;22;8;8;1;0;0;1;1;22;0;22;1;1;0
/org.eclipse.swt/Eclipse SWT PI/motif/org/eclipse/swt/internal/motif/XFocusChangeEvent.java;1;0;2;1;0;0;0;2;12;0;1;54;12;12;2;1;0;2;2;54;1;54;1;1;0
/org.eclipse.jdt.junit/src/org/eclipse/jdt/internal/junit/ui/TestRunInfo.java;2;0;3;1;1;1;1;2;29;1;2;35;57;57;1;0;0;2;3;35;0;336;3;2;0
/org.eclipse.debug.ui/ui/org/eclipse/debug/internal/ui/launchConfigurations/LaunchGroupFilter.java;2;0;1;2;1;1;1;0;10;0;0;280;10;10;1;0;0;0;1;280;0;280;1;2;0
/org.eclipse.core.resources/src/org/eclipse/core/internal/properties/PropertyManager.java;2;0;5;1;1;1;1;4;360;2;3;7;431;431;2;1;0;4;5;176;1;277;4;2;0
/org.eclipse.jdt.ui/ui/org/eclipse/jdt/internal/ui/text/JavaIndenter.java;3;1;20;2;2;2;2;18;1788;5;7;117;2462;2462;5;11;0;18;20;165;11;336;9;3;1
/org.eclipse.ui.workbench/Eclipse UI/org/eclipse/ui/IPerspectiveListener.java;1;0;1;1;0;0;0;1;4;0;1;0;4;4;1;0;0;1;1;0;0;0;1;1;1
/org.eclipse.osgi/defaultAdaptor/src/org/eclipse/osgi/framework/internal/defaultadaptor/DefaultAdaptor.java;6;2;26;4;4;3;8;18;589;5;5;171;1504;1504;5;13;5;22;26;201;18;324;8;6;1
/org.eclipse.jdt.ui/ui/org/eclipse/jdt/ui/search/QuerySpecification.java;3;2;4;2;4;2;4;0;16;0;0;290;20;20;2;0;2;0;4;290;2;335;2;3;0
/org.eclipse.ui.editors/src/org/eclipse/ui/editors/text/templates/ContributionContextTypeRegistry.java;2;1;2;1;2;2;2;0;14;0;0;288;14;14;1;0;0;0;2;288;0;336;2;2;0
/org.eclipse.osgi/eclipseAdaptor/src/org/eclipse/core/runtime/adaptor/Locker.java;2;1;3;1;2;2;2;1;3;0;1;264;4;4;1;0;0;1;3;264;0;326;3;2;0
/org.eclipse.ui.workbench.texteditor/src/org/eclipse/ui/texteditor/quickdiff/QuickDiffToggleAction.java;2;1;4;1;3;3;3;1;6;0;1;100;15;15;1;0;0;1;4;100;0;336;4;2;0
/org.eclipse.core.runtime/src/org/eclipse/core/internal/content/XMLRootHandler.java;1;2;6;1;6;4;6;0;72;0;0;280;157;157;2;0;2;0;6;280;2;320;4;1;1
/org.eclipse.jdt.core/search/org/eclipse/jdt/internal/core/search/matching/ClasspathSourceDirectory.java;3;0;5;1;0;0;0;5;31;2;4;109;37;37;2;1;0;5;5;258;1;258;4;3;0
/org.eclipse.ui.workbench.texteditor/src/org/eclipse/ui/texteditor/IFindReplaceTargetExtension2.java;2;0;1;2;1;1;1;0;8;0;0;336;8;8;1;0;0;0;1;336;0;336;1;2;0
/org.eclipse.ltk.ui.refactoring/src/org/eclipse/ltk/internal/ui/refactoring/RefactoringWizardDialog.java;1;2;5;1;5;4;5;0;12;0;0;273;21;21;2;0;1;0;5;273;1;336;4;1;0
/org.eclipse.update.core/src/org/eclipse/update/core/IVerificationResult.java;2;1;3;1;2;2;2;1;6;0;1;0;11;11;1;0;0;1;3;0;0;336;3;2;0
/org.eclipse.jdt.core/dom/org/eclipse/jdt/internal/core/dom/rewrite/ASTRewriteAnalyzer.java;2;2;5;1;3;2;3;2;380;0;1;262;401;401;2;1;1;2;5;262;2;290;3;2;2
/org.eclipse.jdt.core/model/org/eclipse/jdt/core/IInitializer.java;1;0;2;1;0;0;0;2;2;1;2;107;3;3;1;0;0;2;2;107;0;199;2;1;0
/org.eclipse.jdt.core/compiler/org/eclipse/jdt/internal/compiler/impl/IntConstant.java;2;0;3;1;1;1;1;2;8;1;2;70;16;16;1;0;0;2;3;70;0;299;3;2;0
/org.eclipse.team.ui/src/org/eclipse/team/internal/ui/synchronize/ReferenceCounter.java;1;0;3;1;1;1;1;2;140;0;1;262;142;142;2;1;0;2;3;262;1;336;2;1;0
/org.eclipse.jdt.ui/ui/org/eclipse/jdt/internal/ui/wizards/buildpaths/ArchiveFileFilter.java;2;1;2;1;2;2;2;0;9;0;0;276;11;11;1;0;0;0;2;276;0;336;2;2;0
/org.eclipse.jdt.ui/ui/org/eclipse/jdt/internal/ui/text/correction/JavaCorrectionAssistant.java;2;1;8;1;3;3;3;5;110;4;2;62;156;156;4;3;0;5;8;62;3;336;5;2;0
/org.eclipse.jdt.debug.ui/ui/org/eclipse/jdt/internal/debug/ui/classpath/VariableClasspathEntryAdapterFactory.java;1;0;1;1;0;0;0;1;0;0;1;269;0;0;1;0;0;1;1;269;0;269;1;1;0
/org.eclipse.ui.ide/src/org/eclipse/ui/internal/ide/dialogs/RemoveCapabilityStep.java;1;0;1;1;0;0;0;1;0;0;1;132;0;0;1;0;0;1;1;132;0;132;1;1;0
/org.eclipse.core.resources/src/org/eclipse/core/internal/properties/TestingSupport.java;1;0;1;1;1;1;1;0;26;0;0;277;26;26;1;0;0;0;1;277;0;277;1;1;0
/org.eclipse.help.base/src/org/eclipse/help/internal/browser/CustomBrowserFactory.java;1;1;3;1;2;2;2;1;6;0;1;104;12;12;1;0;0;1;3;104;0;336;3;1;0
/org.eclipse.jdt.ui/core extension/org/eclipse/jdt/internal/corext/callhierarchy/JavaImplementorFinder.java;2;0;3;1;1;1;1;2;5;0;1;12;7;7;2;1;0;2;3;12;1;336;2;2;0
/org.eclipse.ant.ui/Ant Editor/org/eclipse/ant/internal/ui/editor/formatter/XmlDocumentFormatter.java;1;2;7;1;6;4;6;1;348;0;1;251;551;551;2;0;2;1;7;275;2;313;5;1;1
/org.eclipse.team.core/src/org/eclipse/team/core/subscribers/ISubscriberChangeEvent.java;2;2;5;1;3;2;3;2;39;1;2;220;83;83;2;0;1;2;5;335;1;335;4;2;0
/org.eclipse.osgi/core/framework/org/eclipse/osgi/framework/internal/core/SystemBundle.java;4;4;11;3;7;4;7;4;499;2;3;171;604;604;4;1;3;4;11;271;4;336;7;4;0
/org.eclipse.jdt.core/formatter/org/eclipse/jdt/core/formatter/DefaultCodeFormatterConstants.java;3;2;27;3;4;3;4;23;3096;9;5;128;4414;4414;9;18;1;23;27;193;19;323;8;3;2
/org.eclipse.help.base/src/org/eclipse/help/standalone/Infocenter.java;1;2;4;1;3;2;3;1;124;0;1;104;145;145;2;0;1;1;4;330;1;330;3;1;0
/org.eclipse.team.cvs.ui/src/org/eclipse/team/internal/ccvs/ui/operations/OverrideAndUpdateOperation.java;2;2;5;1;3;2;3;2;12;1;2;176;22;22;2;0;1;2;5;315;1;336;4;2;0
/org.eclipse.debug.core/core/org/eclipse/debug/core/model/IDebugModelProvider.java;2;0;3;2;1;1;1;2;18;0;1;220;21;21;2;1;0;2;3;220;1;275;2;2;0
/org.eclipse.help.ide/src/org/eclipse/help/ui/internal/search/SorterByScore.java;1;1;2;1;2;2;2;0;2;0;0;281;2;2;1;0;0;0;2;281;0;311;2;1;0
/org.eclipse.ui.workbench/Eclipse UI/org/eclipse/ui/internal/activities/ActivityRequirementBinding.java;2;1;2;1;2;2;2;0;2;0;0;307;2;2;1;0;0;0;2;307;0;336;2;2;0
/org.eclipse.swt/Eclipse SWT/common/org/eclipse/swt/internal/image/LEDataOutputStream.java;1;0;1;1;0;0;0;1;12;0;1;9;12;12;1;0;0;1;1;9;0;9;1;1;0
/org.eclipse.jdt.core/model/org/eclipse/jdt/core/IBufferChangedListener.java;1;0;1;1;0;0;0;1;2;0;1;199;2;2;1;0;0;1;1;199;0;199;1;1;0
/org.eclipse.debug.ui/ui/org/eclipse/debug/internal/ui/launchConfigurations/LaunchConfigurationsDialog.java;5;0;26;4;6;1;6;20;350;6;9;22;784;784;6;11;5;20;26;100;16;276;10;5;1
/org.eclipse.jdt.ui/core refactoring/org/eclipse/jdt/internal/corext/refactoring/code/flow/ThrowFlowInfo.java;1;0;1;1;1;1;1;0;2;0;0;336;2;2;1;0;0;0;1;336;0;336;1;1;0
/org.eclipse.osgi/eclipseAdaptor/src/org/eclipse/core/runtime/adaptor/PluginConverterImpl.java;7;13;48;5;17;3;17;31;877;19;4;177;1655;1655;19;27;14;31;48;226;41;323;7;7;2
/org.eclipse.team.core/src/org/eclipse/team/core/variants/IResourceVariantComparator.java;2;1;3;1;2;2;2;1;2;0;1;239;4;4;1;0;0;1;3;239;0;336;3;2;0
/org.eclipse.swt/Eclipse SWT/gtk/org/eclipse/swt/widgets/TableItem.java;7;2;26;3;5;4;5;21;243;6;8;19;672;672;6;13;1;21;26;103;14;337;12;7;2
/org.eclipse.swt/Eclipse SWT/win32/org/eclipse/swt/widgets/Tracker.java;5;1;19;3;2;2;2;17;450;3;10;8;691;691;3;7;0;17;19;8;7;337;12;5;0
/org.eclipse.osgi/osgi/src/org/osgi/framework/BundleException.java;3;3;5;1;4;2;4;1;74;0;1;171;104;104;3;0;2;1;5;296;2;296;3;3;0
/org.eclipse.team.ui/src/org/eclipse/team/internal/ui/wizards/ConfigureProjectWizard.java;2;4;10;2;6;3;6;4;236;2;3;63;327;327;4;1;3;4;10;295;4;336;6;2;1
/org.eclipse.ui.workbench/Eclipse UI/org/eclipse/ui/model/IWorkbenchAdapter2.java;1;0;2;1;0;0;0;2;14;0;1;226;14;14;2;1;0;2;2;226;1;226;1;1;0
/org.eclipse.swt.tools/JNI Generation/org/eclipse/swt/tools/internal/MetaData.java;2;0;2;2;0;0;0;2;3;0;1;230;3;3;2;1;0;2;2;230;1;230;1;2;0
/org.eclipse.ui.intro/src/org/eclipse/ui/internal/intro/impl/model/IntroPartPresentation.java;2;7;14;2;14;3;14;0;228;0;0;276;451;451;7;0;11;0;14;304;11;327;3;2;0
/org.eclipse.ui.workbench/Eclipse UI/org/eclipse/ui/internal/themes/WorkbenchThemeManager.java;2;1;13;1;3;3;4;9;408;6;3;206;505;505;6;6;1;10;13;233;7;308;6;2;0
/org.eclipse.jdt.ui/ui/org/eclipse/jdt/internal/ui/callhierarchy/OpenCallHierarchyAction.java;4;1;6;1;2;2;2;4;36;1;4;18;71;71;1;0;0;4;6;18;0;336;6;4;0
/org.eclipse.ui.workbench/Eclipse UI/org/eclipse/ui/actions/OpenPerspectiveMenu.java;2;2;3;1;3;2;3;0;26;0;0;287;28;28;2;0;1;0;3;287;1;336;2;2;0
/org.eclipse.jdt.junit/src/org/eclipse/jdt/internal/junit/ui/CounterPanel.java;2;1;4;1;2;2;2;2;8;1;2;71;16;16;1;0;0;2;4;71;0;336;4;2;0
/org.eclipse.jdt.debug/model/org/eclipse/jdt/internal/debug/core/model/JDIModificationVariable.java;3;0;5;2;2;1;2;3;46;1;3;26;67;67;2;0;1;3;5;301;1;301;4;3;0
/org.eclipse.jdt.core/model/org/eclipse/jdt/internal/core/jdom/DOMBuilder.java;2;0;6;1;1;1;1;5;23;1;5;7;37;37;1;0;0;5;6;7;0;299;6;2;1
/org.eclipse.team.cvs.core/src/org/eclipse/team/internal/ccvs/core/IResourceStateChangeListener.java;1;0;1;1;0;0;0;1;11;0;1;128;11;11;1;0;0;1;1;128;0;128;1;1;0
/org.eclipse.team.cvs.ssh2/src/org/eclipse/team/internal/ccvs/ssh2/Policy.java;2;1;3;1;2;2;2;1;9;0;1;263;11;11;1;0;0;1;3;263;0;336;3;2;0
/org.eclipse.jdt.ui/ui/org/eclipse/jdt/internal/ui/actions/ActionUtil.java;3;1;4;1;4;4;4;0;11;0;0;273;23;23;1;0;0;0;4;273;0;336;4;3;0
/org.eclipse.jdt.ui/core refactoring/org/eclipse/jdt/internal/corext/refactoring/surround/SurroundWithTryCatchAnalyzer.java;2;0;3;1;1;1;1;2;21;1;2;57;31;31;1;0;0;2;3;57;0;336;3;2;0
/org.eclipse.jdt.debug.ui/ui/org/eclipse/jdt/internal/debug/ui/snippeteditor/SelectImportsDialog.java;4;2;5;2;5;3;5;0;29;0;0;274;54;54;2;0;2;0;5;292;2;306;3;4;0
/org.eclipse.ui.workbench/Eclipse UI/org/eclipse/ui/internal/actions/HelpContentsAction.java;1;0;1;1;1;1;1;0;15;0;0;309;15;15;1;0;0;0;1;309;0;309;1;1;0
/org.eclipse.jdt.ui/core refactoring/org/eclipse/jdt/internal/corext/refactoring/code/ExtractConstantRefactoring.java;6;5;35;3;10;4;10;25;76;4;13;4;358;358;5;12;6;25;35;286;18;336;17;6;0
/org.eclipse.help.base/src/org/eclipse/help/internal/search/SearchResults.java;1;1;9;1;3;3;3;6;48;4;2;104;103;103;4;4;0;6;9;197;4;336;5;1;1
/org.eclipse.jdt.core/search/org/eclipse/jdt/internal/core/search/SubTypeSearchJob.java;3;0;6;1;0;0;0;6;91;1;6;113;138;138;1;0;0;6;6;113;0;225;6;3;0
/org.eclipse.debug.ui/ui/org/eclipse/debug/internal/ui/launchConfigurations/LaunchConfigurationManager.java;4;2;16;2;4;3;4;12;61;4;7;62;231;231;4;5;1;12;16;171;6;336;10;4;2
/org.eclipse.jdt.ui/ui/org/eclipse/jdt/internal/ui/search/SearchResultUpdater.java;2;1;9;1;4;4;4;5;163;2;4;196;207;207;2;1;0;5;9;207;1;336;8;2;0
/org.eclipse.help/src/org/eclipse/help/internal/context/PluginContexts.java;1;1;3;1;2;2;2;1;6;0;1;266;7;7;1;0;0;1;3;266;0;336;3;1;0
/org.eclipse.pde.ui/src/org/eclipse/pde/internal/ui/view/CopyToClipboardAction.java;2;1;2;1;2;2;2;0;6;0;0;308;8;8;1;0;0;0;2;308;0;336;2;2;0
/org.eclipse.team.cvs.ui/src/org/eclipse/team/internal/ccvs/ui/CVSUIPlugin.java;2;4;41;2;7;3;8;33;161;5;13;56;484;484;5;20;5;34;41;56;25;329;16;2;5
/org.eclipse.ui.ide/extensions/org/eclipse/ui/actions/NewExampleAction.java;3;0;4;1;1;1;1;3;8;1;3;132;16;16;1;0;0;3;4;132;0;336;4;3;1
/org.eclipse.pde.core/src/org/eclipse/pde/internal/core/plugin/AbstractPluginModelBase.java;3;2;19;2;4;3;4;15;100;7;6;128;276;276;7;9;1;15;19;166;10;336;9;3;0
/org.eclipse.jdt.core/model/org/eclipse/jdt/core/ICodeCompletionRequestor.java;1;0;3;1;0;0;0;3;16;1;3;149;20;20;1;0;0;3;3;149;0;264;3;1;0
/org.eclipse.jdt.core/compiler/org/eclipse/jdt/internal/compiler/env/IConstants.java;2;0;3;1;0;0;0;3;11;1;3;7;15;15;1;0;0;3;3;7;0;223;3;2;0
/org.eclipse.jdt.core/codeassist/org/eclipse/jdt/internal/codeassist/complete/CompletionOnMethodReturnType.java;2;0;2;1;0;0;0;2;4;1;2;63;6;6;1;0;0;2;2;63;0;199;2;2;0
/org.eclipse.osgi/resolver/src/org/eclipse/core/internal/dependencies/AssertionFailedException.java;3;2;4;2;3;2;3;1;23;0;1;171;24;24;2;0;1;1;4;276;1;296;3;3;0
/org.eclipse.team.ui/src/org/eclipse/team/internal/ui/actions/ConfigureProjectAction.java;1;1;5;1;2;2;2;3;13;1;3;63;29;29;1;0;0;3;5;63;0;336;5;1;0
/org.eclipse.jdt.ui/ui/org/eclipse/jdt/internal/ui/browsing/TypesView.java;1;0;3;1;1;1;1;2;31;1;2;44;47;47;1;0;0;2;3;44;0;336;3;1;0
/org.eclipse.jdt.junit/src/org/eclipse/jdt/internal/junit/wizards/MethodStubsSelectionButtonGroup.java;2;1;4;1;3;3;3;1;13;0;1;206;27;27;1;0;0;1;4;206;0;336;4;2;0
/org.eclipse.swt/Eclipse SWT PI/motif/org/eclipse/swt/internal/motif/XSetWindowAttributes.java;1;0;1;1;0;0;0;1;30;0;1;54;30;30;1;0;0;1;1;54;0;54;1;1;0
/org.eclipse.jdt.core/compiler/org/eclipse/jdt/internal/compiler/lookup/TypeConstants.java;2;0;3;1;1;1;1;2;3;1;2;199;6;6;1;0;0;2;3;199;0;312;3;2;0
/org.eclipse.ui.intro/src/org/eclipse/ui/internal/intro/impl/model/IntroStandbyContentPart.java;1;1;2;1;2;2;2;0;2;0;0;287;2;2;1;0;0;0;2;287;0;296;2;1;0
/org.eclipse.core.resources/src/org/eclipse/core/internal/properties/PropertyStore.java;2;0;2;1;1;1;1;1;840;0;1;176;854;854;1;0;0;1;2;176;0;277;2;2;0
/org.eclipse.ui.editors/src/org/eclipse/ui/internal/editors/text/NextPreviousPulldownActionDelegate.java;2;1;4;1;2;2;2;2;189;1;2;123;196;196;1;0;0;2;4;123;0;336;4;2;0
/org.eclipse.jdt.ui/ui/org/eclipse/jdt/internal/ui/text/java/JavaReconcilingStrategy.java;3;7;12;3;8;2;8;4;161;0;1;253;236;236;7;3;6;4;12;274;9;336;3;3;0
/org.eclipse.jdt.core/search/org/eclipse/jdt/internal/core/search/matching/PossibleMatchSet.java;2;0;3;1;0;0;0;3;2;2;2;119;4;4;2;1;0;3;3;119;1;199;2;2;0
/org.eclipse.help.base/src/org/eclipse/help/internal/base/HelpBasePlugin.java;1;4;14;1;6;3;6;8;123;3;4;105;342;342;4;4;3;8;14;286;7;336;7;1;0
/org.eclipse.jdt.core/model/org/eclipse/jdt/core/util/IRuntimeVisibleAnnotationsAttribute.java;2;0;2;1;0;0;0;2;36;1;2;245;36;36;1;0;0;2;2;245;0;264;2;2;0
/org.eclipse.swt/Eclipse SWT/common/org/eclipse/swt/SWTException.java;1;1;2;1;2;2;2;0;18;0;0;328;22;22;1;0;0;0;2;328;0;337;2;1;0
/org.eclipse.osgi/core/framework/org/eclipse/osgi/framework/internal/protocol/ProtocolActivator.java;5;0;5;2;1;1;2;3;4;2;3;171;10;10;2;0;1;4;5;270;1;336;4;5;0
/org.eclipse.jdt.ui/ui/org/eclipse/jdt/internal/ui/text/correction/NameMatcher.java;1;0;1;1;1;1;1;0;2;0;0;336;2;2;1;0;0;0;1;336;0;336;1;1;0
/org.eclipse.jdt.junit/src/org/eclipse/jdt/internal/junit/ui/ITestRunListener3.java;2;0;3;1;1;1;1;2;2;1;2;193;4;4;1;0;0;2;3;193;0;336;3;2;0
/org.eclipse.jdt.core/compiler/org/eclipse/jdt/internal/compiler/ast/TryStatement.java;4;0;21;2;2;1;2;19;274;4;11;7;680;680;4;8;1;19;21;7;9;287;12;4;3
/org.eclipse.jdt.core/search/org/eclipse/jdt/internal/core/search/matching/InternalSearchPattern.java;1;0;2;1;2;1;2;0;14;0;0;280;14;14;2;0;1;0;2;280;1;280;1;1;0
/org.eclipse.jface.text/src/org/eclipse/jface/internal/text/link/contentassist/HTMLTextPresenter.java;3;1;3;1;2;2;2;1;2;0;1;232;4;4;1;0;0;1;3;232;0;336;3;3;0
/org.eclipse.jface.text/src/org/eclipse/jface/text/IAutoIndentStrategy.java;2;1;2;1;2;2;2;0;3;0;0;279;5;5;1;0;0;0;2;279;0;336;2;2;0
/org.eclipse.pde.ui/src/org/eclipse/pde/internal/ui/launcher/InstalledJREsPreferenceNode.java;2;1;4;1;2;2;2;2;103;1;2;89;117;117;1;0;0;2;4;89;0;336;4;2;0
/org.eclipse.update.core/src/org/eclipse/update/core/IFeatureReference.java;2;1;3;1;2;2;2;1;6;0;1;58;16;16;1;0;0;1;3;58;0;336;3;2;0
/org.eclipse.jdt.ui/ui/org/eclipse/jdt/ui/text/java/IJavadocCompletionProcessor.java;1;1;2;1;2;2;2;0;3;0;0;276;5;5;1;0;0;0;2;276;0;335;2;1;0
/org.eclipse.jdt.ui/ui/org/eclipse/jdt/internal/ui/wizards/dialogfields/DialogField.java;2;1;3;1;2;2;2;1;10;0;1;243;15;15;1;0;0;1;3;243;0;336;3;2;0
/org.eclipse.jdt.ui/ui/org/eclipse/jdt/internal/ui/text/spelling/SpellReconcileStrategy.java;3;2;7;2;3;2;3;4;64;3;2;219;121;121;3;2;1;4;7;219;3;335;4;3;0
/org.eclipse.jdt.core/dom/org/eclipse/jdt/core/dom/Assignment.java;4;0;9;1;2;1;2;7;136;2;6;70;188;188;2;1;1;7;9;266;2;276;7;4;1
/org.eclipse.swt/Eclipse SWT Custom Widgets/common/org/eclipse/swt/custom/TableTreeItem.java;5;2;6;2;3;2;3;3;46;1;3;19;73;73;2;0;1;3;6;280;1;337;5;5;1
/org.eclipse.jdt.debug.ui/ui/org/eclipse/jdt/internal/debug/core/refactoring/JavaBreakpointITypeMoveParticipant.java;2;1;2;1;2;2;2;0;8;0;0;287;8;8;1;0;0;0;2;287;0;336;2;2;0
/org.eclipse.swt/Eclipse SWT PI/motif/org/eclipse/swt/internal/motif/Visual.java;1;0;1;1;0;0;0;1;4;0;1;54;4;4;1;0;0;1;1;54;0;54;1;1;0
/org.eclipse.ant.ui/Ant Editor/org/eclipse/ant/internal/ui/editor/derived/HTMLPrinter.java;1;0;1;1;0;0;0;1;0;0;1;108;0;0;1;0;0;1;1;108;0;108;1;1;0
/org.eclipse.jdt.core/compiler/org/eclipse/jdt/internal/compiler/ConfigurableOption.java;2;0;2;1;1;1;1;1;2;0;1;199;4;4;1;0;0;1;2;199;0;314;2;2;0
/org.eclipse.ui.workbench/Eclipse UI/org/eclipse/ui/internal/ViewSashContainer.java;2;2;3;1;3;2;3;0;11;0;0;297;13;13;2;0;1;0;3;297;1;336;2;2;5
/org.eclipse.team.cvs.core/src/org/eclipse/team/internal/ccvs/core/client/Log.java;1;0;1;1;0;0;0;1;2;0;1;110;2;2;1;0;0;1;1;110;0;110;1;1;0
/org.eclipse.jdt.ui/core extension/org/eclipse/jdt/internal/corext/dom/JdtASTMatcher.java;1;0;1;1;1;1;1;0;2;0;0;336;2;2;1;0;0;0;1;336;0;336;1;1;0
/org.eclipse.ant.ui/Ant Editor/org/eclipse/ant/internal/ui/editor/formatter/XmlElementFormattingStrategy.java;1;1;6;1;2;2;2;4;179;2;3;218;465;465;2;1;0;4;6;226;1;306;5;1;0
/org.eclipse.team.cvs.ui/src/org/eclipse/team/internal/ccvs/ui/actions/CompareRemoteWithTagAction.java;2;0;4;1;1;1;1;3;63;1;3;20;135;135;1;0;0;3;4;20;0;336;4;2;0
/org.eclipse.swt/Eclipse SWT/win32/org/eclipse/swt/widgets/Control.java;7;7;75;6;11;3;14;61;404;15;10;1;1878;1878;15;51;11;64;75;1;62;321;13;7;4
/org.eclipse.jdt.ui/ui/org/eclipse/jdt/ui/actions/ConvertAnonymousToNestedAction.java;3;0;11;1;1;1;1;10;86;4;6;3;204;204;4;4;0;10;11;3;4;336;7;3;0
/org.eclipse.jface/src/org/eclipse/jface/action/CoolBarManager.java;6;2;18;3;4;3;4;14;1927;7;3;181;2160;2160;7;11;1;14;18;203;12;336;6;6;0
/org.eclipse.jdt.core/model/org/eclipse/jdt/internal/core/DeltaProcessor.java;4;6;48;3;12;3;12;36;1460;13;11;5;3750;3750;13;25;9;36;48;101;34;323;14;4;0
/org.eclipse.core.resources/src/org/eclipse/core/internal/indexing/ReservationTable.java;1;0;1;1;1;1;1;0;36;0;0;277;36;36;1;0;0;0;1;277;0;277;1;1;0
/org.eclipse.help/src/org/eclipse/help/internal/toc/TocNode.java;1;1;5;1;2;2;2;3;23;2;2;43;50;50;2;1;0;3;5;197;1;336;4;1;0
/org.eclipse.ui.ide/src/org/eclipse/ui/views/tasklist/ITaskListHelpContextIds.java;1;0;1;1;0;0;0;1;0;0;1;129;0;0;1;0;0;1;1;129;0;129;1;1;0
/org.eclipse.jdt.ui/ui/org/eclipse/jdt/ui/IPackagesViewPart.java;1;0;1;1;1;1;1;0;2;0;0;336;2;2;1;0;0;0;1;336;0;336;1;1;0
/org.eclipse.swt/Eclipse SWT/win32/org/eclipse/swt/widgets/Group.java;5;0;12;2;1;1;1;11;122;4;7;8;164;164;4;4;0;11;12;161;4;337;8;5;0
/org.eclipse.ui.workbench/Eclipse UI/org/eclipse/ui/internal/dialogs/FilteredPreferenceContentProvider.java;2;0;4;1;1;1;1;3;35;1;3;177;60;60;1;0;0;3;4;177;0;336;4;2;0
/org.eclipse.ui.workbench.texteditor/src/org/eclipse/ui/texteditor/ITextEditor.java;2;1;2;2;2;2;2;0;39;0;0;276;41;41;1;0;0;0;2;276;0;336;2;2;0
/org.eclipse.jdt.ui/core refactoring/org/eclipse/jdt/internal/corext/refactoring/code/ExtractMethodRefactoring.java;5;4;40;3;8;4;8;32;520;9;12;9;1270;1270;9;20;4;32;40;246;24;336;16;5;0
/org.eclipse.pde.ui/src_samples/org/eclipse/pde/ui/internal/samples/ShowSampleAction.java;3;3;10;2;6;3;6;4;169;3;2;249;274;274;3;2;3;4;10;249;5;336;5;3;0
/org.eclipse.core.resources/src/org/eclipse/core/internal/utils/Convert.java;1;0;2;1;2;1;2;0;177;0;0;275;177;177;2;0;1;0;2;275;1;275;1;1;0
/org.eclipse.ui.workbench/Eclipse UI/org/eclipse/ui/internal/themes/IThemeRegistry.java;2;0;6;1;1;1;1;5;158;2;4;206;225;225;2;1;0;5;6;265;1;283;5;2;0
/org.eclipse.jdt.ui/core extension/org/eclipse/jdt/internal/corext/dom/fragments/SimpleFragment.java;1;0;1;1;1;1;1;0;2;0;0;336;2;2;1;0;0;0;1;336;0;336;1;1;0
/org.eclipse.ltk.ui.refactoring/src/org/eclipse/ltk/internal/ui/refactoring/RefactoringUIPlugin.java;1;0;3;1;1;1;1;2;42;0;1;264;54;54;2;1;0;2;3;264;1;289;2;1;0
/org.eclipse.debug.ui/ui/org/eclipse/debug/internal/ui/actions/EditWatchExpressionAction.java;1;0;2;1;0;0;0;2;10;0;1;92;10;10;2;1;0;2;2;92;1;92;1;1;0
/org.eclipse.jdt.ui/ui/org/eclipse/jdt/internal/ui/dialogs/StatusInfo.java;2;2;3;1;3;2;3;0;8;0;0;300;10;10;2;0;1;0;3;300;1;336;2;2;0
/org.eclipse.pde.ui/src_Forms/org/eclipse/pde/internal/ui/model/plugin/PluginAttribute.java;3;2;9;2;5;3;5;4;14;2;2;244;56;56;2;2;2;4;9;244;4;331;5;3;0
/org.eclipse.ui.ide/extensions/org/eclipse/ui/ICapabilityUninstallWizard.java;1;0;1;1;0;0;0;1;0;0;1;132;0;0;1;0;0;1;1;132;0;132;1;1;0
/org.eclipse.jdt.ui/ui/org/eclipse/jdt/internal/ui/text/folding/EmptyJavaFoldingPreferenceBlock.java;1;1;2;1;2;2;2;0;6;0;0;292;6;6;1;0;0;0;2;292;0;336;2;1;0
/org.eclipse.jdt.core/model/org/eclipse/jdt/internal/core/CompletionRequestorWrapper.java;2;0;4;1;1;1;1;3;62;1;3;109;99;99;1;0;0;3;4;109;0;294;4;2;0
/org.eclipse.jdt.core/dom/org/eclipse/jdt/core/dom/VariableDeclarationStatement.java;4;0;15;1;1;1;5;10;276;6;6;199;380;380;6;4;4;14;15;266;8;308;7;4;3
/org.eclipse.swt/Eclipse SWT PI/gtk/org/eclipse/swt/internal/gtk/GtkTargetEntry.java;3;0;4;1;1;1;1;3;17;2;2;100;23;23;2;1;0;3;4;226;1;337;3;3;0
/org.eclipse.jdt.ui/ui/org/eclipse/jdt/internal/ui/wizards/dialogfields/ComboDialogField.java;2;1;4;1;2;2;2;2;25;1;2;76;37;37;1;0;0;2;4;76;0;336;4;2;0
/org.eclipse.osgi/core/framework/org/eclipse/osgi/framework/internal/core/FilteredServiceListener.java;4;1;5;1;3;3;3;2;118;1;2;171;134;134;1;0;0;2;5;171;0;336;5;4;0
/org.eclipse.jdt.ui/ui/org/eclipse/jdt/ui/search/ElementQuerySpecification.java;3;2;4;2;4;2;4;0;20;0;0;290;24;24;2;0;2;0;4;290;2;335;2;3;0
/org.eclipse.ant.ui/Ant Editor/org/eclipse/ant/internal/ui/editor/outline/FilterPropertiesAction.java;1;0;2;1;1;1;1;1;4;0;1;205;4;4;1;0;0;1;2;205;0;336;2;1;1
/org.eclipse.ant.ui/Ant Tools Support/org/eclipse/ant/internal/ui/launchConfigurations/AntBuildTab.java;2;2;4;2;4;3;4;0;14;0;0;300;22;22;2;0;1;0;4;309;1;336;3;2;1
/org.eclipse.help.ui/src/org/eclipse/help/ui/internal/AppserverPreferencePage.java;1;1;7;1;3;3;3;4;57;2;3;110;137;137;2;1;0;4;7;156;1;336;6;1;0
/org.eclipse.jdt.core/model/org/eclipse/jdt/core/IMethod.java;3;0;5;1;1;1;1;4;57;1;4;7;88;88;1;0;0;4;5;7;0;272;5;3;0
/org.eclipse.team.cvs.ui/src/org/eclipse/team/internal/ccvs/ui/operations/ITagOperation.java;2;0;4;1;1;1;1;3;5;1;3;63;11;11;1;0;0;3;4;63;0;336;4;2;0
/org.eclipse.core.resources/src/org/eclipse/core/resources/refresh/IRefreshMonitor.java;2;0;2;1;1;1;1;1;5;0;1;205;9;9;1;0;0;1;2;205;0;273;2;2;0
/org.eclipse.pde.core/src/org/eclipse/pde/core/plugin/IPluginBase.java;3;2;11;1;4;3;4;7;133;2;5;128;343;343;2;2;1;7;11;128;3;336;8;3;0
/org.eclipse.core.runtime/src/org/eclipse/core/runtime/IStatus.java;3;2;8;2;3;2;3;5;684;3;3;47;765;765;3;2;1;5;8;171;3;332;5;3;1
/org.eclipse.ui.workbench/Eclipse UI/org/eclipse/ui/internal/DetachedWindow.java;5;2;11;2;6;3;6;5;367;2;4;212;446;446;2;1;3;5;11;248;4;330;7;5;2
/org.eclipse.jface.text/src/org/eclipse/jface/text/rules/IRule.java;1;0;1;1;1;1;1;0;2;0;0;336;2;2;1;0;0;0;1;336;0;336;1;1;0
/org.eclipse.jdt.ui/core extension/org/eclipse/jdt/internal/corext/dom/fragments/SimpleExpressionFragment.java;1;0;1;1;1;1;1;0;2;0;0;336;2;2;1;0;0;0;1;336;0;336;1;1;0
/org.eclipse.ui.workbench/Eclipse UI/org/eclipse/ui/internal/dialogs/ViewsPreferencePage.java;7;3;20;4;5;3;6;14;693;7;4;111;1386;1386;7;10;3;15;20;240;13;336;7;7;1
/org.eclipse.jdt.core/search/org/eclipse/jdt/internal/core/search/IndexQueryRequestor.java;1;0;2;1;0;0;0;2;2;1;2;181;2;2;1;0;0;2;2;181;0;199;2;1;0
/org.eclipse.swt/Eclipse SWT/gtk/org/eclipse/swt/widgets/FontDialog.java;4;1;7;3;2;2;2;5;50;3;3;12;107;107;3;2;0;5;7;12;2;337;5;4;0
/org.eclipse.compare/compare/org/eclipse/compare/internal/patch/Hunk.java;1;0;2;1;0;0;0;2;10;1;2;45;12;12;1;0;0;2;2;45;0;219;2;1;0
/org.eclipse.text/src/org/eclipse/jface/text/templates/SimpleTemplateVariableResolver.java;3;2;3;2;3;2;3;0;8;0;0;279;8;8;2;0;1;0;3;334;1;334;2;3;0
/org.eclipse.core.runtime/src/org/eclipse/core/runtime/preferences/IEclipsePreferences.java;2;1;13;2;2;2;3;10;159;5;4;224;368;368;5;6;1;11;13;237;7;336;6;2;1
/org.eclipse.jdt.ui/core refactoring/org/eclipse/jdt/internal/corext/refactoring/CollectingSearchRequestor.java;2;1;2;1;2;2;2;0;2;0;0;289;2;2;1;0;0;0;2;289;0;336;2;2;0
/org.eclipse.swt/Eclipse SWT/motif/org/eclipse/swt/widgets/List.java;4;1;13;3;3;3;3;10;115;5;6;8;320;320;5;4;0;10;13;159;4;337;9;4;0
/org.eclipse.ui.workbench/Eclipse UI/org/eclipse/ui/dialogs/PropertyDialogAction.java;1;0;1;1;1;1;1;0;267;0;0;293;267;267;1;0;0;0;1;293;0;293;1;1;0
/org.eclipse.update.core/src/org/eclipse/update/internal/core/SiteStatusAnalyzer.java;2;1;10;1;3;3;3;7;112;4;4;58;224;224;4;3;0;7;10;228;3;336;7;2;0
/org.eclipse.core.resources/src/org/eclipse/core/internal/events/ResourceChangeListenerList.java;2;1;2;1;2;2;2;0;315;0;0;277;480;480;1;0;0;0;2;277;0;303;2;2;0
/org.eclipse.ui.workbench/Eclipse UI/org/eclipse/ui/activities/IActivityPatternBinding.java;3;1;5;1;2;2;2;3;10;1;3;165;25;25;1;0;0;3;5;165;0;336;5;3;0
/org.eclipse.pde.build/src/org/eclipse/pde/internal/build/builder/IClasspathComputer.java;2;0;3;2;2;1;2;1;21;0;1;230;21;21;2;0;1;1;3;272;1;272;2;2;0
/org.eclipse.jdt.ui/ui/org/eclipse/jdt/internal/ui/jarpackager/IJarPackageWizardPage.java;1;0;1;1;1;1;1;0;2;0;0;336;2;2;1;0;0;0;1;336;0;336;1;1;0
/org.eclipse.pde.build/src/org/eclipse/pde/internal/build/ant/FileSet.java;2;1;7;1;2;2;2;5;176;2;3;31;453;453;2;2;0;5;7;31;2;336;5;2;0
/org.eclipse.team.cvs.ui/src/org/eclipse/team/internal/ccvs/ui/merge/MergeWizardStartPage.java;1;0;2;1;0;0;0;2;2;1;2;63;3;3;1;0;0;2;2;63;0;151;2;1;1
/org.eclipse.text/src/org/eclipse/jface/text/templates/TextTemplateMessages.java;2;1;2;1;2;2;2;0;2;0;0;286;2;2;1;0;0;0;2;286;0;336;2;2;0
/org.eclipse.swt/Eclipse SWT PI/win32/org/eclipse/swt/internal/ole/win32/COSERVERINFO.java;1;0;1;1;0;0;0;1;1;0;1;166;1;1;1;0;0;1;1;166;0;166;1;1;0
/org.eclipse.swt/Eclipse SWT/carbon/org/eclipse/swt/widgets/List.java;5;3;27;3;8;5;8;19;216;4;11;8;582;582;4;8;3;19;27;136;11;337;16;5;0
/org.eclipse.ui.ide/src/org/eclipse/ui/wizards/datatransfer/WizardZipFileImportPage1.java;1;0;1;1;0;0;0;1;0;0;1;92;0;0;1;0;0;1;1;92;0;92;1;1;0
/org.eclipse.core.resources/src/org/eclipse/core/internal/resources/ResourceException.java;1;0;1;1;1;1;1;0;119;0;0;277;119;119;1;0;0;0;1;277;0;277;1;1;0
/org.eclipse.jface/src/org/eclipse/jface/util/ListenerList.java;2;0;2;1;1;1;1;1;4;0;1;227;6;6;1;0;0;1;2;227;0;336;2;2;0
/org.eclipse.help.base/src/org/eclipse/help/internal/standalone/Eclipse.java;1;1;6;1;3;3;3;3;44;1;3;104;126;126;1;0;0;3;6;104;0;336;6;1;0
/org.eclipse.jdt.core/model/org/eclipse/jdt/core/CompletionProposal.java;3;0;7;2;1;1;3;4;119;0;1;264;127;127;6;3;2;6;7;264;5;314;2;3;0
/org.eclipse.jface/src/org/eclipse/jface/viewers/IPostSelectionProvider.java;1;0;1;1;0;0;0;1;0;0;1;68;0;0;1;0;0;1;1;68;0;68;1;1;0
/org.eclipse.help/src/org/eclipse/help/internal/toc/DirectoryToc.java;1;1;7;1;3;3;3;4;107;2;3;156;250;250;2;1;0;4;7;203;1;336;6;1;0
/org.eclipse.jdt.junit/src/org/eclipse/jdt/internal/junit/launcher/JUnitLaunchShortcut.java;2;1;9;2;3;3;3;6;31;2;5;99;90;90;2;1;0;6;9;262;1;336;8;2;0
/org.eclipse.swt/Eclipse SWT PI/carbon/org/eclipse/swt/internal/carbon/ColorPickerInfo.java;1;0;2;1;2;1;2;0;20;0;0;296;20;20;2;0;1;0;2;296;1;296;1;1;0
/org.eclipse.update.core/src/org/eclipse/update/internal/core/SiteTypeFactory.java;2;1;4;1;2;2;2;2;13;1;2;58;23;23;1;0;0;2;4;58;0;336;4;2;0
/org.eclipse.jdt.core/dom/org/eclipse/jdt/core/dom/rewrite/ASTRewrite.java;3;0;7;2;0;0;5;2;259;6;2;262;294;294;6;0;5;7;7;270;5;270;2;3;1
/org.eclipse.jdt.debug.ui/ui/org/eclipse/jdt/internal/debug/core/refactoring/JavaExceptionBreakpointTypeChange.java;2;1;3;1;3;3;3;0;8;0;0;287;16;16;1;0;0;0;3;287;0;336;3;2;1
/org.eclipse.ui.workbench/Eclipse UI/org/eclipse/ui/internal/presentations/ProxyControl.java;1;1;2;1;2;2;2;0;12;0;0;283;12;12;1;0;0;0;2;283;0;294;2;1;0
/org.eclipse.ui.workbench/Eclipse UI/org/eclipse/ui/SelectionEnabler.java;4;0;4;2;1;1;1;3;414;1;3;106;455;455;1;0;0;3;4;106;0;336;4;4;0
/org.eclipse.ui.workbench.texteditor/src/org/eclipse/ui/texteditor/templates/TemplateVariableProcessor.java;3;2;4;2;3;2;3;1;14;0;1;253;20;20;2;0;1;1;4;275;1;336;3;3;0
/org.eclipse.ui.workbench/Eclipse UI/org/eclipse/ui/internal/progress/ErrorNotificationManager.java;1;1;3;1;2;2;2;1;17;0;1;195;34;34;1;0;0;1;3;195;0;299;3;1;0
/org.eclipse.compare/compare/org/eclipse/compare/internal/patch/Diff.java;1;0;2;1;0;0;0;2;2;1;2;79;4;4;1;0;0;2;2;79;0;219;2;1;0
/org.eclipse.ui.workbench/Eclipse UI/org/eclipse/ui/internal/registry/PropertyPagesRegistryReader.java;4;0;4;1;1;1;1;3;6;1;3;163;14;14;1;0;0;3;4;163;0;336;4;4;1
/org.eclipse.ui.workbench/Eclipse UI/org/eclipse/ui/IWorkbenchPartConstants.java;2;1;2;1;2;2;2;0;4;0;0;297;4;4;1;0;0;0;2;297;0;336;2;2;0
/org.eclipse.pde.ui/src/org/eclipse/pde/internal/ui/editor/schema/NewElementAction.java;2;1;2;1;2;2;2;0;12;0;0;308;16;16;1;0;0;0;2;308;0;336;2;2;0
/org.eclipse.jdt.debug/jdi interfaces/com/sun/jdi/TypeComponent.java;1;0;1;1;0;0;0;1;3;0;1;235;3;3;1;0;0;1;1;235;0;235;1;1;0
/org.eclipse.core.resources/src/org/eclipse/core/internal/resources/IMarkerSetElement.java;1;0;1;1;1;1;1;0;6;0;0;277;6;6;1;0;0;0;1;277;0;277;1;1;0
/org.eclipse.ant.ui/Ant Editor/org/eclipse/ant/internal/ui/dtd/util/MapHolder.java;1;0;2;1;0;0;0;2;17;1;2;108;17;17;1;0;0;2;2;108;0;202;2;1;0
/org.eclipse.osgi/resolver/src/org/eclipse/osgi/internal/resolver/UserState.java;3;1;6;2;2;2;3;3;54;2;3;179;127;127;2;0;1;4;6;269;1;296;5;3;0
/org.eclipse.ui.workbench/Eclipse UI/org/eclipse/ui/activities/ICategory.java;3;1;8;1;2;2;2;6;221;4;3;163;256;256;4;3;0;6;8;163;3;336;5;3;0
/org.eclipse.jdt.core/model/org/eclipse/jdt/internal/core/builder/NameEnvironment.java;2;0;9;1;0;0;0;9;7;3;7;19;31;31;3;2;0;9;9;121;2;266;7;2;0
/org.eclipse.update.core/src/org/eclipse/update/internal/core/FeatureTypeFactory.java;2;1;5;1;3;3;3;2;9;1;2;58;25;25;1;0;0;2;5;58;0;336;5;2;0
/org.eclipse.pde.ui/src/org/eclipse/pde/internal/ui/wizards/extension/BaseExtensionPointMainPage.java;2;2;8;2;7;5;7;1;311;0;1;157;613;613;2;0;2;1;8;281;2;331;6;2;0
/org.eclipse.ui.workbench/Eclipse UI/org/eclipse/ui/internal/dialogs/PatternFilter.java;1;0;2;1;1;1;1;1;12;0;1;269;12;12;1;0;0;1;2;269;0;313;2;1;0
/org.eclipse.swt/Eclipse SWT Mozilla/common/org/eclipse/swt/internal/mozilla/nsIDOMUIEvent.java;2;1;2;1;2;2;2;0;2;0;0;283;2;2;1;0;0;0;2;283;0;336;2;2;0
/org.eclipse.jdt.ui/ui/org/eclipse/jdt/internal/ui/util/ElementValidator.java;2;0;2;1;1;1;1;1;5;0;1;84;7;7;1;0;0;1;2;84;0;336;2;2;0
/org.eclipse.debug.ui/ui/org/eclipse/debug/internal/ui/views/registers/RegistersViewContentProvider.java;1;0;1;1;0;0;0;1;0;0;1;239;0;0;1;0;0;1;1;239;0;239;1;1;0
/org.eclipse.jdt.ui/ui/org/eclipse/jdt/internal/ui/actions/AbstractToggleLinkingAction.java;1;0;3;1;1;1;1;2;7;0;1;79;9;9;2;1;0;2;3;79;1;336;2;1;0
/org.eclipse.ui.ide/extensions/org/eclipse/ui/actions/WorkspaceModifyDelegatingOperation.java;4;1;4;1;2;2;2;2;73;1;2;132;77;77;1;0;0;2;4;132;0;336;4;4;0
/org.eclipse.team.cvs.ui/src/org/eclipse/team/internal/ccvs/ui/ListSelectionArea.java;2;0;5;2;1;1;1;4;19;2;3;63;31;31;2;1;0;4;5;63;1;336;4;2;1
/org.eclipse.swt/Eclipse SWT Drag and Drop/carbon/org/eclipse/swt/dnd/TransferData.java;2;1;3;1;2;2;2;1;8;0;1;21;15;15;1;0;0;1;3;21;0;337;3;2;1
/org.eclipse.core.resources/src/org/eclipse/core/internal/refresh/RefreshManager.java;2;2;6;2;3;2;3;3;34;2;2;205;90;90;2;1;1;3;6;205;2;331;4;2;1
/org.eclipse.ui.ide/src/org/eclipse/ui/internal/ide/dialogs/InstallCapabilityStep.java;1;0;1;1;0;0;0;1;0;0;1;132;0;0;1;0;0;1;1;132;0;132;1;1;0
/org.eclipse.swt/Eclipse SWT/common/org/eclipse/swt/graphics/ImageData.java;4;1;8;1;2;2;2;6;50;2;5;0;121;121;2;1;0;6;8;234;1;337;7;4;3
/org.eclipse.jdt.ui/ui/org/eclipse/jdt/internal/ui/text/TypingRunDetector.java;2;1;2;1;2;2;2;0;6;0;0;281;6;6;1;0;0;0;2;281;0;336;2;2;0
/org.eclipse.jface.text/src/org/eclipse/jface/text/source/LineNumberRulerColumn.java;4;2;11;2;4;3;5;6;102;2;6;70;331;331;2;0;2;7;11;269;2;336;9;4;0
/org.eclipse.ui.workbench.texteditor/src/org/eclipse/ui/texteditor/IncrementalFindTarget.java;1;1;8;1;2;2;2;6;97;2;5;53;153;153;2;1;0;6;8;144;1;336;7;1;1
/org.eclipse.jdt.core/model/org/eclipse/jdt/core/util/IBytecodeVisitor.java;1;0;1;1;0;0;0;1;2;0;1;199;2;2;1;0;0;1;1;199;0;199;1;1;0
/org.eclipse.ui.workbench/Eclipse UI/org/eclipse/ui/internal/contexts/Context.java;4;1;20;3;2;2;2;18;933;11;5;75;1666;1666;11;13;0;18;20;75;13;336;7;4;0
/org.eclipse.jdt.core/codeassist/org/eclipse/jdt/internal/codeassist/select/SelectionOnFieldType.java;2;0;2;1;0;0;0;2;4;1;2;63;6;6;1;0;0;2;2;63;0;199;2;2;0
/org.eclipse.core.runtime/src/org/eclipse/core/runtime/CoreException.java;2;2;6;2;3;2;3;3;332;0;1;171;346;346;3;2;1;3;6;171;3;336;3;2;0
/org.eclipse.jdt.core/model/org/eclipse/jdt/core/util/IModifierConstants.java;1;0;3;1;1;1;1;2;25;1;2;199;31;31;1;0;0;2;3;199;0;306;3;1;0
/org.eclipse.search/search/org/eclipse/search/internal/ui/text/SortAction.java;1;0;2;1;1;1;1;1;2;0;1;207;2;2;1;0;0;1;2;207;0;293;2;1;0
/org.eclipse.ui.workbench/Eclipse UI/org/eclipse/ui/dialogs/TwoPaneElementSelector.java;1;1;5;1;2;2;2;3;186;2;2;0;214;214;2;1;0;3;5;0;1;293;4;1;0
/org.eclipse.jdt.debug.ui/ui/org/eclipse/jdt/internal/debug/ui/DetailFormatterCompletionProcessor.java;4;0;5;1;1;1;1;4;20;2;3;72;33;33;2;1;0;4;5;235;1;336;4;4;0
/org.eclipse.ui.workbench/Eclipse UI/org/eclipse/ui/IEditorActionBarContributor.java;2;0;2;2;0;0;0;2;4;0;1;0;4;4;2;1;0;2;2;0;1;0;1;2;0
/org.eclipse.search/search/org/eclipse/search/internal/ui/RemoveResultAction.java;1;0;1;1;1;1;1;0;2;0;0;336;2;2;1;0;0;0;1;336;0;336;1;1;0
/org.eclipse.jdt.ui/ui/org/eclipse/jdt/internal/ui/search/WorkingSetsComparator.java;2;1;2;1;2;2;2;0;2;0;0;290;3;3;1;0;0;0;2;290;0;336;2;2;0
/org.eclipse.jdt.debug/jdi interfaces/com/sun/jdi/connect/spi/TransportService.java;1;0;1;1;0;0;0;1;0;0;1;235;0;0;1;0;0;1;1;235;0;235;1;1;0
/org.eclipse.debug.ui/ui/org/eclipse/debug/internal/ui/views/memory/EmptyRenderer.java;2;0;2;2;2;1;2;0;10;0;0;282;10;10;2;0;1;0;2;282;1;282;1;2;1
/org.eclipse.ui.workbench/Eclipse UI/org/eclipse/ui/IPerspectiveRegistry.java;3;0;3;2;1;1;1;2;22;1;2;157;28;28;1;0;0;2;3;157;0;336;3;3;0
/org.eclipse.ui.workbench/Eclipse UI/org/eclipse/ui/internal/ActivityPersistanceHelper.java;3;1;6;2;2;2;2;4;188;2;3;174;266;266;2;1;0;4;6;174;1;336;5;3;3
/org.eclipse.pde.ui/src/org/eclipse/pde/internal/ui/editor/feature/IncludedFeaturesSection.java;3;2;10;2;4;3;4;6;117;2;5;130;202;202;2;1;1;6;10;130;2;336;8;3;0
/org.eclipse.swt/Eclipse SWT PI/gtk/org/eclipse/swt/internal/gtk/GtkCombo.java;3;0;3;1;1;1;1;2;17;1;2;100;23;23;1;0;0;2;3;100;0;337;3;3;0
/org.eclipse.team.ui/src/org/eclipse/team/internal/ui/dialogs/DetailsDialogWithProjects.java;1;0;3;1;0;0;0;3;115;1;3;63;124;124;1;0;0;3;3;63;0;157;3;1;0
/org.eclipse.debug.core/core/org/eclipse/debug/internal/core/ListenerList.java;2;1;2;1;2;2;2;0;4;0;0;326;6;6;1;0;0;0;2;326;0;336;2;2;0
/org.eclipse.jdt.ui/core refactoring/org/eclipse/jdt/internal/corext/refactoring/changes/DeleteFromClasspathChange.java;3;1;6;1;2;2;2;4;26;1;4;32;55;55;1;0;0;4;6;32;0;336;6;3;0
/org.eclipse.help.ide/src/org/eclipse/help/ui/internal/workingset/HelpWorkingSet.java;1;1;6;1;2;2;2;4;143;2;3;104;224;224;2;1;0;4;6;104;1;336;5;1;0
/org.eclipse.jdt.core/model/org/eclipse/jdt/internal/core/util/Disassembler.java;4;2;10;1;3;2;3;7;549;3;5;12;629;629;3;2;1;7;10;176;3;314;7;4;1
/org.eclipse.pde.ui/src/org/eclipse/pde/internal/ui/wizards/imports/FeatureImportOperation.java;2;1;4;1;2;2;2;2;115;1;2;26;137;137;1;0;0;2;4;26;0;336;4;2;0
/org.eclipse.search/new search/org/eclipse/search2/internal/ui/text/AnnotationHighlighter.java;1;2;4;1;4;3;4;0;43;0;0;295;63;63;2;0;1;0;4;323;1;323;3;1;0
/org.eclipse.ui.workbench/Eclipse UI/org/eclipse/ui/internal/dialogs/PropertyDialog.java;4;0;6;4;0;0;0;6;286;0;1;163;286;286;6;5;0;6;6;163;5;163;1;4;0
/org.eclipse.team.cvs.ui/src/org/eclipse/team/internal/ccvs/ui/repo/RepositoriesView.java;2;2;8;2;5;4;5;3;52;2;2;118;153;153;2;1;1;3;8;250;2;336;6;2;1
/org.eclipse.core.filebuffers/src/org/eclipse/core/internal/filebuffers/JavaTextFileBuffer.java;3;2;8;2;6;3;6;2;157;1;2;130;244;244;2;0;3;2;8;289;3;331;5;3;0
/org.eclipse.jdt.launching/launching/org/eclipse/jdt/launching/sourcelookup/DirectorySourceLocation.java;4;1;9;2;2;2;2;7;31;2;4;53;91;91;2;3;0;7;9;53;3;336;6;4;1
/org.eclipse.ui.forms/src/org/eclipse/ui/forms/HyperlinkGroup.java;1;1;4;1;2;2;2;2;10;1;2;225;18;18;1;0;0;2;4;225;0;336;4;1;0
/org.eclipse.jdt.core/compiler/org/eclipse/jdt/internal/compiler/util/HashtableOfIntValues.java;2;0;2;1;0;0;0;2;26;1;2;197;26;26;1;0;0;2;2;197;0;245;2;2;0
/org.eclipse.jdt.core/model/org/eclipse/jdt/internal/core/OpenableElementInfo.java;1;0;3;1;0;0;0;3;3;1;3;57;7;7;1;0;0;3;3;57;0;199;3;1;0
/org.eclipse.ltk.ui.refactoring/src/org/eclipse/ltk/ui/refactoring/RefactoringWizardOpenOperation.java;1;2;7;1;7;5;7;0;57;0;0;274;152;152;2;0;2;0;7;274;2;335;5;1;0
/org.eclipse.jface/src/org/eclipse/jface/action/ExternalActionManager.java;2;1;3;1;3;3;3;0;32;0;0;282;36;36;1;0;0;0;3;282;0;336;3;2;1
/org.eclipse.pde.ui/src/org/eclipse/pde/internal/ui/search/ReferencesInPluginAction.java;2;1;3;1;2;2;2;1;14;0;1;168;28;28;1;0;0;1;3;168;0;336;3;2;0
/org.eclipse.core.filebuffers/src/org/eclipse/core/filebuffers/ITextFileBufferManager.java;2;2;8;2;3;2;3;5;52;2;3;93;133;133;2;2;1;5;8;93;3;334;5;2;0
/org.eclipse.ui.workbench/Eclipse UI/org/eclipse/ui/internal/layout/LayoutCache.java;1;0;1;1;1;1;1;0;0;0;0;271;0;0;1;0;0;0;1;271;0;271;1;1;0
/org.eclipse.ui.ide/src/org/eclipse/ui/internal/ide/model/WorkspaceFactory.java;3;1;3;1;2;2;2;1;2;0;1;132;4;4;1;0;0;1;3;132;0;336;3;3;0
/org.eclipse.search/search/org/eclipse/search/internal/ui/util/MessageLine.java;1;0;1;1;1;1;1;0;2;0;0;336;2;2;1;0;0;0;1;336;0;336;1;1;0
/org.eclipse.jdt.ui/core extension/org/eclipse/jdt/internal/corext/util/IOCloser.java;1;0;1;1;1;1;1;0;2;0;0;336;2;2;1;0;0;0;1;336;0;336;1;1;0
/org.eclipse.ui.workbench/Eclipse UI/org/eclipse/ui/internal/dialogs/WorkbenchPreferenceNode.java;5;0;7;3;1;1;1;6;176;3;3;116;207;207;3;3;0;6;7;171;3;336;4;5;0
/org.eclipse.osgi/resolver/src/org/eclipse/osgi/internal/resolver/StateReader.java;4;0;12;2;5;1;5;7;66;6;2;171;113;113;6;5;4;7;12;171;9;276;3;4;0
/org.eclipse.jdt.core/compiler/org/eclipse/jdt/internal/compiler/lookup/BindingIds.java;1;0;1;1;0;0;0;1;2;0;1;199;2;2;1;0;0;1;1;199;0;199;1;1;0
/org.eclipse.debug.core/core/org/eclipse/debug/core/DebugPlugin.java;5;0;34;3;5;1;7;27;183;7;9;11;922;922;7;18;6;29;34;32;24;294;10;5;4
/org.eclipse.swt/Eclipse SWT PI/win32/org/eclipse/swt/internal/Platform.java;1;0;1;1;0;0;0;1;0;0;1;117;0;0;1;0;0;1;1;117;0;117;1;1;0
/org.eclipse.ui.workbench/Eclipse UI/org/eclipse/ui/internal/commands/CategoryDefinition.java;2;0;10;1;1;1;1;9;103;3;6;84;305;305;3;3;0;9;10;84;3;336;7;2;0
/org.eclipse.jdt.ui/core refactoring/org/eclipse/jdt/internal/corext/refactoring/changes/DeletePackageFragmentRootChange.java;2;1;3;1;2;2;2;1;15;0;1;219;25;25;1;0;0;1;3;219;0;336;3;2;0
/org.eclipse.jdt.ui/ui/org/eclipse/jdt/internal/ui/text/java/ParameterGuesser.java;4;1;10;3;2;2;2;8;176;2;6;75;534;534;2;2;0;8;10;104;2;336;8;4;0
/org.eclipse.core.runtime/src/org/eclipse/core/internal/boot/PlatformURLConnection.java;4;3;8;2;4;2;4;4;954;2;3;173;1062;1062;3;1;2;4;8;272;3;297;5;4;1
/org.eclipse.jdt.ui/ui/org/eclipse/jdt/internal/ui/dialogs/MainTypeSelectionDialog.java;1;0;1;1;1;1;1;0;2;0;0;336;2;2;1;0;0;0;1;336;0;336;1;1;0
/org.eclipse.core.expressions/src/org/eclipse/core/internal/expressions/ResolveExpression.java;1;0;3;1;1;1;1;2;8;0;1;227;10;10;2;1;0;2;3;227;1;336;2;1;0
/org.eclipse.ltk.ui.refactoring/src/org/eclipse/ltk/ui/refactoring/TextStatusContextViewer.java;1;2;4;1;4;3;4;0;9;0;0;273;17;17;2;0;1;0;4;335;1;335;3;1;0
/org.eclipse.team.cvs.ui/src/org/eclipse/team/internal/ccvs/ui/console/ConsoleDocument.java;2;1;4;1;2;2;2;2;110;1;2;252;122;122;1;0;0;2;4;252;0;336;4;2;0
/org.eclipse.ui.forms/src/org/eclipse/ui/forms/IDetailsPage.java;1;0;4;1;1;1;1;3;79;1;3;225;87;87;1;0;0;3;4;225;0;336;4;1;0
/org.eclipse.ui.workbench/Eclipse UI/org/eclipse/ui/internal/layout/CacheWrapper.java;2;1;2;1;2;2;2;0;10;0;0;293;10;10;1;0;0;0;2;293;0;313;2;2;0
/org.eclipse.pde.ui/src/org/eclipse/pde/internal/ui/view/FileAdapterPropertySource.java;2;1;2;1;2;2;2;0;24;0;0;308;28;28;1;0;0;0;2;308;0;336;2;2;0
/org.eclipse.jface.text/src/org/eclipse/jface/text/link/ProposalPosition.java;2;2;6;2;3;2;3;3;36;1;3;232;53;53;2;0;1;3;6;334;1;334;5;2;0
/org.eclipse.jdt.ui/ui/org/eclipse/jdt/internal/ui/search/JavaElementLineSorter.java;1;0;1;1;0;0;0;1;0;0;1;266;0;0;1;0;0;1;1;266;0;266;1;1;0
/org.eclipse.jdt.core/compiler/org/eclipse/jdt/internal/compiler/parser/RecoveredType.java;4;0;9;2;1;1;1;8;50;3;6;34;129;129;3;2;0;8;9;63;2;290;7;4;0
/org.eclipse.ui.workbench/Eclipse UI/org/eclipse/ui/activities/CategoryEvent.java;3;1;8;2;2;2;2;6;64;4;3;163;125;125;4;3;0;6;8;163;3;336;5;3;0
/org.eclipse.osgi/osgi/src/org/osgi/service/packageadmin/ProvidingBundle.java;1;0;2;1;2;1;2;0;4;0;0;296;4;4;2;0;1;0;2;296;1;296;1;1;0
/org.eclipse.jface.text/src/org/eclipse/jface/text/templates/InclusivePositionUpdater.java;2;1;3;1;3;3;3;0;6;0;0;279;11;11;1;0;0;0;3;279;0;336;3;2;0
/org.eclipse.jdt.ui/core extension/org/eclipse/jdt/internal/corext/codemanipulation/AddUnimplementedMethodsOperation.java;2;0;7;1;1;1;1;6;21;2;5;40;44;44;2;1;0;6;7;95;1;336;6;2;0
/org.eclipse.jdt.ui/ui/org/eclipse/jdt/internal/ui/util/SWTUtil.java;3;0;3;1;1;1;1;2;14;1;2;88;20;20;1;0;0;2;3;88;0;336;3;3;0
/org.eclipse.ui.ide/src/org/eclipse/ui/internal/ide/dialogs/WelcomeEditorActionContributor.java;1;0;1;1;0;0;0;1;0;0;1;132;0;0;1;0;0;1;1;132;0;132;1;1;0
/org.eclipse.ui.console/src/org/eclipse/ui/internal/console/ConsolePluginImages.java;1;0;3;1;1;1;1;2;10;1;2;118;18;18;1;0;0;2;3;118;0;294;3;1;0
/org.eclipse.debug.ui/ui/org/eclipse/debug/ui/actions/ContextualLaunchAction.java;1;1;2;1;2;2;2;0;5;0;0;295;8;8;1;0;0;0;2;295;0;303;2;1;2
/org.eclipse.update.core/src/org/eclipse/update/internal/operations/FeatureOperation.java;1;1;9;1;2;2;2;7;60;2;6;54;128;128;2;1;0;7;9;236;1;336;8;1;0
/org.eclipse.pde.ui/src/org/eclipse/pde/internal/ui/editor/build/BuildEditorContributor.java;2;1;4;1;3;3;3;1;19;0;1;106;45;45;1;0;0;1;4;106;0;336;4;2;0
/org.eclipse.team.cvs.core/src/org/eclipse/team/internal/ccvs/core/client/listeners/AnnotateListener.java;2;0;6;2;2;1;2;4;27;1;4;52;60;60;2;0;1;4;6;329;1;329;5;2;0
/org.eclipse.ui.workbench/Eclipse UI/org/eclipse/ui/keys/KeySequence.java;3;1;23;2;2;2;2;21;326;6;9;79;1221;1221;6;12;0;21;23;79;12;336;11;3;0
/org.eclipse.jface.text/src/org/eclipse/jface/text/source/ISourceViewerExtension.java;2;0;3;2;2;1;2;1;25;0;1;257;27;27;2;0;1;1;3;336;1;336;2;2;0
/org.eclipse.swt/Eclipse SWT/gtk/org/eclipse/swt/widgets/ColorDialog.java;2;1;3;1;2;2;2;1;4;0;1;228;10;10;1;0;0;1;3;228;0;337;3;2;0
/org.eclipse.swt/Eclipse SWT Drag and Drop/motif/org/eclipse/swt/dnd/Clipboard.java;3;1;8;1;2;2;2;6;207;1;6;0;318;318;1;0;0;6;8;0;0;337;8;3;0
/org.eclipse.jdt.ui/ui/org/eclipse/jdt/internal/ui/text/spelling/engine/IPhoneticDistanceAlgorithm.java;2;0;2;1;1;1;1;1;2;0;1;219;2;2;1;0;0;1;2;219;0;336;2;2;0
/org.eclipse.team.cvs.ui/src/org/eclipse/team/internal/ccvs/ui/actions/CheckoutAsAction.java;1;0;5;1;0;0;0;5;340;2;4;53;390;390;2;1;0;5;5;53;1;269;4;1;0
/org.eclipse.jdt.core/search/org/eclipse/jdt/core/search/IJavaSearchConstants.java;2;1;6;1;2;2;2;4;6;1;4;20;19;19;1;0;0;4;6;20;0;303;6;2;0
/org.eclipse.ui.intro/src/org/eclipse/ui/internal/intro/impl/swt/PageFormWithNavigation.java;1;0;1;1;1;1;1;0;0;0;0;333;0;0;1;0;0;0;1;333;0;333;1;1;0
/org.eclipse.swt.tools/JNI Generation/org/eclipse/swt/tools/internal/FieldData.java;1;0;1;1;0;0;0;1;0;0;1;230;0;0;1;0;0;1;1;230;0;230;1;1;0
/org.eclipse.jdt.debug.ui/ui/org/eclipse/jdt/internal/debug/core/refactoring/LaunchConfigurationIPackageFragmentRenameParticipant.java;3;1;7;2;2;2;2;5;28;4;2;246;83;83;4;3;0;5;7;246;3;336;4;3;0
/org.eclipse.pde.core/src/org/eclipse/pde/core/plugin/IPluginElement.java;3;3;6;2;5;3;5;1;100;0;1;232;114;114;3;0;2;1;6;275;2;336;4;3;0
/org.eclipse.ui.workbench/Eclipse UI/org/eclipse/ui/internal/presentations/NativeStackPresentation.java;6;3;12;4;6;3;6;6;79;0;1;245;128;128;6;5;3;6;12;245;8;330;4;6;0
/org.eclipse.ui.ide/extensions/org/eclipse/ui/dialogs/FileSelectionDialog.java;1;0;1;1;0;0;0;1;0;0;1;132;0;0;1;0;0;1;1;132;0;132;1;1;0
/org.eclipse.ui.workbench/Eclipse UI/org/eclipse/ui/internal/dialogs/WorkbenchEditorsDialog.java;6;1;7;1;2;2;2;5;95;1;5;9;215;215;1;0;0;5;7;9;0;336;7;6;0
/org.eclipse.swt/Eclipse SWT/photon/org/eclipse/swt/widgets/Combo.java;5;2;9;2;4;3;4;5;47;2;4;8;113;113;2;1;1;5;9;120;2;337;7;5;0
/org.eclipse.swt/Eclipse SWT/win32/org/eclipse/swt/widgets/ProgressBar.java;3;0;4;1;1;1;1;3;42;1;3;155;70;70;1;0;0;3;4;155;0;337;4;3;0
/org.eclipse.jdt.core/model/org/eclipse/jdt/core/IElementChangedListener.java;1;0;1;1;0;0;0;1;2;0;1;199;2;2;1;0;0;1;1;199;0;199;1;1;0
/org.eclipse.core.resources/src/org/eclipse/core/internal/localstore/HistoryStoreEntry.java;1;0;1;1;1;1;1;0;281;0;0;277;281;281;1;0;0;0;1;277;0;277;1;1;0
/org.eclipse.ui.workbench/Eclipse UI/org/eclipse/ui/part/Page.java;2;0;2;1;1;1;1;1;2;0;1;265;4;4;1;0;0;1;2;265;0;336;2;2;0
/org.eclipse.swt/Eclipse SWT PI/carbon/org/eclipse/swt/internal/carbon/PixMap.java;1;0;2;1;2;1;2;0;20;0;0;296;20;20;2;0;1;0;2;296;1;296;1;1;0
/org.eclipse.pde.ui/src/org/eclipse/pde/internal/ui/PDELabelProvider.java;3;2;12;2;6;4;6;6;57;1;6;70;145;145;2;0;2;6;12;306;2;333;10;3;0
/org.eclipse.ui.workbench/Eclipse UI/org/eclipse/ui/internal/EditorActionBuilder.java;1;0;1;1;0;0;0;1;2;0;1;42;2;2;1;0;0;1;1;42;0;42;1;1;0
/org.eclipse.core.resources/src/org/eclipse/core/internal/indexing/SpaceMapPage.java;1;0;1;1;1;1;1;0;49;0;0;277;49;49;1;0;0;0;1;277;0;277;1;1;0
/org.eclipse.pde.ui/src/org/eclipse/pde/internal/ui/parts/SharedPart.java;1;1;2;1;2;2;2;0;18;0;0;292;22;22;1;0;0;0;2;292;0;336;2;1;0
/org.eclipse.help.base/src/org/eclipse/help/internal/search/ASCIIReader.java;1;1;3;1;2;2;2;1;12;0;1;104;18;18;1;0;0;1;3;104;0;336;3;1;0
/org.eclipse.jface.text/src/org/eclipse/jface/text/ITextSelection.java;2;0;2;2;2;1;2;0;43;0;0;336;43;43;2;0;1;0;2;336;1;336;1;2;0
/org.eclipse.jdt.core/model/org/eclipse/jdt/internal/core/DeleteElementsOperation.java;3;1;7;1;2;2;2;5;37;1;5;67;81;81;1;0;0;5;7;67;0;314;7;3;1
/org.eclipse.core.resources/src/org/eclipse/core/internal/indexing/IndexedStoreContext.java;1;0;1;1;1;1;1;0;24;0;0;277;24;24;1;0;0;0;1;277;0;277;1;1;0
/org.eclipse.ui.workbench/Eclipse UI/org/eclipse/ui/internal/ObjectFilterTest.java;1;0;2;1;0;0;0;2;21;1;2;157;24;24;1;0;0;2;2;157;0;178;2;1;0
/org.eclipse.pde.core/src/org/eclipse/pde/internal/core/schema/SchemaElement.java;2;1;3;1;2;2;2;1;70;0;1;232;76;76;1;0;0;1;3;232;0;336;3;2;0
/org.eclipse.jdt.debug.ui/ui/org/eclipse/jdt/internal/debug/ui/JavaEvaluationEngineManager.java;1;0;1;1;0;0;0;1;2;0;1;78;2;2;1;0;0;1;1;78;0;78;1;1;0
/org.eclipse.jdt.ui/ui/org/eclipse/jdt/internal/ui/typehierarchy/SortByDefiningTypeAction.java;1;0;1;1;1;1;1;0;2;0;0;336;2;2;1;0;0;0;1;336;0;336;1;1;0
/org.eclipse.jdt.core/model/org/eclipse/jdt/internal/core/jdom/SimpleDOMBuilder.java;3;0;7;3;1;1;1;6;34;2;5;7;46;46;2;1;0;6;7;7;1;299;6;3;0
/org.eclipse.pde.ui/src/org/eclipse/pde/internal/ui/wizards/extension/ExtensionEditorWizard.java;3;1;3;1;3;3;3;0;6;0;0;295;12;12;1;0;0;0;3;295;0;336;3;3;0
/org.eclipse.update.core/src/org/eclipse/update/internal/operations/JobRoot.java;1;0;6;1;1;1;1;5;39;1;5;54;61;61;1;0;0;5;6;54;0;336;6;1;0
/org.eclipse.swt/Eclipse SWT/photon/org/eclipse/swt/graphics/Region.java;3;1;4;1;2;2;2;2;87;1;2;100;218;218;1;0;0;2;4;100;0;337;4;3;1
/org.eclipse.ant.ui/Ant Editor/org/eclipse/ant/internal/ui/dtd/IElement.java;1;0;1;1;0;0;0;1;0;0;1;108;0;0;1;0;0;1;1;108;0;108;1;1;0
/org.eclipse.search/new search/org/eclipse/search2/internal/ui/SearchView.java;3;2;26;3;3;2;13;13;571;11;6;195;953;953;11;7;11;23;26;269;18;321;8;3;0
/org.eclipse.pde.core/src/org/eclipse/pde/internal/core/plugin/WorkspaceExtensionsModel.java;3;1;7;1;4;4;4;3;32;1;3;128;58;58;1;0;0;3;7;128;0;336;7;3;0
/org.eclipse.help.base/src/org/eclipse/help/internal/search/SearchIndexWithIndexingProgress.java;1;1;3;1;2;2;2;1;16;0;1;269;32;32;1;0;0;1;3;269;0;336;3;1;0
/org.eclipse.jdt.ui/ui/org/eclipse/jdt/internal/ui/preferences/IPreferenceConfigurationBlock.java;1;1;2;1;2;2;2;0;6;0;0;294;6;6;1;0;0;0;2;294;0;336;2;1;0
/org.eclipse.ui.ide/extensions/org/eclipse/ui/IMarkerResolution2.java;1;0;1;1;0;0;0;1;0;0;1;183;0;0;1;0;0;1;1;183;0;183;1;1;0
/org.eclipse.ui.workbench/Eclipse UI/org/eclipse/ui/internal/dialogs/WorkbenchWizardSelectionPage.java;3;0;3;1;1;1;1;2;10;1;2;157;14;14;1;0;0;2;3;157;0;336;3;3;1
/org.eclipse.jdt.core/compiler/org/eclipse/jdt/internal/compiler/ast/LocalDeclaration.java;2;0;7;2;0;0;0;7;48;3;5;1;91;91;3;2;0;7;7;148;2;199;5;2;3
/org.eclipse.pde.ui/src/org/eclipse/pde/internal/ui/editor/plugin/LoopDialog.java;2;1;3;1;3;3;3;0;4;0;0;292;6;6;1;0;0;0;3;292;0;336;3;2;0
/org.eclipse.jdt.launching/launching/org/eclipse/jdt/internal/launching/JREContainer.java;2;0;2;1;0;0;0;2;10;1;2;22;16;16;1;0;0;2;2;22;0;53;2;2;0
/org.eclipse.jdt.ui/ui/org/eclipse/jdt/internal/ui/IJavaHelpContextIds.java;8;2;28;3;4;3;4;24;37;4;12;12;133;133;4;12;1;24;28;12;13;336;15;8;0
/org.eclipse.ui.externaltools/External Tools Base/org/eclipse/ui/externaltools/internal/registry/ExternalToolMigration.java;3;0;21;3;1;1;1;20;187;6;8;20;470;470;6;12;0;20;21;108;12;330;9;3;0
/org.eclipse.jdt.core/search/org/eclipse/jdt/internal/core/search/matching/PackageReferenceLocator.java;5;1;15;2;3;3;3;12;159;3;7;118;371;371;3;5;0;12;15;118;5;315;10;5;1
/org.eclipse.update.configurator/src/org/eclipse/update/internal/configurator/IConfigurationConstants.java;2;0;3;2;1;1;1;2;14;1;2;227;18;18;1;0;0;2;3;227;0;300;3;2;0
/org.eclipse.jdt.ui/ui/org/eclipse/jdt/internal/ui/jarpackager/ConfirmSaveModifiedResourcesDialog.java;1;0;1;1;1;1;1;0;2;0;0;336;2;2;1;0;0;0;1;336;0;336;1;1;0
/org.eclipse.osgi/core/framework/org/eclipse/osgi/framework/internal/core/BundleResourcePermission.java;4;1;5;1;3;3;3;2;152;1;2;171;160;160;1;0;0;2;5;171;0;336;5;4;0
/org.eclipse.pde.ui/src_Forms/org/eclipse/pde/internal/ui/model/build/BuildModel.java;2;5;8;2;8;3;8;0;140;0;0;283;173;173;5;0;5;0;8;283;5;336;3;2;0
/org.eclipse.ui.workbench/Eclipse UI/org/eclipse/ui/internal/themes/ThemeRegistry.java;2;0;7;1;1;1;2;5;139;3;4;206;309;309;3;1;1;6;7;265;2;283;5;2;1
/org.eclipse.ui.workbench/Eclipse UI/org/eclipse/ui/internal/ShowViewMenuAction.java;1;0;1;1;0;0;0;1;5;0;1;157;5;5;1;0;0;1;1;157;0;157;1;1;0
/org.eclipse.ui.cheatsheets/src/org/eclipse/ui/internal/cheatsheets/views/CheatSheetPage.java;1;5;11;1;7;2;7;4;115;0;1;257;202;202;5;3;5;4;11;300;8;300;3;1;0
/org.eclipse.ui.intro/src/org/eclipse/ui/internal/intro/impl/presentations/BrowserIntroPartImplementation.java;2;8;16;2;16;4;16;0;818;0;0;276;1014;1014;8;0;12;0;16;308;12;327;4;2;0
/org.eclipse.jdt.ui/ui/org/eclipse/jdt/ui/OverrideIndicatorLabelDecorator.java;2;1;8;1;4;4;4;4;52;2;3;92;157;157;2;1;0;4;8;264;1;336;7;2;1
/org.eclipse.swt/Eclipse SWT/common/org/eclipse/swt/widgets/Event.java;1;0;2;1;0;0;0;2;8;1;2;40;15;15;1;0;0;2;2;40;0;124;2;1;0
/org.eclipse.ui.workbench/Eclipse UI/org/eclipse/ui/internal/contexts/IContextRegistryListener.java;1;0;2;1;0;0;0;2;20;1;2;86;20;20;1;0;0;2;2;86;0;174;2;1;0
/org.eclipse.jdt.ui/ui refactoring/org/eclipse/jdt/internal/ui/refactoring/contentassist/JavaTypeCompletionProcessor.java;5;4;12;4;7;3;7;5;282;0;1;204;597;597;5;4;4;5;12;204;8;336;4;5;1
/org.eclipse.pde.ui/src/org/eclipse/pde/ui/templates/BaseOptionTemplateSection.java;2;2;5;1;4;3;4;1;292;0;1;222;427;427;2;0;1;1;5;276;1;336;4;2;0
/org.eclipse.jdt.core/dom/org/eclipse/jdt/core/dom/MethodDeclaration.java;5;0;18;2;1;1;5;13;638;6;8;70;888;888;6;5;4;17;18;266;9;308;9;5;3
/org.eclipse.jdt.debug/jdi/org/eclipse/jdi/internal/connect/SocketListeningConnectorImpl.java;3;0;5;1;1;1;1;4;6;1;4;11;17;17;1;0;0;4;5;11;0;336;5;3;0
/org.eclipse.ant.ui/Ant Tools Support/org/eclipse/ant/internal/ui/preferences/ClasspathEntry.java;1;0;6;1;1;1;1;5;62;2;4;128;126;126;2;1;0;5;6;128;1;299;5;1;1
/org.eclipse.jdt.ui/core refactoring/org/eclipse/jdt/internal/corext/refactoring/util/Changes.java;1;0;1;1;1;1;1;0;0;0;0;278;0;0;1;0;0;0;1;278;0;278;1;1;0
/org.eclipse.team.ui/src/org/eclipse/team/internal/ui/synchronize/SynchronizeModelElementSorter.java;1;0;2;1;1;1;1;1;2;0;1;251;2;2;1;0;0;1;2;251;0;336;2;1;0
/org.eclipse.debug.ui/ui/org/eclipse/debug/ui/IDebugEditorPresentation.java;2;1;4;1;2;2;2;2;65;0;1;72;103;103;2;1;0;2;4;72;1;336;3;2;0
/org.eclipse.ui.workbench/Eclipse UI/org/eclipse/ui/internal/registry/IViewDescriptor.java;3;0;3;1;1;1;1;2;7;1;2;54;16;16;1;0;0;2;3;54;0;336;3;3;0
/org.eclipse.jdt.core/model/org/eclipse/jdt/core/util/IRuntimeInvisibleParameterAnnotationsAttribute.java;2;0;2;1;0;0;0;2;36;1;2;245;36;36;1;0;0;2;2;245;0;264;2;2;0
/org.eclipse.core.resources/src/org/eclipse/core/internal/resources/WorkspaceTreeReader_0.java;1;0;1;1;1;1;1;0;10;0;0;277;10;10;1;0;0;0;1;277;0;277;1;1;0
/org.eclipse.jdt.core/model/org/eclipse/jdt/internal/core/util/ClassFileAttribute.java;1;0;1;1;0;0;0;1;2;0;1;199;2;2;1;0;0;1;1;199;0;199;1;1;0
/org.eclipse.osgi/core/adaptor/org/eclipse/osgi/framework/util/FrameworkMessageFormat.java;1;1;2;1;2;2;2;0;1;0;0;281;1;1;1;0;0;0;2;281;0;309;2;1;0
/org.eclipse.ui.workbench.texteditor/src/org/eclipse/ui/internal/texteditor/quickdiff/compare/rangedifferencer/DocLineComparator.java;3;1;5;1;2;2;2;3;152;1;3;100;277;277;1;0;0;3;5;100;0;336;5;3;0
/org.eclipse.ant.ui/Ant Tools Support/org/eclipse/ant/internal/ui/model/AntUIImages.java;3;3;18;2;4;2;4;14;15;6;4;108;47;47;6;10;2;14;18;236;12;294;6;3;2
/org.eclipse.jdt.ui/core refactoring/org/eclipse/jdt/internal/corext/refactoring/nls/NLSPropertyFileModifier.java;3;5;9;2;9;4;9;0;266;0;0;279;496;496;5;0;5;0;9;279;5;336;4;3;0
/org.eclipse.swt/Eclipse SWT Browser/common/org/eclipse/swt/browser/WindowEvent.java;2;0;5;1;1;1;1;4;83;2;3;179;94;94;2;1;0;4;5;188;1;337;4;2;0
/org.eclipse.pde.ui/src/org/eclipse/pde/internal/ui/view/DependenciesView.java;2;1;7;1;3;3;3;4;13;1;4;26;47;47;1;0;0;4;7;26;0;336;7;2;0
/org.eclipse.ui.ide/src/org/eclipse/ui/views/markers/internal/IItemsChangedListener.java;1;0;1;1;0;0;0;1;0;0;1;129;0;0;1;0;0;1;1;129;0;129;1;1;0
/org.eclipse.core.resources/src/org/eclipse/core/internal/resources/MarkerSnapshotReader_1.java;1;0;1;1;1;1;1;0;175;0;0;277;175;175;1;0;0;0;1;277;0;277;1;1;0
/org.eclipse.core.expressions/src/org/eclipse/core/internal/expressions/TestExpression.java;1;1;5;1;2;2;2;3;8;2;2;227;20;20;2;1;0;3;5;227;1;336;4;1;0
/org.eclipse.osgi/osgi/src/org/eclipse/osgi/service/resolver/State.java;4;2;13;3;4;3;5;8;44;5;4;171;165;165;5;4;2;9;13;171;6;336;7;4;0
/org.eclipse.jdt.junit.runtime/src/org/eclipse/jdt/internal/junit/runner/MessageIds.java;2;0;3;1;1;1;1;2;28;1;2;82;30;30;1;0;0;2;3;82;0;336;3;2;0
/org.eclipse.swt/Eclipse SWT PI/photon/org/eclipse/swt/internal/photon/PtWebStatusCallback_t.java;1;0;1;1;0;0;0;1;0;0;1;122;0;0;1;0;0;1;1;122;0;122;1;1;0
/org.eclipse.ant.ui/Ant Tools Support/org/eclipse/ant/internal/ui/preferences/StatusDialog.java;1;0;3;1;0;0;0;3;6;0;1;108;6;6;3;2;0;3;3;108;2;108;1;1;1
/org.eclipse.jdt.debug/model/org/eclipse/jdt/internal/debug/core/breakpoints/JavaMethodEntryBreakpoint.java;1;0;1;1;0;0;0;1;2;0;1;157;2;2;1;0;0;1;1;157;0;157;1;1;2
/org.eclipse.jface/src/org/eclipse/jface/action/ICoolBarManager.java;5;1;6;2;2;2;2;4;188;2;2;181;287;287;2;2;0;4;6;181;2;336;4;5;0
/org.eclipse.jdt.ui/core refactoring/org/eclipse/jdt/internal/corext/refactoring/rename/TextMatchUpdater.java;2;1;5;1;3;3;3;2;21;0;1;250;37;37;2;1;0;2;5;250;1;336;4;2;1
/org.eclipse.jdt.ui/ui/org/eclipse/jdt/internal/ui/preferences/JavaEditorPreferencePage.java;6;1;50;5;2;2;18;32;1970;20;10;41;2921;2921;20;22;16;48;50;262;38;336;12;6;0
/org.eclipse.swt/Eclipse SWT Mozilla/common/org/eclipse/swt/internal/mozilla/nsIWindowCreator.java;1;0;2;1;0;0;0;2;2;1;2;111;2;2;1;0;0;2;2;111;0;148;2;1;0
/org.eclipse.search/new search/org/eclipse/search2/internal/ui/basic/views/CollapseAllAction.java;2;1;2;1;2;2;2;0;4;0;0;292;4;4;1;0;0;0;2;292;0;336;2;2;0
/org.eclipse.jdt.core/model/org/eclipse/jdt/internal/core/BufferManager.java;2;0;9;1;0;0;0;9;37;3;5;55;74;74;3;4;0;9;9;55;4;199;5;2;0
/org.eclipse.jdt.core/compiler/org/eclipse/jdt/internal/compiler/flow/FlowInfo.java;2;0;3;1;0;0;0;3;25;1;3;61;35;35;1;0;0;3;3;61;0;199;3;2;0
/org.eclipse.jdt.debug.ui/ui/org/eclipse/jdt/internal/debug/ui/jres/BuildJREDescriptor.java;2;0;3;1;0;0;0;3;13;2;2;67;20;20;2;1;0;3;3;67;1;264;2;2;0
/org.eclipse.jdt.ui/ui/org/eclipse/jdt/internal/ui/text/BufferedDocumentScanner.java;1;0;1;1;1;1;1;0;2;0;0;336;2;2;1;0;0;0;1;336;0;336;1;1;0
/org.eclipse.core.runtime/src/org/eclipse/core/internal/runtime/PlatformLogWriter.java;5;0;9;2;2;1;2;7;1061;3;4;171;1386;1386;3;3;1;7;9;171;4;276;5;5;0
/org.eclipse.team.cvs.ui/src/org/eclipse/team/internal/ccvs/ui/merge/MergeWizard.java;2;5;21;2;6;2;8;13;94;4;10;52;363;363;5;3;6;15;21;288;9;336;12;2;0
/org.eclipse.jdt.debug/jdi/org/eclipse/jdi/internal/PrimitiveValueImpl.java;1;0;1;1;0;0;0;1;8;0;1;78;8;8;1;0;0;1;1;78;0;78;1;1;0
/org.eclipse.pde.ui/src/org/eclipse/pde/internal/ui/editor/feature/FeatureMatchSection.java;3;2;6;2;5;3;5;1;41;0;1;232;83;83;2;0;2;1;6;308;2;332;4;3;0
/org.eclipse.jdt.ui/core refactoring/org/eclipse/jdt/internal/corext/refactoring/base/RefactoringStatusCodes.java;2;0;2;1;1;1;1;1;2;0;1;198;4;4;1;0;0;1;2;198;0;336;2;2;0
/org.eclipse.ui.ide/src/org/eclipse/ui/internal/ide/dialogs/NewProjectWizard.java;2;0;2;1;0;0;0;2;1;1;2;132;1;1;1;0;0;2;2;132;0;158;2;2;0
/org.eclipse.jdt.core/dom/org/eclipse/jdt/core/dom/AnnotationTypeMemberDeclaration.java;3;3;12;1;4;2;4;8;435;4;4;225;503;503;4;4;2;8;12;225;6;312;6;3;2
/org.eclipse.ui.workbench/Eclipse UI/org/eclipse/ui/part/MessagePage.java;2;0;2;1;1;1;1;1;12;0;1;265;14;14;1;0;0;1;2;265;0;336;2;2;0
/org.eclipse.jdt.ui/ui/org/eclipse/jdt/internal/ui/viewsupport/StatusBarUpdater.java;1;0;1;1;1;1;1;0;2;0;0;336;2;2;1;0;0;0;1;336;0;336;1;1;0
/org.eclipse.jdt.ui/ui/org/eclipse/jdt/internal/ui/text/spelling/engine/ISpellEvent.java;2;0;3;2;1;1;1;2;12;0;1;219;14;14;2;1;0;2;3;219;1;336;2;2;0
/org.eclipse.ui.workbench/Eclipse UI/org/eclipse/ui/presentations/StackDropResult.java;2;1;3;1;2;2;2;1;29;0;1;245;54;54;1;0;0;1;3;245;0;303;3;2;0
/org.eclipse.jdt.ui/ui/org/eclipse/jdt/internal/ui/text/HTMLPrinter.java;1;1;5;1;3;3;3;2;54;0;1;49;141;141;2;1;0;2;5;49;1;336;4;1;0
/org.eclipse.swt/Eclipse SWT Mozilla/common/org/eclipse/swt/internal/mozilla/nsIPref.java;1;0;2;1;0;0;0;2;70;1;2;100;70;70;1;0;0;2;2;100;0;148;2;1;0
/org.eclipse.swt/Eclipse SWT PI/win32/org/eclipse/swt/internal/win32/SCRIPT_LOGATTR.java;2;0;2;1;1;1;1;1;4;0;1;250;4;4;1;0;0;1;2;250;0;337;2;2;0
/org.eclipse.jdt.debug.ui/ui/org/eclipse/jdt/internal/debug/ui/propertypages/JavaExceptionBreakpointAdvancedPage.java;2;0;3;1;1;1;1;2;5;1;2;82;8;8;1;0;0;2;3;82;0;299;3;2;0
/org.eclipse.pde.ui/src/org/eclipse/pde/internal/ui/editor/site/NewArchiveDialog.java;1;0;3;1;1;1;1;2;50;1;2;134;67;67;1;0;0;2;3;134;0;336;3;1;0
/org.eclipse.update.ui/src/org/eclipse/update/internal/ui/AddBookmarksAction.java;3;0;3;2;0;0;0;3;18;2;2;54;27;27;2;1;0;3;3;54;1;268;2;3;0
/org.eclipse.core.resources/src/org/eclipse/core/internal/watson/IDeltaVisitor.java;1;0;1;1;1;1;1;0;31;0;0;277;31;31;1;0;0;0;1;277;0;277;1;1;0
/org.eclipse.swt/Eclipse SWT/emulated/tray/org/eclipse/swt/widgets/TrayItem.java;2;0;2;1;1;1;1;1;144;0;1;250;144;144;1;0;0;1;2;250;0;300;2;2;0
/org.eclipse.pde.core/src/org/eclipse/pde/internal/core/ModelEntry.java;3;2;14;2;6;4;6;8;120;3;5;129;228;228;3;3;2;8;14;154;5;332;9;3;0
/org.eclipse.team.cvs.ui/src/org/eclipse/team/internal/ccvs/ui/model/CVSRootFolderElement.java;1;0;3;1;1;1;1;2;2;1;2;63;6;6;1;0;0;2;3;63;0;336;3;1;0
/org.eclipse.ui.ide/src/org/eclipse/ui/ide/IDEActionFactory.java;5;4;19;2;7;3;7;12;178;3;7;99;485;485;4;5;4;12;19;294;9;336;10;5;3
/org.eclipse.debug.ui/ui/org/eclipse/debug/internal/ui/views/memory/HexRenderer.java;2;0;2;2;2;1;2;0;59;0;0;282;59;59;2;0;1;0;2;282;1;282;1;2;2
/org.eclipse.compare/compare/org/eclipse/compare/internal/patch/InputPatchPage.java;1;1;5;1;2;2;2;3;13;1;3;79;26;26;1;0;0;3;5;79;0;322;5;1;0
/org.eclipse.jdt.ui/ui/org/eclipse/jdt/internal/ui/compare/PropertiesStructureCreator.java;2;0;6;2;3;1;3;3;9;1;3;18;20;20;3;0;2;3;6;330;2;330;4;2;0
/org.eclipse.jdt.debug.ui/Snippet Support/org/eclipse/jdt/internal/debug/ui/snippeteditor/ScrapbookMain1.java;1;0;1;1;0;0;0;1;0;0;1;49;0;0;1;0;0;1;1;49;0;49;1;1;0
/org.eclipse.jdt.debug.ui/ui/org/eclipse/jdt/internal/debug/ui/console/JavaStackTraceHyperlink.java;1;2;3;1;3;2;3;0;107;0;0;274;112;112;2;0;1;0;3;274;1;321;2;1;1
/org.eclipse.jdt.ui/core extension/org/eclipse/jdt/internal/corext/util/TypeInfoRequestor.java;2;0;2;1;1;1;1;1;18;0;1;179;20;20;1;0;0;1;2;179;0;336;2;2;0
/org.eclipse.team.core/src/org/eclipse/team/core/variants/ThreeWayRemoteTree.java;1;1;3;1;2;2;2;1;28;0;1;239;32;32;1;0;0;1;3;239;0;325;3;1;0
/org.eclipse.jface.text/src/org/eclipse/jface/text/source/SourceViewerConfiguration.java;2;2;7;2;3;2;3;4;28;1;4;80;68;68;2;0;1;4;7;336;1;336;6;2;0
/org.eclipse.jdt.ui/ui/org/eclipse/jdt/internal/ui/text/javadoc/ICommentTagConstants.java;2;0;2;1;1;1;1;1;6;0;1;212;6;6;1;0;0;1;2;212;0;336;2;2;0
/org.eclipse.debug.ui/ui/org/eclipse/debug/ui/ILaunchGroup.java;1;0;1;1;1;1;1;0;0;0;0;280;0;0;1;0;0;0;1;280;0;280;1;1;0
/org.eclipse.pde/src/org/eclipse/pde/internal/builders/SchemaHandler.java;2;1;6;1;3;3;3;3;10;1;3;166;30;30;1;0;0;3;6;166;0;336;6;2;0
/org.eclipse.help.base/src/org/eclipse/help/internal/search/ProgressDistributor.java;1;1;3;1;2;2;2;1;15;0;1;104;21;21;1;0;0;1;3;104;0;336;3;1;0
/org.eclipse.update.scheduler/src/org/eclipse/update/internal/scheduler/UpdateScheduler.java;3;2;13;2;4;3;4;9;420;4;3;62;713;713;4;6;1;9;13;250;7;336;6;3;0
/org.eclipse.debug.ui/ui/org/eclipse/debug/internal/ui/actions/ShowTypesAction.java;1;0;1;1;0;0;0;1;3;0;1;76;3;3;1;0;0;1;1;76;0;76;1;1;0
/org.eclipse.ant.ui/Ant Editor/org/eclipse/ant/internal/ui/dtd/schema/Atom.java;1;0;1;1;0;0;0;1;0;0;1;108;0;0;1;0;0;1;1;108;0;108;1;1;0
/org.eclipse.debug.core/core/org/eclipse/debug/core/sourcelookup/ISourceLookupDirector.java;1;0;3;1;0;0;2;1;66;0;1;268;66;66;3;0;2;3;3;268;2;268;1;1;0
/org.eclipse.jdt.core/model/org/eclipse/jdt/core/util/OpcodeStringValues.java;1;0;1;1;0;0;0;1;2;0;1;199;2;2;1;0;0;1;1;199;0;199;1;1;0
/org.eclipse.jdt.ui/ui/org/eclipse/jdt/internal/ui/text/spelling/engine/AbstractSpellDictionary.java;2;0;2;1;1;1;1;1;2;0;1;219;2;2;1;0;0;1;2;219;0;336;2;2;0
/org.eclipse.jface/src/org/eclipse/jface/action/ToolBarManager.java;5;0;6;2;1;1;1;5;524;2;3;0;534;534;2;2;0;5;6;181;2;336;4;5;0
/org.eclipse.ui.ide/extensions/org/eclipse/ui/actions/CopyFilesAndFoldersOperation.java;3;0;3;1;1;1;1;2;5;1;2;132;7;7;1;0;0;2;3;132;0;336;3;3;0
/org.eclipse.jdt.core/formatter/org/eclipse/jdt/internal/formatter/OptimizedReplaceEdit.java;2;0;2;1;0;0;0;2;2;1;2;127;2;2;1;0;0;2;2;127;0;199;2;2;0
/org.eclipse.jface/src/org/eclipse/jface/dialogs/ErrorDialog.java;3;0;9;3;6;1;6;3;432;2;2;0;478;478;6;1;5;3;9;286;6;286;3;3;1
/org.eclipse.jdt.core/compiler/org/eclipse/jdt/internal/compiler/flow/InsideSubRoutineFlowContext.java;2;0;5;1;0;0;0;5;7;1;5;11;17;17;1;0;0;5;5;11;0;199;5;2;0
/org.eclipse.team.ui/src/org/eclipse/team/internal/ui/synchronize/GlobalRefreshResourceSelectionPage.java;2;4;8;2;8;3;8;0;437;0;0;288;626;626;4;0;5;0;8;309;5;336;3;2;0
/org.eclipse.jface.text/src/org/eclipse/jface/text/information/IInformationProviderExtension.java;1;0;2;1;2;1;2;0;8;0;0;336;8;8;2;0;1;0;2;336;1;336;1;1;0
/org.eclipse.jdt.ui/ui refactoring/org/eclipse/jdt/internal/ui/refactoring/actions/MoveInstanceMethodAction.java;3;0;10;1;1;1;2;8;74;2;7;11;182;182;2;1;1;9;10;70;2;336;8;3;0
/org.eclipse.pde.ui/src/org/eclipse/pde/internal/ui/editor/feature/PluginSection.java;3;2;9;2;4;3;4;5;98;2;4;44;195;195;2;1;1;5;9;130;2;336;7;3;0
/org.eclipse.jdt.debug.ui/ui/org/eclipse/jdt/internal/debug/core/refactoring/LaunchConfigurationIPackageFragmentMoveParticipant.java;2;1;2;1;2;2;2;0;9;0;0;320;11;11;1;0;0;0;2;320;0;336;2;2;0
/org.eclipse.swt/Eclipse SWT Drag and Drop/carbon/org/eclipse/swt/dnd/Clipboard.java;2;1;8;1;2;2;2;6;127;3;4;0;263;263;3;2;0;6;8;21;2;337;6;2;0
/org.eclipse.jdt.ui/ui/org/eclipse/jdt/internal/ui/text/java/ExperimentalResultCollector.java;2;0;3;1;1;1;1;2;6;1;2;76;10;10;1;0;0;2;3;76;0;336;3;2;0
/org.eclipse.ui.ide/src/org/eclipse/ui/views/navigator/ResourceNavigatorActionGroup.java;2;0;2;1;0;0;0;2;2;1;2;129;2;2;1;0;0;2;2;129;0;187;2;2;0
/org.eclipse.jdt.core/compiler/org/eclipse/jdt/internal/compiler/ast/ForStatement.java;3;0;10;2;2;1;2;8;80;3;4;61;141;141;3;4;1;8;10;61;5;287;5;3;1
/org.eclipse.core.filebuffers/src/org/eclipse/core/filebuffers/FileBuffers.java;2;2;10;2;4;2;4;6;63;2;4;93;158;158;2;2;2;6;10;93;4;334;6;2;0
/org.eclipse.swt/Eclipse SWT/common/org/eclipse/swt/internal/image/GIFFileFormat.java;1;0;1;1;0;0;0;1;7;0;1;34;7;7;1;0;0;1;1;34;0;34;1;1;0
/org.eclipse.jdt.ui/ui/org/eclipse/jdt/internal/ui/wizards/buildpaths/EditVariableEntryDialog.java;2;1;3;1;2;2;2;1;25;0;1;82;31;31;1;0;0;1;3;82;0;336;3;2;0
/org.eclipse.help/src/org/eclipse/help/internal/toc/Topic.java;1;1;10;1;3;3;3;7;70;4;2;41;162;162;4;5;0;7;10;197;5;336;5;1;0
/org.eclipse.ant.core/src/org/eclipse/ant/core/Property.java;1;1;6;1;2;2;2;4;94;1;4;85;175;175;1;0;0;4;6;85;0;336;6;1;1
/org.eclipse.ui.workbench/Eclipse UI/org/eclipse/ui/IWorkbenchPartReference.java;2;3;4;1;4;2;4;0;23;0;0;309;25;25;3;0;2;0;4;309;2;336;2;2;0
/org.eclipse.ant.ui/Ant Editor/org/eclipse/ant/internal/ui/editor/text/AbstractAntEditorScanner.java;1;0;1;1;1;1;1;0;0;0;0;306;0;0;1;0;0;0;1;306;0;306;1;1;1
/org.eclipse.pde.core/src/org/eclipse/pde/internal/core/site/SiteFeature.java;2;1;4;1;2;2;2;2;198;1;2;134;255;255;1;0;0;2;4;134;0;336;4;2;0
/org.eclipse.pde.ui/src/org/eclipse/pde/internal/ui/search/FindPluginReferencesAction.java;2;1;3;1;2;2;2;1;18;0;1;0;32;32;1;0;0;1;3;0;0;336;3;2;0
/org.eclipse.jdt.ui/ui/org/eclipse/jdt/internal/ui/preferences/FoldingConfigurationBlock.java;1;1;2;1;2;2;2;0;2;0;0;292;2;2;1;0;0;0;2;292;0;336;2;1;0
/org.eclipse.jdt.debug.ui/ui/org/eclipse/jdt/debug/ui/launchConfigurations/AppletParametersTab.java;4;1;7;2;2;2;2;5;92;2;4;8;136;136;2;1;0;5;7;149;1;336;6;4;0
/org.eclipse.swt/Eclipse SWT OLE Win32/win32/org/eclipse/swt/ole/win32/OlePropertyChangeSink.java;2;1;2;1;2;2;2;0;4;0;0;316;6;6;1;0;0;0;2;316;0;337;2;2;0
/org.eclipse.core.resources/src/org/eclipse/core/internal/resources/ProjectNatureDescriptor.java;2;0;2;1;1;1;1;1;214;0;1;90;216;216;1;0;0;1;2;90;0;277;2;2;0
/org.eclipse.update.ui/src/org/eclipse/update/internal/ui/wizards/InstallWizard.java;4;1;18;3;4;4;4;14;842;4;7;50;1907;1907;4;7;0;14;18;50;7;336;11;4;1
/org.eclipse.jdt.core/dom/org/eclipse/jdt/core/dom/SimplePropertyDescriptor.java;2;0;2;1;1;1;1;1;4;0;1;232;4;4;1;0;0;1;2;232;0;312;2;2;0
/org.eclipse.osgi/eclipseAdaptor/src/org/eclipse/osgi/framework/stats/ResourceBundleStats.java;3;1;3;1;2;2;2;1;20;0;1;171;24;24;1;0;0;1;3;171;0;336;3;3;0
/org.eclipse.debug.ui/ui/org/eclipse/debug/ui/EnvironmentTab.java;4;4;32;3;5;2;5;27;325;5;12;19;988;988;5;15;3;27;32;74;18;311;14;4;0
/org.eclipse.ui.workbench/Eclipse UI/org/eclipse/ui/commands/ActionHandler.java;2;1;8;2;2;2;2;6;191;4;2;226;294;294;4;4;0;6;8;262;4;292;4;2;1
/org.eclipse.swt/Eclipse SWT Mozilla/common/org/eclipse/swt/internal/mozilla/nsIEventSink.java;1;0;1;1;0;0;0;1;0;0;1;102;0;0;1;0;0;1;1;102;0;102;1;1;0
/org.eclipse.search/new search/org/eclipse/search2/internal/ui/text/MarkerHighlighter.java;1;2;5;1;5;3;5;0;22;0;0;295;53;53;2;0;2;0;5;295;2;323;3;1;0
/org.eclipse.team.cvs.ui/src/org/eclipse/team/internal/ccvs/ui/repo/NewDateTagAction.java;2;1;3;1;2;2;2;1;57;0;1;148;59;59;1;0;0;1;3;148;0;336;3;2;0
/org.eclipse.jdt.ui/core refactoring/org/eclipse/jdt/internal/corext/refactoring/code/SourceAnalyzer.java;3;1;10;2;2;2;2;8;47;3;6;41;86;86;3;2;0;8;10;52;2;336;8;3;0
/org.eclipse.ant.ui/Ant Tools Support/org/eclipse/ant/internal/ui/views/actions/AddBuildFilesAction.java;2;1;3;1;2;2;2;1;10;0;1;178;12;12;1;0;0;1;3;178;0;321;3;2;1
/org.eclipse.jdt.core/model/org/eclipse/jdt/core/util/IMethodInfo.java;1;0;2;1;0;0;0;2;10;1;2;199;12;12;1;0;0;2;2;199;0;264;2;1;0
/org.eclipse.core.resources/src/org/eclipse/core/resources/team/IMoveDeleteHook.java;1;0;3;1;0;0;2;1;100;0;1;270;100;100;3;0;2;3;3;270;2;270;1;1;0
/org.eclipse.ui.workbench/Eclipse UI/org/eclipse/ui/internal/progress/TaskInfo.java;2;1;12;1;2;2;2;10;88;2;7;23;191;191;2;3;0;10;12;69;3;336;9;2;1
/org.eclipse.jdt.ui/ui/org/eclipse/jdt/internal/ui/javaeditor/InternalClassFileEditorInput.java;1;0;1;1;1;1;1;0;2;0;0;336;2;2;1;0;0;0;1;336;0;336;1;1;0
/org.eclipse.ui.ide/src/org/eclipse/ui/views/bookmarkexplorer/CopyBookmarkAction.java;1;0;2;1;0;0;0;2;4;0;1;129;4;4;2;1;0;2;2;129;1;129;1;1;0
/org.eclipse.jdt.ui/core refactoring/org/eclipse/jdt/internal/corext/refactoring/rename/RenameFieldProcessor.java;4;2;29;2;5;4;10;19;476;7;8;71;770;770;7;11;6;24;29;243;17;336;12;4;1
/org.eclipse.ltk.ui.refactoring/src/org/eclipse/ltk/ui/refactoring/IStatusContextViewer.java;1;0;4;1;2;1;2;2;27;0;1;269;40;40;2;1;1;2;4;269;2;335;2;1;0
/org.eclipse.jdt.ui/core extension/org/eclipse/jdt/internal/corext/dom/OldASTRewrite.java;2;1;3;1;2;2;2;1;79;0;1;262;95;95;1;0;0;1;3;262;0;336;3;2;0
/org.eclipse.ltk.ui.refactoring/src/org/eclipse/ltk/ui/refactoring/RefactoringUI.java;1;1;10;1;3;3;8;2;114;0;1;269;150;150;7;1;5;7;10;269;6;335;4;1;0
/org.eclipse.debug.ui/ui/org/eclipse/debug/ui/sourcelookup/AbstractSourceContainerBrowser.java;1;0;1;1;0;0;0;1;0;0;1;269;0;0;1;0;0;1;1;269;0;269;1;1;0
/org.eclipse.jdt.ui/core refactoring/org/eclipse/jdt/internal/corext/refactoring/reorg/INewNameQuery.java;1;0;1;1;1;1;1;0;2;0;0;336;2;2;1;0;0;0;1;336;0;336;1;1;0
/org.eclipse.ui.workbench.compatibility/src/org/eclipse/ui/internal/CompatibleWorkbenchPage.java;2;0;3;1;1;1;1;2;7;0;1;188;9;9;2;1;0;2;3;188;1;335;2;2;0
/org.eclipse.ui.externaltools/External Tools Base/org/eclipse/ui/externaltools/internal/ui/BuilderPropertyPage.java;3;2;29;3;3;2;3;26;435;8;8;2;1486;1486;8;18;1;26;29;222;19;324;10;3;2
/org.eclipse.swt/Eclipse SWT Browser/common/org/eclipse/swt/browser/LocationListener.java;2;0;8;1;1;1;1;7;33;2;5;100;99;99;2;2;0;7;8;100;2;337;6;2;0
/org.eclipse.pde.core/src/org/eclipse/pde/core/plugin/IExtensionsModelFactory.java;2;2;4;1;3;2;3;1;34;0;1;128;38;38;2;0;1;1;4;276;1;336;3;2;0
/org.eclipse.swt/Eclipse SWT PI/win32/org/eclipse/swt/internal/ole/win32/CAUUID.java;1;0;1;1;0;0;0;1;2;0;1;166;2;2;1;0;0;1;1;166;0;166;1;1;0
/org.eclipse.jdt.ui/ui/org/eclipse/jdt/internal/ui/util/ISelectionConverter.java;1;0;1;1;0;0;0;1;0;0;1;251;0;0;1;0;0;1;1;251;0;251;1;1;0
/org.eclipse.team.cvs.core/src/org/eclipse/team/internal/ccvs/core/connection/ExtConnection.java;1;0;2;1;0;0;0;2;6;1;2;111;8;8;1;0;0;2;2;111;0;124;2;1;0
/org.eclipse.ui.workbench/Eclipse UI/org/eclipse/ui/internal/keys/WorkbenchKeyboard.java;3;2;32;2;5;3;5;27;1617;11;6;171;3409;3409;11;21;2;27;32;171;23;330;9;3;3
/org.eclipse.core.runtime/src/org/eclipse/core/internal/preferences/PreferenceForwarder.java;2;2;11;2;5;3;5;6;155;4;2;239;374;374;4;4;2;6;11;250;6;303;5;2;2
/org.eclipse.debug.ui/ui/org/eclipse/debug/internal/ui/views/memory/MemoryBlockViewSynchronizer.java;2;1;2;1;2;2;2;0;42;0;0;282;42;42;1;0;0;0;2;282;0;290;2;2;2
/org.eclipse.debug.ui/ui/org/eclipse/debug/internal/ui/views/memory/ISynchronizedMemoryBlockView.java;1;0;1;1;1;1;1;0;0;0;0;282;0;0;1;0;0;0;1;282;0;282;1;1;2
/org.eclipse.ui.workbench/Eclipse UI/org/eclipse/ui/internal/keys/KeyBindingState.java;2;0;4;2;0;0;0;4;229;0;1;172;229;229;4;3;0;4;4;172;3;172;1;2;0
/org.eclipse.team.ui/src/org/eclipse/team/ui/synchronize/ISynchronizePageSite.java;2;3;4;2;4;2;4;0;116;0;0;272;116;116;3;0;2;0;4;288;2;288;2;2;0
/org.eclipse.ant.ui/Ant Editor/org/eclipse/ant/internal/ui/editor/text/XMLReconcilingStrategy.java;1;0;6;1;0;0;0;6;60;3;3;108;93;93;3;3;0;6;6;252;3;252;3;1;3
/org.eclipse.pde.build/src/org/eclipse/pde/internal/build/builder/ClasspathComputer3_0.java;2;5;10;2;9;3;9;1;373;0;1;230;458;458;5;0;6;1;10;294;6;320;4;2;0
/org.eclipse.debug.ui/ui/org/eclipse/debug/internal/ui/DelegatingModelPresentation.java;4;1;12;3;4;4;4;8;86;3;4;72;244;244;3;4;0;8;12;72;4;336;8;4;0
/org.eclipse.ui.workbench/Eclipse UI/org/eclipse/ui/internal/WorkbenchImages.java;6;1;13;4;3;3;3;10;496;6;5;157;673;673;6;5;0;10;13;241;5;336;8;6;1
/org.eclipse.ui.ide/src/org/eclipse/ui/views/markers/internal/BookmarkMarker.java;1;0;1;1;0;0;0;1;0;0;1;181;0;0;1;0;0;1;1;181;0;181;1;1;0
/org.eclipse.ui.workbench/Eclipse UI/org/eclipse/ui/internal/misc/Policy.java;5;1;9;1;2;2;2;7;42;2;6;13;64;64;2;1;0;7;9;199;1;336;8;5;3
/org.eclipse.pde.ui/src/org/eclipse/pde/internal/ui/editor/site/SiteInputContextManager.java;2;2;3;2;3;2;3;0;10;0;0;292;14;14;2;0;1;0;3;292;1;336;2;2;0
/org.eclipse.jdt.debug.ui/ui/org/eclipse/jdt/internal/debug/ui/JavaSourceLocationWorkbenchAdapterFactory.java;2;1;3;1;2;2;2;1;4;0;1;157;9;9;1;0;0;1;3;157;0;336;3;2;0
/org.eclipse.jdt.core/model/org/eclipse/jdt/core/IClasspathEntry.java;2;0;4;2;0;0;0;4;195;2;3;149;207;207;2;1;0;4;4;266;1;266;3;2;0
/org.eclipse.ui.ide/src/org/eclipse/ui/views/markers/internal/TaskFilter.java;2;0;2;1;0;0;0;2;31;1;2;129;31;31;1;0;0;2;2;129;0;181;2;2;0
/org.eclipse.ui.workbench/Eclipse UI/org/eclipse/ui/internal/registry/RegistryManager.java;3;1;7;3;2;2;2;5;52;0;1;250;83;83;5;4;0;5;7;250;4;323;3;3;0
/org.eclipse.jdt.ui/ui/org/eclipse/jdt/internal/ui/wizards/buildpaths/ClasspathContainerDescriptor.java;3;1;3;1;3;3;3;0;34;0;0;278;40;40;1;0;0;0;3;278;0;336;3;3;0
/org.eclipse.jdt.ui/ui/org/eclipse/jdt/internal/ui/search/OccurrencesGroupKey.java;1;0;1;1;0;0;0;1;0;0;1;266;0;0;1;0;0;1;1;266;0;266;1;1;0
/org.eclipse.jdt.core/model/org/eclipse/jdt/internal/core/util/InnerClassesAttributeEntry.java;1;0;1;1;0;0;0;1;2;0;1;199;2;2;1;0;0;1;1;199;0;199;1;1;0
/org.eclipse.pde.ui/src/org/eclipse/pde/internal/ui/search/JavaSearchOperation.java;2;1;3;1;2;2;2;1;12;0;1;168;26;26;1;0;0;1;3;168;0;336;3;2;0
/org.eclipse.swt/Eclipse SWT Printing/gtk/org/eclipse/swt/printing/PrintDialog.java;1;1;2;1;2;2;2;0;8;0;0;300;12;12;1;0;0;0;2;300;0;337;2;1;0
/org.eclipse.core.runtime/src/org/eclipse/core/runtime/IAdapterFactory.java;2;1;5;2;2;2;2;3;208;0;1;171;213;213;3;2;0;3;5;171;2;336;3;2;0
/org.eclipse.pde.core/src/org/eclipse/pde/internal/core/ICoreConstants.java;3;1;4;1;2;2;2;2;24;1;2;134;30;30;1;0;0;2;4;134;0;336;4;3;0
/org.eclipse.core.resources/src/org/eclipse/core/resources/IProjectNatureDescriptor.java;1;0;2;1;0;0;1;1;122;0;1;270;122;122;2;0;1;2;2;270;1;270;1;1;0
/org.eclipse.jdt.debug.ui/ui/org/eclipse/jdt/internal/debug/ui/IJavaDebugHelpContextIds.java;3;0;4;1;0;0;0;4;6;2;3;93;9;9;2;1;0;4;4;264;1;264;3;3;0
/org.eclipse.update.core/src/org/eclipse/update/core/model/FeatureModelFactory.java;2;2;4;1;3;2;3;1;12;0;1;58;25;25;2;0;1;1;4;290;1;336;3;2;0
/org.eclipse.swt/Eclipse SWT PI/motif/org/eclipse/swt/internal/motif/XExposeEvent.java;1;0;1;1;0;0;0;1;11;0;1;56;11;11;1;0;0;1;1;56;0;56;1;1;0
/org.eclipse.core.runtime/src/org/eclipse/core/internal/runtime/PlatformActivator.java;5;9;44;5;14;3;14;30;975;13;3;173;1717;1717;13;27;11;30;44;203;38;331;6;5;0
/org.eclipse.jdt.ui/core refactoring/org/eclipse/jdt/internal/corext/refactoring/code/SnippetFinder.java;3;2;9;2;3;2;3;6;58;2;4;10;168;168;2;2;1;6;9;46;3;336;6;3;0
/org.eclipse.pde.ui/src/org/eclipse/pde/ui/templates/ITemplateSection.java;2;2;6;1;4;3;4;2;194;1;2;159;325;325;2;0;1;2;6;276;1;336;5;2;0
/org.eclipse.ant.ui/Ant Tools Support/org/eclipse/ant/internal/ui/preferences/IClasspathEntry.java;1;0;4;1;0;0;0;4;29;2;3;133;38;38;2;1;0;4;4;148;1;163;3;1;0
/org.eclipse.team.cvs.core/src/org/eclipse/team/internal/ccvs/core/client/Add.java;1;0;2;1;0;0;0;2;19;1;2;101;23;23;1;0;0;2;2;101;0;110;2;1;0
/org.eclipse.debug.ui/ui/org/eclipse/debug/ui/ILaunchConfigurationDialog.java;1;0;1;1;0;0;0;1;3;0;1;107;3;3;1;0;0;1;1;107;0;107;1;1;0
/org.eclipse.jdt.ui/ui/org/eclipse/jdt/internal/ui/filters/StaticsFilter.java;1;0;2;1;1;1;1;1;2;0;1;133;2;2;1;0;0;1;2;133;0;336;2;1;0
/org.eclipse.jdt.core/dom/org/eclipse/jdt/core/dom/ClassInstanceCreation.java;4;0;17;2;2;1;6;11;320;9;4;199;606;606;9;7;5;15;17;258;12;308;5;4;2
/org.eclipse.jdt.core/dom/org/eclipse/jdt/internal/core/dom/rewrite/ASTRewriteFlattener.java;2;0;3;1;2;1;2;1;319;0;1;262;319;319;2;0;1;1;3;290;1;290;2;2;2
/org.eclipse.jface.text/src/org/eclipse/jface/text/JFaceTextMessages.java;1;0;1;1;1;1;1;0;2;0;0;336;2;2;1;0;0;0;1;336;0;336;1;1;0
/org.eclipse.pde.ui/src/org/eclipse/pde/internal/ui/editor/MultiSourceEditor.java;2;1;2;2;2;2;2;0;10;0;0;292;12;12;1;0;0;0;2;292;0;336;2;2;0
/org.eclipse.jface.text/src/org/eclipse/jface/text/reconciler/IReconcilableModel.java;1;0;3;1;2;1;2;1;19;0;1;99;19;19;2;0;1;1;3;336;1;336;2;1;0
/org.eclipse.jface.text/src/org/eclipse/jface/text/contentassist/CompletionProposal.java;2;0;3;1;2;1;2;1;24;0;1;232;26;26;2;0;1;1;3;336;1;336;2;2;0
/org.eclipse.ant.ui/Ant Editor/org/eclipse/ant/internal/ui/editor/text/AntDocumentFactory.java;1;0;1;1;1;1;1;0;0;0;0;273;0;0;1;0;0;0;1;273;0;273;1;1;0
/org.eclipse.ui.workbench.texteditor/src/org/eclipse/ui/texteditor/ResourceAction.java;1;1;3;1;2;2;2;1;2;0;1;268;6;6;1;0;0;1;3;268;0;336;3;1;0
/org.eclipse.ui.workbench/Eclipse UI/org/eclipse/ui/internal/commands/CommandRegistryEvent.java;1;0;8;1;0;0;0;8;21;3;4;84;34;34;3;4;0;8;8;84;4;161;4;1;0
/org.eclipse.core.filebuffers/src/org/eclipse/core/filebuffers/IDocumentFactory.java;2;2;5;2;3;2;3;2;32;0;1;93;39;39;2;1;1;2;5;93;2;334;3;2;0
/org.eclipse.core.runtime/src/org/eclipse/core/internal/content/ContentTypeBuilder.java;2;2;6;1;5;4;5;1;27;0;1;268;66;66;2;0;1;1;6;277;1;306;5;2;1
/org.eclipse.swt/Eclipse SWT Mozilla/common/org/eclipse/swt/internal/mozilla/nsIController.java;1;0;2;1;0;0;0;2;8;1;2;100;8;8;1;0;0;2;2;100;0;148;2;1;0
/org.eclipse.jface.text/src/org/eclipse/jface/internal/text/link/contentassist/LineBreakingReader.java;2;0;2;1;1;1;1;1;2;0;1;232;2;2;1;0;0;1;2;232;0;336;2;2;0
/org.eclipse.debug.ui/ui/org/eclipse/debug/internal/ui/sourcelookup/RemoveAction.java;1;0;1;1;0;0;0;1;0;0;1;209;0;0;1;0;0;1;1;209;0;209;1;1;0
/org.eclipse.text/src/org/eclipse/jface/text/ITextStore.java;1;0;1;1;1;1;1;0;8;0;0;334;8;8;1;0;0;0;1;334;0;334;1;1;0
/org.eclipse.core.runtime/src/org/eclipse/core/internal/preferences/ConfigurationPreferences.java;1;2;10;1;3;2;3;7;87;5;2;239;189;189;5;5;1;7;10;239;6;312;4;1;0
/org.eclipse.core.resources/src/org/eclipse/core/internal/indexing/Page.java;1;0;1;1;1;1;1;0;16;0;0;277;16;16;1;0;0;0;1;277;0;277;1;1;0
/org.eclipse.ui.workbench/Eclipse UI/org/eclipse/ui/internal/progress/IProgressUpdateCollector.java;1;0;2;1;0;0;0;2;44;0;1;199;44;44;2;1;0;2;2;199;1;199;1;1;0
/org.eclipse.jdt.core/model/org/eclipse/jdt/core/ICorrectionRequestor.java;1;0;2;1;0;0;0;2;6;1;2;149;8;8;1;0;0;2;2;149;0;199;2;1;0
/org.eclipse.update.core/src/org/eclipse/update/internal/core/Response.java;2;0;2;1;0;0;0;2;101;1;2;79;122;122;1;0;0;2;2;79;0;171;2;2;0
/org.eclipse.core.variables/src/org/eclipse/core/internal/variables/StringSubstitutionEngine.java;3;0;5;1;1;1;1;4;59;1;4;145;169;169;1;0;0;4;5;145;0;296;5;3;0
/org.eclipse.jdt.ui/ui/org/eclipse/jdt/internal/ui/search/GroupAction.java;1;0;2;1;0;0;0;2;3;1;2;227;3;3;1;0;0;2;2;227;0;240;2;1;0
/org.eclipse.jdt.core/search/org/eclipse/jdt/internal/core/search/JavaSearchScope.java;2;1;4;1;2;2;2;2;45;1;2;199;89;89;1;0;0;2;4;199;0;306;4;2;1
/org.eclipse.jdt.ui/ui/org/eclipse/jdt/internal/ui/javadocexport/JavadocWizardPage.java;2;0;3;1;0;0;0;3;11;1;3;81;20;20;1;0;0;3;3;81;0;243;3;2;0
/org.eclipse.debug.ui/ui/org/eclipse/debug/internal/ui/views/memory/IMemoryViewTabFactory.java;1;0;1;1;1;1;1;0;0;0;0;282;0;0;1;0;0;0;1;282;0;282;1;1;0
/org.eclipse.swt/Eclipse SWT Printing/motif/org/eclipse/swt/printing/PrintDialog.java;1;1;2;1;2;2;2;0;8;0;0;300;12;12;1;0;0;0;2;300;0;337;2;1;0
/org.eclipse.swt/Eclipse SWT PI/win32/org/eclipse/swt/internal/win32/LOGPEN.java;1;0;1;1;0;0;0;1;2;0;1;166;2;2;1;0;0;1;1;166;0;166;1;1;0
/org.eclipse.ant.ui/Ant Tools Support/org/eclipse/ant/internal/ui/console/AntConsoleColorProvider.java;1;0;2;1;1;1;1;1;15;0;1;246;15;15;1;0;0;1;2;246;0;304;2;1;2
/org.eclipse.ui.workbench/Eclipse UI/org/eclipse/ui/internal/progress/NewProgressViewer.java;5;16;26;3;26;2;26;0;3711;0;0;274;3864;3864;16;0;24;0;26;274;24;311;2;5;1
/org.eclipse.team.cvs.ui/src/org/eclipse/team/internal/ccvs/ui/operations/BranchOperation.java;1;2;4;1;4;3;4;0;24;0;0;293;49;49;2;0;1;0;4;320;1;320;3;1;0
/org.eclipse.ltk.core.refactoring/src/org/eclipse/ltk/internal/core/refactoring/Resources.java;1;1;3;1;2;2;2;1;4;0;1;264;6;6;1;0;0;1;3;264;0;336;3;1;0
/org.eclipse.jdt.ui/ui/org/eclipse/jdt/ui/text/java/IQuickFixProcessor.java;2;0;5;2;1;1;3;2;32;3;2;76;45;45;3;0;2;4;5;269;2;335;3;2;0
/org.eclipse.jdt.debug.ui/ui/org/eclipse/jdt/internal/debug/core/refactoring/JavaLineBreakpointTypeChange.java;2;1;3;1;3;3;3;0;8;0;0;287;16;16;1;0;0;0;3;287;0;336;3;2;1
/org.eclipse.core.runtime/src/org/eclipse/core/runtime/ProgressMonitorWrapper.java;3;2;8;2;3;2;3;5;636;3;2;122;745;745;3;3;1;5;8;171;4;336;4;3;0
/org.eclipse.jdt.ui/ui/org/eclipse/jdt/internal/ui/callhierarchy/ToggleOrientationAction.java;3;1;4;1;2;2;2;2;16;0;1;12;20;20;2;1;0;2;4;12;1;336;3;3;0
/org.eclipse.ui.ide/src/org/eclipse/ui/views/markers/internal/MarkerTypesModel.java;1;0;1;1;0;0;0;1;0;0;1;129;0;0;1;0;0;1;1;129;0;129;1;1;0
/org.eclipse.ui.workbench/Eclipse UI/org/eclipse/ui/IPerspectiveListener2.java;1;0;1;1;1;1;1;0;0;0;0;315;0;0;1;0;0;0;1;315;0;315;1;1;1
/org.eclipse.ant.ui/Ant Tools Support/org/eclipse/ant/internal/ui/views/actions/AntViewActionMessages.java;1;0;1;1;0;0;0;1;0;0;1;108;0;0;1;0;0;1;1;108;0;108;1;1;0
/org.eclipse.ltk.ui.refactoring/src/org/eclipse/ltk/ui/refactoring/IRefactoringUIStatusCodes.java;1;0;2;1;1;1;1;1;6;0;1;264;6;6;1;0;0;1;2;264;0;278;2;1;0
/org.eclipse.jface.text/src/org/eclipse/jface/text/ITextHoverExtension.java;2;2;4;2;3;2;3;1;12;0;1;47;18;18;2;0;1;1;4;336;1;336;3;2;0
/org.eclipse.debug.ui/ui/org/eclipse/debug/internal/ui/views/variables/ViewerState.java;3;0;7;2;1;1;1;6;306;2;4;118;501;501;2;2;0;6;7;130;2;336;5;3;0
/org.eclipse.pde.ui/src/org/eclipse/pde/internal/ui/wizards/exports/FeatureExportWizard.java;3;2;15;2;4;3;4;11;194;2;9;7;455;455;2;2;1;11;15;44;3;336;12;3;0
/org.eclipse.ui.forms/src/org/eclipse/ui/forms/IDetailsPageProvider.java;1;0;4;1;1;1;1;3;45;1;3;225;54;54;1;0;0;3;4;225;0;336;4;1;0
/org.eclipse.team.cvs.core/src/org/eclipse/team/internal/ccvs/core/resources/SyncInfoCache.java;2;1;3;1;2;2;2;1;25;0;1;122;33;33;1;0;0;1;3;122;0;336;3;2;0
/org.eclipse.jdt.ui/ui/org/eclipse/jdt/internal/ui/actions/OpenBrowserUtil.java;2;0;7;1;1;1;1;6;29;1;6;46;78;78;1;0;0;6;7;46;0;336;7;2;0
/org.eclipse.ui.workbench/Eclipse UI/org/eclipse/ui/internal/ClosePerspectiveAction.java;1;0;1;1;0;0;0;1;48;0;1;157;48;48;1;0;0;1;1;157;0;157;1;1;0
/org.eclipse.jdt.core/dom/org/eclipse/jdt/core/dom/Comment.java;1;0;3;1;0;0;0;3;12;2;2;206;12;12;2;1;0;3;3;230;1;230;2;1;0
/org.eclipse.jdt.core/compiler/org/eclipse/jdt/internal/compiler/parser/RecoveredMethod.java;4;0;7;2;1;1;1;6;36;2;5;34;97;97;2;1;0;6;7;63;1;314;6;4;0
/org.eclipse.jdt.core/model/org/eclipse/jdt/internal/core/util/ClassFileStruct.java;3;0;3;1;1;1;1;2;14;1;2;71;29;29;1;0;0;2;3;71;0;292;3;3;0
/org.eclipse.pde.core/src/org/eclipse/pde/internal/core/TracingOptionsManager.java;3;1;9;1;2;2;2;7;86;2;5;130;130;130;2;2;0;7;9;130;2;336;7;3;0
/org.eclipse.team.cvs.ui/src/org/eclipse/team/internal/ccvs/ui/WatchEditPreferencePage.java;2;0;2;1;1;1;1;1;61;0;1;208;63;63;1;0;0;1;2;208;0;336;2;2;0
/org.eclipse.pde.ui/src/org/eclipse/pde/internal/ui/preferences/CompilersPreferencePage.java;3;4;9;3;6;2;6;3;116;2;2;44;266;266;4;1;4;3;9;325;5;325;4;3;0
/org.eclipse.jdt.ui/ui/org/eclipse/jdt/internal/ui/actions/LexicalSortingAction.java;1;0;2;1;1;1;1;1;2;0;1;246;2;2;1;0;0;1;2;246;0;336;2;1;0
/org.eclipse.jdt.ui/ui/org/eclipse/jdt/internal/ui/typehierarchy/TypeHierarchyViewer.java;2;1;4;1;2;2;2;2;13;1;2;176;18;18;1;0;0;2;4;176;0;336;4;2;0
/org.eclipse.ui.workbench/Eclipse UI/org/eclipse/ui/internal/ResetPerspectiveAction.java;1;0;1;1;0;0;0;1;55;0;1;157;55;55;1;0;0;1;1;157;0;157;1;1;0
/org.eclipse.jface/src/org/eclipse/jface/util/Policy.java;1;2;4;1;4;3;4;0;29;0;0;289;44;44;2;0;1;0;4;289;1;336;3;1;0
/org.eclipse.jface.text/src/org/eclipse/jface/text/rules/EndOfLineRule.java;1;1;3;1;2;2;2;1;21;0;1;231;24;24;1;0;0;1;3;231;0;336;3;1;0
/org.eclipse.team.cvs.ui/src/org/eclipse/team/internal/ccvs/ui/repo/RemoveDateTagAction.java;2;1;4;1;4;4;4;0;11;0;0;275;18;18;1;0;0;0;4;275;0;336;4;2;0
/org.eclipse.jdt.core/search/org/eclipse/jdt/internal/core/search/matching/VariablePattern.java;2;0;7;2;2;1;2;5;62;2;3;145;96;96;2;2;1;5;7;145;3;280;4;2;0
/org.eclipse.jdt.ui/core refactoring/org/eclipse/jdt/internal/corext/refactoring/SearchResultGroup.java;3;1;4;1;2;2;2;2;23;1;2;6;53;53;1;0;0;2;4;6;0;336;4;3;0
/org.eclipse.debug.ui/ui/org/eclipse/debug/internal/ui/actions/FollowHyperlinkAction.java;1;0;1;1;0;0;0;1;3;0;1;157;3;3;1;0;0;1;1;157;0;157;1;1;1
/org.eclipse.core.resources/src/org/eclipse/core/internal/dtree/IComparator.java;1;0;1;1;1;1;1;0;24;0;0;277;24;24;1;0;0;0;1;277;0;277;1;1;0
/org.eclipse.jdt.ui/ui/org/eclipse/jdt/internal/ui/text/template/preferences/TemplatePreferencesMessages.java;2;1;2;1;2;2;2;0;2;0;0;283;2;2;1;0;0;0;2;283;0;336;2;2;0
/org.eclipse.jdt.ui/ui/org/eclipse/jdt/internal/ui/search/GroupByKeyComputer.java;2;1;3;1;2;2;2;1;5;0;1;82;11;11;1;0;0;1;3;82;0;336;3;2;0
/org.eclipse.jdt.debug/model/org/eclipse/jdt/internal/debug/core/hcr/JavaParseTreeBuilder.java;1;0;1;1;0;0;0;1;2;0;1;16;2;2;1;0;0;1;1;16;0;16;1;1;1
/org.eclipse.ui.forms/src/org/eclipse/ui/forms/widgets/Form.java;1;1;10;1;2;2;2;8;324;7;2;225;335;335;7;6;0;8;10;225;6;321;4;1;0
/org.eclipse.update.core/src/org/eclipse/update/internal/core/ConnectionThreadManager.java;3;1;5;2;2;2;2;3;16;2;2;58;29;29;2;1;0;3;5;253;1;336;4;3;0
/org.eclipse.jdt.debug.ui/ui/org/eclipse/jdt/internal/debug/ui/console/J9ConsoleTracker.java;2;0;3;2;0;0;0;3;14;0;1;125;14;14;3;2;0;3;3;125;2;125;1;2;1
/org.eclipse.ui.workbench/Eclipse UI/org/eclipse/ui/internal/dialogs/AboutFeaturesDialog.java;3;0;3;1;1;1;1;2;1050;1;2;7;1051;1051;1;0;0;2;3;7;0;294;3;3;1
/org.eclipse.jdt.ui/ui/org/eclipse/jdt/internal/ui/preferences/formatter/ModifyDialog.java;1;0;10;1;0;0;0;10;216;4;4;176;362;362;4;6;0;10;10;211;6;262;4;1;0
/org.eclipse.jdt.ui/ui/org/eclipse/jdt/internal/ui/wizards/buildpaths/SourceAttachmentBlock.java;2;1;8;1;3;3;3;5;85;1;5;45;135;135;1;0;0;5;8;45;0;336;8;2;0
/org.eclipse.pde.ui/src/org/eclipse/pde/internal/ui/editor/feature/RequiresSection.java;3;2;10;2;4;3;4;6;103;3;4;50;185;185;3;2;1;6;10;130;3;336;7;3;0
/org.eclipse.jdt.ui/ui refactoring/org/eclipse/jdt/internal/ui/refactoring/nls/RenameKeysDialog.java;2;0;2;2;2;1;2;0;10;0;0;289;10;10;2;0;1;0;2;289;1;289;1;2;0
/org.eclipse.team.cvs.ui/src/org/eclipse/team/internal/ccvs/ui/actions/ShowAnnotationAction.java;2;0;10;2;2;1;2;8;74;1;8;52;252;252;2;0;1;8;10;329;1;329;9;2;2
/org.eclipse.osgi/core/framework/org/eclipse/osgi/framework/internal/core/UnresolvedPermission.java;4;1;5;1;3;3;3;2;322;1;2;171;350;350;1;0;0;2;5;171;0;336;5;4;0
/org.eclipse.compare/compare/org/eclipse/compare/internal/CompareFilter.java;1;1;3;1;2;2;2;1;4;0;1;193;7;7;1;0;0;1;3;193;0;337;3;1;0
/org.eclipse.pde.ui/src/org/eclipse/pde/ui/templates/StringOption.java;3;2;5;1;5;4;5;0;107;0;0;276;117;117;2;0;1;0;5;276;1;336;4;3;0
/org.eclipse.debug.ui/ui/org/eclipse/debug/internal/ui/sourcelookup/SourceContainerViewer.java;2;0;7;2;0;0;0;7;20;2;4;209;36;36;2;3;0;7;7;225;3;268;4;2;0
/org.eclipse.ui.externaltools/External Tools Base/org/eclipse/ui/externaltools/internal/model/ExternalToolsImages.java;2;0;7;2;1;1;1;6;29;2;4;4;69;69;2;2;0;6;7;4;2;294;5;2;0
/org.eclipse.swt/Eclipse SWT/common/org/eclipse/swt/widgets/EventTable.java;1;0;1;1;0;0;0;1;3;0;1;58;3;3;1;0;0;1;1;58;0;58;1;1;0
/org.eclipse.jdt.ui/ui/org/eclipse/jdt/internal/ui/text/CompositeReconcilingStrategy.java;2;1;2;1;2;2;2;0;2;0;0;279;2;2;1;0;0;0;2;279;0;336;2;2;0
/org.eclipse.jdt.ui/core refactoring/org/eclipse/jdt/internal/corext/refactoring/nls/changes/CreateFileChange.java;3;2;11;2;4;3;4;7;88;2;6;10;206;206;2;1;1;7;11;251;2;331;9;3;0
/org.eclipse.osgi/eclipseAdaptor/src/org/eclipse/osgi/service/datalocation/FileManager.java;3;2;10;2;5;4;6;4;335;3;2;256;653;653;3;2;2;5;10;256;4;313;6;3;2
/org.eclipse.jface.text/src/org/eclipse/jface/text/contentassist/Helper.java;1;0;2;1;2;1;2;0;4;0;0;336;4;4;2;0;1;0;2;336;1;336;1;1;0
/org.eclipse.debug.core/core/org/eclipse/debug/core/sourcelookup/containers/DefaultSourceContainer.java;1;0;3;1;0;0;2;1;36;0;1;268;36;36;3;0;2;3;3;268;2;268;1;1;0
/org.eclipse.pde.junit.runtime/src/org/eclipse/pde/internal/junit/runtime/UITestApplication.java;1;1;10;1;2;2;2;8;192;2;5;89;453;453;2;3;0;8;10;122;3;321;7;1;0
/org.eclipse.team.cvs.core/src/org/eclipse/team/internal/ccvs/core/client/Version.java;2;0;3;1;1;1;1;2;8;1;2;101;13;13;1;0;0;2;3;101;0;336;3;2;0
/org.eclipse.jdt.debug.ui/ui/org/eclipse/jdt/internal/debug/ui/actions/JavaBreakpointPropertiesRulerAction.java;1;0;1;1;0;0;0;1;24;0;1;82;24;24;1;0;0;1;1;82;0;82;1;1;0
/org.eclipse.swt/Eclipse SWT Mozilla/common/org/eclipse/swt/internal/mozilla/nsICategoryManager.java;1;0;1;1;0;0;0;1;0;0;1;153;0;0;1;0;0;1;1;153;0;153;1;1;0
/org.eclipse.core.resources/src/org/eclipse/core/internal/localstore/CollectSyncStatusVisitor.java;2;0;3;1;1;1;1;2;114;0;1;90;119;119;2;1;0;2;3;90;1;277;2;2;0
/org.eclipse.jdt.ui/ui/org/eclipse/jdt/internal/ui/workingsets/JavaWorkingSetPageContentProvider.java;1;0;3;1;1;1;1;2;36;1;2;61;64;64;1;0;0;2;3;61;0;336;3;1;0
/org.eclipse.jdt.core/dom/org/eclipse/jdt/core/dom/CompilationUnit.java;5;2;20;2;4;2;5;15;527;6;7;17;824;824;6;8;3;16;20;230;11;312;9;5;2
/org.eclipse.osgi/core/framework/org/eclipse/osgi/framework/internal/core/SystemBundleLoader.java;4;1;6;1;3;3;3;3;14;1;3;171;28;28;1;0;0;3;6;171;0;336;6;4;0
/org.eclipse.jdt.ui/ui/org/eclipse/jdt/internal/ui/typehierarchy/ToggleViewAction.java;1;0;1;1;1;1;1;0;2;0;0;336;2;2;1;0;0;0;1;336;0;336;1;1;0
/org.eclipse.ltk.core.refactoring/src/org/eclipse/ltk/core/refactoring/RefactoringStatusEntry.java;1;2;5;1;3;2;3;2;11;0;1;264;15;15;2;1;1;2;5;264;2;336;3;1;0
/org.eclipse.core.expressions/src/org/eclipse/core/internal/expressions/AndExpression.java;1;0;2;1;1;1;1;1;8;0;1;227;8;8;1;0;0;1;2;227;0;336;2;1;0
/org.eclipse.help.base/src/org/eclipse/help/internal/search/ISearchHitCollector.java;1;1;3;1;2;2;2;1;10;0;1;104;16;16;1;0;0;1;3;104;0;336;3;1;0
/org.eclipse.ui.workbench.texteditor/src/org/eclipse/ui/texteditor/TextNavigationAction.java;3;1;8;1;2;2;2;6;39;1;6;41;63;63;1;0;0;6;8;41;0;336;8;3;0
/org.eclipse.jdt.ui/ui/org/eclipse/jdt/internal/ui/preferences/JavadocConfigurationBlock.java;2;1;11;2;3;3;3;8;661;3;6;45;1105;1105;3;2;0;8;11;76;2;336;9;2;1
/org.eclipse.jdt.core/compiler/org/eclipse/jdt/internal/compiler/ast/CompoundAssignment.java;2;0;8;1;0;0;0;8;278;4;5;41;288;288;4;3;0;8;8;61;3;234;5;2;0
/org.eclipse.jdt.debug/eval/org/eclipse/jdt/internal/debug/eval/ast/instructions/SendStaticMessage.java;2;0;2;2;0;0;0;2;5;0;1;76;5;5;2;1;0;2;2;76;1;76;1;2;0
/org.eclipse.jdt.core/search/org/eclipse/jdt/core/search/PackageReferenceMatch.java;3;3;8;2;4;2;4;4;37;2;2;218;77;77;3;2;2;4;8;275;4;314;4;3;0
/org.eclipse.team.cvs.core/src/org/eclipse/team/internal/ccvs/core/client/Request.java;1;0;2;1;0;0;0;2;52;1;2;76;102;102;1;0;0;2;2;76;0;101;2;1;0
/org.eclipse.update.core/src/org/eclipse/update/operations/IOperationListener.java;1;1;6;1;2;2;2;4;24;1;4;54;45;45;1;0;0;4;6;54;0;336;6;1;0
/org.eclipse.update.core/src/org/eclipse/update/internal/core/FileFragment.java;2;0;2;2;0;0;0;2;23;0;1;175;23;23;2;1;0;2;2;175;1;175;1;2;0
/org.eclipse.jface.text/projection/org/eclipse/jface/text/source/projection/ProjectionAnnotation.java;3;2;10;2;6;4;6;4;144;3;2;247;306;306;3;2;2;4;10;265;4;336;6;3;0
/org.eclipse.swt/Eclipse SWT PI/carbon/org/eclipse/swt/internal/carbon/ThemeButtonDrawInfo.java;1;0;2;1;2;1;2;0;20;0;0;296;20;20;2;0;1;0;2;296;1;296;1;1;0
/org.eclipse.ui.workbench/Eclipse UI/org/eclipse/ui/commands/NotHandledException.java;3;1;6;1;2;2;2;4;43;3;2;71;61;61;3;2;0;4;6;71;2;336;4;3;0
/org.eclipse.jface/src/org/eclipse/jface/dialogs/DialogMessageArea.java;1;0;4;1;1;1;1;3;112;0;1;232;181;181;3;2;0;3;4;232;2;293;2;1;0
/org.eclipse.debug.ui/ui/org/eclipse/debug/internal/ui/views/expression/ExpressionViewEventHandler.java;4;0;7;1;1;1;1;6;22;1;6;22;78;78;1;0;0;6;7;22;0;336;7;4;0
/org.eclipse.jdt.core/compiler/org/eclipse/jdt/internal/compiler/lookup/ProblemFieldBinding.java;2;0;2;1;1;1;1;1;8;0;1;199;10;10;1;0;0;1;2;199;0;325;2;2;0
/org.eclipse.ui.workbench.texteditor/src/org/eclipse/ui/internal/texteditor/EditorMessages.java;1;1;2;1;2;2;2;0;2;0;0;294;4;4;1;0;0;0;2;294;0;336;2;1;0
/org.eclipse.ant.ui/Ant Editor/org/eclipse/ant/internal/ui/editor/templates/AntContext.java;2;4;7;2;7;3;7;0;43;0;0;275;77;77;4;0;4;0;7;275;4;313;3;2;2
/org.eclipse.jdt.core/model/org/eclipse/jdt/internal/core/IJavaElementRequestor.java;1;0;1;1;0;0;0;1;2;0;1;199;2;2;1;0;0;1;1;199;0;199;1;1;0
/org.eclipse.jdt.ui/ui/org/eclipse/jdt/internal/ui/typehierarchy/ToggleOrientationAction.java;2;1;2;1;2;2;2;0;16;0;0;279;18;18;1;0;0;0;2;279;0;336;2;2;0
/org.eclipse.jdt.core/search/org/eclipse/jdt/internal/core/search/matching/OrPattern.java;3;0;14;2;2;1;2;12;210;3;9;52;541;541;3;3;1;12;14;70;4;280;10;3;0
/org.eclipse.ui.intro/src/org/eclipse/ui/internal/intro/impl/model/IntroHTML.java;1;4;5;1;5;2;5;0;24;0;0;276;37;37;4;0;3;0;5;276;3;331;2;1;0
/org.eclipse.debug.ui/ui/org/eclipse/debug/ui/console/IConsole.java;1;0;1;1;0;0;0;1;4;0;1;96;4;4;1;0;0;1;1;96;0;96;1;1;2
/org.eclipse.jdt.ui/ui refactoring/org/eclipse/jdt/internal/ui/refactoring/actions/RenameTempAction.java;3;0;13;1;1;1;2;11;26;2;8;9;82;82;2;3;1;12;13;9;4;336;9;3;0
/org.eclipse.swt/Eclipse SWT/common/org/eclipse/swt/events/MouseListener.java;2;0;2;1;1;1;1;1;4;0;1;225;6;6;1;0;0;1;2;225;0;337;2;2;0
/org.eclipse.jdt.ui/ui/org/eclipse/jdt/internal/ui/search/IJavaSearchUIConstants.java;1;0;1;1;1;1;1;0;2;0;0;336;2;2;1;0;0;0;1;336;0;336;1;1;0
/org.eclipse.core.resources/src/org/eclipse/core/resources/IFolder.java;2;0;4;2;0;0;1;3;616;2;3;3;635;635;2;0;1;4;4;270;1;270;3;2;0
/org.eclipse.jdt.launching/launching/org/eclipse/jdt/launching/IRuntimeContainerComparator.java;3;1;3;1;2;2;2;1;6;0;1;170;11;11;1;0;0;1;3;170;0;336;3;3;0
/org.eclipse.debug.ui/ui/org/eclipse/debug/internal/ui/views/memory/GoToAddressDialog.java;1;0;1;1;1;1;1;0;0;0;0;282;0;0;1;0;0;0;1;282;0;282;1;1;0
/org.eclipse.jdt.debug/eval/org/eclipse/jdt/internal/debug/eval/ast/instructions/PushThis.java;1;0;1;1;0;0;0;1;3;0;1;76;3;3;1;0;0;1;1;76;0;76;1;1;0
/org.eclipse.help/src/org/eclipse/help/internal/context/ContextsBuilder.java;1;1;5;1;4;4;4;1;51;0;1;266;109;109;1;0;0;1;5;266;0;336;5;1;0
/org.eclipse.jdt.ui/ui/org/eclipse/jdt/internal/ui/javadocexport/JavadocProjectContentProvider.java;3;1;5;1;3;3;3;2;33;1;2;81;64;64;1;0;0;2;5;81;0;336;5;3;0
/org.eclipse.jdt.junit/src/org/eclipse/jdt/internal/junit/ui/JUnitAddLibraryProposal.java;2;1;4;1;2;2;2;2;10;1;2;77;20;20;1;0;0;2;4;77;0;336;4;2;0
/org.eclipse.jdt.core/model/org/eclipse/jdt/internal/core/hierarchy/HierarchyResolver.java;4;1;23;2;3;3;3;20;1075;6;10;5;1279;1279;6;10;0;20;23;121;10;323;13;4;1
/org.eclipse.jdt.ui/core refactoring/org/eclipse/jdt/internal/corext/refactoring/nls/NLSUtil.java;3;1;3;1;2;2;2;1;111;0;1;116;124;124;1;0;0;1;3;116;0;336;3;3;0
/org.eclipse.search/search/org/eclipse/search/internal/ui/SearchDropDownAction.java;2;0;3;1;1;1;1;2;14;1;2;42;20;20;1;0;0;2;3;42;0;336;3;2;0
/org.eclipse.osgi/core/adaptor/org/eclipse/osgi/framework/adaptor/ImportClassNotFoundException.java;4;1;4;1;2;2;2;2;34;1;2;171;40;40;1;0;0;2;4;171;0;336;4;4;0
/org.eclipse.jdt.debug/jdi/org/eclipse/jdi/internal/GenericSignature.java;1;0;2;1;0;0;0;2;2;0;1;235;2;2;2;1;0;2;2;235;1;235;1;1;0
/org.eclipse.ui.workbench/Eclipse UI/org/eclipse/ui/internal/intro/IntroRegistry.java;1;0;5;1;0;0;0;5;74;2;3;203;78;78;2;2;0;5;5;203;2;263;3;1;0
/org.eclipse.jdt.debug/jdi/org/eclipse/jdi/Bootstrap.java;3;1;3;1;2;2;2;1;7;0;1;234;15;15;1;0;0;1;3;234;0;303;3;3;0
/org.eclipse.jdt.ui/ui/org/eclipse/jdt/internal/ui/javaeditor/JavaAnnotationImageProvider.java;3;1;4;1;3;3;3;1;8;0;1;181;14;14;1;0;0;1;4;181;0;336;4;3;0
/org.eclipse.jface.text/src/org/eclipse/jface/text/AbstractHoverInformationControlManager.java;2;2;5;2;3;2;3;2;27;1;2;65;57;57;2;0;1;2;5;336;1;336;4;2;0
/org.eclipse.jdt.launching/launching/org/eclipse/jdt/launching/AbstractVMInstallType.java;1;0;2;1;0;0;0;2;18;1;2;144;21;21;1;0;0;2;2;144;0;170;2;1;0
/org.eclipse.ui.workbench/Eclipse UI/org/eclipse/ui/keys/CharacterKey.java;3;1;12;2;2;2;2;10;596;3;5;79;1546;1546;3;5;0;10;12;79;5;336;7;3;0
/org.eclipse.pde.core/src/org/eclipse/pde/internal/core/schema/SchemaType.java;1;0;2;1;1;1;1;1;4;0;1;232;6;6;1;0;0;1;2;232;0;336;2;1;0
/org.eclipse.jdt.ui/core refactoring/org/eclipse/jdt/internal/corext/refactoring/nls/NLSSubstitution.java;3;4;10;1;9;4;9;1;668;0;1;267;707;707;4;0;5;1;10;279;5;336;5;3;0
/org.eclipse.swt/Eclipse SWT/emulated/treetable/org/eclipse/swt/widgets/Header.java;4;0;4;2;2;1;2;2;17;1;2;19;26;26;2;0;1;2;4;330;1;330;3;4;0
/org.eclipse.ui.workbench/Eclipse UI/org/eclipse/ui/IWorkbenchPreferenceConstants.java;5;6;14;4;8;2;8;6;207;3;3;157;296;296;6;3;6;6;14;290;9;290;5;5;1
/org.eclipse.team.cvs.ui/src/org/eclipse/team/internal/ccvs/ui/subscriber/RefreshDirtyStateAction.java;1;0;2;1;2;1;2;0;61;0;0;288;61;61;2;0;1;0;2;288;1;288;1;1;0
/org.eclipse.pde.ui/src/org/eclipse/pde/internal/ui/editor/text/AnnotationHover.java;2;1;2;1;2;2;2;0;6;0;0;308;8;8;1;0;0;0;2;308;0;336;2;2;0
/org.eclipse.jdt.core/compiler/org/eclipse/jdt/internal/compiler/ast/JavadocReturnStatement.java;3;0;5;2;0;0;0;5;15;3;3;165;19;19;3;2;0;5;5;165;2;199;3;3;2
/org.eclipse.ui.cheatsheets/src/org/eclipse/ui/internal/cheatsheets/registry/RegistryReader.java;2;0;4;1;1;1;1;3;17;1;3;243;29;29;1;0;0;3;4;243;0;307;4;2;0
/org.eclipse.debug.ui/ui/org/eclipse/debug/internal/ui/views/memory/ResetMemoryBlockContextAction.java;1;0;1;1;1;1;1;0;0;0;0;282;0;0;1;0;0;0;1;282;0;282;1;1;0
/org.eclipse.ui.workbench/Eclipse UI/org/eclipse/ui/internal/commands/AbstractMutableCommandRegistry.java;3;1;10;1;2;2;2;8;88;2;6;85;236;236;2;2;0;8;10;85;2;336;8;3;0
/org.eclipse.swt/Eclipse SWT/win32/org/eclipse/swt/graphics/GC.java;5;5;33;4;9;4;9;24;279;7;11;8;768;768;7;13;5;24;33;135;18;337;15;5;1
/org.eclipse.pde.ui/src/org/eclipse/pde/internal/ui/editor/KeyValueSourcePage.java;1;1;3;1;3;3;3;0;10;0;0;292;11;11;1;0;0;0;3;292;0;336;3;1;0
/org.eclipse.swt/Eclipse SWT PI/win32/org/eclipse/swt/internal/win32/TRACKMOUSEEVENT.java;1;0;1;1;0;0;0;1;1;0;1;166;1;1;1;0;0;1;1;166;0;166;1;1;0
/org.eclipse.core.resources/src/org/eclipse/core/internal/localstore/FileSystemResourceManager.java;3;2;13;2;6;4;6;7;1541;2;5;13;1780;1780;2;2;2;7;13;90;4;320;9;3;0
/org.eclipse.osgi/osgi/src/org/osgi/service/permissionadmin/PermissionAdmin.java;2;0;2;1;1;1;1;1;3;0;1;171;3;3;1;0;0;1;2;171;0;296;2;2;0
/org.eclipse.jdt.core/dom/org/eclipse/jdt/core/dom/ITypeBinding.java;4;0;8;3;0;0;0;8;548;2;5;168;1655;1655;2;3;0;8;8;168;3;269;5;4;5
/org.eclipse.jdt.debug.ui/ui/org/eclipse/jdt/internal/debug/ui/snippeteditor/JavaSnippetViewerConfiguration.java;2;0;3;1;1;1;1;2;8;1;2;76;14;14;1;0;0;2;3;76;0;336;3;2;0
/org.eclipse.jdt.ui/ui/org/eclipse/jdt/internal/ui/compare/JarStructureCreator.java;1;0;1;1;1;1;1;0;2;0;0;336;2;2;1;0;0;0;1;336;0;336;1;1;0
/org.eclipse.jdt.core/dom/org/eclipse/jdt/core/dom/IfStatement.java;3;0;9;1;2;1;2;7;134;2;6;164;203;203;2;1;1;7;9;266;2;276;7;3;1
/org.eclipse.jface.text/src/org/eclipse/jface/text/IWidgetTokenKeeper.java;2;0;2;2;2;1;2;0;35;0;0;336;35;35;2;0;1;0;2;336;1;336;1;2;0
/org.eclipse.core.resources/src/org/eclipse/core/internal/utils/Queue.java;1;0;1;1;1;1;1;0;371;0;0;277;371;371;1;0;0;0;1;277;0;277;1;1;0
/org.eclipse.core.resources/src/org/eclipse/core/internal/dtree/DeletedNode.java;2;0;2;1;1;1;1;1;234;0;1;13;241;241;1;0;0;1;2;13;0;277;2;2;0
/org.eclipse.jdt.ui/ui/org/eclipse/jdt/internal/ui/search/NewSearchViewActionGroup.java;2;1;5;1;3;3;3;2;32;1;2;196;63;63;1;0;0;2;5;196;0;336;5;2;0
/org.eclipse.ui.forms/src/org/eclipse/ui/forms/widgets/TableWrapData.java;1;1;6;1;2;2;2;4;237;3;2;225;247;247;3;2;0;4;6;225;2;336;4;1;0
/org.eclipse.core.runtime.compatibility/src-boot/org/eclipse/core/boot/IPlatformConfiguration.java;3;2;9;2;4;3;4;5;30;4;2;171;61;61;4;3;1;5;9;171;4;336;5;3;0
/org.eclipse.jdt.ui/core refactoring/org/eclipse/jdt/internal/corext/refactoring/reorg/MoveCuUpdateCreator.java;5;2;17;3;5;4;5;12;378;4;9;21;705;705;4;3;1;12;17;249;4;336;13;5;0
/org.eclipse.pde.build/src_ant/org/eclipse/pde/internal/build/tasks/BuildManifestTask.java;2;1;7;1;2;2;2;5;880;2;3;31;2214;2214;2;2;0;5;7;31;2;336;5;2;0
/org.eclipse.ltk.core.refactoring/src/org/eclipse/ltk/core/refactoring/participants/CreateParticipant.java;1;2;6;1;4;2;4;2;22;0;1;264;58;58;2;1;2;2;6;264;3;336;3;1;0
/org.eclipse.jdt.core/model/org/eclipse/jdt/core/util/IAnnotation.java;2;0;2;1;0;0;0;2;43;1;2;244;43;43;1;0;0;2;2;244;0;264;2;2;0
/org.eclipse.jdt.ui/ui/org/eclipse/jdt/internal/ui/preferences/JavaSourcePreviewerUpdater.java;1;0;3;1;1;1;1;2;19;1;2;139;21;21;1;0;0;2;3;139;0;336;3;1;0
/org.eclipse.jdt.ui/ui/org/eclipse/jdt/internal/ui/wizards/buildpaths/JavadocLocationDialog.java;2;1;2;1;2;2;2;0;2;0;0;276;2;2;1;0;0;0;2;276;0;336;2;2;0
/org.eclipse.pde.ui/src/org/eclipse/pde/internal/ui/parts/TreePart.java;1;1;2;1;2;2;2;0;10;0;0;292;14;14;1;0;0;0;2;292;0;336;2;1;0
/org.eclipse.pde.build/src/org/eclipse/pde/internal/build/IXMLConstants.java;2;3;12;2;5;3;5;7;98;2;5;31;284;284;3;2;2;7;12;272;4;323;8;2;0
/org.eclipse.jdt.junit/src/org/eclipse/jdt/internal/junit/wizards/NewTestSuiteCreationWizardPage.java;3;1;5;1;3;3;3;2;138;1;2;12;146;146;1;0;0;2;5;12;0;336;5;3;0
/org.eclipse.osgi/core/framework/org/eclipse/osgi/framework/internal/core/Util.java;4;1;5;1;3;3;3;2;390;1;2;171;400;400;1;0;0;2;5;171;0;336;5;4;0
/org.eclipse.ui.workbench/Eclipse UI/org/eclipse/ui/IPluginContribution.java;1;0;1;1;0;0;0;1;0;0;1;174;0;0;1;0;0;1;1;174;0;174;1;1;0
/org.eclipse.ui.workbench/Eclipse UI/org/eclipse/ui/internal/presentations/SystemMenuCloseAll.java;1;0;2;1;2;1;2;0;4;0;0;296;4;4;2;0;1;0;2;296;1;296;1;1;0
/org.eclipse.jdt.core/dom/org/eclipse/jdt/core/dom/SwitchStatement.java;3;0;8;1;2;1;2;6;102;2;5;199;132;132;2;1;1;6;8;266;2;276;6;3;1
/org.eclipse.ui.ide/src/org/eclipse/ui/views/navigator/MainActionGroup.java;5;2;8;2;4;3;4;4;22;1;4;129;83;83;2;0;1;4;8;310;1;336;7;5;1
/org.eclipse.jdt.debug/jdi interfaces/com/sun/jdi/VirtualMachineManager.java;1;0;1;1;0;0;0;1;6;0;1;235;6;6;1;0;0;1;1;235;0;235;1;1;0
/org.eclipse.swt/Eclipse SWT Drag and Drop/gtk/org/eclipse/swt/dnd/Transfer.java;2;1;3;1;2;2;2;1;4;0;1;228;8;8;1;0;0;1;3;228;0;337;3;2;0
/org.eclipse.help.base/src/org/eclipse/help/internal/workingset/WorkingSetComparator.java;1;1;3;1;2;2;2;1;9;0;1;104;15;15;1;0;0;1;3;104;0;336;3;1;0
/org.eclipse.team.ui/src/org/eclipse/team/internal/ui/synchronize/TeamSynchronizingPerspective.java;1;1;7;1;3;3;3;4;60;2;3;149;81;81;2;1;0;4;7;149;1;336;6;1;0
/org.eclipse.swt/Eclipse SWT/motif/org/eclipse/swt/graphics/FontData.java;2;1;4;1;2;2;2;2;41;1;2;13;52;52;1;0;0;2;4;13;0;337;4;2;1
/org.eclipse.jdt.ui/ui/org/eclipse/jdt/internal/ui/text/template/contentassist/InclusivePositionUpdater.java;2;1;3;1;3;3;3;0;6;0;0;279;11;11;1;0;0;0;3;279;0;336;3;2;0
/org.eclipse.ui.ide/src/org/eclipse/ui/internal/ide/StringMatcher.java;4;1;3;2;2;2;2;1;52;0;1;93;90;90;1;0;0;1;3;93;0;336;3;4;0
/org.eclipse.jdt.ui/ui refactoring/org/eclipse/jdt/internal/ui/refactoring/reorg/RenameResourceWizard.java;2;1;3;1;2;2;2;1;10;0;1;71;19;19;1;0;0;1;3;71;0;336;3;2;0
/org.eclipse.jdt.debug.ui/ui/org/eclipse/jdt/internal/debug/ui/launcher/WorkspaceOperationRunner.java;2;1;2;1;2;2;2;0;4;0;0;279;4;4;1;0;0;0;2;279;0;336;2;2;0
/org.eclipse.swt/Eclipse SWT PI/win32/org/eclipse/swt/internal/ole/win32/IPersistStreamInit.java;1;0;1;1;0;0;0;1;0;0;1;153;0;0;1;0;0;1;1;153;0;153;1;1;0
/org.eclipse.ui.workbench/Eclipse UI/org/eclipse/ui/internal/PlaceholderFolderLayout.java;2;2;4;1;3;2;3;1;22;0;1;250;36;36;2;0;1;1;4;295;1;336;3;2;1
/org.eclipse.osgi/defaultAdaptor/src/org/eclipse/osgi/framework/adaptor/core/AdaptorMsg.java;2;0;3;2;2;1;2;1;7;0;1;241;7;7;2;0;1;1;3;276;1;276;2;2;0
/org.eclipse.swt/Eclipse SWT/common/org/eclipse/swt/graphics/TextStyle.java;3;3;5;2;4;2;4;1;50;0;1;265;54;54;3;0;2;1;5;299;2;337;3;3;0
/org.eclipse.pde.ui/src/org/eclipse/pde/internal/ui/properties/SelfHostingPropertyPage.java;1;1;2;1;2;2;2;0;10;0;0;312;10;10;1;0;0;0;2;312;0;336;2;1;0
/org.eclipse.swt/Eclipse SWT PI/photon/org/eclipse/swt/internal/photon/PtWebMetaDataCallback_t.java;2;0;2;1;1;1;1;1;6;0;1;207;6;6;1;0;0;1;2;207;0;337;2;2;0
/org.eclipse.jdt.ui/ui/org/eclipse/jdt/ui/actions/FindReadReferencesInWorkingSetAction.java;2;0;2;1;1;1;1;1;9;0;1;184;11;11;1;0;0;1;2;184;0;336;2;2;0
/org.eclipse.pde.core/src/org/eclipse/pde/internal/core/ibundle/IBundlePluginModel.java;1;1;2;1;2;2;2;0;4;0;0;292;4;4;1;0;0;0;2;292;0;336;2;1;0
/org.eclipse.core.runtime/src/org/eclipse/core/internal/content/ContentType.java;3;14;19;2;16;2;16;3;900;2;2;251;1269;1269;14;1;14;3;19;277;15;325;4;3;2
/org.eclipse.ant.ui/Ant Tools Support/org/eclipse/ant/internal/ui/console/JavacLineTracker.java;3;0;4;3;0;0;0;4;27;3;2;108;27;27;3;2;0;4;4;125;2;125;2;3;0
/org.eclipse.swt/Eclipse SWT Custom Widgets/common/org/eclipse/swt/custom/TableTreeEditor.java;3;1;5;2;2;2;2;3;167;2;2;56;185;185;2;1;0;3;5;56;1;337;4;3;0
/org.eclipse.search/new search/org/eclipse/search2/internal/ui/SearchAgainAction.java;2;1;6;2;2;2;2;4;9;2;3;195;21;21;2;1;0;4;6;207;1;336;5;2;0
/org.eclipse.swt/Eclipse SWT/motif/org/eclipse/swt/widgets/Caret.java;2;1;6;1;2;2;2;4;15;2;3;19;43;43;2;1;0;4;6;19;1;337;5;2;0
/org.eclipse.swt/Eclipse SWT Drag and Drop/carbon/org/eclipse/swt/dnd/RTFTransfer.java;1;0;3;1;0;0;0;3;143;0;1;16;143;143;3;2;0;3;3;16;2;16;1;1;0
/org.eclipse.jdt.core/dom/org/eclipse/jdt/core/dom/MethodRefParameter.java;2;0;9;1;2;1;2;7;91;2;5;206;132;132;2;2;1;7;9;206;3;276;6;2;2
/org.eclipse.ui.workbench/Eclipse UI/org/eclipse/ui/internal/ViewLayoutRec.java;1;0;1;1;1;1;1;0;0;0;0;295;0;0;1;0;0;0;1;295;0;295;1;1;0
/org.eclipse.ui.workbench/Eclipse UI/org/eclipse/ui/internal/about/AboutBundleData.java;1;0;1;1;1;1;1;0;0;0;0;294;0;0;1;0;0;0;1;294;0;294;1;1;0
/org.eclipse.jdt.ui/core extension/org/eclipse/jdt/internal/corext/dom/ASTFlattener.java;4;1;12;1;3;3;3;9;292;1;9;10;426;426;1;0;0;9;12;10;0;336;12;4;0
/org.eclipse.team.cvs.core/src/org/eclipse/team/internal/ccvs/core/resources/RemoteResource.java;2;0;7;2;1;1;1;6;41;2;5;52;72;72;2;1;0;6;7;232;1;336;6;2;0
/org.eclipse.jface.text/src/org/eclipse/jface/text/information/IInformationProviderExtension2.java;2;2;4;1;3;2;3;1;26;0;1;47;32;32;2;0;1;1;4;336;1;336;3;2;0
/org.eclipse.ltk.core.refactoring/src/org/eclipse/ltk/core/refactoring/NullChange.java;1;1;5;1;2;2;2;3;6;0;1;264;11;11;3;2;0;3;5;264;2;336;3;1;0
/org.eclipse.pde.core/src/org/eclipse/pde/internal/core/EntryFileAdapter.java;1;0;2;1;1;1;1;1;6;0;1;232;8;8;1;0;0;1;2;232;0;336;2;1;0
/org.eclipse.jdt.debug/jdi/org/eclipse/jdi/internal/InterfaceTypeImpl.java;1;0;1;1;0;0;0;1;13;0;1;235;13;13;1;0;0;1;1;235;0;235;1;1;0
/org.eclipse.core.resources/src/org/eclipse/core/resources/IWorkspace.java;2;0;19;2;1;1;3;16;3252;4;6;3;3601;3601;4;10;2;18;19;238;12;326;7;2;0
/org.eclipse.swt/Eclipse SWT PI/carbon/org/eclipse/swt/internal/carbon/TXNLongRect.java;1;0;2;1;2;1;2;0;20;0;0;296;20;20;2;0;1;0;2;296;1;296;1;1;0
/org.eclipse.ui.intro/src/org/eclipse/ui/internal/intro/impl/swt/SharedStyleManager.java;1;5;6;1;6;2;6;0;124;0;0;305;137;137;5;0;4;0;6;305;4;333;2;1;0
/org.eclipse.ltk.core.refactoring/src/org/eclipse/ltk/core/refactoring/PerformChangeOperation.java;1;1;8;1;2;2;5;3;112;0;1;264;127;127;6;2;3;6;8;264;5;336;3;1;0
/org.eclipse.ui.ide/src/org/eclipse/ui/views/bookmarkexplorer/BookmarkSorter.java;1;0;1;1;0;0;0;1;0;0;1;129;0;0;1;0;0;1;1;129;0;129;1;1;0
/org.eclipse.ui.forms/src/org/eclipse/ui/forms/AbstractFormPart.java;1;1;6;1;2;2;2;4;17;3;2;239;38;38;3;2;0;4;6;239;2;336;4;1;0
/org.eclipse.pde.ui/src/org/eclipse/pde/internal/ui/editor/schema/ElementSection.java;2;1;6;1;3;3;3;3;72;1;3;26;108;108;1;0;0;3;6;26;0;336;6;2;0
/org.eclipse.ui.workbench/Eclipse UI/org/eclipse/ui/internal/themes/ThemeRegistryReader.java;4;2;11;3;3;2;3;8;617;4;4;206;757;757;4;4;1;8;11;241;5;313;6;4;1
/org.eclipse.jdt.ui/ui/org/eclipse/jdt/internal/ui/JavaTaskListAdapter.java;1;0;1;1;1;1;1;0;2;0;0;336;2;2;1;0;0;0;1;336;0;336;1;1;0
/org.eclipse.update.core/src/org/eclipse/update/standalone/ListFeaturesCommand.java;1;3;4;1;4;2;4;0;53;0;0;294;57;57;3;0;2;0;4;294;2;336;2;1;0
/org.eclipse.ui.cheatsheets/src/org/eclipse/ui/internal/cheatsheets/views/StringDelimitedTokenizer.java;1;0;1;1;1;1;1;0;0;0;0;299;0;0;1;0;0;0;1;299;0;299;1;1;0
/org.eclipse.team.cvs.ui/src/org/eclipse/team/internal/ccvs/ui/ICVSUIConstants.java;2;3;23;2;4;2;6;17;23;4;12;57;83;83;4;5;4;19;23;57;9;336;14;2;3
/org.eclipse.ui.workbench/Eclipse UI/org/eclipse/ui/activities/IMutableActivityManager.java;3;1;9;1;2;2;2;7;45;5;3;160;61;61;5;4;0;7;9;160;4;336;5;3;0
/org.eclipse.ant.ui/Ant Tools Support/org/eclipse/ant/internal/ui/preferences/ClasspathModel.java;3;1;18;2;2;2;2;16;367;7;6;128;702;702;7;10;0;16;18;128;10;336;8;3;1
/org.eclipse.jdt.core/model/org/eclipse/jdt/core/util/ICodeAttribute.java;2;0;2;1;1;1;1;1;3;0;1;199;5;5;1;0;0;1;2;199;0;312;2;2;0
/org.eclipse.jdt.core/model/org/eclipse/jdt/internal/core/CommitWorkingCopyOperation.java;3;0;18;2;0;0;0;18;137;3;10;54;261;261;3;8;0;18;18;68;8;258;10;3;0
/org.eclipse.team.core/src/org/eclipse/team/core/RepositoryProvider.java;2;2;10;2;4;3;4;6;227;2;4;52;373;373;2;2;1;6;10;52;3;336;7;2;0
/org.eclipse.ui.ide/src/org/eclipse/ui/internal/ide/dialogs/WelcomeItem.java;1;0;1;1;0;0;0;1;0;0;1;132;0;0;1;0;0;1;1;132;0;132;1;1;0
/org.eclipse.ui.ide/extensions/org/eclipse/ui/part/FileEditorInputFactory.java;1;0;1;1;0;0;0;1;0;0;1;132;0;0;1;0;0;1;1;132;0;132;1;1;0
/org.eclipse.jdt.core/dom/org/eclipse/jdt/core/dom/ArrayInitializer.java;3;0;6;1;1;1;1;5;61;2;4;199;73;73;2;1;0;5;6;266;1;283;5;3;1
/org.eclipse.jdt.core/model/org/eclipse/jdt/internal/core/CreatePackageDeclarationOperation.java;2;1;5;1;2;2;2;3;10;1;3;108;18;18;1;0;0;3;5;108;0;314;5;2;0
/org.eclipse.team.cvs.ui/src/org/eclipse/team/internal/ccvs/ui/model/RemoteResourceElement.java;1;0;1;1;0;0;0;1;3;0;1;74;3;3;1;0;0;1;1;74;0;74;1;1;0
/org.eclipse.help.base/src/org/eclipse/help/internal/search/SearchProgressMonitor.java;1;1;11;1;3;3;3;8;27;3;4;104;77;77;3;4;0;8;11;244;4;336;7;1;0
/org.eclipse.jdt.ui/ui/org/eclipse/jdt/internal/ui/text/correction/TypeMismatchSubProcessor.java;1;0;9;1;9;1;9;0;212;0;0;289;212;212;9;0;8;0;9;289;8;289;1;1;1
/org.eclipse.jface/src/org/eclipse/jface/viewers/Viewer.java;3;1;3;1;2;2;2;1;6;0;1;0;12;12;1;0;0;1;3;0;0;336;3;3;0
/org.eclipse.search/search/org/eclipse/search/internal/ui/util/ExtendedDialogWindow.java;2;2;8;2;3;2;3;5;95;2;3;42;136;136;2;2;1;5;8;165;3;336;5;2;0
/org.eclipse.jdt.ui/ui/org/eclipse/jdt/internal/ui/text/comment/JavaDocRegion.java;4;2;17;2;3;2;3;14;878;6;8;97;1450;1450;6;6;1;14;17;119;7;336;10;4;0
/org.eclipse.pde.ui/src/org/eclipse/pde/internal/ui/editor/FormEntryAdapter.java;2;2;3;2;3;2;3;0;10;0;0;292;14;14;2;0;1;0;3;292;1;336;2;2;0
/org.eclipse.pde.ui/src/org/eclipse/pde/internal/ui/wizards/IProjectProvider.java;2;1;2;1;2;2;2;0;6;0;0;280;6;6;1;0;0;0;2;280;0;336;2;2;0
/org.eclipse.debug.core/core/org/eclipse/debug/internal/core/memory/IMemoryBlockManager.java;1;0;1;1;1;1;1;0;0;0;0;282;0;0;1;0;0;0;1;282;0;282;1;1;2
/org.eclipse.jdt.ui/ui/org/eclipse/jdt/internal/ui/text/java/JavaAutoIndentStrategy.java;5;6;38;4;7;2;7;31;547;8;12;40;3097;3097;8;19;5;31;38;95;24;336;14;5;0
/org.eclipse.compare/compare/org/eclipse/compare/internal/AddFromHistoryDialog.java;1;1;7;1;2;2;2;5;13;2;4;63;32;32;2;1;0;5;7;220;1;337;6;1;0
/org.eclipse.ant.ui/Ant Editor/org/eclipse/ant/internal/ui/editor/model/AntTaskNode.java;1;0;10;1;1;1;1;9;57;4;4;204;127;127;4;5;0;9;10;204;5;314;5;1;1
/org.eclipse.swt/Eclipse SWT/win32/org/eclipse/swt/widgets/Label.java;3;1;5;1;3;3;3;2;16;1;2;61;30;30;1;0;0;2;5;61;0;337;5;3;0
/org.eclipse.jdt.ui/ui/org/eclipse/jdt/internal/ui/search/JavaSearchEditorOpener.java;2;2;5;1;5;4;5;0;16;0;0;293;27;27;2;0;1;0;5;293;1;336;4;2;1
/org.eclipse.jdt.junit/src/org/eclipse/jdt/internal/junit/ui/JUnitQuickFixProcessor.java;2;0;4;1;1;1;1;3;31;2;2;77;33;33;2;1;0;3;4;186;1;336;3;2;0
/org.eclipse.core.resources/src/org/eclipse/core/internal/resources/WorkspaceTreeReader.java;1;0;1;1;1;1;1;0;462;0;0;277;462;462;1;0;0;0;1;277;0;277;1;1;0
/org.eclipse.jdt.ui/ui/org/eclipse/jdt/internal/ui/JavaElementAdapterFactory.java;2;0;2;1;1;1;1;1;2;0;1;81;4;4;1;0;0;1;2;81;0;336;2;2;0
/org.eclipse.jdt.ui/ui/org/eclipse/jdt/internal/ui/wizards/dialogfields/SelectionButtonDialogField.java;3;1;3;1;2;2;2;1;12;0;1;88;16;16;1;0;0;1;3;88;0;336;3;3;0
/org.eclipse.jdt.debug.ui/ui/org/eclipse/jdt/internal/debug/ui/propertypages/PropertyPageMessages.java;2;0;2;2;0;0;0;2;10;0;1;82;10;10;2;1;0;2;2;82;1;82;1;2;0
/org.eclipse.debug.ui/ui/org/eclipse/debug/ui/actions/LaunchAction.java;2;1;2;1;2;2;2;0;4;0;0;280;6;6;1;0;0;0;2;280;0;336;2;2;0
/org.eclipse.jdt.debug.ui/ui/org/eclipse/jdt/internal/debug/ui/classpath/ClasspathLabelProvider.java;2;0;3;1;0;0;0;3;3;1;3;154;5;5;1;0;0;3;3;154;0;266;3;2;0
/org.eclipse.jdt.ui/ui/org/eclipse/jdt/ui/actions/JavaSearchActionGroup.java;3;1;5;1;2;2;2;3;54;1;3;181;87;87;1;0;0;3;5;181;0;336;5;3;0
/org.eclipse.ui.workbench/Eclipse UI/org/eclipse/ui/IWorkbenchSite.java;2;0;3;2;0;0;0;3;15;2;2;0;19;19;2;1;0;3;3;163;1;163;2;2;0
/org.eclipse.swt/Eclipse SWT PI/win32/org/eclipse/swt/internal/win32/OSVERSIONINFOA.java;2;0;2;1;0;0;0;2;1;1;2;61;1;1;1;0;0;2;2;61;0;166;2;2;0
/org.eclipse.swt/Eclipse SWT/carbon/org/eclipse/swt/widgets/Text.java;7;2;30;3;5;4;5;25;204;9;9;1;520;520;9;16;1;25;30;34;17;337;13;7;2
/org.eclipse.ant.ui/Ant Tools Support/org/eclipse/ant/internal/ui/preferences/AntContentProvider.java;1;0;1;1;0;0;0;1;2;0;1;115;2;2;1;0;0;1;1;115;0;115;1;1;0
/org.eclipse.jdt.debug/model/org/eclipse/jdt/internal/debug/core/breakpoints/JavaStratumLineBreakpoint.java;4;2;11;2;4;2;4;7;193;3;5;53;312;312;3;2;2;7;11;53;4;330;7;4;3
/org.eclipse.jdt.core/model/org/eclipse/jdt/internal/core/Initializer.java;2;0;11;2;1;1;1;10;26;2;7;59;81;81;2;3;0;10;11;112;3;299;8;2;0
/org.eclipse.jdt.core/model/org/eclipse/jdt/internal/core/BasicCompilationUnit.java;2;0;4;1;0;0;0;4;55;1;4;107;62;62;1;0;0;4;4;107;0;258;4;2;0
/org.eclipse.update.ui/src/org/eclipse/update/internal/ui/views/ConfigurationPreview.java;3;1;8;2;2;2;3;5;183;2;4;54;208;208;2;1;1;6;8;54;2;336;6;3;2
/org.eclipse.core.resources/src/org/eclipse/core/internal/watson/DefaultElementComparator.java;1;0;1;1;1;1;1;0;76;0;0;277;76;76;1;0;0;0;1;277;0;277;1;1;0
/org.eclipse.jdt.ui/ui refactoring/org/eclipse/jdt/internal/ui/refactoring/contentassist/CUPositionCompletionProcessor.java;2;2;3;1;3;2;3;0;3;0;0;306;5;5;2;0;1;0;3;306;1;336;2;2;0
/org.eclipse.pde.ui/src_Forms/org/eclipse/pde/internal/ui/model/DocumentTextNode.java;3;2;5;2;5;3;5;0;38;0;0;277;54;54;2;0;2;0;5;277;2;336;3;3;0
/org.eclipse.ui.workbench/Eclipse UI/org/eclipse/ui/internal/EditorPane.java;6;9;16;3;10;2;10;6;198;2;4;151;355;355;9;2;8;6;16;289;10;336;6;6;1
/org.eclipse.ui.workbench/Eclipse UI/org/eclipse/ui/internal/PinEditorAction.java;3;0;4;1;1;1;1;3;151;1;3;157;162;162;1;0;0;3;4;157;0;336;4;3;1
/org.eclipse.ui.cheatsheets/src/org/eclipse/ui/internal/cheatsheets/views/ViewItem.java;2;9;21;2;13;2;13;8;861;7;2;243;1418;1418;9;6;11;8;21;288;17;288;4;2;0
/org.eclipse.osgi/core/framework/org/eclipse/osgi/framework/internal/core/ServiceUse.java;5;2;10;3;3;2;6;4;565;5;3;171;672;672;5;1;4;7;10;267;5;326;5;5;0
/org.eclipse.osgi/resolver/src/org/eclipse/core/internal/dependencies/Assert.java;3;2;4;2;3;2;3;1;54;0;1;171;56;56;2;0;1;1;4;276;1;296;3;3;0
/org.eclipse.ant.ui/Ant Tools Support/org/eclipse/ant/internal/ui/preferences/AntPreferencePage.java;1;0;7;1;1;1;1;6;174;2;4;108;385;385;2;2;0;6;7;108;2;304;5;1;2
/org.eclipse.core.resources/src/org/eclipse/core/internal/indexing/ObjectStorePagePolicy.java;1;0;1;1;1;1;1;0;6;0;0;277;6;6;1;0;0;0;1;277;0;277;1;1;0
/org.eclipse.jdt.core/codeassist/org/eclipse/jdt/internal/codeassist/select/SelectionOnSingleTypeReference.java;2;0;2;1;0;0;0;2;8;1;2;63;10;10;1;0;0;2;2;63;0;199;2;2;1
/org.eclipse.osgi/osgi/src/org/osgi/service/packageadmin/ExportedPackage.java;2;0;2;1;1;1;1;1;3;0;1;171;3;3;1;0;0;1;2;171;0;296;2;2;0
/org.eclipse.ui.editors/src/org/eclipse/ui/internal/texteditor/AnnotationType.java;2;1;2;1;2;2;2;0;4;0;0;279;4;4;1;0;0;0;2;279;0;336;2;2;0
/org.eclipse.jdt.core/dom/org/eclipse/jdt/core/dom/Javadoc.java;3;2;14;2;3;2;4;10;204;3;5;199;350;350;3;5;2;11;14;199;7;308;7;3;2
/org.eclipse.ui.workbench/Eclipse UI/org/eclipse/ui/internal/commands/ExtensionCommandRegistry.java;3;2;15;2;3;2;3;12;220;3;6;148;507;507;3;6;1;12;15;177;7;336;8;3;0
/org.eclipse.jdt.debug.ui/ui/org/eclipse/jdt/internal/debug/ui/launcher/JavaAppletTabGroup.java;3;0;3;2;1;1;1;2;14;0;1;267;18;18;2;1;0;2;3;267;1;336;2;3;0
/org.eclipse.jdt.ui/core refactoring/org/eclipse/jdt/internal/corext/refactoring/surround/SurroundWithTryCatchRefactoring.java;5;3;30;2;5;3;5;25;302;5;13;9;523;523;5;12;2;25;30;246;14;336;16;5;0
/org.eclipse.pde.core/src/org/eclipse/pde/core/plugin/IPluginReference.java;3;1;4;1;3;3;3;1;54;0;1;232;66;66;1;0;0;1;4;232;0;336;4;3;0
/org.eclipse.jdt.core/model/org/eclipse/jdt/internal/core/builder/QualifiedNameSet.java;3;0;3;2;1;1;1;2;67;1;2;156;77;77;1;0;0;2;3;156;0;309;3;3;0
/org.eclipse.ui.presentations.r21/src/org/eclipse/ui/internal/presentations/R21ViewStackPresentation.java;1;0;1;1;1;1;1;0;0;0;0;323;0;0;1;0;0;0;1;323;0;323;1;1;0
/org.eclipse.jdt.core/compiler/org/eclipse/jdt/internal/compiler/ast/LongLiteralMinValue.java;1;0;1;1;0;0;0;1;2;0;1;199;2;2;1;0;0;1;1;199;0;199;1;1;0
/org.eclipse.jdt.ui/ui/org/eclipse/jdt/ui/wizards/NewPackageWizardPage.java;2;1;4;2;2;2;2;2;15;1;2;32;27;27;1;0;0;2;4;32;0;336;4;2;1
/org.eclipse.jface.text/src/org/eclipse/jface/text/templates/persistence/TemplatePersistenceData.java;2;0;4;2;2;1;2;2;11;1;2;253;20;20;2;0;1;2;4;336;1;336;3;2;0
/org.eclipse.ui.workbench/Eclipse UI/org/eclipse/ui/internal/presentations/SystemMenuSizeFastView.java;2;0;3;2;1;1;1;2;2;0;1;256;4;4;2;1;0;2;3;256;1;279;2;2;0
/org.eclipse.jdt.core/compiler/org/eclipse/jdt/internal/compiler/ast/ReturnStatement.java;2;0;4;1;0;0;0;4;419;1;4;11;459;459;1;0;0;4;4;11;0;199;4;2;1
/org.eclipse.swt/Eclipse SWT/gtk/org/eclipse/swt/widgets/Text.java;7;1;39;4;4;4;4;35;216;10;14;8;764;764;10;21;0;35;39;51;21;337;18;7;3
/org.eclipse.pde.ui/src/org/eclipse/pde/internal/ui/editor/build/BuildClasspathSection.java;3;6;18;3;7;2;8;10;426;5;5;104;938;938;6;5;6;11;18;292;11;336;7;3;0
/org.eclipse.swt/Eclipse SWT PI/win32/org/eclipse/swt/internal/win32/MOUSEINPUT.java;2;0;2;1;1;1;1;1;4;0;1;253;4;4;1;0;0;1;2;253;0;337;2;2;0
/org.eclipse.team.cvs.core/src/org/eclipse/team/internal/ccvs/core/client/Editors.java;1;0;1;1;0;0;0;1;7;0;1;260;7;7;1;0;0;1;1;260;0;260;1;1;0
/org.eclipse.jdt.core/dom/org/eclipse/jdt/core/dom/SuperMethodInvocation.java;3;0;10;2;3;1;3;7;127;4;4;199;291;291;4;3;2;7;10;258;5;276;5;3;2
/org.eclipse.search/search/org/eclipse/search/internal/ui/util/TypeFilteringDialog.java;1;0;1;1;1;1;1;0;2;0;0;336;2;2;1;0;0;0;1;336;0;336;1;1;0
/org.eclipse.team.ui/src/org/eclipse/team/internal/ui/TeamCapabilityHelper.java;1;0;4;1;4;1;4;0;95;0;0;323;95;95;4;0;3;0;4;323;3;323;1;1;0
/org.eclipse.pde.ui/src/org/eclipse/pde/internal/ui/parts/StructuredViewerPart.java;1;1;2;1;2;2;2;0;46;0;0;292;50;50;1;0;0;0;2;292;0;336;2;1;0
/org.eclipse.jdt.core/compiler/org/eclipse/jdt/core/compiler/IProblem.java;4;4;29;2;6;3;6;23;103;9;11;1;494;494;9;12;3;23;29;51;15;311;14;4;12
/org.eclipse.jdt.core/model/org/eclipse/jdt/internal/core/JavaProject.java;5;4;68;4;9;4;9;59;1196;12;10;1;3245;3245;12;49;5;59;68;48;54;323;14;5;4
/org.eclipse.jdt.ui/ui refactoring/org/eclipse/jdt/internal/ui/refactoring/reorg/ReorgCopyAction.java;3;0;7;1;1;1;1;6;24;3;3;70;53;53;3;3;0;6;7;94;3;336;4;3;0
/org.eclipse.ui.ide/src/org/eclipse/ui/wizards/datatransfer/PopulateRootOperation.java;1;0;1;1;0;0;0;1;0;0;1;92;0;0;1;0;0;1;1;92;0;92;1;1;0
/org.eclipse.jface/src/org/eclipse/jface/dialogs/Dialog.java;4;8;20;3;10;3;10;10;890;5;5;0;1158;1158;8;5;7;10;20;275;12;336;8;4;3
/org.eclipse.ant.ui/Ant Tools Support/org/eclipse/ant/internal/ui/console/TaskLineTracker.java;3;0;5;2;0;0;0;5;14;3;3;108;26;26;3;2;0;5;5;125;2;144;3;3;0
/org.eclipse.update.core/src/org/eclipse/update/core/model/ModelObject.java;2;2;5;1;4;3;4;1;22;0;1;58;56;56;2;0;1;1;5;290;1;336;4;2;0
/org.eclipse.ui.workbench/Eclipse UI/org/eclipse/ui/internal/PerspectiveHistory.java;2;0;2;1;1;1;1;1;9;0;1;196;11;11;1;0;0;1;2;196;0;336;2;2;0
/org.eclipse.jdt.launching.macosx/macosx/org/eclipse/jdt/internal/launching/macosx/MacOSXVMInstall.java;1;0;1;1;0;0;0;1;2;0;1;203;2;2;1;0;0;1;1;203;0;203;1;1;0
/org.eclipse.pde/src/org/eclipse/pde/internal/builders/CompilerFlags.java;2;1;7;1;2;2;2;5;32;3;3;59;63;63;3;2;0;5;7;68;2;336;5;2;1
/org.eclipse.team.cvs.ui/src/org/eclipse/team/internal/ccvs/ui/HistoryView.java;2;2;25;2;5;3;5;20;360;9;9;18;1019;1019;9;11;2;20;25;120;13;336;12;2;0
/org.eclipse.debug.ui/ui/org/eclipse/debug/internal/ui/views/memory/HexRenderingFactory.java;1;0;1;1;1;1;1;0;0;0;0;282;0;0;1;0;0;0;1;282;0;282;1;1;0
/org.eclipse.core.filebuffers/src/org/eclipse/core/filebuffers/IFileBuffer.java;2;2;12;2;3;2;3;9;69;4;5;93;207;207;4;4;1;9;12;130;5;334;7;2;0
/org.eclipse.team.core/src/org/eclipse/team/core/variants/ResourceVariantTreeSubscriber.java;2;2;5;2;4;2;4;1;14;0;1;239;23;23;2;0;2;1;5;288;2;321;3;2;0
/org.eclipse.jdt.core/eval/org/eclipse/jdt/internal/eval/CodeSnippetConstantPool.java;3;0;4;1;1;1;1;3;314;1;3;45;608;608;1;0;0;3;4;45;0;314;4;3;0
/org.eclipse.ui.workbench/Eclipse UI/org/eclipse/ui/testing/ITestHarness.java;1;0;2;1;0;0;0;2;26;1;2;131;26;26;1;0;0;2;2;131;0;157;2;1;0
/org.eclipse.pde.ui/src/org/eclipse/pde/internal/ui/search/JavaSearchCollector.java;2;1;2;1;2;2;2;0;6;0;0;308;8;8;1;0;0;0;2;308;0;336;2;2;0
/org.eclipse.ui.workbench/Eclipse UI/org/eclipse/ui/internal/IntModel.java;3;0;3;2;0;0;0;3;51;2;2;206;51;51;2;1;0;3;3;223;1;223;2;3;0
/org.eclipse.jdt.ui/ui/org/eclipse/jdt/internal/ui/search/FilterAction.java;1;1;2;1;2;2;2;0;4;0;0;290;4;4;1;0;0;0;2;290;0;326;2;1;0
/org.eclipse.ui.workbench/Eclipse UI/org/eclipse/ui/internal/progress/ProgressLabelProvider.java;2;0;8;1;1;1;1;7;113;2;6;23;128;128;2;1;0;7;8;60;1;336;7;2;0
/org.eclipse.jdt.core/model/org/eclipse/jdt/internal/core/BatchOperation.java;2;0;3;1;0;0;0;3;2;1;3;172;6;6;1;0;0;3;3;172;0;199;3;2;0
/org.eclipse.swt/Eclipse SWT Custom Widgets/common/org/eclipse/swt/custom/TableTree.java;4;0;8;2;1;1;1;7;108;3;4;8;172;172;3;3;0;7;8;8;3;337;5;4;0
/org.eclipse.core.runtime/src/org/eclipse/core/runtime/jobs/IJobManager.java;3;2;35;3;3;2;6;29;1011;6;13;23;1757;1757;6;16;4;32;35;71;20;303;15;3;1
/org.eclipse.swt/Eclipse SWT PI/motif/org/eclipse/swt/internal/motif/XFontStruct.java;1;0;1;1;0;0;0;1;2;0;1;54;2;2;1;0;0;1;1;54;0;54;1;1;0
/org.eclipse.ltk.ui.refactoring/src/org/eclipse/ltk/ui/refactoring/RedoRefactoringAction.java;1;1;2;1;2;2;2;0;2;0;0;288;2;2;1;0;0;0;2;288;0;336;2;1;0
/org.eclipse.core.runtime/src/org/eclipse/core/runtime/content/BinarySignatureDescriber.java;3;2;4;2;4;3;4;0;27;0;0;281;58;58;2;0;1;0;4;290;1;325;3;3;0
/org.eclipse.jdt.core/codeassist/org/eclipse/jdt/internal/codeassist/select/SelectionOnExplicitConstructorCall.java;2;0;2;1;0;0;0;2;66;1;2;63;68;68;1;0;0;2;2;63;0;199;2;2;1
/org.eclipse.help.base/src/org/eclipse/help/internal/base/IHelpActivitySupport.java;1;1;5;1;3;3;3;2;13;1;2;188;32;32;1;0;0;2;5;188;0;336;5;1;0
/org.eclipse.debug.ui/ui/org/eclipse/debug/ui/AbstractLaunchConfigurationTab.java;4;0;10;1;1;1;1;9;43;2;7;38;106;106;2;2;0;9;10;163;2;336;8;4;0
/org.eclipse.osgi/osgi/src/org/osgi/service/url/AbstractURLStreamHandlerService.java;2;0;2;1;1;1;1;1;3;0;1;171;3;3;1;0;0;1;2;171;0;296;2;2;0
/org.eclipse.ui.workbench/Eclipse UI/org/eclipse/ui/internal/activities/AbstractActivityManager.java;1;0;4;1;0;0;0;4;33;0;1;160;33;33;4;3;0;4;4;160;3;160;1;1;0
/org.eclipse.jdt.ui/ui/org/eclipse/jdt/internal/ui/text/correction/QuickAssistProcessor.java;1;4;34;1;5;2;5;29;364;6;13;7;1404;1404;6;16;3;29;34;61;19;313;15;1;3
/org.eclipse.help.ui/src/org/eclipse/help/ui/internal/util/RuntimeErrorDialog.java;1;1;3;1;3;3;3;0;84;0;0;299;92;92;1;0;0;0;3;299;0;336;3;1;0
/org.eclipse.jdt.ui/ui/org/eclipse/jdt/internal/ui/packageview/LayoutActionGroup.java;2;0;2;1;1;1;1;1;2;0;1;262;4;4;1;0;0;1;2;262;0;336;2;2;0
/org.eclipse.swt/Eclipse SWT PI/carbon/org/eclipse/swt/internal/carbon/DataBrowserCustomCallbacks.java;1;0;2;1;2;1;2;0;20;0;0;296;20;20;2;0;1;0;2;296;1;296;1;1;0
/org.eclipse.pde.runtime/src/org/eclipse/pde/internal/runtime/registry/RegistryPropertySourceFactory.java;2;0;4;1;1;1;1;3;96;2;2;59;194;194;2;1;0;3;4;224;1;336;3;2;0
/org.eclipse.update.core/src/org/eclipse/update/internal/mirror/MirrorSite.java;2;1;10;2;3;3;3;7;170;3;3;96;421;421;3;4;0;7;10;96;4;336;6;2;0
/org.eclipse.jdt.core/codeassist/org/eclipse/jdt/internal/codeassist/impl/Keywords.java;1;0;2;1;0;0;0;2;2;1;2;6;4;4;1;0;0;2;2;6;0;199;2;1;0
/org.eclipse.ui.workbench/Eclipse UI/org/eclipse/ui/internal/commands/ICommandRegistryListener.java;1;0;3;1;0;0;0;3;18;1;3;86;20;20;1;0;0;3;3;86;0;161;3;1;0
/org.eclipse.ui.workbench/Eclipse UI/org/eclipse/ui/internal/LockToolBarAction.java;2;0;3;2;0;0;0;3;86;2;2;157;138;138;2;1;0;3;3;176;1;176;2;2;0
/org.eclipse.jdt.ui/ui/org/eclipse/jdt/internal/ui/callhierarchy/SearchScopeWorkingSetAction.java;3;2;4;2;3;2;3;1;14;0;1;224;16;16;2;0;1;1;4;293;1;336;3;3;0
/org.eclipse.osgi/defaultAdaptor/src/org/eclipse/osgi/framework/internal/defaultadaptor/DefaultElementFactory.java;2;0;3;2;2;1;2;1;12;0;1;239;12;12;2;0;1;1;3;273;1;273;2;2;0
/org.eclipse.jdt.ui/core refactoring/org/eclipse/jdt/internal/corext/refactoring/code/flow/MessageSendFlowInfo.java;1;0;1;1;1;1;1;0;2;0;0;336;2;2;1;0;0;0;1;336;0;336;1;1;0
/org.eclipse.jdt.core/model/org/eclipse/jdt/internal/core/PackageFragmentInfo.java;1;0;7;1;0;0;0;7;50;2;6;10;75;75;2;1;0;7;7;54;1;266;6;1;0
/org.eclipse.update.core/src/org/eclipse/update/standalone/UpdateCommand.java;1;2;8;1;6;5;6;2;169;1;2;54;263;263;2;0;1;2;8;303;1;336;7;1;0
/org.eclipse.osgi/core/framework/org/eclipse/osgi/framework/internal/protocol/StreamHandlerFactory.java;5;0;7;3;1;1;3;4;207;3;4;171;252;252;3;0;2;6;7;270;2;294;5;5;0
/org.eclipse.ui.workbench/Eclipse UI/org/eclipse/ui/internal/EditorAreaHelper.java;5;4;7;3;7;3;7;0;27;0;0;297;41;41;4;0;4;0;7;297;4;331;3;5;1
/org.eclipse.swt/Eclipse SWT/motif/org/eclipse/swt/widgets/Scrollable.java;4;1;8;2;3;3;3;5;11;2;4;1;45;45;2;1;0;5;8;1;1;337;7;4;0
/org.eclipse.core.resources/src/org/eclipse/core/internal/resources/CharsetManager.java;3;3;8;2;7;4;7;1;381;0;1;239;460;460;3;0;3;1;8;320;3;320;5;3;1
/org.eclipse.ui.forms/src/org/eclipse/ui/forms/ManagedForm.java;1;0;7;1;0;0;0;7;122;0;1;225;122;122;7;6;0;7;7;225;6;225;1;1;0
/org.eclipse.core.resources/src/org/eclipse/core/resources/IProjectNature.java;1;0;2;1;0;0;1;1;105;0;1;270;105;105;2;0;1;2;2;270;1;270;1;1;0
/org.eclipse.debug.core/core/org/eclipse/debug/core/sourcelookup/containers/ExternalArchiveSourceContainer.java;1;0;5;1;3;1;4;1;121;0;1;268;141;141;3;0;3;2;5;313;3;313;2;1;1
/org.eclipse.update.core/src/org/eclipse/update/internal/mirror/MirrorSiteFactory.java;3;0;8;2;1;1;1;7;112;3;4;96;255;255;3;3;0;7;8;227;3;303;5;3;0
/org.eclipse.swt/Eclipse SWT/gtk/org/eclipse/swt/widgets/ToolItem.java;6;1;11;3;2;2;2;9;96;3;6;3;269;269;3;3;0;9;11;77;3;337;8;6;0
/org.eclipse.osgi/core/adaptor/org/eclipse/osgi/framework/adaptor/BundleOperation.java;4;1;4;1;2;2;2;2;53;1;2;171;59;59;1;0;0;2;4;171;0;336;4;4;0
/org.eclipse.ant.ui/Ant Editor/org/eclipse/ant/internal/ui/editor/outline/DocumentModelChangeEvent.java;1;0;2;1;1;1;1;1;15;0;1;108;15;15;1;0;0;1;2;108;0;323;2;1;0
/org.eclipse.jdt.core/search/org/eclipse/jdt/core/search/FieldReferenceMatch.java;4;3;9;3;4;2;4;5;64;2;3;218;135;135;3;2;2;5;9;275;4;314;5;4;0
/org.eclipse.osgi/eclipseAdaptor/src/org/eclipse/core/runtime/adaptor/EclipseClassLoader.java;5;0;35;4;2;1;19;16;425;19;7;171;771;771;19;9;18;33;35;268;27;326;8;5;0
/org.eclipse.debug.ui/ui/org/eclipse/debug/internal/ui/launchConfigurations/PerspectiveTabGroup.java;1;0;1;1;0;0;0;1;0;0;1;42;0;0;1;0;0;1;1;42;0;42;1;1;0
/org.eclipse.jdt.ui/ui/org/eclipse/jdt/internal/ui/packageview/GotoTypeAction.java;2;0;2;1;1;1;1;1;6;0;1;84;8;8;1;0;0;1;2;84;0;336;2;2;0
/org.eclipse.ui.ide/extensions/org/eclipse/ui/actions/MoveFilesAndFoldersOperation.java;1;0;1;1;0;0;0;1;0;0;1;132;0;0;1;0;0;1;1;132;0;132;1;1;0
/org.eclipse.jdt.core/model/org/eclipse/jdt/internal/core/builder/WorkQueue.java;1;0;1;1;0;0;0;1;2;0;1;199;2;2;1;0;0;1;1;199;0;199;1;1;0
/org.eclipse.swt/Eclipse SWT PI/carbon/org/eclipse/swt/internal/carbon/ATSUCaret.java;2;0;3;1;2;1;2;1;20;0;1;248;20;20;2;0;1;1;3;296;1;296;2;2;0
/org.eclipse.ui.workbench/Eclipse UI/org/eclipse/ui/internal/registry/PreferencePageRegistryReader.java;5;0;7;2;1;1;1;6;424;4;3;157;480;480;4;3;0;6;7;157;3;336;4;5;0
/org.eclipse.ant.ui/Ant Editor/org/eclipse/ant/internal/ui/dtd/ParseError.java;1;0;1;1;0;0;0;1;0;0;1;108;0;0;1;0;0;1;1;108;0;108;1;1;0
/org.eclipse.jface/src/org/eclipse/jface/viewers/TableViewerImpl.java;2;1;2;1;2;2;2;0;3;0;0;272;5;5;1;0;0;0;2;272;0;336;2;2;0
/org.eclipse.jdt.ui/ui/org/eclipse/jdt/internal/ui/wizards/dialogfields/LayoutUtil.java;4;0;4;1;1;1;1;3;24;1;3;88;34;34;1;0;0;3;4;88;0;336;4;4;0
/org.eclipse.core.runtime/src/org/eclipse/core/runtime/content/XMLRootElementContentDescriber.java;2;4;7;2;7;4;7;0;61;0;0;281;125;125;4;0;3;0;7;290;3;320;4;2;0
/org.eclipse.core.resources/src/org/eclipse/core/resources/ResourcesPlugin.java;2;0;16;2;1;1;4;12;296;10;6;3;376;376;10;6;3;15;16;247;9;326;7;2;1
/org.eclipse.debug.ui/ui/org/eclipse/debug/internal/ui/views/memory/IMemoryBlockViewSynchronizer.java;1;0;1;1;1;1;1;0;0;0;0;282;0;0;1;0;0;0;1;282;0;282;1;1;2
/org.eclipse.team.ui/src/org/eclipse/team/internal/ui/synchronize/IRefreshSubscriberListener.java;1;1;5;1;2;2;2;3;42;1;3;211;52;52;1;0;0;3;5;211;0;336;5;1;0
/org.eclipse.ui.workbench.texteditor/src/org/eclipse/ui/texteditor/ContentAssistAction.java;2;0;5;1;1;1;1;4;10;2;3;124;15;15;2;1;0;4;5;124;1;336;4;2;0
/org.eclipse.ui.workbench/Eclipse UI/org/eclipse/ui/internal/commands/KeyConfiguration.java;3;1;13;1;2;2;2;11;309;3;6;80;739;739;3;5;0;11;13;80;5;336;8;3;0
/org.eclipse.jdt.core/codeassist/org/eclipse/jdt/internal/codeassist/complete/CompletionOnKeyword1.java;2;0;2;1;0;0;0;2;5;1;2;63;7;7;1;0;0;2;2;63;0;199;2;2;0
/org.eclipse.debug.ui/ui/org/eclipse/debug/internal/ui/views/memory/AddMemoryBlockAction.java;2;0;4;2;4;1;4;0;7;0;0;282;7;7;4;0;3;0;4;282;3;282;1;2;3
/org.eclipse.jdt.ui/ui/org/eclipse/jdt/internal/ui/javadocexport/JavadocStandardWizardPage.java;2;2;6;1;3;2;3;3;226;1;3;76;516;516;2;0;1;3;6;302;1;336;5;2;0
/org.eclipse.pde.runtime/src/org/eclipse/pde/internal/runtime/registry/PrerequisitePropertySource.java;2;1;5;1;2;2;2;3;214;2;2;59;473;473;2;1;0;3;5;224;1;336;4;2;0
/org.eclipse.jdt.core/search/org/eclipse/jdt/internal/core/search/matching/TypeReferenceLocator.java;4;0;13;2;2;1;2;11;335;3;8;118;589;589;3;3;1;11;13;118;4;276;9;4;7
/org.eclipse.pde.ui/src/org/eclipse/pde/internal/ui/editor/text/XMLTagRule.java;3;1;3;1;2;2;2;1;4;0;1;211;6;6;1;0;0;1;3;211;0;336;3;3;0
/org.eclipse.ui.ide/src/org/eclipse/ui/internal/ide/model/WorkbenchAdapterFactory.java;1;0;1;1;0;0;0;1;0;0;1;132;0;0;1;0;0;1;1;132;0;132;1;1;0
/org.eclipse.jdt.ui/ui/org/eclipse/jdt/internal/ui/javaeditor/ISavePolicy.java;1;0;1;1;1;1;1;0;2;0;0;336;2;2;1;0;0;0;1;336;0;336;1;1;0
/org.eclipse.pde.ui/src/org/eclipse/pde/internal/ui/editor/PDESourcePage.java;2;2;9;2;4;3;4;5;445;3;3;157;537;537;3;2;1;5;9;157;3;336;6;2;0
/org.eclipse.jdt.ui/ui refactoring/org/eclipse/jdt/internal/ui/refactoring/QualifiedNameComponent.java;1;0;1;1;1;1;1;0;2;0;0;336;2;2;1;0;0;0;1;336;0;336;1;1;0
/org.eclipse.pde.core/src/org/eclipse/pde/internal/core/ClasspathUtilCore.java;3;2;25;2;7;4;7;18;380;4;11;1;960;960;4;7;3;18;25;167;10;336;15;3;0
/org.eclipse.core.resources/src/org/eclipse/core/internal/resources/MarkerDeltaManager.java;2;0;2;1;1;1;1;1;14;0;1;104;14;14;1;0;0;1;2;104;0;277;2;2;0
/org.eclipse.ui.workbench.texteditor/src/org/eclipse/ui/texteditor/SelectAnnotationRulerAction.java;2;1;2;1;2;2;2;0;2;0;0;279;2;2;1;0;0;0;2;279;0;336;2;2;0
/org.eclipse.osgi/osgi/src/org/eclipse/osgi/service/resolver/VersionRange.java;1;3;4;1;4;2;4;0;51;0;0;290;56;56;3;0;2;0;4;290;2;331;2;1;0
/org.eclipse.jdt.debug/jdi/org/eclipse/jdi/internal/connect/SocketTransportImpl.java;3;0;3;2;0;0;0;3;8;2;2;89;14;14;2;1;0;3;3;184;1;184;2;3;0
/org.eclipse.ui.workbench/Eclipse UI/org/eclipse/ui/internal/presentations/PresentablePart.java;1;0;1;1;1;1;1;0;0;0;0;309;0;0;1;0;0;0;1;309;0;309;1;1;0
/org.eclipse.swt/Eclipse SWT Mozilla/common/org/eclipse/swt/internal/mozilla/nsIChannel.java;1;0;1;1;0;0;0;1;0;0;1;153;0;0;1;0;0;1;1;153;0;153;1;1;0
/org.eclipse.jdt.ui/ui/org/eclipse/jdt/internal/ui/search/JavaSearchDescription.java;2;0;3;1;1;1;1;2;66;1;2;196;68;68;1;0;0;2;3;196;0;336;3;2;0
/org.eclipse.tomcat/src/org/eclipse/tomcat/internal/JndiURLHandler.java;1;1;4;1;3;3;3;1;99;0;1;173;126;126;1;0;0;1;4;173;0;336;4;1;0
/org.eclipse.swt/Eclipse SWT/motif/org/eclipse/swt/graphics/GC.java;5;1;18;2;3;3;3;15;226;5;9;1;918;918;5;6;0;15;18;32;6;337;12;5;1
/org.eclipse.update.core/src/org/eclipse/update/core/model/DefaultFeatureParser.java;4;2;10;1;4;2;4;6;193;1;6;0;271;271;2;0;2;6;10;289;2;302;8;4;0
/org.eclipse.help/src/org/eclipse/help/internal/protocols/HelpURLStreamHandler.java;1;1;4;1;3;3;3;1;16;0;1;159;34;34;1;0;0;1;4;159;0;336;4;1;0
/org.eclipse.ui.ide/src/org/eclipse/ui/internal/ide/registry/MarkerHelpRegistry.java;1;0;1;1;0;0;0;1;0;0;1;132;0;0;1;0;0;1;1;132;0;132;1;1;1
/org.eclipse.jface.text/src/org/eclipse/jface/text/IPaintPositionManager.java;2;0;2;2;2;1;2;0;5;0;0;336;5;5;2;0;1;0;2;336;1;336;1;2;0
/org.eclipse.osgi/defaultAdaptor/src/org/eclipse/osgi/framework/internal/protocol/bundleresource/Handler.java;2;0;4;1;1;1;1;3;15;1;3;203;31;31;1;0;0;3;4;203;0;276;4;2;0
/org.eclipse.jdt.debug/model/org/eclipse/jdt/internal/debug/core/EventDispatcher.java;4;0;5;2;1;1;1;4;32;2;3;26;47;47;2;1;0;4;5;220;1;336;4;4;2
/org.eclipse.jdt.ui/ui/org/eclipse/jdt/internal/ui/javaeditor/JavaEditorMessages.java;1;0;1;1;1;1;1;0;2;0;0;336;2;2;1;0;0;0;1;336;0;336;1;1;0
/org.eclipse.compare/compare/org/eclipse/compare/structuremergeviewer/StructureDiffViewer.java;1;0;2;1;0;0;0;2;4;1;2;19;6;6;1;0;0;2;2;19;0;219;2;1;0
/org.eclipse.jdt.ui/ui/org/eclipse/jdt/ui/actions/FindImplementorsAction.java;1;0;1;1;1;1;1;0;2;0;0;336;2;2;1;0;0;0;1;336;0;336;1;1;0
/org.eclipse.jface.text/src/org/eclipse/jface/text/source/CompositeRuler.java;3;0;11;2;2;1;4;7;71;3;5;60;258;258;3;2;3;9;11;70;5;336;6;3;0
/org.eclipse.core.runtime/src/org/eclipse/core/internal/registry/Namespace.java;3;2;3;2;3;2;3;0;56;0;0;296;71;71;2;0;1;0;3;296;1;307;2;3;0
/org.eclipse.jdt.core/dom/org/eclipse/jdt/internal/core/dom/rewrite/NodeInfoStore.java;3;0;3;2;1;1;1;2;244;0;1;262;247;247;2;1;0;2;3;262;1;290;2;3;0
/org.eclipse.jdt.core/model/org/eclipse/jdt/internal/core/hierarchy/HierarchyType.java;1;0;2;1;0;0;0;2;15;1;2;124;17;17;1;0;0;2;2;124;0;199;2;1;0
/org.eclipse.search/new search/org/eclipse/search2/internal/ui/ShowSearchAction.java;2;0;4;1;1;1;1;3;9;2;2;195;11;11;2;1;0;3;4;262;1;336;3;2;0
/org.eclipse.ui.workbench/Eclipse UI/org/eclipse/ui/internal/registry/WorkingSetDescriptor.java;2;0;3;1;1;1;1;2;16;1;2;157;21;21;1;0;0;2;3;157;0;336;3;2;1
/org.eclipse.jdt.ui/core extension/org/eclipse/jdt/internal/corext/callhierarchy/CalleeMethodWrapper.java;3;0;7;1;1;1;1;6;73;3;3;13;143;143;3;3;0;6;7;13;3;336;4;3;0
/org.eclipse.pde.ui/src/org/eclipse/pde/internal/ui/launcher/WorkbenchLaunchConfigurationDelegate.java;2;7;34;2;12;4;12;22;708;4;12;26;1294;1294;7;10;8;22;34;308;18;333;16;2;0
/org.eclipse.ui.workbench/Eclipse UI/org/eclipse/ui/internal/decorators/DecorationBuilder.java;2;1;3;1;3;3;3;0;14;0;0;275;24;24;1;0;0;0;3;275;0;336;3;2;0
/org.eclipse.ant.ui/Ant Editor/org/eclipse/ant/internal/ui/editor/templates/AntTemplateInformationControlCreator.java;1;0;1;1;1;1;1;0;0;0;0;283;0;0;1;0;0;0;1;283;0;283;1;1;0
/org.eclipse.jdt.core/model/org/eclipse/jdt/core/ClasspathContainerInitializer.java;4;2;8;1;4;3;4;4;28;2;3;108;88;88;2;1;1;4;8;149;2;302;6;4;0
/org.eclipse.jdt.ui/ui/org/eclipse/jdt/internal/ui/text/java/hover/JavaSourceHover.java;3;1;9;2;2;2;2;7;106;3;5;47;138;138;3;2;0;7;9;89;2;336;7;3;1
/org.eclipse.jdt.ui/ui/org/eclipse/jdt/internal/ui/text/correction/MissingReturnTypeCorrectionProposal.java;3;1;16;2;2;2;2;14;48;3;9;26;162;162;3;5;0;14;16;26;5;336;11;3;0
/org.eclipse.swt/Eclipse SWT/carbon/org/eclipse/swt/widgets/Display.java;7;5;55;5;11;3;11;44;630;13;10;0;2109;2109;13;34;8;44;55;0;42;324;13;7;2
/org.eclipse.compare/compare/org/eclipse/compare/internal/DocLineComparator.java;1;0;2;1;0;0;0;2;39;1;2;38;42;42;1;0;0;2;2;38;0;79;2;1;0
/org.eclipse.ui.workbench/Eclipse UI/org/eclipse/ui/actions/ActionContext.java;1;0;1;1;0;0;0;1;2;0;1;0;2;2;1;0;0;1;1;0;0;0;1;1;0
/org.eclipse.team.cvs.ui/src/org/eclipse/team/internal/ccvs/ui/wizards/CVSWizardPage.java;2;0;4;1;1;1;1;3;59;2;2;68;81;81;2;1;0;3;4;254;1;336;3;2;1
/org.eclipse.update.core/src/org/eclipse/update/core/InstallHandlerEntry.java;2;1;3;1;2;2;2;1;6;0;1;58;12;12;1;0;0;1;3;58;0;336;3;2;0
/org.eclipse.ant.ui/Ant Tools Support/org/eclipse/ant/internal/ui/launchConfigurations/AntPropertiesTab.java;2;0;5;1;0;0;0;5;29;2;4;108;39;39;2;1;0;5;5;265;1;265;4;2;2
/org.eclipse.update.ui/src/org/eclipse/update/internal/ui/views/FindUpdatesAction.java;3;2;14;2;3;2;3;11;31;4;7;54;90;90;4;4;1;11;14;54;5;336;9;3;0
/org.eclipse.pde.core/src/org/eclipse/pde/internal/core/search/IPluginSearchResultCollector.java;1;0;2;1;1;1;1;1;4;0;1;232;8;8;1;0;0;1;2;232;0;336;2;1;0
/org.eclipse.ui.workbench/Eclipse UI/org/eclipse/ui/model/WorkbenchLabelProvider.java;4;1;7;1;2;2;2;5;136;3;3;0;265;265;3;2;0;5;7;225;2;336;5;4;0
/org.eclipse.swt/Eclipse SWT PI/motif/org/eclipse/swt/internal/motif/XEvent.java;1;0;2;1;0;0;0;2;4;1;2;56;6;6;1;0;0;2;2;56;0;88;2;1;0
/org.eclipse.core.resources/src/org/eclipse/core/internal/events/InternalBuilder.java;2;0;4;1;1;1;1;3;217;1;3;177;275;275;1;0;0;3;4;177;0;277;4;2;0
/org.eclipse.search/search/org/eclipse/search/ui/ISearchPageScoreComputer.java;1;0;1;1;1;1;1;0;2;0;0;336;2;2;1;0;0;0;1;336;0;336;1;1;0
/org.eclipse.debug.ui/ui/org/eclipse/debug/internal/ui/actions/ProfileHistoryMenuAction.java;1;0;1;1;0;0;0;1;0;0;1;33;0;0;1;0;0;1;1;33;0;33;1;1;0
/org.eclipse.jdt.core/model/org/eclipse/jdt/internal/core/Member.java;2;1;14;2;2;2;2;12;122;5;7;59;191;191;5;5;0;12;14;112;5;299;9;2;0
/org.eclipse.core.resources/src/org/eclipse/core/internal/localstore/CoreFileSystemLibrary.java;3;0;4;1;1;1;1;3;43;1;3;9;61;61;1;0;0;3;4;9;0;277;4;3;1
/org.eclipse.jdt.core/compiler/org/eclipse/jdt/internal/compiler/IErrorHandlingPolicy.java;1;0;1;1;0;0;0;1;2;0;1;199;2;2;1;0;0;1;1;199;0;199;1;1;0
/org.eclipse.jdt.ui/ui/org/eclipse/jdt/internal/ui/javaeditor/JavaSelectMarkerRulerAction2.java;4;0;6;3;1;1;3;3;100;3;3;147;145;145;3;0;2;5;6;268;2;336;4;4;0
/org.eclipse.jface.text/src/org/eclipse/jface/text/reconciler/DirtyRegionQueue.java;1;0;2;1;2;1;2;0;16;0;0;336;16;16;2;0;1;0;2;336;1;336;1;1;0
/org.eclipse.ltk.core.refactoring/src/org/eclipse/ltk/core/refactoring/TextFileChange.java;1;3;7;1;5;2;5;2;67;0;1;264;92;92;3;1;3;2;7;275;4;336;3;1;0
/org.eclipse.core.runtime/src/org/eclipse/core/internal/preferences/Base64.java;2;1;2;1;2;2;2;0;13;0;0;275;18;18;1;0;0;0;2;275;0;312;2;2;0
/org.eclipse.jdt.core/model/org/eclipse/jdt/internal/core/builder/AbortIncrementalBuildException.java;1;0;1;1;0;0;0;1;2;0;1;199;2;2;1;0;0;1;1;199;0;199;1;1;0
/org.eclipse.swt/Eclipse SWT PI/carbon/org/eclipse/swt/internal/carbon/NavReplyRecord.java;1;0;2;1;2;1;2;0;20;0;0;296;20;20;2;0;1;0;2;296;1;296;1;1;0
/org.eclipse.jdt.ui/ui/org/eclipse/jdt/internal/ui/text/java/JavaStringDoubleClickSelector.java;3;1;3;1;2;2;2;1;15;0;1;96;19;19;1;0;0;1;3;96;0;336;3;3;0
/org.eclipse.jdt.ui/ui/org/eclipse/jdt/ui/actions/ProjectActionGroup.java;3;1;3;1;2;2;2;1;10;0;1;237;16;16;1;0;0;1;3;237;0;336;3;3;0
/org.eclipse.core.runtime/src/org/eclipse/core/internal/registry/ConfigurationProperty.java;3;2;6;2;3;2;3;3;122;2;2;173;136;136;2;1;1;3;6;173;2;336;4;3;0
/org.eclipse.search/search/org/eclipse/search/internal/ui/util/ComboFieldEditor.java;1;0;1;1;1;1;1;0;2;0;0;336;2;2;1;0;0;0;1;336;0;336;1;1;0
/org.eclipse.debug.ui/ui/org/eclipse/debug/internal/ui/views/console/ConsoleMessages.java;1;0;1;1;0;0;0;1;0;0;1;86;0;0;1;0;0;1;1;86;0;86;1;1;0
/org.eclipse.ltk.core.refactoring/src/org/eclipse/ltk/core/refactoring/participants/RenameProcessor.java;1;0;6;1;1;1;4;2;119;0;1;264;129;129;5;1;3;5;6;264;4;336;2;1;0
/org.eclipse.ui.workbench/Eclipse UI/org/eclipse/ui/internal/decorators/DecoratorRegistryReader.java;3;0;4;1;1;1;1;3;30;1;3;157;58;58;1;0;0;3;4;157;0;336;4;3;0
/org.eclipse.ant.ui/Ant Editor/org/eclipse/ant/internal/ui/dtd/util/IValueHolder.java;1;0;1;1;0;0;0;1;0;0;1;108;0;0;1;0;0;1;1;108;0;108;1;1;0
/org.eclipse.ui.workbench/Eclipse UI/org/eclipse/ui/internal/dialogs/PreferenceImportExportSettingsSelectionPage.java;3;0;3;1;1;1;1;2;10;1;2;203;14;14;1;0;0;2;3;203;0;336;3;3;1
/org.eclipse.search/new search/org/eclipse/search/ui/text/Match.java;3;3;7;2;5;3;5;2;93;1;2;195;179;179;3;0;2;2;7;276;2;336;5;3;0
/org.eclipse.ui.views/src/org/eclipse/ui/views/properties/PropertySheetPage.java;3;1;5;1;2;2;2;3;25;1;3;0;49;49;1;0;0;3;5;0;0;336;5;3;0
/org.eclipse.osgi/osgi/src/org/osgi/framework/Filter.java;2;0;2;1;1;1;1;1;3;0;1;171;3;3;1;0;0;1;2;171;0;296;2;2;0
/org.eclipse.swt/Eclipse SWT/common/org/eclipse/swt/internal/image/PngIhdrChunk.java;2;0;2;1;1;1;1;1;4;0;1;241;6;6;1;0;0;1;2;241;0;337;2;2;0
/org.eclipse.swt/Eclipse SWT PI/gtk/org/eclipse/swt/internal/gtk/PangoLogAttr.java;2;0;2;1;1;1;1;1;2;0;1;250;2;2;1;0;0;1;2;250;0;337;2;2;0
/org.eclipse.ltk.core.refactoring/src/org/eclipse/ltk/core/refactoring/TextEditChangeGroup.java;1;1;3;1;2;2;2;1;3;0;1;264;5;5;1;0;0;1;3;264;0;336;3;1;0
/org.eclipse.update.core/src/org/eclipse/update/core/BaseInstallHandler.java;3;1;4;1;2;2;2;2;6;1;2;0;14;14;1;0;0;2;4;0;0;336;4;3;0
/org.eclipse.update.ui/src/org/eclipse/update/internal/ui/wizards/ModeSelectionPage.java;3;0;10;3;1;1;1;9;79;4;5;15;165;165;4;4;0;9;10;50;4;330;6;3;0
/org.eclipse.jdt.ui/ui/org/eclipse/jdt/internal/ui/javaeditor/ToggleTextHoverAction.java;1;0;1;1;1;1;1;0;2;0;0;336;2;2;1;0;0;0;1;336;0;336;1;1;0
/org.eclipse.team.ui/src/org/eclipse/team/internal/ui/synchronize/UnchangedResourceModelElement.java;1;0;2;1;1;1;1;1;2;0;1;251;2;2;1;0;0;1;2;251;0;336;2;1;0
/org.eclipse.pde.build/src/org/eclipse/pde/internal/build/Config.java;2;0;6;1;1;1;1;5;4;2;3;31;4;4;2;2;0;5;6;31;2;277;4;2;0
/org.eclipse.jdt.core/search/org/eclipse/jdt/core/search/SearchParticipant.java;4;2;13;2;6;4;6;7;283;3;4;181;437;437;3;3;2;7;13;181;5;324;8;4;0
/org.eclipse.ui.forms/src/org/eclipse/ui/internal/forms/widgets/FormsResources.java;1;1;2;1;2;2;2;0;6;0;0;272;6;6;1;0;0;0;2;272;0;336;2;1;0
/org.eclipse.jdt.ui/ui/org/eclipse/jdt/ui/JavaElementSorter.java;4;0;7;2;1;1;1;6;38;2;5;88;82;82;2;1;0;6;7;207;1;336;6;4;0
/org.eclipse.help.ui/src/org/eclipse/help/ui/internal/HyperlinkLabel.java;1;1;5;1;3;3;3;2;116;1;2;112;197;197;1;0;0;2;5;112;0;336;5;1;0
/org.eclipse.ui.workbench/Eclipse UI/org/eclipse/ui/internal/decorators/LightweightDecoratorDefinition.java;1;0;1;1;0;0;0;1;11;0;1;157;11;11;1;0;0;1;1;157;0;157;1;1;0
/org.eclipse.swt/Eclipse SWT Program/win32/org/eclipse/swt/program/Program.java;5;2;8;1;3;2;3;5;57;1;5;92;123;123;2;0;1;5;8;280;1;337;7;5;1
/org.eclipse.core.filebuffers/src/org/eclipse/core/internal/filebuffers/AbstractFileBuffer.java;2;1;3;1;2;2;2;1;60;0;1;130;80;80;1;0;0;1;3;130;0;336;3;2;0
/org.eclipse.core.runtime.compatibility/src-boot/org/eclipse/core/boot/BootLoader.java;3;4;13;2;6;3;6;7;390;4;4;171;644;644;4;3;3;7;13;171;6;336;7;3;0
/org.eclipse.jdt.ui/ui/org/eclipse/jdt/internal/ui/javaeditor/CustomBufferFactory.java;2;1;5;1;2;2;2;3;36;1;3;71;73;73;1;0;0;3;5;71;0;336;5;2;0
/org.eclipse.jdt.ui/ui/org/eclipse/jdt/internal/ui/text/spelling/engine/ISpellCheckEngine.java;2;0;2;1;1;1;1;1;2;0;1;219;2;2;1;0;0;1;2;219;0;336;2;2;0
/org.eclipse.jdt.core/dom/org/eclipse/jdt/core/dom/IMethodBinding.java;3;0;5;2;0;0;0;5;36;2;4;171;54;54;2;1;0;5;5;171;1;269;4;3;3
/org.eclipse.osgi/core/framework/org/eclipse/osgi/framework/internal/core/KeyedHashSet.java;5;2;6;2;4;3;4;2;632;1;2;171;675;675;2;0;1;2;6;293;1;336;5;5;0
/org.eclipse.team.cvs.ui/src/org/eclipse/team/internal/ccvs/ui/operations/CheckoutProjectOperation.java;2;2;24;1;8;6;8;16;481;4;10;45;1030;1030;4;6;2;16;24;110;8;336;16;2;1
/org.eclipse.jdt.core/compiler/org/eclipse/jdt/internal/compiler/ast/ArrayQualifiedTypeReference.java;2;0;3;1;0;0;0;3;84;1;3;63;92;92;1;0;0;3;3;63;0;199;3;2;1
/org.eclipse.ui.workbench/Eclipse UI/org/eclipse/ui/internal/progress/AnimationManager.java;3;0;33;3;4;1;4;29;476;9;8;91;1522;1522;9;21;3;29;33;91;24;323;9;3;0
/org.eclipse.pde.ui/src/org/eclipse/pde/internal/ui/search/UnusedDependenciesAction.java;3;2;5;2;3;2;3;2;93;0;1;168;116;116;2;1;1;2;5;168;2;336;3;3;0
/org.eclipse.text/src/org/eclipse/jface/text/IDocumentExtension3.java;3;2;5;2;4;2;4;1;97;0;1;92;133;133;2;0;2;1;5;274;2;334;3;3;0
/org.eclipse.search/search/org/eclipse/search/internal/ui/text/FileSearchDescription.java;2;0;2;1;1;1;1;1;2;0;1;207;2;2;1;0;0;1;2;207;0;336;2;2;0
/org.eclipse.jdt.core/compiler/org/eclipse/jdt/internal/compiler/ast/QualifiedThisReference.java;2;0;4;1;0;0;0;4;4;1;4;63;12;12;1;0;0;4;4;63;0;199;4;2;0
/org.eclipse.ui.intro/src/org/eclipse/ui/internal/intro/impl/html/HTMLElement.java;1;1;2;1;2;2;2;0;2;0;0;276;2;2;1;0;0;0;2;276;0;286;2;1;0
/org.eclipse.swt/Eclipse SWT Drag and Drop/emulated/org/eclipse/swt/dnd/DragSource.java;1;0;1;1;0;0;0;1;4;0;1;0;4;4;1;0;0;1;1;0;0;0;1;1;0
/org.eclipse.jdt.debug.ui/ui/org/eclipse/jdt/internal/debug/ui/launcher/NameValuePairDialog.java;2;0;3;1;0;0;0;3;26;1;3;8;53;53;1;0;0;3;3;8;0;180;3;2;0
/org.eclipse.swt/Eclipse SWT Printing/carbon/org/eclipse/swt/printing/Printer.java;3;1;12;1;5;5;5;7;414;3;4;0;489;489;3;3;0;7;12;158;3;337;9;3;0
/org.eclipse.team.cvs.core/src/org/eclipse/team/internal/ccvs/core/client/CRLFDetectInputStream.java;1;0;3;1;0;0;0;3;35;2;2;118;66;66;2;1;0;3;3;118;1;177;2;1;0
/org.eclipse.jdt.debug.ui/ui/org/eclipse/jdt/internal/debug/ui/JavaStepFilterPreferencePage.java;4;1;8;2;3;3;3;5;178;3;3;176;260;260;3;2;0;5;8;197;2;336;6;4;1
/org.eclipse.jface/src/org/eclipse/jface/preference/RadioGroupFieldEditor.java;2;1;3;1;3;3;3;0;4;0;0;272;9;9;1;0;0;0;3;272;0;336;3;2;0
/org.eclipse.team.ui/src/org/eclipse/team/internal/ui/synchronize/RefreshEvent.java;1;1;4;1;2;2;2;2;4;0;1;250;9;9;2;1;0;2;4;250;1;336;3;1;0
/org.eclipse.jdt.core/model/org/eclipse/jdt/internal/compiler/parser/SourceConstructorDeclaration.java;1;0;1;1;0;0;0;1;0;0;1;245;0;0;1;0;0;1;1;245;0;245;1;1;0
/org.eclipse.swt/Eclipse SWT/gtk/org/eclipse/swt/widgets/ImageList.java;4;0;5;1;1;1;1;4;21;1;4;44;49;49;1;0;0;4;5;44;0;337;5;4;0
/org.eclipse.team.cvs.ui/src/org/eclipse/team/internal/ccvs/ui/WorkInProgressPreferencePage.java;2;0;7;1;0;0;0;7;11;2;4;64;26;26;2;3;0;7;7;64;3;163;4;2;0
/org.eclipse.jdt.ui/ui/org/eclipse/jdt/internal/ui/javaeditor/ClassFileDocumentProvider.java;2;0;5;2;1;1;1;4;32;2;3;82;46;46;2;1;0;4;5;96;1;336;4;2;0
/org.eclipse.jdt.core/dom/org/eclipse/jdt/core/dom/Statement.java;2;0;6;2;1;1;1;5;32;2;3;199;50;50;2;2;0;5;6;199;2;287;4;2;0
/org.eclipse.debug.core/core/org/eclipse/debug/internal/core/LaunchConfigurationWorkingCopy.java;5;4;11;2;6;3;6;5;115;1;5;76;248;248;4;0;3;5;11;303;3;336;8;5;0
/org.eclipse.jdt.debug.ui/ui/org/eclipse/jdt/internal/debug/ui/actions/OpenDeclaringTypeAction.java;1;0;1;1;0;0;0;1;4;0;1;144;4;4;1;0;0;1;1;144;0;144;1;1;0
/org.eclipse.compare/compare/org/eclipse/compare/internal/CompareOutlinePage.java;1;0;2;1;0;0;0;2;12;0;1;219;12;12;2;1;0;2;2;219;1;219;1;1;0
/org.eclipse.ui.workbench/Eclipse UI/org/eclipse/ui/application/IWorkbenchConfigurer.java;5;1;8;2;2;2;2;6;145;1;6;77;218;218;1;0;0;6;8;77;0;336;8;5;0
/org.eclipse.ui.ide/src/org/eclipse/ui/views/markers/internal/RestartableJob.java;2;0;6;2;1;1;1;5;23;2;4;181;64;64;2;1;0;5;6;181;1;336;5;2;0
/org.eclipse.jdt.core/compiler/org/eclipse/jdt/internal/compiler/problem/AbortCompilationUnit.java;2;0;2;1;1;1;1;1;5;0;1;199;7;7;1;0;0;1;2;199;0;300;2;2;0
/org.eclipse.jdt.debug.ui/ui/org/eclipse/jdt/internal/debug/ui/monitors/MonitorsDebugEventHandler.java;2;1;2;1;2;2;2;0;37;0;0;306;41;41;1;0;0;0;2;306;0;336;2;2;0
/org.eclipse.ui.workbench/Eclipse UI/org/eclipse/ui/internal/IChangeListener.java;2;0;2;1;0;0;0;2;24;1;2;206;24;24;1;0;0;2;2;206;0;223;2;2;0
/org.eclipse.pde.build/src/org/eclipse/pde/internal/build/site/BuildTimeFeatureFactory.java;2;4;13;2;6;2;6;7;23;2;5;31;36;36;4;2;4;7;13;296;6;296;7;2;0
/org.eclipse.jdt.core/eval/org/eclipse/jdt/internal/eval/CodeSnippetScope.java;4;0;7;1;1;1;1;6;20;1;6;7;37;37;1;0;0;6;7;7;0;325;7;4;0
/org.eclipse.pde.ui/src/org/eclipse/pde/internal/ui/preferences/ExternalPluginsBlock.java;3;4;20;3;7;3;7;13;82;3;9;16;266;266;4;4;4;13;20;322;8;322;12;3;0
/org.eclipse.debug.ui/ui/org/eclipse/debug/internal/ui/DebugUIPlugin.java;5;0;69;4;3;1;23;46;897;23;13;23;1486;1486;23;33;22;66;69;264;55;323;14;5;6
/org.eclipse.team.cvs.ui/src/org/eclipse/team/internal/ccvs/ui/subscriber/CompareRevertAction.java;2;1;8;2;2;2;2;6;103;4;3;207;221;221;4;3;0;6;8;244;3;336;5;2;0
/org.eclipse.debug.ui/ui/org/eclipse/debug/internal/ui/actions/EditLaunchConfigurationAction.java;3;0;4;1;1;1;1;3;15;1;3;10;48;48;1;0;0;3;4;10;0;280;4;3;0
/org.eclipse.tomcat/src/org/eclipse/tomcat/internal/TomcatResources.java;2;1;7;1;3;3;3;4;105;2;3;8;128;128;2;1;0;4;7;8;1;336;6;2;0
/org.eclipse.ui.workbench/Eclipse UI/org/eclipse/ui/internal/dialogs/ViewContentProvider.java;6;0;12;4;1;1;1;11;297;6;6;115;609;609;6;5;0;11;12;157;5;336;7;6;0
/org.eclipse.pde.core/src/org/eclipse/pde/internal/core/ModelProviderEvent.java;1;0;2;1;1;1;1;1;6;0;1;202;10;10;1;0;0;1;2;202;0;336;2;1;0
/org.eclipse.jdt.core/dom/org/eclipse/jdt/core/dom/ThrowStatement.java;3;0;8;1;2;1;2;6;78;2;5;199;108;108;2;1;1;6;8;266;2;276;6;3;1
/org.eclipse.ui.ide/extensions/org/eclipse/ui/actions/CopyProjectOperation.java;3;0;3;1;1;1;1;2;19;1;2;132;21;21;1;0;0;2;3;132;0;336;3;3;1
/org.eclipse.ant.ui/Ant Tools Support/org/eclipse/ant/internal/ui/model/IAntUIConstants.java;3;0;17;2;2;1;2;15;14;6;4;108;49;49;6;11;1;15;17;236;12;294;5;3;1
/org.eclipse.ui.ide/extensions/org/eclipse/ui/actions/CreateProjectAction.java;3;0;4;1;1;1;1;3;4;1;3;132;9;9;1;0;0;3;4;132;0;336;4;3;0
/org.eclipse.ant.ui/Ant Editor/org/eclipse/ant/internal/ui/dtd/util/IKeyHolder.java;1;0;1;1;0;0;0;1;0;0;1;108;0;0;1;0;0;1;1;108;0;108;1;1;0
/org.eclipse.jface/src/org/eclipse/jface/util/Geometry.java;4;0;7;2;0;0;0;7;400;3;5;207;571;571;3;2;0;7;7;219;2;253;5;4;2
/org.eclipse.ant.ui/Ant Tools Support/org/eclipse/ant/internal/ui/views/actions/RemoveAllAction.java;1;0;2;1;0;0;0;2;4;0;1;108;4;4;2;1;0;2;2;108;1;108;1;1;1
/org.eclipse.ltk.ui.refactoring/src/org/eclipse/ltk/internal/ui/refactoring/TextChangePreviewViewer.java;1;2;8;1;4;3;6;2;187;0;1;269;219;219;4;1;3;4;8;269;4;336;4;1;0
/org.eclipse.ui.workbench.texteditor/src/org/eclipse/ui/internal/texteditor/quickdiff/QuickDiffRestoreAction.java;2;1;5;1;2;2;2;3;13;2;2;100;21;21;2;1;0;3;5;124;1;336;4;2;0
/org.eclipse.core.expressions/src/org/eclipse/core/expressions/ExpressionTagNames.java;1;0;3;1;1;1;1;2;5;1;2;227;7;7;1;0;0;2;3;227;0;279;3;1;0
/org.eclipse.jdt.core/dom/org/eclipse/jdt/core/dom/SimpleType.java;4;0;10;1;2;1;2;8;84;2;6;70;124;124;2;2;1;8;10;230;3;276;7;4;1
/org.eclipse.ant.ui/Ant Editor/org/eclipse/ant/internal/ui/editor/AntEditorCompletionProcessor.java;2;2;48;2;3;2;15;33;1022;16;6;108;2658;2658;16;27;13;45;48;225;40;320;8;2;6
/org.eclipse.ui.workbench/Eclipse UI/org/eclipse/ui/internal/registry/PerspectiveDescriptor.java;7;0;13;2;1;1;1;12;44;2;8;54;155;155;2;4;0;12;13;54;4;336;9;7;0
/org.eclipse.debug.ui/ui/org/eclipse/debug/internal/ui/views/console/ConsoleViewer.java;4;2;14;2;4;3;4;10;40;5;6;74;87;87;5;4;1;10;14;74;5;336;9;4;1
/org.eclipse.jdt.ui/ui refactoring/org/eclipse/jdt/internal/ui/refactoring/actions/RefactoringStarter.java;3;0;13;2;1;1;3;10;87;3;7;3;214;214;3;3;2;12;13;251;5;336;8;3;0
/org.eclipse.ui.workbench/Eclipse UI/org/eclipse/ui/internal/registry/NewWizardsRegistryReader.java;5;0;7;2;1;1;1;6;93;2;5;157;196;196;2;1;0;6;7;247;1;336;6;5;2
/org.eclipse.jdt.ui/ui/org/eclipse/jdt/internal/ui/typehierarchy/MethodsContentProvider.java;2;0;2;1;1;1;1;1;9;0;1;220;11;11;1;0;0;1;2;220;0;336;2;2;0
/org.eclipse.jdt.core/search/org/eclipse/jdt/internal/core/search/indexing/IndexRequest.java;2;0;5;1;0;0;0;5;18;1;5;162;46;46;1;0;0;5;5;162;0;225;5;2;0
/org.eclipse.debug.ui/ui/org/eclipse/debug/internal/ui/stringsubstitution/SelectedTextResolver.java;2;0;4;2;0;0;0;4;27;3;2;200;36;36;3;2;0;4;4;200;2;261;2;2;0
/org.eclipse.ui.ide/src/org/eclipse/ui/views/tasklist/NewTaskAction.java;1;0;1;1;0;0;0;1;0;0;1;129;0;0;1;0;0;1;1;129;0;129;1;1;0
/org.eclipse.jdt.ui/ui/org/eclipse/jdt/internal/ui/text/correction/ChangeCorrectionProposal.java;3;0;14;2;0;0;1;13;99;4;8;72;207;207;4;5;1;14;14;246;6;263;8;3;1
/org.eclipse.ui.workbench/Eclipse UI/org/eclipse/ui/internal/presentations/SystemMenuMoveFolder.java;1;1;2;1;2;2;2;0;4;0;0;279;4;4;1;0;0;0;2;279;0;296;2;1;0
/org.eclipse.ui.ide/src/org/eclipse/ui/views/tasklist/SelectAllTasksAction.java;1;0;1;1;0;0;0;1;0;0;1;129;0;0;1;0;0;1;1;129;0;129;1;1;0
/org.eclipse.jdt.ui/core refactoring/org/eclipse/jdt/internal/corext/refactoring/util/JavaElementUtil.java;3;0;5;1;1;1;1;4;17;1;4;24;59;59;1;0;0;4;5;24;0;336;5;3;1
/org.eclipse.update.core/src/org/eclipse/update/search/UpdateSearchScope.java;2;1;6;2;2;2;2;4;21;2;3;54;42;42;2;1;0;4;6;54;1;336;5;2;0
/org.eclipse.osgi/core/framework/org/eclipse/osgi/framework/msg/MessageFormat.java;4;0;5;2;0;0;2;3;481;3;3;171;504;504;3;0;2;5;5;268;2;268;3;4;0
/org.eclipse.team.cvs.core/src/org/eclipse/team/internal/ccvs/core/util/ReplaceWithBaseVisitor.java;2;0;4;1;1;1;1;3;45;1;3;101;64;64;1;0;0;3;4;101;0;336;4;2;0
/org.eclipse.jdt.launching/launching/org/eclipse/jdt/internal/launching/JavaLaunchConfigurationUtils.java;1;0;2;1;0;0;0;2;35;0;1;141;35;35;2;1;0;2;2;141;1;141;1;1;0
/org.eclipse.swt/Eclipse SWT Drag and Drop/gtk/org/eclipse/swt/dnd/ByteArrayTransfer.java;3;0;3;1;1;1;1;2;28;1;2;23;34;34;1;0;0;2;3;23;0;337;3;3;0
/org.eclipse.team.cvs.ui/src/org/eclipse/team/internal/ccvs/ui/subscriber/CVSParticipantLabelDecorator.java;2;2;4;1;4;3;4;0;70;0;0;296;121;121;2;0;1;0;4;296;1;323;3;2;1
/org.eclipse.jdt.debug.ui/ui/org/eclipse/jdt/internal/debug/ui/actions/PopupDisplayAction.java;4;0;13;3;3;1;4;9;162;4;5;212;383;383;4;4;3;10;13;258;7;301;6;4;1
/org.eclipse.update.core/src/org/eclipse/update/internal/core/FileResponse.java;3;1;5;1;2;2;2;3;41;1;3;58;69;69;1;0;0;3;5;58;0;336;5;3;0
/org.eclipse.ui.ide/src/org/eclipse/ui/internal/ide/registry/MarkerQuery.java;3;1;3;1;2;2;2;1;2;0;1;132;4;4;1;0;0;1;3;132;0;336;3;3;0
/org.eclipse.ui.workbench/Eclipse UI/org/eclipse/ui/internal/dialogs/WorkbenchPreferencePage.java;4;2;12;2;6;4;6;6;575;3;4;68;917;917;3;2;2;6;12;157;4;336;8;4;0
/org.eclipse.ui.forms/src/org/eclipse/ui/forms/IPartSelectionListener.java;1;0;4;1;1;1;1;3;5;1;3;225;10;10;1;0;0;3;4;225;0;272;4;1;0
/org.eclipse.text/src/org/eclipse/text/edits/DeleteEdit.java;2;0;4;1;1;1;1;3;16;2;2;118;32;32;2;1;0;3;4;118;1;336;3;2;0
/org.eclipse.help.base/src/org/eclipse/help/internal/search/QueryBuilder.java;1;2;7;1;4;3;4;3;241;2;2;104;329;329;2;1;1;3;7;104;2;336;5;1;1
/org.eclipse.swt/Eclipse SWT/motif/org/eclipse/swt/graphics/TextLayout.java;3;4;22;3;5;2;16;6;1050;15;2;250;1093;1093;15;4;14;17;22;259;18;331;4;3;1
/org.eclipse.search/search/org/eclipse/search/ui/IGroupByKeyComputer.java;2;2;3;1;3;2;3;0;5;0;0;325;7;7;2;0;1;0;3;325;1;336;2;2;0
/org.eclipse.jdt.core/dom/org/eclipse/jdt/core/dom/MemberRef.java;2;0;9;1;2;1;2;7;92;2;5;206;133;133;2;2;1;7;9;206;3;276;6;2;1
/org.eclipse.debug.ui/ui/org/eclipse/debug/internal/ui/LazyModelPresentation.java;3;1;11;2;4;4;4;7;52;2;4;72;191;191;2;3;0;7;11;72;3;336;8;3;1
/org.eclipse.jdt.ui/ui/org/eclipse/jdt/internal/ui/preferences/CorrectionMessages.java;1;0;1;1;1;1;1;0;4;0;0;336;4;4;1;0;0;0;1;336;0;336;1;1;0
/org.eclipse.jdt.ui/ui/org/eclipse/jdt/internal/ui/preferences/formatter/CreateProfileDialog.java;2;0;9;1;1;1;1;8;159;3;4;176;210;210;3;4;0;8;9;176;4;325;5;2;0
/org.eclipse.jdt.core/model/org/eclipse/jdt/internal/core/SourceMethodElementInfo.java;1;0;2;1;0;0;0;2;2;1;2;121;4;4;1;0;0;2;2;121;0;199;2;1;1
/org.eclipse.jdt.core/compiler/org/eclipse/jdt/internal/compiler/ast/ConstructorDeclaration.java;4;1;14;2;2;2;2;12;45;3;8;5;109;109;3;4;0;12;14;61;4;300;10;4;1
/org.eclipse.jdt.ui/core extension/org/eclipse/jdt/internal/corext/template/java/JavaDocContext.java;3;0;7;2;1;1;3;4;18;3;3;234;37;37;3;1;2;6;7;267;3;336;4;3;0
/org.eclipse.jface.text/src/org/eclipse/jface/text/source/ICharacterPairMatcher.java;2;0;2;2;2;1;2;0;18;0;0;336;18;18;2;0;1;0;2;336;1;336;1;2;0
/org.eclipse.update.ui/src/org/eclipse/update/internal/ui/wizards/NewUpdateSiteDialog.java;3;0;8;2;1;1;1;7;20;3;5;54;40;40;3;2;0;7;8;54;2;302;6;3;0
/org.eclipse.jdt.debug.ui/ui/org/eclipse/jdt/internal/debug/ui/actions/BreakpointSuspendPolicyToggleAction.java;1;0;1;1;0;0;0;1;2;0;1;144;2;2;1;0;0;1;1;144;0;144;1;1;0
/org.eclipse.update.ui/src/org/eclipse/update/internal/ui/properties/ConfiguredSitePropertyPage.java;3;1;5;2;3;3;3;2;25;0;1;54;40;40;2;1;0;2;5;54;1;336;4;3;0
/org.eclipse.osgi/resolver/src/org/eclipse/core/internal/dependencies/ElementChange.java;4;2;4;2;3;2;3;1;72;0;1;171;84;84;2;0;1;1;4;276;1;295;3;4;0
/org.eclipse.jdt.ui/core refactoring/org/eclipse/jdt/internal/corext/refactoring/changes/AddToClasspathChange.java;4;1;8;2;2;2;2;6;71;3;4;32;140;140;3;2;0;6;8;247;2;336;6;4;0
/org.eclipse.jdt.junit/src/org/eclipse/jdt/internal/junit/wizards/NewTestCaseCreationWizardPage2.java;3;1;5;1;3;3;3;2;135;0;1;14;167;167;2;1;0;2;5;14;1;336;4;3;0
/org.eclipse.pde.core/src/org/eclipse/pde/internal/core/ibundle/IBundlePluginBase.java;1;1;2;1;2;2;2;0;6;0;0;292;6;6;1;0;0;0;2;292;0;336;2;1;0
/org.eclipse.jdt.debug/model/org/eclipse/jdt/internal/debug/core/model/JDIObjectValue.java;2;0;2;1;1;1;1;1;6;0;1;210;10;10;1;0;0;1;2;210;0;336;2;2;1
/org.eclipse.team.cvs.ui/src/org/eclipse/team/internal/ccvs/ui/TimeoutProgressMonitorDialog.java;1;0;2;1;1;1;1;1;2;0;1;232;4;4;1;0;0;1;2;232;0;336;2;1;0
/org.eclipse.pde.ui/src/org/eclipse/pde/internal/ui/wizards/templates/PopupMenuTemplate.java;3;1;6;1;3;3;3;3;104;2;2;128;125;125;2;1;0;3;6;128;1;336;5;3;0
/org.eclipse.jdt.debug/model/org/eclipse/jdt/debug/core/IJavaBreakpoint.java;2;0;2;1;1;1;1;1;23;0;1;248;27;27;1;0;0;1;2;248;0;336;2;2;0
/org.eclipse.jdt.debug.ui/ui/org/eclipse/jdt/internal/debug/ui/actions/OpenTypeAction.java;2;0;5;2;1;1;2;3;168;3;2;97;184;184;3;1;1;4;5;268;2;321;3;2;0
/org.eclipse.pde.ui/src/org/eclipse/pde/internal/ui/search/FindDeclarationsAction.java;3;2;3;2;3;2;3;0;18;0;0;302;22;22;2;0;1;0;3;302;1;336;2;3;0
/org.eclipse.debug.ui/ui/org/eclipse/debug/internal/ui/actions/ShowSupportedBreakpointsAction.java;3;1;3;1;3;3;3;0;22;0;0;303;32;32;1;0;0;0;3;303;0;336;3;3;1
/org.eclipse.ui.ide/src/org/eclipse/ui/views/markers/internal/ConcreteMarker.java;3;1;4;1;3;3;3;1;40;0;1;181;67;67;1;0;0;1;4;181;0;336;4;3;0
/org.eclipse.jdt.core/compiler/org/eclipse/jdt/internal/compiler/ast/JavadocArrayQualifiedTypeReference.java;3;0;5;2;0;0;0;5;14;2;3;165;22;22;2;2;0;5;5;165;2;199;3;3;0
/org.eclipse.jdt.ui/core extension/org/eclipse/jdt/internal/corext/callhierarchy/MethodCall.java;3;0;5;1;1;1;1;4;10;2;3;13;16;16;2;1;0;4;5;28;1;336;4;3;0
/org.eclipse.jdt.ui/ui/org/eclipse/jdt/internal/ui/util/SelectionUtil.java;1;0;1;1;1;1;1;0;2;0;0;336;2;2;1;0;0;0;1;336;0;336;1;1;0
/org.eclipse.core.runtime/src/org/eclipse/core/runtime/PluginVersionIdentifier.java;4;1;9;1;5;5;5;4;804;2;3;171;855;855;2;1;0;4;9;179;1;336;8;4;0
/org.eclipse.swt/Eclipse SWT PI/gtk/org/eclipse/swt/internal/gtk/GdkEventButton.java;3;0;4;1;1;1;1;3;17;2;2;100;27;27;2;1;0;3;4;226;1;337;3;3;0
/org.eclipse.team.cvs.ui/src/org/eclipse/team/internal/ccvs/ui/IgnoreResourcesDialog.java;1;0;1;1;0;0;0;1;2;0;1;138;2;2;1;0;0;1;1;138;0;138;1;1;0
/org.eclipse.swt/Eclipse SWT/carbon/org/eclipse/swt/widgets/Button.java;3;2;17;2;6;5;6;11;47;3;8;1;125;125;3;3;1;11;17;1;4;332;13;3;2
/org.eclipse.ui.workbench.texteditor/src/org/eclipse/ui/texteditor/IAnnotationImageProvider.java;2;0;2;1;1;1;1;1;2;0;1;181;2;2;1;0;0;1;2;181;0;336;2;2;0
/org.eclipse.osgi/console/src/org/eclipse/osgi/framework/internal/core/FrameworkCommandInterpreter.java;5;1;7;1;4;4;4;3;935;1;3;171;1020;1020;1;0;0;3;7;171;0;336;7;5;0
/org.eclipse.swt/Eclipse SWT/gtk/org/eclipse/swt/widgets/Tree.java;7;4;34;4;10;4;10;24;126;7;8;3;602;602;7;16;6;24;34;13;22;326;12;7;3
/org.eclipse.debug.ui/ui/org/eclipse/debug/internal/ui/stringsubstitution/StringVariablePresentationManager.java;4;1;4;1;2;2;2;2;4;1;2;124;11;11;1;0;0;2;4;124;0;336;4;4;0
/org.eclipse.jdt.ui/ui/org/eclipse/jdt/internal/ui/search/SearchUtil.java;4;2;12;2;5;4;5;7;103;2;6;20;186;186;2;1;1;7;12;104;2;336;10;4;0
/org.eclipse.jdt.debug.ui/ui/org/eclipse/jdt/internal/debug/ui/DetailFormatterDialog.java;5;4;18;4;6;2;10;8;135;5;8;108;221;221;5;0;8;12;18;270;8;330;10;5;0
/org.eclipse.osgi/defaultAdaptor/src/org/eclipse/osgi/framework/adaptor/core/AbstractFrameworkAdaptor.java;3;3;14;3;4;2;9;5;206;7;3;239;281;281;7;2;7;10;14;267;9;326;5;3;0
/org.eclipse.jdt.ui/ui/org/eclipse/jdt/internal/ui/callhierarchy/LocationLabelProvider.java;3;0;5;1;1;1;1;4;53;2;3;12;83;83;2;1;0;4;5;12;1;336;4;3;0
/org.eclipse.jdt.ui/core refactoring/org/eclipse/jdt/internal/corext/refactoring/typeconstraints/CompositeOrTypeConstraint.java;2;0;8;1;1;1;1;7;31;3;4;3;83;83;3;3;0;7;8;3;3;336;5;2;0
/org.eclipse.pde.core/src/org/eclipse/pde/internal/core/schema/DevelopmentSchemaDescriptor.java;2;0;3;2;2;1;2;1;41;0;1;267;41;41;2;0;1;1;3;330;1;330;2;2;0
/org.eclipse.ui.workbench/Eclipse UI/org/eclipse/ui/internal/ViewLayout.java;1;0;1;1;1;1;1;0;0;0;0;295;0;0;1;0;0;0;1;295;0;295;1;1;0
/org.eclipse.swt/Eclipse SWT Drag and Drop/carbon/org/eclipse/swt/dnd/Transfer.java;1;0;2;1;0;0;0;2;33;0;1;17;33;33;2;1;0;2;2;17;1;17;1;1;0
/org.eclipse.pde.core/src/org/eclipse/pde/core/IModelProvider.java;2;1;5;1;3;3;3;2;126;1;2;130;155;155;1;0;0;2;5;130;0;336;5;2;0
/org.eclipse.jdt.ui/ui/org/eclipse/jdt/internal/ui/wizards/dialogfields/StringButtonDialogField.java;2;0;2;1;1;1;1;1;2;0;1;88;4;4;1;0;0;1;2;88;0;336;2;2;0
/org.eclipse.jdt.core/dom/org/eclipse/jdt/core/dom/ParenthesizedExpression.java;3;0;8;1;2;1;2;6;78;2;5;199;108;108;2;1;1;6;8;266;2;276;6;3;1
/org.eclipse.jdt.core/model/org/eclipse/jdt/core/util/IClassFileReader.java;1;0;2;1;0;0;0;2;8;1;2;199;10;10;1;0;0;2;2;199;0;264;2;1;0
/org.eclipse.ui.workbench/Eclipse UI/org/eclipse/ui/internal/presentations/DefaultViewPresentation.java;2;3;5;2;5;2;5;0;11;0;0;297;16;16;3;0;3;0;5;297;3;324;2;2;0
/org.eclipse.ui.forms/src/org/eclipse/ui/forms/widgets/LayoutComposite.java;1;0;3;1;0;0;0;3;34;2;2;225;35;35;2;1;0;3;3;225;1;240;2;1;0
/org.eclipse.jface/src/org/eclipse/jface/operation/AccumulatingProgressMonitor.java;2;2;4;1;3;2;3;1;50;0;1;131;95;95;2;0;1;1;4;288;1;336;3;2;1
/org.eclipse.swt/Eclipse SWT Mozilla/common/org/eclipse/swt/internal/mozilla/nsString.java;1;0;1;1;0;0;0;1;0;0;1;100;0;0;1;0;0;1;1;100;0;100;1;1;0
/org.eclipse.search/search/org/eclipse/search/internal/ui/RemoveAllResultsAction.java;1;0;1;1;1;1;1;0;2;0;0;336;2;2;1;0;0;0;1;336;0;336;1;1;0
/org.eclipse.update.core/src/org/eclipse/update/core/model/InvalidSiteTypeException.java;1;1;2;1;2;2;2;0;6;0;0;292;10;10;1;0;0;0;2;292;0;336;2;1;0
/org.eclipse.pde.ui/src/org/eclipse/pde/internal/ui/editor/plugin/ResourceAttributeValue.java;1;1;2;1;2;2;2;0;4;0;0;292;4;4;1;0;0;0;2;292;0;336;2;1;0
/org.eclipse.core.runtime/src/org/eclipse/core/runtime/IExecutableExtension.java;3;1;4;1;2;2;2;2;172;1;2;171;180;180;1;0;0;2;4;171;0;336;4;3;0
/org.eclipse.ant.ui/Ant Editor/org/eclipse/ant/internal/ui/dtd/schema/Model.java;1;0;3;1;1;1;1;2;5;1;2;108;9;9;1;0;0;2;3;108;0;299;3;1;0
/org.eclipse.ui.ide/src/org/eclipse/ui/views/markers/internal/ActionPasteMarker.java;3;1;3;1;2;2;2;1;2;0;1;129;4;4;1;0;0;1;3;129;0;336;3;3;0
/org.eclipse.ui.workbench.texteditor/src/org/eclipse/ui/texteditor/templates/TemplateVariableProposal.java;2;1;3;2;2;2;2;1;9;0;1;253;11;11;1;0;0;1;3;253;0;336;3;2;0
/org.eclipse.jdt.ui/ui/org/eclipse/jdt/internal/ui/search/OccurrencesFinder.java;5;1;9;2;3;3;3;6;157;2;4;148;377;377;2;2;0;6;9;163;2;336;7;5;0
/org.eclipse.pde.ui/src/org/eclipse/pde/internal/ui/editor/plugin/rows/ClassAttributeRow.java;3;5;7;3;7;2;7;0;40;0;0;292;63;63;5;0;5;0;7;292;5;331;2;3;0
/org.eclipse.swt/Eclipse SWT/motif/org/eclipse/swt/graphics/Color.java;1;1;2;1;2;2;2;0;4;0;0;300;8;8;1;0;0;0;2;300;0;337;2;1;1
/org.eclipse.ant.core/src/org/eclipse/ant/core/AntRunner.java;2;0;14;1;2;1;2;12;97;3;9;0;216;216;3;3;1;12;14;17;4;296;10;2;1
/org.eclipse.ui.workbench/Eclipse UI/org/eclipse/ui/internal/keys/AbstractModifierKeyComparator.java;2;0;2;1;1;1;1;1;10;0;1;188;10;10;1;0;0;1;2;188;0;336;2;2;0
/org.eclipse.ui.workbench/Eclipse UI/org/eclipse/ui/internal/dialogs/WorkingSetSelectionDialog.java;1;0;1;1;0;0;0;1;11;0;1;101;11;11;1;0;0;1;1;101;0;101;1;1;1
/org.eclipse.jdt.ui/ui/org/eclipse/jdt/ui/search/PatternQuerySpecification.java;3;2;4;2;4;2;4;0;49;0;0;290;53;53;2;0;2;0;4;290;2;335;2;3;0
/org.eclipse.jdt.ui/ui/org/eclipse/jdt/internal/ui/typehierarchy/ToggleLinkingAction.java;1;0;2;1;1;1;1;1;13;0;1;79;15;15;1;0;0;1;2;79;0;336;2;1;0
/org.eclipse.jdt.core/dom/org/eclipse/jdt/internal/core/dom/rewrite/TokenScanner.java;3;1;3;1;2;2;2;1;40;0;1;262;44;44;1;0;0;1;3;262;0;336;3;3;0
/org.eclipse.swt/Eclipse SWT Browser/common/org/eclipse/swt/browser/ProgressEvent.java;2;0;5;1;1;1;1;4;15;2;3;100;35;35;2;1;0;4;5;100;1;337;4;2;0
/org.eclipse.swt/Eclipse SWT/common/org/eclipse/swt/internal/image/JPEGFrameHeader.java;1;0;2;1;1;1;1;1;8;0;1;217;12;12;1;0;0;1;2;217;0;337;2;1;0
/org.eclipse.ant.ui/Ant Editor/org/eclipse/ant/internal/ui/editor/AbstractAntSourceViewerConfiguration.java;1;2;5;1;5;3;5;0;89;0;0;286;118;118;2;0;2;0;5;304;2;320;3;1;1
/org.eclipse.osgi/core/framework/org/eclipse/osgi/framework/internal/core/BundlePermissionCollection.java;4;1;4;1;2;2;2;2;17;1;2;171;23;23;1;0;0;2;4;171;0;336;4;4;0
/org.eclipse.jdt.debug/jdi/org/eclipse/jdi/internal/event/ClassUnloadEventImpl.java;4;0;3;2;1;1;1;2;4;1;2;76;12;12;1;0;0;2;3;76;0;336;3;4;0
/org.eclipse.jdt.debug.ui/ui/org/eclipse/jdt/debug/ui/launchConfigurations/JavaJRETab.java;3;1;11;1;2;2;2;9;488;3;7;51;543;543;3;2;0;9;11;65;2;336;9;3;0
/org.eclipse.swt/Eclipse SWT Drag and Drop/photon/org/eclipse/swt/dnd/Clipboard.java;3;1;7;1;2;2;2;5;82;1;5;0;182;182;1;0;0;5;7;0;0;337;7;3;0
/org.eclipse.debug.core/core/org/eclipse/debug/core/model/IErrorReportingExpression.java;2;0;2;2;0;0;0;2;2;0;1;97;2;2;2;1;0;2;2;97;1;97;1;2;0
/org.eclipse.pde.ui/src/org/eclipse/pde/internal/ui/editor/feature/FeatureSpecSection.java;3;4;9;2;6;3;6;3;209;1;3;26;301;301;4;0;3;3;9;302;3;336;6;3;0
/org.eclipse.jdt.debug.ui/ui/org/eclipse/jdt/internal/debug/ui/launcher/SelectSystemLibraryQuickFix.java;3;1;4;1;2;2;2;2;6;1;2;22;17;17;1;0;0;2;4;22;0;336;4;3;0
/org.eclipse.swt/Eclipse SWT Mozilla/common/org/eclipse/swt/internal/mozilla/nsIWebBrowserFocus.java;1;0;2;1;0;0;0;2;8;1;2;100;8;8;1;0;0;2;2;100;0;148;2;1;0
/org.eclipse.jface.text/src/org/eclipse/jface/text/contentassist/ICompletionProposalExtension.java;1;0;3;1;2;1;2;1;28;0;1;263;29;29;2;0;1;1;3;336;1;336;2;1;0
/org.eclipse.swt/Eclipse SWT/win32/org/eclipse/swt/widgets/ImageList.java;1;0;1;1;0;0;0;1;18;0;1;28;18;18;1;0;0;1;1;28;0;28;1;1;0
/org.eclipse.team.cvs.ui/src/org/eclipse/team/internal/ccvs/ui/model/BranchCategory.java;2;1;3;1;2;2;2;1;60;0;1;63;71;71;1;0;0;1;3;63;0;336;3;2;0
/org.eclipse.ui.ide/src/org/eclipse/ui/views/framelist/GoIntoAction.java;1;0;1;1;0;0;0;1;0;0;1;129;0;0;1;0;0;1;1;129;0;129;1;1;0
/org.eclipse.ui.ide/src/org/eclipse/ui/views/navigator/PasteAction.java;1;0;2;1;0;0;0;2;2;1;2;129;2;2;1;0;0;2;2;129;0;150;2;1;0
/org.eclipse.team.ui/src/org/eclipse/team/internal/ui/synchronize/actions/OpenFileInSystemEditorAction.java;1;0;4;1;1;1;1;3;53;2;2;148;74;74;2;1;0;3;4;148;1;336;3;1;0
/org.eclipse.jdt.ui/ui/org/eclipse/jdt/internal/ui/text/java/JavaDoubleClickSelector.java;1;0;1;1;1;1;1;0;2;0;0;336;2;2;1;0;0;0;1;336;0;336;1;1;0
/org.eclipse.compare/compare/org/eclipse/compare/internal/SimpleTextViewer.java;1;0;2;1;0;0;0;2;3;1;2;79;6;6;1;0;0;2;2;79;0;165;2;1;0
/org.eclipse.ui.workbench/Eclipse UI/org/eclipse/ui/internal/OpenedPerspectivesMenu.java;1;0;1;1;0;0;0;1;14;0;1;157;14;14;1;0;0;1;1;157;0;157;1;1;1
/org.eclipse.update.core/src/org/eclipse/update/internal/operations/UninstallOperation.java;2;3;12;2;4;2;4;8;53;2;6;54;128;128;3;2;2;8;12;296;4;336;8;2;0
/org.eclipse.jdt.ui/core refactoring/org/eclipse/jdt/internal/corext/refactoring/surround/ISurroundWithTryCatchQuery.java;1;0;1;1;1;1;1;0;2;0;0;336;2;2;1;0;0;0;1;336;0;336;1;1;0
/org.eclipse.jdt.ui/core refactoring/org/eclipse/jdt/internal/corext/refactoring/code/AstMatchingNodeFinder.java;1;0;1;1;1;1;1;0;2;0;0;336;2;2;1;0;0;0;1;336;0;336;1;1;0
/org.eclipse.jdt.launching/launching/org/eclipse/jdt/launching/sourcelookup/ArchiveSourceLocation.java;3;1;8;2;2;2;2;6;73;2;4;25;173;173;2;2;0;6;8;53;2;336;6;3;1
/org.eclipse.jdt.core/model/org/eclipse/jdt/core/util/ILocalVariableTypeTableEntry.java;2;0;2;1;0;0;0;2;85;1;2;241;85;85;1;0;0;2;2;241;0;264;2;2;0
/org.eclipse.jdt.ui/ui/org/eclipse/jdt/internal/ui/text/spelling/engine/RankedWordProposal.java;2;0;2;1;1;1;1;1;2;0;1;219;2;2;1;0;0;1;2;219;0;336;2;2;0
/org.eclipse.jdt.launching/launching/org/eclipse/jdt/internal/launching/JavaProjectSourceContainerTypeDelegate.java;2;0;5;1;1;1;1;4;18;2;2;227;27;27;2;2;0;4;5;227;2;299;3;2;0
/org.eclipse.update.ui/src/org/eclipse/update/internal/ui/properties/FeatureLicensePropertyPage.java;3;0;3;2;0;0;0;3;24;2;2;54;26;26;2;1;0;3;3;54;1;122;2;3;1
/org.eclipse.jdt.ui/ui/org/eclipse/jdt/internal/ui/infoviews/SourceView.java;6;1;15;2;3;3;3;12;235;4;6;49;533;533;4;6;0;12;15;49;6;336;9;6;1
/org.eclipse.team.cvs.core/src/org/eclipse/team/internal/ccvs/core/util/Util.java;2;1;13;1;2;2;2;11;112;2;9;31;292;292;2;2;0;11;13;110;2;336;11;2;0
/org.eclipse.ui.workbench/Eclipse UI/org/eclipse/ui/internal/Model.java;3;0;3;2;0;0;0;3;106;2;2;206;106;106;2;1;0;3;3;223;1;223;2;3;0
/org.eclipse.jdt.ui/ui/org/eclipse/jdt/internal/ui/util/OpenTypeHierarchyUtil.java;2;0;5;1;1;1;1;4;14;1;4;91;24;24;1;0;0;4;5;91;0;336;5;2;0
/org.eclipse.jdt.ui/core extension/org/eclipse/jdt/internal/corext/textmanipulation/TextRegion.java;1;0;1;1;1;1;1;0;2;0;0;336;2;2;1;0;0;0;1;336;0;336;1;1;0
/org.eclipse.jface.text/src/org/eclipse/jface/text/TextViewer.java;4;7;51;3;9;2;16;35;375;8;11;45;1968;1968;8;24;14;42;51;65;38;327;13;4;0
/org.eclipse.jdt.core/model/org/eclipse/jdt/internal/core/PackageFragmentRoot.java;4;2;35;3;6;4;6;29;143;5;12;2;639;639;5;17;2;29;35;10;19;323;16;4;1
/org.eclipse.jdt.ui/ui refactoring/org/eclipse/jdt/internal/ui/refactoring/nls/NLSUIMessages.java;1;0;1;1;1;1;1;0;2;0;0;336;2;2;1;0;0;0;1;336;0;336;1;1;0
/org.eclipse.jdt.core/compiler/org/eclipse/jdt/internal/compiler/lookup/MethodBinding.java;2;1;7;1;2;2;2;5;12;1;5;2;38;38;1;0;0;5;7;2;0;288;7;2;1
/org.eclipse.team.core/src/org/eclipse/team/internal/core/BackgroundEventHandler.java;2;2;5;1;3;2;3;2;362;1;2;220;408;408;2;0;1;2;5;320;1;336;4;2;3
/org.eclipse.pde.ui/src/org/eclipse/pde/internal/ui/editor/schema/SchemaPropertySheet.java;2;1;4;1;3;3;3;1;183;0;1;270;194;194;1;0;0;1;4;270;0;336;4;2;0
/org.eclipse.team.ui/src/org/eclipse/team/internal/ui/synchronize/SyncInfoModelElement.java;2;3;5;2;4;2;4;1;58;0;1;251;62;62;3;0;2;1;5;315;2;336;3;2;0
/org.eclipse.pde.ui/src/org/eclipse/pde/internal/ui/wizards/tools/MigratePluginWizardPage.java;2;1;5;1;4;4;4;1;20;0;1;213;42;42;1;0;0;1;5;213;0;336;5;2;0
/org.eclipse.ui.workbench/Eclipse UI/org/eclipse/ui/internal/ToggleEditorsVisibilityAction.java;1;0;1;1;0;0;0;1;84;0;1;157;84;84;1;0;0;1;1;157;0;157;1;1;0
/org.eclipse.jdt.launching/launching/org/eclipse/jdt/internal/launching/JavaRemoteApplicationLaunchConfigurationDelegate.java;2;0;2;1;1;1;1;1;4;0;1;211;8;8;1;0;0;1;2;211;0;336;2;2;0
/org.eclipse.search/search/org/eclipse/search/internal/ui/Search.java;1;0;2;1;1;1;1;1;2;0;1;9;4;4;1;0;0;1;2;9;0;336;2;1;0
/org.eclipse.jdt.core/compiler/org/eclipse/jdt/internal/compiler/lookup/CompilationUnitScope.java;3;0;6;1;1;1;1;5;32;1;5;57;61;61;1;0;0;5;6;57;0;299;6;3;3
/org.eclipse.jdt.core/dom/org/eclipse/jdt/core/dom/DocCommentParser.java;3;0;8;3;1;1;1;7;176;6;2;209;197;197;6;5;0;7;8;209;5;300;3;3;4
/org.eclipse.ui.workbench.texteditor/src/org/eclipse/ui/texteditor/ConfigurationElementSorter.java;3;1;4;2;3;3;3;1;56;0;1;210;64;64;1;0;0;1;4;210;0;336;4;3;1
/org.eclipse.jdt.ui/ui/org/eclipse/jdt/internal/ui/callhierarchy/SearchScopeActionGroup.java;3;1;7;1;2;2;2;5;811;3;3;12;1026;1026;3;2;0;5;7;12;2;336;5;3;0
/org.eclipse.compare/compare/org/eclipse/compare/internal/ImageMergeViewer.java;1;0;2;1;0;0;0;2;3;1;2;19;5;5;1;0;0;2;2;19;0;79;2;1;0
/org.eclipse.jdt.debug.ui/ui/org/eclipse/jdt/internal/debug/ui/launcher/JavaLaunchConfigurationTab.java;1;0;1;1;0;0;0;1;3;0;1;154;3;3;1;0;0;1;1;154;0;154;1;1;0
/org.eclipse.jdt.ui/ui/org/eclipse/jdt/internal/ui/actions/QuickMenuAction.java;1;1;4;1;4;4;4;0;97;0;0;273;173;173;1;0;0;0;4;273;0;322;4;1;0
/org.eclipse.osgi/core/framework/org/eclipse/osgi/framework/internal/core/BundleNativeCode.java;5;0;15;3;1;1;4;11;843;7;5;171;892;892;7;6;3;14;15;224;9;293;6;5;0
/org.eclipse.core.expressions/src/org/eclipse/core/expressions/EvaluationContext.java;1;1;6;1;3;3;3;3;27;2;2;227;75;75;2;1;0;3;6;227;1;336;5;1;0
/org.eclipse.jdt.junit/src/org/eclipse/jdt/internal/junit/launcher/JUnitLaunchConfigurationTab.java;1;0;1;1;1;1;1;0;2;0;0;336;2;2;1;0;0;0;1;336;0;336;1;1;0
/org.eclipse.help/src/org/eclipse/help/internal/toc/TocFile.java;1;1;3;1;3;3;3;0;34;0;0;299;52;52;1;0;0;0;3;299;0;336;3;1;0
/org.eclipse.swt/Eclipse SWT PI/gtk/org/eclipse/swt/internal/gtk/OS.java;7;0;96;7;0;0;23;73;3515;43;8;1;5810;5810;43;65;23;96;96;212;88;212;8;7;10
/org.eclipse.team.ui/src/org/eclipse/team/internal/ui/synchronize/RefreshChangeListener.java;2;1;3;2;2;2;2;1;10;0;1;247;13;13;1;0;0;1;3;247;0;336;3;2;0
/org.eclipse.team.cvs.core/src/org/eclipse/team/internal/ccvs/core/CVSProjectSetCapability.java;1;0;2;1;0;0;0;2;516;0;1;265;516;516;2;1;0;2;2;265;1;265;1;1;1
/org.eclipse.swt/Eclipse SWT Drag and Drop/win32/org/eclipse/swt/dnd/TreeDragUnderEffect.java;3;1;5;1;2;2;2;3;103;0;1;51;111;111;3;2;0;3;5;51;2;337;3;3;0
/org.eclipse.jdt.core/model/org/eclipse/jdt/core/ISourceReference.java;1;0;3;1;0;0;0;3;8;2;2;149;10;10;2;1;0;3;3;199;1;199;2;1;0
/org.eclipse.ant.ui/Ant Editor/org/eclipse/ant/internal/ui/editor/formatter/XmlFormatter.java;1;0;5;1;5;1;5;0;263;0;0;306;263;263;5;0;4;0;5;306;4;306;1;1;2
/org.eclipse.jdt.ui/ui/org/eclipse/jdt/internal/ui/text/comment/CommentObjectFactory.java;2;0;7;1;1;1;1;6;37;3;4;97;106;106;3;2;0;6;7;119;2;336;5;2;0
/org.eclipse.ui.workbench/Eclipse UI/org/eclipse/ui/internal/keys/MacKeyFormatter.java;1;0;2;1;0;0;0;2;61;0;1;188;61;61;2;1;0;2;2;188;1;188;1;1;0
/org.eclipse.swt/Eclipse SWT Drag and Drop/common/org/eclipse/swt/dnd/DNDListener.java;1;0;1;1;0;0;0;1;6;0;1;94;6;6;1;0;0;1;1;94;0;94;1;1;0
/org.eclipse.pde.core/src/org/eclipse/pde/internal/core/schema/RepeatableSchemaObject.java;2;1;2;1;2;2;2;0;4;0;0;309;8;8;1;0;0;0;2;309;0;336;2;2;0
/org.eclipse.jdt.core/compiler/org/eclipse/jdt/internal/compiler/lookup/LookupEnvironment.java;3;1;5;1;2;2;2;3;39;2;2;199;59;59;2;1;0;3;5;209;1;315;4;3;2
/org.eclipse.search/search/org/eclipse/search/internal/ui/text/EditorOpener.java;2;2;5;1;5;4;5;0;13;0;0;293;20;20;2;0;1;0;5;293;1;336;4;2;0
/org.eclipse.core.resources/src/org/eclipse/core/internal/localstore/TestingSupport.java;2;1;6;1;2;2;2;4;61;3;2;100;75;75;3;2;0;4;6;100;2;325;4;2;0
/org.eclipse.jdt.junit/src/org/eclipse/jdt/internal/junit/launcher/JUnitBaseLaunchConfiguration.java;4;2;11;2;4;3;4;7;38;2;6;14;93;93;2;1;1;7;11;264;2;336;9;4;0
/org.eclipse.pde.core/src/org/eclipse/pde/internal/core/plugin/PluginObject.java;2;1;12;2;4;4;4;8;20;2;7;26;86;86;2;1;0;8;12;128;1;336;11;2;0
/org.eclipse.swt/Eclipse SWT/photon/org/eclipse/swt/graphics/FontMetrics.java;2;0;2;1;1;1;1;1;9;0;1;250;13;13;1;0;0;1;2;250;0;337;2;2;1
/org.eclipse.team.cvs.ui/src/org/eclipse/team/internal/ccvs/ui/actions/EditAction.java;2;1;3;1;3;3;3;0;41;0;0;293;56;56;1;0;0;0;3;293;0;336;3;2;0
/org.eclipse.ui.workbench/Eclipse UI/org/eclipse/ui/presentations/AbstractPresentationFactory.java;3;2;6;3;3;2;3;3;147;0;1;245;273;273;3;2;1;3;6;245;3;296;3;3;0
/org.eclipse.swt/Eclipse SWT/carbon/org/eclipse/swt/widgets/Menu.java;4;1;14;2;3;3;3;11;177;4;5;2;318;318;4;6;0;11;14;16;6;337;8;4;3
/org.eclipse.ui.workbench.texteditor/src/org/eclipse/ui/texteditor/GotoLineAction.java;1;1;3;1;2;2;2;1;4;0;1;82;8;8;1;0;0;1;3;82;0;336;3;1;0
/org.eclipse.osgi/core/framework/org/eclipse/osgi/framework/internal/core/StartLevelEvent.java;5;1;6;2;3;3;3;3;99;2;2;171;164;164;2;1;0;3;6;171;1;336;5;5;0
/org.eclipse.ui.ide/src/org/eclipse/ui/views/bookmarkexplorer/IBookmarkHelpContextIds.java;1;0;1;1;0;0;0;1;0;0;1;129;0;0;1;0;0;1;1;129;0;129;1;1;0
/org.eclipse.ltk.ui.refactoring/src/org/eclipse/ltk/internal/ui/refactoring/IChangeElementChildrenCreator.java;1;0;2;1;1;1;1;1;2;0;1;269;2;2;1;0;0;1;2;269;0;336;2;1;0
/org.eclipse.ant.ui/Ant Tools Support/org/eclipse/ant/internal/ui/launchConfigurations/AntJavaLaunchDelegate.java;2;0;3;2;1;1;1;2;12;0;1;265;17;17;2;1;0;2;3;265;1;312;2;2;0
/org.eclipse.jdt.core/dom/org/eclipse/jdt/core/dom/PrefixExpression.java;3;0;8;1;2;1;2;6;105;2;5;199;135;135;2;1;1;6;8;266;2;276;6;3;1
/org.eclipse.jdt.ui/core extension/org/eclipse/jdt/internal/corext/SourceRange.java;1;0;1;1;1;1;1;0;2;0;0;336;2;2;1;0;0;0;1;336;0;336;1;1;0
/org.eclipse.team.core/src/org/eclipse/team/core/TeamException.java;2;2;5;1;3;2;3;2;52;1;2;52;108;108;2;0;1;2;5;335;1;335;4;2;0
/org.eclipse.jdt.debug.ui/ui/org/eclipse/jdt/internal/debug/ui/actions/AddVariableAction.java;3;2;5;2;3;2;3;2;16;1;2;76;37;37;2;0;1;2;5;296;1;336;4;3;0
/org.eclipse.team.ui/src/org/eclipse/team/internal/ui/synchronize/ChangesSection.java;2;3;17;2;8;4;8;9;350;7;3;181;552;552;7;6;4;9;17;240;10;336;7;2;0
/org.eclipse.update.core/src/org/eclipse/update/core/IncludedFeatureReference.java;4;2;9;1;4;3;4;5;149;1;5;0;327;327;2;0;1;5;9;289;1;336;8;4;0
/org.eclipse.jdt.core/codeassist/org/eclipse/jdt/internal/codeassist/complete/CompletionOnArgumentName.java;2;0;2;1;0;0;0;2;35;1;2;63;37;37;1;0;0;2;2;63;0;199;2;2;0
/org.eclipse.core.resources/src/org/eclipse/core/internal/utils/Semaphore.java;2;0;2;1;1;1;1;1;67;0;1;90;69;69;1;0;0;1;2;90;0;277;2;2;0
/org.eclipse.core.filebuffers/src/org/eclipse/core/filebuffers/ITextFileBuffer.java;2;2;6;2;4;3;4;2;30;0;1;93;68;68;2;1;1;2;6;93;2;334;4;2;0
/org.eclipse.debug.core/core/org/eclipse/debug/core/sourcelookup/containers/ProjectSourceContainer.java;1;0;3;1;1;1;2;1;37;0;1;268;57;57;2;0;1;2;3;268;1;312;2;1;0
/org.eclipse.swt/Eclipse SWT PI/gtk/org/eclipse/swt/internal/gtk/GdkEventMotion.java;2;0;2;2;2;1;2;0;59;0;0;332;59;59;2;0;1;0;2;332;1;332;1;2;0
/org.eclipse.swt/Eclipse SWT Mozilla/common/org/eclipse/swt/internal/mozilla/nsIEmbeddingSiteWindow.java;1;0;2;1;0;0;0;2;10;1;2;100;10;10;1;0;0;2;2;100;0;148;2;1;0
/org.eclipse.ltk.ui.refactoring/src/org/eclipse/ltk/ui/refactoring/ChangePreviewViewerInput.java;1;0;4;1;2;1;3;1;8;0;1;270;13;13;2;0;2;2;4;270;2;335;2;1;0
/org.eclipse.core.resources/src/org/eclipse/core/internal/localstore/HistoryStore.java;2;2;9;1;4;3;6;3;939;3;3;7;1229;1229;3;0;3;5;9;269;3;325;6;2;0
/org.eclipse.swt/Eclipse SWT Browser/mozilla/org/eclipse/swt/browser/PromptDialog.java;2;0;2;1;1;1;1;1;6;0;1;265;6;6;1;0;0;1;2;265;0;337;2;2;0
/org.eclipse.jdt.ui/core extension/org/eclipse/jdt/internal/corext/textmanipulation/TextManipulationMessages.java;1;0;1;1;1;1;1;0;2;0;0;336;2;2;1;0;0;0;1;336;0;336;1;1;0
/org.eclipse.update.core/src/org/eclipse/update/internal/search/SiteSearchCategory.java;3;1;6;2;2;2;2;4;7;2;3;58;19;19;2;1;0;4;6;58;1;336;5;3;0
/org.eclipse.ui.workbench/Eclipse UI/org/eclipse/ui/part/CellEditorActionHandler.java;1;0;1;1;0;0;0;1;17;0;1;157;17;17;1;0;0;1;1;157;0;157;1;1;0
/org.eclipse.jdt.debug.ui/ui/org/eclipse/jdt/internal/debug/ui/actions/ShowConstantsAction.java;1;0;1;1;0;0;0;1;4;0;1;187;4;4;1;0;0;1;1;187;0;187;1;1;0
/org.eclipse.pde.ui/src/org/eclipse/pde/internal/ui/editor/StructuredViewerSection.java;1;1;2;1;2;2;2;0;36;0;0;292;40;40;1;0;0;0;2;292;0;336;2;1;0
/org.eclipse.jdt.ui/ui/org/eclipse/jdt/internal/ui/preferences/CompilerPropertyPage.java;2;0;3;1;1;1;1;2;26;1;2;82;31;31;1;0;0;2;3;82;0;336;3;2;0
/org.eclipse.jdt.debug.ui/ui/org/eclipse/jdt/internal/debug/ui/monitors/MonitorTraceAction.java;2;0;2;1;1;1;1;1;28;0;1;246;44;44;1;0;0;1;2;246;0;306;2;2;0
/org.eclipse.team.ui/src/org/eclipse/team/internal/ui/dialogs/DetailsDialog.java;2;1;5;1;2;2;2;3;293;1;3;63;352;352;1;0;0;3;5;63;0;336;5;2;0
/org.eclipse.jdt.core/compiler/org/eclipse/jdt/internal/compiler/lookup/BlockScope.java;4;2;18;3;3;2;3;15;206;3;10;1;757;757;3;5;1;15;18;148;6;324;12;4;1
/org.eclipse.ui.ide/src/org/eclipse/ui/views/tasklist/ITaskListResourceAdapter.java;1;0;1;1;0;0;0;1;0;0;1;129;0;0;1;0;0;1;1;129;0;129;1;1;0
/org.eclipse.jdt.ui/ui/org/eclipse/jdt/internal/ui/preferences/AbstractConfigurationBlockPreferencePage.java;1;0;2;1;2;1;2;0;13;0;0;294;13;13;2;0;1;0;2;294;1;294;1;1;0
/org.eclipse.jdt.ui/core refactoring/org/eclipse/jdt/internal/corext/refactoring/structure/ChangeTypeRefactoring.java;5;4;25;2;9;5;9;16;181;3;6;162;709;709;4;10;4;16;25;282;14;336;11;5;1
/org.eclipse.pde.runtime/src/org/eclipse/pde/internal/runtime/registry/RegistryPropertySource.java;2;0;4;1;1;1;1;3;70;2;2;59;143;143;2;1;0;3;4;224;1;336;3;2;0
/org.eclipse.debug.ui/ui/org/eclipse/debug/internal/ui/views/DebugViewDecoratingLabelProvider.java;2;1;3;1;2;2;2;1;30;0;1;196;34;34;1;0;0;1;3;196;0;336;3;2;1
/org.eclipse.osgi/eclipseAdaptor/src/org/eclipse/osgi/framework/stats/ClassloaderStats.java;3;1;5;1;4;4;4;1;94;0;1;171;194;194;1;0;0;1;5;171;0;336;5;3;0
/org.eclipse.ui.workbench/Eclipse UI/org/eclipse/ui/internal/RadioMenu.java;3;0;3;1;1;1;1;2;127;1;2;206;137;137;1;0;0;2;3;206;0;279;3;3;0
/org.eclipse.debug.ui/ui/org/eclipse/debug/internal/ui/sourcelookup/browsers/ProjectSourceContainerBrowser.java;2;0;6;1;0;0;0;6;17;3;4;209;25;25;3;2;0;6;6;266;2;266;4;2;0
/org.eclipse.ui.workbench/Eclipse UI/org/eclipse/ui/internal/PerspectiveListenerListOld.java;2;1;3;1;3;3;3;0;17;0;0;287;31;31;1;0;0;0;3;287;0;336;3;2;1
/org.eclipse.swt/Eclipse SWT PI/motif/org/eclipse/swt/internal/motif/XAnyEvent.java;1;0;2;1;0;0;0;2;7;1;2;56;9;9;1;0;0;2;2;56;0;88;2;1;0
/org.eclipse.swt/Eclipse SWT PI/win32/org/eclipse/swt/internal/ole/win32/VARDESC1.java;1;0;1;1;0;0;0;1;8;0;1;166;8;8;1;0;0;1;1;166;0;166;1;1;0
/org.eclipse.jdt.core/dom/org/eclipse/jdt/core/dom/ASTParser.java;4;3;13;3;6;2;6;7;1686;5;2;230;2804;2804;5;5;4;7;13;246;9;312;4;4;3
/org.eclipse.jdt.core/compiler/org/eclipse/jdt/internal/compiler/ast/ArrayTypeReference.java;3;0;4;1;1;1;1;3;83;1;3;63;91;91;1;0;0;3;4;63;0;314;4;3;1
/org.eclipse.ui.console/src/org/eclipse/ui/console/IConsole.java;1;0;1;1;0;0;0;1;0;0;1;118;0;0;1;0;0;1;1;118;0;118;1;1;0
/org.eclipse.swt/Eclipse SWT Accessibility/common/org/eclipse/swt/accessibility/AccessibleEvent.java;1;0;1;1;0;0;0;1;11;0;1;156;11;11;1;0;0;1;1;156;0;156;1;1;0
/org.eclipse.pde.core/src/org/eclipse/pde/internal/core/isite/ISiteCategoryDefinition.java;2;1;3;1;2;2;2;1;4;0;1;232;10;10;1;0;0;1;3;232;0;336;3;2;0
/org.eclipse.team.cvs.core/src/org/eclipse/team/internal/ccvs/core/client/listeners/UpdateListener.java;2;2;7;1;4;3;4;3;163;2;2;56;274;274;2;1;1;3;7;56;2;336;5;2;0
/org.eclipse.jdt.ui/core refactoring/org/eclipse/jdt/internal/corext/refactoring/code/ConstantChecks.java;1;0;1;1;1;1;1;0;2;0;0;336;2;2;1;0;0;0;1;336;0;336;1;1;0
/org.eclipse.jface/src/org/eclipse/jface/preference/PreferencePage.java;2;0;5;1;0;0;0;5;36;3;3;54;43;43;3;2;0;5;5;101;2;160;3;2;3
/org.eclipse.help/src/org/eclipse/help/internal/model/IAnchorElement.java;1;0;2;1;1;1;1;1;9;0;1;197;9;9;1;0;0;1;2;197;0;311;2;1;0
/org.eclipse.jdt.ui/ui/org/eclipse/jdt/ui/actions/FindReadReferencesInHierarchyAction.java;2;0;2;1;1;1;1;1;5;0;1;184;7;7;1;0;0;1;2;184;0;336;2;2;0
/org.eclipse.jdt.ui/ui/org/eclipse/jdt/internal/ui/viewsupport/LabelProviderDisposer.java;1;0;1;1;1;1;1;0;2;0;0;336;2;2;1;0;0;0;1;336;0;336;1;1;0
/org.eclipse.jdt.debug.ui/ui/org/eclipse/jdt/debug/ui/launchConfigurations/JavaConnectTab.java;4;0;5;1;1;1;1;4;14;1;4;48;30;30;1;0;0;4;5;48;0;336;5;4;0
/org.eclipse.team.cvs.core/src/org/eclipse/team/internal/ccvs/core/resources/FileContentCachingService.java;2;0;6;1;1;1;1;5;116;2;4;100;145;145;2;1;0;5;6;100;1;336;5;2;0
/org.eclipse.team.cvs.ui/src/org/eclipse/team/internal/ccvs/ui/repo/RepositorySorter.java;2;1;3;1;2;2;2;1;12;0;1;20;22;22;1;0;0;1;3;20;0;336;3;2;0
/org.eclipse.swt/Eclipse SWT Browser/motif/org/eclipse/swt/browser/PromptDialog.java;2;0;2;1;1;1;1;1;6;0;1;265;6;6;1;0;0;1;2;265;0;337;2;2;0
/org.eclipse.ui.ide/src/org/eclipse/ui/views/markers/internal/ITableListener.java;1;0;1;1;0;0;0;1;0;0;1;181;0;0;1;0;0;1;1;181;0;181;1;1;0
/org.eclipse.core.runtime/src/org/eclipse/core/internal/registry/RegistryDelta.java;4;1;5;3;2;2;2;3;134;2;2;173;146;146;2;1;0;3;5;173;1;336;4;4;0
/org.eclipse.ant.ui/Ant Tools Support/org/eclipse/ant/internal/ui/preferences/AddPropertyDialog.java;2;0;4;2;0;0;0;4;48;3;2;108;73;73;3;2;0;4;4;108;2;270;2;2;1
/org.eclipse.ui.workbench/Eclipse UI/org/eclipse/ui/internal/ShowPartPaneMenuAction.java;1;0;1;1;0;0;0;1;45;0;1;157;45;45;1;0;0;1;1;157;0;157;1;1;0
/org.eclipse.jdt.junit.runtime/src/org/eclipse/jdt/internal/junit/runner/RemoteTestRunner.java;2;2;9;2;3;2;3;6;69;2;4;82;206;206;2;2;1;6;9;193;3;337;6;2;0
/org.eclipse.ant.ui/Ant Tools Support/org/eclipse/ant/internal/ui/preferences/AntPropertiesBlock.java;2;0;10;2;1;1;1;9;100;3;5;108;218;218;3;4;0;9;10;108;4;299;6;2;1
/org.eclipse.team.cvs.ui/src/org/eclipse/team/internal/ccvs/ui/wizards/KSubstWizard.java;2;1;3;1;2;2;2;1;5;0;1;269;9;9;1;0;0;1;3;269;0;336;3;2;1
/org.eclipse.pde.ui/src/org/eclipse/pde/internal/ui/editor/TableSection.java;2;1;3;1;2;2;2;1;43;0;1;64;58;58;1;0;0;1;3;64;0;336;3;2;0
/org.eclipse.ui.workbench/Eclipse UI/org/eclipse/ui/internal/ViewStack.java;3;3;5;1;5;3;5;0;83;0;0;297;107;107;3;0;2;0;5;297;2;336;3;3;1
/org.eclipse.jdt.ui/ui/org/eclipse/jdt/internal/ui/text/JavaCodeReader.java;1;0;1;1;1;1;1;0;2;0;0;336;2;2;1;0;0;0;1;336;0;336;1;1;0
/org.eclipse.text/src/org/eclipse/jface/text/DocumentEvent.java;1;0;1;1;1;1;1;0;18;0;0;334;18;18;1;0;0;0;1;334;0;334;1;1;0
/org.eclipse.pde.ui/src_Forms/org/eclipse/pde/internal/ui/model/plugin/FragmentNode.java;3;3;9;3;6;4;6;3;40;2;2;244;102;102;3;1;2;3;9;297;3;336;6;3;0
/org.eclipse.ui.workbench/Eclipse UI/org/eclipse/ui/internal/misc/CheckboxDoubleListGroup.java;2;1;2;1;2;2;2;0;6;0;0;287;8;8;1;0;0;0;2;287;0;336;2;2;0
/org.eclipse.debug.ui/ui/org/eclipse/debug/internal/ui/StepFilterManager.java;1;0;1;1;0;0;0;1;0;0;1;202;0;0;1;0;0;1;1;202;0;202;1;1;1
/org.eclipse.jface.text/src/org/eclipse/jface/text/rules/ICharacterScanner.java;1;0;1;1;1;1;1;0;2;0;0;336;2;2;1;0;0;0;1;336;0;336;1;1;0
/org.eclipse.core.resources/src/org/eclipse/core/internal/dtree/ObjectNotFoundException.java;1;0;1;1;1;1;1;0;31;0;0;277;31;31;1;0;0;0;1;277;0;277;1;1;0
/org.eclipse.jdt.core/model/org/eclipse/jdt/internal/core/util/ConstantPoolEntry.java;1;0;1;1;0;0;0;1;2;0;1;199;2;2;1;0;0;1;1;199;0;199;1;1;0
/org.eclipse.pde.build/src/org/eclipse/pde/internal/build/site/BuildTimeSiteFactory.java;2;2;9;2;3;2;3;6;51;2;4;31;62;62;2;2;1;6;9;31;3;296;6;2;0
/org.eclipse.swt/Eclipse SWT/win32/org/eclipse/swt/widgets/CoolBar.java;5;5;13;4;6;2;6;7;83;2;4;85;245;245;5;3;4;7;13;273;7;337;6;5;0
/org.eclipse.team.ui/src/org/eclipse/team/internal/ui/synchronize/ISynchronizeModelProvider.java;2;3;5;2;4;2;4;1;39;0;1;253;43;43;3;0;2;1;5;288;2;336;3;2;0
/org.eclipse.jdt.ui/ui/org/eclipse/jdt/internal/ui/text/correction/LocalCorrectionsSubProcessor.java;5;8;50;3;11;3;11;39;496;10;13;7;1665;1665;10;26;8;39;50;244;34;336;16;5;3
/org.eclipse.jdt.core/compiler/org/eclipse/jdt/internal/compiler/lookup/LocalVariableBinding.java;1;0;2;1;0;0;0;2;3;1;2;13;5;5;1;0;0;2;2;13;0;199;2;1;1
/org.eclipse.debug.ui/ui/org/eclipse/debug/internal/ui/views/variables/SelectLogicalStructureAction.java;2;0;2;1;0;0;0;2;11;1;2;154;11;11;1;0;0;2;2;154;0;166;2;2;0
/org.eclipse.jdt.ui/ui/org/eclipse/jdt/internal/ui/jarpackager/JarPackagerUtil.java;2;0;2;1;1;1;1;1;13;0;1;123;15;15;1;0;0;1;2;123;0;336;2;2;0
/org.eclipse.ant.ui/Ant Tools Support/org/eclipse/ant/internal/ui/views/actions/RefreshBuildFilesAction.java;1;0;5;1;1;1;1;4;14;2;3;108;28;28;2;1;0;4;5;108;1;289;4;1;1
/org.eclipse.update.core/src/org/eclipse/update/internal/search/UpdatesSearchCategory.java;4;1;16;2;2;2;2;14;109;3;9;58;242;242;3;5;0;14;16;251;5;336;11;4;1
/org.eclipse.ant.ui/Ant Editor/org/eclipse/ant/internal/ui/dtd/schema/NfmNode.java;1;0;2;1;0;0;0;2;8;1;2;108;8;8;1;0;0;2;2;108;0;202;2;1;0
/org.eclipse.debug.core/core/org/eclipse/debug/internal/core/sourcelookup/containers/WorkspaceSourceContainerType.java;2;0;3;2;1;1;1;2;21;1;2;205;27;27;1;0;0;2;3;205;0;303;3;2;0
/org.eclipse.search/search/org/eclipse/search/ui/SearchUI.java;2;2;4;1;4;3;4;0;39;0;0;290;47;47;2;0;1;0;4;325;1;336;3;2;0
/org.eclipse.core.runtime/src/org/eclipse/core/internal/runtime/FindSupport.java;4;3;10;3;4;2;4;6;303;3;4;179;612;612;3;2;2;6;10;227;4;336;6;4;0
/org.eclipse.jdt.debug/jdi/org/eclipse/jdi/internal/ThreadReferenceImpl.java;2;0;2;1;1;1;1;1;4;0;1;206;6;6;1;0;0;1;2;206;0;336;2;2;0
/org.eclipse.jdt.ui/ui/org/eclipse/jdt/ui/actions/FindAction.java;5;4;19;4;5;2;7;12;90;5;9;17;233;233;5;3;5;14;19;262;8;336;11;5;0
/org.eclipse.help.ui/src/org/eclipse/help/ui/internal/DefaultHelpUI.java;1;1;6;1;3;3;3;3;83;1;3;106;187;187;1;0;0;3;6;106;0;336;6;1;1
/org.eclipse.osgi/core/adaptor/org/eclipse/osgi/framework/adaptor/ImportResourceNotFoundException.java;4;1;4;1;2;2;2;2;34;1;2;171;40;40;1;0;0;2;4;171;0;336;4;4;0
/org.eclipse.team.cvs.ssh2/src/org/eclipse/team/internal/ccvs/ssh2/PServerSSH2ServerConnection.java;1;0;2;1;1;1;1;1;2;0;1;263;2;2;1;0;0;1;2;263;0;309;2;1;0
/org.eclipse.jdt.core/compiler/org/eclipse/jdt/internal/compiler/ast/Literal.java;2;0;3;1;0;0;0;3;57;1;3;31;64;64;1;0;0;3;3;31;0;199;3;2;0
/org.eclipse.jdt.core/compiler/org/eclipse/jdt/internal/compiler/lookup/InvocationSite.java;2;0;2;1;1;1;1;1;2;0;1;199;4;4;1;0;0;1;2;199;0;300;2;2;0
/org.eclipse.jdt.junit/src/org/eclipse/jdt/internal/junit/util/JUnitStatus.java;2;1;2;1;2;2;2;0;8;0;0;275;10;10;1;0;0;0;2;275;0;336;2;2;0
/org.eclipse.update.configurator/src/org/eclipse/update/internal/configurator/branding/IniFileReader.java;1;2;8;1;3;2;3;5;53;0;1;247;78;78;5;4;1;5;8;247;5;336;3;1;0
/org.eclipse.swt/Eclipse SWT/motif/org/eclipse/swt/widgets/Control.java;7;10;44;4;14;3;15;29;288;5;14;0;1039;1039;10;15;12;30;44;292;27;330;17;7;0
/org.eclipse.pde.core/src/org/eclipse/pde/core/plugin/IPluginLibrary.java;3;1;7;2;2;2;5;2;155;4;2;232;173;173;4;0;3;5;7;267;3;336;4;3;0
/org.eclipse.jface/src/org/eclipse/jface/resource/ColorRegistry.java;2;0;7;1;1;1;1;6;172;4;3;181;205;205;4;3;0;6;7;233;3;336;4;2;0
/org.eclipse.jdt.ui/core extension/org/eclipse/jdt/internal/corext/dom/Selection.java;3;1;3;1;2;2;2;1;9;0;1;116;13;13;1;0;0;1;3;116;0;336;3;3;0
/org.eclipse.search/search/org/eclipse/search/internal/ui/text/TextSearchResultCollector.java;1;0;1;1;1;1;1;0;2;0;0;336;2;2;1;0;0;0;1;336;0;336;1;1;0
/org.eclipse.jdt.ui/ui/org/eclipse/jdt/internal/ui/filters/InterfaceFilter.java;1;0;1;1;1;1;1;0;2;0;0;336;2;2;1;0;0;0;1;336;0;336;1;1;0
/org.eclipse.search/new search/org/eclipse/search/ui/ISearchResultListener.java;3;2;7;2;3;2;3;4;40;1;4;195;85;85;2;0;1;4;7;279;1;336;6;3;0
/org.eclipse.ui.workbench/Eclipse UI/org/eclipse/ui/internal/activities/ws/ActivityLabelProvider.java;1;0;2;1;0;0;0;2;4;0;1;174;4;4;2;1;0;2;2;174;1;174;1;1;0
/org.eclipse.jdt.debug.ui/ui/org/eclipse/jdt/internal/debug/ui/jres/JREDescriptor.java;1;0;1;1;0;0;0;1;0;0;1;264;0;0;1;0;0;1;1;264;0;264;1;1;0
/org.eclipse.jdt.ui/ui/org/eclipse/jdt/internal/ui/javadocexport/JavadocSpecificsWizardPage.java;2;0;4;1;1;1;1;3;68;2;2;224;77;77;2;1;0;3;4;224;1;336;3;2;0
/org.eclipse.team.cvs.core/src/org/eclipse/team/internal/ccvs/core/client/NOOPCommand.java;2;0;3;1;1;1;1;2;14;1;2;110;18;18;1;0;0;2;3;110;0;336;3;2;0
/org.eclipse.jdt.debug/model/org/eclipse/jdt/internal/debug/core/model/JDIArrayValue.java;2;1;4;1;2;2;2;2;40;1;2;148;56;56;1;0;0;2;4;148;0;336;4;2;0
/org.eclipse.jdt.core/model/org/eclipse/jdt/internal/core/Region.java;1;0;1;1;0;0;0;1;2;0;1;199;2;2;1;0;0;1;1;199;0;199;1;1;0
/org.eclipse.ui.workbench/Eclipse UI/org/eclipse/ui/internal/PartStack.java;3;18;20;2;20;2;20;0;602;0;0;289;643;643;18;0;18;0;20;289;18;330;2;3;8
/org.eclipse.ui.workbench/Eclipse UI/org/eclipse/ui/internal/ReopenEditorMenu.java;1;0;2;1;0;0;0;2;89;1;2;157;168;168;1;0;0;2;2;157;0;173;2;1;1
/org.eclipse.swt/Eclipse SWT/photon/org/eclipse/swt/graphics/Device.java;2;1;3;1;2;2;2;1;4;0;1;0;12;12;1;0;0;1;3;0;0;337;3;2;0
/org.eclipse.jdt.core/model/org/eclipse/jdt/internal/core/TypeConverter.java;4;0;7;1;2;1;2;5;20;1;5;7;41;41;2;0;1;5;7;303;1;303;6;4;1
/org.eclipse.jdt.junit/src/org/eclipse/jdt/internal/junit/wizards/NewTestSuiteCreationWizard.java;3;1;3;1;2;2;2;1;6;0;1;14;10;10;1;0;0;1;3;14;0;336;3;3;0
/org.eclipse.jdt.junit/src/org/eclipse/jdt/internal/junit/ui/FailureTab.java;2;1;2;1;2;2;2;0;2;0;0;301;2;2;1;0;0;0;2;301;0;336;2;2;0
/org.eclipse.ui.editors/src/org/eclipse/ui/editors/text/templates/ContributionTemplateMessages.java;2;1;2;1;2;2;2;0;16;0;0;301;16;16;1;0;0;0;2;301;0;336;2;2;0
/org.eclipse.debug.core/core/org/eclipse/debug/internal/core/LaunchMode.java;1;0;1;1;1;1;1;0;0;0;0;275;0;0;1;0;0;0;1;275;0;275;1;1;0
/org.eclipse.ui.editors/src/org/eclipse/ui/internal/editors/text/UISynchronizationContext.java;2;1;2;1;2;2;2;0;20;0;0;279;20;20;1;0;0;0;2;279;0;336;2;2;0
/org.eclipse.ui.workbench/Eclipse UI/org/eclipse/ui/activities/IWorkbenchActivitySupport.java;3;1;6;1;2;2;2;4;26;3;2;174;52;52;3;2;0;4;6;174;2;336;4;3;0
/org.eclipse.help.ui/src/org/eclipse/help/ui/internal/IHyperlinkListener.java;1;1;2;1;2;2;2;0;14;0;0;311;20;20;1;0;0;0;2;311;0;336;2;1;0
/org.eclipse.text/projection/org/eclipse/jface/text/projection/ChildDocumentManager.java;1;0;3;1;1;1;1;2;13;1;2;253;34;34;1;0;0;2;3;253;0;334;3;1;0
/org.eclipse.pde.ui/src/org/eclipse/pde/internal/ui/editor/plugin/JavaAttributeWizard.java;2;1;3;1;3;3;3;0;8;0;0;292;14;14;1;0;0;0;3;292;0;336;3;2;0
/org.eclipse.debug.core/core/org/eclipse/debug/internal/core/WatchExpression.java;3;1;11;2;2;2;2;9;107;6;3;93;169;169;6;6;0;9;11;93;6;301;5;3;0
/org.eclipse.ui.ide/src/org/eclipse/ui/views/navigator/IResourceNavigator.java;1;0;1;1;0;0;0;1;0;0;1;129;0;0;1;0;0;1;1;129;0;129;1;1;0
/org.eclipse.ui.workbench/Eclipse UI/org/eclipse/ui/presentations/StackPresentation.java;6;5;12;5;7;3;7;5;128;0;1;245;213;213;5;4;4;5;12;245;8;336;4;6;0
/org.eclipse.swt/Eclipse SWT PI/photon/org/eclipse/swt/internal/photon/OS.java;4;0;17;2;1;1;1;16;3721;5;6;31;3821;3821;5;10;0;16;17;122;10;337;7;4;0
/org.eclipse.core.resources/src/org/eclipse/core/internal/resources/AliasManager.java;2;2;5;1;3;2;3;2;131;1;2;114;143;143;2;0;1;2;5;275;1;307;4;2;0
/org.eclipse.jdt.ui/core refactoring/org/eclipse/jdt/internal/corext/refactoring/structure/MoveInnerToTopRefactoring.java;5;5;46;2;12;4;12;34;968;6;13;8;1708;1708;6;21;8;34;46;8;29;331;17;5;2
/org.eclipse.pde.build/src/org/eclipse/pde/internal/build/packager/FetchFileGenerator.java;2;4;11;2;5;2;5;6;140;2;4;31;199;199;4;2;3;6;11;272;5;307;6;2;0
/org.eclipse.ui.forms/src/org/eclipse/ui/forms/widgets/SharedScrolledComposite.java;1;1;7;1;2;2;2;5;64;4;2;225;78;78;4;3;0;5;7;225;3;336;4;1;0
/org.eclipse.osgi/osgi/src/org/osgi/service/url/URLConstants.java;2;0;2;1;1;1;1;1;3;0;1;171;3;3;1;0;0;1;2;171;0;296;2;2;0
/org.eclipse.jdt.ui/ui/org/eclipse/jdt/internal/ui/actions/BlockCommentAction.java;3;1;7;2;2;2;2;5;256;2;3;99;283;283;2;2;0;5;7;99;2;336;5;3;0
/org.eclipse.jdt.ui/ui/org/eclipse/jdt/internal/ui/util/TypeInfoLabelProvider.java;2;1;2;1;2;2;2;0;5;0;0;299;7;7;1;0;0;0;2;299;0;336;2;2;0
/org.eclipse.swt/Eclipse SWT/motif/org/eclipse/swt/widgets/Button.java;5;1;12;2;3;3;3;9;57;2;6;19;137;137;2;3;0;9;12;50;3;337;9;5;1
/org.eclipse.pde.ui/src/org/eclipse/pde/internal/ui/wizards/extension/NewExtensionRegistryReader.java;3;1;3;1;3;3;3;0;361;0;0;295;403;403;1;0;0;0;3;295;0;336;3;3;0
/org.eclipse.jdt.ui/core refactoring/org/eclipse/jdt/internal/corext/refactoring/typeconstraints/IConstraintVariableFactory.java;2;0;2;1;1;1;1;1;2;0;1;207;2;2;1;0;0;1;2;207;0;336;2;2;0
/org.eclipse.jdt.ui/ui/org/eclipse/jdt/internal/ui/workingsets/JavaWorkingSetPage.java;1;0;4;1;1;1;1;3;45;2;2;61;81;81;2;1;0;3;4;184;1;336;3;1;0
/org.eclipse.jdt.debug.ui/ui/org/eclipse/jdt/internal/debug/ui/EvaluationContextManager.java;2;0;2;1;0;0;0;2;10;1;2;74;13;13;1;0;0;2;2;74;0;152;2;2;0
/org.eclipse.debug.core/core/org/eclipse/debug/internal/core/EnvironmentVariableResolver.java;3;0;5;2;1;1;1;4;14;2;3;150;27;27;2;1;0;4;5;150;1;294;4;3;0
/org.eclipse.help/src/org/eclipse/help/internal/model/INavigationElement.java;1;0;3;1;1;1;1;2;11;0;1;197;13;13;2;1;0;2;3;197;1;311;2;1;0
/org.eclipse.ui.workbench/Eclipse UI/org/eclipse/ui/IInPlaceEditorInput.java;2;0;2;1;0;0;0;2;39;1;2;123;39;39;1;0;0;2;2;123;0;157;2;2;0
/org.eclipse.compare/compare/org/eclipse/compare/contentmergeviewer/TextMergeViewer.java;1;7;19;1;8;2;8;11;254;3;6;19;582;582;7;5;6;11;19;314;11;314;8;1;1
/org.eclipse.debug.ui/ui/org/eclipse/debug/internal/ui/views/launch/LaunchViewContextListener.java;3;0;28;3;3;1;19;9;1503;20;3;212;2010;2010;20;6;18;25;28;263;24;320;4;3;2
/org.eclipse.ui.workbench/Eclipse UI/org/eclipse/ui/internal/dialogs/RegistryPageContributor.java;4;0;6;2;1;1;1;5;71;2;4;157;134;134;2;1;0;5;6;157;1;336;5;4;2
/org.eclipse.osgi/eclipseAdaptor/src/org/eclipse/osgi/framework/stats/BundleStats.java;3;1;4;1;3;3;3;1;49;0;1;171;75;75;1;0;0;1;4;171;0;336;4;3;0
/org.eclipse.ui.carbon/src/org/eclipse/ui/carbon/CarbonUIEnhancer.java;1;0;4;1;0;0;0;4;38;2;3;165;44;44;2;1;0;4;4;224;1;224;3;1;0
/org.eclipse.jdt.ui/ui/org/eclipse/jdt/internal/ui/javaeditor/SemanticToken.java;2;2;3;1;3;2;3;0;27;0;0;283;27;27;2;0;1;0;3;293;1;293;2;2;0
/org.eclipse.ant.ui/Ant Editor/org/eclipse/ant/internal/ui/editor/templates/AntTemplateAccess.java;1;0;4;1;2;1;2;2;21;0;1;263;31;31;2;1;1;2;4;263;2;285;2;1;1
/org.eclipse.jdt.core/model/org/eclipse/jdt/core/IParent.java;1;0;1;1;0;0;0;1;2;0;1;199;2;2;1;0;0;1;1;199;0;199;1;1;0
/org.eclipse.pde.core/src/org/eclipse/pde/internal/core/ibundle/IBundleModelFactory.java;1;1;2;1;2;2;2;0;4;0;0;292;4;4;1;0;0;0;2;292;0;336;2;1;0
/org.eclipse.ltk.ui.refactoring/src/org/eclipse/ltk/internal/ui/refactoring/RefactoringPreferencePage.java;1;0;2;1;1;1;1;1;2;0;1;269;2;2;1;0;0;1;2;269;0;336;2;1;0
/org.eclipse.jdt.debug/model/org/eclipse/jdt/debug/core/IJavaPatternBreakpoint.java;2;1;2;1;2;2;2;0;4;0;0;275;5;5;1;0;0;0;2;275;0;336;2;2;0
/org.eclipse.jface/src/org/eclipse/jface/preference/PreferenceConverter.java;4;1;9;2;2;2;2;7;89;2;5;0;191;191;2;2;0;7;9;233;2;336;7;4;0
/org.eclipse.team.ui/src/org/eclipse/team/internal/ui/registry/RegistryReader.java;2;1;5;1;2;2;2;3;156;0;1;144;178;178;3;2;0;3;5;144;2;336;3;2;0
/org.eclipse.jdt.ui/ui/org/eclipse/jdt/internal/ui/text/java/hover/JavadocHover.java;1;1;3;1;2;2;2;1;9;0;1;150;13;13;1;0;0;1;3;150;0;336;3;1;0
/org.eclipse.jdt.debug/jdi interfaces/com/sun/jdi/connect/spi/ClosedConnectionException.java;1;0;1;1;0;0;0;1;0;0;1;235;0;0;1;0;0;1;1;235;0;235;1;1;0
/org.eclipse.ui.workbench/Eclipse UI/org/eclipse/ui/internal/dialogs/FilteredTree.java;1;1;4;1;2;2;2;2;13;0;1;269;24;24;2;1;0;2;4;269;1;313;3;1;0
/org.eclipse.core.resources/src/org/eclipse/core/internal/resources/SafeFileTable.java;1;0;1;1;1;1;1;0;132;0;0;277;132;132;1;0;0;0;1;277;0;277;1;1;0
/org.eclipse.jdt.core/search/org/eclipse/jdt/internal/core/search/matching/MethodPattern.java;3;0;16;3;2;1;2;14;509;4;10;7;1196;1196;4;4;1;14;16;70;5;280;11;3;3
/org.eclipse.team.cvs.core/src/org/eclipse/team/internal/ccvs/core/ICVSStorage.java;1;0;1;1;0;0;0;1;0;0;1;177;0;0;1;0;0;1;1;177;0;177;1;1;0
/org.eclipse.team.cvs.core/src/org/eclipse/team/internal/ccvs/core/syncinfo/CVSBaseResourceVariantTree.java;2;1;4;1;2;2;2;2;70;0;1;233;76;76;2;1;0;2;4;233;1;336;3;2;0
/org.eclipse.jdt.debug.ui/ui/org/eclipse/jdt/internal/debug/ui/jres/InstalledJREsBlock.java;4;1;16;2;3;3;3;13;625;5;6;65;686;686;5;7;0;13;16;65;7;336;9;4;0
/org.eclipse.ui.workbench/Eclipse UI/org/eclipse/ui/internal/ViewSite.java;3;0;4;2;1;1;1;3;11;2;2;158;18;18;2;1;0;3;4;158;1;336;3;3;0
/org.eclipse.jface.text/src/org/eclipse/jface/text/IWidgetTokenOwner.java;2;0;2;2;2;1;2;0;34;0;0;336;34;34;2;0;1;0;2;336;1;336;1;2;0
/org.eclipse.ui.ide/src/org/eclipse/ui/internal/ide/model/WorkbenchStatusList.java;1;0;2;1;0;0;0;2;2;1;2;132;2;2;1;0;0;2;2;132;0;151;2;1;0
/org.eclipse.ant.ui/Ant Editor/org/eclipse/ant/internal/ui/editor/AntCompletionProposal.java;1;0;5;1;0;0;0;5;39;3;3;108;47;47;3;2;0;5;5;237;2;237;3;1;0
/org.eclipse.swt.tools/JNI Generation/org/eclipse/swt/tools/internal/CleanupClass.java;1;0;1;1;0;0;0;1;0;0;1;230;0;0;1;0;0;1;1;230;0;230;1;1;0
/org.eclipse.help.ide/src/org/eclipse/help/ui/internal/search/SorterByTitle.java;1;1;2;1;2;2;2;0;2;0;0;281;2;2;1;0;0;0;2;281;0;311;2;1;0
/org.eclipse.ltk.core.refactoring/src/org/eclipse/ltk/core/refactoring/participants/MoveArguments.java;1;0;4;1;2;1;2;2;5;0;1;264;7;7;2;1;1;2;4;264;2;275;2;1;0
/org.eclipse.ui.workbench/Eclipse UI/org/eclipse/ui/internal/presentations/ISelfUpdatingAction.java;1;0;1;1;1;1;1;0;0;0;0;279;0;0;1;0;0;0;1;279;0;279;1;1;0
/org.eclipse.debug.ui/ui/org/eclipse/debug/ui/AbstractDebugView.java;3;1;9;2;2;2;2;7;33;2;5;51;78;78;2;2;0;7;9;79;2;336;7;3;0
/org.eclipse.pde.ui/src/org/eclipse/pde/internal/ui/preferences/EditorPreferencePage.java;2;1;3;1;2;2;2;1;6;0;1;59;13;13;1;0;0;1;3;59;0;336;3;2;0
/org.eclipse.update.core/src/org/eclipse/update/core/IImport.java;3;1;4;1;2;2;2;2;6;1;2;0;16;16;1;0;0;2;4;0;0;336;4;3;0
/org.eclipse.jdt.core/codeassist/org/eclipse/jdt/internal/codeassist/complete/CompletionOnQualifiedInterfaceReference.java;2;0;2;1;0;0;0;2;13;1;2;63;15;15;1;0;0;2;2;63;0;199;2;2;0
/org.eclipse.search/new search/org/eclipse/search2/internal/ui/SearchesDialog.java;2;1;2;1;2;2;2;0;2;0;0;303;2;2;1;0;0;0;2;303;0;336;2;2;0
/org.eclipse.ui.forms/src/org/eclipse/ui/forms/DetailsPart.java;1;1;9;1;4;4;4;5;129;4;2;225;248;248;4;3;0;5;9;236;3;336;6;1;0
/org.eclipse.jdt.core/model/org/eclipse/jdt/core/WorkingCopyOwner.java;2;0;9;2;1;1;1;8;38;3;6;54;76;76;3;2;0;8;9;63;2;288;7;2;0
/org.eclipse.swt/Eclipse SWT Program/gnome/org/eclipse/swt/internal/gnome/GNOME.java;2;0;4;1;1;1;1;3;25;0;1;238;27;27;3;2;0;3;4;238;2;337;2;2;1
/org.eclipse.pde.ui/src/org/eclipse/pde/internal/ui/preferences/MainPreferencePage.java;2;1;6;1;2;2;2;4;49;2;3;26;68;68;2;1;0;4;6;44;1;336;5;2;0
/org.eclipse.jdt.ui/ui/org/eclipse/jdt/ui/actions/ReadReferencesSearchGroup.java;3;1;5;1;2;2;2;3;11;1;3;82;24;24;1;0;0;3;5;82;0;336;5;3;0
/org.eclipse.jdt.core/dom/org/eclipse/jdt/core/dom/AssertStatement.java;3;0;8;1;2;1;2;6;95;2;5;199;132;132;2;1;1;6;8;266;2;276;6;3;1
/org.eclipse.ui.ide/src/org/eclipse/ui/internal/ide/actions/ToggleAutoBuildAction.java;1;0;1;1;1;1;1;0;0;0;0;279;0;0;1;0;0;0;1;279;0;279;1;1;0
/org.eclipse.jdt.ui/ui/org/eclipse/jdt/internal/ui/infoviews/JavadocView.java;3;5;16;2;11;3;11;5;303;2;3;49;695;695;5;2;8;5;16;296;10;331;6;3;1
/org.eclipse.jdt.ui/ui/org/eclipse/jdt/internal/ui/text/correction/TypeChangeCompletionProposal.java;3;3;5;2;5;3;5;0;33;0;0;281;38;38;3;0;2;0;5;281;2;336;3;3;0
/org.eclipse.jdt.debug/eval/org/eclipse/jdt/internal/debug/eval/ast/instructions/PushLocalVariable.java;1;0;1;1;0;0;0;1;3;0;1;76;3;3;1;0;0;1;1;76;0;76;1;1;0
/org.eclipse.jdt.core/compiler/org/eclipse/jdt/internal/compiler/lookup/CompilerModifiers.java;2;0;2;1;0;0;0;2;2;1;2;171;3;3;1;0;0;2;2;171;0;199;2;2;0
/org.eclipse.ui.ide/extensions/org/eclipse/ui/part/MarkerTransfer.java;1;0;1;1;0;0;0;1;0;0;1;132;0;0;1;0;0;1;1;132;0;132;1;1;0
/org.eclipse.help.base/src/org/eclipse/help/internal/search/PluginVersionInfo.java;1;1;7;1;3;3;3;4;88;1;4;105;186;186;1;0;0;4;7;105;0;336;7;1;0
/org.eclipse.jdt.debug/model/org/eclipse/jdt/internal/debug/core/logicalstructures/CollectionStructureType.java;1;0;2;1;0;0;0;2;4;0;1;152;4;4;2;1;0;2;2;152;1;152;1;1;0
/org.eclipse.jdt.ui/ui/org/eclipse/jdt/internal/ui/wizards/NewSourceFolderWizardPage.java;2;1;5;2;2;2;2;3;40;2;2;75;53;53;2;1;0;3;5;75;1;336;4;2;0
/org.eclipse.ui.ide/src/org/eclipse/ui/wizards/datatransfer/WizardFileSystemResourceExportPage1.java;3;1;4;1;2;2;2;2;8;1;2;92;12;12;1;0;0;2;4;92;0;336;4;3;0
/org.eclipse.jdt.core/compiler/org/eclipse/jdt/internal/compiler/env/IBinaryMethod.java;1;0;1;1;0;0;0;1;2;0;1;199;2;2;1;0;0;1;1;199;0;199;1;1;0
/org.eclipse.pde.ui/src/org/eclipse/pde/internal/ui/editor/feature/EditorBuildFeatureAction.java;3;3;7;2;5;3;5;2;81;1;2;232;150;150;3;0;2;2;7;302;2;336;5;3;0
/org.eclipse.ui.ide/src/org/eclipse/ui/internal/ide/actions/OpenWorkspaceFileAction.java;1;0;1;1;0;0;0;1;0;0;1;132;0;0;1;0;0;1;1;132;0;132;1;1;0
/org.eclipse.jdt.core/compiler/org/eclipse/jdt/internal/compiler/ast/LabeledStatement.java;3;0;6;2;2;1;2;4;36;2;3;60;52;52;2;1;1;4;6;60;2;287;4;3;1
/org.eclipse.ant.ui/Ant Tools Support/org/eclipse/ant/internal/ui/preferences/MinimizedFileSystemElement.java;1;1;3;1;2;2;2;1;4;0;1;108;7;7;1;0;0;1;3;108;0;336;3;1;0
/org.eclipse.swt/Eclipse SWT/common/org/eclipse/swt/internal/Callback.java;3;0;4;2;1;1;1;3;49;0;1;223;53;53;3;2;0;3;4;223;2;337;2;3;0
/org.eclipse.pde.build/src/org/eclipse/pde/internal/build/ant/JavacTask.java;2;2;9;2;3;2;3;6;488;2;4;31;1286;1286;2;2;1;6;9;31;3;307;6;2;0
/org.eclipse.pde.ui/src/org/eclipse/pde/internal/ui/search/PluginSearchResultCollector.java;3;1;5;1;2;2;2;3;12;2;2;44;22;22;2;1;0;3;5;128;1;336;4;3;0
/org.eclipse.jdt.core/codeassist/org/eclipse/jdt/internal/codeassist/complete/CompletionOnInterfaceReference.java;2;0;2;1;0;0;0;2;4;1;2;63;6;6;1;0;0;2;2;63;0;199;2;2;0
/org.eclipse.jdt.core/model/org/eclipse/jdt/core/ICodeAssist.java;2;0;9;2;1;1;2;7;87;3;4;62;185;185;3;3;1;8;9;264;4;283;5;2;0
/org.eclipse.jdt.ui/ui/org/eclipse/jdt/internal/ui/jarpackager/SealPackagesFilter.java;1;0;1;1;1;1;1;0;2;0;0;336;2;2;1;0;0;0;1;336;0;336;1;1;0
/org.eclipse.jdt.core/compiler/org/eclipse/jdt/internal/compiler/ast/Assignment.java;2;0;6;1;0;0;0;6;45;1;6;6;75;75;1;0;0;6;6;6;0;199;6;2;5
/org.eclipse.pde.ui/src/org/eclipse/pde/internal/ui/editor/plugin/ExtensionsPage.java;2;2;4;1;4;3;4;0;12;0;0;292;24;24;2;0;1;0;4;336;1;336;3;2;0
/org.eclipse.ui.ide/src/org/eclipse/ui/internal/ide/ResourcePerspective.java;3;1;3;1;2;2;2;1;2;0;1;132;4;4;1;0;0;1;3;132;0;336;3;3;0
/org.eclipse.swt/Eclipse SWT PI/motif/org/eclipse/swt/internal/motif/XmDropFinishCallbackStruct.java;1;0;2;1;0;0;0;2;6;0;1;54;6;6;2;1;0;2;2;54;1;54;1;1;0
/org.eclipse.jface/src/org/eclipse/jface/action/StatusLineManager.java;4;2;8;3;3;2;3;5;250;3;3;125;377;377;3;2;1;5;8;247;3;336;5;4;1
/org.eclipse.swt.tools/JNI Generation/org/eclipse/swt/tools/internal/ConstantsGenerator.java;2;0;2;2;0;0;0;2;8;0;1;230;8;8;2;1;0;2;2;230;1;230;1;2;0
/org.eclipse.ui.workbench/Eclipse UI/org/eclipse/ui/internal/contexts/ws/IContextService.java;2;0;2;1;1;1;1;1;6;0;1;268;6;6;1;0;0;1;2;268;0;336;2;2;0
/org.eclipse.core.resources/src/org/eclipse/core/internal/resources/FileState.java;2;5;9;2;8;4;8;1;207;0;1;220;252;252;5;0;4;1;9;275;4;325;5;2;0
/org.eclipse.jface/src/org/eclipse/jface/viewers/DialogCellEditor.java;2;1;2;1;2;2;2;0;6;0;0;296;8;8;1;0;0;0;2;296;0;336;2;2;0
/org.eclipse.jdt.core/codeassist/org/eclipse/jdt/internal/codeassist/complete/CompletionOnKeyword3.java;2;0;3;1;0;0;0;3;7;1;3;10;12;12;1;0;0;3;3;10;0;199;3;2;0
/org.eclipse.jface/src/org/eclipse/jface/viewers/ComboBoxCellEditor.java;1;0;1;1;0;0;0;1;10;0;1;103;10;10;1;0;0;1;1;103;0;103;1;1;0
/org.eclipse.jdt.ui/ui refactoring/org/eclipse/jdt/internal/ui/refactoring/ChangeSignatureWizard.java;5;1;20;2;4;4;6;14;204;4;9;36;559;559;4;5;2;16;20;198;7;336;13;5;0
/org.eclipse.pde/src/org/eclipse/pde/internal/builders/DependencyLoopFinder.java;2;1;4;1;2;2;2;2;89;1;2;116;105;105;1;0;0;2;4;116;0;336;4;2;0
/org.eclipse.jdt.debug.ui/ui/org/eclipse/jdt/internal/debug/ui/console/JavaConsoleTracker.java;2;0;5;2;0;0;0;5;42;4;2;125;60;60;4;3;0;5;5;125;3;144;2;2;1
/org.eclipse.jface/src/org/eclipse/jface/dialogs/IconAndMessageDialog.java;3;0;7;2;2;1;2;5;185;2;4;0;238;238;2;1;1;5;7;101;2;293;5;3;1
/org.eclipse.pde.build/src/org/eclipse/pde/internal/build/builder/ClasspathComputer2_1.java;2;5;9;2;8;2;8;1;388;0;1;230;473;473;5;0;6;1;9;294;6;294;3;2;0
/org.eclipse.swt/Eclipse SWT/carbon/org/eclipse/swt/widgets/TableItem.java;4;1;18;2;6;6;6;12;484;4;6;17;949;949;4;6;0;12;18;103;6;337;12;4;1
/org.eclipse.ui.workbench/Eclipse UI/org/eclipse/ui/internal/WorkbenchPlugin.java;9;2;56;6;4;3;16;40;654;34;8;60;1089;1089;34;32;13;52;56;223;45;336;11;9;7
/org.eclipse.team.cvs.core/src/org/eclipse/team/internal/ccvs/core/CVSWorkspaceSubscriber.java;2;2;23;2;5;4;5;18;440;5;11;30;972;972;5;7;1;18;23;232;8;336;15;2;0
/org.eclipse.jdt.ui/core refactoring/org/eclipse/jdt/internal/corext/refactoring/code/InlineMethodRefactoring.java;4;2;28;2;5;4;5;23;68;4;13;16;286;286;4;10;1;23;28;195;11;336;17;4;2
/org.eclipse.team.core/src/org/eclipse/team/internal/core/subscribers/ContentComparator.java;2;1;5;2;2;2;2;3;142;2;2;209;146;146;2;1;0;3;5;232;1;336;4;2;0
/org.eclipse.ui.workbench/Eclipse UI/org/eclipse/ui/SubActionBars2.java;4;1;4;2;2;2;2;2;4;0;1;181;8;8;2;1;0;2;4;181;1;336;3;4;0
/org.eclipse.core.resources/src/org/eclipse/core/resources/ISynchronizer.java;1;0;2;1;0;0;1;1;220;0;1;270;220;220;2;0;1;2;2;270;1;270;1;1;0
/org.eclipse.ui.forms/src/org/eclipse/ui/forms/MasterDetailsBlock.java;1;1;6;1;2;2;2;4;76;2;3;225;117;117;2;1;0;4;6;225;1;306;5;1;0
/org.eclipse.jdt.debug/model/org/eclipse/jdt/internal/debug/core/model/JDIInterfaceType.java;3;0;4;1;0;0;0;4;74;2;3;45;117;117;2;1;0;4;4;128;1;128;3;3;0
/org.eclipse.ant.core/src/org/eclipse/ant/core/AntCorePlugin.java;1;4;11;1;5;2;5;6;39;2;5;18;101;101;4;1;3;6;11;292;4;330;7;1;1
/org.eclipse.team.cvs.ui/src/org/eclipse/team/internal/ccvs/ui/model/RemoteFolderElement.java;2;1;7;1;2;2;2;5;107;2;3;5;162;162;2;2;0;5;7;63;2;336;5;2;0
/org.eclipse.ui.intro/src/org/eclipse/ui/internal/intro/impl/model/loader/IntroContentParser.java;1;0;4;1;4;1;4;0;30;0;0;276;30;30;4;0;3;0;4;276;3;276;1;1;0
/org.eclipse.jdt.core/batch/org/eclipse/jdt/internal/compiler/batch/ClasspathDirectory.java;2;0;5;1;1;1;1;4;20;1;4;19;39;39;1;0;0;4;5;19;0;287;5;2;0
/org.eclipse.jdt.ui/core extension/org/eclipse/jdt/internal/corext/callhierarchy/MethodWrapper.java;3;0;7;1;1;1;1;6;112;5;2;13;119;119;5;4;0;6;7;13;4;336;3;3;0
/org.eclipse.help.webapp/src_servlets/org/eclipse/help/internal/webapp/data/WorkingSetManagerData.java;1;1;6;1;3;3;3;3;86;1;3;8;155;155;1;0;0;3;6;8;0;336;6;1;0
/org.eclipse.team.cvs.ui/src/org/eclipse/team/internal/ccvs/ui/actions/ReplaceWithRemoteAction.java;2;0;6;1;1;1;1;5;45;1;5;33;66;66;1;0;0;5;6;33;0;336;6;2;0
/org.eclipse.ui.workbench.texteditor/src/org/eclipse/ui/texteditor/DefaultRangeIndicator.java;2;1;5;1;3;3;3;2;9;1;2;181;20;20;1;0;0;2;5;181;0;336;5;2;0
/org.eclipse.swt/Eclipse SWT PI/win32/org/eclipse/swt/internal/ole/win32/OLEINPLACEFRAMEINFO.java;1;0;1;1;0;0;0;1;6;0;1;166;6;6;1;0;0;1;1;166;0;166;1;1;0
/org.eclipse.ui.externaltools/Program Tools Support/org/eclipse/ui/externaltools/internal/program/launchConfigurations/ProgramLaunchDelegate.java;3;0;15;2;0;0;0;15;91;4;5;16;185;185;4;10;0;15;15;16;10;123;5;3;0
/org.eclipse.ui.ide/src/org/eclipse/ui/views/framelist/IFrameSource.java;3;1;3;1;2;2;2;1;2;0;1;129;4;4;1;0;0;1;3;129;0;336;3;3;0
/org.eclipse.jdt.core/dom/org/eclipse/jdt/core/dom/InstanceofExpression.java;3;0;8;1;2;1;2;6;110;2;5;199;158;158;2;1;1;6;8;266;2;276;6;3;1
/org.eclipse.swt/Eclipse SWT Accessibility/emulated/org/eclipse/swt/accessibility/Accessible.java;3;1;6;1;2;2;2;4;990;1;4;0;1136;1136;1;0;0;4;6;0;0;337;6;3;0
/org.eclipse.update.ui/src/org/eclipse/update/internal/ui/wizards/FeatureSorter.java;2;1;5;1;2;2;2;3;8;1;3;91;16;16;1;0;0;3;5;91;0;336;5;2;0
/org.eclipse.search/search/org/eclipse/search/internal/ui/util/SWTUtil.java;1;0;2;1;1;1;1;1;73;0;1;116;75;75;1;0;0;1;2;116;0;336;2;1;0
/org.eclipse.ui.forms/src/org/eclipse/ui/internal/forms/widgets/FormUtil.java;1;1;2;1;2;2;2;0;6;0;0;272;6;6;1;0;0;0;2;272;0;336;2;1;0
/org.eclipse.jdt.ui/ui/org/eclipse/jdt/internal/ui/preferences/JavadocConfigurationPropertyPage.java;2;0;4;1;1;1;1;3;26;1;3;41;33;33;1;0;0;3;4;41;0;336;4;2;0
/org.eclipse.jdt.core/model/org/eclipse/jdt/internal/core/eval/RequestorWrapper.java;1;0;1;1;0;0;0;1;2;0;1;199;2;2;1;0;0;1;1;199;0;199;1;1;0
/org.eclipse.debug.ui/ui/org/eclipse/debug/internal/ui/launchConfigurations/LaunchShortcutExtension.java;3;2;9;3;3;2;3;6;147;3;3;211;316;316;3;3;1;6;9;219;4;294;5;3;1
/org.eclipse.ui.workbench/Eclipse UI/org/eclipse/ui/internal/dialogs/AbstractPreferenceImportExportPage.java;4;0;3;2;1;1;1;2;32;1;2;203;36;36;1;0;0;2;3;203;0;336;3;4;0
/org.eclipse.swt/Eclipse SWT/motif/org/eclipse/swt/graphics/Cursor.java;4;1;9;1;3;3;3;6;104;2;5;16;246;246;2;1;0;6;9;16;1;337;8;4;1
/org.eclipse.ui.workbench/Eclipse UI/org/eclipse/ui/internal/activities/CategoryDefinition.java;4;0;9;2;1;1;1;8;54;5;3;163;86;86;5;5;0;8;9;163;5;336;4;4;0
/org.eclipse.core.runtime/src/org/eclipse/core/runtime/IPath.java;3;0;6;2;2;1;2;4;1812;3;2;148;1878;1878;3;2;1;4;6;171;3;274;3;3;0
/org.eclipse.jdt.core/compiler/org/eclipse/jdt/internal/compiler/ast/Clinit.java;3;0;5;1;1;1;1;4;14;1;4;5;30;30;1;0;0;4;5;5;0;288;5;3;1
/org.eclipse.debug.core/core/org/eclipse/debug/core/sourcelookup/containers/AbstractSourceContainerTypeDelegate.java;1;0;2;1;0;0;1;1;2;0;1;268;2;2;2;0;1;2;2;268;1;268;1;1;0
/org.eclipse.jdt.ui/core extension/org/eclipse/jdt/internal/corext/util/SearchUtils.java;1;0;1;1;1;1;1;0;0;0;0;289;0;0;1;0;0;0;1;289;0;289;1;1;0
/org.eclipse.ui.workbench.texteditor/src/org/eclipse/ui/texteditor/EditorMessages.java;1;0;1;1;1;1;1;0;2;0;0;336;2;2;1;0;0;0;1;336;0;336;1;1;0
/org.eclipse.core.resources/src/org/eclipse/core/resources/IResourceVisitor.java;1;0;2;1;0;0;1;1;24;0;1;270;24;24;2;0;1;2;2;270;1;270;1;1;0
/org.eclipse.jdt.core/compiler/org/eclipse/jdt/internal/compiler/env/INameEnvironment.java;1;0;1;1;0;0;0;1;2;0;1;199;2;2;1;0;0;1;1;199;0;199;1;1;0
/org.eclipse.jdt.core/dom/org/eclipse/jdt/core/dom/StringLiteral.java;5;0;10;2;1;1;1;9;69;2;7;67;101;101;2;2;0;9;10;199;2;283;8;5;1
/org.eclipse.jdt.debug.ui/ui/org/eclipse/jdt/internal/debug/ui/console/JavaNativeStackTraceHyperlink.java;1;0;1;1;0;0;0;1;3;0;1;144;3;3;1;0;0;1;1;144;0;144;1;1;1
/org.eclipse.core.runtime/src/org/eclipse/core/internal/jobs/LockManager.java;3;2;21;3;4;3;4;17;1365;9;6;25;1726;1726;9;11;1;17;21;161;12;330;9;3;0
/org.eclipse.core.resources/src/org/eclipse/core/internal/dtree/DataTree.java;2;0;2;1;1;1;1;1;559;0;1;90;561;561;1;0;0;1;2;90;0;277;2;2;0
/org.eclipse.jface/src/org/eclipse/jface/resource/JFaceColors.java;3;0;5;3;0;0;0;5;249;3;3;223;558;558;3;2;0;5;5;223;2;253;3;3;0
/org.eclipse.core.runtime/src/org/eclipse/core/internal/jobs/ObjectMap.java;2;1;3;1;2;2;2;1;70;0;1;265;72;72;1;0;0;1;3;265;0;303;3;2;0
/org.eclipse.jdt.core/compiler/org/eclipse/jdt/internal/compiler/env/IBinaryType.java;1;0;1;1;0;0;0;1;2;0;1;199;2;2;1;0;0;1;1;199;0;199;1;1;0
/org.eclipse.jface/src/org/eclipse/jface/util/DelegatingDropAdapter.java;1;0;1;1;0;0;0;1;0;0;1;13;0;0;1;0;0;1;1;13;0;13;1;1;0
/org.eclipse.swt/Eclipse SWT PI/gtk/org/eclipse/swt/internal/gtk/PangoAttribute.java;3;0;4;1;1;1;1;3;4;2;2;114;6;6;2;1;0;3;4;226;1;337;3;3;0
/org.eclipse.team.cvs.ui/src/org/eclipse/team/internal/ccvs/ui/operations/SingleCommandOperation.java;2;1;9;1;2;2;2;7;66;2;5;97;133;133;2;2;0;7;9;97;2;336;7;2;0
/org.eclipse.ui.workbench/Eclipse UI/org/eclipse/ui/internal/registry/ViewDescriptor.java;6;1;9;2;2;2;2;7;343;2;6;54;430;430;2;1;0;7;9;171;1;323;8;6;0
/org.eclipse.jdt.ui/ui refactoring/org/eclipse/jdt/internal/ui/refactoring/VisibilityControlUtil.java;4;0;6;2;1;1;1;5;63;3;3;26;117;117;3;2;0;5;6;26;2;336;4;4;0
/org.eclipse.jdt.ui/ui/org/eclipse/jdt/internal/ui/preferences/formatter/CodingStyleConfigurationBlock.java;2;2;14;2;3;2;3;11;474;5;6;176;656;656;5;5;1;11;14;191;6;325;8;2;0
/org.eclipse.ant.ui/Ant Editor/org/eclipse/ant/internal/ui/editor/templates/TaskContextType.java;1;0;1;1;0;0;0;1;0;0;1;267;0;0;1;0;0;1;1;267;0;267;1;1;0
/org.eclipse.pde.ui/src/org/eclipse/pde/internal/ui/editor/feature/FeatureUndoManager.java;1;1;3;1;2;2;2;1;47;0;1;232;57;57;1;0;0;1;3;232;0;336;3;1;0
/org.eclipse.ui.ide/src/org/eclipse/ui/views/tasklist/ResolveMarkerAction.java;1;0;1;1;0;0;0;1;0;0;1;129;0;0;1;0;0;1;1;129;0;129;1;1;0
/org.eclipse.osgi/core/framework/org/eclipse/osgi/framework/eventmgr/ListElement.java;1;1;2;1;2;2;2;0;6;0;0;275;6;6;1;0;0;0;2;275;0;302;2;1;0
/org.eclipse.ui.workbench/Eclipse UI/org/eclipse/ui/commands/HandlerEvent.java;2;0;3;1;1;1;1;2;122;1;2;226;146;146;1;0;0;2;3;226;0;281;3;2;0
/org.eclipse.osgi/osgi/src/org/eclipse/osgi/service/resolver/BundleDelta.java;3;1;4;1;2;2;2;2;10;0;1;171;22;22;2;1;0;2;4;171;1;336;3;3;0
/org.eclipse.swt/Eclipse SWT PI/gtk/org/eclipse/swt/internal/gtk/PangoRectangle.java;3;0;3;1;1;1;1;2;2;1;2;159;4;4;1;0;0;2;3;159;0;337;3;3;0
/org.eclipse.debug.core/core/org/eclipse/debug/core/model/RuntimeProcess.java;4;1;7;2;3;3;3;4;13;1;4;115;44;44;1;0;0;4;7;115;0;336;7;4;4
/org.eclipse.jdt.core/model/org/eclipse/jdt/internal/core/OverflowingLRUCache.java;1;0;5;1;0;0;0;5;21;2;4;62;26;26;2;1;0;5;5;62;1;199;4;1;0
/org.eclipse.jdt.ui/core extension/org/eclipse/jdt/internal/corext/template/java/CodeTemplateContextType.java;4;3;11;3;4;2;4;7;186;2;6;45;343;343;3;1;2;7;11;274;3;336;8;4;0
/org.eclipse.core.runtime/src/org/eclipse/core/runtime/preferences/IScope.java;2;0;5;1;1;1;1;4;57;2;3;224;61;61;2;1;0;4;5;237;1;277;4;2;0
/org.eclipse.debug.core/core/org/eclipse/debug/internal/core/sourcelookup/containers/DefaultSourceContainerType.java;2;0;5;2;1;1;1;4;20;2;3;205;52;52;2;1;0;4;5;205;1;303;4;2;0
/org.eclipse.jdt.ui/ui refactoring/org/eclipse/jdt/internal/ui/refactoring/actions/InlineConstantAction.java;3;0;6;1;1;1;1;5;63;1;5;11;99;99;1;0;0;5;6;11;0;336;6;3;0
/org.eclipse.jdt.ui/ui/org/eclipse/jdt/internal/ui/dialogs/MessageLine.java;1;0;1;1;1;1;1;0;2;0;0;336;2;2;1;0;0;0;1;336;0;336;1;1;0
/org.eclipse.compare/compare/org/eclipse/compare/internal/EditionAction.java;1;0;5;1;1;1;1;4;103;2;3;104;124;124;2;1;0;4;5;104;1;337;4;1;0
/org.eclipse.text/src/org/eclipse/jface/text/ConfigurableLineTracker.java;1;0;1;1;1;1;1;0;21;0;0;334;21;21;1;0;0;0;1;334;0;334;1;1;0
/org.eclipse.jdt.core/search/org/eclipse/jdt/core/search/MethodReferenceMatch.java;3;3;9;2;4;2;4;5;45;2;3;218;99;99;3;2;2;5;9;275;4;314;5;3;0
/org.eclipse.core.filebuffers/src/org/eclipse/core/internal/filebuffers/ContainerGenerator.java;4;2;5;2;3;2;3;2;40;1;2;93;51;51;2;0;1;2;5;332;1;332;4;4;0
/org.eclipse.help.base/src/org/eclipse/help/internal/workingset/AdaptableTopic.java;1;1;4;1;3;3;3;1;33;0;1;104;41;41;1;0;0;1;4;104;0;336;4;1;0
/org.eclipse.ui.workbench/Eclipse UI/org/eclipse/ui/internal/WorkbenchPreferenceInitializer.java;3;5;6;2;6;2;6;0;36;0;0;287;38;38;5;0;4;0;6;287;4;336;2;3;2
/org.eclipse.jdt.debug.ui/ui/org/eclipse/jdt/internal/debug/ui/breakpoints/ToggleClassPrepareBreakpointAction.java;2;0;2;1;0;0;0;2;11;1;2;248;11;11;1;0;0;2;2;248;0;264;2;2;0
/org.eclipse.jdt.ui/ui/org/eclipse/jdt/internal/ui/callhierarchy/CallHierarchyTransferDropAdapter.java;2;0;2;1;1;1;1;1;2;0;1;16;2;2;1;0;0;1;2;16;0;336;2;2;0
/org.eclipse.jdt.ui/core refactoring/org/eclipse/jdt/internal/corext/refactoring/code/flow/ConditionalFlowInfo.java;1;0;1;1;1;1;1;0;2;0;0;336;2;2;1;0;0;0;1;336;0;336;1;1;0
/org.eclipse.help/src/org/eclipse/help/internal/context/RelatedTopic.java;1;1;3;1;3;3;3;0;6;0;0;299;14;14;1;0;0;0;3;299;0;336;3;1;0
/org.eclipse.ui.workbench.texteditor/src/org/eclipse/ui/texteditor/quickdiff/QuickDiff.java;2;2;5;2;4;3;4;1;71;0;1;100;85;85;2;0;1;1;5;287;1;336;4;2;0
/org.eclipse.ui.intro/src/org/eclipse/ui/internal/intro/impl/model/IntroURLAction.java;1;0;1;1;1;1;1;0;0;0;0;287;0;0;1;0;0;0;1;287;0;287;1;1;0
/org.eclipse.jdt.core/search/org/eclipse/jdt/internal/core/search/matching/MatchLocator.java;6;0;65;5;3;1;13;52;2355;32;9;5;6616;6616;32;43;12;62;65;106;55;326;10;6;12
/org.eclipse.osgi/core/adaptor/org/eclipse/osgi/framework/util/Headers.java;3;2;9;1;4;3;4;5;536;2;4;171;606;606;2;1;1;5;9;251;2;336;7;3;0
/org.eclipse.jdt.core/model/org/eclipse/jdt/internal/core/CopyResourceElementsOperation.java;4;2;20;3;4;2;4;16;155;4;8;10;363;363;4;8;2;16;20;67;10;330;10;4;0
/org.eclipse.swt/Eclipse SWT/motif/org/eclipse/swt/widgets/Group.java;2;0;8;2;0;0;0;8;51;3;5;6;97;97;3;3;0;8;8;139;3;169;5;2;0
/org.eclipse.jdt.ui/core refactoring/org/eclipse/jdt/internal/corext/refactoring/util/JavadocUtil.java;1;1;2;1;2;2;2;0;8;0;0;311;8;8;1;0;0;0;2;311;0;320;2;1;0
/org.eclipse.ui.workbench/Eclipse UI/org/eclipse/ui/internal/registry/EditorRegistry.java;7;2;11;4;6;3;6;5;1658;4;2;157;2316;2316;4;3;3;5;11;157;6;330;5;7;1
/org.eclipse.core.expressions/src/org/eclipse/core/internal/expressions/TypeExtension.java;1;1;5;1;2;2;2;3;76;2;2;227;124;124;2;1;0;3;5;227;1;336;4;1;0
/org.eclipse.ant.core/src_ant/org/eclipse/ant/internal/core/ant/InternalProject.java;2;0;5;2;2;1;2;3;80;1;3;97;157;157;2;0;1;3;5;301;1;301;4;2;0
/org.eclipse.compare/compare/org/eclipse/compare/internal/Utilities.java;1;1;12;1;3;3;3;9;258;2;7;79;469;469;2;2;0;9;12;104;2;337;10;1;0
/org.eclipse.help.webapp/src_servlets/org/eclipse/help/internal/webapp/data/WorkingSetData.java;1;1;6;1;3;3;3;3;16;1;3;8;51;51;1;0;0;3;6;8;0;336;6;1;0
/org.eclipse.ant.ui/Ant Editor/org/eclipse/ant/internal/ui/dtd/util/AntDTDUtilMessages.java;1;0;1;1;0;0;0;1;0;0;1;108;0;0;1;0;0;1;1;108;0;108;1;1;0
/org.eclipse.ui.ide/src/org/eclipse/ui/views/markers/MarkerViewUtil.java;2;0;2;1;0;0;0;2;4;1;2;129;4;4;1;0;0;2;2;129;0;181;2;2;0
/org.eclipse.ant.ui/Ant Editor/org/eclipse/ant/internal/ui/editor/text/FileScanner.java;1;0;1;1;0;0;0;1;0;0;1;208;0;0;1;0;0;1;1;208;0;208;1;1;0
/org.eclipse.jdt.core/model/org/eclipse/jdt/core/util/IAttributeNamesConstants.java;1;0;2;1;0;0;0;2;120;1;2;199;122;122;1;0;0;2;2;199;0;264;2;1;0
/org.eclipse.jdt.ui/ui/org/eclipse/jdt/internal/ui/text/spelling/WordCorrectionProposal.java;2;0;3;2;1;1;1;2;2;0;1;219;4;4;2;1;0;2;3;219;1;336;2;2;0
/org.eclipse.pde.ui/src/org/eclipse/pde/internal/ui/editor/plugin/GeneralInfoSection.java;3;10;11;3;11;2;11;0;299;0;0;292;315;315;10;0;9;0;11;292;9;336;2;3;0
/org.eclipse.pde.ui/src/org/eclipse/pde/internal/ui/launcher/JUnitLaunchConfiguration.java;3;9;37;2;11;3;11;26;373;7;12;82;1185;1185;9;14;8;26;37;299;22;299;15;3;0
/org.eclipse.jdt.core/model/org/eclipse/jdt/core/util/IFieldInfo.java;1;0;2;1;0;0;0;2;8;1;2;199;10;10;1;0;0;2;2;199;0;264;2;1;0
/org.eclipse.jdt.ui/core extension/org/eclipse/jdt/internal/corext/dom/JavaElementMapper.java;2;1;4;1;3;3;3;1;6;0;1;266;11;11;1;0;0;1;4;266;0;336;4;2;0
/org.eclipse.compare/compare/org/eclipse/compare/internal/NullViewer.java;1;0;1;1;0;0;0;1;4;0;1;79;4;4;1;0;0;1;1;79;0;79;1;1;0
/org.eclipse.ant.ui/Ant Tools Support/org/eclipse/ant/internal/ui/preferences/IAntBlockContainer.java;1;0;1;1;0;0;0;1;0;0;1;108;0;0;1;0;0;1;1;108;0;108;1;1;0
/org.eclipse.swt/Eclipse SWT Custom Widgets/common/org/eclipse/swt/custom/DefaultLineStyler.java;2;0;2;1;1;1;1;1;4;0;1;197;7;7;1;0;0;1;2;197;0;337;2;2;0
/org.eclipse.jdt.ui/ui/org/eclipse/jdt/internal/ui/IUIConstants.java;1;0;1;1;1;1;1;0;2;0;0;336;2;2;1;0;0;0;1;336;0;336;1;1;0
/org.eclipse.pde.ui/src/org/eclipse/pde/internal/ui/editor/feature/SynchronizeVersionsWizard.java;2;1;2;1;2;2;2;0;4;0;0;308;6;6;1;0;0;0;2;308;0;336;2;2;0
/org.eclipse.jdt.ui/ui/org/eclipse/jdt/internal/ui/actions/MultiActionGroup.java;2;0;2;1;1;1;1;1;7;0;1;262;9;9;1;0;0;1;2;262;0;336;2;2;0
/org.eclipse.jdt.core/dom/org/eclipse/jdt/core/dom/BreakStatement.java;3;0;7;1;1;1;1;6;68;2;5;199;85;85;2;1;0;6;7;266;1;283;6;3;1
/org.eclipse.team.cvs.core/src/org/eclipse/team/internal/ccvs/core/resources/EclipseFile.java;2;0;11;2;1;1;1;10;71;4;6;20;176;176;4;4;0;10;11;119;4;336;7;2;2
/org.eclipse.core.resources/src/org/eclipse/core/internal/indexing/BinarySmallObject.java;1;0;1;1;1;1;1;0;32;0;0;277;32;32;1;0;0;0;1;277;0;277;1;1;0
/org.eclipse.ui.workbench/Eclipse UI/org/eclipse/ui/IInPlaceEditor.java;2;0;2;1;0;0;0;2;36;1;2;123;36;36;1;0;0;2;2;123;0;157;2;2;0
/org.eclipse.jdt.core/compiler/org/eclipse/jdt/internal/compiler/ast/SuperReference.java;2;0;4;1;0;0;0;4;82;1;4;63;90;90;1;0;0;4;4;63;0;267;4;2;0
/org.eclipse.team.ui/src/org/eclipse/team/internal/ui/synchronize/actions/NavigateAction.java;2;2;10;2;4;2;4;6;136;3;4;148;335;335;3;2;2;6;10;148;4;329;6;2;0
/org.eclipse.ant.ui/Remote Ant Support/org/eclipse/ant/internal/ui/antsupport/DemuxInputStreamSetter.java;1;0;1;1;0;0;0;1;0;0;1;208;0;0;1;0;0;1;1;208;0;208;1;1;0
/org.eclipse.ui.workbench/Eclipse UI/org/eclipse/ui/internal/CloseEditorAction.java;1;0;1;1;0;0;0;1;3;0;1;157;3;3;1;0;0;1;1;157;0;157;1;1;0
/org.eclipse.jdt.launching.macosx/macosx/org/eclipse/jdt/internal/ui/macbundler/BundleDescription.java;1;0;2;1;0;0;0;2;2;1;2;203;2;2;1;0;0;2;2;203;0;217;2;1;0
/org.eclipse.ui.ide/extensions/org/eclipse/ui/dialogs/ContainerGenerator.java;3;1;3;1;2;2;2;1;3;0;1;132;5;5;1;0;0;1;3;132;0;336;3;3;0
/org.eclipse.text/projection/org/eclipse/jface/text/projection/ProjectionMapping.java;1;2;7;1;6;4;6;1;125;0;1;247;237;237;2;0;2;1;7;283;2;327;5;1;0
/org.eclipse.pde.core/src/org/eclipse/pde/internal/core/site/WorkspaceSiteModel.java;3;3;5;2;4;2;4;1;29;0;1;145;35;35;3;0;2;1;5;301;2;336;3;3;0
/org.eclipse.pde.ui/src/org/eclipse/pde/internal/ui/editor/schema/SchemaSourcePage.java;1;1;3;1;2;2;2;1;39;0;1;59;59;59;1;0;0;1;3;59;0;336;3;1;0
/org.eclipse.jdt.debug.ui/ui/org/eclipse/jdt/internal/debug/ui/actions/InspectAction.java;3;0;3;1;1;1;1;2;170;1;2;97;177;177;1;0;0;2;3;97;0;336;3;3;0
/org.eclipse.core.runtime/src/org/eclipse/core/runtime/preferences/ConfigurationScope.java;2;0;4;1;1;1;1;3;19;1;3;239;25;25;1;0;0;3;4;239;0;297;4;2;0
/org.eclipse.pde.ui/src/org/eclipse/pde/internal/ui/editor/feature/URLElementPropertySource.java;2;1;3;1;2;2;2;1;22;0;1;232;33;33;1;0;0;1;3;232;0;336;3;2;0
/org.eclipse.swt/Eclipse SWT PI/gtk/org/eclipse/swt/internal/accessibility/gtk/AtkComponentIface.java;4;0;4;1;1;1;1;3;26;1;3;75;45;45;1;0;0;3;4;75;0;337;4;4;0
/org.eclipse.jface.text/src/org/eclipse/jface/text/formatter/IContentFormatter.java;2;0;2;2;2;1;2;0;4;0;0;336;4;4;2;0;1;0;2;336;1;336;1;2;0
/org.eclipse.core.resources/src/org/eclipse/core/internal/utils/ObjectMap.java;1;2;3;1;3;2;3;0;488;0;0;275;490;490;2;0;1;0;3;275;1;303;2;1;0
/org.eclipse.jdt.ui/ui/org/eclipse/jdt/internal/ui/text/java/JavaTypeCompletionProposal.java;4;1;5;1;2;2;2;3;10;1;3;40;30;30;1;0;0;3;5;40;0;336;5;4;0
/org.eclipse.pde.runtime/src/org/eclipse/pde/internal/runtime/logview/FilterDialog.java;2;1;6;1;2;2;2;4;160;3;2;53;212;212;3;2;0;4;6;53;2;336;4;2;0
/org.eclipse.jdt.ui/core extension/org/eclipse/jdt/internal/corext/util/Strings.java;4;0;5;1;1;1;1;4;79;2;3;19;96;96;2;1;0;4;5;96;1;336;4;4;0
/org.eclipse.ui.editors/src/org/eclipse/ui/internal/editors/text/PixelConverter.java;1;0;1;1;1;1;1;0;0;0;0;295;0;0;1;0;0;0;1;295;0;295;1;1;0
/org.eclipse.jdt.ui/core refactoring/org/eclipse/jdt/internal/corext/refactoring/nls/AccessorClass.java;3;2;6;2;5;4;5;1;126;0;1;267;178;178;2;0;1;1;6;331;1;331;5;3;0
/org.eclipse.ui.workbench/Eclipse UI/org/eclipse/ui/internal/intro/IIntroRegistry.java;1;0;6;1;1;1;1;5;26;2;3;203;32;32;2;2;0;5;6;203;2;280;4;1;0
/org.eclipse.jdt.debug/model/org/eclipse/jdt/internal/debug/core/model/JDILocalVariable.java;3;1;3;1;2;2;2;1;6;0;1;144;17;17;1;0;0;1;3;144;0;336;3;3;1
/org.eclipse.jdt.ui/ui/org/eclipse/jdt/internal/ui/typehierarchy/SelectionProviderMediator.java;2;1;3;1;2;2;2;1;100;0;1;264;104;104;1;0;0;1;3;264;0;336;3;2;0
/org.eclipse.team.cvs.ui/src/org/eclipse/team/internal/ccvs/ui/CVSPropertiesPage.java;1;0;1;1;0;0;0;1;318;0;1;31;318;318;1;0;0;1;1;31;0;31;1;1;0
/org.eclipse.swt/Eclipse SWT Browser/mozilla/org/eclipse/swt/browser/AppFileLocProvider.java;2;1;5;1;2;2;2;3;49;1;3;101;89;89;1;0;0;3;5;101;0;337;5;2;0
/org.eclipse.pde.ui/src/org/eclipse/pde/internal/ui/editor/feature/InfoSection.java;3;2;10;2;4;3;4;6;254;1;6;26;346;346;2;0;1;6;10;301;1;336;9;3;0
/org.eclipse.team.ui/src/org/eclipse/team/ui/synchronize/AbstractSynchronizeParticipant.java;2;3;14;2;8;5;8;6;271;2;5;146;606;606;3;1;3;6;14;307;4;336;10;2;2
/org.eclipse.update.ui/src/org/eclipse/update/internal/ui/security/Authentication.java;2;1;2;1;2;2;2;0;4;0;0;298;4;4;1;0;0;0;2;298;0;336;2;2;0
/org.eclipse.team.cvs.ui/src/org/eclipse/team/internal/ccvs/ui/operations/CommitOperation.java;1;0;3;1;1;1;1;2;8;0;1;261;15;15;2;1;0;2;3;261;1;323;2;1;2
/org.eclipse.swt/Eclipse SWT/common/org/eclipse/swt/events/TypedEvent.java;1;0;1;1;0;0;0;1;28;0;1;156;28;28;1;0;0;1;1;156;0;156;1;1;0
/org.eclipse.jdt.ui/ui/org/eclipse/jdt/internal/ui/typehierarchy/HistoryDropDownAction.java;2;0;2;1;1;1;1;1;2;0;1;200;4;4;1;0;0;1;2;200;0;336;2;2;0
/org.eclipse.ui.workbench/Eclipse UI/org/eclipse/ui/part/MultiPageEditor.java;1;0;1;1;0;0;0;1;2;0;1;0;2;2;1;0;0;1;1;0;0;0;1;1;0
/org.eclipse.core.resources/src/org/eclipse/core/internal/resources/ModelObject.java;1;0;2;1;1;1;1;1;35;0;1;174;44;44;1;0;0;1;2;174;0;277;2;1;0
/org.eclipse.jface.text/src/org/eclipse/jface/text/source/ILineRange.java;2;2;3;2;3;2;3;0;8;0;0;275;8;8;2;0;1;0;3;336;1;336;2;2;0
/org.eclipse.help/src/org/eclipse/help/internal/context/Context.java;1;1;4;1;4;4;4;0;21;0;0;290;49;49;1;0;0;0;4;290;0;336;4;1;1
/org.eclipse.jdt.debug.ui/ui/org/eclipse/jdt/internal/debug/ui/ErrorDialogWithToggle.java;1;0;2;1;0;0;0;2;10;1;2;19;14;14;1;0;0;2;2;19;0;122;2;1;0
/org.eclipse.ui.console/src/org/eclipse/ui/console/actions/TextViewerGotoLineAction.java;2;0;2;2;0;0;0;2;8;0;1;118;8;8;2;1;0;2;2;118;1;118;1;2;0
/org.eclipse.jdt.ui/ui/org/eclipse/jdt/internal/ui/search/LRUWorkingSetsList.java;2;1;2;1;2;2;2;0;2;0;0;290;3;3;1;0;0;0;2;290;0;336;2;2;0
/org.eclipse.jdt.ui/ui/org/eclipse/jdt/internal/ui/search/ColorDecoratingLabelProvider.java;1;0;1;1;1;1;1;0;0;0;0;321;0;0;1;0;0;0;1;321;0;321;1;1;0
/org.eclipse.swt/Eclipse SWT Mozilla/common/org/eclipse/swt/internal/mozilla/nsISupports.java;1;0;1;1;0;0;0;1;0;0;1;100;0;0;1;0;0;1;1;100;0;100;1;1;0
/org.eclipse.update.core/src/org/eclipse/update/internal/operations/OperationFactory.java;2;0;7;2;1;1;1;6;11;2;5;54;31;31;2;1;0;6;7;54;1;336;6;2;0
/org.eclipse.ui.workbench/Eclipse UI/org/eclipse/ui/model/BaseWorkbenchContentProvider.java;2;0;2;2;0;0;0;2;104;0;1;150;104;104;2;1;0;2;2;150;1;150;1;2;0
/org.eclipse.osgi/eclipseAdaptor/src/org/eclipse/core/runtime/adaptor/EclipseCommandProvider.java;3;4;11;3;6;3;6;5;66;2;3;209;129;129;4;2;3;5;11;272;5;326;6;3;0
/org.eclipse.jdt.ui/core refactoring/org/eclipse/jdt/internal/corext/refactoring/structure/ConstructorReferenceFinder.java;3;2;9;1;4;3;4;5;224;3;3;18;412;412;3;2;1;5;9;18;3;336;6;3;2
/org.eclipse.ui.ide/src/org/eclipse/ui/internal/ide/IDEWorkbenchActivityHelper.java;5;1;8;2;2;2;2;6;69;2;5;155;220;220;2;1;0;6;8;174;1;336;7;5;1
/org.eclipse.ui.workbench.texteditor/src/org/eclipse/ui/texteditor/IncrementalFindAction.java;2;1;2;2;2;2;2;0;6;0;0;276;10;10;1;0;0;0;2;276;0;336;2;2;0
/org.eclipse.text/src/org/eclipse/jface/text/link/LinkedPositionGroup.java;2;2;5;2;4;2;4;1;256;0;1;232;270;270;2;0;2;1;5;275;2;334;3;2;0
/org.eclipse.ltk.ui.refactoring/src/org/eclipse/ltk/internal/ui/refactoring/TextEditChangeElement.java;1;2;5;1;3;2;3;2;31;0;1;269;43;43;2;1;1;2;5;269;2;336;3;1;0
/org.eclipse.debug.ui/ui/org/eclipse/debug/internal/ui/actions/ConvertToWatchExpressionAction.java;1;0;2;1;0;0;0;2;4;0;1;92;4;4;2;1;0;2;2;92;1;92;1;1;0
/org.eclipse.ant.ui/Ant Tools Support/org/eclipse/ant/internal/ui/launchConfigurations/AntClasspathTab.java;2;0;17;2;1;1;1;16;282;6;6;108;552;552;6;10;0;16;17;108;10;309;7;2;1
/org.eclipse.jdt.core/compiler/org/eclipse/jdt/internal/compiler/impl/ReferenceContext.java;2;0;2;1;1;1;1;1;3;0;1;199;5;5;1;0;0;1;2;199;0;300;2;2;0
/org.eclipse.jdt.debug.ui/ui/org/eclipse/jdt/internal/debug/ui/actions/BreakpointFieldLocator.java;1;0;1;1;0;0;0;1;0;0;1;104;0;0;1;0;0;1;1;104;0;104;1;1;1
/org.eclipse.search/search/org/eclipse/search/internal/ui/util/RowLayouter.java;1;0;1;1;1;1;1;0;2;0;0;336;2;2;1;0;0;0;1;336;0;336;1;1;0
/org.eclipse.core.resources/src/org/eclipse/core/internal/resources/Workspace.java;3;0;47;3;4;1;13;34;4543;12;9;13;9520;9520;12;25;12;43;47;268;37;306;10;3;3
/org.eclipse.swt/Eclipse SWT/photon/org/eclipse/swt/widgets/List.java;4;1;7;1;2;2;2;5;75;1;5;8;164;164;1;0;0;5;7;8;0;337;7;4;0
/org.eclipse.jdt.debug.ui/ui/org/eclipse/jdt/internal/debug/ui/actions/JavaBreakpointPropertiesAction.java;1;0;2;1;0;0;0;2;23;1;2;82;28;28;1;0;0;2;2;82;0;90;2;1;0
/org.eclipse.jdt.core/compiler/org/eclipse/jdt/internal/compiler/ast/AND_AND_Expression.java;2;0;6;1;0;0;0;6;390;3;3;47;404;404;3;3;0;6;6;170;3;199;3;2;0
/org.eclipse.compare/compare/org/eclipse/compare/internal/merge/LineComparator.java;1;0;2;1;2;1;2;0;8;0;0;278;8;8;2;0;1;0;2;278;1;278;1;1;0
/org.eclipse.jdt.core/model/org/eclipse/jdt/core/util/IVerificationTypeInfo.java;2;0;2;1;0;0;0;2;68;1;2;210;68;68;1;0;0;2;2;210;0;264;2;2;0
/org.eclipse.debug.ui/ui/org/eclipse/debug/internal/ui/actions/ProfileAsAction.java;1;0;1;1;0;0;0;1;0;0;1;33;0;0;1;0;0;1;1;33;0;33;1;1;1
/org.eclipse.ui.workbench/Eclipse UI/org/eclipse/ui/internal/progress/ProgressManagerUtil.java;5;5;17;3;6;2;12;5;344;7;4;162;767;767;7;1;10;11;17;270;11;336;6;5;1
/org.eclipse.ant.ui/Ant Tools Support/org/eclipse/ant/internal/ui/views/actions/RemoveProjectAction.java;1;0;2;1;0;0;0;2;4;0;1;108;4;4;2;1;0;2;2;108;1;108;1;1;1
/org.eclipse.jdt.core/model/org/eclipse/jdt/core/util/ILineNumberAttribute.java;1;0;1;1;0;0;0;1;2;0;1;199;2;2;1;0;0;1;1;199;0;199;1;1;0
/org.eclipse.text/src/org/eclipse/jface/text/templates/GlobalTemplateVariables.java;3;2;4;2;4;2;4;0;16;0;0;279;21;21;2;0;2;0;4;279;2;334;2;3;0
/org.eclipse.text/src/org/eclipse/jface/text/SlaveDocumentEvent.java;1;0;1;1;1;1;1;0;4;0;0;334;4;4;1;0;0;0;1;334;0;334;1;1;0
/org.eclipse.update.core/src/org/eclipse/update/core/ContentReference.java;4;1;8;1;3;3;3;5;37;2;4;0;88;88;2;1;0;5;8;175;1;336;7;4;0
/org.eclipse.jdt.ui/ui/org/eclipse/jdt/internal/ui/text/spelling/engine/ISpellCheckIterator.java;2;0;2;1;1;1;1;1;2;0;1;219;2;2;1;0;0;1;2;219;0;336;2;2;0
/org.eclipse.pde.ui/src_Forms/org/eclipse/pde/internal/ui/model/XMLEditingModel.java;2;3;9;2;7;4;7;2;42;0;1;244;92;92;3;1;3;2;9;283;4;336;5;2;0
/org.eclipse.jdt.debug/eval/org/eclipse/jdt/internal/debug/eval/ast/instructions/BinaryOperator.java;1;0;1;1;0;0;0;1;14;0;1;78;14;14;1;0;0;1;1;78;0;78;1;1;0
/org.eclipse.debug.ui/ui/org/eclipse/debug/ui/actions/LaunchAsAction.java;4;1;9;2;3;3;3;6;36;3;4;33;121;121;3;2;0;6;9;171;2;336;7;4;1
/org.eclipse.debug.core/core/org/eclipse/debug/internal/core/SystemVariableResolver.java;2;1;2;1;2;2;2;0;15;0;0;281;15;15;1;0;0;0;2;281;0;294;2;2;0
/org.eclipse.swt/Eclipse SWT Printing/win32/org/eclipse/swt/printing/Printer.java;2;2;8;2;3;2;3;5;14;1;5;24;39;39;2;0;1;5;8;292;1;337;7;2;1
/org.eclipse.core.runtime/src/org/eclipse/core/internal/boot/PlatformURLHandler.java;4;3;7;2;4;2;4;3;148;2;2;173;198;198;3;1;2;3;7;272;3;297;4;4;0
/org.eclipse.swt/Eclipse SWT/gtk/org/eclipse/swt/graphics/GCData.java;5;0;7;1;1;1;1;6;10;2;5;0;23;23;2;1;0;6;7;134;1;337;6;5;0
/org.eclipse.ui.workbench/Eclipse UI/org/eclipse/ui/IWorkbenchActionConstants.java;8;1;13;3;3;3;3;10;122;3;7;0;167;167;3;3;0;10;13;174;3;336;10;8;0
/org.eclipse.jdt.core/model/org/eclipse/jdt/core/ICodeFormatter.java;3;0;4;2;0;0;0;4;6;1;4;54;11;11;1;0;0;4;4;54;0;199;4;3;0
/org.eclipse.pde.runtime/src/org/eclipse/pde/internal/runtime/logview/LogViewLabelProvider.java;2;1;5;1;2;2;2;3;32;0;1;55;38;38;3;2;0;3;5;55;2;336;3;2;0
/org.eclipse.ui.workbench.texteditor/src/org/eclipse/ui/texteditor/MarkRegionTarget.java;2;1;3;1;2;2;2;1;6;0;1;257;9;9;1;0;0;1;3;257;0;336;3;2;0
/org.eclipse.debug.core/core/org/eclipse/debug/core/model/IWatchExpressionResult.java;4;1;5;1;2;2;2;3;6;2;2;92;13;13;2;1;0;3;5;92;1;336;4;4;0
/org.eclipse.ltk.core.refactoring/src/org/eclipse/ltk/core/refactoring/participants/DeleteProcessor.java;1;2;5;1;3;2;3;2;21;0;1;264;47;47;2;1;1;2;5;264;2;336;3;1;0
/org.eclipse.help.base/src/org/eclipse/help/internal/search/SearchManager.java;1;3;11;1;6;3;6;5;168;2;3;104;353;353;3;2;3;5;11;296;5;336;6;1;0
/org.eclipse.jdt.ui/ui/org/eclipse/jdt/internal/ui/wizards/buildpaths/OutputLocationDialog.java;3;0;4;2;1;1;1;3;6;2;2;82;10;10;2;1;0;3;4;82;1;336;3;3;0
/org.eclipse.core.runtime/src/org/eclipse/core/runtime/content/IContentDescription.java;3;3;9;2;4;2;7;2;115;4;2;251;163;163;4;0;5;5;9;268;5;314;4;3;0
/org.eclipse.jdt.ui/ui/org/eclipse/jdt/internal/ui/compare/TextMergeViewerCreator.java;1;0;1;1;1;1;1;0;2;0;0;336;2;2;1;0;0;0;1;336;0;336;1;1;0
/org.eclipse.ui.intro/src/org/eclipse/ui/internal/intro/impl/model/loader/ExtensionPointManager.java;1;1;3;1;3;3;3;0;6;0;0;276;8;8;1;0;0;0;3;276;0;314;3;1;0
/org.eclipse.jdt.ui/ui/org/eclipse/jdt/internal/ui/search/JavaSearchMarkerUpdater.java;2;1;3;1;3;3;3;0;15;0;0;290;21;21;1;0;0;0;3;290;0;336;3;2;0
/org.eclipse.pde.core/src/org/eclipse/pde/internal/core/ifeature/IFeatureEntry.java;2;1;3;1;2;2;2;1;12;0;1;232;20;20;1;0;0;1;3;232;0;336;3;2;0
/org.eclipse.search/search/org/eclipse/search/internal/core/SearchScope.java;1;0;2;1;1;1;1;1;5;0;1;99;7;7;1;0;0;1;2;99;0;336;2;1;0
/org.eclipse.ui.ide/src/org/eclipse/ui/internal/ide/registry/CapabilityRegistry.java;1;0;2;1;0;0;0;2;2;1;2;132;2;2;1;0;0;2;2;132;0;151;2;1;0
/org.eclipse.team.cvs.ui/src/org/eclipse/team/internal/ccvs/ui/wizards/CheckoutWizard.java;2;3;6;1;5;3;5;1;308;0;1;265;359;359;3;0;2;1;6;320;2;320;4;2;2
/org.eclipse.team.cvs.ui/src/org/eclipse/team/internal/ccvs/ui/wizards/SharingWizardSyncPage.java;2;5;11;1;7;3;7;4;235;3;2;247;449;449;5;2;4;4;11;288;6;336;5;2;0
/org.eclipse.jdt.ui/ui refactoring/org/eclipse/jdt/internal/ui/refactoring/reorg/RenameUserInterfaceStarter.java;2;0;8;1;1;1;1;7;15;4;4;103;22;22;4;3;0;7;8;247;3;336;5;2;0
/org.eclipse.swt/Eclipse SWT/gtk/org/eclipse/swt/widgets/Label.java;6;1;14;1;2;2;2;12;47;3;10;19;119;119;3;2;0;12;14;76;2;337;12;6;1
/org.eclipse.swt/Eclipse SWT/win32/org/eclipse/swt/widgets/ScrollBar.java;5;1;12;2;2;2;2;10;29;2;9;1;102;102;2;1;0;10;12;175;1;337;11;5;0
/org.eclipse.jface.text/src/org/eclipse/jface/text/rules/ITokenScanner.java;1;0;1;1;1;1;1;0;2;0;0;336;2;2;1;0;0;0;1;336;0;336;1;1;0
/org.eclipse.ant.ui/Ant Tools Support/org/eclipse/ant/internal/ui/preferences/AntPage.java;1;0;7;1;0;0;0;7;35;3;4;108;72;72;3;3;0;7;7;108;3;170;4;1;0
/org.eclipse.jdt.ui/ui/org/eclipse/jdt/internal/ui/text/JavaPairMatcher.java;1;0;1;1;1;1;1;0;2;0;0;336;2;2;1;0;0;0;1;336;0;336;1;1;0
/org.eclipse.team.ui/src/org/eclipse/team/internal/ui/OverlayIcon.java;1;0;4;1;1;1;1;3;183;1;3;116;220;220;1;0;0;3;4;116;0;336;4;1;0
/org.eclipse.jface.text/src/org/eclipse/jface/internal/text/link/contentassist/IContentAssistListener2.java;2;0;2;1;1;1;1;1;2;0;1;232;2;2;1;0;0;1;2;232;0;336;2;2;0
/org.eclipse.update.core/src/org/eclipse/update/internal/core/SiteLocal.java;2;3;19;1;4;2;4;15;928;8;7;58;1157;1157;8;8;2;15;19;227;10;336;9;2;0
/org.eclipse.compare/compare/org/eclipse/compare/structuremergeviewer/ICompareInput.java;1;0;1;1;0;0;0;1;2;0;1;219;2;2;1;0;0;1;1;219;0;219;1;1;0
/org.eclipse.team.cvs.core/src/org/eclipse/team/internal/ccvs/core/syncinfo/MultiTagResourceVariantTree.java;2;0;4;2;1;1;1;3;11;2;2;233;17;17;2;1;0;3;4;233;1;336;3;2;0
/org.eclipse.swt/Eclipse SWT/win32/org/eclipse/swt/widgets/Combo.java;6;3;29;3;8;4;9;20;262;6;10;8;605;605;6;10;5;21;29;8;15;337;14;6;4
/org.eclipse.jdt.debug.ui/ui/org/eclipse/jdt/internal/debug/ui/display/DisplayCompletionProcessor.java;5;1;10;2;3;3;3;7;26;3;3;72;65;65;3;4;0;7;10;235;4;336;6;5;0
/org.eclipse.swt/Eclipse SWT/common/org/eclipse/swt/SWT.java;7;3;27;4;7;3;7;20;845;4;11;0;1373;1373;4;9;4;20;27;0;13;336;14;7;0
/org.eclipse.ui.editors/src/org/eclipse/ui/internal/texteditor/TextChangeHover.java;2;2;3;1;3;2;3;0;18;0;0;286;24;24;2;0;1;0;3;286;1;336;2;2;0
/org.eclipse.jdt.launching/launching/org/eclipse/jdt/launching/AbstractVMRunner.java;4;0;7;1;1;1;1;6;33;2;5;89;97;97;2;1;0;6;7;170;1;336;6;4;0
/org.eclipse.team.cvs.ui/src/org/eclipse/team/internal/ccvs/ui/operations/CVSOperation.java;2;1;28;2;5;5;5;23;471;7;9;20;1091;1091;7;14;0;23;28;52;14;336;14;2;2
/org.eclipse.ui.intro/src/org/eclipse/ui/internal/intro/impl/model/IntroAnchor.java;1;0;1;1;1;1;1;0;0;0;0;304;0;0;1;0;0;0;1;304;0;304;1;1;0
/org.eclipse.ui.workbench.texteditor/src/org/eclipse/ui/contentassist/ContentAssistMessages.java;1;0;1;1;1;1;1;0;0;0;0;294;0;0;1;0;0;0;1;294;0;294;1;1;0
/org.eclipse.pde.ui/src/org/eclipse/pde/internal/ui/wizards/feature/FeatureData.java;2;0;4;2;3;1;3;1;68;0;1;213;68;68;3;0;2;1;4;325;2;325;2;2;0
/org.eclipse.jdt.ui/ui/org/eclipse/jdt/internal/ui/wizards/NewPackageCreationWizard.java;2;1;5;1;2;2;2;3;13;2;2;225;35;35;2;1;0;3;5;225;1;336;4;2;0
/org.eclipse.swt/Eclipse SWT/gtk/org/eclipse/swt/widgets/DirectoryDialog.java;4;1;9;1;2;2;2;7;31;3;5;58;92;92;3;2;0;7;9;156;2;337;7;4;2
/org.eclipse.ui/src/org/eclipse/ui/internal/UIPlugin.java;4;5;13;2;7;3;7;6;80;2;4;157;148;148;5;2;4;6;13;286;6;336;7;4;0
/org.eclipse.swt/Eclipse SWT PI/gtk/org/eclipse/swt/internal/gtk/GtkColorSelectionDialog.java;3;0;3;1;1;1;1;2;17;1;2;100;27;27;1;0;0;2;3;100;0;337;3;3;0
/org.eclipse.ui.intro/src/org/eclipse/ui/internal/intro/impl/model/AbstractBaseIntroElement.java;1;5;10;1;10;3;10;0;96;0;0;276;123;123;5;0;7;0;10;276;7;314;3;1;0
/org.eclipse.team.cvs.core/src/org/eclipse/team/internal/ccvs/core/client/listeners/IMessagePatterns.java;2;1;4;1;2;2;2;2;36;0;1;145;40;40;2;1;0;2;4;145;1;336;3;2;0
/org.eclipse.swt/Eclipse SWT Browser/common/org/eclipse/swt/browser/StatusTextEvent.java;2;0;5;1;1;1;1;4;15;2;3;100;35;35;2;1;0;4;5;100;1;337;4;2;0
/org.eclipse.jdt.core/dom/org/eclipse/jdt/core/dom/Message.java;1;0;1;1;0;0;0;1;2;0;1;199;2;2;1;0;0;1;1;199;0;199;1;1;0
/org.eclipse.swt/Eclipse SWT/gtk/org/eclipse/swt/widgets/Group.java;7;1;16;2;2;2;2;14;31;3;10;8;148;148;3;4;0;14;16;76;4;337;12;7;1
/org.eclipse.jdt.debug.ui/ui/org/eclipse/jdt/internal/debug/ui/actions/AddAdvancedAction.java;1;0;1;1;0;0;0;1;20;0;1;154;20;20;1;0;0;1;1;154;0;154;1;1;0
/org.eclipse.pde.ui/src/org/eclipse/pde/internal/ui/parts/EditableTablePart.java;2;1;4;1;2;2;2;2;62;1;2;64;75;75;1;0;0;2;4;64;0;336;4;2;0
/org.eclipse.swt/Eclipse SWT/carbon/org/eclipse/swt/internal/Converter.java;1;0;1;1;0;0;0;1;2;0;1;0;2;2;1;0;0;1;1;0;0;0;1;1;0
/org.eclipse.team.cvs.core/src/org/eclipse/team/internal/ccvs/core/CVSSyncTreeSubscriber.java;2;0;18;2;1;1;1;17;714;4;6;37;1158;1158;4;11;0;17;18;52;11;336;7;2;0
/org.eclipse.jface.text/projection/org/eclipse/jface/text/source/projection/ProjectionSummary.java;2;0;9;2;3;1;8;1;129;0;1;269;216;216;6;0;7;6;9;269;7;331;2;2;0
/org.eclipse.team.ui/src/org/eclipse/team/internal/ui/synchronize/actions/OpenInCompareAction.java;2;2;15;1;5;4;5;10;203;4;4;148;446;446;4;6;1;10;15;244;7;329;8;2;0
/org.eclipse.compare/compare/org/eclipse/compare/internal/ViewerDescriptor.java;1;0;1;1;0;0;0;1;1;0;1;79;1;1;1;0;0;1;1;79;0;79;1;1;0
/org.eclipse.osgi/osgi/src/org/eclipse/osgi/service/resolver/Resolver.java;4;1;5;1;2;2;2;3;14;2;2;171;35;35;2;1;0;3;5;171;1;336;4;4;0
/org.eclipse.swt/Eclipse SWT PI/gtk/org/eclipse/swt/internal/accessibility/gtk/AtkActionIface.java;4;0;4;1;1;1;1;3;13;1;3;75;27;27;1;0;0;3;4;75;0;337;4;4;0
/org.eclipse.update.core/src/org/eclipse/update/operations/IRevertConfigurationOperation.java;1;0;6;1;1;1;1;5;13;2;4;54;22;22;2;1;0;5;6;267;1;292;5;1;0
/org.eclipse.jdt.debug.ui/ui/org/eclipse/jdt/internal/debug/ui/actions/EditStepFiltersAction.java;1;0;1;1;0;0;0;1;0;0;1;202;0;0;1;0;0;1;1;202;0;202;1;1;0
/org.eclipse.pde.ui/src_Forms/org/eclipse/pde/internal/ui/model/plugin/PluginDocumentHandler.java;2;4;14;2;8;3;8;6;260;3;2;244;582;582;4;4;5;6;14;277;9;336;5;2;0
/org.eclipse.text/src/org/eclipse/jface/text/templates/TemplateTranslator.java;2;2;8;2;3;2;5;3;44;3;2;234;70;70;3;1;3;5;8;267;4;334;4;2;0
/org.eclipse.jdt.core/model/org/eclipse/jdt/core/Signature.java;3;0;10;3;1;1;2;8;2152;5;5;8;2195;2195;5;3;1;9;10;264;4;312;6;3;5
/org.eclipse.ui.externaltools/Program Tools Support/org/eclipse/ui/externaltools/internal/program/launchConfigurations/BackgroundResourceRefresher.java;3;0;8;1;0;0;0;8;34;2;7;23;89;89;2;1;0;8;8;49;1;200;7;3;0
/org.eclipse.swt/Eclipse SWT/photon/org/eclipse/swt/widgets/ToolBar.java;4;1;5;2;2;2;2;3;21;2;2;3;32;32;2;1;0;3;5;3;1;337;4;4;0
/org.eclipse.jdt.core/model/org/eclipse/jdt/internal/core/JavaModelInfo.java;3;0;4;1;1;1;1;3;20;1;3;5;29;29;1;0;0;3;4;5;0;314;4;3;0
/org.eclipse.ltk.core.refactoring/src/org/eclipse/ltk/internal/core/refactoring/RefactoringCorePreferences.java;1;1;2;1;2;2;2;0;2;0;0;279;2;2;1;0;0;0;2;279;0;336;2;1;0
/org.eclipse.pde.core/src/org/eclipse/pde/core/plugin/IPluginExtension.java;3;3;6;2;5;3;5;1;49;0;1;232;59;59;3;0;2;1;6;275;2;336;4;3;0
/org.eclipse.core.runtime.compatibility/src-model/org/eclipse/core/runtime/model/ConfigurationElementModel.java;3;1;5;1;3;3;3;2;26;1;2;171;35;35;1;0;0;2;5;171;0;336;5;3;0
/org.eclipse.jdt.ui/ui refactoring/org/eclipse/jdt/internal/ui/refactoring/PushDownWizard.java;3;0;8;2;1;1;2;6;530;2;5;36;590;590;2;1;1;7;8;65;2;336;6;3;0
/org.eclipse.ui.workbench/Eclipse UI/org/eclipse/ui/IFolderLayout.java;2;1;3;1;2;2;2;1;10;0;1;212;22;22;1;0;0;1;3;212;0;336;3;2;0
/org.eclipse.jdt.ui/ui/org/eclipse/jdt/internal/ui/wizards/buildpaths/FolderSelectionDialog.java;2;0;3;2;1;1;1;2;5;0;1;75;7;7;2;1;0;2;3;75;1;336;2;2;0
/org.eclipse.core.runtime/src/org/eclipse/core/internal/registry/ReadWriteMonitor.java;1;0;1;1;1;1;1;0;0;0;0;301;0;0;1;0;0;0;1;301;0;301;1;1;0
/org.eclipse.ui.workbench/Eclipse UI/org/eclipse/ui/internal/PerspectiveBarNewContributionItem.java;3;0;6;2;1;1;1;5;73;2;4;211;125;125;2;1;0;5;6;258;1;336;5;3;0
/org.eclipse.swt/Eclipse SWT Drag and Drop/carbon/org/eclipse/swt/dnd/TextTransfer.java;1;0;5;1;0;0;0;5;220;0;1;15;220;220;5;4;0;5;5;15;4;15;1;1;0
/org.eclipse.jdt.ui/ui/org/eclipse/jdt/internal/ui/dialogs/SourceActionDialog.java;3;2;16;2;5;3;5;11;593;4;6;35;1298;1298;4;5;2;11;16;49;7;321;9;3;3
/org.eclipse.swt/Eclipse SWT PI/win32/org/eclipse/swt/internal/win32/KEYBDINPUT.java;2;0;2;1;1;1;1;1;4;0;1;253;4;4;1;0;0;1;2;253;0;337;2;2;0
/org.eclipse.debug.ui/ui/org/eclipse/debug/internal/ui/Pair.java;2;0;2;1;1;1;1;1;4;0;1;211;4;4;1;0;0;1;2;211;0;336;2;2;0
/org.eclipse.swt/Eclipse SWT/common/org/eclipse/swt/events/TraverseEvent.java;2;0;4;1;1;1;1;3;34;1;3;0;45;45;1;0;0;3;4;0;0;337;4;2;0
/org.eclipse.osgi/eclipseAdaptor/src/org/eclipse/core/runtime/adaptor/Locker_JavaNio.java;3;2;6;3;3;2;4;2;18;0;1;264;27;27;3;1;2;3;6;264;3;326;3;3;0
/org.eclipse.team.cvs.ui/src/org/eclipse/team/internal/ccvs/ui/CVSDecoratorConfiguration.java;1;0;2;1;0;0;0;2;8;1;2;20;9;9;1;0;0;2;2;20;0;151;2;1;0
/org.eclipse.pde.ui/src/org/eclipse/pde/internal/ui/wizards/BaseWizardSelectionPage.java;3;2;4;1;4;3;4;0;74;0;0;289;92;92;2;0;1;0;4;289;1;336;3;3;0
/org.eclipse.debug.ui/ui/org/eclipse/debug/internal/ui/views/console/BreakPartition.java;1;0;1;1;0;0;0;1;2;0;1;122;2;2;1;0;0;1;1;122;0;122;1;1;1
/org.eclipse.jdt.debug.ui/ui/org/eclipse/jdt/internal/debug/ui/monitors/MonitorAction.java;2;0;2;1;0;0;0;2;12;1;2;15;14;14;1;0;0;2;2;15;0;246;2;2;0
/org.eclipse.jdt.debug.ui/ui/org/eclipse/jdt/debug/ui/launchConfigurations/JavaClasspathTab.java;3;2;17;2;3;2;3;14;310;4;8;9;750;750;4;6;1;14;17;178;7;309;10;3;0
/org.eclipse.swt/Eclipse SWT/emulated/treetable/org/eclipse/swt/widgets/TableItem.java;4;1;14;2;3;3;3;11;155;4;7;19;451;451;4;4;0;11;14;214;4;337;10;4;1
/org.eclipse.help.webapp/src_servlets/org/eclipse/help/internal/webapp/data/View.java;1;1;4;1;4;4;4;0;28;0;0;272;48;48;1;0;0;0;4;272;0;336;4;1;1
/org.eclipse.ui.workbench/Eclipse UI/org/eclipse/ui/internal/ShowInMenu.java;1;0;1;1;0;0;0;1;3;0;1;157;3;3;1;0;0;1;1;157;0;157;1;1;0
/org.eclipse.pde.ui/src/org/eclipse/pde/internal/ui/editor/XMLConfiguration.java;2;0;3;1;1;1;1;2;24;1;2;59;45;45;1;0;0;2;3;59;0;336;3;2;0
/org.eclipse.compare/compare/org/eclipse/compare/internal/StreamMergerDescriptor.java;1;0;2;1;2;1;2;0;8;0;0;278;8;8;2;0;1;0;2;278;1;278;1;1;0
/org.eclipse.ant.ui/Ant Tools Support/org/eclipse/ant/internal/ui/launchConfigurations/RemoteAntRuntimeProcess.java;2;0;2;2;0;0;0;2;15;0;1;112;15;15;2;1;0;2;2;112;1;112;1;2;1
/org.eclipse.debug.ui/ui/org/eclipse/debug/internal/ui/views/memory/IMemoryViewTab.java;1;0;1;1;1;1;1;0;0;0;0;282;0;0;1;0;0;0;1;282;0;282;1;1;0
/org.eclipse.text/src/org/eclipse/jface/text/source/AnnotationModelEvent.java;1;1;3;1;2;2;2;1;254;0;1;131;275;275;1;0;0;1;3;131;0;334;3;1;0
/org.eclipse.jdt.debug.ui/ui/org/eclipse/jdt/internal/debug/core/refactoring/LaunchConfigurationProjectMainTypeChange.java;1;2;4;1;4;3;4;0;45;0;0;295;60;60;2;0;1;0;4;295;1;320;3;1;1
/org.eclipse.ui.ide/src/org/eclipse/ui/internal/ide/actions/BuildSetAction.java;2;0;2;2;0;0;0;2;3;0;1;254;3;3;2;1;0;2;2;254;1;254;1;2;1
/org.eclipse.jdt.ui/ui/org/eclipse/jdt/internal/ui/search/JavaSearchContentProvider.java;2;1;4;1;2;2;2;2;24;0;1;207;30;30;2;1;0;2;4;207;1;336;3;2;0
/org.eclipse.pde.build/src/org/eclipse/pde/internal/build/builder/FeatureBuildScriptGenerator.java;2;9;29;2;16;3;16;13;813;3;7;31;1048;1048;9;6;13;13;29;294;19;331;10;2;0
/org.eclipse.team.core/src/org/eclipse/team/core/variants/PersistantResourceVariantByteStore.java;1;1;3;1;2;2;2;1;26;0;1;239;39;39;1;0;0;1;3;239;0;325;3;1;0
/org.eclipse.ui.workbench/Eclipse UI/org/eclipse/ui/internal/IWorkbenchConstants.java;11;3;33;3;11;4;11;22;26;5;10;26;135;135;5;12;7;22;33;203;19;326;14;11;0
/org.eclipse.ui.workbench/Eclipse UI/org/eclipse/ui/IViewReference.java;2;1;3;1;2;2;2;1;17;0;1;212;21;21;1;0;0;1;3;212;0;336;3;2;0
/org.eclipse.osgi/resolver/src/org/eclipse/osgi/internal/resolver/BundleInstaller.java;2;0;2;1;1;1;1;1;4;0;1;233;8;8;1;0;0;1;2;233;0;276;2;2;0
/org.eclipse.jdt.junit/src/org/eclipse/jdt/internal/junit/ui/CompareResultDialog.java;3;1;8;1;3;3;3;5;32;4;2;193;78;78;4;3;0;5;8;193;3;336;5;3;0
/org.eclipse.ui.editors/src/org/eclipse/ui/texteditor/MarkerRulerInfoAction.java;2;0;3;1;1;1;1;2;31;1;2;118;35;35;1;0;0;2;3;118;0;336;3;2;0
/org.eclipse.pde/src/org/eclipse/pde/internal/PDE.java;1;1;3;1;2;2;2;1;18;0;1;232;26;26;1;0;0;1;3;232;0;336;3;1;0
/org.eclipse.jdt.core/model/org/eclipse/jdt/internal/core/ImportDeclaration.java;2;2;12;1;3;2;3;9;14;1;9;7;75;75;2;0;1;9;12;299;1;299;11;2;0
/org.eclipse.jdt.debug.ui/ui/org/eclipse/jdt/internal/debug/ui/launcher/AppletWorkingDirectoryBlock.java;1;0;1;1;1;1;1;0;6;0;0;331;6;6;1;0;0;0;1;331;0;331;1;1;0
/org.eclipse.ui.workbench/Eclipse UI/org/eclipse/ui/activities/IdentifierEvent.java;3;1;5;1;2;2;2;3;50;2;2;170;71;71;2;1;0;3;5;170;1;336;4;3;0
/org.eclipse.ui.intro/src/org/eclipse/ui/internal/intro/impl/util/ImageUtil.java;1;4;5;1;5;2;5;0;50;0;0;276;59;59;4;0;3;0;5;276;3;307;2;1;0
/org.eclipse.jface/src/org/eclipse/jface/wizard/IWizardContainer2.java;1;0;1;1;1;1;1;0;0;0;0;274;0;0;1;0;0;0;1;274;0;274;1;1;0
/org.eclipse.jdt.ui/ui/org/eclipse/jdt/internal/ui/callhierarchy/HistoryAction.java;3;1;5;1;2;2;2;3;26;0;1;12;32;32;3;2;0;3;5;12;2;336;3;3;0
/org.eclipse.jdt.junit/src/org/eclipse/jdt/internal/junit/ui/OpenEditorAction.java;3;1;6;1;3;3;3;3;21;2;2;30;46;46;2;1;0;3;6;30;1;336;5;3;0
/org.eclipse.core.variables/src/org/eclipse/core/internal/variables/DynamicVariable.java;4;2;4;2;3;2;3;1;17;0;1;145;21;21;2;0;1;1;4;294;1;336;3;4;0
/org.eclipse.pde.build/src/org/eclipse/pde/internal/build/packager/PackagerBuildScriptGenerator.java;2;4;18;2;8;4;8;10;40;2;7;31;112;112;4;3;4;10;18;303;7;332;11;2;0
/org.eclipse.ui.cheatsheets/src/org/eclipse/ui/internal/cheatsheets/actions/OpenPerspective.java;1;1;2;1;2;2;2;0;19;0;0;292;19;19;1;0;0;0;2;292;0;306;2;1;0
/org.eclipse.ant.ui/Ant Editor/org/eclipse/ant/internal/ui/dtd/ISchema.java;1;0;1;1;0;0;0;1;0;0;1;108;0;0;1;0;0;1;1;108;0;108;1;1;0
/org.eclipse.ui.workbench/Eclipse UI/org/eclipse/ui/internal/MultiEditorOuterPane.java;2;1;2;1;2;2;2;0;2;0;0;297;4;4;1;0;0;0;2;297;0;336;2;2;0
/org.eclipse.jdt.ui/ui refactoring/org/eclipse/jdt/internal/ui/refactoring/reorg/ReorgMoveAction.java;4;1;12;1;2;2;3;9;69;3;6;70;144;144;3;3;1;10;12;94;4;336;8;4;0
/org.eclipse.ui.workbench/Eclipse UI/org/eclipse/ui/presentations/IStackPresentationSite.java;4;3;9;3;5;3;5;4;75;3;2;245;163;163;3;2;2;4;9;245;4;336;5;4;0
/org.eclipse.ui.ide/src/org/eclipse/ui/wizards/datatransfer/MinimizedFileSystemElement.java;2;0;3;2;0;0;0;3;23;0;1;92;23;23;3;2;0;3;3;92;2;92;1;2;0
/org.eclipse.core.resources/src/org/eclipse/core/internal/dtree/DataTreeReader.java;1;0;1;1;1;1;1;0;200;0;0;277;200;200;1;0;0;0;1;277;0;277;1;1;0
/org.eclipse.team.cvs.ui/src/org/eclipse/team/internal/ccvs/ui/CVSDecoratorPreferencesPage.java;2;0;2;1;0;0;0;2;30;1;2;20;33;33;1;0;0;2;2;20;0;151;2;2;3
/org.eclipse.core.resources/src/org/eclipse/core/internal/resources/MarkerManager.java;2;2;6;1;3;2;3;3;979;2;2;104;1228;1228;2;1;1;3;6;145;2;329;4;2;0
/org.eclipse.jdt.core/model/org/eclipse/jdt/internal/core/ImportDeclarationElementInfo.java;3;0;3;1;1;1;1;2;2;1;2;7;4;4;1;0;0;2;3;7;0;314;3;3;1
/org.eclipse.jdt.core/model/org/eclipse/jdt/internal/core/InitializerElementInfo.java;1;0;3;1;0;0;0;3;2;1;3;108;5;5;1;0;0;3;3;108;0;199;3;1;0
/org.eclipse.jdt.core/model/org/eclipse/jdt/internal/compiler/SourceElementRequestorAdapter.java;1;0;2;1;1;1;1;1;51;0;1;245;51;51;1;0;0;1;2;245;0;326;2;1;0
/org.eclipse.ui.workbench.texteditor/src/org/eclipse/ui/texteditor/BasicTextEditorActionContributor.java;3;2;8;2;4;3;4;4;53;1;4;41;124;124;2;0;1;4;8;275;1;336;7;3;0
/org.eclipse.osgi/resolver/src/org/eclipse/core/internal/dependencies/Element.java;3;2;4;2;3;2;3;1;30;0;1;171;51;51;2;0;1;1;4;276;1;296;3;3;0
/org.eclipse.ui.ide/src/org/eclipse/ui/views/navigator/LocalSelectionTransfer.java;4;1;3;2;2;2;2;1;27;0;1;129;32;32;1;0;0;1;3;129;0;336;3;4;0
/org.eclipse.jface.text/src/org/eclipse/jface/contentassist/IContentAssistSubjectControl.java;1;1;2;1;2;2;2;0;129;0;0;280;131;131;1;0;0;0;2;280;0;336;2;1;0
/org.eclipse.jdt.debug.ui/ui/org/eclipse/jdt/internal/debug/ui/snippeteditor/SnippetAction.java;1;1;2;1;2;2;2;0;57;0;0;274;62;62;1;0;0;0;2;274;0;296;2;1;0
/org.eclipse.ui.ide/src/org/eclipse/ui/views/navigator/GotoActionGroup.java;1;0;1;1;0;0;0;1;0;0;1;129;0;0;1;0;0;1;1;129;0;129;1;1;0
/org.eclipse.team.cvs.ui/src/org/eclipse/team/internal/ccvs/ui/operations/CheckoutSingleProjectOperation.java;2;0;6;1;1;1;1;5;71;1;5;20;123;123;1;0;0;5;6;20;0;336;6;2;0
/org.eclipse.ui.workbench/Eclipse UI/org/eclipse/ui/intro/IIntroPart.java;1;2;8;1;3;2;3;5;105;2;4;198;247;247;2;1;1;5;8;198;2;296;6;1;0
/org.eclipse.ui.workbench/Eclipse UI/org/eclipse/ui/internal/AbstractPartSelectionTracker.java;2;1;3;1;2;2;2;1;12;0;1;68;20;20;1;0;0;1;3;68;0;336;3;2;0
/org.eclipse.swt/Eclipse SWT PI/win32/org/eclipse/swt/internal/ole/win32/TYPEATTR.java;1;0;1;1;0;0;0;1;13;0;1;166;13;13;1;0;0;1;1;166;0;166;1;1;0
/org.eclipse.pde.ui/src/org/eclipse/pde/internal/ui/editor/build/BuildUndoManager.java;1;1;2;1;2;2;2;0;4;0;0;292;4;4;1;0;0;0;2;292;0;336;2;1;0
/org.eclipse.jdt.debug.ui/ui/org/eclipse/jdt/internal/debug/ui/JDIDebugUIPlugin.java;6;7;21;4;9;3;9;12;109;2;11;22;188;188;7;1;6;12;21;273;7;336;14;6;2
/org.eclipse.debug.core/core/org/eclipse/debug/core/sourcelookup/containers/ZipEntryStorage.java;2;0;2;1;1;1;1;1;5;0;1;268;5;5;1;0;0;1;2;268;0;303;2;2;0
/org.eclipse.help.ui/src/org/eclipse/help/ui/internal/browser/embedded/EmbeddedBrowserAdapter.java;2;0;7;1;2;1;2;5;578;2;4;165;672;672;2;1;1;5;7;245;2;293;5;2;0
/org.eclipse.debug.ui/ui/org/eclipse/debug/internal/ui/sourcelookup/AddContainerAction.java;2;0;6;2;0;0;0;6;34;4;3;209;55;55;4;3;0;6;6;260;3;260;3;2;0
/org.eclipse.text/src/org/eclipse/text/edits/RangeMarker.java;2;0;4;1;1;1;1;3;23;2;2;118;39;39;2;1;0;3;4;118;1;336;3;2;0
/org.eclipse.jdt.junit/src/org/eclipse/jdt/internal/junit/launcher/ContainerComparator.java;1;0;1;1;1;1;1;0;2;0;0;336;2;2;1;0;0;0;1;336;0;336;1;1;0
/org.eclipse.ant.ui/Ant Tools Support/org/eclipse/ant/internal/ui/preferences/AntClasspathContentProvider.java;2;0;12;2;1;1;1;11;218;4;6;108;290;290;4;5;0;11;12;147;5;336;7;2;0
/org.eclipse.pde.runtime/src/org/eclipse/pde/internal/runtime/logview/EventDetailsDialog.java;2;3;16;2;4;2;5;11;108;6;3;203;311;311;6;8;3;12;16;252;11;336;5;2;1
/org.eclipse.pde.ui/src/org/eclipse/pde/internal/ui/editor/plugin/RequiresSection.java;3;4;8;2;8;3;8;0;53;0;0;292;72;72;4;0;5;0;8;302;5;331;3;3;0
/org.eclipse.jdt.core/model/org/eclipse/jdt/core/CompletionRequestor.java;1;0;1;1;0;0;0;1;0;0;1;264;0;0;1;0;0;1;1;264;0;264;1;1;1
/org.eclipse.jdt.ui/core refactoring/org/eclipse/jdt/internal/corext/refactoring/structure/MovedMemberAnalyzer.java;4;3;10;2;5;3;5;5;94;2;4;93;175;175;3;1;2;5;10;292;3;336;7;4;0
/org.eclipse.team.cvs.core/src/org/eclipse/team/internal/ccvs/core/client/RemoteCommand.java;1;0;2;1;0;0;0;2;23;1;2;110;26;26;1;0;0;2;2;110;0;146;2;1;0
/org.eclipse.pde.core/src/org/eclipse/pde/core/plugin/IPlugin.java;3;2;6;1;4;3;4;2;26;1;2;232;36;36;2;0;1;2;6;276;1;336;5;3;0
/org.eclipse.jdt.launching/launching/org/eclipse/jdt/launching/VMStandin.java;2;0;2;1;0;0;0;2;5;1;2;170;7;7;1;0;0;2;2;170;0;246;2;2;1
/org.eclipse.jface/src/org/eclipse/jface/viewers/ListViewer.java;3;1;3;1;2;2;2;1;362;0;1;150;367;367;1;0;0;1;3;150;0;336;3;3;1
/org.eclipse.ant.ui/Ant Editor/org/eclipse/ant/internal/ui/editor/text/AntEditorWhitespaceDetector.java;1;0;1;1;0;0;0;1;0;0;1;108;0;0;1;0;0;1;1;108;0;108;1;1;0
/org.eclipse.jdt.ui/ui/org/eclipse/jdt/internal/ui/text/correction/CorrectionMarkerResolutionGenerator.java;3;1;13;1;2;2;2;11;46;4;7;65;96;96;4;4;0;11;13;65;4;336;9;3;0
/org.eclipse.pde.ui/src/org/eclipse/pde/internal/ui/editor/feature/PluginReference.java;1;0;2;1;1;1;1;1;4;0;1;232;6;6;1;0;0;1;2;232;0;336;2;1;0
/org.eclipse.jdt.core/model/org/eclipse/jdt/core/jdom/IDOMType.java;2;0;4;1;1;1;1;3;80;1;3;199;88;88;1;0;0;3;4;199;0;299;4;2;0
/org.eclipse.pde.ui/src/org/eclipse/pde/ui/templates/IVariableProvider.java;2;1;3;1;3;3;3;0;16;0;0;276;34;34;1;0;0;0;3;276;0;336;3;2;0
/org.eclipse.pde.ui/src/org/eclipse/pde/internal/ui/wizards/plugin/FragmentFieldData.java;2;1;3;1;2;2;2;1;10;0;1;222;14;14;1;0;0;1;3;222;0;336;3;2;0
/org.eclipse.debug.ui/ui/org/eclipse/debug/ui/sourcelookup/SourceLookupTab.java;2;1;5;1;3;3;3;2;8;0;1;268;22;22;2;1;0;2;5;268;1;313;4;2;0
/org.eclipse.debug.ui/ui/org/eclipse/debug/internal/ui/launchConfigurations/OrganizeFavoritesAction.java;1;0;1;1;0;0;0;1;0;0;1;134;0;0;1;0;0;1;1;134;0;134;1;1;0
/org.eclipse.osgi/resolver/src/org/eclipse/osgi/internal/resolver/ResolverHelper.java;4;0;9;3;4;1;4;5;172;2;4;171;262;262;4;1;3;5;9;276;4;276;5;4;0
/org.eclipse.jface.text/src/org/eclipse/jface/text/IInformationControlCreator.java;2;0;2;2;2;1;2;0;17;0;0;336;17;17;2;0;1;0;2;336;1;336;1;2;0
/org.eclipse.team.cvs.core/src/org/eclipse/team/internal/ccvs/core/client/DiffStructureVisitor.java;1;0;2;1;0;0;0;2;25;1;2;56;30;30;1;0;0;2;2;56;0;110;2;1;0
/org.eclipse.jdt.ui/ui/org/eclipse/jdt/internal/ui/text/correction/NewVariableCompletionProposal.java;3;2;28;2;5;3;5;23;343;7;11;22;787;787;7;12;2;23;28;66;14;336;14;3;0
/org.eclipse.debug.core/core/org/eclipse/debug/internal/core/memory/IDynamicRenderingFactory.java;1;0;1;1;1;1;1;0;0;0;0;282;0;0;1;0;0;0;1;282;0;282;1;1;0
/org.eclipse.jdt.debug.ui/ui/org/eclipse/jdt/internal/debug/ui/actions/RetargettableActionAdapterFactory.java;1;0;3;1;0;0;0;3;39;0;1;243;39;39;3;2;0;3;3;243;2;243;1;1;0
/org.eclipse.jdt.ui/ui/org/eclipse/jdt/ui/text/IColorManager.java;1;0;2;1;2;1;2;0;20;0;0;335;20;20;2;0;1;0;2;335;1;335;1;1;0
/org.eclipse.debug.core/core/org/eclipse/debug/core/sourcelookup/ISourceContainerType.java;1;0;2;1;0;0;1;1;13;0;1;268;13;13;2;0;1;2;2;268;1;268;1;1;0
/org.eclipse.swt/Eclipse SWT PI/gtk/org/eclipse/swt/internal/gtk/LONG.java;2;0;3;1;1;1;1;2;2;0;1;230;4;4;2;1;0;2;3;230;1;337;2;2;0
/org.eclipse.swt/Eclipse SWT/gtk/org/eclipse/swt/graphics/TextLayout.java;4;6;20;3;11;3;13;7;901;5;2;250;1268;1268;6;5;10;9;20;296;15;334;5;4;1
/org.eclipse.ltk.core.refactoring/src/org/eclipse/ltk/internal/core/refactoring/SaveListener.java;1;0;1;1;1;1;1;0;0;0;0;278;0;0;1;0;0;0;1;278;0;278;1;1;0
/org.eclipse.jdt.ui/core refactoring/org/eclipse/jdt/internal/corext/refactoring/structure/MoveInstanceMethodRefactoring.java;4;1;14;1;3;3;3;11;35;2;9;9;102;102;2;2;0;11;14;70;2;336;12;4;1
/org.eclipse.jdt.core/dom/org/eclipse/jdt/core/dom/AST.java;6;7;46;5;12;2;12;34;2049;10;8;5;6231;6231;10;26;10;34;46;199;36;308;10;6;5
/org.eclipse.pde.build/src/org/eclipse/pde/internal/build/builder/AbstractBuildScriptGenerator.java;2;3;10;2;4;2;4;6;62;2;4;31;79;79;3;2;2;6;10;272;4;294;6;2;0
/org.eclipse.ui.workbench/Eclipse UI/org/eclipse/ui/internal/dialogs/PerspContentProvider.java;4;1;9;2;2;2;2;7;221;4;4;123;347;347;4;3;0;7;9;160;3;336;6;4;0
/org.eclipse.ui.presentations.r21/src/org/eclipse/ui/internal/presentations/r21/R21Colors.java;1;1;2;1;2;2;2;0;2;0;0;323;2;2;1;0;0;0;2;323;0;336;2;1;0
/org.eclipse.ui.workbench/Eclipse UI/org/eclipse/ui/internal/CloseAllSavedAction.java;1;0;1;1;0;0;0;1;115;0;1;157;115;115;1;0;0;1;1;157;0;157;1;1;0
/org.eclipse.pde.core/src/org/eclipse/pde/internal/core/plugin/AbstractExtensions.java;3;1;7;2;3;3;3;4;27;2;3;128;68;68;2;1;0;4;7;128;1;336;6;3;0
/org.eclipse.pde.ui/src/org/eclipse/pde/internal/ui/preferences/TargetPlatformPreferenceNode.java;2;1;3;1;2;2;2;1;4;0;1;222;8;8;1;0;0;1;3;222;0;336;3;2;0
/org.eclipse.jdt.debug.ui/ui/org/eclipse/jdt/internal/debug/ui/actions/AttachSourceAction.java;3;0;7;2;2;1;2;5;83;1;5;76;174;174;2;0;1;5;7;292;1;292;6;3;0
/org.eclipse.jdt.core/search/org/eclipse/jdt/internal/core/search/matching/VariableLocator.java;2;0;4;2;1;1;1;3;103;2;2;145;107;107;2;1;0;3;4;145;1;280;3;2;0
/org.eclipse.jdt.core/compiler/org/eclipse/jdt/internal/compiler/problem/DefaultProblem.java;4;0;8;2;2;1;2;6;99;2;5;63;170;170;2;1;1;6;8;135;2;296;6;4;0
/org.eclipse.osgi/eclipseAdaptor/src/org/eclipse/core/runtime/adaptor/EclipseStarter.java;5;0;52;5;3;1;20;32;1733;37;3;171;2327;2327;37;29;19;49;52;207;48;324;4;5;3
/org.eclipse.jdt.core/model/org/eclipse/jdt/core/JavaCore.java;6;1;92;5;2;2;21;71;1289;21;11;1;4387;4387;21;60;19;90;92;266;79;323;13;6;1
/org.eclipse.swt/Eclipse SWT Printing/motif/org/eclipse/swt/printing/Printer.java;4;2;8;2;4;3;4;4;17;1;4;0;46;46;2;0;1;4;8;300;1;337;7;4;0
/org.eclipse.swt/Eclipse SWT/emulated/tabfolder/org/eclipse/swt/widgets/TabFolder.java;3;1;6;2;2;2;2;4;20;2;3;19;36;36;2;1;0;4;6;175;1;337;5;3;0
/org.eclipse.swt/Eclipse SWT/gtk/org/eclipse/swt/graphics/Region.java;4;1;5;2;2;2;2;3;87;1;3;100;232;232;1;0;0;3;5;100;0;337;5;4;1
/org.eclipse.core.resources/src/org/eclipse/core/resources/IResourceChangeListener.java;1;0;2;1;0;0;1;1;46;0;1;270;46;46;2;0;1;2;2;270;1;270;1;1;0
/org.eclipse.jdt.debug.ui/ui/org/eclipse/jdt/internal/debug/ui/actions/ExecuteAction.java;2;0;2;2;0;0;0;2;20;0;1;105;20;20;2;1;0;2;2;105;1;105;1;2;0
/org.eclipse.jdt.ui/core refactoring/org/eclipse/jdt/internal/corext/refactoring/code/flow/TryFlowInfo.java;1;0;1;1;1;1;1;0;2;0;0;336;2;2;1;0;0;0;1;336;0;336;1;1;0
/org.eclipse.pde.ui/src/org/eclipse/pde/internal/ui/editor/site/CategorySection.java;3;4;9;2;7;4;7;2;576;1;2;134;1017;1017;4;0;3;2;9;303;3;336;6;3;0
/org.eclipse.pde.ui/src/org/eclipse/pde/internal/ui/search/PluginJavaSearchUtil.java;1;1;2;1;2;2;2;0;4;0;0;302;8;8;1;0;0;0;2;302;0;336;2;1;0
/org.eclipse.team.cvs.ui/src/org/eclipse/team/internal/ccvs/ui/repo/CVSRepoViewAction.java;2;1;3;1;2;2;2;1;48;0;1;148;50;50;1;0;0;1;3;148;0;336;3;2;0
/org.eclipse.ui.workbench/Eclipse UI/org/eclipse/ui/internal/keys/KdeKeyFormatter.java;1;0;2;1;0;0;0;2;6;0;1;188;6;6;2;1;0;2;2;188;1;188;1;1;0
/org.eclipse.debug.ui/ui/org/eclipse/debug/internal/ui/sourcelookup/ResolveDuplicatesHandler.java;1;0;2;1;1;1;1;1;6;0;1;252;9;9;1;0;0;1;2;252;0;313;2;1;0
/org.eclipse.jdt.core/dom/org/eclipse/jdt/core/dom/ASTSyntaxErrorPropagator.java;4;0;4;1;1;1;1;3;14;1;3;51;20;20;1;0;0;3;4;51;0;289;4;4;0
/org.eclipse.team.cvs.ui/src/org/eclipse/team/internal/ccvs/ui/wizards/SharingWizard.java;2;3;28;2;8;4;8;20;839;9;9;56;1141;1141;9;11;4;20;28;244;15;336;13;2;0
/org.eclipse.pde.ui/src_samples/org/eclipse/pde/ui/internal/samples/SampleOperation.java;3;2;6;2;4;2;4;2;92;1;2;248;163;163;2;0;2;2;6;303;2;332;4;3;0
/org.eclipse.jface.text/src/org/eclipse/jface/text/contentassist/IContextInformationExtension.java;1;0;2;1;2;1;2;0;9;0;0;336;9;9;2;0;1;0;2;336;1;336;1;1;0
/org.eclipse.ui.workbench/Eclipse UI/org/eclipse/ui/dialogs/ListSelectionDialog.java;2;0;3;1;1;1;1;2;296;1;2;101;305;305;1;0;0;2;3;101;0;293;3;2;0
/org.eclipse.jdt.debug/jdi/org/eclipse/jdi/internal/VirtualMachineManagerImpl.java;3;1;3;1;2;2;2;1;20;0;1;235;25;25;1;0;0;1;3;235;0;323;3;3;0
/org.eclipse.team.cvs.ui/src/org/eclipse/team/internal/ccvs/ui/actions/ReplaceWithTagAction.java;2;0;4;1;1;1;1;3;65;1;3;71;82;82;1;0;0;3;4;71;0;336;4;2;0
/org.eclipse.pde.ui/src/org/eclipse/pde/internal/ui/editor/PDEMasterDetailsBlock.java;2;1;3;1;3;3;3;0;10;0;0;292;20;20;1;0;0;0;3;292;0;336;3;2;0
/org.eclipse.core.resources/src/org/eclipse/core/internal/resources/MarkerReader_1.java;2;0;2;1;1;1;1;1;205;0;1;104;207;207;1;0;0;1;2;104;0;277;2;2;0
/org.eclipse.jdt.ui/ui/org/eclipse/jdt/internal/ui/filters/ClosedProjectFilter.java;1;0;1;1;1;1;1;0;2;0;0;336;2;2;1;0;0;0;1;336;0;336;1;1;0
/org.eclipse.ui.workbench.texteditor/src/org/eclipse/ui/texteditor/templates/EditTemplateDialog.java;3;2;10;3;3;2;8;2;108;6;2;253;165;165;6;0;6;7;10;268;6;336;4;3;0
/org.eclipse.debug.ui/ui/org/eclipse/debug/internal/ui/preferences/LaunchingPreferencePage.java;4;3;6;2;4;2;4;2;31;0;1;264;62;62;3;1;2;2;6;275;3;290;3;4;0
/org.eclipse.ui.intro/src/org/eclipse/ui/internal/intro/impl/parts/ContextHelpStandbyPart.java;1;4;6;1;6;2;6;0;48;0;0;286;72;72;4;0;4;0;6;307;4;307;2;1;0
/org.eclipse.jdt.core/search/org/eclipse/jdt/internal/core/search/matching/OrLocator.java;3;0;9;2;0;0;0;9;153;3;6;118;187;187;3;3;0;9;9;118;3;237;6;3;2
/org.eclipse.jface.text/src/org/eclipse/jface/text/contentassist/IContextInformationValidator.java;1;2;3;1;3;2;3;0;17;0;0;280;19;19;2;0;1;0;3;336;1;336;2;1;0
/org.eclipse.pde.ui/src/org/eclipse/pde/internal/ui/wizards/templates/PDETemplateSection.java;2;1;3;1;2;2;2;1;7;0;1;222;15;15;1;0;0;1;3;222;0;336;3;2;0
/org.eclipse.jdt.debug.ui/ui/org/eclipse/jdt/debug/ui/launchConfigurations/JavaArgumentsTab.java;2;1;6;1;2;2;2;4;40;1;4;71;83;83;1;0;0;4;6;71;0;336;6;2;0
/org.eclipse.ui.workbench/Eclipse UI/org/eclipse/ui/internal/dnd/AbstractDropTarget.java;2;0;2;1;0;0;0;2;35;1;2;209;35;35;1;0;0;2;2;209;0;223;2;2;0
/org.eclipse.debug.ui/ui/org/eclipse/debug/internal/ui/stringsubstitution/StringPrompt.java;2;0;2;1;1;1;1;1;2;0;1;123;2;2;1;0;0;1;2;123;0;336;2;2;0
/org.eclipse.ui.workbench/Eclipse UI/org/eclipse/ui/internal/PluginActionSet.java;2;1;2;1;2;2;2;0;2;0;0;326;3;3;1;0;0;0;2;326;0;336;2;2;0
/org.eclipse.pde.ui/src/org/eclipse/pde/internal/ui/build/ClasspathHelper.java;1;1;2;1;2;2;2;0;10;0;0;312;10;10;1;0;0;0;2;312;0;336;2;1;0
/org.eclipse.help.base/src/org/eclipse/help/internal/browser/BrowserLog.java;1;1;5;1;3;3;3;2;27;0;1;104;47;47;2;1;0;2;5;104;1;336;4;1;0
/org.eclipse.ui.workbench/Eclipse UI/org/eclipse/ui/contexts/ContextException.java;3;1;3;1;2;2;2;1;22;0;1;269;26;26;1;0;0;1;3;269;0;336;3;3;0
/org.eclipse.jdt.ui/ui/org/eclipse/jdt/internal/ui/text/correction/NewDefiningMethodProposal.java;1;2;3;1;3;2;3;0;30;0;0;296;36;36;2;0;1;0;3;296;1;308;2;1;0
/org.eclipse.ui.ide/src/org/eclipse/ui/views/navigator/OpenActionGroup.java;1;0;1;1;0;0;0;1;0;0;1;129;0;0;1;0;0;1;1;129;0;129;1;1;0
/org.eclipse.core.expressions/src/org/eclipse/core/expressions/IVariableResolver.java;1;0;2;1;1;1;1;1;6;0;1;253;6;6;1;0;0;1;2;253;0;279;2;1;0
/org.eclipse.ui.console/src/org/eclipse/ui/internal/console/ConsoleWorkbenchPart.java;1;0;2;1;0;0;0;2;6;0;1;118;6;6;2;1;0;2;2;118;1;118;1;1;0
/org.eclipse.jdt.debug.ui/ui/org/eclipse/jdt/internal/debug/ui/propertypages/ThreadFilterEditor.java;1;0;1;1;0;0;0;1;0;0;1;82;0;0;1;0;0;1;1;82;0;82;1;1;0
/org.eclipse.debug.ui/ui/org/eclipse/debug/ui/RefreshTab.java;4;1;9;1;3;3;3;6;90;1;6;125;164;164;1;0;0;6;9;125;0;336;9;4;1
/org.eclipse.team.cvs.core/src/org/eclipse/team/internal/ccvs/core/resources/SynchronizerSyncInfoCache.java;2;4;13;1;6;3;6;7;100;3;5;52;307;307;4;2;3;7;13;313;5;336;8;2;0
/org.eclipse.jdt.launching.macosx/macosx/org/eclipse/jdt/internal/ui/macbundler/BundleAttributes.java;1;0;1;1;0;0;0;1;0;0;1;203;0;0;1;0;0;1;1;203;0;203;1;1;0
/org.eclipse.osgi/eclipseAdaptor/src/org/eclipse/core/runtime/adaptor/testsupport/TestLocationManager.java;1;0;1;1;1;1;1;0;0;0;0;319;0;0;1;0;0;0;1;319;0;319;1;1;0
/org.eclipse.ant.ui/Ant Tools Support/org/eclipse/ant/internal/ui/views/actions/AntOpenWithMenu.java;2;0;4;1;1;1;1;3;78;1;3;108;119;119;1;0;0;3;4;108;0;299;4;2;2
/org.eclipse.ui.ide/src/org/eclipse/ui/views/tasklist/FiltersDialog.java;1;0;2;1;0;0;0;2;4;0;1;129;4;4;2;1;0;2;2;129;1;129;1;1;0
/org.eclipse.update.scheduler/src/org/eclipse/update/internal/scheduler/SchedulerStartup.java;1;1;3;1;2;2;2;1;78;0;1;258;84;84;1;0;0;1;3;258;0;336;3;1;0
/org.eclipse.ui.ide/extensions/org/eclipse/ui/actions/ReadOnlyStateChecker.java;1;0;1;1;0;0;0;1;0;0;1;132;0;0;1;0;0;1;1;132;0;132;1;1;0
/org.eclipse.debug.ui/ui/org/eclipse/debug/internal/ui/views/memory/MemoryView.java;2;0;5;2;5;1;5;0;37;0;0;282;37;37;5;0;4;0;5;282;4;282;1;2;1
/org.eclipse.jdt.ui/ui/org/eclipse/jdt/internal/ui/util/JavaUIHelp.java;2;1;2;1;2;2;2;0;2;0;0;273;4;4;1;0;0;0;2;273;0;336;2;2;0
/org.eclipse.update.core/src/org/eclipse/update/internal/core/NonPluginEntryContentConsumer.java;2;1;3;1;2;2;2;1;6;0;1;58;14;14;1;0;0;1;3;58;0;336;3;2;0
/org.eclipse.jdt.debug/eval/org/eclipse/jdt/internal/debug/eval/ast/instructions/DivideOperator.java;1;0;1;1;0;0;0;1;5;0;1;76;5;5;1;0;0;1;1;76;0;76;1;1;0
/org.eclipse.jdt.debug.ui/ui/org/eclipse/jdt/internal/debug/ui/actions/BreakpointToggleAction.java;1;0;1;1;0;0;0;1;6;0;1;97;6;6;1;0;0;1;1;97;0;97;1;1;0
/org.eclipse.jdt.ui/ui/org/eclipse/jdt/internal/ui/dnd/JdtViewerDragAdapter.java;1;0;1;1;1;1;1;0;2;0;0;336;2;2;1;0;0;0;1;336;0;336;1;1;0
/org.eclipse.core.resources/src/org/eclipse/core/resources/IWorkspaceDescription.java;1;0;3;1;1;1;2;1;397;0;1;270;416;416;2;0;1;2;3;270;1;326;2;1;0
/org.eclipse.debug.core/core/org/eclipse/debug/core/model/IWatchExpression.java;3;1;10;2;2;2;2;8;92;6;3;73;123;123;6;5;0;8;10;92;5;336;5;3;0
/org.eclipse.jdt.ui/ui/org/eclipse/jdt/internal/ui/text/template/contentassist/MultiVariable.java;2;0;3;1;1;1;1;2;2;0;1;267;4;4;2;1;0;2;3;267;1;336;2;2;0
/org.eclipse.core.resources/src/org/eclipse/core/internal/indexing/Buffer.java;1;0;1;1;1;1;1;0;66;0;0;277;66;66;1;0;0;0;1;277;0;277;1;1;0
/org.eclipse.jdt.ui/ui/org/eclipse/jdt/internal/ui/wizards/buildpaths/NewVariableEntryDialog.java;2;1;6;1;2;2;2;4;29;1;4;32;73;73;1;0;0;4;6;32;0;336;6;2;0
/org.eclipse.jdt.core/model/org/eclipse/jdt/internal/core/jdom/DOMInitializer.java;3;1;5;1;2;2;2;3;10;1;3;7;29;29;1;0;0;3;5;7;0;314;5;3;0
/org.eclipse.jdt.ui/ui/org/eclipse/jdt/internal/ui/browsing/LogicalPackage.java;1;0;1;1;1;1;1;0;2;0;0;336;2;2;1;0;0;0;1;336;0;336;1;1;0
/org.eclipse.ui.workbench/Eclipse UI/org/eclipse/ui/internal/layout/TrimLayoutData.java;1;0;1;1;0;0;0;1;0;0;1;270;0;0;1;0;0;1;1;270;0;270;1;1;0
/org.eclipse.team.ui/src/org/eclipse/team/internal/ui/synchronize/ISynchronizeModelProviderDescriptor.java;2;1;3;1;2;2;2;1;34;0;1;266;36;36;1;0;0;1;3;266;0;336;3;2;0
/org.eclipse.swt/Eclipse SWT/gtk/org/eclipse/swt/widgets/Decorations.java;5;1;10;1;3;3;3;7;188;2;6;8;321;321;2;1;0;7;10;182;1;337;9;5;0
/org.eclipse.ui.workbench/Eclipse UI/org/eclipse/ui/internal/presentations/SystemMenuStateChange.java;2;1;2;2;2;2;2;0;3;0;0;279;3;3;1;0;0;0;2;279;0;296;2;2;0
/org.eclipse.ant.ui/Ant Editor/org/eclipse/ant/internal/ui/editor/outline/FilterInternalTargetsAction.java;2;0;4;2;1;1;1;3;9;2;2;114;15;15;2;1;0;3;4;114;1;336;3;2;1
/org.eclipse.team.cvs.ui/src/org/eclipse/team/internal/ccvs/ui/model/CVSFileElement.java;1;0;1;1;0;0;0;1;2;0;1;63;2;2;1;0;0;1;1;63;0;63;1;1;0
/org.eclipse.jdt.ui/ui/org/eclipse/jdt/internal/ui/packageview/PackageExplorerContentProvider.java;4;1;11;2;3;3;3;8;143;1;8;76;298;298;1;0;0;8;11;76;0;336;11;4;1
/org.eclipse.ui.workbench/Eclipse UI/org/eclipse/ui/internal/dialogs/WorkbenchPreferenceDialog.java;6;0;13;3;1;1;1;12;210;4;7;68;509;509;4;5;0;12;13;166;5;336;8;6;2
/org.eclipse.ui.ide/src/org/eclipse/ui/views/markers/internal/DialogMarkerFilter.java;4;1;5;1;2;2;2;3;10;2;2;129;20;20;2;1;0;3;5;129;1;336;4;4;1
/org.eclipse.ui.ide/extensions/org/eclipse/ui/actions/GlobalBuildAction.java;6;3;12;3;5;3;6;6;590;2;6;132;745;745;3;0;3;7;12;290;3;336;9;6;1
/org.eclipse.team.ui/src/org/eclipse/team/internal/ui/synchronize/SubscriberParticipantPage.java;2;2;8;2;4;3;4;4;368;0;1;251;416;416;4;3;1;4;8;251;4;336;4;2;1
/org.eclipse.ui.workbench/Eclipse UI/org/eclipse/ui/IEditorPart.java;3;1;4;2;3;3;3;1;14;0;1;157;28;28;1;0;0;1;4;157;0;336;4;3;1
/org.eclipse.ant.ui/Ant Editor/org/eclipse/ant/internal/ui/editor/OpenDeclarationAction.java;1;0;2;1;1;1;1;1;2;0;1;214;2;2;1;0;0;1;2;214;0;296;2;1;1
/org.eclipse.jface/src/org/eclipse/jface/action/ToolBarContributionItem.java;6;1;13;3;2;2;2;11;1133;4;4;181;1477;1477;4;7;0;11;13;219;7;336;6;6;0
/org.eclipse.jdt.core/compiler/org/eclipse/jdt/internal/compiler/impl/CompilerOptions.java;4;0;39;4;4;1;4;35;661;7;11;1;2241;2241;7;24;3;35;39;124;27;287;12;4;0
/org.eclipse.jdt.debug.ui/ui/org/eclipse/jdt/internal/debug/ui/snippeteditor/JavaSnippetEditor.java;5;4;28;4;7;3;10;18;1033;12;8;50;1308;1308;12;10;7;21;28;243;17;325;11;5;0
/org.eclipse.jdt.ui/core refactoring/org/eclipse/jdt/internal/corext/refactoring/structure/ImportRewriteManager.java;3;0;3;1;1;1;1;2;2;1;2;116;4;4;1;0;0;2;3;116;0;336;3;3;0
/org.eclipse.jdt.debug.ui/ui/org/eclipse/jdt/internal/debug/ui/BreakpointConditionCompletionProcessor.java;4;0;5;1;1;1;1;4;20;2;3;72;33;33;2;1;0;4;5;235;1;336;4;4;0
/org.eclipse.jdt.ui/ui/org/eclipse/jdt/ui/actions/ModifyParametersAction.java;4;1;12;2;2;2;3;9;209;3;6;9;372;372;3;3;1;10;12;9;4;336;8;4;0
/org.eclipse.jdt.core/batch/org/eclipse/jdt/internal/compiler/batch/Main.java;4;4;47;3;6;3;6;41;666;10;11;1;2631;2631;10;30;3;41;47;63;33;312;14;4;3
/org.eclipse.jdt.debug/jdi/org/eclipse/jdi/internal/ValueCache.java;1;0;1;1;0;0;0;1;4;0;1;78;4;4;1;0;0;1;1;78;0;78;1;1;0
/org.eclipse.jdt.core/model/org/eclipse/jdt/core/util/ILocalVariableTableEntry.java;1;0;1;1;0;0;0;1;2;0;1;199;2;2;1;0;0;1;1;199;0;199;1;1;0
/org.eclipse.jdt.debug.ui/ui/org/eclipse/jdt/internal/debug/core/refactoring/LaunchConfigurationITypeRenameParticipant.java;3;1;9;2;2;2;2;7;44;3;4;208;115;115;3;3;0;7;9;251;3;336;6;3;0
/org.eclipse.jdt.ui/ui/org/eclipse/jdt/ui/actions/ExtractInterfaceAction.java;3;0;9;1;1;1;2;7;144;2;6;3;278;278;2;1;1;8;9;94;2;336;7;3;0
/org.eclipse.update.core/src/org/eclipse/update/internal/operations/ToggleSiteOperation.java;1;1;7;1;2;2;2;5;4;1;5;54;16;16;1;0;0;5;7;54;0;336;7;1;0
/org.eclipse.jdt.core/search/org/eclipse/jdt/internal/core/search/matching/MatchingNodeSet.java;3;1;18;2;2;2;2;16;544;5;9;6;1098;1098;5;7;0;16;18;118;7;329;11;3;0
/org.eclipse.pde.ui/src_Forms/org/eclipse/pde/internal/ui/model/plugin/PluginLibraryNode.java;3;4;9;3;5;2;7;2;153;3;2;244;227;227;4;0;5;4;9;297;5;336;4;3;0
/org.eclipse.ui.workbench/Eclipse UI/org/eclipse/ui/internal/WorkingSet.java;1;0;2;1;0;0;0;2;94;1;2;157;96;96;1;0;0;2;2;157;0;181;2;1;2
/org.eclipse.jdt.core/eval/org/eclipse/jdt/internal/eval/GlobalVariable.java;1;0;1;1;0;0;0;1;2;0;1;199;2;2;1;0;0;1;1;199;0;199;1;1;0
/org.eclipse.swt/Eclipse SWT Printing/photon/org/eclipse/swt/printing/Printer.java;2;1;6;1;2;2;2;4;15;2;3;0;33;33;2;1;0;4;6;144;1;337;5;2;0
/org.eclipse.jdt.debug/eval/org/eclipse/jdt/internal/debug/eval/ast/instructions/ThrowInstruction.java;2;0;3;1;0;0;0;3;1;2;2;81;2;2;2;1;0;3;3;81;1;116;2;2;0
/org.eclipse.ui.views/src/org/eclipse/ui/views/properties/ComboBoxLabelProvider.java;1;0;1;1;0;0;0;1;0;0;1;171;0;0;1;0;0;1;1;171;0;171;1;1;0
/org.eclipse.jface/src/org/eclipse/jface/dialogs/DialogSettings.java;5;0;5;2;1;1;1;4;74;2;3;150;107;107;2;1;0;4;5;158;1;336;4;5;0
/org.eclipse.jdt.ui/ui/org/eclipse/jdt/ui/actions/RemoveFromClasspathAction.java;5;1;6;2;2;2;2;4;25;2;3;41;37;37;2;1;0;4;6;217;1;336;5;5;0
/org.eclipse.ui.cheatsheets/src/org/eclipse/ui/internal/cheatsheets/CheatSheetStopWatch.java;1;0;1;1;1;1;1;0;0;0;0;315;0;0;1;0;0;0;1;315;0;315;1;1;0
/org.eclipse.pde.ui/src/org/eclipse/pde/internal/ui/view/PluginsContentProvider.java;1;0;3;1;1;1;1;2;6;1;2;222;8;8;1;0;0;2;3;222;0;336;3;1;0
/org.eclipse.team.cvs.ui/src/org/eclipse/team/internal/ccvs/ui/RemoteAnnotationEditorInput.java;2;1;3;1;2;2;2;1;22;0;1;52;24;24;1;0;0;1;3;52;0;336;3;2;0
/org.eclipse.ui.ide/src/org/eclipse/ui/views/bookmarkexplorer/BookmarkContentProvider.java;1;0;1;1;0;0;0;1;0;0;1;129;0;0;1;0;0;1;1;129;0;129;1;1;0
/org.eclipse.jdt.debug.ui/ui/org/eclipse/jdt/internal/debug/ui/propertypages/JavaBreakpointPage.java;5;0;11;2;1;1;1;10;251;4;7;82;322;322;4;3;0;10;11;82;3;336;8;5;0
/org.eclipse.jdt.ui/core extension/org/eclipse/jdt/internal/corext/dom/TypeBindingVisitor.java;2;0;2;1;1;1;1;1;4;0;1;75;6;6;1;0;0;1;2;75;0;336;2;2;0
/org.eclipse.team.cvs.core/src/org/eclipse/team/internal/ccvs/core/connection/Connection.java;2;1;6;1;3;3;3;3;47;1;3;28;79;79;1;0;0;3;6;28;0;336;6;2;1
/org.eclipse.ui.editors/src/org/eclipse/ui/texteditor/SelectMarkerRulerInfoAction.java;1;1;2;1;2;2;2;0;11;0;0;276;12;12;1;0;0;0;2;276;0;336;2;1;0
/org.eclipse.jdt.debug.ui/ui/org/eclipse/jdt/internal/debug/ui/snippeteditor/ScrapbookSourcepathProvider.java;1;0;1;1;1;1;1;0;0;0;0;324;0;0;1;0;0;0;1;324;0;324;1;1;0
/org.eclipse.jdt.debug.ui/ui/org/eclipse/jdt/internal/debug/ui/launcher/SourceElementQualifierProvider.java;3;1;3;2;2;2;2;1;49;0;1;131;58;58;1;0;0;1;3;131;0;336;3;3;0
/org.eclipse.osgi/core/framework/org/eclipse/osgi/framework/console/CommandProvider.java;4;1;5;1;3;3;3;2;48;1;2;171;60;60;1;0;0;2;5;171;0;336;5;4;0
/org.eclipse.pde.ui/src/org/eclipse/pde/internal/ui/editor/StreamDocumentProvider.java;1;0;1;1;0;0;0;1;10;0;1;158;10;10;1;0;0;1;1;158;0;158;1;1;0
/org.eclipse.jdt.debug.ui/ui/org/eclipse/jdt/internal/debug/ui/JDIImageDescriptor.java;1;0;1;1;0;0;0;1;48;0;1;139;48;48;1;0;0;1;1;139;0;139;1;1;0
/org.eclipse.ui.externaltools/Program Tools Support/org/eclipse/ui/externaltools/internal/program/launchConfigurations/ProgramMainTab.java;3;0;9;2;0;0;0;9;19;2;6;23;65;65;2;3;0;9;9;23;3;178;6;3;0
/org.eclipse.jdt.ui/ui/org/eclipse/jdt/internal/ui/javaeditor/ClassFileEditor.java;5;3;15;2;6;4;6;9;60;2;7;42;159;159;3;2;2;9;15;276;4;336;11;5;1
/org.eclipse.pde.ui/src/org/eclipse/pde/internal/ui/editor/site/BaseNewDialog.java;2;1;3;1;2;2;2;1;14;0;1;208;20;20;1;0;0;1;3;208;0;336;3;2;0
/org.eclipse.swt/Eclipse SWT Browser/common/org/eclipse/swt/browser/ProgressListener.java;2;0;5;1;1;1;1;4;56;2;3;100;101;101;2;1;0;4;5;100;1;337;4;2;0
/org.eclipse.core.resources/src/org/eclipse/core/internal/indexing/IndexedStoreObject.java;1;0;1;1;1;1;1;0;18;0;0;277;18;18;1;0;0;0;1;277;0;277;1;1;0
/org.eclipse.swt/Eclipse SWT/emulated/coolbar/org/eclipse/swt/widgets/CoolBar.java;4;3;11;3;4;2;7;4;214;4;4;19;374;374;4;0;5;7;11;266;5;337;6;4;0
/org.eclipse.help.base/src/org/eclipse/help/internal/workingset/WorkingSet.java;1;1;4;1;3;3;3;1;55;0;1;104;77;77;1;0;0;1;4;104;0;336;4;1;0
/org.eclipse.jdt.core/dom/org/eclipse/jdt/core/dom/NodeEventHandler.java;2;0;4;1;1;1;1;3;110;2;2;232;142;142;2;1;0;3;4;232;1;314;3;2;0
/org.eclipse.ui.ide/src/org/eclipse/ui/views/tasklist/MarkCompletedAction.java;1;0;1;1;0;0;0;1;0;0;1;129;0;0;1;0;0;1;1;129;0;129;1;1;0
/org.eclipse.ui.ide/src/org/eclipse/ui/internal/ide/model/WorkbenchFolder.java;1;0;1;1;0;0;0;1;0;0;1;132;0;0;1;0;0;1;1;132;0;132;1;1;0
/org.eclipse.help.base/src/org/eclipse/help/internal/base/util/HelpProperties.java;1;2;7;1;4;3;4;3;33;1;3;105;61;61;2;0;1;3;7;296;1;336;6;1;0
/org.eclipse.pde.ui/src/org/eclipse/pde/internal/ui/editor/feature/FeaturePropertySource.java;1;0;2;1;1;1;1;1;8;0;1;232;12;12;1;0;0;1;2;232;0;336;2;1;0
/org.eclipse.jface.text/src/org/eclipse/jface/text/information/InformationPresenter.java;3;2;13;2;4;2;4;9;139;3;6;47;264;264;3;3;2;9;13;47;5;336;8;3;0
/org.eclipse.jdt.ui/ui/org/eclipse/jdt/ui/actions/OpenSuperImplementationAction.java;3;0;3;1;1;1;1;2;10;1;2;41;14;14;1;0;0;2;3;41;0;336;3;3;0
/org.eclipse.jdt.core/dom/org/eclipse/jdt/core/dom/ASTConverter.java;6;4;46;4;9;3;9;37;801;11;12;5;2263;2263;11;25;6;37;46;193;31;323;15;6;12
/org.eclipse.core.runtime/src/org/osgi/service/prefs/Preferences.java;1;0;1;1;1;1;1;0;0;0;0;294;0;0;1;0;0;0;1;294;0;294;1;1;0
/org.eclipse.jdt.ui/ui/org/eclipse/jdt/ui/actions/AddJavaDocStubAction.java;4;1;10;2;3;3;3;7;46;2;6;41;108;108;2;1;0;7;10;75;1;336;9;4;0
/org.eclipse.ant.ui/Ant Editor/org/eclipse/ant/internal/ui/editor/utils/ProjectHelperMessages.java;1;0;1;1;1;1;1;0;0;0;0;289;0;0;1;0;0;0;1;289;0;289;1;1;0
/org.eclipse.swt/Eclipse SWT Drag and Drop/gtk/org/eclipse/swt/dnd/FileTransfer.java;3;0;5;1;1;1;1;4;125;1;4;23;232;232;1;0;0;4;5;23;0;337;5;3;0
/org.eclipse.pde.ui/src/org/eclipse/pde/internal/ui/editor/schema/NewCompositorAction.java;2;1;2;1;2;2;2;0;4;0;0;308;8;8;1;0;0;0;2;308;0;336;2;2;0
/org.eclipse.core.runtime/src/org/eclipse/core/internal/content/ContentDescription.java;3;5;8;2;7;2;7;1;213;0;1;251;290;290;5;0;5;1;8;301;5;301;3;3;1
/org.eclipse.swt/Eclipse SWT OLE Win32/win32/org/eclipse/swt/ole/win32/OLE.java;1;0;1;1;0;0;0;1;15;0;1;92;15;15;1;0;0;1;1;92;0;92;1;1;0
/org.eclipse.tomcat/src/org/eclipse/tomcat/internal/TomcatAppServer.java;1;4;12;1;6;3;6;6;147;3;4;25;348;348;4;2;3;6;12;292;5;336;7;1;0
/org.eclipse.jdt.core/search/org/eclipse/jdt/internal/core/search/matching/LocalVariableLocator.java;3;0;9;2;1;1;1;8;170;3;6;145;215;215;3;2;0;8;9;145;2;280;7;3;0
/org.eclipse.jface.text/src/org/eclipse/jface/text/IInformationControlExtension2.java;2;0;2;2;2;1;2;0;15;0;0;336;15;15;2;0;1;0;2;336;1;336;1;2;0
/org.eclipse.osgi/osgi/src/org/osgi/service/url/URLStreamHandlerSetter.java;2;0;2;1;1;1;1;1;3;0;1;171;3;3;1;0;0;1;2;171;0;296;2;2;0
/org.eclipse.jdt.ui/core refactoring/org/eclipse/jdt/internal/corext/refactoring/rename/RefactoringAnalyzeUtil.java;4;0;11;2;1;1;1;10;70;3;6;10;130;130;3;4;0;10;11;251;4;336;7;4;0
/org.eclipse.jdt.launching/launching/org/eclipse/jdt/internal/launching/RuntimeClasspathEntry.java;2;0;9;2;2;1;2;7;173;2;5;53;319;319;2;2;1;7;9;141;3;299;6;2;0
/org.eclipse.swt/Eclipse SWT PI/motif/org/eclipse/swt/internal/motif/XCreateWindowEvent.java;1;0;1;1;0;0;0;1;0;0;1;88;0;0;1;0;0;1;1;88;0;88;1;1;0
/org.eclipse.swt/Eclipse SWT PI/win32/org/eclipse/swt/internal/ole/win32/FUNCDESC2.java;1;0;1;1;0;0;0;1;8;0;1;166;8;8;1;0;0;1;1;166;0;166;1;1;0
/org.eclipse.jdt.core/model/org/eclipse/jdt/core/IMember.java;2;0;6;1;0;0;0;6;14;1;6;112;24;24;1;0;0;6;6;112;0;241;6;2;0
/org.eclipse.swt/Eclipse SWT PI/carbon/org/eclipse/swt/internal/carbon/PMRect.java;2;0;3;1;2;1;2;1;20;0;1;156;20;20;2;0;1;1;3;296;1;296;2;2;0
/org.eclipse.swt/Eclipse SWT/photon/org/eclipse/swt/widgets/Group.java;4;1;6;1;2;2;2;4;13;1;4;8;30;30;1;0;0;4;6;8;0;337;6;4;0
/org.eclipse.ui.workbench/Eclipse UI/org/eclipse/ui/part/MultiEditorInput.java;2;1;2;1;2;2;2;0;4;0;0;293;6;6;1;0;0;0;2;293;0;336;2;2;0
/org.eclipse.swt/Eclipse SWT/gtk/org/eclipse/swt/widgets/TableColumn.java;7;1;17;2;2;2;2;15;56;4;9;4;148;148;4;6;0;15;17;76;6;337;11;7;1
/org.eclipse.help/src/org/eclipse/help/IContext.java;1;1;2;1;2;2;2;0;27;0;0;311;33;33;1;0;0;0;2;311;0;336;2;1;0
/org.eclipse.jdt.ui/ui/org/eclipse/jdt/internal/ui/text/spelling/SpellCheckIterator.java;2;0;4;1;1;1;1;3;6;1;3;219;10;10;1;0;0;3;4;219;0;336;4;2;0
/org.eclipse.ui.cheatsheets/src/org/eclipse/ui/cheatsheets/ICheatSheetEvent.java;2;0;2;2;0;0;0;2;95;0;1;253;95;95;2;1;0;2;2;253;1;253;1;2;0
/org.eclipse.swt/Eclipse SWT PI/gtk/org/eclipse/swt/internal/gtk/GdkEventFocus.java;3;0;4;1;1;1;1;3;17;2;2;100;23;23;2;1;0;3;4;226;1;337;3;3;0
/org.eclipse.pde.ui/src/org/eclipse/pde/internal/ui/parts/FormBrowser.java;2;1;4;1;2;2;2;2;71;1;2;163;108;108;1;0;0;2;4;163;0;336;4;2;0
/org.eclipse.ui.workbench.texteditor/src/org/eclipse/ui/texteditor/IAbstractTextEditorHelpContextIds.java;3;0;5;2;1;1;1;4;28;1;4;31;50;50;1;0;0;4;5;31;0;336;5;3;0
/org.eclipse.jdt.ui/ui refactoring/org/eclipse/jdt/internal/ui/refactoring/reorg/DeleteAction.java;3;0;13;2;1;1;1;12;212;6;4;70;263;263;6;8;0;12;13;94;8;336;5;3;0
/org.eclipse.ui.workbench/Eclipse UI/org/eclipse/ui/internal/OpenPreferencesAction.java;1;0;1;1;0;0;0;1;45;0;1;157;45;45;1;0;0;1;1;157;0;157;1;1;1
/org.eclipse.ui.ide/src/org/eclipse/ui/internal/ide/dialogs/WelcomeParser.java;2;0;2;1;0;0;0;2;66;1;2;132;66;66;1;0;0;2;2;132;0;156;2;2;0
/org.eclipse.update.core/src/org/eclipse/update/core/ArchiveReference.java;2;2;4;1;3;2;3;1;9;0;1;58;15;15;2;0;1;1;4;302;1;336;3;2;0
/org.eclipse.pde.ui/src/org/eclipse/pde/internal/ui/wizards/plugin/PluginContentPage.java;2;1;2;1;2;2;2;0;4;0;0;326;4;4;1;0;0;0;2;326;0;336;2;2;0
/org.eclipse.jdt.debug.ui/ui/org/eclipse/jdt/internal/debug/core/refactoring/JavaBreakpointIJavaProjectRenameParticipant.java;2;1;2;1;2;2;2;0;8;0;0;300;8;8;1;0;0;0;2;300;0;336;2;2;0
/org.eclipse.swt/Eclipse SWT Drag and Drop/win32/org/eclipse/swt/dnd/FileTransfer.java;1;0;1;1;0;0;0;1;88;0;1;22;88;88;1;0;0;1;1;22;0;22;1;1;0
/org.eclipse.jdt.ui/ui/org/eclipse/jdt/ui/actions/AddDelegateMethodsAction.java;4;3;18;2;4;2;5;13;354;3;8;31;595;595;3;5;3;14;18;49;8;314;10;4;0
/org.eclipse.ui.ide/src/org/eclipse/ui/internal/ide/dialogs/MultiStepWizardDialog.java;1;0;1;1;0;0;0;1;0;0;1;132;0;0;1;0;0;1;1;132;0;132;1;1;0
/org.eclipse.jdt.launching/launching/org/eclipse/jdt/launching/sourcelookup/containers/ClasspathVariableSourceContainer.java;1;0;2;1;0;0;1;1;4;0;1;269;4;4;2;0;1;2;2;269;1;269;1;1;0
/org.eclipse.swt/Eclipse SWT/motif/org/eclipse/swt/widgets/ScrollBar.java;4;1;6;2;2;2;2;4;32;2;3;1;61;61;2;1;0;4;6;1;1;337;5;4;0
/org.eclipse.pde.core/src/org/eclipse/pde/core/plugin/IPluginAttribute.java;3;2;5;1;4;3;4;1;26;0;1;232;34;34;2;0;1;1;5;276;1;336;4;3;0
/org.eclipse.jface.text/src/org/eclipse/jface/text/contentassist/IContentAssistantExtension.java;3;2;8;1;3;2;3;5;32;2;4;92;68;68;2;1;1;5;8;132;2;336;6;3;0
/org.eclipse.ui.workbench.texteditor/src/org/eclipse/ui/texteditor/IWorkbenchActionDefinitionIds.java;2;1;4;1;2;2;2;2;18;1;2;120;26;26;1;0;0;2;4;120;0;336;4;2;0
/org.eclipse.core.runtime.compatibility/src-runtime/org/eclipse/core/internal/plugins/PluginRegistry.java;4;2;8;2;3;2;3;5;101;1;5;171;173;173;2;0;1;5;8;276;1;336;7;4;1
/org.eclipse.swt/Eclipse SWT Custom Widgets/common/org/eclipse/swt/custom/CTabFolderListener.java;2;1;5;1;2;2;2;3;14;1;3;94;36;36;1;0;0;3;5;94;0;337;5;2;0
/org.eclipse.jdt.debug/jdi interfaces/com/sun/jdi/VMCannotBeModifiedException.java;1;0;1;1;0;0;0;1;0;0;1;235;0;0;1;0;0;1;1;235;0;235;1;1;0
/org.eclipse.ltk.core.refactoring/src/org/eclipse/ltk/internal/core/refactoring/RefactoringCorePlugin.java;1;0;6;1;4;1;4;2;46;0;1;264;58;58;4;1;3;2;6;278;4;278;2;1;0
/org.eclipse.swt.tools/JNI Generation/org/eclipse/swt/tools/internal/StatsGenerator.java;2;0;2;2;2;1;2;0;28;0;0;287;28;28;2;0;1;0;2;287;1;287;1;2;0
/org.eclipse.update.core/src/org/eclipse/update/internal/model/SiteLocalParser.java;2;1;10;1;3;3;3;7;174;3;5;58;306;306;3;2;0;7;10;235;2;336;8;2;0
/org.eclipse.jdt.launching/launching/org/eclipse/jdt/internal/launching/JavaAppletLaunchConfigurationDelegate.java;3;1;8;3;2;2;2;6;32;2;4;144;98;98;2;2;0;6;8;172;2;307;6;3;1
/org.eclipse.debug.ui/ui/org/eclipse/debug/internal/ui/stringsubstitution/ResourceResolver.java;5;0;6;2;1;1;1;5;22;2;3;121;44;44;2;2;0;5;6;121;2;336;4;5;0
/org.eclipse.jdt.ui/ui/org/eclipse/jdt/internal/ui/dnd/JdtViewerDropAdapter.java;1;0;1;1;1;1;1;0;2;0;0;336;2;2;1;0;0;0;1;336;0;336;1;1;0
/org.eclipse.text/src/org/eclipse/text/edits/MoveTargetEdit.java;2;0;4;1;1;1;1;3;74;2;2;118;109;109;2;1;0;3;4;118;1;336;3;2;0
/org.eclipse.jdt.ui/ui refactoring/org/eclipse/jdt/internal/ui/refactoring/nls/PackageSelectionDialogButtonField.java;3;1;3;1;2;2;2;1;14;0;1;267;16;16;1;0;0;1;3;267;0;336;3;3;0
/org.eclipse.ui.workbench/Eclipse UI/org/eclipse/ui/internal/WorkbenchWindow.java;12;13;102;7;17;2;22;80;5946;29;8;26;12551;12551;29;72;20;85;102;223;92;326;10;12;7
/org.eclipse.ui.workbench/Eclipse UI/org/eclipse/ui/keys/IKeyFormatter.java;2;0;2;2;0;0;0;2;14;0;1;182;14;14;2;1;0;2;2;182;1;182;1;2;0
/org.eclipse.core.runtime/src/org/eclipse/core/runtime/jobs/IJobChangeListener.java;3;0;12;3;0;0;2;10;298;4;5;46;445;445;4;5;2;12;12;171;7;270;5;3;0
/org.eclipse.jdt.core/compiler/org/eclipse/jdt/internal/compiler/CompilationResult.java;3;0;4;1;1;1;1;3;34;1;3;2;52;52;1;0;0;3;4;2;0;324;4;3;0
/org.eclipse.swt/Eclipse SWT PI/win32/org/eclipse/swt/internal/win32/NOTIFYICONDATAW.java;3;0;3;2;1;1;1;2;12;0;1;244;16;16;2;1;0;2;3;244;1;337;2;3;0
/org.eclipse.update.configurator/src/org/eclipse/update/internal/configurator/Configuration.java;1;0;8;1;4;1;4;4;31;2;3;227;47;47;4;1;3;4;8;295;4;295;4;1;0
/org.eclipse.pde.ui/src_Forms/org/eclipse/pde/internal/ui/model/IEditingModel.java;2;2;6;2;4;3;4;2;12;1;2;244;20;20;2;0;1;2;6;303;1;336;5;2;0
/org.eclipse.ui.editors/src/org/eclipse/ui/texteditor/MarkerRulerAction.java;2;1;7;1;3;3;3;4;428;1;4;118;508;508;1;0;0;4;7;118;0;336;7;2;0
/org.eclipse.jdt.ui/ui/org/eclipse/jdt/internal/ui/text/JavaPartitionScanner.java;1;0;2;1;1;1;1;1;4;0;1;82;6;6;1;0;0;1;2;82;0;336;2;1;0
/org.eclipse.team.core/src/org/eclipse/team/core/ProjectSetSerializationContext.java;1;1;5;1;3;3;3;2;56;0;1;265;90;90;2;1;0;2;5;265;1;336;4;1;0
/org.eclipse.core.resources/src/org/eclipse/core/resources/IResourceDelta.java;2;1;5;1;2;2;3;2;811;2;2;3;832;832;2;0;1;3;5;270;1;336;4;2;1
/org.eclipse.ui.ide/src/org/eclipse/ui/views/tasklist/PasteTaskAction.java;1;0;1;1;0;0;0;1;0;0;1;129;0;0;1;0;0;1;1;129;0;129;1;1;0
/org.eclipse.jdt.ui/ui/org/eclipse/jdt/internal/ui/callhierarchy/CallHierarchyUI.java;3;1;12;1;3;3;3;9;174;5;5;13;281;281;5;4;0;9;12;13;4;336;8;3;0
/org.eclipse.ui.workbench.texteditor/src/org/eclipse/ui/texteditor/TextSelectionNavigationLocation.java;2;1;3;1;2;2;2;1;12;0;1;66;16;16;1;0;0;1;3;66;0;336;3;2;0
/org.eclipse.jdt.ui/core refactoring/org/eclipse/jdt/internal/corext/refactoring/code/ConvertAnonymousToNestedRefactoring.java;5;2;29;3;5;4;5;24;942;7;10;4;1129;1129;7;14;1;24;29;180;15;336;14;5;0
/org.eclipse.pde.ui/src_Forms/org/eclipse/pde/internal/ui/model/plugin/PluginBaseNode.java;3;3;16;3;4;2;8;8;367;0;1;244;443;443;12;7;6;12;16;244;13;336;3;3;0
/org.eclipse.ui.views/src/org/eclipse/ui/views/contentoutline/ContentOutlinePage.java;3;1;2;2;2;2;2;0;12;0;0;287;18;18;1;0;0;0;2;287;0;336;2;3;0
/org.eclipse.ui.workbench/Eclipse UI/org/eclipse/ui/internal/progress/IJobProgressManagerListener.java;2;0;5;1;1;1;1;4;24;2;3;88;32;32;2;1;0;4;5;205;1;336;4;2;0
/org.eclipse.jdt.ui/ui/org/eclipse/jdt/internal/ui/text/correction/CorrectPackageDeclarationProposal.java;3;0;8;1;1;1;1;7;26;2;6;65;79;79;2;1;0;7;8;116;1;336;7;3;0
/org.eclipse.core.runtime/src/org/eclipse/core/runtime/NullProgressMonitor.java;2;1;6;2;2;2;2;4;453;3;2;171;486;486;3;2;0;4;6;171;2;336;4;2;0
/org.eclipse.search/search/org/eclipse/search/internal/ui/text/NameSorter.java;1;0;2;1;1;1;1;1;4;0;1;207;4;4;1;0;0;1;2;207;0;292;2;1;0
/org.eclipse.team.cvs.ui/src/org/eclipse/team/internal/ccvs/ui/operations/CheckoutIntoOperation.java;2;1;15;2;2;2;2;13;409;5;5;45;650;650;5;8;0;13;15;110;8;336;7;2;0
/org.eclipse.osgi/core/framework/org/eclipse/osgi/framework/eventmgr/EventDispatcher.java;1;1;2;1;2;2;2;0;4;0;0;275;4;4;1;0;0;0;2;275;0;303;2;1;0
/org.eclipse.team.cvs.core/src/org/eclipse/team/internal/ccvs/core/resources/FileModificationManager.java;2;0;6;1;1;1;1;5;18;1;5;20;47;47;1;0;0;5;6;20;0;336;6;2;1
/org.eclipse.osgi/defaultAdaptor/src/org/eclipse/osgi/framework/internal/defaultadaptor/DefaultClassLoader.java;5;0;21;3;2;1;7;14;373;12;5;171;1010;1010;12;9;6;19;21;239;15;295;6;5;0
/org.eclipse.jdt.core/compiler/org/eclipse/jdt/internal/compiler/ast/ImplicitDocTypeReference.java;1;0;1;1;0;0;0;1;0;0;1;218;0;0;1;0;0;1;1;218;0;218;1;1;0
/org.eclipse.ui.workbench.texteditor/src/org/eclipse/ui/texteditor/quickdiff/ReferenceProviderDescriptor.java;2;6;8;2;7;2;7;1;36;0;1;100;42;42;6;0;5;1;8;275;5;336;3;2;0
/org.eclipse.jdt.ui/ui/org/eclipse/jdt/ui/actions/ExtractConstantAction.java;4;0;8;2;1;1;1;7;44;2;6;9;92;92;2;1;0;7;8;9;1;336;7;4;1
/org.eclipse.update.ui/src/org/eclipse/update/internal/ui/UpdateUI.java;3;1;23;3;3;3;3;20;378;7;8;32;589;589;7;12;0;20;23;48;12;336;11;3;1
/org.eclipse.jface/src/org/eclipse/jface/action/ContributionItem.java;2;0;2;2;0;0;0;2;19;0;1;181;19;19;2;1;0;2;2;181;1;181;1;2;0
/org.eclipse.jface.text/src/org/eclipse/jface/text/rules/DefaultDamagerRepairer.java;1;0;3;1;1;1;1;2;10;1;2;167;17;17;1;0;0;2;3;167;0;336;3;1;0
/org.eclipse.ant.ui/Ant Tools Support/org/eclipse/ant/internal/ui/views/elements/AntViewElementsMessages.java;1;0;1;1;0;0;0;1;0;0;1;108;0;0;1;0;0;1;1;108;0;108;1;1;1
/org.eclipse.pde.ui/src/org/eclipse/pde/internal/ui/editor/build/BuildInputContext.java;3;3;5;3;5;3;5;0;16;0;0;292;33;33;3;0;2;0;5;301;2;336;3;3;0
/org.eclipse.ui.ide/src/org/eclipse/ui/internal/ide/Policy.java;1;0;1;1;0;0;0;1;0;0;1;92;0;0;1;0;0;1;1;92;0;92;1;1;0
/org.eclipse.osgi/core/framework/org/eclipse/osgi/service/systembundle/EntryLocator.java;1;0;1;1;1;1;1;0;0;0;0;281;0;0;1;0;0;0;1;281;0;281;1;1;0
/org.eclipse.jdt.ui/ui/org/eclipse/jdt/ui/jarpackager/JarPackageData.java;3;3;7;2;5;2;5;2;60;1;2;28;127;127;3;0;3;2;7;279;3;334;4;3;0
/org.eclipse.team.cvs.core/src/org/eclipse/team/internal/ccvs/core/client/MTHandler.java;1;0;1;1;0;0;0;1;7;0;1;101;7;7;1;0;0;1;1;101;0;101;1;1;0
/org.eclipse.jdt.core/search/org/eclipse/jdt/internal/core/search/indexing/InternalSearchDocument.java;1;0;1;1;1;1;1;0;0;0;0;283;0;0;1;0;0;0;1;283;0;283;1;1;0
/org.eclipse.jdt.ui/core extension/org/eclipse/jdt/internal/corext/util/CodeFormatterUtil.java;2;1;24;1;2;2;2;22;1251;10;5;38;1975;1975;10;17;0;22;24;121;17;336;7;2;0
/org.eclipse.jdt.junit/src/org/eclipse/jdt/internal/junit/refactoring/LaunchConfigTypeChange.java;2;1;2;1;2;2;2;0;10;0;0;272;10;10;1;0;0;0;2;272;0;336;2;2;1
/org.eclipse.ui.ide/src/org/eclipse/ui/views/markers/internal/ImageFactory.java;1;0;1;1;0;0;0;1;0;0;1;129;0;0;1;0;0;1;1;129;0;129;1;1;0
/org.eclipse.ui.workbench.texteditor/src/org/eclipse/ui/texteditor/templates/MessageLine.java;2;1;3;1;2;2;2;1;9;0;1;253;11;11;1;0;0;1;3;253;0;336;3;2;0
/org.eclipse.update.ui/src_webapp/org/eclipse/update/internal/ui/servlets/InstallServlet.java;3;0;4;3;0;0;0;4;127;0;1;49;127;127;4;3;0;4;4;49;3;49;1;3;0
/org.eclipse.jdt.debug.ui/ui/org/eclipse/jdt/internal/debug/ui/actions/DropToFrameAction.java;1;0;1;1;0;0;0;1;6;0;1;97;6;6;1;0;0;1;1;97;0;97;1;1;1
/org.eclipse.swt/Eclipse SWT/win32/org/eclipse/swt/widgets/CoolItem.java;4;3;7;3;5;3;5;2;104;1;2;19;130;130;3;0;2;2;7;274;2;337;5;4;0
/org.eclipse.ui.presentations.r21/src/org/eclipse/ui/internal/presentations/r21/widgets/R21PaneFolderButtonListener.java;1;0;1;1;1;1;1;0;0;0;0;323;0;0;1;0;0;0;1;323;0;323;1;1;0
/org.eclipse.ui.workbench/Eclipse UI/org/eclipse/ui/internal/commands/ws/CommandsView.java;2;0;2;1;1;1;1;1;10;0;1;266;10;10;1;0;0;1;2;266;0;336;2;2;0
/org.eclipse.pde.ui/src/org/eclipse/pde/ui/templates/ChoiceOption.java;2;1;3;1;3;3;3;0;49;0;0;276;91;91;1;0;0;0;3;276;0;336;3;2;0
/org.eclipse.team.core/src/org/eclipse/team/core/subscribers/SubscriberChangeEvent.java;2;2;5;1;3;2;3;2;60;1;2;220;89;89;2;0;1;2;5;335;1;335;4;2;0
/org.eclipse.jdt.ui/core refactoring/org/eclipse/jdt/internal/corext/refactoring/structure/CompilationUnitRewrite.java;2;3;4;1;4;2;4;0;75;0;0;296;77;77;3;0;2;0;4;296;2;336;2;2;0
/org.eclipse.jdt.ui/core refactoring/org/eclipse/jdt/internal/corext/refactoring/nls/NLSHintHelper.java;2;1;2;1;2;2;2;0;2;0;0;301;2;2;1;0;0;0;2;301;0;336;2;2;1
/org.eclipse.jdt.debug.ui/ui/org/eclipse/jdt/internal/debug/ui/launcher/VMArgumentsBlock.java;3;1;6;2;2;2;2;4;26;2;3;71;58;58;2;1;0;4;6;266;1;336;5;3;0
/org.eclipse.jface.text/src/org/eclipse/jface/text/MarginPainter.java;2;0;3;2;2;1;2;1;10;0;1;55;12;12;2;0;1;1;3;336;1;336;2;2;0
/org.eclipse.ui.workbench/Eclipse UI/org/eclipse/ui/internal/presentations/PresentationSerializer.java;2;0;2;2;2;1;2;0;2;0;0;303;2;2;2;0;1;0;2;303;1;303;1;2;0
/org.eclipse.jdt.ui/ui/org/eclipse/jdt/internal/ui/callhierarchy/CallHierarchyContentProvider.java;4;0;15;2;1;1;1;14;57;4;8;12;226;226;4;6;0;14;15;12;6;336;9;4;0
/org.eclipse.ui.forms/src/org/eclipse/ui/forms/widgets/ScrolledForm.java;1;0;5;1;1;1;1;4;18;2;3;228;34;34;2;1;0;4;5;228;1;272;4;1;0
/org.eclipse.text/src/org/eclipse/text/edits/MoveSourceEdit.java;2;0;5;1;1;1;1;4;210;2;3;118;283;283;2;1;0;4;5;118;1;336;4;2;0
/org.eclipse.update.configurator/src/org/eclipse/update/internal/configurator/BundleManifest.java;2;1;7;1;3;3;3;4;90;3;2;227;113;113;3;2;0;4;7;227;2;309;5;2;0
/org.eclipse.jdt.core/compiler/org/eclipse/jdt/core/compiler/CharOperation.java;5;0;11;2;2;1;2;9;61;2;8;1;205;205;2;1;1;9;11;1;2;299;9;5;0
/org.eclipse.pde.ui/src/org/eclipse/pde/internal/ui/editor/plugin/ExtensionElementDetails.java;3;7;8;3;8;2;8;0;43;0;0;292;53;53;7;0;6;0;8;292;6;336;2;3;0
/org.eclipse.swt/Eclipse SWT PI/win32/org/eclipse/swt/internal/win32/NOTIFYICONDATAA.java;3;0;3;2;1;1;1;2;12;0;1;244;16;16;2;1;0;2;3;244;1;337;2;3;0
/org.eclipse.update.core/src/org/eclipse/update/core/ISiteFactoryExtension.java;2;1;3;1;2;2;2;1;6;0;1;58;14;14;1;0;0;1;3;58;0;336;3;2;0
/org.eclipse.jface/src/org/eclipse/jface/util/DelegatingDragAdapter.java;3;0;3;1;1;1;1;2;6;1;2;13;10;10;1;0;0;2;3;13;0;336;3;3;0
/org.eclipse.compare/compare/org/eclipse/compare/internal/ResourceCompareInput.java;1;2;7;1;4;3;4;3;68;2;2;45;159;159;2;1;1;3;7;45;2;337;5;1;0
/org.eclipse.update.core/src/org/eclipse/update/internal/operations/UnconfigOperation.java;1;0;10;1;1;1;1;9;4;2;7;54;21;21;2;2;0;9;10;71;2;336;8;1;0
/org.eclipse.team.ui/src/org/eclipse/team/ui/synchronize/ISynchronizeParticipantReference.java;2;2;5;1;3;2;3;2;61;0;1;262;82;82;2;1;1;2;5;262;2;335;3;2;0
/org.eclipse.swt/Eclipse SWT PI/win32/org/eclipse/swt/internal/win32/TEXTMETRICA.java;1;0;1;1;0;0;0;1;0;0;1;61;0;0;1;0;0;1;1;61;0;61;1;1;0
/org.eclipse.ui.ide/src/org/eclipse/ui/wizards/datatransfer/ExternalProjectImportWizard.java;1;0;1;1;0;0;0;1;0;0;1;92;0;0;1;0;0;1;1;92;0;92;1;1;0
/org.eclipse.pde.core/src/org/eclipse/pde/internal/core/SourceLocation.java;1;0;3;1;1;1;1;2;14;1;2;71;28;28;1;0;0;2;3;71;0;336;3;1;0
/org.eclipse.jdt.ui/ui/org/eclipse/jdt/internal/ui/wizards/buildpaths/ClasspathContainerSelectionPage.java;2;1;3;1;2;2;2;1;4;0;1;243;8;8;1;0;0;1;3;243;0;336;3;2;0
/org.eclipse.ui.workbench.texteditor/src/org/eclipse/ui/internal/texteditor/EditPosition.java;1;0;1;1;1;1;1;0;2;0;0;336;2;2;1;0;0;0;1;336;0;336;1;1;0
/org.eclipse.jdt.core/compiler/org/eclipse/jdt/internal/compiler/impl/StringConstant.java;1;0;1;1;0;0;0;1;2;0;1;199;2;2;1;0;0;1;1;199;0;199;1;1;0
/org.eclipse.jdt.ui/ui/org/eclipse/jdt/ui/actions/UseSupertypeAction.java;3;0;9;1;1;1;2;7;146;2;6;3;279;279;2;1;1;8;9;94;2;336;7;3;0
/org.eclipse.debug.ui/ui/org/eclipse/debug/internal/ui/views/memory/MemoryRenderingViewTabFactory.java;1;0;1;1;1;1;1;0;0;0;0;282;0;0;1;0;0;0;1;282;0;282;1;1;0
/org.eclipse.ui.workbench/Eclipse UI/org/eclipse/ui/part/IShowInTarget.java;1;0;1;1;0;0;0;1;4;0;1;0;4;4;1;0;0;1;1;0;0;0;1;1;0
/org.eclipse.jdt.ui/core refactoring/org/eclipse/jdt/internal/corext/refactoring/code/CodeRefactoringUtil.java;2;0;2;1;1;1;1;1;2;0;1;251;4;4;1;0;0;1;2;251;0;336;2;2;0
/org.eclipse.core.filebuffers/src/org/eclipse/core/filebuffers/IAnnotationModelFactory.java;2;2;3;2;3;2;3;0;29;0;0;289;29;29;2;0;1;0;3;334;1;334;2;2;0
/org.eclipse.pde.ui/src/org/eclipse/pde/internal/ui/editor/build/BuildContentsSection.java;3;4;12;3;7;4;7;5;1212;3;3;104;1598;1598;4;2;3;5;12;292;5;336;7;3;0
/org.eclipse.jdt.ui/ui/org/eclipse/jdt/internal/ui/util/ViewerPane.java;1;0;1;1;1;1;1;0;2;0;0;336;2;2;1;0;0;0;1;336;0;336;1;1;0
/org.eclipse.jdt.ui/ui/org/eclipse/jdt/internal/ui/SharedImages.java;1;0;1;1;1;1;1;0;2;0;0;336;2;2;1;0;0;0;1;336;0;336;1;1;0
/org.eclipse.ltk.ui.refactoring/src/org/eclipse/ltk/internal/ui/refactoring/UIPerformChangeOperation.java;1;1;3;1;2;2;2;1;65;0;1;269;123;123;1;0;0;1;3;269;0;327;3;1;0
/org.eclipse.ant.ui/Ant Editor Content Assist Dev/TaskXMLFileMerger.java;1;0;1;1;0;0;0;1;0;0;1;211;0;0;1;0;0;1;1;211;0;211;1;1;1
/org.eclipse.pde.build/src_ant/org/eclipse/pde/internal/build/tasks/AssemblerTask.java;2;2;9;2;3;2;3;6;17;2;4;31;26;26;2;2;1;6;9;31;3;336;6;2;0
/org.eclipse.swt/Eclipse SWT PI/win32/org/eclipse/swt/internal/win32/NMLVFINDITEM.java;2;0;2;1;1;1;1;1;6;0;1;232;6;6;1;0;0;1;2;232;0;337;2;2;0
/org.eclipse.pde.ui/src/org/eclipse/pde/internal/ui/editor/feature/FeatureEditorContributor.java;2;1;5;1;3;3;3;2;63;1;2;99;80;80;1;0;0;2;5;99;0;336;5;2;0
/org.eclipse.jdt.ui/core extension/org/eclipse/jdt/internal/corext/codemanipulation/CodeGenerationSettings.java;2;0;2;1;1;1;1;1;3;0;1;57;5;5;1;0;0;1;2;57;0;336;2;2;0
/org.eclipse.pde.build/src/org/eclipse/pde/internal/build/ant/ITask.java;2;0;6;1;1;1;1;5;52;2;3;31;135;135;2;2;0;5;6;31;2;277;4;2;0
/org.eclipse.jdt.core/model/org/eclipse/jdt/internal/core/LocalVariable.java;2;1;12;2;2;2;2;10;52;6;4;140;69;69;6;6;0;10;12;140;6;300;6;2;0
/org.eclipse.team.cvs.ui/src/org/eclipse/team/internal/ccvs/ui/actions/WorkspaceAction.java;2;1;7;1;2;2;2;5;69;1;5;31;119;119;1;0;0;5;7;31;0;336;7;2;1
/org.eclipse.ui.forms/src/org/eclipse/ui/forms/widgets/ColumnLayoutData.java;1;0;4;1;1;1;1;3;54;2;2;225;58;58;2;1;0;3;4;225;1;272;3;1;0
/org.eclipse.ui.workbench/Eclipse UI/org/eclipse/ui/internal/registry/ViewRegistry.java;5;1;9;2;4;4;4;5;193;1;5;61;354;354;1;0;0;5;9;61;0;336;9;5;1
/org.eclipse.ui.workbench/Eclipse UI/org/eclipse/ui/internal/themes/CascadingMap.java;1;0;1;1;0;0;0;1;0;0;1;250;0;0;1;0;0;1;1;250;0;250;1;1;0
/org.eclipse.jdt.launching/launching/org/eclipse/jdt/internal/launching/VMDefinitionsContainer.java;2;0;7;2;1;1;1;6;53;2;4;48;99;99;2;2;0;6;7;48;2;299;5;2;2
/org.eclipse.pde.core/src/org/eclipse/pde/internal/core/plugin/PluginBase.java;3;3;14;2;6;3;6;8;187;2;7;128;509;509;3;1;3;8;14;288;4;336;10;3;0
/org.eclipse.pde.ui/src/org/eclipse/pde/internal/ui/editor/plugin/NewElementAction.java;2;1;4;1;4;4;4;0;14;0;0;292;20;20;1;0;0;0;4;292;0;336;4;2;0
/org.eclipse.ui.workbench/Eclipse UI/org/eclipse/ui/part/MultiEditor.java;4;1;8;1;2;2;2;6;183;3;3;118;233;233;3;3;0;6;8;239;3;336;5;4;0
/org.eclipse.jdt.ui/ui refactoring/org/eclipse/jdt/internal/ui/refactoring/reorg/ReorgQueries.java;4;1;6;2;2;2;2;4;84;2;3;70;136;136;2;1;0;4;6;180;1;336;5;4;0
/org.eclipse.pde.ui/src/org/eclipse/pde/internal/ui/editor/plugin/DependencyAnalysisSection.java;2;2;5;1;5;3;5;0;50;0;0;292;84;84;2;0;2;0;5;308;2;330;3;2;0
/org.eclipse.jdt.debug/model/org/eclipse/jdt/internal/debug/core/model/JDIReferenceType.java;4;1;6;2;2;2;2;4;109;3;2;128;161;161;3;2;0;4;6;128;2;336;4;4;1
/org.eclipse.ui.console/src/org/eclipse/ui/console/MessageConsole.java;3;1;7;1;2;2;2;5;52;2;4;118;104;104;2;1;0;5;7;118;1;336;6;3;0
/org.eclipse.ui.workbench/Eclipse UI/org/eclipse/ui/internal/decorators/DecoratorManager.java;5;3;14;2;5;3;5;9;82;2;7;75;255;255;3;2;2;9;14;306;4;336;10;5;1
/org.eclipse.pde.ui/src/org/eclipse/pde/internal/ui/wizards/plugin/AbstractFieldData.java;3;1;4;1;3;3;3;1;10;0;1;222;16;16;1;0;0;1;4;222;0;336;4;3;0
/org.eclipse.ui.workbench/Eclipse UI/org/eclipse/ui/IEditorSite.java;2;0;2;1;1;1;1;1;2;0;1;212;4;4;1;0;0;1;2;212;0;336;2;2;0
/org.eclipse.jface.text/src/org/eclipse/jface/text/source/IVerticalRulerColumn.java;2;0;2;2;2;1;2;0;14;0;0;336;14;14;2;0;1;0;2;336;1;336;1;2;0
/org.eclipse.core.resources/src/org/eclipse/core/internal/resources/ICoreConstants.java;2;1;2;1;2;2;2;0;17;0;0;277;27;27;1;0;0;0;2;277;0;306;2;2;1
/org.eclipse.swt/Eclipse SWT Browser/common/org/eclipse/swt/browser/LocationEvent.java;2;0;8;1;1;1;1;7;15;2;6;100;52;52;2;1;0;7;8;100;1;337;7;2;0
/org.eclipse.ui.ide/src/org/eclipse/ui/views/markers/internal/Messages.java;1;0;1;1;0;0;0;1;0;0;1;129;0;0;1;0;0;1;1;129;0;129;1;1;0
/org.eclipse.swt/Eclipse SWT PI/motif/org/eclipse/swt/internal/motif/XmDropProcCallbackStruct.java;1;0;2;1;0;0;0;2;4;0;1;54;4;4;2;1;0;2;2;54;1;54;1;1;0
/org.eclipse.ltk.core.refactoring/src/org/eclipse/ltk/core/refactoring/participants/ProcessorBasedRefactoring.java;2;1;15;2;3;3;12;3;203;0;1;264;230;230;12;2;9;12;15;264;11;336;4;2;0
/org.eclipse.ui.editors/src/org/eclipse/ui/texteditor/TextEditorMessages.java;1;0;1;1;1;1;1;0;17;0;0;336;17;17;1;0;0;0;1;336;0;336;1;1;0
/org.eclipse.jdt.ui/core extension/org/eclipse/jdt/internal/corext/dom/fragments/IASTFragment.java;1;0;1;1;1;1;1;0;2;0;0;336;2;2;1;0;0;0;1;336;0;336;1;1;0
/org.eclipse.jdt.junit/src/org/eclipse/jdt/internal/junit/util/IJUnitStatusConstants.java;1;0;1;1;1;1;1;0;2;0;0;336;2;2;1;0;0;0;1;336;0;336;1;1;0
/org.eclipse.ltk.core.refactoring/src/org/eclipse/ltk/internal/core/refactoring/UndoManager.java;1;1;5;1;3;3;3;2;130;0;1;264;205;205;2;1;0;2;5;264;1;336;4;1;0
/org.eclipse.swt/Eclipse SWT/common/org/eclipse/swt/events/MouseTrackAdapter.java;1;0;2;1;1;1;1;1;4;0;1;204;6;6;1;0;0;1;2;204;0;337;2;1;0
/org.eclipse.swt/Eclipse SWT/gtk/org/eclipse/swt/graphics/Cursor.java;4;1;11;2;3;3;3;8;109;2;6;16;362;362;2;2;0;8;11;16;2;337;9;4;1
/org.eclipse.ui.console/src/org/eclipse/ui/console/IConsoleListener.java;1;0;1;1;0;0;0;1;0;0;1;118;0;0;1;0;0;1;1;118;0;118;1;1;0
/org.eclipse.ui.workbench.texteditor/src/org/eclipse/ui/texteditor/IDocumentProviderExtension3.java;3;0;4;2;1;1;1;3;22;1;3;76;24;24;1;0;0;3;4;76;0;336;4;3;0
/org.eclipse.ui.workbench/Eclipse UI/org/eclipse/ui/internal/themes/IThemeElementDefinition.java;1;0;1;1;0;0;0;1;0;0;1;241;0;0;1;0;0;1;1;241;0;241;1;1;0
/org.eclipse.pde.ui/src/org/eclipse/pde/internal/ui/editor/feature/NewFeaturePluginWizardPage.java;2;1;3;1;2;2;2;1;19;0;1;232;33;33;1;0;0;1;3;232;0;336;3;2;0
/org.eclipse.ui.cheatsheets/src/org/eclipse/ui/internal/cheatsheets/data/IParserTags.java;2;3;8;2;5;2;5;3;115;2;2;243;169;169;3;1;3;3;8;279;4;306;4;2;0
/org.eclipse.ui.workbench/Eclipse UI/org/eclipse/ui/internal/ActivateEditorAction.java;1;0;1;1;0;0;0;1;20;0;1;157;20;20;1;0;0;1;1;157;0;157;1;1;0
/org.eclipse.pde.core/src/org/eclipse/pde/internal/core/RequiredPluginsInitializer.java;1;0;3;1;1;1;1;2;6;1;2;161;10;10;1;0;0;2;3;161;0;336;3;1;0
/org.eclipse.team.ui/src/org/eclipse/team/internal/ui/synchronize/actions/ExpandAllAction.java;1;1;4;1;2;2;2;2;55;1;2;221;70;70;1;0;0;2;4;221;0;336;4;1;0
/org.eclipse.jdt.core/compiler/org/eclipse/jdt/internal/compiler/ast/IfStatement.java;2;0;8;1;1;1;1;7;39;2;6;61;138;138;2;1;0;7;8;61;1;288;7;2;0
/org.eclipse.jdt.ui/ui/org/eclipse/jdt/internal/ui/javaeditor/JavaAnnotationIterator.java;3;0;4;1;1;1;1;3;26;1;3;130;45;45;1;0;0;3;4;130;0;336;4;3;0
/org.eclipse.team.core/src/org/eclipse/team/internal/core/TeamPlugin.java;2;2;9;2;5;4;5;4;50;2;3;52;143;143;2;1;1;4;9;52;2;336;7;2;0
/org.eclipse.compare/compare/org/eclipse/compare/internal/BufferedResourceNode.java;1;1;4;1;2;2;2;2;21;1;2;79;43;43;1;0;0;2;4;79;0;337;4;1;0
/org.eclipse.jdt.ui/ui/org/eclipse/jdt/internal/ui/dialogs/TypeSelectionDialog.java;3;1;3;1;3;3;3;0;74;0;0;302;89;89;1;0;0;0;3;302;0;336;3;3;0
/org.eclipse.search/search/org/eclipse/search/internal/ui/text/GotoMarkerAction.java;1;0;3;1;1;1;1;2;7;1;2;157;12;12;1;0;0;2;3;157;0;336;3;1;0
/org.eclipse.jdt.debug/jdi interfaces/com/sun/jdi/Field.java;1;0;1;1;0;0;0;1;3;0;1;235;3;3;1;0;0;1;1;235;0;235;1;1;0
/org.eclipse.jdt.core/compiler/org/eclipse/jdt/internal/compiler/problem/ProblemHandler.java;4;0;4;2;2;1;2;2;17;1;2;199;21;21;2;0;1;2;4;296;1;296;3;4;0
/org.eclipse.team.cvs.ui/src/org/eclipse/team/internal/ccvs/ui/HistoryDropAdapter.java;2;1;2;1;2;2;2;0;2;0;0;320;4;4;1;0;0;0;2;320;0;336;2;2;0
/org.eclipse.jdt.core/compiler/org/eclipse/jdt/internal/compiler/codegen/ConstantPool.java;5;0;7;3;2;1;2;5;164;2;4;16;358;358;2;1;1;5;7;31;2;314;5;5;0
/org.eclipse.swt/Eclipse SWT/common/org/eclipse/swt/internal/image/FileFormat.java;1;0;1;1;0;0;0;1;2;0;1;26;2;2;1;0;0;1;1;26;0;26;1;1;1
/org.eclipse.ui.ide/src/org/eclipse/ui/internal/ide/dialogs/CleanDialog.java;3;4;8;1;7;3;7;1;199;0;1;254;252;252;4;0;4;1;8;306;4;331;4;3;1
/org.eclipse.team.ui/src/org/eclipse/team/internal/ui/preferences/TextPreferencePage.java;1;1;4;1;2;2;2;2;402;1;2;63;468;468;1;0;0;2;4;63;0;336;4;1;0
/org.eclipse.jdt.core/search/org/eclipse/jdt/internal/core/search/matching/DeclarationOfReferencedTypesPattern.java;2;0;8;2;1;1;1;7;129;3;5;38;206;206;3;2;0;7;8;70;2;280;6;2;0
/org.eclipse.debug.ui/ui/org/eclipse/debug/internal/ui/views/memory/AbstractMemoryRenderer.java;2;0;2;2;2;1;2;0;6;0;0;282;6;6;2;0;1;0;2;282;1;282;1;2;1
/org.eclipse.jdt.ui/core refactoring/org/eclipse/jdt/internal/corext/refactoring/reorg/SourceReferenceUtil.java;3;0;3;1;1;1;1;2;18;1;2;73;25;25;1;0;0;2;3;73;0;336;3;3;0
/org.eclipse.update.core/src/org/eclipse/update/internal/core/PatchedFeature.java;2;0;2;1;1;1;1;1;4;0;1;225;4;4;1;0;0;1;2;225;0;302;2;2;0
/org.eclipse.debug.ui/ui/org/eclipse/debug/internal/ui/sourcelookup/SourceElementLabelProvider.java;1;0;1;1;0;0;0;1;0;0;1;252;0;0;1;0;0;1;1;252;0;252;1;1;0
/org.eclipse.text/src/org/eclipse/jface/text/link/LinkedModeManager.java;2;1;2;1;2;2;2;0;6;0;0;276;6;6;1;0;0;0;2;276;0;336;2;2;0
/org.eclipse.jdt.ui/core extension/org/eclipse/jdt/internal/corext/util/WorkingCopyUtil.java;3;0;5;1;1;1;1;4;45;3;2;70;86;86;3;2;0;4;5;70;2;336;3;3;0
/org.eclipse.update.core/src/org/eclipse/update/core/Category.java;2;1;3;1;2;2;2;1;6;0;1;58;12;12;1;0;0;1;3;58;0;336;3;2;0
/org.eclipse.jface/src/org/eclipse/jface/wizard/Wizard.java;1;0;3;1;1;1;1;2;676;1;2;0;680;680;1;0;0;2;3;0;0;293;3;1;0
/org.eclipse.team.cvs.ui/src/org/eclipse/team/internal/ccvs/ui/subscriber/WorkspaceCommitOperation.java;2;2;4;1;4;3;4;0;331;0;0;294;345;345;2;0;1;0;4;294;1;336;3;2;1
/org.eclipse.team.cvs.ui/src/org/eclipse/team/internal/ccvs/ui/wizards/NewLocationWizard.java;2;1;4;1;2;2;2;2;73;0;1;254;86;86;2;1;0;2;4;254;1;336;3;2;0
/org.eclipse.ant.ui/Ant Editor/org/eclipse/ant/internal/ui/dtd/util/IMapHolder.java;1;0;1;1;0;0;0;1;0;0;1;108;0;0;1;0;0;1;1;108;0;108;1;1;0
/org.eclipse.debug.core/core/org/eclipse/debug/internal/core/memory/IMemoryRenderingFactory.java;1;0;1;1;1;1;1;0;0;0;0;282;0;0;1;0;0;0;1;282;0;282;1;1;0
/org.eclipse.jdt.ui/ui/org/eclipse/jdt/internal/ui/filters/NamePatternFilter.java;1;0;2;1;1;1;1;1;11;0;1;11;13;13;1;0;0;1;2;11;0;336;2;1;0
/org.eclipse.pde.core/src/org/eclipse/pde/internal/core/build/IBuildObject.java;1;1;2;1;2;2;2;0;19;0;0;290;19;19;1;0;0;0;2;290;0;308;2;1;0
/org.eclipse.jdt.core/model/org/eclipse/jdt/internal/core/builder/NameSet.java;2;0;3;2;1;1;1;2;64;1;2;156;76;76;1;0;0;2;3;156;0;309;3;2;0
/org.eclipse.ui.workbench.texteditor/src/org/eclipse/ui/texteditor/templates/TemplatePreferencePage.java;3;4;13;2;8;4;8;5;115;3;2;253;317;317;4;3;4;5;13;279;7;336;6;3;0
/org.eclipse.ui.ide/src/org/eclipse/ui/views/navigator/INavigatorHelpContextIds.java;2;0;2;1;0;0;0;2;4;1;2;129;4;4;1;0;0;2;2;129;0;187;2;2;0
/org.eclipse.jdt.core/model/org/eclipse/jdt/internal/core/jdom/DOMField.java;3;1;5;1;2;2;2;3;7;1;3;7;27;27;1;0;0;3;5;7;0;314;5;3;0
/org.eclipse.pde.ui/src/org/eclipse/pde/internal/ui/search/PluginSearchUIOperation.java;2;1;3;1;2;2;2;1;8;0;1;168;18;18;1;0;0;1;3;168;0;336;3;2;0
/org.eclipse.ui.workbench.texteditor/src/org/eclipse/ui/texteditor/IDocumentProvider.java;2;1;3;2;2;2;2;1;50;0;1;122;59;59;1;0;0;1;3;122;0;336;3;2;0
/org.eclipse.jdt.ui/ui/org/eclipse/jdt/internal/ui/javaeditor/JavaDocumentSetupParticipant.java;2;0;2;1;1;1;1;1;20;0;1;243;20;20;1;0;0;1;2;243;0;336;2;2;0
/org.eclipse.jdt.ui/core refactoring/org/eclipse/jdt/internal/corext/refactoring/rename/RippleMethodFinder.java;3;3;6;1;4;2;4;2;99;1;2;18;157;157;3;0;2;2;6;290;2;336;4;3;0
/org.eclipse.jdt.launching.macosx/macosx/org/eclipse/jdt/internal/launching/macosx/MacOSXLaunchingPlugin.java;1;0;8;1;0;0;0;8;258;2;6;10;607;607;2;2;0;8;8;10;2;219;6;1;0
/org.eclipse.jdt.core/batch/org/eclipse/jdt/internal/compiler/batch/FileSystem.java;3;0;4;2;0;0;0;4;50;2;3;19;69;69;2;1;0;4;4;199;1;199;3;3;0
/org.eclipse.pde.ui/src/org/eclipse/pde/internal/ui/editor/SystemFileEditorInputFactory.java;2;1;3;1;3;3;3;0;4;0;0;292;6;6;1;0;0;0;3;292;0;336;3;2;0
/org.eclipse.team.core/src/org/eclipse/team/internal/core/subscribers/SyncInfoTreeChangeEvent.java;2;0;3;1;1;1;1;2;95;1;2;223;97;97;1;0;0;2;3;223;0;336;3;2;0
/org.eclipse.osgi/resolver/src/org/eclipse/core/internal/dependencies/ResolutionDelta.java;3;2;4;2;3;2;3;1;73;0;1;171;75;75;2;0;1;1;4;276;1;296;3;3;0
/org.eclipse.ui.workbench/Eclipse UI/org/eclipse/ui/internal/commands/ws/SelectAllHandler.java;1;0;1;1;1;1;1;0;0;0;0;294;0;0;1;0;0;0;1;294;0;294;1;1;1
/org.eclipse.jdt.debug/model/org/eclipse/jdt/internal/debug/core/model/JDIClassType.java;3;0;4;1;0;0;0;4;49;2;3;45;89;89;2;1;0;4;4;128;1;128;3;3;0
/org.eclipse.ui.workbench/Eclipse UI/org/eclipse/ui/internal/dialogs/NewWizardActivityFilter.java;1;0;1;1;1;1;1;0;0;0;0;272;0;0;1;0;0;0;1;272;0;272;1;1;0
/org.eclipse.debug.ui/ui/org/eclipse/debug/internal/ui/views/memory/GoToAddressAction.java;1;0;1;1;1;1;1;0;0;0;0;282;0;0;1;0;0;0;1;282;0;282;1;1;0
/org.eclipse.jdt.core/compiler/org/eclipse/jdt/internal/compiler/ast/ArrayAllocationExpression.java;2;0;4;1;1;1;1;3;31;1;3;63;40;40;1;0;0;3;4;63;0;299;4;2;1
/org.eclipse.jface.text/src/org/eclipse/jface/text/source/VerticalRuler.java;2;2;10;2;3;2;4;6;42;2;6;82;119;119;2;0;2;7;10;269;2;336;8;2;0
/org.eclipse.ant.core/src/org/eclipse/ant/internal/core/AntClasspathEntry.java;1;0;7;1;1;1;1;6;27;2;5;149;65;65;2;1;0;6;7;175;1;312;6;1;0
/org.eclipse.ui.externaltools/Program Tools Support/org/eclipse/ui/externaltools/internal/program/launchConfigurations/ProgramTabGroup.java;3;0;6;2;0;0;0;6;7;2;5;19;19;19;2;1;0;6;6;19;1;125;5;3;0
/org.eclipse.team.cvs.core/src/org/eclipse/team/internal/ccvs/core/client/FileStructureVisitor.java;1;0;3;1;0;0;0;3;17;2;2;73;26;26;2;1;0;3;3;73;1;110;2;1;0
/org.eclipse.jdt.core/compiler/org/eclipse/jdt/internal/compiler/codegen/ExceptionLabel.java;2;0;2;1;0;0;0;2;47;1;2;11;49;49;1;0;0;2;2;11;0;199;2;2;0
/org.eclipse.ui.workbench/Eclipse UI/org/eclipse/ui/internal/EditorList.java;4;1;4;1;2;2;2;2;10;1;2;151;20;20;1;0;0;2;4;151;0;336;4;4;0
/org.eclipse.jdt.ui/ui/org/eclipse/jdt/internal/ui/actions/AddBlockCommentAction.java;3;2;5;2;3;2;3;2;226;1;2;100;238;238;2;0;1;2;5;274;1;336;4;3;0
/org.eclipse.jface/src/org/eclipse/jface/action/IAction.java;5;3;6;3;5;3;5;1;42;0;1;0;51;51;3;0;2;1;6;276;2;336;4;5;0
/org.eclipse.osgi/defaultAdaptor/src/org/eclipse/osgi/framework/internal/defaultadaptor/DefaultPermissionStorage.java;2;1;4;1;4;4;4;0;20;0;0;276;29;29;1;0;0;0;4;276;0;336;4;2;1
/org.eclipse.jdt.core/eval/org/eclipse/jdt/internal/eval/CodeSnippetCodeStream.java;4;1;6;2;2;2;2;4;152;2;3;67;289;289;2;1;0;4;6;67;1;315;5;4;0
/org.eclipse.update.ui/src/org/eclipse/update/internal/ui/model/FeatureReferenceAdapter.java;1;0;1;1;0;0;0;1;15;0;1;58;15;15;1;0;0;1;1;58;0;58;1;1;0
/org.eclipse.update.ui/src/org/eclipse/update/internal/ui/model/FeatureAdapter.java;1;0;1;1;0;0;0;1;6;0;1;58;6;6;1;0;0;1;1;58;0;58;1;1;0
/org.eclipse.compare/compare/org/eclipse/compare/ICompareNavigator.java;1;0;2;1;0;0;0;2;2;1;2;104;2;2;1;0;0;2;2;104;0;219;2;1;0
/org.eclipse.pde.ui/src_Forms/org/eclipse/pde/internal/ui/model/bundle/Bundle.java;3;5;7;3;7;3;7;0;77;0;0;293;87;87;5;0;4;0;7;293;4;336;3;3;0
/org.eclipse.ui.cheatsheets/src/org/eclipse/ui/internal/cheatsheets/data/IPerformWhenItem.java;1;0;1;1;1;1;1;0;0;0;0;279;0;0;1;0;0;0;1;279;0;279;1;1;0
/org.eclipse.jdt.core/dom/org/eclipse/jdt/core/dom/PackageDeclaration.java;3;0;12;1;3;1;3;9;264;5;4;199;327;327;5;5;2;9;12;230;7;276;5;3;2
/org.eclipse.search/search/org/eclipse/search/internal/ui/OpenSearchDialogAction.java;1;0;1;1;1;1;1;0;2;0;0;336;2;2;1;0;0;0;1;336;0;336;1;1;0
/org.eclipse.ui.ide/src/org/eclipse/ui/views/bookmarkexplorer/BookmarkNavigator.java;4;1;5;1;2;2;2;3;6;1;3;129;16;16;1;0;0;3;5;129;0;336;5;4;0
/org.eclipse.team.cvs.ui/src/org/eclipse/team/internal/ccvs/ui/subscriber/ChangeLogModelSorter.java;1;0;3;1;3;1;3;0;128;0;0;294;128;128;3;0;2;0;3;294;2;294;1;1;0
/org.eclipse.ui.workbench/Eclipse UI/org/eclipse/ui/about/ISystemSummarySection.java;1;0;1;1;1;1;1;0;0;0;0;294;0;0;1;0;0;0;1;294;0;294;1;1;0
/org.eclipse.jdt.debug.ui/ui/org/eclipse/jdt/debug/ui/JavaUISourceLocator.java;2;1;3;1;2;2;2;1;22;0;1;76;29;29;1;0;0;1;3;76;0;336;3;2;0
/org.eclipse.core.resources/src/org/eclipse/core/internal/events/BuildManager.java;2;2;22;1;6;4;6;16;1283;3;9;90;1755;1755;3;7;2;16;22;266;9;332;13;2;3
/org.eclipse.ui.intro/src/org/eclipse/ui/internal/intro/impl/model/IntroExtensionContent.java;1;5;7;1;7;2;7;0;22;0;0;276;26;26;5;0;5;0;7;276;5;328;2;1;0
/org.eclipse.jdt.ui/ui/org/eclipse/jdt/internal/ui/wizards/dialogfields/StringDialogField.java;3;1;3;1;2;2;2;1;19;0;1;267;31;31;1;0;0;1;3;267;0;336;3;3;0
/org.eclipse.search/search/org/eclipse/search/internal/ui/util/FileTypeEditor.java;1;0;3;1;1;1;1;2;4;1;2;42;8;8;1;0;0;2;3;42;0;336;3;1;0
/org.eclipse.jdt.ui/core refactoring/org/eclipse/jdt/internal/corext/refactoring/tagging/ITextUpdating.java;3;0;3;1;1;1;1;2;57;1;2;71;59;59;1;0;0;2;3;71;0;336;3;3;1
/org.eclipse.pde.build/src/org/eclipse/pde/internal/build/XMLWriter.java;2;1;7;1;2;2;2;5;15;2;3;31;30;30;2;2;0;5;7;31;2;306;5;2;0
/org.eclipse.ui.ide/src/org/eclipse/ui/views/navigator/NavigatorDragAdapter.java;1;0;1;1;0;0;0;1;0;0;1;129;0;0;1;0;0;1;1;129;0;129;1;1;0
/org.eclipse.search/new search/org/eclipse/search2/internal/ui/ThrottlingProgressMonitor.java;2;2;6;1;5;4;5;1;53;0;1;195;56;56;2;0;1;1;6;286;1;336;5;2;0
/org.eclipse.swt/Eclipse SWT/common/org/eclipse/swt/events/VerifyEvent.java;1;0;1;1;0;0;0;1;21;0;1;156;21;21;1;0;0;1;1;156;0;156;1;1;0
/org.eclipse.update.core/src/org/eclipse/update/configuration/LocalSystemInfo.java;2;1;4;1;3;3;3;1;12;0;1;58;30;30;1;0;0;1;4;58;0;336;4;2;0
/org.eclipse.jface/src/org/eclipse/jface/dialogs/IDialogBlockedHandler.java;2;4;5;1;5;2;5;0;29;0;0;288;33;33;4;0;3;0;5;288;3;336;2;2;0
/org.eclipse.jdt.ui/ui/org/eclipse/jdt/ui/actions/ExtractTempAction.java;3;0;8;1;1;1;1;7;43;2;6;9;84;84;2;1;0;7;8;9;1;336;7;3;1
/org.eclipse.pde.ui/src/org/eclipse/pde/internal/ui/editor/feature/HandlerSection.java;3;4;9;2;6;3;6;3;119;1;3;26;175;175;4;0;3;3;9;302;3;336;6;3;0
/org.eclipse.update.core/src/org/eclipse/update/standalone/DisableCommand.java;1;2;8;1;6;5;6;2;78;1;2;54;115;115;2;0;1;2;8;292;1;336;7;1;0
/org.eclipse.osgi/core/framework/org/eclipse/osgi/framework/internal/core/BundlePermissions.java;5;1;7;3;2;2;4;3;594;3;3;171;630;630;3;0;2;5;7;270;2;336;5;5;0
/org.eclipse.pde.ui/src_Forms/org/eclipse/pde/internal/ui/model/plugin/PluginExtensionPointNode.java;3;3;8;3;6;3;6;2;36;1;2;244;95;95;3;0;3;2;8;297;3;335;5;3;0
/org.eclipse.ui.ide/src/org/eclipse/ui/internal/ide/misc/ProjectCapabilitySelectionGroup.java;1;0;1;1;0;0;0;1;0;0;1;132;0;0;1;0;0;1;1;132;0;132;1;1;0
/org.eclipse.jdt.debug.ui/ui/org/eclipse/jdt/internal/debug/ui/jres/AddVMDialog.java;4;0;7;2;0;0;0;7;159;2;5;65;265;265;2;2;0;7;7;113;2;264;5;4;1
/org.eclipse.jdt.core/antadapter/org/eclipse/jdt/core/CheckDebugAttributes.java;3;0;5;2;0;0;0;5;16;2;3;96;20;20;2;2;0;5;5;178;2;199;3;3;0
/org.eclipse.jdt.core/dom/org/eclipse/jdt/core/dom/BlockComment.java;2;0;7;1;1;1;1;6;39;2;4;206;49;49;2;2;0;6;7;230;2;283;5;2;1
/org.eclipse.jdt.core/dom/org/eclipse/jdt/core/dom/PackageBinding.java;2;0;3;2;0;0;0;3;6;2;2;13;8;8;2;1;0;3;3;13;1;199;2;2;2
/org.eclipse.ui.workbench/Eclipse UI/org/eclipse/ui/internal/layout/GridInfo.java;1;0;1;1;1;1;1;0;0;0;0;271;0;0;1;0;0;0;1;271;0;271;1;1;0
/org.eclipse.ui.workbench/Eclipse UI/org/eclipse/ui/IEditorInput.java;2;0;3;1;0;0;0;3;44;1;3;0;52;52;1;0;0;3;3;0;0;157;3;2;0
/org.eclipse.swt/Eclipse SWT/gtk/org/eclipse/swt/widgets/TabFolder.java;6;1;16;2;3;3;3;13;39;3;9;19;127;127;3;4;0;13;16;129;4;337;12;6;1
/org.eclipse.core.runtime/src/org/eclipse/core/internal/jobs/ThreadJob.java;2;0;3;2;3;1;3;0;14;0;0;292;14;14;3;0;2;0;3;292;2;292;1;2;0
/org.eclipse.help.ui/src/org/eclipse/help/ui/browser/LaunchURL.java;1;1;6;1;4;4;4;2;35;1;2;73;72;72;1;0;0;2;6;73;0;336;6;1;0
/org.eclipse.debug.ui/ui/org/eclipse/debug/internal/ui/views/memory/MemoryViewTabLabelProvider.java;2;1;2;1;2;2;2;0;18;0;0;282;18;18;1;0;0;0;2;282;0;304;2;2;0
/org.eclipse.jdt.core/search/org/eclipse/jdt/core/search/SearchRequestor.java;2;3;6;1;4;2;4;2;123;1;2;181;126;126;3;0;2;2;6;276;2;314;4;2;0
/org.eclipse.help.ide/src/org/eclipse/help/ui/internal/ide/HelpIdeResources.java;1;1;6;1;3;3;3;3;80;2;2;106;122;122;2;1;0;3;6;253;1;336;5;1;0
/org.eclipse.pde.ui/src/org/eclipse/pde/internal/ui/editor/context/UTF8InputContext.java;2;1;3;1;3;3;3;0;10;0;0;292;12;12;1;0;0;0;3;292;0;336;3;2;0
/org.eclipse.update.configurator/src/org/eclipse/update/internal/configurator/branding/IBundleGroupConstants.java;1;0;2;1;1;1;1;1;6;0;1;247;6;6;1;0;0;1;2;247;0;293;2;1;0
/org.eclipse.ui.workbench/Eclipse UI/org/eclipse/ui/internal/progress/ProgressViewer.java;2;0;6;1;0;0;0;6;100;5;2;228;128;128;5;4;0;6;6;228;4;260;2;2;0
/org.eclipse.ui.workbench/Eclipse UI/org/eclipse/ui/internal/dialogs/ActivitiesPreferencePage.java;1;1;2;1;2;2;2;0;52;0;0;301;52;52;1;0;0;0;2;301;0;319;2;1;0
/org.eclipse.team.cvs.ui/src/org/eclipse/team/internal/ccvs/ui/model/AllRootsElement.java;1;0;1;1;0;0;0;1;2;0;1;63;2;2;1;0;0;1;1;63;0;63;1;1;0
/org.eclipse.pde.ui/src/org/eclipse/pde/internal/ui/editor/site/SiteFeatureAdapter.java;1;0;2;1;1;1;1;1;10;0;1;208;10;10;1;0;0;1;2;208;0;336;2;1;0
/org.eclipse.swt/Eclipse SWT PI/motif/org/eclipse/swt/internal/motif/XColor.java;1;0;1;1;0;0;0;1;4;0;1;54;4;4;1;0;0;1;1;54;0;54;1;1;0
/org.eclipse.help/src/org/eclipse/help/HelpSystem.java;1;1;7;1;3;3;3;4;89;2;3;105;146;146;2;1;0;4;7;156;1;336;6;1;0
/org.eclipse.jdt.core/model/org/eclipse/jdt/core/ICompilationUnit.java;4;0;24;2;1;1;4;20;606;7;11;54;1042;1042;7;9;3;23;24;54;12;312;12;4;0
/org.eclipse.jdt.core/compiler/org/eclipse/jdt/internal/compiler/ast/JavadocAllocationExpression.java;4;0;10;2;0;0;0;10;77;5;4;165;110;110;5;6;0;10;10;175;6;218;4;4;0
/org.eclipse.core.runtime/src/org/eclipse/core/internal/runtime/AssertionFailedException.java;2;1;5;2;2;2;2;3;139;0;1;171;144;144;3;2;0;3;5;171;2;336;3;2;0
/org.eclipse.jdt.ui/ui/org/eclipse/jdt/internal/ui/callhierarchy/CallHierarchyLabelDecorator.java;3;0;4;1;1;1;1;3;5;1;3;18;11;11;1;0;0;3;4;18;0;336;4;3;0
/org.eclipse.ui.cheatsheets/src/org/eclipse/ui/internal/cheatsheets/views/NoopAction.java;2;0;2;1;0;0;0;2;17;1;2;243;17;17;1;0;0;2;2;243;0;253;2;2;0
/org.eclipse.jdt.ui/ui/org/eclipse/jdt/internal/ui/search/ReferenceScopeFactory.java;1;0;4;1;2;1;2;2;165;1;2;219;177;177;2;0;1;2;4;290;1;290;3;1;0
/org.eclipse.swt.tools/JNI Generation/org/eclipse/swt/tools/internal/JNIGenerator.java;2;0;3;2;0;0;0;3;86;2;2;230;103;103;2;1;0;3;3;230;1;265;2;2;0
/org.eclipse.ui.workbench/Eclipse UI/org/eclipse/ui/intro/IIntroManager.java;2;3;6;2;5;2;5;1;138;0;1;270;146;146;3;0;3;1;6;279;3;290;3;2;0
/org.eclipse.update.ui/src/org/eclipse/update/internal/ui/views/UninstallFeatureAction.java;3;2;12;2;3;2;3;9;68;2;6;54;128;128;2;3;1;9;12;54;4;336;8;3;1
/org.eclipse.jdt.ui/ui/org/eclipse/jdt/ui/wizards/BuildPathDialogAccess.java;1;3;4;1;4;2;4;0;474;0;0;276;492;492;3;0;2;0;4;276;2;336;2;1;0
/org.eclipse.jdt.debug/model/org/eclipse/jdt/internal/debug/core/logicalstructures/LogicalStructuresMessages.java;2;0;2;1;0;0;0;2;11;1;2;152;11;11;1;0;0;2;2;152;0;176;2;2;0
/org.eclipse.jdt.core/search/org/eclipse/jdt/internal/core/search/indexing/IndexAllProject.java;4;1;15;3;2;2;3;12;54;4;8;60;151;151;4;4;1;13;15;178;5;324;10;4;0
/org.eclipse.ui.workbench/Eclipse UI/org/eclipse/ui/internal/CyclePartAction.java;7;2;28;3;3;2;3;25;765;7;9;16;1104;1104;7;16;1;25;28;148;17;336;11;7;1
/org.eclipse.text/src/org/eclipse/jface/text/AbstractDocument.java;3;3;10;3;4;2;4;6;284;1;6;82;788;788;3;0;2;6;10;274;2;334;8;3;0
/org.eclipse.jdt.ui/ui/org/eclipse/jdt/ui/actions/OpenViewActionGroup.java;4;1;4;1;2;2;2;2;21;1;2;18;43;43;1;0;0;2;4;18;0;336;4;4;0
/org.eclipse.jdt.core/compiler/org/eclipse/jdt/internal/compiler/env/IBinaryNestedType.java;1;0;1;1;0;0;0;1;2;0;1;199;2;2;1;0;0;1;1;199;0;199;1;1;0
/org.eclipse.swt/Eclipse SWT/common/org/eclipse/swt/events/MouseEvent.java;1;0;1;1;0;0;0;1;16;0;1;156;16;16;1;0;0;1;1;156;0;156;1;1;0
/org.eclipse.ui.ide/extensions/org/eclipse/ui/actions/OpenWithMenu.java;4;1;4;1;2;2;2;2;12;1;2;132;16;16;1;0;0;2;4;132;0;336;4;4;0
/org.eclipse.jdt.core/compiler/org/eclipse/jdt/internal/compiler/ast/LongLiteral.java;2;0;2;1;0;0;0;2;4;1;2;170;6;6;1;0;0;2;2;170;0;199;2;2;0
/org.eclipse.jdt.ui/ui/org/eclipse/jdt/internal/ui/packageview/ClassPathContainer.java;3;3;8;2;4;2;4;4;102;3;2;49;149;149;3;2;2;4;8;239;4;336;4;3;0
/org.eclipse.osgi/defaultAdaptor/src/org/eclipse/osgi/framework/internal/defaultadaptor/DevClassPathHelper.java;2;1;5;2;3;3;3;2;14;0;1;250;23;23;2;1;0;2;5;250;1;295;4;2;0
/org.eclipse.pde.ui/src/org/eclipse/pde/internal/ui/editor/ModelUndoManager.java;2;1;4;1;3;3;3;1;16;0;1;166;35;35;1;0;0;1;4;166;0;336;4;2;0
/org.eclipse.help.base/src/org/eclipse/help/browser/IBrowserFactory.java;1;1;4;1;2;2;2;2;16;0;1;104;24;24;2;1;0;2;4;104;1;336;3;1;0
/org.eclipse.jdt.core/model/org/eclipse/jdt/internal/core/PackageFragment.java;3;3;29;3;4;2;4;25;330;9;11;10;493;493;9;14;2;25;29;51;16;300;13;3;0
/org.eclipse.ant.ui/Ant Tools Support/org/eclipse/ant/internal/ui/launchConfigurations/TargetOrderDialog.java;1;0;5;1;0;0;0;5;95;4;2;108;124;124;4;3;0;5;5;108;3;219;2;1;2
/org.eclipse.swt.tools/JNI Generation/org/eclipse/swt/tools/internal/JNIGeneratorApp.java;3;0;6;2;2;1;2;4;126;3;2;230;161;161;3;2;1;4;6;230;3;287;3;3;0
/org.eclipse.jdt.ui/ui/org/eclipse/jdt/internal/ui/text/FastJavaPartitionScanner.java;2;0;2;1;1;1;1;1;24;0;1;240;26;26;1;0;0;1;2;240;0;336;2;2;0
/org.eclipse.update.ui/src/org/eclipse/update/internal/ui/wizards/TableLayoutComposite.java;1;1;2;1;2;2;2;0;6;0;0;321;6;6;1;0;0;0;2;321;0;336;2;1;0
/org.eclipse.ltk.core.refactoring/src/org/eclipse/ltk/internal/core/refactoring/UndoDocumentChange.java;1;1;3;1;2;2;2;1;3;0;1;267;5;5;1;0;0;1;3;267;0;336;3;1;0
/org.eclipse.jdt.ui/ui/org/eclipse/jdt/internal/ui/text/correction/AddArgumentCorrectionProposal.java;2;1;12;1;2;2;2;10;29;4;7;63;115;115;4;3;0;10;12;63;3;336;9;2;0
/org.eclipse.swt/Eclipse SWT/gtk/org/eclipse/swt/widgets/ProgressBar.java;5;1;9;2;3;3;3;6;24;3;4;19;65;65;3;2;0;6;9;19;2;337;7;5;0
/org.eclipse.pde.ui/src/org/eclipse/pde/internal/ui/editor/feature/RequiredFeaturesWizard.java;2;0;3;2;2;1;2;1;5;0;1;232;7;7;2;0;1;1;3;331;1;331;2;2;0
/org.eclipse.jdt.ui/ui/org/eclipse/jdt/internal/ui/javaeditor/selectionactions/StructureSelectPreviousAction.java;3;2;3;2;3;2;3;0;44;0;0;322;46;46;2;0;1;0;3;322;1;336;2;3;0
/org.eclipse.swt/Eclipse SWT Drag and Drop/photon/org/eclipse/swt/dnd/DropTarget.java;2;0;2;1;0;0;0;2;5;1;2;0;9;9;1;0;0;2;2;0;0;19;2;2;0
/org.eclipse.jdt.ui/core refactoring/org/eclipse/jdt/internal/corext/refactoring/code/flow/BranchFlowInfo.java;1;0;1;1;1;1;1;0;2;0;0;336;2;2;1;0;0;0;1;336;0;336;1;1;0
/org.eclipse.core.resources/src/org/eclipse/core/internal/resources/MoveDeleteHook.java;1;0;1;1;1;1;1;0;98;0;0;277;98;98;1;0;0;0;1;277;0;277;1;1;0
/org.eclipse.jdt.core/model/org/eclipse/jdt/core/CompletionRequestorAdapter.java;2;0;4;1;1;1;1;3;14;1;3;108;21;21;1;0;0;3;4;108;0;273;4;2;0
/org.eclipse.update.core/src/org/eclipse/update/core/ISiteContentProvider.java;2;1;3;1;2;2;2;1;6;0;1;58;14;14;1;0;0;1;3;58;0;336;3;2;0
/org.eclipse.jdt.ui/core extension/org/eclipse/jdt/internal/corext/callhierarchy/CallHierarchyMessages.java;2;0;2;1;1;1;1;1;2;0;1;13;2;2;1;0;0;1;2;13;0;336;2;2;0
/org.eclipse.help.webapp/src_servlets/org/eclipse/help/internal/webapp/servlet/SearchServlet.java;1;1;10;1;3;3;3;7;92;1;7;8;301;301;1;0;0;7;10;8;0;336;10;1;0
/org.eclipse.compare/compare/org/eclipse/compare/structuremergeviewer/DiffNode.java;1;0;3;1;1;1;1;2;10;1;2;79;14;14;1;0;0;2;3;79;0;280;3;1;0
/org.eclipse.team.cvs.ui/src/org/eclipse/team/internal/ccvs/ui/console/CVSOutputConsole.java;2;1;9;1;3;3;3;6;229;2;5;128;603;603;2;1;0;6;9;219;1;336;8;2;2
/org.eclipse.ui.ide/src/org/eclipse/ui/views/markers/internal/IDeferredTableContentProvider.java;1;0;1;1;0;0;0;1;0;0;1;181;0;0;1;0;0;1;1;181;0;181;1;1;0
/org.eclipse.swt/Eclipse SWT PI/carbon/org/eclipse/swt/internal/carbon/CGPoint.java;1;0;2;1;2;1;2;0;20;0;0;296;20;20;2;0;1;0;2;296;1;296;1;1;0
/org.eclipse.swt/Eclipse SWT/photon/org/eclipse/swt/graphics/Image.java;4;1;7;1;3;3;3;4;12;1;4;0;37;37;1;0;0;4;7;0;0;337;7;4;1
/org.eclipse.jdt.ui/core refactoring/org/eclipse/jdt/internal/corext/refactoring/structure/ExtractInterfaceRefactoring.java;6;2;33;3;6;4;6;27;585;4;14;16;838;838;4;13;2;27;33;73;15;331;18;6;0
/org.eclipse.jdt.ui/ui/org/eclipse/jdt/internal/ui/text/JavaAnnotationHover.java;3;1;9;1;2;2;2;7;138;2;6;103;261;261;2;1;0;7;9;152;1;336;8;3;0
/org.eclipse.jdt.core/compiler/org/eclipse/jdt/internal/compiler/ast/EqualExpression.java;3;0;8;2;0;0;0;8;117;3;5;12;172;172;3;3;0;8;8;71;3;267;5;3;0
/org.eclipse.jdt.core/model/org/eclipse/jdt/internal/core/util/Util.java;5;3;18;3;6;2;7;11;1647;3;7;49;2686;2686;3;4;5;12;18;199;9;300;9;5;3
/org.eclipse.jdt.core/dom/org/eclipse/jdt/core/dom/ArrayCreation.java;3;0;10;2;3;1;3;7;120;4;4;199;198;198;4;3;2;7;10;258;5;276;5;3;1
/org.eclipse.swt/Eclipse SWT PI/gtk/org/eclipse/swt/internal/gtk/GtkFixed.java;3;0;3;1;1;1;1;2;17;1;2;100;21;21;1;0;0;2;3;100;0;337;3;3;0
/org.eclipse.jdt.core/model/org/eclipse/jdt/internal/core/BinaryField.java;1;0;5;1;1;1;1;4;14;1;4;59;37;37;1;0;0;4;5;59;0;300;5;1;1
/org.eclipse.jdt.ui/core extension/org/eclipse/jdt/internal/corext/codemanipulation/AddDelegateMethodsOperation.java;2;0;12;1;1;1;2;10;162;4;6;40;207;207;4;4;1;11;12;95;5;336;7;2;0
/org.eclipse.jdt.ui/ui/org/eclipse/jdt/internal/ui/text/PreferencesAdapter.java;1;0;1;1;1;1;1;0;0;0;0;283;0;0;1;0;0;0;1;283;0;283;1;1;0
/org.eclipse.ui.workbench/Eclipse UI/org/eclipse/ui/internal/intro/IIntroConstants.java;1;0;3;1;0;0;0;3;5;2;2;203;7;7;2;1;0;3;3;203;1;263;2;1;0
/org.eclipse.pde.ui/src/org/eclipse/pde/internal/ui/launcher/LauncherUtils.java;2;11;42;2;17;2;17;25;539;5;10;89;1873;1873;11;15;15;25;42;308;30;308;12;2;0
/org.eclipse.ui.workbench/Eclipse UI/org/eclipse/ui/internal/commands/Match.java;3;0;7;2;1;1;1;6;32;2;4;99;80;80;2;2;0;6;7;99;2;336;5;3;0
/org.eclipse.jdt.ui/core refactoring/org/eclipse/jdt/internal/corext/refactoring/reorg/IReorgPolicy.java;4;2;10;1;5;4;5;5;7;2;4;70;35;35;2;1;1;5;10;251;2;336;8;4;0
/org.eclipse.ui.workbench/Eclipse UI/org/eclipse/ui/commands/Priority.java;2;0;2;1;1;1;1;1;59;0;1;267;111;111;1;0;0;1;2;267;0;281;2;2;0
/org.eclipse.swt/Eclipse SWT/gtk/org/eclipse/swt/graphics/Color.java;2;1;3;1;2;2;2;1;4;0;1;228;12;12;1;0;0;1;3;228;0;337;3;2;1
/org.eclipse.jdt.core/compiler/org/eclipse/jdt/internal/compiler/lookup/LocalTypeBinding.java;2;0;4;1;0;0;0;4;11;1;4;2;23;23;1;0;0;4;4;2;0;225;4;2;0
/org.eclipse.jdt.core/model/org/eclipse/jdt/internal/core/BinaryType.java;5;2;26;3;3;2;3;23;219;6;12;19;732;732;6;11;1;23;26;59;12;300;14;5;5
/org.eclipse.jdt.ui/ui/org/eclipse/jdt/internal/ui/packageview/SelectionTransferDragAdapter.java;2;0;2;1;1;1;1;1;2;0;1;253;4;4;1;0;0;1;2;253;0;336;2;2;0
/org.eclipse.debug.ui/ui/org/eclipse/debug/internal/ui/views/registers/RegistersView.java;1;0;1;1;0;0;0;1;0;0;1;239;0;0;1;0;0;1;1;239;0;239;1;1;0
/org.eclipse.ui.ide/src/org/eclipse/ui/views/bookmarkexplorer/EditBookmarkAction.java;1;0;2;1;0;0;0;2;4;0;1;129;4;4;2;1;0;2;2;129;1;129;1;1;0
/org.eclipse.jdt.ui/core refactoring/org/eclipse/jdt/internal/corext/refactoring/structure/RefactoringWorkingCopyOwner.java;2;0;2;1;1;1;1;1;2;0;1;74;2;2;1;0;0;1;2;74;0;336;2;2;0
/org.eclipse.help.appserver/src/org/eclipse/help/internal/appserver/DevClassPathHelper.java;1;2;3;1;3;2;3;0;21;0;0;292;25;25;2;0;1;0;3;292;1;311;2;1;0
/org.eclipse.swt/Eclipse SWT Custom Widgets/common/org/eclipse/swt/custom/DefaultContent.java;2;1;2;1;2;2;2;0;4;0;0;307;6;6;1;0;0;0;2;307;0;337;2;2;0
/org.eclipse.team.cvs.ui/src/org/eclipse/team/internal/ccvs/ui/subscriber/CVSParticipantAction.java;1;0;2;1;2;1;2;0;63;0;0;294;63;63;2;0;1;0;2;294;1;294;1;1;0
/org.eclipse.help.ui/src/org/eclipse/help/ui/internal/StyledLineWrapper.java;1;1;4;1;3;3;3;1;44;0;1;156;74;74;1;0;0;1;4;156;0;336;4;1;1
/org.eclipse.core.runtime/src/org/eclipse/core/internal/preferences/AbstractScope.java;1;0;3;1;1;1;1;2;8;1;2;239;10;10;1;0;0;2;3;239;0;298;3;1;1
/org.eclipse.update.ui/src/org/eclipse/update/internal/ui/model/BookmarkUtil.java;3;1;10;3;2;2;2;8;138;4;5;15;240;240;4;3;0;8;10;50;3;336;7;3;2
/org.eclipse.ltk.ui.refactoring/src/org/eclipse/ltk/internal/ui/refactoring/Assert.java;1;0;2;1;1;1;1;1;2;0;1;269;2;2;1;0;0;1;2;269;0;336;2;1;0
/org.eclipse.pde.build/src_ant/org/eclipse/pde/internal/build/tasks/FetchTask.java;2;1;8;2;2;2;2;6;298;2;4;31;819;819;2;2;0;6;8;31;2;336;6;2;0
/org.eclipse.team.cvs.core/src/org/eclipse/team/internal/ccvs/core/CVSCompareSubscriber.java;2;1;12;2;3;3;3;9;319;7;3;205;413;413;7;6;0;9;12;232;6;336;6;2;3
/org.eclipse.ui.workbench/Eclipse UI/org/eclipse/ui/internal/dialogs/AboutDialog.java;2;1;3;1;2;2;2;1;499;0;1;157;502;502;1;0;0;1;3;157;0;314;3;2;1
/org.eclipse.jdt.ui/ui/org/eclipse/jdt/internal/ui/text/folding/FoldingMessages.java;1;1;2;1;2;2;2;0;6;0;0;292;6;6;1;0;0;0;2;292;0;336;2;1;0
/org.eclipse.jdt.ui/ui/org/eclipse/jdt/internal/ui/callhierarchy/SearchScopeProjectAction.java;2;2;4;1;3;2;3;1;19;0;1;224;21;21;2;0;1;1;4;293;1;336;3;2;0
/org.eclipse.jdt.debug.ui/ui/org/eclipse/jdt/internal/debug/core/refactoring/JavaBreakpointTypeChange.java;2;2;6;1;6;4;6;0;210;0;0;287;236;236;2;0;2;0;6;300;2;336;4;2;0
/org.eclipse.jface.text/src/org/eclipse/jface/internal/text/link/contentassist/ContentAssistMessages.java;1;0;1;1;1;1;1;0;0;0;0;295;0;0;1;0;0;0;1;295;0;295;1;1;0
/org.eclipse.team.cvs.core/src/org/eclipse/team/internal/ccvs/core/resources/EclipseResource.java;2;0;6;1;1;1;1;5;28;2;4;124;61;61;2;1;0;5;6;140;1;336;5;2;0
/org.eclipse.jdt.core/model/org/eclipse/jdt/internal/core/CompilationUnitStructureRequestor.java;3;0;8;1;1;1;1;7;137;1;7;7;323;323;1;0;0;7;8;7;0;314;8;3;2
/org.eclipse.debug.ui/ui/org/eclipse/debug/internal/ui/views/console/HyperlinkPosition.java;1;0;1;1;0;0;0;1;2;0;1;38;2;2;1;0;0;1;1;38;0;38;1;1;1
/org.eclipse.pde.ui/src/org/eclipse/pde/internal/ui/editor/text/XMLWhitespaceDetector.java;2;0;2;1;1;1;1;1;4;0;1;211;4;4;1;0;0;1;2;211;0;336;2;2;0
/org.eclipse.team.core/src/org/eclipse/team/internal/core/StringMatcher.java;1;0;1;1;0;0;0;1;8;0;1;88;8;8;1;0;0;1;1;88;0;88;1;1;0
/org.eclipse.swt/Eclipse SWT/common/org/eclipse/swt/events/PaintEvent.java;1;0;1;1;0;0;0;1;17;0;1;156;17;17;1;0;0;1;1;156;0;156;1;1;0
/org.eclipse.swt/Eclipse SWT/photon/org/eclipse/swt/widgets/Text.java;5;1;14;2;2;2;2;12;41;3;9;8;144;144;3;3;0;12;14;120;3;337;11;5;1
/org.eclipse.jdt.debug.ui/ui/org/eclipse/jdt/internal/debug/ui/breakpoints/AddExceptionDialog.java;1;0;1;1;0;0;0;1;1;0;1;175;1;1;1;0;0;1;1;175;0;175;1;1;0
/org.eclipse.core.runtime.compatibility/src-model/org/eclipse/core/internal/model/PluginParser.java;3;2;5;1;4;3;4;1;52;0;1;171;61;61;2;0;1;1;5;276;1;336;4;3;0
/org.eclipse.jdt.ui/ui/org/eclipse/jdt/internal/ui/preferences/JavaPreferencesSettings.java;2;0;3;1;1;1;1;2;5;1;2;57;8;8;1;0;0;2;3;57;0;336;3;2;0
/org.eclipse.ui.workbench/Eclipse UI/org/eclipse/ui/internal/FastViewBar.java;7;3;17;3;8;4;8;9;746;4;4;205;1384;1384;4;5;4;9;17;223;9;320;8;7;0
/org.eclipse.jdt.ui/ui/org/eclipse/jdt/internal/ui/viewsupport/JavaUILabelProvider.java;2;0;2;1;1;1;1;1;52;0;1;35;54;54;1;0;0;1;2;35;0;336;2;2;1
/org.eclipse.jdt.ui/ui/org/eclipse/jdt/internal/ui/text/java/MethodCompletionProposal.java;1;0;5;1;5;1;5;0;46;0;0;295;46;46;5;0;4;0;5;295;4;295;1;1;0
/org.eclipse.ui.workbench/Eclipse UI/org/eclipse/ui/internal/WWinPartService.java;1;0;1;1;0;0;0;1;2;0;1;68;2;2;1;0;0;1;1;68;0;68;1;1;2
/org.eclipse.jface.text/src/org/eclipse/jface/text/formatter/IFormattingContext.java;2;1;6;1;2;2;2;4;196;3;2;119;209;209;3;2;0;4;6;119;2;336;4;2;0
/org.eclipse.team.core/src/org/eclipse/team/core/synchronize/ISyncInfoSetChangeListener.java;2;2;5;1;3;2;3;2;74;1;2;224;97;97;2;0;1;2;5;335;1;335;4;2;0
/org.eclipse.jdt.ui/ui/org/eclipse/jdt/internal/ui/callhierarchy/HistoryDropDownAction.java;2;0;4;1;1;1;1;3;28;0;1;12;30;30;3;2;0;3;4;12;2;336;2;2;0
/org.eclipse.jdt.ui/ui/org/eclipse/jdt/ui/actions/FindReadReferencesInProjectAction.java;3;1;8;2;3;3;3;5;11;2;3;102;32;32;2;2;0;5;8;102;2;336;6;3;0
/org.eclipse.ui.ide/src/org/eclipse/ui/views/markers/internal/TableView.java;4;1;5;1;2;2;2;3;144;1;3;129;173;173;1;0;0;3;5;129;0;336;5;4;0
/org.eclipse.jdt.ui/ui/org/eclipse/jdt/internal/ui/compare/JavaAddElementFromHistory.java;4;2;11;3;3;2;3;8;285;3;6;79;436;436;3;2;1;8;11;262;3;336;8;4;2
/org.eclipse.jdt.ui/core refactoring/org/eclipse/jdt/internal/corext/refactoring/typeconstraints/RawBindingVariable.java;2;0;3;1;1;1;1;2;8;1;2;3;10;10;1;0;0;2;3;3;0;336;3;2;0
/org.eclipse.ui.workbench/Eclipse UI/org/eclipse/ui/IPerspectiveDescriptor.java;5;1;5;1;2;2;2;3;9;1;3;54;28;28;1;0;0;3;5;54;0;336;5;5;0
/org.eclipse.debug.ui/ui/org/eclipse/debug/internal/ui/preferences/ConsolePreferencePage.java;3;0;4;2;1;1;1;3;27;2;2;180;43;43;2;1;0;3;4;246;1;304;3;3;1
/org.eclipse.osgi/core/framework/org/eclipse/osgi/framework/internal/core/BundleHost.java;5;0;23;3;1;1;10;13;290;13;5;171;626;626;13;8;9;22;23;254;17;309;6;5;0
/org.eclipse.swt/Eclipse SWT PI/motif/org/eclipse/swt/internal/Platform.java;1;0;1;1;0;0;0;1;0;0;1;117;0;0;1;0;0;1;1;117;0;117;1;1;0
/org.eclipse.ui.ide/src/org/eclipse/ui/views/tasklist/TasksFilter.java;1;0;2;1;0;0;0;2;13;0;1;129;13;13;2;1;0;2;2;129;1;129;1;1;0
/org.eclipse.jdt.ui/ui/org/eclipse/jdt/internal/ui/wizards/buildpaths/ClasspathContainerDefaultPage.java;2;0;2;1;1;1;1;1;6;0;1;135;8;8;1;0;0;1;2;135;0;336;2;2;0
/org.eclipse.jdt.core/model/org/eclipse/jdt/core/util/IClassFileDisassembler.java;1;0;1;1;0;0;0;1;2;0;1;199;2;2;1;0;0;1;1;199;0;199;1;1;0
/org.eclipse.core.runtime/src/org/eclipse/core/internal/content/LazyInputStream.java;2;0;2;2;2;1;2;0;2;0;0;330;2;2;2;0;1;0;2;330;1;330;1;2;0
/org.eclipse.ui.ide/src/org/eclipse/ui/internal/ide/dialogs/ProjectPerspectiveChoiceDialog.java;1;0;1;1;0;0;0;1;0;0;1;132;0;0;1;0;0;1;1;132;0;132;1;1;0
/org.eclipse.debug.ui/ui/org/eclipse/debug/ui/IDebugUIConstants.java;5;3;34;3;7;4;7;27;134;8;8;19;468;468;8;19;3;27;34;223;22;335;12;5;3
/org.eclipse.jdt.ui/ui/org/eclipse/jdt/ui/actions/RefreshAction.java;3;1;4;1;2;2;2;2;23;1;2;41;33;33;1;0;0;2;4;41;0;336;4;3;0
/org.eclipse.swt/Eclipse SWT/win32/org/eclipse/swt/widgets/Widget.java;3;2;14;2;3;2;3;11;131;3;7;18;382;382;3;4;1;11;14;183;5;337;9;3;0
/org.eclipse.swt/Eclipse SWT PI/gtk/org/eclipse/swt/internal/accessibility/gtk/AtkTextIface.java;4;0;4;1;1;1;1;3;40;1;3;75;59;59;1;0;0;3;4;75;0;337;4;4;0
/org.eclipse.team.cvs.ui/src/org/eclipse/team/internal/ccvs/ui/EditorsDialog.java;1;0;1;1;0;0;0;1;7;0;1;138;7;7;1;0;0;1;1;138;0;138;1;1;0
/org.eclipse.swt/Eclipse SWT/photon/org/eclipse/swt/widgets/Canvas.java;2;0;2;2;0;0;0;2;17;0;1;93;17;17;2;1;0;2;2;93;1;93;1;2;0
/org.eclipse.swt/Eclipse SWT Mozilla/common/org/eclipse/swt/internal/mozilla/nsILocalFile.java;1;0;2;1;0;0;0;2;34;1;2;100;34;34;1;0;0;2;2;100;0;148;2;1;0
/org.eclipse.debug.ui/ui/org/eclipse/debug/internal/ui/sourcelookup/browsers/DirectorySourceContainerDialog.java;1;0;2;1;1;1;1;1;5;0;1;209;5;5;1;0;0;1;2;209;0;331;2;1;0
/org.eclipse.core.resources/src/org/eclipse/core/internal/resources/WorkspaceTreeReader_2.java;1;0;1;1;1;1;1;0;117;0;0;277;117;117;1;0;0;0;1;277;0;277;1;1;0
/org.eclipse.ui.ide/src/org/eclipse/ui/views/markers/internal/ActionTaskProperties.java;3;1;3;1;2;2;2;1;4;0;1;129;6;6;1;0;0;1;3;129;0;336;3;3;0
/org.eclipse.jdt.debug.ui/ui/org/eclipse/jdt/internal/debug/ui/actions/ToggleBreakpointAdapter.java;2;2;7;2;5;3;5;2;592;0;1;245;664;664;2;1;2;2;7;245;3;321;4;2;3
/org.eclipse.team.ui/src/org/eclipse/team/internal/ui/synchronize/actions/PinParticipantAction.java;1;2;3;1;3;2;3;0;62;0;0;296;81;81;2;0;1;0;3;296;1;310;2;1;1
/org.eclipse.ui.presentations.r21/src/org/eclipse/ui/internal/presentations/R21BasicStackPresentation.java;2;0;4;2;4;1;4;0;81;0;0;323;81;81;4;0;3;0;4;323;3;323;1;2;0
/org.eclipse.compare/compare/org/eclipse/compare/internal/patch/Patcher.java;1;0;5;1;0;0;0;5;29;1;5;45;55;55;1;0;0;5;5;45;0;219;5;1;0
/org.eclipse.ui.workbench/Eclipse UI/org/eclipse/ui/keys/NaturalKey.java;3;1;5;1;2;2;2;3;17;1;3;81;51;51;1;0;0;3;5;81;0;336;5;3;0
/org.eclipse.jdt.ui/core extension/org/eclipse/jdt/internal/corext/codemanipulation/ImportRewrite.java;3;1;9;1;3;3;3;6;35;2;4;116;118;118;2;2;0;6;9;116;2;336;7;3;0
/org.eclipse.swt/Eclipse SWT/gtk/org/eclipse/swt/widgets/Tracker.java;5;2;19;2;6;5;6;13;454;3;9;8;1070;1070;3;4;1;13;19;215;5;337;14;5;0
/org.eclipse.swt/Eclipse SWT/motif/org/eclipse/swt/graphics/Font.java;4;1;5;2;2;2;2;3;133;2;2;33;187;187;2;1;0;3;5;33;1;337;4;4;1
/org.eclipse.team.cvs.core/src/org/eclipse/team/internal/ccvs/core/CVSAnnotateBlock.java;1;0;2;1;0;0;0;2;20;1;2;52;20;20;1;0;0;2;2;52;0;103;2;1;0
/org.eclipse.jdt.core/dom/org/eclipse/jdt/core/dom/VariableDeclarationExpression.java;4;0;15;1;1;1;5;10;274;6;6;199;378;378;6;4;4;14;15;266;8;308;7;4;3
/org.eclipse.team.cvs.ui/src/org/eclipse/team/internal/ccvs/ui/actions/CompareWithRevisionAction.java;2;2;7;2;4;3;4;3;42;0;1;244;91;91;3;2;1;3;7;244;3;336;4;2;0
/org.eclipse.swt/Eclipse SWT Custom Widgets/common/org/eclipse/swt/custom/StyledText.java;8;2;47;5;4;3;12;35;16687;13;11;0;36597;36597;13;24;9;43;47;113;33;337;14;8;3
/org.eclipse.swt/Eclipse SWT/carbon/org/eclipse/swt/graphics/Image.java;3;3;9;1;6;4;6;3;12;1;3;24;46;46;3;0;2;3;9;310;2;337;7;3;1
/org.eclipse.swt/Eclipse SWT Mozilla/common/org/eclipse/swt/internal/mozilla/nsIInterfaceRequestor.java;1;0;1;1;0;0;0;1;0;0;1;100;0;0;1;0;0;1;1;100;0;100;1;1;0
/org.eclipse.osgi/resolver/src/org/eclipse/osgi/internal/resolver/BundleDescriptionImpl.java;5;0;16;4;0;0;6;10;116;8;5;171;192;192;8;5;6;16;16;267;11;267;5;5;0
/org.eclipse.ui.editors/src/org/eclipse/ui/editors/text/ForwardingDocumentProvider.java;2;1;2;1;2;2;2;0;44;0;0;311;44;44;1;0;0;0;2;311;0;336;2;2;0
/org.eclipse.pde.ui/src_Forms/org/eclipse/pde/internal/ui/model/plugin/PluginImportNode.java;3;3;8;3;6;3;6;2;75;1;2;244;150;150;3;0;3;2;8;297;3;336;5;3;0
/org.eclipse.jdt.core/compiler/org/eclipse/jdt/internal/compiler/lookup/PackageBinding.java;3;0;4;1;1;1;1;3;35;1;3;2;46;46;1;0;0;3;4;2;0;282;4;3;1
/org.eclipse.team.cvs.ui/src/org/eclipse/team/internal/ccvs/ui/BranchPromptDialog.java;2;0;3;2;0;0;0;3;8;2;2;63;15;15;2;1;0;3;3;63;1;138;2;2;0
/org.eclipse.jdt.ui/ui/org/eclipse/jdt/internal/ui/text/spelling/ChangeCaseProposal.java;2;0;2;1;1;1;1;1;2;0;1;219;2;2;1;0;0;1;2;219;0;336;2;2;0
/org.eclipse.swt/Eclipse SWT Drag and Drop/emulated/org/eclipse/swt/dnd/Clipboard.java;1;0;4;1;0;0;0;4;81;1;4;0;116;116;1;0;0;4;4;0;0;172;4;1;0
/org.eclipse.team.ui/src/org/eclipse/team/internal/ui/synchronize/IPageValidator.java;1;0;2;1;1;1;1;1;2;0;1;254;2;2;1;0;0;1;2;254;0;336;2;1;0
/org.eclipse.core.resources/src/org/eclipse/core/internal/indexing/IndexNode.java;2;0;2;1;1;1;1;1;171;0;1;13;205;205;1;0;0;1;2;13;0;277;2;2;0
/org.eclipse.pde.ui/src/org/eclipse/pde/internal/ui/util/SharedLabelProvider.java;3;1;4;2;2;2;2;2;18;0;1;131;24;24;2;1;0;2;4;131;1;336;3;3;0
/org.eclipse.ui.ide/extensions/org/eclipse/ui/IMarkerActionFilter.java;3;1;3;1;2;2;2;1;2;0;1;132;4;4;1;0;0;1;3;132;0;336;3;3;0
/org.eclipse.jface/src/org/eclipse/jface/dialogs/MessageDialog.java;3;5;9;3;7;3;7;2;1692;1;2;0;1713;1713;5;0;4;2;9;289;4;336;5;3;0
/org.eclipse.swt/Eclipse SWT Browser/mozilla/org/eclipse/swt/browser/PromptService.java;2;0;3;1;1;1;1;2;368;0;1;264;374;374;2;1;0;2;3;264;1;337;2;2;1
/org.eclipse.text/src/org/eclipse/jface/text/source/IAnnotationModel.java;2;2;4;2;3;2;3;1;124;0;1;131;151;151;2;0;1;1;4;334;1;334;3;2;0
/org.eclipse.ant.ui/Ant Editor/org/eclipse/ant/internal/ui/editor/AntAutoIndentStrategy.java;1;1;6;1;5;5;5;1;208;0;1;254;332;332;1;0;0;1;6;254;0;326;6;1;1
/org.eclipse.jface.text/src/org/eclipse/jface/text/ITextViewerExtension5.java;2;0;6;2;2;1;3;3;69;2;2;257;88;88;2;1;2;4;6;257;3;331;3;2;0
/org.eclipse.jdt.ui/ui/org/eclipse/jdt/internal/ui/text/java/JavaStringAutoIndentStrategy.java;3;1;11;2;3;3;3;8;137;3;4;40;396;396;3;4;0;8;11;96;4;336;7;3;0
/org.eclipse.ui.workbench/Eclipse UI/org/eclipse/ui/internal/ActionPresentation.java;3;0;3;3;0;0;0;3;103;0;1;181;103;103;3;2;0;3;3;181;2;181;1;3;1
/org.eclipse.team.core/src/org/eclipse/team/core/ITeamStatus.java;2;1;5;1;2;2;2;3;39;1;3;224;52;52;1;0;0;3;5;224;0;336;5;2;0
/org.eclipse.ui.ide/extensions/org/eclipse/ui/ResourceWorkingSetFilter.java;1;0;1;1;0;0;0;1;0;0;1;132;0;0;1;0;0;1;1;132;0;132;1;1;0
/org.eclipse.jdt.ui/ui/org/eclipse/jdt/internal/ui/filters/JavaFileFilter.java;1;0;1;1;1;1;1;0;2;0;0;336;2;2;1;0;0;0;1;336;0;336;1;1;0
/org.eclipse.jdt.ui/ui/org/eclipse/jdt/internal/ui/text/java/hover/BestMatchHover.java;2;1;5;1;2;2;2;3;41;1;3;47;91;91;1;0;0;3;5;47;0;336;5;2;0
/org.eclipse.jdt.ui/ui/org/eclipse/jdt/internal/ui/wizards/buildpaths/SourceAttachmentDialog.java;2;1;3;1;2;2;2;1;112;0;1;243;119;119;1;0;0;1;3;243;0;336;3;2;0
/org.eclipse.osgi/osgi/src/org/eclipse/osgi/service/resolver/PlatformAdmin.java;4;0;8;2;0;0;1;7;82;2;5;171;140;140;2;2;1;8;8;171;3;269;5;4;0
/org.eclipse.jdt.junit/src/org/eclipse/jdt/internal/junit/ui/OpenEditorAtLineAction.java;3;2;5;1;3;2;3;2;54;1;2;30;112;112;2;0;1;2;5;289;1;336;4;3;0
/org.eclipse.team.cvs.core/src/org/eclipse/team/internal/ccvs/core/syncinfo/DeferredResourceChangeHandler.java;2;3;8;1;4;2;4;4;52;2;3;124;109;109;3;1;2;4;8;314;3;336;5;2;3
/org.eclipse.pde.ui/src/org/eclipse/pde/internal/ui/editor/plugin/rows/ExtensionAttributeRow.java;2;2;4;1;4;3;4;0;10;0;0;292;20;20;2;0;1;0;4;292;1;336;3;2;0
/org.eclipse.team.ui/src/org/eclipse/team/ui/TeamOperation.java;2;2;7;2;5;4;5;2;54;1;2;247;126;126;2;0;1;2;7;295;1;336;6;2;0
/org.eclipse.team.cvs.ui/src/org/eclipse/team/internal/ccvs/ui/repo/RemoteViewPart.java;2;0;4;1;1;1;1;3;4;1;3;63;11;11;1;0;0;3;4;63;0;336;4;2;0
/org.eclipse.jdt.core/codeassist/org/eclipse/jdt/internal/codeassist/complete/CompletionOnQualifiedNameReference.java;3;0;3;1;0;0;0;3;20;1;3;63;31;31;1;0;0;3;3;63;0;199;3;3;0
/org.eclipse.jdt.core/model/org/eclipse/jdt/core/jdom/IDOMMember.java;2;0;3;1;1;1;1;2;3;1;2;199;7;7;1;0;0;2;3;199;0;299;3;2;0
/org.eclipse.core.resources/src/org/eclipse/core/internal/resources/MarkerReader.java;1;0;1;1;1;1;1;0;61;0;0;277;61;61;1;0;0;0;1;277;0;277;1;1;0
/org.eclipse.jdt.ui/core refactoring/org/eclipse/jdt/internal/corext/refactoring/changes/DeleteFileChange.java;3;0;6;1;1;1;1;5;38;2;4;31;59;59;2;1;0;5;6;245;1;336;5;3;1
/org.eclipse.core.resources/src/org/eclipse/core/internal/utils/AssertionFailedException.java;1;0;2;1;1;1;1;1;23;0;1;173;28;28;1;0;0;1;2;173;0;277;2;1;0
/org.eclipse.jdt.core/compiler/org/eclipse/jdt/internal/compiler/ast/NameReference.java;1;0;1;1;0;0;0;1;2;0;1;199;2;2;1;0;0;1;1;199;0;199;1;1;0
/org.eclipse.jface/src/org/eclipse/jface/resource/ImageDescriptor.java;2;0;2;1;1;1;1;1;63;0;1;224;65;65;1;0;0;1;2;224;0;336;2;2;1
/org.eclipse.debug.ui/ui/org/eclipse/debug/ui/DebugUITools.java;4;4;25;3;8;3;8;17;289;6;9;42;726;726;6;8;5;17;25;100;13;336;12;4;2
/org.eclipse.ui.workbench/Eclipse UI/org/eclipse/ui/internal/progress/FinishedJobs.java;4;9;12;2;12;3;12;0;663;0;0;276;720;720;9;0;9;0;12;276;9;336;3;4;1
/org.eclipse.compare/compare/org/eclipse/compare/internal/BinaryCompareViewer.java;1;1;4;1;2;2;2;2;16;1;2;79;27;27;1;0;0;2;4;79;0;337;4;1;0
/org.eclipse.jdt.core/model/org/eclipse/jdt/internal/core/ElementCache.java;1;0;2;1;0;0;0;2;5;1;2;57;7;7;1;0;0;2;2;57;0;199;2;1;0
/org.eclipse.ui.workbench/Eclipse UI/org/eclipse/ui/internal/presentations/NativePresentationFactory.java;2;2;3;2;3;2;3;0;31;0;0;277;35;35;2;0;1;0;3;277;1;296;2;2;0
/org.eclipse.team.core/src/org/eclipse/team/core/IProjectSetSerializer.java;2;2;4;1;3;2;3;1;4;0;1;269;10;10;2;0;1;1;4;313;1;336;3;2;0
/org.eclipse.ui.forms/src/org/eclipse/ui/forms/widgets/Twistie.java;1;1;6;1;2;2;2;4;26;3;2;225;37;37;3;2;0;4;6;225;2;336;4;1;0
/org.eclipse.swt/Eclipse SWT Custom Widgets/common/org/eclipse/swt/custom/CCombo.java;4;2;18;1;6;4;6;12;87;2;10;0;373;373;2;2;2;12;18;27;4;337;14;4;2
/org.eclipse.swt/Eclipse SWT/photon/org/eclipse/swt/widgets/Scale.java;3;1;4;1;2;2;2;2;22;1;2;2;34;34;1;0;0;2;4;2;0;337;4;3;0
/org.eclipse.jdt.ui/core refactoring/org/eclipse/jdt/internal/corext/refactoring/rename/RenameResourceProcessor.java;2;0;17;1;1;1;4;13;102;5;7;71;172;172;5;6;3;16;17;247;9;336;8;2;0
/org.eclipse.jdt.ui/core extension/org/eclipse/jdt/internal/corext/Assert.java;1;0;1;1;1;1;1;0;2;0;0;336;2;2;1;0;0;0;1;336;0;336;1;1;0
/org.eclipse.team.cvs.ssh2/src/org/eclipse/team/internal/ccvs/ssh2/JSchSession.java;3;4;9;2;8;4;8;1;104;0;1;263;136;136;4;0;4;1;9;309;4;330;5;3;0
/org.eclipse.swt/Eclipse SWT Drag and Drop/motif/org/eclipse/swt/dnd/ByteArrayTransfer.java;1;0;1;1;0;0;0;1;30;0;1;24;30;30;1;0;0;1;1;24;0;24;1;1;0
/org.eclipse.team.ui/src/org/eclipse/team/internal/ui/synchronize/RefreshUserNotificationPolicy.java;2;3;18;2;8;3;11;7;91;0;1;247;229;229;10;6;8;10;18;247;14;323;4;2;1
/org.eclipse.pde.ui/src/org/eclipse/pde/internal/ui/editor/PDEMultiPageContentOutline.java;2;2;4;2;3;2;3;1;70;0;1;44;76;76;2;0;1;1;4;292;1;336;3;2;0
/org.eclipse.core.resources/src/org/eclipse/core/internal/events/ResourceDeltaFactory.java;2;0;3;1;1;1;1;2;316;1;2;104;330;330;1;0;0;2;3;104;0;277;3;2;1
/org.eclipse.pde.ui/src/org/eclipse/pde/ui/IExtensionWizard.java;2;2;4;1;4;3;4;0;60;0;0;276;72;72;2;0;1;0;4;276;1;336;3;2;0
/org.eclipse.update.core/src/org/eclipse/update/internal/model/InstallConfigurationModel.java;2;1;10;1;3;3;3;7;40;3;4;58;96;96;3;3;0;7;10;238;3;336;7;2;0
/org.eclipse.team.ui/src/org/eclipse/team/internal/ui/synchronize/SubscriberRefreshSchedule.java;2;3;6;2;6;3;6;0;15;0;0;288;37;37;3;0;3;0;6;288;3;336;3;2;0
/org.eclipse.pde.ui/src/org/eclipse/pde/internal/ui/editor/context/InputContext.java;2;5;10;2;10;3;10;0;56;0;0;292;134;134;5;0;7;0;10;292;7;327;3;2;0
/org.eclipse.jdt.core/model/org/eclipse/jdt/core/util/ClassFileBytesDisassembler.java;1;0;1;1;0;0;0;1;2;0;1;199;2;2;1;0;0;1;1;199;0;199;1;1;1
/org.eclipse.ui.externaltools/Program Tools Support/org/eclipse/ui/externaltools/internal/program/launchConfigurations/ProgramBuilderTabGroup.java;3;0;6;1;1;1;1;5;4;1;5;24;16;16;1;0;0;5;6;24;0;336;6;3;0
/org.eclipse.ui.workbench/Eclipse UI/org/eclipse/ui/IWorkbenchPart2.java;2;2;4;2;4;3;4;0;18;0;0;294;30;30;2;0;1;0;4;294;1;324;3;2;0
/org.eclipse.jface/src/org/eclipse/jface/preference/BooleanPropertyAction.java;2;0;2;1;1;1;1;1;19;0;1;37;19;19;1;0;0;1;2;37;0;293;2;2;0
/org.eclipse.team.ui/src/org/eclipse/team/ui/synchronize/SubscriberParticipant.java;2;10;13;2;13;2;13;0;683;0;0;288;729;729;10;0;11;0;13;288;11;329;2;2;2
/org.eclipse.swt/Eclipse SWT PI/win32/org/eclipse/swt/internal/win32/COMBOBOXINFO.java;1;0;1;1;0;0;0;1;0;0;1;120;0;0;1;0;0;1;1;120;0;120;1;1;0
/org.eclipse.jdt.ui/core refactoring/org/eclipse/jdt/internal/corext/refactoring/code/PromoteTempToFieldRefactoring.java;5;3;27;3;5;3;5;22;103;5;12;9;366;366;5;10;2;22;27;246;12;336;15;5;0
/org.eclipse.jdt.ui/core extension/org/eclipse/jdt/internal/corext/dom/ASTRewriteClear.java;2;0;7;1;1;1;1;6;8;1;6;7;29;29;1;0;0;6;7;7;0;336;7;2;0
/org.eclipse.jdt.core/compiler/org/eclipse/jdt/internal/compiler/lookup/ProblemPackageBinding.java;1;0;1;1;0;0;0;1;2;0;1;199;2;2;1;0;0;1;1;199;0;199;1;1;0
/org.eclipse.text/src/org/eclipse/jface/text/DocumentPartitioningChangedEvent.java;2;0;4;2;2;1;2;2;36;1;2;92;44;44;2;0;1;2;4;334;1;334;3;2;0
/org.eclipse.jdt.ui/ui/org/eclipse/jdt/internal/ui/typehierarchy/FocusOnTypeAction.java;1;0;1;1;1;1;1;0;2;0;0;336;2;2;1;0;0;0;1;336;0;336;1;1;0
/org.eclipse.jdt.core/codeassist/org/eclipse/jdt/internal/codeassist/ISearchRequestor.java;1;0;1;1;0;0;0;1;2;0;1;199;2;2;1;0;0;1;1;199;0;199;1;1;0
/org.eclipse.ui.ide/src/org/eclipse/ui/wizards/datatransfer/FileSystemExportWizard.java;2;0;4;1;0;0;0;4;33;2;3;92;46;46;2;1;0;4;4;132;1;132;3;2;0
/org.eclipse.update.core/src/org/eclipse/update/core/IInstallHandlerEntry.java;2;1;3;1;2;2;2;1;6;0;1;58;14;14;1;0;0;1;3;58;0;336;3;2;0
/org.eclipse.debug.ui/ui/org/eclipse/debug/internal/ui/sourcelookup/UpAction.java;1;0;1;1;0;0;0;1;0;0;1;209;0;0;1;0;0;1;1;209;0;209;1;1;0
/org.eclipse.swt/Eclipse SWT PI/win32/org/eclipse/swt/internal/win32/TEXTMETRICW.java;1;0;1;1;0;0;0;1;0;0;1;61;0;0;1;0;0;1;1;61;0;61;1;1;0
/org.eclipse.ui.workbench/Eclipse UI/org/eclipse/ui/contexts/IWorkbenchContextSupport.java;4;1;14;2;2;2;2;12;131;5;4;174;388;388;5;8;0;12;14;224;8;336;6;4;1
/org.eclipse.jdt.ui/ui/org/eclipse/jdt/internal/ui/preferences/formatter/ProfileManager.java;2;0;10;1;1;1;1;9;202;4;4;176;379;379;4;5;0;9;10;191;5;325;5;2;0
/org.eclipse.ui.workbench/Eclipse UI/org/eclipse/ui/IWorkbenchPropertyPage.java;2;1;2;1;2;2;2;0;8;0;0;294;10;10;1;0;0;0;2;294;0;336;2;2;0
/org.eclipse.jdt.debug/eval/org/eclipse/jdt/internal/debug/eval/ast/instructions/SendMessage.java;2;0;2;2;0;0;0;2;5;0;1;76;5;5;2;1;0;2;2;76;1;76;1;2;0
/org.eclipse.jdt.ui/core extension/org/eclipse/jdt/internal/corext/dom/TypeRules.java;3;1;6;1;2;2;2;4;82;1;4;61;115;115;1;0;0;4;6;61;0;336;6;3;0
/org.eclipse.jdt.core/search/org/eclipse/jdt/internal/core/search/matching/ConstructorPattern.java;2;0;15;2;2;1;2;13;174;4;9;70;693;693;4;4;1;13;15;70;5;280;10;2;1
/org.eclipse.jdt.launching/launching/org/eclipse/jdt/internal/launching/Standard11xVMRunner.java;3;1;4;1;2;2;2;2;4;1;2;211;12;12;1;0;0;2;4;211;0;336;4;3;0
/org.eclipse.jdt.ui/core refactoring/org/eclipse/jdt/internal/corext/refactoring/util/QualifiedNameFinder.java;3;1;9;1;4;4;4;5;33;1;5;75;99;99;1;0;0;5;9;75;0;336;9;3;0
/org.eclipse.swt/Eclipse SWT PI/photon/org/eclipse/swt/internal/Platform.java;1;0;1;1;0;0;0;1;0;0;1;117;0;0;1;0;0;1;1;117;0;117;1;1;0
/org.eclipse.team.cvs.ui/src/org/eclipse/team/internal/ccvs/ui/actions/CompareWithTagAction.java;2;7;17;2;8;2;9;8;120;3;4;71;270;270;7;4;7;9;17;288;11;336;6;2;1
/org.eclipse.help.ide/src/org/eclipse/help/ui/internal/search/ResultTableContentProvider.java;1;0;1;1;1;1;1;0;0;0;0;281;0;0;1;0;0;0;1;281;0;281;1;1;0
/org.eclipse.ui.workbench/Eclipse UI/org/eclipse/ui/internal/registry/EditorDescriptor.java;5;1;9;4;2;2;2;7;284;6;2;157;319;319;6;5;0;7;9;157;5;336;4;5;1
/org.eclipse.core.runtime/src/org/eclipse/core/internal/registry/FlushableExtension.java;2;2;3;1;3;2;3;0;15;0;0;303;27;27;2;0;1;0;3;303;1;321;2;2;0
/org.eclipse.jdt.debug.ui/ui/org/eclipse/jdt/internal/debug/ui/launcher/LocalJavaApplicationTabGroup.java;3;0;4;1;1;1;1;3;7;2;2;150;13;13;2;1;0;3;4;267;1;336;3;3;0
/org.eclipse.ant.ui/Ant Editor/org/eclipse/ant/internal/ui/editor/model/AntTargetNode.java;1;0;7;1;0;0;0;7;32;3;3;204;79;79;3;4;0;7;7;232;4;251;3;1;2
/org.eclipse.swt/Eclipse SWT PI/gtk/org/eclipse/swt/internal/accessibility/gtk/ATK.java;4;1;11;1;2;2;2;9;131;5;5;75;163;163;5;4;0;9;11;226;4;337;7;4;0
/org.eclipse.ui.workbench/Eclipse UI/org/eclipse/ui/internal/progress/ProgressMonitorJobsDialog.java;2;0;22;2;8;1;14;8;390;8;6;140;722;722;8;2;13;14;22;266;15;314;7;2;1
/org.eclipse.ui.workbench/Eclipse UI/org/eclipse/ui/internal/presentations/UpdatingActionContributionItem.java;1;0;1;1;1;1;1;0;0;0;0;279;0;0;1;0;0;0;1;279;0;279;1;1;0
/org.eclipse.ui.workbench/Eclipse UI/org/eclipse/ui/IPageLayout.java;6;3;10;2;4;2;4;6;124;2;5;36;223;223;3;1;2;6;10;293;3;336;7;6;1
/org.eclipse.jdt.core/compiler/org/eclipse/jdt/internal/compiler/impl/LongConstant.java;2;0;3;1;1;1;1;2;6;1;2;70;14;14;1;0;0;2;3;70;0;299;3;2;0
/org.eclipse.swt/Eclipse SWT PI/gtk/org/eclipse/swt/internal/gtk/GtkAdjustment.java;2;0;2;1;1;1;1;1;17;0;1;100;19;19;1;0;0;1;2;100;0;337;2;2;0
/org.eclipse.debug.ui/ui/org/eclipse/debug/ui/ILaunchConfigurationTabGroup.java;1;0;2;1;0;0;0;2;45;1;2;104;49;49;1;0;0;2;2;104;0;155;2;1;0
/org.eclipse.jdt.core/compiler/org/eclipse/jdt/internal/compiler/lookup/UpdatedMethodBinding.java;2;0;2;1;0;0;0;2;2;1;2;37;2;2;1;0;0;2;2;37;0;199;2;2;0
/org.eclipse.pde.ui/src/org/eclipse/pde/internal/ui/wizards/extension/NewExtensionPointMainPage.java;2;2;6;1;5;4;5;1;54;0;1;44;82;82;2;0;1;1;6;281;1;336;5;2;0
/org.eclipse.core.runtime/src/org/eclipse/core/internal/preferences/EclipsePreferences.java;2;10;30;2;11;2;15;15;2687;0;1;239;3158;3158;19;14;13;19;30;239;27;312;3;2;6
/org.eclipse.ui.workbench/Eclipse UI/org/eclipse/ui/internal/activities/ws/ActivityCategoryContentProvider.java;2;0;2;1;1;1;1;1;2;0;1;194;2;2;1;0;0;1;2;194;0;336;2;2;2
/org.eclipse.swt/Eclipse SWT PI/carbon/org/eclipse/swt/internal/carbon/OS.java;4;6;52;4;11;3;11;41;126;19;8;6;325;325;19;33;8;41;52;96;41;323;11;4;1
/org.eclipse.core.resources/src/org/eclipse/core/internal/properties/IVisitor.java;1;0;1;1;1;1;1;0;72;0;0;277;72;72;1;0;0;0;1;277;0;277;1;1;0
/org.eclipse.jdt.core/search/org/eclipse/jdt/internal/core/search/indexing/IndexManager.java;4;2;26;2;4;2;9;17;318;7;10;7;837;837;7;7;7;22;26;266;14;324;12;4;2
/org.eclipse.jdt.ui/ui/org/eclipse/jdt/internal/ui/infoviews/CopyToClipboardAction.java;1;0;2;1;1;1;1;1;2;0;1;86;2;2;1;0;0;1;2;86;0;336;2;1;0
/org.eclipse.pde.build/src/org/eclipse/pde/internal/build/site/BuildTimeSite.java;2;5;20;2;9;3;9;11;228;3;6;31;385;385;5;5;6;11;20;296;11;330;9;2;0
/org.eclipse.search/search/org/eclipse/search/internal/ui/text/TextSearchActionGroup.java;2;0;3;1;1;1;1;2;41;1;2;165;70;70;1;0;0;2;3;165;0;336;3;2;0
/org.eclipse.jdt.ui/ui refactoring/org/eclipse/jdt/internal/ui/refactoring/reorg/ReorgUserInputPage.java;5;2;12;1;4;3;5;7;42;2;6;70;89;89;2;1;2;8;12;113;3;336;9;5;0
/org.eclipse.pde.core/src/org/eclipse/pde/internal/core/schema/EditableSchema.java;2;1;3;1;2;2;2;1;4;0;1;232;10;10;1;0;0;1;3;232;0;336;3;2;0
/org.eclipse.ui.editors/src/org/eclipse/ui/editors/text/IEncodingActionsConstants.java;1;1;2;1;2;2;2;0;7;0;0;314;11;11;1;0;0;0;2;314;0;336;2;1;0
/org.eclipse.ltk.core.refactoring/src/org/eclipse/ltk/internal/core/refactoring/Changes.java;1;0;2;1;1;1;1;1;6;0;1;264;6;6;1;0;0;1;2;264;0;332;2;1;0
/org.eclipse.swt/Eclipse SWT PI/carbon/org/eclipse/swt/internal/carbon/HICommand.java;1;0;2;1;2;1;2;0;20;0;0;296;20;20;2;0;1;0;2;296;1;296;1;1;0
/org.eclipse.ui.editors/src/org/eclipse/ui/texteditor/ChainedPreferenceStore.java;2;2;3;2;3;2;3;0;167;0;0;295;171;171;2;0;1;0;3;295;1;336;2;2;0
/org.eclipse.core.resources/src/org/eclipse/core/internal/resources/ProjectInfo.java;2;1;3;1;2;2;2;1;152;0;1;239;183;183;1;0;0;1;3;239;0;296;3;2;0
/org.eclipse.osgi/resolver/src/org/eclipse/osgi/internal/resolver/BundleDeltaImpl.java;3;2;5;1;4;3;4;1;26;0;1;171;44;44;2;0;1;1;5;276;1;336;4;3;0
/org.eclipse.jdt.ui/ui refactoring/org/eclipse/jdt/internal/ui/refactoring/JavaStatusContextViewer.java;4;0;11;2;1;1;3;8;30;3;8;57;95;95;3;0;2;10;11;269;2;336;9;4;0
/org.eclipse.jdt.ui/ui/org/eclipse/jdt/internal/ui/text/AbstractJavaScanner.java;2;1;3;1;2;2;2;1;90;0;1;228;102;102;1;0;0;1;3;228;0;336;3;2;0
/org.eclipse.swt/Eclipse SWT PI/motif/org/eclipse/swt/internal/motif/XmAnyCallbackStruct.java;1;0;1;1;0;0;0;1;4;0;1;54;4;4;1;0;0;1;1;54;0;54;1;1;0
/org.eclipse.search/search/org/eclipse/search/ui/IContextMenuConstants.java;1;0;1;1;1;1;1;0;2;0;0;336;2;2;1;0;0;0;1;336;0;336;1;1;0
/org.eclipse.swt/Eclipse SWT/photon/org/eclipse/swt/widgets/Scrollable.java;1;1;2;1;2;2;2;0;4;0;0;300;8;8;1;0;0;0;2;300;0;337;2;1;0
/org.eclipse.ant.ui/Ant Tools Support/org/eclipse/ant/internal/ui/launchConfigurations/RemoteAntProcessFactory.java;1;0;2;1;1;1;1;1;6;0;1;112;6;6;1;0;0;1;2;112;0;330;2;1;0
/org.eclipse.search/search/org/eclipse/search/internal/ui/text/RegExContentAssistProcessor.java;2;1;3;1;3;3;3;0;54;0;0;295;56;56;1;0;0;0;3;295;0;336;3;2;0
/org.eclipse.jdt.core/dom/org/eclipse/jdt/core/dom/VariableDeclarationFragment.java;4;0;9;1;2;1;2;7;130;2;6;199;168;168;2;1;1;7;9;266;2;276;7;4;1
/org.eclipse.jface.text/src/org/eclipse/jface/text/source/AnnotationPainter.java;4;6;44;3;16;4;16;28;827;12;7;82;2233;2233;12;21;12;28;44;147;33;325;11;4;0
/org.eclipse.ltk.core.refactoring/src/org/eclipse/ltk/core/refactoring/DocumentChange.java;1;2;6;1;3;2;3;3;7;0;1;264;17;17;3;2;1;3;6;264;3;336;3;1;0
/org.eclipse.jdt.junit/src/org/eclipse/jdt/internal/junit/ui/TestRunnerViewPart.java;5;6;37;2;12;4;15;22;324;6;8;14;1177;1177;6;14;11;25;37;262;25;336;12;5;3
/org.eclipse.ui.forms/src/org/eclipse/ui/forms/SectionPart.java;1;0;8;1;1;1;2;6;236;4;3;225;262;262;4;3;1;7;8;225;4;336;4;1;0
/org.eclipse.ui.forms/src/org/eclipse/ui/internal/forms/widgets/BulletParagraph.java;1;1;2;1;2;2;2;0;6;0;0;272;6;6;1;0;0;0;2;272;0;336;2;1;0
/org.eclipse.ant.ui/Ant Tools Support/org/eclipse/ant/internal/ui/launchConfigurations/AntLaunchShortcut.java;3;3;13;2;6;3;6;7;141;2;6;108;351;351;3;1;3;7;13;300;4;336;9;3;1
/org.eclipse.swt/Eclipse SWT Custom Widgets/common/org/eclipse/swt/custom/CTabItem.java;4;10;31;2;14;3;14;17;1757;11;4;19;2637;2637;11;13;11;17;31;224;24;331;7;4;0
/org.eclipse.search/new search/org/eclipse/search2/internal/ui/basic/views/ShowNextResultAction.java;2;0;3;1;1;1;1;2;8;1;2;195;10;10;1;0;0;2;3;195;0;336;3;2;0
/org.eclipse.team.cvs.ui/src/org/eclipse/team/internal/ccvs/ui/HistoryFilterDialog.java;1;0;1;1;0;0;0;1;4;0;1;138;4;4;1;0;0;1;1;138;0;138;1;1;0
/org.eclipse.jdt.ui/ui/org/eclipse/jdt/internal/ui/text/correction/ReplaceCorrectionProposal.java;3;0;7;1;1;1;1;6;14;2;4;116;47;47;2;2;0;6;7;116;2;336;5;3;0
/org.eclipse.jface.text/src/org/eclipse/jface/text/source/IAnnotationHover.java;2;0;2;2;2;1;2;0;22;0;0;336;22;22;2;0;1;0;2;336;1;336;1;2;0
/org.eclipse.swt/Eclipse SWT Drag and Drop/motif/org/eclipse/swt/dnd/TreeDragUnderEffect.java;3;1;3;1;2;2;2;1;91;0;1;53;97;97;1;0;0;1;3;53;0;337;3;3;0
/org.eclipse.osgi/osgi/src/org/eclipse/osgi/service/resolver/VersionConstraint.java;5;3;9;2;4;2;4;5;74;2;3;171;152;152;3;2;2;5;9;290;4;290;5;5;0
/org.eclipse.pde.build/src/org/eclipse/pde/internal/build/ant/Condition.java;2;1;7;1;2;2;2;5;256;2;3;31;653;653;2;2;0;5;7;31;2;336;5;2;0
/org.eclipse.jdt.ui/ui/org/eclipse/jdt/internal/ui/wizards/buildpaths/UserLibraryMarkerResolutionGenerator.java;2;2;4;1;3;2;3;1;36;0;1;243;63;63;2;0;1;1;4;276;1;292;3;2;0
/org.eclipse.ltk.ui.refactoring/src/org/eclipse/ltk/internal/ui/refactoring/ChangePreviewViewerDescriptor.java;1;0;3;1;1;1;2;1;8;0;1;269;10;10;2;0;1;2;3;269;1;336;2;1;0
/org.eclipse.ui.workbench/Eclipse UI/org/eclipse/ui/internal/commands/ws/HandlerProxy.java;3;1;4;1;3;3;3;1;51;0;1;269;72;72;1;0;0;1;4;269;0;336;4;3;0
/org.eclipse.ui.ide/src/org/eclipse/ui/views/tasklist/TaskPropertiesDialog.java;4;1;4;1;3;3;3;1;104;0;1;129;108;108;1;0;0;1;4;129;0;336;4;4;1
/org.eclipse.jdt.ui/ui/org/eclipse/jdt/internal/ui/text/folding/JavaFoldingStructureProviderDescriptor.java;1;1;2;1;2;2;2;0;6;0;0;292;6;6;1;0;0;0;2;292;0;336;2;1;0
/org.eclipse.debug.core/core/org/eclipse/debug/core/sourcelookup/AbstractSourceLookupParticipant.java;2;0;2;1;1;1;1;1;5;0;1;268;5;5;1;0;0;1;2;268;0;303;2;2;0
/org.eclipse.ui.workbench/Eclipse UI/org/eclipse/ui/internal/WorkingSetFactory.java;1;0;1;1;0;0;0;1;9;0;1;181;9;9;1;0;0;1;1;181;0;181;1;1;0
/org.eclipse.ui.editors/src/org/eclipse/ui/editors/text/TextEditorActionContributor.java;2;0;2;1;1;1;1;1;9;0;1;157;16;16;1;0;0;1;2;157;0;336;2;2;0
/org.eclipse.update.core/src/org/eclipse/update/internal/core/UpdateManagerLogWriter.java;2;2;7;1;3;2;3;4;103;2;3;58;189;189;2;1;1;4;7;240;2;336;5;2;0
/org.eclipse.debug.core/core/org/eclipse/debug/core/sourcelookup/containers/LocalFileStorage.java;1;0;1;1;0;0;0;1;0;0;1;268;0;0;1;0;0;1;1;268;0;268;1;1;0
/org.eclipse.team.cvs.core/src/org/eclipse/team/internal/ccvs/core/CVSMergeSubscriber.java;2;0;26;2;1;1;1;25;576;7;8;36;1317;1317;7;17;0;25;26;70;17;336;9;2;0
/org.eclipse.ui.workbench.texteditor/src/org/eclipse/ui/texteditor/templates/TextEditorTemplateMessages.java;2;1;2;1;2;2;2;0;2;0;0;286;2;2;1;0;0;0;2;286;0;336;2;2;0
/org.eclipse.swt/Eclipse SWT/carbon/org/eclipse/swt/graphics/GCData.java;2;0;6;2;0;0;0;6;6;3;3;24;13;13;3;3;0;6;6;24;3;130;3;2;0
/org.eclipse.pde.core/src/org/eclipse/pde/internal/core/plugin/Plugin.java;3;3;10;2;4;2;4;6;56;1;6;134;102;102;3;0;2;6;10;306;2;336;8;3;0
/org.eclipse.compare/compare/org/eclipse/compare/rangedifferencer/LinkedRangeDifference.java;1;0;2;1;0;0;0;2;2;1;2;19;4;4;1;0;0;2;2;19;0;219;2;1;0
/org.eclipse.jdt.debug.ui/ui/org/eclipse/jdt/internal/debug/ui/snippeteditor/ShowInPackageViewAction.java;3;1;4;2;2;2;2;2;15;0;1;91;31;31;2;1;0;2;4;91;1;336;3;3;0
/org.eclipse.core.runtime.compatibility/src-model/org/eclipse/core/runtime/model/PluginPrerequisiteModel.java;3;1;5;1;3;3;3;2;25;1;2;171;34;34;1;0;0;2;5;171;0;336;5;3;0
/org.eclipse.jdt.ui/ui/org/eclipse/jdt/internal/ui/search/OccurrencesInFileLabelProvider.java;3;1;3;1;2;2;2;1;4;0;1;209;10;10;1;0;0;1;3;209;0;336;3;3;0
/org.eclipse.team.cvs.ui/src/org/eclipse/team/internal/ccvs/ui/subscriber/CVSSynchronizeWizard.java;2;3;4;1;4;2;4;0;63;0;0;296;72;72;3;0;2;0;4;296;2;315;2;2;0
/org.eclipse.pde.core/src/org/eclipse/pde/internal/core/plugin/PluginReference.java;2;1;3;1;2;2;2;1;6;0;1;232;12;12;1;0;0;1;3;232;0;336;3;2;0
/org.eclipse.jdt.ui/core refactoring/org/eclipse/jdt/internal/corext/refactoring/changes/DeleteFolderChange.java;3;1;5;1;2;2;2;3;14;1;3;31;38;38;1;0;0;3;5;31;0;336;5;3;1
/org.eclipse.jdt.ui/ui/org/eclipse/jdt/internal/ui/text/correction/NewCUCompletionUsingWizardProposal.java;1;0;4;1;1;1;1;3;9;1;3;61;19;19;1;0;0;3;4;61;0;297;4;1;0
/org.eclipse.jface.text/src/org/eclipse/jface/text/source/IVerticalRulerInfoExtension.java;3;2;5;2;3;2;3;2;23;1;2;70;47;47;2;0;1;2;5;336;1;336;4;3;0
/org.eclipse.jdt.ui/core extension/org/eclipse/jdt/internal/corext/util/JdtFlags.java;4;1;9;1;3;3;3;6;78;2;5;18;190;190;2;1;0;6;9;69;1;336;8;4;0
/org.eclipse.jdt.ui/ui/org/eclipse/jdt/internal/ui/wizards/buildpaths/JARFileSelectionDialog.java;1;0;2;1;1;1;1;1;4;0;1;82;6;6;1;0;0;1;2;82;0;336;2;1;0
/org.eclipse.jface.text/src/org/eclipse/jface/text/formatter/FormattingContextProperties.java;3;3;7;2;4;2;4;3;40;2;2;119;116;116;3;1;2;3;7;334;3;334;4;3;0
/org.eclipse.ui.workbench/Eclipse UI/org/eclipse/ui/model/WorkbenchPartLabelProvider.java;2;0;2;1;0;0;0;2;78;1;2;93;78;78;1;0;0;2;2;93;0;157;2;2;0
/org.eclipse.ui.ide/src/org/eclipse/ui/wizards/newresource/BasicNewFolderResourceWizard.java;1;0;1;1;0;0;0;1;0;0;1;92;0;0;1;0;0;1;1;92;0;92;1;1;0
/org.eclipse.jdt.launching/launching/org/eclipse/jdt/launching/IJavaLaunchConfigurationConstants.java;2;0;4;1;1;1;1;3;36;1;3;112;53;53;1;0;0;3;4;112;0;336;4;2;0
/org.eclipse.ui.workbench.texteditor/src/org/eclipse/ui/internal/texteditor/quickdiff/compare/rangedifferencer/IRangeComparator.java;1;1;3;1;2;2;2;1;2;0;1;100;4;4;1;0;0;1;3;100;0;336;3;1;0
/org.eclipse.core.variables/src/org/eclipse/core/variables/IValueVariableInitializer.java;1;0;1;1;0;0;0;1;0;0;1;145;0;0;1;0;0;1;1;145;0;145;1;1;0
/org.eclipse.jdt.debug.ui/ui/org/eclipse/jdt/internal/debug/ui/ZipEntryStorageEditorInput.java;2;1;2;1;2;2;2;0;7;0;0;274;11;11;1;0;0;0;2;274;0;286;2;2;0
/org.eclipse.ui.ide/src/org/eclipse/ui/wizards/datatransfer/ZipFileExporter.java;1;0;1;1;0;0;0;1;0;0;1;92;0;0;1;0;0;1;1;92;0;92;1;1;0
/org.eclipse.core.runtime/src/org/eclipse/core/internal/registry/RegistryCacheReader.java;4;5;19;3;9;3;9;10;711;4;5;173;1401;1401;5;5;6;10;19;296;11;327;8;4;0
/org.eclipse.swt/Eclipse SWT/gtk/org/eclipse/swt/widgets/MessageBox.java;3;1;4;1;2;2;2;2;20;1;2;161;33;33;1;0;0;2;4;161;0;337;4;3;0
/org.eclipse.ui.workbench/Eclipse UI/org/eclipse/ui/part/ISetSelectionTarget.java;1;0;1;1;0;0;0;1;4;0;1;0;4;4;1;0;0;1;1;0;0;0;1;1;0
/org.eclipse.team.ui/src/org/eclipse/team/ui/synchronize/ISynchronizeModelChangeListener.java;1;1;3;1;2;2;2;1;2;0;1;253;3;3;1;0;0;1;3;253;0;336;3;1;0
/org.eclipse.team.cvs.ui/src/org/eclipse/team/internal/ccvs/ui/repo/RepositoryRoot.java;2;2;13;2;4;3;4;9;121;4;4;5;228;228;4;5;1;9;13;121;6;336;7;2;2
/org.eclipse.ui.workbench/Eclipse UI/org/eclipse/ui/activities/IActivityManagerListener.java;3;1;6;1;2;2;2;4;21;1;4;131;42;42;1;0;0;4;6;131;0;336;6;3;0
/org.eclipse.ui.workbench/Eclipse UI/org/eclipse/ui/internal/keys/OutOfOrderListener.java;2;0;5;1;1;1;1;4;19;2;3;171;48;48;2;1;0;4;5;254;1;336;4;2;0
/org.eclipse.jdt.ui/ui/org/eclipse/jdt/internal/ui/wizards/NewClassCreationWizard.java;2;1;5;1;2;2;2;3;25;2;2;225;57;57;2;1;0;3;5;225;1;336;4;2;0
/org.eclipse.ui.ide/src/org/eclipse/ui/internal/ide/dialogs/SimpleListContentProvider.java;1;0;1;1;0;0;0;1;0;0;1;132;0;0;1;0;0;1;1;132;0;132;1;1;0
/org.eclipse.ant.ui/Ant Tools Support/org/eclipse/ant/internal/ui/preferences/PropertyFileFilter.java;1;0;1;1;0;0;0;1;0;0;1;108;0;0;1;0;0;1;1;108;0;108;1;1;0
/org.eclipse.update.core/src/org/eclipse/update/core/IIncludedFeatureReference.java;4;1;5;1;2;2;2;3;6;1;3;0;26;26;1;0;0;3;5;0;0;336;5;4;0
/org.eclipse.ui.externaltools/External Tools Base/org/eclipse/ui/externaltools/internal/variables/BuildTypeResolver.java;2;0;4;1;0;0;0;4;8;2;3;123;16;16;2;1;0;4;4;123;1;145;3;2;0
/org.eclipse.ui.workbench/Eclipse UI/org/eclipse/ui/IActionBars2.java;2;0;2;2;0;0;0;2;4;0;1;181;4;4;2;1;0;2;2;181;1;181;1;2;0
/org.eclipse.ui.ide/extensions/org/eclipse/ui/IMarkerHelpRegistry.java;1;0;1;1;0;0;0;1;0;0;1;132;0;0;1;0;0;1;1;132;0;132;1;1;0
/org.eclipse.core.resources/src/org/eclipse/core/internal/resources/MarkerDelta.java;2;0;5;1;2;1;2;3;439;1;3;13;492;492;2;0;1;3;5;275;1;275;4;2;0
/org.eclipse.update.ui/src/org/eclipse/update/internal/ui/views/ReplaceVersionAction.java;3;0;7;2;1;1;1;6;13;2;4;76;30;30;2;2;0;6;7;76;2;336;5;3;0
/org.eclipse.update.core/src/org/eclipse/update/search/IQueryUpdateSiteAdapter.java;2;0;5;2;1;1;1;4;16;2;3;54;27;27;2;1;0;4;5;267;1;292;4;2;0
/org.eclipse.osgi/eclipseAdaptor/src/org/eclipse/core/runtime/adaptor/PluginParser.java;4;9;29;4;12;3;12;17;629;7;4;177;1212;1212;9;13;9;17;29;275;22;326;7;4;0
/org.eclipse.jdt.ui/ui/org/eclipse/jdt/internal/ui/text/comment/ICommentAttributes.java;3;0;5;1;1;1;1;4;36;3;2;124;45;45;3;2;0;4;5;124;2;336;3;3;0
/org.eclipse.pde.ui/src/org/eclipse/pde/internal/ui/editor/plugin/rows/ChoiceAttributeRow.java;2;1;3;1;3;3;3;0;10;0;0;292;14;14;1;0;0;0;3;292;0;336;3;2;0
/org.eclipse.search/search/org/eclipse/search/internal/ui/GotoMarkerAction.java;1;0;1;1;1;1;1;0;2;0;0;336;2;2;1;0;0;0;1;336;0;336;1;1;0
/org.eclipse.jdt.ui/core extension/org/eclipse/jdt/internal/corext/ValidateEditException.java;1;0;1;1;1;1;1;0;2;0;0;336;2;2;1;0;0;0;1;336;0;336;1;1;0
/org.eclipse.ui.workbench/Eclipse UI/org/eclipse/ui/internal/activities/ws/ActivityCategoryLabelProvider.java;2;0;3;1;1;1;1;2;10;1;2;194;12;12;1;0;0;2;3;194;0;336;3;2;0
/org.eclipse.jdt.ui/ui/org/eclipse/jdt/internal/ui/filters/NonSharedProjectFilter.java;1;0;1;1;1;1;1;0;2;0;0;336;2;2;1;0;0;0;1;336;0;336;1;1;0
/org.eclipse.pde.ui/src/org/eclipse/pde/internal/ui/editor/feature/FeatureReferencePage.java;2;1;4;1;3;3;3;1;96;0;1;232;108;108;1;0;0;1;4;232;0;336;4;2;0
/org.eclipse.jdt.core/compiler/org/eclipse/jdt/internal/compiler/codegen/MethodNameAndTypeCache.java;2;0;2;1;1;1;1;1;2;0;1;199;4;4;1;0;0;1;2;199;0;314;2;2;0
/org.eclipse.jdt.ui/core extension/org/eclipse/jdt/internal/corext/codemanipulation/IRequestQuery.java;1;0;1;1;1;1;1;0;2;0;0;336;2;2;1;0;0;0;1;336;0;336;1;1;0
/org.eclipse.ltk.core.refactoring/src/org/eclipse/ltk/core/refactoring/participants/RenameArguments.java;1;0;4;1;2;1;2;2;5;0;1;264;7;7;2;1;1;2;4;264;2;275;2;1;0
/org.eclipse.ui.workbench/Eclipse UI/org/eclipse/ui/internal/IWindowTrim.java;2;0;2;1;0;0;0;2;42;1;2;205;42;42;1;0;0;2;2;205;0;223;2;2;0
/org.eclipse.ui.workbench/Eclipse UI/org/eclipse/ui/internal/layout/CellLayout.java;1;0;1;1;1;1;1;0;0;0;0;271;0;0;1;0;0;0;1;271;0;271;1;1;0
/org.eclipse.jdt.core/model/org/eclipse/jdt/internal/core/util/FieldInfo.java;2;0;2;1;1;1;1;1;8;0;1;199;10;10;1;0;0;1;2;199;0;314;2;2;0
/org.eclipse.jdt.ui/ui/org/eclipse/jdt/internal/ui/text/JavaBreakIterator.java;2;2;3;1;3;2;3;0;8;0;0;323;11;11;2;0;1;0;3;323;1;336;2;2;0
/org.eclipse.jdt.core/search/org/eclipse/jdt/internal/core/search/indexing/SourceIndexerRequestor.java;4;0;6;2;1;1;1;5;61;2;4;7;107;107;2;1;0;5;6;107;1;299;5;4;0
/org.eclipse.ant.ui/Ant Tools Support/org/eclipse/ant/internal/ui/preferences/AntTypesPage.java;1;0;5;1;0;0;0;5;69;3;3;108;102;102;3;2;0;5;5;108;2;170;3;1;1
/org.eclipse.search/new search/org/eclipse/search2/internal/ui/RemoveAllSearchesAction.java;2;1;4;1;2;2;2;2;8;1;2;195;12;12;1;0;0;2;4;195;0;336;4;2;0
/org.eclipse.pde.ui/src/org/eclipse/pde/internal/ui/editor/site/BuiltFeaturesWizard.java;2;0;3;2;2;1;2;1;5;0;1;208;9;9;2;0;1;1;3;331;1;331;2;2;0
/org.eclipse.ui.workbench/Eclipse UI/org/eclipse/ui/internal/util/ImageSupport.java;4;0;5;1;1;1;1;4;18;1;4;104;40;40;1;0;0;4;5;104;0;336;5;4;0
/org.eclipse.pde.runtime/src/org/eclipse/pde/internal/runtime/registry/ConfigurationElementPropertySource.java;2;0;4;1;1;1;1;3;72;2;2;59;149;149;2;1;0;3;4;224;1;336;3;2;0
/org.eclipse.ui.workbench/Eclipse UI/org/eclipse/ui/internal/dialogs/PreferenceErrorDialog.java;4;2;4;2;3;2;3;1;11;0;1;157;16;16;2;0;1;1;4;299;1;336;3;4;0
/org.eclipse.swt/Eclipse SWT/gtk/org/eclipse/swt/graphics/FontMetrics.java;2;0;2;1;1;1;1;1;10;0;1;244;14;14;1;0;0;1;2;244;0;337;2;2;0
/org.eclipse.ant.ui/Ant Tools Support/org/eclipse/ant/internal/ui/preferences/AntPropertiesPage.java;1;0;4;1;1;1;1;3;4;2;2;108;10;10;2;1;0;3;4;108;1;336;3;1;1
/org.eclipse.search/new search/org/eclipse/search/ui/text/RemoveAllEvent.java;2;2;4;2;3;2;3;1;18;0;1;207;19;19;2;0;1;1;4;335;1;335;3;2;0
/org.eclipse.jdt.ui/ui/org/eclipse/jdt/internal/ui/browsing/PackagesViewHierarchicalContentProvider.java;1;2;4;1;3;2;3;1;38;0;1;20;44;44;2;0;1;1;4;321;1;336;3;1;0
/org.eclipse.jdt.ui/ui/org/eclipse/jdt/internal/ui/wizards/buildpaths/VariableCreationDialog.java;2;0;2;1;1;1;1;1;10;0;1;265;12;12;1;0;0;1;2;265;0;336;2;2;0
/org.eclipse.pde.core/src/org/eclipse/pde/internal/core/bundle/Bundle.java;2;1;4;1;2;2;2;2;98;0;1;128;108;108;2;1;0;2;4;128;1;336;3;2;0
/org.eclipse.update.ui/src/org/eclipse/update/internal/ui/model/ConfiguredSiteAdapter.java;1;0;1;1;0;0;0;1;4;0;1;79;4;4;1;0;0;1;1;79;0;79;1;1;0
/org.eclipse.swt/Eclipse SWT/photon/org/eclipse/swt/widgets/FileDialog.java;3;1;3;2;2;2;2;1;19;0;1;153;27;27;1;0;0;1;3;153;0;337;3;3;0
/org.eclipse.pde.core/src/org/eclipse/pde/internal/core/plugin/PluginExtensionPoint.java;3;2;7;2;4;3;4;3;26;1;3;128;68;68;2;0;1;3;7;306;1;336;6;3;0
/org.eclipse.jdt.ui/ui refactoring/org/eclipse/jdt/internal/ui/refactoring/reorg/RenameMethodWizard.java;2;1;3;1;2;2;2;1;10;0;1;71;19;19;1;0;0;1;3;71;0;336;3;2;0
/org.eclipse.team.cvs.core/src/org/eclipse/team/internal/ccvs/core/ICVSRemoteFolder.java;1;0;1;1;0;0;0;1;3;0;1;113;3;3;1;0;0;1;1;113;0;113;1;1;0
/org.eclipse.ltk.core.refactoring/src/org/eclipse/ltk/internal/core/refactoring/NotCancelableProgressMonitor.java;1;0;1;1;1;1;1;0;0;0;0;283;0;0;1;0;0;0;1;283;0;283;1;1;0
/org.eclipse.core.filebuffers/src/org/eclipse/core/internal/filebuffers/ResourceFileBuffer.java;3;2;10;3;4;2;4;6;44;5;2;130;106;106;5;4;2;6;10;130;6;332;4;3;0
/org.eclipse.team.cvs.ui/src/org/eclipse/team/internal/ccvs/ui/model/CVSFolderElement.java;2;0;2;1;0;0;0;2;5;1;2;5;7;7;1;0;0;2;2;5;0;63;2;2;0
/org.eclipse.pde.ui/src/org/eclipse/pde/internal/ui/wizards/WizardCollectionElement.java;2;1;2;1;2;2;2;0;6;0;0;308;10;10;1;0;0;0;2;308;0;336;2;2;0
/org.eclipse.jdt.core/model/org/eclipse/jdt/core/IField.java;3;0;5;1;1;1;1;4;68;1;4;107;85;85;1;0;0;4;5;107;0;272;5;3;0
/org.eclipse.team.cvs.ui/src/org/eclipse/team/internal/ccvs/ui/repo/RepositoryEncodingPropertyPage.java;2;2;6;2;5;3;5;1;19;0;1;264;28;28;2;0;2;1;6;288;2;320;4;2;0
/org.eclipse.ui.workbench/Eclipse UI/org/eclipse/ui/internal/PerspectiveSwitcher.java;5;0;9;5;9;1;9;0;1136;0;0;306;1136;1136;9;0;8;0;9;306;8;306;1;5;3
/org.eclipse.help.base/src/org/eclipse/help/internal/standalone/EclipseController.java;1;2;7;1;4;3;4;3;241;1;3;104;372;372;2;0;1;3;7;296;1;336;6;1;1
/org.eclipse.jdt.ui/ui/org/eclipse/jdt/internal/ui/filters/LibraryFilter.java;1;0;1;1;1;1;1;0;2;0;0;336;2;2;1;0;0;0;1;336;0;336;1;1;0
/org.eclipse.pde.core/src/org/eclipse/pde/core/IWritable.java;2;1;4;1;3;3;3;1;42;0;1;232;54;54;1;0;0;1;4;232;0;336;4;2;0
/org.eclipse.swt/Eclipse SWT PI/carbon/org/eclipse/swt/internal/carbon/EventRecord.java;1;0;2;1;2;1;2;0;20;0;0;296;20;20;2;0;1;0;2;296;1;296;1;1;0
/org.eclipse.help.ui/src/org/eclipse/help/ui/internal/HelpUIResources.java;1;1;7;1;3;3;3;4;181;2;3;106;301;301;2;1;0;4;7;253;1;336;6;1;0
/org.eclipse.search/search/org/eclipse/search/internal/ui/SearchMessages.java;1;0;1;1;1;1;1;0;2;0;0;336;2;2;1;0;0;0;1;336;0;336;1;1;0
/org.eclipse.compare/compare/org/eclipse/compare/internal/BaseCompareAction.java;1;0;1;1;0;0;0;1;0;0;1;104;0;0;1;0;0;1;1;104;0;104;1;1;0
/org.eclipse.jdt.debug.ui/ui/org/eclipse/jdt/internal/debug/ui/actions/ExcludeExceptionLocationAction.java;1;0;1;1;0;0;0;1;6;0;1;97;6;6;1;0;0;1;1;97;0;97;1;1;0
/org.eclipse.jdt.core/model/org/eclipse/jdt/core/ToolFactory.java;4;0;20;2;0;0;0;20;105;4;12;5;227;227;4;8;0;20;20;54;8;267;12;4;1
/org.eclipse.pde.ui/src/org/eclipse/pde/internal/ui/editor/text/XMLPartitionScanner.java;3;1;4;1;2;2;2;2;19;1;2;211;31;31;1;0;0;2;4;211;0;336;4;3;0
/org.eclipse.ui.ide/src/org/eclipse/ui/internal/ide/DialogUtil.java;3;1;3;1;2;2;2;1;7;0;1;93;9;9;1;0;0;1;3;93;0;336;3;3;0
/org.eclipse.debug.core/core/org/eclipse/debug/core/IProcessFactory.java;3;1;5;2;2;2;2;3;31;2;2;112;39;39;2;1;0;3;5;112;1;336;4;3;0
/org.eclipse.jdt.ui/core refactoring/org/eclipse/jdt/internal/corext/refactoring/code/TargetProvider.java;4;2;10;1;4;3;4;6;45;1;6;16;100;100;2;0;1;6;10;286;1;336;9;4;1
/org.eclipse.jdt.core/search/org/eclipse/jdt/internal/core/search/matching/PackageDeclarationPattern.java;3;0;13;2;2;1;2;11;37;2;9;52;166;166;2;2;1;11;13;109;3;280;10;3;0
/org.eclipse.jface.text/src/org/eclipse/jface/internal/text/link/contentassist/HTML2TextReader.java;3;1;4;1;3;3;3;1;6;0;1;232;10;10;1;0;0;1;4;232;0;336;4;3;0
/org.eclipse.jdt.ui/core refactoring/org/eclipse/jdt/internal/corext/refactoring/code/flow/GenericConditionalFlowInfo.java;1;0;1;1;1;1;1;0;2;0;0;336;2;2;1;0;0;0;1;336;0;336;1;1;0
/org.eclipse.ui.editors/src/org/eclipse/ui/internal/editors/text/SharedTextColors.java;2;0;3;1;1;1;1;2;2;1;2;100;2;2;1;0;0;2;3;100;0;336;3;2;0
/org.eclipse.search/search/org/eclipse/search/internal/ui/RemoveAllSearchesAction.java;1;0;1;1;1;1;1;0;2;0;0;336;2;2;1;0;0;0;1;336;0;336;1;1;0
/org.eclipse.core.runtime/src/org/eclipse/core/internal/jobs/Semaphore.java;3;0;9;2;1;1;1;8;224;3;6;25;296;296;3;2;0;8;9;171;2;277;7;3;0
/org.eclipse.ui.workbench/Eclipse UI/org/eclipse/ui/activities/IIdentifier.java;3;1;5;1;2;2;2;3;87;2;2;170;122;122;2;1;0;3;5;170;1;336;4;3;0
/org.eclipse.pde.ui/src/org/eclipse/pde/internal/ui/editor/plugin/BundleSourcePage.java;1;2;4;1;4;3;4;0;10;0;0;292;14;14;2;0;1;0;4;292;1;336;3;1;0
/org.eclipse.jface.text/src/org/eclipse/jface/text/contentassist/ICompletionProposalExtension3.java;3;2;6;2;3;2;3;3;63;1;3;52;126;126;2;0;1;3;6;336;1;336;5;3;0
/org.eclipse.swt/Eclipse SWT/emulated/tabfolder/org/eclipse/swt/widgets/TabItem.java;3;1;4;1;2;2;2;2;12;1;2;19;20;20;1;0;0;2;4;19;0;337;4;3;0
/org.eclipse.swt/Eclipse SWT Mozilla/common/org/eclipse/swt/internal/mozilla/nsIDocumentLoaderFactory.java;1;0;1;1;0;0;0;1;0;0;1;153;0;0;1;0;0;1;1;153;0;153;1;1;0
/org.eclipse.ui.ide/src/org/eclipse/ui/views/markers/internal/TableSorter.java;3;1;3;1;2;2;2;1;2;0;1;129;4;4;1;0;0;1;3;129;0;336;3;3;0
/org.eclipse.jdt.ui/core refactoring/org/eclipse/jdt/internal/corext/refactoring/code/TempAssignmentFinder.java;1;0;1;1;1;1;1;0;2;0;0;336;2;2;1;0;0;0;1;336;0;336;1;1;0
/org.eclipse.jdt.core/model/org/eclipse/jdt/core/ISourceRange.java;1;0;1;1;0;0;0;1;2;0;1;199;2;2;1;0;0;1;1;199;0;199;1;1;0
/org.eclipse.jdt.ui/ui refactoring/org/eclipse/jdt/internal/ui/refactoring/nls/SourceContainerDialog.java;3;1;3;1;2;2;2;1;90;0;1;267;92;92;1;0;0;1;3;267;0;336;3;3;0
/org.eclipse.pde.ui/src/org/eclipse/pde/internal/ui/preferences/BuildOptionsPreferencePage.java;1;1;6;1;2;2;2;4;71;1;4;104;114;114;1;0;0;4;6;104;0;336;6;1;0
/org.eclipse.update.core/src/org/eclipse/update/operations/IReplaceFeatureVersionOperation.java;1;1;5;1;2;2;2;3;11;1;3;76;17;17;1;0;0;3;5;76;0;336;5;1;0
/org.eclipse.jdt.ui/ui/org/eclipse/jdt/ui/IWorkingCopyManager.java;2;0;2;1;1;1;1;1;2;0;1;263;4;4;1;0;0;1;2;263;0;336;2;2;0
/org.eclipse.jdt.core/eval/org/eclipse/jdt/internal/eval/EvaluationConstants.java;2;0;2;1;0;0;0;2;4;1;2;45;6;6;1;0;0;2;2;45;0;199;2;2;0
/org.eclipse.debug.core/core/org/eclipse/debug/core/sourcelookup/ISourceContainer.java;1;0;1;1;0;0;0;1;0;0;1;268;0;0;1;0;0;1;1;268;0;268;1;1;0
/org.eclipse.debug.core/core/org/eclipse/debug/internal/core/memory/IMemoryRendering.java;1;0;1;1;1;1;1;0;0;0;0;282;0;0;1;0;0;0;1;282;0;282;1;1;0
/org.eclipse.ui.ide/src/org/eclipse/ui/internal/ide/WorkbenchActionBuilder.java;8;6;42;5;11;4;11;31;1822;16;8;132;2617;2617;16;23;7;31;42;154;30;336;12;8;4
/org.eclipse.team.cvs.ssh/src/org/eclipse/team/internal/ccvs/ssh/SSHPlugin.java;1;0;1;1;0;0;0;1;8;0;1;56;8;8;1;0;0;1;1;56;0;56;1;1;0
/org.eclipse.jdt.ui/ui/org/eclipse/jdt/internal/ui/actions/SelectionConverter.java;4;0;6;2;1;1;1;5;71;2;4;26;107;107;2;1;0;5;6;81;1;336;5;4;0
/org.eclipse.jdt.ui/ui refactoring/org/eclipse/jdt/internal/ui/refactoring/nls/search/NLSSorter.java;1;0;1;1;0;0;0;1;0;0;1;268;0;0;1;0;0;1;1;268;0;268;1;1;0
/org.eclipse.update.core/src/org/eclipse/update/internal/core/ErrorRecoveryLog.java;3;0;11;2;2;1;2;9;149;4;5;58;232;232;4;4;1;9;11;251;5;302;6;3;0
/org.eclipse.jface/src/org/eclipse/jface/viewers/CellEditor.java;3;1;2;2;2;2;2;0;24;0;0;287;28;28;1;0;0;0;2;287;0;336;2;3;0
/org.eclipse.jface.text/src/org/eclipse/jface/text/source/JFaceTextMessages.java;1;1;3;1;2;2;2;1;17;0;1;103;21;21;1;0;0;1;3;103;0;336;3;1;0
/org.eclipse.ui.workbench/Eclipse UI/org/eclipse/ui/internal/themes/RGBContrastFactory.java;1;0;1;1;1;1;1;0;0;0;0;314;0;0;1;0;0;0;1;314;0;314;1;1;0
/org.eclipse.jdt.ui/ui/org/eclipse/jdt/ui/IContextMenuConstants.java;1;0;1;1;1;1;1;0;2;0;0;336;2;2;1;0;0;0;1;336;0;336;1;1;0
/org.eclipse.jdt.debug.ui/ui/org/eclipse/jdt/internal/debug/ui/actions/StepIntoSelectionHandler.java;4;0;5;2;1;1;1;4;234;2;3;13;258;258;2;1;0;4;5;246;1;336;4;4;1
/org.eclipse.jface.text/src/org/eclipse/jface/text/contentassist/IContextInformationPresenter.java;1;0;2;1;2;1;2;0;14;0;0;336;14;14;2;0;1;0;2;336;1;336;1;1;0
/org.eclipse.team.cvs.ui/src/org/eclipse/team/internal/ccvs/ui/PasswordManagementPreferencePage.java;2;1;4;1;4;4;4;0;204;0;0;274;216;216;1;0;0;0;4;274;0;336;4;2;0
/org.eclipse.pde.ui/src/org/eclipse/pde/internal/ui/editor/feature/ReferenceWizardPage.java;3;1;6;1;3;3;3;3;27;2;2;130;54;54;2;1;0;3;6;130;1;336;5;3;0
/org.eclipse.ui.ide/src/org/eclipse/ui/wizards/datatransfer/FileSystemStructureProvider.java;1;0;1;1;0;0;0;1;0;0;1;92;0;0;1;0;0;1;1;92;0;92;1;1;0
/org.eclipse.core.runtime.compatibility/src-runtime/org/eclipse/core/internal/compatibility/PluginActivator.java;4;1;11;3;2;2;3;8;94;3;4;178;137;137;3;4;1;9;11;219;5;314;6;4;1
/org.eclipse.jdt.ui/ui/org/eclipse/jdt/internal/ui/text/JavaCompositeReconcilingStrategy.java;2;1;7;2;2;2;2;5;24;3;2;219;32;32;3;3;0;5;7;253;3;336;4;2;0
/org.eclipse.debug.ui/ui/org/eclipse/debug/internal/ui/sourcelookup/browsers/ExternalArchiveSourceContainerBrowser.java;1;0;4;1;0;0;0;4;16;3;2;254;16;16;3;2;0;4;4;266;2;266;2;1;0
/org.eclipse.jdt.ui/ui/org/eclipse/jdt/internal/ui/viewsupport/SelectionListenerWithASTManager.java;2;2;14;2;4;3;4;10;186;6;3;165;433;433;6;7;1;10;14;191;8;336;6;2;1
/org.eclipse.jdt.launching/launching/org/eclipse/jdt/internal/launching/PackageFragmentRootSourceContainerTypeDelegate.java;1;0;4;1;0;0;0;4;56;3;2;227;56;56;3;2;0;4;4;266;2;266;2;1;0
/org.eclipse.ui.workbench/Eclipse UI/org/eclipse/ui/internal/presentations/SystemMenuFastViewOrientation.java;1;0;2;1;1;1;1;1;2;0;1;265;2;2;1;0;0;1;2;265;0;279;2;1;0
/org.eclipse.swt/Eclipse SWT Mozilla/common/org/eclipse/swt/internal/mozilla/nsIURI.java;1;0;2;1;0;0;0;2;54;1;2;100;54;54;1;0;0;2;2;100;0;148;2;1;0
/org.eclipse.jdt.ui/ui/org/eclipse/jdt/internal/ui/filters/NonJavaElementFilter.java;1;0;1;1;1;1;1;0;2;0;0;336;2;2;1;0;0;0;1;336;0;336;1;1;0
/org.eclipse.jdt.core/compiler/org/eclipse/jdt/internal/compiler/problem/AbortType.java;2;0;2;1;1;1;1;1;5;0;1;199;7;7;1;0;0;1;2;199;0;300;2;2;0
/org.eclipse.search/search/org/eclipse/search/internal/ui/SearchManager.java;2;0;6;1;1;1;1;5;110;2;4;82;138;138;2;1;0;5;6;180;1;336;5;2;0
/org.eclipse.core.resources/src/org/eclipse/core/internal/dtree/DataTreeNode.java;1;0;1;1;1;1;1;0;612;0;0;277;612;612;1;0;0;0;1;277;0;277;1;1;0
/org.eclipse.core.runtime/src/org/eclipse/core/runtime/OperationCanceledException.java;2;0;5;2;2;1;2;3;120;0;1;171;127;127;3;2;1;3;5;171;3;274;2;2;0
/org.eclipse.ui.workbench/Eclipse UI/org/eclipse/ui/internal/presentations/SystemMenuMaximize.java;3;0;3;2;1;1;1;2;44;0;1;256;46;46;2;1;0;2;3;256;1;279;2;3;0
/org.eclipse.debug.ui/ui/org/eclipse/debug/internal/ui/views/console/ProcessConsolePage.java;3;4;12;2;5;2;5;7;56;1;7;86;217;217;4;0;3;7;12;294;3;336;9;3;1
/org.eclipse.team.cvs.ui/src/org/eclipse/team/internal/ccvs/ui/wizards/KSubstWizardDirtyFilesPage.java;1;0;1;1;0;0;0;1;2;0;1;138;2;2;1;0;0;1;1;138;0;138;1;1;0
/org.eclipse.osgi/defaultAdaptor/src/org/eclipse/osgi/framework/internal/reliablefile/ReliableFileOutputStream.java;5;1;7;3;2;2;4;3;220;3;3;171;282;282;3;0;2;5;7;270;2;311;5;5;0
/org.eclipse.jdt.launching/launching/org/eclipse/jdt/internal/launching/StandardVM.java;2;0;2;1;1;1;1;1;4;0;1;211;8;8;1;0;0;1;2;211;0;336;2;2;0
/org.eclipse.ui.cheatsheets/src/org/eclipse/ui/internal/cheatsheets/data/RepeatedSubItem.java;1;2;3;1;3;2;3;0;5;0;0;279;5;5;2;0;1;0;3;299;1;299;2;1;0
/org.eclipse.core.resources/src/org/eclipse/core/internal/indexing/ObjectStorePage.java;1;0;1;1;1;1;1;0;13;0;0;277;13;13;1;0;0;0;1;277;0;277;1;1;0
/org.eclipse.jface.text/src/org/eclipse/jface/text/contentassist/ContentAssistSubjectControlAdapter.java;1;2;3;1;3;2;3;0;50;0;0;280;50;50;2;0;1;0;3;336;1;336;2;1;0
/org.eclipse.swt/Eclipse SWT/photon/org/eclipse/swt/widgets/Shell.java;5;1;10;2;3;3;3;7;143;4;4;19;192;192;4;3;0;7;10;125;3;337;7;5;1
/org.eclipse.jdt.ui/core refactoring/org/eclipse/jdt/internal/corext/refactoring/Checks.java;4;0;16;3;5;1;5;11;45;3;7;10;188;188;5;4;4;11;16;321;8;321;8;4;2
/org.eclipse.core.resources/src/org/eclipse/core/internal/resources/LinkDescription.java;1;0;1;1;1;1;1;0;105;0;0;277;105;105;1;0;0;0;1;277;0;277;1;1;0
/org.eclipse.tomcat/src/org/eclipse/tomcat/internal/TomcatPlugin.java;2;1;8;2;3;3;3;5;115;4;2;25;157;157;4;3;0;5;8;173;3;336;5;2;0
/org.eclipse.pde.core/src/org/eclipse/pde/internal/core/build/BuildModel.java;2;0;4;1;1;1;1;3;112;1;3;167;134;134;1;0;0;3;4;167;0;336;4;2;0
/org.eclipse.team.cvs.ui/src/org/eclipse/team/internal/ccvs/ui/RemoteAnnotationStorage.java;2;1;3;1;2;2;2;1;58;0;1;52;60;60;1;0;0;1;3;52;0;336;3;2;0
/org.eclipse.jdt.debug.ui/ui/org/eclipse/jdt/internal/debug/ui/launcher/RuntimeClasspathEntryLabelProvider.java;4;0;12;2;1;1;1;11;276;3;8;128;387;387;3;3;0;11;12;248;3;336;9;4;0
/org.eclipse.jface.text/src/org/eclipse/jface/text/IRewriteTarget.java;2;0;2;2;2;1;2;0;25;0;0;336;25;25;2;0;1;0;2;336;1;336;1;2;0
/org.eclipse.team.ui/src/org/eclipse/team/internal/ui/actions/JobRunnableContext.java;2;1;8;2;2;2;3;5;146;3;3;225;333;333;3;2;1;6;8;225;3;336;5;2;0
/org.eclipse.pde.ui/src/org/eclipse/pde/internal/ui/editor/GenericSourcePage.java;2;1;2;1;2;2;2;0;19;0;0;292;19;19;1;0;0;0;2;292;0;308;2;2;0
/org.eclipse.help.webapp/src_servlets/org/eclipse/help/internal/webapp/servlet/LiveHelpServlet.java;1;2;6;1;4;3;4;2;32;1;2;156;68;68;2;0;1;2;6;294;1;336;5;1;0
/org.eclipse.jdt.ui/ui refactoring/org/eclipse/jdt/internal/ui/refactoring/PromoteTempWizard.java;4;2;8;2;3;2;4;4;199;2;4;36;231;231;2;0;2;5;8;269;2;336;6;4;0
/org.eclipse.jdt.core/batch/org/eclipse/jdt/internal/compiler/batch/FileFinder.java;2;0;2;1;0;0;0;2;14;1;2;107;16;16;1;0;0;2;2;107;0;199;2;2;0
/org.eclipse.swt/Eclipse SWT/common/org/eclipse/swt/widgets/Item.java;2;1;2;1;2;2;2;0;4;0;0;280;5;5;1;0;0;0;2;280;0;337;2;2;0
/org.eclipse.debug.ui/ui/org/eclipse/debug/internal/ui/launchConfigurations/WorkingSetComparator.java;1;0;2;1;0;0;0;2;40;1;2;124;40;40;1;0;0;2;2;124;0;156;2;1;0
/org.eclipse.debug.ui/ui/org/eclipse/debug/internal/ui/sourcelookup/EditSourceLookupPathAction.java;1;0;4;1;1;1;1;3;105;1;3;209;116;116;1;0;0;3;4;209;0;279;4;1;0
/org.eclipse.swt/Eclipse SWT/carbon/org/eclipse/swt/graphics/FontMetrics.java;2;0;2;1;1;1;1;1;10;0;1;248;14;14;1;0;0;1;2;248;0;337;2;2;0
/org.eclipse.debug.ui/ui/org/eclipse/debug/internal/ui/actions/AssignValueAction.java;2;0;2;2;0;0;0;2;3;0;1;238;3;3;2;1;0;2;2;238;1;238;1;2;1
/org.eclipse.ui.externaltools/External Tools Base/org/eclipse/ui/externaltools/internal/launchConfigurations/ExternalToolsMainTab.java;3;2;29;2;3;2;3;26;302;4;11;2;948;948;4;15;1;26;29;12;16;304;13;3;0
/org.eclipse.jdt.debug/model/org/eclipse/jdt/debug/core/IJavaDebugTarget.java;4;0;6;1;1;1;1;5;23;2;4;26;62;62;2;1;0;5;6;53;1;336;5;4;1
/org.eclipse.jdt.ui/ui/org/eclipse/jdt/internal/ui/text/correction/TaskMarkerProposal.java;3;0;10;1;1;1;1;9;61;2;8;83;180;180;2;1;0;9;10;116;1;336;9;3;0
/org.eclipse.jdt.debug.ui/ui/org/eclipse/jdt/internal/debug/ui/JDISourceViewer.java;4;2;5;2;3;2;3;2;249;1;2;76;270;270;2;0;1;2;5;294;1;336;4;4;0
/org.eclipse.jdt.core/model/org/eclipse/jdt/core/IJavaProject.java;4;0;16;2;1;1;1;15;183;2;12;14;553;553;2;3;0;15;16;62;3;295;13;4;0
/org.eclipse.core.variables/src/org/eclipse/core/variables/IStringVariableManager.java;4;0;5;2;1;1;2;3;15;2;2;145;25;25;2;1;1;4;5;145;2;336;3;4;0
/org.eclipse.jdt.core/dom/org/eclipse/jdt/core/dom/PrimitiveType.java;3;0;6;1;1;1;1;5;64;2;4;199;76;76;2;1;0;5;6;266;1;283;5;3;1
/org.eclipse.update.core/src/org/eclipse/update/core/model/URLEntryModel.java;2;2;5;1;4;3;4;1;10;0;1;58;23;23;2;0;1;1;5;290;1;336;4;2;0
/org.eclipse.text/src/org/eclipse/text/edits/TextEditMessages.java;2;0;2;1;1;1;1;1;2;0;1;118;2;2;1;0;0;1;2;118;0;336;2;2;0
/org.eclipse.search/search/org/eclipse/search/internal/ui/text/ResourcenameSorter.java;2;0;2;1;1;1;1;1;3;0;1;207;5;5;1;0;0;1;2;207;0;336;2;2;0
/org.eclipse.swt/Eclipse SWT PI/win32/org/eclipse/swt/internal/win32/SCRIPT_ANALYSIS.java;2;0;2;1;1;1;1;1;4;0;1;250;4;4;1;0;0;1;2;250;0;337;2;2;0
/org.eclipse.ant.ui/Ant Tools Support/org/eclipse/ant/internal/ui/preferences/AbstractAntEditorPreferencePage.java;1;0;2;1;2;1;2;0;27;0;0;304;27;27;2;0;1;0;2;304;1;304;1;1;1
/org.eclipse.jdt.ui/core refactoring/org/eclipse/jdt/internal/corext/refactoring/reorg/INewNameQueries.java;2;0;3;1;1;1;1;2;8;1;2;53;10;10;1;0;0;2;3;53;0;336;3;2;0
/org.eclipse.help.webapp/src_servlets/org/eclipse/help/internal/webapp/servlet/FramesetFilter.java;1;1;4;1;3;3;3;1;23;0;1;156;49;49;1;0;0;1;4;156;0;336;4;1;1
/org.eclipse.jdt.ui/core refactoring/org/eclipse/jdt/internal/corext/refactoring/changes/AbstractDeleteChange.java;3;0;5;1;1;1;1;4;37;1;4;41;69;69;1;0;0;4;5;41;0;336;5;3;1
/org.eclipse.text/src/org/eclipse/jface/text/DefaultPositionUpdater.java;1;0;2;1;1;1;1;1;21;0;1;247;28;28;1;0;0;1;2;247;0;334;2;1;0
/org.eclipse.update.core/src/org/eclipse/update/internal/operations/FeatureStatus.java;1;0;1;1;0;0;0;1;0;0;1;232;0;0;1;0;0;1;1;232;0;232;1;1;0
/org.eclipse.jdt.ui/core refactoring/org/eclipse/jdt/internal/corext/refactoring/rename/RenameTempRefactoring.java;5;1;21;2;4;4;4;17;143;4;8;9;247;247;4;9;0;17;21;251;9;336;12;5;0
/org.eclipse.jface/src/org/eclipse/jface/resource/FileImageDescriptor.java;3;2;5;1;3;2;3;2;18;1;2;207;48;48;2;0;1;2;5;313;1;336;4;3;0
/org.eclipse.jdt.junit/src/org/eclipse/jdt/internal/junit/ui/RerunAction.java;2;0;2;1;1;1;1;1;13;0;1;262;15;15;1;0;0;1;2;262;0;336;2;2;0
/org.eclipse.ui.workbench/Eclipse UI/org/eclipse/ui/internal/dnd/TestDropLocation.java;1;0;1;1;0;0;0;1;0;0;1;270;0;0;1;0;0;1;1;270;0;270;1;1;1
/org.eclipse.osgi/console/src/org/eclipse/osgi/framework/internal/core/FrameworkCommandProvider.java;5;2;11;2;3;2;5;6;2787;3;5;171;3676;3676;3;1;3;8;11;267;4;336;7;5;0
/org.eclipse.search/search/org/eclipse/search/ui/ISearchResultViewEntry.java;2;2;3;1;3;2;3;0;8;0;0;325;10;10;2;0;1;0;3;325;1;336;2;2;0
/org.eclipse.core.runtime/src/org/eclipse/core/runtime/IProgressMonitorWithBlocking.java;3;2;7;2;3;2;3;4;192;3;2;127;210;210;3;2;1;4;7;171;3;286;4;3;0
/org.eclipse.jdt.debug.ui/ui/org/eclipse/jdt/internal/debug/ui/MethodActionFilter.java;1;0;1;1;0;0;0;1;4;0;1;138;4;4;1;0;0;1;1;138;0;138;1;1;0
/org.eclipse.pde.ui/src/org/eclipse/pde/internal/ui/editor/plugin/rows/ReferenceAttributeRow.java;2;2;5;2;5;3;5;0;10;0;0;292;16;16;2;0;2;0;5;292;2;336;3;2;0
/org.eclipse.jdt.ui/ui/org/eclipse/jdt/internal/ui/javaeditor/EditorHighlightingSynchronizer.java;2;2;3;2;3;2;3;0;8;0;0;282;14;14;2;0;1;0;3;282;1;336;2;2;0
/org.eclipse.jdt.ui/ui/org/eclipse/jdt/internal/ui/JavaWorkbenchAdapter.java;2;0;2;1;1;1;1;1;6;0;1;32;8;8;1;0;0;1;2;32;0;336;2;2;0
/org.eclipse.jdt.core/dom/org/eclipse/jdt/core/dom/TryStatement.java;3;0;8;1;2;1;2;6;125;2;5;199;166;166;2;1;1;6;8;266;2;276;6;3;1
/org.eclipse.pde.junit.runtime/src/org/eclipse/pde/internal/junit/runtime/RemotePluginTestRunner.java;1;0;3;1;1;1;1;2;23;1;2;89;33;33;1;0;0;2;3;89;0;321;3;1;0
/org.eclipse.jdt.ui/core extension/org/eclipse/jdt/internal/corext/codemanipulation/SortMembersOperation.java;2;1;5;1;2;2;2;3;31;2;2;207;66;66;2;1;0;3;5;264;1;336;4;2;0
/org.eclipse.osgi/eclipseAdaptor/src/org/eclipse/core/runtime/adaptor/EclipseElementFactory.java;4;0;10;3;1;1;4;6;19;4;4;171;50;50;4;2;3;9;10;270;5;326;5;4;0
/org.eclipse.jdt.ui/core refactoring/org/eclipse/jdt/internal/corext/refactoring/changes/RenameCompilationUnitChange.java;2;0;6;1;1;1;1;5;11;2;3;207;22;22;2;2;0;5;6;219;2;336;4;2;0
/org.eclipse.ui.ide/src/org/eclipse/ui/internal/ide/actions/BuildCleanAction.java;1;0;2;1;1;1;1;1;25;0;1;254;25;25;1;0;0;1;2;254;0;279;2;1;1
/org.eclipse.jdt.debug.ui/ui/org/eclipse/jdt/internal/debug/ui/JavaDebugHover.java;4;2;12;2;4;3;4;8;191;3;5;6;286;286;3;3;1;8;12;89;4;336;8;4;2
/org.eclipse.search/search/org/eclipse/search/internal/ui/SearchResultLabelProvider.java;1;0;1;1;1;1;1;0;2;0;0;336;2;2;1;0;0;0;1;336;0;336;1;1;0
/org.eclipse.pde.ui/src/org/eclipse/pde/internal/ui/wizards/PluginSelectionDialog.java;2;1;3;1;2;2;2;1;8;0;1;192;12;12;1;0;0;1;3;192;0;336;3;2;0
/org.eclipse.jdt.ui/ui/org/eclipse/jdt/internal/ui/search/ParentSorter.java;1;0;3;1;2;1;2;1;10;0;1;207;10;10;2;0;1;1;3;290;1;290;2;1;1
/org.eclipse.debug.ui/ui/org/eclipse/debug/internal/ui/actions/OpenProfileConfigurations.java;1;0;1;1;0;0;0;1;0;0;1;33;0;0;1;0;0;1;1;33;0;33;1;1;0
/org.eclipse.ui.workbench.texteditor/src/org/eclipse/ui/internal/texteditor/quickdiff/ReferenceSelectionAction.java;2;1;3;1;2;2;2;1;7;0;1;100;13;13;1;0;0;1;3;100;0;336;3;2;0
/org.eclipse.swt/Eclipse SWT/carbon/org/eclipse/swt/graphics/Device.java;3;1;5;1;3;3;3;2;64;1;2;13;97;97;1;0;0;2;5;13;0;337;5;3;1
/org.eclipse.ui.ide/src/org/eclipse/ui/views/tasklist/TaskPropertiesAction.java;1;0;1;1;0;0;0;1;0;0;1;129;0;0;1;0;0;1;1;129;0;129;1;1;0
/org.eclipse.jdt.ui/core refactoring/org/eclipse/jdt/internal/corext/refactoring/structure/MemberCheckUtil.java;3;1;5;1;2;2;2;3;18;1;3;57;46;46;1;0;0;3;5;57;0;336;5;3;0
/org.eclipse.jdt.ui/core refactoring/org/eclipse/jdt/internal/corext/refactoring/nls/AccessorClassInfo.java;2;4;6;1;6;3;6;0;33;0;0;279;65;65;4;0;3;0;6;279;3;336;3;2;0
/org.eclipse.ui.ide/extensions/org/eclipse/ui/dialogs/ContainerSelectionDialog.java;1;0;1;1;0;0;0;1;0;0;1;132;0;0;1;0;0;1;1;132;0;132;1;1;0
/org.eclipse.jdt.junit/src/org/eclipse/jdt/internal/junit/util/JUnitStubUtility.java;2;1;3;1;2;2;2;1;7;0;1;193;11;11;1;0;0;1;3;193;0;336;3;2;0
/org.eclipse.pde.ui/src/org/eclipse/pde/internal/ui/parts/IFormEntryListener.java;2;2;3;2;3;2;3;0;10;0;0;292;16;16;2;0;1;0;3;292;1;336;2;2;0
/org.eclipse.jdt.core/search/org/eclipse/jdt/internal/core/search/JavaWorkspaceScope.java;2;0;4;1;1;1;1;3;6;1;3;113;12;12;1;0;0;3;4;113;0;306;4;2;0
/org.eclipse.jdt.ui/ui/org/eclipse/jdt/internal/ui/util/PixelConverter.java;1;0;1;1;1;1;1;0;2;0;0;336;2;2;1;0;0;0;1;336;0;336;1;1;0
/org.eclipse.jdt.core/model/org/eclipse/jdt/core/eval/IEvaluationContext.java;2;0;5;1;0;0;0;5;66;1;5;63;74;74;1;0;0;5;5;63;0;264;5;2;0
/org.eclipse.swt/Eclipse SWT PI/carbon/org/eclipse/swt/internal/carbon/GDevice.java;1;0;2;1;2;1;2;0;20;0;0;296;20;20;2;0;1;0;2;296;1;296;1;1;0
/org.eclipse.swt/Eclipse SWT Mozilla/common/org/eclipse/swt/internal/mozilla/nsIRequest.java;1;0;1;1;0;0;0;1;0;0;1;153;0;0;1;0;0;1;1;153;0;153;1;1;0
/org.eclipse.pde.core/src/org/eclipse/pde/internal/core/bundle/BundleModel.java;2;2;5;1;3;2;3;2;85;0;1;128;89;89;2;1;1;2;5;128;2;336;3;2;0
/org.eclipse.ui.workbench/Eclipse UI/org/eclipse/ui/IEditorDescriptor.java;1;0;1;1;0;0;0;1;80;0;1;157;80;80;1;0;0;1;1;157;0;157;1;1;0
/org.eclipse.team.ui/src/org/eclipse/team/internal/ui/preferences/TeamPreferencePage.java;2;0;4;2;1;1;1;3;125;2;2;63;135;135;2;1;0;3;4;63;1;336;3;2;0
/org.eclipse.jdt.ui/ui/org/eclipse/jdt/internal/ui/compare/ResizableDialog.java;2;0;2;1;1;1;1;1;2;0;1;79;4;4;1;0;0;1;2;79;0;336;2;2;0
/org.eclipse.jdt.ui/ui/org/eclipse/jdt/internal/ui/text/template/preferences/TemplateVariableProposal.java;2;1;4;1;2;2;2;2;10;0;1;234;15;15;2;1;0;2;4;234;1;336;3;2;0
/org.eclipse.help.ide/src/org/eclipse/help/ui/internal/search/SearchQueryData.java;1;1;7;1;3;3;3;4;193;3;2;104;319;319;3;2;0;4;7;104;2;336;5;1;0
/org.eclipse.jface/src/org/eclipse/jface/window/WindowManager.java;4;0;3;2;1;1;1;2;10;1;2;157;20;20;1;0;0;2;3;157;0;336;3;4;0
/org.eclipse.platform/src/org/eclipse/core/launcher/Main.java;3;7;37;2;12;3;12;25;2638;9;7;103;5054;5054;9;18;9;25;37;250;27;331;10;3;0
/org.eclipse.debug.ui/ui/org/eclipse/debug/internal/ui/views/launch/SourceNotFoundEditor.java;1;0;1;1;0;0;0;1;4;0;1;141;4;4;1;0;0;1;1;141;0;141;1;1;0
/org.eclipse.swt/Eclipse SWT Drag and Drop/win32/org/eclipse/swt/dnd/TransferData.java;2;1;3;1;2;2;2;1;9;0;1;28;20;20;1;0;0;1;3;28;0;337;3;2;1
/org.eclipse.jdt.core/model/org/eclipse/jdt/internal/core/util/CommentRecorderScanner.java;2;0;2;1;0;0;0;2;5;1;2;214;5;5;1;0;0;2;2;214;0;244;2;2;0
/org.eclipse.ui.workbench/Eclipse UI/org/eclipse/ui/internal/dialogs/WorkbenchWizardElement.java;5;1;11;3;2;2;2;9;502;3;4;157;651;651;3;5;0;9;11;171;5;336;6;5;1
/org.eclipse.update.ui/src/org/eclipse/update/internal/ui/security/JarVerificationPage.java;3;1;8;3;2;2;2;6;121;4;3;43;163;163;4;3;0;6;8;43;3;336;5;3;0
/org.eclipse.jdt.debug.ui/ui/org/eclipse/jdt/internal/debug/core/refactoring/LaunchConfigurationIJavaProjectRenameParticipant.java;3;1;8;1;2;2;2;6;28;3;4;208;83;83;3;2;0;6;8;251;2;336;6;3;0
/org.eclipse.swt/Eclipse SWT/photon/org/eclipse/swt/internal/Converter.java;2;0;2;1;0;0;0;2;2;1;2;0;4;4;1;0;0;2;2;0;0;19;2;2;0
/org.eclipse.update.configurator/src/org/eclipse/update/internal/configurator/ConfigurationParser.java;2;8;15;2;10;3;10;5;96;3;2;227;202;202;8;3;7;5;15;282;10;326;5;2;0
/org.eclipse.osgi/osgi/src/org/osgi/framework/ServicePermission.java;2;0;2;1;1;1;1;1;3;0;1;171;3;3;1;0;0;1;2;171;0;296;2;2;0
/org.eclipse.ui.workbench.texteditor/src/org/eclipse/ui/texteditor/MarkAction.java;1;1;2;1;2;2;2;0;6;0;0;276;8;8;1;0;0;0;2;276;0;336;2;1;0
/org.eclipse.debug.core/core/org/eclipse/debug/core/ILaunchConfigurationType.java;2;0;6;2;0;0;2;4;38;3;4;32;83;83;3;0;2;6;6;268;2;268;4;2;0
/org.eclipse.jdt.ui/core refactoring/org/eclipse/jdt/internal/corext/refactoring/typeconstraints/ConstraintVariableFactory.java;2;0;3;1;1;1;1;2;2;1;2;207;4;4;1;0;0;2;3;207;0;336;3;2;0
/org.eclipse.swt/Eclipse SWT/gtk/org/eclipse/swt/widgets/MenuItem.java;5;2;11;2;3;2;3;8;46;1;8;4;95;95;2;0;1;8;11;293;1;337;10;5;0
/org.eclipse.jdt.ui/core extension/org/eclipse/jdt/internal/corext/util/AllTypesCache.java;6;6;22;3;7;2;7;15;669;4;6;81;1133;1133;6;9;5;15;22;294;14;336;8;6;3
/org.eclipse.core.variables/src/org/eclipse/core/variables/IValueVariableListener.java;3;1;3;1;2;2;2;1;4;0;1;145;6;6;1;0;0;1;3;145;0;336;3;3;0
/org.eclipse.text/src/org/eclipse/jface/text/IRepairableDocument.java;2;2;4;2;3;2;3;1;35;0;1;134;36;36;2;0;1;1;4;334;1;334;3;2;0
/org.eclipse.jdt.core/compiler/org/eclipse/jdt/internal/compiler/ast/PostfixExpression.java;2;0;3;1;0;0;0;3;10;1;3;63;16;16;1;0;0;3;3;63;0;199;3;2;0
/org.eclipse.swt/Eclipse SWT PI/carbon/org/eclipse/swt/internal/carbon/ControlButtonContentInfo.java;1;0;2;1;2;1;2;0;20;0;0;296;20;20;2;0;1;0;2;296;1;296;1;1;0
/org.eclipse.help.base/src/org/eclipse/help/internal/search/ISearchQuery.java;1;1;3;1;2;2;2;1;18;0;1;104;34;34;1;0;0;1;3;104;0;336;3;1;0
/org.eclipse.ui.ide/src/org/eclipse/ui/internal/ide/dialogs/RemoveCapabilityWizard.java;1;0;1;1;0;0;0;1;0;0;1;132;0;0;1;0;0;1;1;132;0;132;1;1;0
/org.eclipse.update.core/src/org/eclipse/update/standalone/EnableCommand.java;1;2;8;1;6;5;6;2;76;1;2;54;114;114;2;0;1;2;8;292;1;336;7;1;0
/org.eclipse.debug.ui/ui/org/eclipse/debug/internal/ui/stringsubstitution/FilePrompt.java;2;0;3;2;2;1;2;1;5;0;1;125;5;5;2;0;1;1;3;331;1;331;2;2;0
/org.eclipse.ant.ui/Ant Tools Support/org/eclipse/ant/internal/ui/model/AntUIModelMessages.java;1;0;1;1;0;0;0;1;0;0;1;108;0;0;1;0;0;1;1;108;0;108;1;1;1
/org.eclipse.jdt.ui/ui/org/eclipse/jdt/internal/ui/text/java/AnonymousTypeCompletionProposal.java;2;0;9;1;1;1;1;8;177;2;7;40;217;217;2;1;0;8;9;95;1;336;8;2;0
/org.eclipse.pde.build/src/org/eclipse/pde/internal/build/BuildScriptGenerator.java;2;3;13;2;6;3;6;7;466;2;4;31;1320;1320;3;3;3;7;13;272;6;336;7;2;0
/org.eclipse.debug.core/core/org/eclipse/debug/core/model/IIndexedValue.java;2;1;4;1;2;2;2;2;12;1;2;148;28;28;1;0;0;2;4;148;0;336;4;2;0
/org.eclipse.jdt.core/compiler/org/eclipse/jdt/internal/compiler/ast/CharLiteral.java;2;0;3;1;0;0;0;3;4;1;3;63;8;8;1;0;0;3;3;63;0;199;3;2;0
/org.eclipse.swt/Eclipse SWT Custom Widgets/common/org/eclipse/swt/custom/AnimatedProgress.java;2;1;2;1;2;2;2;0;22;0;0;281;26;26;1;0;0;0;2;281;0;337;2;2;0
/org.eclipse.pde.ui/src/org/eclipse/pde/internal/ui/parts/FormEntry.java;3;0;4;3;4;1;4;0;15;0;0;292;15;15;4;0;3;0;4;292;3;292;1;3;0
/org.eclipse.jdt.ui/ui/org/eclipse/jdt/internal/ui/browsing/ExcludingDecoratingLabelProvider.java;1;0;1;1;1;1;1;0;2;0;0;336;2;2;1;0;0;0;1;336;0;336;1;1;0
/org.eclipse.jdt.debug.ui/ui/org/eclipse/jdt/internal/debug/ui/actions/AddExternalFolderAction.java;1;0;1;1;0;0;0;1;15;0;1;154;15;15;1;0;0;1;1;154;0;154;1;1;0
/org.eclipse.jdt.junit/src/org/eclipse/jdt/internal/junit/ui/TabFolderLayout.java;1;0;1;1;1;1;1;0;2;0;0;336;2;2;1;0;0;0;1;336;0;336;1;1;0
/org.eclipse.jdt.core/model/org/eclipse/jdt/internal/core/util/ToStringSorter.java;1;0;1;1;0;0;0;1;2;0;1;199;2;2;1;0;0;1;1;199;0;199;1;1;0
/org.eclipse.jdt.ui/ui/org/eclipse/jdt/internal/ui/search/ExceptionOccurrencesLabelProvider.java;3;1;3;1;2;2;2;1;4;0;1;209;6;6;1;0;0;1;3;209;0;336;3;3;0
/org.eclipse.ant.ui/Ant Tools Support/org/eclipse/ant/internal/ui/launchConfigurations/AntProcess.java;1;0;3;1;0;0;0;3;6;1;3;108;11;11;1;0;0;3;3;108;0;246;3;1;2
/org.eclipse.pde.core/src/org/eclipse/pde/core/plugin/IPluginParent.java;3;1;4;1;3;3;3;1;60;0;1;232;68;68;1;0;0;1;4;232;0;336;4;3;0
/org.eclipse.debug.core/core/org/eclipse/debug/core/model/IBreakpoint.java;2;0;2;1;1;1;1;1;4;0;1;220;6;6;1;0;0;1;2;220;0;336;2;2;0
/org.eclipse.core.resources/src/org/eclipse/core/internal/indexing/PageStoreException.java;1;0;1;1;1;1;1;0;9;0;0;277;9;9;1;0;0;0;1;277;0;277;1;1;0
/org.eclipse.jface.text/src/org/eclipse/jface/text/contentassist/ContentAssistant.java;3;0;23;3;2;1;6;17;555;5;8;46;1287;1287;5;9;5;21;23;181;14;336;9;3;0
/org.eclipse.ui.workbench/Eclipse UI/org/eclipse/ui/internal/progress/WorkbenchSiteProgressService.java;2;0;19;2;4;1;10;9;377;9;5;162;960;960;9;4;9;15;19;266;13;303;6;2;0
/org.eclipse.update.core/src/org/eclipse/update/internal/search/UpdatePolicy.java;3;1;10;2;2;2;2;8;32;3;5;61;73;73;3;3;0;8;10;61;3;336;7;3;1
/org.eclipse.jdt.debug/eval/org/eclipse/jdt/internal/debug/eval/ast/engine/SourceBasedSourceGenerator.java;2;1;2;1;2;2;2;0;43;0;0;321;47;47;1;0;0;0;2;321;0;336;2;2;2
/org.eclipse.swt/Eclipse SWT PI/gtk/org/eclipse/swt/internal/gtk/PangoItem.java;2;0;2;1;1;1;1;1;2;0;1;250;2;2;1;0;0;1;2;250;0;337;2;2;0
/org.eclipse.debug.ui/ui/org/eclipse/debug/internal/ui/preferences/ProcessPropertyPage.java;3;0;3;3;0;0;0;3;30;0;1;8;30;30;3;2;0;3;3;8;2;8;1;3;0
/org.eclipse.ui.workbench/Eclipse UI/org/eclipse/ui/internal/RectangleAnimation.java;1;1;7;1;3;3;3;4;149;2;3;232;221;221;2;1;0;4;7;264;1;320;6;1;0
/org.eclipse.pde.build/src/org/eclipse/pde/internal/build/site/BuildTimeSiteContentProvider.java;2;0;7;2;2;1;2;5;80;2;3;31;80;80;2;2;1;5;7;31;3;272;4;2;0
/org.eclipse.jdt.ui/ui/org/eclipse/jdt/internal/ui/preferences/OptionsConfigurationBlock.java;4;2;22;3;5;3;5;17;142;3;10;71;387;387;3;7;2;17;22;228;9;330;13;4;0
/org.eclipse.ui.forms/src/org/eclipse/ui/internal/forms/widgets/ImageSegment.java;1;1;2;1;2;2;2;0;4;0;0;272;4;4;1;0;0;0;2;272;0;336;2;1;0
/org.eclipse.debug.ui/ui/org/eclipse/debug/internal/ui/stringsubstitution/ResourceSelector.java;2;0;2;1;0;0;0;2;2;1;2;124;2;2;1;0;0;2;2;124;0;145;2;2;0
/org.eclipse.jdt.core/compiler/org/eclipse/jdt/internal/compiler/classfmt/ClassFileConstants.java;2;0;5;1;0;0;0;5;21;1;5;37;31;31;1;0;0;5;5;37;0;234;5;2;0
/org.eclipse.ui.workbench/Eclipse UI/org/eclipse/ui/internal/Semaphore.java;2;0;2;1;0;0;0;2;88;1;2;93;90;90;1;0;0;2;2;93;0;145;2;2;0
/org.eclipse.jface.text/src/org/eclipse/jface/contentassist/SubjectControlContextInformationValidator.java;1;2;3;1;3;2;3;0;14;0;0;280;14;14;2;0;1;0;3;336;1;336;2;1;0
/org.eclipse.ant.core/src_ant/org/eclipse/ant/internal/core/ant/ProgressBuildListener.java;1;0;1;1;0;0;0;1;14;0;1;170;14;14;1;0;0;1;1;170;0;170;1;1;0
/org.eclipse.ui.ide/src/org/eclipse/ui/internal/ide/model/ResourceFactory.java;4;1;5;2;2;2;2;3;4;2;2;132;8;8;2;1;0;3;5;160;1;336;4;4;0
/org.eclipse.core.runtime/src/org/eclipse/core/runtime/IRegistryChangeEvent.java;3;0;6;1;2;1;2;4;57;2;3;177;114;114;2;1;1;4;6;177;2;272;4;3;0
/org.eclipse.jdt.core/compiler/org/eclipse/jdt/internal/compiler/lookup/SyntheticAccessMethodBinding.java;3;0;3;1;0;0;0;3;48;1;3;2;62;62;1;0;0;3;3;2;0;199;3;3;0
/org.eclipse.debug.core/core/org/eclipse/debug/internal/core/memory/IMemoryRenderingListener.java;1;0;1;1;1;1;1;0;0;0;0;282;0;0;1;0;0;0;1;282;0;282;1;1;1
/org.eclipse.ui.intro/src/org/eclipse/ui/intro/config/IIntroURL.java;2;2;4;2;4;3;4;0;59;0;0;283;70;70;2;0;1;0;4;283;1;336;3;2;0
/org.eclipse.pde.core/src/org/eclipse/pde/internal/core/schema/SchemaComplexType.java;3;1;4;1;2;2;2;2;8;1;2;232;22;22;1;0;0;2;4;232;0;336;4;3;0
/org.eclipse.core.resources/src/org/eclipse/core/internal/resources/MarkerReader_3.java;2;0;2;1;1;1;1;1;209;0;1;104;211;211;1;0;0;1;2;104;0;277;2;2;0
/org.eclipse.pde.ui/src/org/eclipse/pde/internal/ui/search/UnusedImportsDialog.java;2;1;2;1;2;2;2;0;4;0;0;308;6;6;1;0;0;0;2;308;0;336;2;2;0
/org.eclipse.ant.ui/Ant Runner Support/org/eclipse/ant/internal/ui/antsupport/inputhandler/AntInputHandler.java;1;1;5;1;3;3;3;2;9;1;2;108;21;21;1;0;0;2;5;108;0;336;5;1;0
/org.eclipse.osgi/core/adaptor/org/eclipse/osgi/framework/adaptor/ServiceRegistry.java;4;1;5;1;3;3;3;2;9;1;2;171;20;20;1;0;0;2;5;171;0;336;5;4;0
/org.eclipse.osgi/core/framework/org/eclipse/osgi/framework/internal/protocol/ContentHandlerFactory.java;5;1;7;3;2;2;4;3;106;3;3;171;127;127;3;0;2;5;7;270;2;336;5;5;0
/org.eclipse.jdt.core/model/org/eclipse/jdt/core/Flags.java;4;0;6;2;0;0;0;6;88;1;6;7;101;101;1;0;0;6;6;7;0;264;6;4;0
/org.eclipse.pde.ui/src/org/eclipse/pde/internal/ui/wizards/extension/ExtensionEditorSelectionPage.java;2;2;3;2;3;2;3;0;29;0;0;295;29;29;2;0;1;0;3;308;1;308;2;2;0
/org.eclipse.debug.ui/ui/org/eclipse/debug/ui/sourcelookup/WorkingSetSourceContainer.java;1;0;2;1;1;1;1;1;7;0;1;269;7;7;1;0;0;1;2;269;0;326;2;1;0
/org.eclipse.jdt.ui/core extension/org/eclipse/jdt/internal/corext/util/Resources.java;2;1;2;1;2;2;2;0;4;0;0;289;6;6;1;0;0;0;2;289;0;336;2;2;0
/org.eclipse.ant.ui/Ant Editor/org/eclipse/ant/internal/ui/dtd/util/Factory.java;1;0;1;1;0;0;0;1;0;0;1;108;0;0;1;0;0;1;1;108;0;108;1;1;0
/org.eclipse.swt/Eclipse SWT Mozilla/common/org/eclipse/swt/internal/mozilla/nsIControllers.java;1;0;2;1;0;0;0;2;28;1;2;100;28;28;1;0;0;2;2;100;0;148;2;1;0
/org.eclipse.debug.ui/ui/org/eclipse/debug/internal/ui/sourcelookup/LookupSourceAction.java;1;0;2;1;0;0;0;2;2;1;2;253;2;2;1;0;0;2;2;253;0;268;2;1;0
/org.eclipse.core.resources/src/org/eclipse/core/internal/resources/ResourceTree.java;2;2;10;2;3;2;3;7;2125;2;6;13;2808;2808;2;1;1;7;10;174;2;313;8;2;0
/org.eclipse.update.core/src/org/eclipse/update/internal/core/FeatureContentConsumer.java;1;0;1;1;0;0;0;1;4;0;1;58;4;4;1;0;0;1;1;58;0;58;1;1;0
/org.eclipse.jdt.core/model/org/eclipse/jdt/internal/core/builder/JavaBuilder.java;3;3;20;2;4;2;4;16;46;4;11;1;164;164;4;5;2;16;20;121;7;309;13;3;0
/org.eclipse.jdt.core/model/org/eclipse/jdt/core/util/IConstantPoolEntry.java;1;0;1;1;0;0;0;1;2;0;1;199;2;2;1;0;0;1;1;199;0;199;1;1;0
/org.eclipse.ui.ide/extensions/org/eclipse/ui/actions/BuildAction.java;4;0;4;1;1;1;1;3;69;1;3;132;73;73;1;0;0;3;4;132;0;336;4;4;1
/org.eclipse.jdt.ui/core refactoring/org/eclipse/jdt/internal/corext/refactoring/util/CodeAnalyzer.java;2;0;3;1;1;1;1;2;4;1;2;57;8;8;1;0;0;2;3;57;0;336;3;2;0
/org.eclipse.ltk.core.refactoring/src/org/eclipse/ltk/core/refactoring/participants/ParticipantManager.java;1;0;6;1;4;1;4;2;143;0;1;264;193;193;4;1;3;2;6;275;4;275;2;1;0
/org.eclipse.ui.ide/src/org/eclipse/ui/internal/ide/IDEExceptionHandler.java;4;0;5;1;1;1;1;4;13;1;4;92;18;18;1;0;0;4;5;92;0;336;5;4;0
/org.eclipse.jface.text/src/org/eclipse/jface/text/rules/PatternRule.java;1;0;2;1;1;1;1;1;38;0;1;231;40;40;1;0;0;1;2;231;0;336;2;1;0
/org.eclipse.team.ui/src/org/eclipse/team/internal/ui/synchronize/TreeViewerAdvisor.java;2;2;4;2;4;3;4;0;125;0;0;288;131;131;2;0;1;0;4;288;1;336;3;2;1
/org.eclipse.jface.text/src/org/eclipse/jface/text/rules/WhitespaceRule.java;1;0;1;1;1;1;1;0;2;0;0;336;2;2;1;0;0;0;1;336;0;336;1;1;0
/org.eclipse.ui.ide/src/org/eclipse/ui/internal/ide/ProblemImageProvider.java;1;0;1;1;0;0;0;1;0;0;1;132;0;0;1;0;0;1;1;132;0;132;1;1;0
/org.eclipse.swt/Eclipse SWT Drag and Drop/photon/org/eclipse/swt/dnd/TextTransfer.java;1;0;1;1;0;0;0;1;4;0;1;137;4;4;1;0;0;1;1;137;0;137;1;1;0
/org.eclipse.update.configurator/src/org/eclipse/update/internal/configurator/ConfigurationActivator.java;2;6;38;2;11;3;14;24;350;11;3;186;1084;1084;11;21;11;27;38;211;32;326;6;2;0
/org.eclipse.ui.ide/src/org/eclipse/ui/views/navigator/ResourceNavigatorRenameAction.java;1;0;1;1;0;0;0;1;0;0;1;129;0;0;1;0;0;1;1;129;0;129;1;1;0
/org.eclipse.jdt.ui/ui/org/eclipse/jdt/ui/wizards/NewTypeWizardPage.java;6;3;36;4;5;3;8;28;197;7;12;16;754;754;7;16;5;31;36;81;21;336;15;6;3
/org.eclipse.ui.ide/src/org/eclipse/ui/internal/ide/dialogs/MultiStepCapabilityWizard.java;1;0;1;1;0;0;0;1;0;0;1;132;0;0;1;0;0;1;1;132;0;132;1;1;0
/org.eclipse.pde.ui/src/org/eclipse/pde/internal/ui/editor/plugin/rows/ResourceAttributeRow.java;2;2;4;2;4;3;4;0;10;0;0;292;20;20;2;0;1;0;4;292;1;336;3;2;0
/org.eclipse.core.expressions/src/org/eclipse/core/internal/expressions/WithExpression.java;1;0;3;1;1;1;1;2;8;0;1;227;10;10;2;1;0;2;3;227;1;336;2;1;0
/org.eclipse.ltk.ui.refactoring/src/org/eclipse/ltk/internal/ui/refactoring/util/Strings.java;1;0;2;1;0;0;1;1;407;0;1;269;407;407;2;0;1;2;2;269;1;269;1;1;0
/org.eclipse.jdt.ui/ui/org/eclipse/jdt/internal/ui/text/spelling/engine/ISpellCheckPreferenceKeys.java;2;0;2;1;1;1;1;1;2;0;1;219;2;2;1;0;0;1;2;219;0;336;2;2;0
/org.eclipse.jface/src/org/eclipse/jface/resource/URLImageDescriptor.java;3;1;3;1;2;2;2;1;14;0;1;224;20;20;1;0;0;1;3;224;0;336;3;3;0
/org.eclipse.ui.workbench/Eclipse UI/org/eclipse/ui/internal/commands/KeySequenceBindingDefinition.java;3;0;10;2;1;1;1;9;118;4;5;148;214;214;4;4;0;9;10;226;4;336;6;3;0
/org.eclipse.team.cvs.core/src/org/eclipse/team/internal/ccvs/core/CVSStatus.java;2;1;5;1;2;2;2;3;2;1;3;60;7;7;1;0;0;3;5;60;0;336;5;2;1
/org.eclipse.jface/src/org/eclipse/jface/preference/FieldEditor.java;2;1;3;2;2;2;2;1;18;0;1;0;28;28;1;0;0;1;3;0;0;336;3;2;2
/org.eclipse.debug.ui/ui/org/eclipse/debug/internal/ui/sourcelookup/browsers/ProjectSourceContainerDialog.java;1;0;1;1;0;0;0;1;0;0;1;209;0;0;1;0;0;1;1;209;0;209;1;1;0
/org.eclipse.pde.ui/src/org/eclipse/pde/internal/ui/wizards/plugin/NewPluginProjectWizard.java;3;5;13;2;9;4;9;4;180;2;3;213;307;307;5;1;5;4;13;280;6;336;7;3;0
/org.eclipse.text/src/org/eclipse/jface/text/DefaultLineTracker.java;1;0;1;1;1;1;1;0;18;0;0;334;18;18;1;0;0;0;1;334;0;334;1;1;0
/org.eclipse.jface.text/src/org/eclipse/jface/text/formatter/IContentFormatterExtension.java;3;2;4;2;3;2;3;1;76;0;1;92;102;102;2;0;1;1;4;336;1;336;3;3;0
/org.eclipse.jdt.ui/ui/org/eclipse/jdt/internal/ui/text/comment/MultiCommentRegion.java;3;0;12;3;1;1;1;11;213;3;6;124;386;386;3;5;0;11;12;124;5;336;7;3;0
/org.eclipse.swt/Eclipse SWT Mozilla/common/org/eclipse/swt/internal/mozilla/nsIServiceManager.java;1;0;2;1;0;0;0;2;11;1;2;100;11;11;1;0;0;2;2;100;0;148;2;1;0
/org.eclipse.jdt.ui/core extension/org/eclipse/jdt/internal/corext/dom/fragments/ASTMatchingFragmentFinder.java;2;1;3;1;3;3;3;0;6;0;0;302;9;9;1;0;0;0;3;302;0;336;3;2;0
/org.eclipse.jdt.ui/core refactoring/org/eclipse/jdt/internal/corext/refactoring/nls/changes/DeleteFileChange.java;3;2;7;2;4;3;4;3;32;1;3;207;86;86;2;0;1;3;7;331;1;331;6;3;0
/org.eclipse.pde.core/src/org/eclipse/pde/internal/core/schema/IncludedSchemaDescriptor.java;3;2;5;2;3;2;3;2;32;1;2;232;49;49;2;0;1;2;5;330;1;330;4;3;0
/org.eclipse.jdt.core/dom/org/eclipse/jdt/core/dom/AnonymousClassDeclaration.java;3;0;6;1;1;1;1;5;61;2;4;199;73;73;2;1;0;5;6;266;1;283;5;3;1
/org.eclipse.pde.ui/src_samples/org/eclipse/pde/ui/internal/samples/SampleEditor.java;3;3;5;2;4;2;4;1;101;0;1;248;107;107;3;0;2;1;5;303;2;336;3;3;0
/org.eclipse.swt/Eclipse SWT PI/motif/org/eclipse/swt/internal/motif/XPropertyEvent.java;1;0;1;1;0;0;0;1;0;0;1;88;0;0;1;0;0;1;1;88;0;88;1;1;0
/org.eclipse.jdt.core/codeassist/org/eclipse/jdt/internal/codeassist/complete/CompletionOnMessageSend.java;2;0;3;1;0;0;0;3;20;1;3;1;32;32;1;0;0;3;3;1;0;199;3;2;0
/org.eclipse.pde.runtime/src/org/eclipse/pde/internal/runtime/logview/OpenLogDialog.java;2;2;3;2;3;2;3;0;379;0;0;312;379;379;2;0;1;0;3;330;1;330;2;2;0
/org.eclipse.help/src/org/eclipse/help/IToc.java;1;1;5;1;3;3;3;2;25;1;2;73;43;43;1;0;0;2;5;73;0;336;5;1;0
/org.eclipse.core.resources/src/org/eclipse/core/internal/events/ILifecycleListener.java;1;0;1;1;1;1;1;0;4;0;0;277;4;4;1;0;0;0;1;277;0;277;1;1;0
/org.eclipse.debug.ui/ui/org/eclipse/debug/internal/ui/sourcelookup/SourceContainerWorkbenchAdapter.java;1;0;4;1;0;0;0;4;15;2;2;253;26;26;2;2;0;4;4;253;2;267;2;1;0
/org.eclipse.ui.workbench/Eclipse UI/org/eclipse/ui/commands/IKeyConfigurationListener.java;3;1;5;1;2;2;2;3;20;1;3;87;52;52;1;0;0;3;5;87;0;336;5;3;0
/org.eclipse.jdt.ui/ui/org/eclipse/jdt/internal/ui/preferences/MembersOrderPreferenceCache.java;2;0;2;1;1;1;1;1;110;0;1;207;112;112;1;0;0;1;2;207;0;336;2;2;0
/org.eclipse.ui.ide/src/org/eclipse/ui/views/markers/internal/TableContentProvider.java;4;2;10;2;4;3;4;6;480;2;5;129;559;559;2;1;1;6;10;181;2;336;8;4;0
/org.eclipse.jdt.ui/ui refactoring/org/eclipse/jdt/internal/ui/refactoring/reorg/ReorgMoveWizard.java;4;2;14;1;5;3;6;8;77;2;6;70;245;245;2;2;3;9;14;70;5;336;9;4;0
/org.eclipse.ui.workbench/Eclipse UI/org/eclipse/ui/internal/dialogs/PreferenceImportExportWizard.java;4;1;6;1;3;3;3;3;243;2;2;203;468;468;2;1;0;3;6;203;1;336;5;4;0
/org.eclipse.search/new search/org/eclipse/search/ui/SearchResultEvent.java;3;3;8;2;4;2;4;4;46;1;4;195;113;113;3;0;2;4;8;276;2;336;6;3;0
/org.eclipse.jdt.core/model/org/eclipse/jdt/core/NamingConventions.java;3;0;6;1;0;0;0;6;142;1;6;2;225;225;1;0;0;6;6;2;0;199;6;3;0
/org.eclipse.ui.workbench/Eclipse UI/org/eclipse/ui/activities/NotDefinedException.java;3;1;7;1;2;2;2;5;31;2;4;146;54;54;2;1;0;5;7;156;1;336;6;3;0
/org.eclipse.swt/Eclipse SWT/gtk/org/eclipse/swt/graphics/Font.java;4;0;4;2;1;1;1;3;12;1;3;76;20;20;1;0;0;3;4;76;0;337;4;4;2
/org.eclipse.swt/Eclipse SWT PI/gtk/org/eclipse/swt/internal/gtk/GdkEventVisibility.java;2;1;2;1;2;2;2;0;2;0;0;324;2;2;1;0;0;0;2;324;0;337;2;2;0
/org.eclipse.swt/Eclipse SWT/win32/org/eclipse/swt/widgets/Composite.java;7;1;25;5;2;2;5;20;182;4;13;2;462;462;4;7;3;23;25;188;10;337;15;7;0
/org.eclipse.jdt.ui/core refactoring/org/eclipse/jdt/internal/corext/refactoring/util/RefactoringFileBuffers.java;1;0;2;1;1;1;1;1;4;0;1;257;4;4;1;0;0;1;2;257;0;332;2;1;0
/org.eclipse.ant.ui/Ant Editor/org/eclipse/ant/internal/ui/editor/text/XMLTextHover.java;2;2;12;2;4;2;4;8;269;3;4;108;327;327;3;4;2;8;12;201;6;295;6;2;6
/org.eclipse.jdt.ui/ui/org/eclipse/jdt/internal/ui/search/JavaSearchResultCollector.java;2;1;6;1;2;2;2;4;32;2;3;82;46;46;2;1;0;4;6;135;1;336;5;2;0
/org.eclipse.ui.workbench/Eclipse UI/org/eclipse/ui/progress/IDeferredWorkbenchAdapter.java;2;3;6;1;4;2;4;2;20;1;2;67;30;30;3;0;2;2;6;280;2;336;4;2;0
/org.eclipse.jdt.ui/ui/org/eclipse/jdt/internal/ui/text/DocumentCharacterIterator.java;2;1;2;1;2;2;2;0;8;0;0;323;8;8;1;0;0;0;2;323;0;336;2;2;0
/org.eclipse.text/src/org/eclipse/jface/text/templates/TemplateContextType.java;3;2;3;2;3;2;3;0;30;0;0;279;30;30;2;0;1;0;3;334;1;334;2;3;0
/org.eclipse.pde.core/src/org/eclipse/pde/internal/core/site/Site.java;2;1;3;1;2;2;2;1;26;0;1;232;35;35;1;0;0;1;3;232;0;336;3;2;0
/org.eclipse.jdt.ui/ui/org/eclipse/jdt/internal/ui/text/javadoc/JavaDocScanner.java;6;1;11;2;4;4;4;7;46;3;5;81;125;125;3;2;0;7;11;244;2;336;9;6;0
/org.eclipse.debug.ui/ui/org/eclipse/debug/internal/ui/sourcelookup/SourceLookupUIUtils.java;2;0;4;1;1;1;1;3;14;2;2;209;20;20;2;1;0;3;4;268;1;294;3;2;1
/org.eclipse.ui.cheatsheets/src/org/eclipse/ui/internal/cheatsheets/views/CoreItem.java;2;6;18;2;12;4;12;6;894;5;2;243;1603;1603;6;4;8;6;18;295;12;335;6;2;0
/org.eclipse.jdt.core/model/org/eclipse/jdt/internal/core/jdom/DOMImport.java;2;1;4;1;2;2;2;2;25;1;2;199;41;41;1;0;0;2;4;199;0;314;4;2;0
/org.eclipse.core.resources.win32/src/org/eclipse/core/internal/resources/refresh/win32/Convert.java;1;0;2;1;0;0;0;2;22;1;2;206;22;22;1;0;0;2;2;206;0;267;2;1;0
/org.eclipse.help/src/org/eclipse/help/internal/toc/Link.java;1;1;4;1;3;3;3;1;12;0;1;197;25;25;1;0;0;1;4;197;0;336;4;1;0
/org.eclipse.jdt.ui/ui/org/eclipse/jdt/internal/ui/text/spelling/WordIgnoreProposal.java;2;0;2;1;1;1;1;1;2;0;1;219;2;2;1;0;0;1;2;219;0;336;2;2;0
/org.eclipse.ui.ide/src/org/eclipse/ui/internal/ide/dialogs/ProjectCapabilityPropertyPage.java;1;0;1;1;0;0;0;1;0;0;1;132;0;0;1;0;0;1;1;132;0;132;1;1;0
/org.eclipse.team.core/src/org/eclipse/team/internal/core/subscribers/SyncInfoStatistics.java;1;0;3;1;1;1;1;2;107;1;2;199;111;111;1;0;0;2;3;199;0;336;3;1;0
/org.eclipse.swt/Eclipse SWT Mozilla/common/org/eclipse/swt/internal/mozilla/nsIProperties.java;1;0;2;1;0;0;0;2;4;1;2;100;4;4;1;0;0;2;2;100;0;148;2;1;0
/org.eclipse.jdt.core/compiler/org/eclipse/jdt/internal/compiler/lookup/Binding.java;1;0;1;1;0;0;0;1;2;0;1;199;2;2;1;0;0;1;1;199;0;199;1;1;1
/org.eclipse.ui.ide/src/org/eclipse/ui/views/markers/internal/MarkerType.java;1;0;1;1;0;0;0;1;0;0;1;129;0;0;1;0;0;1;1;129;0;129;1;1;1
/org.eclipse.jdt.ui/ui/org/eclipse/jdt/internal/ui/wizards/dialogfields/IListAdapter.java;1;0;1;1;1;1;1;0;2;0;0;336;2;2;1;0;0;0;1;336;0;336;1;1;0
/org.eclipse.osgi/core/adaptor/org/eclipse/osgi/framework/util/Tokenizer.java;4;1;5;1;2;2;2;3;296;1;3;171;310;310;1;0;0;3;5;171;0;336;5;4;0
/org.eclipse.jdt.core/dom/org/eclipse/jdt/core/dom/EmptyStatement.java;3;0;6;1;1;1;1;5;36;2;4;199;48;48;2;1;0;5;6;266;1;283;5;3;1
/org.eclipse.jdt.ui/ui/org/eclipse/jdt/internal/ui/javaeditor/IClassFileEditorInput.java;1;0;1;1;1;1;1;0;2;0;0;336;2;2;1;0;0;0;1;336;0;336;1;1;0
/org.eclipse.pde.runtime/src/org/eclipse/pde/internal/runtime/registry/TogglePropertiesAction.java;2;1;4;2;2;2;2;2;18;1;2;234;30;30;1;0;0;2;4;234;0;336;4;2;0
/org.eclipse.ui.workbench.texteditor/src/org/eclipse/ui/internal/texteditor/quickdiff/QuickDiffExtensionsRegistry.java;1;2;3;1;3;2;3;0;7;0;0;288;13;13;2;0;1;0;3;288;1;336;2;1;0
/org.eclipse.jdt.ui/ui/org/eclipse/jdt/internal/ui/preferences/OverlayPreferenceStore.java;2;1;3;1;2;2;2;1;34;0;1;81;42;42;1;0;0;1;3;81;0;336;3;2;0
/org.eclipse.ant.ui/Ant Editor/org/eclipse/ant/internal/ui/editor/model/AntPropertyNode.java;1;1;8;1;2;2;2;6;68;5;2;204;108;108;5;4;0;6;8;204;4;314;4;1;1
/org.eclipse.help.base/src/org/eclipse/help/internal/workingset/AdaptableToc.java;1;1;4;1;3;3;3;1;13;0;1;104;21;21;1;0;0;1;4;104;0;336;4;1;0
/org.eclipse.swt/Eclipse SWT Drag and Drop/gtk/org/eclipse/swt/dnd/TreeDragUnderEffect.java;4;1;6;1;2;2;2;4;94;2;3;49;117;117;2;1;0;4;6;49;1;337;5;4;0
/org.eclipse.jdt.debug.ui/ui/org/eclipse/jdt/internal/debug/ui/classpath/RuntimeClasspathViewer.java;3;1;6;1;2;2;2;4;37;1;4;154;95;95;1;0;0;4;6;154;0;336;6;3;0
/org.eclipse.jdt.ui/ui/org/eclipse/jdt/ui/actions/NavigateActionGroup.java;1;0;1;1;1;1;1;0;2;0;0;336;2;2;1;0;0;0;1;336;0;336;1;1;0
/org.eclipse.ui.cheatsheets/src/org/eclipse/ui/internal/cheatsheets/actions/CheatSheetHelpMenuAction.java;1;0;1;1;1;1;1;0;0;0;0;306;0;0;1;0;0;0;1;306;0;306;1;1;0
/org.eclipse.pde.ui/src/org/eclipse/pde/internal/ui/editor/PDEFormPage.java;3;6;8;3;7;2;7;1;373;0;1;180;384;384;6;0;5;1;8;292;5;336;3;3;0
/org.eclipse.ui.cheatsheets/src/org/eclipse/ui/internal/cheatsheets/views/CheatSheetManager.java;2;3;11;2;7;3;7;4;268;3;2;243;599;599;3;2;4;4;11;253;6;317;5;2;0
/org.eclipse.update.core/src/org/eclipse/update/internal/core/Volume.java;2;1;3;1;2;2;2;1;6;0;1;58;13;13;1;0;0;1;3;58;0;336;3;2;0
/org.eclipse.jdt.core/model/org/eclipse/jdt/core/util/IInnerClassesAttributeEntry.java;1;0;1;1;0;0;0;1;2;0;1;199;2;2;1;0;0;1;1;199;0;199;1;1;0
/org.eclipse.pde.ui/src/org/eclipse/pde/internal/ui/editor/plugin/ExtensionPointsPage.java;2;2;4;1;4;3;4;0;12;0;0;292;19;19;2;0;1;0;4;336;1;336;3;2;0
/org.eclipse.core.runtime/src/org/eclipse/core/runtime/IPlatformRunnable.java;3;2;5;1;3;2;3;2;17;1;2;180;21;21;2;0;1;2;5;272;1;336;4;3;0
/org.eclipse.core.resources/src/org/eclipse/core/internal/utils/KeyedHashSet.java;2;1;3;1;3;3;3;0;10;0;0;292;12;12;1;0;0;0;3;292;0;336;3;2;0
/org.eclipse.jdt.ui/ui/org/eclipse/jdt/internal/ui/javaeditor/DocumentAdapter.java;2;0;5;1;1;1;1;4;284;2;3;82;399;399;2;1;0;4;5;96;1;336;4;2;0
/org.eclipse.jdt.ui/core refactoring/org/eclipse/jdt/internal/corext/refactoring/typeconstraints/NullContext.java;2;0;2;1;1;1;1;1;2;0;1;207;2;2;1;0;0;1;2;207;0;336;2;2;0
/org.eclipse.jdt.ui/ui/org/eclipse/jdt/internal/ui/search/JavaSearchResultLabelProvider.java;4;2;6;2;3;2;3;3;46;0;1;184;55;55;3;2;1;3;6;184;3;336;3;4;0
/org.eclipse.jdt.launching/launching/org/eclipse/jdt/internal/launching/JavaSourceLookupDirector.java;1;0;6;1;0;0;0;6;29;3;3;227;70;70;3;3;0;6;6;267;3;267;3;1;0
/org.eclipse.text/src/org/eclipse/jface/text/link/LinkedPosition.java;2;2;4;2;3;2;3;1;31;0;1;232;45;45;2;0;1;1;4;334;1;334;3;2;0
/org.eclipse.jdt.core/formatter/org/eclipse/jdt/internal/formatter/align/AlignmentException.java;3;0;5;1;1;1;1;4;4;1;4;37;13;13;1;0;0;4;5;37;0;337;5;3;0
/org.eclipse.jdt.debug.ui/ui/org/eclipse/jdt/internal/debug/ui/actions/OpenVariableTypeAction.java;1;0;1;1;0;0;0;1;3;0;1;144;3;3;1;0;0;1;1;144;0;144;1;1;0
/org.eclipse.help.ide/src/org/eclipse/help/ui/internal/workingset/HelpWorkingSetTreeContentProvider.java;1;1;3;1;2;2;2;1;76;0;1;104;117;117;1;0;0;1;3;104;0;336;3;1;0
/org.eclipse.debug.core/core/org/eclipse/debug/internal/core/memory/IExtendedMemoryBlockRetrieval.java;1;0;1;1;1;1;1;0;0;0;0;282;0;0;1;0;0;0;1;282;0;282;1;1;1
/org.eclipse.ui.workbench/Eclipse UI/org/eclipse/ui/themes/IColorFactory.java;1;0;2;1;1;1;1;1;4;0;1;243;4;4;1;0;0;1;2;243;0;282;2;1;0
/org.eclipse.pde.ui/src/org/eclipse/pde/internal/ui/editor/SystemFileMarkerAnnotationModel.java;1;0;1;1;0;0;0;1;4;0;1;80;4;4;1;0;0;1;1;80;0;80;1;1;0
/org.eclipse.jdt.ui/ui/org/eclipse/jdt/internal/ui/wizards/buildpaths/NewContainerDialog.java;2;1;2;1;2;2;2;0;7;0;0;276;9;9;1;0;0;0;2;276;0;336;2;2;0
/org.eclipse.ui.workbench/Eclipse UI/org/eclipse/ui/internal/decorators/LightweightDecoratorManager.java;2;0;5;1;0;0;0;5;35;1;5;81;71;71;1;0;0;5;5;81;0;251;5;2;0
/org.eclipse.jdt.ui/core extension/org/eclipse/jdt/internal/corext/template/java/JavaContext.java;5;0;14;3;1;1;4;10;205;7;6;56;308;308;7;4;3;13;14;263;7;336;7;5;0
/org.eclipse.platform/src-intro/org/eclipse/platform/internal/CheatSheetStandbyContent.java;2;3;6;2;6;3;6;0;100;0;0;276;104;104;3;0;3;0;6;306;3;332;3;2;0
/org.eclipse.core.runtime/src/org/eclipse/core/runtime/IPluginDescriptor.java;5;2;16;2;3;2;8;8;662;6;6;4;1041;1041;6;2;6;13;16;270;8;336;8;5;0
/org.eclipse.ui.workbench/Eclipse UI/org/eclipse/ui/activities/WorkbenchActivityHelper.java;5;4;16;2;5;2;5;11;158;4;4;174;457;457;4;7;3;11;16;237;10;336;6;5;0
/org.eclipse.jdt.ui/core extension/org/eclipse/jdt/internal/corext/callhierarchy/CallSearchResultCollector.java;3;0;4;1;1;1;1;3;6;1;3;13;10;10;1;0;0;3;4;13;0;336;4;3;0
/org.eclipse.team.ui/src/org/eclipse/team/internal/ui/synchronize/RefreshUserNotificationPolicyInModalDialog.java;1;5;16;1;7;2;10;6;82;5;2;247;186;186;5;4;8;9;16;266;12;329;4;1;0
/org.eclipse.ant.ui/Ant Tools Support/org/eclipse/ant/internal/ui/launchConfigurations/EditAntHomeEntryAction.java;1;0;3;1;0;0;0;3;4;2;2;238;6;6;2;1;0;3;3;238;1;269;2;1;1
/org.eclipse.update.core/src/org/eclipse/update/core/model/SiteModel.java;4;1;7;1;3;3;3;4;8;2;3;0;30;30;2;1;0;4;7;230;1;336;6;4;0
/org.eclipse.search/search/org/eclipse/search/internal/core/text/TextSearchEngine.java;2;1;4;1;3;3;3;1;7;0;1;165;22;22;1;0;0;1;4;165;0;336;4;2;0
/org.eclipse.jdt.core/codeassist/org/eclipse/jdt/internal/codeassist/complete/CompletionOnFieldName.java;2;0;3;1;0;0;0;3;22;1;3;63;29;29;1;0;0;3;3;63;0;199;3;2;0
/org.eclipse.ui.workbench/Eclipse UI/org/eclipse/ui/internal/activities/Category.java;4;0;7;2;1;1;1;6;101;5;2;163;126;126;5;4;0;6;7;163;4;336;3;4;0
/org.eclipse.jdt.junit/src/org/eclipse/jdt/internal/junit/ui/CompareResultsAction.java;3;1;5;1;2;2;2;3;4;1;3;193;9;9;1;0;0;3;5;193;0;336;5;3;0
/org.eclipse.jdt.ui/ui/org/eclipse/jdt/internal/ui/text/spelling/engine/DefaultPhoneticDistanceAlgorithm.java;2;0;2;1;1;1;1;1;2;0;1;219;2;2;1;0;0;1;2;219;0;336;2;2;0
/org.eclipse.swt/Eclipse SWT PI/carbon/org/eclipse/swt/internal/carbon/ATSTrapezoid.java;1;0;2;1;2;1;2;0;20;0;0;296;20;20;2;0;1;0;2;296;1;296;1;1;0
/org.eclipse.ui.editors/src/org/eclipse/ui/texteditor/SelectMarkerRulerAction.java;2;1;7;2;2;2;3;4;76;3;3;82;128;128;3;1;1;5;7;268;2;336;5;2;0
/org.eclipse.jdt.ui/ui/org/eclipse/jdt/internal/ui/actions/SelectAllAction.java;1;0;1;1;1;1;1;0;2;0;0;336;2;2;1;0;0;0;1;336;0;336;1;1;0
/org.eclipse.ui.workbench/Eclipse UI/org/eclipse/ui/internal/about/AboutData.java;1;0;1;1;1;1;1;0;0;0;0;294;0;0;1;0;0;0;1;294;0;294;1;1;0
/org.eclipse.pde.core/src/org/eclipse/pde/internal/core/PDECore.java;3;5;21;3;8;4;8;13;525;4;8;40;1098;1098;5;5;4;13;21;302;9;336;12;3;0
/org.eclipse.jdt.core/search/org/eclipse/jdt/internal/core/search/matching/ConstructorLocator.java;4;0;8;2;1;1;1;7;67;4;4;118;87;87;4;3;0;7;8;118;3;280;5;4;1
/org.eclipse.jdt.ui/core refactoring/org/eclipse/jdt/internal/corext/refactoring/typeconstraints/ITypeConstraintFactory.java;1;0;1;1;0;0;0;1;0;0;1;217;0;0;1;0;0;1;1;217;0;217;1;1;0
/org.eclipse.swt/Eclipse SWT Browser/motif/org/eclipse/swt/browser/AppFileLocProvider.java;2;1;5;1;2;2;2;3;49;1;3;125;89;89;1;0;0;3;5;125;0;337;5;2;0
/org.eclipse.team.cvs.core/src/org/eclipse/team/internal/ccvs/core/client/listeners/RDiffSummaryListener.java;1;0;2;1;0;0;0;2;144;0;1;144;144;144;2;1;0;2;2;144;1;144;1;1;0
/org.eclipse.swt/Eclipse SWT PI/carbon/org/eclipse/swt/internal/carbon/DataBrowserListViewHeaderDesc.java;1;0;2;1;2;1;2;0;20;0;0;296;20;20;2;0;1;0;2;296;1;296;1;1;0
/org.eclipse.help.ide/src/org/eclipse/help/ui/internal/workingset/HelpWorkingSetPage.java;1;1;8;1;3;3;3;5;349;3;3;104;503;503;3;2;0;5;8;104;2;336;6;1;0
/org.eclipse.ant.ui/Ant Tools Support/org/eclipse/ant/internal/ui/datatransfer/DataTransferMessages.java;1;0;1;1;0;0;0;1;0;0;1;263;0;0;1;0;0;1;1;263;0;263;1;1;1
/org.eclipse.team.ui/src/org/eclipse/team/internal/ui/synchronize/actions/ShowSynchronizeParticipantAction.java;1;1;6;1;2;2;2;4;41;2;3;146;70;70;2;1;0;4;6;146;1;336;5;1;0
/org.eclipse.pde.ui/src/org/eclipse/pde/internal/ui/editor/site/FeatureSection.java;3;3;11;3;7;5;7;4;740;2;3;134;940;940;3;1;2;4;11;303;3;336;8;3;0
/org.eclipse.core.resources/src/org/eclipse/core/internal/dtree/NodeComparison.java;1;0;1;1;1;1;1;0;164;0;0;277;164;164;1;0;0;0;1;277;0;277;1;1;0
/org.eclipse.jdt.ui/ui refactoring/org/eclipse/jdt/internal/ui/refactoring/nls/search/NLSSearchOperation.java;3;1;5;2;2;2;2;3;19;2;2;163;23;23;2;1;0;3;5;268;1;336;4;3;0
/org.eclipse.jdt.core/compiler/org/eclipse/jdt/internal/compiler/lookup/BinaryTypeBinding.java;4;2;12;3;3;2;3;9;57;3;6;2;126;126;3;3;1;9;12;78;4;312;8;4;4
/org.eclipse.jface.text/src/org/eclipse/jface/text/formatter/MultiPassContentFormatter.java;4;3;7;3;5;2;5;2;101;1;2;240;148;148;3;0;3;2;7;274;3;336;4;4;0
/org.eclipse.pde.ui/src/org/eclipse/pde/internal/ui/PDEPerspective.java;2;1;6;1;2;2;2;4;143;2;3;64;182;182;2;1;0;4;6;99;1;336;5;2;0
/org.eclipse.help.webapp/src_servlets/org/eclipse/help/internal/webapp/data/LinksData.java;1;1;5;1;3;3;3;2;15;1;2;124;47;47;1;0;0;2;5;124;0;336;5;1;0
/org.eclipse.team.ui/src/org/eclipse/team/internal/ui/synchronize/SyncInfoSetSynchronizePage.java;2;0;4;2;4;1;4;0;77;0;0;288;77;77;4;0;3;0;4;288;3;288;1;2;0
/org.eclipse.ui.workbench/Eclipse UI/org/eclipse/ui/internal/actions/PinEditorContributionItem.java;2;0;2;1;0;0;0;2;82;1;2;106;82;82;1;0;0;2;2;106;0;157;2;2;0
/org.eclipse.text/projection/org/eclipse/jface/text/projection/ChildDocument.java;2;1;5;1;2;2;2;3;106;2;2;253;131;131;2;1;0;3;5;253;1;334;4;2;0
/org.eclipse.pde.runtime/src/org/eclipse/pde/internal/runtime/registry/PluginPropertySource.java;2;1;5;1;2;2;2;3;126;2;2;59;285;285;2;1;0;3;5;224;1;336;4;2;0
/org.eclipse.update.ui/src/org/eclipse/update/internal/ui/model/SimpleFeatureAdapter.java;1;0;1;1;0;0;0;1;5;0;1;58;5;5;1;0;0;1;1;58;0;58;1;1;0
/org.eclipse.pde.ui/src/org/eclipse/pde/internal/ui/editor/build/BuildEditor.java;3;6;7;3;7;2;7;0;19;0;0;292;23;23;6;0;5;0;7;292;5;336;2;3;0
/org.eclipse.jdt.junit/src/org/eclipse/jdt/internal/junit/ui/JUnitProgressBar.java;2;1;6;1;2;2;2;4;20;1;4;69;59;59;1;0;0;4;6;69;0;336;6;2;0
/org.eclipse.ui.workbench.texteditor/src/org/eclipse/ui/texteditor/ITextEditorExtension3.java;3;0;5;2;1;1;1;4;14;2;3;46;26;26;2;1;0;4;5;76;1;336;4;3;0
/org.eclipse.jdt.core/model/org/eclipse/jdt/internal/core/builder/ClasspathMultiDirectory.java;2;0;4;2;0;0;0;4;14;1;4;31;28;28;1;0;0;4;4;31;0;266;4;2;0
/org.eclipse.pde.ui/src/org/eclipse/pde/internal/ui/editor/schema/SchemaDocPage.java;2;1;5;1;4;4;4;1;102;0;1;26;149;149;1;0;0;1;5;26;0;336;5;2;0
/org.eclipse.jdt.ui/ui/org/eclipse/jdt/ui/actions/WorkingSetFindAction.java;2;0;2;1;1;1;1;1;2;0;1;41;4;4;1;0;0;1;2;41;0;336;2;2;0
/org.eclipse.core.runtime.compatibility/src-runtime/org/eclipse/core/internal/plugins/Library.java;2;1;3;1;2;2;2;1;6;0;1;171;8;8;1;0;0;1;3;171;0;336;3;2;0
/org.eclipse.debug.ui/ui/org/eclipse/debug/internal/ui/sourcelookup/SourceLookupPanel.java;3;4;7;2;6;2;6;1;77;0;1;269;88;88;4;0;4;1;7;296;4;325;3;3;0
/org.eclipse.jdt.core/model/org/eclipse/jdt/internal/core/JavaProjectElementInfo.java;2;0;7;2;1;1;1;6;178;2;4;10;191;191;2;2;0;6;7;178;2;306;5;2;0
/org.eclipse.ltk.core.refactoring/src/org/eclipse/ltk/core/refactoring/participants/RefactoringProcessor.java;1;0;9;1;2;1;7;2;255;0;1;264;272;272;7;1;6;7;9;264;7;336;2;1;0
/org.eclipse.jdt.core/dom/org/eclipse/jdt/core/dom/ArrayType.java;4;0;9;1;2;1;2;7;78;2;6;70;112;112;2;1;1;7;9;266;2;276;7;4;1
/org.eclipse.team.cvs.ui/src/org/eclipse/team/internal/ccvs/ui/wizards/ICVSWizard.java;2;0;3;1;1;1;1;2;27;0;1;251;37;37;2;1;0;2;3;251;1;336;2;2;0
/org.eclipse.jdt.core/model/org/eclipse/jdt/internal/core/CompilationUnit.java;5;2;65;3;4;3;8;57;1703;20;9;6;2341;2341;20;48;5;61;65;51;53;323;12;5;3
/org.eclipse.ui.workbench/Eclipse UI/org/eclipse/ui/internal/commands/PreferenceCommandRegistry.java;3;2;13;1;3;2;3;10;337;2;7;85;607;607;2;3;1;10;13;85;4;336;9;3;0
/org.eclipse.core.runtime/src/org/eclipse/core/runtime/jobs/ISchedulingRule.java;3;0;12;3;2;1;2;10;264;4;6;43;363;363;4;4;1;10;12;166;5;274;7;3;0
/org.eclipse.ui.workbench/Eclipse UI/org/eclipse/ui/internal/dialogs/PropertyPageContributorManager.java;3;0;4;2;1;1;1;3;54;2;2;157;58;58;2;1;0;3;4;157;1;336;3;3;2
/org.eclipse.team.cvs.core/src/org/eclipse/team/internal/ccvs/core/util/KnownRepositories.java;2;1;5;1;2;2;2;3;230;2;2;142;234;234;2;1;0;3;5;254;1;336;4;2;0
/org.eclipse.debug.ui/ui/org/eclipse/debug/internal/ui/actions/ProfileToolbarAction.java;1;0;1;1;0;0;0;1;0;0;1;33;0;0;1;0;0;1;1;33;0;33;1;1;0
/org.eclipse.jdt.debug/eval/org/eclipse/jdt/internal/debug/eval/ast/instructions/ReturnInstruction.java;1;0;1;1;0;0;0;1;3;0;1;144;3;3;1;0;0;1;1;144;0;144;1;1;0
/org.eclipse.update.core/src/org/eclipse/update/core/Feature.java;2;2;11;1;3;2;3;8;377;2;6;62;578;578;2;2;1;8;11;62;3;302;8;2;2
/org.eclipse.pde.ui/src/org/eclipse/pde/internal/ui/IPDEUIConstants.java;3;2;5;2;4;3;4;1;26;0;1;211;40;40;2;0;1;1;5;286;1;336;4;3;0
/org.eclipse.ui.forms/src/org/eclipse/ui/forms/widgets/FormToolkit.java;1;0;13;1;0;0;2;11;332;8;2;225;373;373;8;9;2;13;13;253;11;253;2;1;0
/org.eclipse.swt/Eclipse SWT Browser/mozilla/org/eclipse/swt/browser/InputStream.java;1;0;1;1;0;0;0;1;0;0;1;153;0;0;1;0;0;1;1;153;0;153;1;1;0
/org.eclipse.core.resources/src/org/eclipse/core/internal/watson/ElementTreeReader.java;1;0;1;1;1;1;1;0;177;0;0;277;177;177;1;0;0;0;1;277;0;277;1;1;0
/org.eclipse.swt/Eclipse SWT/photon/org/eclipse/swt/widgets/MenuItem.java;3;1;8;1;4;4;4;4;11;2;3;19;33;33;2;1;0;4;8;129;1;337;7;3;0
/org.eclipse.jdt.ui/ui refactoring/org/eclipse/jdt/internal/ui/refactoring/RefactoringSaveHelper.java;3;0;5;1;1;1;1;4;17;1;4;80;37;37;1;0;0;4;5;80;0;336;5;3;0
/org.eclipse.search/new search/org/eclipse/search2/internal/ui/text/Highlighter.java;1;1;2;1;2;2;2;0;47;0;0;295;47;47;1;0;0;0;2;295;0;323;2;1;0
/org.eclipse.swt/Eclipse SWT PI/motif/org/eclipse/swt/internal/motif/XModifierKeymap.java;1;0;1;1;0;0;0;1;0;0;1;114;0;0;1;0;0;1;1;114;0;114;1;1;0
/org.eclipse.ui.ide/src/org/eclipse/ui/internal/ide/ChooseWorkspaceData.java;5;3;8;2;4;2;4;4;82;2;3;244;134;134;3;1;2;4;8;325;3;325;5;5;0
/org.eclipse.update.ui/src/org/eclipse/update/internal/ui/views/ConfigurationView.java;4;7;28;3;10;4;10;18;1697;5;10;50;2327;2327;7;8;6;18;28;289;14;336;14;4;2
/org.eclipse.jdt.ui/ui/org/eclipse/jdt/internal/ui/infoviews/GotoInputAction.java;1;0;2;1;1;1;1;1;2;0;1;86;2;2;1;0;0;1;2;86;0;336;2;1;0
/org.eclipse.jdt.core/dom/org/eclipse/jdt/core/dom/LineComment.java;2;0;6;1;1;1;1;5;37;2;4;206;47;47;2;1;0;5;6;266;1;283;5;2;1
/org.eclipse.swt/Eclipse SWT/carbon/org/eclipse/swt/widgets/ToolItem.java;3;2;17;2;4;2;4;13;120;3;7;19;254;254;3;6;2;13;17;19;8;335;9;3;0
/org.eclipse.jdt.ui/ui/org/eclipse/jdt/internal/ui/text/comment/Java2HTMLEntityReader.java;2;0;2;1;1;1;1;1;2;0;1;200;2;2;1;0;0;1;2;200;0;336;2;2;0
/org.eclipse.jface.text/src/org/eclipse/jface/text/source/OverviewRuler.java;4;2;20;2;6;4;7;13;184;3;8;55;651;651;3;5;3;14;20;99;8;336;12;4;0
/org.eclipse.ui.workbench/Eclipse UI/org/eclipse/ui/internal/NavigationHistoryAction.java;3;0;5;1;1;1;1;4;206;2;3;157;236;236;2;1;0;4;5;157;1;336;4;3;0
/org.eclipse.jdt.core/compiler/org/eclipse/jdt/internal/compiler/ast/ContinueStatement.java;2;0;4;1;0;0;0;4;10;1;4;11;18;18;1;0;0;4;4;11;0;199;4;2;0
/org.eclipse.ltk.core.refactoring/src/org/eclipse/ltk/internal/core/refactoring/AssertionFailedException.java;1;1;3;1;2;2;2;1;5;0;1;264;7;7;1;0;0;1;3;264;0;336;3;1;0
/org.eclipse.jdt.ui/ui/org/eclipse/jdt/internal/ui/text/template/contentassist/MultiVariableGuess.java;2;0;2;1;1;1;1;1;2;0;1;267;2;2;1;0;0;1;2;267;0;336;2;2;0
/org.eclipse.jdt.junit/src/org/eclipse/jdt/internal/junit/launcher/ResourceExtender.java;2;0;2;1;1;1;1;1;10;0;1;251;10;10;1;0;0;1;2;251;0;336;2;2;0
/org.eclipse.osgi/osgi/src/org/osgi/framework/FrameworkEvent.java;3;1;4;1;2;2;2;2;16;1;2;171;33;33;1;0;0;2;4;171;0;296;4;3;0
/org.eclipse.debug.ui/ui/org/eclipse/debug/ui/console/IConsoleLineTracker.java;2;0;3;2;0;0;0;3;14;0;1;125;14;14;3;2;0;3;3;125;2;125;1;2;0
/org.eclipse.ui.externaltools/External Tools Base/org/eclipse/ui/externaltools/internal/ui/ExternalToolsPreferencePage.java;2;0;2;2;1;1;1;1;39;0;1;2;50;50;1;0;0;1;2;2;0;324;2;2;0
/org.eclipse.jdt.debug.ui/ui/org/eclipse/jdt/internal/debug/core/refactoring/JavaBreakpointIPackageFragmentRenameParticipant.java;2;1;2;1;2;2;2;0;8;0;0;300;8;8;1;0;0;0;2;300;0;336;2;2;0
/org.eclipse.jdt.ui/ui/org/eclipse/jdt/internal/ui/search/FiltersDialog.java;2;1;2;1;2;2;2;0;10;0;0;326;10;10;1;0;0;0;2;326;0;336;2;2;0
/org.eclipse.ui.workbench/Eclipse UI/org/eclipse/ui/internal/misc/TestPageListener.java;1;0;1;1;0;0;0;1;1;0;1;157;1;1;1;0;0;1;1;157;0;157;1;1;0
/org.eclipse.ui.presentations.r21/src/org/eclipse/ui/internal/presentations/r21/widgets/ViewForm.java;1;1;2;1;2;2;2;0;2;0;0;323;2;2;1;0;0;0;2;323;0;336;2;1;0
/org.eclipse.jface.text/src/org/eclipse/jface/text/source/ILineDiffer.java;3;0;5;2;3;1;3;2;46;0;1;70;57;57;3;1;2;2;5;335;3;335;2;3;0
/org.eclipse.swt/Eclipse SWT/carbon/org/eclipse/swt/widgets/Group.java;4;2;7;2;3;2;3;4;17;3;2;1;46;46;3;2;1;4;7;1;3;331;4;4;0
/org.eclipse.jdt.ui/ui/org/eclipse/jdt/internal/ui/preferences/ImportOrganizePreferencePage.java;2;0;4;1;1;1;1;3;43;1;3;82;52;52;1;0;0;3;4;82;0;336;4;2;0
/org.eclipse.jdt.ui/core refactoring/org/eclipse/jdt/internal/corext/refactoring/reorg/ICreateTargetQueries.java;1;0;1;1;1;1;1;0;0;0;0;313;0;0;1;0;0;0;1;313;0;313;1;1;0
/org.eclipse.jdt.core/model/org/eclipse/jdt/internal/core/util/LocalVariableTableEntry.java;1;0;1;1;0;0;0;1;2;0;1;199;2;2;1;0;0;1;1;199;0;199;1;1;0
/org.eclipse.ui.editors/src/org/eclipse/ui/texteditor/AbstractDecoratedTextEditorPreferenceConstants.java;3;2;5;2;5;3;5;0;47;0;0;276;80;80;2;0;2;0;5;288;2;332;3;3;0
/org.eclipse.ui.workbench/Eclipse UI/org/eclipse/ui/internal/dialogs/SavePerspectiveDialog.java;4;1;6;1;2;2;2;4;22;1;4;129;33;33;1;0;0;4;6;129;0;336;6;4;0
/org.eclipse.pde.ui/src/org/eclipse/pde/internal/ui/view/PluginsLabelProvider.java;2;1;3;1;2;2;2;1;6;0;1;157;11;11;1;0;0;1;3;157;0;336;3;2;0
/org.eclipse.jdt.ui/core extension/org/eclipse/jdt/internal/corext/template/java/JavaDocContextType.java;4;1;5;1;2;2;2;3;33;2;2;175;52;52;2;1;0;3;5;234;1;336;4;4;0
/org.eclipse.ui.ide/extensions/org/eclipse/ui/actions/CreateFolderAction.java;1;0;2;1;0;0;0;2;2;1;2;132;2;2;1;0;0;2;2;132;0;150;2;1;0
/org.eclipse.ant.ui/Ant Tools Support/org/eclipse/ant/internal/ui/preferences/AddCustomDialog.java;2;0;8;2;1;1;1;7;68;3;3;108;103;103;3;4;0;7;8;108;4;299;4;2;2
/org.eclipse.osgi/osgi/src/org/osgi/util/tracker/ServiceTrackerCustomizer.java;2;1;2;1;2;2;2;0;5;0;0;274;5;5;1;0;0;0;2;274;0;296;2;2;0
/org.eclipse.ui.ide/extensions/org/eclipse/ui/actions/MoveProjectAction.java;4;0;4;2;1;1;2;2;26;2;2;132;28;28;2;0;1;3;4;269;1;336;3;4;2
/org.eclipse.update.core/src/org/eclipse/update/internal/operations/ConfigOperation.java;1;0;9;1;1;1;1;8;7;2;7;54;22;22;2;1;0;8;9;232;1;336;8;1;0
/org.eclipse.ui.workbench/Eclipse UI/org/eclipse/ui/internal/layout/LayoutUtil.java;1;1;2;1;2;2;2;0;9;0;0;293;9;9;1;0;0;0;2;293;0;308;2;1;0
/org.eclipse.swt/Eclipse SWT PI/photon/org/eclipse/swt/internal/photon/PgMap_t.java;1;0;1;1;0;0;0;1;1;0;1;53;1;1;1;0;0;1;1;53;0;53;1;1;0
/org.eclipse.debug.core/core/org/eclipse/debug/core/model/Breakpoint.java;2;1;5;1;2;2;2;3;18;2;2;157;35;35;2;1;0;3;5;250;1;336;4;2;0
/org.eclipse.ui.workbench/Eclipse UI/org/eclipse/ui/part/PageSite.java;3;0;4;2;1;1;1;3;48;2;2;163;51;51;2;1;0;3;4;163;1;336;3;3;0
/org.eclipse.ui.ide/src/org/eclipse/ui/views/markers/internal/DialogProblemFilter.java;1;0;1;1;0;0;0;1;0;0;1;129;0;0;1;0;0;1;1;129;0;129;1;1;1
/org.eclipse.jdt.ui/core refactoring/org/eclipse/jdt/internal/corext/refactoring/util/TextChangeManager.java;4;0;5;2;1;1;1;4;15;2;3;96;25;25;2;1;0;4;5;250;1;336;4;4;0
/org.eclipse.pde.ui/src_Forms/org/eclipse/pde/internal/ui/model/build/BuildEntry.java;3;4;7;2;7;3;7;0;129;0;0;285;145;145;4;0;4;0;7;285;4;336;3;3;0
/org.eclipse.core.resources/src/org/eclipse/core/internal/resources/SaveManager.java;2;0;14;1;3;1;3;11;2942;4;6;17;3169;3169;4;5;2;11;14;90;7;275;7;2;1
/org.eclipse.pde.ui/src/org/eclipse/pde/internal/ui/editor/build/AddLibraryDialog.java;2;2;7;2;5;3;5;2;137;1;2;105;166;166;2;0;2;2;7;292;2;336;5;2;0
/org.eclipse.jdt.core/model/org/eclipse/jdt/internal/core/ReconcileWorkingCopyOperation.java;3;1;13;1;2;2;2;11;63;2;9;54;149;149;2;2;0;11;13;54;2;323;11;3;1
/org.eclipse.pde.core/src/org/eclipse/pde/internal/core/isite/ISiteBuild.java;2;1;4;1;3;3;3;1;10;0;1;232;17;17;1;0;0;1;4;232;0;336;4;2;0
/org.eclipse.ui.ide/extensions/org/eclipse/ui/actions/AddTaskAction.java;1;0;2;1;0;0;0;2;2;1;2;132;2;2;1;0;0;2;2;132;0;150;2;1;0
/org.eclipse.jdt.core/dom/org/eclipse/jdt/core/dom/AbstractTypeDeclaration.java;1;0;6;1;2;1;2;4;230;3;2;225;260;260;3;2;1;4;6;225;3;276;3;1;0
/org.eclipse.help/src/org/eclipse/help/internal/model/ILinkElement.java;1;0;2;1;1;1;1;1;9;0;1;197;9;9;1;0;0;1;2;197;0;311;2;1;0
/org.eclipse.jdt.debug.ui/ui/org/eclipse/jdt/internal/debug/ui/actions/OpenReceivingTypeHierarchyAction.java;1;0;1;1;0;0;0;1;3;0;1;78;3;3;1;0;0;1;1;78;0;78;1;1;0
/org.eclipse.ui.workbench.texteditor/src/org/eclipse/ui/texteditor/IUpdate.java;1;0;1;1;1;1;1;0;2;0;0;336;2;2;1;0;0;0;1;336;0;336;1;1;0
/org.eclipse.ui.workbench/Eclipse UI/org/eclipse/ui/internal/dialogs/ExportWizard.java;1;0;1;1;0;0;0;1;12;0;1;157;12;12;1;0;0;1;1;157;0;157;1;1;1
/org.eclipse.ui.ide/src/org/eclipse/ui/views/navigator/ResourceSorter.java;1;0;1;1;0;0;0;1;0;0;1;129;0;0;1;0;0;1;1;129;0;129;1;1;0
/org.eclipse.ui.editors/src/org/eclipse/ui/texteditor/AnnotationTypeLookup.java;4;2;7;2;4;3;4;3;7;2;2;181;17;17;2;1;1;3;7;202;2;336;5;4;0
/org.eclipse.osgi/core/framework/org/eclipse/osgi/framework/internal/core/BundleFragment.java;4;3;15;2;6;4;6;9;219;5;4;171;435;435;5;5;2;9;15;238;7;336;8;4;0
/org.eclipse.swt.tools/JNI Generation/org/eclipse/swt/tools/internal/JNIGeneratorAppUI.java;3;0;3;2;0;0;0;3;212;2;2;230;215;215;2;1;0;3;3;230;1;250;2;3;0
/org.eclipse.jdt.debug.ui/ui/org/eclipse/jdt/internal/debug/ui/actions/StepIntoSelectionActionDelegate.java;4;2;11;2;4;3;4;7;249;4;3;207;366;366;4;4;1;7;11;245;5;336;6;4;1
/org.eclipse.update.core/src/org/eclipse/update/core/model/FeatureReferenceModel.java;2;2;6;1;4;3;4;2;12;1;2;58;32;32;2;0;1;2;6;290;1;336;5;2;0
/org.eclipse.ui.workbench.texteditor/src/org/eclipse/ui/texteditor/link/EditorLinkedModeUI.java;2;1;2;1;2;2;2;0;2;0;0;279;2;2;1;0;0;0;2;279;0;336;2;2;0
/org.eclipse.ant.ui/Ant Tools Support/org/eclipse/ant/internal/ui/preferences/DialogSettingsHelper.java;1;0;1;1;0;0;0;1;0;0;1;269;0;0;1;0;0;1;1;269;0;269;1;1;1
/org.eclipse.ui.workbench/Eclipse UI/org/eclipse/ui/actions/NewWizardAction.java;4;2;7;2;3;2;3;4;62;1;4;157;114;114;2;0;1;4;7;274;1;336;6;4;0
/org.eclipse.jdt.ui/ui/org/eclipse/jdt/ui/wizards/NewJavaProjectWizardPage.java;2;0;3;1;1;1;1;2;4;1;2;51;9;9;1;0;0;2;3;51;0;336;3;2;0
/org.eclipse.jdt.ui/ui/org/eclipse/jdt/internal/ui/search/SearchParticipantRecord.java;1;0;1;1;1;1;1;0;0;0;0;299;0;0;1;0;0;0;1;299;0;299;1;1;0
/org.eclipse.pde.core/src/org/eclipse/pde/internal/core/schema/FileSchemaDescriptor.java;3;1;3;1;2;2;2;1;4;0;1;267;10;10;1;0;0;1;3;267;0;336;3;3;0
/org.eclipse.ui.workbench/Eclipse UI/org/eclipse/ui/IPartListener2.java;2;1;3;1;3;3;3;0;32;0;0;294;52;52;1;0;0;0;3;294;0;336;3;2;0
/org.eclipse.ui.externaltools/External Tools Base/org/eclipse/ui/externaltools/internal/ui/FileSelectionDialog.java;2;1;4;1;2;2;2;2;349;1;2;76;359;359;1;0;0;2;4;76;0;336;4;2;0
/org.eclipse.ui.ide/src/org/eclipse/ui/views/markers/internal/ProblemFilter.java;2;0;2;1;0;0;0;2;24;1;2;129;24;24;1;0;0;2;2;129;0;181;2;2;0
/org.eclipse.jdt.debug/model/org/eclipse/jdt/internal/debug/core/breakpoints/JavaMethodBreakpoint.java;5;0;8;1;1;1;1;7;30;2;6;26;102;102;2;1;0;7;8;237;1;336;7;5;2
/org.eclipse.team.cvs.ui/src/org/eclipse/team/internal/ccvs/ui/repo/RefreshRemoteProjectSelectionPage.java;1;0;1;1;0;0;0;1;1;0;1;138;1;1;1;0;0;1;1;138;0;138;1;1;1
/org.eclipse.ant.ui/Ant Tools Support/org/eclipse/ant/internal/ui/model/ImageDescriptorRegistry.java;1;0;3;1;1;1;1;2;4;1;2;108;6;6;1;0;0;2;3;108;0;336;3;1;1
/org.eclipse.jdt.ui/ui/org/eclipse/jdt/internal/ui/viewsupport/DecoratingJavaLabelProvider.java;2;0;5;1;1;1;1;4;102;2;3;31;148;148;2;1;0;4;5;31;1;336;4;2;0
/org.eclipse.jdt.debug.ui/ui/org/eclipse/jdt/internal/debug/ui/actions/PrimitiveOptionsDialog.java;1;0;1;1;0;0;0;1;14;0;1;243;14;14;1;0;0;1;1;243;0;243;1;1;0
/org.eclipse.ui.workbench/Eclipse UI/org/eclipse/ui/internal/contexts/ProxyContextManager.java;3;1;5;2;2;2;2;3;12;2;2;174;20;20;2;1;0;3;5;262;1;336;4;3;0
/org.eclipse.pde.ui/src/org/eclipse/pde/ui/templates/TemplateOption.java;2;2;4;1;4;3;4;0;162;0;0;276;170;170;2;0;1;0;4;276;1;336;3;2;0
/org.eclipse.swt/Eclipse SWT Browser/motif/org/eclipse/swt/browser/Browser.java;2;6;32;2;8;2;9;23;1050;7;6;100;3132;3132;7;17;7;24;32;153;24;331;8;2;2
/org.eclipse.search/search/org/eclipse/search/internal/ui/SortDropDownAction.java;1;0;2;1;1;1;1;1;2;0;1;82;4;4;1;0;0;1;2;82;0;336;2;1;0
/org.eclipse.jdt.core/model/org/eclipse/jdt/internal/core/BufferFactoryWrapper.java;2;0;8;2;1;1;1;7;40;2;6;54;68;68;2;1;0;7;8;66;1;279;7;2;0
/org.eclipse.ui.ide/src/org/eclipse/ui/internal/ide/dialogs/InternalBase64Encoder.java;1;0;1;1;0;0;0;1;0;0;1;132;0;0;1;0;0;1;1;132;0;132;1;1;0
/org.eclipse.core.resources/src/org/eclipse/core/internal/watson/IElementContentVisitor.java;1;0;1;1;1;1;1;0;26;0;0;277;26;26;1;0;0;0;1;277;0;277;1;1;0
/org.eclipse.jdt.ui/ui/org/eclipse/jdt/internal/ui/javaeditor/CompilationUnitEditor.java;5;5;63;5;10;3;16;47;789;19;11;35;2218;2218;19;36;13;53;63;245;49;323;14;5;2
/org.eclipse.osgi/core/framework/org/eclipse/osgi/framework/internal/core/Constants.java;4;2;11;2;4;3;4;7;130;2;6;171;335;335;2;1;1;7;11;229;2;313;9;4;0
/org.eclipse.ui.ide/src/org/eclipse/ui/internal/ide/IDEApplication.java;5;3;22;2;8;5;8;14;505;7;5;92;709;709;7;9;3;14;22;237;12;336;10;5;0
/org.eclipse.debug.core/core/org/eclipse/debug/internal/core/memory/MemoryBlockManager.java;2;2;3;2;3;2;3;0;32;0;0;282;59;59;2;0;1;0;3;282;1;294;2;2;3
/org.eclipse.jface.text/src/org/eclipse/jface/contentassist/ISubjectControlContextInformationValidator.java;1;2;3;1;3;2;3;0;12;0;0;280;20;20;2;0;1;0;3;336;1;336;2;1;0
/org.eclipse.compare/compare/org/eclipse/compare/IViewerCreator.java;1;0;1;1;0;0;0;1;2;0;1;219;2;2;1;0;0;1;1;219;0;219;1;1;0
/org.eclipse.core.resources.win32/src/org/eclipse/core/internal/resources/refresh/win32/Win32Natives.java;1;0;2;1;0;0;0;2;17;1;2;206;17;17;1;0;0;2;2;206;0;267;2;1;0
/org.eclipse.debug.ui/ui/org/eclipse/debug/internal/ui/actions/AbstractListenerActionDelegate.java;1;0;1;1;0;0;0;1;4;0;1;22;4;4;1;0;0;1;1;22;0;22;1;1;1
/org.eclipse.pde.core/src/org/eclipse/pde/internal/core/schema/SchemaObject.java;2;1;3;1;2;2;2;1;14;0;1;232;25;25;1;0;0;1;3;232;0;336;3;2;0
/org.eclipse.swt/Eclipse SWT Mozilla/common/org/eclipse/swt/internal/mozilla/nsISupportsWeakReference.java;1;0;1;1;0;0;0;1;0;0;1;100;0;0;1;0;0;1;1;100;0;100;1;1;0
/org.eclipse.jdt.ui/ui/org/eclipse/jdt/ui/actions/FindDeclarationsInHierarchyAction.java;2;0;3;1;1;1;1;2;14;1;2;184;21;21;1;0;0;2;3;184;0;336;3;2;0
/org.eclipse.jdt.ui/ui/org/eclipse/jdt/internal/ui/text/javadoc/JavaDocAutoIndentStrategy.java;5;3;15;3;4;2;4;11;174;4;6;40;271;271;4;5;2;11;15;96;7;336;8;5;0
/org.eclipse.jdt.core/compiler/org/eclipse/jdt/internal/compiler/problem/AbortCompilation.java;2;0;3;1;1;1;1;2;46;1;2;71;50;50;1;0;0;2;3;71;0;300;3;2;0
/org.eclipse.jdt.debug.ui/ui/org/eclipse/jdt/internal/debug/ui/display/JavaInspectExpression.java;2;0;3;2;0;0;0;3;83;0;1;97;83;83;3;2;0;3;3;97;2;97;1;2;0
/org.eclipse.ui.intro/src/org/eclipse/ui/internal/intro/impl/model/IntroURL.java;2;10;19;2;19;3;19;0;428;0;0;276;751;751;10;0;16;0;19;297;16;327;3;2;0
/org.eclipse.jface/src/org/eclipse/jface/preference/StringButtonFieldEditor.java;2;1;3;1;2;2;2;1;244;0;1;28;254;254;1;0;0;1;3;28;0;336;3;2;1
/org.eclipse.ant.ui/Ant Editor/org/eclipse/ant/internal/ui/dtd/AntDTDMessages.java;1;0;1;1;0;0;0;1;0;0;1;108;0;0;1;0;0;1;1;108;0;108;1;1;0
/org.eclipse.swt/Eclipse SWT PI/win32/org/eclipse/swt/internal/win32/MONITORINFO.java;2;0;2;1;0;0;0;2;4;1;2;1;4;4;1;0;0;2;2;1;0;166;2;2;0
/org.eclipse.ui.intro/src/org/eclipse/ui/internal/intro/impl/html/IIntroHTMLConstants.java;3;3;4;2;4;2;4;0;7;0;0;276;8;8;3;0;2;0;4;276;2;327;2;3;0
/org.eclipse.jdt.debug.ui/ui/org/eclipse/jdt/internal/debug/ui/classpath/ClasspathEntry.java;3;1;7;2;2;2;2;5;40;2;4;154;73;73;2;1;0;5;7;211;1;336;6;3;0
/org.eclipse.jdt.ui/ui/org/eclipse/jdt/internal/ui/text/AbstractInformationControl.java;3;2;18;2;3;2;3;15;515;4;5;35;1116;1116;4;10;1;15;18;35;11;336;7;3;0
/org.eclipse.pde.core/src/org/eclipse/pde/internal/core/ifeature/IFeatureInstallHandler.java;2;1;3;1;2;2;2;1;6;0;1;232;15;15;1;0;0;1;3;232;0;336;3;2;0
/org.eclipse.jdt.core/compiler/org/eclipse/jdt/internal/compiler/ast/ExtendedStringLiteral.java;2;0;3;1;0;0;0;3;5;1;3;63;11;11;1;0;0;3;3;63;0;199;3;2;0
/org.eclipse.debug.ui/ui/org/eclipse/debug/internal/ui/actions/ExecutionAction.java;1;0;1;1;0;0;0;1;1;0;1;107;1;1;1;0;0;1;1;107;0;107;1;1;0
/org.eclipse.ant.ui/Ant Runner Support/org/eclipse/ant/internal/ui/antsupport/logger/NullBuildLogger.java;1;0;3;1;1;1;1;2;4;1;2;108;8;8;1;0;0;2;3;108;0;336;3;1;0
/org.eclipse.jdt.debug.ui/ui/org/eclipse/jdt/internal/debug/ui/breakpoints/BreakpointMessages.java;2;0;2;2;0;0;0;2;11;0;1;175;11;11;2;1;0;2;2;175;1;175;1;2;0
/org.eclipse.jdt.ui/ui/org/eclipse/jdt/ui/actions/FindDeclarationsInProjectAction.java;3;2;12;2;4;3;4;8;20;3;5;99;72;72;3;3;1;8;12;184;4;336;8;3;0
/org.eclipse.jdt.ui/ui refactoring/org/eclipse/jdt/internal/ui/refactoring/reorg/RenamePackageWizard.java;2;1;3;1;2;2;2;1;8;0;1;71;17;17;1;0;0;1;3;71;0;336;3;2;0
/org.eclipse.swt/Eclipse SWT PI/win32/org/eclipse/swt/internal/ole/win32/FORMATETC.java;1;0;1;1;0;0;0;1;4;0;1;166;4;4;1;0;0;1;1;166;0;166;1;1;0
/org.eclipse.swt/Eclipse SWT/carbon/org/eclipse/swt/widgets/Canvas.java;4;1;6;2;2;2;2;4;21;2;3;93;49;49;2;1;0;4;6;93;1;337;5;4;0
/org.eclipse.osgi/eclipseAdaptor/src/org/eclipse/core/runtime/adaptor/EclipseBundleData.java;5;2;34;4;5;3;11;23;346;15;6;171;1005;1005;15;17;8;29;34;251;25;325;9;5;2
/org.eclipse.jdt.launching/launching/org/eclipse/jdt/internal/launching/StandardVMRunner.java;4;0;12;3;0;0;0;12;50;3;8;89;143;143;3;4;0;12;12;108;4;264;8;4;1
/org.eclipse.jdt.core/model/org/eclipse/jdt/core/util/ClassFormatException.java;2;0;6;1;0;0;0;6;10;1;6;10;20;20;1;0;0;6;6;10;0;264;6;2;0
/org.eclipse.jdt.ui/ui/org/eclipse/jdt/internal/ui/callhierarchy/SelectWorkingSetAction.java;2;1;3;1;2;2;2;1;11;0;1;224;13;13;1;0;0;1;3;224;0;336;3;2;0
/org.eclipse.jdt.core/compiler/org/eclipse/jdt/internal/compiler/codegen/CaseLabel.java;1;0;1;1;0;0;0;1;2;0;1;199;2;2;1;0;0;1;1;199;0;199;1;1;0
/org.eclipse.debug.core/core/org/eclipse/debug/core/model/IFilteredStep.java;2;0;2;1;1;1;1;1;4;0;1;202;5;5;1;0;0;1;2;202;0;336;2;2;0
/org.eclipse.help.ui/src/org/eclipse/help/ui/internal/HyperlinkAdapter.java;1;1;2;1;2;2;2;0;25;0;0;311;41;41;1;0;0;0;2;311;0;336;2;1;0
/org.eclipse.core.resources/src/org/eclipse/core/internal/watson/ElementSubtree.java;1;0;1;1;1;1;1;0;121;0;0;277;121;121;1;0;0;0;1;277;0;277;1;1;0
/org.eclipse.jdt.core/dom/org/eclipse/jdt/core/dom/CharacterLiteral.java;4;0;8;2;1;1;1;7;67;2;5;67;89;89;2;2;0;7;8;199;2;283;6;4;1
/org.eclipse.jdt.ui/ui/org/eclipse/jdt/internal/ui/util/CoreUtility.java;2;1;2;1;2;2;2;0;8;0;0;289;10;10;1;0;0;0;2;289;0;336;2;2;1
/org.eclipse.jdt.launching/launching/org/eclipse/jdt/internal/launching/StandardVMType.java;4;2;14;2;3;2;3;11;28;2;9;46;126;126;2;2;1;11;14;46;3;293;11;4;1
/org.eclipse.osgi/eclipseAdaptor/src/org/eclipse/osgi/framework/stats/StatsManager.java;4;3;9;2;6;3;6;3;107;2;2;171;171;171;3;1;3;3;9;294;4;336;5;4;0
/org.eclipse.swt/Eclipse SWT PI/photon/org/eclipse/swt/internal/photon/PtFileSelectionInfo_t.java;1;0;1;1;0;0;0;1;3;0;1;59;3;3;1;0;0;1;1;59;0;59;1;1;0
/org.eclipse.ui.cheatsheets/src/org/eclipse/ui/internal/cheatsheets/registry/CheatSheetCollectionElement.java;2;0;3;1;1;1;1;2;17;1;2;243;20;20;1;0;0;2;3;243;0;307;3;2;0
/org.eclipse.jdt.ui/ui/org/eclipse/jdt/internal/ui/text/comment/MultiCommentLine.java;3;0;10;1;1;1;1;9;354;4;5;97;535;535;4;4;0;9;10;119;4;336;6;3;0
/org.eclipse.jdt.core/model/org/eclipse/jdt/internal/core/util/CodeAttribute.java;3;0;3;1;0;0;0;3;4;1;3;70;9;9;1;0;0;3;3;70;0;199;3;3;0
/org.eclipse.jdt.debug.ui/ui/org/eclipse/jdt/internal/debug/ui/propertypages/JavaExceptionBreakpointPage.java;2;0;2;1;0;0;0;2;2;1;2;82;2;2;1;0;0;2;2;82;0;144;2;2;0
/org.eclipse.jdt.debug/jdi/org/eclipse/jdi/internal/connect/SocketRawLaunchingConnectorImpl.java;1;0;2;1;0;0;0;2;16;0;1;71;16;16;2;1;0;2;2;71;1;71;1;1;0
/org.eclipse.jdt.core/compiler/org/eclipse/jdt/internal/compiler/util/HashtableOfLong.java;2;0;2;1;0;0;0;2;2;1;2;199;4;4;1;0;0;2;2;199;0;227;2;2;0
/org.eclipse.core.runtime/src/org/eclipse/core/internal/runtime/CompatibilityHelper.java;3;2;7;2;4;3;4;3;64;2;2;179;156;156;2;1;1;3;7;179;2;298;5;3;1
/org.eclipse.jdt.debug.ui/ui/org/eclipse/jdt/internal/debug/ui/actions/BreakpointMethodLocator.java;1;0;1;1;0;0;0;1;0;0;1;104;0;0;1;0;0;1;1;104;0;104;1;1;0
/org.eclipse.jdt.ui/ui/org/eclipse/jdt/ui/JavaElementContentProvider.java;2;0;3;1;1;1;1;2;57;1;2;84;64;64;1;0;0;2;3;84;0;336;3;2;0
/org.eclipse.jdt.launching/launching/org/eclipse/jdt/internal/launching/StandardVMDebugger.java;5;2;13;3;3;2;3;10;39;2;6;83;124;124;2;4;1;10;13;83;5;299;8;5;1
/org.eclipse.core.resources/src/org/eclipse/core/internal/indexing/PageStore.java;2;1;4;1;2;2;2;2;321;1;2;13;328;328;1;0;0;2;4;13;0;295;4;2;0
/org.eclipse.jdt.ui/core refactoring/org/eclipse/jdt/internal/corext/refactoring/structure/IMemberActionInfo.java;1;0;1;1;1;1;1;0;2;0;0;336;2;2;1;0;0;0;1;336;0;336;1;1;0
/org.eclipse.compare/compare/org/eclipse/compare/BufferedContent.java;1;0;2;1;0;0;0;2;2;1;2;79;3;3;1;0;0;2;2;79;0;219;2;1;0
/org.eclipse.jdt.core/eval/org/eclipse/jdt/internal/eval/CodeSnippetThisReference.java;2;0;3;1;0;0;0;3;129;1;3;63;145;145;1;0;0;3;3;63;0;199;3;2;0
/org.eclipse.pde.ui/src/org/eclipse/pde/internal/ui/wizards/exports/PluginExportWizardPage.java;3;2;12;2;3;2;3;9;53;3;7;7;170;170;3;2;1;9;12;224;3;336;9;3;0
/org.eclipse.pde.core/src/org/eclipse/pde/internal/core/ExternalJavaSearchClasspathContainer.java;2;1;2;1;2;2;2;0;4;0;0;307;4;4;1;0;0;0;2;307;0;336;2;2;0
/org.eclipse.jdt.debug/model/org/eclipse/jdt/internal/debug/core/breakpoints/JavaExceptionBreakpoint.java;3;0;3;1;0;0;0;3;32;1;3;26;40;40;1;0;0;3;3;26;0;157;3;3;3
/org.eclipse.ui.workbench/Eclipse UI/org/eclipse/ui/internal/EditorPluginAction.java;5;1;4;2;2;2;2;2;14;1;2;3;32;32;1;0;0;2;4;3;0;336;4;5;0
/org.eclipse.core.runtime/src/org/eclipse/core/runtime/IAdaptable.java;2;1;5;2;2;2;2;3;180;0;1;171;184;184;3;2;0;3;5;171;2;336;3;2;0
/org.eclipse.jface.text/src/org/eclipse/jface/text/ITextListener.java;3;0;3;2;2;1;2;1;28;0;1;175;32;32;2;0;1;1;3;336;1;336;2;3;0
/org.eclipse.team.cvs.core/src/org/eclipse/team/internal/ccvs/core/client/listeners/LogListener.java;2;1;6;1;3;3;3;3;113;1;3;56;132;132;1;0;0;3;6;56;0;336;6;2;0
/org.eclipse.pde.core/src/org/eclipse/pde/core/build/IBuild.java;2;1;3;1;2;2;2;1;70;0;1;232;80;80;1;0;0;1;3;232;0;336;3;2;0
/org.eclipse.pde.ui/src/org/eclipse/pde/internal/ui/editor/build/SrcSection.java;2;3;10;2;6;4;6;4;265;3;2;104;454;454;3;2;2;4;10;104;4;336;6;2;0
/org.eclipse.jdt.ui/ui/org/eclipse/jdt/internal/ui/preferences/ImportOrganizeInputDialog.java;1;0;2;1;1;1;1;1;3;0;1;82;5;5;1;0;0;1;2;82;0;336;2;1;0
/org.eclipse.pde.ui/src/org/eclipse/pde/internal/ui/editor/schema/SchemaEditor.java;2;3;6;2;6;3;6;0;268;0;0;272;281;281;3;0;3;0;6;292;3;330;3;2;0
/org.eclipse.pde.ui/src/org/eclipse/pde/internal/ui/editor/plugin/ManifestEditor.java;3;9;13;3;13;2;13;0;364;0;0;292;395;395;9;0;11;0;13;292;11;326;2;3;0
/org.eclipse.core.resources/src/org/eclipse/core/internal/dtree/DataTreeLookup.java;1;0;1;1;1;1;1;0;75;0;0;277;75;75;1;0;0;0;1;277;0;277;1;1;0
/org.eclipse.jdt.ui/ui/org/eclipse/jdt/internal/ui/callhierarchy/SearchUtil.java;2;0;2;1;1;1;1;1;2;0;1;224;2;2;1;0;0;1;2;224;0;336;2;2;0
/org.eclipse.jdt.ui/ui refactoring/org/eclipse/jdt/internal/ui/refactoring/ExtractConstantWizard.java;3;0;6;1;1;1;2;4;198;2;4;36;217;217;2;0;1;5;6;269;1;336;5;3;0
/org.eclipse.jdt.core/model/org/eclipse/jdt/core/util/IAnnotationComponentValue.java;2;0;2;1;0;0;0;2;102;1;2;244;102;102;1;0;0;2;2;244;0;264;2;2;0
/org.eclipse.ui.workbench/Eclipse UI/org/eclipse/ui/internal/registry/WorkingSetRegistry.java;3;0;4;1;1;1;1;3;4;1;3;157;10;10;1;0;0;3;4;157;0;336;4;3;1
/org.eclipse.pde.core/src/org/eclipse/pde/internal/core/isite/ISiteBuildFeature.java;1;0;2;1;1;1;1;1;6;0;1;232;7;7;1;0;0;1;2;232;0;336;2;1;0
/org.eclipse.jdt.junit/src/org/eclipse/jdt/internal/junit/util/SWTUtil.java;2;0;2;1;1;1;1;1;8;0;1;263;10;10;1;0;0;1;2;263;0;336;2;2;0
/org.eclipse.ui.console/src/org/eclipse/ui/console/IConsoleConstants.java;2;0;2;2;0;0;0;2;10;0;1;118;10;10;2;1;0;2;2;118;1;118;1;2;0
/org.eclipse.pde.ui/src_Forms/org/eclipse/pde/internal/ui/model/plugin/PluginModel.java;2;1;4;1;2;2;2;2;14;1;2;244;28;28;1;0;0;2;4;244;0;336;4;2;0
/org.eclipse.pde.ui/src/org/eclipse/pde/internal/ui/build/BuildFeatureAction.java;2;4;9;2;8;3;8;1;60;0;1;213;111;111;4;0;5;1;9;308;5;336;4;2;0
/org.eclipse.debug.core/core/org/eclipse/debug/core/sourcelookup/containers/WorkspaceSourceContainer.java;1;0;2;1;0;0;1;1;20;0;1;268;20;20;2;0;1;2;2;268;1;268;1;1;0
/org.eclipse.jdt.core/search/org/eclipse/jdt/internal/core/search/indexing/SaveIndex.java;2;0;6;1;1;1;1;5;10;1;5;60;23;23;1;0;0;5;6;60;0;273;6;2;0
/org.eclipse.compare/compare/org/eclipse/compare/internal/ViewerSwitchingCancelled.java;1;1;2;1;2;2;2;0;4;0;0;319;6;6;1;0;0;0;2;319;0;337;2;1;0
/org.eclipse.ui.editors/src/org/eclipse/ui/texteditor/MarkerAnnotationPreferences.java;3;3;17;2;7;3;7;10;272;4;5;123;819;819;4;5;4;10;17;202;9;334;8;3;0
/org.eclipse.ui.workbench/Eclipse UI/org/eclipse/ui/internal/MultiEditorInnerPane.java;2;1;2;1;2;2;2;0;2;0;0;297;4;4;1;0;0;0;2;297;0;336;2;2;0
/org.eclipse.core.expressions/src/org/eclipse/core/internal/expressions/ExpressionStatus.java;1;0;3;1;0;0;0;3;8;2;2;227;13;13;2;1;0;3;3;227;1;267;2;1;0
/org.eclipse.swt/Eclipse SWT Program/motif/org/eclipse/swt/program/Program.java;4;1;11;2;3;3;3;8;1149;3;5;56;1248;1248;3;3;0;8;11;174;3;337;8;4;1
/org.eclipse.jdt.ui/ui/org/eclipse/jdt/internal/ui/text/correction/RenameNodeCompletionProposal.java;2;0;6;1;1;1;1;5;19;3;3;192;29;29;3;2;0;5;6;262;2;336;4;2;0
/org.eclipse.ui.ide/extensions/org/eclipse/ui/actions/CreateFileAction.java;1;0;2;1;0;0;0;2;2;1;2;132;2;2;1;0;0;2;2;132;0;150;2;1;0
/org.eclipse.ui.workbench/Eclipse UI/org/eclipse/ui/IWorkbenchWindow.java;3;1;9;2;2;2;2;7;301;2;5;51;350;350;2;2;0;7;9;157;2;336;7;3;0
/org.eclipse.ui.intro/src/org/eclipse/ui/internal/intro/impl/model/IntroHomePage.java;1;5;8;1;8;3;8;0;137;0;0;276;218;218;5;0;5;0;8;276;5;315;3;1;0
/org.eclipse.update.ui/src/org/eclipse/update/internal/ui/views/IPreviewTask.java;2;1;3;1;2;2;2;1;6;0;1;54;10;10;1;0;0;1;3;54;0;336;3;2;0
/org.eclipse.debug.ui/ui/org/eclipse/debug/internal/ui/views/memory/SetColumnSizeDefaultAction.java;1;0;1;1;1;1;1;0;0;0;0;282;0;0;1;0;0;0;1;282;0;282;1;1;0
/org.eclipse.jdt.ui/core refactoring/org/eclipse/jdt/internal/corext/refactoring/changes/DeleteSourceManipulationChange.java;3;0;8;2;2;1;2;6;68;3;4;31;180;180;3;2;1;6;8;245;3;332;5;3;1
/org.eclipse.help/src/org/eclipse/help/internal/context/IStyledContext.java;1;1;2;1;2;2;2;0;6;0;0;290;6;6;1;0;0;0;2;290;0;336;2;1;0
/org.eclipse.ant.core/src_ant/org/eclipse/ant/internal/core/ant/DemuxInputStreamSetter.java;1;0;1;1;0;0;0;1;0;0;1;208;0;0;1;0;0;1;1;208;0;208;1;1;0
/org.eclipse.ui.forms/src/org/eclipse/ui/forms/HyperlinkSettings.java;1;1;4;1;2;2;2;2;119;1;2;225;130;130;1;0;0;2;4;225;0;336;4;1;0
/org.eclipse.swt/Eclipse SWT PI/carbon/org/eclipse/swt/internal/carbon/MenuTrackingData.java;1;0;2;1;2;1;2;0;20;0;0;296;20;20;2;0;1;0;2;296;1;296;1;1;0
/org.eclipse.compare/compare/org/eclipse/compare/structuremergeviewer/IStructureComparator.java;1;0;1;1;0;0;0;1;2;0;1;219;2;2;1;0;0;1;1;219;0;219;1;1;0
/org.eclipse.jdt.ui/core extension/org/eclipse/jdt/internal/corext/dom/SelectionAnalyzer.java;3;1;4;1;2;2;2;2;14;1;2;116;23;23;1;0;0;2;4;116;0;336;4;3;0
/org.eclipse.ui.ide/src/org/eclipse/ui/internal/ide/dialogs/WizardNewProjectCapabilityPage.java;1;0;1;1;0;0;0;1;0;0;1;132;0;0;1;0;0;1;1;132;0;132;1;1;0
/org.eclipse.help.ide/src/org/eclipse/help/ui/internal/ide/HelpIdePlugin.java;1;2;8;1;4;3;4;4;40;2;3;106;132;132;2;1;1;4;8;106;2;336;6;1;0
/org.eclipse.ant.ui/Ant Editor/org/eclipse/ant/internal/ui/editor/outline/AntModel.java;1;0;59;1;19;1;22;37;2736;38;3;108;3180;3180;38;34;21;40;59;204;55;287;4;1;9
/org.eclipse.jdt.ui/ui/org/eclipse/jdt/internal/ui/javaeditor/BasicJavaEditorActionContributor.java;3;5;13;2;6;2;6;7;147;2;5;41;308;308;5;2;4;7;13;286;6;336;7;3;0
/org.eclipse.swt/Eclipse SWT/win32/org/eclipse/swt/widgets/Text.java;6;1;35;3;3;3;4;31;564;6;13;8;961;961;6;18;1;32;35;137;19;337;16;6;2
/org.eclipse.debug.ui/ui/org/eclipse/debug/internal/ui/views/console/ConsoleDocumentProvider.java;3;1;6;1;2;2;2;4;20;1;4;103;64;64;1;0;0;4;6;103;0;336;6;3;1
/org.eclipse.swt/Eclipse SWT/gtk/org/eclipse/swt/widgets/Sash.java;5;2;13;2;4;2;4;9;92;5;5;7;301;301;5;4;2;9;13;7;6;332;7;5;0
/org.eclipse.ui.intro/src/org/eclipse/ui/internal/intro/impl/model/loader/SharedConfigExtensionsManager.java;1;0;2;1;2;1;2;0;31;0;0;286;31;31;2;0;1;0;2;286;1;286;1;1;0
/org.eclipse.team.ui/src/org/eclipse/team/internal/ui/synchronize/WorkbenchAction.java;1;1;2;1;2;2;2;0;2;0;0;287;2;2;1;0;0;0;2;287;0;336;2;1;0
/org.eclipse.jdt.ui/ui refactoring/org/eclipse/jdt/internal/ui/refactoring/reorg/RenameInputWizardPage.java;3;1;8;2;2;2;2;6;148;3;4;71;292;292;3;2;0;6;8;247;2;336;6;3;0
/org.eclipse.pde.ui/src/org/eclipse/pde/internal/ui/build/BuildSiteAction.java;1;1;5;1;3;3;3;2;40;1;2;213;62;62;1;0;0;2;5;213;0;336;5;1;0
/org.eclipse.pde.ui/src/org/eclipse/pde/internal/ui/wizards/exports/PluginExportJob.java;2;3;7;2;6;4;6;1;183;0;1;149;222;222;3;0;2;1;7;304;2;336;5;2;0
/org.eclipse.ui.workbench/Eclipse UI/org/eclipse/ui/internal/ShowViewMenu.java;7;1;11;2;3;3;3;8;61;3;6;116;152;152;3;2;0;8;11;166;2;336;9;7;2
/org.eclipse.team.ui/src/org/eclipse/team/ui/synchronize/ParticipantPageSaveablePart.java;2;5;9;2;9;4;9;0;586;0;0;280;617;617;5;0;5;0;9;288;5;335;4;2;0
/org.eclipse.jdt.core/codeassist/org/eclipse/jdt/internal/codeassist/complete/CompletionOnQualifiedExceptionReference.java;2;0;2;1;0;0;0;2;13;1;2;63;15;15;1;0;0;2;2;63;0;199;2;2;0
/org.eclipse.text/src/org/eclipse/jface/text/IDocumentListener.java;2;0;2;2;2;1;2;0;4;0;0;334;4;4;2;0;1;0;2;334;1;334;1;2;0
/org.eclipse.jdt.core/dom/org/eclipse/jdt/core/dom/ParameterizedType.java;4;3;14;2;4;2;4;10;265;5;4;163;457;457;5;6;2;10;14;258;8;336;6;4;2
/org.eclipse.jdt.launching/launching/org/eclipse/jdt/internal/launching/DefaultProjectClasspathEntry.java;3;2;8;2;4;3;4;4;46;2;3;211;115;115;2;1;1;4;8;225;2;313;6;3;1
/org.eclipse.jdt.core/model/org/eclipse/jdt/internal/core/MemberElementInfo.java;2;0;2;1;1;1;1;1;2;0;1;199;4;4;1;0;0;1;2;199;0;314;2;2;1
/org.eclipse.jdt.core/dom/org/eclipse/jdt/core/dom/CastExpression.java;3;0;8;1;2;1;2;6;110;2;5;199;158;158;2;1;1;6;8;266;2;276;6;3;1
/org.eclipse.compare/compare/org/eclipse/compare/NavigationAction.java;1;0;3;1;1;1;1;2;31;1;2;104;35;35;1;0;0;2;3;104;0;280;3;1;0
/org.eclipse.ant.ui/Ant Editor/org/eclipse/ant/internal/ui/editor/model/IAntModelConstants.java;1;0;1;1;0;0;0;1;0;0;1;233;0;0;1;0;0;1;1;233;0;233;1;1;1
/org.eclipse.ui.ide/src/org/eclipse/ui/internal/ide/AboutInfo.java;1;1;2;1;2;2;2;0;2;0;0;324;2;2;1;0;0;0;2;324;0;336;2;1;0
/org.eclipse.team.cvs.core/src/org/eclipse/team/internal/ccvs/core/resources/RemoteFolderTreeBuilder.java;2;1;9;1;3;3;3;6;172;2;5;25;253;253;2;1;0;6;9;118;1;336;8;2;2
/org.eclipse.jdt.launching/launching/org/eclipse/jdt/internal/launching/JavaSourceLookupUtil.java;1;1;3;1;3;3;3;0;42;0;0;275;44;44;1;0;0;0;3;275;0;313;3;1;0
/org.eclipse.swt/Eclipse SWT Drag and Drop/gtk/org/eclipse/swt/dnd/TransferData.java;2;1;3;1;2;2;2;1;10;0;1;228;18;18;1;0;0;1;3;228;0;337;3;2;1
/org.eclipse.debug.ui/ui/org/eclipse/debug/internal/ui/views/memory/IFixedLengthOutputRenderer.java;1;0;1;1;1;1;1;0;0;0;0;282;0;0;1;0;0;0;1;282;0;282;1;1;0
/org.eclipse.jdt.core/model/org/eclipse/jdt/internal/core/SearchableEnvironmentRequestor.java;2;0;2;1;0;0;0;2;5;1;2;113;7;7;1;0;0;2;2;113;0;199;2;2;0
/org.eclipse.swt.tools/JNI Generation/org/eclipse/swt/tools/internal/MethodData.java;1;0;1;1;0;0;0;1;0;0;1;230;0;0;1;0;0;1;1;230;0;230;1;1;0
/org.eclipse.swt/Eclipse SWT PI/win32/org/eclipse/swt/internal/win32/SCRIPT_PROPERTIES.java;2;0;2;1;1;1;1;1;4;0;1;260;4;4;1;0;0;1;2;260;0;337;2;2;0
/org.eclipse.team.ui/src/org/eclipse/team/internal/ui/wizards/ImportProjectSetMainPage.java;1;1;4;1;2;2;2;2;214;1;2;63;219;219;1;0;0;2;4;63;0;336;4;1;0
/org.eclipse.ui.workbench/Eclipse UI/org/eclipse/ui/part/EditorActionBarContributor.java;2;0;2;2;0;0;0;2;31;0;1;181;31;31;2;1;0;2;2;181;1;181;1;2;0
/org.eclipse.help.ui/src/org/eclipse/help/ui/internal/browser/embedded/EmbeddedBrowser.java;1;8;15;1;11;2;11;4;475;0;1;245;707;707;8;3;9;4;15;276;12;311;3;1;0
/org.eclipse.jdt.ui/core refactoring/org/eclipse/jdt/internal/corext/refactoring/code/ExtractTempRefactoring.java;6;9;40;3;14;3;14;26;168;5;13;4;715;715;9;13;11;26;40;278;24;336;16;6;0
/org.eclipse.team.core/src/org/eclipse/team/internal/core/InfiniteSubProgressMonitor.java;1;0;1;1;0;0;0;1;12;0;1;110;12;12;1;0;0;1;1;110;0;110;1;1;0
/org.eclipse.core.runtime.compatibility/src-model/org/eclipse/core/runtime/model/PluginFragmentModel.java;3;1;5;1;3;3;3;2;18;1;2;171;27;27;1;0;0;2;5;171;0;336;5;3;0
/org.eclipse.update.ui/src/org/eclipse/update/internal/ui/model/MissingFeature.java;1;0;1;1;0;0;0;1;8;0;1;58;8;8;1;0;0;1;1;58;0;58;1;1;0
/org.eclipse.team.cvs.ui/src/org/eclipse/team/internal/ccvs/ui/wizards/GenerateDiffFileWizard.java;2;0;2;1;0;0;0;2;38;1;2;57;42;42;1;0;0;2;2;57;0;157;2;2;3
/org.eclipse.update.ui/src/org/eclipse/update/internal/ui/model/IConfiguredFeatureAdapter.java;1;0;1;1;0;0;0;1;2;0;1;48;2;2;1;0;0;1;1;48;0;48;1;1;0
/org.eclipse.jdt.core/compiler/org/eclipse/jdt/internal/compiler/ast/OR_OR_Expression.java;2;0;5;1;0;0;0;5;342;2;3;47;359;359;2;2;0;5;5;47;2;199;3;2;0
/org.eclipse.jdt.core/compiler/org/eclipse/jdt/internal/compiler/ast/NumberLiteral.java;2;0;2;1;0;0;0;2;34;1;2;63;36;36;1;0;0;2;2;63;0;199;2;2;0
/org.eclipse.team.core/src/org/eclipse/team/core/synchronize/SyncInfoFilter.java;2;0;5;2;1;1;1;4;73;2;3;224;100;100;2;1;0;4;5;232;1;336;4;2;0
/org.eclipse.ui.workbench/Eclipse UI/org/eclipse/ui/internal/commands/CommandManagerFactory.java;3;1;3;1;2;2;2;1;4;0;1;267;5;5;1;0;0;1;3;267;0;336;3;3;0
/org.eclipse.help/src/org/eclipse/help/internal/toc/Anchor.java;1;1;5;1;3;3;3;2;20;1;2;43;47;47;1;0;0;2;5;43;0;336;5;1;0
/org.eclipse.jdt.ui/ui/org/eclipse/jdt/internal/ui/javaeditor/ClassFileEditorActionContributor.java;1;0;1;1;1;1;1;0;2;0;0;336;2;2;1;0;0;0;1;336;0;336;1;1;0
/org.eclipse.jdt.debug.ui/ui/org/eclipse/jdt/internal/debug/ui/propertypages/ExceptionFilterEditor.java;3;2;7;2;3;2;3;4;13;3;2;82;23;23;3;2;1;4;7;82;3;313;4;3;3
/org.eclipse.ui.cheatsheets/src/org/eclipse/ui/internal/cheatsheets/views/SubItemCompositeHolder.java;2;0;4;2;1;1;1;3;34;2;2;243;58;58;2;1;0;3;4;253;1;299;3;2;0
/org.eclipse.debug.ui/ui/org/eclipse/debug/internal/ui/actions/RetargetRunToLineAction.java;1;0;2;1;0;0;0;2;4;0;1;245;4;4;2;1;0;2;2;245;1;245;1;1;0
/org.eclipse.jdt.ui/ui/org/eclipse/jdt/internal/ui/search/NewSearchResultCollector.java;2;0;9;2;2;1;5;4;77;4;3;196;171;171;4;1;4;7;9;269;5;290;4;2;0
/org.eclipse.help.webapp/src_servlets/org/eclipse/help/internal/webapp/data/TocData.java;1;2;18;1;6;4;6;12;213;2;10;11;683;683;2;2;2;12;18;41;4;332;14;1;1
/org.eclipse.ui.workbench/Eclipse UI/org/eclipse/ui/internal/dialogs/NewWizard.java;5;0;11;2;1;1;1;10;169;3;6;116;280;280;3;4;0;10;11;174;4;336;7;5;1
/org.eclipse.jdt.core/compiler/org/eclipse/jdt/internal/compiler/lookup/FieldBinding.java;3;0;6;2;1;1;1;5;11;2;3;1;19;19;2;2;0;5;6;1;2;275;4;3;1
/org.eclipse.swt/Eclipse SWT Accessibility/common/org/eclipse/swt/accessibility/AccessibleTextListener.java;1;0;1;1;0;0;0;1;0;0;1;131;0;0;1;0;0;1;1;131;0;131;1;1;0
/org.eclipse.jdt.core/dom/org/eclipse/jdt/internal/core/dom/rewrite/ListRewriteEvent.java;3;1;3;1;2;2;2;1;62;0;1;262;66;66;1;0;0;1;3;262;0;336;3;3;0
/org.eclipse.ui.workbench/Eclipse UI/org/eclipse/ui/activities/ActivityManagerEvent.java;4;1;11;2;3;3;3;8;148;6;2;160;263;263;6;6;0;8;11;160;6;336;5;4;0
/org.eclipse.jdt.ui/ui/org/eclipse/jdt/internal/ui/javaeditor/TogglePresentationAction.java;1;0;2;1;1;1;1;1;10;0;1;93;12;12;1;0;0;1;2;93;0;336;2;1;0
/org.eclipse.ui.workbench/Eclipse UI/org/eclipse/ui/internal/commands/Command.java;4;2;36;2;6;4;6;30;1494;13;10;37;3231;3231;13;20;2;30;36;61;22;336;14;4;0
/org.eclipse.team.ui/src/org/eclipse/team/ui/TeamUI.java;2;1;9;2;2;2;2;7;46;2;5;59;93;93;2;2;0;7;9;59;2;336;7;2;0
/org.eclipse.jdt.core/model/org/eclipse/jdt/internal/core/builder/ImageBuilderInternalException.java;2;0;2;1;1;1;1;1;12;0;1;199;14;14;1;0;0;1;2;199;0;287;2;2;0
/org.eclipse.jdt.core/model/org/eclipse/jdt/internal/core/UserLibraryClasspathContainerInitializer.java;1;0;2;1;2;1;2;0;9;0;0;280;9;9;2;0;1;0;2;280;1;280;1;1;0
/org.eclipse.jdt.core/compiler/org/eclipse/jdt/internal/compiler/ast/FalseLiteral.java;2;0;2;1;0;0;0;2;4;1;2;170;6;6;1;0;0;2;2;170;0;199;2;2;0
/org.eclipse.pde.core/src/org/eclipse/pde/internal/core/isite/ISiteFeature.java;2;1;4;1;2;2;2;2;19;1;2;134;43;43;1;0;0;2;4;134;0;336;4;2;0
/org.eclipse.jface/src/org/eclipse/jface/action/IContributionItem.java;3;0;3;2;0;0;0;3;26;2;2;13;33;33;2;1;0;3;3;181;1;181;2;3;0
/org.eclipse.debug.ui/ui/org/eclipse/debug/internal/ui/actions/ReevaluateWatchExpressionAction.java;1;0;3;1;0;0;0;3;20;2;2;92;24;24;2;1;0;3;3;92;1;110;2;1;0
/org.eclipse.swt/Eclipse SWT/win32/org/eclipse/swt/widgets/MessageBox.java;4;1;8;1;2;2;2;6;20;2;5;16;69;69;2;1;0;6;8;16;1;337;7;4;0
/org.eclipse.jdt.launching/launching/org/eclipse/jdt/launching/sourcelookup/JavaSourceLocator.java;4;1;7;1;4;4;4;3;32;1;3;141;95;95;1;0;0;3;7;141;0;336;7;4;1
/org.eclipse.help.ide/src/org/eclipse/help/ui/internal/workingset/HelpWorkingSetElementLabelProvider.java;1;1;3;1;2;2;2;1;47;0;1;104;87;87;1;0;0;1;3;104;0;336;3;1;0
/org.eclipse.jdt.ui/ui/org/eclipse/jdt/internal/ui/search/GotoMarkerAction.java;3;1;4;1;3;3;3;1;32;0;1;157;42;42;1;0;0;1;4;157;0;336;4;3;0
/org.eclipse.osgi/osgi/src/org/osgi/framework/ServiceEvent.java;2;0;2;1;1;1;1;1;3;0;1;171;3;3;1;0;0;1;2;171;0;296;2;2;0
/org.eclipse.debug.ui/ui/org/eclipse/debug/internal/ui/views/memory/CopyViewTabToClipboardContextAction.java;1;0;1;1;1;1;1;0;0;0;0;282;0;0;1;0;0;0;1;282;0;282;1;1;0
/org.eclipse.jdt.ui/ui refactoring/org/eclipse/jdt/internal/ui/refactoring/nls/search/NLSSearchResultLabelProvider.java;3;1;3;1;2;2;2;1;3;0;1;269;6;6;1;0;0;1;3;269;0;336;3;3;0
/org.eclipse.debug.ui/ui/org/eclipse/debug/internal/ui/views/memory/ViewTabCursorManager.java;2;4;5;2;5;2;5;0;16;0;0;282;21;21;4;0;3;0;5;282;3;326;2;2;4
/org.eclipse.jdt.core/dom/org/eclipse/jdt/core/dom/MemberValuePair.java;2;0;11;1;3;1;3;8;279;4;4;225;337;337;4;4;2;8;11;225;6;276;5;2;2
/org.eclipse.jdt.core/compiler/org/eclipse/jdt/internal/compiler/codegen/FloatCache.java;1;0;1;1;0;0;0;1;2;0;1;199;2;2;1;0;0;1;1;199;0;199;1;1;0
/org.eclipse.swt/Eclipse SWT Custom Widgets/common/org/eclipse/swt/custom/StyleRange.java;2;0;3;1;1;1;1;2;4;1;2;253;8;8;1;0;0;2;3;253;0;337;3;2;0
/org.eclipse.team.cvs.core/src/org/eclipse/team/internal/ccvs/core/ICVSRepositoryLocation.java;2;1;5;1;2;2;2;3;23;1;3;176;56;56;1;0;0;3;5;176;0;336;5;2;0
/org.eclipse.swt/Eclipse SWT/carbon/org/eclipse/swt/widgets/MessageBox.java;4;1;5;1;3;3;3;2;38;1;2;28;71;71;1;0;0;2;5;28;0;337;5;4;0
/org.eclipse.swt/Eclipse SWT/carbon/org/eclipse/swt/graphics/Color.java;1;1;2;1;2;2;2;0;4;0;0;300;8;8;1;0;0;0;2;300;0;337;2;1;1
/org.eclipse.jdt.ui/ui/org/eclipse/jdt/internal/ui/compare/JavaParseTreeBuilder.java;2;0;2;1;1;1;1;1;5;0;1;14;7;7;1;0;0;1;2;14;0;336;2;2;1
/org.eclipse.ui.cheatsheets/src/org/eclipse/ui/internal/cheatsheets/actions/CheatSheetMenuAction.java;1;1;2;1;2;2;2;0;77;0;0;275;77;77;1;0;0;0;2;275;0;306;2;1;0
/org.eclipse.swt/Eclipse SWT/carbon/org/eclipse/swt/graphics/FontData.java;3;1;5;1;3;3;3;2;42;1;2;13;58;58;1;0;0;2;5;13;0;337;5;3;1
/org.eclipse.jdt.ui/core refactoring/org/eclipse/jdt/internal/corext/refactoring/nls/SimpleLineReader.java;3;1;3;1;2;2;2;1;87;0;1;267;89;89;1;0;0;1;3;267;0;336;3;3;0
/org.eclipse.core.resources/src/org/eclipse/core/resources/IPathVariableChangeEvent.java;1;0;1;1;1;1;1;0;4;0;0;277;4;4;1;0;0;0;1;277;0;277;1;1;0
/org.eclipse.jdt.ui/ui/org/eclipse/jdt/internal/ui/text/template/contentassist/TemplateContentAssistMessages.java;2;1;2;1;2;2;2;0;2;0;0;283;2;2;1;0;0;0;2;283;0;336;2;2;0
/org.eclipse.compare/compare/org/eclipse/compare/rangedifferencer/RangeDifference.java;1;0;1;1;0;0;0;1;2;0;1;219;2;2;1;0;0;1;1;219;0;219;1;1;0
/org.eclipse.ui.workbench/Eclipse UI/org/eclipse/ui/internal/progress/PendingUpdateAdapter.java;4;0;7;1;1;1;1;6;29;2;4;73;38;38;2;2;0;6;7;73;2;336;5;4;0
/org.eclipse.debug.ui/ui/org/eclipse/debug/internal/ui/actions/DisableWatchExpressionAction.java;1;0;1;1;0;0;0;1;0;0;1;92;0;0;1;0;0;1;1;92;0;92;1;1;0
/org.eclipse.compare/compare/org/eclipse/compare/structuremergeviewer/ICompareInputChangeListener.java;1;0;1;1;0;0;0;1;2;0;1;219;2;2;1;0;0;1;1;219;0;219;1;1;0
/org.eclipse.team.ui/src/org/eclipse/team/internal/ui/registry/SynchronizeParticipantRegistry.java;1;1;4;1;2;2;2;2;54;0;1;144;57;57;2;1;0;2;4;144;1;336;3;1;0
/org.eclipse.jdt.ui/ui/org/eclipse/jdt/internal/ui/text/java/hover/JavaTypeHover.java;1;1;3;1;2;2;2;1;10;0;1;103;20;20;1;0;0;1;3;103;0;336;3;1;0
/org.eclipse.pde.core/src/org/eclipse/pde/core/IModelChangedEvent.java;2;2;5;1;4;3;4;1;114;0;1;264;127;127;2;0;1;1;5;276;1;336;4;2;0
/org.eclipse.jdt.ui/ui/org/eclipse/jdt/internal/ui/text/JavaWordIterator.java;2;1;2;1;2;2;2;0;8;0;0;323;8;8;1;0;0;0;2;323;0;336;2;2;0
/org.eclipse.ui.workbench/Eclipse UI/org/eclipse/ui/IPathEditorInput.java;2;0;2;1;0;0;0;2;41;1;2;99;41;41;1;0;0;2;2;99;0;157;2;2;0
/org.eclipse.jdt.ui/core refactoring/org/eclipse/jdt/internal/corext/refactoring/reorg/OverwriteHelper.java;3;1;6;1;2;2;2;4;44;2;2;70;69;69;2;2;0;4;6;70;2;336;4;3;0
/org.eclipse.text/src/org/eclipse/jface/text/source/IAnnotationMap.java;2;2;3;2;3;2;3;0;22;0;0;289;22;22;2;0;1;0;3;334;1;334;2;2;0
/org.eclipse.jdt.debug/model/org/eclipse/jdt/internal/debug/core/model/JDIValue.java;2;0;3;1;0;0;0;3;6;1;3;78;11;11;1;0;0;3;3;78;0;148;3;2;1
/org.eclipse.ui.ide/src/org/eclipse/ui/views/markers/internal/FieldFolder.java;4;1;4;2;2;2;2;2;37;1;2;129;75;75;1;0;0;2;4;129;0;336;4;4;0
/org.eclipse.swt/Eclipse SWT PI/win32/org/eclipse/swt/internal/ole/win32/DISPPARAMS.java;1;0;1;1;0;0;0;1;7;0;1;166;7;7;1;0;0;1;1;166;0;166;1;1;0
/org.eclipse.jdt.ui/ui/org/eclipse/jdt/ui/actions/FindReferencesAction.java;3;1;5;1;2;2;2;3;8;1;3;41;20;20;1;0;0;3;5;41;0;336;5;3;0
/org.eclipse.jdt.core/model/org/eclipse/jdt/core/util/IAnnotationComponent.java;2;0;2;1;0;0;0;2;42;1;2;244;42;42;1;0;0;2;2;244;0;264;2;2;0
/org.eclipse.ui.workbench/Eclipse UI/org/eclipse/ui/internal/commands/KeySequenceBindingMachine.java;4;1;15;2;2;2;2;13;492;6;4;148;606;606;6;9;0;13;15;148;9;336;6;4;0
/org.eclipse.ui.workbench/Eclipse UI/org/eclipse/ui/internal/decorators/FullImageDecoratorRunnable.java;1;0;1;1;0;0;0;1;0;0;1;233;0;0;1;0;0;1;1;233;0;233;1;1;0
/org.eclipse.ui.ide/extensions/org/eclipse/ui/dialogs/WizardResourceImportPage.java;3;1;3;1;2;2;2;1;3;0;1;132;5;5;1;0;0;1;3;132;0;336;3;3;0
/org.eclipse.jdt.ui/ui refactoring/org/eclipse/jdt/internal/ui/refactoring/actions/ListDialog.java;1;0;1;1;1;1;1;0;2;0;0;336;2;2;1;0;0;0;1;336;0;336;1;1;0
/org.eclipse.ui.ide/src/org/eclipse/ui/wizards/datatransfer/FileSystemImportWizard.java;2;0;3;1;0;0;0;3;17;2;2;92;17;17;2;1;0;3;3;132;1;132;2;2;0
/org.eclipse.help.base/src/org/eclipse/help/internal/search/WordTokenStream.java;1;1;4;1;2;2;2;2;16;1;2;104;24;24;1;0;0;2;4;104;0;336;4;1;0
/org.eclipse.jface.text/projection/org/eclipse/jface/text/source/projection/ProjectionSupport.java;3;2;15;2;4;3;11;4;282;10;2;247;377;377;10;2;8;11;15;265;10;336;5;3;0
/org.eclipse.jface/src/org/eclipse/jface/action/SubMenuManager.java;4;0;4;1;1;1;1;3;167;1;3;181;225;225;1;0;0;3;4;181;0;336;4;4;1
/org.eclipse.debug.ui/ui/org/eclipse/debug/internal/ui/sourcelookup/EditContainerAction.java;2;0;2;2;0;0;0;2;10;0;1;269;10;10;2;1;0;2;2;269;1;269;1;2;0
/org.eclipse.core.resources/src/org/eclipse/core/internal/dtree/DataTreeWriter.java;1;0;1;1;1;1;1;0;273;0;0;277;273;273;1;0;0;0;1;277;0;277;1;1;0
/org.eclipse.core.resources/src/org/eclipse/core/internal/dtree/TestHelper.java;1;0;1;1;1;1;1;0;16;0;0;277;16;16;1;0;0;0;1;277;0;277;1;1;0
/org.eclipse.ui.externaltools/External Tools Base/org/eclipse/ui/externaltools/internal/launchConfigurations/IgnoreWhiteSpaceComparator.java;1;0;1;1;0;0;0;1;0;0;1;130;0;0;1;0;0;1;1;130;0;130;1;1;0
/org.eclipse.jdt.core/compiler/org/eclipse/jdt/internal/compiler/problem/DefaultProblemFactory.java;3;0;8;1;1;1;1;7;76;1;7;1;110;110;1;0;0;7;8;1;0;286;8;3;0
/org.eclipse.text/src/org/eclipse/jface/text/templates/DocumentTemplateContext.java;3;2;7;2;4;2;4;3;41;2;2;234;56;56;2;1;2;3;7;234;3;334;4;3;0
/org.eclipse.ui.ide/src/org/eclipse/ui/internal/ide/update/InstallWizardAction.java;1;0;1;1;1;1;1;0;12;0;0;309;12;12;1;0;0;0;1;309;0;309;1;1;0
/org.eclipse.swt/Eclipse SWT/emulated/treetable/org/eclipse/swt/widgets/SelectableItem.java;4;0;4;1;1;1;1;3;17;1;3;19;29;29;1;0;0;3;4;19;0;337;4;4;0
/org.eclipse.ant.ui/Ant Tools Support/org/eclipse/ant/internal/ui/launchConfigurations/RemoteAntBuildListener.java;3;0;7;2;0;0;0;7;65;3;4;108;102;102;3;3;0;7;7;108;3;183;4;3;1
/org.eclipse.team.cvs.ssh2/src/org/eclipse/team/internal/ccvs/ssh2/PServerSSH2Method.java;1;0;1;1;0;0;0;1;0;0;1;263;0;0;1;0;0;1;1;263;0;263;1;1;0
/org.eclipse.ui.workbench/Eclipse UI/org/eclipse/ui/internal/progress/IAnimationProcessor.java;2;0;2;1;1;1;1;1;6;0;1;243;6;6;1;0;0;1;2;243;0;326;2;2;0
/org.eclipse.swt/Eclipse SWT/photon/org/eclipse/swt/graphics/Cursor.java;2;1;3;1;2;2;2;1;93;0;1;18;126;126;1;0;0;1;3;18;0;337;3;2;1
/org.eclipse.swt/Eclipse SWT PI/carbon/org/eclipse/swt/internal/carbon/Cursor.java;1;0;2;1;2;1;2;0;20;0;0;296;20;20;2;0;1;0;2;296;1;296;1;1;0
/org.eclipse.compare/compare/org/eclipse/compare/structuremergeviewer/Differencer.java;1;0;2;1;0;0;0;2;4;1;2;79;6;6;1;0;0;2;2;79;0;219;2;1;0
/org.eclipse.ui.workbench/Eclipse UI/org/eclipse/ui/internal/activities/Identifier.java;2;0;2;1;0;0;0;2;41;1;2;170;42;42;1;0;0;2;2;170;0;179;2;2;0
/org.eclipse.pde.ui/src/org/eclipse/pde/internal/ui/wizards/extension/NewExtensionWizard.java;3;1;6;1;4;4;4;2;42;0;1;252;91;91;2;1;0;2;6;252;1;336;5;3;0
/org.eclipse.ui.forms/src/org/eclipse/ui/internal/forms/widgets/WrappedPageBook.java;1;0;1;1;1;1;1;0;0;0;0;272;0;0;1;0;0;0;1;272;0;272;1;1;0
/org.eclipse.ui.editors/src/org/eclipse/ui/editors/text/IFoldingCommandIds.java;2;2;3;1;3;2;3;0;16;0;0;288;16;16;2;0;1;0;3;334;1;334;2;2;0
/org.eclipse.debug.core/core/org/eclipse/debug/internal/core/sourcelookup/SourceLookupUtils.java;1;0;4;1;0;0;0;4;158;2;3;205;307;307;2;1;0;4;4;226;1;268;3;1;0
/org.eclipse.debug.ui/ui/org/eclipse/debug/internal/ui/DefaultLabelProvider.java;3;0;15;3;2;1;2;13;52;3;7;33;188;188;3;6;1;13;15;148;7;307;8;3;0
/org.eclipse.jdt.debug.ui/ui/org/eclipse/jdt/internal/debug/ui/NoLineNumberAttributesStatusHandler.java;4;0;4;2;1;1;1;3;28;2;2;144;35;35;2;1;0;3;4;262;1;336;3;4;0
/org.eclipse.jdt.ui/ui/org/eclipse/jdt/internal/ui/JavaUIMessages.java;1;0;1;1;1;1;1;0;2;0;0;336;2;2;1;0;0;0;1;336;0;336;1;1;0
/org.eclipse.jdt.ui/ui/org/eclipse/jdt/internal/ui/IResourceLocator.java;1;0;1;1;1;1;1;0;2;0;0;336;2;2;1;0;0;0;1;336;0;336;1;1;0
/org.eclipse.help/src/org/eclipse/help/ILiveHelpAction.java;1;1;3;1;2;2;2;1;17;0;1;156;25;25;1;0;0;1;3;156;0;336;3;1;0
/org.eclipse.debug.ui/ui/org/eclipse/debug/internal/ui/views/memory/HexRendering.java;1;0;1;1;1;1;1;0;0;0;0;282;0;0;1;0;0;0;1;282;0;282;1;1;0
/org.eclipse.swt/Eclipse SWT PI/gtk/org/eclipse/swt/internal/accessibility/gtk/GObjectClass.java;4;0;4;1;1;1;1;3;17;1;3;75;33;33;1;0;0;3;4;75;0;337;4;4;0
/org.eclipse.update.core/src/org/eclipse/update/internal/model/BundleManifest.java;2;1;6;1;2;2;2;4;22;3;2;227;43;43;3;2;0;4;6;227;2;309;4;2;0
/org.eclipse.jdt.ui/ui/org/eclipse/jdt/internal/ui/typehierarchy/SuperTypeHierarchyViewer.java;2;0;3;1;1;1;1;2;10;1;2;35;14;14;1;0;0;2;3;35;0;336;3;2;0
/org.eclipse.jdt.core/eval/org/eclipse/jdt/internal/eval/CodeSnippetSkeleton.java;4;0;4;1;1;1;1;3;4;1;3;5;11;11;1;0;0;3;4;5;0;314;4;4;0
/org.eclipse.pde.ui/src/org/eclipse/pde/internal/ui/wizards/plugin/ContentPage.java;3;3;9;2;7;4;7;2;461;1;2;222;611;611;3;0;3;2;9;325;3;336;6;3;0
/org.eclipse.swt/Eclipse SWT/photon/org/eclipse/swt/widgets/Button.java;3;1;8;1;2;2;2;6;90;2;5;19;112;112;2;1;0;6;8;153;1;337;7;3;0
/org.eclipse.swt/Eclipse SWT Browser/common/org/eclipse/swt/browser/VisibilityWindowAdapter.java;2;0;4;1;1;1;1;3;31;1;3;179;54;54;1;0;0;3;4;179;0;337;4;2;0
/org.eclipse.jdt.ui/ui/org/eclipse/jdt/internal/ui/callhierarchy/ICallHierarchyViewPart.java;2;0;2;1;1;1;1;1;2;0;1;18;2;2;1;0;0;1;2;18;0;336;2;2;0
/org.eclipse.swt/Eclipse SWT PI/win32/org/eclipse/swt/internal/win32/NMRGINFO.java;2;0;2;1;0;0;0;2;2;1;2;147;2;2;1;0;0;2;2;147;0;166;2;2;0
/org.eclipse.jdt.ui/ui/org/eclipse/jdt/internal/ui/javadocexport/JavadocTreeWizardPage.java;1;1;10;1;2;2;2;8;166;2;6;45;503;503;2;2;0;8;10;59;2;326;8;1;0
/org.eclipse.swt/Eclipse SWT Drag and Drop/photon/org/eclipse/swt/dnd/TransferData.java;1;1;2;1;2;2;2;0;8;0;0;300;12;12;1;0;0;0;2;300;0;337;2;1;1
/org.eclipse.team.cvs.ui/src/org/eclipse/team/internal/ccvs/ui/actions/OpenRemoteFileAction.java;2;1;2;1;2;2;2;0;14;0;0;303;16;16;1;0;0;0;2;303;0;336;2;2;0
/org.eclipse.compare/compare/org/eclipse/compare/CompareUI.java;1;0;4;1;2;1;2;2;42;1;2;104;61;61;2;0;1;2;4;279;1;279;3;1;0
/org.eclipse.core.resources/src/org/eclipse/core/resources/IEncodedStorage.java;2;0;6;2;0;0;3;3;27;4;3;220;36;36;4;0;3;6;6;270;3;270;3;2;0
/org.eclipse.search/search/org/eclipse/search/internal/ui/util/PixelConverter.java;1;0;2;1;1;1;1;1;2;0;1;116;2;2;1;0;0;1;2;116;0;336;2;1;0
/org.eclipse.jdt.ui/core extension/org/eclipse/jdt/internal/corext/callhierarchy/CallHierarchyVisitor.java;2;0;2;1;1;1;1;1;2;0;1;21;2;2;1;0;0;1;2;21;0;336;2;2;0
/org.eclipse.pde.ui/src/org/eclipse/pde/internal/ui/search/DependencyExtentAction.java;2;1;4;1;2;2;2;2;15;1;2;168;32;32;1;0;0;2;4;168;0;336;4;2;0
/org.eclipse.jdt.ui/ui/org/eclipse/jdt/internal/ui/text/java/hover/SourceViewerInformationControl.java;3;2;12;2;3;2;3;9;235;3;5;47;295;295;3;4;1;9;12;47;5;336;7;3;0
/org.eclipse.ui.workbench/Eclipse UI/org/eclipse/ui/internal/activities/ActivityRegistryEvent.java;1;0;3;1;0;0;0;3;7;1;3;141;8;8;1;0;0;3;3;141;0;170;3;1;0
/org.eclipse.jdt.debug.ui/ui/org/eclipse/jdt/internal/debug/ui/actions/PrimitiveOptionsAction.java;2;0;2;1;0;0;0;2;4;1;2;17;6;6;1;0;0;2;2;17;0;76;2;2;0
/org.eclipse.ui.ide/src/org/eclipse/ui/views/tasklist/MarkerType.java;1;0;1;1;0;0;0;1;0;0;1;129;0;0;1;0;0;1;1;129;0;129;1;1;0
/org.eclipse.jdt.core/compiler/org/eclipse/jdt/internal/compiler/ast/Reference.java;1;0;1;1;0;0;0;1;2;0;1;199;2;2;1;0;0;1;1;199;0;199;1;1;1
/org.eclipse.jdt.debug/jdi interfaces/com/sun/jdi/connect/TransportTimeoutException.java;1;0;1;1;0;0;0;1;0;0;1;235;0;0;1;0;0;1;1;235;0;235;1;1;0
/org.eclipse.jdt.core/model/org/eclipse/jdt/internal/core/XMLWriter.java;3;0;3;1;1;1;1;2;4;1;2;138;6;6;1;0;0;2;3;138;0;276;3;3;0
/org.eclipse.osgi/core/framework/org/eclipse/osgi/framework/internal/core/PackageSource.java;4;1;5;1;2;2;2;3;10;2;2;171;28;28;2;1;0;3;5;171;1;336;4;4;0
/org.eclipse.team.ui/src/org/eclipse/team/internal/ui/synchronize/HierarchicalModelProvider.java;2;4;11;2;6;3;6;5;274;0;1;243;326;326;5;4;3;5;11;243;7;336;4;2;1
/org.eclipse.team.ui/src/org/eclipse/team/internal/ui/synchronize/SynchronizeModelElement.java;2;1;7;1;4;4;4;3;31;0;1;251;77;77;3;2;0;3;7;251;2;336;5;2;0
/org.eclipse.core.resources/src/org/eclipse/core/internal/watson/ElementTree.java;2;0;3;1;1;1;1;2;1548;1;2;13;1608;1608;1;0;0;2;3;13;0;277;3;2;0
/org.eclipse.debug.ui/ui/org/eclipse/debug/internal/ui/sourcelookup/browsers/WorkingSetSourceContainerBrowser.java;1;0;5;1;0;0;0;5;17;3;3;209;22;22;3;2;0;5;5;266;2;266;3;1;0
/org.eclipse.core.runtime/src/org/eclipse/core/internal/runtime/ListenerList.java;1;0;1;1;1;1;1;0;2;0;0;303;2;2;1;0;0;0;1;303;0;303;1;1;0
/org.eclipse.jdt.core/dom/org/eclipse/jdt/core/dom/Expression.java;2;0;2;1;0;0;0;2;2;1;2;199;4;4;1;0;0;2;2;199;0;232;2;2;0
/org.eclipse.pde.ui/src/org/eclipse/pde/internal/ui/wizards/tools/ConvertedProjectWizard.java;2;1;3;1;2;2;2;1;4;0;1;213;6;6;1;0;0;1;3;213;0;336;3;2;0
/org.eclipse.search/new search/org/eclipse/search2/internal/ui/basic/views/RemoveAllMatchesAction.java;2;1;2;1;2;2;2;0;2;0;0;276;2;2;1;0;0;0;2;276;0;336;2;2;0
/org.eclipse.ui.workbench/Eclipse UI/org/eclipse/ui/internal/about/ConfigurationLogErrorLogSection.java;1;1;2;1;2;2;2;0;2;0;0;294;2;2;1;0;0;0;2;294;0;336;2;1;0
/org.eclipse.swt/Eclipse SWT PI/win32/org/eclipse/swt/internal/win32/INPUT.java;2;0;2;1;1;1;1;1;4;0;1;253;4;4;1;0;0;1;2;253;0;337;2;2;0
/org.eclipse.ui.ide/src/org/eclipse/ui/internal/ide/dialogs/IDEWorkbenchPreferencePage.java;6;2;14;3;5;4;6;8;587;3;5;132;1091;1091;3;3;2;9;14;160;5;336;9;6;1
/org.eclipse.pde.core/src/org/eclipse/pde/internal/core/PlatformConfigurationUtils.java;1;0;3;1;1;1;1;2;9;0;1;225;13;13;2;1;0;2;3;225;1;336;2;1;0
/org.eclipse.jdt.ui/ui/org/eclipse/jdt/internal/ui/text/java/JavaFormattingStrategy.java;4;0;11;2;1;1;1;10;163;3;7;38;579;579;3;3;0;10;11;130;3;336;8;4;0
/org.eclipse.team.cvs.ui/src/org/eclipse/team/internal/ccvs/ui/subscriber/CVSSubscriberOperation.java;2;1;8;2;3;3;3;5;29;0;1;244;48;48;5;4;0;5;8;244;4;336;4;2;0
/org.eclipse.debug.ui/ui/org/eclipse/debug/ui/actions/RunToLineActionDelegate.java;2;2;4;1;3;2;3;1;56;0;1;246;64;64;2;0;1;1;4;276;1;287;3;2;0
/org.eclipse.pde.ui/src/org/eclipse/pde/internal/ui/wizards/plugin/PluginClassCodeGenerator.java;2;1;6;2;4;4;4;2;1010;1;2;213;1281;1281;1;0;0;2;6;213;0;336;6;2;0
/org.eclipse.jface.text/src/org/eclipse/jface/text/ITextViewer.java;2;2;6;2;3;2;3;3;222;0;1;253;262;262;3;2;1;3;6;253;3;336;3;2;0
/org.eclipse.team.ui/src/org/eclipse/team/internal/ui/synchronize/SynchronizeModelProvider.java;2;9;26;2;15;2;16;10;961;0;1;243;1593;1593;11;9;14;11;26;243;23;323;3;2;1
/org.eclipse.ui.ide/src/org/eclipse/ui/internal/ide/actions/ProjectPropertyDialogAction.java;1;0;1;1;0;0;0;1;0;0;1;132;0;0;1;0;0;1;1;132;0;132;1;1;0
/org.eclipse.jdt.core/dom/org/eclipse/jdt/core/dom/ChildPropertyDescriptor.java;2;0;2;1;1;1;1;1;4;0;1;232;4;4;1;0;0;1;2;232;0;312;2;2;0
/org.eclipse.jdt.ui/core extension/org/eclipse/jdt/internal/corext/javadoc/JavaDocCommentReader.java;2;0;2;1;1;1;1;1;10;0;1;147;12;12;1;0;0;1;2;147;0;336;2;2;0
/org.eclipse.pde.ui/src/org/eclipse/pde/internal/ui/wizards/templates/NewPluginTemplateChoiceWizard.java;1;0;3;1;1;1;1;2;6;1;2;162;16;16;1;0;0;2;3;162;0;336;3;1;0
/org.eclipse.text/src/org/eclipse/jface/text/Position.java;2;1;5;1;2;2;2;3;41;2;2;82;55;55;2;1;0;3;5;82;1;334;4;2;0
/org.eclipse.jdt.debug/jdi/org/eclipse/jdi/internal/connect/SocketLaunchingConnectorImpl.java;2;0;3;1;0;0;0;3;16;2;2;71;18;18;2;1;0;3;3;71;1;89;2;2;0
/org.eclipse.ui.workbench.texteditor/src/org/eclipse/ui/internal/texteditor/GotoLastEditPositionAction.java;2;0;2;1;1;1;1;1;102;0;1;157;104;104;1;0;0;1;2;157;0;336;2;2;0
/org.eclipse.team.cvs.core/src/org/eclipse/team/internal/ccvs/core/client/PruneFolderVisitor.java;1;0;1;1;0;0;0;1;20;0;1;52;20;20;1;0;0;1;1;52;0;52;1;1;0
/org.eclipse.jface/src/org/eclipse/jface/preference/FontFieldEditor.java;3;1;3;2;2;2;2;1;22;0;1;234;28;28;1;0;0;1;3;234;0;336;3;3;1
/org.eclipse.ui.workbench/Eclipse UI/org/eclipse/ui/internal/commands/ICommandRegistry.java;3;1;7;1;2;2;2;5;72;1;5;86;82;82;1;0;0;5;7;86;0;336;7;3;0
/org.eclipse.core.runtime/src/org/eclipse/core/runtime/jobs/Job.java;3;2;37;2;3;2;5;32;1792;9;11;23;2796;2796;9;21;3;34;37;67;24;320;13;3;1
/org.eclipse.team.cvs.ui/src/org/eclipse/team/internal/ccvs/ui/actions/CommitAction.java;2;1;6;1;2;2;2;4;143;1;4;52;162;162;1;0;0;4;6;52;0;336;6;2;1
/org.eclipse.jface/src/org/eclipse/jface/preference/IPreferenceStore.java;2;1;2;1;2;2;2;0;2;0;0;293;4;4;1;0;0;0;2;293;0;336;2;2;2
/org.eclipse.jdt.ui/ui/org/eclipse/jdt/internal/ui/javaeditor/JavaDocumentFactory.java;2;0;2;1;1;1;1;1;20;0;1;243;20;20;1;0;0;1;2;243;0;336;2;2;0
/org.eclipse.jdt.ui/core refactoring/org/eclipse/jdt/internal/corext/refactoring/util/AbstractExceptionAnalyzer.java;1;0;1;1;1;1;1;0;2;0;0;336;2;2;1;0;0;0;1;336;0;336;1;1;0
/org.eclipse.team.ui/src/org/eclipse/team/internal/ui/synchronize/actions/RemoveFromViewAction.java;1;0;1;1;1;1;1;0;107;0;0;299;107;107;1;0;0;0;1;299;0;299;1;1;0
/org.eclipse.pde.build/src/org/eclipse/pde/internal/build/AssemblyInformation.java;2;2;12;2;4;3;4;8;62;2;5;31;154;154;2;3;1;8;12;31;4;332;8;2;0
/org.eclipse.jdt.ui/ui/org/eclipse/jdt/internal/ui/javadocexport/JavadocWizard.java;4;6;19;3;8;3;9;10;366;3;6;59;746;746;6;4;6;11;19;302;10;336;9;4;0
/org.eclipse.update.core/src/org/eclipse/update/standalone/StandaloneUpdateApplication.java;1;1;5;1;2;2;2;3;60;2;2;54;90;90;2;1;0;3;5;267;1;303;4;1;0
/org.eclipse.update.ui/src/org/eclipse/update/internal/ui/model/UpdateModel.java;2;1;7;2;2;2;2;5;109;4;2;48;130;130;4;3;0;5;7;48;3;336;4;2;0
/org.eclipse.jface.text/src/org/eclipse/jface/text/templates/persistence/TemplatePersistenceMessages.java;1;1;2;1;2;2;2;0;2;0;0;283;2;2;1;0;0;0;2;283;0;336;2;1;0
/org.eclipse.core.resources/src/org/eclipse/core/internal/indexing/StoredObject.java;1;0;1;1;1;1;1;0;25;0;0;277;25;25;1;0;0;0;1;277;0;277;1;1;0
/org.eclipse.swt/Eclipse SWT PI/gtk/org/eclipse/swt/internal/accessibility/gtk/GInterfaceInfo.java;4;0;5;1;1;1;1;4;11;2;3;75;21;21;2;1;0;4;5;226;1;337;4;4;0
/org.eclipse.jdt.core/codeassist/org/eclipse/jdt/internal/codeassist/select/SelectionOnLocalName.java;2;0;3;1;0;0;0;3;22;1;3;63;29;29;1;0;0;3;3;63;0;199;3;2;1
/org.eclipse.ant.ui/Ant Tools Support/org/eclipse/ant/internal/ui/launchConfigurations/IAntLaunchConfigurationConstants.java;3;0;7;2;1;1;1;6;12;2;4;108;27;27;2;2;0;6;7;127;2;336;5;3;0
/org.eclipse.jdt.junit/src/org/eclipse/jdt/internal/junit/ui/TestHierarchyTab.java;2;1;3;1;3;3;3;0;6;0;0;301;8;8;1;0;0;0;3;301;0;336;3;2;0
/org.eclipse.jdt.debug.ui/ui/org/eclipse/jdt/internal/debug/ui/MessageLine.java;2;0;2;1;1;1;1;1;4;0;1;197;4;4;1;0;0;1;2;197;0;336;2;2;0
/org.eclipse.ui.workbench/Eclipse UI/org/eclipse/ui/IWorkbenchPartSite.java;4;1;12;2;2;2;2;10;44;5;6;0;71;71;5;4;0;10;12;158;4;336;8;4;0
/org.eclipse.jdt.ui/core refactoring/org/eclipse/jdt/internal/corext/refactoring/changes/WorkspaceTracker.java;2;1;2;1;2;2;2;0;2;0;0;283;2;2;1;0;0;0;2;283;0;336;2;2;0
/org.eclipse.jdt.ui/ui/org/eclipse/jdt/internal/ui/viewsupport/AppearanceAwareLabelProvider.java;1;0;1;1;1;1;1;0;2;0;0;336;2;2;1;0;0;0;1;336;0;336;1;1;0
/org.eclipse.team.ui/src/org/eclipse/team/internal/ui/synchronize/WorkbenchPartSynchronizePageSite.java;2;4;5;2;5;2;5;0;110;0;0;272;110;110;4;0;3;0;5;288;3;288;2;2;0
/org.eclipse.ui.ide/extensions/org/eclipse/ui/IFileEditorInput.java;1;0;1;1;0;0;0;1;0;0;1;132;0;0;1;0;0;1;1;132;0;132;1;1;0
/org.eclipse.ui.workbench/Eclipse UI/org/eclipse/ui/internal/misc/StatusUtil.java;3;1;3;1;3;3;3;0;11;0;0;293;19;19;1;0;0;0;3;293;0;336;3;3;0
/org.eclipse.team.ui/src/org/eclipse/team/ui/synchronize/ISynchronizeManager.java;2;1;9;1;3;3;3;6;90;2;4;146;183;183;2;2;0;6;9;146;2;336;7;2;0
/org.eclipse.team.cvs.ui/src/org/eclipse/team/internal/ccvs/ui/RemoteRevisionQuickDiffProvider.java;2;6;15;2;9;4;9;6;531;4;3;102;735;735;6;3;5;6;15;290;8;336;7;2;0
/org.eclipse.ui.workbench/Eclipse UI/org/eclipse/ui/internal/registry/PerspectiveExtensionReader.java;2;1;3;1;2;2;2;1;32;0;1;252;54;54;1;0;0;1;3;252;0;336;3;2;2
/org.eclipse.jdt.debug.ui/ui/org/eclipse/jdt/internal/debug/ui/launcher/JavaApplicationLaunchShortcut.java;4;2;12;2;5;4;5;7;168;3;5;44;307;307;3;2;1;7;12;211;3;336;9;4;1
/org.eclipse.jface/src/org/eclipse/jface/preference/ColorFieldEditor.java;2;1;3;1;2;2;2;1;22;0;1;223;39;39;1;0;0;1;3;223;0;336;3;2;2
/org.eclipse.jdt.ui/ui/org/eclipse/jdt/internal/ui/text/spelling/engine/ISpellEventListener.java;2;0;2;1;1;1;1;1;2;0;1;219;2;2;1;0;0;1;2;219;0;336;2;2;0
/org.eclipse.jdt.debug/model/org/eclipse/jdt/debug/core/IJavaClassType.java;2;0;3;1;0;0;0;3;31;2;2;45;60;60;2;1;0;3;3;128;1;128;2;2;0
/org.eclipse.pde.core/src/org/eclipse/pde/internal/core/build/BuildEntry.java;3;1;6;1;3;3;3;3;83;1;3;128;166;166;1;0;0;3;6;128;0;336;6;3;0
/org.eclipse.jdt.ui/ui/org/eclipse/jdt/internal/ui/preferences/formatter/RenameProfileDialog.java;1;0;6;1;0;0;0;6;35;3;4;176;62;62;3;2;0;6;6;176;2;262;4;1;0
/org.eclipse.ui.workbench/Eclipse UI/org/eclipse/ui/internal/PerspectiveBarManager.java;6;6;15;3;12;3;12;3;730;1;3;183;1069;1069;6;0;9;3;15;283;9;324;6;6;0
/org.eclipse.pde.build/src/org/eclipse/pde/internal/build/AbstractScriptGenerator.java;2;5;16;2;8;3;8;8;338;2;5;31;989;989;5;3;5;8;16;272;8;335;8;2;0
/org.eclipse.debug.ui/ui/org/eclipse/debug/internal/ui/actions/LaunchablePropertyTester.java;1;0;1;1;1;1;1;0;0;0;0;295;0;0;1;0;0;0;1;295;0;295;1;1;0
/org.eclipse.jdt.ui/ui/org/eclipse/jdt/internal/ui/typehierarchy/HierarchyViewerSorter.java;2;0;2;1;1;1;1;1;81;0;1;208;83;83;1;0;0;1;2;208;0;336;2;2;0
/org.eclipse.jdt.core/eval/org/eclipse/jdt/internal/eval/CodeSnippetFieldReference.java;3;0;7;1;0;0;0;7;154;2;6;3;207;207;2;1;0;7;7;3;1;199;6;3;1
/org.eclipse.jdt.ui/ui refactoring/org/eclipse/jdt/internal/ui/refactoring/MoveInstanceMethodWizard.java;3;0;8;2;1;1;2;6;217;2;5;36;363;363;2;1;1;7;8;65;2;336;6;3;1
/org.eclipse.compare/compare/org/eclipse/compare/ResourceNode.java;1;0;5;1;0;0;0;5;17;2;4;79;35;35;2;1;0;5;5;219;1;219;4;1;1
/org.eclipse.team.cvs.core/src/org/eclipse/team/internal/ccvs/core/util/SyncFileChangeListener.java;2;2;11;2;3;2;3;8;185;4;4;20;293;293;4;4;1;8;11;122;5;336;6;2;0
/org.eclipse.jdt.core/codeassist/org/eclipse/jdt/internal/codeassist/complete/CompletionOnLocalName.java;2;0;3;1;0;0;0;3;24;1;3;63;31;31;1;0;0;3;3;63;0;199;3;2;0
/org.eclipse.help/src/org/eclipse/help/internal/context/ContextsNode.java;1;1;3;1;3;3;3;0;18;0;0;299;35;35;1;0;0;0;3;299;0;336;3;1;0
/org.eclipse.jdt.ui/core refactoring/org/eclipse/jdt/internal/corext/refactoring/rename/MethodOccurenceCollector.java;4;2;6;2;3;2;3;3;63;2;2;96;69;69;2;1;1;3;6;96;2;336;4;4;0
/org.eclipse.core.resources/src/org/eclipse/core/internal/indexing/IndexedStore.java;1;0;1;1;1;1;1;0;73;0;0;277;73;73;1;0;0;0;1;277;0;277;1;1;0
/org.eclipse.pde.core/src/org/eclipse/pde/internal/core/plugin/ExternalPluginModelBase.java;3;1;7;1;3;3;3;4;24;2;3;184;74;74;2;1;0;4;7;259;1;336;6;3;0
/org.eclipse.jdt.core/compiler/org/eclipse/jdt/internal/compiler/lookup/MemberTypeBinding.java;1;0;1;1;0;0;0;1;2;0;1;199;2;2;1;0;0;1;1;199;0;199;1;1;0
/org.eclipse.team.cvs.ui/src/org/eclipse/team/internal/ccvs/ui/CVSProjectSetSerializer.java;2;1;5;1;3;3;3;2;23;1;2;254;43;43;1;0;0;2;5;254;0;336;5;2;0
/org.eclipse.pde.core/src/org/eclipse/pde/internal/core/schema/ChoiceRestriction.java;2;1;3;1;2;2;2;1;12;0;1;232;18;18;1;0;0;1;3;232;0;336;3;2;0
/org.eclipse.jdt.ui/ui/org/eclipse/jdt/internal/ui/callhierarchy/ToggleCallModeAction.java;2;0;3;1;1;1;1;2;2;0;1;12;4;4;2;1;0;2;3;12;1;336;2;2;0
/org.eclipse.pde/src/org/eclipse/pde/internal/builders/PluginErrorReporter.java;1;0;3;1;1;1;1;2;6;1;2;166;16;16;1;0;0;2;3;166;0;336;3;1;0
/org.eclipse.jdt.ui/ui/org/eclipse/jdt/internal/ui/text/template/preferences/TemplateVariableProcessor.java;3;1;4;1;2;2;2;2;8;0;1;234;18;18;2;1;0;2;4;234;1;336;3;3;0
/org.eclipse.jdt.ui/ui/org/eclipse/jdt/ui/IJavaElementSearchConstants.java;1;0;1;1;1;1;1;0;2;0;0;336;2;2;1;0;0;0;1;336;0;336;1;1;0
/org.eclipse.jdt.junit/src/org/eclipse/jdt/internal/junit/ui/CopyTraceAction.java;2;1;2;1;2;2;2;0;4;0;0;301;6;6;1;0;0;0;2;301;0;336;2;2;0
/org.eclipse.core.resources/src/org/eclipse/core/internal/resources/WorkspaceDescriptionReader.java;2;0;3;1;1;1;1;2;271;1;2;90;277;277;1;0;0;2;3;90;0;277;3;2;0
/org.eclipse.swt/Eclipse SWT/motif/org/eclipse/swt/widgets/Canvas.java;5;0;7;2;1;1;1;6;30;2;4;25;83;83;2;2;0;6;7;50;2;337;5;5;0
/org.eclipse.debug.ui/ui/org/eclipse/debug/internal/ui/views/variables/VariablesViewContentProvider.java;3;0;16;2;1;1;1;15;187;5;7;37;486;486;5;8;0;15;16;37;8;309;8;3;0
/org.eclipse.jdt.debug/eval/org/eclipse/jdt/internal/debug/eval/ast/instructions/ArrayAccess.java;2;0;3;2;0;0;0;3;16;2;2;76;21;21;2;1;0;3;3;76;1;148;2;2;0
/org.eclipse.jdt.ui/ui/org/eclipse/jdt/internal/ui/search/SortingLabelProvider.java;2;2;6;1;6;4;6;0;33;0;0;275;51;51;2;0;2;0;6;275;2;336;4;2;1
/org.eclipse.jdt.debug.ui/ui/org/eclipse/jdt/internal/debug/ui/classpath/IClasspathEntry.java;3;0;3;1;1;1;1;2;7;1;2;154;11;11;1;0;0;2;3;154;0;336;3;3;0
/org.eclipse.jdt.debug.ui/ui/org/eclipse/jdt/internal/debug/ui/sourcelookup/WorkbenchAdapter.java;1;0;2;1;0;0;0;2;8;1;2;252;8;8;1;0;0;2;2;252;0;269;2;1;0
/org.eclipse.jdt.core/dom/org/eclipse/jdt/core/dom/ChildListPropertyDescriptor.java;2;0;2;1;1;1;1;1;2;0;1;232;2;2;1;0;0;1;2;232;0;312;2;2;0
/org.eclipse.jdt.debug.ui/ui/org/eclipse/jdt/internal/debug/ui/JavaHotCodeReplaceListener.java;2;0;2;2;0;0;0;2;10;1;2;111;16;16;1;0;0;2;2;111;0;122;2;2;0
/org.eclipse.jdt.debug.ui/ui/org/eclipse/jdt/internal/debug/ui/snippeteditor/SnippetDocumentSetupParticipant.java;1;0;1;1;1;1;1;0;0;0;0;273;0;0;1;0;0;0;1;273;0;273;1;1;0
/org.eclipse.osgi/resolver/src/org/eclipse/osgi/internal/resolver/ResolverImpl.java;4;0;12;3;5;1;5;7;107;3;5;171;212;212;5;2;4;7;12;276;6;276;6;4;0
/org.eclipse.jdt.ui/ui/org/eclipse/jdt/internal/ui/compare/JavaMergeViewer.java;3;1;3;1;2;2;2;1;23;0;1;79;26;26;1;0;0;1;3;79;0;336;3;3;0
/org.eclipse.search/search/org/eclipse/search/internal/ui/util/ListContentProvider.java;1;0;1;1;1;1;1;0;2;0;0;336;2;2;1;0;0;0;1;336;0;336;1;1;0
/org.eclipse.swt/Eclipse SWT Drag and Drop/photon/org/eclipse/swt/dnd/Transfer.java;1;1;2;1;2;2;2;0;4;0;0;300;6;6;1;0;0;0;2;300;0;337;2;1;0
/org.eclipse.team.ui/src/org/eclipse/team/internal/ui/synchronize/HierarchicalModelManager.java;2;2;3;2;3;2;3;0;79;0;0;273;79;79;2;0;1;0;3;288;1;288;2;2;0
/org.eclipse.jdt.core/model/org/eclipse/jdt/internal/core/UserLibrary.java;1;1;2;1;2;2;2;0;11;0;0;280;11;11;1;0;0;0;2;280;0;305;2;1;0
/org.eclipse.core.resources/src/org/eclipse/core/internal/indexing/ObjectPage.java;1;0;1;1;1;1;1;0;97;0;0;277;97;97;1;0;0;0;1;277;0;277;1;1;0
/org.eclipse.search/search/org/eclipse/search/internal/ui/SearchResultViewer.java;2;0;8;1;1;1;1;7;55;2;6;42;121;121;2;1;0;7;8;180;1;313;7;2;0
/org.eclipse.jdt.ui/ui/org/eclipse/jdt/internal/ui/text/spelling/engine/LocaleSensitiveSpellDictionary.java;2;0;2;1;1;1;1;1;2;0;1;219;2;2;1;0;0;1;2;219;0;336;2;2;0
/org.eclipse.ui.workbench/Eclipse UI/org/eclipse/ui/internal/BaseSaveAction.java;1;0;1;1;0;0;0;1;53;0;1;157;53;53;1;0;0;1;1;157;0;157;1;1;0
/org.eclipse.update.ui/src/org/eclipse/update/internal/ui/parts/SWTUtil.java;2;1;4;1;2;2;2;2;54;1;2;58;87;87;1;0;0;2;4;58;0;336;4;2;1
/org.eclipse.jdt.core/model/org/eclipse/jdt/internal/core/BinaryMember.java;2;0;8;2;0;0;0;8;52;3;5;51;82;82;3;3;0;8;8;51;3;199;5;2;1
/org.eclipse.swt/Eclipse SWT PI/gtk/org/eclipse/swt/internal/gtk/GdkEventExpose.java;3;0;4;1;1;1;1;3;17;2;2;100;25;25;2;1;0;3;4;226;1;337;3;3;0
/org.eclipse.ui.editors/src/org/eclipse/ui/editors/text/DefaultEncodingSupport.java;1;1;2;1;2;2;2;0;15;0;0;314;20;20;1;0;0;0;2;314;0;336;2;1;0
/org.eclipse.debug.core/core/org/eclipse/debug/internal/core/sourcelookup/containers/ArchiveSourceContainerType.java;2;0;4;1;1;1;1;3;20;1;3;226;41;41;1;0;0;3;4;226;0;303;4;2;0
/org.eclipse.pde.ui/src/org/eclipse/pde/internal/ui/editor/feature/FeatureChildPropertySource.java;2;1;4;1;2;2;2;2;36;1;2;26;56;56;1;0;0;2;4;26;0;336;4;2;0
/org.eclipse.ui.workbench/Eclipse UI/org/eclipse/ui/dialogs/ElementTreeSelectionDialog.java;1;0;1;1;1;1;1;0;48;0;0;293;48;48;1;0;0;0;1;293;0;293;1;1;0
/org.eclipse.team.cvs.core/src/org/eclipse/team/internal/ccvs/core/client/Diff.java;1;0;2;1;0;0;0;2;4;1;2;110;5;5;1;0;0;2;2;110;0;146;2;1;0
/org.eclipse.ant.ui/Ant Tools Support/org/eclipse/ant/internal/ui/preferences/AntEditorPreferencePage.java;2;3;14;1;5;3;5;9;1452;3;6;108;2047;2047;3;3;2;9;14;224;5;314;9;2;3
/org.eclipse.pde.ui/src/org/eclipse/pde/internal/ui/wizards/site/NewSiteProjectWizard.java;3;4;10;2;9;4;9;1;600;0;1;213;670;670;4;0;5;1;10;319;5;336;5;3;0
/org.eclipse.ui.forms/src/org/eclipse/ui/forms/IManagedForm.java;1;1;10;1;2;2;2;8;199;0;1;225;212;212;8;7;0;8;10;225;7;336;3;1;0
/org.eclipse.jdt.debug.ui/ui/org/eclipse/jdt/internal/debug/ui/actions/EvaluateAction.java;5;1;11;3;2;2;2;9;46;3;4;76;110;110;3;5;0;9;11;213;5;336;6;5;0
/org.eclipse.jface.text/src/org/eclipse/jface/text/rules/IWhitespaceDetector.java;1;1;2;1;2;2;2;0;2;0;0;276;3;3;1;0;0;0;2;276;0;336;2;1;0
/org.eclipse.swt/Eclipse SWT Mozilla/common/org/eclipse/swt/internal/mozilla/nsID.java;1;0;1;1;0;0;0;1;0;0;1;100;0;0;1;0;0;1;1;100;0;100;1;1;0
/org.eclipse.jdt.core/model/org/eclipse/jdt/internal/core/CreateImportOperation.java;3;1;6;1;2;2;2;4;6;1;4;108;16;16;1;0;0;4;6;108;0;314;6;3;0
/org.eclipse.pde.ui/src/org/eclipse/pde/internal/ui/editor/text/TextUtil.java;2;1;2;1;2;2;2;0;4;0;0;309;6;6;1;0;0;0;2;309;0;336;2;2;0
/org.eclipse.ui.workbench/Eclipse UI/org/eclipse/ui/internal/SwitchToWindowMenu.java;1;0;1;1;0;0;0;1;6;0;1;157;6;6;1;0;0;1;1;157;0;157;1;1;0
/org.eclipse.debug.core/core/org/eclipse/debug/core/sourcelookup/ISourceContainerTypeDelegate.java;1;0;2;1;0;0;1;1;6;0;1;268;6;6;2;0;1;2;2;268;1;268;1;1;0
/org.eclipse.jface/src/org/eclipse/jface/preference/ScaleFieldEditor.java;1;0;1;1;0;0;0;1;0;0;1;159;0;0;1;0;0;1;1;159;0;159;1;1;0
/org.eclipse.ant.ui/Ant Editor/org/eclipse/ant/internal/ui/editor/text/XMLAnnotationHover.java;1;0;3;1;1;1;1;2;8;1;2;108;14;14;1;0;0;2;3;108;0;299;3;1;1
/org.eclipse.jdt.ui/core refactoring/org/eclipse/jdt/internal/corext/refactoring/changes/CopyResourceChange.java;2;1;4;1;2;2;2;2;11;1;2;219;24;24;1;0;0;2;4;219;0;336;4;2;0
/org.eclipse.jdt.ui/core extension/org/eclipse/jdt/internal/corext/callhierarchy/CalleeAnalyzerVisitor.java;4;0;9;2;1;1;1;8;61;4;3;13;169;169;4;5;0;8;9;13;5;336;4;4;0
/org.eclipse.ui.intro/src/org/eclipse/ui/internal/intro/impl/util/StringUtil.java;1;1;3;1;3;3;3;0;40;0;0;277;42;42;1;0;0;0;3;277;0;297;3;1;0
/org.eclipse.ui.workbench/Eclipse UI/org/eclipse/ui/dialogs/TypeFilteringDialog.java;1;0;3;1;1;1;1;2;466;1;2;28;477;477;1;0;0;2;3;28;0;293;3;1;0
/org.eclipse.core.resources/src/org/eclipse/core/internal/watson/ElementDelta.java;1;0;1;1;1;1;1;0;234;0;0;277;234;234;1;0;0;0;1;277;0;277;1;1;0
/org.eclipse.ui.ide/src/org/eclipse/ui/views/framelist/FrameList.java;1;0;1;1;0;0;0;1;0;0;1;129;0;0;1;0;0;1;1;129;0;129;1;1;0
/org.eclipse.jdt.ui/ui refactoring/org/eclipse/jdt/internal/ui/refactoring/code/ExtractMethodInputPage.java;4;1;14;2;3;3;4;10;80;3;8;10;225;225;3;2;1;11;14;263;3;336;11;4;0
/org.eclipse.jdt.debug/model/org/eclipse/jdt/debug/core/IJavaFieldVariable.java;2;0;2;2;0;0;0;2;46;0;1;132;46;46;2;1;0;2;2;132;1;132;1;2;0
/org.eclipse.swt/Eclipse SWT Browser/common/org/eclipse/swt/browser/TitleListener.java;2;0;3;1;1;1;1;2;7;1;2;206;13;13;1;0;0;2;3;206;0;337;3;2;0
/org.eclipse.ui.workbench/Eclipse UI/org/eclipse/ui/internal/decorators/DecoratorOverlayIcon.java;1;0;1;1;0;0;0;1;17;0;1;81;17;17;1;0;0;1;1;81;0;81;1;1;0
/org.eclipse.jdt.debug.ui/ui/org/eclipse/jdt/internal/debug/ui/actions/MoveUpAction.java;1;0;2;1;0;0;0;2;16;1;2;91;18;18;1;0;0;2;2;91;0;154;2;1;0
/org.eclipse.ui.workbench/Eclipse UI/org/eclipse/ui/commands/AbstractHandler.java;2;1;6;1;2;2;2;4;27;2;3;226;73;73;2;1;0;4;6;268;1;292;5;2;0
/org.eclipse.team.cvs.ui/src/org/eclipse/team/internal/ccvs/ui/actions/ShowResourceInHistoryAction.java;2;1;3;1;2;2;2;1;7;0;1;71;11;11;1;0;0;1;3;71;0;336;3;2;1
/org.eclipse.help.base/src/org/eclipse/help/internal/base/util/IErrorUtil.java;1;1;4;1;2;2;2;2;8;0;1;105;18;18;2;1;0;2;4;105;1;336;3;1;0
/org.eclipse.update.core/src/org/eclipse/update/internal/core/SiteFile.java;3;2;11;2;3;2;3;8;40;3;6;58;119;119;3;2;1;8;11;100;3;302;8;3;0
/org.eclipse.search/search/org/eclipse/search/ui/ISearchPageContainer.java;2;0;6;2;2;1;2;4;64;2;3;93;78;78;2;1;1;4;6;165;2;335;4;2;0
/org.eclipse.ui.ide/src/org/eclipse/ui/views/bookmarkexplorer/MarkerUtil.java;1;0;1;1;0;0;0;1;0;0;1;129;0;0;1;0;0;1;1;129;0;129;1;1;0
/org.eclipse.ui.ide/src/org/eclipse/ui/internal/ide/dialogs/BuildOrderPreferencePage.java;1;0;1;1;0;0;0;1;0;0;1;132;0;0;1;0;0;1;1;132;0;132;1;1;1
/org.eclipse.ui.workbench/Eclipse UI/org/eclipse/ui/IWorkingSetManager.java;2;1;3;1;2;2;2;1;34;0;1;181;42;42;1;0;0;1;3;181;0;336;3;2;2
/org.eclipse.ui.ide/src/org/eclipse/ui/internal/ide/registry/CapabilityRegistryReader.java;2;0;2;1;0;0;0;2;3;1;2;132;3;3;1;0;0;2;2;132;0;160;2;2;0
/org.eclipse.ant.ui/Ant Tools Support/org/eclipse/ant/internal/ui/views/elements/RootNode.java;1;0;1;1;0;0;0;1;0;0;1;108;0;0;1;0;0;1;1;108;0;108;1;1;1
/org.eclipse.jdt.ui/ui refactoring/org/eclipse/jdt/internal/ui/refactoring/actions/MoveStaticMembersAction.java;3;1;13;1;2;2;3;10;142;3;7;3;271;271;3;3;1;11;13;3;4;336;9;3;0
/org.eclipse.jdt.ui/ui/org/eclipse/jdt/internal/ui/dnd/BasicSelectionTransferDragAdapter.java;2;1;2;1;2;2;2;0;4;0;0;303;6;6;1;0;0;0;2;303;0;336;2;2;0
/org.eclipse.core.runtime/src/org/eclipse/core/runtime/content/IContentType.java;2;1;10;2;2;2;7;3;220;6;2;251;249;249;6;1;5;8;10;268;6;320;4;2;0
/org.eclipse.jdt.ui/ui/org/eclipse/jdt/internal/ui/text/IJavaPartitions.java;2;0;2;1;1;1;1;1;7;0;1;96;9;9;1;0;0;1;2;96;0;336;2;2;0
/org.eclipse.swt/Eclipse SWT PI/carbon/org/eclipse/swt/internal/carbon/DataBrowserCallbacks.java;1;0;2;1;2;1;2;0;20;0;0;296;20;20;2;0;1;0;2;296;1;296;1;1;0
/org.eclipse.swt/Eclipse SWT OLE Win32/win32/org/eclipse/swt/ole/win32/OleClientSite.java;1;0;2;1;0;0;0;2;161;1;2;48;178;178;1;0;0;2;2;48;0;91;2;1;0
/org.eclipse.jdt.core/compiler/org/eclipse/jdt/internal/compiler/ClassFile.java;5;2;19;3;4;3;4;15;1119;3;9;16;1398;1398;3;6;1;15;19;217;7;314;12;5;4
/org.eclipse.debug.ui/ui/org/eclipse/debug/internal/ui/stringsubstitution/ContainerResolver.java;2;0;2;1;0;0;0;2;4;1;2;121;4;4;1;0;0;2;2;121;0;266;2;2;0
/org.eclipse.swt/Eclipse SWT Browser/motif/org/eclipse/swt/internal/mozilla/XPCOMObject.java;1;0;1;1;0;0;0;1;0;0;1;125;0;0;1;0;0;1;1;125;0;125;1;1;0
/org.eclipse.jdt.ui/core refactoring/org/eclipse/jdt/internal/corext/refactoring/changes/RenamePackageChange.java;2;0;7;1;1;1;1;6;44;3;3;207;57;57;3;3;0;6;7;245;3;336;4;2;0
/org.eclipse.jdt.ui/ui/org/eclipse/jdt/ui/actions/IntroduceFactoryAction.java;2;1;7;1;3;3;3;4;102;2;3;162;118;118;2;1;0;4;7;267;1;336;6;2;0
/org.eclipse.core.runtime/src/org/eclipse/core/runtime/content/IContentTypeManager.java;3;4;14;3;6;3;10;4;177;5;2;251;312;312;5;2;7;8;14;268;9;336;5;3;0
/org.eclipse.jdt.ui/ui/org/eclipse/jdt/ui/actions/FindWriteReferencesInWorkingSetAction.java;2;0;2;1;1;1;1;1;9;0;1;184;11;11;1;0;0;1;2;184;0;336;2;2;0
/org.eclipse.ant.core/src/org/eclipse/ant/internal/core/AntPropertyValueProvider.java;1;0;4;1;1;1;1;3;9;2;2;85;15;15;2;1;0;3;4;85;1;323;3;1;0
/org.eclipse.ui.workbench/Eclipse UI/org/eclipse/ui/internal/layout/SizeCache.java;1;1;3;1;3;3;3;0;175;0;0;271;194;194;1;0;0;0;3;271;0;293;3;1;0
/org.eclipse.ui.presentations.r21/src/org/eclipse/ui/internal/presentations/r21/widgets/R21PaneFolder.java;2;0;3;2;3;1;3;0;80;0;0;323;80;80;3;0;2;0;3;323;2;323;1;2;0
/org.eclipse.jdt.ui/ui refactoring/org/eclipse/jdt/internal/ui/refactoring/nls/PackageSelectionStringButtonAdapter.java;3;3;5;1;4;2;4;1;20;0;1;267;22;22;3;0;2;1;5;289;2;336;3;3;0
/org.eclipse.jdt.ui/ui/org/eclipse/jdt/ui/actions/FindDeclarationsAction.java;2;1;5;1;2;2;2;3;16;1;3;184;29;29;1;0;0;3;5;184;0;336;5;2;0
/org.eclipse.pde.core/src/org/eclipse/pde/internal/core/plugin/ExtensionsParser.java;2;1;4;1;3;3;3;1;10;0;1;259;23;23;1;0;0;1;4;259;0;336;4;2;0
/org.eclipse.ui.forms/src/org/eclipse/ui/internal/forms/widgets/HyperlinkSegment.java;1;2;3;1;3;2;3;0;6;0;0;272;6;6;2;0;1;0;3;330;1;330;2;1;0
/org.eclipse.jdt.core/dom/org/eclipse/jdt/core/dom/IDocElement.java;2;0;2;2;0;0;0;2;6;0;1;206;6;6;2;1;0;2;2;206;1;206;1;2;0
/org.eclipse.update.core/src/org/eclipse/update/internal/core/SiteFileContentProvider.java;1;0;1;1;0;0;0;1;17;0;1;58;17;17;1;0;0;1;1;58;0;58;1;1;0
/org.eclipse.jdt.debug/model/org/eclipse/jdt/debug/core/IJavaExceptionBreakpoint.java;1;0;1;1;0;0;0;1;2;0;1;0;2;2;1;0;0;1;1;0;0;0;1;1;0
/org.eclipse.pde.ui/src/org/eclipse/pde/internal/ui/editor/plugin/ManifestEditorContributor.java;2;1;3;1;3;3;3;0;10;0;0;292;12;12;1;0;0;0;3;292;0;336;3;2;0
/org.eclipse.ui.editors/src/org/eclipse/ui/texteditor/ResourceMarkerAnnotationModel.java;2;0;4;1;1;1;1;3;152;1;3;118;161;161;1;0;0;3;4;118;0;336;4;2;0
/org.eclipse.debug.ui/ui/org/eclipse/debug/internal/ui/launchConfigurations/DebugModePromptStatusHandler.java;3;5;9;3;8;2;8;1;43;0;1;254;63;63;5;0;6;1;9;279;6;309;3;3;0
/org.eclipse.jdt.ui/ui/org/eclipse/jdt/internal/ui/workingsets/WorkingSetMenuContributionItem.java;1;0;2;1;1;1;1;1;30;0;1;263;32;32;1;0;0;1;2;263;0;336;2;1;0
/org.eclipse.swt/Eclipse SWT/win32/org/eclipse/swt/widgets/Tree.java;7;3;30;3;7;3;7;23;355;3;13;3;865;865;3;10;4;23;30;145;14;337;16;7;3
/org.eclipse.pde.ui/src/org/eclipse/pde/internal/ui/editor/plugin/JavaAttributeValue.java;1;1;2;1;2;2;2;0;4;0;0;292;4;4;1;0;0;0;2;292;0;336;2;1;0
/org.eclipse.ui.workbench/Eclipse UI/org/eclipse/ui/internal/UISynchronizer.java;1;0;2;1;0;0;0;2;55;1;2;93;72;72;1;0;0;2;2;93;0;128;2;1;0
/org.eclipse.jdt.ui/core refactoring/org/eclipse/jdt/internal/corext/refactoring/changes/MovePackageChange.java;2;1;4;1;2;2;2;2;8;1;2;219;16;16;1;0;0;2;4;219;0;336;4;2;0
/org.eclipse.core.runtime/src/org/eclipse/core/runtime/preferences/DefaultScope.java;2;1;4;1;2;2;2;2;8;1;2;239;12;12;1;0;0;2;4;239;0;332;4;2;0
/org.eclipse.jdt.ui/ui/org/eclipse/jdt/internal/ui/actions/NewWizardsActionGroup.java;2;0;2;1;1;1;1;1;2;0;1;264;4;4;1;0;0;1;2;264;0;336;2;2;0
/org.eclipse.pde.ui/src/org/eclipse/pde/internal/ui/search/PluginSearchActionGroup.java;1;1;2;1;2;2;2;0;4;0;0;292;8;8;1;0;0;0;2;292;0;336;2;1;0
/org.eclipse.core.expressions/src/org/eclipse/core/internal/expressions/Property.java;1;1;4;1;2;2;2;2;13;0;1;227;17;17;2;1;0;2;4;227;1;336;3;1;0
/org.eclipse.team.cvs.ui/src/org/eclipse/team/internal/ccvs/ui/subscriber/CompareParticipant.java;2;7;25;2;12;3;13;12;207;10;2;229;439;439;10;10;10;13;25;244;20;336;5;2;2
/org.eclipse.jdt.ui/ui/org/eclipse/jdt/internal/ui/LogicalPackageAdapterFactory.java;1;0;1;1;1;1;1;0;2;0;0;336;2;2;1;0;0;0;1;336;0;336;1;1;0
/org.eclipse.jdt.ui/core refactoring/org/eclipse/jdt/internal/corext/refactoring/code/flow/ReturnFlowInfo.java;1;0;1;1;1;1;1;0;2;0;0;336;2;2;1;0;0;0;1;336;0;336;1;1;0
/org.eclipse.core.resources/src/org/eclipse/core/internal/events/ResourceDelta.java;2;1;5;1;2;2;2;3;960;1;3;90;1089;1089;1;0;0;3;5;90;0;303;5;2;0
/org.eclipse.jdt.ui/core extension/org/eclipse/jdt/internal/corext/template/java/CodeTemplates.java;2;2;10;2;4;3;4;6;22;3;3;234;68;68;3;3;1;6;10;234;4;336;6;2;0
/org.eclipse.jdt.ui/ui/org/eclipse/jdt/internal/ui/filters/ImportDeclarationFilter.java;1;0;1;1;1;1;1;0;2;0;0;336;2;2;1;0;0;0;1;336;0;336;1;1;0
/org.eclipse.core.runtime/src/org/eclipse/core/internal/registry/ExtensionPoint.java;5;0;12;4;4;1;7;5;196;4;3;173;379;379;4;2;6;8;12;268;8;296;4;5;0
/org.eclipse.ui.ide/src/org/eclipse/ui/wizards/datatransfer/ZipFileExportWizard.java;2;0;3;1;0;0;0;3;17;2;2;92;17;17;2;1;0;3;3;132;1;132;2;2;0
/org.eclipse.osgi/defaultAdaptor/src/org/eclipse/osgi/framework/adaptor/core/BundleEntry.java;3;4;7;3;5;2;5;2;34;0;1;239;49;49;4;1;3;2;7;272;4;295;3;3;0
/org.eclipse.jdt.ui/core refactoring/org/eclipse/jdt/internal/corext/refactoring/util/StatementAnalyzer.java;2;0;4;1;1;1;1;3;6;1;3;57;16;16;1;0;0;3;4;57;0;336;4;2;0
/org.eclipse.core.expressions/src/org/eclipse/core/internal/expressions/Assert.java;1;0;2;1;1;1;1;1;2;0;1;227;2;2;1;0;0;1;2;227;0;336;2;1;0
/org.eclipse.ant.ui/Ant Editor/org/eclipse/ant/internal/ui/editor/templates/AntVariableResolver.java;1;0;2;1;1;1;1;1;4;0;1;263;4;4;1;0;0;1;2;263;0;336;2;1;0
/org.eclipse.core.filebuffers/src/org/eclipse/core/internal/filebuffers/ResourceTextFileBuffer.java;3;2;9;2;5;3;5;4;176;2;3;130;395;395;2;1;2;4;9;243;3;331;6;3;0
/org.eclipse.jdt.ui/core extension/org/eclipse/jdt/internal/corext/textmanipulation/TextBufferEditor.java;2;0;9;1;1;1;1;8;330;6;3;96;393;393;6;5;0;8;9;112;5;336;4;2;0
/org.eclipse.jdt.debug.ui/ui/org/eclipse/jdt/internal/debug/ui/StatusDialog.java;2;0;2;1;1;1;1;1;4;0;1;197;4;4;1;0;0;1;2;197;0;336;2;2;0
/org.eclipse.pde.ui/src_Forms/org/eclipse/pde/internal/ui/model/build/BuildModelFactory.java;2;1;3;1;3;3;3;0;10;0;0;285;14;14;1;0;0;0;3;285;0;336;3;2;0
/org.eclipse.ui.workbench/Eclipse UI/org/eclipse/ui/application/IActionBarConfigurer.java;4;1;8;3;2;2;2;6;119;3;4;134;239;239;3;2;0;6;8;174;2;336;6;4;0
/org.eclipse.ui.workbench/Eclipse UI/org/eclipse/ui/SubActionBars.java;5;0;7;2;3;1;3;4;8;2;3;13;27;27;3;1;2;4;7;326;3;326;4;5;0
/org.eclipse.ui.workbench/Eclipse UI/org/eclipse/ui/internal/dialogs/PerspectivesPreferencePage.java;3;3;6;2;4;2;4;2;162;0;1;157;238;238;3;1;2;2;6;287;3;336;3;3;1
/org.eclipse.jdt.core/compiler/org/eclipse/jdt/internal/compiler/env/NameEnvironmentAnswer.java;2;0;2;1;1;1;1;1;12;0;1;199;14;14;1;0;0;1;2;199;0;314;2;2;0
/org.eclipse.core.resources/src/org/eclipse/core/internal/utils/Assert.java;1;0;2;1;1;1;1;1;153;0;1;173;163;163;1;0;0;1;2;173;0;277;2;1;0
/org.eclipse.ui.forms/src/org/eclipse/ui/forms/widgets/AbstractHyperlink.java;1;1;5;1;2;2;2;3;44;2;2;225;64;64;2;1;0;3;5;225;1;312;4;1;0
/org.eclipse.jface/src/org/eclipse/jface/window/ApplicationWindow.java;7;1;13;2;3;3;3;10;159;3;5;55;351;351;3;5;0;10;13;55;5;336;8;7;0
/org.eclipse.pde.ui/src/org/eclipse/pde/internal/ui/parts/ModifiedTextCellEditor.java;2;1;2;1;2;2;2;0;4;0;0;308;6;6;1;0;0;0;2;308;0;336;2;2;0
/org.eclipse.jdt.ui/ui/org/eclipse/jdt/internal/ui/preferences/TodoTaskInputDialog.java;1;0;1;1;1;1;1;0;2;0;0;336;2;2;1;0;0;0;1;336;0;336;1;1;0
/org.eclipse.ui.workbench/Eclipse UI/org/eclipse/ui/internal/FastViewPane.java;7;8;25;6;10;2;10;15;813;13;3;205;1372;1372;13;12;8;15;25;239;20;330;5;7;1
/org.eclipse.jdt.ui/ui/org/eclipse/jdt/internal/ui/actions/FindExceptionOccurrences.java;2;1;3;1;2;2;2;1;4;0;1;209;6;6;1;0;0;1;3;209;0;336;3;2;0
/org.eclipse.jdt.core/compiler/org/eclipse/jdt/internal/compiler/ast/JavadocArraySingleTypeReference.java;3;0;5;2;0;0;0;5;14;2;3;165;22;22;2;2;0;5;5;165;2;199;3;3;0
/org.eclipse.ui.ide/src/org/eclipse/ui/views/framelist/FrameAction.java;1;0;1;1;0;0;0;1;0;0;1;129;0;0;1;0;0;1;1;129;0;129;1;1;0
/org.eclipse.jdt.core/compiler/org/eclipse/jdt/internal/compiler/ast/JavadocMessageSend.java;4;0;11;3;2;1;2;9;82;5;4;165;154;154;5;5;1;9;11;165;6;324;5;4;0
/org.eclipse.debug.ui/ui/org/eclipse/debug/internal/ui/actions/DebugContextualLaunchAction.java;1;0;1;1;1;1;1;0;0;0;0;295;0;0;1;0;0;0;1;295;0;295;1;1;0
/org.eclipse.pde.core/src/org/eclipse/pde/internal/core/site/WorkspaceSiteBuildModel.java;3;1;5;1;3;3;3;2;12;1;2;145;30;30;1;0;0;2;5;145;0;336;5;3;0
/org.eclipse.jdt.ui/core refactoring/org/eclipse/jdt/internal/corext/refactoring/rename/RenameSourceFolderProcessor.java;2;2;16;1;4;3;4;12;76;5;7;71;123;123;5;5;1;12;16;247;6;336;10;2;0
/org.eclipse.jdt.core/compiler/org/eclipse/jdt/internal/compiler/parser/ParserBasicInformation.java;3;0;7;2;0;0;0;7;117;3;5;51;203;203;3;2;0;7;7;51;2;199;5;3;4
/org.eclipse.jdt.ui/ui/org/eclipse/jdt/internal/ui/search/SearchParticipantsExtensionPoint.java;2;1;2;1;2;2;2;0;10;0;0;299;10;10;1;0;0;0;2;299;0;336;2;2;0
/org.eclipse.update.ui/src/org/eclipse/update/internal/ui/wizards/DuplicateConflictsDialog.java;3;0;3;3;0;0;0;3;251;0;1;50;251;251;3;2;0;3;3;50;2;50;1;3;0
/org.eclipse.jdt.ui/ui refactoring/org/eclipse/jdt/internal/ui/refactoring/actions/RefactoringActions.java;2;0;2;1;1;1;1;1;2;0;1;183;2;2;1;0;0;1;2;183;0;336;2;2;0
/org.eclipse.ui.cheatsheets/src/org/eclipse/ui/internal/cheatsheets/registry/CheatSheetRegistryReader.java;2;2;9;2;4;3;4;5;91;3;3;243;268;268;3;2;1;5;9;253;3;306;6;2;0
/org.eclipse.core.resources/src/org/eclipse/core/internal/localstore/FileSystemStore.java;3;0;6;1;1;1;1;5;694;2;4;7;729;729;2;1;0;5;6;100;1;277;5;3;0
/org.eclipse.osgi/defaultAdaptor/src/org/eclipse/osgi/framework/adaptor/core/AdaptorElementFactory.java;2;0;2;1;1;1;1;1;4;0;1;239;4;4;1;0;0;1;2;239;0;276;2;2;0
/org.eclipse.text/src/org/eclipse/text/edits/MultiTextEdit.java;2;1;7;1;3;3;3;4;83;3;2;118;133;133;3;2;0;4;7;118;2;336;5;2;0
/org.eclipse.jdt.ui/ui/org/eclipse/jdt/internal/ui/viewsupport/IProblemChangedListener.java;1;0;1;1;1;1;1;0;2;0;0;336;2;2;1;0;0;0;1;336;0;336;1;1;0
/org.eclipse.swt/Eclipse SWT PI/common_j2se/org/eclipse/swt/internal/Library.java;5;0;62;3;7;1;15;47;48;18;5;16;150;150;18;42;14;55;62;214;56;320;6;5;0
/org.eclipse.jdt.core/compiler/org/eclipse/jdt/internal/compiler/lookup/ReferenceBinding.java;3;1;7;1;2;2;2;5;190;1;5;6;220;220;1;0;0;5;7;6;0;312;7;3;1
/org.eclipse.ui.workbench/Eclipse UI/org/eclipse/ui/internal/contexts/Persistence.java;3;1;16;2;3;3;3;13;265;6;6;75;656;656;6;7;0;13;16;75;7;336;9;3;0
/org.eclipse.osgi/core/framework/org/eclipse/osgi/framework/internal/core/StartLevelManager.java;4;2;6;2;6;4;6;0;275;0;0;276;368;368;2;0;2;0;6;276;2;326;4;4;1
/org.eclipse.update.ui/src/org/eclipse/update/internal/ui/model/UIModelObject.java;1;0;1;1;0;0;0;1;4;0;1;58;4;4;1;0;0;1;1;58;0;58;1;1;0
/org.eclipse.pde.core/src/org/eclipse/pde/internal/core/plugin/WorkspacePluginModelBase.java;3;1;5;1;2;2;2;3;12;1;3;55;31;31;1;0;0;3;5;55;0;336;5;3;0
/org.eclipse.pde/src/org/eclipse/pde/internal/builders/ExtensionPointSchemaBuilder.java;3;1;15;2;3;3;3;12;156;3;8;62;350;350;3;4;0;12;15;123;4;336;11;3;0
/org.eclipse.help.webapp/src_servlets/org/eclipse/help/internal/webapp/data/BookmarksData.java;1;1;8;1;3;3;3;5;48;1;5;8;165;165;1;0;0;5;8;8;0;336;8;1;0
/org.eclipse.ui.workbench/Eclipse UI/org/eclipse/ui/internal/layout/CellLayoutUtil.java;1;0;1;1;1;1;1;0;0;0;0;271;0;0;1;0;0;0;1;271;0;271;1;1;0
/org.eclipse.team.ui/src/org/eclipse/team/internal/ui/registry/SynchronizeParticipantDescriptor.java;2;2;9;1;3;2;3;6;133;3;4;150;243;243;3;2;1;6;9;150;3;336;6;2;1
/org.eclipse.swt/Eclipse SWT/carbon/org/eclipse/swt/widgets/Scrollable.java;4;2;9;1;4;3;4;5;14;1;5;0;43;43;2;0;1;5;9;313;1;337;8;4;0
/org.eclipse.ui.workbench/Eclipse UI/org/eclipse/ui/part/IShowInTargetList.java;1;0;1;1;0;0;0;1;4;0;1;0;4;4;1;0;0;1;1;0;0;0;1;1;0
/org.eclipse.ui.workbench/Eclipse UI/org/eclipse/ui/internal/SaveAction.java;3;0;4;1;1;1;1;3;26;1;3;157;51;51;1;0;0;3;4;157;0;336;4;3;0
/org.eclipse.osgi/core/framework/org/eclipse/osgi/framework/internal/core/BundleLoaderProxy.java;6;0;19;3;3;1;8;11;102;8;5;171;256;256;8;6;7;16;19;267;13;290;6;6;0
/org.eclipse.jdt.ui/ui/org/eclipse/jdt/internal/ui/text/JavaHeuristicScanner.java;2;1;6;1;2;2;2;4;106;1;4;117;153;153;1;0;0;4;6;117;0;336;6;2;0
/org.eclipse.ant.ui/Ant Tools Support/org/eclipse/ant/internal/ui/model/AntUIPlugin.java;3;0;14;2;5;1;5;9;75;3;5;108;121;121;5;4;4;9;14;294;8;294;6;3;2
/org.eclipse.debug.ui/ui/org/eclipse/debug/internal/ui/views/console/ConsoleDocument.java;2;0;2;1;0;0;0;2;9;1;2;38;11;11;1;0;0;2;2;38;0;103;2;2;1
/org.eclipse.swt/Eclipse SWT/photon/org/eclipse/swt/widgets/FontDialog.java;4;1;6;2;2;2;2;4;44;2;3;12;98;98;2;1;0;4;6;12;1;337;5;4;0
/org.eclipse.osgi/resolver/src/org/eclipse/core/internal/dependencies/SatisfactionVisitor.java;4;2;4;2;3;2;3;1;27;0;1;171;29;29;2;0;1;1;4;276;1;290;3;4;0
/org.eclipse.jdt.ui/ui/org/eclipse/jdt/internal/ui/text/correction/ContributedProcessorDescriptor.java;3;0;9;1;1;1;1;8;47;2;6;75;144;144;2;2;0;8;9;75;2;336;7;3;0
/org.eclipse.ltk.core.refactoring/src/org/eclipse/ltk/core/refactoring/IUndoManager.java;1;3;8;1;5;3;5;3;33;0;1;264;59;59;3;2;2;3;8;264;4;336;4;1;0
/org.eclipse.pde.ui/src/org/eclipse/pde/internal/ui/preferences/BuildOptionsPreferenceNode.java;2;1;3;1;2;2;2;1;10;0;1;222;14;14;1;0;0;1;3;222;0;336;3;2;0
/org.eclipse.jdt.ui/ui/org/eclipse/jdt/ui/actions/WriteReferencesSearchGroup.java;3;1;5;1;2;2;2;3;11;1;3;82;24;24;1;0;0;3;5;82;0;336;5;3;0
/org.eclipse.text/src/org/eclipse/jface/text/templates/Template.java;2;0;4;2;2;1;2;2;103;1;2;234;110;110;2;0;1;2;4;334;1;334;3;2;0
/org.eclipse.debug.ui/ui/org/eclipse/debug/internal/ui/actions/CopyToClipboardActionDelegate.java;2;0;2;2;0;0;0;2;86;0;1;147;86;86;2;1;0;2;2;147;1;147;1;2;0
/org.eclipse.osgi/core/adaptor/org/eclipse/osgi/framework/adaptor/EventPublisher.java;4;1;4;1;2;2;2;2;4;1;2;171;9;9;1;0;0;2;4;171;0;336;4;4;0
/org.eclipse.search/search/org/eclipse/search/internal/ui/text/ReplaceDialog2.java;2;4;13;2;9;3;9;4;1134;3;2;224;1446;1446;4;2;6;4;13;325;8;325;5;2;1
/org.eclipse.swt/Eclipse SWT/photon/org/eclipse/swt/widgets/Control.java;7;1;25;3;5;5;5;20;75;3;13;0;302;302;3;7;0;20;25;0;7;337;18;7;0
/org.eclipse.core.runtime/src/org/eclipse/core/runtime/MultiStatus.java;3;0;6;2;2;1;2;4;560;3;2;81;800;800;3;2;1;4;6;171;3;274;3;3;0
/org.eclipse.ant.ui/Ant Editor/org/eclipse/ant/internal/ui/editor/text/AntEditorPartitionScanner.java;1;1;4;1;2;2;2;2;21;1;2;108;39;39;1;0;0;2;4;108;0;321;4;1;0
/org.eclipse.jdt.ui/core extension/org/eclipse/jdt/internal/corext/dom/TokenScanner.java;2;0;10;1;1;1;1;9;161;5;4;9;484;484;5;5;0;9;10;156;5;336;5;2;0
/org.eclipse.ui.cheatsheets/src/org/eclipse/ui/internal/cheatsheets/actions/CheatSheetMenu.java;2;0;5;2;2;1;2;3;61;2;2;243;72;72;2;1;1;3;5;253;2;306;3;2;0
/org.eclipse.core.resources/src/org/eclipse/core/internal/dtree/AbstractDataTree.java;1;0;1;1;1;1;1;0;590;0;0;277;590;590;1;0;0;0;1;277;0;277;1;1;0
/org.eclipse.ui.workbench/Eclipse UI/org/eclipse/ui/internal/dialogs/NewWizardNewPage.java;5;3;18;3;5;3;7;11;1489;11;3;157;2223;2223;11;8;4;13;18;239;12;326;6;5;3
/org.eclipse.team.cvs.ui/src/org/eclipse/team/internal/ccvs/ui/operations/CheckoutOperation.java;2;0;10;2;1;1;1;9;65;4;6;20;166;166;4;3;0;9;10;63;3;336;7;2;0
/org.eclipse.jdt.ui/ui/org/eclipse/jdt/ui/actions/SortMembersAction.java;4;2;11;2;4;3;4;7;33;1;7;41;99;99;2;0;1;7;11;314;1;336;10;4;0
/org.eclipse.jdt.ui/ui/org/eclipse/jdt/internal/ui/text/java/ProposalInfo.java;1;0;1;1;1;1;1;0;2;0;0;336;2;2;1;0;0;0;1;336;0;336;1;1;0
/org.eclipse.pde.ui/src/org/eclipse/pde/internal/ui/wizards/exports/BaseExportWizardPage.java;3;3;17;2;6;4;6;11;474;2;8;99;1163;1163;3;3;2;11;17;304;5;336;12;3;0
/org.eclipse.search/search/org/eclipse/search/internal/ui/SearchPreferencePage.java;2;2;4;1;3;2;3;1;208;0;1;147;227;227;2;0;1;1;4;313;1;336;3;2;0
/org.eclipse.update.scheduler/src/org/eclipse/update/internal/scheduler/AutomaticUpdatesJob.java;3;3;19;3;4;2;4;15;106;6;7;62;285;285;6;8;2;15;19;73;10;336;9;3;1
/org.eclipse.search/search/org/eclipse/search/internal/ui/text/FileTreeContentProvider.java;2;0;5;1;1;1;1;4;94;2;3;207;108;108;2;1;0;4;5;239;1;336;4;2;0
/org.eclipse.core.runtime/src/org/eclipse/core/runtime/IProductProvider.java;1;0;3;1;2;1;2;1;6;0;1;224;6;6;2;0;1;1;3;272;1;272;2;1;0
/org.eclipse.ui.workbench/Eclipse UI/org/eclipse/ui/progress/DeferredTreeContentManager.java;2;4;23;2;7;3;7;16;279;4;7;67;1023;1023;4;9;4;16;23;67;13;330;10;2;2
/org.eclipse.swt/Eclipse SWT PI/gtk/org/eclipse/swt/internal/gtk/GdkGCValues.java;3;0;4;1;1;1;1;3;17;2;2;100;31;31;2;1;0;3;4;226;1;337;3;3;0
/org.eclipse.ui.intro/src/org/eclipse/ui/internal/intro/impl/model/viewer/IntroModelLabelProvider.java;1;4;6;1;6;2;6;0;45;0;0;276;55;55;4;0;4;0;6;276;4;301;2;1;0
/org.eclipse.ui.workbench/Eclipse UI/org/eclipse/ui/internal/Workbench.java;8;0;109;6;5;1;16;93;7677;48;7;36;11089;11089;48;86;15;104;109;103;101;324;8;8;9
/org.eclipse.jdt.launching/launching/org/eclipse/jdt/launching/sourcelookup/IJavaSourceLocation.java;2;1;2;1;2;2;2;0;8;0;0;273;12;12;1;0;0;0;2;273;0;336;2;2;0
/org.eclipse.swt/Eclipse SWT PI/win32/org/eclipse/swt/internal/win32/OSVERSIONINFO.java;2;0;2;1;0;0;0;2;8;1;2;61;9;9;1;0;0;2;2;61;0;166;2;2;0
/org.eclipse.jdt.debug/model/org/eclipse/jdt/internal/debug/core/logicalstructures/CompositeStructureType.java;1;0;1;1;0;0;0;1;0;0;1;155;0;0;1;0;0;1;1;155;0;155;1;1;0
/org.eclipse.jdt.core/compiler/org/eclipse/jdt/internal/compiler/impl/ITypeRequestor.java;1;0;1;1;0;0;0;1;2;0;1;199;2;2;1;0;0;1;1;199;0;199;1;1;0
/org.eclipse.osgi/core/framework/org/eclipse/osgi/framework/internal/core/KeyedElement.java;4;1;4;1;2;2;2;2;6;1;2;171;14;14;1;0;0;2;4;171;0;336;4;4;0
/org.eclipse.ui.workbench/Eclipse UI/org/eclipse/ui/internal/PartSashContainer.java;6;3;21;3;8;4;12;9;772;9;4;212;1108;1108;9;5;8;13;21;252;13;336;8;6;6
/org.eclipse.ui.workbench/Eclipse UI/org/eclipse/ui/internal/contexts/AbstractContextRegistry.java;1;0;5;1;0;0;0;5;52;2;4;85;86;86;2;1;0;5;5;85;1;174;4;1;0
/org.eclipse.ui.ide/extensions/org/eclipse/ui/actions/OpenResourceAction.java;1;0;1;1;0;0;0;1;0;0;1;132;0;0;1;0;0;1;1;132;0;132;1;1;0
/org.eclipse.swt/Eclipse SWT/photon/org/eclipse/swt/widgets/Widget.java;3;1;11;1;2;2;2;9;185;3;4;18;432;432;3;5;0;9;11;124;5;337;6;3;1
/org.eclipse.jdt.ui/ui/org/eclipse/jdt/internal/ui/preferences/CompilerPreferencePage.java;1;0;1;1;1;1;1;0;2;0;0;336;2;2;1;0;0;0;1;336;0;336;1;1;0
/org.eclipse.jdt.ui/ui/org/eclipse/jdt/ui/search/IQueryParticipant.java;4;2;5;3;5;3;5;0;54;0;0;274;69;69;2;0;2;0;5;274;2;335;3;4;0
/org.eclipse.pde.ui/src/org/eclipse/pde/internal/ui/editor/schema/TypeRestrictionDialog.java;2;1;3;1;2;2;2;1;6;0;1;44;13;13;1;0;0;1;3;44;0;336;3;2;0
/org.eclipse.swt/Eclipse SWT PI/win32/org/eclipse/swt/internal/win32/NOTIFYICONDATA.java;3;0;3;2;1;1;1;2;28;0;1;244;34;34;2;1;0;2;3;244;1;337;2;3;0
/org.eclipse.jdt.ui/ui refactoring/org/eclipse/jdt/internal/ui/refactoring/ExtractTempWizard.java;4;1;7;1;2;2;3;4;143;2;4;36;182;182;2;0;1;5;7;269;1;336;6;4;0
/org.eclipse.pde.ui/src/org/eclipse/pde/internal/ui/wizards/templates/PerspectiveExtensionsTemplate.java;3;1;4;1;2;2;2;2;118;0;1;128;127;127;2;1;0;2;4;128;1;336;3;3;0
/org.eclipse.team.core/src/org/eclipse/team/internal/core/DefaultProjectSetCapability.java;1;0;2;1;0;0;0;2;26;0;1;265;26;26;2;1;0;2;2;265;1;265;1;1;0
/org.eclipse.swt/Eclipse SWT/emulated/treetable/org/eclipse/swt/widgets/Tree.java;5;2;10;2;7;4;7;3;24;1;3;19;86;86;2;0;3;3;10;299;3;332;7;5;1
/org.eclipse.jdt.ui/ui/org/eclipse/jdt/internal/ui/javaeditor/ClassFileMarkerRulerAction.java;1;0;1;1;1;1;1;0;2;0;0;336;2;2;1;0;0;0;1;336;0;336;1;1;0
/org.eclipse.ui.workbench/Eclipse UI/org/eclipse/ui/internal/gestures/Point.java;1;0;3;1;0;0;0;3;18;1;3;104;32;32;1;0;0;3;3;104;0;161;3;1;0
/org.eclipse.jdt.core/compiler/org/eclipse/jdt/internal/compiler/lookup/ProblemBinding.java;1;0;1;1;0;0;0;1;2;0;1;199;2;2;1;0;0;1;1;199;0;199;1;1;0
/org.eclipse.swt/Eclipse SWT/win32/org/eclipse/swt/graphics/Color.java;1;1;2;1;2;2;2;0;5;0;0;299;9;9;1;0;0;0;2;299;0;337;2;1;1
/org.eclipse.jdt.core/model/org/eclipse/jdt/internal/core/builder/ClasspathLocation.java;3;0;3;2;0;0;0;3;4;1;3;113;10;10;1;0;0;3;3;113;0;266;3;3;0
/org.eclipse.ui.ide/extensions/org/eclipse/ui/dialogs/WizardNewProjectCreationPage.java;1;0;1;1;0;0;0;1;0;0;1;132;0;0;1;0;0;1;1;132;0;132;1;1;0
/org.eclipse.jdt.debug.ui/ui/org/eclipse/jdt/internal/debug/core/refactoring/JavaMethodBreakpointIMethodRenameParticipant.java;3;0;3;2;1;1;1;2;42;0;1;266;50;50;2;1;0;2;3;266;1;336;2;3;0
/org.eclipse.jface.text/src/org/eclipse/jface/text/presentation/IPresentationReconcilerExtension.java;3;0;3;2;2;1;2;1;24;0;1;92;24;24;2;0;1;1;3;336;1;336;2;3;0
/org.eclipse.jface.text/src/org/eclipse/jface/internal/text/link/contentassist/Helper2.java;2;0;2;1;1;1;1;1;2;0;1;232;2;2;1;0;0;1;2;232;0;336;2;2;0
/org.eclipse.jface.text/src/org/eclipse/jface/text/IEventConsumer.java;2;0;3;2;2;1;2;1;23;0;1;132;25;25;2;0;1;1;3;336;1;336;2;2;0
/org.eclipse.jface.text/src/org/eclipse/jface/text/reconciler/MonoReconciler.java;2;0;3;1;2;1;2;1;21;0;1;92;23;23;2;0;1;1;3;336;1;336;2;2;0
/org.eclipse.jdt.core/model/org/eclipse/jdt/internal/core/CompilationUnitProblemFinder.java;4;1;17;2;2;2;2;15;69;4;10;10;160;160;4;5;0;15;17;254;5;314;12;4;1
/org.eclipse.jdt.ui/ui/org/eclipse/jdt/ui/actions/OpenJavaPerspectiveAction.java;1;0;1;1;1;1;1;0;2;0;0;336;2;2;1;0;0;0;1;336;0;336;1;1;0
/org.eclipse.jdt.ui/ui/org/eclipse/jdt/internal/ui/filters/OutputFolderFilter.java;2;0;2;2;1;1;1;1;6;0;1;166;6;6;1;0;0;1;2;166;0;336;2;2;0
/org.eclipse.debug.core/core/org/eclipse/debug/internal/core/BreakpointManager.java;4;0;11;3;5;1;5;6;90;2;4;18;196;196;5;2;4;6;11;287;6;287;5;4;1
/org.eclipse.jdt.ui/ui/org/eclipse/jdt/internal/ui/javadocexport/JavadocWriter.java;2;0;4;1;1;1;1;3;47;1;3;142;97;97;1;0;0;3;4;142;0;336;4;2;0
/org.eclipse.ui.workbench.texteditor/src/org/eclipse/ui/internal/texteditor/AnnotationExpandHover.java;3;3;7;2;4;2;4;3;281;1;3;147;419;419;3;0;2;3;7;275;2;336;5;3;0
/org.eclipse.swt/Eclipse SWT Accessibility/common/org/eclipse/swt/accessibility/AccessibleTextAdapter.java;1;0;1;1;0;0;0;1;0;0;1;131;0;0;1;0;0;1;1;131;0;131;1;1;0
/org.eclipse.ui.externaltools/External Tools Base/org/eclipse/ui/externaltools/internal/launchConfigurations/WorkingSetComparator.java;2;1;5;1;2;2;2;3;44;1;3;26;61;61;1;0;0;3;5;26;0;336;5;2;0
/org.eclipse.text/src/org/eclipse/text/edits/TreeIterationInfo.java;2;0;2;1;1;1;1;1;2;0;1;118;2;2;1;0;0;1;2;118;0;336;2;2;0
/org.eclipse.jdt.core/model/org/eclipse/jdt/internal/compiler/IDocumentElementRequestor.java;2;0;2;1;1;1;1;1;2;0;1;245;2;2;1;0;0;1;2;245;0;314;2;2;0
/org.eclipse.ui.ide/src/org/eclipse/ui/wizards/datatransfer/SelectFilesOperation.java;1;0;1;1;0;0;0;1;0;0;1;92;0;0;1;0;0;1;1;92;0;92;1;1;0
/org.eclipse.ui.ide/src/org/eclipse/ui/views/framelist/ForwardAction.java;3;0;4;1;1;1;1;3;4;1;3;129;9;9;1;0;0;3;4;129;0;336;4;3;0
/org.eclipse.jdt.debug/eval/org/eclipse/jdt/internal/debug/eval/ast/instructions/Cast.java;1;0;1;1;0;0;0;1;5;0;1;76;5;5;1;0;0;1;1;76;0;76;1;1;0
/org.eclipse.team.cvs.core/src/org/eclipse/team/internal/ccvs/core/client/listeners/CompareDiffListener.java;2;0;4;1;1;1;1;3;118;2;2;143;139;139;2;1;0;3;4;143;1;336;3;2;0
/org.eclipse.ui.ide/src/org/eclipse/ui/internal/ide/model/WorkbenchRootResource.java;3;1;4;1;2;2;2;2;4;1;2;132;7;7;1;0;0;2;4;132;0;336;4;3;0
/org.eclipse.jdt.core/compiler/org/eclipse/jdt/internal/compiler/parser/RecoveredStatement.java;3;0;4;2;0;0;0;4;6;2;3;63;12;12;2;1;0;4;4;63;1;199;3;3;0
/org.eclipse.ui.ide/src/org/eclipse/ui/views/markers/internal/ActionDeleteCompleted.java;6;1;7;1;2;2;2;5;32;2;4;129;41;41;2;1;0;5;7;181;1;336;6;6;0
/org.eclipse.ui.workbench/Eclipse UI/org/eclipse/ui/internal/dialogs/DecoratorsPreferencePage.java;2;0;3;1;0;0;0;3;28;2;2;75;37;37;2;1;0;3;3;75;1;157;2;2;0
/org.eclipse.jface.text/src/org/eclipse/jface/text/DefaultInformationControl.java;2;2;11;2;3;2;3;8;185;3;4;82;275;275;3;4;1;8;11;82;5;336;6;2;0
/org.eclipse.jdt.debug.ui/ui/org/eclipse/jdt/internal/debug/ui/launcher/IClasspathViewer.java;2;0;3;1;1;1;1;2;86;1;2;154;105;105;1;0;0;2;3;154;0;336;3;2;0
/org.eclipse.jface.text/src/org/eclipse/jface/text/source/VisualAnnotationModel.java;2;0;6;2;2;1;2;4;49;2;3;81;71;71;2;1;1;4;6;81;2;336;4;2;0
/org.eclipse.ui.ide/src/org/eclipse/ui/internal/ide/StatusUtil.java;4;1;4;1;3;3;3;1;10;0;1;92;17;17;1;0;0;1;4;92;0;336;4;4;0
/org.eclipse.jdt.ui/ui/org/eclipse/jdt/internal/ui/preferences/SourceAttachmentPropertyPage.java;3;1;4;1;3;3;3;1;37;0;1;41;77;77;1;0;0;1;4;41;0;336;4;3;0
/org.eclipse.jdt.debug/model/org/eclipse/jdt/internal/debug/core/breakpoints/JavaClassPrepareBreakpoint.java;2;0;2;1;0;0;0;2;15;1;2;248;15;15;1;0;0;2;2;248;0;264;2;2;2
/org.eclipse.osgi/osgi/src/org/osgi/framework/Constants.java;5;3;15;3;6;2;6;9;380;6;4;171;723;723;6;5;4;9;15;224;9;292;6;5;0
/org.eclipse.update.core/src/org/eclipse/update/internal/core/SiteFilePackedPluginContentConsumer.java;2;0;2;1;1;1;1;1;19;0;1;238;19;19;1;0;0;1;2;238;0;302;2;2;0
/org.eclipse.jdt.ui/core refactoring/org/eclipse/jdt/internal/corext/refactoring/reorg/IReorgQueries.java;3;1;3;1;2;2;2;1;6;0;1;70;10;10;1;0;0;1;3;70;0;336;3;3;0
/org.eclipse.jdt.ui/ui/org/eclipse/jdt/internal/ui/browsing/JavaBrowsingPart.java;6;1;16;2;3;3;3;13;89;3;9;44;301;301;3;4;0;13;16;82;4;336;12;6;0
/org.eclipse.team.core/src/org/eclipse/team/core/TeamStatus.java;2;1;4;1;2;2;2;2;49;1;2;224;59;59;1;0;0;2;4;224;0;336;4;2;0
/org.eclipse.swt/Eclipse SWT Custom Widgets/common/org/eclipse/swt/custom/SashForm.java;4;1;8;1;2;2;2;6;62;2;4;9;161;161;2;2;0;6;8;141;2;337;6;4;0
/org.eclipse.ui.cheatsheets/src/org/eclipse/ui/internal/cheatsheets/data/ConditionalSubItem.java;1;1;2;1;2;2;2;0;25;0;0;279;25;25;1;0;0;0;2;279;0;300;2;1;0
/org.eclipse.jdt.core/compiler/org/eclipse/jdt/internal/compiler/ast/AbstractVariableDeclaration.java;2;0;4;1;0;0;0;4;53;1;4;1;89;89;1;0;0;4;4;1;0;199;4;2;0
/org.eclipse.debug.ui/ui/org/eclipse/debug/internal/ui/actions/RelaunchActionDelegate.java;1;0;1;1;0;0;0;1;9;0;1;104;9;9;1;0;0;1;1;104;0;104;1;1;1
/org.eclipse.core.runtime/src/org/eclipse/core/internal/runtime/AdapterFactoryProxy.java;2;1;4;1;2;2;2;2;16;1;2;228;48;48;1;0;0;2;4;228;0;300;4;2;0
/org.eclipse.jdt.core/model/org/eclipse/jdt/internal/core/BinaryMethod.java;4;2;14;2;4;3;4;10;108;1;10;7;254;254;2;0;1;10;14;272;1;330;13;4;2
/org.eclipse.help.base/src/org/eclipse/help/internal/workingset/AdaptableHelpResource.java;1;1;3;1;2;2;2;1;29;0;1;104;35;35;1;0;0;1;3;104;0;336;3;1;0
/org.eclipse.jdt.core/formatter/org/eclipse/jdt/internal/formatter/DefaultCodeFormatterOptions.java;4;2;32;3;4;3;4;28;3201;8;5;128;6393;6393;8;23;1;28;32;190;24;323;8;4;4
/org.eclipse.swt/Eclipse SWT PI/photon/org/eclipse/swt/internal/photon/PgAlpha_t.java;1;0;1;1;0;0;0;1;1;0;1;53;1;1;1;0;0;1;1;53;0;53;1;1;0
/org.eclipse.jdt.core/model/org/eclipse/jdt/core/util/IOpcodeMnemonics.java;1;0;1;1;0;0;0;1;2;0;1;199;2;2;1;0;0;1;1;199;0;199;1;1;0
/org.eclipse.jdt.debug.ui/ui/org/eclipse/jdt/internal/debug/ui/JavaVariableActionFilter.java;3;0;3;1;1;1;1;2;39;1;2;144;45;45;1;0;0;2;3;144;0;336;3;3;0
/org.eclipse.jdt.core/model/org/eclipse/jdt/internal/core/util/ConstantValueAttribute.java;1;0;1;1;0;0;0;1;2;0;1;199;2;2;1;0;0;1;1;199;0;199;1;1;0
/org.eclipse.jdt.debug/model/org/eclipse/jdt/internal/debug/core/breakpoints/JavaLineBreakpoint.java;4;0;12;4;3;1;3;9;216;2;6;25;256;256;3;3;2;9;12;325;5;325;7;4;3
/org.eclipse.jdt.core/model/org/eclipse/jdt/internal/core/hierarchy/RegionBasedHierarchyBuilder.java;3;0;10;2;0;0;0;10;184;3;6;5;302;302;3;4;0;10;10;195;4;195;6;3;0
/org.eclipse.jdt.ui/ui/org/eclipse/jdt/internal/ui/preferences/NewJavaProjectPreferencePage.java;2;1;5;1;2;2;2;3;28;1;3;82;41;41;1;0;0;3;5;82;0;336;5;2;0
/org.eclipse.jdt.ui/ui/org/eclipse/jdt/ui/actions/ShowInNavigatorViewAction.java;2;0;2;1;1;1;1;1;10;0;1;41;12;12;1;0;0;1;2;41;0;336;2;2;0
/org.eclipse.ui.cheatsheets/src/org/eclipse/ui/internal/cheatsheets/data/IActionItem.java;1;0;1;1;1;1;1;0;0;0;0;279;0;0;1;0;0;0;1;279;0;279;1;1;0
/org.eclipse.jdt.ui/ui/org/eclipse/jdt/internal/ui/text/spelling/SpellCheckEngine.java;3;1;4;2;2;2;2;2;25;0;1;219;29;29;2;1;0;2;4;219;1;336;3;3;1
/org.eclipse.jdt.ui/core refactoring/org/eclipse/jdt/internal/corext/refactoring/rename/RefactoringScanner.java;3;0;4;1;1;1;1;3;160;1;3;71;166;166;1;0;0;3;4;71;0;336;4;3;1
/org.eclipse.jdt.debug/model/org/eclipse/jdt/internal/debug/core/model/JDINullValue.java;1;0;1;1;0;0;0;1;3;0;1;144;3;3;1;0;0;1;1;144;0;144;1;1;0
/org.eclipse.pde.ui/src/org/eclipse/pde/internal/ui/editor/site/SiteUndoManager.java;2;1;6;1;3;3;3;3;42;1;3;117;113;113;1;0;0;3;6;117;0;336;6;2;0
/org.eclipse.jdt.debug.ui/ui/org/eclipse/jdt/internal/debug/core/refactoring/JDTDebugRefactoringUtil.java;2;2;3;1;3;2;3;0;8;0;0;295;12;12;2;0;1;0;3;295;1;336;2;2;0
/org.eclipse.jdt.ui/ui refactoring/org/eclipse/jdt/internal/ui/refactoring/RefactoringExecutionHelper.java;3;1;17;1;5;5;5;12;178;3;8;32;395;395;3;4;0;12;17;247;4;336;13;3;0
/org.eclipse.swt/Eclipse SWT Browser/mozilla/org/eclipse/swt/browser/Browser.java;2;7;42;2;11;4;12;30;844;9;8;100;2973;2973;9;22;8;31;42;153;30;331;12;2;0
/org.eclipse.team.cvs.ui/src/org/eclipse/team/internal/ccvs/ui/wizards/GenerateDiffFileOperation.java;1;0;2;1;0;0;0;2;18;1;2;57;31;31;1;0;0;2;2;57;0;68;2;1;1
/org.eclipse.pde.ui/src/org/eclipse/pde/internal/ui/wizards/feature/PatchPluginListPage.java;3;2;4;2;4;3;4;0;26;0;0;298;35;35;2;0;1;0;4;330;1;330;3;3;0
/org.eclipse.ui.workbench/Eclipse UI/org/eclipse/ui/IDecoratorManager.java;3;0;2;2;1;1;1;1;5;0;1;215;9;9;1;0;0;1;2;215;0;336;2;3;0
/org.eclipse.jdt.ui/ui/org/eclipse/jdt/internal/ui/text/correction/ConstructorFromSuperclassProposal.java;3;1;17;2;3;3;3;14;107;3;6;16;211;211;3;8;0;14;17;67;8;336;9;3;0
/org.eclipse.osgi/osgi/src/org/eclipse/osgi/service/resolver/BundleDescription.java;4;0;13;3;0;0;6;7;82;7;4;171;140;140;7;3;6;13;13;269;9;269;4;4;0
/org.eclipse.team.ui/src/org/eclipse/team/internal/ui/actions/ProgressDialogRunnableContext.java;2;0;4;1;1;1;1;3;125;2;2;225;224;224;2;1;0;3;4;225;1;336;3;2;0
/org.eclipse.ui.ide/src/org/eclipse/ui/views/navigator/ResourceNavigatorAction.java;1;0;1;1;0;0;0;1;0;0;1;129;0;0;1;0;0;1;1;129;0;129;1;1;0
/org.eclipse.team.ui/src/org/eclipse/team/ui/synchronize/ISynchronizeScope.java;2;1;2;1;2;2;2;0;65;0;0;299;74;74;1;0;0;0;2;299;0;335;2;2;1
/org.eclipse.swt/Eclipse SWT PI/gtk/org/eclipse/swt/internal/gtk/XClientMessageEvent.java;3;0;3;2;1;1;1;2;8;0;1;244;12;12;2;1;0;2;3;244;1;337;2;3;0
/org.eclipse.ui.ide/src/org/eclipse/ui/internal/ide/dialogs/ResourceInfoPage.java;4;2;6;2;5;4;5;1;239;0;1;132;368;368;2;0;1;1;6;281;1;336;5;4;3
/org.eclipse.team.cvs.core/src/org/eclipse/team/internal/ccvs/core/syncinfo/CVSDescendantResourceVariantByteStore.java;2;1;4;1;2;2;2;2;14;0;1;234;24;24;2;1;0;2;4;234;1;336;3;2;0
/org.eclipse.ui.workbench/Eclipse UI/org/eclipse/ui/internal/BrandingProperties.java;1;1;2;1;2;2;2;0;72;0;0;294;72;72;1;0;0;0;2;294;0;320;2;1;0
/org.eclipse.ui.ide/src/org/eclipse/ui/internal/ide/model/PropertyParser.java;5;1;6;2;2;2;2;4;34;2;3;165;69;69;2;1;0;4;6;165;1;336;5;5;0
/org.eclipse.swt/Eclipse SWT PI/gtk/org/eclipse/swt/internal/gtk/GdkEventWindowState.java;4;0;5;1;1;1;1;4;17;2;3;69;23;23;2;1;0;4;5;226;1;337;4;4;0
/org.eclipse.swt/Eclipse SWT PI/gtk/org/eclipse/swt/internal/gtk/GtkFileSelection.java;3;0;3;1;1;1;1;2;40;1;2;100;59;59;1;0;0;2;3;100;0;337;3;3;0
/org.eclipse.swt/Eclipse SWT PI/motif/org/eclipse/swt/internal/motif/XmTextBlockRec.java;1;0;1;1;0;0;0;1;6;0;1;54;6;6;1;0;0;1;1;54;0;54;1;1;0
/org.eclipse.jdt.ui/core refactoring/org/eclipse/jdt/internal/corext/refactoring/changes/MoveCompilationUnitChange.java;3;1;5;1;2;2;2;3;27;1;3;41;69;69;1;0;0;3;5;41;0;336;5;3;0
/org.eclipse.ltk.core.refactoring/src/org/eclipse/ltk/internal/core/refactoring/ParticipantDescriptor.java;1;1;3;1;2;2;2;1;8;0;1;267;12;12;1;0;0;1;3;267;0;336;3;1;0
/org.eclipse.swt/Eclipse SWT Drag and Drop/photon/org/eclipse/swt/dnd/DragSource.java;2;0;2;1;0;0;0;2;4;1;2;0;8;8;1;0;0;2;2;0;0;19;2;2;0
/org.eclipse.osgi/defaultAdaptor/src/org/eclipse/osgi/framework/adaptor/core/BundleURLConnection.java;2;3;7;1;4;2;4;3;102;2;2;239;126;126;3;1;2;3;7;295;3;295;4;2;0
/org.eclipse.update.core/src/org/eclipse/update/internal/core/OtherResponse.java;2;1;3;1;2;2;2;1;4;0;1;175;6;6;1;0;0;1;3;175;0;336;3;2;0
/org.eclipse.jdt.core/model/org/eclipse/jdt/internal/core/Assert.java;2;0;3;1;0;0;0;3;4;1;3;80;8;8;1;0;0;3;3;80;0;199;3;2;0
/org.eclipse.jdt.debug/eval/org/eclipse/jdt/internal/debug/eval/ast/instructions/InstanceOfOperator.java;2;0;2;2;0;0;0;2;5;0;1;76;5;5;2;1;0;2;2;76;1;76;1;2;0
/org.eclipse.team.cvs.ui/src/org/eclipse/team/internal/ccvs/ui/CVSFilePropertiesPage.java;2;0;3;1;0;0;0;3;14;1;3;20;18;18;1;0;0;3;3;20;0;138;3;2;0
/org.eclipse.team.cvs.ui/src/org/eclipse/team/internal/ccvs/ui/repo/RemoteProjectsView.java;2;0;2;2;0;0;0;2;6;0;1;52;6;6;2;1;0;2;2;52;1;52;1;2;0
/org.eclipse.ui.forms/src/org/eclipse/ui/forms/editor/FormEditor.java;1;3;14;1;4;2;6;8;204;5;3;225;433;433;5;5;4;10;14;239;9;336;5;1;0
/org.eclipse.ui.workbench/Eclipse UI/org/eclipse/ui/actions/PerspectiveMenu.java;6;0;12;2;1;1;1;11;100;3;8;0;214;214;3;3;0;11;12;166;3;336;9;6;2
/org.eclipse.team.core/src/org/eclipse/team/core/synchronize/ISyncInfoSetChangeEvent.java;2;2;5;1;3;2;3;2;68;1;2;224;82;82;2;0;1;2;5;335;1;335;4;2;0
/org.eclipse.text/src/org/eclipse/jface/text/templates/TemplateVariableResolver.java;2;0;7;2;2;1;2;5;115;0;1;241;124;124;5;4;1;5;7;241;5;334;2;2;0
/org.eclipse.core.filebuffers/src/org/eclipse/core/internal/filebuffers/ExtensionsRegistry.java;2;5;10;2;8;3;8;2;452;1;2;93;605;605;5;0;5;2;10;280;5;336;5;2;0
/org.eclipse.pde.core/src/org/eclipse/pde/internal/core/schema/SchemaSimpleType.java;2;1;3;1;2;2;2;1;6;0;1;232;14;14;1;0;0;1;3;232;0;336;3;2;0
/org.eclipse.ui.workbench.texteditor/src/org/eclipse/ui/texteditor/IEditorStatusLine.java;1;0;1;1;1;1;1;0;4;0;0;336;4;4;1;0;0;0;1;336;0;336;1;1;0
/org.eclipse.ui.workbench.texteditor/src/org/eclipse/ui/texteditor/FindNextAction.java;3;1;7;2;3;3;3;4;112;2;3;97;154;154;2;1;0;4;7;125;1;336;6;3;0
/org.eclipse.pde.build/src/org/eclipse/pde/internal/build/builder/ModelBuildScriptGenerator.java;2;13;31;2;16;2;16;15;453;4;8;31;915;915;13;7;14;15;31;287;21;287;10;2;0
/org.eclipse.jdt.ui/ui/org/eclipse/jdt/internal/ui/javaeditor/EditorUtility.java;3;1;9;1;2;2;2;7;88;2;6;41;255;255;2;1;0;7;9;41;1;336;8;3;1
/org.eclipse.ant.ui/Ant Editor/org/eclipse/ant/internal/ui/dtd/schema/Attribute.java;1;0;1;1;0;0;0;1;0;0;1;108;0;0;1;0;0;1;1;108;0;108;1;1;0
/org.eclipse.help.base/src/org/eclipse/help/internal/search/LazyProgressMonitor.java;1;1;3;1;2;2;2;1;14;0;1;104;20;20;1;0;0;1;3;104;0;336;3;1;0
/org.eclipse.ltk.core.refactoring/src/org/eclipse/ltk/core/refactoring/participants/MoveParticipant.java;1;1;4;1;2;2;2;2;19;0;1;264;42;42;2;1;0;2;4;264;1;336;3;1;0
/org.eclipse.team.core/src/org/eclipse/team/internal/core/subscribers/SyncSetChangedEvent.java;2;0;4;1;1;1;1;3;104;1;3;199;136;136;1;0;0;3;4;199;0;336;4;2;0
/org.eclipse.osgi/defaultAdaptor/src/org/eclipse/osgi/framework/adaptor/core/ServiceRegistryImpl.java;2;1;3;1;2;2;2;1;127;0;1;239;144;144;1;0;0;1;3;239;0;296;3;2;0
/org.eclipse.core.resources/src/org/eclipse/core/resources/IFileState.java;2;0;4;1;0;0;1;3;145;2;3;3;151;151;2;0;1;4;4;270;1;270;3;2;0
/org.eclipse.ui.workbench/Eclipse UI/org/eclipse/ui/presentations/IPartMenu.java;1;0;2;1;1;1;1;1;2;0;1;257;2;2;1;0;0;1;2;257;0;321;2;1;0
/org.eclipse.ui.intro/src/org/eclipse/ui/internal/intro/impl/model/IntroModelRoot.java;2;11;19;2;19;3;19;0;493;0;0;276;634;634;11;0;16;0;19;296;16;327;3;2;0
/org.eclipse.pde.ui/src/org/eclipse/pde/internal/ui/editor/text/XMLScanner.java;3;1;4;1;2;2;2;2;27;1;2;211;33;33;1;0;0;2;4;211;0;336;4;3;0
/org.eclipse.jdt.ui/ui refactoring/org/eclipse/jdt/internal/ui/refactoring/MoveInnerToTopWizard.java;4;0;9;1;1;1;2;7;98;2;7;36;207;207;2;0;1;8;9;269;1;336;8;4;0
/org.eclipse.debug.core/core/org/eclipse/debug/core/model/IStepFilters.java;1;0;2;1;1;1;1;1;3;0;1;202;3;3;1;0;0;1;2;202;0;275;2;1;0
/org.eclipse.update.core/src/org/eclipse/update/core/IURLEntry.java;3;1;4;1;2;2;2;2;6;1;2;0;18;18;1;0;0;2;4;0;0;336;4;3;0
/org.eclipse.osgi/core/framework/org/eclipse/osgi/framework/internal/core/StartLevelImpl.java;7;1;12;4;2;2;6;6;1120;6;4;171;2141;2141;6;2;4;10;12;267;6;336;6;7;0
/org.eclipse.jdt.debug/model/org/eclipse/jdt/internal/debug/core/model/JDIDebugElement.java;4;0;5;2;0;0;0;5;28;1;5;26;65;65;1;0;0;5;5;26;0;243;5;4;1
/org.eclipse.jface/src/org/eclipse/jface/dialogs/IInputValidator.java;1;0;1;1;1;1;1;0;10;0;0;293;10;10;1;0;0;0;1;293;0;293;1;1;0
/org.eclipse.ui.ide/src/org/eclipse/ui/internal/ide/FeatureSelectionDialog.java;3;1;6;1;4;4;4;2;28;1;2;132;49;49;1;0;0;2;6;132;0;336;6;3;0
/org.eclipse.jdt.ui/ui/org/eclipse/jdt/internal/ui/wizards/JavaProjectWizardSecondPage.java;2;2;11;1;4;3;4;7;53;4;4;212;104;104;4;3;1;7;11;220;4;336;7;2;0
/org.eclipse.ui.workbench/Eclipse UI/org/eclipse/ui/internal/presentations/SystemMenuMove.java;2;0;3;2;1;1;1;2;82;0;1;256;84;84;2;1;0;2;3;256;1;279;2;2;0
/org.eclipse.ui.workbench/Eclipse UI/org/eclipse/ui/IActionFilter.java;3;1;3;2;2;2;2;1;8;0;1;0;17;17;1;0;0;1;3;0;0;336;3;3;0
/org.eclipse.debug.ui/ui/org/eclipse/debug/internal/ui/ResourceExtender.java;4;4;6;3;5;2;5;1;155;0;1;247;165;165;4;0;3;1;6;293;3;336;3;4;1
/org.eclipse.osgi/resolver/src/org/eclipse/osgi/internal/resolver/StateImpl.java;4;0;17;3;1;1;7;10;204;7;5;171;374;374;7;5;6;16;17;269;11;312;6;4;1
/org.eclipse.jdt.debug.ui/ui/org/eclipse/jdt/internal/debug/ui/actions/DisplayAction.java;3;0;4;1;1;1;1;3;302;1;3;22;334;334;1;0;0;3;4;22;0;336;4;3;0
/org.eclipse.ui.workbench/Eclipse UI/org/eclipse/ui/internal/IntroAction.java;2;2;7;1;4;3;4;3;37;1;3;203;51;51;2;0;1;3;7;280;1;336;6;2;0
/org.eclipse.pde.core/src/org/eclipse/pde/internal/core/site/SiteDescription.java;2;1;3;1;2;2;2;1;10;0;1;232;23;23;1;0;0;1;3;232;0;336;3;2;0
/org.eclipse.ui.cheatsheets/src/org/eclipse/ui/internal/cheatsheets/actions/CheatSheetCategoryBasedSelectionAction.java;2;0;4;2;1;1;1;3;21;2;2;243;27;27;2;1;0;3;4;253;1;288;3;2;0
/org.eclipse.team.cvs.ui/src/org/eclipse/team/internal/ccvs/ui/AlternateUserValidationDialog.java;1;0;1;1;0;0;0;1;8;0;1;138;8;8;1;0;0;1;1;138;0;138;1;1;0
/org.eclipse.debug.ui/ui/org/eclipse/debug/internal/ui/views/expression/PopupInformationControl.java;3;4;9;2;9;3;9;0;25;0;0;276;59;59;4;0;6;0;9;276;6;330;3;3;3
/org.eclipse.team.ui/src/org/eclipse/team/internal/ui/synchronize/ConfigureSynchronizeScheduleComposite.java;2;1;4;1;3;3;3;1;32;0;1;254;35;35;1;0;0;1;4;254;0;336;4;2;0
/org.eclipse.osgi/defaultAdaptor/src/org/eclipse/osgi/framework/internal/reliablefile/ReliableFileInputStream.java;5;0;6;3;1;1;3;3;144;3;3;171;260;260;3;0;2;5;6;270;2;311;4;5;0
/org.eclipse.jdt.ui/ui/org/eclipse/jdt/internal/ui/text/java/IProblemRequestorExtension.java;2;0;2;1;1;1;1;1;16;0;1;219;18;18;1;0;0;1;2;219;0;336;2;2;0
/org.eclipse.jdt.core/search/org/eclipse/jdt/internal/core/search/JavaSearchDocument.java;3;0;7;2;2;1;2;5;62;3;3;181;113;113;3;2;1;5;7;181;3;282;4;3;1
/org.eclipse.jdt.ui/ui/org/eclipse/jdt/ui/refactoring/IRefactoringProcessorIds.java;2;2;4;2;3;2;3;1;129;0;1;269;141;141;2;0;1;1;4;336;1;336;3;2;0
/org.eclipse.jdt.ui/core refactoring/org/eclipse/jdt/internal/corext/refactoring/code/InlineTempRefactoring.java;4;1;16;2;3;3;3;13;120;4;8;9;206;206;4;5;0;13;16;251;5;336;11;4;0
/org.eclipse.team.cvs.ui/src/org/eclipse/team/internal/ccvs/ui/CVSPreferencesPage.java;2;2;8;1;3;2;3;5;36;2;4;57;75;75;2;1;1;5;8;57;2;336;6;2;0
/org.eclipse.ui.ide/src/org/eclipse/ui/views/navigator/ShowInNavigatorAction.java;1;0;1;1;0;0;0;1;0;0;1;129;0;0;1;0;0;1;1;129;0;129;1;1;0
/org.eclipse.debug.ui/ui/org/eclipse/debug/internal/ui/actions/ToggleStepFiltersActionDelegate.java;2;0;5;2;0;0;0;5;25;2;3;202;45;45;2;2;0;5;5;202;2;244;3;2;2
/org.eclipse.help/src/org/eclipse/help/internal/util/FastStack.java;1;1;2;1;2;2;2;0;15;0;0;311;21;21;1;0;0;0;2;311;0;336;2;1;0
/org.eclipse.jdt.core/dom/org/eclipse/jdt/core/dom/IVariableBinding.java;3;0;4;1;1;1;1;3;15;1;3;199;23;23;1;0;0;3;4;199;0;308;4;3;0
/org.eclipse.jdt.ui/ui/org/eclipse/jdt/internal/ui/text/correction/CorrectMainTypeNameProposal.java;3;2;8;2;3;2;3;5;25;2;4;27;62;62;2;1;1;5;8;192;2;336;6;3;0
/org.eclipse.jdt.ui/core refactoring/org/eclipse/jdt/internal/corext/refactoring/nls/NLSSourceModifier.java;2;5;7;1;7;3;7;0;517;0;0;279;544;544;5;0;4;0;7;279;4;336;3;2;0
/org.eclipse.jdt.ui/ui/org/eclipse/jdt/internal/ui/preferences/BuildPathsPropertyPage.java;2;1;9;1;2;2;2;7;52;2;5;41;116;116;2;2;0;7;9;225;2;336;7;2;0
/org.eclipse.jdt.ui/ui/org/eclipse/jdt/internal/ui/filters/FilterDescriptor.java;3;2;7;2;3;2;3;4;52;2;3;25;137;137;2;1;1;4;7;25;2;336;5;3;1
/org.eclipse.swt/Eclipse SWT PI/motif_gtk/org/eclipse/swt/internal/gtk/GTK.java;1;0;1;1;0;0;0;1;0;0;1;125;0;0;1;0;0;1;1;125;0;125;1;1;0
/org.eclipse.team.cvs.core/src/org/eclipse/team/internal/ccvs/core/resources/RemoteFolder.java;2;0;14;2;1;1;1;13;429;3;9;52;787;787;3;4;0;13;14;52;4;336;10;2;0
/org.eclipse.ui.workbench/Eclipse UI/org/eclipse/ui/themes/IThemeManager.java;2;1;5;1;3;3;3;2;65;0;1;243;83;83;2;1;0;2;5;243;1;336;4;2;0
/org.eclipse.pde.ui/src/org/eclipse/pde/ui/templates/TemplateField.java;2;2;4;1;4;3;4;0;86;0;0;276;107;107;2;0;1;0;4;276;1;336;3;2;0
/org.eclipse.jdt.ui/core refactoring/org/eclipse/jdt/internal/corext/refactoring/typeconstraints/TypeBindings.java;3;1;6;1;2;2;2;4;12;3;2;3;38;38;3;2;0;4;6;3;2;336;4;3;0
/org.eclipse.swt/Eclipse SWT AWT/emulated/org/eclipse/swt/awt/SWT_AWT.java;3;2;8;2;6;4;6;2;41;1;2;171;64;64;2;0;2;2;8;279;2;334;6;3;0
/org.eclipse.pde.core/src/org/eclipse/pde/internal/core/site/IdentifiableObject.java;2;1;3;1;2;2;2;1;8;0;1;232;14;14;1;0;0;1;3;232;0;336;3;2;0
/org.eclipse.ui.workbench/Eclipse UI/org/eclipse/ui/commands/CommandException.java;3;1;3;1;2;2;2;1;22;0;1;226;26;26;1;0;0;1;3;226;0;336;3;3;0
/org.eclipse.text/src/org/eclipse/jface/text/ISynchronizable.java;2;2;3;2;3;2;3;0;39;0;0;289;39;39;2;0;1;0;3;334;1;334;2;2;0
/org.eclipse.ui.ide/src/org/eclipse/ui/internal/ide/dialogs/IDEEditorsPreferencePage.java;4;0;4;2;1;1;1;3;4;2;2;160;7;7;2;1;0;3;4;160;1;336;3;4;2
/org.eclipse.jdt.ui/ui/org/eclipse/jdt/internal/ui/wizards/buildpaths/CPVariableElement.java;1;0;1;1;1;1;1;0;2;0;0;336;2;2;1;0;0;0;1;336;0;336;1;1;0
/org.eclipse.jdt.core/compiler/org/eclipse/jdt/internal/compiler/parser/TerminalTokens.java;3;0;7;2;0;0;0;7;446;3;5;51;870;870;3;2;0;7;7;51;2;199;5;3;2
/org.eclipse.ui.workbench.texteditor/src/org/eclipse/ui/internal/texteditor/quickdiff/RestoreAction.java;2;0;3;1;1;1;1;2;6;1;2;100;11;11;1;0;0;2;3;100;0;336;3;2;0
/org.eclipse.jdt.debug.ui/ui/org/eclipse/jdt/internal/debug/ui/sourcelookup/ClasspathContainerSourceContainerBrowser.java;1;0;8;1;2;1;2;6;79;4;3;230;147;147;4;3;1;6;8;266;4;296;4;1;0
/org.eclipse.ui.workbench/Eclipse UI/org/eclipse/ui/PlatformUI.java;4;2;8;2;3;2;3;5;177;3;3;157;207;207;3;2;1;5;8;157;3;336;5;4;0
/org.eclipse.ui.forms/src/org/eclipse/ui/forms/widgets/ToggleHyperlink.java;1;0;2;1;0;0;0;2;152;0;1;225;152;152;2;1;0;2;2;225;1;225;1;1;0
/org.eclipse.team.ui/src/org/eclipse/team/internal/ui/synchronize/actions/StatusLineContributionGroup.java;2;5;16;2;7;3;7;9;265;5;4;146;624;624;5;5;4;9;16;146;9;336;7;2;0
/org.eclipse.update.core/src/org/eclipse/update/configuration/IActivity.java;1;0;1;1;0;0;0;1;4;0;1;58;4;4;1;0;0;1;1;58;0;58;1;1;0
/org.eclipse.pde.core/src/org/eclipse/pde/internal/core/ifeature/IFeatureURLElement.java;2;1;3;1;2;2;2;1;4;0;1;232;11;11;1;0;0;1;3;232;0;336;3;2;0
/org.eclipse.jdt.ui/ui/org/eclipse/jdt/ui/ITypeHierarchyViewPart.java;2;0;2;2;1;1;1;1;6;0;1;263;12;12;1;0;0;1;2;263;0;336;2;2;0
/org.eclipse.ant.ui/Ant Editor/org/eclipse/ant/internal/ui/editor/model/AntProjectNode.java;1;1;11;1;2;2;2;9;28;4;4;204;84;84;4;5;0;9;11;204;5;320;6;1;1
/org.eclipse.jdt.ui/core extension/org/eclipse/jdt/internal/corext/template/java/JavaTemplateMessages.java;2;1;2;1;2;2;2;0;2;0;0;283;4;4;1;0;0;0;2;283;0;336;2;2;0
/org.eclipse.ui.externaltools/External Tools Base/org/eclipse/ui/externaltools/internal/model/ImageDescriptorRegistry.java;1;0;1;1;0;0;0;1;4;0;1;200;4;4;1;0;0;1;1;200;0;200;1;1;0
/org.eclipse.pde.core/src/org/eclipse/pde/core/plugin/IExtensions.java;3;2;9;1;5;4;5;4;73;2;3;128;95;95;2;1;1;4;9;232;2;336;7;3;0
/org.eclipse.swt/Eclipse SWT PI/gtk/org/eclipse/swt/internal/gtk/GdkEventCrossing.java;3;0;4;1;1;1;1;3;17;2;2;100;25;25;2;1;0;3;4;226;1;337;3;3;0
/org.eclipse.help.base/src/org/eclipse/help/internal/search/QueryWordsToken.java;1;1;5;1;3;3;3;2;16;1;2;104;36;36;1;0;0;2;5;104;0;336;5;1;0
/org.eclipse.ant.ui/Ant Tools Support/org/eclipse/ant/internal/ui/preferences/AbstractClasspathEntry.java;1;0;5;1;0;0;0;5;27;2;4;133;51;51;2;1;0;5;5;148;1;227;4;1;0
/org.eclipse.ant.ui/Ant Tools Support/org/eclipse/ant/internal/ui/views/AntViewMessages.java;1;0;1;1;0;0;0;1;0;0;1;108;0;0;1;0;0;1;1;108;0;108;1;1;0
/org.eclipse.osgi/resolver/src/org/eclipse/osgi/internal/resolver/Eclipse30SelectionPolicy.java;4;2;4;2;3;2;3;1;59;0;1;171;63;63;2;0;1;1;4;276;1;290;3;4;0
/org.eclipse.search/search/org/eclipse/search/internal/ui/SearchResultViewEntry.java;1;0;1;1;1;1;1;0;2;0;0;336;2;2;1;0;0;0;1;336;0;336;1;1;0
/org.eclipse.team.cvs.ui/src/org/eclipse/team/internal/ccvs/ui/actions/OpenLogEntryAction.java;2;1;2;1;2;2;2;0;4;0;0;303;6;6;1;0;0;0;2;303;0;336;2;2;0
/org.eclipse.osgi/console/src/org/eclipse/osgi/framework/internal/core/FrameworkConsole.java;3;1;6;1;4;4;4;2;78;1;2;171;171;171;1;0;0;2;6;171;0;336;6;3;0
/org.eclipse.core.expressions/src/org/eclipse/core/internal/expressions/SystemTestExpression.java;1;0;2;1;1;1;1;1;8;0;1;227;8;8;1;0;0;1;2;227;0;336;2;1;0
/org.eclipse.jdt.junit/src/org/eclipse/jdt/internal/junit/ui/JUnitMessages.java;1;0;1;1;1;1;1;0;4;0;0;336;4;4;1;0;0;0;1;336;0;336;1;1;1
/org.eclipse.jdt.ui/ui/org/eclipse/jdt/ui/ISharedImages.java;2;1;2;2;2;2;2;0;158;0;0;278;170;170;1;0;0;0;2;278;0;336;2;2;0
/org.eclipse.swt/Eclipse SWT Browser/common/org/eclipse/swt/browser/CloseWindowListener.java;2;0;7;1;1;1;1;6;27;3;4;165;52;52;3;2;0;6;7;165;2;337;5;2;0
/org.eclipse.jdt.ui/core refactoring/org/eclipse/jdt/internal/corext/refactoring/typeconstraints/ExpressionVariable.java;2;0;5;1;1;1;1;4;78;1;4;3;145;145;1;0;0;4;5;3;0;336;5;2;0
/org.eclipse.swt/Eclipse SWT Custom Widgets/common/org/eclipse/swt/custom/ViewForm.java;4;4;16;2;9;3;9;7;918;3;5;9;1152;1152;4;2;6;7;16;299;8;336;8;4;0
/org.eclipse.jdt.ui/core refactoring/org/eclipse/jdt/internal/corext/refactoring/surround/LocalDeclarationAnalyzer.java;1;0;1;1;1;1;1;0;2;0;0;336;2;2;1;0;0;0;1;336;0;336;1;1;0
/org.eclipse.ui.ide/src/org/eclipse/ui/internal/ide/dialogs/ZipFileResourceExporter.java;1;0;1;1;0;0;0;1;0;0;1;132;0;0;1;0;0;1;1;132;0;132;1;1;0
/org.eclipse.update.core/src/org/eclipse/update/core/model/IncludedFeatureReferenceModel.java;3;1;5;1;3;3;3;2;78;1;2;0;102;102;1;0;0;2;5;0;0;336;5;3;0
/org.eclipse.ant.core/src_ant/org/eclipse/ant/internal/core/ant/NullInputHandler.java;1;0;1;1;1;1;1;0;0;0;0;301;0;0;1;0;0;0;1;301;0;301;1;1;0
/org.eclipse.pde.core/src/org/eclipse/pde/internal/core/SearchablePluginsManager.java;3;4;7;3;5;2;5;2;228;1;2;193;241;241;4;0;3;2;7;299;3;336;4;3;0
/org.eclipse.jface.text/projection/org/eclipse/jface/text/source/projection/IProjectionListener.java;2;2;3;2;3;2;3;0;7;0;0;276;7;7;2;0;1;0;3;336;1;336;2;2;0
/org.eclipse.core.resources/src/org/eclipse/core/internal/resources/MarkerTypeDefinition.java;2;1;2;1;2;2;2;0;148;0;0;277;157;157;1;0;0;0;2;277;0;299;2;2;0
/org.eclipse.jface.text/src/org/eclipse/jface/text/DefaultTextDoubleClickStrategy.java;2;0;3;2;2;1;2;1;18;0;1;82;20;20;2;0;1;1;3;336;1;336;2;2;0
/org.eclipse.jface/src/org/eclipse/jface/action/IContributionManagerOverrides.java;4;2;4;2;3;2;3;1;33;0;1;150;40;40;2;0;1;1;4;292;1;336;3;4;0
/org.eclipse.jdt.ui/ui/org/eclipse/jdt/ui/actions/ReferencesSearchGroup.java;3;1;5;1;2;2;2;3;11;1;3;82;24;24;1;0;0;3;5;82;0;336;5;3;0
/org.eclipse.swt/Eclipse SWT PI/gtk/org/eclipse/swt/internal/accessibility/gtk/AtkObjectFactoryClass.java;4;0;4;1;1;1;1;3;17;1;3;75;25;25;1;0;0;3;4;75;0;337;4;4;0
/org.eclipse.jdt.debug.ui/ui/org/eclipse/jdt/internal/debug/ui/sourcelookup/ClasspathVariableSourceContainerBrowser.java;1;0;7;1;2;1;2;5;40;3;3;230;61;61;3;2;1;5;7;266;3;296;4;1;0
/org.eclipse.swt/Eclipse SWT PI/gtk/org/eclipse/swt/internal/gtk/XVisibilityEvent.java;2;1;2;1;2;2;2;0;4;0;0;326;4;4;1;0;0;0;2;326;0;337;2;2;0
/org.eclipse.debug.ui/ui/org/eclipse/debug/internal/ui/stringsubstitution/StringVariableLabelProvider.java;2;0;2;1;0;0;0;2;9;1;2;124;11;11;1;0;0;2;2;124;0;145;2;2;0
/org.eclipse.swt/Eclipse SWT Custom Widgets/common/org/eclipse/swt/custom/TableEditor.java;2;0;2;1;0;0;0;2;119;1;2;59;122;122;1;0;0;2;2;59;0;101;2;2;0
/org.eclipse.ltk.core.refactoring/src/org/eclipse/ltk/internal/core/refactoring/Assert.java;1;0;2;1;1;1;1;1;2;0;1;264;2;2;1;0;0;1;2;264;0;336;2;1;0
/org.eclipse.pde.ui/src/org/eclipse/pde/internal/ui/editor/plugin/BodyTextSection.java;3;5;6;3;6;2;6;0;39;0;0;292;43;43;5;0;4;0;6;292;4;336;2;3;0
/org.eclipse.jdt.core/model/org/eclipse/jdt/internal/core/builder/ClasspathJar.java;3;0;5;2;0;0;0;5;121;3;2;80;144;144;3;3;0;5;5;80;3;199;2;3;0
/org.eclipse.pde.ui/src/org/eclipse/pde/internal/ui/editor/feature/DataSection.java;3;2;10;2;4;3;4;6;88;2;5;130;165;165;2;1;1;6;10;130;2;336;8;3;0
/org.eclipse.jdt.core/compiler/org/eclipse/jdt/internal/compiler/codegen/Label.java;3;2;9;2;3;2;3;6;15;2;5;13;55;55;2;1;1;6;9;67;2;300;7;3;0
/org.eclipse.ant.ui/Ant Tools Support/org/eclipse/ant/internal/ui/launchConfigurations/RunAntStatusHandler.java;2;1;4;1;2;2;2;2;4;1;2;108;9;9;1;0;0;2;4;108;0;336;4;2;0
/org.eclipse.ui.console/src/org/eclipse/ui/internal/console/MessageConsoleViewer.java;1;0;2;1;0;0;0;2;24;0;1;118;24;24;2;1;0;2;2;118;1;118;1;1;0
/org.eclipse.jdt.core/model/org/eclipse/jdt/internal/core/MoveResourceElementsOperation.java;1;0;2;1;0;0;0;2;2;1;2;180;3;3;1;0;0;2;2;180;0;199;2;1;0
/org.eclipse.jdt.core/model/org/eclipse/jdt/internal/core/JarPackageFragmentRootInfo.java;1;0;1;1;0;0;0;1;2;0;1;199;2;2;1;0;0;1;1;199;0;199;1;1;0
/org.eclipse.jdt.ui/core refactoring/org/eclipse/jdt/internal/corext/refactoring/nls/KeyValuePair.java;3;1;3;1;2;2;2;1;52;0;1;267;56;56;1;0;0;1;3;267;0;336;3;3;0
/org.eclipse.team.cvs.ui/src/org/eclipse/team/internal/ccvs/ui/console/ConsolePreferencesPage.java;1;0;2;1;1;1;1;1;4;0;1;252;4;4;1;0;0;1;2;252;0;336;2;1;1
/org.eclipse.text/src/org/eclipse/text/edits/TextEditGroup.java;2;1;3;1;2;2;2;1;2;0;1;204;4;4;1;0;0;1;3;204;0;336;3;2;0
/org.eclipse.jdt.core/model/org/eclipse/jdt/core/ILocalVariable.java;2;0;6;1;1;1;1;5;15;2;4;140;32;32;2;1;0;5;6;150;1;272;5;2;0
/org.eclipse.jdt.ui/core refactoring/org/eclipse/jdt/internal/corext/refactoring/typeconstraints/DeclaringTypeVariable.java;2;0;4;1;1;1;1;3;19;1;3;3;29;29;1;0;0;3;4;3;0;336;4;2;0
/org.eclipse.ui.cheatsheets/src/org/eclipse/ui/internal/cheatsheets/data/PerformWhen.java;1;1;2;1;2;2;2;0;20;0;0;279;20;20;1;0;0;0;2;279;0;295;2;1;0
/org.eclipse.team.cvs.ssh2/src/org/eclipse/team/internal/ccvs/ssh2/CVSSSH2Plugin.java;1;0;1;1;0;0;0;1;2;0;1;263;2;2;1;0;0;1;1;263;0;263;1;1;0
/org.eclipse.update.ui/src/org/eclipse/update/internal/ui/views/InstallationHistoryAction.java;3;1;9;2;2;2;2;7;148;2;4;54;185;185;2;3;0;7;9;54;3;336;6;3;3
/org.eclipse.ui.editors/src/org/eclipse/ui/texteditor/AnnotationPreferenceLookup.java;2;1;4;1;2;2;2;2;23;1;2;181;29;29;1;0;0;2;4;181;0;336;4;2;0
/org.eclipse.jdt.debug.ui/ui/org/eclipse/jdt/internal/debug/ui/actions/ShowQualifiedAction.java;1;0;1;1;0;0;0;1;6;0;1;187;6;6;1;0;0;1;1;187;0;187;1;1;0
/org.eclipse.ui.forms/src/org/eclipse/ui/forms/widgets/Section.java;1;2;8;1;3;2;3;5;147;3;3;225;401;401;3;2;1;5;8;225;3;335;5;1;0
/org.eclipse.ltk.ui.refactoring/src/org/eclipse/ltk/internal/ui/refactoring/ChangeElementLabelProvider.java;1;1;4;1;2;2;3;1;10;0;1;269;20;20;2;0;1;2;4;269;1;336;3;1;0
/org.eclipse.jdt.core/model/org/eclipse/jdt/internal/core/hierarchy/IndexBasedHierarchyBuilder.java;5;0;29;3;2;1;2;27;218;7;10;10;581;581;7;17;1;27;29;109;18;275;11;5;0
/org.eclipse.ui.workbench/Eclipse UI/org/eclipse/ui/dialogs/ListDialog.java;1;0;1;1;1;1;1;0;84;0;0;293;84;84;1;0;0;0;1;293;0;293;1;1;0
/org.eclipse.team.cvs.core/src/org/eclipse/team/internal/ccvs/core/connection/CVSAuthenticationException.java;2;0;2;1;1;1;1;1;23;0;1;203;25;25;1;0;0;1;2;203;0;336;2;2;0
/org.eclipse.ui.externaltools/External Tools Base/org/eclipse/ui/externaltools/internal/model/IExternalToolsHelpContextIds.java;2;0;7;2;0;0;0;7;27;5;3;2;53;53;5;4;0;7;7;2;4;111;3;2;0
/org.eclipse.jdt.core/compiler/org/eclipse/jdt/internal/compiler/flow/SwitchFlowContext.java;2;0;5;1;0;0;0;5;4;1;5;34;12;12;1;0;0;5;5;34;0;199;5;2;0
/org.eclipse.ui.workbench/Eclipse UI/org/eclipse/ui/internal/themes/ColorUtils.java;1;0;4;1;1;1;1;3;180;0;1;241;182;182;3;2;0;3;4;241;2;280;2;1;0
/org.eclipse.swt/Eclipse SWT/motif/org/eclipse/swt/graphics/Device.java;4;1;6;1;2;2;2;4;183;1;4;0;211;211;1;0;0;4;6;0;0;337;6;4;2
/org.eclipse.ui.editors/src/org/eclipse/ui/texteditor/ImageUtilities.java;2;1;4;1;3;3;3;1;60;0;1;181;74;74;1;0;0;1;4;181;0;336;4;2;0
/org.eclipse.team.cvs.core/src/org/eclipse/team/internal/ccvs/core/syncinfo/BaserevInfo.java;1;0;1;1;0;0;0;1;5;0;1;144;5;5;1;0;0;1;1;144;0;144;1;1;0
/org.eclipse.ui.workbench/Eclipse UI/org/eclipse/ui/internal/EditorManager.java;10;0;21;6;11;1;11;10;442;2;9;31;1380;1380;11;1;10;10;21;297;11;297;10;10;7
/org.eclipse.jdt.ui/ui refactoring/org/eclipse/jdt/internal/ui/refactoring/ConvertAnonymousToNestedWizard.java;4;0;7;1;1;1;2;5;104;2;5;36;150;150;2;0;1;6;7;269;1;336;6;4;0
/org.eclipse.ltk.ui.refactoring/src/org/eclipse/ltk/internal/ui/refactoring/PreviewWizardPage.java;2;2;10;2;4;3;8;2;87;0;1;269;140;140;6;1;5;6;10;269;6;336;4;2;0
/org.eclipse.jdt.core/model/org/eclipse/jdt/internal/core/util/InnerClassesAttribute.java;1;0;2;1;0;0;0;2;10;1;2;199;12;12;1;0;0;2;2;199;0;225;2;1;0
/org.eclipse.team.core/src/org/eclipse/team/core/variants/IResourceVariant.java;2;1;3;1;2;2;2;1;8;0;1;239;10;10;1;0;0;1;3;239;0;336;3;2;0
/org.eclipse.ui.cheatsheets/src/org/eclipse/ui/internal/cheatsheets/actions/CheatSheetSelectionAction.java;2;0;4;2;1;1;1;3;21;2;2;243;27;27;2;1;0;3;4;253;1;288;3;2;0
/org.eclipse.jdt.ui/ui refactoring/org/eclipse/jdt/internal/ui/refactoring/sef/SelfEncapsulateFieldInputPage.java;3;0;7;1;1;1;2;5;49;3;4;80;58;58;3;1;1;6;7;263;2;336;5;3;0
/org.eclipse.swt/Eclipse SWT Custom Widgets/common/org/eclipse/swt/custom/PopupList.java;4;1;5;1;2;2;2;3;22;2;2;16;48;48;2;1;0;3;5;16;1;337;4;4;0
/org.eclipse.text/src/org/eclipse/jface/text/IDocumentPartitioningListener.java;2;1;2;1;2;2;2;0;33;0;0;275;35;35;1;0;0;0;2;275;0;334;2;2;0
/org.eclipse.ui.workbench/Eclipse UI/org/eclipse/ui/internal/about/AboutFeaturesButtonManager.java;1;0;1;1;1;1;1;0;0;0;0;294;0;0;1;0;0;0;1;294;0;294;1;1;0
/org.eclipse.jdt.ui/ui/org/eclipse/jdt/internal/ui/compare/JavaReplaceWithEditionAction.java;5;0;11;2;1;1;1;10;123;3;7;79;207;207;3;3;0;10;11;94;3;336;8;5;2
/org.eclipse.ant.ui/Ant Tools Support/org/eclipse/ant/internal/ui/launchConfigurations/AntClasspathProvider.java;2;0;8;2;0;0;0;8;63;3;6;108;114;114;3;2;0;8;8;227;2;247;6;2;0
/org.eclipse.pde.ui/src/org/eclipse/pde/internal/ui/wizards/templates/HelloWorldTemplate.java;3;1;7;1;3;3;3;4;74;2;3;55;134;134;2;1;0;4;7;128;1;336;6;3;0
/org.eclipse.ui.workbench/Eclipse UI/org/eclipse/ui/internal/commands/ws/WorkbenchCommandSupport.java;4;9;35;3;14;2;14;21;884;7;4;177;2229;2229;9;17;12;21;35;281;29;325;6;4;2
/org.eclipse.jdt.ui/ui/org/eclipse/jdt/internal/ui/browsing/LogicalPackagesProvider.java;1;1;3;1;2;2;2;1;38;0;1;20;44;44;1;0;0;1;3;20;0;336;3;1;0
/org.eclipse.ui.workbench/Eclipse UI/org/eclipse/ui/internal/WorkbenchPartReference.java;4;4;6;3;5;2;5;1;376;0;1;212;412;412;4;0;3;1;6;302;3;336;3;4;1
/org.eclipse.team.ui/src/org/eclipse/team/internal/ui/wizards/TeamWizardPage.java;1;0;1;1;0;0;0;1;107;0;1;63;107;107;1;0;0;1;1;63;0;63;1;1;0
/org.eclipse.jdt.core/dom/org/eclipse/jdt/core/dom/DefaultASTVisitor.java;1;0;1;1;0;0;0;1;0;0;1;237;0;0;1;0;0;1;1;237;0;237;1;1;0
/org.eclipse.ant.ui/Ant Tools Support/org/eclipse/ant/internal/ui/views/actions/RunTargetAction.java;1;0;3;1;0;0;0;3;24;2;2;108;28;28;2;1;0;3;3;108;1;224;2;1;1
/org.eclipse.osgi/osgi/src/org/eclipse/osgi/service/resolver/PackageSpecification.java;3;0;5;2;1;1;2;3;14;2;2;171;29;29;2;1;1;4;5;171;2;336;3;3;0
/org.eclipse.jdt.ui/ui/org/eclipse/jdt/ui/text/java/IJavaCompletionProposal.java;1;0;1;1;1;1;1;0;3;0;0;335;3;3;1;0;0;0;1;335;0;335;1;1;0
/org.eclipse.jdt.ui/ui/org/eclipse/jdt/internal/ui/text/correction/ChangeMethodSignatureProposal.java;3;5;25;2;6;2;6;19;278;5;12;21;631;631;5;7;4;19;25;65;11;336;14;3;0
/org.eclipse.ui.editors/src/org/eclipse/ui/texteditor/MarkerAnnotation.java;3;2;12;1;5;3;5;7;300;3;5;118;685;685;3;2;2;7;12;204;4;334;8;3;0
/org.eclipse.jdt.core/compiler/org/eclipse/jdt/internal/compiler/problem/ProblemReporter.java;6;4;50;4;7;4;7;43;1160;12;13;1;3254;3254;12;30;3;43;50;46;33;324;17;6;16
/org.eclipse.jface.text/src/org/eclipse/jface/text/rules/IToken.java;2;0;2;2;2;1;2;0;4;0;0;336;4;4;2;0;1;0;2;336;1;336;1;2;0
/org.eclipse.team.core/src/org/eclipse/team/internal/core/subscribers/SyncSetInputFromSyncSet.java;1;1;4;1;2;2;2;2;117;1;2;199;144;144;1;0;0;2;4;199;0;336;4;1;0
/org.eclipse.jdt.launching.macosx/macosx/org/eclipse/jdt/internal/ui/macbundler/ResourceInfo.java;1;0;1;1;0;0;0;1;0;0;1;203;0;0;1;0;0;1;1;203;0;203;1;1;0
/org.eclipse.update.core/src/org/eclipse/update/internal/security/KeyStores.java;2;1;4;1;2;2;2;2;7;1;2;58;15;15;1;0;0;2;4;58;0;336;4;2;0
/org.eclipse.ui.forms/src/org/eclipse/ui/forms/widgets/ILayoutExtension.java;1;0;4;1;1;1;1;3;58;2;2;225;74;74;2;1;0;3;4;225;1;272;3;1;0
/org.eclipse.jdt.debug.ui/ui/org/eclipse/jdt/internal/debug/ui/launcher/RuntimeClasspathViewer.java;1;0;4;1;0;0;0;4;41;2;3;123;81;81;2;1;0;4;4;154;1;181;3;1;0
/org.eclipse.jdt.ui/core extension/org/eclipse/jdt/internal/corext/dom/ASTNodes.java;4;0;30;3;4;1;4;26;246;6;10;12;1188;1188;6;16;3;26;30;91;19;290;11;4;3
/org.eclipse.help.ide/src/org/eclipse/help/ui/internal/ide/IHelpIdeConstants.java;1;1;5;1;4;4;4;1;24;0;1;106;46;46;1;0;0;1;5;106;0;336;5;1;0
/org.eclipse.core.resources/src/org/eclipse/core/internal/events/EventStats.java;2;0;2;1;1;1;1;1;50;0;1;90;60;60;1;0;0;1;2;90;0;277;2;2;0
/org.eclipse.swt/Eclipse SWT Drag and Drop/motif/org/eclipse/swt/dnd/FileTransfer.java;1;0;1;1;0;0;0;1;67;0;1;24;67;67;1;0;0;1;1;24;0;24;1;1;0
/org.eclipse.ui.workbench/Eclipse UI/org/eclipse/ui/internal/IWorkbenchThemeConstants.java;1;0;3;1;1;1;1;2;6;0;1;250;9;9;2;1;0;2;3;250;1;293;2;1;0
/org.eclipse.ltk.core.refactoring/src/org/eclipse/ltk/core/refactoring/IValidationCheckResultQuery.java;1;0;1;1;1;1;1;0;7;0;0;279;7;7;1;0;0;0;1;279;0;279;1;1;0
/org.eclipse.swt/Eclipse SWT/carbon/org/eclipse/swt/widgets/ToolBar.java;3;1;6;1;3;3;3;3;8;1;3;8;25;25;1;0;0;3;6;8;0;337;6;3;0
/org.eclipse.jdt.core/dom/org/eclipse/jdt/core/dom/IPackageBinding.java;1;0;1;1;0;0;0;1;2;0;1;199;2;2;1;0;0;1;1;199;0;199;1;1;1
/org.eclipse.jdt.launching/launching/org/eclipse/jdt/launching/IRuntimeClasspathEntry.java;3;1;8;1;2;2;2;6;56;1;6;53;117;117;1;0;0;6;8;53;0;336;8;3;0
/org.eclipse.core.expressions/src/org/eclipse/core/expressions/Expression.java;1;2;5;1;3;2;3;2;10;0;1;227;16;16;2;1;1;2;5;227;2;334;3;1;0
/org.eclipse.ui.workbench.texteditor/src/org/eclipse/ui/texteditor/FindReplaceAction.java;1;1;3;1;2;2;2;1;4;0;1;82;8;8;1;0;0;1;3;82;0;336;3;1;0
/org.eclipse.jface.text/src/org/eclipse/jface/text/contentassist/IContentAssistListener.java;1;0;3;1;2;1;2;1;5;0;1;263;6;6;2;0;1;1;3;336;1;336;2;1;0
/org.eclipse.core.runtime/src/org/eclipse/core/internal/content/ContentTypeManager.java;3;6;20;2;16;4;16;4;444;3;2;251;1119;1119;6;2;12;4;20;277;14;325;6;3;2
/org.eclipse.ltk.ui.refactoring/src/org/eclipse/ltk/internal/ui/refactoring/RefactoringStatusViewer.java;1;1;4;1;2;2;3;1;5;0;1;269;10;10;2;0;1;2;4;269;1;336;3;1;0
/org.eclipse.ui.ide/extensions/org/eclipse/ui/dialogs/WizardNewProjectReferencePage.java;1;0;2;1;0;0;0;2;4;1;2;132;4;4;1;0;0;2;2;132;0;150;2;1;0
/org.eclipse.ui.workbench/Eclipse UI/org/eclipse/ui/progress/IProgressService.java;2;5;17;2;6;2;12;5;122;7;4;158;288;288;7;1;10;11;17;270;11;336;6;2;1
/org.eclipse.jdt.core/dom/org/eclipse/jdt/core/dom/IBinding.java;3;0;8;2;1;1;1;7;15;2;5;156;52;52;2;2;0;7;8;156;2;312;6;3;3
/org.eclipse.ui.presentations.r21/src/org/eclipse/ui/internal/presentations/r21/widgets/CTabFolder.java;1;1;2;1;2;2;2;0;2;0;0;323;2;2;1;0;0;0;2;323;0;336;2;1;0
/org.eclipse.swt/Eclipse SWT/carbon/org/eclipse/swt/widgets/TabItem.java;3;1;5;1;2;2;2;3;12;1;3;19;33;33;1;0;0;3;5;19;0;337;5;3;0
/org.eclipse.jdt.core/model/org/eclipse/jdt/internal/core/DeltaProcessingState.java;2;4;17;2;5;2;5;12;458;3;7;71;1049;1049;4;5;3;12;17;281;8;306;9;2;0
/org.eclipse.jdt.ui/core refactoring/org/eclipse/jdt/internal/corext/refactoring/reorg/ReadOnlyResourceFinder.java;3;0;5;1;1;1;1;4;9;2;3;70;22;22;2;1;0;4;5;70;1;336;4;3;0
/org.eclipse.jdt.ui/ui refactoring/org/eclipse/jdt/internal/ui/refactoring/reorg/RenameRefactoringWizard.java;2;0;8;1;1;1;2;6;23;3;3;71;54;54;3;3;1;7;8;251;4;336;4;2;0
/org.eclipse.osgi/osgi/src/org/eclipse/osgi/service/resolver/StateDelta.java;3;1;4;1;2;2;2;2;10;0;1;171;20;20;2;1;0;2;4;171;1;336;3;3;0
/org.eclipse.osgi/defaultAdaptor/src/org/eclipse/osgi/framework/adaptor/core/ReferenceInputStream.java;2;0;2;1;1;1;1;1;2;0;1;239;2;2;1;0;0;1;2;239;0;276;2;2;0
/org.eclipse.jdt.debug.ui/ui/org/eclipse/jdt/internal/debug/ui/actions/AbstractAddStepFilterAction.java;1;0;1;1;0;0;0;1;6;0;1;97;6;6;1;0;0;1;1;97;0;97;1;1;0
/org.eclipse.jdt.core/dom/org/eclipse/jdt/core/dom/FieldDeclaration.java;5;0;17;1;1;1;5;12;255;6;8;70;340;340;6;4;4;16;17;266;8;308;9;5;2
/org.eclipse.jdt.ui/ui/org/eclipse/jdt/internal/ui/callhierarchy/TreeRoot.java;2;0;4;1;1;1;1;3;3;1;3;12;7;7;1;0;0;3;4;12;0;336;4;2;0
/org.eclipse.ui.forms/src/org/eclipse/ui/forms/events/ExpansionEvent.java;1;1;5;1;2;2;2;3;36;2;2;225;46;46;2;1;0;3;5;225;1;336;4;1;0
/org.eclipse.core.resources/src/org/eclipse/core/internal/indexing/IndexAnchor.java;1;0;1;1;1;1;1;0;17;0;0;277;17;17;1;0;0;0;1;277;0;277;1;1;0
/org.eclipse.help.base/src/org/eclipse/help/internal/search/SearchIndex.java;1;3;19;1;6;3;6;13;343;3;8;104;742;742;3;5;3;13;19;104;8;336;11;1;0
/org.eclipse.update.core/src/org/eclipse/update/internal/core/FeaturePackagedContentProvider.java;3;1;5;1;2;2;2;3;21;1;3;58;35;35;1;0;0;3;5;58;0;336;5;3;0
/org.eclipse.jdt.ui/ui/org/eclipse/jdt/internal/ui/wizards/buildpaths/BuildPathsBlock.java;3;1;12;2;3;3;3;9;61;2;7;81;216;216;2;2;0;9;12;81;2;336;10;3;1
/org.eclipse.ui.ide/src/org/eclipse/ui/internal/ide/dialogs/ResourceWorkingSetPage.java;1;0;2;1;0;0;0;2;3;1;2;132;3;3;1;0;0;2;2;132;0;150;2;1;0
/org.eclipse.ui.workbench/Eclipse UI/org/eclipse/ui/internal/progress/ProgressMonitorFocusJobDialog.java;1;6;18;1;11;2;14;4;1191;0;1;266;1415;1415;7;3;12;7;18;266;15;314;3;1;1
/org.eclipse.jdt.core/model/org/eclipse/jdt/internal/core/eval/EvaluationContextWrapper.java;3;0;7;1;0;0;0;7;78;2;6;1;169;169;2;1;0;7;7;199;1;199;6;3;0
/org.eclipse.swt/Eclipse SWT/gtk/org/eclipse/swt/widgets/List.java;7;3;26;4;5;3;5;21;166;6;8;8;678;678;6;13;2;21;26;159;15;332;11;7;2
/org.eclipse.ui.intro/src/org/eclipse/ui/internal/intro/impl/model/AbstractIntroElement.java;1;5;8;1;8;3;8;0;67;0;0;276;110;110;5;0;5;0;8;286;5;331;3;1;0
/org.eclipse.team.cvs.ui/src/org/eclipse/team/internal/ccvs/ui/model/CVSRepositoryRootElement.java;2;1;4;2;2;2;2;2;7;0;1;59;12;12;2;1;0;2;4;59;1;336;3;2;0
/org.eclipse.ui.ide/src/org/eclipse/ui/internal/ide/model/WorkbenchStatus.java;1;0;2;1;0;0;0;2;1;1;2;132;1;1;1;0;0;2;2;132;0;151;2;1;0
/org.eclipse.ui.ide/src/org/eclipse/ui/ide/IDE.java;6;3;22;4;5;3;5;17;379;8;4;92;1067;1067;8;13;2;17;22;92;15;336;7;6;0
/org.eclipse.osgi/eclipseAdaptor/src/org/eclipse/core/runtime/adaptor/testsupport/SimplePlatformAdmin.java;2;0;2;1;1;1;1;1;2;0;1;233;2;2;1;0;0;1;2;233;0;276;2;2;0
/org.eclipse.jdt.ui/core refactoring/org/eclipse/jdt/internal/corext/refactoring/rename/RenameTypeProcessor.java;4;2;33;2;5;4;12;21;227;10;9;71;461;461;10;12;8;28;33;266;20;336;13;4;1
/org.eclipse.jdt.ui/ui/org/eclipse/jdt/internal/ui/JavaPlugin.java;8;1;42;7;3;3;14;28;616;22;9;13;825;825;22;19;11;39;42;241;30;336;12;8;0
/org.eclipse.pde.ui/src/org/eclipse/pde/internal/ui/wizards/imports/FeatureImportWizard.java;2;1;3;1;2;2;2;1;74;0;1;175;90;90;1;0;0;1;3;175;0;336;3;2;0
/org.eclipse.jdt.debug.ui/ui/org/eclipse/jdt/internal/debug/ui/monitors/MonitorManager.java;4;1;6;1;2;2;2;4;4;1;4;110;18;18;1;0;0;4;6;110;0;336;6;4;0
/org.eclipse.team.cvs.ui/src/org/eclipse/team/internal/ccvs/ui/actions/IgnoreAction.java;2;1;3;1;2;2;2;1;23;0;1;257;27;27;1;0;0;1;3;257;0;336;3;2;2
/org.eclipse.ui.workbench/Eclipse UI/org/eclipse/ui/model/IWorkbenchAdapter.java;4;0;4;2;1;1;1;3;44;2;2;157;58;58;2;1;0;3;4;225;1;336;3;4;0
/org.eclipse.ui.editors/src/org/eclipse/ui/texteditor/SimpleMarkerAnnotation.java;2;1;2;1;2;2;2;0;7;0;0;287;7;7;1;0;0;0;2;287;0;336;2;2;0
/org.eclipse.debug.core/core/org/eclipse/debug/core/Launch.java;3;1;4;1;2;2;2;2;115;0;1;230;124;124;2;1;0;2;4;230;1;336;3;3;0
/org.eclipse.jdt.core/dom/org/eclipse/jdt/internal/core/dom/rewrite/RewriteEventStore.java;3;1;4;1;3;3;3;1;222;0;1;262;264;264;1;0;0;1;4;262;0;336;4;3;0
/org.eclipse.jdt.debug/jdi/org/eclipse/jdi/internal/event/VMDisconnectEventImpl.java;1;0;1;1;0;0;0;1;3;0;1;144;3;3;1;0;0;1;1;144;0;144;1;1;0
/org.eclipse.jdt.ui/ui/org/eclipse/jdt/ui/actions/FindWriteReferencesInHierarchyAction.java;2;0;2;1;1;1;1;1;5;0;1;184;7;7;1;0;0;1;2;184;0;336;2;2;0
/org.eclipse.pde.ui/src/org/eclipse/pde/internal/ui/wizards/extension/NewSchemaFileWizard.java;2;2;4;2;4;3;4;0;24;0;0;279;34;34;2;0;1;0;4;279;1;336;3;2;0
/org.eclipse.ant.ui/Ant Tools Support/org/eclipse/ant/internal/ui/console/BuildFailedTracker.java;3;0;8;3;1;1;1;7;54;3;5;108;98;98;3;2;0;7;8;125;2;301;6;3;0
/org.eclipse.ltk.core.refactoring/src/org/eclipse/ltk/internal/core/refactoring/RefactoringCoreMessages.java;1;0;2;1;1;1;1;1;2;0;1;264;2;2;1;0;0;1;2;264;0;336;2;1;0
/org.eclipse.jdt.junit/src/org/eclipse/jdt/internal/junit/refactoring/ProjectRenameParticipant.java;2;1;3;1;3;3;3;0;10;0;0;272;14;14;1;0;0;0;3;272;0;336;3;2;1
/org.eclipse.ui.workbench/Eclipse UI/org/eclipse/ui/themes/ITheme.java;1;1;6;1;2;2;2;4;97;0;1;243;163;163;4;3;0;4;6;243;3;282;3;1;0
/org.eclipse.core.runtime/src/org/eclipse/core/runtime/jobs/IJobStatus.java;1;0;1;1;1;1;1;0;0;0;0;286;0;0;1;0;0;0;1;286;0;286;1;1;0
/org.eclipse.debug.core/core/org/eclipse/debug/internal/core/LogicalStructureManager.java;3;1;4;1;2;2;2;2;30;0;1;152;39;39;2;1;0;2;4;152;1;336;3;3;0
/org.eclipse.jdt.ui/ui/org/eclipse/jdt/internal/ui/viewsupport/TreeHierarchyLayoutProblemsDecorator.java;1;0;1;1;1;1;1;0;2;0;0;336;2;2;1;0;0;0;1;336;0;336;1;1;0
/org.eclipse.debug.core/core/org/eclipse/debug/internal/core/sourcelookup/SourcePathComputer.java;1;0;2;1;0;0;0;2;1;1;2;205;1;1;1;0;0;2;2;205;0;268;2;1;0
/org.eclipse.core.resources/src/org/eclipse/core/internal/resources/MarkerSet.java;2;0;3;1;1;1;1;2;361;1;2;104;380;380;1;0;0;2;3;104;0;277;3;2;0
/org.eclipse.jdt.ui/ui/org/eclipse/jdt/internal/ui/javaeditor/GotoAnnotationAction.java;1;0;3;1;1;1;1;2;2;0;1;93;4;4;2;1;0;2;3;93;1;336;2;1;0
/org.eclipse.jdt.ui/ui/org/eclipse/jdt/internal/ui/preferences/formatter/AlreadyExistsDialog.java;1;0;4;1;0;0;0;4;22;2;3;178;26;26;2;1;0;4;4;178;1;219;3;1;0
/org.eclipse.help/src/org/eclipse/help/internal/toc/ITocNode.java;1;1;4;1;2;2;2;2;21;0;1;197;43;43;2;1;0;2;4;197;1;336;3;1;0
/org.eclipse.swt/Eclipse SWT/carbon/org/eclipse/swt/widgets/Composite.java;4;1;14;1;3;3;3;11;54;2;9;1;231;231;2;2;0;11;14;26;2;337;12;4;0
/org.eclipse.pde.ui/src/org/eclipse/pde/internal/ui/wizards/templates/PerspectiveExtensionsNewWizard.java;3;2;5;1;4;3;4;1;12;0;1;222;31;31;2;0;1;1;5;308;1;336;4;3;0
/org.eclipse.jface.text/src/org/eclipse/jface/contentassist/ComboContentAssistSubjectAdapter.java;1;2;4;1;4;2;4;0;28;0;0;279;50;50;2;0;2;0;4;279;2;336;2;1;0
/org.eclipse.swt/Eclipse SWT PI/gtk/org/eclipse/swt/internal/gtk/XCrossingEvent.java;1;0;1;1;1;1;1;0;0;0;0;337;0;0;1;0;0;0;1;337;0;337;1;1;0
/org.eclipse.jdt.ui/core extension/org/eclipse/jdt/internal/corext/callhierarchy/Implementors.java;2;0;3;1;1;1;1;2;8;0;1;12;10;10;2;1;0;2;3;12;1;336;2;2;0
/org.eclipse.ui.workbench/Eclipse UI/org/eclipse/ui/part/WorkbenchPart.java;6;4;21;3;10;4;10;11;522;4;5;157;899;899;4;6;6;11;21;252;12;336;9;6;2
/org.eclipse.osgi/core/framework/org/eclipse/osgi/framework/console/CommandInterpreter.java;4;1;5;1;3;3;3;2;115;1;2;171;124;124;1;0;0;2;5;171;0;336;5;4;0
/org.eclipse.swt/Eclipse SWT PI/carbon/org/eclipse/swt/internal/Platform.java;1;0;1;1;0;0;0;1;0;0;1;117;0;0;1;0;0;1;1;117;0;117;1;1;0
/org.eclipse.osgi/core/adaptor/org/eclipse/osgi/framework/util/SecureAction.java;3;0;6;3;1;1;3;3;94;3;2;245;99;99;3;1;2;5;6;269;3;336;3;3;0
/org.eclipse.jdt.core/formatter/org/eclipse/jdt/internal/formatter/CodeFormatterVisitor.java;4;2;73;3;3;2;8;65;3112;40;6;54;5675;5675;40;59;6;70;73;85;65;314;8;4;9
/org.eclipse.team.cvs.core/src/org/eclipse/team/internal/ccvs/core/ICVSRemoteResource.java;1;0;2;1;1;1;1;1;21;0;1;232;23;23;1;0;0;1;2;232;0;336;2;1;0
/org.eclipse.jdt.ui/ui refactoring/org/eclipse/jdt/internal/ui/refactoring/RefactoringSavePreferences.java;2;0;2;1;1;1;1;1;2;0;1;269;2;2;1;0;0;1;2;269;0;336;2;2;0
/org.eclipse.osgi/core/framework/org/eclipse/osgi/framework/launcher/Launcher.java;4;1;5;1;3;3;3;2;112;1;2;171;224;224;1;0;0;2;5;171;0;336;5;4;0
/org.eclipse.jdt.core/compiler/org/eclipse/jdt/internal/compiler/codegen/AttributeNamesConstants.java;1;0;1;1;0;0;0;1;2;0;1;199;2;2;1;0;0;1;1;199;0;199;1;1;0
/org.eclipse.jdt.ui/ui/org/eclipse/jdt/internal/ui/JavaUIException.java;1;0;1;1;1;1;1;0;2;0;0;336;2;2;1;0;0;0;1;336;0;336;1;1;0
/org.eclipse.core.resources/src/org/eclipse/core/internal/events/PathVariableChangeEvent.java;1;0;1;1;1;1;1;0;8;0;0;277;8;8;1;0;0;0;1;277;0;277;1;1;0
/org.eclipse.jdt.ui/ui/org/eclipse/jdt/internal/ui/text/correction/ASTResolving.java;4;4;22;2;6;3;6;16;190;5;10;16;713;713;5;6;3;16;22;16;9;336;13;4;0
/org.eclipse.jdt.debug.ui/ui/org/eclipse/jdt/internal/debug/ui/classpath/ClasspathMessages.java;1;0;2;1;0;0;0;2;4;1;2;154;6;6;1;0;0;2;2;154;0;245;2;1;0
/org.eclipse.swt/Eclipse SWT Accessibility/common/org/eclipse/swt/accessibility/ACC.java;2;1;4;1;2;2;2;2;7;1;2;131;16;16;1;0;0;2;4;131;0;337;4;2;0
/org.eclipse.jdt.ui/ui refactoring/org/eclipse/jdt/internal/ui/refactoring/PullUpTreeViewer.java;2;0;2;1;1;1;1;1;12;0;1;251;14;14;1;0;0;1;2;251;0;336;2;2;0
/org.eclipse.update.core/src/org/eclipse/update/core/IUpdateConstants.java;1;1;2;1;2;2;2;0;6;0;0;292;10;10;1;0;0;0;2;292;0;336;2;1;0
/org.eclipse.pde.ui/src/org/eclipse/pde/internal/ui/editor/schema/SchemaObjectPropertySource.java;2;1;2;1;2;2;2;0;4;0;0;308;6;6;1;0;0;0;2;308;0;336;2;2;0
/org.eclipse.jdt.ui/ui/org/eclipse/jdt/internal/ui/jarpackager/CheckboxTreeAndListGroup.java;2;1;4;1;2;2;2;2;25;0;1;224;29;29;2;1;0;2;4;224;1;336;3;2;0
/org.eclipse.search/search/org/eclipse/search/internal/ui/OpenFileSearchPageAction.java;2;1;2;1;2;2;2;0;9;0;0;325;11;11;1;0;0;0;2;325;0;336;2;2;0
/org.eclipse.pde.ui/src/org/eclipse/pde/internal/ui/search/DependencyExtentLabelProvider.java;3;1;4;1;2;2;2;2;6;0;1;128;16;16;2;1;0;2;4;128;1;336;3;3;0
/org.eclipse.ui.ide/extensions/org/eclipse/ui/actions/MoveResourceAction.java;1;0;1;1;0;0;0;1;0;0;1;132;0;0;1;0;0;1;1;132;0;132;1;1;0
/org.eclipse.ui.ide/src/org/eclipse/ui/internal/ide/misc/ContainerSelectionGroup.java;2;0;2;1;0;0;0;2;2;1;2;132;2;2;1;0;0;2;2;132;0;144;2;2;1
/org.eclipse.swt/Eclipse SWT/photon/org/eclipse/swt/widgets/Display.java;7;4;26;5;7;4;7;19;406;5;9;0;730;730;5;10;3;19;26;13;13;337;13;7;0
/org.eclipse.jdt.core/compiler/org/eclipse/jdt/internal/compiler/flow/FinallyFlowContext.java;1;0;3;1;0;0;0;3;4;1;3;63;8;8;1;0;0;3;3;63;0;199;3;1;0
/org.eclipse.ui.workbench/Eclipse UI/org/eclipse/ui/internal/activities/CategoryActivityBinding.java;4;0;5;1;1;1;1;4;4;2;3;165;8;8;2;1;0;4;5;165;1;336;4;4;0
/org.eclipse.swt/Eclipse SWT Mozilla/common/org/eclipse/swt/internal/mozilla/nsIDocShell.java;1;0;1;1;0;0;0;1;0;0;1;153;0;0;1;0;0;1;1;153;0;153;1;1;0
/org.eclipse.jdt.ui/ui/org/eclipse/jdt/ui/actions/GenerateActionGroup.java;6;2;15;2;4;3;4;11;144;2;9;13;353;353;2;2;1;11;15;78;3;336;12;6;0
/org.eclipse.ui.intro/src/org/eclipse/ui/internal/intro/impl/util/Log.java;1;1;2;1;2;2;2;0;2;0;0;277;2;2;1;0;0;0;2;277;0;286;2;1;0
/org.eclipse.compare/compare/org/eclipse/compare/internal/MergeViewerContentProvider.java;1;0;3;1;2;1;2;1;39;0;1;183;42;42;2;0;1;1;3;331;1;331;2;1;0
/org.eclipse.jface.text/src/org/eclipse/jface/text/IWidgetTokenOwnerExtension.java;2;0;3;2;2;1;2;1;30;0;1;75;30;30;2;0;1;1;3;336;1;336;2;2;0
/org.eclipse.ui.workbench/Eclipse UI/org/eclipse/ui/internal/IWorkbenchGraphicConstants.java;5;1;11;3;2;2;2;9;116;5;5;157;225;225;5;4;0;9;11;241;4;336;7;5;0
/org.eclipse.jdt.core/compiler/org/eclipse/jdt/internal/compiler/ast/FieldReference.java;2;0;10;1;0;0;0;10;28;3;7;3;75;75;3;3;0;10;10;63;3;199;7;2;6
/org.eclipse.jdt.ui/ui/org/eclipse/jdt/internal/ui/JavaElementContainmentAdapter.java;2;0;2;1;1;1;1;1;2;0;1;75;3;3;1;0;0;1;2;75;0;336;2;2;0
/org.eclipse.team.cvs.ui/src/org/eclipse/team/internal/ccvs/ui/actions/UpdateAction.java;2;1;4;1;2;2;2;2;44;1;2;71;62;62;1;0;0;2;4;71;0;336;4;2;1
/org.eclipse.team.cvs.core/src/org/eclipse/team/internal/ccvs/core/client/ModifiedFileSender.java;1;0;1;1;0;0;0;1;5;0;1;110;5;5;1;0;0;1;1;110;0;110;1;1;0
/org.eclipse.pde.core/src/org/eclipse/pde/internal/core/EclipseHomeInitializer.java;1;1;6;1;3;3;3;3;71;2;2;162;136;136;2;1;0;3;6;162;1;336;5;1;0
/org.eclipse.ui.workbench/Eclipse UI/org/eclipse/ui/keys/ModifierKey.java;3;1;11;2;2;2;2;9;101;3;6;79;331;331;3;3;0;9;11;79;3;336;8;3;0
/org.eclipse.jdt.ui/ui/org/eclipse/jdt/internal/ui/preferences/formatter/WhiteSpaceTabPage.java;2;0;13;2;1;1;1;12;2537;10;3;176;2588;2588;10;9;0;12;13;184;9;336;4;2;1
/org.eclipse.jdt.ui/ui/org/eclipse/jdt/internal/ui/JavaElementProperties.java;1;0;1;1;1;1;1;0;2;0;0;336;2;2;1;0;0;0;1;336;0;336;1;1;0
/org.eclipse.jdt.ui/ui/org/eclipse/jdt/internal/ui/search/PostfixLabelProvider.java;1;3;9;1;7;3;7;2;84;1;2;227;145;145;3;0;4;2;9;274;4;300;5;1;1
/org.eclipse.jdt.debug/jdi/org/eclipse/jdi/internal/event/ClassPrepareEventImpl.java;3;0;3;1;1;1;1;2;4;1;2;52;10;10;1;0;0;2;3;52;0;336;3;3;0
/org.eclipse.ant.ui/Ant Tools Support/org/eclipse/ant/internal/ui/launchConfigurations/AntLaunchShortcutWithDialog.java;2;0;2;2;2;1;2;0;4;0;0;293;4;4;2;0;1;0;2;293;1;293;1;2;0
/org.eclipse.pde.core/src/org/eclipse/pde/internal/core/isite/ISiteBuildObject.java;1;0;2;1;1;1;1;1;4;0;1;232;8;8;1;0;0;1;2;232;0;336;2;1;0
/org.eclipse.ui.ide/src/org/eclipse/ui/views/markers/internal/DefaultMarkerResourceAdapter.java;1;0;1;1;0;0;0;1;0;0;1;129;0;0;1;0;0;1;1;129;0;129;1;1;0
/org.eclipse.jdt.debug/model/org/eclipse/jdt/internal/debug/core/breakpoints/JavaBreakpoint.java;4;0;10;3;0;0;0;10;50;4;7;26;110;110;4;3;0;10;10;235;3;235;7;4;3
/org.eclipse.jdt.ui/ui/org/eclipse/jdt/internal/ui/text/correction/MarkerResolutionProposal.java;2;0;4;1;1;1;1;3;11;1;3;72;25;25;1;0;0;3;4;72;0;336;4;2;0
/org.eclipse.osgi/resolver/src/org/eclipse/osgi/internal/resolver/ReadOnlyState.java;3;1;5;2;2;2;3;2;86;2;2;209;134;134;2;0;1;3;5;269;1;296;4;3;0
/org.eclipse.team.cvs.ui/src/org/eclipse/team/internal/ccvs/ui/OverlayIconCache.java;1;0;1;1;0;0;0;1;1;0;1;116;1;1;1;0;0;1;1;116;0;116;1;1;0
/org.eclipse.jdt.ui/ui/org/eclipse/jdt/internal/ui/javaeditor/IJavaEditorActionConstants.java;2;0;3;1;1;1;1;2;15;1;2;35;27;27;1;0;0;2;3;35;0;336;3;2;0
/org.eclipse.ui.workbench/Eclipse UI/org/eclipse/ui/internal/commands/Category.java;3;1;16;1;2;2;2;14;258;3;9;42;557;557;3;5;0;14;16;92;5;336;11;3;0
/org.eclipse.jface/src/org/eclipse/jface/action/MenuManager.java;8;1;15;2;3;3;3;12;1206;3;7;27;1350;1350;3;5;0;12;15;27;5;336;10;8;1
/org.eclipse.jdt.junit/src/org/eclipse/jdt/internal/junit/ui/ProgressImages.java;1;0;1;1;1;1;1;0;2;0;0;336;2;2;1;0;0;0;1;336;0;336;1;1;0
/org.eclipse.search/new search/org/eclipse/search2/internal/ui/CancelSearchAction.java;2;1;4;1;2;2;2;2;5;1;2;225;11;11;1;0;0;2;4;225;0;336;4;2;0
/org.eclipse.ui.workbench/Eclipse UI/org/eclipse/ui/internal/presentations/SystemMenuCloseOthers.java;1;0;2;1;2;1;2;0;4;0;0;296;4;4;2;0;1;0;2;296;1;296;1;1;0
/org.eclipse.osgi/defaultAdaptor/src/org/eclipse/osgi/framework/internal/protocol/reference/Handler.java;4;1;5;1;3;3;3;2;61;1;2;171;97;97;1;0;0;2;5;171;0;336;5;4;0
/org.eclipse.core.runtime/src/org/eclipse/core/internal/jobs/JobManager.java;3;3;75;3;4;2;18;57;3132;18;10;23;5400;5400;18;47;16;71;75;265;63;337;12;3;3
/org.eclipse.swt/Eclipse SWT Custom Widgets/common/org/eclipse/swt/custom/CLabel.java;4;2;8;1;5;4;5;3;78;1;3;9;117;117;2;0;1;3;8;302;1;337;7;4;0
/org.eclipse.text/src/org/eclipse/text/edits/CopySourceEdit.java;2;0;4;1;1;1;1;3;186;2;2;118;371;371;2;1;0;3;4;118;1;336;3;2;0
/org.eclipse.jdt.core/model/org/eclipse/jdt/internal/core/TypeVector.java;1;0;1;1;0;0;0;1;2;0;1;199;2;2;1;0;0;1;1;199;0;199;1;1;0
/org.eclipse.jdt.core/compiler/org/eclipse/jdt/internal/compiler/parser/NLSLine.java;1;0;1;1;0;0;0;1;2;0;1;199;2;2;1;0;0;1;1;199;0;199;1;1;0
/org.eclipse.debug.core/core/org/eclipse/debug/internal/core/memory/MemoryByte.java;1;0;1;1;1;1;1;0;0;0;0;282;0;0;1;0;0;0;1;282;0;282;1;1;2
/org.eclipse.jdt.core/compiler/org/eclipse/jdt/internal/compiler/codegen/IntegerCache.java;1;0;1;1;0;0;0;1;2;0;1;199;2;2;1;0;0;1;1;199;0;199;1;1;0
/org.eclipse.team.cvs.core/src/org/eclipse/team/internal/ccvs/core/client/TagFileSender.java;1;0;1;1;0;0;0;1;5;0;1;110;5;5;1;0;0;1;1;110;0;110;1;1;0
/org.eclipse.team.ui/src/org/eclipse/team/ui/synchronize/WorkingSetScope.java;2;2;4;1;4;3;4;0;183;0;0;299;237;237;2;0;1;0;4;299;1;335;3;2;2
/org.eclipse.jdt.core/compiler/org/eclipse/jdt/internal/compiler/ast/CaseStatement.java;2;0;7;1;0;0;0;7;32;2;6;11;65;65;2;1;0;7;7;11;1;225;6;2;1
/org.eclipse.jdt.debug.ui/ui/org/eclipse/jdt/internal/debug/core/refactoring/JavaWatchpointIFieldRenameParticipant.java;3;0;6;2;1;1;1;5;35;4;2;247;75;75;4;3;0;5;6;247;3;336;3;3;0
/org.eclipse.ui.workbench/Eclipse UI/org/eclipse/ui/dialogs/YesNoCancelListSelectionDialog.java;1;0;1;1;1;1;1;0;153;0;0;293;153;153;1;0;0;0;1;293;0;293;1;1;0
/org.eclipse.jdt.ui/ui/org/eclipse/jdt/internal/ui/filters/NonPublicFilter.java;1;0;2;1;1;1;1;1;2;0;1;133;2;2;1;0;0;1;2;133;0;336;2;1;0
/org.eclipse.jdt.core/batch/org/eclipse/jdt/internal/compiler/batch/ClasspathJar.java;2;0;3;1;0;0;0;3;24;1;3;80;36;36;1;0;0;3;3;80;0;199;3;2;0
/org.eclipse.jdt.debug/model/org/eclipse/jdt/internal/debug/core/breakpoints/JavaTargetPatternBreakpoint.java;3;0;3;1;0;0;0;3;7;1;3;26;11;11;1;0;0;3;3;26;0;157;3;3;0
/org.eclipse.debug.ui/ui/org/eclipse/debug/internal/ui/views/memory/AbstractTableViewTabLabelProvider.java;2;0;2;2;2;1;2;0;12;0;0;282;12;12;2;0;1;0;2;282;1;282;1;2;1
/org.eclipse.team.cvs.core/src/org/eclipse/team/internal/ccvs/core/CVSMergeSyncInfo.java;2;0;8;2;1;1;1;7;23;3;4;57;68;68;3;3;0;7;8;71;3;312;5;2;0
/org.eclipse.ltk.core.refactoring/src/org/eclipse/ltk/core/refactoring/participants/IConditionChecker.java;1;0;3;1;2;1;2;1;7;0;1;264;7;7;2;0;1;1;3;278;1;278;2;1;0
/org.eclipse.ui.cheatsheets/src/org/eclipse/ui/cheatsheets/AbstractItemExtensionElement.java;2;0;4;2;1;1;1;3;164;2;2;253;187;187;2;1;0;3;4;253;1;275;3;2;0
/org.eclipse.swt/Eclipse SWT PI/win32/org/eclipse/swt/internal/win32/LOGFONTW.java;1;0;1;1;0;0;0;1;0;0;1;61;0;0;1;0;0;1;1;61;0;61;1;1;0
/org.eclipse.pde.ui/src/org/eclipse/pde/internal/ui/wizards/tools/ConvertedProjectsPage.java;2;1;5;1;3;3;3;2;28;1;2;213;46;46;1;0;0;2;5;213;0;336;5;2;0
/org.eclipse.ui.workbench/Eclipse UI/org/eclipse/ui/internal/DetachedPlaceHolder.java;4;0;3;2;1;1;1;2;203;1;2;223;215;215;1;0;0;2;3;223;0;336;3;4;0
/org.eclipse.core.runtime/src/org/eclipse/core/runtime/SubProgressMonitor.java;3;2;7;2;3;2;3;4;676;3;2;83;692;692;3;2;1;4;7;171;3;336;4;3;0
/org.eclipse.ui.console/src/org/eclipse/ui/console/MessageConsoleStream.java;2;0;4;1;0;0;0;4;9;2;3;118;16;16;2;1;0;4;4;118;1;200;3;2;0
/org.eclipse.pde.ui/src/org/eclipse/pde/internal/ui/editor/feature/InfoFormPage.java;2;1;4;1;3;3;3;1;71;0;1;232;83;83;1;0;0;1;4;232;0;336;4;2;0
/org.eclipse.core.runtime/src/org/eclipse/core/internal/runtime/AuthorizationDatabase.java;3;3;8;3;5;3;5;3;1340;0;1;171;1372;1372;3;2;2;3;8;171;4;336;4;3;1
/org.eclipse.jdt.launching/launching/org/eclipse/jdt/launching/sourcelookup/containers/JavaSourcePathComputer.java;1;0;1;1;1;1;1;0;0;0;0;275;0;0;1;0;0;0;1;275;0;275;1;1;0
/org.eclipse.debug.core/core/org/eclipse/debug/core/ILogicalStructureType.java;3;0;3;1;1;1;1;2;4;1;2;153;6;6;1;0;0;2;3;153;0;336;3;3;1
/org.eclipse.jdt.core/compiler/org/eclipse/jdt/internal/compiler/flow/UnconditionalFlowInfo.java;3;0;6;1;1;1;1;5;19;2;4;2;50;50;2;1;0;5;6;61;1;299;5;3;1
/org.eclipse.jdt.ui/ui/org/eclipse/jdt/internal/ui/callhierarchy/HistoryListAction.java;3;0;5;1;1;1;1;4;24;1;4;16;31;31;1;0;0;4;5;16;0;336;5;3;0
/org.eclipse.jdt.ui/core extension/org/eclipse/jdt/internal/corext/util/IFileTypeInfo.java;2;0;4;1;1;1;1;3;25;2;2;162;38;38;2;1;0;3;4;162;1;336;3;2;0
/org.eclipse.team.cvs.ui/src/org/eclipse/team/internal/ccvs/ui/wizards/RepositorySelectionPage.java;2;1;6;1;2;2;2;4;23;1;4;116;47;47;1;0;0;4;6;116;0;336;6;2;0
/org.eclipse.debug.ui/ui/org/eclipse/debug/internal/ui/sourcelookup/RestoreDefaultAction.java;2;0;6;2;1;1;1;5;23;2;3;209;50;50;2;2;0;5;6;227;2;309;4;2;0
/org.eclipse.swt/Eclipse SWT Mozilla/common/org/eclipse/swt/internal/mozilla/nsIInputStreamChannel.java;1;0;1;1;0;0;0;1;0;0;1;153;0;0;1;0;0;1;1;153;0;153;1;1;0
/org.eclipse.ui.ide/src/org/eclipse/ui/internal/ide/dialogs/CreateProjectStep.java;1;0;1;1;0;0;0;1;0;0;1;132;0;0;1;0;0;1;1;132;0;132;1;1;0
/org.eclipse.pde.core/src/org/eclipse/pde/internal/core/plugin/AttributeChangedEvent.java;3;1;4;1;2;2;2;2;4;1;2;232;12;12;1;0;0;2;4;232;0;336;4;3;0
/org.eclipse.ant.ui/Ant Editor/org/eclipse/ant/internal/ui/dtd/schema/SchemaFactory.java;1;0;2;1;0;0;0;2;6;1;2;108;6;6;1;0;0;2;2;108;0;135;2;1;0
/org.eclipse.swt/Eclipse SWT PI/gtk/org/eclipse/swt/internal/gtk/XFocusChangeEvent.java;2;0;2;2;2;1;2;0;4;0;0;331;4;4;2;0;1;0;2;331;1;331;1;2;0
/org.eclipse.pde.ui/src/org/eclipse/pde/internal/ui/wizards/exports/FeatureExportWizardPage.java;3;2;8;2;3;2;3;5;44;1;5;99;128;128;2;0;1;5;8;304;1;336;7;3;0
/org.eclipse.jdt.ui/ui refactoring/org/eclipse/jdt/internal/ui/refactoring/RefactoringMessages.java;1;0;1;1;1;1;1;0;2;0;0;336;2;2;1;0;0;0;1;336;0;336;1;1;0
/org.eclipse.team.ui/src/org/eclipse/team/internal/ui/dialogs/DialogArea.java;2;0;6;2;1;1;1;5;203;2;4;63;260;260;2;1;0;5;6;244;1;336;5;2;1
/org.eclipse.pde.ui/src/org/eclipse/pde/internal/ui/editor/text/IReconcilingParticipant.java;1;1;2;1;2;2;2;0;10;0;0;292;10;10;1;0;0;0;2;292;0;336;2;1;0
/org.eclipse.jdt.core/search/org/eclipse/jdt/core/search/SearchMatch.java;2;9;12;1;10;2;10;2;335;1;2;181;411;411;9;0;8;2;12;275;8;314;4;2;0
/org.eclipse.ui.ide/src/org/eclipse/ui/views/navigator/ResourceSelectionUtil.java;1;0;1;1;0;0;0;1;0;0;1;129;0;0;1;0;0;1;1;129;0;129;1;1;0
/org.eclipse.tomcat/src/org/eclipse/tomcat/internal/SocketUtil.java;1;1;3;1;2;2;2;1;77;0;1;27;83;83;1;0;0;1;3;27;0;336;3;1;0
/org.eclipse.debug.ui/ui/org/eclipse/debug/internal/ui/actions/StatusDialog.java;2;0;2;2;0;0;0;2;10;0;1;92;10;10;2;1;0;2;2;92;1;92;1;2;0
/org.eclipse.jdt.ui/ui/org/eclipse/jdt/internal/ui/search/JavaSearchQuery.java;4;0;18;4;1;1;11;7;345;11;4;207;577;577;11;3;10;17;18;269;13;336;5;4;1
/org.eclipse.jdt.debug.ui/ui/org/eclipse/jdt/internal/debug/ui/actions/ArchiveFilter.java;2;0;2;1;0;0;0;2;10;1;2;74;14;14;1;0;0;2;2;74;0;91;2;2;0
/org.eclipse.ltk.ui.refactoring/src/org/eclipse/ltk/internal/ui/refactoring/FinishResult.java;1;0;1;1;1;1;1;0;0;0;0;281;0;0;1;0;0;0;1;281;0;281;1;1;0
/org.eclipse.jdt.ui/core refactoring/org/eclipse/jdt/internal/corext/refactoring/rename/RenameAnalyzeUtil.java;4;3;17;4;5;3;7;10;197;4;6;57;323;323;4;4;4;12;17;265;8;336;9;4;0
/org.eclipse.ui.workbench/Eclipse UI/org/eclipse/ui/internal/themes/CascadingColorRegistry.java;1;0;2;1;0;0;0;2;11;1;2;241;11;11;1;0;0;2;2;241;0;262;2;1;0
/org.eclipse.update.core/src/org/eclipse/update/core/model/ContentEntryModel.java;1;2;3;1;3;2;3;0;14;0;0;289;18;18;2;0;1;0;3;289;1;336;2;1;0
/org.eclipse.update.ui/src/org/eclipse/update/internal/ui/security/UpdateManagerAuthenticator.java;3;1;6;1;3;3;3;3;264;1;3;58;314;314;1;0;0;3;6;58;0;336;6;3;0
/org.eclipse.jdt.ui/ui/org/eclipse/jdt/internal/ui/search/SortAction.java;1;0;3;1;1;1;1;2;7;1;2;207;9;9;1;0;0;2;3;207;0;292;3;1;0
/org.eclipse.ui.workbench/Eclipse UI/org/eclipse/ui/internal/progress/ProgressTreeContentProvider.java;2;1;4;1;2;2;2;2;100;0;1;199;117;117;2;1;0;2;4;199;1;314;3;2;0
/org.eclipse.update.ui/src/org/eclipse/update/internal/ui/security/JarVerificationService.java;3;1;5;1;2;2;2;3;29;2;2;52;48;48;2;1;0;3;5;52;1;336;4;3;1
/org.eclipse.ui.workbench/Eclipse UI/org/eclipse/ui/internal/ActionExpression.java;3;1;5;1;2;2;2;3;136;1;3;157;173;173;1;0;0;3;5;157;0;336;5;3;0
/org.eclipse.ui.intro/src/org/eclipse/ui/internal/intro/impl/model/AbstractTextElement.java;1;2;5;1;5;4;5;0;17;0;0;276;37;37;2;0;1;0;5;276;1;331;4;1;0
/org.eclipse.ui.ide/src/org/eclipse/ui/internal/ide/dialogs/ProjectCapabilitySimpleSelectionPage.java;1;0;1;1;0;0;0;1;0;0;1;132;0;0;1;0;0;1;1;132;0;132;1;1;0
/org.eclipse.swt/Eclipse SWT PI/win32/org/eclipse/swt/internal/ole/win32/DVTARGETDEVICE.java;1;0;1;1;0;0;0;1;4;0;1;166;4;4;1;0;0;1;1;166;0;166;1;1;0
/org.eclipse.jdt.ui/ui/org/eclipse/jdt/internal/ui/text/javadoc/IJavaDocTagConstants.java;3;0;5;2;1;1;1;4;7;2;3;212;15;15;2;1;0;4;5;240;1;336;4;3;0
/org.eclipse.core.runtime/src/org/eclipse/core/internal/jobs/JobListeners.java;3;5;18;3;7;2;7;11;607;5;6;43;1062;1062;5;5;5;11;18;167;10;289;8;3;0
/org.eclipse.update.ui/src/org/eclipse/update/internal/ui/security/UserValidationDialog.java;4;1;5;2;2;2;2;3;129;2;2;58;157;157;2;1;0;3;5;58;1;336;4;4;0
/org.eclipse.pde.build/src/org/eclipse/pde/internal/build/site/QualifierReplacer.java;1;3;4;1;4;2;4;0;36;0;0;296;36;36;3;0;2;0;4;307;2;307;2;1;0
/org.eclipse.pde.ui/src/org/eclipse/pde/internal/ui/editor/feature/SynchronizeVersionsWizardPage.java;3;1;7;1;3;3;3;4;27;2;3;130;64;64;2;1;0;4;7;130;1;336;6;3;0
/org.eclipse.swt/Eclipse SWT/gtk/org/eclipse/swt/widgets/Composite.java;7;4;29;3;7;4;7;22;88;3;15;19;454;454;4;7;3;22;29;300;10;337;19;7;1
/org.eclipse.jdt.ui/ui/org/eclipse/jdt/internal/ui/MarkerAdapterFactory.java;1;0;1;1;1;1;1;0;2;0;0;336;2;2;1;0;0;0;1;336;0;336;1;1;0
/org.eclipse.core.resources/src/org/eclipse/core/internal/resources/InternalWorkspaceJob.java;2;0;8;1;1;1;1;7;70;3;4;71;87;87;3;3;0;7;8;117;3;277;5;2;0
/org.eclipse.jdt.ui/ui/org/eclipse/jdt/internal/ui/typehierarchy/TraditionalHierarchyViewer.java;3;2;7;2;3;2;3;4;84;2;3;35;191;191;2;1;1;4;7;226;2;336;5;3;0
/org.eclipse.swt/Eclipse SWT OLE Win32/win32/org/eclipse/swt/ole/win32/OleControlSite.java;1;0;1;1;0;0;0;1;12;0;1;152;12;12;1;0;0;1;1;152;0;152;1;1;0
/org.eclipse.help.webapp/src_servlets/org/eclipse/help/internal/webapp/servlet/TocServlet.java;2;1;7;1;3;3;3;4;81;2;3;80;159;159;2;1;0;4;7;156;1;336;6;2;0
/org.eclipse.team.ui/src/org/eclipse/team/internal/ui/wizards/ExportProjectSetMainPage.java;1;1;4;1;2;2;2;2;200;1;2;63;205;205;1;0;0;2;4;63;0;336;4;1;0
/org.eclipse.jdt.ui/ui/org/eclipse/jdt/internal/ui/callhierarchy/CallHierarchyFiltersActionGroup.java;2;1;5;1;2;2;2;3;5;2;2;13;12;12;2;1;0;3;5;13;1;336;4;2;0
/org.eclipse.ui.workbench/Eclipse UI/org/eclipse/ui/internal/BundleGroupProperties.java;1;2;3;1;3;2;3;0;156;0;0;294;156;156;2;0;1;0;3;320;1;320;2;1;0
/org.eclipse.jdt.core/compiler/org/eclipse/jdt/internal/compiler/env/IDependent.java;1;0;1;1;0;0;0;1;2;0;1;199;2;2;1;0;0;1;1;199;0;199;1;1;0
/org.eclipse.ui.ide/src/org/eclipse/ui/internal/ide/dialogs/CreateProjectWizard.java;1;0;1;1;0;0;0;1;0;0;1;132;0;0;1;0;0;1;1;132;0;132;1;1;0
/org.eclipse.jdt.core/model/org/eclipse/jdt/core/IOpenable.java;3;0;5;1;1;1;1;4;8;1;4;149;18;18;1;0;0;4;5;149;0;275;5;3;0
/org.eclipse.jdt.ui/ui/org/eclipse/jdt/internal/ui/text/correction/AbstractMethodCompletionProposal.java;2;2;3;1;3;2;3;0;39;0;0;296;41;41;2;0;1;0;3;296;1;336;2;2;0
/org.eclipse.core.expressions/src/org/eclipse/core/internal/expressions/StandardElementHandler.java;1;0;3;1;1;1;1;2;8;1;2;227;10;10;1;0;0;2;3;227;0;336;3;1;0
/org.eclipse.debug.ui/ui/org/eclipse/debug/ui/console/IConsoleLineTrackerExtension.java;2;0;2;2;0;0;0;2;2;0;1;127;2;2;2;1;0;2;2;127;1;127;1;2;0
/org.eclipse.debug.ui/ui/org/eclipse/debug/internal/ui/actions/SkipAllBreakpointsAction.java;3;0;4;2;0;0;0;4;62;2;3;233;76;76;2;1;0;4;4;244;1;265;3;3;0
/org.eclipse.jdt.ui/ui/org/eclipse/jdt/internal/ui/wizards/buildpaths/UserLibraryWizardPage.java;1;2;5;1;4;3;4;1;60;0;1;243;89;89;2;0;1;1;5;276;1;326;4;1;0
/org.eclipse.osgi/resolver/src/org/eclipse/core/internal/dependencies/IElementSetVisitor.java;3;0;3;2;2;1;2;1;16;0;1;171;16;16;2;0;1;1;3;276;1;276;2;3;0
/org.eclipse.team.cvs.core/src/org/eclipse/team/internal/ccvs/core/resources/CVSEntryLineTag.java;2;1;4;1;2;2;3;1;65;0;1;270;71;71;2;0;1;2;4;270;1;336;3;2;0
/org.eclipse.jdt.core/dom/org/eclipse/jdt/core/dom/MethodRef.java;2;0;9;1;2;1;2;7;109;2;5;206;158;158;2;2;1;7;9;206;3;276;6;2;1
/org.eclipse.pde.core/src/org/eclipse/pde/internal/core/feature/FeatureURLElement.java;2;1;3;1;2;2;2;1;20;0;1;232;34;34;1;0;0;1;3;232;0;336;3;2;0
/org.eclipse.jdt.core/search/org/eclipse/jdt/internal/core/search/indexing/RemoveFolderFromIndex.java;2;0;9;2;1;1;2;7;20;2;6;60;49;49;2;1;1;8;9;180;2;302;7;2;0
/org.eclipse.help.ui/src/org/eclipse/help/ui/internal/HyperlinkHandler.java;1;1;2;1;2;2;2;0;87;0;0;311;103;103;1;0;0;0;2;311;0;336;2;1;0
/org.eclipse.ui.workbench/Eclipse UI/org/eclipse/ui/progress/WorkbenchJob.java;2;2;5;1;3;2;3;2;17;1;2;170;47;47;2;0;1;2;5;287;1;336;4;2;0
/org.eclipse.jdt.core/dom/org/eclipse/jdt/core/dom/TypeLiteral.java;4;0;9;1;2;1;2;7;75;2;6;71;107;107;2;1;1;7;9;266;2;276;7;4;1
/org.eclipse.debug.ui/ui/org/eclipse/debug/internal/ui/actions/RetargetAction.java;1;0;3;1;0;0;0;3;40;2;2;245;56;56;2;1;0;3;3;245;1;254;2;1;0
/org.eclipse.ui.workbench/Eclipse UI/org/eclipse/ui/progress/IProgressConstants.java;2;3;5;1;5;3;5;0;23;0;0;293;31;31;3;0;2;0;5;326;2;326;3;2;0
/org.eclipse.jdt.ui/ui/org/eclipse/jdt/internal/ui/text/java/ProposalContextInformation.java;1;0;1;1;1;1;1;0;2;0;0;336;2;2;1;0;0;0;1;336;0;336;1;1;0
/org.eclipse.pde.ui/src/org/eclipse/pde/internal/ui/search/UnusedDependenciesOperation.java;2;1;4;1;2;2;2;2;24;0;1;168;42;42;2;1;0;2;4;168;1;336;3;2;0
/org.eclipse.ui.workbench.texteditor/src/org/eclipse/ui/texteditor/DeleteLineTarget.java;2;2;4;2;4;2;4;0;27;0;0;275;37;37;2;0;2;0;4;275;2;331;2;2;0
/org.eclipse.team.cvs.ui/src/org/eclipse/team/internal/ccvs/ui/repo/RefreshTagsAction.java;2;1;2;1;2;2;2;0;44;0;0;272;46;46;1;0;0;0;2;272;0;336;2;2;0
/org.eclipse.core.expressions/src/org/eclipse/core/internal/expressions/IterateExpression.java;1;1;3;1;2;2;2;1;10;0;1;227;12;12;1;0;0;1;3;227;0;336;3;1;0
/org.eclipse.jdt.ui/ui refactoring/org/eclipse/jdt/internal/ui/refactoring/nls/search/NLSSearchPage.java;5;2;13;3;4;3;6;7;144;4;4;80;258;258;4;3;3;9;13;268;6;336;7;5;0
/org.eclipse.jdt.core/compiler/org/eclipse/jdt/internal/compiler/ast/JavadocArgumentExpression.java;3;0;6;2;0;0;0;6;24;2;4;165;33;33;2;2;0;6;6;165;2;211;4;3;0
/org.eclipse.jdt.ui/core refactoring/org/eclipse/jdt/internal/corext/refactoring/changes/UndoCompilationUnitChange.java;1;0;6;1;1;1;1;5;133;2;3;204;182;182;2;2;0;5;6;204;2;278;4;1;0
/org.eclipse.jdt.ui/core extension/org/eclipse/jdt/internal/corext/javadoc/SingleCharReader.java;1;0;1;1;1;1;1;0;2;0;0;336;2;2;1;0;0;0;1;336;0;336;1;1;0
/org.eclipse.swt/Eclipse SWT Accessibility/common/org/eclipse/swt/accessibility/AccessibleControlListener.java;1;0;1;1;0;0;0;1;2;0;1;94;2;2;1;0;0;1;1;94;0;94;1;1;0
/org.eclipse.core.runtime/src/org/eclipse/core/internal/preferences/DefaultPreferences.java;1;4;10;1;10;4;10;0;205;0;0;286;261;261;4;0;6;0;10;286;6;332;4;1;3
/org.eclipse.team.cvs.ui/src/org/eclipse/team/internal/ccvs/ui/wizards/KSubstWizardCommitCommentPage.java;2;1;3;1;2;2;2;1;10;0;1;138;13;13;1;0;0;1;3;138;0;336;3;2;0
/org.eclipse.update.core/src/org/eclipse/update/core/IContentConsumer.java;2;2;4;1;3;2;3;1;10;0;1;58;17;17;2;0;1;1;4;289;1;336;3;2;0
/org.eclipse.core.resources/src/org/eclipse/core/internal/indexing/ObjectStoreException.java;1;0;1;1;1;1;1;0;47;0;0;277;47;47;1;0;0;0;1;277;0;277;1;1;0
/org.eclipse.pde.ui/src/org/eclipse/pde/internal/ui/wizards/templates/TemplateSelectionPage.java;3;1;6;1;3;3;3;3;24;1;3;145;62;62;1;0;0;3;6;145;0;336;6;3;0
/org.eclipse.swt/Eclipse SWT/gtk/org/eclipse/swt/graphics/Device.java;6;1;9;2;3;3;3;6;26;2;5;0;69;69;2;1;0;6;9;111;1;337;8;6;2
/org.eclipse.jdt.ui/ui/org/eclipse/jdt/internal/ui/wizards/dialogfields/ListDialogField.java;4;1;5;1;3;3;3;2;40;1;2;88;110;110;1;0;0;2;5;88;0;336;5;4;0
/org.eclipse.jdt.core/dom/org/eclipse/jdt/core/dom/ASTVisitor.java;3;0;7;2;1;1;1;6;1915;3;4;85;2553;2553;3;2;0;6;7;199;2;283;5;3;1
/org.eclipse.search/new search/org/eclipse/search2/internal/ui/basic/views/TableViewerNavigator.java;2;3;4;1;4;2;4;0;11;0;0;275;13;13;3;0;2;0;4;275;2;336;2;2;0
/org.eclipse.swt/Eclipse SWT/carbon/org/eclipse/swt/widgets/ScrollBar.java;5;1;14;2;3;3;3;11;37;3;8;1;147;147;3;3;0;11;14;19;3;337;11;5;0
/org.eclipse.jdt.ui/ui/org/eclipse/jdt/ui/actions/ExtractMethodAction.java;3;0;9;1;1;1;1;8;39;2;6;9;90;90;2;2;0;8;9;9;2;336;7;3;1
/org.eclipse.ui.ide/src/org/eclipse/ui/internal/ide/misc/ResourceAndContainerGroup.java;3;1;3;1;2;2;2;1;22;0;1;132;26;26;1;0;0;1;3;132;0;336;3;3;1
/org.eclipse.ui.workbench/Eclipse UI/org/eclipse/ui/internal/presentations/PaneFolderButtonListener.java;1;0;1;1;1;1;1;0;0;0;0;283;0;0;1;0;0;0;1;283;0;283;1;1;0
/org.eclipse.team.cvs.core/src/org/eclipse/team/internal/ccvs/core/CVSTeamProvider.java;2;2;26;2;6;4;7;19;348;4;9;56;1408;1408;4;10;3;20;26;139;13;336;13;2;1
/org.eclipse.debug.core/core/org/eclipse/debug/core/model/ILaunchConfigurationDelegate2.java;1;0;4;1;1;1;1;3;62;2;2;240;68;68;2;1;0;3;4;251;1;275;3;1;0
/org.eclipse.ltk.core.refactoring/src/org/eclipse/ltk/core/refactoring/FileStatusContext.java;1;2;4;1;3;2;3;1;7;0;1;269;10;10;2;0;1;1;4;336;1;336;3;1;0
/org.eclipse.search/new search/org/eclipse/search2/internal/ui/basic/views/TreeViewerNavigator.java;2;2;4;2;4;3;4;0;209;0;0;275;226;226;2;0;1;0;4;326;1;326;3;2;0
/org.eclipse.jdt.ui/ui/org/eclipse/jdt/internal/ui/text/correction/ImplementInterfaceProposal.java;1;0;2;1;2;1;2;0;15;0;0;289;15;15;2;0;1;0;2;289;1;289;1;1;0
/org.eclipse.swt/Eclipse SWT Mozilla/common/org/eclipse/swt/internal/mozilla/nsIFile.java;1;0;2;1;0;0;0;2;106;1;2;100;106;106;1;0;0;2;2;100;0;148;2;1;0
/org.eclipse.jdt.ui/ui/org/eclipse/jdt/ui/actions/DeclarationsSearchGroup.java;2;0;5;1;1;1;1;4;29;2;3;82;44;44;2;1;0;4;5;97;1;336;4;2;0
/org.eclipse.ltk.ui.refactoring/src/org/eclipse/ltk/internal/ui/refactoring/UndoManagerAction.java;1;4;7;1;7;4;7;0;96;0;0;278;114;114;4;0;3;0;7;278;3;336;4;1;0
/org.eclipse.jface/src/org/eclipse/jface/action/SubStatusLineManager.java;1;0;1;1;0;0;0;1;28;0;1;38;28;28;1;0;0;1;1;38;0;38;1;1;0
/org.eclipse.ui.workbench.texteditor/src/org/eclipse/ui/texteditor/MoveLinesAction.java;3;1;9;2;2;2;2;7;635;3;4;31;683;683;3;3;0;7;9;70;3;336;6;3;0
/org.eclipse.update.ui/src/org/eclipse/update/internal/ui/views/RevertConfigurationAction.java;3;0;6;2;1;1;1;5;15;2;3;54;29;29;2;2;0;5;6;54;2;336;4;3;0
/org.eclipse.team.cvs.ui/src/org/eclipse/team/internal/ccvs/ui/model/RemoteVersionModule.java;1;0;1;1;0;0;0;1;2;0;1;63;2;2;1;0;0;1;1;63;0;63;1;1;0
/org.eclipse.team.cvs.ui/src/org/eclipse/team/internal/ccvs/ui/wizards/ConfigurationWizardMainPage.java;2;2;10;1;7;5;7;3;165;1;3;68;338;338;2;0;2;3;10;301;2;329;8;2;2
/org.eclipse.ui.views/src/org/eclipse/ui/views/properties/PropertySheetViewer.java;3;2;4;1;3;2;3;1;499;0;1;145;505;505;2;0;1;1;4;295;1;336;3;3;0
/org.eclipse.pde.ui/src/org/eclipse/pde/internal/ui/editor/SourceOutlinePage.java;2;3;5;2;5;3;5;0;42;0;0;292;74;74;3;0;2;0;5;292;2;336;3;2;0
/org.eclipse.debug.ui/ui/org/eclipse/debug/internal/ui/sourcelookup/browsers/FolderSourceContainerDialog.java;1;0;1;1;0;0;0;1;0;0;1;209;0;0;1;0;0;1;1;209;0;209;1;1;0
/org.eclipse.jdt.core/model/org/eclipse/jdt/internal/core/SourceRange.java;1;0;2;1;0;0;0;2;4;1;2;140;6;6;1;0;0;2;2;140;0;199;2;1;0
/org.eclipse.debug.ui/ui/org/eclipse/debug/internal/ui/StringMatcher.java;1;0;1;1;0;0;0;1;792;0;1;221;792;792;1;0;0;1;1;221;0;221;1;1;1
/org.eclipse.jdt.ui/core refactoring/org/eclipse/jdt/internal/corext/refactoring/participants/ResourceProcessors.java;2;0;3;1;1;1;1;2;30;1;2;101;38;38;1;0;0;2;3;101;0;336;3;2;0
/org.eclipse.swt/Eclipse SWT PI/gtk/org/eclipse/swt/internal/accessibility/gtk/AtkSelectionIface.java;4;0;4;1;1;1;1;3;17;1;3;75;35;35;1;0;0;3;4;75;0;337;4;4;0
/org.eclipse.ui.workbench/Eclipse UI/org/eclipse/ui/internal/ShowFastViewContribution.java;2;1;2;1;2;2;2;0;42;0;0;301;44;44;1;0;0;0;2;301;0;336;2;2;0
/org.eclipse.ui.workbench/Eclipse UI/org/eclipse/ui/internal/decorators/DecorationScheduler.java;3;2;25;2;3;2;3;22;487;12;8;47;788;788;12;14;1;22;25;67;15;335;10;3;2
/org.eclipse.team.cvs.core/src/org/eclipse/team/internal/ccvs/core/client/listeners/StatusListener.java;2;0;2;1;1;1;1;1;16;0;1;268;18;18;1;0;0;1;2;268;0;336;2;2;0
/org.eclipse.jface.text/src/org/eclipse/jface/text/source/VerticalRulerEvent.java;2;1;2;1;2;2;2;0;6;0;0;279;8;8;1;0;0;0;2;279;0;336;2;2;0
/org.eclipse.jdt.ui/ui/org/eclipse/jdt/internal/ui/filters/EmptyInnerPackageFilter.java;1;0;1;1;1;1;1;0;2;0;0;336;2;2;1;0;0;0;1;336;0;336;1;1;0
/org.eclipse.core.runtime/src/org/eclipse/core/internal/runtime/Cipher.java;3;3;7;3;4;2;4;3;604;0;1;171;623;623;3;2;2;3;7;171;4;336;3;3;0
/org.eclipse.ui.workbench/Eclipse UI/org/eclipse/ui/internal/IPreferenceConstants.java;7;3;20;3;5;3;5;15;103;4;8;111;300;300;4;7;2;15;20;240;9;336;11;7;1
/org.eclipse.core.resources/src/org/eclipse/core/resources/team/IResourceTree.java;1;0;3;1;0;0;2;1;84;0;1;270;84;84;3;0;2;3;3;270;2;270;1;1;0
/org.eclipse.osgi/core/framework/org/eclipse/osgi/service/debug/DebugOptions.java;2;1;4;1;3;3;3;1;4;0;1;178;11;11;1;0;0;1;4;178;0;336;4;2;0
/org.eclipse.jdt.core/compiler/org/eclipse/jdt/internal/compiler/lookup/ClassScope.java;5;2;14;2;3;2;3;11;136;2;8;67;293;293;2;3;1;11;14;165;4;312;10;5;8
/org.eclipse.ui.ide/extensions/org/eclipse/ui/dialogs/WizardExportResourcesPage.java;1;0;2;1;0;0;0;2;4;1;2;132;4;4;1;0;0;2;2;132;0;150;2;1;0
/org.eclipse.jdt.ui/ui/org/eclipse/jdt/internal/ui/text/spelling/engine/DefaultSpellChecker.java;3;1;4;1;2;2;2;2;80;1;2;219;107;107;1;0;0;2;4;219;0;336;4;3;0
/org.eclipse.core.runtime/src/org/eclipse/core/runtime/preferences/AbstractPreferenceInitializer.java;1;0;1;1;1;1;1;0;0;0;0;288;0;0;1;0;0;0;1;288;0;288;1;1;0
/org.eclipse.team.cvs.ui/src/org/eclipse/team/internal/ccvs/ui/wizards/ConfigurationWizardAutoconnectPage.java;2;0;3;1;1;1;1;2;11;1;2;138;15;15;1;0;0;2;3;138;0;336;3;2;0
/org.eclipse.jdt.core/dom/org/eclipse/jdt/core/dom/TextElement.java;2;0;8;1;1;1;1;7;64;3;4;206;94;94;3;3;0;7;8;206;3;283;5;2;1
/org.eclipse.jdt.core/search/org/eclipse/jdt/core/search/TypeDeclarationMatch.java;2;0;7;2;3;1;3;4;31;2;2;218;59;59;3;2;2;4;7;275;4;275;3;2;0
/org.eclipse.core.resources/src/org/eclipse/core/resources/IPathVariableManager.java;1;0;2;1;0;0;1;1;10;0;1;270;10;10;2;0;1;2;2;270;1;270;1;1;0
/org.eclipse.jdt.ui/ui/org/eclipse/jdt/internal/ui/typehierarchy/ShowQualifiedTypeNamesAction.java;1;0;1;1;1;1;1;0;2;0;0;336;2;2;1;0;0;0;1;336;0;336;1;1;0
/org.eclipse.jdt.ui/ui/org/eclipse/jdt/internal/ui/actions/AddTaskAction.java;2;0;2;1;1;1;1;1;4;0;1;41;6;6;1;0;0;1;2;41;0;336;2;2;0
/org.eclipse.team.cvs.ui/src/org/eclipse/team/internal/ccvs/ui/operations/CheckoutToRemoteFolderOperation.java;2;1;5;1;2;2;2;3;35;1;3;184;42;42;1;0;0;3;5;184;0;336;5;2;0
/org.eclipse.ui.ide/src/org/eclipse/ui/wizards/newresource/BasicNewFileResourceWizard.java;2;0;3;2;0;0;0;3;10;0;1;92;10;10;3;2;0;3;3;92;2;92;1;2;0
/org.eclipse.jdt.ui/ui/org/eclipse/jdt/internal/ui/text/correction/LinkedCorrectionProposal.java;4;2;19;3;3;2;6;13;219;8;6;72;691;691;8;7;4;16;19;254;11;311;8;4;1
/org.eclipse.pde.core/src/org/eclipse/pde/internal/core/build/WorkspaceBuildModel.java;3;2;5;2;3;2;3;2;6;1;2;145;16;16;2;0;1;2;5;303;1;336;4;3;0
/org.eclipse.ui.ide/extensions/org/eclipse/ui/actions/AddBookmarkAction.java;1;0;2;1;0;0;0;2;2;1;2;132;2;2;1;0;0;2;2;132;0;150;2;1;0
/org.eclipse.jdt.debug.ui/ui/org/eclipse/jdt/internal/debug/core/refactoring/JavaWatchpointFieldNameChange.java;3;0;7;2;1;1;1;6;107;4;2;247;130;130;4;4;0;6;7;247;4;336;3;3;0
/org.eclipse.jdt.ui/ui/org/eclipse/jdt/internal/ui/wizards/OpenProjectWizardAction.java;2;0;2;1;1;1;1;1;2;0;1;212;4;4;1;0;0;1;2;212;0;336;2;2;0
/org.eclipse.debug.ui/ui/org/eclipse/debug/internal/ui/views/memory/IMemoryView.java;1;0;1;1;1;1;1;0;0;0;0;282;0;0;1;0;0;0;1;282;0;282;1;1;0
/org.eclipse.pde.ui/src/org/eclipse/pde/internal/ui/editor/plugin/JavaAttributeWizardPage.java;2;1;3;1;3;3;3;0;20;0;0;292;26;26;1;0;0;0;3;292;0;336;3;2;0
/org.eclipse.debug.ui/ui/org/eclipse/debug/internal/ui/actions/ToggleDetailPaneAction.java;1;0;2;1;0;0;0;2;8;0;1;46;8;8;2;1;0;2;2;46;1;46;1;1;0
/org.eclipse.ui.workbench/Eclipse UI/org/eclipse/ui/internal/presentations/SystemMenuSize.java;2;0;2;1;1;1;1;1;12;0;1;256;12;12;1;0;0;1;2;256;0;279;2;2;0
/org.eclipse.swt/Eclipse SWT Drag and Drop/emulated/org/eclipse/swt/dnd/Transfer.java;1;1;2;1;2;2;2;0;4;0;0;300;6;6;1;0;0;0;2;300;0;337;2;1;0
/org.eclipse.ant.ui/Ant Editor/org/eclipse/ant/internal/ui/editor/outline/ToggleLinkWithEditorAction.java;1;0;1;1;0;0;0;1;0;0;1;252;0;0;1;0;0;1;1;252;0;252;1;1;1
/org.eclipse.compare/compare/org/eclipse/compare/IContentChangeListener.java;1;0;1;1;0;0;0;1;2;0;1;219;2;2;1;0;0;1;1;219;0;219;1;1;0
/org.eclipse.team.cvs.ssh2/src/org/eclipse/team/internal/ccvs/ssh2/CVSSSH2PreferencePage.java;3;5;10;2;7;3;8;2;235;0;1;263;338;338;5;1;5;3;10;304;6;326;4;3;0
/org.eclipse.swt/Eclipse SWT/win32/org/eclipse/swt/widgets/ToolItem.java;2;0;6;1;1;1;1;5;46;2;4;15;66;66;2;1;0;5;6;15;1;337;5;2;0
/org.eclipse.swt/Eclipse SWT AWT/win32/org/eclipse/swt/awt/SWT_AWT.java;3;3;12;2;7;4;7;5;78;2;4;171;279;279;3;1;3;5;12;276;4;334;8;3;2
/org.eclipse.pde.ui/src/org/eclipse/pde/internal/ui/wizards/imports/PluginImportWizardFirstPage.java;2;2;15;2;4;3;4;11;766;2;9;26;1081;1081;2;2;1;11;15;45;3;336;12;2;0
/org.eclipse.text/src/org/eclipse/jface/text/BadPositionCategoryException.java;1;0;1;1;1;1;1;0;4;0;0;334;4;4;1;0;0;0;1;334;0;334;1;1;0
/org.eclipse.swt/Eclipse SWT/common/org/eclipse/swt/internal/image/WinICOFileFormat.java;2;1;3;1;2;2;2;1;38;0;1;234;69;69;1;0;0;1;3;234;0;337;3;2;0
/org.eclipse.core.resources/src/org/eclipse/core/internal/watson/IDeltaFilter.java;1;0;1;1;1;1;1;0;22;0;0;277;22;22;1;0;0;0;1;277;0;277;1;1;0
/org.eclipse.update.core/src/org/eclipse/update/core/FeatureContentProvider.java;3;2;11;2;4;3;4;7;1511;4;3;58;1614;1614;4;4;1;7;11;171;5;336;6;3;1
/org.eclipse.ui.workbench/Eclipse UI/org/eclipse/ui/internal/PartListenerList2.java;2;1;2;1;2;2;2;0;48;0;0;287;50;50;1;0;0;0;2;287;0;336;2;2;0
/org.eclipse.ant.ui/Ant Tools Support/org/eclipse/ant/internal/ui/preferences/GlobalClasspathEntries.java;1;0;7;1;1;1;1;6;47;3;4;128;87;87;3;2;0;6;7;128;2;336;5;1;0
/org.eclipse.jdt.ui/core refactoring/org/eclipse/jdt/internal/corext/refactoring/rename/RenameVirtualMethodProcessor.java;4;1;14;2;3;3;3;11;97;4;5;71;158;158;4;6;0;11;14;247;6;336;8;4;0
/org.eclipse.osgi/core/adaptor/org/eclipse/osgi/framework/adaptor/BundleWatcher.java;2;2;4;1;4;3;4;0;7;0;0;274;14;14;2;0;1;0;4;274;1;336;3;2;0
/org.eclipse.update.core/src/org/eclipse/update/internal/core/ContentConsumer.java;1;0;1;1;0;0;0;1;2;0;1;58;2;2;1;0;0;1;1;58;0;58;1;1;0
/org.eclipse.core.resources/src/org/eclipse/core/internal/dtree/NoDataDeltaNode.java;1;0;1;1;1;1;1;0;200;0;0;277;200;200;1;0;0;0;1;277;0;277;1;1;0
/org.eclipse.jdt.ui/ui/org/eclipse/jdt/internal/ui/text/JavaPresentationReconciler.java;1;0;1;1;1;1;1;0;0;0;0;283;0;0;1;0;0;0;1;283;0;283;1;1;0
/org.eclipse.ui.cheatsheets/src/org/eclipse/ui/internal/cheatsheets/dialogs/CheatSheetSelectionDialog.java;2;0;4;1;1;1;1;3;17;1;3;243;22;22;1;0;0;3;4;243;0;307;4;2;0
/org.eclipse.team.cvs.ui/src/org/eclipse/team/internal/ccvs/ui/model/GroupedByVersionCategory.java;1;0;1;1;0;0;0;1;2;0;1;63;2;2;1;0;0;1;1;63;0;63;1;1;0
/org.eclipse.ui.intro/src/org/eclipse/ui/internal/intro/impl/swt/PageWidgetFactory.java;1;5;6;1;6;2;6;0;202;0;0;306;206;206;5;0;4;0;6;306;4;333;2;1;0
/org.eclipse.ui.editors/src/org/eclipse/ui/texteditor/DefaultMarkerAnnotationAccess.java;3;2;12;1;4;3;4;8;349;3;6;118;594;594;3;2;1;8;12;175;3;336;9;3;0
/org.eclipse.update.core/src/org/eclipse/update/internal/core/SiteFilePluginContentConsumer.java;3;0;5;1;1;1;1;4;48;1;4;58;98;98;1;0;0;4;5;58;0;302;5;3;1
/org.eclipse.jdt.core/model/org/eclipse/jdt/internal/core/util/CodeSnippetParsingUtil.java;1;0;5;1;0;0;0;5;168;0;1;202;168;168;5;4;0;5;5;202;4;202;1;1;1
/org.eclipse.help.webapp/src_servlets/org/eclipse/help/internal/webapp/servlet/FilterHTMLHeadOutputStream.java;1;1;2;1;2;2;2;0;31;0;0;311;37;37;1;0;0;0;2;311;0;336;2;1;1
/org.eclipse.core.runtime/src/org/eclipse/core/runtime/content/IContentDescriber.java;2;0;7;2;1;1;4;3;79;4;2;251;115;115;4;1;3;6;7;268;4;300;3;2;0
/org.eclipse.jdt.core/search/org/eclipse/jdt/internal/core/search/matching/DeclarationOfAccessedFieldsPattern.java;3;0;9;2;1;1;1;8;94;2;6;7;196;196;2;2;0;8;9;37;2;280;7;3;0
/org.eclipse.swt/Eclipse SWT Mozilla/common/org/eclipse/swt/internal/mozilla/nsIWebProgress.java;1;0;2;1;0;0;0;2;4;1;2;100;4;4;1;0;0;2;2;100;0;148;2;1;0
/org.eclipse.jdt.ui/ui/org/eclipse/jdt/internal/ui/search/NameSorter.java;1;0;3;1;2;1;2;1;8;0;1;207;8;8;2;0;1;1;3;290;1;290;2;1;1
/org.eclipse.ui.workbench/Eclipse UI/org/eclipse/ui/internal/EditorActionBars.java;4;1;9;2;2;2;2;7;765;3;4;181;974;974;3;3;0;7;9;203;3;336;6;4;0
/org.eclipse.pde.core/src/org/eclipse/pde/internal/core/search/PluginSearchScope.java;1;0;4;1;1;1;1;3;15;2;2;26;30;30;2;1;0;3;4;232;1;336;3;1;0
/org.eclipse.team.ui/src/org/eclipse/team/internal/ui/synchronize/actions/RemoveSynchronizeParticipantAction.java;2;3;6;1;4;2;4;2;104;1;2;221;149;149;3;0;2;2;6;292;2;336;4;2;0
/org.eclipse.swt/Eclipse SWT Mozilla/common/org/eclipse/swt/internal/mozilla/nsILoadGroup.java;1;0;1;1;0;0;0;1;0;0;1;153;0;0;1;0;0;1;1;153;0;153;1;1;0
/org.eclipse.jdt.core/dom/org/eclipse/jdt/core/dom/TagElement.java;4;1;13;2;2;2;2;11;129;5;3;206;247;247;5;8;0;11;13;206;8;312;5;4;2
/org.eclipse.jdt.ui/ui/org/eclipse/jdt/internal/ui/typehierarchy/SubTypeHierarchyViewer.java;2;0;3;1;1;1;1;2;20;1;2;35;24;24;1;0;0;2;3;35;0;336;3;2;0
/org.eclipse.jdt.core/model/org/eclipse/jdt/internal/core/SourceRefElementInfo.java;1;0;1;1;0;0;0;1;2;0;1;199;2;2;1;0;0;1;1;199;0;199;1;1;0
/org.eclipse.jdt.core/model/org/eclipse/jdt/core/eval/IGlobalVariable.java;2;0;2;1;0;0;0;2;2;1;2;199;4;4;1;0;0;2;2;199;0;221;2;2;0
/org.eclipse.core.resources/src/org/eclipse/core/internal/events/NodeIDMap.java;1;0;1;1;1;1;1;0;472;0;0;277;472;472;1;0;0;0;1;277;0;277;1;1;0
/org.eclipse.ui.forms/src/org/eclipse/ui/internal/forms/widgets/Paragraph.java;1;1;2;1;2;2;2;0;4;0;0;272;4;4;1;0;0;0;2;272;0;336;2;1;0
/org.eclipse.jdt.ui/core refactoring/org/eclipse/jdt/internal/corext/refactoring/ExceptionInfo.java;3;1;3;1;2;2;2;1;8;0;1;148;10;10;1;0;0;1;3;148;0;336;3;3;0
/org.eclipse.pde.ui/src_Forms/org/eclipse/pde/internal/ui/model/plugin/PluginDocumentNodeFactory.java;3;2;9;2;3;2;5;4;45;4;2;244;106;106;4;2;3;6;9;265;5;336;4;3;0
/org.eclipse.jdt.core/dom/org/eclipse/jdt/core/dom/QualifiedName.java;4;0;12;2;0;0;2;10;109;5;7;70;172;172;5;3;2;12;12;266;5;266;7;4;1
/org.eclipse.update.core/src/org/eclipse/update/core/Site.java;3;2;7;1;4;3;4;3;26;1;3;0;71;71;2;0;1;3;7;289;1;336;6;3;0
/org.eclipse.ui.ide/src/org/eclipse/ui/internal/ide/LinkedResourceDecorator.java;3;1;3;1;2;2;2;1;8;0;1;132;10;10;1;0;0;1;3;132;0;336;3;3;0
/org.eclipse.debug.ui/ui/org/eclipse/debug/internal/ui/InstructionPointerAnnotation.java;2;0;7;2;0;0;0;7;65;2;5;72;180;180;2;2;0;7;7;163;2;201;5;2;0
/org.eclipse.pde.core/src/org/eclipse/pde/internal/core/search/PluginSearchOperation.java;2;1;5;1;2;2;2;3;15;1;3;26;24;24;1;0;0;3;5;26;0;336;5;2;0
/org.eclipse.jdt.core/model/org/eclipse/jdt/core/IImportContainer.java;1;0;1;1;0;0;0;1;2;0;1;199;2;2;1;0;0;1;1;199;0;199;1;1;0
/org.eclipse.jdt.core/model/org/eclipse/jdt/internal/core/IPathRequestor.java;1;0;2;1;0;0;0;2;2;1;2;124;4;4;1;0;0;2;2;124;0;199;2;1;0
/org.eclipse.jdt.ui/ui/org/eclipse/jdt/internal/ui/workingsets/EditWorkingSetAction.java;1;0;2;1;1;1;1;1;3;0;1;82;5;5;1;0;0;1;2;82;0;336;2;1;0
/org.eclipse.jdt.core/model/org/eclipse/jdt/internal/core/builder/BatchImageBuilder.java;4;0;13;3;1;1;1;12;52;3;7;16;147;147;3;5;0;12;13;171;5;293;8;4;1
/org.eclipse.jface.text/src/org/eclipse/jface/text/IPainter.java;2;0;2;2;2;1;2;0;62;0;0;336;62;62;2;0;1;0;2;336;1;336;1;2;0
/org.eclipse.compare/compare/org/eclipse/compare/HistoryItem.java;1;0;6;1;2;1;2;4;19;3;2;165;40;40;3;2;1;4;6;219;3;319;3;1;1
/org.eclipse.ui.workbench/Eclipse UI/org/eclipse/ui/commands/IHandler.java;2;1;11;1;2;2;2;9;91;4;4;67;275;275;4;5;0;9;11;67;5;292;6;2;0
/org.eclipse.ui.ide/extensions/org/eclipse/ui/actions/WorkspaceAction.java;4;0;7;2;1;1;2;5;588;3;4;132;629;629;3;1;1;6;7;268;2;336;5;4;0
/org.eclipse.ui.workbench/Eclipse UI/org/eclipse/ui/part/PageBookView.java;3;4;7;2;5;2;5;2;161;1;2;228;169;169;4;0;3;2;7;287;3;336;4;3;1
/org.eclipse.help.base/src/org/eclipse/help/internal/search/SearchHit.java;1;1;3;1;2;2;2;1;18;0;1;104;24;24;1;0;0;1;3;104;0;336;3;1;0
/org.eclipse.pde.build/src/org/eclipse/pde/internal/build/site/PluginRegistryConverter.java;2;2;5;2;4;3;4;1;140;0;1;230;161;161;2;0;1;1;5;272;1;330;4;2;0
/org.eclipse.pde.runtime/src/org/eclipse/pde/internal/runtime/registry/RegistryBrowserContentProvider.java;2;0;10;1;1;1;1;9;560;5;5;59;620;620;5;4;0;9;10;219;4;336;6;2;0
/org.eclipse.jdt.core/compiler/org/eclipse/jdt/internal/compiler/codegen/ObjectCache.java;2;0;2;1;1;1;1;1;2;0;1;199;4;4;1;0;0;1;2;199;0;314;2;2;0
/org.eclipse.jdt.core/formatter/org/eclipse/jdt/internal/formatter/BinaryExpressionFragmentBuilder.java;3;0;13;2;2;1;2;11;195;3;5;37;579;579;3;6;1;11;13;127;7;300;6;3;0
/org.eclipse.jdt.core/compiler/org/eclipse/jdt/internal/compiler/problem/ShouldNotImplement.java;2;0;2;1;0;0;0;2;8;1;2;85;10;10;1;0;0;2;2;85;0;199;2;2;0
/org.eclipse.swt/Eclipse SWT/gtk/org/eclipse/swt/graphics/Image.java;5;1;11;2;3;3;3;8;101;3;6;0;199;199;3;2;0;8;11;228;2;337;9;5;2
/org.eclipse.jdt.ui/ui/org/eclipse/jdt/internal/ui/jarpackager/JarPackageWizard.java;2;0;3;1;1;1;1;2;21;1;2;28;28;28;1;0;0;2;3;28;0;336;3;2;0
/org.eclipse.jdt.ui/ui/org/eclipse/jdt/internal/ui/text/correction/SimilarElement.java;1;0;1;1;1;1;1;0;2;0;0;336;2;2;1;0;0;0;1;336;0;336;1;1;0
/org.eclipse.jdt.ui/ui/org/eclipse/jdt/internal/ui/text/comment/ITextMeasurement.java;2;0;2;2;0;0;0;2;35;0;1;240;35;35;2;1;0;2;2;240;1;240;1;2;0
/org.eclipse.jdt.ui/ui refactoring/org/eclipse/jdt/internal/ui/refactoring/nls/PackageFragmentSelection.java;3;1;3;1;2;2;2;1;16;0;1;267;22;22;1;0;0;1;3;267;0;336;3;3;0
/org.eclipse.core.runtime/src/org/eclipse/core/runtime/ILogListener.java;2;1;6;2;2;2;2;4;132;3;2;171;140;140;3;2;0;4;6;171;2;336;4;2;0
/org.eclipse.jdt.ui/ui/org/eclipse/jdt/internal/ui/JavaPluginImages.java;5;1;17;4;2;2;8;9;193;10;6;18;217;217;10;3;6;15;17;263;9;336;8;5;0
/org.eclipse.jdt.ui/core refactoring/org/eclipse/jdt/internal/corext/refactoring/structure/ReferenceFinderUtil.java;4;2;6;2;4;2;4;2;58;1;2;24;108;108;2;0;2;2;6;283;2;331;4;4;0
/org.eclipse.jface.text/src/org/eclipse/jface/text/rules/DefaultPartitioner.java;4;4;9;3;8;3;8;1;190;0;1;93;287;287;4;0;5;1;9;274;5;335;4;4;0
/org.eclipse.update.configurator/src/org/eclipse/update/internal/configurator/ProductProvider.java;1;0;2;1;1;1;1;1;2;0;1;229;2;2;1;0;0;1;2;229;0;296;2;1;0
/org.eclipse.pde.ui/src/org/eclipse/pde/internal/ui/wizards/imports/ShowTargetPlatformAction.java;2;2;3;2;3;2;3;0;16;0;0;290;17;17;2;0;1;0;3;290;1;308;2;2;0
/org.eclipse.ui.workbench/Eclipse UI/org/eclipse/ui/internal/commands/ws/ICommandService.java;2;0;2;1;1;1;1;1;6;0;1;268;6;6;1;0;0;1;2;268;0;336;2;2;0
/org.eclipse.pde.runtime/src/org/eclipse/pde/internal/runtime/registry/PluginObjectAdapter.java;1;0;1;1;0;0;0;1;2;0;1;59;2;2;1;0;0;1;1;59;0;59;1;1;0
/org.eclipse.osgi/eclipseAdaptor/src/org/eclipse/core/runtime/adaptor/Semaphore.java;4;2;5;2;4;3;4;1;7;0;1;171;14;14;2;0;1;1;5;275;1;336;4;4;0
/org.eclipse.jdt.core/model/org/eclipse/jdt/internal/core/util/HandleFactory.java;4;2;22;4;3;2;3;19;360;7;6;114;649;649;7;13;1;19;22;169;14;301;8;4;3
/org.eclipse.ui.ide/src/org/eclipse/ui/wizards/datatransfer/IDataTransferHelpContextIds.java;1;0;1;1;0;0;0;1;0;0;1;92;0;0;1;0;0;1;1;92;0;92;1;1;0
/org.eclipse.pde.core/src/org/eclipse/pde/internal/core/build/Build.java;3;1;5;1;3;3;3;2;6;1;2;232;17;17;1;0;0;2;5;232;0;336;5;3;0
/org.eclipse.jdt.ui/core refactoring/org/eclipse/jdt/internal/corext/refactoring/rename/RenameCompilationUnitProcessor.java;3;3;17;2;4;2;4;13;119;5;7;71;198;198;5;6;2;13;17;247;8;336;9;3;1
/org.eclipse.pde.core/src/org/eclipse/pde/core/plugin/IFragmentModel.java;2;2;3;1;3;2;3;0;18;0;0;276;24;24;2;0;1;0;3;276;1;336;2;2;0
/org.eclipse.pde.ui/src/org/eclipse/pde/internal/ui/editor/plugin/DependenciesPage.java;3;3;6;2;6;3;6;0;47;0;0;292;74;74;3;0;3;0;6;330;3;330;3;3;0
/org.eclipse.swt/Eclipse SWT PI/win32/org/eclipse/swt/internal/win32/NMTTDISPINFOW.java;1;0;1;1;0;0;0;1;0;0;1;61;0;0;1;0;0;1;1;61;0;61;1;1;0
/org.eclipse.team.cvs.ui/src/org/eclipse/team/internal/ccvs/ui/subscriber/SafeUpdateOperation.java;2;1;7;1;5;5;5;2;43;0;1;244;88;88;2;1;0;2;7;244;1;336;6;2;0
/org.eclipse.jdt.ui/core refactoring/org/eclipse/jdt/internal/corext/refactoring/nls/PropertyFileDocumentModel.java;4;4;8;3;8;3;8;0;292;0;0;289;341;341;4;0;5;0;8;306;5;326;3;4;0
/org.eclipse.ui.workbench/Eclipse UI/org/eclipse/ui/internal/progress/GroupInfo.java;2;1;6;1;2;2;2;4;111;3;2;205;188;188;3;2;0;4;6;205;2;336;4;2;0
/org.eclipse.ui.workbench.texteditor/src/org/eclipse/ui/internal/texteditor/quickdiff/RevertSelectionAction.java;2;0;4;1;1;1;1;3;6;1;3;100;14;14;1;0;0;3;4;100;0;336;4;2;0
/org.eclipse.update.core/src/org/eclipse/update/internal/core/HttpResponse.java;3;1;9;1;2;2;2;7;136;3;5;58;180;180;3;2;0;7;9;171;2;336;7;3;1
/org.eclipse.ui.workbench/Eclipse UI/org/eclipse/ui/commands/IWorkbenchCommandSupport.java;4;1;16;2;3;3;3;13;186;5;5;177;456;456;5;8;0;13;16;226;8;336;8;4;0
/org.eclipse.pde.build/src/org/eclipse/pde/internal/build/builder/DevClassPathHelper.java;2;2;4;2;3;2;3;1;95;0;1;259;97;97;2;0;1;1;4;272;1;307;3;2;0
/org.eclipse.ui.forms/src/org/eclipse/ui/forms/events/IHyperlinkListener.java;1;1;2;1;2;2;2;0;6;0;0;272;6;6;1;0;0;0;2;272;0;336;2;1;0
/org.eclipse.jdt.ui/ui refactoring/org/eclipse/jdt/internal/ui/refactoring/ParameterEditDialog.java;3;1;7;1;2;2;2;5;56;2;4;80;167;167;2;1;0;5;7;204;1;336;6;3;0
/org.eclipse.jdt.core/search/org/eclipse/jdt/internal/core/index/MemoryIndex.java;2;0;4;1;1;1;1;3;106;1;3;213;117;117;1;0;0;3;4;213;0;283;4;2;0
/org.eclipse.jdt.ui/ui/org/eclipse/jdt/internal/ui/viewsupport/JavaElementLabels.java;3;1;10;1;2;2;2;8;43;2;7;73;153;153;2;1;0;8;10;125;1;336;9;3;0
/org.eclipse.ui.workbench/Eclipse UI/org/eclipse/ui/internal/ActionSetActionBars.java;6;1;8;3;2;2;2;6;527;2;4;181;762;762;2;2;0;6;8;181;2;336;6;6;0
/org.eclipse.team.cvs.ui/src/org/eclipse/team/internal/ccvs/ui/wizards/CheckoutAsLocationSelectionPage.java;2;1;7;1;2;2;2;5;316;1;5;20;380;380;1;0;0;5;7;20;0;336;7;2;0
/org.eclipse.compare/compare/org/eclipse/compare/CompareConfiguration.java;1;0;3;1;1;1;1;2;6;1;2;211;13;13;1;0;0;2;3;211;0;335;3;1;0
/org.eclipse.ui.workbench/Eclipse UI/org/eclipse/ui/IKeyBindingService.java;3;1;5;1;2;2;2;3;69;1;3;52;131;131;1;0;0;3;5;52;0;336;5;3;0
/org.eclipse.ui.workbench.texteditor/src/org/eclipse/ui/texteditor/quickdiff/IQuickDiffReferenceProvider.java;2;2;6;2;3;2;3;3;31;2;2;100;51;51;2;1;1;3;6;100;2;336;4;2;0
/org.eclipse.help.ide/src/org/eclipse/help/ui/internal/search/HelpSearchResult.java;1;1;2;1;2;2;2;0;15;0;0;281;21;21;1;0;0;0;2;281;0;311;2;1;0
/org.eclipse.ui.workbench/Eclipse UI/org/eclipse/ui/internal/PluginActionSetBuilder.java;7;1;7;4;2;2;2;5;341;4;2;54;382;382;4;3;0;5;7;181;3;336;4;7;0
/org.eclipse.ui.ide/src/org/eclipse/ui/internal/ide/dialogs/IDEPerspectivesPreferencePage.java;3;1;4;2;2;2;2;2;59;0;1;160;64;64;2;1;0;2;4;160;1;336;3;3;1
/org.eclipse.ant.ui/Ant Editor/org/eclipse/ant/internal/ui/editor/text/XMLMarkerAnnotation.java;1;0;4;1;1;1;1;3;64;1;3;108;114;114;1;0;0;3;4;108;0;299;4;1;1
/org.eclipse.jdt.core/search/org/eclipse/jdt/core/search/SearchPattern.java;3;0;12;2;6;1;6;6;561;3;4;181;690;690;6;2;5;6;12;275;7;275;5;3;3
/org.eclipse.ui.workbench/Eclipse UI/org/eclipse/ui/activities/IActivityListener.java;3;1;6;1;2;2;2;4;22;1;4;131;42;42;1;0;0;4;6;131;0;336;6;3;0
/org.eclipse.jdt.ui/ui/org/eclipse/jdt/internal/ui/wizards/buildpaths/BuildPathBasePage.java;2;0;3;1;1;1;1;2;38;1;2;192;42;42;1;0;0;2;3;192;0;336;3;2;0
/org.eclipse.ui.workbench/Eclipse UI/org/eclipse/ui/internal/BooleanModel.java;2;0;2;1;0;0;0;2;61;1;2;211;61;61;1;0;0;2;2;211;0;223;2;2;0
/org.eclipse.ui.workbench/Eclipse UI/org/eclipse/ui/internal/progress/ErrorNotificationDialog.java;1;3;9;1;6;2;6;3;364;1;3;195;662;662;3;0;4;3;9;279;4;294;5;1;1
/org.eclipse.core.runtime/src/org/eclipse/core/runtime/jobs/MultiRule.java;3;1;12;3;3;3;3;9;398;4;4;86;496;496;4;5;0;9;12;171;5;313;7;3;0
/org.eclipse.core.runtime.compatibility/src-model/org/eclipse/core/internal/model/RegistryResolver.java;3;1;4;1;3;3;3;1;48;0;1;171;58;58;1;0;0;1;4;171;0;336;4;3;0
/org.eclipse.ui.ide/extensions/org/eclipse/ui/part/FileInPlaceEditorInput.java;1;0;1;1;0;0;0;1;0;0;1;132;0;0;1;0;0;1;1;132;0;132;1;1;0
/org.eclipse.pde.junit.runtime/src/org/eclipse/pde/internal/junit/runtime/CoreTestApplication.java;1;0;2;1;1;1;1;1;4;0;1;89;4;4;1;0;0;1;2;89;0;321;2;1;0
/org.eclipse.update.configurator/src/org/eclipse/update/internal/configurator/PlatformConfiguration.java;2;2;46;1;3;2;18;28;1630;22;5;183;3091;3091;22;23;16;43;46;251;39;336;7;2;1
/org.eclipse.ant.ui/Ant Editor/org/eclipse/ant/internal/ui/editor/templates/AntTemplateVariableTextHover.java;1;0;1;1;1;1;1;0;0;0;0;286;0;0;1;0;0;0;1;286;0;286;1;1;0
/org.eclipse.jdt.debug.ui/ui/org/eclipse/jdt/internal/debug/ui/jres/JREMessages.java;2;0;2;1;0;0;0;2;11;1;2;65;11;11;1;0;0;2;2;65;0;87;2;2;0
/org.eclipse.pde.ui/src/org/eclipse/pde/internal/ui/editor/build/BuildOutlinePage.java;2;1;3;1;2;2;2;1;131;0;1;104;137;137;1;0;0;1;3;104;0;336;3;2;0
/org.eclipse.ant.ui/Ant Editor/org/eclipse/ant/internal/ui/editor/derived/LineBreakingReader.java;1;1;3;1;2;2;2;1;5;0;1;108;9;9;1;0;0;1;3;108;0;336;3;1;0
/org.eclipse.jdt.core/compiler/org/eclipse/jdt/internal/compiler/ast/OperatorExpression.java;3;0;4;1;0;0;0;4;2248;1;4;63;2294;2294;1;0;0;4;4;63;0;199;4;3;0
/org.eclipse.swt/Eclipse SWT OLE Win32/win32/org/eclipse/swt/ole/win32/OleFrame.java;1;0;1;1;0;0;0;1;5;0;1;169;5;5;1;0;0;1;1;169;0;169;1;1;1
/org.eclipse.help/src/org/eclipse/help/internal/context/Contexts.java;1;1;2;1;2;2;2;0;6;0;0;311;10;10;1;0;0;0;2;311;0;336;2;1;0
/org.eclipse.jdt.ui/ui/org/eclipse/jdt/internal/ui/wizards/NewWizardMessages.java;1;0;1;1;1;1;1;0;2;0;0;336;2;2;1;0;0;0;1;336;0;336;1;1;0
/org.eclipse.ui.intro/src/org/eclipse/ui/internal/intro/impl/swt/PageContentForm.java;1;5;6;1;6;2;6;0;43;0;0;305;63;63;5;0;4;0;6;305;4;333;2;1;0
/org.eclipse.core.runtime.compatibility/src-model/org/eclipse/core/runtime/model/PluginDescriptorModel.java;3;1;5;1;3;3;3;2;14;1;2;171;23;23;1;0;0;2;5;171;0;336;5;3;0
/org.eclipse.jdt.core/eval/org/eclipse/jdt/internal/eval/CodeSnippetClassFile.java;4;0;8;1;1;1;1;7;68;1;7;37;128;128;1;0;0;7;8;37;0;315;8;4;1
/org.eclipse.pde/src/org/eclipse/pde/internal/builders/DependencyLoop.java;1;0;2;1;1;1;1;1;6;0;1;232;8;8;1;0;0;1;2;232;0;336;2;1;0
/org.eclipse.help.ide/src/org/eclipse/help/ui/internal/search/ResultTableLabelProvider.java;1;1;3;1;3;3;3;0;2;0;0;281;3;3;1;0;0;0;3;281;0;311;3;1;0
/org.eclipse.core.runtime/src/org/eclipse/core/internal/preferences/ExportedPreferences.java;1;2;8;1;5;3;5;3;31;0;1;240;63;63;3;2;2;3;8;240;4;303;4;1;1
/org.eclipse.pde.ui/src/org/eclipse/pde/internal/ui/wizards/tools/ExtensionPointMappings.java;2;1;3;1;2;2;2;1;34;0;1;213;44;44;1;0;0;1;3;213;0;336;3;2;0
/org.eclipse.help/src/org/eclipse/help/internal/toc/TocManager.java;1;2;13;1;4;3;4;9;56;3;6;135;207;207;3;3;1;9;13;245;4;336;9;1;1
/org.eclipse.jface.text/src/org/eclipse/jface/text/TextSelection.java;2;2;4;2;3;2;3;1;24;0;1;14;39;39;2;0;1;1;4;336;1;336;3;2;0
/org.eclipse.swt/Eclipse SWT Custom Widgets/common/org/eclipse/swt/custom/CBanner.java;4;5;35;3;11;3;16;19;687;10;5;171;1879;1879;10;14;13;24;35;171;27;325;8;4;0
/org.eclipse.jdt.debug.ui/ui/org/eclipse/jdt/internal/debug/ui/actions/RuntimeClasspathAction.java;1;0;3;1;0;0;0;3;31;2;2;91;35;35;2;1;0;3;3;154;1;154;2;1;0
/org.eclipse.update.core/src/org/eclipse/update/core/NonPluginEntry.java;2;1;3;1;2;2;2;1;6;0;1;58;12;12;1;0;0;1;3;58;0;336;3;2;0
/org.eclipse.jdt.core/dom/org/eclipse/jdt/core/dom/Annotation.java;1;0;7;1;2;1;2;5;156;3;2;225;198;198;3;3;1;5;7;225;4;276;3;1;1
/org.eclipse.jdt.core/model/org/eclipse/jdt/internal/core/CopyElementsOperation.java;2;0;7;1;1;1;1;6;20;1;6;10;73;73;1;0;0;6;7;10;0;299;7;2;0
/org.eclipse.jdt.ui/ui refactoring/org/eclipse/jdt/internal/ui/refactoring/reorg/RenameJavaProjectWizard.java;2;1;3;1;2;2;2;1;8;0;1;71;17;17;1;0;0;1;3;71;0;336;3;2;0
/org.eclipse.jdt.ui/ui/org/eclipse/jdt/internal/ui/preferences/PreferencePageSupport.java;1;0;1;1;0;0;0;1;0;0;1;243;0;0;1;0;0;1;1;243;0;243;1;1;0
/org.eclipse.jdt.ui/ui/org/eclipse/jdt/internal/ui/text/SubstitutionTextReader.java;1;0;1;1;1;1;1;0;2;0;0;336;2;2;1;0;0;0;1;336;0;336;1;1;0
/org.eclipse.core.runtime.compatibility/src-boot/org/eclipse/core/internal/boot/FeatureEntry.java;3;1;4;2;2;2;2;2;10;0;1;171;22;22;2;1;0;2;4;171;1;336;3;3;0
/org.eclipse.swt/Eclipse SWT Drag and Drop/win32/org/eclipse/swt/dnd/TableDragUnderEffect.java;1;0;3;1;0;0;0;3;81;0;1;51;81;81;3;2;0;3;3;51;2;51;1;1;0
/org.eclipse.compare/compare/org/eclipse/compare/structuremergeviewer/IDiffElement.java;1;0;1;1;0;0;0;1;2;0;1;219;2;2;1;0;0;1;1;219;0;219;1;1;0
/org.eclipse.swt/Eclipse SWT Mozilla/common/org/eclipse/swt/internal/mozilla/nsIFactory.java;1;0;1;1;0;0;0;1;0;0;1;100;0;0;1;0;0;1;1;100;0;100;1;1;0
/org.eclipse.jdt.ui/ui/org/eclipse/jdt/internal/ui/browsing/ToggleLinkingAction.java;1;0;2;1;1;1;1;1;13;0;1;79;15;15;1;0;0;1;2;79;0;336;2;1;0
/org.eclipse.core.expressions/src/org/eclipse/core/internal/expressions/AdaptExpression.java;1;0;3;1;1;1;1;2;38;1;2;227;40;40;1;0;0;2;3;227;0;336;3;1;0
/org.eclipse.jdt.core/compiler/org/eclipse/jdt/internal/compiler/ast/Javadoc.java;2;1;16;2;3;3;3;13;347;7;4;165;584;584;7;9;0;13;16;165;9;324;7;2;5
/org.eclipse.jdt.core/compiler/org/eclipse/jdt/internal/compiler/ast/ASTNode.java;2;1;6;1;2;2;2;4;63;1;4;170;115;115;1;0;0;4;6;170;0;300;6;2;4
/org.eclipse.jdt.core/compiler/org/eclipse/jdt/internal/compiler/lookup/NestedTypeBinding.java;2;0;2;1;0;0;0;2;26;1;2;2;28;28;1;0;0;2;2;2;0;199;2;2;0
/org.eclipse.update.core/src/org/eclipse/update/internal/core/SiteFileContentConsumer.java;3;0;3;1;1;1;1;2;31;1;2;58;51;51;1;0;0;2;3;58;0;302;3;3;0
/org.eclipse.jdt.ui/ui/org/eclipse/jdt/internal/ui/preferences/AppearancePreferencePage.java;2;0;3;1;1;1;1;2;44;1;2;81;58;58;1;0;0;2;3;81;0;336;3;2;0
/org.eclipse.jdt.debug.ui/ui/org/eclipse/jdt/internal/debug/ui/jres/JREsUpdater.java;4;1;7;1;4;4;4;3;186;1;3;67;281;281;1;0;0;3;7;67;0;336;7;4;0
/org.eclipse.ui.workbench/Eclipse UI/org/eclipse/ui/internal/decorators/FullDecoratorDefinition.java;2;0;2;1;0;0;0;2;3;1;2;81;5;5;1;0;0;2;2;81;0;157;2;2;0
/org.eclipse.jdt.ui/core extension/org/eclipse/jdt/internal/corext/codemanipulation/OrganizeImportsOperation.java;4;3;13;2;5;3;5;8;306;3;6;30;669;669;3;2;2;8;13;264;4;336;9;4;1
/org.eclipse.jdt.launching.macosx/macosx/org/eclipse/jdt/internal/launching/macosx/MacOSXVMRunner.java;1;0;2;1;0;0;0;2;4;1;2;156;6;6;1;0;0;2;2;156;0;203;2;1;0
/org.eclipse.pde.ui/src/org/eclipse/pde/internal/ui/editor/PDESection.java;3;2;4;2;4;3;4;0;10;0;0;292;15;15;2;0;1;0;4;303;1;336;3;3;0
/org.eclipse.jdt.ui/ui/org/eclipse/jdt/internal/ui/callhierarchy/DeferredMethodWrapper.java;2;1;6;1;2;2;2;4;9;2;3;230;15;15;2;1;0;4;6;246;1;336;5;2;1
/org.eclipse.help.base/src/org/eclipse/help/internal/workingset/PropertyChange.java;1;1;3;1;2;2;2;1;189;0;1;104;195;195;1;0;0;1;3;104;0;336;3;1;0
/org.eclipse.jface/src/org/eclipse/jface/viewers/ViewerLabel.java;1;0;1;1;0;0;0;1;0;0;1;251;0;0;1;0;0;1;1;251;0;251;1;1;1
/org.eclipse.pde.core/src/org/eclipse/pde/internal/core/ifeature/IVersionable.java;2;1;3;1;2;2;2;1;4;0;1;232;10;10;1;0;0;1;3;232;0;336;3;2;0
/org.eclipse.jdt.debug/jdi interfaces/com/sun/jdi/ClassType.java;1;0;1;1;0;0;0;1;3;0;1;235;3;3;1;0;0;1;1;235;0;235;1;1;0
/org.eclipse.jface.text/src/org/eclipse/jface/text/PaintManager.java;3;2;7;2;3;2;3;4;18;1;4;82;46;46;2;0;1;4;7;336;1;336;6;3;0
/org.eclipse.ui.workbench/Eclipse UI/org/eclipse/ui/internal/dialogs/NewWizardCollectionSorter.java;2;0;3;1;1;1;1;2;13;1;2;225;21;21;1;0;0;2;3;225;0;336;3;2;1
/org.eclipse.jdt.ui/ui/org/eclipse/jdt/internal/ui/util/TableLayoutComposite.java;1;0;1;1;1;1;1;0;2;0;0;336;2;2;1;0;0;0;1;336;0;336;1;1;0
/org.eclipse.jdt.ui/core refactoring/org/eclipse/jdt/internal/corext/refactoring/structure/ASTNodeSearchUtil.java;4;1;14;1;2;2;2;12;120;4;7;3;364;364;4;5;0;12;14;18;5;336;9;4;0
/org.eclipse.swt/Eclipse SWT PI/gtk/org/eclipse/swt/internal/gtk/GdkImage.java;3;0;3;1;1;1;1;2;17;1;2;100;27;27;1;0;0;2;3;100;0;337;3;3;0
/org.eclipse.ant.ui/Ant Tools Support/org/eclipse/ant/internal/ui/launchConfigurations/AntHomeClasspathEntry.java;2;0;4;2;1;1;1;3;37;2;2;238;58;58;2;1;0;3;4;238;1;299;3;2;1
/org.eclipse.jdt.ui/ui/org/eclipse/jdt/internal/ui/callhierarchy/FocusOnSelectionAction.java;3;0;6;1;1;1;1;5;35;4;2;12;66;66;4;3;0;5;6;12;3;336;3;3;0
/org.eclipse.jdt.ui/ui/org/eclipse/jdt/internal/ui/preferences/TemplateEditorSourceViewerConfiguration.java;3;2;7;2;3;2;3;4;18;3;2;156;38;38;3;2;1;4;7;234;3;336;4;3;0
/org.eclipse.jdt.core/model/org/eclipse/jdt/core/IBuffer.java;2;0;3;1;0;0;0;3;41;1;3;40;49;49;1;0;0;3;3;40;0;199;3;2;0
/org.eclipse.ui.workbench/Eclipse UI/org/eclipse/ui/actions/LabelRetargetAction.java;1;0;2;1;0;0;0;2;21;1;2;93;22;22;1;0;0;2;2;93;0;157;2;1;0
/org.eclipse.swt/Eclipse SWT/emulated/treetable/org/eclipse/swt/widgets/SelectableItemWidget.java;5;2;9;2;4;3;4;5;32;2;4;13;97;97;2;1;1;5;9;13;2;337;7;5;0
/org.eclipse.ui.editors/src/org/eclipse/ui/texteditor/MarkerUpdater.java;2;0;3;1;1;1;1;2;65;1;2;118;70;70;1;0;0;2;3;118;0;336;3;2;0
/org.eclipse.jdt.ui/ui/org/eclipse/jdt/internal/ui/search/FiltersDialogAction.java;1;0;1;1;1;1;1;0;0;0;0;326;0;0;1;0;0;0;1;326;0;326;1;1;0
/org.eclipse.pde.ui/src/org/eclipse/pde/internal/ui/editor/plugin/RuntimePage.java;2;5;8;1;8;3;8;0;44;0;0;292;56;56;5;0;5;0;8;292;5;336;3;2;0
/org.eclipse.ant.ui/Ant Tools Support/org/eclipse/ant/internal/ui/launchConfigurations/AntStreamsProxy.java;1;0;2;1;0;0;0;2;4;1;2;108;4;4;1;0;0;2;2;108;0;134;2;1;1
/org.eclipse.jdt.core/model/org/eclipse/jdt/internal/core/CopyPackageFragmentRootOperation.java;3;0;4;2;0;0;0;4;18;1;4;172;37;37;1;0;0;4;4;172;0;266;4;3;0
/org.eclipse.jdt.debug/jdi/org/eclipse/jdi/internal/MethodImpl.java;4;0;12;2;1;1;1;11;153;3;6;39;326;326;3;5;0;11;12;187;5;324;7;4;1
/org.eclipse.pde.ui/src/org/eclipse/pde/internal/ui/PDEPluginImages.java;3;3;16;3;5;3;5;11;295;2;9;26;349;349;3;2;2;11;16;307;4;336;12;3;0
/org.eclipse.ui.workbench/Eclipse UI/org/eclipse/ui/internal/commands/KeySequenceBindingNode.java;4;4;18;2;5;2;5;13;2330;7;3;148;2999;2999;7;10;3;13;18;148;13;336;5;4;0
/org.eclipse.team.cvs.ui/src/org/eclipse/team/internal/ccvs/ui/ReleaseCommentDialog.java;2;1;9;2;3;3;3;6;153;3;4;138;255;255;3;2;0;6;9;250;2;336;7;2;0
/org.eclipse.jdt.debug.ui/ui/org/eclipse/jdt/internal/debug/ui/sourcelookup/SourceLookupMessages.java;1;0;1;1;0;0;0;1;0;0;1;230;0;0;1;0;0;1;1;230;0;230;1;1;0
/org.eclipse.ui.workbench/Eclipse UI/org/eclipse/ui/model/PerspectiveLabelProvider.java;5;0;6;1;1;1;1;5;138;1;5;93;186;186;1;0;0;5;6;93;0;336;6;5;0
/org.eclipse.core.variables/src/org/eclipse/core/internal/variables/StringVariableManager.java;3;1;4;1;2;2;2;2;20;1;2;145;35;35;1;0;0;2;4;145;0;302;4;3;1
/org.eclipse.update.core/src/org/eclipse/update/internal/core/FeatureExecutableContentConsumer.java;2;1;3;1;2;2;2;1;4;0;1;58;9;9;1;0;0;1;3;58;0;336;3;2;0
/org.eclipse.team.cvs.core/src/org/eclipse/team/internal/ccvs/core/ICVSRemoteFile.java;1;0;2;1;1;1;1;1;10;0;1;232;12;12;1;0;0;1;2;232;0;336;2;1;0
/org.eclipse.team.ui/src/org/eclipse/team/internal/ui/preferences/ComboFieldEditor.java;1;0;2;1;0;0;0;2;185;0;1;80;185;185;2;1;0;2;2;80;1;80;1;1;0
/org.eclipse.pde.core/src/org/eclipse/pde/internal/core/feature/Feature.java;3;1;6;2;3;3;3;3;320;1;3;130;362;362;1;0;0;3;6;130;0;336;6;3;0
/org.eclipse.pde.core/src/org/eclipse/pde/internal/core/site/VersionableObject.java;2;1;3;1;2;2;2;1;8;0;1;232;14;14;1;0;0;1;3;232;0;336;3;2;0
/org.eclipse.help.webapp/src_servlets/org/eclipse/help/internal/webapp/servlet/ContextServlet.java;1;1;6;1;3;3;3;3;58;2;2;124;112;112;2;1;0;3;6;156;1;336;5;1;0
/org.eclipse.jdt.ui/ui refactoring/org/eclipse/jdt/internal/ui/refactoring/nls/search/FileEntry.java;2;0;2;1;1;1;1;1;10;0;1;268;10;10;1;0;0;1;2;268;0;299;2;2;0
/org.eclipse.jdt.core/model/org/eclipse/jdt/internal/core/SelectionRequestor.java;3;0;8;2;2;1;2;6;279;3;4;54;464;464;3;2;1;6;8;113;3;324;5;3;3
/org.eclipse.jdt.debug/eval/org/eclipse/jdt/internal/debug/eval/ast/instructions/NoOp.java;1;0;1;1;0;0;0;1;3;0;1;144;3;3;1;0;0;1;1;144;0;144;1;1;0
/org.eclipse.jdt.ui/ui/org/eclipse/jdt/internal/ui/preferences/ClasspathVariablesPreferencePage.java;2;0;3;1;1;1;1;2;39;1;2;41;51;51;1;0;0;2;3;41;0;336;3;2;0
/org.eclipse.text/src/org/eclipse/jface/text/IDocumentExtension.java;2;0;2;1;1;1;1;1;17;0;1;250;19;19;1;0;0;1;2;250;0;334;2;2;0
/org.eclipse.help.webapp/src_servlets/org/eclipse/help/internal/webapp/data/ServletResources.java;1;1;10;1;3;3;3;7;76;2;5;13;188;188;2;2;0;7;10;68;2;336;8;1;1
/org.eclipse.team.ui/src/org/eclipse/team/ui/SaveablePartDialog.java;2;1;4;1;4;4;4;0;94;0;0;280;119;119;1;0;0;0;4;280;0;336;4;2;1
/org.eclipse.ant.ui/Ant Editor/org/eclipse/ant/internal/ui/editor/text/MultilineDamagerRepairer.java;1;0;1;1;0;0;0;1;0;0;1;132;0;0;1;0;0;1;1;132;0;132;1;1;0
/org.eclipse.jdt.ui/ui/org/eclipse/jdt/internal/ui/javaeditor/JavaEditor.java;7;0;105;7;7;1;29;76;1803;31;8;35;7951;7951;31;68;28;98;105;251;96;320;9;7;4
/org.eclipse.jdt.ui/ui refactoring/org/eclipse/jdt/internal/ui/refactoring/IVisibilityChangeListener.java;2;0;2;1;1;1;1;1;2;0;1;26;3;3;1;0;0;1;2;26;0;336;2;2;0
/org.eclipse.jdt.core/compiler/org/eclipse/jdt/internal/compiler/lookup/ImportBinding.java;1;0;1;1;0;0;0;1;2;0;1;199;2;2;1;0;0;1;1;199;0;199;1;1;0
/org.eclipse.search/search/org/eclipse/search/internal/ui/SearchPageDescriptor.java;2;0;5;1;1;1;1;4;24;2;3;70;77;77;2;1;0;4;5;165;1;293;4;2;1
/org.eclipse.debug.core/core/org/eclipse/debug/internal/core/memory/IExtendedMemoryBlock.java;1;0;1;1;1;1;1;0;0;0;0;282;0;0;1;0;0;0;1;282;0;282;1;1;1
/org.eclipse.text/src/org/eclipse/text/edits/InsertEdit.java;2;0;5;1;1;1;1;4;18;2;3;118;37;37;2;1;0;4;5;118;1;336;4;2;0
/org.eclipse.jdt.debug/jdi/org/eclipse/jdi/internal/VerboseWriter.java;1;0;1;1;0;0;0;1;6;0;1;78;6;6;1;0;0;1;1;78;0;78;1;1;0
/org.eclipse.debug.ui/ui/org/eclipse/debug/internal/ui/views/variables/VariableViewToggleAction.java;1;0;1;1;0;0;0;1;41;0;1;185;41;41;1;0;0;1;1;185;0;185;1;1;0
/org.eclipse.pde.ui/src/org/eclipse/pde/internal/ui/editor/plugin/MatchSection.java;3;7;9;3;9;3;9;0;130;0;0;292;139;139;7;0;6;0;9;292;6;336;3;3;0
/org.eclipse.help.base/src/org/eclipse/help/internal/browser/MozillaFactory.java;1;1;6;1;3;3;3;3;55;2;2;104;116;116;2;1;0;3;6;104;1;336;5;1;0
/org.eclipse.ui.ide/extensions/org/eclipse/ui/actions/TextActionHandler.java;1;0;1;1;0;0;0;1;0;0;1;132;0;0;1;0;0;1;1;132;0;132;1;1;0
/org.eclipse.ui.forms/src/org/eclipse/ui/forms/IFormPart.java;1;1;5;1;2;2;2;3;63;1;3;225;76;76;1;0;0;3;5;225;0;336;5;1;0
/org.eclipse.ui.ide/src/org/eclipse/ui/wizards/datatransfer/ZipFileStructureProvider.java;1;0;1;1;0;0;0;1;0;0;1;92;0;0;1;0;0;1;1;92;0;92;1;1;0
/org.eclipse.jdt.ui/ui/org/eclipse/jdt/internal/ui/wizards/buildpaths/ExclusionInclusionDialog.java;2;1;3;1;2;2;2;1;167;0;1;267;169;169;1;0;0;1;3;267;0;336;3;2;0
/org.eclipse.ui.workbench/Eclipse UI/org/eclipse/ui/internal/intro/IntroDescriptor.java;2;0;6;2;1;1;1;5;41;2;3;203;70;70;2;2;0;5;6;203;2;294;4;2;0
/org.eclipse.osgi/resolver/src/org/eclipse/osgi/internal/resolver/PackageSpecificationImpl.java;3;1;3;1;2;2;2;1;7;0;1;171;11;11;1;0;0;1;3;171;0;336;3;3;0
/org.eclipse.jdt.core/model/org/eclipse/jdt/core/IJavaModelMarker.java;2;0;2;1;0;0;0;2;2;1;2;128;4;4;1;0;0;2;2;128;0;199;2;2;0
/org.eclipse.core.runtime/src/org/eclipse/core/internal/registry/EclipseBundleListener.java;5;4;17;3;10;3;10;7;294;3;4;173;475;475;4;3;7;7;17;276;10;326;7;5;1
/org.eclipse.ltk.ui.refactoring/src/org/eclipse/ltk/internal/ui/refactoring/NotCancelableProgressMonitor.java;1;0;1;1;1;1;1;0;0;0;0;283;0;0;1;0;0;0;1;283;0;283;1;1;0
/org.eclipse.help.base/src/org/eclipse/help/browser/IBrowser.java;1;1;4;1;2;2;2;2;57;0;1;104;65;65;2;1;0;2;4;104;1;336;3;1;0
/org.eclipse.ui.workbench/Eclipse UI/org/eclipse/ui/internal/misc/StringMatcher.java;3;1;3;1;2;2;2;1;6;0;1;88;10;10;1;0;0;1;3;88;0;336;3;3;0
/org.eclipse.swt/Eclipse SWT PI/win32/org/eclipse/swt/internal/win32/NMTVCUSTOMDRAW.java;1;0;1;1;0;0;0;1;1;0;1;166;1;1;1;0;0;1;1;166;0;166;1;1;0
/org.eclipse.debug.ui/ui/org/eclipse/debug/internal/ui/sourcelookup/SourceContainerLabelProvider.java;1;0;4;1;0;0;0;4;40;1;4;209;77;77;1;0;0;4;4;209;0;268;4;1;0
/org.eclipse.core.resources/src/org/eclipse/core/internal/refresh/RefreshJob.java;2;0;6;2;2;1;2;4;12;2;3;205;23;23;2;1;1;4;6;205;2;277;4;2;0
/org.eclipse.jdt.ui/ui/org/eclipse/jdt/internal/ui/compare/LocalHistoryActionGroup.java;2;0;2;1;1;1;1;1;26;0;1;104;28;28;1;0;0;1;2;104;0;336;2;2;0
/org.eclipse.ltk.core.refactoring/src/org/eclipse/ltk/core/refactoring/participants/CheckConditionsContext.java;1;2;5;1;4;3;4;1;27;0;1;264;37;37;2;0;1;1;5;275;1;337;4;1;0
/org.eclipse.ui.ide/src/org/eclipse/ui/internal/ide/dialogs/FileSystemResourceExporter.java;1;0;1;1;0;0;0;1;0;0;1;132;0;0;1;0;0;1;1;132;0;132;1;1;0
/org.eclipse.debug.core/core/org/eclipse/debug/internal/core/memory/IMemoryRenderingManager.java;1;0;1;1;1;1;1;0;0;0;0;282;0;0;1;0;0;0;1;282;0;282;1;1;1
/org.eclipse.ui.cheatsheets/src/org/eclipse/ui/cheatsheets/OpenCheatSheetFromHelpAction.java;2;0;4;2;0;0;0;4;55;3;2;243;55;55;3;2;0;4;4;253;2;253;2;2;0
/org.eclipse.core.runtime/src/org/eclipse/core/internal/content/TextContentDescriber.java;1;1;2;1;2;2;2;0;13;0;0;290;13;13;1;0;0;0;2;290;0;303;2;1;0
/org.eclipse.jdt.ui/ui/org/eclipse/jdt/internal/ui/wizards/OpenPackageWizardAction.java;1;0;1;1;1;1;1;0;2;0;0;336;2;2;1;0;0;0;1;336;0;336;1;1;0
/org.eclipse.team.cvs.ui/src/org/eclipse/team/internal/ccvs/ui/model/RemoteContentProvider.java;2;0;9;2;0;0;0;9;163;2;5;63;214;214;2;4;0;9;9;63;4;182;5;2;0
/org.eclipse.team.ui/src/org/eclipse/team/internal/ui/synchronize/actions/DirectionFilterActionGroup.java;2;2;4;2;4;3;4;0;214;0;0;274;218;218;2;0;1;0;4;288;1;336;3;2;0
/org.eclipse.jface.text/src/org/eclipse/jface/text/AbstractInformationControlManager.java;2;2;12;2;3;2;3;9;205;3;5;47;419;419;3;4;1;9;12;47;5;336;7;2;0
/org.eclipse.ui.externaltools/External Tools Base/org/eclipse/ui/externaltools/internal/model/ExternalToolBuilder.java;2;2;22;2;5;4;5;17;146;4;10;15;387;387;4;7;1;17;22;15;8;336;14;2;3
/org.eclipse.core.resources/src/org/eclipse/core/internal/resources/NatureManager.java;2;2;4;1;3;2;3;1;1166;0;1;90;1180;1180;2;0;1;1;4;275;1;294;3;2;0
/org.eclipse.search/search/org/eclipse/search/internal/ui/text/FileSearchQuery.java;2;3;14;1;8;4;8;6;46;2;5;207;162;162;3;1;4;6;14;310;5;336;9;2;2
/org.eclipse.jdt.ui/ui/org/eclipse/jdt/internal/ui/packageview/FileTransferDragAdapter.java;1;0;1;1;1;1;1;0;2;0;0;336;2;2;1;0;0;0;1;336;0;336;1;1;0
/org.eclipse.ui.ide/src/org/eclipse/ui/views/navigator/CollapseAllAction.java;2;0;2;1;0;0;0;2;4;1;2;129;4;4;1;0;0;2;2;129;0;187;2;2;0
/org.eclipse.jdt.junit/src/org/eclipse/jdt/internal/junit/launcher/JUnitMainTab.java;3;4;10;3;7;3;7;3;249;2;2;80;396;396;4;1;4;3;10;320;5;320;5;3;2
/org.eclipse.swt/Eclipse SWT PI/motif/org/eclipse/swt/internal/motif/XineramaScreenInfo.java;1;0;1;1;0;0;0;1;0;0;1;1;0;0;1;0;0;1;1;1;0;1;1;1;0
/org.eclipse.swt/Eclipse SWT Custom Widgets/common/org/eclipse/swt/custom/TableCursor.java;5;4;15;2;6;3;6;9;378;4;5;0;591;591;4;4;3;9;15;219;7;337;8;5;0
/org.eclipse.jdt.ui/ui/org/eclipse/jdt/ui/actions/ImportActionGroup.java;4;1;4;1;3;3;3;1;11;0;1;51;33;33;1;0;0;1;4;51;0;336;4;4;0
/org.eclipse.jdt.ui/ui/org/eclipse/jdt/internal/ui/dialogs/ListDialog.java;1;0;1;1;1;1;1;0;2;0;0;336;2;2;1;0;0;0;1;336;0;336;1;1;0
/org.eclipse.ui.cheatsheets/src/org/eclipse/ui/internal/cheatsheets/data/Action.java;1;0;1;1;1;1;1;0;0;0;0;279;0;0;1;0;0;0;1;279;0;279;1;1;0
/org.eclipse.jdt.ui/core extension/org/eclipse/jdt/internal/corext/codemanipulation/AddCustomConstructorOperation.java;4;0;14;2;1;1;1;13;235;6;6;66;323;323;6;7;0;13;14;94;7;336;7;4;0
/org.eclipse.jdt.ui/ui/org/eclipse/jdt/internal/ui/search/PathNameSorter.java;3;1;3;1;2;2;2;1;36;0;1;183;40;40;1;0;0;1;3;183;0;336;3;3;0
/org.eclipse.update.configurator/src/org/eclipse/update/internal/configurator/PluginEntry.java;1;0;3;1;1;1;1;2;17;1;2;184;27;27;1;0;0;2;3;184;0;300;3;1;0
/org.eclipse.ui.workbench/Eclipse UI/org/eclipse/ui/activities/IIdentifierListener.java;3;1;5;1;2;2;2;3;11;2;2;170;22;22;2;1;0;3;5;170;1;336;4;3;0
/org.eclipse.update.core/src/org/eclipse/update/standalone/RemoveSiteCommand.java;1;1;5;1;5;5;5;0;27;0;0;281;51;51;1;0;0;0;5;281;0;336;5;1;0
/org.eclipse.jdt.ui/ui/org/eclipse/jdt/internal/ui/search/OpenJavaSearchPageAction.java;2;1;3;1;3;3;3;0;10;0;0;290;16;16;1;0;0;0;3;290;0;336;3;2;0
/org.eclipse.jdt.ui/ui refactoring/org/eclipse/jdt/internal/ui/refactoring/nls/search/NLSSearchQuery.java;1;0;3;1;2;1;2;1;30;0;1;268;30;30;2;0;1;1;3;283;1;283;2;1;0
/org.eclipse.jdt.core/dom/org/eclipse/jdt/core/dom/SingleMemberAnnotation.java;2;0;11;1;3;1;3;8;241;4;4;225;281;281;4;4;2;8;11;225;6;276;5;2;2
/org.eclipse.jdt.ui/ui/org/eclipse/jdt/internal/ui/preferences/formatter/BracesTabPage.java;1;0;9;1;1;1;1;8;164;4;4;176;272;272;4;4;0;8;9;191;4;280;5;1;0
/org.eclipse.pde.core/src/org/eclipse/pde/internal/core/bundle/BundleFragment.java;2;3;7;2;7;3;7;0;76;0;0;292;109;109;3;0;4;0;7;292;4;330;3;2;0
/org.eclipse.debug.core/core/org/eclipse/debug/internal/core/sourcelookup/containers/DirectorySourceContainerType.java;2;0;3;2;1;1;1;2;20;1;2;205;24;24;1;0;0;2;3;205;0;303;3;2;0
/org.eclipse.jdt.ui/ui/org/eclipse/jdt/ui/search/ISearchRequestor.java;3;2;5;2;5;3;5;0;8;0;0;274;16;16;2;0;2;0;5;274;2;335;3;3;0
/org.eclipse.jdt.ui/ui/org/eclipse/jdt/ui/actions/ConvertNestedToTopAction.java;3;0;11;1;1;1;2;9;199;4;5;3;400;400;4;4;1;10;11;3;5;336;6;3;0
/org.eclipse.jdt.ui/ui/org/eclipse/jdt/internal/ui/text/folding/DefaultJavaFoldingPreferenceBlock.java;1;1;2;1;2;2;2;0;6;0;0;292;6;6;1;0;0;0;2;292;0;336;2;1;0
/org.eclipse.text/src/org/eclipse/text/edits/CopyTargetEdit.java;2;0;4;1;1;1;1;3;36;2;2;118;65;65;2;1;0;3;4;118;1;336;3;2;0
/org.eclipse.ltk.core.refactoring/src/org/eclipse/ltk/core/refactoring/CreateChangeOperation.java;1;1;9;1;2;2;7;2;55;0;1;264;63;63;7;1;5;7;9;264;6;336;3;1;0
/org.eclipse.team.cvs.core/src/org/eclipse/team/internal/ccvs/core/client/Commit.java;2;0;4;1;1;1;1;3;9;1;3;101;20;20;1;0;0;3;4;101;0;336;4;2;0
/org.eclipse.jdt.launching/launching/org/eclipse/jdt/launching/LibraryLocation.java;2;0;3;2;0;0;0;3;12;2;2;46;20;20;2;1;0;3;3;46;1;170;2;2;0
/org.eclipse.pde.ui/src/org/eclipse/pde/internal/ui/wizards/plugin/FragmentContentPage.java;2;1;4;1;2;2;2;2;196;1;2;213;202;202;1;0;0;2;4;213;0;336;4;2;0
/org.eclipse.jface.text/src/org/eclipse/jface/text/source/IChangeRulerColumn.java;3;0;4;2;2;1;2;2;10;1;2;76;18;18;2;0;1;2;4;336;1;336;3;3;0
/org.eclipse.ui.ide/src/org/eclipse/ui/views/navigator/WorkspaceActionGroup.java;6;0;8;3;1;1;1;7;20;3;5;129;56;56;3;2;0;7;8;254;2;336;6;6;1
/org.eclipse.pde.ui/src/org/eclipse/pde/internal/ui/wizards/feature/NewFeatureProjectWizard.java;3;1;9;1;7;7;7;2;320;1;2;213;450;450;1;0;0;2;9;213;0;336;9;3;0
/org.eclipse.core.resources/src/org/eclipse/core/internal/indexing/IndexCursor.java;1;0;1;1;1;1;1;0;211;0;0;277;211;211;1;0;0;0;1;277;0;277;1;1;0
/org.eclipse.pde.ui/src/org/eclipse/pde/internal/ui/editor/feature/IncludeFeaturesWizard.java;2;0;3;2;2;1;2;1;5;0;1;232;7;7;2;0;1;1;3;331;1;331;2;2;0
/org.eclipse.debug.ui/ui/org/eclipse/debug/internal/ui/launchConfigurations/DeleteLaunchConfigurationAction.java;1;0;1;1;0;0;0;1;4;0;1;33;4;4;1;0;0;1;1;33;0;33;1;1;0
/org.eclipse.jdt.debug/model/org/eclipse/jdt/internal/debug/core/breakpoints/JavaPatternBreakpoint.java;4;0;5;2;2;1;2;3;11;1;3;26;24;24;2;0;1;3;5;330;1;330;4;4;1
/org.eclipse.debug.ui/ui/org/eclipse/debug/internal/ui/sourcelookup/SourceContainerAdapterFactory.java;1;0;1;1;0;0;0;1;0;0;1;253;0;0;1;0;0;1;1;253;0;253;1;1;0
/org.eclipse.jdt.core/codeassist/org/eclipse/jdt/internal/codeassist/complete/CompletionOnKeyword2.java;2;0;4;2;0;0;0;4;5;2;3;7;11;11;2;1;0;4;4;7;1;199;3;2;0
/org.eclipse.text/src/org/eclipse/jface/text/IDocumentPartitioner.java;1;0;1;1;1;1;1;0;60;0;0;334;60;60;1;0;0;0;1;334;0;334;1;1;0
/org.eclipse.jdt.core/compiler/org/eclipse/jdt/internal/compiler/util/HashtableOfObject.java;2;0;2;1;0;0;0;2;26;1;2;199;28;28;1;0;0;2;2;199;0;245;2;2;0
/org.eclipse.jdt.ui/ui/org/eclipse/jdt/internal/ui/compare/CompareDialog.java;1;0;1;1;1;1;1;0;2;0;0;336;2;2;1;0;0;0;1;336;0;336;1;1;0
/org.eclipse.ui.workbench/Eclipse UI/org/eclipse/ui/commands/IHandlerListener.java;2;0;2;1;1;1;1;1;9;0;1;226;9;9;1;0;0;1;2;226;0;281;2;2;0
/org.eclipse.swt/Eclipse SWT/emulated/textlayout/org/eclipse/swt/graphics/TextLayout.java;3;4;22;3;5;2;16;6;1037;14;2;250;1091;1091;14;4;14;17;22;265;18;331;4;3;1
/org.eclipse.swt/Eclipse SWT PI/gtk/org/eclipse/swt/internal/accessibility/gtk/AtkObjectClass.java;4;0;4;1;1;1;1;3;46;1;3;75;65;65;1;0;0;3;4;75;0;337;4;4;0
/org.eclipse.jdt.ui/core refactoring/org/eclipse/jdt/internal/corext/refactoring/changes/CopyCompilationUnitChange.java;3;1;5;1;2;2;2;3;17;1;3;41;49;49;1;0;0;3;5;41;0;336;5;3;0
/org.eclipse.jdt.core/model/org/eclipse/jdt/internal/core/jdom/DOMMethod.java;3;1;6;1;2;2;2;4;46;1;4;7;83;83;1;0;0;4;6;7;0;314;6;3;0
/org.eclipse.jdt.ui/ui/org/eclipse/jdt/internal/ui/wizards/OpenInterfaceWizardAction.java;1;0;1;1;1;1;1;0;2;0;0;336;2;2;1;0;0;0;1;336;0;336;1;1;0
/org.eclipse.swt.tools/JNI Generation/org/eclipse/swt/tools/internal/MetaDataGenerator.java;2;0;2;2;0;0;0;2;14;0;1;230;14;14;2;1;0;2;2;230;1;230;1;2;0
/org.eclipse.osgi/core/framework/org/eclipse/osgi/framework/internal/core/PackageAdminImpl.java;3;7;12;2;12;3;12;0;181;0;0;276;315;315;7;0;9;0;12;292;9;324;3;3;1
/org.eclipse.osgi/eclipseAdaptor/src/org/eclipse/osgi/service/pluginconversion/PluginConversionException.java;1;0;2;1;2;1;2;0;7;0;0;283;7;7;2;0;1;0;2;283;1;283;1;1;0
/org.eclipse.update.core/src/org/eclipse/update/internal/operations/FeatureHierarchyElement.java;1;1;4;1;3;3;3;1;4;0;1;93;7;7;1;0;0;1;4;93;0;336;4;1;0
/org.eclipse.ui.workbench/Eclipse UI/org/eclipse/ui/internal/LayoutPartSash.java;4;1;5;1;3;3;3;2;343;1;2;223;413;413;1;0;0;2;5;223;0;336;5;4;0
/org.eclipse.debug.ui/ui/org/eclipse/debug/internal/ui/stringsubstitution/StringSubstitutionMessages.java;2;0;2;1;0;0;0;2;13;1;2;121;13;13;1;0;0;2;2;121;0;149;2;2;0
/org.eclipse.jdt.ui/ui/org/eclipse/jdt/internal/ui/text/java/hover/JavaExpandHover.java;4;2;9;2;6;4;6;3;350;1;3;147;451;451;2;0;2;3;9;275;2;336;7;4;0
/org.eclipse.jdt.ui/ui/org/eclipse/jdt/internal/ui/packageview/PackageExplorerLabelProvider.java;1;0;1;1;1;1;1;0;2;0;0;336;2;2;1;0;0;0;1;336;0;336;1;1;0
/org.eclipse.team.ui/src/org/eclipse/team/internal/ui/dialogs/PreferencePageContainerDialog.java;1;0;6;1;1;1;1;5;421;1;5;63;467;467;1;0;0;5;6;63;0;336;6;1;2
/org.eclipse.ltk.core.refactoring/src/org/eclipse/ltk/core/refactoring/participants/MoveProcessor.java;1;0;6;1;1;1;4;2;97;0;1;264;107;107;5;1;3;5;6;264;4;336;2;1;0
/org.eclipse.jface.text/src/org/eclipse/jface/text/rules/IPartitionTokenScanner.java;1;0;1;1;1;1;1;0;2;0;0;336;2;2;1;0;0;0;1;336;0;336;1;1;0
/org.eclipse.pde.ui/src/org/eclipse/pde/internal/ui/launcher/RunWorkbenchAction.java;2;1;2;1;2;2;2;0;6;0;0;290;6;6;1;0;0;0;2;290;0;336;2;2;0
/org.eclipse.swt/Eclipse SWT Mozilla/common/org/eclipse/swt/internal/mozilla/nsIWebNavigation.java;1;0;2;1;0;0;0;2;14;1;2;100;14;14;1;0;0;2;2;100;0;148;2;1;0
/org.eclipse.jdt.ui/ui/org/eclipse/jdt/internal/ui/wizards/ClassPathDetector.java;3;1;7;2;2;2;2;5;53;2;4;32;109;109;2;1;0;5;7;81;1;336;6;3;0
/org.eclipse.jdt.debug.ui/ui/org/eclipse/jdt/debug/ui/IJavaDebugUIConstants.java;3;1;5;1;2;2;2;3;14;1;3;45;32;32;1;0;0;3;5;45;0;336;5;3;0
/org.eclipse.ant.ui/Ant Tools Support/org/eclipse/ant/internal/ui/launchConfigurations/AntTargetsTab.java;3;2;26;3;7;5;8;18;429;9;6;108;769;769;9;12;3;19;26;118;15;336;11;3;2
/org.eclipse.pde.core/src/org/eclipse/pde/core/plugin/IPluginExtensionPoint.java;3;2;5;1;4;3;4;1;32;0;1;232;42;42;2;0;1;1;5;276;1;336;4;3;0
/org.eclipse.ant.ui/Ant Editor/org/eclipse/ant/internal/ui/dtd/IDfm.java;1;0;1;1;0;0;0;1;0;0;1;108;0;0;1;0;0;1;1;108;0;108;1;1;0
/org.eclipse.jdt.core/compiler/org/eclipse/jdt/internal/compiler/ast/DoStatement.java;3;0;8;2;2;1;2;6;32;2;4;63;84;84;2;2;1;6;8;152;3;287;5;3;1
/org.eclipse.debug.ui/ui/org/eclipse/debug/internal/ui/stringsubstitution/FolderPrompt.java;2;0;3;2;2;1;2;1;5;0;1;123;5;5;2;0;1;1;3;331;1;331;2;2;0
/org.eclipse.ui.console/src/org/eclipse/ui/console/actions/TextViewerAction.java;3;1;4;2;2;2;2;2;14;0;1;118;27;27;2;1;0;2;4;118;1;336;3;3;0
/org.eclipse.update.core/src/org/eclipse/update/internal/operations/InstallOperation.java;1;4;11;1;5;2;5;6;41;1;6;54;101;101;4;0;3;6;11;290;3;336;8;1;0
/org.eclipse.swt/Eclipse SWT Mozilla/gtk/org/eclipse/swt/internal/mozilla/GRE.java;1;1;4;1;2;2;2;2;54;1;2;100;82;82;1;0;0;2;4;100;0;301;4;1;1
/org.eclipse.jdt.ui/core refactoring/org/eclipse/jdt/internal/corext/refactoring/changes/CreatePackageChange.java;2;1;6;1;2;2;2;4;32;2;3;207;56;56;2;1;0;4;6;247;1;336;5;2;0
/org.eclipse.ui.ide/extensions/org/eclipse/ui/IMarkerResolutionGenerator.java;1;0;1;1;0;0;0;1;0;0;1;132;0;0;1;0;0;1;1;132;0;132;1;1;0
/org.eclipse.osgi/osgi/src/org/eclipse/osgi/service/resolver/StateObjectFactory.java;3;0;9;3;1;1;1;8;131;4;4;171;207;207;4;4;0;8;9;171;4;276;5;3;0
/org.eclipse.core.runtime/src/org/eclipse/core/runtime/PlatformObject.java;2;0;5;2;2;1;2;3;249;0;1;171;262;262;3;2;1;3;5;171;3;274;2;2;0
/org.eclipse.jdt.ui/ui/org/eclipse/jdt/internal/ui/preferences/formatter/ProfileVersioner.java;2;1;9;1;2;2;2;7;747;5;3;199;791;791;5;4;0;7;9;199;4;325;5;2;0
/org.eclipse.jdt.launching/launching/org/eclipse/jdt/internal/launching/DefaultEntryResolver.java;1;0;3;1;0;0;0;3;4;1;3;211;5;5;1;0;0;3;3;211;0;269;3;1;0
/org.eclipse.jdt.ui/ui/org/eclipse/jdt/internal/ui/text/comment/HTMLEntity2JavaReader.java;2;0;2;1;1;1;1;1;2;0;1;200;2;2;1;0;0;1;2;200;0;336;2;2;0
/org.eclipse.ui.workbench/Eclipse UI/org/eclipse/ui/internal/CloseAllAction.java;1;0;1;1;0;0;0;1;73;0;1;157;73;73;1;0;0;1;1;157;0;157;1;1;0
/org.eclipse.jdt.junit/src/org/eclipse/jdt/internal/junit/ui/ShowPreviousFailureAction.java;3;0;3;1;1;1;1;2;2;1;2;35;4;4;1;0;0;2;3;35;0;336;3;3;0
/org.eclipse.pde.ui/src/org/eclipse/pde/internal/ui/wizards/templates/EditorTemplate.java;3;2;10;2;4;3;4;6;62;2;5;128;138;138;2;1;1;6;10;128;2;336;8;3;0
/org.eclipse.jface/src/org/eclipse/jface/dialogs/InputDialog.java;3;2;7;2;5;3;5;2;388;1;2;43;403;403;2;0;2;2;7;293;2;336;5;3;0
/org.eclipse.search/search/org/eclipse/search/internal/ui/util/ExceptionHandler.java;2;1;2;1;2;2;2;0;12;0;0;325;14;14;1;0;0;0;2;325;0;336;2;2;0
/org.eclipse.jface.text/src/org/eclipse/jface/text/source/IVerticalRuler.java;2;0;4;2;2;1;2;2;50;0;1;268;52;52;2;1;1;2;4;268;2;336;2;2;0
/org.eclipse.ui.workbench/Eclipse UI/org/eclipse/ui/internal/PartPlaceholder.java;2;1;2;1;2;2;2;0;20;0;0;275;22;22;1;0;0;0;2;275;0;336;2;2;0
/org.eclipse.core.resources/src/org/eclipse/core/internal/watson/IElementTreeData.java;1;0;1;1;1;1;1;0;14;0;0;277;14;14;1;0;0;0;1;277;0;277;1;1;0
/org.eclipse.jdt.debug.ui/ui/org/eclipse/jdt/internal/debug/ui/JDIModelPresentation.java;5;1;31;3;3;3;3;28;473;7;8;50;1007;1007;7;20;0;28;31;126;20;321;11;5;4
/org.eclipse.jdt.ui/ui/org/eclipse/jdt/internal/ui/text/javadoc/JavaDocCompletionProcessor.java;5;1;9;1;3;3;3;6;18;4;3;72;45;45;4;3;0;6;9;234;3;336;6;5;0
/org.eclipse.ui.intro/src/org/eclipse/ui/internal/intro/impl/IntroPlugin.java;1;5;8;1;8;3;8;0;68;0;0;276;116;116;5;0;5;0;8;276;5;312;3;1;0
/org.eclipse.ui.workbench/Eclipse UI/org/eclipse/ui/IActionDelegate.java;1;0;1;1;0;0;0;1;2;0;1;157;2;2;1;0;0;1;1;157;0;157;1;1;0
/org.eclipse.jdt.ui/core refactoring/org/eclipse/jdt/internal/corext/refactoring/code/ExceptionAnalyzer.java;3;0;3;1;1;1;1;2;8;1;2;80;13;13;1;0;0;2;3;80;0;336;3;3;0
/org.eclipse.help.base/src/org/eclipse/help/internal/base/util/TString.java;1;1;5;1;3;3;3;2;43;1;2;105;83;83;1;0;0;2;5;105;0;336;5;1;0
/org.eclipse.help.base/src/org/eclipse/help/internal/standalone/Options.java;1;2;7;1;5;3;5;2;89;1;2;104;205;205;2;0;2;2;7;309;2;330;5;1;1
/org.eclipse.pde.ui/src_Forms/org/eclipse/pde/internal/ui/model/plugin/PluginExtensionNode.java;3;5;11;3;9;3;9;2;50;1;2;244;133;133;5;0;6;2;11;293;6;333;5;3;0
/org.eclipse.pde.core/src/org/eclipse/pde/internal/core/ischema/ISchemaComplexType.java;1;0;2;1;1;1;1;1;4;0;1;232;6;6;1;0;0;1;2;232;0;336;2;1;0
/org.eclipse.ui.views/src/org/eclipse/ui/views/properties/IPropertySource2.java;1;0;1;1;1;1;1;0;0;0;0;295;0;0;1;0;0;0;1;295;0;295;1;1;0
/org.eclipse.jdt.launching.macosx/macosx/org/eclipse/jdt/internal/launching/macosx/MacOSXVMInstallType.java;1;0;4;1;0;0;0;4;48;2;3;79;69;69;2;1;0;4;4;79;1;203;3;1;0
/org.eclipse.team.ui/src/org/eclipse/team/internal/ui/TeamAdapterFactory.java;1;0;3;1;1;1;1;2;40;0;1;226;42;42;2;1;0;2;3;226;1;336;2;1;0
/org.eclipse.jdt.ui/ui/org/eclipse/jdt/internal/ui/EditorInputAdapterFactory.java;1;0;1;1;1;1;1;0;2;0;0;336;2;2;1;0;0;0;1;336;0;336;1;1;0
/org.eclipse.debug.ui/ui/org/eclipse/debug/internal/ui/views/variables/VariablesViewer.java;4;0;5;1;1;1;1;4;284;2;3;65;328;328;2;1;0;4;5;130;1;336;4;4;0
/org.eclipse.ui.editors/src/org/eclipse/ui/internal/editors/text/AbstractConfigurationBlockPreferencePage.java;1;0;1;1;1;1;1;0;0;0;0;295;0;0;1;0;0;0;1;295;0;295;1;1;0
/org.eclipse.jdt.core/search/org/eclipse/jdt/internal/core/search/matching/SuperTypeNamesCollector.java;3;0;17;2;1;1;1;16;465;4;9;6;845;845;4;7;0;16;17;6;7;275;10;3;0
/org.eclipse.ui.workbench/Eclipse UI/org/eclipse/ui/internal/themes/ThemeElementCategory.java;1;0;4;1;0;0;1;3;13;2;3;241;19;19;2;0;1;4;4;269;1;269;3;1;1
/org.eclipse.jdt.ui/ui/org/eclipse/jdt/internal/ui/search/JavaSearchPageScoreComputer.java;2;1;2;1;2;2;2;0;5;0;0;290;7;7;1;0;0;0;2;290;0;336;2;2;0
/org.eclipse.ui.ide/src/org/eclipse/ui/views/markers/internal/ActionProblemProperties.java;3;1;3;1;2;2;2;1;4;0;1;129;6;6;1;0;0;1;3;129;0;336;3;3;0
/org.eclipse.jdt.ui/ui/org/eclipse/jdt/internal/ui/text/template/contentassist/VariablePosition.java;2;0;2;1;1;1;1;1;2;0;1;267;2;2;1;0;0;1;2;267;0;336;2;2;0
/org.eclipse.ui.workbench/Eclipse UI/org/eclipse/ui/internal/keys/CancelOnModifyListener.java;2;0;2;1;1;1;1;1;4;0;1;238;4;4;1;0;0;1;2;238;0;336;2;2;0
/org.eclipse.team.ui/src/org/eclipse/team/internal/ui/wizards/GlobalRefreshWizardSelectionPage.java;2;2;3;1;3;2;3;0;174;0;0;296;176;176;2;0;1;0;3;296;1;336;2;2;1
/org.eclipse.ui.workbench/Eclipse UI/org/eclipse/ui/part/EditorInputTransfer.java;3;0;3;1;0;0;0;3;12;1;3;0;18;18;1;0;0;3;3;0;0;157;3;3;0
/org.eclipse.core.resources/src/org/eclipse/core/internal/localstore/IUnifiedTreeVisitor.java;1;0;1;1;1;1;1;0;12;0;0;277;12;12;1;0;0;0;1;277;0;277;1;1;0
/org.eclipse.pde.core/src/org/eclipse/pde/internal/core/feature/VersionableObject.java;2;1;3;1;2;2;2;1;8;0;1;232;14;14;1;0;0;1;3;232;0;336;3;2;0
/org.eclipse.team.cvs.ui/src/org/eclipse/team/internal/ccvs/ui/subscriber/WorkspaceUpdateAction.java;2;1;14;2;2;2;2;12;124;4;7;48;354;354;4;5;0;12;14;244;5;336;9;2;1
/org.eclipse.core.resources/src/org/eclipse/core/internal/indexing/StoreException.java;1;0;1;1;1;1;1;0;68;0;0;277;68;68;1;0;0;0;1;277;0;277;1;1;0
/org.eclipse.jdt.ui/ui/org/eclipse/jdt/internal/ui/javaeditor/ASTProvider.java;3;3;14;3;6;4;6;8;668;0;1;253;773;773;8;7;2;8;14;253;9;336;5;3;1
/org.eclipse.jface.text/src/org/eclipse/jface/text/source/MatchingCharacterPainter.java;3;2;4;2;3;2;3;1;28;0;1;257;50;50;2;0;1;1;4;336;1;336;3;3;0
/org.eclipse.jdt.core/eval/org/eclipse/jdt/internal/eval/Evaluator.java;3;0;6;1;0;0;0;6;6;1;6;5;21;21;1;0;0;6;6;5;0;199;6;3;0
/org.eclipse.jdt.launching/launching/org/eclipse/jdt/launching/AbstractJavaLaunchConfigurationDelegate.java;5;2;24;4;3;2;6;18;1579;14;5;150;1734;1734;14;13;4;21;24;241;17;331;7;5;0
/org.eclipse.pde.ui/src/org/eclipse/pde/internal/ui/editor/feature/URLSection.java;2;2;6;1;4;3;4;2;77;1;2;157;134;134;2;0;1;2;6;308;1;336;5;2;0
/org.eclipse.ui.workbench/Eclipse UI/org/eclipse/ui/internal/activities/ws/ActivityMessages.java;1;0;1;1;0;0;0;1;0;0;1;174;0;0;1;0;0;1;1;174;0;174;1;1;0
/org.eclipse.jdt.ui/ui/org/eclipse/jdt/ui/actions/FindImplementorsInWorkingSetAction.java;2;2;6;1;3;2;3;3;15;1;3;82;29;29;2;0;1;3;6;290;1;336;5;2;0
/org.eclipse.jdt.ui/ui/org/eclipse/jdt/internal/ui/text/spelling/HtmlTagDictionary.java;2;0;2;1;1;1;1;1;2;0;1;219;2;2;1;0;0;1;2;219;0;336;2;2;0
/org.eclipse.jdt.ui/core extension/org/eclipse/jdt/internal/corext/util/TypeInfoFactory.java;1;0;1;1;1;1;1;0;2;0;0;336;2;2;1;0;0;0;1;336;0;336;1;1;0
/org.eclipse.update.ui/src/org/eclipse/update/internal/ui/wizards/SitePage.java;3;3;17;2;7;4;7;10;599;4;7;15;979;979;4;3;3;10;17;54;6;328;11;3;1
/org.eclipse.ui.ide/extensions/org/eclipse/ui/dialogs/ResourceListSelectionDialog.java;2;0;2;1;0;0;0;2;35;1;2;132;35;35;1;0;0;2;2;132;0;171;2;2;2
/org.eclipse.search/new search/org/eclipse/search/ui/NewSearchUI.java;3;3;14;2;8;4;8;6;113;3;4;195;429;429;3;2;4;6;14;254;6;335;8;3;0
/org.eclipse.jdt.core/model/org/eclipse/jdt/internal/core/util/SourceFileAttribute.java;1;0;1;1;0;0;0;1;2;0;1;199;2;2;1;0;0;1;1;199;0;199;1;1;0
/org.eclipse.jdt.ui/ui/org/eclipse/jdt/internal/ui/text/SmartBackspaceManager.java;2;2;3;1;3;2;3;0;12;0;0;281;18;18;2;0;1;0;3;281;1;336;2;2;0
/org.eclipse.ui.views/src/org/eclipse/ui/views/properties/PropertySheetEntry.java;2;0;2;2;2;1;2;0;60;0;0;295;60;60;2;0;1;0;2;295;1;295;1;2;0
/org.eclipse.update.core/src/org/eclipse/update/search/EnvironmentFilter.java;2;1;6;2;2;2;2;4;7;2;3;54;15;15;2;1;0;4;6;54;1;336;5;2;0
/org.eclipse.pde.ui/src/org/eclipse/pde/internal/ui/editor/ModelDataTransfer.java;2;1;2;1;2;2;2;0;6;0;0;308;10;10;1;0;0;0;2;308;0;336;2;2;0
/org.eclipse.ui.ide/src/org/eclipse/ui/views/navigator/SortAndFilterActionGroup.java;4;0;5;1;1;1;1;4;20;1;4;129;29;29;1;0;0;4;5;129;0;336;5;4;0
/org.eclipse.jdt.ui/ui refactoring/org/eclipse/jdt/internal/ui/refactoring/nls/ExternalizeWizardPage.java;7;0;26;3;1;1;15;11;2639;16;10;3;2974;2974;16;1;14;25;26;267;15;336;11;7;1
/org.eclipse.core.expressions/src/org/eclipse/core/internal/expressions/InstanceofExpression.java;1;0;3;1;1;1;1;2;17;1;2;227;25;25;1;0;0;2;3;227;0;336;3;1;0
/org.eclipse.ui.ide/src/org/eclipse/ui/views/navigator/NavigatorDropAdapter.java;1;0;2;1;0;0;0;2;5;0;1;129;5;5;2;1;0;2;2;129;1;129;1;1;1
/org.eclipse.jdt.core/model/org/eclipse/jdt/internal/core/NameLookup.java;3;1;19;2;3;3;3;16;150;4;8;14;355;355;4;8;0;16;19;14;8;311;11;3;2
/org.eclipse.jdt.launching/launching/org/eclipse/jdt/launching/IVMInstall.java;1;0;1;1;0;0;0;1;24;0;1;246;24;24;1;0;0;1;1;246;0;246;1;1;1
/org.eclipse.jdt.core/compiler/org/eclipse/jdt/internal/compiler/ast/ImportReference.java;2;0;4;1;0;0;0;4;84;1;4;7;113;113;1;0;0;4;4;7;0;199;4;2;0
/org.eclipse.ui.workbench/Eclipse UI/org/eclipse/ui/commands/ICategoryListener.java;3;1;5;1;2;2;2;3;23;1;3;87;67;67;1;0;0;3;5;87;0;336;5;3;0
/org.eclipse.ui.ide/src/org/eclipse/ui/views/markers/internal/MarkerList.java;4;1;5;2;4;4;4;1;61;0;1;181;106;106;1;0;0;1;5;181;0;336;5;4;0
/org.eclipse.core.runtime/src/org/eclipse/core/internal/jobs/Worker.java;3;2;23;2;4;3;4;19;336;7;7;23;528;528;7;12;1;19;23;63;13;320;10;3;0
/org.eclipse.swt/Eclipse SWT PI/gtk/org/eclipse/swt/internal/gtk/XEvent.java;2;1;2;1;2;2;2;0;4;0;0;293;4;4;1;0;0;0;2;293;0;337;2;2;0
/org.eclipse.swt/Eclipse SWT/win32/org/eclipse/swt/graphics/Image.java;5;2;15;2;3;2;3;12;177;4;8;18;295;295;4;4;1;12;15;234;5;337;10;5;3
/org.eclipse.team.cvs.ui/src/org/eclipse/team/internal/ccvs/ui/operations/RemoteOperation.java;2;1;4;1;2;2;2;2;6;1;2;63;12;12;1;0;0;2;4;63;0;336;4;2;0
/org.eclipse.jdt.debug.ui/ui/org/eclipse/jdt/internal/debug/ui/launcher/AppletSelectionDialog.java;1;0;2;1;0;0;0;2;127;0;1;9;127;127;2;1;0;2;2;9;1;9;1;1;0
/org.eclipse.ui.workbench/Eclipse UI/org/eclipse/ui/internal/registry/ActionSetRegistryReader.java;3;0;3;1;1;1;1;2;7;1;2;196;11;11;1;0;0;2;3;196;0;336;3;3;0
/org.eclipse.search/search/org/eclipse/search/internal/core/text/IMatchCollector.java;1;0;1;1;0;0;0;1;0;0;1;224;0;0;1;0;0;1;1;224;0;224;1;1;0
/org.eclipse.team.ui/src/org/eclipse/team/ui/synchronize/SynchronizeModelAction.java;2;4;8;1;7;3;7;1;291;0;1;253;385;385;4;0;4;1;8;295;4;335;4;2;0
/org.eclipse.ui.workbench.texteditor/src/org/eclipse/ui/texteditor/ConvertLineDelimitersAction.java;3;1;6;2;2;2;2;4;23;2;3;29;65;65;2;1;0;4;6;124;1;336;5;3;0
/org.eclipse.jdt.ui/ui/org/eclipse/jdt/internal/ui/wizards/buildpaths/CPVariableElementLabelProvider.java;1;0;1;1;1;1;1;0;2;0;0;336;2;2;1;0;0;0;1;336;0;336;1;1;0
/org.eclipse.jdt.core/eval/org/eclipse/jdt/internal/eval/EvaluationContext.java;5;0;9;1;1;1;1;8;54;2;7;1;108;108;2;1;0;8;9;1;1;296;8;5;0
/org.eclipse.ui.workbench/Eclipse UI/org/eclipse/ui/internal/FolderLayout.java;4;2;11;3;4;3;4;7;191;3;3;178;287;287;3;4;1;7;11;244;5;336;6;4;3
/org.eclipse.jdt.debug/eval/org/eclipse/jdt/internal/debug/eval/ast/instructions/AssignmentOperator.java;1;0;1;1;0;0;0;1;2;0;1;78;2;2;1;0;0;1;1;78;0;78;1;1;0
/org.eclipse.update.core/src/org/eclipse/update/search/IUpdateSearchSite.java;2;1;5;2;2;2;2;3;7;1;3;54;17;17;1;0;0;3;5;54;0;336;5;2;0
/org.eclipse.swt/Eclipse SWT Mozilla/common/org/eclipse/swt/internal/mozilla/nsIDocShellTreeItem.java;1;0;2;1;0;0;0;2;34;1;2;100;34;34;1;0;0;2;2;100;0;148;2;1;0
/org.eclipse.pde.ui/src/org/eclipse/pde/internal/ui/wizards/templates/PreprocessorParser.java;2;1;3;1;2;2;2;1;42;0;1;26;63;63;1;0;0;1;3;26;0;336;3;2;0
/org.eclipse.update.configurator/src/org/eclipse/update/internal/configurator/FeatureEntry.java;1;3;19;1;8;3;8;11;158;5;4;183;376;376;5;7;5;11;19;247;12;321;7;1;0
/org.eclipse.swt/Eclipse SWT/common/org/eclipse/swt/internal/image/TIFFRandomFileAccess.java;1;0;1;1;0;0;0;1;0;0;1;26;0;0;1;0;0;1;1;26;0;26;1;1;0
/org.eclipse.debug.ui/ui/org/eclipse/debug/internal/ui/views/memory/ReformatAction.java;1;0;1;1;1;1;1;0;0;0;0;282;0;0;1;0;0;0;1;282;0;282;1;1;0
/org.eclipse.core.resources/src/org/eclipse/core/internal/utils/Cache.java;2;1;2;1;2;2;2;0;12;0;0;292;12;12;1;0;0;0;2;292;0;306;2;2;1
/org.eclipse.jdt.ui/ui/org/eclipse/jdt/internal/ui/search/SearchViewActionGroup.java;2;1;2;1;2;2;2;0;9;0;0;290;11;11;1;0;0;0;2;290;0;336;2;2;0
/org.eclipse.jdt.core/compiler/org/eclipse/jdt/internal/compiler/ast/AbstractMethodDeclaration.java;5;1;16;3;3;3;3;13;118;3;7;2;328;328;3;6;0;13;16;76;6;326;10;5;1
/org.eclipse.pde.core/src/org/eclipse/pde/internal/core/plugin/PluginElement.java;3;2;6;2;4;3;4;2;35;1;2;232;61;61;2;0;1;2;6;306;1;336;5;3;0
/org.eclipse.text/src/org/eclipse/jface/text/templates/TemplateException.java;2;2;3;2;3;2;3;0;5;0;0;274;5;5;2;0;1;0;3;334;1;334;2;2;0
/org.eclipse.debug.ui/ui/org/eclipse/debug/internal/ui/sourcelookup/CommonSourceNotFoundEditor.java;3;2;7;2;4;3;4;3;141;1;3;209;216;216;2;0;1;3;7;283;1;307;6;3;2
/org.eclipse.jdt.debug.ui/ui/org/eclipse/jdt/internal/debug/ui/propertypages/JavaLineBreakpointPage.java;3;1;9;2;3;3;3;6;36;3;4;82;89;89;3;2;0;6;9;82;2;336;7;3;0
/org.eclipse.swt/Eclipse SWT Browser/carbon/org/eclipse/swt/browser/WebKit.java;2;1;2;1;2;2;2;0;6;0;0;287;10;10;1;0;0;0;2;287;0;337;2;2;2
/org.eclipse.debug.ui/ui/org/eclipse/debug/internal/ui/launchConfigurations/DuplicateLaunchConfigurationAction.java;1;0;1;1;0;0;0;1;4;0;1;33;4;4;1;0;0;1;1;33;0;33;1;1;0
/org.eclipse.ui.workbench/Eclipse UI/org/eclipse/ui/internal/themes/CascadingTheme.java;1;0;1;1;0;0;0;1;0;0;1;250;0;0;1;0;0;1;1;250;0;250;1;1;0
/org.eclipse.jdt.ui/ui/org/eclipse/jdt/internal/ui/wizards/buildpaths/NewSourceFolderDialog.java;1;0;1;1;1;1;1;0;2;0;0;336;2;2;1;0;0;0;1;336;0;336;1;1;0
/org.eclipse.swt/Eclipse SWT PI/gtk/org/eclipse/swt/internal/gtk/GdkVisual.java;2;0;2;1;1;1;1;1;17;0;1;100;19;19;1;0;0;1;2;100;0;337;2;2;0
/org.eclipse.swt/Eclipse SWT/photon/org/eclipse/swt/widgets/Sash.java;2;0;3;1;0;0;0;3;2;1;3;19;6;6;1;0;0;3;3;19;0;139;3;2;0
/org.eclipse.team.cvs.core/src/org/eclipse/team/internal/ccvs/core/CVSRevisionNumberCompareCriteria.java;2;0;9;2;1;1;1;8;94;3;4;30;182;182;3;4;0;8;9;232;4;336;5;2;0
/org.eclipse.jdt.core/dom/org/eclipse/jdt/internal/core/dom/rewrite/RewriteEvent.java;2;0;2;1;1;1;1;1;4;0;1;262;4;4;1;0;0;1;2;262;0;336;2;2;0
/org.eclipse.swt/Eclipse SWT/win32/org/eclipse/swt/graphics/TextLayout.java;4;0;31;3;3;1;22;9;2211;0;1;250;2238;2238;28;8;21;28;31;250;29;334;2;4;2
/org.eclipse.jdt.ui/ui/org/eclipse/jdt/internal/ui/text/spelling/AddWordProposal.java;2;0;2;1;1;1;1;1;2;0;1;219;2;2;1;0;0;1;2;219;0;336;2;2;0
/org.eclipse.core.runtime/src/org/eclipse/core/runtime/IExtensionRegistry.java;4;0;7;2;1;1;2;5;199;2;3;177;394;394;2;2;1;6;7;177;3;296;4;4;0
/org.eclipse.pde.build/src/org/eclipse/pde/internal/build/FeatureWriter.java;2;3;12;2;5;2;5;7;33;3;3;31;61;61;3;4;3;7;12;70;7;303;5;2;0
/org.eclipse.ui.ide/extensions/org/eclipse/ui/IResourceActionFilter.java;6;2;6;2;3;2;3;3;30;2;2;132;49;49;2;1;1;3;6;165;2;336;4;6;0
/org.eclipse.team.ui/src/org/eclipse/team/ui/synchronize/SyncInfoCompareInput.java;1;7;12;1;9;2;9;3;420;2;2;214;604;604;7;1;7;3;12;321;8;321;4;1;0
/org.eclipse.ant.core/src_ant/org/eclipse/ant/internal/core/ant/AntSecurityManager.java;1;0;2;1;0;0;0;2;68;1;2;71;134;134;1;0;0;2;2;71;0;170;2;1;0
/org.eclipse.jface/src/org/eclipse/jface/dialogs/IDialogSettings.java;2;1;2;1;2;2;2;0;427;0;0;293;431;431;1;0;0;0;2;293;0;336;2;2;0
/org.eclipse.jdt.core/model/org/eclipse/jdt/core/util/ISignatureAttribute.java;2;0;2;1;0;0;0;2;37;1;2;210;37;37;1;0;0;2;2;210;0;264;2;2;0
/org.eclipse.jdt.ui/ui/org/eclipse/jdt/internal/ui/typehierarchy/MethodsViewer.java;2;0;4;1;1;1;1;3;4;1;3;31;10;10;1;0;0;3;4;31;0;336;4;2;0
/org.eclipse.jdt.debug/eval/org/eclipse/jdt/internal/debug/eval/ast/engine/ASTInstructionCompiler.java;2;0;5;2;0;0;0;5;19;2;3;78;36;36;2;2;0;5;5;78;2;188;3;2;5
/org.eclipse.pde.core/src/org/eclipse/pde/internal/core/TargetPlatformRegistryLoader.java;2;2;13;1;6;5;6;7;318;4;3;179;492;492;4;4;1;7;13;259;5;336;8;2;0
/org.eclipse.jdt.debug.ui/ui/org/eclipse/jdt/internal/debug/ui/actions/MoveDownAction.java;1;0;2;1;0;0;0;2;13;1;2;91;17;17;1;0;0;2;2;91;0;154;2;1;0
/org.eclipse.team.cvs.core/src/org/eclipse/team/internal/ccvs/core/client/NOOPVisitor.java;1;0;1;1;0;0;0;1;5;0;1;110;5;5;1;0;0;1;1;110;0;110;1;1;0
/org.eclipse.jface/src/org/eclipse/jface/dialogs/IMessageProvider.java;2;1;2;1;2;2;2;0;34;0;0;293;38;38;1;0;0;0;2;293;0;336;2;2;0
/org.eclipse.team.cvs.core/src/org/eclipse/team/internal/ccvs/core/resources/SessionPropertySyncInfoCache.java;2;2;11;1;3;2;3;8;132;6;3;56;243;243;6;5;1;8;11;122;6;336;5;2;3
/org.eclipse.update.ui/src/org/eclipse/update/internal/ui/parts/SharedLabelProvider.java;2;0;3;1;1;1;1;2;12;1;2;58;24;24;1;0;0;2;3;58;0;336;3;2;0
/org.eclipse.ui.ide/src/org/eclipse/ui/internal/ide/IDEWorkbenchMessages.java;1;0;1;1;0;0;0;1;0;0;1;92;0;0;1;0;0;1;1;92;0;92;1;1;0
/org.eclipse.core.resources/src/org/eclipse/core/internal/refresh/PollingMonitor.java;2;2;9;2;5;3;5;4;156;2;2;205;238;238;2;2;2;4;9;205;4;331;5;2;0
/org.eclipse.swt/Eclipse SWT PI/carbon/org/eclipse/swt/internal/carbon/ATSUUnhighlightData.java;2;0;3;1;2;1;2;1;20;0;1;248;20;20;2;0;1;1;3;296;1;296;2;2;0
/org.eclipse.jdt.ui/core extension/org/eclipse/jdt/internal/corext/dom/HierarchicalASTVisitor.java;2;1;2;1;2;2;2;0;277;0;0;320;279;279;1;0;0;0;2;320;0;336;2;2;0
/org.eclipse.core.runtime/src/org/eclipse/core/internal/content/DefaultDescription.java;1;1;2;1;2;2;2;0;5;0;0;306;5;5;1;0;0;0;2;306;0;314;2;1;1
/org.eclipse.swt/Eclipse SWT Custom Widgets/common/org/eclipse/swt/custom/ScrolledComposite.java;3;1;3;1;2;2;2;1;8;0;1;9;14;14;1;0;0;1;3;9;0;337;3;3;1
/org.eclipse.jdt.core/model/org/eclipse/jdt/core/ClasspathVariableInitializer.java;2;0;3;1;0;0;0;3;4;1;3;108;7;7;1;0;0;3;3;108;0;199;3;2;0
/org.eclipse.team.ui/src/org/eclipse/team/ui/ISharedImages.java;2;2;17;1;4;3;6;11;98;3;9;52;214;214;3;2;3;13;17;52;5;336;12;2;0
/org.eclipse.jdt.debug.ui/ui/org/eclipse/jdt/internal/debug/ui/launcher/JavaElementPropertyTester.java;2;1;2;1;2;2;2;0;11;0;0;295;11;11;1;0;0;0;2;295;0;336;2;2;0
/org.eclipse.ant.ui/Ant Tools Support/org/eclipse/ant/internal/ui/preferences/AntCodeAssistPreferencePage.java;1;2;3;1;3;2;3;0;4;0;0;304;8;8;2;0;1;0;3;304;1;323;2;1;0
/org.eclipse.jdt.ui/ui/org/eclipse/jdt/internal/ui/javaeditor/selectionactions/StructureSelectEnclosingAction.java;1;0;1;1;1;1;1;0;2;0;0;336;2;2;1;0;0;0;1;336;0;336;1;1;0
/org.eclipse.pde.build/src/org/eclipse/pde/internal/build/packager/UnzipperGenerator.java;2;2;11;2;3;2;3;8;107;2;5;31;163;163;2;3;1;8;11;31;4;336;7;2;0
/org.eclipse.jdt.core/model/org/eclipse/jdt/core/jdom/IDOMMethod.java;2;0;4;1;1;1;1;3;53;1;3;199;67;67;1;0;0;3;4;199;0;299;4;2;0
/org.eclipse.jface/src/org/eclipse/jface/dialogs/MessageDialogWithToggle.java;2;2;4;1;4;3;4;0;143;0;0;289;278;278;2;0;1;0;4;289;1;326;3;2;0
/org.eclipse.jdt.ui/core refactoring/org/eclipse/jdt/internal/corext/refactoring/rename/RefactoringScopeFactory.java;3;0;5;1;1;1;1;4;62;2;3;93;132;132;2;1;0;4;5;221;1;336;4;3;0
/org.eclipse.jdt.ui/ui refactoring/org/eclipse/jdt/internal/ui/refactoring/reorg/NewNameQueries.java;3;0;8;2;1;1;1;7;144;2;5;70;237;237;2;2;0;7;8;70;2;336;6;3;0
/org.eclipse.osgi/resolver/src/org/eclipse/osgi/internal/resolver/BundleSpecificationImpl.java;3;1;3;1;2;2;2;1;6;0;1;171;10;10;1;0;0;1;3;171;0;336;3;3;0
/org.eclipse.ui.workbench.texteditor/src/org/eclipse/ui/internal/texteditor/quickdiff/compare/rangedifferencer/LinkedRangeFactory.java;3;0;3;3;3;1;3;0;38;0;0;332;38;38;3;0;2;0;3;332;2;332;1;3;0
/org.eclipse.jdt.debug.ui/ui/org/eclipse/jdt/internal/debug/ui/JDIContentAssistPreference.java;3;2;4;2;3;2;3;1;11;0;1;78;17;17;2;0;1;1;4;294;1;336;3;3;0
/org.eclipse.ui.workbench/Eclipse UI/org/eclipse/ui/internal/progress/ProgressViewUpdater.java;2;1;12;1;3;3;3;9;242;4;3;134;393;393;4;6;0;9;12;203;6;336;6;2;0
/org.eclipse.swt/Eclipse SWT/motif/org/eclipse/swt/widgets/Shell.java;7;4;32;4;7;2;7;25;259;7;12;6;586;586;7;13;5;25;32;125;18;321;14;7;6
/org.eclipse.jdt.ui/ui/org/eclipse/jdt/internal/ui/javaeditor/CompilationUnitAnnotationModelEvent.java;3;0;5;2;1;1;1;4;59;1;4;71;93;93;1;0;0;4;5;71;0;336;5;3;0
/org.eclipse.jdt.core/compiler/org/eclipse/jdt/internal/compiler/ast/EmptyStatement.java;2;0;5;1;1;1;1;4;24;2;3;61;32;32;2;1;0;4;5;61;1;287;4;2;0
/org.eclipse.debug.ui/ui/org/eclipse/debug/internal/ui/DebugPerspectiveFactory.java;4;0;6;1;1;1;1;5;12;2;3;122;28;28;2;2;0;5;6;208;2;336;4;4;0
/org.eclipse.swt/Eclipse SWT/motif/org/eclipse/swt/widgets/FontDialog.java;4;1;8;3;2;2;2;6;1009;4;3;12;1081;1081;4;3;0;6;8;12;3;337;5;4;0
/org.eclipse.team.ui/src/org/eclipse/team/internal/ui/synchronize/LocalResourceTypedElement.java;1;1;6;1;2;2;2;4;157;2;3;228;189;189;2;1;0;4;6;228;1;336;5;1;0
/org.eclipse.jdt.core/compiler/org/eclipse/jdt/internal/compiler/parser/RecoveredBlock.java;4;0;7;2;1;1;1;6;92;2;5;34;210;210;2;1;0;6;7;63;1;288;6;4;0
/org.eclipse.jdt.debug.ui/ui/org/eclipse/jdt/internal/debug/ui/breakpoints/AddExceptionAction.java;3;0;3;2;2;1;2;1;25;0;1;175;25;25;2;0;1;1;3;292;1;292;2;3;0
/org.eclipse.debug.ui/ui/org/eclipse/debug/internal/ui/sourcelookup/CommonSourceNotFoundEditorInput.java;1;0;2;1;1;1;1;1;59;0;1;209;59;59;1;0;0;1;2;209;0;296;2;1;0
/org.eclipse.team.cvs.core/src/org/eclipse/team/internal/ccvs/core/client/UpdateMergableOnly.java;2;1;7;2;2;2;2;5;115;3;3;48;201;201;3;2;0;5;7;48;2;336;5;2;0
/org.eclipse.jdt.debug.ui/ui/org/eclipse/jdt/internal/debug/ui/launcher/MainMethodSearchEngine.java;3;1;4;1;3;3;3;1;111;0;1;231;116;116;1;0;0;1;4;231;0;290;4;3;1
/org.eclipse.swt/Eclipse SWT PI/win32/org/eclipse/swt/internal/win32/NONCLIENTMETRICSW.java;2;0;2;1;0;0;0;2;1;1;2;61;1;1;1;0;0;2;2;61;0;166;2;2;0
/org.eclipse.jdt.core/model/org/eclipse/jdt/core/jdom/DOMException.java;1;0;3;1;1;1;1;2;4;1;2;108;10;10;1;0;0;2;3;108;0;308;3;1;0
/org.eclipse.ant.ui/Ant Editor/org/eclipse/ant/internal/ui/editor/derived/HTML2TextReader.java;1;0;1;1;0;0;0;1;0;0;1;108;0;0;1;0;0;1;1;108;0;108;1;1;0
/org.eclipse.debug.ui/ui/org/eclipse/debug/internal/ui/actions/RetargetWatchpointAction.java;1;0;1;1;0;0;0;1;1;0;1;246;1;1;1;0;0;1;1;246;0;246;1;1;0
/org.eclipse.swt/Eclipse SWT PI/carbon/org/eclipse/swt/internal/carbon/HMHelpContentRec.java;1;0;2;1;2;1;2;0;20;0;0;296;20;20;2;0;1;0;2;296;1;296;1;1;0
/org.eclipse.update.configurator/src/org/eclipse/update/internal/configurator/Utils.java;1;3;17;1;5;2;6;11;244;6;4;184;359;359;6;7;4;12;17;256;11;312;6;1;0
/org.eclipse.jdt.core/compiler/org/eclipse/jdt/internal/compiler/ast/QualifiedSuperReference.java;2;0;4;1;0;0;0;4;10;1;4;63;18;18;1;0;0;4;4;63;0;267;4;2;0
/org.eclipse.core.runtime.compatibility/src-boot/org/eclipse/core/boot/IPlatformRunnable.java;2;1;2;1;2;2;2;0;2;0;0;297;2;2;1;0;0;0;2;297;0;336;2;2;0
/org.eclipse.swt/Eclipse SWT Drag and Drop/win32/org/eclipse/swt/dnd/DropTarget.java;2;0;6;2;0;0;0;6;681;5;2;13;713;713;5;4;0;6;6;13;4;52;2;2;1
/org.eclipse.core.resources/src/org/eclipse/core/resources/team/ResourceRuleFactory.java;2;0;5;2;1;1;4;1;80;0;1;270;91;91;4;0;3;4;5;270;3;313;2;2;1
/org.eclipse.swt/Eclipse SWT PI/carbon/org/eclipse/swt/internal/carbon/FontInfo.java;1;0;2;1;2;1;2;0;20;0;0;296;20;20;2;0;1;0;2;296;1;296;1;1;0
/org.eclipse.jdt.debug.ui/ui/org/eclipse/jdt/internal/debug/core/refactoring/JavaClassPrepareBreakpointTypeChange.java;2;1;3;1;3;3;3;0;8;0;0;287;16;16;1;0;0;0;3;287;0;336;3;2;1
/org.eclipse.core.filebuffers/src/org/eclipse/core/filebuffers/IPersistableAnnotationModel.java;1;1;2;1;2;2;2;0;27;0;0;289;27;27;1;0;0;0;2;289;0;334;2;1;0
/org.eclipse.jdt.launching/launching/org/eclipse/jdt/internal/launching/JavaClasspathVariablesInitializer.java;3;0;3;2;2;1;2;1;14;0;1;144;16;16;2;0;1;1;3;331;1;331;2;3;0
/org.eclipse.ui.ide/extensions/org/eclipse/ui/dialogs/NewFolderDialog.java;3;0;3;1;1;1;1;2;35;1;2;132;59;59;1;0;0;2;3;132;0;336;3;3;1
/org.eclipse.debug.ui/ui/org/eclipse/debug/internal/ui/views/memory/ViewTabEnablementManager.java;2;0;2;2;2;1;2;0;2;0;0;282;2;2;2;0;1;0;2;282;1;282;1;2;0
/org.eclipse.update.core/src/org/eclipse/update/internal/core/ISiteContentConsumer.java;2;1;3;1;2;2;2;1;4;0;1;58;11;11;1;0;0;1;3;58;0;336;3;2;0
/org.eclipse.swt/Eclipse SWT/win32/org/eclipse/swt/widgets/TrayItem.java;3;1;9;2;3;3;3;6;50;4;2;247;126;126;4;4;0;6;9;247;4;326;5;3;0
/org.eclipse.jdt.junit/src/org/eclipse/jdt/internal/junit/refactoring/TypeRenameParticipant.java;2;1;2;1;2;2;2;0;10;0;0;272;10;10;1;0;0;0;2;272;0;336;2;2;1
/org.eclipse.team.ui/src/org/eclipse/team/internal/ui/synchronize/SynchronizeView.java;2;5;21;2;10;3;10;11;305;6;3;146;962;962;6;8;7;11;21;232;15;314;6;2;2
/org.eclipse.pde.ui/src/org/eclipse/pde/internal/ui/editor/build/JARFileFilter.java;2;1;5;1;3;3;3;2;25;1;2;104;35;35;1;0;0;2;5;104;0;336;5;2;0
/org.eclipse.core.resources/src/org/eclipse/core/internal/resources/WorkspacePreferences.java;3;0;7;1;2;1;2;5;34;1;5;7;79;79;2;0;1;5;7;275;1;275;6;3;2
/org.eclipse.ltk.core.refactoring/src/org/eclipse/ltk/internal/core/refactoring/TextChanges.java;1;0;2;1;1;1;1;1;2;0;1;264;2;2;1;0;0;1;2;264;0;278;2;1;0
/org.eclipse.pde.core/src/org/eclipse/pde/core/plugin/ISharedPluginModel.java;2;1;3;1;2;2;2;1;20;0;1;128;24;24;1;0;0;1;3;128;0;336;3;2;0
/org.eclipse.ui.workbench/Eclipse UI/org/eclipse/ui/internal/decorators/FullDecoratorRunnable.java;1;0;1;1;0;0;0;1;0;0;1;233;0;0;1;0;0;1;1;233;0;233;1;1;0
/org.eclipse.swt/Eclipse SWT/motif/org/eclipse/swt/widgets/Sash.java;4;1;8;1;2;2;2;6;40;2;5;6;107;107;2;1;0;6;8;6;1;337;7;4;0
/org.eclipse.pde.core/src/org/eclipse/pde/internal/core/feature/IdentifiableObject.java;2;1;3;1;2;2;2;1;8;0;1;232;14;14;1;0;0;1;3;232;0;336;3;2;0
/org.eclipse.update.ui/src/org/eclipse/update/internal/ui/wizards/OptionalFeaturesPage.java;3;1;10;3;2;2;2;8;266;4;5;50;319;319;4;3;0;8;10;50;3;336;7;3;0
/org.eclipse.pde.core/src/org/eclipse/pde/internal/core/ischema/IDocumentSection.java;1;0;1;1;1;1;1;0;12;0;0;309;12;12;1;0;0;0;1;309;0;309;1;1;0
/org.eclipse.jdt.ui/ui/org/eclipse/jdt/internal/ui/jarpackager/ManifestProvider.java;1;0;1;1;1;1;1;0;2;0;0;336;2;2;1;0;0;0;1;336;0;336;1;1;0
/org.eclipse.pde.core/src/org/eclipse/pde/internal/core/feature/FeatureObject.java;2;0;3;1;1;1;1;2;7;1;2;232;13;13;1;0;0;2;3;232;0;336;3;2;0
/org.eclipse.team.core/src/org/eclipse/team/internal/core/streams/TimeoutInputStream.java;2;0;2;1;1;1;1;1;62;0;1;263;64;64;1;0;0;1;2;263;0;336;2;2;0
/org.eclipse.pde.ui/src/org/eclipse/pde/internal/ui/wizards/imports/PluginImportWizardDetailedPage.java;2;1;21;2;4;4;4;17;1244;8;8;7;1836;1836;8;9;0;17;21;45;9;336;12;2;0
/org.eclipse.debug.core/core/org/eclipse/debug/internal/core/LaunchManager.java;4;1;37;3;2;2;4;33;218;7;12;32;891;891;7;21;2;35;37;61;23;303;14;4;4
/org.eclipse.ui.cheatsheets/src/org/eclipse/ui/internal/cheatsheets/views/CheatSheetView.java;3;3;14;3;7;3;7;7;1120;6;2;243;2186;2186;6;5;4;7;14;253;9;336;5;3;0
/org.eclipse.update.core/src/org/eclipse/update/internal/model/ConfigurationPolicyModel.java;2;1;6;1;3;3;3;3;34;2;2;58;66;66;2;1;0;3;6;227;1;336;5;2;0
/org.eclipse.ui.editors/src/org/eclipse/ui/internal/editors/text/JavaFileEditorInput.java;2;0;3;1;1;1;1;2;22;0;1;130;44;44;2;1;0;2;3;130;1;336;2;2;0
/org.eclipse.ui.workbench/Eclipse UI/org/eclipse/ui/internal/themes/IHierarchalThemeElementDefinition.java;1;0;1;1;0;0;0;1;0;0;1;241;0;0;1;0;0;1;1;241;0;241;1;1;0
/org.eclipse.jdt.ui/ui/org/eclipse/jdt/internal/ui/text/java/hover/JavaHoverMessages.java;1;0;2;1;1;1;1;1;55;0;1;206;57;57;1;0;0;1;2;206;0;336;2;1;0
/org.eclipse.team.cvs.core/src/org/eclipse/team/internal/ccvs/core/client/Tag.java;1;0;3;1;0;0;0;3;4;1;3;63;8;8;1;0;0;3;3;63;0;110;3;1;0
/org.eclipse.jface.text/src/org/eclipse/jface/text/source/AnnotationColumn.java;2;0;2;2;2;1;2;0;4;0;0;336;4;4;2;0;1;0;2;336;1;336;1;2;0
/org.eclipse.debug.core/core/org/eclipse/debug/internal/core/sourcelookup/containers/ExternalArchiveSourceContainerType.java;2;0;3;1;1;1;1;2;20;1;2;254;25;25;1;0;0;2;3;254;0;303;3;2;0
/org.eclipse.jdt.ui/core extension/org/eclipse/jdt/internal/corext/dom/fragments/ASTFragmentFactory.java;3;0;4;1;1;1;1;3;21;1;3;80;30;30;1;0;0;3;4;80;0;336;4;3;0
/org.eclipse.ant.ui/Ant Editor/org/eclipse/ant/internal/ui/dtd/schema/NfmParser.java;1;0;1;1;0;0;0;1;0;0;1;108;0;0;1;0;0;1;1;108;0;108;1;1;0
/org.eclipse.jdt.ui/ui refactoring/org/eclipse/jdt/internal/ui/refactoring/code/InlineMethodInputPage.java;2;0;5;1;1;1;2;3;17;3;2;251;22;22;3;1;1;4;5;267;2;336;3;2;0
/org.eclipse.jdt.ui/ui/org/eclipse/jdt/internal/ui/compare/JavaStructureDiffViewerCreator.java;1;0;1;1;1;1;1;0;2;0;0;336;2;2;1;0;0;0;1;336;0;336;1;1;0
/org.eclipse.ltk.ui.refactoring/src/org/eclipse/ltk/internal/ui/refactoring/ChangeElement.java;1;1;5;1;2;2;3;2;9;0;1;269;17;17;3;1;1;3;5;269;2;336;3;1;0
/org.eclipse.update.core/src/org/eclipse/update/configuration/ILocalSite.java;2;0;3;1;1;1;1;2;4;1;2;58;9;9;1;0;0;2;3;58;0;336;3;2;0
/org.eclipse.jdt.debug/eval/org/eclipse/jdt/debug/eval/IAstEvaluationEngine.java;2;0;1;2;1;1;1;0;6;0;0;336;6;6;1;0;0;0;1;336;0;336;1;2;0
/org.eclipse.jdt.ui/core extension/org/eclipse/jdt/internal/corext/template/java/JavaContextType.java;4;1;8;1;2;2;2;6;112;3;3;175;241;241;3;3;0;6;8;234;3;336;5;4;0
/org.eclipse.team.core/src/org/eclipse/team/internal/core/subscribers/ThreeWayBaseTree.java;2;0;2;1;1;1;1;1;2;0;1;239;2;2;1;0;0;1;2;239;0;336;2;2;0
/org.eclipse.debug.core/core/org/eclipse/debug/internal/core/LogicalStructureType.java;1;0;2;1;0;0;0;2;34;0;1;152;34;34;2;1;0;2;2;152;1;152;1;1;1
/org.eclipse.ui.workbench.texteditor/src/org/eclipse/ui/texteditor/IDocumentProviderExtension.java;2;0;1;2;1;1;1;0;4;0;0;336;4;4;1;0;0;0;1;336;0;336;1;2;0
/org.eclipse.jdt.core/compiler/org/eclipse/jdt/internal/compiler/ast/MethodDeclaration.java;1;0;8;1;0;0;0;8;32;3;6;1;53;53;3;2;0;8;8;61;2;199;6;1;1
/org.eclipse.text/src/org/eclipse/text/edits/EditDocument.java;2;0;2;1;1;1;1;1;2;0;1;125;2;2;1;0;0;1;2;125;0;336;2;2;0
/org.eclipse.jdt.ui/ui/org/eclipse/jdt/internal/ui/text/correction/SimilarElementsRequestor.java;2;1;4;1;2;2;2;2;44;1;2;179;61;61;1;0;0;2;4;179;0;336;4;2;1
/org.eclipse.jdt.ui/ui/org/eclipse/jdt/internal/ui/callhierarchy/CancelSearchAction.java;2;0;2;1;1;1;1;1;2;0;1;246;2;2;1;0;0;1;2;246;0;336;2;2;0
/org.eclipse.jdt.ui/ui/org/eclipse/jdt/internal/ui/search/JavaSearchSorter.java;3;2;4;2;3;2;3;1;10;0;1;183;12;12;2;0;1;1;4;283;1;336;3;3;0
/org.eclipse.ui.forms/src/org/eclipse/ui/internal/forms/WizardForm.java;1;0;1;1;1;1;1;0;0;0;0;272;0;0;1;0;0;0;1;272;0;272;1;1;0
/org.eclipse.search/search/org/eclipse/search/internal/ui/ShowSearchAction.java;1;0;1;1;1;1;1;0;2;0;0;336;2;2;1;0;0;0;1;336;0;336;1;1;0
/org.eclipse.core.resources/src/org/eclipse/core/internal/resources/Rules.java;2;1;12;2;3;3;5;7;219;3;5;149;396;396;3;2;2;9;12;270;4;329;8;2;1
/org.eclipse.pde.ui/src/org/eclipse/pde/internal/ui/search/PluginSearchPage.java;2;1;5;1;2;2;2;3;38;1;3;93;59;59;1;0;0;3;5;93;0;336;5;2;0
/org.eclipse.swt/Eclipse SWT Drag and Drop/emulated/org/eclipse/swt/dnd/DropTarget.java;1;0;1;1;0;0;0;1;4;0;1;0;4;4;1;0;0;1;1;0;0;0;1;1;0
/org.eclipse.debug.ui/ui/org/eclipse/debug/internal/ui/views/breakpoints/BreakpointsView.java;5;3;15;3;6;4;6;9;201;3;5;96;390;390;3;4;2;9;15;96;6;336;9;5;6
/org.eclipse.jdt.core/compiler/org/eclipse/jdt/internal/compiler/ast/SingleTypeReference.java;3;0;4;2;0;0;0;4;103;1;4;1;115;115;1;0;0;4;4;1;0;199;4;3;1
/org.eclipse.core.resources/src/org/eclipse/core/resources/IResourceChangeEvent.java;2;0;5;1;2;1;3;2;137;2;2;170;219;219;2;0;2;3;5;270;2;292;3;2;1
/org.eclipse.jdt.ui/core refactoring/org/eclipse/jdt/internal/corext/refactoring/nls/changes/CreateTextFileChange.java;3;2;4;2;3;2;3;1;14;0;1;65;23;23;2;0;1;1;4;331;1;331;3;3;0
/org.eclipse.ant.ui/Ant Editor/org/eclipse/ant/internal/ui/dtd/schema/Schema.java;1;0;2;1;0;0;0;2;6;1;2;108;6;6;1;0;0;2;2;108;0;202;2;1;0
/org.eclipse.jdt.junit/src/org/eclipse/jdt/internal/junit/util/PixelConverter.java;2;1;2;1;2;2;2;0;8;0;0;275;10;10;1;0;0;0;2;275;0;336;2;2;0
/org.eclipse.swt/Eclipse SWT/win32/org/eclipse/swt/widgets/Button.java;4;0;7;1;0;0;0;7;12;2;6;3;34;34;2;1;0;7;7;153;1;189;6;4;0
/org.eclipse.swt/Eclipse SWT Custom Widgets/common/org/eclipse/swt/custom/PrintRenderer.java;3;0;4;1;1;1;1;3;79;2;2;115;85;85;2;1;0;3;4;253;1;337;3;3;0
/org.eclipse.jdt.ui/ui/org/eclipse/jdt/internal/ui/text/HTML2TextReader.java;3;1;4;1;2;2;2;2;5;1;2;11;11;11;1;0;0;2;4;11;0;336;4;3;0
/org.eclipse.swt/Eclipse SWT PI/win32/org/eclipse/swt/internal/win32/SHRGINFO.java;1;0;1;1;0;0;0;1;2;0;1;166;2;2;1;0;0;1;1;166;0;166;1;1;0
/org.eclipse.ui.workbench/Eclipse UI/org/eclipse/ui/internal/ViewFactory.java;6;5;17;3;11;4;11;6;659;2;4;178;1110;1110;5;2;7;6;17;297;9;324;8;6;5
/org.eclipse.jdt.debug/jdi/org/eclipse/jdi/internal/SourceDebugExtensionParser.java;3;0;5;2;0;0;0;5;64;2;3;39;71;71;2;2;0;5;5;48;2;71;3;3;0
/org.eclipse.osgi/resolver/src/org/eclipse/core/internal/dependencies/Dependency.java;4;2;5;2;4;3;4;1;31;0;1;171;56;56;2;0;1;1;5;276;1;336;4;4;0
/org.eclipse.jface/src/org/eclipse/jface/preference/FileFieldEditor.java;2;1;2;1;2;2;2;0;5;0;0;293;7;7;1;0;0;0;2;293;0;336;2;2;0
/org.eclipse.jdt.ui/core refactoring/org/eclipse/jdt/internal/corext/refactoring/structure/InstanceMethodMover.java;5;1;32;2;3;3;3;29;276;6;11;16;685;685;6;18;0;29;32;95;18;336;14;5;0
/org.eclipse.jdt.ui/ui/org/eclipse/jdt/internal/ui/wizards/dialogfields/TreeListDialogField.java;3;1;4;1;2;2;2;2;27;1;2;88;42;42;1;0;0;2;4;88;0;336;4;3;0
/org.eclipse.jdt.ui/ui/org/eclipse/jdt/internal/ui/compare/JavaCompareWithEditionAction.java;2;0;3;1;1;1;1;2;22;1;2;104;32;32;1;0;0;2;3;104;0;336;3;2;1
/org.eclipse.jdt.core/compiler/org/eclipse/jdt/internal/compiler/ast/SwitchStatement.java;3;0;16;2;2;1;2;14;389;3;9;11;591;591;3;5;1;14;16;11;6;287;10;3;0
/org.eclipse.ui.ide/src/org/eclipse/ui/internal/ide/model/WorkbenchResource.java;5;2;8;2;4;3;4;4;310;2;3;132;513;513;2;1;1;4;8;165;2;336;6;5;0
/org.eclipse.team.cvs.core/src/org/eclipse/team/internal/ccvs/core/resources/RemoteFolderSandbox.java;1;0;1;1;0;0;0;1;0;0;1;184;0;0;1;0;0;1;1;184;0;184;1;1;0
/org.eclipse.ltk.core.refactoring/src/org/eclipse/ltk/core/refactoring/RefactoringStatus.java;1;2;6;1;4;2;4;2;36;0;1;264;58;58;2;1;2;2;6;264;3;332;3;1;0
/org.eclipse.jdt.ui/ui refactoring/org/eclipse/jdt/internal/ui/refactoring/reorg/RenameSourceFolderWizard.java;2;1;3;1;2;2;2;1;10;0;1;71;19;19;1;0;0;1;3;71;0;336;3;2;0
/org.eclipse.core.runtime/src/org/eclipse/core/internal/runtime/Product.java;2;2;10;2;4;3;4;6;63;4;3;205;123;123;4;3;1;6;10;205;4;314;6;2;0
/org.eclipse.jdt.debug.ui/ui/org/eclipse/jdt/debug/ui/launchConfigurations/AppletMainTab.java;5;1;13;3;2;2;2;11;304;5;5;76;349;349;5;6;0;11;13;233;6;336;7;5;0
/org.eclipse.swt/Eclipse SWT/photon/org/eclipse/swt/graphics/Font.java;1;0;1;1;0;0;0;1;4;0;1;134;4;4;1;0;0;1;1;134;0;134;1;1;2
/org.eclipse.ant.ui/Ant Editor/org/eclipse/ant/internal/ui/editor/text/AntStorageDocumentProvider.java;1;1;2;1;2;2;2;0;13;0;0;273;13;13;1;0;0;0;2;273;0;321;2;1;0
/org.eclipse.ui.workbench/Eclipse UI/org/eclipse/ui/actions/RetargetAction.java;4;0;4;2;1;1;1;3;23;1;3;93;63;63;1;0;0;3;4;93;0;336;4;4;1
/org.eclipse.update.core/src/org/eclipse/update/internal/core/ConfigurationActivity.java;2;0;4;1;1;1;1;3;46;1;3;58;71;71;1;0;0;3;4;58;0;336;4;2;0
/org.eclipse.osgi/eclipseAdaptor/src/org/eclipse/osgi/service/datalocation/Location.java;2;0;8;2;0;0;2;6;78;3;4;227;119;119;3;2;2;8;8;227;4;270;4;2;0
/org.eclipse.swt/Eclipse SWT PI/carbon/org/eclipse/swt/internal/carbon/DataBrowserListViewColumnDesc.java;1;0;2;1;2;1;2;0;20;0;0;296;20;20;2;0;1;0;2;296;1;296;1;1;0
/org.eclipse.jdt.ui/ui/org/eclipse/jdt/internal/ui/text/comment/JavaDocLine.java;2;0;7;2;1;1;1;6;419;4;3;97;441;441;4;3;0;6;7;119;3;336;4;2;0
/org.eclipse.ui.forms/src/org/eclipse/ui/forms/widgets/TreeNode.java;1;2;7;1;3;2;3;4;27;3;2;225;44;44;3;2;1;4;7;225;3;332;4;1;0
/org.eclipse.ui.workbench/Eclipse UI/org/eclipse/ui/IWorkbench.java;7;1;32;5;2;2;3;29;1024;15;9;0;1488;1488;15;20;1;30;32;156;21;336;11;7;2
/org.eclipse.text/src/org/eclipse/jface/text/Assert.java;2;1;2;1;2;2;2;0;10;0;0;275;12;12;1;0;0;0;2;275;0;334;2;2;0
/org.eclipse.osgi/eclipseAdaptor/src/org/eclipse/core/runtime/adaptor/IPluginInfo.java;3;2;8;2;4;3;4;4;18;2;3;177;30;30;2;1;1;4;8;234;2;326;6;3;0
/org.eclipse.jdt.junit/src/org/eclipse/jdt/internal/junit/ui/TestMethodSelectionDialog.java;3;1;4;1;3;3;3;1;52;0;1;193;73;73;1;0;0;1;4;193;0;336;4;3;0
/org.eclipse.swt/Eclipse SWT/win32/org/eclipse/swt/widgets/Slider.java;4;2;10;2;3;2;3;7;60;3;4;11;176;176;3;3;1;7;10;168;4;330;6;4;1
/org.eclipse.team.cvs.ui/src/org/eclipse/team/internal/ccvs/ui/ResourcePropertiesPage.java;1;0;1;1;0;0;0;1;2;0;1;138;2;2;1;0;0;1;1;138;0;138;1;1;0
/org.eclipse.core.resources/src/org/eclipse/core/internal/localstore/CopyVisitor.java;2;0;3;1;1;1;1;2;273;1;2;7;277;277;1;0;0;2;3;7;0;277;3;2;0
/org.eclipse.text/src/org/eclipse/jface/text/IDocumentPartitioningListenerExtension.java;2;1;2;1;2;2;2;0;16;0;0;275;18;18;1;0;0;0;2;275;0;334;2;2;0
/org.eclipse.jdt.ui/core refactoring/org/eclipse/jdt/internal/corext/refactoring/typeconstraints/ASTCreator.java;3;1;5;1;2;2;2;3;20;1;3;95;26;26;1;0;0;3;5;95;0;336;5;3;0
/org.eclipse.team.cvs.core/src/org/eclipse/team/internal/ccvs/core/syncinfo/ResourceSyncInfo.java;2;0;6;1;1;1;1;5;65;2;4;52;102;102;2;1;0;5;6;204;1;336;5;2;1
/org.eclipse.pde.ui/src/org/eclipse/pde/ui/IPluginFieldData.java;2;2;5;1;4;3;4;1;60;0;1;222;105;105;2;0;1;1;5;276;1;336;4;2;0
/org.eclipse.core.runtime/src/org/osgi/service/prefs/BackingStoreException.java;1;0;1;1;1;1;1;0;0;0;0;294;0;0;1;0;0;0;1;294;0;294;1;1;0
/org.eclipse.jdt.core/codeassist/org/eclipse/jdt/internal/codeassist/complete/CompletionOnSingleTypeReference.java;2;0;2;1;0;0;0;2;10;1;2;63;12;12;1;0;0;2;2;63;0;199;2;2;0
/org.eclipse.team.core/src/org/eclipse/team/internal/core/DefaultFileModificationValidator.java;2;0;3;1;1;1;1;2;13;1;2;141;18;18;1;0;0;2;3;141;0;336;3;2;0
/org.eclipse.update.core/src/org/eclipse/update/core/INonPluginEntry.java;2;1;3;1;2;2;2;1;6;0;1;58;12;12;1;0;0;1;3;58;0;336;3;2;0
/org.eclipse.jdt.core/model/org/eclipse/jdt/internal/core/CreatePackageFragmentOperation.java;2;0;4;1;0;0;0;4;12;1;4;172;18;18;1;0;0;4;4;172;0;266;4;2;0
/org.eclipse.ant.ui/Ant Editor/org/eclipse/ant/internal/ui/editor/templates/AntSourceViewerInformationControl.java;1;1;2;1;2;2;2;0;10;0;0;283;10;10;1;0;0;0;2;283;0;313;2;1;1
/org.eclipse.osgi/core/framework/org/eclipse/osgi/framework/internal/core/FilterImpl.java;3;1;4;1;4;4;4;0;337;0;0;276;523;523;1;0;0;0;4;276;0;336;4;3;0
/org.eclipse.swt/Eclipse SWT Mozilla/common/org/eclipse/swt/internal/mozilla/nsIDOMEvent.java;2;1;2;1;2;2;2;0;2;0;0;283;2;2;1;0;0;0;2;283;0;336;2;2;0
/org.eclipse.debug.ui/ui/org/eclipse/debug/internal/ui/actions/ResumeActionDelegate.java;1;1;2;1;2;2;2;0;22;0;0;281;26;26;1;0;0;0;2;281;0;336;2;1;1
/org.eclipse.jdt.core/model/org/eclipse/jdt/core/ICompletionRequestor.java;2;0;4;1;1;1;1;3;31;1;3;149;73;73;1;0;0;3;4;149;0;273;4;2;0
/org.eclipse.pde.ui/src/org/eclipse/pde/internal/ui/search/ShowDescriptionAction.java;3;1;8;2;4;4;4;4;34;2;3;62;115;115;2;1;0;4;8;83;1;336;7;3;0
/org.eclipse.jdt.debug/model/org/eclipse/jdt/internal/debug/core/model/JDIFieldVariable.java;2;0;4;2;0;0;0;4;146;0;1;128;146;146;4;3;0;4;4;128;3;128;1;2;1
/org.eclipse.compare/compare/org/eclipse/compare/IContentChangeNotifier.java;1;0;1;1;0;0;0;1;2;0;1;219;2;2;1;0;0;1;1;219;0;219;1;1;0
/org.eclipse.ui.ide/src/org/eclipse/ui/views/bookmarkexplorer/BookmarkMessages.java;1;0;1;1;0;0;0;1;0;0;1;129;0;0;1;0;0;1;1;129;0;129;1;1;0
/org.eclipse.jdt.ui/ui/org/eclipse/jdt/ui/actions/IntroduceParameterAction.java;3;2;7;2;3;2;3;4;36;1;4;130;49;49;2;0;1;4;7;292;1;336;6;3;0
/org.eclipse.jface.text/src/org/eclipse/jface/text/rules/RuleBasedScanner.java;1;1;3;1;2;2;2;1;2;0;1;209;6;6;1;0;0;1;3;209;0;336;3;1;0
/org.eclipse.ui.ide/src/org/eclipse/ui/views/properties/IResourcePropertyConstants.java;1;0;1;1;0;0;0;1;0;0;1;129;0;0;1;0;0;1;1;129;0;129;1;1;0
/org.eclipse.jdt.ui/ui/org/eclipse/jdt/ui/actions/FindDeclarationsInWorkingSetAction.java;2;2;6;1;3;2;3;3;25;1;3;82;42;42;2;0;1;3;6;290;1;336;5;2;0
/org.eclipse.jdt.core/compiler/org/eclipse/jdt/internal/compiler/ast/BranchStatement.java;3;0;4;1;1;1;1;3;19;1;3;11;28;28;1;0;0;3;4;11;0;288;4;3;0
/org.eclipse.team.cvs.ssh/src/org/eclipse/team/internal/ccvs/ssh/Client.java;2;1;5;1;2;2;2;3;38;1;3;12;50;50;1;0;0;3;5;12;0;336;5;2;0
/org.eclipse.team.ui/src/org/eclipse/team/ui/synchronize/ParticipantPageDialog.java;2;2;5;1;5;4;5;0;93;0;0;280;106;106;2;0;1;0;5;335;1;335;4;2;0
/org.eclipse.swt/Eclipse SWT/win32/org/eclipse/swt/widgets/List.java;5;1;16;2;2;2;2;14;112;5;9;8;353;353;5;5;0;14;16;159;5;337;11;5;1
/org.eclipse.osgi/core/framework/org/eclipse/osgi/framework/internal/core/MultiSourcePackage.java;4;1;5;1;2;2;2;3;10;2;2;171;22;22;2;1;0;3;5;171;1;336;4;4;0
/org.eclipse.team.cvs.ui/src/org/eclipse/team/internal/ccvs/ui/subscriber/OverrideAndUpdateAction.java;2;1;12;2;2;2;2;10;72;4;6;100;185;185;4;4;0;10;12;244;4;336;8;2;0
/org.eclipse.jdt.core/batch/org/eclipse/jdt/internal/compiler/batch/CompilationUnit.java;2;0;3;1;0;0;0;3;12;1;3;80;15;15;1;0;0;3;3;80;0;199;3;2;0
/org.eclipse.jface/src/org/eclipse/jface/wizard/WizardDialog.java;4;3;14;2;7;4;7;7;343;2;5;0;487;487;3;2;3;7;14;287;5;320;9;4;1
/org.eclipse.jdt.core/codeassist/org/eclipse/jdt/internal/codeassist/complete/CompletionParser.java;5;0;28;4;1;1;1;27;104;7;10;5;369;369;7;17;0;27;28;51;17;306;11;5;6
/org.eclipse.team.ui/src/org/eclipse/team/internal/ui/synchronize/ScopableSubscriberParticipant.java;1;0;2;1;2;1;2;0;59;0;0;296;59;59;2;0;1;0;2;296;1;296;1;1;0
/org.eclipse.ui.ide/src/org/eclipse/ui/ide/IGotoMarker.java;1;0;1;1;0;0;0;1;0;0;1;131;0;0;1;0;0;1;1;131;0;131;1;1;0
/org.eclipse.swt/Eclipse SWT/photon/org/eclipse/swt/widgets/Caret.java;3;1;4;1;2;2;2;2;6;1;2;19;15;15;1;0;0;2;4;19;0;337;4;3;0
/org.eclipse.ui.workbench/Eclipse UI/org/eclipse/ui/plugin/AbstractUIPlugin.java;5;2;12;2;7;4;7;5;159;2;4;0;425;425;2;1;3;5;12;212;4;336;8;5;1
/org.eclipse.ui.ide/src/org/eclipse/ui/views/markers/internal/FieldCreationTime.java;2;0;3;1;1;1;1;2;53;1;2;129;88;88;1;0;0;2;3;129;0;336;3;2;0
/org.eclipse.jdt.ui/ui/org/eclipse/jdt/internal/ui/text/correction/CUCorrectionProposal.java;3;2;38;3;3;2;3;35;427;11;7;62;1095;1095;11;28;1;35;38;246;29;320;9;3;0
/org.eclipse.ui.presentations.r21/src/org/eclipse/ui/internal/presentations/r21/R21PresentationMessages.java;1;0;1;1;1;1;1;0;0;0;0;323;0;0;1;0;0;0;1;323;0;323;1;1;0
/org.eclipse.jdt.ui/ui refactoring/org/eclipse/jdt/internal/ui/refactoring/nls/search/NLSSearchEditorOpener.java;1;0;1;1;1;1;1;0;0;0;0;293;0;0;1;0;0;0;1;293;0;293;1;1;0
/org.eclipse.ui.workbench/Eclipse UI/org/eclipse/ui/internal/keys/AlphabeticModifierKeyComparator.java;1;0;1;1;0;0;0;1;0;0;1;187;0;0;1;0;0;1;1;187;0;187;1;1;0
/org.eclipse.core.resources/src_ant/org/eclipse/core/resources/ant/Policy.java;1;0;2;1;2;1;2;0;96;0;0;274;96;96;2;0;1;0;2;274;1;274;1;1;0
/org.eclipse.jdt.debug.ui/ui/org/eclipse/jdt/internal/debug/ui/actions/NewDetailFormatterAction.java;1;0;1;1;0;0;0;1;4;0;1;76;4;4;1;0;0;1;1;76;0;76;1;1;0
/org.eclipse.ui.intro/src/org/eclipse/ui/internal/intro/impl/presentations/BrowserIntroPartLocationListener.java;2;2;5;1;5;4;5;0;37;0;0;276;65;65;2;0;1;0;5;336;1;336;4;2;0
/org.eclipse.jdt.ui/ui/org/eclipse/jdt/internal/ui/search/SearchLabelProvider.java;2;0;6;2;6;1;6;0;72;0;0;275;72;72;6;0;5;0;6;275;5;275;1;2;1
/org.eclipse.help.ide/src/org/eclipse/help/ui/internal/search/SortAction.java;1;0;1;1;1;1;1;0;0;0;0;281;0;0;1;0;0;0;1;281;0;281;1;1;0
/org.eclipse.osgi/osgi/src/org/osgi/framework/ServiceReference.java;2;0;2;1;1;1;1;1;3;0;1;171;3;3;1;0;0;1;2;171;0;296;2;2;0
/org.eclipse.ui.views/src/org/eclipse/ui/views/properties/PropertyDescriptor.java;2;0;2;1;1;1;1;1;11;0;1;171;15;15;1;0;0;1;2;171;0;336;2;2;0
/org.eclipse.help.base/src/org/eclipse/help/internal/browser/CustomBrowser.java;1;1;6;1;3;3;3;3;42;2;2;104;88;88;2;1;0;3;6;104;1;336;5;1;0
/org.eclipse.core.runtime/src/org/eclipse/core/internal/registry/Extension.java;5;6;15;4;9;2;9;6;353;3;4;173;479;479;6;2;7;6;15;296;9;296;6;5;0
/org.eclipse.core.resources/src/org/eclipse/core/internal/resources/MarkerAttributeMap.java;1;0;2;1;2;1;2;0;515;0;0;275;515;515;2;0;1;0;2;275;1;275;1;1;0
/org.eclipse.ant.ui/Ant Editor/org/eclipse/ant/internal/ui/editor/outline/XMLProblem.java;1;0;5;1;1;1;1;4;47;2;3;204;143;143;2;1;0;4;5;204;1;314;4;1;2
/org.eclipse.jdt.ui/ui/org/eclipse/jdt/internal/ui/jarpackager/JarManifestWizardPage.java;4;1;6;2;3;3;3;3;30;2;2;82;43;43;2;1;0;3;6;82;1;336;5;4;0
/org.eclipse.update.core/src/org/eclipse/update/internal/core/SiteFileNonPluginContentConsumer.java;1;1;2;1;2;2;2;0;4;0;0;302;8;8;1;0;0;0;2;302;0;336;2;1;0
/org.eclipse.help.webapp/src_servlets/org/eclipse/help/internal/webapp/data/ActivitiesData.java;1;2;5;1;5;4;5;0;31;0;0;286;58;58;2;0;1;0;5;286;1;336;4;1;0
/org.eclipse.core.runtime/src/org/eclipse/core/internal/registry/RegistryCacheWriter.java;4;3;16;3;4;2;6;10;531;4;5;173;711;711;4;5;4;12;16;219;9;327;7;4;0
/org.eclipse.pde.core/src/org/eclipse/pde/internal/core/ischema/ISchemaDescriptor.java;2;0;2;1;1;1;1;1;11;0;1;267;15;15;1;0;0;1;2;267;0;336;2;2;0
/org.eclipse.team.ui/src/org/eclipse/team/internal/ui/synchronize/actions/SubscriberActionContribution.java;2;4;6;2;6;3;6;0;175;0;0;274;179;179;4;0;3;0;6;288;3;312;3;2;3
/org.eclipse.swt/Eclipse SWT/win32/org/eclipse/swt/widgets/Decorations.java;7;2;33;3;7;5;8;25;324;5;13;8;865;865;5;12;3;26;33;182;15;336;18;7;4
/org.eclipse.swt/Eclipse SWT Accessibility/common/org/eclipse/swt/accessibility/AccessibleControlEvent.java;1;0;1;1;0;0;0;1;11;0;1;156;11;11;1;0;0;1;1;156;0;156;1;1;0
/org.eclipse.search/new search/org/eclipse/search2/internal/ui/InternalSearchUI.java;4;2;21;3;5;3;11;10;278;8;6;195;730;730;8;4;8;16;21;269;12;336;9;4;0
/org.eclipse.swt/Eclipse SWT/gtk/org/eclipse/swt/widgets/FileDialog.java;3;1;7;1;3;3;3;4;137;1;4;153;206;206;1;0;0;4;7;153;0;337;7;3;2
/org.eclipse.ui.workbench/Eclipse UI/org/eclipse/ui/internal/themes/ColorsAndFontsPreferencePage.java;2;2;16;2;4;3;5;11;1050;7;2;241;1602;1602;7;9;2;12;16;262;11;330;5;2;1
/org.eclipse.ui.workbench/Eclipse UI/org/eclipse/ui/internal/gestures/Capture.java;1;0;2;1;0;0;0;2;111;1;2;104;145;145;1;0;0;2;2;104;0;161;2;1;0
/org.eclipse.jdt.ui/ui/org/eclipse/jdt/ui/actions/JdtActionConstants.java;6;3;16;3;4;2;4;12;83;5;7;18;215;215;5;5;2;12;16;94;7;336;9;6;0
/org.eclipse.jdt.ui/ui refactoring/org/eclipse/jdt/internal/ui/refactoring/nls/search/NLSGroupByKeyComputer.java;4;1;4;1;2;2;2;2;7;1;2;80;14;14;1;0;0;2;4;80;0;336;4;4;0
/org.eclipse.text/src/org/eclipse/text/edits/TextEdit.java;2;1;8;1;3;3;3;5;322;3;3;118;477;477;3;2;0;5;8;118;2;336;6;2;0
/org.eclipse.ui.console/src/org/eclipse/ui/internal/console/MessageConsolePartition.java;1;0;2;1;0;0;0;2;4;0;1;118;4;4;2;1;0;2;2;118;1;118;1;1;0
/org.eclipse.ltk.ui.refactoring/src/org/eclipse/ltk/internal/ui/refactoring/RefactoringWizardDialog2.java;1;2;6;1;6;4;6;0;7;0;0;273;14;14;2;0;2;0;6;273;2;336;4;1;0
/org.eclipse.jdt.core/compiler/org/eclipse/jdt/internal/compiler/ast/FloatLiteral.java;3;0;3;1;0;0;0;3;4;1;3;128;8;8;1;0;0;3;3;128;0;199;3;3;1
/org.eclipse.ui.workbench/Eclipse UI/org/eclipse/ui/internal/gestures/ICaptureListener.java;1;0;1;1;0;0;0;1;0;0;1;104;0;0;1;0;0;1;1;104;0;104;1;1;0
/org.eclipse.jdt.ui/ui/org/eclipse/jdt/ui/JavaElementLabelProvider.java;2;0;1;2;1;1;1;0;20;0;0;336;20;20;1;0;0;0;1;336;0;336;1;2;0
/org.eclipse.ui.ide/src/org/eclipse/ui/wizards/newresource/BasicNewResourceWizard.java;3;0;4;1;0;0;0;4;36;1;4;92;57;57;1;0;0;4;4;92;0;178;4;3;0
/org.eclipse.jface/src/org/eclipse/jface/preference/BooleanFieldEditor.java;2;1;2;1;2;2;2;0;3;0;0;293;5;5;1;0;0;0;2;293;0;336;2;2;0
/org.eclipse.jdt.debug.ui/ui/org/eclipse/jdt/internal/debug/ui/actions/BreakpointHitCountAction.java;3;1;5;1;3;3;3;2;50;1;2;76;73;73;1;0;0;2;5;76;0;336;5;3;0
/org.eclipse.ui.editors/src/org/eclipse/ui/editors/text/TextEditorMessages.java;1;1;2;1;2;2;2;0;20;0;0;314;37;37;1;0;0;0;2;314;0;336;2;1;0
/org.eclipse.core.resources/src/org/eclipse/core/internal/indexing/ObjectID.java;1;0;1;1;1;1;1;0;12;0;0;277;12;12;1;0;0;0;1;277;0;277;1;1;0
/org.eclipse.jdt.ui/ui/org/eclipse/jdt/internal/ui/filters/NonJavaProjectsFilter.java;1;0;1;1;1;1;1;0;2;0;0;336;2;2;1;0;0;0;1;336;0;336;1;1;0
/org.eclipse.jdt.core/model/org/eclipse/jdt/internal/core/ImportContainer.java;2;0;9;2;1;1;1;8;23;2;7;40;72;72;2;1;0;8;9;124;1;279;8;2;0
/org.eclipse.ui.workbench/Eclipse UI/org/eclipse/ui/internal/util/ConfigurationElementMemento.java;2;0;6;2;0;0;0;6;41;3;4;75;66;66;3;2;0;6;6;75;2;179;4;2;0
/org.eclipse.ltk.ui.refactoring/src/org/eclipse/ltk/internal/ui/refactoring/ChangeElementContentProvider.java;1;2;4;1;3;2;3;1;23;0;1;269;25;25;2;0;1;1;4;290;1;336;3;1;0
/org.eclipse.jdt.ui/ui/org/eclipse/jdt/internal/ui/dialogs/PackageSelectionDialog.java;3;2;4;1;3;2;3;1;56;0;1;179;60;60;2;0;1;1;4;289;1;336;3;3;0
/org.eclipse.jdt.ui/ui/org/eclipse/jdt/internal/ui/util/StringMatcher.java;1;0;2;1;1;1;1;1;6;0;1;88;8;8;1;0;0;1;2;88;0;336;2;1;0
/org.eclipse.debug.ui/ui/org/eclipse/debug/internal/ui/views/variables/VariablesView.java;6;2;37;4;4;3;4;33;364;10;10;17;931;931;10;23;1;33;37;37;24;304;13;6;1
/org.eclipse.jdt.ui/core refactoring/org/eclipse/jdt/internal/corext/refactoring/code/NameCollector.java;1;0;1;1;1;1;1;0;2;0;0;336;2;2;1;0;0;0;1;336;0;336;1;1;0
/org.eclipse.jface.text/projection/org/eclipse/jface/text/source/projection/AnnotationBag.java;2;0;4;2;2;1;3;1;24;0;1;269;26;26;2;0;2;2;4;269;2;336;2;2;0
/org.eclipse.core.runtime/src/org/eclipse/core/internal/runtime/URLTool.java;2;1;5;2;2;2;2;3;1937;0;1;171;1956;1956;3;2;0;3;5;171;2;336;3;2;0
/org.eclipse.debug.ui/ui/org/eclipse/debug/internal/ui/stringsubstitution/PromptingResolver.java;4;0;6;2;2;1;2;4;11;2;2;123;26;26;2;2;1;4;6;123;3;331;3;4;1
/org.eclipse.core.resources/src/org/eclipse/core/internal/localstore/RefreshLocalAliasVisitor.java;1;0;1;1;1;1;1;0;20;0;0;277;20;20;1;0;0;0;1;277;0;277;1;1;0
/org.eclipse.jdt.core/compiler/org/eclipse/jdt/internal/compiler/ast/DoubleLiteral.java;2;0;2;1;0;0;0;2;4;1;2;170;6;6;1;0;0;2;2;170;0;199;2;2;1
/org.eclipse.osgi/osgi/src/org/osgi/service/permissionadmin/PermissionInfo.java;2;0;2;1;1;1;1;1;3;0;1;171;3;3;1;0;0;1;2;171;0;296;2;2;0
/org.eclipse.jdt.core/model/org/eclipse/jdt/internal/core/util/SimpleSet.java;2;0;2;1;0;0;0;2;2;1;2;82;2;2;1;0;0;2;2;82;0;199;2;2;0
/org.eclipse.jdt.ui/ui/org/eclipse/jdt/internal/ui/text/comment/CommentRange.java;3;0;10;1;1;1;1;9;311;4;6;97;418;418;4;3;0;9;10;119;3;336;7;3;0
/org.eclipse.pde.build/src_ant/org/eclipse/pde/internal/build/tasks/ManifestModifier.java;2;2;4;2;3;2;3;1;127;0;1;230;138;138;2;0;1;1;4;272;1;336;3;2;0
/org.eclipse.jdt.core/model/org/eclipse/jdt/core/util/IInnerClassesAttribute.java;1;0;1;1;0;0;0;1;2;0;1;199;2;2;1;0;0;1;1;199;0;199;1;1;0
/org.eclipse.ui.workbench/Eclipse UI/org/eclipse/ui/dialogs/FilteredList.java;2;0;8;1;1;1;1;7;402;3;5;90;1084;1084;3;2;0;7;8;250;2;293;6;2;0
/org.eclipse.swt/Eclipse SWT/win32/org/eclipse/swt/widgets/ToolBar.java;7;2;19;3;4;3;4;15;125;6;7;8;307;307;6;8;1;15;19;158;9;337;10;7;1
/org.eclipse.jdt.core/model/org/eclipse/jdt/internal/core/util/LocalVariableAttribute.java;1;0;1;1;0;0;0;1;2;0;1;199;2;2;1;0;0;1;1;199;0;199;1;1;0
/org.eclipse.ui.editors/src/org/eclipse/ui/internal/editors/text/TextEditorPreferencePage2.java;3;4;20;2;6;3;6;14;366;4;7;55;1196;1196;4;7;3;14;20;70;10;336;10;3;0
/org.eclipse.jdt.core/codeassist/org/eclipse/jdt/internal/codeassist/complete/CompletionOnQualifiedTypeReference.java;2;0;2;1;0;0;0;2;13;1;2;63;15;15;1;0;0;2;2;63;0;199;2;2;0
/org.eclipse.jdt.core/compiler/org/eclipse/jdt/internal/compiler/ast/AllocationExpression.java;2;0;6;1;0;0;0;6;60;1;6;3;99;99;1;0;0;6;6;3;0;199;6;2;1
/org.eclipse.jdt.ui/ui refactoring/org/eclipse/jdt/internal/ui/refactoring/contentassist/JavaSourcePackageFragmentRootCompletionProcessor.java;4;2;5;2;4;3;4;1;16;0;1;267;34;34;2;0;1;1;5;279;1;336;4;4;0
/org.eclipse.ui.workbench/Eclipse UI/org/eclipse/ui/contexts/IContextManagerListener.java;4;1;9;1;2;2;2;7;20;3;5;70;62;62;3;2;0;7;9;70;2;336;7;4;0
/org.eclipse.debug.ui/ui/org/eclipse/debug/internal/ui/views/memory/MemoryViewLine.java;2;0;2;2;2;1;2;0;6;0;0;282;6;6;2;0;1;0;2;282;1;282;1;2;2
/org.eclipse.jdt.ui/ui/org/eclipse/jdt/internal/ui/javadocexport/JavadocLinkDialogLabelProvider.java;2;1;3;1;2;2;2;1;68;0;1;262;98;98;1;0;0;1;3;262;0;336;3;2;0
/org.eclipse.ui.workbench/Eclipse UI/org/eclipse/ui/internal/commands/MutableCommandManager.java;3;3;8;1;5;3;5;3;3730;0;1;267;3969;3969;3;2;2;3;8;267;4;336;4;3;0
/org.eclipse.swt/Eclipse SWT/gtk/org/eclipse/swt/widgets/Canvas.java;6;1;11;2;2;2;2;9;24;2;8;16;88;88;2;1;0;9;11;93;1;337;10;6;0
/org.eclipse.update.core/src/org/eclipse/update/operations/IOperationFactory.java;1;2;7;1;3;2;3;4;68;1;4;54;153;153;2;0;1;4;7;290;1;336;6;1;0
/org.eclipse.ui.workbench/Eclipse UI/org/eclipse/ui/internal/commands/Persistence.java;4;3;38;2;4;2;4;34;3257;11;9;37;7728;7728;11;25;2;34;38;61;27;336;11;4;1
/org.eclipse.pde.ui/src/org/eclipse/pde/internal/ui/preferences/TargetEnvironmentPreferencePage.java;2;1;6;1;2;2;2;4;37;1;4;99;82;82;1;0;0;4;6;99;0;336;6;2;0
/org.eclipse.jdt.ui/ui refactoring/org/eclipse/jdt/internal/ui/refactoring/ChangeTypeContentProvider.java;2;0;3;1;1;1;1;2;4;1;2;162;6;6;1;0;0;2;3;162;0;336;3;2;1
/org.eclipse.team.core/src/org/eclipse/team/internal/core/subscribers/SubscriberSyncInfoCollector.java;2;1;3;2;3;3;3;0;24;0;0;288;35;35;1;0;0;0;3;288;0;307;3;2;0
/org.eclipse.ui.workbench/Eclipse UI/org/eclipse/ui/activities/ICategoryListener.java;3;1;5;1;2;2;2;3;11;1;3;163;23;23;1;0;0;3;5;163;0;336;5;3;0
/org.eclipse.team.cvs.ui/src/org/eclipse/team/internal/ccvs/ui/CVSFolderPropertiesPage.java;2;1;6;1;2;2;2;4;36;1;4;6;80;80;1;0;0;4;6;6;0;336;6;2;0
/org.eclipse.jface.text/src/org/eclipse/jface/text/DocumentClone.java;1;0;2;1;2;1;2;0;12;0;0;336;12;12;2;0;1;0;2;336;1;336;1;1;0
/org.eclipse.jdt.ui/core extension/org/eclipse/jdt/internal/corext/dom/CodeScopeBuilder.java;1;0;1;1;1;1;1;0;2;0;0;336;2;2;1;0;0;0;1;336;0;336;1;1;0
/org.eclipse.jdt.ui/core refactoring/org/eclipse/jdt/internal/corext/refactoring/rename/TempOccurrenceAnalyzer.java;2;0;2;1;1;1;1;1;2;0;1;252;2;2;1;0;0;1;2;252;0;336;2;2;0
/org.eclipse.jdt.core/compiler/org/eclipse/jdt/internal/compiler/flow/FlowContext.java;3;1;7;1;2;2;2;5;37;1;5;11;79;79;1;0;0;5;7;11;0;312;7;3;0
/org.eclipse.ui.intro/src/org/eclipse/ui/internal/intro/impl/IIntroConstants.java;2;6;12;2;12;3;12;0;41;0;0;276;83;83;6;0;9;0;12;276;9;327;3;2;0
/org.eclipse.team.cvs.ui/src/org/eclipse/team/internal/ccvs/ui/CVSCompareEditorInput.java;2;1;4;1;2;2;2;2;40;1;2;56;75;75;1;0;0;2;4;56;0;336;4;2;0
/org.eclipse.jface.text/src/org/eclipse/jface/text/DocumentCommand.java;3;2;5;2;3;2;3;2;91;1;2;40;165;165;2;0;1;2;5;336;1;336;4;3;0
/org.eclipse.jdt.ui/ui/org/eclipse/jdt/internal/ui/actions/FoldingExpandAllRulerAction.java;2;1;2;1;2;2;2;0;6;0;0;300;6;6;1;0;0;0;2;300;0;336;2;2;0
/org.eclipse.text/src/org/eclipse/jface/text/link/ILinkedModeListener.java;2;2;3;2;3;2;3;0;65;0;0;276;65;65;2;0;1;0;3;334;1;334;2;2;0
/org.eclipse.jdt.core/codeassist/org/eclipse/jdt/internal/codeassist/complete/CompletionOnFieldType.java;2;0;2;1;0;0;0;2;4;1;2;63;6;6;1;0;0;2;2;63;0;199;2;2;0
/org.eclipse.ui.workbench/Eclipse UI/org/eclipse/ui/internal/ObjectActionContributorManager.java;1;0;2;1;0;0;0;2;21;1;2;157;23;23;1;0;0;2;2;157;0;178;2;1;0
/org.eclipse.ui.ide/src/org/eclipse/ui/wizards/datatransfer/WizardExternalProjectImportPage.java;4;1;4;2;2;2;2;2;6;0;1;92;9;9;2;1;0;2;4;92;1;336;3;4;0
/org.eclipse.search/search/org/eclipse/search/internal/core/text/ITextSearchResultCollector.java;2;1;2;1;2;2;2;0;4;0;0;301;6;6;1;0;0;0;2;301;0;336;2;2;0
/org.eclipse.jdt.ui/ui/org/eclipse/jdt/internal/ui/text/correction/ProblemLocation.java;2;0;6;1;1;1;1;5;21;1;5;65;50;50;1;0;0;5;6;65;0;336;6;2;0
/org.eclipse.pde/src/org/eclipse/pde/internal/SiteProject.java;1;0;2;1;1;1;1;1;4;0;1;232;6;6;1;0;0;1;2;232;0;336;2;1;0
/org.eclipse.swt/Eclipse SWT Accessibility/gtk/org/eclipse/swt/accessibility/AccessibleFactory.java;3;1;13;1;2;2;2;11;263;4;6;70;708;708;4;5;0;11;13;70;5;337;8;3;0
/org.eclipse.jdt.core/dom/org/eclipse/jdt/core/dom/InternalASTRewrite.java;2;0;3;2;1;1;1;2;18;0;1;258;33;33;2;1;0;2;3;258;1;274;2;2;0
/org.eclipse.jface/src/org/eclipse/jface/viewers/ViewerDropAdapter.java;2;0;2;1;0;0;0;2;92;1;2;0;100;100;1;0;0;2;2;0;0;14;2;2;1
/org.eclipse.ui.workbench/Eclipse UI/org/eclipse/ui/internal/decorators/DecorationReference.java;2;0;2;1;1;1;1;1;42;0;1;224;44;44;1;0;0;1;2;224;0;336;2;2;0
/org.eclipse.ui.externaltools/External Tools Base/org/eclipse/ui/externaltools/internal/model/IPreferenceConstants.java;2;1;3;1;2;2;2;1;15;0;1;20;32;32;1;0;0;1;3;20;0;336;3;2;0
/org.eclipse.core.runtime/src/org/eclipse/core/internal/jobs/ImplicitJobs.java;3;0;42;3;1;1;12;30;1343;16;6;94;2636;2636;16;24;11;41;42;94;35;330;7;3;1
/org.eclipse.jdt.core/model/org/eclipse/jdt/internal/core/JavaModel.java;2;0;14;2;1;1;1;13;198;3;9;40;306;306;3;4;0;13;14;63;4;279;10;2;0
/org.eclipse.jdt.core/codeassist/org/eclipse/jdt/internal/codeassist/select/SelectionOnSuperReference.java;2;0;2;1;0;0;0;2;10;1;2;63;12;12;1;0;0;2;2;63;0;199;2;2;1
/org.eclipse.jdt.core/eval/org/eclipse/jdt/internal/eval/CodeSnippetSingleNameReference.java;3;0;5;2;0;0;0;5;150;1;5;4;312;312;1;0;0;5;5;4;0;199;5;3;1
/org.eclipse.jface/src/org/eclipse/jface/dialogs/ProgressMonitorDialog.java;4;0;17;3;0;0;7;10;889;9;5;129;1120;1120;9;5;7;17;17;266;12;266;5;4;1
/org.eclipse.swt/Eclipse SWT PI/win32/org/eclipse/swt/internal/ole/win32/OLECMD.java;1;0;1;1;0;0;0;1;1;0;1;166;1;1;1;0;0;1;1;166;0;166;1;1;0
/org.eclipse.jdt.ui/core refactoring/org/eclipse/jdt/internal/corext/refactoring/tagging/IReferenceUpdating.java;2;0;2;1;1;1;1;1;2;0;1;71;2;2;1;0;0;1;2;71;0;336;2;2;0
/org.eclipse.jdt.core/dom/org/eclipse/jdt/core/dom/VariableDeclaration.java;2;0;2;1;0;0;0;2;2;1;2;199;4;4;1;0;0;2;2;199;0;232;2;2;0
/org.eclipse.swt/Eclipse SWT PI/win32/org/eclipse/swt/internal/win32/LOGFONTA.java;1;0;1;1;0;0;0;1;0;0;1;61;0;0;1;0;0;1;1;61;0;61;1;1;0
/org.eclipse.jdt.ui/ui refactoring/org/eclipse/jdt/internal/ui/refactoring/ChangeTypeWizard.java;2;1;11;1;2;2;3;8;48;3;5;162;151;151;3;3;1;9;11;251;4;336;7;2;1
/org.eclipse.jdt.core/model/org/eclipse/jdt/internal/core/JavaElement.java;3;4;26;2;6;3;6;20;219;4;11;7;631;631;4;9;3;20;26;108;12;314;14;3;0
/org.eclipse.osgi/resolver/src/org/eclipse/osgi/internal/resolver/StateHelperImpl.java;3;0;7;2;3;1;4;3;61;2;3;247;78;78;3;0;3;4;7;286;3;286;4;3;0
/org.eclipse.jdt.core/compiler/org/eclipse/jdt/internal/compiler/lookup/ProblemReasons.java;1;0;1;1;0;0;0;1;2;0;1;199;2;2;1;0;0;1;1;199;0;199;1;1;0
/org.eclipse.ui.workbench/Eclipse UI/org/eclipse/ui/internal/contexts/ContextRegistryEvent.java;1;0;6;1;0;0;0;6;21;3;4;84;33;33;3;2;0;6;6;84;2;174;4;1;0
/org.eclipse.text/src/org/eclipse/jface/text/ISlaveDocumentManagerExtension.java;1;0;2;1;1;1;1;1;11;0;1;258;11;11;1;0;0;1;2;258;0;334;2;1;0
/org.eclipse.jdt.debug.ui/ui/org/eclipse/jdt/debug/ui/launchConfigurations/JavaMainTab.java;4;1;11;2;2;2;2;9;235;3;5;74;356;356;3;4;0;9;11;74;4;336;7;4;1
/org.eclipse.team.cvs.ui/src/org/eclipse/team/internal/ccvs/ui/operations/UpdateOnlyMergableOperation.java;2;2;11;2;3;2;3;8;95;3;6;49;195;195;3;2;1;8;11;49;3;336;8;2;0
/org.eclipse.core.runtime/src/org/eclipse/core/internal/registry/ConfigurationElement.java;5;4;18;3;10;4;10;8;908;4;5;173;1040;1040;4;3;6;8;18;173;9;330;9;5;1
/org.eclipse.jdt.core/codeassist/org/eclipse/jdt/internal/codeassist/complete/CompletionNodeFound.java;2;0;2;1;0;0;0;2;8;1;2;170;10;10;1;0;0;2;2;170;0;199;2;2;0
/org.eclipse.jdt.debug.ui/ui/org/eclipse/jdt/internal/debug/ui/classpath/ClasspathGroup.java;3;0;3;1;1;1;1;2;7;1;2;154;11;11;1;0;0;2;3;154;0;336;3;3;0
/org.eclipse.jdt.core/model/org/eclipse/jdt/core/util/IAnnotationDefaultAttribute.java;2;0;2;1;0;0;0;2;30;1;2;247;30;30;1;0;0;2;2;247;0;264;2;2;0
/org.eclipse.jdt.core/search/org/eclipse/jdt/core/search/IJavaSearchScope.java;4;2;7;2;3;2;3;4;24;2;3;182;69;69;2;1;1;4;7;233;2;312;5;4;0
/org.eclipse.update.core/src/org/eclipse/update/core/JarEntryContentReference.java;3;1;5;1;3;3;3;2;6;1;2;0;21;21;1;0;0;2;5;0;0;336;5;3;0
/org.eclipse.ui.workbench.texteditor/src/org/eclipse/ui/texteditor/AnnotationPreference.java;3;2;13;2;4;3;4;9;546;3;5;94;1206;1206;3;4;1;9;13;219;5;336;8;3;0
/org.eclipse.core.expressions/src/org/eclipse/core/expressions/IEvaluationContext.java;1;1;6;1;3;3;3;3;8;2;2;227;22;22;2;1;0;3;6;227;1;334;5;1;0
/org.eclipse.ui.intro/src/org/eclipse/ui/intro/config/IIntroAction.java;2;0;2;2;2;1;2;0;18;0;0;283;18;18;2;0;1;0;2;283;1;283;1;2;0
/org.eclipse.jdt.junit/src/org/eclipse/jdt/internal/junit/ui/EnableStackFilterAction.java;3;1;3;1;2;2;2;1;4;0;1;270;8;8;1;0;0;1;3;270;0;336;3;3;0
/org.eclipse.ui.workbench.texteditor/src/org/eclipse/ui/texteditor/WorkbenchChainedTextFontFieldEditor.java;1;1;2;1;2;2;2;0;2;0;0;301;3;3;1;0;0;0;2;301;0;336;2;1;0
/org.eclipse.jdt.ui/ui/org/eclipse/jdt/internal/ui/javaeditor/JavaSelectAnnotationRulerAction.java;2;1;4;2;2;2;3;1;57;0;1;268;65;65;2;0;1;2;4;268;1;336;3;2;0
/org.eclipse.team.cvs.ui/src/org/eclipse/team/internal/ccvs/ui/subscriber/UpdateDialog.java;2;0;9;2;1;1;1;8;180;2;7;48;376;376;2;1;0;8;9;48;1;336;8;2;0
/org.eclipse.swt/Eclipse SWT/common/org/eclipse/swt/graphics/Rectangle.java;3;1;4;1;2;2;2;2;62;1;2;100;86;86;1;0;0;2;4;100;0;337;4;3;0
/org.eclipse.jdt.ui/core refactoring/org/eclipse/jdt/internal/corext/refactoring/tagging/IQualifiedNameUpdatingRefactoring.java;1;0;1;1;1;1;1;0;2;0;0;336;2;2;1;0;0;0;1;336;0;336;1;1;0
/org.eclipse.jdt.core/compiler/org/eclipse/jdt/internal/compiler/lookup/Scope.java;4;3;25;2;8;4;8;17;571;2;14;1;2145;2145;3;3;4;17;25;324;7;335;18;4;11
/org.eclipse.jdt.junit/src/org/eclipse/jdt/internal/junit/ui/ITestRunListener2.java;2;1;3;1;2;2;2;1;2;0;1;30;6;6;1;0;0;1;3;30;0;336;3;2;0
/org.eclipse.jdt.junit/src/org/eclipse/jdt/internal/junit/wizards/UpdateTestSuite.java;2;1;2;1;2;2;2;0;41;0;0;275;43;43;1;0;0;0;2;275;0;336;2;2;0
/org.eclipse.jdt.core/dom/org/eclipse/jdt/core/dom/BooleanLiteral.java;3;0;6;1;1;1;1;5;65;2;4;199;77;77;2;1;0;5;6;266;1;283;5;3;1
/org.eclipse.swt/Eclipse SWT/common/org/eclipse/swt/internal/image/PngHuffmanTable.java;1;0;1;1;0;0;0;1;2;0;1;127;2;2;1;0;0;1;1;127;0;127;1;1;0
/org.eclipse.jdt.ui/core refactoring/org/eclipse/jdt/internal/corext/refactoring/reorg/JavaDeleteProcessor.java;3;2;23;2;5;4;9;14;164;6;6;101;425;425;6;8;5;18;23;267;13;332;10;3;1
/org.eclipse.jdt.core/codeassist/org/eclipse/jdt/internal/codeassist/complete/InvalidCursorLocation.java;1;0;1;1;0;0;0;1;2;0;1;199;2;2;1;0;0;1;1;199;0;199;1;1;0
/org.eclipse.jdt.core/dom/org/eclipse/jdt/core/dom/QualifiedType.java;4;3;12;1;4;2;4;8;299;3;5;163;359;359;3;3;2;8;12;230;5;336;7;4;2
/org.eclipse.debug.core/core/org/eclipse/debug/internal/core/LaunchConfiguration.java;4;0;17;3;1;1;1;16;121;4;11;32;315;315;4;5;0;16;17;100;5;336;12;4;1
/org.eclipse.pde.ui/src/org/eclipse/pde/internal/ui/wizards/tools/MigratePluginWizard.java;2;4;8;1;6;3;6;2;58;0;1;213;126;126;4;1;3;2;8;326;4;326;4;2;0
/org.eclipse.jdt.core/model/org/eclipse/jdt/internal/core/CreateFieldOperation.java;3;1;6;1;2;2;2;4;19;1;4;27;30;30;1;0;0;4;6;27;0;314;6;3;0
/org.eclipse.jface.text/src/org/eclipse/jface/text/ITextViewerExtension4.java;2;0;3;2;1;1;1;2;42;1;2;75;62;62;1;0;0;2;3;75;0;336;3;2;0
/org.eclipse.team.cvs.ui/src/org/eclipse/team/internal/ccvs/ui/wizards/KSubstWizardSummaryPage.java;1;0;1;1;0;0;0;1;2;0;1;138;2;2;1;0;0;1;1;138;0;138;1;1;0
/org.eclipse.ui.workbench.texteditor/src/org/eclipse/ui/texteditor/AbstractDocumentProvider.java;3;2;13;2;4;3;4;9;203;2;7;76;378;378;2;2;1;9;13;76;3;336;10;3;0
/org.eclipse.jdt.ui/ui/org/eclipse/jdt/internal/ui/wizards/buildpaths/VariableBlock.java;2;1;7;2;2;2;2;5;114;2;4;82;241;241;2;1;0;5;7;82;1;336;6;2;0
/org.eclipse.update.core/src/org/eclipse/update/core/JarContentReference.java;3;1;5;1;3;3;3;2;10;1;2;0;35;35;1;0;0;2;5;0;0;336;5;3;0
/org.eclipse.update.configurator/src/org/eclipse/update/internal/configurator/BootDescriptor.java;1;0;2;1;0;0;0;2;2;1;2;183;2;2;1;0;0;2;2;183;0;227;2;1;0
/org.eclipse.ui.workbench/Eclipse UI/org/eclipse/ui/internal/decorators/LightweightActionDescriptor.java;3;0;5;1;1;1;1;4;39;2;3;157;71;71;2;1;0;4;5;225;1;336;4;3;0
/org.eclipse.update.ui/src/org/eclipse/update/internal/ui/model/ISiteAdapter.java;1;0;1;1;0;0;0;1;7;0;1;58;7;7;1;0;0;1;1;58;0;58;1;1;0
/org.eclipse.jdt.core/compiler/org/eclipse/jdt/internal/compiler/DefaultErrorHandlingPolicies.java;1;0;1;1;0;0;0;1;2;0;1;199;2;2;1;0;0;1;1;199;0;199;1;1;0
/org.eclipse.pde.core/src/org/eclipse/pde/core/plugin/IPluginObject.java;3;2;6;1;4;3;4;2;76;1;2;128;102;102;2;0;1;2;6;276;1;336;5;3;0
/org.eclipse.jdt.core/model/org/eclipse/jdt/internal/core/MovePackageFragmentRootOperation.java;2;0;2;1;0;0;0;2;18;1;2;172;20;20;1;0;0;2;2;172;0;199;2;2;0
/org.eclipse.jdt.ui/core extension/org/eclipse/jdt/internal/corext/callhierarchy/IImplementorFinder.java;2;0;2;1;1;1;1;1;2;0;1;12;2;2;1;0;0;1;2;12;0;336;2;2;0
/org.eclipse.swt/Eclipse SWT Browser/motif/org/eclipse/swt/browser/WindowCreator.java;3;2;8;2;4;3;4;4;264;2;3;162;344;344;2;1;1;4;8;162;2;337;6;3;0
/org.eclipse.ui.workbench/Eclipse UI/org/eclipse/ui/internal/dialogs/ViewSorter.java;1;0;1;1;0;0;0;1;6;0;1;157;6;6;1;0;0;1;1;157;0;157;1;1;0
/org.eclipse.jdt.core/compiler/org/eclipse/jdt/internal/compiler/impl/BooleanConstant.java;4;0;6;2;1;1;1;5;45;3;3;70;67;67;3;2;0;5;6;148;2;299;4;4;0
/org.eclipse.ui.ide/src/org/eclipse/ui/views/markers/internal/TaskView.java;5;1;6;1;2;2;2;4;8;1;4;183;13;13;1;0;0;4;6;183;0;336;6;5;0
/org.eclipse.jdt.debug/model/org/eclipse/jdt/internal/debug/core/logicalstructures/LogicalObjectStructureInterfaceType.java;3;1;5;2;2;2;3;2;14;2;2;155;21;21;2;0;1;3;5;270;1;336;4;3;0
/org.eclipse.text/src/org/eclipse/jface/text/Document.java;1;0;1;1;1;1;1;0;23;0;0;334;23;23;1;0;0;0;1;334;0;334;1;1;0
/org.eclipse.swt/Eclipse SWT/emulated/treetable/org/eclipse/swt/widgets/TableColumn.java;4;1;4;1;2;2;2;2;12;1;2;19;26;26;1;0;0;2;4;19;0;337;4;4;0
/org.eclipse.help.base/src/org/eclipse/help/internal/workingset/WorkingSetManager.java;1;1;11;1;3;3;3;8;239;3;5;104;401;401;3;3;0;8;11;104;3;336;8;1;0
/org.eclipse.search/search/org/eclipse/search/internal/ui/ShowSearchesAction.java;1;0;3;1;1;1;1;2;77;1;2;14;84;84;1;0;0;2;3;14;0;336;3;1;0
/org.eclipse.update.ui/src/org/eclipse/update/internal/ui/RestartDialog.java;1;1;3;1;2;2;2;1;4;0;1;244;8;8;1;0;0;1;3;244;0;336;3;1;1
/org.eclipse.ui.cheatsheets/src/org/eclipse/ui/internal/cheatsheets/registry/CheatSheetCollectionSorter.java;2;0;2;1;0;0;0;2;17;1;2;243;17;17;1;0;0;2;2;243;0;253;2;2;0
/org.eclipse.team.cvs.core/src/org/eclipse/team/internal/ccvs/core/resources/RemoteModule.java;2;0;5;1;1;1;1;4;10;2;3;56;19;19;2;1;0;4;5;118;1;336;4;2;1
/org.eclipse.ui.forms/src/org/eclipse/ui/forms/widgets/TableWrapLayout.java;1;1;7;1;3;3;3;4;368;3;2;225;391;391;3;2;0;4;7;225;2;336;5;1;0
/org.eclipse.jdt.ui/core refactoring/org/eclipse/jdt/internal/corext/refactoring/code/flow/BlockFlowInfo.java;1;0;1;1;1;1;1;0;2;0;0;336;2;2;1;0;0;0;1;336;0;336;1;1;0
/org.eclipse.core.resources/src/org/eclipse/core/resources/IResourceDeltaVisitor.java;1;0;2;1;0;0;1;1;22;0;1;270;22;22;2;0;1;2;2;270;1;270;1;1;0
/org.eclipse.jdt.core/compiler/org/eclipse/jdt/internal/compiler/ast/ConditionalExpression.java;2;0;6;1;0;0;0;6;74;2;5;63;108;108;2;1;0;6;6;71;1;199;5;2;1
/org.eclipse.ui.workbench/Eclipse UI/org/eclipse/ui/internal/EditorSite.java;3;2;7;2;4;3;4;3;34;1;3;157;71;71;2;0;1;3;7;319;1;336;6;3;1
/org.eclipse.jdt.core/compiler/org/eclipse/jdt/internal/compiler/parser/RecoveredElement.java;4;0;8;1;1;1;1;7;63;1;7;34;130;130;1;0;0;7;8;34;0;288;8;4;0
/org.eclipse.jdt.ui/ui refactoring/org/eclipse/jdt/internal/ui/refactoring/IExceptionListChangeListener.java;2;0;2;1;1;1;1;1;2;0;1;148;2;2;1;0;0;1;2;148;0;336;2;2;0
/org.eclipse.jdt.ui/ui/org/eclipse/jdt/internal/ui/javaeditor/selectionactions/StructureSelectionAction.java;3;1;4;1;3;3;3;1;25;0;1;266;34;34;1;0;0;1;4;266;0;336;4;3;0
/org.eclipse.help.base/src/org/eclipse/help/internal/browser/BrowserManager.java;1;1;13;1;3;3;3;10;310;4;5;104;509;509;4;5;0;10;13;250;5;336;8;1;0
/org.eclipse.ui.cheatsheets/src/org/eclipse/ui/cheatsheets/CheatSheetListener.java;2;0;1;2;0;0;0;1;47;0;1;253;47;47;1;0;0;1;1;253;0;253;1;2;0
/org.eclipse.jdt.ui/ui/org/eclipse/jdt/internal/ui/text/template/contentassist/TemplateProposal.java;3;0;16;2;1;1;8;8;273;10;2;234;354;354;10;6;7;15;16;267;13;336;3;3;0
/org.eclipse.team.ui/src/org/eclipse/team/internal/ui/synchronize/IRefreshEvent.java;1;1;5;1;2;2;2;3;69;1;3;211;109;109;1;0;0;3;5;211;0;336;5;1;0
/org.eclipse.jdt.ui/ui/org/eclipse/jdt/ui/text/java/IProblemLocation.java;3;0;6;3;1;1;3;3;40;3;3;76;89;89;3;0;2;5;6;269;2;335;4;3;0
/org.eclipse.team.cvs.ui/src/org/eclipse/team/internal/ccvs/ui/operations/RemoteLogOperation.java;2;4;7;2;6;3;6;1;102;0;1;268;109;109;4;0;3;1;7;302;3;323;4;2;5
/org.eclipse.pde.core/src/org/eclipse/pde/internal/core/plugin/PluginAttribute.java;3;1;7;2;3;3;3;4;14;2;3;188;34;34;2;1;0;4;7;259;1;336;6;3;0
/org.eclipse.swt/Eclipse SWT Drag and Drop/photon/org/eclipse/swt/dnd/ByteArrayTransfer.java;1;1;2;1;2;2;2;0;4;0;0;300;6;6;1;0;0;0;2;300;0;337;2;1;0
/org.eclipse.debug.core/core/org/eclipse/debug/internal/core/LaunchConfigurationType.java;3;1;10;1;3;3;3;7;109;1;7;32;188;188;1;0;0;7;10;32;0;303;10;3;1
/org.eclipse.swt/Eclipse SWT/carbon/org/eclipse/swt/widgets/Caret.java;3;1;6;1;3;3;3;3;50;1;3;19;73;73;1;0;0;3;6;19;0;337;6;3;0
/org.eclipse.jdt.ui/ui/org/eclipse/jdt/internal/ui/wizards/IStatusChangeListener.java;1;0;1;1;1;1;1;0;2;0;0;336;2;2;1;0;0;0;1;336;0;336;1;1;0
/org.eclipse.debug.core/core/org/eclipse/debug/core/IBreakpointManager.java;2;0;2;1;1;1;1;1;42;0;1;233;46;46;1;0;0;1;2;233;0;336;2;2;1
/org.eclipse.jdt.core/model/org/eclipse/jdt/internal/core/PackageDeclaration.java;1;0;7;1;2;1;2;5;15;1;5;59;39;39;2;0;1;5;7;299;1;299;6;1;0
/org.eclipse.jdt.ui/ui/org/eclipse/jdt/internal/ui/search/LevelTreeContentProvider.java;2;2;10;2;5;4;5;5;162;2;3;227;465;465;2;2;1;5;10;239;3;335;7;2;0
/org.eclipse.core.runtime/src/org/eclipse/core/internal/runtime/CipherInputStream.java;3;2;7;2;3;2;3;4;365;3;2;83;382;382;3;2;1;4;7;171;3;336;4;3;0
/org.eclipse.swt/Eclipse SWT/common/org/eclipse/swt/internal/image/PngLzBlockReader.java;1;0;1;1;0;0;0;1;2;0;1;127;2;2;1;0;0;1;1;127;0;127;1;1;0
/org.eclipse.jdt.ui/ui/org/eclipse/jdt/internal/ui/filters/PackageDeclarationFilter.java;1;0;1;1;1;1;1;0;2;0;0;336;2;2;1;0;0;0;1;336;0;336;1;1;0
/org.eclipse.team.cvs.ui/src/org/eclipse/team/internal/ccvs/ui/actions/CompareRemoteResourcesAction.java;2;1;5;1;2;2;2;3;71;2;2;146;117;117;2;1;0;3;5;146;1;336;4;2;0
/org.eclipse.jdt.ui/core refactoring/org/eclipse/jdt/internal/corext/refactoring/code/IntroduceFactoryRefactoring.java;4;5;26;3;9;5;9;17;230;6;6;162;544;544;6;11;4;17;26;244;15;336;11;4;0
/org.eclipse.jface.text/src/org/eclipse/jface/text/IAutoEditStrategy.java;1;0;1;1;1;1;1;0;2;0;0;336;2;2;1;0;0;0;1;336;0;336;1;1;0
/org.eclipse.ui.workbench/Eclipse UI/org/eclipse/ui/internal/EditorHistoryItem.java;1;0;1;1;0;0;0;1;2;0;1;157;2;2;1;0;0;1;1;157;0;157;1;1;0
/org.eclipse.jdt.ui/core extension/org/eclipse/jdt/internal/corext/codemanipulation/AddJavaDocStubOperation.java;3;1;8;1;2;2;2;6;94;1;6;51;176;176;1;0;0;6;8;51;0;336;8;3;0
/org.eclipse.ui.workbench/Eclipse UI/org/eclipse/ui/internal/contexts/ContextManagerFactory.java;3;1;4;1;2;2;2;2;38;0;1;267;45;45;2;1;0;2;4;267;1;336;3;3;0
/org.eclipse.jdt.core/model/org/eclipse/jdt/internal/core/util/SimpleLookupTable.java;2;0;3;1;0;0;0;3;11;1;3;82;19;19;1;0;0;3;3;82;0;238;3;2;0
/org.eclipse.ui.workbench/Eclipse UI/org/eclipse/ui/internal/presentations/DefaultStandalonePresentation.java;1;0;1;1;1;1;1;0;0;0;0;297;0;0;1;0;0;0;1;297;0;297;1;1;0
/org.eclipse.core.resources/src/org/eclipse/core/internal/resources/OS.java;2;1;4;1;2;2;2;2;64;1;2;174;79;79;1;0;0;2;4;174;0;294;4;2;0
/org.eclipse.swt/Eclipse SWT PI/carbon/org/eclipse/swt/internal/carbon/Point.java;1;0;2;1;2;1;2;0;20;0;0;296;20;20;2;0;1;0;2;296;1;296;1;1;0
/org.eclipse.ui.workbench/Eclipse UI/org/eclipse/ui/dialogs/ISelectionValidator.java;1;0;1;1;1;1;1;0;4;0;0;293;4;4;1;0;0;0;1;293;0;293;1;1;0
/org.eclipse.ui.workbench/Eclipse UI/org/eclipse/ui/internal/LayoutTree.java;4;1;5;2;2;2;2;3;26;1;3;223;86;86;1;0;0;3;5;223;0;336;5;4;3
/org.eclipse.team.cvs.ui/src/org/eclipse/team/internal/ccvs/ui/actions/TagLocalAction.java;2;0;5;1;1;1;1;4;11;2;3;63;17;17;2;1;0;4;5;63;1;336;4;2;1
/org.eclipse.team.ui/src/org/eclipse/team/internal/ui/IHelpContextIds.java;2;1;2;1;2;2;2;0;2;0;0;320;4;4;1;0;0;0;2;320;0;336;2;2;0
/org.eclipse.jdt.core/model/org/eclipse/jdt/internal/core/JarPackageFragmentRoot.java;2;0;8;1;1;1;1;7;230;3;5;51;256;256;3;2;0;7;8;51;2;326;6;2;1
/org.eclipse.swt/Eclipse SWT Browser/common/org/eclipse/swt/browser/StatusTextListener.java;2;0;6;1;1;1;1;5;19;2;4;100;45;45;2;1;0;5;6;100;1;337;5;2;0
/org.eclipse.team.cvs.ui/src/org/eclipse/team/internal/ccvs/ui/model/RemoteProjectsElement.java;1;0;1;1;0;0;0;1;5;0;1;63;5;5;1;0;0;1;1;63;0;63;1;1;0
/org.eclipse.jface.text/src/org/eclipse/jface/contentassist/AbstractControlContentAssistSubjectAdapter.java;1;3;6;1;6;3;6;0;84;0;0;279;172;172;3;0;3;0;6;279;3;332;3;1;0
/org.eclipse.osgi/core/framework/org/eclipse/osgi/framework/internal/core/OSGi.java;5;1;7;2;2;2;3;4;181;2;3;171;207;207;2;1;1;5;7;171;2;336;5;5;0
/org.eclipse.jdt.debug.ui/ui/org/eclipse/jdt/internal/debug/ui/sourcelookup/WorkbenchAdapterFactory.java;1;0;1;1;0;0;0;1;0;0;1;252;0;0;1;0;0;1;1;252;0;252;1;1;0
/org.eclipse.debug.ui/ui/org/eclipse/debug/internal/ui/sourcelookup/browsers/WorkspaceSourceContainerBrowser.java;1;0;5;1;0;0;0;5;16;3;3;209;21;21;3;2;0;5;5;266;2;266;3;1;0
/org.eclipse.swt/Eclipse SWT Mozilla/common/org/eclipse/swt/internal/mozilla/nsIDOMMouseEvent.java;2;1;2;1;2;2;2;0;2;0;0;283;2;2;1;0;0;0;2;283;0;336;2;2;0
/org.eclipse.jdt.core/dom/org/eclipse/jdt/core/dom/Name.java;3;0;7;2;1;1;1;6;44;3;4;164;94;94;3;2;0;6;7;199;2;280;5;3;0
/org.eclipse.jdt.ui/ui/org/eclipse/jdt/internal/ui/text/java/IJavaReconcilingListener.java;1;0;3;1;1;1;1;2;13;0;1;253;20;20;2;1;0;2;3;253;1;290;2;1;0
/org.eclipse.core.runtime/src/org/eclipse/core/internal/preferences/InstancePreferences.java;1;2;13;1;4;3;4;9;139;7;2;239;347;347;7;7;1;9;13;239;8;312;5;1;3
/org.eclipse.jdt.ui/core refactoring/org/eclipse/jdt/internal/corext/refactoring/code/flow/SwitchFlowInfo.java;1;0;1;1;1;1;1;0;2;0;0;336;2;2;1;0;0;0;1;336;0;336;1;1;0
/org.eclipse.team.cvs.ui/src/org/eclipse/team/internal/ccvs/ui/merge/TagElement.java;2;1;3;1;2;2;2;1;18;0;1;254;37;37;1;0;0;1;3;254;0;336;3;2;0
/org.eclipse.ui.ide/src/org/eclipse/ui/internal/ide/misc/CheckboxTreeAndListGroup.java;4;1;3;2;2;2;2;1;28;0;1;132;34;34;1;0;0;1;3;132;0;336;3;4;0
/org.eclipse.jdt.ui/ui/org/eclipse/jdt/ui/wizards/IClasspathContainerPage.java;1;0;1;1;1;1;1;0;2;0;0;336;2;2;1;0;0;0;1;336;0;336;1;1;0
/org.eclipse.team.core/src/org/eclipse/team/internal/core/subscribers/SubscriberSyncInfoSet.java;2;0;2;1;0;0;0;2;80;1;2;222;80;80;1;0;0;2;2;222;0;232;2;2;0
/org.eclipse.swt/Eclipse SWT PI/motif/org/eclipse/swt/internal/motif/XtWidgetGeometry.java;1;0;1;1;0;0;0;1;7;0;1;54;7;7;1;0;0;1;1;54;0;54;1;1;0
/org.eclipse.ui.cheatsheets/src/org/eclipse/ui/internal/cheatsheets/data/CheatSheetParser.java;1;7;10;1;10;4;10;0;554;0;0;279;637;637;7;0;6;0;10;299;6;315;4;1;0
/org.eclipse.jdt.core/compiler/org/eclipse/jdt/internal/compiler/ast/NullLiteral.java;2;0;2;1;0;0;0;2;4;1;2;170;6;6;1;0;0;2;2;170;0;199;2;2;0
/org.eclipse.jdt.core/search/org/eclipse/jdt/core/search/PackageDeclarationMatch.java;2;0;7;2;3;1;3;4;31;2;2;218;59;59;3;2;2;4;7;275;4;275;3;2;0
/org.eclipse.jdt.debug.ui/ui/org/eclipse/jdt/internal/debug/ui/snippeteditor/JavaSnippetCompletionProcessor.java;5;1;8;2;2;2;2;6;32;3;3;72;58;58;3;3;0;6;8;235;3;336;5;5;0
/org.eclipse.jdt.ui/ui/org/eclipse/jdt/internal/ui/javaeditor/RemoveOccurrenceAnnotations.java;1;0;2;1;1;1;1;1;4;0;1;149;4;4;1;0;0;1;2;149;0;336;2;1;0
/org.eclipse.ui.workbench/Eclipse UI/org/eclipse/ui/internal/EditorStack.java;4;4;7;3;7;2;7;0;126;0;0;297;210;210;4;0;5;0;7;297;5;324;2;4;1
/org.eclipse.jdt.ui/ui/org/eclipse/jdt/internal/ui/search/TextSearchTableContentProvider.java;2;0;2;1;1;1;1;1;1;0;1;268;1;1;1;0;0;1;2;268;0;290;2;2;0
/org.eclipse.update.configurator/src/org/eclipse/update/internal/configurator/FeatureParser.java;2;0;9;2;2;1;3;6;27;2;4;184;100;100;2;2;2;7;9;184;4;296;5;2;0
/org.eclipse.team.core/src/org/eclipse/team/internal/core/Policy.java;2;1;5;1;2;2;2;3;8;1;3;52;16;16;1;0;0;3;5;52;0;336;5;2;0
/org.eclipse.core.resources/src/org/eclipse/core/internal/watson/ElementTreeDelta.java;1;0;1;1;1;1;1;0;245;0;0;277;245;245;1;0;0;0;1;277;0;277;1;1;0
/org.eclipse.swt/Eclipse SWT/common/org/eclipse/swt/internal/image/TIFFFileFormat.java;1;0;1;1;0;0;0;1;0;0;1;26;0;0;1;0;0;1;1;26;0;26;1;1;0
/org.eclipse.jface.text/src/org/eclipse/jface/text/IFindReplaceTarget.java;2;2;3;2;3;2;3;0;37;0;0;283;51;51;2;0;1;0;3;336;1;336;2;2;0
/org.eclipse.core.resources/src/org/eclipse/core/internal/indexing/Insertable.java;1;0;1;1;1;1;1;0;4;0;0;277;4;4;1;0;0;0;1;277;0;277;1;1;0
/org.eclipse.ui.intro/src/org/eclipse/ui/internal/intro/impl/parts/StandbyPart.java;4;6;11;3;11;2;11;0;370;0;0;276;435;435;6;0;9;0;11;307;9;307;2;4;0
/org.eclipse.osgi/osgi/src/org/osgi/framework/BundleActivator.java;2;0;2;1;1;1;1;1;3;0;1;171;3;3;1;0;0;1;2;171;0;296;2;2;0
/org.eclipse.jdt.ui/core extension/org/eclipse/jdt/internal/corext/javadoc/JavaDocLocations.java;3;2;7;1;3;2;3;4;125;1;4;80;263;263;2;0;1;4;7;313;1;336;6;3;0
/org.eclipse.debug.ui/ui/org/eclipse/debug/internal/ui/views/breakpoints/BreakpointsSorter.java;2;0;2;1;1;1;1;1;15;0;1;262;19;19;1;0;0;1;2;262;0;336;2;2;0
/org.eclipse.update.core/src/org/eclipse/update/internal/core/InstallLogParser.java;1;2;10;1;3;2;3;7;127;5;2;241;165;165;5;5;1;7;10;241;6;336;4;1;2
/org.eclipse.jdt.core/model/org/eclipse/jdt/internal/core/util/MementoTokenizer.java;1;0;1;1;1;1;1;0;0;0;0;279;0;0;1;0;0;0;1;279;0;279;1;1;0
/org.eclipse.osgi/core/framework/org/eclipse/osgi/framework/internal/core/ExportedPackageImpl.java;6;2;10;3;3;2;5;5;18;3;3;171;54;54;3;2;3;7;10;171;5;336;5;6;0
/org.eclipse.debug.ui/ui/org/eclipse/debug/ui/actions/ToggleWatchpointActionDelegate.java;1;0;2;1;1;1;1;1;3;0;1;246;3;3;1;0;0;1;2;246;0;276;2;1;0
/org.eclipse.pde.core/src/org/eclipse/pde/internal/core/WorkspaceModelManager.java;3;4;27;2;10;4;10;17;1283;4;8;26;1661;1661;4;9;6;17;27;162;15;333;12;3;0
/org.eclipse.jdt.core/model/org/eclipse/jdt/internal/core/SimpleDelta.java;1;0;2;1;0;0;0;2;2;1;2;131;2;2;1;0;0;2;2;131;0;199;2;1;0
/org.eclipse.swt/Eclipse SWT Drag and Drop/motif/org/eclipse/swt/dnd/TextTransfer.java;1;0;1;1;0;0;0;1;91;0;1;24;91;91;1;0;0;1;1;24;0;24;1;1;0
/org.eclipse.jdt.ui/ui/org/eclipse/jdt/ui/actions/ConvertLocalToFieldAction.java;3;0;8;1;1;1;1;7;53;3;5;3;88;88;3;2;0;7;8;3;2;336;6;3;0
/org.eclipse.jdt.ui/ui/org/eclipse/jdt/internal/ui/text/java/ExperimentalProposal.java;3;4;12;2;5;2;5;7;47;4;3;172;111;111;4;4;3;7;12;172;7;336;5;3;0
/org.eclipse.jdt.ui/ui/org/eclipse/jdt/internal/ui/text/javadoc/JavaDocCompletionEvaluator.java;3;1;8;1;2;2;2;6;47;1;6;41;81;81;1;0;0;6;8;41;0;336;8;3;1
/org.eclipse.osgi/eclipseAdaptor/src/org/eclipse/core/runtime/adaptor/CachedManifest.java;5;5;17;3;7;3;7;10;37;5;5;171;105;105;5;5;4;10;17;251;9;326;8;5;0
/org.eclipse.jdt.ui/ui/org/eclipse/jdt/internal/ui/infoviews/InfoViewMessages.java;1;0;2;1;1;1;1;1;2;0;1;86;2;2;1;0;0;1;2;86;0;336;2;1;0
/org.eclipse.update.core/src/org/eclipse/update/internal/operations/ReplaceFeatureVersionOperation.java;1;0;7;1;1;1;1;6;6;2;5;76;16;16;2;1;0;6;7;232;1;336;6;1;0
/org.eclipse.jdt.debug/eval/org/eclipse/jdt/internal/debug/eval/ast/instructions/Instruction.java;2;0;3;1;0;0;0;3;13;1;3;76;27;27;1;0;0;3;3;76;0;144;3;2;0
/org.eclipse.jdt.ui/ui/org/eclipse/jdt/internal/ui/text/TypingRun.java;2;1;2;1;2;2;2;0;8;0;0;281;8;8;1;0;0;0;2;281;0;336;2;2;0
/org.eclipse.swt/Eclipse SWT/motif/org/eclipse/swt/widgets/Combo.java;5;2;14;2;4;3;4;10;67;2;8;8;252;252;2;2;1;10;14;120;3;337;11;5;0
/org.eclipse.team.core/src/org/eclipse/team/core/variants/ThreeWaySynchronizer.java;1;1;4;1;2;2;2;2;6;1;2;239;12;12;1;0;0;2;4;239;0;325;4;1;0
/org.eclipse.core.resources/src/org/eclipse/core/internal/resources/WorkspaceDescription.java;2;0;2;1;1;1;1;1;25;0;1;90;40;40;1;0;0;1;2;90;0;277;2;2;1
/org.eclipse.debug.core/core/org/eclipse/debug/internal/core/memory/IMemoryBlockListener.java;1;0;1;1;1;1;1;0;0;0;0;282;0;0;1;0;0;0;1;282;0;282;1;1;1
/org.eclipse.ui.workbench/Eclipse UI/org/eclipse/ui/internal/activities/ActivityPatternBindingDefinition.java;3;0;8;1;1;1;1;7;124;3;4;141;148;148;3;3;0;7;8;165;3;336;5;3;0
/org.eclipse.jdt.debug/jdi interfaces/com/sun/jdi/request/DuplicateRequestException.java;2;0;2;2;0;0;0;2;8;0;1;79;8;8;2;1;0;2;2;79;1;79;1;2;0
/org.eclipse.core.resources/src/org/eclipse/core/internal/resources/InternalTeamHook.java;2;0;2;2;0;0;1;1;4;0;1;270;4;4;2;0;1;2;2;270;1;270;1;2;0
/org.eclipse.jdt.core/model/org/eclipse/jdt/internal/core/jdom/DOMCompilationUnit.java;2;0;8;1;1;1;1;7;10;1;7;7;45;45;1;0;0;7;8;7;0;299;8;2;0
/org.eclipse.jdt.core/model/org/eclipse/jdt/core/IBufferFactory.java;1;0;3;1;0;0;0;3;2;1;3;149;4;4;1;0;0;3;3;149;0;199;3;1;0
/org.eclipse.pde/src_ant/org/eclipse/pde/ant/ConvertSchemaToHTML.java;2;0;11;2;3;1;3;8;75;2;5;62;248;248;3;3;2;8;11;325;5;325;6;2;0
/org.eclipse.jdt.ui/ui refactoring/org/eclipse/jdt/internal/ui/refactoring/CreateTextFileChangePreviewViewer.java;5;1;10;2;2;2;4;6;66;4;5;65;143;143;4;1;2;8;10;269;3;336;7;5;0
/org.eclipse.ui.editors/src/org/eclipse/ui/editors/text/TextEditorPreferencePage.java;1;1;2;1;2;2;2;0;11;0;0;301;13;13;1;0;0;0;2;301;0;336;2;1;0
/org.eclipse.ui.ide/src/org/eclipse/ui/views/markers/internal/ActionMarkCompleted.java;3;1;3;1;2;2;2;1;2;0;1;129;3;3;1;0;0;1;3;129;0;336;3;3;0
/org.eclipse.swt/Eclipse SWT/common/org/eclipse/swt/events/KeyEvent.java;1;0;1;1;0;0;0;1;26;0;1;156;26;26;1;0;0;1;1;156;0;156;1;1;0
/org.eclipse.ui.ide/src/org/eclipse/ui/internal/ide/IDEWorkbenchPlugin.java;8;2;22;2;6;4;6;16;261;6;7;91;689;689;6;9;2;16;22;100;11;336;11;8;3
/org.eclipse.jdt.ui/ui/org/eclipse/jdt/internal/ui/javadocexport/JavadocExportMessages.java;1;0;1;1;1;1;1;0;2;0;0;336;2;2;1;0;0;0;1;336;0;336;1;1;0
/org.eclipse.team.ui/src/org/eclipse/team/internal/ui/synchronize/actions/OpenWithActionGroup.java;2;1;9;2;2;2;2;7;101;3;4;148;223;223;3;3;0;7;9;244;3;336;6;2;0
/org.eclipse.jdt.launching/launching/org/eclipse/jdt/internal/launching/Standard11xVMType.java;3;0;5;2;1;1;1;4;4;2;3;46;16;16;2;1;0;4;5;46;1;336;4;3;0
/org.eclipse.ant.ui/Ant Tools Support/org/eclipse/ant/internal/ui/launchConfigurations/ContributedClasspathEntriesEntry.java;2;0;7;2;1;1;1;6;106;5;2;238;130;130;5;4;0;6;7;238;4;312;3;2;0
/org.eclipse.pde.ui/src/org/eclipse/pde/internal/ui/IPreferenceConstants.java;2;1;7;1;3;3;3;4;18;1;4;70;55;55;1;0;0;4;7;70;0;336;7;2;0
/org.eclipse.jdt.core/compiler/org/eclipse/jdt/internal/compiler/env/IGenericField.java;1;0;1;1;0;0;0;1;2;0;1;199;2;2;1;0;0;1;1;199;0;199;1;1;0
/org.eclipse.swt/Eclipse SWT PI/win32/org/eclipse/swt/internal/ole/win32/FUNCDESC1.java;1;0;1;1;0;0;0;1;8;0;1;166;8;8;1;0;0;1;1;166;0;166;1;1;0
/org.eclipse.compare/compare/org/eclipse/compare/internal/patch/PreviewPatchPage.java;1;0;7;1;1;1;1;6;52;2;4;79;80;80;2;2;0;6;7;193;2;314;5;1;0
/org.eclipse.osgi/eclipseAdaptor/src/org/eclipse/core/runtime/adaptor/LocationManager.java;2;2;14;2;6;4;6;8;99;5;2;227;348;348;5;6;2;8;14;227;8;326;6;2;2
/org.eclipse.jdt.ui/core refactoring/org/eclipse/jdt/internal/corext/refactoring/rename/RenamePackageProcessor.java;4;5;30;3;10;4;10;20;346;7;9;71;755;755;7;11;6;20;30;247;17;336;13;4;1
/org.eclipse.update.core/src/org/eclipse/update/core/Utilities.java;3;1;10;2;3;3;3;7;76;3;3;58;143;143;3;4;0;7;10;175;4;336;6;3;0
/org.eclipse.jdt.core/dom/org/eclipse/jdt/core/dom/rewrite/ITrackedNodePosition.java;3;0;4;3;0;0;0;4;26;0;1;258;26;26;4;3;0;4;4;258;3;258;1;3;0
/org.eclipse.jdt.core/model/org/eclipse/jdt/internal/core/builder/ReferenceCollection.java;2;0;3;1;0;0;0;3;54;2;2;156;56;56;2;1;0;3;3;156;1;199;2;2;0
/org.eclipse.debug.ui/ui/org/eclipse/debug/ui/actions/IRunToLineTarget.java;1;0;3;1;2;1;2;1;8;0;1;246;8;8;2;0;1;1;3;276;1;276;2;1;0
/org.eclipse.jdt.launching/launching/org/eclipse/jdt/internal/launching/AbstractRuntimeClasspathEntry.java;2;0;5;1;1;1;1;4;22;2;3;211;43;43;2;1;0;4;5;268;1;301;4;2;0
/org.eclipse.jface.text/src/org/eclipse/jface/text/TextAttribute.java;2;0;2;2;2;1;2;0;9;0;0;336;9;9;2;0;1;0;2;336;1;336;1;2;0
/org.eclipse.swt/Eclipse SWT Mozilla/common/org/eclipse/swt/internal/mozilla/nsIPromptService.java;1;0;2;1;0;0;0;2;30;1;2;100;30;30;1;0;0;2;2;100;0;148;2;1;0
/org.eclipse.ui.ide/src/org/eclipse/ui/views/markers/internal/ActionOpenMarker.java;4;0;5;1;1;1;1;4;58;1;4;129;68;68;1;0;0;4;5;129;0;336;5;4;0
/org.eclipse.pde.runtime/src/org/eclipse/pde/internal/runtime/logview/LogView.java;3;5;45;2;9;2;12;33;2068;12;8;53;5826;5826;12;25;10;36;45;53;35;322;10;3;1
/org.eclipse.text/src/org/eclipse/text/edits/CopyingRangeMarker.java;2;0;4;1;1;1;1;3;16;2;2;118;31;31;2;1;0;3;4;118;1;336;3;2;0
/org.eclipse.pde.ui/src/org/eclipse/pde/internal/ui/editor/feature/IncludeFeaturesWizardPage.java;3;1;5;1;3;3;3;2;31;1;2;130;67;67;1;0;0;2;5;130;0;336;5;3;0
/org.eclipse.ui.workbench/Eclipse UI/org/eclipse/ui/internal/registry/WizardsRegistryReader.java;3;0;4;1;1;1;1;3;54;1;3;157;67;67;1;0;0;3;4;157;0;336;4;3;1
/org.eclipse.jdt.ui/core refactoring/org/eclipse/jdt/internal/corext/refactoring/typeconstraints/TypeConstraintFactory.java;1;0;1;1;0;0;0;1;0;0;1;217;0;0;1;0;0;1;1;217;0;217;1;1;0
/org.eclipse.jdt.ui/ui/org/eclipse/jdt/internal/ui/text/correction/ModifierCorrectionSubProcessor.java;2;2;22;1;5;3;5;17;106;5;9;16;617;617;5;8;2;17;22;61;10;336;12;2;1
/org.eclipse.jdt.core/compiler/org/eclipse/jdt/internal/compiler/IProblemFactory.java;1;0;1;1;0;0;0;1;2;0;1;199;2;2;1;0;0;1;1;199;0;199;1;1;0
/org.eclipse.ui.editors/src/org/eclipse/ui/editors/text/TextEditor.java;3;2;19;2;4;3;4;15;706;5;7;46;1418;1418;5;8;1;15;19;70;9;334;10;3;0
/org.eclipse.jdt.core/compiler/org/eclipse/jdt/internal/compiler/ASTVisitor.java;3;0;5;2;2;1;2;3;12;2;2;170;20;20;2;1;1;3;5;197;2;300;3;3;0
/org.eclipse.jdt.core/model/org/eclipse/jdt/internal/core/MoveElementsOperation.java;1;0;2;1;0;0;0;2;2;1;2;180;3;3;1;0;0;2;2;180;0;199;2;1;0
/org.eclipse.swt/Eclipse SWT Custom Widgets/common/org/eclipse/swt/custom/CTabFolder2Listener.java;2;2;4;2;3;2;3;1;83;0;1;233;93;93;2;0;1;1;4;336;1;336;3;2;0
/org.eclipse.pde.ui/src/org/eclipse/pde/internal/ui/wizards/feature/PluginListPage.java;2;1;5;1;3;3;3;2;30;1;2;213;46;46;1;0;0;2;5;213;0;336;5;2;0
/org.eclipse.ui.ide/src/org/eclipse/ui/views/navigator/FiltersContentProvider.java;2;0;2;1;0;0;0;2;4;1;2;129;4;4;1;0;0;2;2;129;0;160;2;2;0
/org.eclipse.core.runtime.compatibility/src-boot/org/eclipse/core/internal/boot/PlatformConfiguration.java;2;1;2;1;2;2;2;0;2;0;0;282;2;2;1;0;0;0;2;282;0;336;2;2;0
/org.eclipse.swt.tools/JNI Generation/org/eclipse/swt/tools/internal/ItemData.java;1;0;1;1;0;0;0;1;0;0;1;230;0;0;1;0;0;1;1;230;0;230;1;1;0
/org.eclipse.swt/Eclipse SWT/common/org/eclipse/swt/layout/GridData.java;2;0;3;1;1;1;1;2;25;1;2;131;37;37;1;0;0;2;3;131;0;337;3;2;0
/org.eclipse.compare/compare/org/eclipse/compare/structuremergeviewer/DiffElement.java;1;0;1;1;0;0;0;1;2;0;1;219;2;2;1;0;0;1;1;219;0;219;1;1;0
/org.eclipse.ui.workbench/Eclipse UI/org/eclipse/ui/internal/PluginActionBuilder.java;3;1;3;1;2;2;2;1;25;0;1;252;29;29;1;0;0;1;3;252;0;336;3;3;0
/org.eclipse.jface.text/src/org/eclipse/jface/text/rules/MultiLineRule.java;1;0;1;1;1;1;1;0;2;0;0;336;2;2;1;0;0;0;1;336;0;336;1;1;0
/org.eclipse.swt/Eclipse SWT/gtk/org/eclipse/swt/widgets/Caret.java;4;1;5;1;2;2;2;3;17;1;3;19;40;40;1;0;0;3;5;19;0;337;5;4;0
/org.eclipse.ui.presentations.r21/src/org/eclipse/ui/internal/presentations/R21PresentationFactory.java;1;0;1;1;1;1;1;0;0;0;0;323;0;0;1;0;0;0;1;323;0;323;1;1;0
/org.eclipse.team.cvs.core/src/org/eclipse/team/internal/ccvs/core/client/AbstractMessageCommand.java;1;0;1;1;0;0;0;1;2;0;1;110;2;2;1;0;0;1;1;110;0;110;1;1;0
/org.eclipse.swt/Eclipse SWT Custom Widgets/common/org/eclipse/swt/custom/ControlEditor.java;1;0;1;1;0;0;0;1;6;0;1;56;6;6;1;0;0;1;1;56;0;56;1;1;0
/org.eclipse.ui.workbench.texteditor/src/org/eclipse/ui/internal/texteditor/quickdiff/compare/rangedifferencer/ITokenComparator.java;1;1;3;1;2;2;2;1;2;0;1;100;3;3;1;0;0;1;3;100;0;336;3;1;0
/org.eclipse.jdt.ui/ui/org/eclipse/jdt/internal/ui/browsing/PackagesView.java;2;1;5;2;2;2;2;3;6;2;2;82;13;13;2;1;0;3;5;263;1;336;4;2;0
/org.eclipse.ui.ide/src/org/eclipse/ui/wizards/datatransfer/FileSystemExportOperation.java;1;0;2;1;0;0;0;2;20;1;2;92;20;20;1;0;0;2;2;92;0;121;2;1;0
/org.eclipse.ant.core/src_ant/org/eclipse/ant/internal/core/ant/InternalAntRunner.java;2;2;27;2;5;4;5;22;166;7;9;11;961;961;7;13;1;22;27;11;14;336;13;2;3
/org.eclipse.team.cvs.ui/src/org/eclipse/team/internal/ccvs/ui/operations/RepositoryLocationOperation.java;2;0;2;1;1;1;1;1;5;0;1;268;5;5;1;0;0;1;2;268;0;294;2;2;0
/org.eclipse.swt/Eclipse SWT PI/win32/org/eclipse/swt/internal/win32/NONCLIENTMETRICS.java;2;0;2;1;0;0;0;2;16;1;2;61;17;17;1;0;0;2;2;61;0;166;2;2;0
/org.eclipse.pde.core/src/org/eclipse/pde/internal/core/isite/ISiteObject.java;2;1;3;1;2;2;2;1;6;0;1;232;12;12;1;0;0;1;3;232;0;336;3;2;0
/org.eclipse.pde.ui/src_Forms/org/eclipse/pde/internal/ui/model/plugin/PluginModelBase.java;3;3;14;3;7;3;8;6;61;4;2;244;160;160;4;4;5;7;14;264;9;336;5;3;0
/org.eclipse.jface.text/src/org/eclipse/jface/text/rules/RuleBasedPartitionScanner.java;1;0;1;1;1;1;1;0;2;0;0;336;2;2;1;0;0;0;1;336;0;336;1;1;0
/org.eclipse.team.cvs.ui/src/org/eclipse/team/internal/ccvs/ui/actions/TagInRepositoryAction.java;2;0;5;1;1;1;1;4;118;2;3;47;151;151;2;1;0;4;5;63;1;336;4;2;0
/org.eclipse.core.resources/src/org/eclipse/core/resources/IPathVariableChangeListener.java;1;0;2;1;0;0;1;1;8;0;1;270;8;8;2;0;1;2;2;270;1;270;1;1;0
/org.eclipse.jdt.ui/ui/org/eclipse/jdt/internal/ui/compare/JavaHistoryAction.java;6;3;15;3;4;2;4;11;143;3;7;79;361;361;3;4;2;11;15;262;6;336;9;6;2
/org.eclipse.swt/Eclipse SWT/photon/org/eclipse/swt/graphics/Color.java;1;1;2;1;2;2;2;0;4;0;0;300;8;8;1;0;0;0;2;300;0;337;2;1;1
/org.eclipse.swt/Eclipse SWT PI/win32/org/eclipse/swt/internal/ole/win32/CONTROLINFO.java;1;0;1;1;0;0;0;1;4;0;1;166;4;4;1;0;0;1;1;166;0;166;1;1;0
/org.eclipse.jdt.ui/ui/org/eclipse/jdt/ui/jarpackager/IJarDescriptionReader.java;1;0;1;1;1;1;1;0;2;0;0;336;2;2;1;0;0;0;1;336;0;336;1;1;0
/org.eclipse.osgi/resolver/src/org/eclipse/osgi/internal/resolver/VersionConstraintImpl.java;3;3;7;1;5;3;5;2;108;1;2;171;149;149;3;0;2;2;7;290;2;336;5;3;0
/org.eclipse.team.ui/src/org/eclipse/team/ui/synchronize/AbstractSynchronizeScope.java;2;1;2;1;2;2;2;0;158;0;0;299;172;172;1;0;0;0;2;299;0;326;2;2;0
/org.eclipse.pde.ui/src/org/eclipse/pde/internal/ui/editor/build/RuntimeInfoSection.java;3;7;20;3;10;4;10;10;3283;4;7;104;4652;4652;7;3;6;10;20;292;9;336;11;3;0
/org.eclipse.jdt.ui/ui/org/eclipse/jdt/internal/ui/search/SearchParticipantDescriptor.java;1;0;1;1;1;1;1;0;0;0;0;299;0;0;1;0;0;0;1;299;0;299;1;1;0
/org.eclipse.pde.ui/src/org/eclipse/pde/internal/ui/editor/LinkSection.java;2;1;2;1;2;2;2;0;4;0;0;292;4;4;1;0;0;0;2;292;0;308;2;2;0
/org.eclipse.swt/Eclipse SWT AWT/gtk/org/eclipse/swt/awt/SWT_AWT.java;5;2;13;2;8;4;8;5;66;1;5;171;196;196;2;0;4;5;13;279;4;334;9;5;3
/org.eclipse.swt/Eclipse SWT/win32/org/eclipse/swt/widgets/Menu.java;6;4;20;3;7;3;7;13;151;5;6;2;360;360;5;7;4;13;20;224;11;336;9;6;1
/org.eclipse.jdt.ui/ui/org/eclipse/jdt/internal/ui/typehierarchy/HistoryListAction.java;3;0;4;2;1;1;1;3;5;2;2;82;9;9;2;1;0;3;4;82;1;336;3;3;0
/org.eclipse.debug.ui/ui/org/eclipse/debug/internal/ui/stringsubstitution/StringVariableSelectionDialog.java;4;2;8;2;3;2;3;5;150;2;4;124;337;337;2;1;1;5;8;124;2;302;6;4;0
/org.eclipse.text/src/org/eclipse/jface/text/TypedRegion.java;1;0;1;1;1;1;1;0;19;0;0;334;19;19;1;0;0;0;1;334;0;334;1;1;0
/org.eclipse.core.resources/src/org/eclipse/core/internal/indexing/Index.java;1;0;1;1;1;1;1;0;33;0;0;277;33;33;1;0;0;0;1;277;0;277;1;1;0
/org.eclipse.debug.ui/ui/org/eclipse/debug/internal/ui/views/memory/AbstractMemoryAction.java;1;0;1;1;1;1;1;0;0;0;0;282;0;0;1;0;0;0;1;282;0;282;1;1;1
/org.eclipse.text/projection/org/eclipse/jface/text/projection/SegmentUpdater.java;1;2;4;1;3;2;3;1;14;0;1;247;16;16;2;0;1;1;4;332;1;332;3;1;0
/org.eclipse.team.cvs.ui/src/org/eclipse/team/internal/ccvs/ui/model/RemoteFileElement.java;1;0;1;1;0;0;0;1;2;0;1;63;2;2;1;0;0;1;1;63;0;63;1;1;0
/org.eclipse.ui.ide/src/org/eclipse/ui/views/markers/internal/ActionSelectAll.java;4;1;4;1;2;2;2;2;17;1;2;129;20;20;1;0;0;2;4;129;0;336;4;4;0
/org.eclipse.ui.ide/src/org/eclipse/ui/views/bookmarkexplorer/PasteBookmarkAction.java;1;0;1;1;0;0;0;1;0;0;1;129;0;0;1;0;0;1;1;129;0;129;1;1;0
/org.eclipse.jdt.ui/ui refactoring/org/eclipse/jdt/internal/ui/refactoring/contentassist/ControlContentAssistHelper.java;3;0;6;3;2;1;2;4;299;3;2;204;422;422;3;2;1;4;6;204;3;279;3;3;0
/org.eclipse.swt/Eclipse SWT/common_j2se/org/eclipse/swt/internal/Compatibility.java;4;1;4;2;2;2;2;2;18;0;1;225;39;39;2;1;0;2;4;225;1;337;3;4;0
/org.eclipse.ltk.core.refactoring/src/org/eclipse/ltk/core/refactoring/Change.java;1;4;10;1;7;4;7;3;30;0;1;264;51;51;4;2;3;3;10;278;5;336;5;1;0
/org.eclipse.osgi/core/adaptor/org/eclipse/osgi/framework/util/SecurePermissionStorage.java;2;1;2;1;2;2;2;0;4;0;0;276;6;6;1;0;0;0;2;276;0;336;2;2;0
/org.eclipse.help.base/src/org/eclipse/help/internal/search/AnalyzerDescriptor.java;1;1;6;1;3;3;3;3;74;2;2;104;142;142;2;1;0;3;6;104;1;336;5;1;1
/org.eclipse.pde.ui/src/org/eclipse/pde/internal/ui/editor/plugin/PluginExportAction.java;2;1;4;1;4;4;4;0;30;0;0;292;53;53;1;0;0;0;4;292;0;336;4;2;0
/org.eclipse.update.core/src/org/eclipse/update/operations/IInstallFeatureOperation.java;1;1;6;1;2;2;2;4;18;1;4;54;31;31;1;0;0;4;6;54;0;336;6;1;0
/org.eclipse.ant.ui/Ant Tools Support/org/eclipse/ant/internal/ui/views/AntViewLabelProvider.java;1;0;4;1;1;1;1;3;4;2;2;108;7;7;2;1;0;3;4;108;1;336;3;1;1
/org.eclipse.debug.ui/ui/org/eclipse/debug/internal/ui/views/console/ConsoleRemoveAllTerminatedAction.java;3;0;3;1;1;1;1;2;73;1;2;86;90;90;1;0;0;2;3;86;0;336;3;3;1
/org.eclipse.help.ui/src/org/eclipse/help/ui/internal/browser/SystemBrowserFactory.java;1;1;3;1;2;2;2;1;16;0;1;251;36;36;1;0;0;1;3;251;0;336;3;1;0
/org.eclipse.update.core/src/org/eclipse/update/internal/core/FeatureExecutableContentProvider.java;3;1;4;1;2;2;2;2;40;1;2;58;89;89;1;0;0;2;4;58;0;336;4;3;0
/org.eclipse.jdt.core/dom/org/eclipse/jdt/core/dom/VariableBinding.java;3;0;7;2;1;1;2;5;125;3;3;156;250;250;3;2;1;6;7;156;3;301;4;3;2
/org.eclipse.jdt.core/model/org/eclipse/jdt/internal/core/util/ILRUCacheable.java;1;0;1;1;0;0;0;1;2;0;1;199;2;2;1;0;0;1;1;199;0;199;1;1;0
/org.eclipse.ui.ide/src/org/eclipse/ui/views/markers/internal/FieldSeverity.java;4;0;4;2;1;1;1;3;41;1;3;129;82;82;1;0;0;3;4;129;0;336;4;4;0
/org.eclipse.jdt.ui/ui/org/eclipse/jdt/internal/ui/browsing/JavaBrowsingContentProvider.java;3;1;7;2;2;2;2;5;61;1;5;17;140;140;1;0;0;5;7;17;0;336;7;3;1
/org.eclipse.jface.text/src/org/eclipse/jface/text/templates/TemplateCompletionProcessor.java;3;3;7;2;5;2;5;2;29;0;1;253;44;44;3;1;3;2;7;274;4;336;3;3;0
/org.eclipse.jdt.ui/ui/org/eclipse/jdt/internal/ui/JavaUIStatus.java;2;0;2;1;1;1;1;1;8;0;1;256;10;10;1;0;0;1;2;256;0;336;2;2;0
/org.eclipse.jdt.ui/ui/org/eclipse/jdt/ui/actions/AddGetterSetterAction.java;4;2;27;2;5;4;6;21;1479;6;10;26;2580;2580;6;11;2;22;27;26;13;336;14;4;0
/org.eclipse.pde.ui/src/org/eclipse/pde/internal/ui/wizards/templates/PopupMenuNewWizard.java;3;2;5;1;4;3;4;1;12;0;1;222;27;27;2;0;1;1;5;308;1;336;4;3;0
/org.eclipse.text/src/org/eclipse/jface/text/IDocumentInformationMappingExtension.java;2;2;4;2;3;2;3;1;47;0;1;247;55;55;2;0;1;1;4;275;1;334;3;2;0
/org.eclipse.jface.text/src/org/eclipse/jface/text/IUndoManager.java;2;0;2;2;2;1;2;0;22;0;0;336;22;22;2;0;1;0;2;336;1;336;1;2;0
/org.eclipse.debug.core/core/org/eclipse/debug/core/ILaunchConfigurationWorkingCopy.java;1;0;1;1;0;0;0;1;13;0;1;184;13;13;1;0;0;1;1;184;0;184;1;1;0
/org.eclipse.ui.workbench/Eclipse UI/org/eclipse/ui/internal/contexts/ws/WorkbenchContextSupport.java;5;4;25;3;10;3;10;15;568;7;3;174;1631;1631;7;12;7;15;25;224;19;325;6;5;2
/org.eclipse.jdt.ui/ui/org/eclipse/jdt/ui/actions/FormatAllAction.java;3;4;6;3;6;3;6;0;53;0;0;300;55;55;4;0;3;0;6;325;3;325;3;3;1
/org.eclipse.swt/Eclipse SWT/common/org/eclipse/swt/internal/image/WinBMPFileFormat.java;2;1;2;1;2;2;2;0;4;0;0;302;8;8;1;0;0;0;2;302;0;337;2;2;0
/org.eclipse.swt/Eclipse SWT/gtk/org/eclipse/swt/widgets/Scrollable.java;6;1;11;2;2;2;2;9;28;3;7;19;80;80;3;2;0;9;11;111;2;337;9;6;0
/org.eclipse.debug.ui/ui/org/eclipse/debug/internal/ui/views/launch/LaunchView.java;4;0;54;3;18;1;22;32;672;9;11;32;1805;1805;18;21;21;36;54;288;42;288;12;4;5
/org.eclipse.pde.ui/src/org/eclipse/pde/internal/ui/wizards/extension/PointSelectionPage.java;3;4;14;2;7;3;7;7;412;3;5;26;1030;1030;4;2;4;7;14;326;6;326;8;3;0
/org.eclipse.osgi/eclipseAdaptor/src/org/eclipse/core/runtime/adaptor/BundleLocalizationImpl.java;2;1;3;1;3;3;3;0;193;0;0;276;196;196;1;0;0;0;3;276;0;326;3;2;0
/org.eclipse.ui.workbench/Eclipse UI/org/eclipse/ui/internal/progress/ProgressContentProvider.java;3;1;24;2;2;2;2;22;1047;12;6;23;1749;1749;12;16;0;22;24;60;16;336;8;3;1
/org.eclipse.text/projection/org/eclipse/jface/text/projection/ProjectionTextStore.java;1;1;3;1;2;2;2;1;9;0;1;247;11;11;1;0;0;1;3;247;0;334;3;1;0
/org.eclipse.pde.core/src/org/eclipse/pde/internal/core/ExternalModelManager.java;3;3;14;2;5;3;5;9;217;3;6;124;336;336;3;3;2;9;14;124;5;336;9;3;0
/org.eclipse.pde.core/src/org/eclipse/pde/internal/core/bundle/WorkspaceBundleModel.java;3;2;6;2;4;3;4;2;21;0;1;128;29;29;2;1;1;2;6;128;2;336;4;3;0
/org.eclipse.jface.text/src/org/eclipse/jface/text/DefaultAutoIndentStrategy.java;2;0;2;2;2;1;2;0;11;0;0;336;11;11;2;0;1;0;2;336;1;336;1;2;0
/org.eclipse.ui.editors/src/org/eclipse/ui/texteditor/DocumentProviderRegistry.java;3;1;7;1;3;3;3;4;301;2;3;118;364;364;2;1;0;4;7;202;1;336;6;3;0
/org.eclipse.jdt.ui/ui/org/eclipse/jdt/ui/JavaElementImageDescriptor.java;2;1;3;2;2;2;2;1;73;0;1;226;136;136;1;0;0;1;3;226;0;336;3;2;0
/org.eclipse.team.cvs.ui/src/org/eclipse/team/internal/ccvs/ui/model/RepositoryLocationSchedulingRule.java;1;0;1;1;0;0;0;1;0;0;1;118;0;0;1;0;0;1;1;118;0;118;1;1;0
/org.eclipse.pde.ui/src/org/eclipse/pde/internal/ui/wizards/NewWizard.java;3;1;4;1;3;3;3;1;77;0;1;248;111;111;1;0;0;1;4;248;0;336;4;3;0
/org.eclipse.jface/src/org/eclipse/jface/action/IContributionManager.java;2;1;2;1;2;2;2;0;4;0;0;292;6;6;1;0;0;0;2;292;0;336;2;2;0
/org.eclipse.jdt.launching.macosx/macosx/org/eclipse/jdt/internal/ui/macbundler/BundleBuilder.java;1;0;2;1;0;0;0;2;15;1;2;203;15;15;1;0;0;2;2;203;0;228;2;1;0
/org.eclipse.ui.workbench.texteditor/src/org/eclipse/ui/internal/texteditor/quickdiff/compare/rangedifferencer/RangeDifference.java;2;1;5;1;2;2;2;3;67;1;3;100;97;97;1;0;0;3;5;100;0;336;5;2;0
/org.eclipse.ant.core/src/org/eclipse/ant/internal/core/AntObject.java;1;1;7;1;2;2;2;5;34;2;3;85;99;99;2;2;0;5;7;170;2;336;5;1;0
/org.eclipse.compare/compare/org/eclipse/compare/internal/StructureCreatorDescriptor.java;1;0;1;1;1;1;1;0;0;0;0;278;0;0;1;0;0;0;1;278;0;278;1;1;0
/org.eclipse.ui.workbench/Eclipse UI/org/eclipse/ui/part/PluginTransfer.java;1;0;1;1;0;0;0;1;6;0;1;0;6;6;1;0;0;1;1;0;0;0;1;1;0
/org.eclipse.ant.ui/Ant Editor/org/eclipse/ant/internal/ui/editor/outline/AntEditorMarkerUpdater.java;1;2;10;1;7;4;7;3;86;2;2;251;207;207;2;1;3;3;10;262;4;330;6;1;2
/org.eclipse.jface/src/org/eclipse/jface/operation/ModalContext.java;2;1;3;1;2;2;2;1;2;0;1;0;5;5;1;0;0;1;3;0;0;336;3;2;1
/org.eclipse.core.resources/src/org/eclipse/core/resources/IContainer.java;3;1;11;2;2;2;5;6;830;4;5;114;977;977;4;1;3;9;11;270;4;336;7;3;1
/org.eclipse.ui.workbench/Eclipse UI/org/eclipse/ui/internal/WorkbenchColors.java;4;0;7;2;1;1;1;6;521;3;2;223;756;756;3;4;0;6;7;223;4;336;3;4;0
/org.eclipse.team.core/src/org/eclipse/team/internal/core/PessimisticResourceRuleFactory.java;1;0;1;1;1;1;1;0;0;0;0;275;0;0;1;0;0;0;1;275;0;275;1;1;0
/org.eclipse.ui.ide/extensions/org/eclipse/ui/actions/CopyProjectAction.java;4;0;5;2;1;1;2;3;32;2;3;132;36;36;2;0;1;4;5;269;1;336;4;4;0
/org.eclipse.swt/Eclipse SWT PI/win32/org/eclipse/swt/internal/win32/NMCUSTOMDRAW.java;1;0;1;1;0;0;0;1;3;0;1;166;3;3;1;0;0;1;1;166;0;166;1;1;0
/org.eclipse.ui.workbench.texteditor/src/org/eclipse/ui/internal/texteditor/quickdiff/compare/rangedifferencer/DifferencesIterator.java;1;1;3;1;2;2;2;1;2;0;1;100;4;4;1;0;0;1;3;100;0;336;3;1;0
/org.eclipse.ui.workbench.texteditor/src/org/eclipse/ui/contentassist/ContentAssistHandler.java;3;2;4;2;4;3;4;0;50;0;0;279;58;58;2;0;1;0;4;279;1;336;3;3;0
/org.eclipse.help/src/org/eclipse/help/internal/toc/TocBuilder.java;1;1;5;1;3;3;3;2;37;1;2;156;65;65;1;0;0;2;5;156;0;336;5;1;0
/org.eclipse.swt/Eclipse SWT PI/carbon/org/eclipse/swt/internal/carbon/Rect.java;1;0;2;1;2;1;2;0;20;0;0;296;20;20;2;0;1;0;2;296;1;296;1;1;0
/org.eclipse.ant.ui/Ant Editor/org/eclipse/ant/internal/ui/editor/formatter/XmlDocumentFormattingStrategy.java;1;2;7;1;4;2;4;3;124;1;3;218;225;225;2;0;2;3;7;275;2;306;5;1;0
/org.eclipse.core.resources/src/org/eclipse/core/internal/resources/MarkerReader_2.java;2;0;2;1;1;1;1;1;205;0;1;104;207;207;1;0;0;1;2;104;0;277;2;2;0
/org.eclipse.ui.workbench/Eclipse UI/org/eclipse/ui/internal/util/Util.java;4;1;21;2;3;3;3;18;788;7;8;75;1513;1513;7;10;0;18;21;75;10;336;11;4;0
/org.eclipse.update.ui/src/org/eclipse/update/internal/ui/wizards/SearchRunner.java;3;0;10;3;1;1;1;9;85;3;5;15;126;126;3;4;0;9;10;50;4;325;6;3;0
/org.eclipse.jdt.core/compiler/org/eclipse/jdt/internal/compiler/env/ISourceMethod.java;1;0;1;1;0;0;0;1;2;0;1;199;2;2;1;0;0;1;1;199;0;199;1;1;0
/org.eclipse.jface/src/org/eclipse/jface/action/Separator.java;3;0;3;3;0;0;0;3;26;0;1;181;26;26;3;2;0;3;3;181;2;181;1;3;0
/org.eclipse.jdt.core/search/org/eclipse/jdt/internal/core/search/indexing/BinaryIndexer.java;4;1;11;2;2;2;2;9;1005;2;8;19;1247;1247;2;1;0;9;11;109;1;300;10;4;0
/org.eclipse.jdt.core/model/org/eclipse/jdt/core/IProblemRequestor.java;1;0;1;1;0;0;0;1;2;0;1;199;2;2;1;0;0;1;1;199;0;199;1;1;0
/org.eclipse.jdt.ui/ui/org/eclipse/jdt/internal/ui/javaeditor/ICompilationUnitDocumentProvider.java;2;0;3;1;1;1;1;2;20;0;1;96;23;23;2;1;0;2;3;96;1;336;2;2;0
/org.eclipse.osgi/core/adaptor/org/eclipse/osgi/framework/adaptor/PermissionStorage.java;4;1;4;1;2;2;2;2;77;1;2;171;83;83;1;0;0;2;4;171;0;336;4;4;0
/org.eclipse.osgi/defaultAdaptor/src/org/eclipse/osgi/framework/internal/reliablefile/ReliableFile.java;5;0;7;3;1;1;3;4;940;3;4;171;1429;1429;3;0;2;6;7;270;2;295;5;5;0
/org.eclipse.ui.workbench.texteditor/src/org/eclipse/ui/texteditor/ITextEditorExtension2.java;3;0;2;2;1;1;1;1;11;0;1;211;13;13;1;0;0;1;2;211;0;336;2;3;0
/org.eclipse.jface.text/src/org/eclipse/jface/contentassist/SubjectControlContentAssistant.java;1;1;2;1;2;2;2;0;5;0;0;280;5;5;1;0;0;0;2;280;0;336;2;1;0
/org.eclipse.swt/Eclipse SWT Mozilla/common/org/eclipse/swt/internal/mozilla/nsIDOMWindow.java;1;0;2;1;0;0;0;2;26;1;2;100;26;26;1;0;0;2;2;100;0;148;2;1;0
/org.eclipse.swt/Eclipse SWT/gtk/org/eclipse/swt/widgets/Control.java;7;0;76;6;0;0;21;55;583;22;12;0;1878;1878;22;43;21;76;76;266;64;266;12;7;6
/org.eclipse.jdt.launching/launching/org/eclipse/jdt/launching/SocketUtil.java;2;0;5;2;0;0;0;5;48;2;3;9;107;107;2;2;0;5;5;83;2;115;3;2;0
/org.eclipse.help.base/src/org/eclipse/help/internal/browser/MozillaBrowserAdapter.java;1;1;6;1;3;3;3;3;65;2;2;104;130;130;2;1;0;3;6;104;1;336;5;1;0
/org.eclipse.jdt.core/dom/org/eclipse/jdt/core/dom/BodyDeclaration.java;3;3;13;2;4;2;4;9;182;3;5;164;304;304;3;4;2;9;13;242;6;308;7;3;1
/org.eclipse.jdt.junit/src/org/eclipse/jdt/internal/junit/launcher/JUnitTabGroup.java;2;1;4;1;2;2;2;2;5;1;2;157;13;13;1;0;0;2;4;157;0;336;4;2;0
/org.eclipse.update.core/src/org/eclipse/update/search/BackLevelFilter.java;2;1;6;2;2;2;2;4;7;2;3;54;15;15;2;1;0;4;6;54;1;336;5;2;0
/org.eclipse.team.ui/src/org/eclipse/team/internal/ui/preferences/IgnorePreferencePage.java;1;0;3;1;1;1;1;2;194;1;2;63;213;213;1;0;0;2;3;63;0;336;3;1;0
/org.eclipse.swt/Eclipse SWT PI/gtk/org/eclipse/swt/internal/gtk/XAnyEvent.java;3;1;2;2;2;2;2;0;4;0;0;293;6;6;1;0;0;0;2;293;0;337;2;3;0
/org.eclipse.pde.build/src/org/eclipse/pde/internal/build/packager/PackagingConfigScriptGenerator.java;2;2;11;2;6;4;6;5;151;2;3;31;277;277;2;2;2;5;11;31;4;332;7;2;0
/org.eclipse.ui.workbench.texteditor/src/org/eclipse/ui/texteditor/FindReplaceDialog.java;3;4;24;2;11;4;11;13;620;5;8;63;1101;1101;5;5;7;13;24;125;12;336;12;3;0
/org.eclipse.pde.core/src/org/eclipse/pde/internal/core/SourceLocationManager.java;2;1;13;2;3;3;3;10;355;2;7;43;473;473;2;3;0;10;13;70;3;336;10;2;0
/org.eclipse.jdt.ui/ui refactoring/org/eclipse/jdt/internal/ui/refactoring/code/InlineMethodWizard.java;2;0;4;1;1;1;2;2;6;2;2;66;13;13;2;0;1;3;4;269;1;336;3;2;0
/org.eclipse.text/src/org/eclipse/jface/text/IPositionUpdater.java;1;0;1;1;1;1;1;0;25;0;0;334;25;25;1;0;0;0;1;334;0;334;1;1;0
/org.eclipse.swt/Eclipse SWT/common/org/eclipse/swt/widgets/Tray.java;2;0;3;1;1;1;1;2;16;0;1;247;21;21;2;1;0;2;3;247;1;337;2;2;0
/org.eclipse.ui.workbench/Eclipse UI/org/eclipse/ui/internal/CycleEditorAction.java;1;0;1;1;0;0;0;1;16;0;1;157;16;16;1;0;0;1;1;157;0;157;1;1;0
/org.eclipse.pde.ui/src/org/eclipse/pde/ui/templates/NewPluginTemplateWizard.java;2;2;5;1;4;3;4;1;76;0;1;222;86;86;2;0;1;1;5;276;1;336;4;2;0
/org.eclipse.jdt.debug.ui/ui/org/eclipse/jdt/internal/debug/ui/classpath/ClasspathContentProvider.java;3;0;5;1;1;1;1;4;17;2;3;154;32;32;2;1;0;4;5;232;1;336;4;3;0
/org.eclipse.jdt.ui/ui/org/eclipse/jdt/ui/actions/FindReferencesInHierarchyAction.java;2;0;3;1;1;1;1;2;13;1;2;184;20;20;1;0;0;2;3;184;0;336;3;2;0
/org.eclipse.jdt.ui/ui/org/eclipse/jdt/internal/ui/wizards/dialogfields/IDialogFieldListener.java;1;0;1;1;1;1;1;0;2;0;0;336;2;2;1;0;0;0;1;336;0;336;1;1;0
/org.eclipse.jdt.ui/ui/org/eclipse/jdt/internal/ui/wizards/SuperInterfaceSelectionDialog.java;2;0;2;1;1;1;1;1;10;0;1;129;12;12;1;0;0;1;2;129;0;336;2;2;0
/org.eclipse.ui.ide/src/org/eclipse/ui/internal/ide/dialogs/ConfigurationLogUpdateSection.java;1;1;2;1;2;2;2;0;2;0;0;294;2;2;1;0;0;0;2;294;0;336;2;1;0
/org.eclipse.pde.ui/src/org/eclipse/pde/internal/ui/editor/feature/NewFeatureRequireWizardPage.java;3;1;4;2;3;3;3;1;15;0;1;232;38;38;1;0;0;1;4;232;0;336;4;3;0
/org.eclipse.ltk.ui.refactoring/src/org/eclipse/ltk/internal/ui/refactoring/AbstractDescriptor.java;1;0;3;1;1;1;2;1;11;0;1;269;19;19;2;0;1;2;3;269;1;336;2;1;0
/org.eclipse.pde.core/src/org/eclipse/pde/internal/core/feature/FeatureInstallHandler.java;2;1;3;1;2;2;2;1;16;0;1;232;30;30;1;0;0;1;3;232;0;336;3;2;0
/org.eclipse.debug.ui/ui/org/eclipse/debug/internal/ui/launchConfigurations/PerspectivesTab.java;4;1;10;2;2;2;2;8;176;2;5;42;225;225;2;3;0;8;10;71;3;336;7;4;1
/org.eclipse.ui.workbench/Eclipse UI/org/eclipse/ui/internal/ActionSetContributionItem.java;2;0;2;1;1;1;1;1;54;0;1;194;56;56;1;0;0;1;2;194;0;336;2;2;0
/org.eclipse.ui.ide/src/org/eclipse/ui/views/markers/internal/FieldMessage.java;4;1;4;2;2;2;2;2;37;1;2;129;76;76;1;0;0;2;4;129;0;336;4;4;0
/org.eclipse.jdt.ui/ui/org/eclipse/jdt/internal/ui/preferences/CodeTemplateBlock.java;4;4;22;2;7;4;7;15;219;4;10;27;443;443;4;5;3;15;22;234;8;336;14;4;0
/org.eclipse.team.cvs.core/src/org/eclipse/team/internal/ccvs/core/ICVSFile.java;1;0;2;1;0;0;0;2;30;1;2;132;34;34;1;0;0;2;2;132;0;177;2;1;0
/org.eclipse.debug.ui/ui/org/eclipse/debug/internal/ui/launchConfigurations/LaunchConfigurationView.java;3;0;5;1;1;1;1;4;33;1;4;33;62;62;1;0;0;4;5;33;0;336;5;3;0
/org.eclipse.jdt.ui/ui/org/eclipse/jdt/ui/wizards/NewContainerWizardPage.java;3;1;4;2;2;2;2;2;23;1;2;82;40;40;1;0;0;2;4;82;0;336;4;3;0
/org.eclipse.help.webapp/src_servlets/org/eclipse/help/internal/webapp/data/Topic.java;1;1;2;1;2;2;2;0;23;0;0;311;39;39;1;0;0;0;2;311;0;336;2;1;0
/org.eclipse.jdt.ui/ui/org/eclipse/jdt/internal/ui/javaeditor/ToggleMarkOccurrencesAction.java;1;0;2;1;2;1;2;0;6;0;0;286;6;6;2;0;1;0;2;286;1;286;1;1;0
/org.eclipse.core.runtime/src/org/eclipse/core/runtime/IAdapterManager.java;3;0;8;2;2;1;2;6;448;3;3;171;703;703;3;3;1;6;8;171;4;274;4;3;0
/org.eclipse.help.base/src/org/eclipse/help/internal/base/HelpApplication.java;2;3;12;1;7;3;7;5;83;2;4;105;205;205;3;1;4;5;12;294;5;336;7;2;0
/org.eclipse.ui.ide/extensions/org/eclipse/ui/dialogs/WizardNewLinkPage.java;1;0;1;1;0;0;0;1;0;0;1;132;0;0;1;0;0;1;1;132;0;132;1;1;0
/org.eclipse.jdt.core/model/org/eclipse/jdt/internal/core/SingleTypeRequestor.java;2;0;2;1;0;0;0;2;4;1;2;113;6;6;1;0;0;2;2;113;0;199;2;2;0
/org.eclipse.jdt.core/dom/org/eclipse/jdt/core/dom/ASTNode.java;5;0;23;2;2;1;6;17;1262;7;7;148;1875;1875;7;10;5;21;23;266;15;312;8;5;2
/org.eclipse.team.core/src/org/eclipse/team/core/variants/AbstractResourceVariantTree.java;2;2;5;1;4;3;4;1;31;0;1;239;54;54;2;0;1;1;5;321;1;336;4;2;0
/org.eclipse.ui.intro/src/org/eclipse/ui/internal/intro/impl/parts/EmptyStandbyContentPart.java;1;0;4;1;4;1;4;0;10;0;0;307;10;10;4;0;3;0;4;307;3;307;1;1;0
/org.eclipse.debug.ui/ui/org/eclipse/debug/internal/ui/actions/ProfileLastAction.java;1;0;1;1;0;0;0;1;0;0;1;33;0;0;1;0;0;1;1;33;0;33;1;1;0
/org.eclipse.osgi/resolver/src/org/eclipse/core/internal/dependencies/ElementSet.java;3;2;4;2;3;2;3;1;128;0;1;171;177;177;2;0;1;1;4;276;1;296;3;3;0
/org.eclipse.jdt.ui/ui/org/eclipse/jdt/ui/actions/SelfEncapsulateFieldAction.java;4;0;7;2;1;1;1;6;65;2;5;9;139;139;2;1;0;6;7;91;1;336;6;4;0
/org.eclipse.core.resources/src/org/eclipse/core/internal/resources/TestingSupport.java;2;0;6;1;1;1;1;5;66;2;4;17;90;90;2;1;0;5;6;90;1;277;5;2;0
/org.eclipse.swt/Eclipse SWT/win32/org/eclipse/swt/graphics/Font.java;2;1;3;1;2;2;2;1;4;0;1;61;7;7;1;0;0;1;3;61;0;337;3;2;2
/org.eclipse.search/search/org/eclipse/search/internal/ui/text/TextSearchPage.java;2;2;23;1;5;4;5;18;160;5;12;9;837;837;5;6;1;18;23;93;7;336;16;2;0
/org.eclipse.swt/Eclipse SWT Mozilla/common/org/eclipse/swt/internal/mozilla/nsIComponentRegistrar.java;1;0;2;1;0;0;0;2;30;1;2;100;30;30;1;0;0;2;2;100;0;148;2;1;0
/org.eclipse.ui.workbench.texteditor/src/org/eclipse/ui/texteditor/templates/TemplateContentProvider.java;3;1;3;1;2;2;2;1;2;0;1;253;4;4;1;0;0;1;3;253;0;336;3;3;0
/org.eclipse.jdt.core/model/org/eclipse/jdt/internal/core/DiscardWorkingCopyOperation.java;1;0;8;1;0;0;0;8;32;4;4;54;79;79;4;4;0;8;8;127;4;199;4;1;0
/org.eclipse.help.webapp/src_servlets/org/eclipse/help/internal/webapp/servlet/ControlServlet.java;1;1;5;1;3;3;3;2;49;1;2;156;112;112;1;0;0;2;5;156;0;336;5;1;1
/org.eclipse.jdt.core/model/org/eclipse/jdt/internal/core/SourceMethod.java;4;2;14;2;5;3;5;9;33;1;9;7;169;169;2;0;2;9;14;272;2;330;12;4;1
/org.eclipse.ui.editors/src/org/eclipse/ui/editors/text/ILocationProvider.java;2;1;5;2;2;2;2;3;26;2;2;130;49;49;2;1;0;3;5;140;1;336;4;2;0
/org.eclipse.jface.text/src/org/eclipse/jface/text/MarkSelection.java;2;0;2;2;2;1;2;0;5;0;0;336;5;5;2;0;1;0;2;336;1;336;1;2;0
/org.eclipse.ui.editors/src/org/eclipse/ui/texteditor/IMarkerUpdater.java;2;1;4;1;2;2;2;2;59;1;2;118;70;70;1;0;0;2;4;118;0;336;4;2;0
/org.eclipse.jdt.debug.ui/ui/org/eclipse/jdt/internal/debug/ui/classpath/VariableClasspathEntryWorkbenchAdapter.java;1;0;1;1;0;0;0;1;0;0;1;269;0;0;1;0;0;1;1;269;0;269;1;1;0
/org.eclipse.swt/Eclipse SWT/common/org/eclipse/swt/events/SelectionEvent.java;3;0;3;1;0;0;0;3;20;1;3;0;40;40;1;0;0;3;3;0;0;180;3;3;0
/org.eclipse.team.cvs.ui/src/org/eclipse/team/internal/ccvs/ui/KeyboardInteractiveDialog.java;2;0;4;2;1;1;1;3;7;2;2;211;16;16;2;1;0;3;4;211;1;320;3;2;0
/org.eclipse.jdt.core/model/org/eclipse/jdt/core/IPackageFragment.java;3;0;9;2;0;0;0;9;39;2;7;25;88;88;2;2;0;9;9;62;2;266;7;3;0
/org.eclipse.ui.workbench.texteditor/src/org/eclipse/ui/texteditor/templates/StatusInfo.java;2;2;4;2;3;2;3;1;27;0;1;253;29;29;2;0;1;1;4;275;1;336;3;2;0
/org.eclipse.jdt.debug.ui/ui/org/eclipse/jdt/internal/debug/ui/snippeteditor/NewSnippetFileWizardPage.java;1;0;1;1;0;0;0;1;0;0;1;264;0;0;1;0;0;1;1;264;0;264;1;1;0
/org.eclipse.pde.ui/src/org/eclipse/pde/internal/ui/wizards/extension/NewSchemaFileMainPage.java;2;2;5;1;5;4;5;0;58;0;0;273;69;69;2;0;1;0;5;281;1;336;4;2;0
/org.eclipse.jdt.ui/core refactoring/org/eclipse/jdt/internal/corext/refactoring/RefactoringCoreMessages.java;1;0;1;1;1;1;1;0;2;0;0;336;2;2;1;0;0;0;1;336;0;336;1;1;1
/org.eclipse.core.runtime/src/org/eclipse/core/internal/runtime/PlatformURLFragmentConnection.java;4;3;9;2;4;2;4;5;266;3;3;171;284;284;3;2;2;5;9;171;4;336;5;4;0
/org.eclipse.core.resources/src/org/eclipse/core/internal/resources/MarkerWriter.java;2;0;2;1;1;1;1;1;352;0;1;151;356;356;1;0;0;1;2;151;0;277;2;2;0
/org.eclipse.ui.workbench/Eclipse UI/org/eclipse/ui/keys/Key.java;3;1;14;2;2;2;2;12;131;5;5;79;340;340;5;7;0;12;14;79;7;336;7;3;0
/org.eclipse.jdt.ui/ui refactoring/org/eclipse/jdt/internal/ui/refactoring/nls/search/LineReader.java;1;0;1;1;0;0;0;1;18;0;1;268;18;18;1;0;0;1;1;268;0;268;1;1;0
/org.eclipse.ui.workbench.texteditor/src/org/eclipse/ui/texteditor/DeleteLineAction.java;2;1;4;2;2;2;2;2;18;0;1;124;30;30;2;1;0;2;4;124;1;336;3;2;0
/org.eclipse.jface/src/org/eclipse/jface/preference/PreferenceDialog.java;4;4;23;3;8;4;8;15;1046;5;6;0;2283;2283;5;9;4;15;23;177;13;329;10;4;2
/org.eclipse.core.resources/src/org/eclipse/core/internal/events/LifecycleEvent.java;1;0;1;1;1;1;1;0;15;0;0;277;15;15;1;0;0;0;1;277;0;277;1;1;0
/org.eclipse.ltk.ui.refactoring/src/org/eclipse/ltk/internal/ui/refactoring/DescriptorManager.java;1;1;4;1;2;2;3;1;14;0;1;269;26;26;2;0;1;2;4;269;1;336;3;1;0
/org.eclipse.swt/Eclipse SWT PI/win32/org/eclipse/swt/internal/win32/PAINTSTRUCT.java;1;0;1;1;0;0;0;1;5;0;1;61;5;5;1;0;0;1;1;61;0;61;1;1;0
/org.eclipse.compare/compare/org/eclipse/compare/rangedifferencer/DifferencesIterator.java;1;0;1;1;0;0;0;1;2;0;1;219;2;2;1;0;0;1;1;219;0;219;1;1;0
/org.eclipse.jface.text/src/org/eclipse/jface/text/rules/RuleBasedDamagerRepairer.java;1;0;1;1;1;1;1;0;2;0;0;336;2;2;1;0;0;0;1;336;0;336;1;1;0
/org.eclipse.jdt.ui/ui/org/eclipse/jdt/ui/actions/OpenProjectAction.java;3;1;4;2;2;2;2;2;22;1;2;41;38;38;1;0;0;2;4;41;0;336;4;3;0
/org.eclipse.ui.workbench/Eclipse UI/org/eclipse/ui/internal/activities/ProxyActivityManager.java;4;1;13;2;2;2;2;11;120;10;2;160;131;131;10;9;0;11;13;160;9;336;4;4;0
/org.eclipse.core.resources/src/org/eclipse/core/internal/events/BuilderPersistentInfo.java;1;0;1;1;1;1;1;0;59;0;0;277;59;59;1;0;0;0;1;277;0;277;1;1;0
/org.eclipse.help.webapp/src_servlets/org/eclipse/help/internal/webapp/servlet/ContentServlet.java;1;1;3;1;3;3;3;0;26;0;0;299;34;34;1;0;0;0;3;299;0;336;3;1;0
/org.eclipse.ui.workbench/Eclipse UI/org/eclipse/ui/internal/themes/ThemeDescriptor.java;2;0;7;1;0;0;0;7;371;6;2;206;371;371;6;5;0;7;7;233;5;233;2;2;1
/org.eclipse.ui.editors/src/org/eclipse/ui/internal/editors/text/OverlayPreferenceStore.java;1;1;3;1;2;2;2;1;33;0;1;82;41;41;1;0;0;1;3;82;0;336;3;1;0
/org.eclipse.pde.core/src/org/eclipse/pde/internal/core/PDEStateHelper.java;1;0;2;1;1;1;1;1;10;0;1;259;10;10;1;0;0;1;2;259;0;336;2;1;0
/org.eclipse.ui.ide/src/org/eclipse/ui/internal/ide/dialogs/WelcomeEditor.java;5;1;5;1;3;3;3;2;72;1;2;132;78;78;1;0;0;2;5;132;0;336;5;5;0
/org.eclipse.jdt.ui/core refactoring/org/eclipse/jdt/internal/corext/refactoring/changes/CompilationUnitReorgChange.java;2;1;5;1;2;2;2;3;18;1;3;207;33;33;1;0;0;3;5;207;0;336;5;2;0
/org.eclipse.swt/Eclipse SWT PI/win32/org/eclipse/swt/internal/win32/TEXTMETRIC.java;1;0;1;1;0;0;0;1;10;0;1;61;10;10;1;0;0;1;1;61;0;61;1;1;0
/org.eclipse.debug.ui/ui/org/eclipse/debug/internal/ui/views/variables/ToggleLogicalStructureAction.java;1;0;2;1;0;0;0;2;9;0;1;152;9;9;2;1;0;2;2;152;1;152;1;1;0
/org.eclipse.debug.ui/ui/org/eclipse/debug/internal/ui/views/memory/RemoveMemoryBlockAction.java;1;0;1;1;1;1;1;0;0;0;0;282;0;0;1;0;0;0;1;282;0;282;1;1;1
/org.eclipse.swt/Eclipse SWT PI/win32/org/eclipse/swt/internal/win32/DROPFILES.java;1;0;1;1;0;0;0;1;3;0;1;166;3;3;1;0;0;1;1;166;0;166;1;1;0
/org.eclipse.jdt.ui/ui/org/eclipse/jdt/internal/ui/text/correction/UnimplementedMethodsCompletionProposal.java;3;2;15;2;4;3;4;11;38;3;7;16;163;163;3;4;1;11;15;16;5;336;10;3;1
/org.eclipse.core.runtime/src/org/eclipse/core/internal/content/XMLContentDescriber.java;2;4;11;2;8;3;8;3;67;2;2;251;192;192;4;1;5;3;11;303;6;303;5;2;1
/org.eclipse.ui.workbench/Eclipse UI/org/eclipse/ui/dialogs/IWorkingSetSelectionDialog.java;1;0;1;1;0;0;0;1;2;0;1;0;2;2;1;0;0;1;1;0;0;0;1;1;0
/org.eclipse.jface.text/src/org/eclipse/jface/text/rules/Token.java;1;1;2;1;2;2;2;0;6;0;0;276;8;8;1;0;0;0;2;276;0;336;2;1;0
/org.eclipse.jdt.core/codeassist/org/eclipse/jdt/internal/codeassist/impl/Engine.java;3;0;6;1;0;0;0;6;27;1;6;66;57;57;1;0;0;6;6;66;0;199;6;3;3
/org.eclipse.ui.workbench/Eclipse UI/org/eclipse/ui/internal/commands/ws/CommandView.java;2;0;2;1;1;1;1;1;10;0;1;266;10;10;1;0;0;1;2;266;0;336;2;2;0
/org.eclipse.ui.console/src/org/eclipse/ui/internal/console/ConsoleDropDownAction.java;3;0;4;1;1;1;1;3;25;2;2;118;39;39;2;1;0;3;4;118;1;336;3;3;0
/org.eclipse.core.runtime/src/org/eclipse/core/runtime/IPluginPrerequisite.java;4;2;10;2;6;4;6;4;198;2;3;171;495;495;2;1;2;4;10;179;3;336;7;4;0
/org.eclipse.swt/Eclipse SWT PI/gtk/org/eclipse/swt/internal/gtk/GdkDragContext.java;3;0;4;1;1;1;1;3;17;2;2;100;27;27;2;1;0;3;4;226;1;337;3;3;0
/org.eclipse.pde.ui/src/org/eclipse/pde/internal/ui/editor/schema/ElementSectionDragAdapter.java;2;1;2;1;2;2;2;0;4;0;0;308;6;6;1;0;0;0;2;308;0;336;2;2;0
/org.eclipse.jdt.debug.ui/ui/org/eclipse/jdt/internal/debug/ui/propertypages/InstanceFilterEditor.java;1;0;1;1;0;0;0;1;0;0;1;82;0;0;1;0;0;1;1;82;0;82;1;1;0
/org.eclipse.ui.ide/src/org/eclipse/ui/views/tasklist/TaskSorter.java;1;0;1;1;0;0;0;1;0;0;1;129;0;0;1;0;0;1;1;129;0;129;1;1;0
/org.eclipse.jdt.core/search/org/eclipse/jdt/internal/core/search/matching/DeclarationOfReferencedMethodsPattern.java;2;0;8;1;1;1;1;7;88;2;6;7;165;165;2;1;0;7;8;70;1;280;7;2;0
/org.eclipse.ui.cheatsheets/src/org/eclipse/ui/internal/cheatsheets/registry/CheatSheetItemExtensionElement.java;1;1;2;1;2;2;2;0;6;0;0;288;6;6;1;0;0;0;2;288;0;317;2;1;0
/org.eclipse.team.cvs.ui/src/org/eclipse/team/internal/ccvs/ui/repo/CommentHistoryContentHandler.java;1;0;1;1;0;0;0;1;24;0;1;139;24;24;1;0;0;1;1;139;0;139;1;1;0
/org.eclipse.pde.core/src/org/eclipse/pde/core/ModelChangedEvent.java;2;1;4;1;3;3;3;1;102;0;1;264;128;128;1;0;0;1;4;264;0;336;4;2;0
/org.eclipse.pde.core/src/org/eclipse/pde/internal/core/isite/ISiteCategory.java;2;1;3;1;2;2;2;1;4;0;1;232;8;8;1;0;0;1;3;232;0;336;3;2;0
/org.eclipse.ui.ide/src/org/eclipse/ui/internal/ide/registry/ProjectImageRegistryReader.java;2;0;2;1;0;0;0;2;3;1;2;132;3;3;1;0;0;2;2;132;0;160;2;2;1
/org.eclipse.ui.ide/src/org/eclipse/ui/views/navigator/ResourcePatternFilter.java;1;0;2;1;0;0;0;2;4;0;1;129;4;4;2;1;0;2;2;129;1;129;1;1;0
/org.eclipse.jdt.debug/model/org/eclipse/jdt/internal/debug/core/JDIDebugPlugin.java;3;0;5;2;2;1;2;3;83;1;3;130;116;116;2;0;1;3;5;290;1;290;4;3;1
/org.eclipse.team.core/src/org/eclipse/team/internal/core/subscribers/SyncSetInputFromSubscriber.java;1;0;3;1;1;1;1;2;57;1;2;199;59;59;1;0;0;2;3;199;0;336;3;1;0
/org.eclipse.jdt.core/search/org/eclipse/jdt/internal/core/search/indexing/AddJarFileToIndex.java;3;1;9;2;2;2;2;7;90;2;6;60;142;142;2;1;0;7;9;181;1;302;8;3;1
/org.eclipse.ui.cheatsheets/src/org/eclipse/ui/internal/cheatsheets/data/CheatSheetSaveHelper.java;2;5;9;1;6;2;6;3;496;1;3;243;787;787;5;0;4;3;9;306;4;306;5;2;0
/org.eclipse.ui.workbench/Eclipse UI/org/eclipse/ui/internal/ViewPane.java;7;13;48;6;17;2;17;31;3660;25;4;51;4004;4004;25;27;15;31;48;206;42;295;6;7;3
/org.eclipse.jdt.junit/src/org/eclipse/jdt/junit/ITestRunListener.java;2;1;2;1;2;2;2;0;6;0;0;275;8;8;1;0;0;0;2;275;0;336;2;2;0
/org.eclipse.jface/src/org/eclipse/jface/resource/StringConverter.java;3;0;6;1;1;1;2;4;99;2;4;3;263;263;2;0;1;5;6;265;1;336;5;3;0
/org.eclipse.ui.workbench.texteditor/src/org/eclipse/ui/texteditor/TextOperationAction.java;2;1;4;1;2;2;2;2;23;0;1;124;29;29;2;1;0;2;4;124;1;336;3;2;0
/org.eclipse.team.ui/src/org/eclipse/team/internal/ui/synchronize/StructuredViewerAdvisor.java;2;4;5;2;5;2;5;0;174;0;0;288;178;178;4;0;3;0;5;288;3;336;2;2;0
/org.eclipse.jdt.ui/core refactoring/org/eclipse/jdt/internal/corext/refactoring/structure/ImportRemover.java;1;0;2;1;2;1;2;0;6;0;0;300;6;6;2;0;1;0;2;300;1;300;1;1;0
/org.eclipse.jdt.launching/launching/org/eclipse/jdt/launching/sourcelookup/PackageFragmentRootSourceLocation.java;3;1;6;1;3;3;3;3;34;1;3;53;100;100;1;0;0;3;6;53;0;336;6;3;1
/org.eclipse.jdt.ui/ui refactoring/org/eclipse/jdt/internal/ui/refactoring/reorg/ReorgMoveStarter.java;4;1;9;1;2;2;4;5;40;3;3;70;77;77;3;2;2;7;9;70;4;336;5;4;0
/org.eclipse.ui.ide/src/org/eclipse/ui/wizards/datatransfer/WizardZipFileExportPage1.java;1;0;1;1;0;0;0;1;0;0;1;92;0;0;1;0;0;1;1;92;0;92;1;1;0
/org.eclipse.jdt.core/model/org/eclipse/jdt/internal/core/DefaultWorkingCopyOwner.java;2;0;12;2;1;1;1;11;53;2;8;54;101;101;2;3;0;11;12;66;3;279;9;2;0
/org.eclipse.ui.intro/src/org/eclipse/ui/internal/intro/impl/model/IntroPage.java;1;2;3;1;3;2;3;0;8;0;0;276;10;10;2;0;1;0;3;276;1;286;2;1;0
/org.eclipse.core.runtime.compatibility/src-runtime/org/eclipse/core/internal/plugins/PluginClassLoader.java;2;1;7;1;2;2;2;5;25;2;4;171;58;58;2;1;0;5;7;179;1;336;6;2;0
/org.eclipse.jdt.core/search/org/eclipse/jdt/internal/core/search/matching/FieldPattern.java;2;0;16;2;3;1;3;13;263;2;9;70;552;552;3;4;2;13;16;280;6;280;10;2;5
/org.eclipse.ui.workbench/Eclipse UI/org/eclipse/ui/internal/gestures/GestureSupport.java;2;0;5;1;0;0;0;5;38;1;5;104;79;79;1;0;0;5;5;104;0;181;5;2;0
/org.eclipse.team.cvs.core/src/org/eclipse/team/internal/ccvs/core/client/TemplateHandler.java;1;0;1;1;0;0;0;1;63;0;1;177;63;63;1;0;0;1;1;177;0;177;1;1;0
/org.eclipse.jdt.core/model/org/eclipse/jdt/internal/core/JavaElementRequestor.java;1;0;1;1;0;0;0;1;2;0;1;199;2;2;1;0;0;1;1;199;0;199;1;1;0
/org.eclipse.ui.workbench/Eclipse UI/org/eclipse/ui/internal/EditActionSetsAction.java;1;0;1;1;0;0;0;1;46;0;1;157;46;46;1;0;0;1;1;157;0;157;1;1;0
/org.eclipse.swt/Eclipse SWT/common/org/eclipse/swt/widgets/Synchronizer.java;2;1;5;1;2;2;2;3;13;1;3;51;27;27;1;0;0;3;5;51;0;337;5;2;1
/org.eclipse.swt/Eclipse SWT/gtk/org/eclipse/swt/graphics/FontData.java;2;1;4;1;2;2;2;2;42;1;2;13;53;53;1;0;0;2;4;13;0;337;4;2;1
/org.eclipse.ant.ui/Ant Tools Support/org/eclipse/ant/internal/ui/launchConfigurations/AntTargetContentProvider.java;2;1;6;2;2;2;2;4;117;3;2;108;156;156;3;2;0;4;6;119;2;336;4;2;2
/org.eclipse.update.core/src/org/eclipse/update/core/ISiteFeatureReference.java;3;1;4;1;2;2;2;2;8;1;2;0;20;20;1;0;0;2;4;0;0;336;4;3;0
/org.eclipse.swt/Eclipse SWT/photon/org/eclipse/swt/graphics/FontData.java;2;1;4;1;2;2;2;2;42;1;2;13;53;53;1;0;0;2;4;13;0;337;4;2;1
/org.eclipse.team.cvs.ui/src/org/eclipse/team/internal/ccvs/ui/actions/NewRepositoryAction.java;1;1;2;1;2;2;2;0;8;0;0;273;10;10;1;0;0;0;2;273;0;336;2;1;0
/org.eclipse.ui.cheatsheets/src/org/eclipse/ui/cheatsheets/OpenCheatSheetAction.java;2;2;6;2;3;2;3;3;62;0;1;255;98;98;3;2;1;3;6;255;3;306;3;2;0
/org.eclipse.jdt.core/model/org/eclipse/jdt/core/IWorkingCopy.java;1;0;5;1;0;0;0;5;16;1;5;54;23;23;1;0;0;5;5;54;0;199;5;1;0
/org.eclipse.ant.ui/Ant Tools Support/org/eclipse/ant/internal/ui/preferences/MessageLine.java;1;0;1;1;0;0;0;1;0;0;1;108;0;0;1;0;0;1;1;108;0;108;1;1;0
/org.eclipse.ui.workbench.texteditor/src/org/eclipse/ui/texteditor/ITextEditorExtension.java;2;0;1;2;1;1;1;0;5;0;0;336;5;5;1;0;0;0;1;336;0;336;1;2;0
/org.eclipse.debug.ui/ui/org/eclipse/debug/internal/ui/stringsubstitution/SelectedResourceManager.java;4;3;7;2;4;2;4;3;115;1;3;121;149;149;3;0;2;3;7;283;2;336;5;4;2
/org.eclipse.debug.ui/ui/org/eclipse/debug/internal/ui/actions/RelaunchLastAction.java;1;0;1;1;0;0;0;1;36;0;1;33;36;36;1;0;0;1;1;33;0;33;1;1;0
/org.eclipse.jdt.ui/ui/org/eclipse/jdt/internal/ui/text/java/hover/JavaInformationProvider.java;1;0;2;1;1;1;1;1;2;0;1;82;4;4;1;0;0;1;2;82;0;336;2;1;0
/org.eclipse.osgi/osgi/src/org/osgi/framework/ServiceFactory.java;2;0;2;1;1;1;1;1;3;0;1;171;3;3;1;0;0;1;2;171;0;296;2;2;0
/org.eclipse.jdt.core/model/org/eclipse/jdt/core/IPackageFragmentRoot.java;2;0;6;2;1;1;1;5;19;2;4;25;37;37;2;1;0;5;6;266;1;295;5;2;0
/org.eclipse.ui.workbench.texteditor/src/org/eclipse/ui/texteditor/IStatusFieldExtension.java;2;0;2;2;1;1;1;1;6;0;1;144;6;6;1;0;0;1;2;144;0;336;2;2;0
/org.eclipse.jdt.launching.macosx/macosx/org/eclipse/jdt/internal/ui/macbundler/BundleWizardPage3.java;1;0;1;1;0;0;0;1;0;0;1;203;0;0;1;0;0;1;1;203;0;203;1;1;0
/org.eclipse.jdt.ui/ui/org/eclipse/jdt/internal/ui/text/correction/QuickFixProcessor.java;2;7;27;1;8;2;8;19;143;9;8;28;398;398;9;11;6;19;27;64;17;336;10;2;2
/org.eclipse.pde.build/src/org/eclipse/pde/internal/build/AssembleConfigScriptGenerator.java;2;5;22;2;13;4;13;9;415;3;5;31;695;695;5;4;9;9;22;323;13;323;9;2;0
/org.eclipse.swt/Eclipse SWT PI/motif/org/eclipse/swt/internal/motif/XDestroyWindowEvent.java;1;0;1;1;0;0;0;1;0;0;1;88;0;0;1;0;0;1;1;88;0;88;1;1;0
/org.eclipse.jdt.core/model/org/eclipse/jdt/internal/core/BecomeWorkingCopyOperation.java;2;0;13;1;0;0;0;13;41;3;8;54;98;98;3;5;0;13;13;54;5;218;8;2;0
/org.eclipse.swt/Eclipse SWT Mozilla/common/org/eclipse/swt/internal/mozilla/nsIURIContentListener.java;1;0;2;1;0;0;0;2;33;1;2;111;33;33;1;0;0;2;2;111;0;148;2;1;0
/org.eclipse.help.base/src/org/eclipse/help/internal/workingset/AdaptableTocsArray.java;1;1;3;1;2;2;2;1;26;0;1;104;30;30;1;0;0;1;3;104;0;336;3;1;0
/org.eclipse.jface.text/src/org/eclipse/jface/text/ITextPresentationListener.java;2;0;5;2;2;1;2;3;25;1;3;158;32;32;2;0;1;3;5;336;1;336;4;2;0
/org.eclipse.jdt.core/eval/org/eclipse/jdt/internal/eval/CodeSnippetCompiler.java;3;0;5;1;0;0;0;5;18;1;5;5;26;26;1;0;0;5;5;5;0;199;5;3;0
/org.eclipse.swt/Eclipse SWT/common/org/eclipse/swt/SWTError.java;2;1;3;1;2;2;2;1;18;0;1;225;24;24;1;0;0;1;3;225;0;337;3;2;0
/org.eclipse.jdt.ui/ui/org/eclipse/jdt/ui/actions/OpenAction.java;3;1;6;2;2;2;2;4;12;1;4;41;24;24;1;0;0;4;6;41;0;336;6;3;0
/org.eclipse.pde.ui/src/org/eclipse/pde/internal/ui/wizards/tools/UpdateClasspathAction.java;2;2;6;2;3;2;3;3;16;1;3;213;34;34;2;0;1;3;6;302;1;336;5;2;0
/org.eclipse.team.ui/src/org/eclipse/team/internal/ui/actions/TeamAction.java;2;2;10;2;3;2;3;7;188;3;3;52;352;352;3;4;1;7;10;52;5;336;5;2;1
/org.eclipse.jface.text/src/org/eclipse/jface/text/formatter/ContextBasedFormattingStrategy.java;3;3;9;2;4;2;4;5;66;4;2;119;180;180;4;3;2;5;9;119;5;334;4;3;0
/org.eclipse.ui.cheatsheets/src/org/eclipse/ui/internal/cheatsheets/ICheatSheetResource.java;2;3;10;1;7;4;7;3;114;1;3;243;169;169;3;0;3;3;10;305;3;315;7;2;0
/org.eclipse.update.core/src/org/eclipse/update/internal/security/JarVerificationResult.java;2;1;4;1;2;2;2;2;19;1;2;58;33;33;1;0;0;2;4;58;0;336;4;2;0
/org.eclipse.jdt.ui/ui refactoring/org/eclipse/jdt/internal/ui/refactoring/nls/search/NLSSearchMessages.java;1;0;1;1;1;1;1;0;2;0;0;336;2;2;1;0;0;0;1;336;0;336;1;1;0
/org.eclipse.core.resources/src/org/eclipse/core/resources/team/TeamHook.java;2;0;5;2;0;0;2;3;133;3;3;90;236;236;3;0;2;5;5;270;2;270;3;2;0
/org.eclipse.jface.text/src/org/eclipse/jface/text/rules/IWordDetector.java;1;0;1;1;1;1;1;0;2;0;0;336;2;2;1;0;0;0;1;336;0;336;1;1;0
/org.eclipse.pde.ui/src/org/eclipse/pde/internal/ui/parts/StatusDialog.java;1;0;1;1;0;0;0;1;7;0;1;44;7;7;1;0;0;1;1;44;0;44;1;1;0
/org.eclipse.jdt.ui/ui/org/eclipse/jdt/internal/ui/text/CompoundContentAssistProcessor.java;2;2;4;1;3;2;3;1;52;0;1;262;54;54;2;0;1;1;4;279;1;336;3;2;0
/org.eclipse.pde.build/src/org/eclipse/pde/internal/build/IBuildPropertiesConstants.java;2;3;5;2;4;2;4;1;69;0;1;246;74;74;3;0;2;1;5;272;2;310;3;2;0
/org.eclipse.update.core/src/org/eclipse/update/internal/core/FeatureDownloadException.java;2;1;4;1;3;3;3;1;4;0;1;179;8;8;1;0;0;1;4;179;0;336;4;2;0
/org.eclipse.jdt.core/codeassist/org/eclipse/jdt/internal/codeassist/select/SelectionNodeFound.java;2;0;2;1;1;1;1;1;5;0;1;199;7;7;1;0;0;1;2;199;0;324;2;2;1
/org.eclipse.jdt.debug.ui/ui/org/eclipse/jdt/debug/ui/JavaSourceLookupDialog.java;3;1;3;1;2;2;2;1;8;0;1;170;18;18;1;0;0;1;3;170;0;336;3;3;0
/org.eclipse.ui.ide/extensions/org/eclipse/ui/actions/NewWizardMenu.java;4;0;7;2;0;0;0;7;68;3;4;132;98;98;3;3;0;7;7;166;3;166;4;4;3
/org.eclipse.debug.ui/ui/org/eclipse/debug/internal/ui/views/memory/FormatColumnAction.java;1;0;1;1;1;1;1;0;0;0;0;282;0;0;1;0;0;0;1;282;0;282;1;1;0
/org.eclipse.core.runtime.compatibility/src-model/org/eclipse/core/runtime/model/Factory.java;3;1;5;1;3;3;3;2;18;1;2;171;27;27;1;0;0;2;5;171;0;336;5;3;0
/org.eclipse.osgi/osgi/src/org/osgi/framework/BundleEvent.java;3;2;4;1;3;2;3;1;67;0;1;171;77;77;2;0;1;1;4;296;1;296;3;3;0
/org.eclipse.jface/src/org/eclipse/jface/dialogs/TitleAreaDialog.java;3;2;9;1;4;3;4;5;1063;2;4;26;1142;1142;2;1;1;5;9;36;2;336;7;3;0
/org.eclipse.jface/src/org/eclipse/jface/preference/FieldEditorPreferencePage.java;1;0;2;1;1;1;1;1;7;0;1;0;9;9;1;0;0;1;2;0;0;293;2;1;1
/org.eclipse.jface.text/src/org/eclipse/jface/text/IInformationControlCreatorExtension.java;2;2;5;2;3;2;3;2;11;0;1;47;26;26;2;1;1;2;5;47;2;336;3;2;0
/org.eclipse.team.cvs.ui/src/org/eclipse/team/internal/ccvs/ui/actions/AddAction.java;2;0;2;1;1;1;1;1;44;0;1;261;46;46;1;0;0;1;2;261;0;336;2;2;1
/org.eclipse.jdt.ui/ui/org/eclipse/jdt/internal/ui/preferences/UserLibraryPreferencePage.java;3;3;17;1;7;5;10;7;158;7;2;243;434;434;7;5;5;10;17;260;10;336;7;3;1
/org.eclipse.jdt.debug/model/org/eclipse/jdt/internal/debug/core/model/JDIDebugTarget.java;5;0;21;2;3;1;3;18;262;4;9;26;540;540;4;9;2;18;21;233;11;323;10;5;5
/org.eclipse.jface/src/org/eclipse/jface/dialogs/IDialogConstants.java;1;0;1;1;1;1;1;0;151;0;0;293;151;151;1;0;0;0;1;293;0;293;1;1;0
/org.eclipse.jdt.debug.ui/ui/org/eclipse/jdt/internal/debug/ui/jres/IAddVMDialogRequestor.java;1;0;1;1;0;0;0;1;0;0;1;65;0;0;1;0;0;1;1;65;0;65;1;1;0
/org.eclipse.core.runtime/src/org/eclipse/core/internal/runtime/ResourceTranslator.java;4;8;11;3;10;3;10;1;183;0;1;266;205;205;8;0;7;1;11;289;7;336;4;4;0
/org.eclipse.ui.ide/src/org/eclipse/ui/internal/ide/IHelpContextIds.java;4;1;4;2;2;2;2;2;4;0;1;94;6;6;2;1;0;2;4;94;1;336;3;4;0
/org.eclipse.team.cvs.ui/src/org/eclipse/team/internal/ccvs/ui/model/RemoteModule.java;2;1;6;1;2;2;2;4;434;2;3;5;446;446;2;1;0;4;6;63;1;336;5;2;0
/org.eclipse.jdt.ui/core extension/org/eclipse/jdt/internal/corext/codemanipulation/CodeGenerationMessages.java;1;0;1;1;1;1;1;0;2;0;0;336;2;2;1;0;0;0;1;336;0;336;1;1;0
/org.eclipse.ui.workbench.texteditor/src/org/eclipse/ui/texteditor/AbstractRulerActionDelegate.java;3;0;3;2;1;1;1;2;3;1;2;46;6;6;1;0;0;2;3;46;0;336;3;3;0
/org.eclipse.jdt.ui/core refactoring/org/eclipse/jdt/internal/corext/refactoring/typeconstraints/SimpleTypeConstraint.java;2;0;8;1;1;1;1;7;84;3;4;3;166;166;3;3;0;7;8;3;3;336;5;2;0
/org.eclipse.ui.workbench/Eclipse UI/org/eclipse/ui/internal/LayoutPart.java;8;6;23;3;8;2;11;12;481;6;6;69;817;817;6;6;9;15;23;237;15;330;8;8;6
/org.eclipse.jdt.core/antadapter/org/eclipse/jdt/core/JDTCompilerAdapter.java;3;2;16;2;3;2;3;13;313;3;9;22;724;724;3;4;1;13;16;127;5;312;11;3;1
/org.eclipse.debug.ui/ui/org/eclipse/debug/internal/ui/launchConfigurations/EnvironmentVariable.java;2;0;3;1;1;1;1;2;19;1;2;156;21;21;1;0;0;2;3;156;0;336;3;2;0
/org.eclipse.jdt.junit/src/org/eclipse/jdt/internal/junit/wizards/WizardMessages.java;1;0;1;1;1;1;1;0;2;0;0;336;2;2;1;0;0;0;1;336;0;336;1;1;0
/org.eclipse.ui.workbench/Eclipse UI/org/eclipse/ui/internal/EditorHistory.java;1;0;1;1;0;0;0;1;60;0;1;157;60;60;1;0;0;1;1;157;0;157;1;1;0
/org.eclipse.swt/Eclipse SWT PI/motif/org/eclipse/swt/internal/motif/OS.java;7;2;37;4;5;4;5;32;5781;11;10;1;7555;7555;11;22;1;32;37;126;23;337;14;7;0
/org.eclipse.jdt.core/model/org/eclipse/jdt/internal/core/InternalNamingConventions.java;4;0;5;1;1;1;1;4;8;1;4;5;16;16;1;0;0;4;5;5;0;302;5;4;0
/org.eclipse.ltk.core.refactoring/src/org/eclipse/ltk/core/refactoring/ContentStamp.java;1;0;3;1;3;1;3;0;18;0;0;278;18;18;3;0;2;0;3;278;2;278;1;1;0
/org.eclipse.help/src/org/eclipse/help/ITopic.java;1;1;4;1;3;3;3;1;6;0;1;73;17;17;1;0;0;1;4;73;0;336;4;1;0
/org.eclipse.ui.editors/src/org/eclipse/ui/internal/editors/text/AnnotationsPreferencePage.java;1;1;2;1;2;2;2;0;8;0;0;295;10;10;1;0;0;0;2;295;0;336;2;1;0
/org.eclipse.pde.ui/src/org/eclipse/pde/internal/ui/wizards/templates/HelpTemplate.java;3;1;7;1;3;3;3;4;100;2;3;128;128;128;2;1;0;4;7;128;1;336;6;3;0
/org.eclipse.ui.intro/src/org/eclipse/ui/intro/config/IStandbyContentPart.java;2;2;5;2;5;3;5;0;135;0;0;283;254;254;2;0;2;0;5;283;2;336;3;2;0
/org.eclipse.update.core/src/org/eclipse/update/internal/operations/UpdateUtils.java;4;5;20;2;7;3;7;13;188;3;8;54;468;468;5;5;4;13;20;289;9;336;11;4;1
/org.eclipse.ui.workbench/Eclipse UI/org/eclipse/ui/internal/contexts/IContextRegistry.java;1;0;2;1;0;0;0;2;32;1;2;86;32;32;1;0;0;2;2;86;0;174;2;1;0
/org.eclipse.ltk.ui.refactoring/src/org/eclipse/ltk/ui/refactoring/UserInputWizardPage.java;2;2;9;2;3;2;8;1;124;0;1;269;160;160;6;0;6;6;9;269;6;336;3;2;0
/org.eclipse.pde.ui/src/org/eclipse/pde/internal/ui/editor/feature/FeatureOutlinePage.java;2;1;4;1;3;3;3;1;140;0;1;232;174;174;1;0;0;1;4;232;0;336;4;2;0
/org.eclipse.jdt.core/model/org/eclipse/jdt/internal/core/builder/State.java;4;0;7;1;1;1;1;6;37;1;6;70;61;61;1;0;0;6;7;70;0;310;7;4;1
/org.eclipse.ui.editors/src/org/eclipse/ui/editors/text/FileDocumentProvider.java;3;4;20;2;8;4;8;12;246;2;9;82;718;718;4;3;4;12;20;325;7;325;13;3;0
/org.eclipse.jdt.ui/ui/org/eclipse/jdt/internal/ui/workingsets/ClearWorkingSetAction.java;1;0;1;1;1;1;1;0;2;0;0;336;2;2;1;0;0;0;1;336;0;336;1;1;0
/org.eclipse.ui.cheatsheets/src/org/eclipse/ui/cheatsheets/ICheatSheetManager.java;2;0;2;2;0;0;0;2;192;1;2;243;192;192;1;0;0;2;2;243;0;253;2;2;0
/org.eclipse.pde.ui/src/org/eclipse/pde/internal/ui/editor/PDEFormEditor.java;3;9;12;3;12;2;12;0;171;0;0;292;242;242;9;0;10;0;12;292;10;327;2;3;0
/org.eclipse.ui.ide/extensions/org/eclipse/ui/IMarkerResolutionGenerator2.java;1;0;1;1;0;0;0;1;0;0;1;132;0;0;1;0;0;1;1;132;0;132;1;1;0
/org.eclipse.jdt.core/dom/org/eclipse/jdt/core/dom/Initializer.java;5;0;17;1;1;1;5;12;233;6;8;70;316;316;6;4;4;16;17;266;8;308;9;5;2
/org.eclipse.core.variables/src/org/eclipse/core/internal/variables/ListenerList.java;1;0;1;1;0;0;0;1;0;0;1;145;0;0;1;0;0;1;1;145;0;145;1;1;0
/org.eclipse.jdt.ui/ui/org/eclipse/jdt/internal/ui/packageview/GotoRequiredProjectAction.java;2;1;2;1;2;2;2;0;2;0;0;314;2;2;1;0;0;0;2;314;0;336;2;2;0
/org.eclipse.pde.core/src/org/eclipse/pde/internal/core/ifeature/IFeatureImport.java;2;1;3;1;2;2;2;1;6;0;1;232;14;14;1;0;0;1;3;232;0;336;3;2;0
/org.eclipse.core.resources/src/org/eclipse/core/internal/indexing/AbstractPagePolicy.java;1;0;1;1;1;1;1;0;6;0;0;277;6;6;1;0;0;0;1;277;0;277;1;1;0
/org.eclipse.jdt.core/model/org/eclipse/jdt/internal/core/builder/ClasspathDirectory.java;4;0;6;1;0;0;0;6;16;1;6;2;31;31;1;0;0;6;6;2;0;199;6;4;0
/org.eclipse.swt/Eclipse SWT/gtk/org/eclipse/swt/widgets/ScrollBar.java;5;1;9;1;2;2;2;7;32;2;6;1;96;96;2;1;0;7;9;179;1;337;8;5;0
/org.eclipse.ui.workbench/Eclipse UI/org/eclipse/ui/internal/about/AboutAction.java;1;0;1;1;1;1;1;0;0;0;0;294;0;0;1;0;0;0;1;294;0;294;1;1;0
/org.eclipse.ui.ide/src/org/eclipse/ui/views/markers/internal/IMarkerChangedListener.java;1;0;1;1;0;0;0;1;0;0;1;129;0;0;1;0;0;1;1;129;0;129;1;1;0
/org.eclipse.swt/Eclipse SWT PI/gtk/org/eclipse/swt/internal/gtk/GdkWindowAttr.java;2;1;2;1;2;2;2;0;2;0;0;306;2;2;1;0;0;0;2;306;0;337;2;2;0
/org.eclipse.jdt.ui/ui refactoring/org/eclipse/jdt/internal/ui/refactoring/reorg/CopyToClipboardAction.java;3;0;9;2;1;1;1;8;97;4;3;70;125;125;4;5;0;8;9;94;5;336;4;3;0
/org.eclipse.swt.tools/JNI Generation/org/eclipse/swt/tools/internal/NativesGenerator.java;2;2;8;2;3;2;3;5;217;4;2;230;451;451;4;3;1;5;8;230;4;308;4;2;0
/org.eclipse.pde.build/src_ant/org/eclipse/pde/internal/build/tasks/IdReplaceTask.java;2;2;13;2;7;5;7;6;69;2;4;31;163;163;2;2;2;6;13;31;4;336;9;2;0
/org.eclipse.help.base/src/org/eclipse/help/standalone/Help.java;1;2;5;1;4;3;4;1;160;0;1;104;183;183;2;0;1;1;5;330;1;330;4;1;0
/org.eclipse.ui.workbench/Eclipse UI/org/eclipse/ui/internal/registry/RegistryReader.java;5;0;7;2;1;1;1;6;24;2;5;82;73;73;2;1;0;6;7;196;1;336;6;5;0
/org.eclipse.ui.ide/src/org/eclipse/ui/internal/ide/dialogs/PathVariableDialog.java;2;1;3;1;2;2;2;1;22;0;1;132;41;41;1;0;0;1;3;132;0;336;3;2;1
/org.eclipse.jdt.ui/ui/org/eclipse/jdt/internal/ui/preferences/JavaTemplatePreferencePage.java;2;2;5;1;4;3;4;1;106;0;1;263;121;121;2;0;1;1;5;283;1;336;4;2;0
/org.eclipse.debug.ui/ui/org/eclipse/debug/internal/ui/views/launch/Decoration.java;1;0;1;1;0;0;0;1;0;0;1;75;0;0;1;0;0;1;1;75;0;75;1;1;0
/org.eclipse.debug.ui/ui/org/eclipse/debug/internal/ui/launchConfigurations/LaunchHistory.java;4;1;4;1;2;2;2;2;27;1;2;141;44;44;1;0;0;2;4;141;0;307;4;4;0
/org.eclipse.update.core/src/org/eclipse/update/internal/core/UpdatePreferencesInitializer.java;1;1;2;1;2;2;2;0;6;0;0;289;6;6;1;0;0;0;2;289;0;302;2;1;0
/org.eclipse.jdt.debug/eval/org/eclipse/jdt/internal/debug/eval/ast/instructions/Constructor.java;1;0;1;1;0;0;0;1;2;0;1;78;2;2;1;0;0;1;1;78;0;78;1;1;0
/org.eclipse.jdt.debug.ui/ui/org/eclipse/jdt/internal/debug/ui/actions/ValidBreakpointLocationLocator.java;2;0;9;2;0;0;0;9;78;2;6;98;178;178;2;3;0;9;9;98;3;184;6;2;2
/org.eclipse.jdt.ui/ui/org/eclipse/jdt/internal/ui/packageview/GotoResourceAction.java;2;0;2;1;1;1;1;1;28;0;1;32;30;30;1;0;0;1;2;32;0;336;2;2;0
/org.eclipse.core.resources/src/org/eclipse/core/internal/indexing/LogReader.java;1;1;2;1;2;2;2;0;31;0;0;277;51;51;1;0;0;0;2;277;0;295;2;1;0
/org.eclipse.pde.ui/src_Forms/org/eclipse/pde/internal/ui/model/build/Build.java;3;5;9;3;9;3;9;0;62;0;0;285;91;91;5;0;6;0;9;285;6;336;3;3;0
/org.eclipse.jdt.ui/core refactoring/org/eclipse/jdt/internal/corext/refactoring/nls/NLSHint.java;3;0;9;2;1;1;7;2;609;0;1;267;611;611;8;1;6;8;9;267;7;336;2;3;1
/org.eclipse.search/new search/org/eclipse/search2/internal/ui/text/AnnotationManagers.java;2;1;2;1;2;2;2;0;2;0;0;321;2;2;1;0;0;0;2;321;0;336;2;2;0
/org.eclipse.update.core/src/org/eclipse/update/operations/IUpdateModelChangedListener.java;1;1;6;1;2;2;2;4;22;1;4;54;46;46;1;0;0;4;6;54;0;336;6;1;0
/org.eclipse.pde.ui/src/org/eclipse/pde/internal/ui/editor/feature/FeatureInputContext.java;3;2;4;2;4;3;4;0;7;0;0;292;17;17;2;0;1;0;4;292;1;336;3;3;0
/org.eclipse.search/search/org/eclipse/search/internal/ui/CopyToClipboardAction.java;2;0;2;1;1;1;1;1;5;0;1;195;7;7;1;0;0;1;2;195;0;336;2;2;0
/org.eclipse.core.resources.win32/src/org/eclipse/core/internal/resources/refresh/win32/Win32RefreshProvider.java;1;0;2;1;1;1;1;1;5;0;1;206;5;5;1;0;0;1;2;206;0;286;2;1;0
/org.eclipse.team.ui/src/org/eclipse/team/ui/IConfigurationWizard.java;1;1;2;1;2;2;2;0;4;0;0;302;6;6;1;0;0;0;2;302;0;336;2;1;0
/org.eclipse.core.expressions/src/org/eclipse/core/internal/expressions/PropertyTesterDescriptor.java;1;2;5;1;3;2;3;2;48;0;1;227;58;58;2;1;1;2;5;227;2;336;3;1;1
/org.eclipse.core.resources/src/org/eclipse/core/resources/ISaveContext.java;1;0;3;1;0;0;1;2;318;2;2;3;322;322;2;0;1;3;3;270;1;270;2;1;0
/org.eclipse.swt/Eclipse SWT Mozilla/common/org/eclipse/swt/internal/mozilla/nsIWebBrowserChrome.java;1;0;2;1;0;0;0;2;12;1;2;100;12;12;1;0;0;2;2;100;0;148;2;1;0
/org.eclipse.ui.workbench/Eclipse UI/org/eclipse/ui/commands/ICommandManagerListener.java;3;1;8;1;2;2;2;6;20;3;4;70;90;90;3;2;0;6;8;70;2;336;6;3;0
/org.eclipse.update.core/src/org/eclipse/update/core/IFeatureFactory.java;2;1;3;1;2;2;2;1;6;0;1;58;15;15;1;0;0;1;3;58;0;336;3;2;0
/org.eclipse.update.core/src/org/eclipse/update/core/ISite.java;2;2;5;1;4;3;4;1;10;0;1;58;28;28;2;0;1;1;5;289;1;336;4;2;0
/org.eclipse.ui.workbench/Eclipse UI/org/eclipse/ui/internal/Perspective.java;11;12;42;5;17;3;17;25;475;7;8;24;1348;1348;12;17;14;25;42;289;31;326;11;11;11
/org.eclipse.ui.ide/src/org/eclipse/ui/views/markers/internal/ActionMarkerProperties.java;3;1;3;1;2;2;2;1;4;0;1;129;6;6;1;0;0;1;3;129;0;336;3;3;0
/org.eclipse.pde.core/src/org/eclipse/pde/core/build/IBuildEntry.java;3;1;5;1;3;3;3;2;80;1;2;222;108;108;1;0;0;2;5;222;0;336;5;3;0
/org.eclipse.jdt.ui/ui/org/eclipse/jdt/internal/ui/actions/RemoveBlockCommentAction.java;2;1;5;2;2;2;2;3;169;0;1;99;179;179;3;2;0;3;5;99;2;336;3;2;0
/org.eclipse.jdt.ui/ui refactoring/org/eclipse/jdt/internal/ui/refactoring/nls/search/NLSSearchResultLabelProvider2.java;1;0;2;1;1;1;1;1;1;0;1;268;1;1;1;0;0;1;2;268;0;283;2;1;0
/org.eclipse.jdt.ui/ui/org/eclipse/jdt/internal/ui/JavaHierarchyPerspectiveFactory.java;6;4;10;2;8;4;8;2;20;1;2;130;47;47;4;0;4;2;10;325;4;336;6;6;0
/org.eclipse.jdt.core/formatter/org/eclipse/jdt/internal/formatter/Location.java;2;1;8;1;2;2;2;6;12;2;5;37;27;27;2;1;0;6;8;37;1;312;7;2;0
/org.eclipse.jdt.launching/launching/org/eclipse/jdt/internal/launching/VariableClasspathEntry.java;3;0;2;3;0;0;0;2;22;0;1;269;22;22;2;1;0;2;2;269;1;269;1;3;0
/org.eclipse.update.ui/src/org/eclipse/update/internal/ui/model/NamedModelObject.java;1;0;1;1;0;0;0;1;8;0;1;58;8;8;1;0;0;1;1;58;0;58;1;1;0
/org.eclipse.ltk.core.refactoring/src/org/eclipse/ltk/core/refactoring/CompositeChange.java;1;8;14;1;11;3;11;3;86;0;1;264;223;223;8;2;8;3;14;275;10;336;4;1;0
/org.eclipse.jdt.debug/jdi/org/eclipse/jdi/internal/TypeComponentImpl.java;2;0;2;1;1;1;1;1;12;0;1;235;16;16;1;0;0;1;2;235;0;336;2;2;0
/org.eclipse.pde/src/org/eclipse/pde/internal/builders/UpdateSiteBuilder.java;2;1;4;1;2;2;2;2;34;1;2;166;79;79;1;0;0;2;4;166;0;336;4;2;0
/org.eclipse.jface.text/src/org/eclipse/jface/text/templates/persistence/TemplateStore.java;2;2;8;2;3;2;4;4;180;3;2;253;456;456;3;2;2;5;8;263;4;336;4;2;0
/org.eclipse.update.ui/src/org/eclipse/update/internal/ui/wizards/UIProblemHandler.java;2;0;2;2;0;0;0;2;9;0;1;54;9;9;2;1;0;2;2;54;1;54;1;2;0
/org.eclipse.ui.ide/src/org/eclipse/ui/views/markers/internal/SelectionProviderAdapter.java;1;0;1;1;0;0;0;1;0;0;1;181;0;0;1;0;0;1;1;181;0;181;1;1;1
/org.eclipse.jdt.core/model/org/eclipse/jdt/internal/core/RenameElementsOperation.java;1;0;4;1;0;0;0;4;6;1;4;10;11;11;1;0;0;4;4;10;0;199;4;1;0
/org.eclipse.jdt.junit/src/org/eclipse/jdt/internal/junit/ui/TestRunTab.java;2;1;2;1;2;2;2;0;2;0;0;301;2;2;1;0;0;0;2;301;0;336;2;2;0
/org.eclipse.pde.core/src/org/eclipse/pde/internal/core/site/SiteBuildObject.java;3;1;4;1;2;2;2;2;16;1;2;232;27;27;1;0;0;2;4;232;0;336;4;3;0
/org.eclipse.jdt.ui/ui/org/eclipse/jdt/internal/ui/viewsupport/ProblemMarkerManager.java;2;0;3;1;1;1;1;2;13;1;2;71;17;17;1;0;0;2;3;71;0;336;3;2;0
/org.eclipse.jdt.ui/core refactoring/org/eclipse/jdt/internal/corext/refactoring/nls/NLSElement.java;2;1;3;1;2;2;2;1;65;0;1;89;79;79;1;0;0;1;3;89;0;289;3;2;0
/org.eclipse.jface/src/org/eclipse/jface/action/Action.java;5;2;6;2;3;2;3;3;39;1;3;0;80;80;2;0;1;3;6;276;1;336;5;5;0
/org.eclipse.core.variables/src/org/eclipse/core/internal/variables/VariablesMessages.java;2;0;2;2;0;0;0;2;16;0;1;145;16;16;2;1;0;2;2;145;1;145;1;2;0
/org.eclipse.core.variables/src/org/eclipse/core/variables/IStringVariable.java;1;0;1;1;0;0;0;1;0;0;1;145;0;0;1;0;0;1;1;145;0;145;1;1;0
/org.eclipse.jdt.junit/src/org/eclipse/jdt/internal/junit/util/ExceptionHandler.java;1;0;1;1;1;1;1;0;2;0;0;336;2;2;1;0;0;0;1;336;0;336;1;1;0
/org.eclipse.jface.text/src/org/eclipse/jface/text/reconciler/IReconcilingStrategyExtension.java;1;0;2;1;2;1;2;0;16;0;0;336;16;16;2;0;1;0;2;336;1;336;1;1;0
/org.eclipse.ui.views/src/org/eclipse/ui/internal/views/ViewsPlugin.java;4;1;4;1;2;2;2;2;50;1;2;129;59;59;1;0;0;2;4;129;0;336;4;4;0
/org.eclipse.team.ui/src/org/eclipse/team/internal/ui/synchronize/SynchronizeModelManager.java;2;2;5;2;5;3;5;0;245;0;0;273;282;282;2;0;2;0;5;288;2;302;3;2;1
/org.eclipse.swt/Eclipse SWT PI/win32/org/eclipse/swt/internal/win32/OS.java;7;7;63;6;11;3;15;48;196;20;13;1;530;530;20;35;12;52;63;227;47;337;16;7;4
/org.eclipse.jdt.core/model/org/eclipse/jdt/internal/core/SortElementsOperation.java;4;0;10;1;0;0;0;10;32;2;9;10;62;62;2;1;0;10;10;258;1;258;9;4;1
/org.eclipse.ui.workbench/Eclipse UI/org/eclipse/ui/internal/EarlyStartupRunnable.java;2;0;2;1;1;1;1;1;5;0;1;268;9;9;1;0;0;1;2;268;0;276;2;2;0
/org.eclipse.jdt.core/model/org/eclipse/jdt/core/jdom/IDOMField.java;2;0;3;1;1;1;1;2;3;1;2;199;8;8;1;0;0;2;3;199;0;299;3;2;0
/org.eclipse.ui.workbench/Eclipse UI/org/eclipse/ui/internal/PopupMenuExtender.java;3;0;3;1;1;1;1;2;34;1;2;72;44;44;1;0;0;2;3;72;0;336;3;3;0
/org.eclipse.team.core/src/org/eclipse/team/internal/core/ResourceVariantCache.java;2;1;5;2;2;2;2;3;252;0;1;226;285;285;3;2;0;3;5;226;2;336;3;2;0
/org.eclipse.jdt.core/compiler/org/eclipse/jdt/internal/compiler/ast/ThisReference.java;2;0;4;1;0;0;0;4;12;1;4;63;21;21;1;0;0;4;4;63;0;199;4;2;0
/org.eclipse.ant.ui/Ant Editor/org/eclipse/ant/internal/ui/dtd/schema/Dfm.java;1;0;2;1;0;0;0;2;29;1;2;108;29;29;1;0;0;2;2;108;0;198;2;1;0
/org.eclipse.jdt.junit/src/org/eclipse/jdt/internal/junit/wizards/IAboutToRunOperation.java;2;1;2;1;2;2;2;0;2;0;0;303;2;2;1;0;0;0;2;303;0;336;2;2;0
/org.eclipse.jdt.debug.ui/ui/org/eclipse/jdt/internal/debug/ui/launcher/SourceLookupBlock.java;3;2;7;2;3;2;3;4;56;1;4;9;113;113;2;0;1;4;7;296;1;336;6;3;0
/org.eclipse.ui.console/src/org/eclipse/ui/internal/console/ShowConsoleAction.java;3;1;4;1;2;2;2;2;9;0;1;118;23;23;2;1;0;2;4;118;1;336;3;3;0
/org.eclipse.jdt.core/model/org/eclipse/jdt/core/ISourceManipulation.java;1;0;1;1;0;0;0;1;2;0;1;199;2;2;1;0;0;1;1;199;0;199;1;1;0
/org.eclipse.team.ui/src/org/eclipse/team/ui/synchronize/ISynchronizeParticipantListener.java;1;0;4;1;2;1;2;2;38;0;1;146;42;42;2;1;1;2;4;146;2;335;2;1;0
/org.eclipse.core.runtime/src/org/eclipse/core/internal/jobs/Deadlock.java;2;0;2;1;1;1;1;1;7;0;1;178;7;7;1;0;0;1;2;178;0;277;2;2;0
/org.eclipse.jdt.ui/ui/org/eclipse/jdt/internal/ui/packageview/ToggleLinkingAction.java;1;0;2;1;1;1;1;1;13;0;1;79;15;15;1;0;0;1;2;79;0;336;2;1;0
/org.eclipse.jdt.debug/eval/org/eclipse/jdt/internal/debug/eval/ast/engine/ASTEvaluationEngine.java;3;1;7;2;2;2;2;5;28;2;4;78;43;43;2;1;0;5;7;235;1;302;6;3;1
/org.eclipse.jdt.ui/ui/org/eclipse/jdt/internal/ui/javaeditor/BasicEditorActionContributor.java;2;1;5;1;2;2;2;3;12;2;2;170;23;23;2;1;0;3;5;184;1;336;4;2;0
/org.eclipse.jdt.ui/core refactoring/org/eclipse/jdt/internal/corext/refactoring/code/flow/FlowAnalyzer.java;2;0;4;1;1;1;1;3;24;1;3;14;55;55;1;0;0;3;4;14;0;336;4;2;0
/org.eclipse.update.core/src/org/eclipse/update/internal/core/Assert.java;1;1;2;1;2;2;2;0;10;0;0;290;14;14;1;0;0;0;2;290;0;336;2;1;0
/org.eclipse.ui.workbench/Eclipse UI/org/eclipse/ui/branding/IProductConstants.java;3;2;5;2;4;2;4;1;42;0;1;243;63;63;2;0;2;1;5;318;2;332;3;3;0
/org.eclipse.swt/Eclipse SWT Mozilla/common/org/eclipse/swt/internal/mozilla/nsIWebProgressListener.java;1;0;1;1;0;0;0;1;0;0;1;100;0;0;1;0;0;1;1;100;0;100;1;1;0
/org.eclipse.jdt.ui/ui/org/eclipse/jdt/internal/ui/packageview/PackagesMessages.java;1;0;1;1;1;1;1;0;2;0;0;336;2;2;1;0;0;0;1;336;0;336;1;1;0
/org.eclipse.jdt.ui/core extension/org/eclipse/jdt/internal/corext/template/java/TemplateSet.java;3;3;4;2;4;2;4;0;13;0;0;275;15;15;3;0;2;0;4;275;2;336;2;3;0
/org.eclipse.core.resources/src/org/eclipse/core/internal/resources/SyncInfoSnapReader.java;1;0;1;1;1;1;1;0;86;0;0;277;86;86;1;0;0;0;1;277;0;277;1;1;0
/org.eclipse.pde.core/src/org/eclipse/pde/internal/core/feature/FeatureChild.java;3;1;4;1;2;2;2;2;48;1;2;130;66;66;1;0;0;2;4;130;0;336;4;3;0
/org.eclipse.jdt.core/dom/org/eclipse/jdt/core/dom/InfixExpression.java;3;0;8;1;2;1;2;6;174;2;5;199;222;222;2;1;1;6;8;266;2;276;6;3;1
/org.eclipse.ui.workbench.texteditor/src/org/eclipse/ui/texteditor/ITextEditorActionDefinitionIds.java;3;0;6;2;1;1;1;5;42;2;4;31;96;96;2;1;0;5;6;92;1;336;5;3;0
/org.eclipse.ant.ui/Ant Editor/org/eclipse/ant/internal/ui/editor/outline/AntModelProject.java;1;0;5;1;3;1;3;2;67;1;2;251;82;82;3;0;2;2;5;294;2;294;3;1;2
/org.eclipse.ant.ui/Ant Editor/org/eclipse/ant/internal/ui/editor/text/AnnotationAccess.java;1;0;2;1;0;0;0;2;21;1;2;108;21;21;1;0;0;2;2;108;0;200;2;1;1
/org.eclipse.jdt.junit/src/org/eclipse/jdt/internal/junit/wizards/NewTestCaseCreationWizard.java;3;0;3;1;1;1;1;2;2;1;2;14;6;6;1;0;0;2;3;14;0;336;3;3;0
/org.eclipse.debug.ui/ui/org/eclipse/debug/internal/ui/launchConfigurations/LaunchConfigurationTabGroupViewer.java;4;1;13;1;2;2;2;11;270;4;6;33;579;579;4;5;0;11;13;33;5;336;8;4;1
/org.eclipse.ui.views/src/org/eclipse/ui/views/properties/ComboBoxPropertyDescriptor.java;1;0;1;1;0;0;0;1;77;0;1;171;77;77;1;0;0;1;1;171;0;171;1;1;0
/org.eclipse.osgi/osgi/src/org/osgi/framework/ServiceListener.java;2;0;2;1;1;1;1;1;3;0;1;171;3;3;1;0;0;1;2;171;0;296;2;2;0
/org.eclipse.ltk.ui.refactoring/src/org/eclipse/ltk/internal/ui/refactoring/DefaultChangeElement.java;1;1;5;1;2;2;3;2;7;0;1;269;15;15;3;1;1;3;5;269;2;336;3;1;0
/org.eclipse.ant.ui/Ant Tools Support/org/eclipse/ant/internal/ui/views/elements/ProjectNode.java;1;0;3;1;1;1;1;2;4;1;2;108;6;6;1;0;0;2;3;108;0;336;3;1;1
/org.eclipse.jdt.core/compiler/org/eclipse/jdt/internal/compiler/util/HashtableOfType.java;2;0;3;1;0;0;0;3;6;1;3;199;10;10;1;0;0;3;3;199;0;245;3;2;0
/org.eclipse.swt/Eclipse SWT Mozilla/common/org/eclipse/swt/internal/mozilla/nsIDirectoryService.java;1;0;1;1;0;0;0;1;0;0;1;100;0;0;1;0;0;1;1;100;0;100;1;1;0
/org.eclipse.pde.ui/src/org/eclipse/pde/internal/ui/editor/site/SiteEditorContributor.java;1;1;4;1;2;2;2;2;27;1;2;134;42;42;1;0;0;2;4;134;0;336;4;1;0
/org.eclipse.jdt.ui/core extension/org/eclipse/jdt/internal/corext/javadoc/JavaDocVMInstallListener.java;1;0;1;1;1;1;1;0;2;0;0;336;2;2;1;0;0;0;1;336;0;336;1;1;0
/org.eclipse.jface/src/org/eclipse/jface/action/SubContributionItem.java;1;0;1;1;0;0;0;1;13;0;1;181;13;13;1;0;0;1;1;181;0;181;1;1;1
/org.eclipse.swt/Eclipse SWT Drag and Drop/win32/org/eclipse/swt/dnd/DragSource.java;2;0;2;1;0;0;0;2;77;1;2;19;81;81;1;0;0;2;2;19;0;41;2;2;0
/org.eclipse.ui.editors/src/org/eclipse/ui/editors/text/templates/ContributionTemplateStore.java;3;2;6;2;6;4;6;0;15;0;0;288;48;48;2;0;2;0;6;288;2;336;4;3;0
/org.eclipse.ui.ide/src/org/eclipse/ui/internal/ide/dialogs/ProjectCapabilitySimpleAddWizard.java;2;0;2;1;0;0;0;2;1;1;2;132;1;1;1;0;0;2;2;132;0;158;2;2;0
/org.eclipse.jdt.ui/ui/org/eclipse/jdt/internal/ui/filters/FilterMessages.java;1;0;1;1;1;1;1;0;2;0;0;336;2;2;1;0;0;0;1;336;0;336;1;1;0
/org.eclipse.ant.ui/Ant Editor/org/eclipse/ant/internal/ui/editor/model/AntDefiningTaskNode.java;1;1;8;1;3;3;3;5;55;3;2;248;88;88;3;3;0;5;8;248;3;323;5;1;2
/org.eclipse.ui.editors/src/org/eclipse/ui/internal/editors/text/WorkspaceOperationRunner.java;2;1;2;1;2;2;2;0;2;0;0;279;2;2;1;0;0;0;2;279;0;336;2;2;0
/org.eclipse.jface.text/src/org/eclipse/jface/text/templates/TemplateProposal.java;3;0;16;3;2;1;9;7;241;9;2;241;416;416;9;5;8;14;16;268;13;336;3;3;0
/org.eclipse.jdt.core/dom/org/eclipse/jdt/core/dom/DefaultCommentMapper.java;4;1;10;2;2;2;2;8;470;4;4;209;1026;1026;4;4;0;8;10;250;4;325;6;4;2
/org.eclipse.core.resources/src/org/eclipse/core/internal/watson/IPathRequestor.java;1;0;1;1;1;1;1;0;8;0;0;277;8;8;1;0;0;0;1;277;0;277;1;1;0
/org.eclipse.swt/Eclipse SWT/win32/org/eclipse/swt/widgets/TabItem.java;3;0;4;1;1;1;1;3;5;1;3;19;18;18;1;0;0;3;4;19;0;337;4;3;0
/org.eclipse.jdt.ui/ui/org/eclipse/jdt/ui/IWorkingCopyProvider.java;2;0;2;1;1;1;1;1;2;0;1;220;3;3;1;0;0;1;2;220;0;336;2;2;0
/org.eclipse.debug.core/core/org/eclipse/debug/internal/core/sourcelookup/containers/ContainerSourceContainer.java;1;0;6;1;0;0;1;5;72;3;3;205;84;84;3;2;1;6;6;225;3;268;3;1;0
/org.eclipse.pde.ui/src/org/eclipse/pde/ui/templates/AbstractNewPluginTemplateWizard.java;3;2;22;2;7;5;7;15;384;5;7;70;854;854;5;8;2;15;22;157;10;336;12;3;0
/org.eclipse.update.core/src/org/eclipse/update/internal/search/UpdateSiteAdapter.java;3;1;7;2;2;2;2;5;6;2;4;54;23;23;2;1;0;5;7;54;1;336;6;3;0
/org.eclipse.ui.workbench/Eclipse UI/org/eclipse/ui/internal/ViewPluginAction.java;2;1;2;1;2;2;2;0;4;0;0;286;6;6;1;0;0;0;2;286;0;336;2;2;0
/org.eclipse.ui.workbench/Eclipse UI/org/eclipse/ui/internal/layout/Row.java;1;0;1;1;1;1;1;0;0;0;0;271;0;0;1;0;0;0;1;271;0;271;1;1;0
/org.eclipse.osgi/osgi/src/org/osgi/service/packageadmin/PackageAdmin.java;3;4;11;2;5;2;6;5;216;2;4;171;412;412;4;1;4;6;11;292;5;292;6;3;0
/org.eclipse.jdt.ui/core extension/org/eclipse/jdt/internal/corext/textmanipulation/TextBufferFactory.java;4;0;7;1;1;1;1;6;22;1;6;32;44;44;1;0;0;6;7;32;0;336;7;4;0
/org.eclipse.debug.ui/ui/org/eclipse/debug/internal/ui/actions/ChangeVariableValueAction.java;1;0;1;1;0;0;0;1;9;0;1;243;9;9;1;0;0;1;1;243;0;243;1;1;0
/org.eclipse.jdt.ui/ui/org/eclipse/jdt/internal/ui/text/java/JavaCompletionProcessor.java;5;1;12;3;2;2;2;10;28;5;5;72;71;71;5;5;0;10;12;234;5;336;7;5;0
/org.eclipse.swt.tools/JNI Generation/org/eclipse/swt/tools/internal/StructsGenerator.java;3;0;5;2;1;1;1;4;109;3;2;230;143;143;3;2;0;4;5;230;2;293;3;3;0
/org.eclipse.ant.ui/Ant Editor/org/eclipse/ant/internal/ui/editor/model/AntElementNode.java;2;0;20;2;4;1;5;15;167;8;4;204;375;375;8;11;4;16;20;232;15;299;5;2;3
/org.eclipse.jface.text/src/org/eclipse/jface/text/IWidgetTokenKeeperExtension.java;3;0;4;2;2;1;2;2;27;1;2;75;33;33;2;0;1;2;4;336;1;336;3;3;0
/org.eclipse.pde.core/src/org/eclipse/pde/internal/core/schema/DocumentSection.java;2;1;3;1;2;2;2;1;14;0;1;232;20;20;1;0;0;1;3;232;0;336;3;2;0
/org.eclipse.jdt.debug/model/org/eclipse/jdt/internal/debug/core/model/JDIStackFrame.java;5;4;21;4;6;2;6;15;187;4;9;13;388;388;4;6;4;15;21;53;10;329;11;5;3
/org.eclipse.core.resources/src/org/eclipse/core/internal/resources/ProjectPreferences.java;2;9;19;2;11;3;11;8;221;5;2;239;565;565;9;6;8;8;19;277;14;320;5;2;1
/org.eclipse.ant.ui/Ant Editor/org/eclipse/ant/internal/ui/editor/AntEditor.java;2;5;35;2;6;2;10;25;387;13;7;108;981;981;13;18;8;29;35;200;26;323;9;2;10
/org.eclipse.ui.ide/src/org/eclipse/ui/internal/ide/model/WorkbenchWorkspace.java;2;0;3;1;1;1;1;2;11;1;2;132;12;12;1;0;0;2;3;132;0;336;3;2;0
/org.eclipse.jdt.core/dom/org/eclipse/jdt/core/dom/WhileStatement.java;3;0;9;1;2;1;2;7;110;2;6;164;166;166;2;1;1;7;9;266;2;276;7;3;1
/org.eclipse.jface.text/src/org/eclipse/jface/contentassist/ISubjectControlContentAssistProcessor.java;1;1;2;1;2;2;2;0;7;0;0;280;12;12;1;0;0;0;2;280;0;336;2;1;0
/org.eclipse.swt/Eclipse SWT PI/motif/org/eclipse/swt/internal/motif/XGCValues.java;1;0;1;1;0;0;0;1;40;0;1;54;40;40;1;0;0;1;1;54;0;54;1;1;0
/org.eclipse.jdt.ui/ui/org/eclipse/jdt/ui/text/IJavaColorConstants.java;2;2;4;1;3;2;3;1;16;0;1;97;42;42;2;0;1;1;4;273;1;335;3;2;0
/org.eclipse.jdt.junit/src/org/eclipse/jdt/internal/junit/ui/IJUnitHelpContextIds.java;3;0;4;1;1;1;1;3;3;1;3;19;7;7;1;0;0;3;4;19;0;336;4;3;0
/org.eclipse.jdt.core/model/org/eclipse/jdt/internal/core/CreateTypeOperation.java;2;0;7;2;1;1;1;6;47;1;6;27;101;101;1;0;0;6;7;27;0;299;7;2;0
/org.eclipse.jdt.core/model/org/eclipse/jdt/internal/core/DeletePackageFragmentRootOperation.java;2;0;2;1;0;0;0;2;8;1;2;172;10;10;1;0;0;2;2;172;0;199;2;2;0
/org.eclipse.team.cvs.ui/src/org/eclipse/team/internal/ccvs/ui/WorkbenchUserAuthenticator.java;1;2;6;1;3;2;3;3;104;1;3;176;209;209;2;0;1;3;6;274;1;336;5;1;1
/org.eclipse.help.ui/src/org/eclipse/help/ui/internal/IHelpUIConstants.java;1;1;4;1;3;3;3;1;17;0;1;156;54;54;1;0;0;1;4;156;0;336;4;1;0
/org.eclipse.ui.workbench/Eclipse UI/org/eclipse/ui/internal/commands/AbstractCommandRegistry.java;3;1;10;1;2;2;2;8;53;2;6;85;150;150;2;2;0;8;10;85;2;336;8;3;0
/org.eclipse.update.core/src/org/eclipse/update/configuration/IInstallConfiguration.java;2;1;3;1;2;2;2;1;7;0;1;58;13;13;1;0;0;1;3;58;0;336;3;2;0
/org.eclipse.core.runtime/src/org/eclipse/core/runtime/ISafeRunnable.java;2;1;6;2;2;2;2;4;188;3;2;171;201;201;3;2;0;4;6;171;2;336;4;2;0
/org.eclipse.jdt.core/compiler/org/eclipse/jdt/internal/compiler/ast/StringLiteralConcatenation.java;1;0;1;1;1;1;1;0;0;0;0;301;0;0;1;0;0;0;1;301;0;301;1;1;1
/org.eclipse.jdt.ui/ui/org/eclipse/jdt/internal/ui/text/spelling/engine/ISpellDictionary.java;2;0;3;2;1;1;1;2;6;0;1;219;8;8;2;1;0;2;3;219;1;336;2;2;0
/org.eclipse.swt/Eclipse SWT Mozilla/common/org/eclipse/swt/internal/mozilla/nsIStreamListener.java;1;0;1;1;0;0;0;1;0;0;1;153;0;0;1;0;0;1;1;153;0;153;1;1;0
/org.eclipse.swt/Eclipse SWT PI/win32/org/eclipse/swt/internal/win32/TCHAR.java;1;0;1;1;0;0;0;1;4;0;1;61;4;4;1;0;0;1;1;61;0;61;1;1;0
/org.eclipse.jdt.launching/launching/org/eclipse/jdt/launching/sourcelookup/containers/PackageFragmentRootSourceContainer.java;1;0;1;1;0;0;0;1;0;0;1;269;0;0;1;0;0;1;1;269;0;269;1;1;0
/org.eclipse.jdt.core/model/org/eclipse/jdt/internal/core/builder/AdditionalTypeCollection.java;1;0;1;1;0;0;0;1;2;0;1;199;2;2;1;0;0;1;1;199;0;199;1;1;0
/org.eclipse.pde.ui/src/org/eclipse/pde/internal/ui/wizards/IDefaultValueConsumer.java;2;1;2;1;2;2;2;0;4;0;0;289;4;4;1;0;0;0;2;289;0;336;2;2;0
/org.eclipse.jdt.core/model/org/eclipse/jdt/core/util/IParameterAnnotation.java;2;0;2;1;0;0;0;2;37;1;2;245;37;37;1;0;0;2;2;245;0;264;2;2;0
/org.eclipse.swt/Eclipse SWT/carbon/org/eclipse/swt/widgets/TreeItem.java;4;2;11;2;7;5;7;4;398;2;3;17;497;497;2;1;2;4;11;17;3;337;8;4;0
/org.eclipse.jdt.ui/ui/org/eclipse/jdt/internal/ui/text/JavaElementProvider.java;1;0;1;1;1;1;1;0;2;0;0;336;2;2;1;0;0;0;1;336;0;336;1;1;0
/org.eclipse.jdt.ui/core extension/org/eclipse/jdt/internal/corext/callhierarchy/CallLocation.java;4;0;11;2;1;1;1;10;105;3;6;13;233;233;3;4;0;10;11;260;4;336;7;4;0
/org.eclipse.text/src/org/eclipse/text/edits/TextEditProcessor.java;2;1;6;1;2;2;2;4;202;3;2;118;237;237;3;2;0;4;6;118;2;336;4;2;0
/org.eclipse.compare/compare/org/eclipse/compare/IEncodedStreamContentAccessor.java;1;0;3;1;1;1;1;2;19;0;1;220;30;30;2;1;0;2;3;220;1;335;2;1;0
/org.eclipse.jface/src/org/eclipse/jface/viewers/StructuredViewer.java;3;2;9;2;5;3;5;4;2406;1;4;0;2640;2640;2;0;2;4;9;287;2;329;7;3;5
/org.eclipse.ant.ui/Ant Tools Support/org/eclipse/ant/internal/ui/launchConfigurations/AntBuilderTabGroup.java;3;0;4;2;0;0;0;4;8;1;4;108;14;14;1;0;0;4;4;108;0;253;4;3;0
/org.eclipse.team.cvs.core/src/org/eclipse/team/internal/ccvs/core/client/SyncUpdate.java;1;0;3;1;0;0;0;3;2;2;2;73;4;4;2;1;0;3;3;73;1;110;2;1;0
/org.eclipse.jface.text/src/org/eclipse/jface/text/presentation/PresentationReconciler.java;3;3;18;3;5;2;5;13;86;3;7;56;346;346;3;6;3;13;18;92;9;336;9;3;0
/org.eclipse.swt/Eclipse SWT/win32/org/eclipse/swt/widgets/TreeItem.java;5;3;12;2;6;4;6;6;55;2;5;3;184;184;3;1;2;6;12;312;3;337;9;5;1
/org.eclipse.team.cvs.core/src/org/eclipse/team/internal/ccvs/core/Policy.java;1;0;1;1;0;0;0;1;2;0;1;150;2;2;1;0;0;1;1;150;0;150;1;1;0
/org.eclipse.help.base/src/org/eclipse/help/internal/browser/StreamConsumer.java;1;1;4;1;2;2;2;2;6;0;1;104;13;13;2;1;0;2;4;104;1;336;3;1;0
/org.eclipse.team.ui/src/org/eclipse/team/internal/ui/Utils.java;2;5;24;2;8;3;10;14;445;7;5;63;1272;1272;7;9;7;16;24;232;16;336;8;2;2
/org.eclipse.jdt.debug.ui/ui/org/eclipse/jdt/internal/debug/ui/propertypages/BreakpointConditionEditor.java;4;0;12;2;1;1;2;10;83;5;5;82;134;134;5;5;1;11;12;267;6;330;6;4;1
/org.eclipse.help/src/org/eclipse/help/internal/model/ITopicElement.java;1;0;2;1;1;1;1;1;9;0;1;197;9;9;1;0;0;1;2;197;0;311;2;1;0
/org.eclipse.update.core/src/org/eclipse/update/search/IUpdateSearchCategory.java;1;1;5;1;2;2;2;3;7;1;3;54;13;13;1;0;0;3;5;54;0;336;5;1;0
/org.eclipse.help.base/src/org/eclipse/help/internal/search/Analyzer_en.java;1;1;4;1;3;3;3;1;62;0;1;104;92;92;1;0;0;1;4;104;0;336;4;1;0
/org.eclipse.swt/Eclipse SWT Drag and Drop/emulated/org/eclipse/swt/dnd/TransferData.java;1;1;2;1;2;2;2;0;7;0;0;300;11;11;1;0;0;0;2;300;0;337;2;1;1
/org.eclipse.jdt.ui/ui/org/eclipse/jdt/ui/jarpackager/IJarExportRunnable.java;2;0;1;2;1;1;1;0;4;0;0;336;4;4;1;0;0;0;1;336;0;336;1;2;0
/org.eclipse.core.runtime/src/org/eclipse/core/internal/runtime/PlatformURLPluginConnection.java;5;3;12;2;4;2;4;8;364;3;6;83;399;399;3;2;2;8;12;171;4;336;8;5;0
/org.eclipse.jdt.core/compiler/org/eclipse/jdt/internal/compiler/flow/LabelFlowContext.java;2;0;2;1;0;0;0;2;4;1;2;170;6;6;1;0;0;2;2;170;0;199;2;2;0
/org.eclipse.ui.externaltools/External Tools Base/org/eclipse/ui/externaltools/internal/launchConfigurations/ExternalToolsUtil.java;3;2;24;2;3;2;3;21;173;6;11;19;812;812;6;10;1;21;24;19;11;309;13;3;1
/org.eclipse.ui.editors/src/org/eclipse/ui/texteditor/AbstractMarkerAnnotationModel.java;3;2;14;3;4;3;4;10;591;4;6;118;831;831;4;4;1;10;14;202;5;336;9;3;0
/org.eclipse.jdt.ui/ui/org/eclipse/jdt/internal/ui/dnd/TransferDragSourceListener.java;1;0;1;1;1;1;1;0;2;0;0;336;2;2;1;0;0;0;1;336;0;336;1;1;0
/org.eclipse.core.runtime.compatibility/src-boot/org/eclipse/core/internal/boot/SiteEntry.java;3;1;4;2;2;2;2;2;11;0;1;171;19;19;2;1;0;2;4;171;1;336;3;3;0
/org.eclipse.ui.workbench/Eclipse UI/org/eclipse/ui/internal/LayoutHelper.java;3;0;5;2;1;1;1;4;42;2;3;179;46;46;2;1;0;4;5;199;1;336;4;3;2
/org.eclipse.jdt.ui/core refactoring/org/eclipse/jdt/internal/corext/refactoring/RefactoringSearchEngine.java;5;3;12;1;5;3;5;7;186;1;7;3;347;347;3;0;2;7;12;289;2;336;10;5;0
/org.eclipse.search/new search/org/eclipse/search2/internal/ui/basic/views/ShowPreviousResultAction.java;2;0;3;1;1;1;1;2;8;1;2;195;10;10;1;0;0;2;3;195;0;336;3;2;0
/org.eclipse.jdt.ui/ui/org/eclipse/jdt/internal/ui/text/javadoc/ILinkTagConstants.java;2;0;2;1;1;1;1;1;6;0;1;212;6;6;1;0;0;1;2;212;0;336;2;2;0
/org.eclipse.pde.ui/src/org/eclipse/pde/internal/ui/editor/site/SiteInputContext.java;3;2;4;2;4;3;4;0;8;0;0;292;14;14;2;0;1;0;4;301;1;336;3;3;0
/org.eclipse.core.resources/src/org/eclipse/core/internal/resources/MarkerSnapshotReader.java;1;0;1;1;1;1;1;0;57;0;0;277;57;57;1;0;0;0;1;277;0;277;1;1;0
/org.eclipse.jdt.debug/model/org/eclipse/jdt/debug/core/IJavaStackFrame.java;3;0;4;1;1;1;1;3;41;1;3;53;82;82;1;0;0;3;4;53;0;336;4;3;0
/org.eclipse.update.core/src/org/eclipse/update/internal/core/SiteURLFactory.java;2;1;4;1;2;2;2;2;10;1;2;58;23;23;1;0;0;2;4;58;0;336;4;2;0
/org.eclipse.core.resources/src/org/eclipse/core/resources/WorkspaceLock.java;2;0;3;1;1;1;1;2;98;1;2;90;139;139;1;0;0;2;3;90;0;277;3;2;0
/org.eclipse.jdt.core/model/org/eclipse/jdt/core/compiler/ITerminalSymbols.java;1;0;2;1;0;0;0;2;247;1;2;199;249;249;1;0;0;2;2;199;0;264;2;1;0
/org.eclipse.team.cvs.ui/src/org/eclipse/team/internal/ccvs/ui/CommitCommentArea.java;2;3;10;2;5;2;5;5;67;2;4;63;118;118;3;1;3;5;10;324;4;324;6;2;0
/org.eclipse.jdt.ui/ui/org/eclipse/jdt/internal/ui/text/spelling/JavaDocTagDictionary.java;2;0;2;1;1;1;1;1;2;0;1;219;2;2;1;0;0;1;2;219;0;336;2;2;0
/org.eclipse.ui.workbench/Eclipse UI/org/eclipse/ui/internal/registry/WorkingSetRegistryReader.java;3;0;3;1;1;1;1;2;14;1;2;196;18;18;1;0;0;2;3;196;0;336;3;3;0
/org.eclipse.jdt.ui/ui/org/eclipse/jdt/internal/ui/text/java/OverrideCompletionProposal.java;2;1;2;1;2;2;2;0;2;0;0;294;2;2;1;0;0;0;2;294;0;336;2;2;0
/org.eclipse.jdt.ui/ui/org/eclipse/jdt/ui/search/IMatchPresentation.java;2;2;4;2;4;3;4;0;28;0;0;279;34;34;2;0;1;0;4;335;1;335;3;2;0
/org.eclipse.team.ui/src/org/eclipse/team/internal/ui/synchronize/DiffNodeWorkbenchAdapter.java;1;0;5;1;1;1;1;4;64;2;2;226;76;76;2;2;0;4;5;226;2;336;3;1;0
/org.eclipse.ant.ui/Ant Editor/org/eclipse/ant/internal/ui/editor/formatter/XmlTagFormatter.java;1;1;4;1;3;3;3;1;18;0;1;251;33;33;1;0;0;1;4;251;0;312;4;1;1
/org.eclipse.search/search/org/eclipse/search/internal/core/text/AmountOfWorkCalculator.java;2;1;2;1;2;2;2;0;16;0;0;312;18;18;1;0;0;0;2;312;0;336;2;2;0
/org.eclipse.jdt.ui/ui/org/eclipse/jdt/internal/ui/search/JavaElementLine.java;1;0;1;1;0;0;0;1;0;0;1;266;0;0;1;0;0;1;1;266;0;266;1;1;0
/org.eclipse.jdt.core/model/org/eclipse/jdt/core/util/IRuntimeVisibleParameterAnnotationsAttribute.java;2;0;2;1;0;0;0;2;36;1;2;245;36;36;1;0;0;2;2;245;0;264;2;2;0
/org.eclipse.swt/Eclipse SWT/win32/org/eclipse/swt/widgets/MenuItem.java;4;4;17;2;7;3;7;10;69;2;7;19;297;297;4;3;4;10;17;292;7;336;10;4;0
/org.eclipse.jdt.ui/ui/org/eclipse/jdt/internal/ui/text/comment/SingleCommentLine.java;2;0;7;1;1;1;1;6;102;4;3;97;148;148;4;3;0;6;7;119;3;336;4;2;0
/org.eclipse.swt/Eclipse SWT Program/gnome/org/eclipse/swt/internal/gnome/GnomeVFSMimeApplication.java;2;0;2;1;1;1;1;1;2;0;1;238;2;2;1;0;0;1;2;238;0;337;2;2;0
/org.eclipse.ui.workbench/Eclipse UI/org/eclipse/ui/internal/activities/ws/EnablementDialog.java;1;0;2;1;2;1;2;0;149;0;0;283;149;149;2;0;1;0;2;283;1;283;1;1;1
/org.eclipse.swt/Eclipse SWT/carbon/org/eclipse/swt/widgets/Decorations.java;5;1;8;2;3;3;3;5;61;2;4;8;116;116;2;1;0;5;8;8;1;337;7;5;2
/org.eclipse.jface/src/org/eclipse/jface/wizard/WizardSelectionPage.java;1;0;1;1;0;0;0;1;2;0;1;116;2;2;1;0;0;1;1;116;0;116;1;1;0
/org.eclipse.osgi/core/framework/org/eclipse/osgi/framework/internal/core/Framework.java;7;4;38;6;7;3;15;23;1097;12;7;171;2303;2303;12;16;12;31;38;265;28;326;10;7;0
/org.eclipse.pde.ui/src/org/eclipse/pde/internal/ui/wizards/templates/ViewTemplate.java;3;2;12;2;4;3;4;8;144;3;6;26;199;199;3;2;1;8;12;128;3;336;9;3;0
/org.eclipse.update.ui/src/org/eclipse/update/internal/ui/preferences/MainPreferencePage.java;3;1;10;3;3;3;3;7;428;5;2;32;621;621;5;5;0;7;10;51;5;336;5;3;2
/org.eclipse.pde.ui/src/org/eclipse/pde/internal/ui/editor/TreeSection.java;1;1;2;1;2;2;2;0;16;0;0;292;20;20;1;0;0;0;2;292;0;336;2;1;0
/org.eclipse.jdt.core/model/org/eclipse/jdt/internal/compiler/parser/SourceTypeConverter.java;3;1;3;1;2;2;2;1;8;0;1;245;10;10;1;0;0;1;3;245;0;323;3;3;2
/org.eclipse.core.resources/src/org/eclipse/core/internal/dtree/IDataFlattener.java;1;0;1;1;1;1;1;0;44;0;0;277;44;44;1;0;0;0;1;277;0;277;1;1;0
/org.eclipse.update.core/src/org/eclipse/update/internal/core/ConfiguredSite.java;3;2;14;2;5;3;5;9;222;3;7;58;569;569;3;2;2;9;14;191;4;336;10;3;0
/org.eclipse.ui.ide/extensions/org/eclipse/ui/model/WorkbenchContentProvider.java;2;0;2;1;0;0;0;2;56;1;2;150;58;58;1;0;0;2;2;150;0;166;2;2;2
/org.eclipse.jdt.core/model/org/eclipse/jdt/internal/core/util/ExceptionTableEntry.java;1;0;1;1;0;0;0;1;2;0;1;199;2;2;1;0;0;1;1;199;0;199;1;1;0
/org.eclipse.pde.core/src/org/eclipse/pde/internal/core/schema/SchemaInclude.java;3;1;4;1;2;2;2;2;8;1;2;232;22;22;1;0;0;2;4;232;0;336;4;3;0
/org.eclipse.ui.workbench/Eclipse UI/org/eclipse/ui/internal/ObjectActionContributorReader.java;3;0;3;1;1;1;1;2;7;1;2;214;11;11;1;0;0;2;3;214;0;336;3;3;0
/org.eclipse.pde.ui/src_Forms/org/eclipse/pde/internal/ui/model/IDocumentKey.java;2;3;5;1;5;3;5;0;10;0;0;285;23;23;3;0;2;0;5;285;2;336;3;2;0
/org.eclipse.ui.workbench/Eclipse UI/org/eclipse/ui/internal/keys/OutOfOrderVerifyListener.java;2;0;4;1;1;1;1;3;14;1;3;171;15;15;1;0;0;3;4;171;0;336;4;2;0
/org.eclipse.swt/Eclipse SWT PI/common_j2me/org/eclipse/swt/internal/Library.java;5;0;62;3;7;1;15;47;41;18;5;16;143;143;18;42;14;55;62;214;56;320;6;5;0
/org.eclipse.jdt.debug.ui/ui/org/eclipse/jdt/internal/debug/core/refactoring/RefactoringMessages.java;2;0;2;1;1;1;1;1;11;0;1;224;11;11;1;0;0;1;2;224;0;336;2;2;0
/org.eclipse.pde/src/org/eclipse/pde/internal/builders/ValidatingSAXParser.java;1;0;4;1;1;1;1;3;88;2;2;166;106;106;2;1;0;3;4;166;1;336;3;1;0
/org.eclipse.ui.externaltools/External Tools Base/org/eclipse/ui/externaltools/internal/model/ExternalToolsPlugin.java;3;2;9;2;3;2;3;6;51;2;4;20;123;123;2;2;1;6;9;20;3;324;6;3;1
/org.eclipse.ui.workbench/Eclipse UI/org/eclipse/ui/actions/ActionGroup.java;2;1;2;1;2;2;2;0;13;0;0;277;15;15;1;0;0;0;2;277;0;336;2;2;0
/org.eclipse.update.core/src/org/eclipse/update/core/Import.java;3;1;5;1;3;3;3;2;6;1;2;0;21;21;1;0;0;2;5;0;0;336;5;3;0
/org.eclipse.debug.core/core/org/eclipse/debug/internal/core/StreamsProxy.java;1;0;1;1;0;0;0;1;16;0;1;115;16;16;1;0;0;1;1;115;0;115;1;1;0
/org.eclipse.swt/Eclipse SWT/common/org/eclipse/swt/internal/image/LZWCodec.java;3;0;4;1;1;1;1;3;29;2;2;226;35;35;2;1;0;3;4;226;1;337;3;3;0
/org.eclipse.jdt.ui/ui/org/eclipse/jdt/ui/actions/FindReadReferencesAction.java;2;0;2;1;1;1;1;1;5;0;1;184;7;7;1;0;0;1;2;184;0;336;2;2;0
/org.eclipse.jdt.core/model/org/eclipse/jdt/internal/core/SourceField.java;2;0;10;1;2;1;2;8;56;1;8;59;117;117;2;0;1;8;10;299;1;299;9;2;0
/org.eclipse.jdt.ui/core refactoring/org/eclipse/jdt/internal/corext/refactoring/code/flow/ForFlowInfo.java;1;0;1;1;1;1;1;0;2;0;0;336;2;2;1;0;0;0;1;336;0;336;1;1;0
/org.eclipse.core.runtime/src/org/eclipse/core/runtime/jobs/JobChangeAdapter.java;3;0;8;2;2;1;2;6;259;3;3;46;354;354;3;3;1;6;8;171;4;274;4;3;0
/org.eclipse.pde.ui/src/org/eclipse/pde/internal/ui/wizards/WizardNode.java;2;1;2;1;2;2;2;0;6;0;0;308;10;10;1;0;0;0;2;308;0;336;2;2;0
/org.eclipse.team.cvs.ui/src/org/eclipse/team/internal/ccvs/ui/subscriber/MergeUpdateAction.java;2;1;21;2;2;2;2;19;355;5;8;48;1076;1076;5;11;0;19;21;48;11;336;10;2;0
/org.eclipse.team.cvs.ui/src/org/eclipse/team/internal/ccvs/ui/WorkingSetSelectionArea.java;2;0;6;2;1;1;1;5;13;2;4;20;39;39;2;1;0;5;6;63;1;336;5;2;1
/org.eclipse.jdt.ui/ui/org/eclipse/jdt/internal/ui/search/JavaSearchTableContentProvider.java;2;3;6;1;4;2;4;2;52;1;2;207;59;59;3;0;2;2;6;287;2;336;4;2;0
/org.eclipse.core.resources/src/org/eclipse/core/internal/dtree/DataDeltaNode.java;1;0;1;1;1;1;1;0;202;0;0;277;202;202;1;0;0;0;1;277;0;277;1;1;0
/org.eclipse.jdt.ui/core refactoring/org/eclipse/jdt/internal/corext/refactoring/base/JavaStringStatusContext.java;2;0;4;1;1;1;1;3;9;1;3;57;12;12;1;0;0;3;4;57;0;336;4;2;0
/org.eclipse.ui.workbench/Eclipse UI/org/eclipse/ui/IActionBars.java;1;0;1;1;0;0;0;1;2;0;1;0;2;2;1;0;0;1;1;0;0;0;1;1;0
/org.eclipse.ui.ide/src/org/eclipse/ui/views/navigator/FilterSelectionAction.java;1;0;1;1;0;0;0;1;0;0;1;129;0;0;1;0;0;1;1;129;0;129;1;1;0
/org.eclipse.ltk.ui.refactoring/src/org/eclipse/ltk/internal/ui/refactoring/AssertionFailedException.java;1;0;3;1;1;1;2;1;5;0;1;269;7;7;2;0;1;2;3;269;1;336;2;1;0
/org.eclipse.ltk.core.refactoring/src/org/eclipse/ltk/core/refactoring/RefactoringCore.java;1;0;5;1;2;1;2;3;34;0;1;264;43;43;3;2;1;3;5;264;3;278;2;1;0
/org.eclipse.pde.runtime/src/org/eclipse/pde/internal/runtime/registry/ExtensionPropertySource.java;2;1;5;1;2;2;2;3;96;2;2;59;211;211;2;1;0;3;5;224;1;336;4;2;0
/org.eclipse.jface/src/org/eclipse/jface/preference/ColorSelector.java;3;1;5;2;2;2;2;3;164;2;2;81;293;293;2;1;0;3;5;180;1;336;4;3;0
/org.eclipse.ui.cheatsheets/src/org/eclipse/ui/internal/cheatsheets/data/Intro.java;1;0;1;1;1;1;1;0;0;0;0;279;0;0;1;0;0;0;1;279;0;279;1;1;0
/org.eclipse.ui.workbench.texteditor/src/org/eclipse/ui/texteditor/StatusTextEditor.java;2;0;3;1;1;1;1;2;20;1;2;149;29;29;1;0;0;2;3;149;0;336;3;2;0
/org.eclipse.swt/Eclipse SWT/win32/org/eclipse/swt/widgets/Scrollable.java;2;1;3;1;2;2;2;1;4;0;1;19;12;12;1;0;0;1;3;19;0;337;3;2;0
/org.eclipse.jface.text/src/org/eclipse/jface/text/formatter/FormattingContext.java;2;0;3;1;1;1;1;2;132;0;1;119;138;138;2;1;0;2;3;119;1;336;2;2;0
/org.eclipse.pde.ui/src/org/eclipse/pde/internal/ui/wizards/feature/OpenProjectWizardAction.java;3;1;4;1;4;4;4;0;10;0;0;289;18;18;1;0;0;0;4;289;0;336;4;3;0
/org.eclipse.ui.forms/src/org/eclipse/ui/internal/forms/widgets/FormTextModel.java;1;2;4;1;4;3;4;0;81;0;0;272;85;85;2;0;1;0;4;282;1;336;3;1;0
/org.eclipse.update.core/src/org/eclipse/update/operations/IUnconfigFeatureOperation.java;1;1;6;1;2;2;2;4;13;1;4;54;22;22;1;0;0;4;6;54;0;336;6;1;0
/org.eclipse.core.resources/src/org/eclipse/core/internal/resources/ProjectDescriptionReader.java;3;0;7;2;2;1;2;5;52;2;4;90;95;95;2;1;1;5;7;115;2;277;5;3;0
/org.eclipse.osgi/resolver/src/org/eclipse/osgi/internal/resolver/StateObjectFactoryImpl.java;4;0;14;2;0;0;5;9;175;6;5;171;258;258;6;4;5;14;14;269;9;269;5;4;0
/org.eclipse.ui.workbench/Eclipse UI/org/eclipse/ui/internal/dialogs/SelectPerspectiveDialog.java;5;1;9;3;2;2;2;7;405;2;6;116;605;605;2;1;0;7;9;174;1;336;8;5;0
/org.eclipse.pde.runtime/src/org/eclipse/pde/internal/runtime/logview/EventDetailsDialogAction.java;2;2;5;1;3;2;3;2;35;1;2;232;43;43;2;0;1;2;5;309;1;336;4;2;0
/org.eclipse.debug.ui/ui/org/eclipse/debug/internal/ui/stringsubstitution/ProjectResolver.java;2;0;3;1;0;0;0;3;16;2;2;121;20;20;2;1;0;3;3;121;1;141;2;2;0
/org.eclipse.pde.ui/src/org/eclipse/pde/internal/ui/launcher/JUnitWorkbenchShortcut.java;2;1;9;1;2;2;2;7;110;2;4;95;205;205;2;3;0;7;9;95;3;308;6;2;0
/org.eclipse.ui.forms/src/org/eclipse/ui/internal/forms/widgets/TextSegment.java;1;1;2;1;2;2;2;0;4;0;0;272;4;4;1;0;0;0;2;272;0;336;2;1;0
/org.eclipse.jdt.ui/ui/org/eclipse/jdt/internal/ui/search/ParentNameSorter.java;3;1;3;1;2;2;2;1;35;0;1;183;39;39;1;0;0;1;3;183;0;336;3;3;0
/org.eclipse.ui.workbench/Eclipse UI/org/eclipse/ui/internal/dialogs/WorkbenchDialogBlockedHandler.java;1;3;4;1;4;2;4;0;34;0;0;288;58;58;3;0;2;0;4;288;2;320;2;1;0
/org.eclipse.jdt.core/model/org/eclipse/jdt/internal/core/CreateTypeMemberOperation.java;3;0;6;1;1;1;1;5;23;1;5;27;43;43;1;0;0;5;6;27;0;299;6;3;0
/org.eclipse.swt/Eclipse SWT Drag and Drop/carbon/org/eclipse/swt/dnd/ByteArrayTransfer.java;1;0;2;1;0;0;0;2;43;0;1;21;43;43;2;1;0;2;2;21;1;21;1;1;0
/org.eclipse.help.ui/src/org/eclipse/help/ui/internal/browser/embedded/EmbeddedBrowserFactory.java;1;2;13;1;4;3;4;9;53;5;3;165;119;119;5;6;1;9;13;165;7;336;6;1;0
/org.eclipse.help.webapp/src_servlets/org/eclipse/help/internal/webapp/servlet/WebappWorkingSetManager.java;1;1;8;1;3;3;3;5;123;2;3;26;205;205;2;2;0;5;8;26;2;336;6;1;0
/org.eclipse.jdt.ui/core refactoring/org/eclipse/jdt/internal/corext/refactoring/changes/TextChangeCompatibility.java;1;0;2;1;0;0;0;2;4;1;2;204;5;5;1;0;0;2;2;204;0;253;2;1;0
/org.eclipse.team.cvs.core/src/org/eclipse/team/internal/ccvs/core/ICVSResource.java;1;0;2;1;0;0;0;2;16;0;1;119;16;16;2;1;0;2;2;119;1;119;1;1;0
/org.eclipse.ui.workbench/Eclipse UI/org/eclipse/ui/internal/presentations/SystemMenuMovePane.java;1;1;3;1;3;3;3;0;3;0;0;279;5;5;1;0;0;0;3;279;0;309;3;1;0
/org.eclipse.core.filebuffers/src/org/eclipse/core/internal/filebuffers/JavaFileBuffer.java;3;1;6;2;2;2;2;4;20;2;3;130;40;40;2;1;0;4;6;130;1;336;5;3;0
/org.eclipse.update.core/src/org/eclipse/update/internal/mirror/MirrorCommand.java;2;1;11;2;2;2;2;9;85;4;4;96;178;178;4;5;0;9;11;96;5;336;6;2;0
/org.eclipse.help.webapp/src_servlets/org/eclipse/help/internal/webapp/data/RequestData.java;1;2;8;1;4;3;4;4;42;2;3;7;85;85;2;1;1;4;8;7;2;332;6;1;1
/org.eclipse.ui.workbench/Eclipse UI/org/eclipse/ui/contexts/IContext.java;4;1;19;2;2;2;2;17;253;11;6;70;652;652;11;11;0;17;19;70;11;336;8;4;0
/org.eclipse.text/src/org/eclipse/text/edits/UndoEdit.java;2;0;4;1;1;1;1;3;14;2;2;121;26;26;2;1;0;3;4;121;1;336;3;2;0
/org.eclipse.ui.workbench/Eclipse UI/org/eclipse/ui/internal/util/OldConfigurationElementMemento.java;2;0;3;1;0;0;0;3;42;1;3;139;43;43;1;0;0;3;3;139;0;179;3;2;0
/org.eclipse.jdt.debug/model/org/eclipse/jdt/internal/debug/core/model/JDIThread.java;5;3;27;3;5;3;5;22;132;4;13;13;638;638;4;9;2;22;27;53;11;336;16;5;4
/org.eclipse.team.ui/src/org/eclipse/team/internal/ui/UIProjectSetSerializationContext.java;2;1;3;1;3;3;3;0;4;0;0;288;7;7;1;0;0;0;3;288;0;314;3;2;0
/org.eclipse.jdt.launching.macosx/macosx/org/eclipse/jdt/internal/ui/macbundler/BundleWizardBasePage.java;1;0;1;1;0;0;0;1;0;0;1;203;0;0;1;0;0;1;1;203;0;203;1;1;0
/org.eclipse.ui.ide/src/org/eclipse/ui/wizards/datatransfer/FileSystemExporter.java;3;0;3;1;1;1;1;2;2;1;2;92;4;4;1;0;0;2;3;92;0;336;3;3;0
/org.eclipse.pde.ui/src/org/eclipse/pde/internal/ui/parts/WizardCheckboxTablePart.java;2;1;4;1;3;3;3;1;12;0;1;153;28;28;1;0;0;1;4;153;0;336;4;2;0
/org.eclipse.core.runtime.compatibility/src-boot/org/eclipse/core/internal/boot/SitePolicy.java;3;1;4;2;2;2;2;2;9;0;1;171;15;15;2;1;0;2;4;171;1;336;3;3;0
/org.eclipse.debug.ui/ui/org/eclipse/debug/internal/ui/views/memory/BasicDebugViewContentProvider.java;2;0;2;2;2;1;2;0;16;0;0;282;16;16;2;0;1;0;2;282;1;282;1;2;1
/org.eclipse.pde.core/src/org/eclipse/pde/internal/core/feature/AbstractFeatureModel.java;3;1;8;2;3;3;3;5;34;3;3;166;49;49;3;2;0;5;8;166;2;336;6;3;0
/org.eclipse.jdt.core/model/org/eclipse/jdt/core/util/CompilationUnitSorter.java;2;0;4;1;0;0;0;4;5;2;3;107;8;8;2;1;0;4;4;194;1;221;3;2;0
/org.eclipse.core.resources/src/org/eclipse/core/internal/events/ResourceDeltaInfo.java;1;0;1;1;1;1;1;0;75;0;0;277;75;75;1;0;0;0;1;277;0;277;1;1;0
/org.eclipse.jdt.core/compiler/org/eclipse/jdt/internal/compiler/parser/diagnose/DiagnoseParser.java;4;3;14;3;4;2;4;10;130;4;5;51;260;260;4;5;2;10;14;66;7;315;7;4;0
/org.eclipse.ui.ide/src/org/eclipse/ui/internal/ide/dialogs/WelcomeEditorInputFactory.java;2;1;5;1;2;2;2;3;44;2;2;132;51;51;2;1;0;3;5;154;1;336;4;2;0
/org.eclipse.debug.ui/ui/org/eclipse/debug/internal/ui/sourcelookup/WorkingSetSourceContainerType.java;1;0;2;1;1;1;1;1;2;0;1;269;2;2;1;0;0;1;2;269;0;309;2;1;1
/org.eclipse.pde.ui/src/org/eclipse/pde/internal/ui/editor/feature/RequiredFeaturesWizardPage.java;3;1;5;1;3;3;3;2;31;1;2;130;67;67;1;0;0;2;5;130;0;336;5;3;0
/org.eclipse.ui.intro/src/org/eclipse/ui/internal/intro/impl/model/AbstractIntroContainer.java;1;9;13;1;13;3;13;0;292;0;0;276;385;385;9;0;10;0;13;276;10;328;3;1;0
/org.eclipse.team.ui/src/org/eclipse/team/internal/ui/Policy.java;1;0;4;1;1;1;1;3;25;1;3;59;47;47;1;0;0;3;4;59;0;336;4;1;0
/org.eclipse.jdt.junit/src/org/eclipse/jdt/internal/junit/util/CheckedTableSelectionDialog.java;1;0;1;1;1;1;1;0;2;0;0;336;2;2;1;0;0;0;1;336;0;336;1;1;0
/org.eclipse.jdt.core/model/org/eclipse/jdt/internal/core/util/ICacheEnumeration.java;1;0;1;1;0;0;0;1;2;0;1;199;2;2;1;0;0;1;1;199;0;199;1;1;0
/org.eclipse.jdt.debug/jdi/org/eclipse/jdi/internal/VoidValueImpl.java;1;0;1;1;0;0;0;1;3;0;1;144;3;3;1;0;0;1;1;144;0;144;1;1;0
/org.eclipse.jdt.ui/core refactoring/org/eclipse/jdt/internal/corext/refactoring/code/LocalTypeAnalyzer.java;2;0;3;1;1;1;1;2;6;1;2;187;10;10;1;0;0;2;3;187;0;336;3;2;0
/org.eclipse.jdt.ui/core extension/org/eclipse/jdt/internal/corext/javadoc/JavaDocAccess.java;2;0;5;2;1;1;1;4;43;2;3;126;86;86;2;1;0;4;5;219;1;336;4;2;0
/org.eclipse.jdt.ui/ui/org/eclipse/jdt/internal/ui/util/JavadocHelpContext.java;2;0;3;1;1;1;1;2;22;1;2;121;26;26;1;0;0;2;3;121;0;336;3;2;0
/org.eclipse.jdt.core/model/org/eclipse/jdt/core/util/IConstantPoolConstant.java;1;0;1;1;0;0;0;1;2;0;1;199;2;2;1;0;0;1;1;199;0;199;1;1;0
/org.eclipse.jdt.ui/ui/org/eclipse/jdt/internal/ui/text/spelling/engine/ISpellChecker.java;3;1;4;2;2;2;2;2;6;0;1;219;12;12;2;1;0;2;4;219;1;336;3;3;0
/org.eclipse.text/src/org/eclipse/text/edits/ISourceModifier.java;2;0;3;1;1;1;1;2;15;0;1;118;17;17;2;1;0;2;3;118;1;336;2;2;0
/org.eclipse.swt/Eclipse SWT Drag and Drop/gtk/org/eclipse/swt/dnd/DropTarget.java;4;0;9;1;1;1;1;8;507;2;7;0;609;609;2;1;0;8;9;29;1;337;8;4;0
/org.eclipse.compare/compare/org/eclipse/compare/internal/CompareEditor.java;1;0;5;1;1;1;1;4;71;2;3;60;113;113;2;1;0;4;5;75;1;326;4;1;0
/org.eclipse.debug.ui/ui/org/eclipse/debug/internal/ui/views/memory/SynchronizeInfo.java;2;2;3;2;3;2;3;0;8;0;0;282;11;11;2;0;1;0;3;282;1;294;2;2;2
/org.eclipse.pde.core/src/org/eclipse/pde/internal/core/plugin/ExternalFragmentModel.java;3;1;4;1;2;2;2;2;38;1;2;184;46;46;1;0;0;2;4;184;0;336;4;3;0
/org.eclipse.swt/Eclipse SWT Mozilla/win32/org/eclipse/swt/internal/mozilla/GRE.java;1;0;1;1;0;0;0;1;0;0;1;100;0;0;1;0;0;1;1;100;0;100;1;1;0
/org.eclipse.team.cvs.core/src/org/eclipse/team/internal/ccvs/core/util/BuildCleanupListener.java;2;1;4;1;2;2;2;2;14;1;2;122;28;28;1;0;0;2;4;122;0;336;4;2;0
/org.eclipse.swt/Eclipse SWT Drag and Drop/win32/org/eclipse/swt/dnd/Clipboard.java;3;0;8;2;3;1;3;5;228;2;4;22;477;477;3;1;2;5;8;329;3;329;5;3;2
/org.eclipse.help.base/src/org/eclipse/help/internal/browser/macosx/DefaultBrowserAdapter.java;1;1;5;1;3;3;3;2;47;1;2;104;91;91;1;0;0;2;5;104;0;336;5;1;0
/org.eclipse.swt/Eclipse SWT/win32/org/eclipse/swt/widgets/TableItem.java;4;4;29;3;9;5;9;20;308;6;7;2;999;999;6;13;4;20;29;232;17;337;12;4;2
/org.eclipse.swt/Eclipse SWT PI/gtk/org/eclipse/swt/internal/gtk/XExposeEvent.java;2;1;2;1;2;2;2;0;4;0;0;293;4;4;1;0;0;0;2;293;0;337;2;2;0
/org.eclipse.jdt.ui/ui/org/eclipse/jdt/internal/ui/callhierarchy/FiltersDialog.java;2;0;5;1;1;1;1;4;190;0;1;13;192;192;4;3;0;4;5;13;3;336;2;2;0
/org.eclipse.jdt.core/compiler/org/eclipse/jdt/internal/compiler/lookup/ArrayBinding.java;2;0;5;1;1;1;1;4;16;1;4;37;40;40;1;0;0;4;5;37;0;299;5;2;2
/org.eclipse.ui.ide/extensions/org/eclipse/ui/IMarkerResolution.java;1;0;1;1;0;0;0;1;0;0;1;132;0;0;1;0;0;1;1;132;0;132;1;1;0
/org.eclipse.team.cvs.core/src/org/eclipse/team/internal/ccvs/core/client/listeners/DiffListener.java;1;0;2;1;1;1;1;1;14;0;1;232;16;16;1;0;0;1;2;232;0;336;2;1;0
/org.eclipse.jdt.ui/ui refactoring/org/eclipse/jdt/internal/ui/refactoring/reorg/RenameUserInterfaceManager.java;1;0;1;1;0;0;0;1;0;0;1;247;0;0;1;0;0;1;1;247;0;247;1;1;0
/org.eclipse.text/src/org/eclipse/jface/text/Line.java;1;0;1;1;1;1;1;0;7;0;0;334;7;7;1;0;0;0;1;334;0;334;1;1;0
/org.eclipse.jdt.ui/ui/org/eclipse/jdt/internal/ui/search/OccurrencesSearchResult.java;2;1;4;1;2;2;2;2;40;0;1;266;59;59;2;1;0;2;4;266;1;311;3;2;0
/org.eclipse.ant.ui/Ant Tools Support/org/eclipse/ant/internal/ui/views/elements/AntNode.java;1;0;1;1;0;0;0;1;0;0;1;108;0;0;1;0;0;1;1;108;0;108;1;1;1
/org.eclipse.ui.editors/src/org/eclipse/ui/internal/editors/text/StatusInfo.java;2;1;4;1;2;2;2;2;31;0;1;202;39;39;2;1;0;2;4;202;1;336;3;2;0
/org.eclipse.team.cvs.ui/src/org/eclipse/team/internal/ccvs/ui/operations/HasProjectMetaFileOperation.java;2;0;8;2;1;1;1;7;92;2;6;20;142;142;2;1;0;7;8;68;1;336;7;2;0
/org.eclipse.ui.ide/src/org/eclipse/ui/wizards/datatransfer/WizardZipFileResourceImportPage1.java;1;0;1;1;0;0;0;1;0;0;1;92;0;0;1;0;0;1;1;92;0;92;1;1;0
/org.eclipse.update.configurator/src/org/eclipse/update/internal/configurator/SiteEntry.java;2;4;21;2;7;4;8;13;736;7;3;183;1090;1090;7;10;4;14;21;227;14;331;7;2;0
/org.eclipse.jdt.debug/jdi interfaces/com/sun/jdi/connect/IllegalConnectorArgumentsException.java;2;0;2;2;0;0;0;2;14;0;1;79;14;14;2;1;0;2;2;79;1;79;1;2;0
/org.eclipse.ui.forms/src/org/eclipse/ui/forms/events/HyperlinkEvent.java;1;1;5;1;2;2;2;3;47;2;2;225;71;71;2;1;0;3;5;225;1;336;4;1;0
/org.eclipse.ui.workbench/Eclipse UI/org/eclipse/ui/internal/decorators/DeclarativeDecorator.java;4;0;3;2;1;1;1;2;42;1;2;223;59;59;1;0;0;2;3;223;0;336;3;4;0
/org.eclipse.ui.workbench/Eclipse UI/org/eclipse/ui/internal/ViewIntroAdapterPart.java;1;0;9;1;3;1;3;6;74;2;5;203;150;150;3;1;2;6;9;289;3;289;6;1;2
/org.eclipse.ui.workbench/Eclipse UI/org/eclipse/ui/internal/progress/BlockedJobsDialog.java;4;12;21;4;16;2;16;5;521;2;3;208;1004;1004;12;2;14;5;21;274;16;313;5;4;2
/org.eclipse.core.resources/src_ant/org/eclipse/core/resources/ant/RefreshLocalTask.java;2;0;3;1;2;1;2;1;134;0;1;13;136;136;2;0;1;1;3;274;1;274;2;2;0
/org.eclipse.ui.workbench/Eclipse UI/org/eclipse/ui/internal/layout/CellData.java;1;0;1;1;1;1;1;0;0;0;0;271;0;0;1;0;0;0;1;271;0;271;1;1;0
/org.eclipse.osgi/resolver/src/org/eclipse/osgi/internal/resolver/StateWriter.java;4;0;11;2;0;0;4;7;37;5;4;171;53;53;5;3;4;11;11;269;7;269;4;4;0
/org.eclipse.core.expressions/src/org/eclipse/core/internal/expressions/ExpressionPlugin.java;1;0;3;1;1;1;1;2;29;1;2;227;31;31;1;0;0;2;3;227;0;289;3;1;0
/org.eclipse.team.cvs.ui/src/org/eclipse/team/internal/ccvs/ui/operations/ReconcileProjectOperation.java;2;1;9;2;2;2;2;7;256;6;2;184;270;270;6;5;0;7;9;232;5;336;4;2;0
/org.eclipse.swt/Eclipse SWT Drag and Drop/carbon/org/eclipse/swt/dnd/DropTarget.java;2;0;8;2;0;0;0;8;1134;7;2;0;1138;1138;7;6;0;8;8;19;6;19;2;2;0
/org.eclipse.jdt.ui/core refactoring/org/eclipse/jdt/internal/corext/refactoring/structure/ExtractInterfaceUtil.java;5;3;22;2;5;3;5;17;356;3;8;73;735;735;3;9;2;17;22;73;11;336;11;5;0
/org.eclipse.ui.workbench/Eclipse UI/org/eclipse/ui/internal/commands/KeySequenceBinding.java;3;1;6;1;2;2;2;4;39;1;4;148;64;64;1;0;0;4;6;148;0;336;6;3;0
/org.eclipse.pde.ui/src/org/eclipse/pde/internal/ui/editor/plugin/LibrarySection.java;3;5;7;3;7;2;7;0;36;0;0;292;45;45;5;0;5;0;7;292;5;331;2;3;0
/org.eclipse.jdt.junit/src/org/eclipse/jdt/internal/junit/ui/CopyFailureListAction.java;3;1;5;1;2;2;2;3;5;1;3;19;13;13;1;0;0;3;5;19;0;336;5;3;0
/org.eclipse.pde.ui/src/org/eclipse/pde/internal/ui/editor/feature/PortabilityChoiceCellEditor.java;2;1;3;1;2;2;2;1;6;0;1;232;14;14;1;0;0;1;3;232;0;336;3;2;0
/org.eclipse.ui.workbench/Eclipse UI/org/eclipse/ui/internal/dialogs/WorkbenchWizardListSelectionPage.java;4;1;6;1;2;2;2;4;520;1;4;157;813;813;1;0;0;4;6;157;0;336;6;4;1
/org.eclipse.team.cvs.core/src/org/eclipse/team/internal/ccvs/core/client/CheckoutWithOverwrite.java;1;0;1;1;0;0;0;1;0;0;1;102;0;0;1;0;0;1;1;102;0;102;1;1;0
/org.eclipse.update.ui/src/org/eclipse/update/ui/UpdateManagerUI.java;1;0;1;1;1;1;1;0;32;0;0;308;32;32;1;0;0;0;1;308;0;308;1;1;0
/org.eclipse.swt/Eclipse SWT/motif/org/eclipse/swt/widgets/Text.java;5;1;18;3;3;3;3;15;88;4;8;8;278;278;4;7;0;15;18;37;7;337;11;5;1
/org.eclipse.pde.core/src/org/eclipse/pde/internal/core/isite/ISiteArchive.java;2;1;3;1;2;2;2;1;4;0;1;232;10;10;1;0;0;1;3;232;0;336;3;2;0
/org.eclipse.jdt.core/search/org/eclipse/jdt/internal/core/search/processing/IJob.java;1;0;2;1;0;0;0;2;12;1;2;162;14;14;1;0;0;2;2;162;0;199;2;1;0
/org.eclipse.debug.ui/ui/org/eclipse/debug/internal/ui/views/memory/IMemoryBlockModelPresentation.java;1;0;1;1;1;1;1;0;0;0;0;282;0;0;1;0;0;0;1;282;0;282;1;1;1
/org.eclipse.search/search/org/eclipse/search/internal/core/text/FileMatchCollector.java;1;0;1;1;0;0;0;1;0;0;1;224;0;0;1;0;0;1;1;224;0;224;1;1;0
/org.eclipse.ant.ui/Ant Runner Support/org/eclipse/ant/internal/ui/antsupport/AntSupportMessages.java;1;0;1;1;0;0;0;1;0;0;1;108;0;0;1;0;0;1;1;108;0;108;1;1;0
/org.eclipse.jface.text/src/org/eclipse/jface/text/ISelectionValidator.java;2;0;3;2;2;1;2;1;16;0;1;265;16;16;2;0;1;1;3;336;1;336;2;2;0
/org.eclipse.jdt.core/compiler/org/eclipse/jdt/internal/compiler/ast/Statement.java;3;0;6;1;1;1;1;5;40;2;4;61;63;63;2;1;0;5;6;61;1;288;5;3;0
/org.eclipse.jdt.ui/ui/org/eclipse/jdt/internal/ui/packageview/SelectionTransferDropAdapter.java;3;1;9;1;3;3;3;6;448;2;5;10;543;543;2;1;0;6;9;70;1;336;8;3;0
/org.eclipse.ui.workbench/Eclipse UI/org/eclipse/ui/activities/ICategoryActivityBinding.java;3;1;5;1;2;2;2;3;6;1;3;165;14;14;1;0;0;3;5;165;0;336;5;3;0
/org.eclipse.jdt.core/dom/org/eclipse/jdt/core/dom/ArrayAccess.java;3;0;8;1;2;1;2;6;108;2;5;199;156;156;2;1;1;6;8;266;2;276;6;3;1
/org.eclipse.search/search/org/eclipse/search/internal/ui/text/ReplaceDialog.java;2;0;10;1;1;1;1;9;868;3;5;157;1128;1128;3;4;0;9;10;183;4;336;6;2;0
/org.eclipse.jdt.ui/ui refactoring/org/eclipse/jdt/internal/ui/refactoring/reorg/ReorgCopyWizard.java;4;1;9;1;2;2;3;6;13;2;5;70;43;43;2;1;1;7;9;70;2;336;7;4;0
/org.eclipse.jdt.ui/core refactoring/org/eclipse/jdt/internal/corext/refactoring/reorg/ParentChecker.java;2;0;3;1;1;1;1;2;8;0;1;70;10;10;2;1;0;2;3;70;1;336;2;2;0
/org.eclipse.jdt.ui/core refactoring/org/eclipse/jdt/internal/corext/refactoring/typeconstraints/ITypeConstraint.java;2;0;4;1;1;1;1;3;19;2;2;3;33;33;2;1;0;3;4;3;1;336;3;2;0
/org.eclipse.swt/Eclipse SWT/common/org/eclipse/swt/layout/FormAttachment.java;2;0;3;1;1;1;1;2;73;1;2;133;80;80;1;0;0;2;3;133;0;337;3;2;0
/org.eclipse.pde.ui/src/org/eclipse/pde/internal/ui/editor/PDEMultiPagePropertySheet.java;2;0;3;2;2;1;2;1;6;0;1;26;10;10;2;0;1;1;3;332;1;332;2;2;0
/org.eclipse.core.runtime/src/org/eclipse/core/internal/preferences/RootPreferences.java;2;2;10;2;4;3;4;6;130;3;2;239;227;227;3;4;1;6;10;239;5;298;5;2;1
/org.eclipse.update.core/src/org/eclipse/update/core/model/SiteModelFactory.java;2;2;5;1;3;2;3;2;13;1;2;58;37;37;2;0;1;2;5;290;1;336;4;2;0
/org.eclipse.pde.core/src/org/eclipse/pde/internal/core/ischema/IMetaAttribute.java;2;1;2;1;2;2;2;0;4;0;0;309;6;6;1;0;0;0;2;309;0;336;2;2;0
/org.eclipse.jdt.ui/ui/org/eclipse/jdt/internal/ui/jarpackager/JarPackageReader.java;1;1;4;1;2;2;2;2;12;1;2;18;26;26;1;0;0;2;4;18;0;336;4;1;0
/org.eclipse.core.runtime.compatibility/src-model/org/eclipse/core/runtime/model/PluginModelObject.java;3;1;5;1;3;3;3;2;23;1;2;171;32;32;1;0;0;2;5;171;0;336;5;3;0
/org.eclipse.ui.intro/src/org/eclipse/ui/internal/intro/impl/model/IntroText.java;1;7;11;1;11;2;11;0;68;0;0;276;78;78;7;0;9;0;11;296;9;296;2;1;0
/org.eclipse.pde.ui/src/org/eclipse/pde/internal/ui/editor/text/XMLTagScanner.java;3;1;4;1;2;2;2;2;30;1;2;211;38;38;1;0;0;2;4;211;0;336;4;3;0
/org.eclipse.jdt.ui/ui/org/eclipse/jdt/internal/ui/search/JavaSearchScopeFactory.java;3;2;16;2;6;4;6;10;115;6;4;82;329;329;6;6;2;10;16;93;8;336;8;3;0
/org.eclipse.swt/Eclipse SWT Mozilla/common/org/eclipse/swt/internal/mozilla/nsIObserverService.java;1;0;2;1;0;0;0;2;4;1;2;100;4;4;1;0;0;2;2;100;0;148;2;1;0
/org.eclipse.jdt.launching.macosx/macosx/org/eclipse/jdt/internal/ui/macbundler/BundleWizardPage1.java;1;0;2;1;0;0;0;2;13;0;1;203;13;13;2;1;0;2;2;203;1;203;1;1;0
/org.eclipse.pde.core/src/org/eclipse/pde/internal/core/feature/FeatureURL.java;2;1;3;1;2;2;2;1;8;0;1;232;19;19;1;0;0;1;3;232;0;336;3;2;0
/org.eclipse.pde.ui/src/org/eclipse/pde/internal/ui/editor/schema/SchemaInputContext.java;3;1;2;2;2;2;2;0;25;0;0;292;27;27;1;0;0;0;2;292;0;308;2;3;0
/org.eclipse.swt/Eclipse SWT PI/gtk/org/eclipse/swt/internal/accessibility/gtk/AtkHypertextIface.java;2;1;2;1;2;2;2;0;2;0;0;289;2;2;1;0;0;0;2;289;0;337;2;2;0
/org.eclipse.jdt.ui/core refactoring/org/eclipse/jdt/internal/corext/refactoring/surround/ExceptionAnalyzer.java;2;0;2;1;1;1;1;1;2;0;1;16;4;4;1;0;0;1;2;16;0;336;2;2;0
/org.eclipse.pde.ui/src/org/eclipse/pde/internal/ui/wizards/tools/UpdateBuildpathWizard.java;2;1;3;1;2;2;2;1;4;0;1;213;8;8;1;0;0;1;3;213;0;336;3;2;0
/org.eclipse.ui.console/src/org/eclipse/ui/internal/console/MessageConsolePage.java;3;0;9;1;1;1;1;8;17;2;7;118;74;74;2;1;0;8;9;118;1;336;8;3;0
/org.eclipse.jdt.debug.ui/ui/org/eclipse/jdt/internal/debug/ui/actions/ProjectSelectionDialog.java;2;0;1;2;1;1;1;0;43;0;0;293;43;43;1;0;0;0;1;293;0;293;1;2;0
/org.eclipse.core.expressions/src/org/eclipse/core/internal/expressions/Expressions.java;1;1;5;1;2;2;2;3;125;2;2;227;225;225;2;1;0;3;5;227;1;336;4;1;0
/org.eclipse.jdt.ui/ui/org/eclipse/jdt/internal/ui/preferences/JavaEditorHoverConfigurationBlock.java;1;7;15;1;11;3;11;4;385;1;4;41;519;519;7;0;8;4;15;287;8;336;7;1;1
/org.eclipse.jface/src/org/eclipse/jface/action/SubContributionManager.java;3;1;3;1;2;2;2;1;29;0;1;257;44;44;1;0;0;1;3;257;0;336;3;3;2
/org.eclipse.pde.ui/src_samples/org/eclipse/pde/ui/internal/samples/SampleWizard.java;3;3;10;2;6;3;6;4;191;0;1;248;248;248;4;3;3;4;10;248;6;332;4;3;0
/org.eclipse.team.cvs.ui/src/org/eclipse/team/internal/ccvs/ui/DateTagDialog.java;2;2;7;1;6;5;6;1;266;0;1;148;320;320;2;0;1;1;7;320;1;336;6;2;1
/org.eclipse.pde.ui/src/org/eclipse/pde/internal/ui/wizards/templates/PropertyPageNewWizard.java;3;2;5;1;4;3;4;1;12;0;1;222;31;31;2;0;1;1;5;308;1;336;4;3;0
/org.eclipse.ui.cheatsheets/src/org/eclipse/ui/internal/cheatsheets/views/CheatSheetEvent.java;2;0;2;2;0;0;0;2;55;1;2;243;55;55;1;0;0;2;2;243;0;253;2;2;0
/org.eclipse.ui.ide/src/org/eclipse/ui/views/tasklist/TaskList.java;5;1;8;2;3;3;3;5;22;2;4;129;72;72;2;1;0;5;8;129;1;336;7;5;0
/org.eclipse.debug.ui/ui/org/eclipse/debug/internal/ui/DebugPluginImages.java;4;3;27;3;5;2;5;22;83;5;8;38;187;187;5;14;3;22;27;38;17;293;10;4;1
/org.eclipse.ui.editors/src/org/eclipse/ui/editors/text/ITextEditorHelpContextIds.java;3;1;4;2;2;2;2;2;25;0;1;157;35;35;2;1;0;2;4;157;1;336;3;3;0
/org.eclipse.core.runtime/src/org/eclipse/core/runtime/IBundleGroup.java;3;0;10;3;1;1;3;7;45;4;4;205;96;96;4;3;2;9;10;266;5;297;5;3;0
/org.eclipse.pde.build/src/org/eclipse/pde/internal/build/SourceFeatureWriter.java;2;2;8;2;3;2;3;5;8;2;3;31;11;11;2;2;1;5;8;31;3;306;5;2;0
/org.eclipse.update.ui/src/org/eclipse/update/internal/ui/UpdateUIImages.java;3;2;12;2;3;2;3;9;195;3;5;15;377;377;3;4;1;9;12;254;5;336;7;3;0
/org.eclipse.jdt.core/dom/org/eclipse/jdt/internal/core/dom/rewrite/SourceModifier.java;3;1;3;1;2;2;2;1;53;0;1;262;57;57;1;0;0;1;3;262;0;336;3;3;0
/org.eclipse.core.variables/src/org/eclipse/core/internal/variables/ValueVariable.java;1;0;1;1;0;0;0;1;0;0;1;145;0;0;1;0;0;1;1;145;0;145;1;1;0
/org.eclipse.jdt.ui/ui/org/eclipse/jdt/internal/ui/text/java/ResultCollector.java;3;4;8;1;5;2;5;3;66;1;3;71;106;106;4;0;3;3;8;294;3;336;5;3;0
/org.eclipse.jdt.ui/ui/org/eclipse/jdt/ui/actions/MoveAction.java;3;1;10;1;2;2;2;8;197;2;5;9;317;317;2;3;0;8;10;9;3;336;7;3;0
/org.eclipse.ant.ui/Ant Tools Support/org/eclipse/ant/internal/ui/launchConfigurations/MessageIds.java;1;0;1;1;0;0;0;1;0;0;1;108;0;0;1;0;0;1;1;108;0;108;1;1;0
/org.eclipse.pde.ui/src/org/eclipse/pde/ui/templates/BooleanOption.java;2;1;3;1;3;3;3;0;66;0;0;276;116;116;1;0;0;0;3;276;0;336;3;2;0
/org.eclipse.core.runtime/src/org/eclipse/core/runtime/IProduct.java;2;0;8;2;1;1;3;5;41;3;3;205;113;113;3;2;2;7;8;205;4;314;4;2;0
/org.eclipse.jdt.ui/ui/org/eclipse/jdt/internal/ui/javaeditor/IJavaAnnotation.java;3;1;5;1;2;2;2;3;51;1;3;75;83;83;1;0;0;3;5;75;0;336;5;3;0
/org.eclipse.jdt.core/dom/org/eclipse/jdt/core/dom/DoStatement.java;3;0;9;1;2;1;2;7;110;2;6;164;166;166;2;1;1;7;9;266;2;276;7;3;1
/org.eclipse.ant.ui/Ant Tools Support/org/eclipse/ant/internal/ui/launchConfigurations/AntStreamMonitor.java;3;0;3;2;0;0;0;3;20;2;2;108;20;20;2;1;0;3;3;122;1;122;2;3;0
/org.eclipse.jdt.ui/ui/org/eclipse/jdt/internal/ui/ResourceLocator.java;1;0;2;1;1;1;1;1;4;0;1;200;6;6;1;0;0;1;2;200;0;336;2;1;0
/org.eclipse.ui.workbench/Eclipse UI/org/eclipse/ui/internal/decorators/DecoratorDefinition.java;2;0;3;1;1;1;1;2;8;1;2;41;13;13;1;0;0;2;3;41;0;336;3;2;0
/org.eclipse.help.webapp/src/org/eclipse/help/internal/webapp/HelpWebappPlugin.java;1;1;5;1;3;3;3;2;39;1;2;29;90;90;1;0;0;2;5;29;0;336;5;1;0
/org.eclipse.debug.ui/ui/org/eclipse/debug/internal/ui/views/memory/AbstractMemoryViewTab.java;1;0;1;1;1;1;1;0;0;0;0;282;0;0;1;0;0;0;1;282;0;282;1;1;1
/org.eclipse.jdt.ui/ui/org/eclipse/jdt/internal/ui/text/spelling/engine/IPhoneticHashProvider.java;2;0;2;1;1;1;1;1;2;0;1;219;2;2;1;0;0;1;2;219;0;336;2;2;0
/org.eclipse.core.runtime/src/org/eclipse/core/internal/runtime/SafeFileOutputStream.java;2;2;7;2;4;3;4;3;501;0;1;171;529;529;3;2;1;3;7;171;3;336;4;2;0
/org.eclipse.update.core/src/org/eclipse/update/search/VersionedIdentifiersFilter.java;1;1;5;1;2;2;2;3;7;1;3;54;11;11;1;0;0;3;5;54;0;336;5;1;0
/org.eclipse.jdt.core/search/org/eclipse/jdt/internal/core/search/HierarchyScope.java;2;0;6;1;1;1;1;5;8;2;4;19;23;23;2;1;0;5;6;62;1;306;5;2;0
/org.eclipse.core.runtime/src/org/eclipse/core/runtime/Platform.java;6;2;47;4;4;2;16;31;1051;13;10;47;3165;3165;13;21;14;43;47;268;35;336;12;6;1
/org.eclipse.jdt.core/model/org/eclipse/jdt/core/CorrectionEngine.java;3;0;10;2;0;0;0;10;112;2;8;31;165;165;2;2;0;10;10;62;2;199;8;3;0
/org.eclipse.ui.forms/src/org/eclipse/ui/forms/widgets/Hyperlink.java;1;0;6;1;1;1;1;5;15;4;2;225;30;30;4;3;0;5;6;225;3;272;3;1;0
/org.eclipse.team.core/src/org/eclipse/team/internal/core/subscribers/DescendantResourceVariantByteStore.java;2;1;3;1;2;2;2;1;9;0;1;239;11;11;1;0;0;1;3;239;0;336;3;2;0
/org.eclipse.update.core/src/org/eclipse/update/internal/search/BaseSearchCategory.java;2;0;4;1;1;1;1;3;4;1;3;61;8;8;1;0;0;3;4;61;0;336;4;2;0
/org.eclipse.core.runtime/src/org/eclipse/core/internal/jobs/OrderedLock.java;3;2;26;3;3;2;3;23;1275;7;8;25;1773;1773;7;15;1;23;26;161;16;312;10;3;0
/org.eclipse.jdt.ui/core refactoring/org/eclipse/jdt/internal/corext/refactoring/structure/MoveStaticMembersProcessor.java;3;7;11;2;11;4;11;0;241;0;0;283;279;279;7;0;7;0;11;283;7;336;4;3;1
/org.eclipse.team.ui/src/org/eclipse/team/internal/ui/synchronize/SynchronizePageConfiguration.java;2;6;7;2;7;2;7;0;612;0;0;272;612;612;6;0;5;0;7;288;5;288;2;2;0
/org.eclipse.core.resources/src/org/eclipse/core/internal/resources/IModelObjectConstants.java;2;0;3;2;2;1;2;1;7;0;1;226;8;8;2;0;1;1;3;277;1;277;2;2;0
/org.eclipse.team.core/src/org/eclipse/team/core/synchronize/SyncInfo.java;2;2;7;2;4;2;4;3;412;2;2;224;558;558;2;1;2;3;7;232;3;335;4;2;0
/org.eclipse.ui.intro/src/org/eclipse/ui/internal/intro/impl/model/IntroGroup.java;1;0;1;1;1;1;1;0;0;0;0;301;0;0;1;0;0;0;1;301;0;301;1;1;0
/org.eclipse.ui.workbench/Eclipse UI/org/eclipse/ui/internal/commands/IMutableCommandRegistry.java;3;1;8;1;2;2;2;6;15;2;4;85;32;32;2;2;0;6;8;85;2;336;6;3;0
/org.eclipse.debug.ui/ui/org/eclipse/debug/internal/ui/views/launch/StandardDecoration.java;2;1;3;1;2;2;2;1;4;0;1;75;8;8;1;0;0;1;3;75;0;336;3;2;0
/org.eclipse.ui.workbench.texteditor/src/org/eclipse/ui/texteditor/SaveAction.java;1;1;2;1;2;2;2;0;2;0;0;276;4;4;1;0;0;0;2;276;0;336;2;1;0
/org.eclipse.jdt.core/model/org/eclipse/jdt/internal/compiler/DocumentElementParser.java;2;0;2;1;1;1;1;1;16;0;1;245;16;16;1;0;0;1;2;245;0;312;2;2;0
/org.eclipse.ui.ide/src/org/eclipse/ui/internal/ide/model/WorkbenchProject.java;1;0;1;1;0;0;0;1;0;0;1;132;0;0;1;0;0;1;1;132;0;132;1;1;0
/org.eclipse.ui.ide/src/org/eclipse/ui/internal/ide/misc/WorkInProgressMessages.java;3;1;3;1;2;2;2;1;2;0;1;207;4;4;1;0;0;1;3;207;0;336;3;3;0
/org.eclipse.jface/src/org/eclipse/jface/viewers/IDecoration.java;2;1;2;1;2;2;2;0;16;0;0;275;18;18;1;0;0;0;2;275;0;336;2;2;0
/org.eclipse.jdt.ui/core refactoring/org/eclipse/jdt/internal/corext/refactoring/reorg/IPackageFragmentRootManipulationQuery.java;1;0;1;1;1;1;1;0;2;0;0;336;2;2;1;0;0;0;1;336;0;336;1;1;0
/org.eclipse.ui.workbench/Eclipse UI/org/eclipse/ui/internal/intro/IntroMessages.java;1;0;3;1;0;0;0;3;6;2;2;203;8;8;2;1;0;3;3;203;1;263;2;1;0
/org.eclipse.osgi/osgi/src/org/eclipse/osgi/service/resolver/BundleSpecification.java;3;0;5;2;1;1;2;3;19;2;2;171;39;39;2;1;1;4;5;171;2;336;3;3;0
/org.eclipse.swt/Eclipse SWT/carbon/org/eclipse/swt/graphics/GC.java;4;4;25;2;7;4;7;18;356;5;8;24;1066;1066;5;10;3;18;25;24;13;337;12;4;2
/org.eclipse.ui.workbench/Eclipse UI/org/eclipse/ui/internal/contexts/ExtensionContextRegistry.java;3;1;8;2;2;2;2;6;41;4;2;174;74;74;4;4;0;6;8;174;4;336;4;3;0
/org.eclipse.search/new search/org/eclipse/search/ui/ISearchResultPage.java;3;3;11;2;5;3;5;6;115;3;4;195;284;284;3;2;2;6;11;239;4;336;7;3;0
/org.eclipse.jdt.core/compiler/org/eclipse/jdt/internal/compiler/lookup/MethodScope.java;4;1;9;2;2;2;2;7;13;2;6;1;43;43;2;1;0;7;9;170;1;325;8;4;0
/org.eclipse.jdt.ui/core refactoring/org/eclipse/jdt/internal/corext/refactoring/typeconstraints/ConstraintCreator.java;2;0;2;1;1;1;1;1;8;0;1;6;8;8;1;0;0;1;2;6;0;336;2;2;0
/org.eclipse.jdt.ui/ui/org/eclipse/jdt/internal/ui/javaeditor/selectionactions/GoToNextPreviousMemberAction.java;1;0;1;1;1;1;1;0;2;0;0;336;2;2;1;0;0;0;1;336;0;336;1;1;0
/org.eclipse.swt/Eclipse SWT Mozilla/common/org/eclipse/swt/internal/mozilla/nsIWeakReference.java;1;0;1;1;0;0;0;1;0;0;1;100;0;0;1;0;0;1;1;100;0;100;1;1;0
/org.eclipse.pde.build/src/org/eclipse/pde/internal/build/ant/ConditionTask.java;2;0;6;1;1;1;1;5;118;2;3;31;301;301;2;2;0;5;6;31;2;277;4;2;0
/org.eclipse.core.runtime.compatibility/src-model/org/eclipse/core/runtime/model/ConfigurationPropertyModel.java;3;1;5;1;3;3;3;2;13;1;2;171;22;22;1;0;0;2;5;171;0;336;5;3;0
/org.eclipse.swt/Eclipse SWT Custom Widgets/common/org/eclipse/swt/custom/CTabFolderAdapter.java;2;1;2;1;2;2;2;0;4;0;0;281;6;6;1;0;0;0;2;281;0;337;2;2;0
/org.eclipse.debug.ui/ui/org/eclipse/debug/internal/ui/views/AbstractDebugEventHandler.java;1;0;1;1;0;0;0;1;2;0;1;128;2;2;1;0;0;1;1;128;0;128;1;1;1
/org.eclipse.ui.workbench/Eclipse UI/org/eclipse/ui/internal/about/AboutItem.java;1;1;2;1;2;2;2;0;2;0;0;294;2;2;1;0;0;0;2;294;0;336;2;1;0
/org.eclipse.jdt.ui/core refactoring/org/eclipse/jdt/internal/corext/refactoring/typeconstraints/ConstraintCollector.java;2;0;4;1;1;1;1;3;509;0;1;3;517;517;3;2;0;3;4;3;2;336;2;2;0
/org.eclipse.ui.workbench/Eclipse UI/org/eclipse/ui/internal/dialogs/WorkbenchWizardNode.java;3;1;3;1;2;2;2;1;254;0;1;177;258;258;1;0;0;1;3;177;0;336;3;3;1
/org.eclipse.jface/src/org/eclipse/jface/viewers/DecoratingLabelProvider.java;1;0;1;1;0;0;0;1;58;0;1;251;58;58;1;0;0;1;1;251;0;251;1;1;0
/org.eclipse.team.ui/src/org/eclipse/team/internal/ui/preferences/SyncViewerPreferencePage.java;2;1;16;2;3;3;3;13;167;3;7;63;606;606;3;6;0;13;16;93;6;336;10;2;1
/org.eclipse.ant.ui/Ant Editor/org/eclipse/ant/internal/ui/editor/templates/AntTemplateViewerConfiguration.java;1;0;1;1;1;1;1;0;0;0;0;286;0;0;1;0;0;0;1;286;0;286;1;1;0
/org.eclipse.help/src/org/eclipse/help/internal/model/ITocElement.java;1;0;4;1;1;1;1;3;31;0;1;197;62;62;3;2;0;3;4;197;2;311;2;1;0
/org.eclipse.ui.ide/src/org/eclipse/ui/views/markers/internal/ActionRemoveMarker.java;4;0;5;1;1;1;1;4;4;1;4;129;10;10;1;0;0;4;5;129;0;336;5;4;0
/org.eclipse.ui.ide/src/org/eclipse/ui/internal/ide/Category.java;2;0;4;2;0;0;0;4;4;2;3;94;8;8;2;1;0;4;4;94;1;151;3;2;0
/org.eclipse.jdt.ui/ui/org/eclipse/jdt/internal/ui/search/PathSorter.java;1;0;3;1;2;1;2;1;10;0;1;207;10;10;2;0;1;1;3;290;1;290;2;1;1
/org.eclipse.jdt.ui/core extension/org/eclipse/jdt/internal/corext/dom/Bindings.java;5;5;27;3;7;3;7;20;370;7;10;3;816;816;7;10;4;20;27;3;14;336;13;5;2
/org.eclipse.jdt.ui/ui refactoring/org/eclipse/jdt/internal/ui/refactoring/UseSupertypeWizard.java;3;0;13;2;1;1;2;11;196;4;6;36;410;410;4;5;1;12;13;65;6;336;7;3;0
/org.eclipse.jdt.ui/ui/org/eclipse/jdt/ui/actions/AddToClasspathAction.java;5;0;8;2;2;1;2;6;66;1;6;41;156;156;2;0;1;6;8;330;1;330;7;5;0
/org.eclipse.jdt.core/dom/org/eclipse/jdt/core/dom/PostfixExpression.java;3;0;8;1;2;1;2;6;105;2;5;199;135;135;2;1;1;6;8;266;2;276;6;3;1
/org.eclipse.update.core/src/org/eclipse/update/operations/IConfigFeatureOperation.java;1;1;6;1;2;2;2;4;11;1;4;54;20;20;1;0;0;4;6;54;0;336;6;1;0
/org.eclipse.osgi/core/framework/org/eclipse/osgi/framework/internal/core/PermissionsHash.java;4;1;5;1;3;3;3;2;145;1;2;171;155;155;1;0;0;2;5;171;0;336;5;4;0
/org.eclipse.swt/Eclipse SWT/common/org/eclipse/swt/layout/FormLayout.java;2;0;4;1;0;0;0;4;28;1;4;30;89;89;1;0;0;4;4;30;0;158;4;2;0
/org.eclipse.team.core/src/org/eclipse/team/internal/core/ExceptionCollector.java;1;0;1;1;0;0;0;1;0;0;1;87;0;0;1;0;0;1;1;87;0;87;1;1;0
/org.eclipse.ui.workbench.texteditor/src/org/eclipse/ui/texteditor/IReadOnlyDependent.java;1;0;1;1;1;1;1;0;2;0;0;336;2;2;1;0;0;0;1;336;0;336;1;1;0
/org.eclipse.jdt.launching/launching/org/eclipse/jdt/launching/ExecutionArguments.java;4;1;5;1;2;2;2;3;11;1;3;128;35;35;1;0;0;3;5;128;0;336;5;4;2
/org.eclipse.update.ui/src/org/eclipse/update/internal/ui/wizards/TargetPage.java;3;0;14;3;4;1;4;10;1257;3;7;50;2596;2596;4;3;3;10;14;326;6;326;8;3;2
/org.eclipse.debug.core/core/org/eclipse/debug/core/model/IStep.java;2;0;2;1;1;1;1;1;5;0;1;202;9;9;1;0;0;1;2;202;0;336;2;2;0
/org.eclipse.help.base/src/org/eclipse/help/internal/search/QueryTooComplexException.java;1;1;3;1;2;2;2;1;6;0;1;115;12;12;1;0;0;1;3;115;0;336;3;1;0
/org.eclipse.ui.ide/src/org/eclipse/ui/views/bookmarkexplorer/BookmarkPropertiesDialog.java;1;0;1;1;0;0;0;1;0;0;1;129;0;0;1;0;0;1;1;129;0;129;1;1;0
/org.eclipse.jdt.ui/core extension/org/eclipse/jdt/internal/corext/template/java/CodeTemplateContext.java;3;1;7;1;2;2;2;5;47;2;3;51;96;96;2;2;0;5;7;51;2;336;5;3;0
/org.eclipse.jdt.ui/core refactoring/org/eclipse/jdt/internal/corext/refactoring/typeconstraints/ParameterTypeVariable.java;2;0;6;1;1;1;1;5;19;3;3;3;39;39;3;2;0;5;6;3;2;336;4;2;0
/org.eclipse.jdt.debug.ui/ui/org/eclipse/jdt/internal/debug/ui/snippeteditor/NewSnippetFileCreationWizard.java;1;0;1;1;0;0;0;1;0;0;1;264;0;0;1;0;0;1;1;264;0;264;1;1;0
/org.eclipse.jdt.ui/ui/org/eclipse/jdt/internal/ui/javaeditor/SemanticHighlighting.java;3;1;3;1;3;3;3;0;7;0;0;283;12;12;1;0;0;0;3;283;0;326;3;3;0
/org.eclipse.help.webapp/src_servlets/org/eclipse/help/internal/webapp/servlet/IFilter.java;1;1;2;1;2;2;2;0;14;0;0;311;20;20;1;0;0;0;2;311;0;336;2;1;0
/org.eclipse.swt/Eclipse SWT/photon/org/eclipse/swt/graphics/GCData.java;4;0;4;1;1;1;1;3;4;1;3;0;8;8;1;0;0;3;4;0;0;337;4;4;0
/org.eclipse.ui.ide/src/org/eclipse/ui/internal/ide/dialogs/PathVariableSelectionDialog.java;1;0;1;1;0;0;0;1;0;0;1;132;0;0;1;0;0;1;1;132;0;132;1;1;0
/org.eclipse.ltk.ui.refactoring/src/org/eclipse/ltk/internal/ui/refactoring/WorkbenchRunnableAdapter.java;1;0;3;1;1;1;2;1;6;0;1;269;9;9;2;0;1;2;3;269;1;302;2;1;0
/org.eclipse.ui.workbench/Eclipse UI/org/eclipse/ui/branding/IBundleGroupConstants.java;2;1;3;1;2;2;2;1;18;0;1;243;23;23;1;0;0;1;3;243;0;335;3;2;0
/org.eclipse.help/src/org/eclipse/help/internal/toc/HrefUtil.java;1;1;4;1;3;3;3;1;48;0;1;44;95;95;1;0;0;1;4;44;0;336;4;1;0
/org.eclipse.jdt.debug.ui/ui/org/eclipse/jdt/internal/debug/ui/launcher/RuntimeClasspathAdvancedDialog.java;3;1;6;1;2;2;2;4;142;2;3;71;258;258;2;1;0;4;6;71;1;336;5;3;0
/org.eclipse.osgi/resolver/src/org/eclipse/core/internal/dependencies/SimpleSelectionPolicy.java;3;0;3;2;2;1;2;1;17;0;1;171;17;17;2;0;1;1;3;276;1;276;2;3;0
/org.eclipse.ltk.ui.refactoring/src/org/eclipse/ltk/internal/ui/refactoring/util/PixelConverter.java;1;0;2;1;0;0;1;1;13;0;1;269;13;13;2;0;1;2;2;269;1;269;1;1;0
/org.eclipse.jface.text/src/org/eclipse/jface/text/DefaultDocumentAdapter.java;2;2;3;2;3;2;3;0;82;0;0;279;82;82;2;0;1;0;3;336;1;336;2;2;0
/org.eclipse.jdt.ui/ui/org/eclipse/jdt/internal/ui/wizards/dialogfields/StringButtonStatusDialogField.java;2;1;2;1;2;2;2;0;14;0;0;282;16;16;1;0;0;0;2;282;0;336;2;2;0
/org.eclipse.debug.ui/ui/org/eclipse/debug/internal/ui/actions/ChangeVariableValueInputDialog.java;4;1;5;1;2;2;2;3;437;1;3;76;507;507;1;0;0;3;5;76;0;336;5;4;0
/org.eclipse.pde.core/src/org/eclipse/pde/internal/core/plugin/ImportObject.java;1;0;2;1;1;1;1;1;4;0;1;232;5;5;1;0;0;1;2;232;0;336;2;1;0
/org.eclipse.jdt.core/codeassist/org/eclipse/jdt/internal/codeassist/select/SelectionOnQualifiedAllocationExpression.java;3;0;4;1;0;0;0;4;69;1;4;63;76;76;1;0;0;4;4;63;0;199;4;3;2
/org.eclipse.ant.core/src/org/eclipse/ant/internal/core/IAntCoreConstants.java;1;0;2;1;1;1;1;1;9;0;1;149;13;13;1;0;0;1;2;149;0;314;2;1;0
/org.eclipse.search/new search/org/eclipse/search/ui/text/MatchEvent.java;3;3;6;2;4;2;4;2;90;1;2;207;130;130;3;0;2;2;6;276;2;336;4;3;0
/org.eclipse.swt/Eclipse SWT/common/org/eclipse/swt/graphics/ImageLoader.java;3;0;3;1;1;1;1;2;12;1;2;134;22;22;1;0;0;2;3;134;0;337;3;3;1
/org.eclipse.team.cvs.core/src/org/eclipse/team/internal/ccvs/core/client/ResponseHandler.java;2;1;4;1;2;2;2;2;84;1;2;101;101;101;1;0;0;2;4;101;0;336;4;2;1
/org.eclipse.search/new search/org/eclipse/search/ui/text/IFileMatchAdapter.java;3;2;3;2;3;2;3;0;31;0;0;279;33;33;2;0;1;0;3;279;1;336;2;3;0
/org.eclipse.update.core/src/org/eclipse/update/internal/model/ConfiguredSiteModel.java;2;1;4;1;2;2;2;2;8;1;2;58;21;21;1;0;0;2;4;58;0;336;4;2;0
/org.eclipse.jdt.core/model/org/eclipse/jdt/core/IPackageDeclaration.java;1;0;2;1;0;0;0;2;2;1;2;149;4;4;1;0;0;2;2;149;0;199;2;1;0
/org.eclipse.ui.ide/src/org/eclipse/ui/internal/ide/dialogs/MultiStepConfigureWizardPage.java;1;0;1;1;0;0;0;1;0;0;1;132;0;0;1;0;0;1;1;132;0;132;1;1;0
/org.eclipse.team.cvs.ui/src/org/eclipse/team/internal/ccvs/ui/subscriber/CompareRevertOperation.java;2;1;5;2;3;3;3;2;11;0;1;244;27;27;2;1;0;2;5;244;1;336;4;2;0
/org.eclipse.search/search/org/eclipse/search/internal/ui/text/FileSearchPage.java;2;5;16;2;8;4;8;8;103;3;4;207;299;299;5;4;4;8;16;286;8;336;8;2;3
/org.eclipse.jdt.ui/ui/org/eclipse/jdt/ui/IWorkingCopyManagerExtension.java;2;0;1;2;1;1;1;0;4;0;0;336;4;4;1;0;0;0;1;336;0;336;1;2;0
/org.eclipse.core.resources/src/org/eclipse/core/internal/resources/ResourceStatus.java;2;0;3;1;2;1;2;1;122;0;1;90;130;130;2;0;1;1;3;275;1;275;2;2;0
/org.eclipse.core.variables/src/org/eclipse/core/variables/IDynamicVariable.java;3;1;5;1;3;3;3;2;13;0;1;145;41;41;2;1;0;2;5;145;1;336;4;3;0
/org.eclipse.update.ui/src/org/eclipse/update/internal/ui/views/InstallOptionalFeatureAction.java;3;2;12;2;3;2;3;9;20;2;7;54;82;82;2;2;1;9;12;54;3;336;9;3;0
/org.eclipse.core.runtime/src/org/eclipse/core/internal/jobs/JobChangeEvent.java;3;1;6;2;2;2;2;4;196;3;2;68;207;207;3;2;0;4;6;171;2;306;4;3;0
/org.eclipse.jface.text/src/org/eclipse/jface/text/source/LineChangeHover.java;4;3;15;2;7;3;7;8;132;4;4;70;354;354;4;4;4;8;15;70;8;332;7;4;0
/org.eclipse.swt/Eclipse SWT Custom Widgets/common/org/eclipse/swt/custom/WrappedContent.java;2;1;5;1;2;2;2;3;217;2;2;253;233;233;2;1;0;3;5;253;1;337;4;2;0
/org.eclipse.jdt.ui/ui/org/eclipse/jdt/internal/ui/javaeditor/ClassFileMarkerAnnotationModel.java;1;0;1;1;1;1;1;0;2;0;0;336;2;2;1;0;0;0;1;336;0;336;1;1;0
/org.eclipse.jdt.core/compiler/org/eclipse/jdt/internal/compiler/ast/IntLiteral.java;2;0;4;1;0;0;0;4;12;1;4;63;20;20;1;0;0;4;4;63;0;199;4;2;0
/org.eclipse.help.appserver/src/org/eclipse/help/internal/appserver/IWebappServer.java;1;1;2;1;2;2;2;0;48;0;0;311;54;54;1;0;0;0;2;311;0;336;2;1;0
/org.eclipse.ui.ide/extensions/org/eclipse/ui/actions/RenameResourceAction.java;6;2;7;2;5;3;5;2;38;1;2;132;103;103;2;0;2;2;7;272;2;336;5;6;0
/org.eclipse.swt/Eclipse SWT PI/carbon/org/eclipse/swt/internal/carbon/ControlFontStyleRec.java;1;0;2;1;2;1;2;0;20;0;0;296;20;20;2;0;1;0;2;296;1;296;1;1;0
/org.eclipse.swt/Eclipse SWT PI/gtk/org/eclipse/swt/internal/gtk/PangoLayoutRun.java;2;0;2;1;1;1;1;1;2;0;1;250;2;2;1;0;0;1;2;250;0;337;2;2;0
/org.eclipse.swt/Eclipse SWT/motif/org/eclipse/swt/widgets/Display.java;7;6;45;5;9;3;9;36;742;10;12;0;1734;1734;10;24;6;36;45;0;30;330;15;7;2
/org.eclipse.ui.ide/src/org/eclipse/ui/internal/ide/actions/SelectBuildWorkingSetAction.java;1;0;1;1;0;0;0;1;0;0;1;254;0;0;1;0;0;1;1;254;0;254;1;1;0
/org.eclipse.compare/compare/org/eclipse/compare/internal/patch/PatchMessages.java;1;0;1;1;0;0;0;1;2;0;1;219;2;2;1;0;0;1;1;219;0;219;1;1;0
/org.eclipse.search/new search/org/eclipse/search/ui/text/AbstractTextSearchViewPage.java;3;0;42;3;24;1;24;18;1075;8;4;207;2297;2297;24;14;23;18;42;275;37;275;5;3;2
/org.eclipse.jdt.ui/ui/org/eclipse/jdt/internal/ui/text/spelling/SpellReconcileDictionary.java;2;0;2;1;1;1;1;1;2;0;1;219;2;2;1;0;0;1;2;219;0;336;2;2;0
/org.eclipse.jdt.ui/ui/org/eclipse/jdt/ui/ProblemsLabelDecorator.java;2;0;4;2;1;1;1;3;9;1;3;131;19;19;1;0;0;3;4;131;0;336;4;2;0
/org.eclipse.pde.ui/src/org/eclipse/pde/internal/ui/OpenPDEPerspectiveAction.java;3;1;3;1;3;3;3;0;23;0;0;288;29;29;1;0;0;0;3;288;0;336;3;3;0
/org.eclipse.swt/Eclipse SWT Mozilla/common/org/eclipse/swt/internal/mozilla/nsIProfileChangeStatus.java;1;0;1;1;0;0;0;1;0;0;1;100;0;0;1;0;0;1;1;100;0;100;1;1;0
/org.eclipse.team.ui/src/org/eclipse/team/internal/ui/synchronize/actions/SyncViewerShowPreferencesAction.java;1;0;2;1;0;0;0;2;35;0;1;148;35;35;2;1;0;2;2;148;1;148;1;1;1
/org.eclipse.help.ide/src/org/eclipse/help/ui/internal/search/ResultPage.java;1;1;3;1;3;3;3;0;4;0;0;281;7;7;1;0;0;0;3;281;0;311;3;1;0
/org.eclipse.swt/Eclipse SWT Drag and Drop/gtk/org/eclipse/swt/dnd/Clipboard.java;4;3;12;2;6;3;6;6;104;1;6;0;262;262;3;0;3;6;12;317;3;337;9;4;1
/org.eclipse.pde.ui/src/org/eclipse/pde/internal/ui/editor/build/BuildUtil.java;1;0;1;1;0;0;0;1;0;0;1;104;0;0;1;0;0;1;1;104;0;104;1;1;0
/org.eclipse.swt/Eclipse SWT/motif/org/eclipse/swt/graphics/Image.java;4;1;8;2;2;2;2;6;10;2;5;0;36;36;2;1;0;6;8;234;1;337;7;4;2
/org.eclipse.ui.editors/src/org/eclipse/ui/editors/text/StorageDocumentProvider.java;2;1;8;1;4;4;4;4;21;1;4;82;86;86;1;0;0;4;8;82;0;336;8;2;0
/org.eclipse.jdt.core/dom/org/eclipse/jdt/core/dom/NaiveASTFlattener.java;5;0;24;3;3;1;3;21;697;6;8;18;1323;1323;6;13;2;21;24;199;15;283;9;5;2
/org.eclipse.swt/Eclipse SWT Drag and Drop/gtk/org/eclipse/swt/dnd/DragSource.java;4;1;8;1;2;2;2;6;138;2;5;0;211;211;2;1;0;6;8;238;1;337;7;4;0
/org.eclipse.compare/compare/org/eclipse/compare/internal/AddFromHistoryAction.java;1;0;2;1;0;0;0;2;21;1;2;79;23;23;1;0;0;2;2;79;0;104;2;1;0
/org.eclipse.pde.core/src/org/eclipse/pde/internal/core/plugin/WorkspacePluginModel.java;1;0;2;1;1;1;1;1;4;0;1;232;7;7;1;0;0;1;2;232;0;336;2;1;0
/org.eclipse.help.base/src/org/eclipse/help/internal/base/BaseHelpSystem.java;2;2;16;1;4;3;4;12;79;6;5;105;295;295;6;7;1;12;16;245;8;336;8;2;1
/org.eclipse.jdt.ui/core refactoring/org/eclipse/jdt/internal/corext/refactoring/typeconstraints/ConstraintOperator.java;2;0;3;1;1;1;1;2;57;1;2;5;67;67;1;0;0;2;3;5;0;336;3;2;0
/org.eclipse.jdt.ui/ui/org/eclipse/jdt/internal/ui/text/java/hover/AbstractJavaEditorTextHover.java;2;1;8;1;4;4;4;4;69;2;2;89;111;111;2;2;0;4;8;89;2;336;6;2;0
/org.eclipse.swt/Eclipse SWT/gtk/org/eclipse/swt/graphics/GC.java;5;1;21;2;3;3;3;18;255;4;9;24;819;819;4;9;0;18;21;33;9;337;12;5;1
/org.eclipse.jdt.ui/ui/org/eclipse/jdt/internal/ui/jarpackager/JarPackageActionDelegate.java;1;0;1;1;1;1;1;0;2;0;0;336;2;2;1;0;0;0;1;336;0;336;1;1;0
/org.eclipse.jdt.ui/ui/org/eclipse/jdt/internal/ui/search/JavaSearchResultPage.java;4;14;32;2;19;2;19;13;568;5;5;207;1217;1217;14;8;17;13;32;274;25;321;7;4;3
/org.eclipse.team.cvs.ui/src/org/eclipse/team/internal/ccvs/ui/actions/RestoreFromRepositoryAction.java;2;0;5;1;1;1;1;4;45;1;4;55;67;67;1;0;0;4;5;55;0;336;5;2;0
/org.eclipse.jdt.ui/core refactoring/org/eclipse/jdt/internal/corext/refactoring/code/flow/InOutFlowAnalyzer.java;1;0;1;1;1;1;1;0;2;0;0;336;2;2;1;0;0;0;1;336;0;336;1;1;0
/org.eclipse.ant.ui/Ant Tools Support/org/eclipse/ant/internal/ui/views/actions/SearchForBuildFilesDialog.java;1;1;6;1;3;3;3;3;30;2;2;108;46;46;2;1;0;3;6;108;1;336;5;1;1
/org.eclipse.jdt.ui/ui/org/eclipse/jdt/internal/ui/typehierarchy/HistoryAction.java;1;0;1;1;1;1;1;0;2;0;0;336;2;2;1;0;0;0;1;336;0;336;1;1;0
/org.eclipse.search/search/org/eclipse/search/internal/ui/SorterDescriptor.java;1;0;1;1;1;1;1;0;2;0;0;336;2;2;1;0;0;0;1;336;0;336;1;1;0
/org.eclipse.ui.editors/src/org/eclipse/ui/internal/texteditor/SourceViewerInformationControl.java;2;3;4;1;4;2;4;0;53;0;0;286;55;55;3;0;2;0;4;286;2;336;2;2;0
/org.eclipse.jdt.ui/ui/org/eclipse/jdt/internal/ui/workingsets/WorkingSetFilterActionGroup.java;4;0;7;2;1;1;1;6;122;2;4;81;151;151;2;2;0;6;7;81;2;336;5;4;0
/org.eclipse.jdt.ui/ui/org/eclipse/jdt/internal/ui/infoviews/AbstractInfoView.java;2;2;11;1;3;2;3;8;302;4;3;49;482;482;4;5;1;8;11;49;6;336;5;2;0
/org.eclipse.swt/Eclipse SWT PI/gtk/org/eclipse/swt/internal/gtk/XWindowChanges.java;3;0;4;1;1;1;1;3;6;1;3;152;10;10;1;0;0;3;4;152;0;337;4;3;0
/org.eclipse.jdt.ui/ui/org/eclipse/jdt/internal/ui/preferences/JavaBasePreferencePage.java;5;1;8;1;3;3;3;5;176;2;4;13;341;341;2;1;0;5;8;76;1;336;7;5;0
/org.eclipse.jdt.ui/ui/org/eclipse/jdt/internal/ui/compare/JavaCompareAction.java;2;1;5;1;2;2;2;3;16;1;3;18;26;26;1;0;0;3;5;18;0;336;5;2;0
/org.eclipse.search/search/org/eclipse/search/ui/IActionGroupFactory.java;2;2;3;1;3;2;3;0;5;0;0;325;7;7;2;0;1;0;3;325;1;336;2;2;0
/org.eclipse.core.expressions/src/org/eclipse/core/internal/expressions/DefaultVariable.java;1;0;3;1;1;1;1;2;2;0;1;227;3;3;2;1;0;2;3;227;1;336;2;1;0
/org.eclipse.search/new search/org/eclipse/search2/internal/ui/basic/views/RemoveSelectedMatchesAction.java;3;2;3;2;3;2;3;0;2;0;0;276;4;4;2;0;1;0;3;276;1;336;2;3;0
/org.eclipse.pde.ui/src/org/eclipse/pde/internal/ui/wizards/imports/BinaryProjectFilter.java;2;1;4;1;4;4;4;0;30;0;0;287;50;50;1;0;0;0;4;287;0;336;4;2;0
/org.eclipse.core.resources/src/org/eclipse/core/internal/resources/SavedState.java;2;4;10;1;5;2;5;5;17;2;4;90;40;40;4;1;3;5;10;286;4;286;6;2;0
/org.eclipse.jdt.ui/ui/org/eclipse/jdt/internal/ui/dialogs/OpenTypeSelectionDialog.java;1;0;1;1;1;1;1;0;2;0;0;336;2;2;1;0;0;0;1;336;0;336;1;1;0
/org.eclipse.jdt.ui/ui/org/eclipse/jdt/internal/ui/browsing/IPackagesViewViewer.java;1;0;1;1;1;1;1;0;2;0;0;336;2;2;1;0;0;0;1;336;0;336;1;1;0
/org.eclipse.team.ui/src/org/eclipse/team/internal/ui/synchronize/SubscriberParticipantWizard.java;2;3;5;2;5;3;5;0;93;0;0;296;175;175;3;0;2;0;5;296;2;323;3;2;0
/org.eclipse.ant.ui/Ant Tools Support/org/eclipse/ant/internal/ui/views/actions/SearchForBuildFilesAction.java;1;0;4;1;1;1;1;3;9;2;2;108;15;15;2;1;0;3;4;108;1;289;3;1;1
/org.eclipse.swt/Eclipse SWT/carbon/org/eclipse/swt/widgets/Label.java;3;1;10;1;3;3;3;7;102;3;5;1;138;138;3;2;0;7;10;1;2;337;8;3;0
/org.eclipse.ui.intro/src/org/eclipse/ui/internal/intro/impl/model/loader/ModelLoaderUtil.java;1;4;6;1;6;3;6;0;102;0;0;276;185;185;4;0;3;0;6;276;3;309;3;1;0
/org.eclipse.help/src/org/eclipse/help/IHelp.java;1;1;3;1;2;2;2;1;232;0;1;156;284;284;1;0;0;1;3;156;0;336;3;1;0
/org.eclipse.jface.text/src/org/eclipse/jface/text/reconciler/IReconcileResult.java;1;0;3;1;2;1;2;1;11;0;1;99;11;11;2;0;1;1;3;336;1;336;2;1;0
/org.eclipse.ui.ide/src/org/eclipse/ui/internal/ide/dialogs/WizardNewProjectNameAndLocationPage.java;1;0;1;1;0;0;0;1;0;0;1;132;0;0;1;0;0;1;1;132;0;132;1;1;0
/org.eclipse.jdt.ui/core refactoring/org/eclipse/jdt/internal/corext/refactoring/code/flow/IfFlowInfo.java;1;0;1;1;1;1;1;0;2;0;0;336;2;2;1;0;0;0;1;336;0;336;1;1;0
/org.eclipse.core.runtime/src/org/eclipse/core/internal/registry/ExtensionsParser.java;5;5;16;3;11;4;11;5;1037;2;3;173;1480;1480;5;2;7;5;16;276;9;326;7;5;0
/org.eclipse.ui.editors/src/org/eclipse/ui/editors/text/TextSourceViewerConfiguration.java;3;2;7;2;3;2;3;4;51;2;3;70;145;145;2;1;1;4;7;70;2;336;5;3;0
/org.eclipse.ui.workbench/Eclipse UI/org/eclipse/ui/ISharedImages.java;4;1;5;1;2;2;2;3;62;1;3;157;162;162;1;0;0;3;5;157;0;336;5;4;1
/org.eclipse.ui.ide/src/org/eclipse/ui/internal/ide/dialogs/FileFolderSelectionDialog.java;1;0;1;1;0;0;0;1;0;0;1;132;0;0;1;0;0;1;1;132;0;132;1;1;0
/org.eclipse.osgi/osgi/src/org/osgi/framework/InvalidSyntaxException.java;2;0;2;1;1;1;1;1;7;0;1;171;7;7;1;0;0;1;2;171;0;296;2;2;0
/org.eclipse.ui.workbench/Eclipse UI/org/eclipse/ui/internal/activities/Activity.java;5;1;18;3;2;2;2;16;586;11;3;141;725;725;11;13;0;16;18;156;13;336;5;5;0
/org.eclipse.update.ui/src/org/eclipse/update/internal/ui/wizards/ReviewPage.java;4;3;21;3;5;3;5;16;1662;4;9;50;2835;2835;4;7;2;16;21;50;9;321;12;4;2
/org.eclipse.team.cvs.ui/src/org/eclipse/team/internal/ccvs/ui/subscriber/SyncInfoSetDetailsDialog.java;2;0;6;1;1;1;1;5;18;1;5;71;32;32;1;0;0;5;6;71;0;336;6;2;0
/org.eclipse.swt/Eclipse SWT PI/carbon/org/eclipse/swt/internal/carbon/CGRect.java;1;0;2;1;2;1;2;0;20;0;0;296;20;20;2;0;1;0;2;296;1;296;1;1;0
/org.eclipse.jdt.debug.ui/ui/org/eclipse/jdt/internal/debug/ui/DialogSettingsHelper.java;1;0;1;1;0;0;0;1;0;0;1;264;0;0;1;0;0;1;1;264;0;264;1;1;0
/org.eclipse.jdt.core/dom/org/eclipse/jdt/core/dom/NullLiteral.java;3;0;7;2;1;1;1;6;37;2;4;199;51;51;2;2;0;6;7;199;2;283;5;3;1
/org.eclipse.jdt.core/formatter/org/eclipse/jdt/internal/formatter/align/Alignment.java;3;0;17;1;0;0;0;17;87;5;11;37;189;189;5;6;0;17;17;172;6;222;11;3;2
/org.eclipse.jdt.ui/ui refactoring/org/eclipse/jdt/internal/ui/refactoring/UserInterfaceStarter.java;2;0;6;1;1;1;1;5;77;2;4;103;103;103;2;1;0;5;6;247;1;336;5;2;0
/org.eclipse.jdt.ui/ui/org/eclipse/jdt/internal/ui/dialogs/StatusUtil.java;1;0;2;1;1;1;1;1;7;0;1;82;9;9;1;0;0;1;2;82;0;336;2;1;0
/org.eclipse.ui.workbench.texteditor/src/org/eclipse/ui/internal/texteditor/TextEditorPlugin.java;2;3;9;1;5;3;5;4;78;3;2;94;203;203;3;2;2;4;9;94;4;336;5;2;0
/org.eclipse.pde.core/src/org/eclipse/pde/internal/core/plugin/Fragment.java;3;3;12;2;6;3;6;6;56;1;6;128;161;161;3;0;3;6;12;306;3;336;9;3;0
/org.eclipse.compare/compare/org/eclipse/compare/CompareEditorInput.java;1;2;10;1;4;3;4;6;374;2;4;75;419;419;2;2;1;6;10;75;3;335;7;1;0
/org.eclipse.ant.ui/Ant Editor/org/eclipse/ant/internal/ui/editor/text/AntEditorTagScanner.java;1;0;5;1;2;1;2;3;54;1;3;108;114;114;2;0;1;3;5;304;1;304;4;1;0
/org.eclipse.pde.ui/src/org/eclipse/pde/internal/ui/wizards/RenameDialog.java;3;1;4;2;2;2;2;2;81;1;2;192;94;94;1;0;0;2;4;192;0;336;4;3;0
/org.eclipse.osgi/core/framework/org/eclipse/osgi/framework/internal/protocol/ContentHandlerProxy.java;5;0;6;3;1;1;3;3;146;3;3;171;175;175;3;0;2;5;6;270;2;336;4;5;0
/org.eclipse.ant.ui/Ant Tools Support/org/eclipse/ant/internal/ui/launchConfigurations/AntEnvironmentTab.java;1;0;3;1;1;1;1;2;7;1;2;253;10;10;1;0;0;2;3;253;0;293;3;1;0
/org.eclipse.jdt.ui/ui/org/eclipse/jdt/internal/ui/text/spelling/TaskTagDictionary.java;2;0;2;1;1;1;1;1;2;0;1;219;2;2;1;0;0;1;2;219;0;336;2;2;0
/org.eclipse.swt/Eclipse SWT PI/win32/org/eclipse/swt/internal/win32/SCRIPT_STATE.java;2;0;2;1;1;1;1;1;4;0;1;250;4;4;1;0;0;1;2;250;0;337;2;2;0
/org.eclipse.ui.intro/src/org/eclipse/ui/intro/config/CustomizableIntroPart.java;4;8;11;3;11;4;11;0;508;0;0;286;562;562;8;0;7;0;11;307;7;327;4;4;0
/org.eclipse.pde.ui/src/org/eclipse/pde/internal/ui/editor/schema/NewReferenceAction.java;1;0;2;1;0;0;0;2;2;1;2;26;3;3;1;0;0;2;2;26;0;44;2;1;0
/org.eclipse.jdt.core/model/org/eclipse/jdt/internal/core/jdom/CompilationUnit.java;1;0;1;1;0;0;0;1;2;0;1;199;2;2;1;0;0;1;1;199;0;199;1;1;0
/org.eclipse.jdt.ui/ui refactoring/org/eclipse/jdt/internal/ui/refactoring/ChangeExceptionsControl.java;3;1;5;2;3;3;3;2;8;0;1;148;20;20;2;1;0;2;5;148;1;336;4;3;0
/org.eclipse.update.core/src/org/eclipse/update/core/model/PluginEntryModel.java;2;2;4;1;3;2;3;1;24;0;1;238;38;38;2;0;1;1;4;290;1;302;3;2;0
/org.eclipse.ui.workbench/Eclipse UI/org/eclipse/ui/internal/LegacyResourceSupport.java;2;0;3;1;1;1;1;2;30;1;2;178;32;32;1;0;0;2;3;178;0;336;3;2;1
/org.eclipse.search/new search/org/eclipse/search2/internal/ui/text/PositionTracker.java;2;4;17;2;10;4;10;7;84;4;4;195;280;280;4;3;6;7;17;250;9;321;8;2;1
/org.eclipse.jdt.ui/ui/org/eclipse/jdt/internal/ui/text/JavaWordDetector.java;1;0;1;1;1;1;1;0;2;0;0;336;2;2;1;0;0;0;1;336;0;336;1;1;0
/org.eclipse.text/src/org/eclipse/text/edits/ReplaceEdit.java;2;0;4;1;1;1;1;3;20;2;2;118;36;36;2;1;0;3;4;118;1;336;3;2;0
/org.eclipse.team.cvs.ui/src/org/eclipse/team/internal/ccvs/ui/CVSCompareRevisionsInput.java;2;3;12;2;5;3;5;7;190;4;4;52;396;396;4;3;2;7;12;232;5;336;7;2;0
/org.eclipse.search/new search/org/eclipse/search/ui/ISearchQuery.java;3;3;7;2;4;2;4;3;93;1;3;207;159;159;3;0;2;3;7;276;2;336;5;3;0
/org.eclipse.swt/Eclipse SWT Browser/carbon/org/eclipse/swt/browser/Browser.java;3;6;24;2;13;3;13;11;1275;4;7;100;1490;1490;6;4;10;11;24;287;14;337;10;3;6
/org.eclipse.jface/src/org/eclipse/jface/resource/ImageRegistry.java;4;2;6;1;3;2;3;3;69;1;3;91;164;164;2;0;1;3;6;299;1;336;5;4;1
/org.eclipse.jdt.core/dom/org/eclipse/jdt/core/dom/SimpleName.java;4;0;10;2;1;1;1;9;145;2;6;67;180;180;2;3;0;9;10;199;3;283;7;4;1
/org.eclipse.ui.ide/src/org/eclipse/ui/internal/ide/dialogs/WelcomeEditorCopyAction.java;1;0;1;1;0;0;0;1;0;0;1;132;0;0;1;0;0;1;1;132;0;132;1;1;0
/org.eclipse.jdt.core/model/org/eclipse/jdt/internal/core/SourceTypeElementInfo.java;3;0;7;2;0;0;0;7;105;4;4;7;213;213;4;3;0;7;7;112;3;199;4;3;2
/org.eclipse.ui.views/src/org/eclipse/ui/views/properties/PropertySheet.java;1;0;2;1;0;0;0;2;23;0;1;157;23;23;2;1;0;2;2;157;1;157;1;1;0
/org.eclipse.ui.workbench/Eclipse UI/org/eclipse/ui/contexts/IContextListener.java;4;1;11;1;2;2;2;9;20;4;6;70;71;71;4;3;0;9;11;70;3;336;8;4;0
/org.eclipse.jdt.ui/ui/org/eclipse/jdt/internal/ui/javaeditor/selectionactions/StructureSelectHistoryAction.java;1;0;1;1;1;1;1;0;2;0;0;336;2;2;1;0;0;0;1;336;0;336;1;1;0
/org.eclipse.osgi/osgi/src/org/eclipse/osgi/service/resolver/StateChangeEvent.java;3;1;4;1;2;2;2;2;10;0;1;171;16;16;2;1;0;2;4;171;1;336;3;3;0
/org.eclipse.ui.ide/src/org/eclipse/ui/internal/ide/dialogs/UpdateProjectCapabilityWizard.java;2;0;2;1;0;0;0;2;1;1;2;132;1;1;1;0;0;2;2;132;0;158;2;2;0
/org.eclipse.jface/src/org/eclipse/jface/viewers/IFontProvider.java;1;0;1;1;0;0;0;1;0;0;1;233;0;0;1;0;0;1;1;233;0;233;1;1;0
/org.eclipse.update.ui/src/org/eclipse/update/internal/ui/views/NewExtensionLocationAction.java;3;2;16;2;5;4;5;11;87;3;6;54;243;243;3;5;1;11;16;54;6;336;10;3;1
/org.eclipse.debug.ui/ui/org/eclipse/debug/internal/ui/launchConfigurations/LaunchConfigurationPropertiesDialog.java;3;1;4;1;2;2;2;2;18;1;2;44;29;29;1;0;0;2;4;44;0;336;4;3;1
/org.eclipse.ui.workbench/Eclipse UI/org/eclipse/ui/internal/progress/ProgressManager.java;4;0;59;3;4;1;25;34;4925;25;7;125;7233;7233;25;27;24;55;59;266;51;323;8;4;2
/org.eclipse.ui.workbench/Eclipse UI/org/eclipse/ui/internal/activities/ActivityPatternBinding.java;4;0;5;1;1;1;1;4;4;2;3;165;8;8;2;1;0;4;5;165;1;336;4;4;0
/org.eclipse.jdt.ui/ui/org/eclipse/jdt/internal/ui/jarpackager/JarPackageWizardPage.java;1;1;5;1;2;2;2;3;57;1;3;18;90;90;1;0;0;3;5;18;0;336;5;1;0
/org.eclipse.ui.cheatsheets/src/org/eclipse/ui/cheatsheets/ICheatSheetViewer.java;2;1;2;2;2;2;2;0;76;0;0;275;87;87;1;0;0;0;2;275;0;306;2;2;0
/org.eclipse.swt/Eclipse SWT/common/org/eclipse/swt/events/ShellEvent.java;1;0;1;1;0;0;0;1;21;0;1;156;21;21;1;0;0;1;1;156;0;156;1;1;0
/org.eclipse.ui.workbench/Eclipse UI/org/eclipse/ui/internal/PluginAction.java;7;2;12;3;3;2;3;9;41;3;7;3;180;180;3;2;1;9;12;171;3;336;9;7;1
/org.eclipse.osgi/osgi/src/org/osgi/framework/AdminPermission.java;2;0;2;1;1;1;1;1;3;0;1;171;3;3;1;0;0;1;2;171;0;296;2;2;0
/org.eclipse.team.ui/src/org/eclipse/team/internal/ui/synchronize/ConfigureRefreshScheduleDialog.java;2;1;8;1;3;3;3;5;197;2;4;193;394;394;2;1;0;5;8;253;1;336;7;2;0
/org.eclipse.team.cvs.ui/src/org/eclipse/team/internal/ccvs/ui/subscriber/CVSActionDelegateWrapper.java;1;0;1;1;1;1;1;0;43;0;0;295;43;43;1;0;0;0;1;295;0;295;1;1;1
/org.eclipse.help.ui/src/org/eclipse/help/ui/internal/ContextHelpDialog.java;1;1;8;1;4;4;4;4;129;2;3;112;278;278;2;1;0;4;8;156;1;336;7;1;2
/org.eclipse.compare/compare/org/eclipse/compare/internal/MergeSourceViewer.java;1;0;1;1;0;0;0;1;6;0;1;79;6;6;1;0;0;1;1;79;0;79;1;1;0
/org.eclipse.jdt.ui/ui/org/eclipse/jdt/internal/ui/browsing/JavaBrowsingPerspectiveFactory.java;5;4;11;2;8;4;8;3;59;1;3;84;102;102;4;0;4;3;11;325;4;336;7;5;0
/org.eclipse.jdt.core/eval/org/eclipse/jdt/internal/eval/VariablesEvaluator.java;2;0;4;1;0;0;0;4;4;1;4;18;10;10;1;0;0;4;4;18;0;199;4;2;0
/org.eclipse.ui.editors/src/org/eclipse/ui/texteditor/AddTaskAction.java;1;1;2;1;2;2;2;0;3;0;0;276;5;5;1;0;0;0;2;276;0;336;2;1;0
/org.eclipse.team.cvs.ui/src/org/eclipse/team/internal/ccvs/ui/operations/TagInRepositoryOperation.java;2;1;7;2;2;2;2;5;14;2;4;63;35;35;2;1;0;5;7;63;1;336;6;2;0
/org.eclipse.team.cvs.ui/src/org/eclipse/team/internal/ccvs/ui/ResourceEditionNode.java;2;2;6;2;3;2;3;3;92;2;2;56;112;112;2;1;1;3;6;232;2;336;4;2;0
/org.eclipse.ui.views/src/org/eclipse/ui/views/properties/IPropertySource.java;2;0;3;1;1;1;1;2;28;1;2;0;52;52;1;0;0;2;3;0;0;295;3;2;0
/org.eclipse.jface.text/src/org/eclipse/jface/text/presentation/IPresentationReconciler.java;2;2;3;2;3;2;3;0;83;0;0;276;85;85;2;0;1;0;3;336;1;336;2;2;0
/org.eclipse.osgi/eclipseAdaptor/src/org/eclipse/core/runtime/adaptor/Locker_JavaIo.java;3;1;5;3;2;2;3;2;9;0;1;264;17;17;3;1;1;3;5;264;2;326;3;3;0
/org.eclipse.swt/Eclipse SWT PI/win32/org/eclipse/swt/internal/win32/SCRIPT_FONTPROPERTIES.java;2;0;2;1;1;1;1;1;4;0;1;270;4;4;1;0;0;1;2;270;0;337;2;2;0
/org.eclipse.pde.core/src/org/eclipse/pde/internal/core/schema/StorageSchemaDescriptor.java;1;0;2;1;1;1;1;1;11;0;1;232;15;15;1;0;0;1;2;232;0;336;2;1;0
/org.eclipse.compare/compare/org/eclipse/compare/ITypedElement.java;1;0;1;1;0;0;0;1;2;0;1;219;2;2;1;0;0;1;1;219;0;219;1;1;0
/org.eclipse.jdt.ui/ui/org/eclipse/jdt/internal/ui/text/spelling/engine/DefaultPhoneticHashProvider.java;2;0;2;1;1;1;1;1;2;0;1;219;2;2;1;0;0;1;2;219;0;336;2;2;0
/org.eclipse.ui.workbench.texteditor/src/org/eclipse/ui/texteditor/ValidateStateException.java;1;0;1;1;1;1;1;0;2;0;0;336;2;2;1;0;0;0;1;336;0;336;1;1;0
/org.eclipse.swt/Eclipse SWT Browser/motif/org/eclipse/swt/browser/PromptServiceFactory.java;2;0;2;1;1;1;1;1;6;0;1;264;6;6;1;0;0;1;2;264;0;337;2;2;0
/org.eclipse.debug.ui/ui/org/eclipse/debug/internal/ui/views/registers/RegistersViewerState.java;1;0;1;1;0;0;0;1;0;0;1;239;0;0;1;0;0;1;1;239;0;239;1;1;0
/org.eclipse.jdt.launching/launching/org/eclipse/jdt/internal/launching/RuntimeClasspathEntryResolver.java;2;0;2;1;1;1;1;1;8;0;1;211;12;12;1;0;0;1;2;211;0;336;2;2;0
/org.eclipse.pde.build/src/org/eclipse/pde/internal/build/Policy.java;2;0;7;1;1;1;1;6;352;2;3;31;904;904;2;3;0;6;7;31;3;277;4;2;0
/org.eclipse.jdt.ui/core refactoring/org/eclipse/jdt/internal/corext/refactoring/changes/ResourceReorgChange.java;3;0;5;1;1;1;1;4;48;1;4;41;70;70;1;0;0;4;5;41;0;336;5;3;0
/org.eclipse.team.core/src/org/eclipse/team/internal/core/IJobListener.java;2;0;3;1;1;1;1;2;26;1;2;220;28;28;1;0;0;2;3;220;0;336;3;2;0
/org.eclipse.swt/Eclipse SWT/win32/org/eclipse/swt/graphics/FontData.java;3;2;7;1;4;3;4;3;175;1;3;13;238;238;2;0;1;3;7;292;1;337;6;3;1
/org.eclipse.update.core/src/org/eclipse/update/internal/model/ConfigurationActivityModel.java;1;0;1;1;0;0;0;1;4;0;1;58;4;4;1;0;0;1;1;58;0;58;1;1;0
/org.eclipse.jdt.debug.ui/ui/org/eclipse/jdt/internal/debug/ui/console/J9StackTraceHyperlink.java;1;0;1;1;0;0;0;1;2;0;1;144;2;2;1;0;0;1;1;144;0;144;1;1;1
/org.eclipse.pde.ui/src/org/eclipse/pde/internal/ui/util/ChoicePropertyDescriptor.java;1;0;1;1;0;0;0;1;6;0;1;106;6;6;1;0;0;1;1;106;0;106;1;1;0
/org.eclipse.ui.workbench/Eclipse UI/org/eclipse/ui/internal/keys/WindowsKeyFormatter.java;1;0;2;1;0;0;0;2;6;0;1;188;6;6;2;1;0;2;2;188;1;188;1;1;0
/org.eclipse.ui.workbench/Eclipse UI/org/eclipse/ui/dialogs/CheckedTreeSelectionDialog.java;1;1;2;1;2;2;2;0;197;0;0;279;225;225;1;0;0;0;2;279;0;293;2;1;0
/org.eclipse.ui.workbench/Eclipse UI/org/eclipse/ui/internal/themes/ThemeElementHelper.java;1;0;7;1;0;0;1;6;131;4;2;241;231;231;4;4;1;7;7;241;5;262;2;1;0
/org.eclipse.jdt.debug.ui/ui/org/eclipse/jdt/internal/debug/ui/launcher/DefineSystemLibraryQuickFix.java;1;0;2;1;0;0;0;2;3;1;2;65;6;6;1;0;0;2;2;65;0;76;2;1;0
/org.eclipse.jdt.debug/jdi/org/eclipse/jdi/internal/ClassTypeImpl.java;1;0;2;1;0;0;0;2;24;1;2;130;34;34;1;0;0;2;2;130;0;235;2;1;0
/org.eclipse.jdt.ui/ui/org/eclipse/jdt/ui/wizards/NewClassWizardPage.java;1;0;1;1;1;1;1;0;2;0;0;336;2;2;1;0;0;0;1;336;0;336;1;1;0
/org.eclipse.update.ui/src/org/eclipse/update/internal/ui/properties/FeatureGeneralPropertyPage.java;2;0;2;2;0;0;0;2;51;0;1;54;51;51;2;1;0;2;2;54;1;54;1;2;0
/org.eclipse.jdt.debug/eval/org/eclipse/jdt/internal/debug/eval/LocalEvaluationEngine.java;3;1;3;2;2;2;2;1;77;0;1;78;83;83;1;0;0;1;3;78;0;336;3;3;0
/org.eclipse.help.webapp/src_servlets/org/eclipse/help/internal/webapp/data/ToolbarData.java;1;2;8;1;7;5;7;1;54;0;1;124;181;181;2;0;2;1;8;286;2;336;6;1;0
/org.eclipse.jdt.ui/ui refactoring/org/eclipse/jdt/internal/ui/refactoring/nls/NLSAccessorConfigurationDialog.java;2;4;7;1;7;3;7;0;163;0;0;289;186;186;4;0;4;0;7;289;4;336;3;2;0
/org.eclipse.team.ui/src/org/eclipse/team/ui/ISaveableWorkbenchPart.java;2;1;3;1;3;3;3;0;22;0;0;280;31;31;1;0;0;0;3;280;0;302;3;2;0
/org.eclipse.ui.workbench.texteditor/src/org/eclipse/ui/texteditor/PropagatingFontFieldEditor.java;1;0;1;1;1;1;1;0;2;0;0;336;2;2;1;0;0;0;1;336;0;336;1;1;0
/org.eclipse.ui.console/src/org/eclipse/ui/internal/console/ConsoleManager.java;5;2;7;2;3;2;3;4;69;2;2;118;110;110;2;2;1;4;7;118;3;336;4;5;0
/org.eclipse.jdt.debug.ui/ui/org/eclipse/jdt/internal/debug/ui/monitors/MonitorsView.java;5;0;6;4;4;1;4;2;122;1;2;238;137;137;4;0;3;2;6;300;3;300;3;5;0
/org.eclipse.swt/Eclipse SWT/gtk/org/eclipse/swt/widgets/Combo.java;7;3;36;4;6;4;6;30;93;6;12;4;675;675;6;18;2;30;36;153;20;337;16;7;1
/org.eclipse.pde.core/src/org/eclipse/pde/internal/core/PluginModelManager.java;3;10;33;3;14;3;14;19;430;4;7;130;782;782;10;12;11;19;33;292;23;332;10;3;0
/org.eclipse.team.cvs.ui/src/org/eclipse/team/internal/ccvs/ui/repo/RepositoriesViewContentHandler.java;2;2;9;2;5;4;5;4;48;2;3;121;135;135;2;1;1;4;9;121;2;336;7;2;0
/org.eclipse.update.core/src/org/eclipse/update/standalone/ScriptedCommand.java;1;1;6;1;4;4;4;2;78;1;2;54;115;115;1;0;0;2;6;54;0;336;6;1;1
/org.eclipse.jdt.ui/ui refactoring/org/eclipse/jdt/internal/ui/refactoring/IntroduceParameterWizard.java;3;1;5;1;2;2;3;2;17;2;2;130;28;28;2;0;1;3;5;269;1;336;4;3;0
/org.eclipse.jdt.core/search/org/eclipse/jdt/internal/core/search/indexing/IndexBinaryFolder.java;3;1;10;3;2;2;2;8;51;3;6;60;84;84;3;2;0;8;10;178;2;283;8;3;0
/org.eclipse.swt/Eclipse SWT/gtk/org/eclipse/swt/widgets/TreeItem.java;7;3;14;3;4;2;4;10;78;3;5;19;202;202;3;5;2;10;14;19;7;337;7;7;1
/org.eclipse.ui.editors/src/org/eclipse/ui/editors/text/TextFileDocumentProvider.java;3;4;39;3;10;4;10;29;324;7;9;96;1283;1283;7;20;6;29;39;130;26;324;13;3;0
/org.eclipse.team.cvs.core/src/org/eclipse/team/internal/ccvs/core/client/CheckedInHandler.java;1;0;1;1;0;0;0;1;7;0;1;177;7;7;1;0;0;1;1;177;0;177;1;1;0
/org.eclipse.debug.ui/ui/org/eclipse/debug/internal/ui/views/expression/ExpressionView.java;4;0;13;2;1;1;1;12;72;4;7;45;165;165;4;5;0;12;13;45;5;272;8;4;0
/org.eclipse.jdt.ui/ui/org/eclipse/jdt/internal/ui/filters/CustomFiltersDialog.java;3;1;6;1;3;3;3;3;72;1;3;127;116;116;1;0;0;3;6;127;0;336;6;3;0
/org.eclipse.jdt.ui/ui/org/eclipse/jdt/internal/ui/preferences/formatter/JavaPreview.java;2;0;9;1;2;1;2;7;214;2;4;176;309;309;2;3;1;7;9;176;4;276;5;2;0
/org.eclipse.team.cvs.ui/src/org/eclipse/team/internal/ccvs/ui/AnnotateView.java;2;1;9;1;3;3;3;6;68;1;6;52;221;221;1;0;0;6;9;52;0;336;9;2;1
/org.eclipse.jdt.ui/core refactoring/org/eclipse/jdt/internal/corext/refactoring/nls/Messages.java;2;1;2;1;2;2;2;0;2;0;0;279;2;2;1;0;0;0;2;279;0;336;2;2;0
/org.eclipse.debug.ui/ui/org/eclipse/debug/internal/ui/views/variables/IValueContentProvider.java;1;0;1;1;0;0;0;1;0;0;1;148;0;0;1;0;0;1;1;148;0;148;1;1;0
/org.eclipse.compare/compare/org/eclipse/compare/internal/patch/PatchWizard.java;1;0;10;1;0;0;0;10;21;3;6;19;42;42;3;4;0;10;10;186;4;219;6;1;0
/org.eclipse.jface.text/src/org/eclipse/jface/text/contentassist/PopupCloser.java;2;0;3;1;2;1;2;1;15;0;1;119;22;22;2;0;1;1;3;336;1;336;2;2;0
/org.eclipse.osgi/resolver/src/org/eclipse/osgi/internal/resolver/StateManager.java;5;4;22;2;7;3;7;15;135;6;4;171;378;378;6;11;4;15;22;171;15;324;7;5;0
/org.eclipse.ui.ide/src/org/eclipse/ui/views/tasklist/IMarkerConstants.java;1;0;1;1;0;0;0;1;0;0;1;129;0;0;1;0;0;1;1;129;0;129;1;1;0
/org.eclipse.ui.editors/src/org/eclipse/ui/editors/text/IEncodingSupport.java;1;0;1;1;1;1;1;0;4;0;0;336;4;4;1;0;0;0;1;336;0;336;1;1;0
/org.eclipse.search/search/org/eclipse/search/internal/ui/util/ListDialog.java;1;0;1;1;1;1;1;0;2;0;0;336;2;2;1;0;0;0;1;336;0;336;1;1;0
/org.eclipse.ui.ide/src/org/eclipse/ui/wizards/datatransfer/WizardZipFileResourceExportPage1.java;2;0;3;1;0;0;0;3;33;1;3;92;40;40;1;0;0;3;3;92;0;159;3;2;0
/org.eclipse.jdt.core/search/org/eclipse/jdt/internal/core/search/AbstractSearchScope.java;2;0;2;1;0;0;0;2;2;1;2;113;4;4;1;0;0;2;2;113;0;199;2;2;0
/org.eclipse.team.core/src/org/eclipse/team/core/subscribers/Subscriber.java;2;2;9;2;3;2;3;6;391;5;2;220;500;500;5;4;1;6;9;232;5;335;4;2;0
/org.eclipse.ltk.core.refactoring/src/org/eclipse/ltk/core/refactoring/participants/RenameRefactoring.java;1;1;4;1;2;2;2;2;21;0;1;264;32;32;2;1;0;2;4;264;1;336;3;1;0
/org.eclipse.pde.ui/src/org/eclipse/pde/internal/ui/editor/site/ArchiveSection.java;2;1;6;1;3;3;3;3;399;1;3;134;666;666;1;0;0;3;6;134;0;336;6;2;0
/org.eclipse.help/src/org/eclipse/help/internal/protocols/HelpURLConnection.java;1;1;9;1;3;3;3;6;232;3;3;64;476;476;3;3;0;6;9;245;3;336;6;1;1
/org.eclipse.jdt.junit/src/org/eclipse/jdt/internal/junit/ui/JUnitPreferencePage.java;2;1;3;1;3;3;3;0;5;0;0;303;11;11;1;0;0;0;3;303;0;336;3;2;0
/org.eclipse.jdt.core/model/org/eclipse/jdt/internal/core/JarEntryFile.java;1;0;1;1;0;0;0;1;2;0;1;199;2;2;1;0;0;1;1;199;0;199;1;1;0
/org.eclipse.team.cvs.ui/src/org/eclipse/team/internal/ccvs/ui/SynchronizeProjectsDialog.java;1;0;1;1;0;0;0;1;9;0;1;138;9;9;1;0;0;1;1;138;0;138;1;1;0
/org.eclipse.osgi/eclipseAdaptor/src/org/eclipse/osgi/service/localization/BundleLocalization.java;3;0;3;2;1;1;1;2;4;0;1;261;8;8;2;1;0;2;3;261;1;276;2;3;0
/org.eclipse.jdt.ui/ui/org/eclipse/jdt/internal/ui/workingsets/WorkingSetFilter.java;2;0;3;1;1;1;1;2;5;1;2;84;12;12;1;0;0;2;3;84;0;336;3;2;0
/org.eclipse.jdt.ui/core extension/org/eclipse/jdt/internal/corext/dom/NodeFinder.java;3;0;5;1;1;1;1;4;50;1;4;27;71;71;1;0;0;4;5;27;0;336;5;3;0
/org.eclipse.ui.ide/src/org/eclipse/ui/views/markers/internal/FiltersAction.java;5;0;5;1;1;1;1;4;12;1;4;129;17;17;1;0;0;4;5;129;0;336;5;5;0
/org.eclipse.jdt.ui/core extension/org/eclipse/jdt/internal/corext/dom/ScopeAnalyzer.java;2;1;13;1;2;2;2;11;510;8;3;16;631;631;8;8;0;11;13;16;8;336;5;2;0
/org.eclipse.jdt.debug.ui/ui/org/eclipse/jdt/internal/debug/ui/snippeteditor/ScrapbookLauncher.java;3;2;9;2;4;3;4;5;19;2;3;44;47;47;2;2;1;5;9;44;3;336;6;3;0
/org.eclipse.jdt.ui/ui refactoring/org/eclipse/jdt/internal/ui/refactoring/reorg/ReorgCopyStarter.java;3;0;7;1;1;1;3;4;20;3;2;70;36;36;3;2;2;6;7;70;4;336;3;3;0
/org.eclipse.debug.ui/ui/org/eclipse/debug/ui/IDebugModelPresentation.java;3;0;3;1;1;1;1;2;4;1;2;128;6;6;1;0;0;2;3;128;0;336;3;3;0
/org.eclipse.jdt.ui/ui/org/eclipse/jdt/internal/ui/viewsupport/JavaElementImageProvider.java;4;2;8;2;4;3;4;4;22;2;3;76;42;42;2;1;1;4;8;187;2;336;6;4;1
/org.eclipse.debug.ui/ui/org/eclipse/debug/internal/ui/actions/RetargetToggleLineBreakpointAction.java;1;0;2;1;0;0;0;2;1;0;1;245;1;1;2;1;0;2;2;245;1;245;1;1;0
/org.eclipse.swt/Eclipse SWT PI/motif/org/eclipse/swt/internal/motif/XButtonEvent.java;1;0;2;1;0;0;0;2;16;0;1;54;16;16;2;1;0;2;2;54;1;54;1;1;0
/org.eclipse.ui.workbench/Eclipse UI/org/eclipse/ui/internal/EditorSashContainer.java;4;3;5;3;5;2;5;0;57;0;0;297;76;76;3;0;3;0;5;328;3;328;2;4;5
/org.eclipse.update.core/src/org/eclipse/update/internal/core/FeatureExecutableFactory.java;2;1;3;1;2;2;2;1;11;0;1;58;24;24;1;0;0;1;3;58;0;336;3;2;1
/org.eclipse.ant.ui/Ant Tools Support/org/eclipse/ant/internal/ui/preferences/StatusInfo.java;1;0;3;1;1;1;1;2;10;1;2;108;14;14;1;0;0;2;3;108;0;336;3;1;1
/org.eclipse.osgi/eclipseAdaptor/src/org/eclipse/osgi/service/environment/Constants.java;4;1;5;1;3;3;3;2;8;1;2;178;26;26;1;0;0;2;5;178;0;336;5;4;0
/org.eclipse.ui.workbench/Eclipse UI/org/eclipse/ui/internal/dnd/SwtUtil.java;1;0;5;1;3;1;3;2;45;0;1;264;72;72;3;1;2;2;5;304;3;304;2;1;1
/org.eclipse.jdt.core/compiler/org/eclipse/jdt/internal/compiler/ast/Argument.java;2;0;8;2;1;1;1;7;61;2;5;1;129;129;2;2;0;7;8;1;2;299;6;2;2
/org.eclipse.search/search/org/eclipse/search/internal/ui/SearchResultContentProvider.java;1;0;1;1;1;1;1;0;2;0;0;336;2;2;1;0;0;0;1;336;0;336;1;1;0
/org.eclipse.jdt.core/model/org/eclipse/jdt/internal/core/jdom/SiblingEnumeration.java;1;0;2;1;1;1;1;1;6;0;1;199;8;8;1;0;0;1;2;199;0;299;2;1;0
/org.eclipse.jdt.core/model/org/eclipse/jdt/internal/core/hierarchy/HierarchyBinaryType.java;1;0;1;1;0;0;0;1;2;0;1;199;2;2;1;0;0;1;1;199;0;199;1;1;0
/org.eclipse.jdt.core/model/org/eclipse/jdt/core/BufferChangedEvent.java;1;0;2;1;0;0;0;2;2;1;2;188;4;4;1;0;0;2;2;188;0;199;2;1;0
/org.eclipse.ui.workbench/Eclipse UI/org/eclipse/ui/internal/util/SWTResourceUtil.java;1;0;1;1;1;1;1;0;0;0;0;312;0;0;1;0;0;0;1;312;0;312;1;1;0
/org.eclipse.jdt.core/compiler/org/eclipse/jdt/internal/compiler/classfmt/ClassFileReader.java;4;1;9;1;3;3;3;6;29;2;5;17;99;99;2;1;0;6;9;17;1;331;8;4;1
/org.eclipse.ui.workbench/Eclipse UI/org/eclipse/ui/internal/IHelpContextIds.java;3;1;5;1;3;3;3;2;2;1;2;53;6;6;1;0;0;2;5;53;0;336;5;3;1
/org.eclipse.jdt.ui/ui/org/eclipse/jdt/internal/ui/javaeditor/JavaMarkerAnnotation.java;4;1;10;2;2;2;2;8;291;3;4;75;446;446;3;4;0;8;10;75;4;336;6;4;0
/org.eclipse.jdt.ui/ui/org/eclipse/jdt/internal/ui/text/correction/AssistContext.java;3;1;11;1;2;2;2;9;21;2;7;65;60;60;2;2;0;9;11;162;2;336;9;3;0
/org.eclipse.ui.workbench/Eclipse UI/org/eclipse/ui/internal/ActionDescriptor.java;5;1;7;2;3;3;3;4;21;2;3;54;73;73;2;1;0;4;7;54;1;336;6;5;1
/org.eclipse.core.runtime/src/org/eclipse/core/runtime/IExtensionDelta.java;4;2;6;1;3;2;3;3;52;2;2;177;75;75;2;1;1;3;6;177;2;336;4;4;0
/org.eclipse.jdt.ui/ui/org/eclipse/jdt/internal/ui/browsing/PackageViewerWrapper.java;1;0;2;1;1;1;1;1;6;0;1;39;8;8;1;0;0;1;2;39;0;336;2;1;0
/org.eclipse.ui.views/src/org/eclipse/ui/views/properties/IPropertySheetEntry.java;2;1;2;1;2;2;2;0;273;0;0;295;277;277;1;0;0;0;2;295;0;336;2;2;0
/org.eclipse.search/search/org/eclipse/search/internal/ui/ResourceToItemsMapper.java;1;0;1;1;1;1;1;0;2;0;0;336;2;2;1;0;0;0;1;336;0;336;1;1;0
/org.eclipse.jdt.ui/ui/org/eclipse/jdt/internal/ui/preferences/formatter/ControlStatementsTabPage.java;1;0;9;1;1;1;1;8;94;3;5;176;179;179;3;3;0;8;9;191;3;280;6;1;0
/org.eclipse.team.core/src/org/eclipse/team/internal/core/subscribers/SyncInfoWorkingSetFilter.java;1;0;3;1;1;1;1;2;111;1;2;199;113;113;1;0;0;2;3;199;0;336;3;1;0
/org.eclipse.swt/Eclipse SWT PI/gtk/org/eclipse/swt/internal/accessibility/gtk/GtkAccessible.java;4;0;4;1;1;1;1;3;17;1;3;75;21;21;1;0;0;3;4;75;0;337;4;4;0
/org.eclipse.osgi/resolver/src/org/eclipse/core/internal/dependencies/SelectionVisitor.java;3;0;3;2;2;1;2;1;22;0;1;171;22;22;2;0;1;1;3;276;1;276;2;3;0
/org.eclipse.ui.ide/src/org/eclipse/ui/views/navigator/SortViewAction.java;1;0;1;1;0;0;0;1;0;0;1;129;0;0;1;0;0;1;1;129;0;129;1;1;0
/org.eclipse.text/src/org/eclipse/jface/text/BadPartitioningException.java;2;2;4;2;3;2;3;1;22;0;1;92;23;23;2;0;1;1;4;334;1;334;3;2;0
/org.eclipse.core.runtime/src/org/eclipse/core/internal/runtime/AuthorizationHandler.java;2;1;2;2;2;2;2;0;5;0;0;279;5;5;1;0;0;0;2;279;0;296;2;2;1
/org.eclipse.ui.workbench/Eclipse UI/org/eclipse/ui/help/DialogPageContextComputer.java;2;0;2;1;0;0;0;2;3;1;2;0;5;5;1;0;0;2;2;0;0;75;2;2;0
/org.eclipse.osgi/defaultAdaptor/src/org/eclipse/osgi/framework/internal/defaultadaptor/DefaultBundleData.java;6;3;19;4;4;2;4;15;976;6;6;171;1723;1723;6;9;2;15;19;226;11;295;8;6;0
/org.eclipse.jdt.core/compiler/org/eclipse/jdt/internal/compiler/ast/ExplicitConstructorCall.java;2;0;6;1;0;0;0;6;50;2;5;3;111;111;2;1;0;6;6;56;1;199;5;2;2
/org.eclipse.jface.text/src/org/eclipse/jface/text/contentassist/IContentAssistProcessor.java;2;0;3;1;2;1;2;1;18;0;1;226;22;22;2;0;1;1;3;336;1;336;2;2;0
/org.eclipse.jdt.ui/ui/org/eclipse/jdt/internal/ui/text/TextMessages.java;1;0;1;1;0;0;0;1;0;0;1;245;0;0;1;0;0;1;1;245;0;245;1;1;0
/org.eclipse.ant.core/src/org/eclipse/ant/core/AntCorePreferences.java;3;4;32;2;7;3;7;25;481;6;11;0;1579;1579;6;14;4;25;32;225;18;336;14;3;0
/org.eclipse.team.cvs.core/src/org/eclipse/team/internal/ccvs/core/util/SyncFileWriter.java;2;5;14;2;9;2;9;5;45;2;3;56;117;117;5;2;7;5;14;314;9;314;5;2;1
/org.eclipse.pde.ui/src/org/eclipse/pde/internal/ui/editor/site/ArchivePage.java;2;2;6;2;4;3;4;2;61;1;2;134;106;106;2;0;1;2;6;308;1;336;5;2;0
/org.eclipse.ui.workbench/Eclipse UI/org/eclipse/ui/internal/keys/AbstractKeyFormatter.java;1;0;2;1;0;0;0;2;1;0;1;187;1;1;2;1;0;2;2;187;1;187;1;1;0
/org.eclipse.pde.ui/src/org/eclipse/pde/internal/ui/wizards/templates/BaseEditorTemplate.java;3;1;6;1;3;3;3;3;15;1;3;159;38;38;1;0;0;3;6;159;0;336;6;3;0
/org.eclipse.debug.ui/ui/org/eclipse/debug/internal/ui/sourcelookup/browsers/FolderSourceContainerBrowser.java;2;0;6;1;0;0;0;6;17;3;4;209;25;25;3;2;0;6;6;266;2;266;4;2;0
/org.eclipse.debug.core/core/org/eclipse/debug/internal/core/OutputStreamMonitor.java;4;1;7;2;2;2;2;5;94;3;3;122;113;113;3;2;0;5;7;122;2;336;5;4;2
/org.eclipse.jface/src/org/eclipse/jface/action/ContributionManager.java;6;2;11;3;3;2;3;8;115;4;4;162;193;193;4;4;1;8;11;226;5;336;6;6;1
/org.eclipse.ui.ide/extensions/org/eclipse/ui/actions/CloseResourceAction.java;1;0;2;1;0;0;0;2;4;1;2;132;4;4;1;0;0;2;2;132;0;150;2;1;0
/org.eclipse.jdt.ui/core refactoring/org/eclipse/jdt/internal/corext/refactoring/changes/CopyPackageChange.java;2;1;4;1;2;2;2;2;8;1;2;219;16;16;1;0;0;2;4;219;0;336;4;2;0
/org.eclipse.team.cvs.ui/src/org/eclipse/team/internal/ccvs/ui/subscriber/WorkspaceCommitAction.java;2;2;3;1;3;2;3;0;44;0;0;294;48;48;2;0;1;0;3;294;1;336;2;2;1
/org.eclipse.swt/Eclipse SWT/gtk/org/eclipse/swt/widgets/Slider.java;6;1;10;2;2;2;2;8;30;2;6;19;110;110;2;2;0;8;10;179;2;337;8;6;0
/org.eclipse.jdt.ui/ui refactoring/org/eclipse/jdt/internal/ui/refactoring/nls/search/NLSSearchResultPage.java;2;0;4;1;3;1;3;1;67;0;1;268;67;67;3;0;2;1;4;293;2;293;2;2;1
/org.eclipse.jdt.core/model/org/eclipse/jdt/internal/core/jdom/DOMPackage.java;1;0;2;1;1;1;1;1;6;0;1;199;8;8;1;0;0;1;2;199;0;299;2;1;0
/org.eclipse.ltk.ui.refactoring/src/org/eclipse/ltk/internal/ui/refactoring/ChangeElementTreeViewer.java;1;0;2;1;1;1;1;1;2;0;1;269;2;2;1;0;0;1;2;269;0;336;2;1;0
/org.eclipse.jdt.ui/core refactoring/org/eclipse/jdt/internal/corext/refactoring/reorg/SourceRangeComputer.java;2;0;2;1;1;1;1;1;4;0;1;126;6;6;1;0;0;1;2;126;0;336;2;2;0
/org.eclipse.ui.workbench.texteditor/src/org/eclipse/ui/internal/texteditor/quickdiff/RevertLineAction.java;3;0;4;1;1;1;1;3;6;1;3;100;15;15;1;0;0;3;4;100;0;336;4;3;0
/org.eclipse.jdt.ui/ui/org/eclipse/jdt/internal/ui/preferences/TodoTaskPropertyPage.java;2;1;6;1;2;2;3;3;26;2;3;81;50;50;2;0;1;4;6;268;1;336;5;2;0
/org.eclipse.ui.workbench.texteditor/src/org/eclipse/ui/internal/texteditor/quickdiff/RevertBlockAction.java;3;0;4;1;1;1;1;3;6;1;3;100;13;13;1;0;0;3;4;100;0;336;4;3;0
/org.eclipse.jdt.core/search/org/eclipse/jdt/internal/core/search/indexing/IIndexConstants.java;2;0;6;2;0;0;0;6;25;2;5;88;41;41;2;1;0;6;6;225;1;225;5;2;0
/org.eclipse.team.ui/src/org/eclipse/team/internal/ui/IPreferenceIds.java;2;3;17;2;6;3;6;11;43;5;6;63;120;120;5;5;3;11;17;73;8;332;9;2;1
/org.eclipse.core.expressions/src/org/eclipse/core/expressions/ExpressionConverter.java;1;2;5;1;3;2;3;2;10;1;2;227;17;17;2;0;1;2;5;334;1;334;4;1;0
/org.eclipse.ui.workbench/Eclipse UI/org/eclipse/ui/internal/commands/IMutableCommandManager.java;2;2;4;1;4;3;4;0;21;0;0;281;27;27;2;0;1;0;4;289;1;336;3;2;0
/org.eclipse.pde.core/src/org/eclipse/pde/internal/core/schema/AbstractSchemaDescriptor.java;2;0;4;2;2;1;2;2;8;1;2;232;16;16;2;0;1;2;4;330;1;330;3;2;0
/org.eclipse.update.scheduler/src/org/eclipse/update/internal/scheduler/preferences/AutomaticUpdatesPreferencePage.java;3;1;9;2;3;3;3;6;85;3;4;62;335;335;3;2;0;6;9;62;2;336;7;3;0
/org.eclipse.jdt.ui/ui refactoring/org/eclipse/jdt/internal/ui/refactoring/UserInterfaceManager.java;1;0;5;1;0;0;1;4;16;3;2;247;22;22;3;2;1;5;5;247;3;269;2;1;0
/org.eclipse.debug.ui/ui/org/eclipse/debug/internal/ui/sourcelookup/DownAction.java;1;0;1;1;0;0;0;1;0;0;1;209;0;0;1;0;0;1;1;209;0;209;1;1;0
/org.eclipse.ui.workbench/Eclipse UI/org/eclipse/ui/internal/commands/ActiveKeyConfigurationDefinition.java;2;0;10;1;1;1;1;9;45;3;6;84;144;144;3;3;0;9;10;84;3;336;7;2;0
/org.eclipse.jdt.core/model/org/eclipse/jdt/internal/core/builder/ProblemFactory.java;1;0;1;1;0;0;0;1;2;0;1;199;2;2;1;0;0;1;1;199;0;199;1;1;0
/org.eclipse.jdt.debug/model/org/eclipse/jdt/internal/debug/core/breakpoints/JavaWatchpoint.java;5;0;7;2;1;1;1;6;54;2;4;26;79;79;2;2;0;6;7;78;2;336;5;5;1
/org.eclipse.jdt.core/model/org/eclipse/jdt/core/jdom/IDOMImport.java;3;1;6;1;3;3;3;3;31;1;3;199;49;49;1;0;0;3;6;199;0;312;6;3;0
/org.eclipse.swt/Eclipse SWT/carbon/org/eclipse/swt/graphics/Cursor.java;3;1;6;1;2;2;2;4;127;2;3;18;241;241;2;1;0;4;6;18;1;337;5;3;1
/org.eclipse.ui.ide/src/org/eclipse/ui/internal/ide/registry/IDERegistryReader.java;2;0;2;1;0;0;0;2;4;1;2;132;4;4;1;0;0;2;2;132;0;160;2;2;1
/org.eclipse.text/src/org/eclipse/jface/text/IDocument.java;3;0;5;1;2;1;2;3;132;1;3;17;139;139;2;0;1;3;5;334;1;334;4;3;0
/org.eclipse.jdt.ui/ui/org/eclipse/jdt/internal/ui/compare/JavaStructureCreator.java;3;2;9;2;3;2;3;6;25;2;5;79;61;61;2;1;1;6;9;265;2;331;7;3;2
/org.eclipse.jdt.ui/ui/org/eclipse/jdt/internal/ui/text/java/hover/ProblemHover.java;1;0;1;1;1;1;1;0;0;0;0;302;0;0;1;0;0;0;1;302;0;302;1;1;0
/org.eclipse.update.core/src/org/eclipse/update/internal/core/SiteReconciler.java;3;2;11;2;3;2;3;8;1887;3;6;58;3466;3466;3;2;1;8;11;191;3;336;8;3;0
/org.eclipse.jdt.ui/ui/org/eclipse/jdt/internal/ui/preferences/formatter/ProfileStore.java;1;0;10;1;5;1;5;5;283;4;2;199;432;432;5;3;4;5;10;313;7;313;3;1;0
/org.eclipse.jdt.debug/jdi/org/eclipse/jdi/internal/AccessibleImpl.java;1;0;2;1;0;0;0;2;14;1;2;130;16;16;1;0;0;2;2;130;0;235;2;1;0
/org.eclipse.text/projection/org/eclipse/jface/text/projection/Segment.java;2;0;3;2;2;1;2;1;37;0;1;247;37;37;2;0;1;1;3;334;1;334;2;2;0
/org.eclipse.pde.ui/src/org/eclipse/pde/internal/ui/wizards/imports/BaseImportWizardSecondPage.java;2;1;16;1;3;3;3;13;245;5;5;45;386;386;5;8;0;13;16;45;8;336;8;2;0
/org.eclipse.pde.core/src/org/eclipse/pde/internal/core/bundle/BundleObject.java;3;1;5;1;3;3;3;2;4;0;1;128;10;10;2;1;0;2;5;128;1;336;4;3;0
/org.eclipse.update.core/src/org/eclipse/update/operations/IToggleSiteOperation.java;1;0;6;1;1;1;1;5;13;2;4;54;22;22;2;1;0;5;6;267;1;292;5;1;0
/org.eclipse.jdt.ui/ui/org/eclipse/jdt/ui/actions/OpenExternalJavadocAction.java;3;0;3;1;1;1;1;2;10;1;2;41;14;14;1;0;0;2;3;41;0;336;3;3;0
/org.eclipse.jdt.debug/model/org/eclipse/jdt/internal/debug/core/logicalstructures/JDIPlaceholderVariable.java;2;0;2;1;0;0;0;2;5;1;2;152;5;5;1;0;0;2;2;152;0;177;2;2;1
/org.eclipse.team.cvs.ui/src/org/eclipse/team/internal/ccvs/ui/actions/BranchAction.java;2;1;3;1;2;2;2;1;170;0;1;56;176;176;1;0;0;1;3;56;0;336;3;2;1
/org.eclipse.jdt.ui/ui/org/eclipse/jdt/internal/ui/wizards/dialogfields/SelectionButtonDialogFieldGroup.java;2;1;2;1;2;2;2;0;21;0;0;282;23;23;1;0;0;0;2;282;0;336;2;2;0
/org.eclipse.pde.runtime/src/org/eclipse/pde/internal/runtime/PDERuntimePlugin.java;2;1;8;2;2;2;2;6;46;3;3;55;74;74;3;3;0;6;8;224;3;336;5;2;0
/org.eclipse.ui.workbench/Eclipse UI/org/eclipse/ui/internal/KeyBindingService.java;3;2;28;2;3;2;3;25;755;6;8;46;1588;1588;6;17;1;25;28;67;18;335;10;3;0
/org.eclipse.team.cvs.core/src/org/eclipse/team/internal/ccvs/core/client/UpdatedHandler.java;2;0;5;2;1;1;1;4;33;2;3;52;59;59;2;1;0;4;5;52;1;336;4;2;0
/org.eclipse.jdt.ui/ui/org/eclipse/jdt/internal/ui/javaeditor/ClassFileEditorInputFactory.java;1;0;1;1;1;1;1;0;2;0;0;336;2;2;1;0;0;0;1;336;0;336;1;1;0
/org.eclipse.osgi/core/framework/org/eclipse/osgi/framework/eventmgr/EventManager.java;4;2;6;1;4;3;4;2;196;1;2;171;435;435;2;0;1;2;6;302;1;302;5;4;0
/org.eclipse.ui.workbench/Eclipse UI/org/eclipse/ui/internal/MaximizePartAction.java;4;0;5;1;1;1;1;4;21;1;4;53;53;53;1;0;0;4;5;53;0;336;5;4;0
/org.eclipse.jdt.core/dom/org/eclipse/jdt/core/dom/StructuralPropertyDescriptor.java;2;0;2;1;1;1;1;1;6;0;1;232;6;6;1;0;0;1;2;232;0;312;2;2;0
/org.eclipse.ant.ui/Ant Editor/org/eclipse/ant/internal/ui/editor/text/IReconcilingParticipant.java;1;0;1;1;0;0;0;1;0;0;1;108;0;0;1;0;0;1;1;108;0;108;1;1;0
/org.eclipse.jdt.ui/ui/org/eclipse/jdt/ui/actions/SurroundWithTryCatchAction.java;4;1;16;2;4;4;5;11;26;3;8;9;82;82;3;3;1;12;16;267;4;336;12;4;0
/org.eclipse.ui.ide/src/org/eclipse/ui/internal/ide/misc/OverlayIcon.java;3;1;3;1;2;2;2;1;4;0;1;132;6;6;1;0;0;1;3;132;0;336;3;3;0
/org.eclipse.swt/Eclipse SWT/carbon/org/eclipse/swt/graphics/Font.java;3;2;8;1;5;4;5;3;43;2;2;113;106;106;2;1;1;3;8;113;2;337;6;3;2
/org.eclipse.core.expressions/src/org/eclipse/core/internal/expressions/AssertionFailedException.java;1;1;3;1;2;2;2;1;6;0;1;227;8;8;1;0;0;1;3;227;0;336;3;1;0
/org.eclipse.ui.workbench/Eclipse UI/org/eclipse/ui/internal/dialogs/ShowViewDialog.java;5;0;7;3;1;1;1;6;652;2;4;157;968;968;2;2;0;6;7;174;2;336;5;5;2
/org.eclipse.swt/Eclipse SWT/photon/org/eclipse/swt/widgets/ColorDialog.java;2;1;3;1;3;3;3;0;4;0;0;300;10;10;1;0;0;0;3;300;0;337;3;2;0
/org.eclipse.ant.ui/Ant Editor/org/eclipse/ant/internal/ui/dtd/IAtom.java;1;0;1;1;0;0;0;1;0;0;1;108;0;0;1;0;0;1;1;108;0;108;1;1;0
/org.eclipse.jface.text/projection/org/eclipse/jface/text/source/projection/SourceViewerInformationControl.java;2;2;5;2;4;2;4;1;14;0;1;265;23;23;2;0;2;1;5;275;2;336;3;2;0
/org.eclipse.search/search/org/eclipse/search/internal/ui/text/FileLabelProvider.java;2;4;9;1;5;2;5;4;128;2;3;194;193;193;4;1;3;4;9;286;4;336;5;2;0
/org.eclipse.jdt.core/dom/org/eclipse/jdt/core/dom/IExtendedModifier.java;1;0;2;1;1;1;1;1;6;0;1;246;6;6;1;0;0;1;2;246;0;283;2;1;1
/org.eclipse.swt/Eclipse SWT/win32/org/eclipse/swt/graphics/FontMetrics.java;1;1;2;1;2;2;2;0;4;0;0;299;7;7;1;0;0;0;2;299;0;337;2;1;1
/org.eclipse.ui.workbench/Eclipse UI/org/eclipse/ui/internal/dialogs/WizardContentProvider.java;4;1;7;3;2;2;2;5;51;2;3;174;132;132;2;2;0;5;7;174;2;336;5;4;0
/org.eclipse.core.resources/src/org/eclipse/core/internal/events/ResourceChangeEvent.java;1;0;1;1;1;1;1;0;132;0;0;277;132;132;1;0;0;0;1;277;0;277;1;1;0
/org.eclipse.jdt.ui/ui/org/eclipse/jdt/internal/ui/wizards/buildpaths/CPListElement.java;2;0;8;1;1;1;2;6;50;2;6;72;123;123;2;0;1;7;8;267;1;336;7;2;1
/org.eclipse.jdt.debug.ui/ui/org/eclipse/jdt/internal/debug/ui/launcher/IEntriesChangedListener.java;1;0;1;1;0;0;0;1;2;0;1;154;2;2;1;0;0;1;1;154;0;154;1;1;0
/org.eclipse.pde.core/src/org/eclipse/pde/internal/core/ifeature/IFeatureInfo.java;2;1;3;1;2;2;2;1;4;0;1;232;10;10;1;0;0;1;3;232;0;336;3;2;0
/org.eclipse.ui.workbench/Eclipse UI/org/eclipse/ui/internal/misc/ExternalEditor.java;2;0;3;1;1;1;1;2;19;1;2;157;40;40;1;0;0;2;3;157;0;336;3;2;0
/org.eclipse.jdt.core/dom/org/eclipse/jdt/core/dom/SwitchCase.java;3;0;8;1;2;1;2;6;79;2;5;199;111;111;2;1;1;6;8;266;2;276;6;3;1
/org.eclipse.pde.ui/src/org/eclipse/pde/internal/ui/preferences/SourcePreferencePage.java;2;1;10;1;3;3;3;7;109;2;6;26;272;272;2;1;0;7;10;197;1;336;9;2;0
/org.eclipse.team.cvs.core/src/org/eclipse/team/internal/ccvs/core/CVSTeamProviderType.java;2;0;2;1;1;1;1;1;8;0;1;269;10;10;1;0;0;1;2;269;0;336;2;2;0
/org.eclipse.pde.ui/src/org/eclipse/pde/internal/ui/editor/feature/FeatureSourcePage.java;1;1;4;1;2;2;2;2;27;1;2;59;58;58;1;0;0;2;4;59;0;336;4;1;0
/org.eclipse.jdt.ui/ui/org/eclipse/jdt/ui/actions/FindStringsToExternalizeAction.java;5;2;10;2;3;2;3;7;25;2;6;41;57;57;2;1;1;7;10;70;2;336;8;5;0
/org.eclipse.ui.editors/src/org/eclipse/ui/texteditor/MarkerUtilities.java;2;1;7;2;2;2;2;5;259;2;4;118;436;436;2;1;0;5;7;157;1;336;6;2;0
/org.eclipse.jface.text/src/org/eclipse/jface/text/templates/ContextTypeRegistry.java;3;2;7;2;4;3;4;3;235;2;2;234;411;411;2;1;1;3;7;253;2;336;5;3;0
/org.eclipse.jdt.debug.ui/ui/org/eclipse/jdt/internal/debug/ui/launcher/VMConnectTimeoutStatusHandler.java;1;0;1;1;0;0;0;1;6;0;1;144;6;6;1;0;0;1;1;144;0;144;1;1;0
/org.eclipse.ui.workbench/Eclipse UI/org/eclipse/ui/keys/KeyFormatterFactory.java;3;1;5;2;2;2;2;3;113;0;1;182;128;128;3;2;0;3;5;182;2;336;3;3;0
/org.eclipse.jdt.ui/core refactoring/org/eclipse/jdt/internal/corext/refactoring/changes/CopyPackageFragmentRootChange.java;2;1;4;1;2;2;2;2;12;1;2;219;23;23;1;0;0;2;4;219;0;336;4;2;0
/org.eclipse.ui.ide/src/org/eclipse/ui/internal/ide/DefaultContributorResourceAdapter.java;1;0;1;1;0;0;0;1;0;0;1;151;0;0;1;0;0;1;1;151;0;151;1;1;0
/org.eclipse.update.ui/src/org/eclipse/update/internal/ui/parts/AbstractOverlayIcon.java;1;0;1;1;0;0;0;1;7;0;1;58;7;7;1;0;0;1;1;58;0;58;1;1;0
/org.eclipse.ui.workbench.texteditor/src/org/eclipse/ui/texteditor/IElementStateListener.java;2;0;1;2;1;1;1;0;13;0;0;336;13;13;1;0;0;0;1;336;0;336;1;2;0
/org.eclipse.jdt.debug.ui/ui/org/eclipse/jdt/internal/debug/ui/classpath/BootpathFilter.java;1;0;1;1;0;0;0;1;0;0;1;238;0;0;1;0;0;1;1;238;0;238;1;1;0
/org.eclipse.core.resources/src_ant/org/eclipse/core/resources/ant/ConvertPath.java;2;2;4;1;4;3;4;0;244;0;0;274;274;274;2;0;1;0;4;274;1;313;3;2;0
/org.eclipse.ui.workbench/Eclipse UI/org/eclipse/ui/internal/presentations/SystemMenuClose.java;2;1;3;1;2;2;2;1;60;0;1;256;62;62;1;0;0;1;3;256;0;296;3;2;0
/org.eclipse.debug.ui/ui/org/eclipse/debug/internal/ui/views/console/ConsoleLineNotifier.java;2;0;6;2;0;0;0;6;98;5;2;110;124;124;5;4;0;6;6;123;4;123;2;2;2
/org.eclipse.jface.text/src/org/eclipse/jface/internal/text/link/contentassist/IProposalListener.java;2;0;2;1;1;1;1;1;2;0;1;246;2;2;1;0;0;1;2;246;0;336;2;2;0
/org.eclipse.ui.workbench/Eclipse UI/org/eclipse/ui/internal/contexts/AbstractContextManager.java;1;0;1;1;0;0;0;1;0;0;1;174;0;0;1;0;0;1;1;174;0;174;1;1;0
/org.eclipse.jdt.debug.ui/ui/org/eclipse/jdt/internal/debug/ui/monitors/MonitorQuitAction.java;2;0;2;1;0;0;0;2;41;1;2;110;51;51;1;0;0;2;2;110;0;246;2;2;0
/org.eclipse.jdt.ui/ui/org/eclipse/jdt/internal/ui/wizards/buildpaths/ProjectsWorkbookPage.java;2;1;2;1;2;2;2;0;2;0;0;311;4;4;1;0;0;0;2;311;0;336;2;2;0
/org.eclipse.jdt.ui/core refactoring/org/eclipse/jdt/internal/corext/refactoring/structure/ReferenceAnalyzer.java;3;2;8;2;4;3;4;4;60;2;3;93;98;98;2;1;1;4;8;93;2;336;6;3;0
/org.eclipse.core.runtime/src/org/eclipse/core/runtime/jobs/ProgressProvider.java;3;0;9;2;2;1;2;7;184;3;3;159;266;266;3;4;1;7;9;171;5;274;4;3;0
/org.eclipse.ui.editors/src/org/eclipse/ui/texteditor/SelectRulerAction.java;1;0;1;1;1;1;1;0;6;0;0;336;6;6;1;0;0;0;1;336;0;336;1;1;0
/org.eclipse.swt/Eclipse SWT PI/gtk/org/eclipse/swt/internal/gtk/GtkAllocation.java;3;0;3;1;1;1;1;2;17;1;2;100;21;21;1;0;0;2;3;100;0;337;3;3;0
/org.eclipse.jdt.debug.ui/ui/org/eclipse/jdt/internal/debug/ui/console/JavaExceptionHyperLink.java;2;1;4;1;2;2;2;2;48;1;2;134;54;54;1;0;0;2;4;134;0;336;4;2;1
/org.eclipse.core.resources/src/org/eclipse/core/internal/resources/Synchronizer.java;2;2;8;1;3;2;3;5;443;1;5;94;457;457;2;0;1;5;8;275;1;329;7;2;0
/org.eclipse.swt/Eclipse SWT Mozilla/common/org/eclipse/swt/internal/mozilla/nsIContextMenuListener.java;1;0;1;1;0;0;0;1;0;0;1;100;0;0;1;0;0;1;1;100;0;100;1;1;0
/org.eclipse.osgi/core/framework/org/eclipse/osgi/framework/internal/core/BundleContextImpl.java;2;2;5;1;5;4;5;0;236;0;0;276;272;272;2;0;1;0;5;293;1;326;4;2;0
/org.eclipse.pde.ui/src/org/eclipse/pde/internal/ui/editor/plugin/NewRuntimeLibraryDialog.java;3;1;3;2;3;3;3;0;13;0;0;292;17;17;1;0;0;0;3;292;0;336;3;3;0
/org.eclipse.jdt.ui/ui/org/eclipse/jdt/internal/ui/preferences/EditTemplateDialog.java;5;3;26;3;4;2;9;17;221;7;9;51;673;673;7;8;7;22;26;263;15;336;11;5;0
/org.eclipse.pde.ui/src/org/eclipse/pde/ui/IBasePluginWizard.java;2;2;4;1;4;3;4;0;14;0;0;276;27;27;2;0;1;0;4;295;1;336;3;2;0
/org.eclipse.jdt.debug/model/org/eclipse/jdt/internal/debug/core/model/JDIVariable.java;1;0;2;1;0;0;0;2;16;1;2;110;20;20;1;0;0;2;2;110;0;144;2;1;0
/org.eclipse.ant.ui/Ant Editor/org/eclipse/ant/internal/ui/dtd/util/SortedMapFactory.java;1;0;1;1;0;0;0;1;0;0;1;108;0;0;1;0;0;1;1;108;0;108;1;1;0
/org.eclipse.pde.ui/src/org/eclipse/pde/internal/ui/parts/CheckboxTablePart.java;1;1;2;1;2;2;2;0;10;0;0;292;14;14;1;0;0;0;2;292;0;336;2;1;0
/org.eclipse.osgi/defaultAdaptor/src/org/eclipse/osgi/framework/adaptor/core/AbstractBundleData.java;3;1;6;1;3;3;3;3;46;2;2;239;78;78;2;1;0;3;6;239;1;295;5;3;0
/org.eclipse.core.filebuffers/src/org/eclipse/core/filebuffers/IDocumentSetupParticipant.java;2;2;5;2;3;2;3;2;42;0;1;93;54;54;2;1;1;2;5;93;2;334;3;2;0
/org.eclipse.update.core/src/org/eclipse/update/core/IVerifier.java;2;1;3;1;2;2;2;1;6;0;1;58;12;12;1;0;0;1;3;58;0;336;3;2;0
/org.eclipse.jdt.core/dom/org/eclipse/jdt/core/dom/rewrite/ListRewrite.java;3;1;4;2;2;2;2;2;48;0;1;262;53;53;2;1;0;2;4;262;1;290;3;3;0
/org.eclipse.ui.workbench/Eclipse UI/org/eclipse/ui/internal/dialogs/ViewLabelProvider.java;3;0;5;1;1;1;1;4;44;1;4;157;74;74;1;0;0;4;5;157;0;336;5;3;0
/org.eclipse.jdt.ui/ui/org/eclipse/jdt/internal/ui/dialogs/StatusDialog.java;1;1;4;1;2;2;2;2;18;1;2;76;36;36;1;0;0;2;4;76;0;289;4;1;0
/org.eclipse.swt/Eclipse SWT PI/win32/org/eclipse/swt/internal/ole/win32/LICINFO.java;1;0;1;1;0;0;0;1;4;0;1;166;4;4;1;0;0;1;1;166;0;166;1;1;0
/org.eclipse.pde.core/src/org/eclipse/pde/core/IBaseModel.java;2;1;4;1;3;3;3;1;39;0;1;265;46;46;1;0;0;1;4;265;0;336;4;2;0
/org.eclipse.debug.core/core/org/eclipse/debug/core/IStreamListener.java;2;0;2;2;0;0;0;2;14;0;1;122;14;14;2;1;0;2;2;122;1;122;1;2;0
/org.eclipse.debug.core/core/org/eclipse/debug/core/sourcelookup/containers/AbstractSourceContainer.java;1;0;2;1;0;0;1;1;21;0;1;268;21;21;2;0;1;2;2;268;1;268;1;1;0
/org.eclipse.pde.ui/src/org/eclipse/pde/internal/ui/editor/schema/DocSection.java;3;2;9;2;5;4;5;4;221;1;4;26;333;333;2;0;1;4;9;301;1;336;8;3;0
/org.eclipse.ui.workbench/Eclipse UI/org/eclipse/ui/themes/IThemePreview.java;1;2;3;1;3;2;3;0;5;0;0;272;5;5;2;0;1;0;3;280;1;280;2;1;0
/org.eclipse.help.ide/src/org/eclipse/help/ui/internal/workingset/HelpWorkingSetSynchronizer.java;1;1;5;1;2;2;2;3;238;2;2;104;322;322;2;1;0;3;5;104;1;336;4;1;0
/org.eclipse.team.ui/src/org/eclipse/team/internal/ui/synchronize/SynchronizeModelElementLabelProvider.java;1;0;5;1;1;1;1;4;125;3;2;251;192;192;3;2;0;4;5;251;2;336;3;1;0
/org.eclipse.ant.ui/Ant Editor/org/eclipse/ant/internal/ui/editor/AntEditorMessages.java;1;0;1;1;0;0;0;1;0;0;1;108;0;0;1;0;0;1;1;108;0;108;1;1;0
/org.eclipse.ui.workbench/Eclipse UI/org/eclipse/ui/commands/IKeyConfiguration.java;3;1;12;1;2;2;2;10;172;6;4;80;473;473;6;6;0;10;12;80;6;336;6;3;0
/org.eclipse.pde.ui/src/org/eclipse/pde/internal/ui/build/BaseBuildAction.java;3;7;11;3;10;3;10;1;339;0;1;213;433;433;7;0;7;1;11;302;7;336;4;3;0
/org.eclipse.jdt.ui/ui/org/eclipse/jdt/ui/actions/FindReferencesInWorkingSetAction.java;2;2;6;1;3;2;3;3;14;1;3;82;31;31;2;0;1;3;6;290;1;336;5;2;0
/org.eclipse.pde.ui/src/org/eclipse/pde/internal/ui/wizards/plugin/TemplateListSelectionPage.java;3;2;5;2;5;4;5;0;48;0;0;295;60;60;2;0;1;0;5;325;1;336;4;3;0
/org.eclipse.ui.workbench/Eclipse UI/org/eclipse/ui/internal/WorkbenchIntroManager.java;1;0;5;1;2;1;4;1;39;0;1;270;56;56;3;0;3;3;5;270;3;330;2;1;1
/org.eclipse.jdt.ui/ui refactoring/org/eclipse/jdt/internal/ui/refactoring/reorg/RenameTypeWizard.java;2;1;4;1;2;2;2;2;8;0;1;66;17;17;2;1;0;2;4;66;1;336;3;2;0
/org.eclipse.search/search/org/eclipse/search/internal/ui/SearchAgainAction.java;1;0;1;1;1;1;1;0;2;0;0;336;2;2;1;0;0;0;1;336;0;336;1;1;0
/org.eclipse.jdt.ui/core refactoring/org/eclipse/jdt/internal/corext/refactoring/util/CommentAnalyzer.java;3;0;3;2;1;1;1;2;25;0;1;251;27;27;2;1;0;2;3;251;1;336;2;3;0
/org.eclipse.jdt.core/model/org/eclipse/jdt/core/IJavaModel.java;1;0;3;1;0;0;0;3;3;1;3;25;6;6;1;0;0;3;3;25;0;199;3;1;0
/org.eclipse.swt/Eclipse SWT Custom Widgets/common/org/eclipse/swt/custom/CTabFolder.java;4;17;50;3;21;2;21;29;6287;21;7;0;8199;8199;21;22;19;29;50;224;41;324;9;4;1
/org.eclipse.jdt.debug.ui/ui/org/eclipse/jdt/internal/debug/ui/JavaDebugPreferencePage.java;6;0;7;4;1;1;1;6;71;4;3;220;145;145;4;3;0;6;7;254;3;276;4;6;0
/org.eclipse.ant.ui/Ant Editor/org/eclipse/ant/internal/ui/editor/model/AntImportNode.java;1;1;3;1;2;2;2;1;13;0;1;233;17;17;1;0;0;1;3;233;0;314;3;1;1
/org.eclipse.swt/Eclipse SWT Drag and Drop/emulated/org/eclipse/swt/dnd/ByteArrayTransfer.java;1;1;2;1;2;2;2;0;4;0;0;300;6;6;1;0;0;0;2;300;0;337;2;1;0
/org.eclipse.ui.ide/src/org/eclipse/ui/views/markers/internal/ActionAddGlobalTask.java;4;0;5;1;1;1;1;4;2;1;4;129;7;7;1;0;0;4;5;129;0;336;5;4;0
/org.eclipse.team.cvs.core/src/org/eclipse/team/internal/ccvs/core/client/RemoveEntryHandler.java;1;0;1;1;0;0;0;1;8;0;1;138;8;8;1;0;0;1;1;138;0;138;1;1;0
/org.eclipse.ui.ide/extensions/org/eclipse/ui/dialogs/WizardNewFileCreationPage.java;3;1;3;1;2;2;2;1;24;0;1;132;26;26;1;0;0;1;3;132;0;336;3;3;1
/org.eclipse.ui.ide/extensions/org/eclipse/ui/dialogs/WizardImportPage.java;3;1;3;1;2;2;2;1;2;0;1;132;4;4;1;0;0;1;3;132;0;336;3;3;0
/org.eclipse.jdt.core/model/org/eclipse/jdt/internal/core/Buffer.java;3;0;11;2;0;0;0;11;70;3;6;2;154;154;3;5;0;11;11;131;5;258;6;3;1
/org.eclipse.jdt.launching/launching/org/eclipse/jdt/launching/StandardSourcePathProvider.java;4;0;7;2;1;1;1;6;46;2;5;146;105;105;2;1;0;6;7;146;1;336;6;4;0
/org.eclipse.ui.workbench/Eclipse UI/org/eclipse/ui/internal/dialogs/CustomizePerspectiveDialog.java;8;2;18;2;4;3;4;14;221;4;11;54;899;899;4;3;1;14;18;54;4;336;14;8;5
/org.eclipse.jdt.ui/ui refactoring/org/eclipse/jdt/internal/ui/refactoring/reorg/CreateTargetQueries.java;1;0;2;1;2;1;2;0;34;0;0;313;34;34;2;0;1;0;2;313;1;313;1;1;0
/org.eclipse.jdt.core/model/org/eclipse/jdt/core/util/ByteCodeVisitorAdapter.java;1;0;2;1;0;0;0;2;205;1;2;108;207;207;1;0;0;2;2;108;0;199;2;1;0
/org.eclipse.debug.ui/ui/org/eclipse/debug/internal/ui/actions/AddWatchExpressionAction.java;1;0;2;1;0;0;0;2;4;0;1;92;4;4;2;1;0;2;2;92;1;92;1;1;0
/org.eclipse.pde.ui/src/org/eclipse/pde/internal/ui/build/BuildPluginAction.java;2;4;11;2;9;3;9;2;29;1;2;213;52;52;4;0;6;2;11;272;6;336;5;2;0
/org.eclipse.jdt.debug.ui/ui/org/eclipse/jdt/internal/debug/ui/JavaWatchExpressionDelegate.java;4;0;5;2;1;1;1;4;41;2;3;92;50;50;2;1;0;4;5;108;1;336;4;4;0
/org.eclipse.swt/Eclipse SWT/gtk/org/eclipse/swt/widgets/Widget.java;6;2;32;3;4;3;4;28;176;5;11;2;779;779;5;17;1;28;32;64;18;335;14;6;1
/org.eclipse.core.resources/src/org/eclipse/core/internal/localstore/SafeFileInputStream.java;1;0;1;1;1;1;1;0;49;0;0;277;49;49;1;0;0;0;1;277;0;277;1;1;0
/org.eclipse.jdt.core/compiler/org/eclipse/jdt/internal/compiler/parser/diagnose/RangeUtil.java;1;0;2;1;0;0;0;2;2;1;2;180;2;2;1;0;0;2;2;180;0;199;2;1;0
/org.eclipse.jdt.core/model/org/eclipse/jdt/internal/core/JarPackageFragmentInfo.java;1;0;3;1;1;1;1;2;23;1;2;108;33;33;1;0;0;2;3;108;0;326;3;1;0
/org.eclipse.swt/Eclipse SWT Mozilla/common/org/eclipse/swt/internal/mozilla/nsIRequestObserver.java;1;0;1;1;0;0;0;1;0;0;1;153;0;0;1;0;0;1;1;153;0;153;1;1;0
/org.eclipse.ui.ide/extensions/org/eclipse/ui/IContributorResourceAdapter.java;3;1;3;1;2;2;2;1;2;0;1;151;4;4;1;0;0;1;3;151;0;336;3;3;0
/org.eclipse.ui.workbench/Eclipse UI/org/eclipse/ui/internal/WorkbenchConfigurer.java;4;1;7;1;2;2;2;5;175;1;5;77;214;214;1;0;0;5;7;77;0;336;7;4;0
/org.eclipse.core.runtime/src/org/eclipse/core/runtime/content/ITextContentDescriber.java;1;1;3;1;3;3;3;0;6;0;0;281;12;12;1;0;0;0;3;281;0;325;3;1;0
/org.eclipse.pde.ui/src/org/eclipse/pde/internal/ui/launcher/LaunchListener.java;2;2;8;2;4;2;4;4;370;2;3;99;541;541;2;1;2;4;8;208;3;330;5;2;0
/org.eclipse.pde.core/src/org/eclipse/pde/internal/core/site/SiteArchive.java;2;1;3;1;2;2;2;1;12;0;1;232;28;28;1;0;0;1;3;232;0;336;3;2;0
/org.eclipse.swt/Eclipse SWT/photon/org/eclipse/swt/widgets/Composite.java;4;1;9;1;2;2;2;7;59;2;6;19;121;121;2;1;0;7;9;188;1;337;8;4;0
/org.eclipse.pde.core/src/org/eclipse/pde/internal/core/plugin/PluginImport.java;2;3;9;2;6;3;6;3;68;1;3;104;153;153;3;0;3;3;9;288;3;336;6;2;0
/org.eclipse.core.resources/src/org/eclipse/core/internal/utils/Policy.java;2;2;8;1;3;2;3;5;200;2;4;90;270;270;2;1;1;5;8;90;2;294;6;2;1
/org.eclipse.jdt.ui/ui/org/eclipse/jdt/ui/actions/FindWriteReferencesAction.java;2;0;2;1;1;1;1;1;5;0;1;184;7;7;1;0;0;1;2;184;0;336;2;2;0
/org.eclipse.update.core/src/org/eclipse/update/operations/IOperation.java;1;1;7;1;2;2;2;5;17;2;4;54;34;34;2;1;0;5;7;76;1;336;6;1;0
/org.eclipse.core.expressions/src/org/eclipse/core/internal/expressions/TypeExtensionManager.java;1;0;5;1;2;1;2;3;162;2;2;227;249;249;2;1;1;3;5;227;2;289;3;1;0
/org.eclipse.swt/Eclipse SWT Custom Widgets/common/org/eclipse/swt/custom/BusyIndicator.java;2;1;4;1;2;2;2;2;28;0;1;71;51;51;2;1;0;2;4;71;1;337;3;2;0
/org.eclipse.help.webapp/src_servlets/org/eclipse/help/internal/webapp/servlet/InfocenterWorkingSetManager.java;1;1;8;1;3;3;3;5;299;2;4;26;417;417;2;1;0;5;8;26;1;336;7;1;0
/org.eclipse.jdt.debug.ui/ui/org/eclipse/jdt/internal/debug/ui/BreakpointUtils.java;5;0;7;2;1;1;1;6;18;2;5;102;38;38;2;1;0;6;7;121;1;336;6;5;1
/org.eclipse.jdt.ui/ui/org/eclipse/jdt/internal/ui/wizards/dialogfields/CheckedListDialogField.java;3;1;5;1;3;3;3;2;30;1;2;243;64;64;1;0;0;2;5;243;0;336;5;3;0
/org.eclipse.osgi/eclipseAdaptor/src/org/eclipse/osgi/service/urlconversion/URLConverter.java;2;0;2;1;1;1;1;1;10;0;1;203;12;12;1;0;0;1;2;203;0;276;2;2;0
/org.eclipse.team.cvs.ui/src/org/eclipse/team/internal/ccvs/ui/operations/RepositoryProviderOperation.java;2;2;12;2;3;2;3;9;124;3;6;49;259;259;3;3;1;9;12;101;4;336;8;2;0
/org.eclipse.ui.workbench/Eclipse UI/org/eclipse/ui/IPlaceholderFolderLayout.java;2;1;3;1;2;2;2;1;14;0;1;250;30;30;1;0;0;1;3;250;0;336;3;2;0
/org.eclipse.ui.ide/src/org/eclipse/ui/internal/ide/dialogs/LinkedResourcesPreferencePage.java;4;1;4;1;2;2;2;2;19;1;2;132;23;23;1;0;0;2;4;132;0;336;4;4;0
/org.eclipse.update.ui/src/org/eclipse/update/internal/ui/wizards/ShowActivitiesDialog.java;1;2;6;1;4;3;4;2;120;0;1;244;149;149;2;1;1;2;6;244;2;336;4;1;1
/org.eclipse.jdt.ui/ui/org/eclipse/jdt/ui/actions/BuildActionGroup.java;3;0;3;1;1;1;1;2;12;1;2;237;20;20;1;0;0;2;3;237;0;336;3;3;0
/org.eclipse.jdt.ui/ui/org/eclipse/jdt/internal/ui/typehierarchy/EnableMemberFilterAction.java;1;0;1;1;1;1;1;0;2;0;0;336;2;2;1;0;0;0;1;336;0;336;1;1;0
/org.eclipse.pde.ui/src/org/eclipse/pde/internal/ui/editor/site/SiteSourcePage.java;1;1;5;1;2;2;2;3;24;1;3;59;55;55;1;0;0;3;5;59;0;336;5;1;0
/org.eclipse.ui.workbench/Eclipse UI/org/eclipse/ui/commands/ICommand.java;3;2;26;1;3;2;3;23;632;14;7;70;1678;1678;14;16;1;23;26;70;17;336;9;3;0
/org.eclipse.ui.ide/src/org/eclipse/ui/views/markers/internal/FieldDone.java;2;0;3;1;1;1;1;2;56;1;2;129;91;91;1;0;0;2;3;129;0;336;3;2;0
/org.eclipse.jdt.core/compiler/org/eclipse/jdt/internal/compiler/ast/AssertStatement.java;3;0;8;2;0;0;1;7;55;2;6;3;113;113;2;1;1;8;8;3;2;269;6;3;0
/org.eclipse.jdt.ui/ui refactoring/org/eclipse/jdt/internal/ui/refactoring/InlineConstantWizard.java;3;0;5;1;1;1;2;3;102;2;3;36;116;116;2;0;1;4;5;269;1;336;4;3;0
/org.eclipse.jdt.core/compiler/org/eclipse/jdt/internal/compiler/parser/RecoveredImport.java;3;0;3;1;0;0;0;3;6;1;3;66;12;12;1;0;0;3;3;66;0;199;3;3;0
/org.eclipse.swt/Eclipse SWT/common/org/eclipse/swt/layout/FillLayout.java;2;0;5;1;1;1;1;4;78;1;4;28;118;118;1;0;0;4;5;28;0;337;5;2;0
/org.eclipse.ui.ide/src/org/eclipse/ui/views/markers/internal/ProblemView.java;5;2;7;2;4;3;4;3;41;1;3;183;54;54;2;0;1;3;7;330;1;330;6;5;0
/org.eclipse.update.core/src/org/eclipse/update/internal/core/BaseSiteLocalFactory.java;1;0;1;1;0;0;0;1;2;0;1;58;2;2;1;0;0;1;1;58;0;58;1;1;0
/org.eclipse.update.configurator/src/org/eclipse/update/internal/configurator/branding/IProductConstants.java;1;1;3;1;2;2;2;1;6;0;1;247;7;7;1;0;0;1;3;247;0;321;3;1;0
/org.eclipse.debug.ui/ui/org/eclipse/debug/internal/ui/MultipleInputDialog.java;2;3;4;2;4;2;4;0;12;0;0;280;22;22;3;0;2;0;4;280;2;336;2;2;0
/org.eclipse.jdt.ui/ui/org/eclipse/jdt/internal/ui/callhierarchy/CallHierarchyLabelProvider.java;3;0;7;1;1;1;1;6;70;3;4;12;84;84;3;2;0;6;7;12;2;336;5;3;0
/org.eclipse.ltk.ui.refactoring/src/org/eclipse/ltk/ui/refactoring/UndoRefactoringAction.java;1;1;2;1;2;2;2;0;2;0;0;288;2;2;1;0;0;0;2;288;0;336;2;1;0
/org.eclipse.jdt.ui/ui/org/eclipse/jdt/internal/ui/search/ElementNameSorter.java;3;1;3;1;2;2;2;1;35;0;1;183;39;39;1;0;0;1;3;183;0;336;3;3;0
/org.eclipse.osgi/osgi/src/org/osgi/framework/BundleContext.java;3;0;4;1;1;1;1;3;169;1;3;171;221;221;1;0;0;3;4;171;0;296;4;3;0
/org.eclipse.ui.workbench/Eclipse UI/org/eclipse/ui/internal/NavigationHistoryEditorInfo.java;1;0;1;1;0;0;0;1;3;0;1;157;3;3;1;0;0;1;1;157;0;157;1;1;0
/org.eclipse.jdt.core/model/org/eclipse/jdt/internal/core/SetClasspathOperation.java;3;1;21;2;2;2;3;18;145;4;12;1;387;387;4;6;1;19;21;1;7;306;14;3;1
/org.eclipse.debug.ui/ui/org/eclipse/debug/internal/ui/views/memory/PrintViewTabContextAction.java;1;0;1;1;1;1;1;0;0;0;0;282;0;0;1;0;0;0;1;282;0;282;1;1;0
/org.eclipse.ui.cheatsheets/src/org/eclipse/ui/internal/cheatsheets/data/AbstractSubItem.java;1;0;1;1;1;1;1;0;0;0;0;300;0;0;1;0;0;0;1;300;0;300;1;1;0
/org.eclipse.jdt.core/model/org/eclipse/jdt/internal/core/CompilationUnitVisitor.java;4;0;8;1;0;0;0;8;13;2;6;113;37;37;2;2;0;8;8;199;2;258;6;4;0
/org.eclipse.team.cvs.ui/src/org/eclipse/team/internal/ccvs/ui/wizards/KSubstWizardSelectionPage.java;1;0;1;1;0;0;0;1;2;0;1;138;2;2;1;0;0;1;1;138;0;138;1;1;0
/org.eclipse.jdt.ui/ui/org/eclipse/jdt/internal/ui/typehierarchy/MethodsLabelProvider.java;2;0;6;1;1;1;1;5;15;3;3;31;22;22;3;2;0;5;6;31;2;336;4;2;0
/org.eclipse.ui.workbench/Eclipse UI/org/eclipse/ui/internal/presentations/PaneFolder.java;3;9;12;3;12;2;12;0;215;0;0;283;336;336;9;0;10;0;12;283;10;313;2;3;2
/org.eclipse.jdt.core/model/org/eclipse/jdt/core/jdom/DOMFactory.java;1;0;3;1;1;1;1;2;6;1;2;108;12;12;1;0;0;2;3;108;0;299;3;1;0
/org.eclipse.ui.workbench/Eclipse UI/org/eclipse/ui/internal/contexts/IMutableContextManager.java;2;1;2;1;2;2;2;0;6;0;0;283;10;10;1;0;0;0;2;283;0;336;2;2;0
/org.eclipse.jdt.ui/core refactoring/org/eclipse/jdt/internal/corext/refactoring/code/ParameterData.java;2;0;2;1;1;1;1;1;14;0;1;41;16;16;1;0;0;1;2;41;0;336;2;2;0
/org.eclipse.jdt.core/dom/org/eclipse/jdt/core/dom/ConstructorInvocation.java;3;0;8;2;2;1;2;6;96;4;3;199;191;191;4;3;1;6;8;258;4;283;4;3;2
/org.eclipse.jdt.ui/core refactoring/org/eclipse/jdt/internal/corext/refactoring/code/flow/LocalFlowInfo.java;2;0;2;1;1;1;1;1;9;0;1;14;11;11;1;0;0;1;2;14;0;336;2;2;0
/org.eclipse.team.ui/src/org/eclipse/team/ui/synchronize/ISynchronizeModelElement.java;1;1;3;1;2;2;2;1;81;0;1;253;85;85;1;0;0;1;3;253;0;336;3;1;0
/org.eclipse.jdt.debug.ui/ui/org/eclipse/jdt/internal/debug/ui/jres/JREContainerWizardPage.java;3;1;7;2;2;2;2;5;66;3;2;67;113;113;3;3;0;5;7;67;3;336;4;3;0
/org.eclipse.pde.build/src/org/eclipse/pde/internal/build/ant/AntScript.java;2;2;11;2;5;4;5;6;2198;2;4;31;5580;5580;2;2;1;6;11;31;3;323;8;2;0
/org.eclipse.update.ui/src/org/eclipse/update/internal/ui/properties/InstallConfigurationPropertyPage.java;1;0;2;1;2;1;2;0;10;0;0;330;10;10;2;0;1;0;2;330;1;330;1;1;0
/org.eclipse.jdt.core/model/org/eclipse/jdt/core/JavaModelException.java;2;0;4;1;0;0;0;4;23;1;4;81;45;45;1;0;0;4;4;81;0;267;4;2;0
/org.eclipse.debug.ui/ui/org/eclipse/debug/internal/ui/sourcelookup/SourceElementAdapterFactory.java;1;0;1;1;0;0;0;1;0;0;1;252;0;0;1;0;0;1;1;252;0;252;1;1;0
/org.eclipse.debug.ui/ui/org/eclipse/debug/internal/ui/actions/OpenBreakpointMarkerAction.java;3;0;5;2;2;1;2;3;20;1;3;98;46;46;2;0;1;3;5;281;1;281;4;3;0
/org.eclipse.pde.ui/src_Forms/org/eclipse/pde/internal/ui/model/IDocumentNode.java;2;3;10;2;5;3;5;5;47;3;2;244;93;93;3;3;2;5;10;259;5;336;5;2;0
/org.eclipse.ui.workbench/Eclipse UI/org/eclipse/ui/internal/WWinPluginPulldown.java;4;1;4;1;3;3;3;1;167;0;1;3;179;179;1;0;0;1;4;3;0;336;4;4;0
/org.eclipse.debug.ui/ui/org/eclipse/debug/internal/ui/views/variables/StatusLineContributionItem.java;1;0;1;1;0;0;0;1;0;0;1;245;0;0;1;0;0;1;1;245;0;245;1;1;0
/org.eclipse.jdt.core/compiler/org/eclipse/jdt/internal/compiler/util/SimpleNameVector.java;1;0;1;1;0;0;0;1;2;0;1;199;2;2;1;0;0;1;1;199;0;199;1;1;0
/org.eclipse.ant.ui/Ant Editor/org/eclipse/ant/internal/ui/editor/text/PartiallySynchronizedDocument.java;1;2;6;1;3;2;3;3;67;2;2;108;90;90;2;1;1;3;6;238;2;288;4;1;1
/org.eclipse.ui.workbench/Eclipse UI/org/eclipse/ui/internal/AbstractSelectionService.java;3;1;4;1;2;2;2;2;22;1;2;38;43;43;1;0;0;2;4;38;0;336;4;3;0
/org.eclipse.search/search/org/eclipse/search/internal/ui/text/NewTextSearchActionGroup.java;2;1;5;1;2;2;2;3;106;2;2;194;128;128;2;1;0;3;5;194;1;336;4;2;0
/org.eclipse.jface.text/src/org/eclipse/jface/text/formatter/IFormattingStrategy.java;1;0;2;1;1;1;1;1;2;0;1;217;4;4;1;0;0;1;2;217;0;336;2;1;0
/org.eclipse.ui.ide/src/org/eclipse/ui/views/tasklist/PurgeCompletedAction.java;1;0;1;1;0;0;0;1;0;0;1;129;0;0;1;0;0;1;1;129;0;129;1;1;0
/org.eclipse.jdt.ui/core refactoring/org/eclipse/jdt/internal/corext/refactoring/changes/PackageReorgChange.java;3;0;5;1;1;1;1;4;32;1;4;41;49;49;1;0;0;4;5;41;0;336;5;3;0
/org.eclipse.update.core/src/org/eclipse/update/internal/model/DefaultPluginParser.java;2;1;4;1;2;2;2;2;20;1;2;58;38;38;1;0;0;2;4;58;0;336;4;2;0
/org.eclipse.core.resources/src/org/eclipse/core/internal/resources/Container.java;3;3;9;2;6;3;6;3;542;2;2;239;699;699;3;1;3;3;9;326;4;326;5;3;1
/org.eclipse.compare/compare/org/eclipse/compare/CompareViewerPane.java;1;0;4;1;1;1;1;3;14;1;3;19;24;24;1;0;0;3;4;19;0;335;4;1;1
/org.eclipse.core.resources/src/org/eclipse/core/internal/indexing/IndexedStoreException.java;1;0;1;1;1;1;1;0;94;0;0;277;94;94;1;0;0;0;1;277;0;277;1;1;0
/org.eclipse.jdt.core/compiler/org/eclipse/jdt/internal/compiler/lookup/SyntheticFieldBinding.java;1;0;1;1;0;0;0;1;2;0;1;199;2;2;1;0;0;1;1;199;0;199;1;1;0
/org.eclipse.jdt.core/codeassist/org/eclipse/jdt/internal/codeassist/impl/AssistOptions.java;3;0;3;1;0;0;0;3;149;1;3;111;152;152;1;0;0;3;3;111;0;199;3;3;0
/org.eclipse.swt/Eclipse SWT PI/motif/org/eclipse/swt/internal/motif/XSizeHints.java;2;0;2;1;1;1;1;1;4;0;1;263;4;4;1;0;0;1;2;263;0;337;2;2;0
/org.eclipse.jdt.debug.ui/ui/org/eclipse/jdt/internal/debug/ui/actions/EditDetailFormatterAction.java;1;0;1;1;0;0;0;1;4;0;1;76;4;4;1;0;0;1;1;76;0;76;1;1;0
/org.eclipse.jdt.ui/core extension/org/eclipse/jdt/internal/corext/codemanipulation/AddUnimplementedConstructorsOperation.java;2;1;9;1;2;2;2;7;396;3;5;41;419;419;3;2;0;7;9;96;2;336;7;2;0
/org.eclipse.team.core/src/org/eclipse/team/internal/core/subscribers/BatchingLock.java;2;1;3;1;2;2;2;1;24;0;1;239;26;26;1;0;0;1;3;239;0;336;3;2;0
/org.eclipse.jface.text/src/org/eclipse/jface/text/IDocumentAdapterExtension.java;2;0;2;2;2;1;2;0;21;0;0;336;21;21;2;0;1;0;2;336;1;336;1;2;0
/org.eclipse.search/search/org/eclipse/search/internal/ui/text/TextSearchOperation.java;2;1;6;1;3;3;3;3;44;2;2;165;65;65;2;1;0;3;6;165;1;336;5;2;0
/org.eclipse.debug.core/core/org/eclipse/debug/core/model/IStreamMonitor.java;2;0;2;2;0;0;0;2;6;0;1;122;6;6;2;1;0;2;2;122;1;122;1;2;0
/org.eclipse.update.core/src/org/eclipse/update/core/Verifier.java;2;1;3;1;2;2;2;1;6;0;1;58;12;12;1;0;0;1;3;58;0;336;3;2;0
/org.eclipse.team.core/src/org/eclipse/team/core/Team.java;2;2;14;2;5;4;5;9;121;3;6;20;347;347;3;3;1;9;14;111;4;335;10;2;1
/org.eclipse.osgi/core/framework/org/eclipse/osgi/framework/eventmgr/EventListeners.java;3;2;5;1;3;2;3;2;162;1;2;171;298;298;2;0;1;2;5;302;1;302;4;3;0
/org.eclipse.jdt.core/compiler/org/eclipse/jdt/internal/compiler/flow/InitializationFlowContext.java;2;0;2;1;0;0;0;2;10;1;2;170;12;12;1;0;0;2;2;170;0;199;2;2;0
/org.eclipse.jdt.ui/ui/org/eclipse/jdt/internal/ui/util/ExceptionHandler.java;1;0;1;1;1;1;1;0;2;0;0;336;2;2;1;0;0;0;1;336;0;336;1;1;0
/org.eclipse.ant.ui/Ant Editor/org/eclipse/ant/internal/ui/dtd/schema/Element.java;1;0;1;1;0;0;0;1;0;0;1;108;0;0;1;0;0;1;1;108;0;108;1;1;0
/org.eclipse.core.expressions/src/org/eclipse/core/internal/expressions/OrExpression.java;1;0;2;1;1;1;1;1;8;0;1;227;8;8;1;0;0;1;2;227;0;336;2;1;0
/org.eclipse.jdt.core/search/org/eclipse/jdt/core/search/TypeReferenceMatch.java;3;3;9;2;4;2;4;5;41;2;3;218;93;93;3;2;2;5;9;275;4;314;5;3;0
/org.eclipse.update.core/src/org/eclipse/update/internal/core/DefaultInstallHandler.java;2;1;3;1;2;2;2;1;16;0;1;58;30;30;1;0;0;1;3;58;0;336;3;2;0
/org.eclipse.osgi/core/framework/org/eclipse/osgi/framework/internal/core/NullPackageSource.java;4;1;6;1;3;3;3;3;10;2;2;171;25;25;2;1;0;3;6;171;1;336;5;4;0
/org.eclipse.ant.core/src/org/eclipse/ant/internal/core/AntClassLoader.java;1;2;7;1;3;2;3;4;40;1;4;20;94;94;2;0;1;4;7;295;1;336;6;1;0
/org.eclipse.jdt.ui/ui/org/eclipse/jdt/internal/ui/typehierarchy/TypeHierarchyTransferDropAdapter.java;1;0;1;1;1;1;1;0;2;0;0;336;2;2;1;0;0;0;1;336;0;336;1;1;0
/org.eclipse.ui.workbench/Eclipse UI/org/eclipse/ui/commands/ICategory.java;3;1;11;1;2;2;2;9;116;5;4;80;303;303;5;5;0;9;11;80;5;336;6;3;0
/org.eclipse.jdt.core/compiler/org/eclipse/jdt/internal/compiler/parser/RecoveredInitializer.java;4;0;9;2;2;1;2;7;78;2;5;34;157;157;2;2;1;7;9;63;3;288;6;4;0
/org.eclipse.jdt.ui/ui/org/eclipse/jdt/internal/ui/search/JavaSearchPage.java;4;7;24;3;8;2;11;13;236;5;7;82;909;909;7;6;9;16;24;290;15;336;9;4;1
/org.eclipse.jface.text/src/org/eclipse/jface/text/TextViewerHoverManager.java;3;2;12;2;4;2;4;8;124;3;6;47;259;259;3;2;2;8;12;47;4;336;8;3;0
/org.eclipse.update.core/src/org/eclipse/update/core/URLEntry.java;2;1;4;1;3;3;3;1;6;0;1;58;20;20;1;0;0;1;4;58;0;336;4;2;0
/org.eclipse.ui.workbench/Eclipse UI/org/eclipse/ui/contexts/ContextEvent.java;4;1;7;1;2;2;2;5;196;2;4;70;359;359;2;1;0;5;7;70;1;336;6;4;0
/org.eclipse.jdt.ui/ui/org/eclipse/jdt/internal/ui/text/template/contentassist/TemplateEngine.java;4;1;7;2;2;2;2;5;12;3;3;234;34;34;3;2;0;5;7;234;2;336;5;4;0
/org.eclipse.ui.workbench/Eclipse UI/org/eclipse/ui/internal/PartSite.java;6;1;34;3;3;3;3;31;154;9;10;46;604;604;9;21;0;31;34;61;21;336;13;6;0
/org.eclipse.ui.ide/extensions/org/eclipse/ui/actions/WorkspaceModifyOperation.java;4;1;4;1;2;2;2;2;35;1;2;132;45;45;1;0;0;2;4;132;0;336;4;4;0
/org.eclipse.update.configurator/src/org/eclipse/update/internal/configurator/PluginParser.java;2;0;4;1;1;1;1;3;31;1;3;184;56;56;1;0;0;3;4;184;0;300;4;2;0
/org.eclipse.osgi/core/adaptor/org/eclipse/osgi/util/ManifestElement.java;5;1;12;2;4;4;4;8;619;6;3;181;754;754;6;5;0;8;12;240;5;336;7;5;0
/org.eclipse.jdt.ui/ui/org/eclipse/jdt/internal/ui/wizards/dialogfields/ITreeListAdapter.java;1;0;1;1;1;1;1;0;2;0;0;336;2;2;1;0;0;0;1;336;0;336;1;1;0
/org.eclipse.pde.junit.runtime/src/org/eclipse/pde/internal/junit/runtime/PdeJUnitPlugin.java;1;1;3;1;2;2;2;1;10;0;1;196;12;12;1;0;0;1;3;196;0;336;3;1;0
/org.eclipse.compare/compare/org/eclipse/compare/IStreamContentAccessor.java;1;0;1;1;0;0;0;1;2;0;1;219;2;2;1;0;0;1;1;219;0;219;1;1;0
/org.eclipse.ui.workbench/Eclipse UI/org/eclipse/ui/internal/dialogs/EditorSelectionDialog.java;1;0;2;1;0;0;0;2;26;1;2;157;48;48;1;0;0;2;2;157;0;187;2;1;1
/org.eclipse.jdt.ui/ui/org/eclipse/jdt/internal/ui/typehierarchy/TypeHierarchyContentProvider.java;2;1;7;1;2;2;2;5;134;2;3;176;282;282;2;2;0;5;7;176;2;336;5;2;0
/org.eclipse.jdt.core/search/org/eclipse/jdt/core/search/FieldDeclarationMatch.java;2;0;8;2;3;1;3;5;31;2;3;218;60;60;3;2;2;5;8;275;4;275;4;2;0
/org.eclipse.jdt.ui/ui/org/eclipse/jdt/internal/ui/text/java/ParameterGuessingProposal.java;3;5;19;3;6;2;6;13;159;4;7;75;374;374;5;6;4;13;19;276;10;336;9;3;0
/org.eclipse.search/search/org/eclipse/search/internal/ui/RemoveMatchAction.java;1;0;1;1;1;1;1;0;2;0;0;336;2;2;1;0;0;0;1;336;0;336;1;1;0
/org.eclipse.pde.core/src/org/eclipse/pde/internal/core/IModelChangedListenerFilter.java;2;1;2;1;2;2;2;0;4;0;0;297;4;4;1;0;0;0;2;297;0;336;2;2;0
/org.eclipse.core.resources/src/org/eclipse/core/internal/resources/MarkerSnapshotReader_2.java;1;0;1;1;1;1;1;0;179;0;0;277;179;179;1;0;0;0;1;277;0;277;1;1;0
/org.eclipse.pde.ui/src/org/eclipse/pde/internal/ui/editor/site/NewCategoryDefinitionDialog.java;2;0;4;1;1;1;1;3;23;1;3;40;50;50;1;0;0;3;4;40;0;336;4;2;0
/org.eclipse.jdt.debug/model/org/eclipse/jdt/internal/debug/core/StringMatcher.java;1;0;1;1;0;0;0;1;4;0;1;79;4;4;1;0;0;1;1;79;0;79;1;1;1
/org.eclipse.pde.ui/src/org/eclipse/pde/internal/ui/launcher/JUnitTabGroup.java;3;1;10;1;3;3;3;7;81;2;5;82;171;171;2;2;0;7;10;99;2;322;8;3;0
/org.eclipse.update.ui/src/org/eclipse/update/internal/ui/wizards/ResizableInstallWizardDialog.java;1;2;3;1;3;2;3;0;13;0;0;308;19;19;2;0;1;0;3;308;1;336;2;1;0
/org.eclipse.debug.ui/ui/org/eclipse/debug/ui/actions/IToggleBreakpointsTarget.java;1;0;2;1;1;1;1;1;3;0;1;246;3;3;1;0;0;1;2;246;0;276;2;1;0
/org.eclipse.swt.tools/JNI Generation/org/eclipse/swt/tools/internal/CleanupNatives.java;2;0;2;2;0;0;0;2;7;0;1;230;7;7;2;1;0;2;2;230;1;230;1;2;0
/org.eclipse.debug.ui/ui/org/eclipse/debug/internal/ui/sourcelookup/SourceElementWorkbenchAdapter.java;1;0;3;1;0;0;0;3;44;2;2;252;59;59;2;1;0;3;3;267;1;267;2;1;0
/org.eclipse.debug.ui/ui/org/eclipse/debug/internal/ui/views/breakpoints/BreakpointsViewContentProvider.java;2;0;7;2;2;1;2;5;43;4;2;152;86;86;4;3;1;5;7;171;4;282;3;2;0
/org.eclipse.debug.ui/ui/org/eclipse/debug/internal/ui/BreakpointImageProvider.java;1;0;1;1;0;0;0;1;0;0;1;264;0;0;1;0;0;1;1;264;0;264;1;1;0
/org.eclipse.ui.editors/src/org/eclipse/ui/editors/text/EditorsUI.java;3;2;7;2;5;3;5;2;103;1;2;205;142;142;2;0;2;2;7;276;2;336;5;3;0
/org.eclipse.ui.editors/src/org/eclipse/ui/internal/editors/text/TextEditorMessages.java;1;0;1;1;1;1;1;0;2;0;0;336;2;2;1;0;0;0;1;336;0;336;1;1;0
/org.eclipse.text/src/org/eclipse/text/edits/MalformedTreeException.java;2;1;4;1;2;2;2;2;4;0;1;118;11;11;2;1;0;2;4;118;1;336;3;2;0
/org.eclipse.ui.workbench/Eclipse UI/org/eclipse/ui/activities/IActivityRequirementBinding.java;2;1;2;1;2;2;2;0;4;0;0;307;4;4;1;0;0;0;2;307;0;336;2;2;0
/org.eclipse.jdt.ui/ui/org/eclipse/jdt/internal/ui/wizards/buildpaths/CPListElementAttribute.java;2;0;2;1;1;1;1;1;2;0;1;192;3;3;1;0;0;1;2;192;0;336;2;2;0
/org.eclipse.jdt.debug.ui/ui/org/eclipse/jdt/internal/debug/ui/snippeteditor/SnippetEditorActionContributor.java;2;1;2;1;2;2;2;0;16;0;0;274;20;20;1;0;0;0;2;274;0;336;2;2;0
/org.eclipse.ui.ide/src/org/eclipse/ui/internal/ide/dialogs/ResourceTreeAndListGroup.java;5;1;4;2;3;3;3;1;18;0;1;132;40;40;1;0;0;1;4;132;0;336;4;5;0
/org.eclipse.pde.ui/src/org/eclipse/pde/internal/ui/editor/feature/PortabilitySection.java;3;3;9;2;5;3;5;4;303;1;4;16;393;393;3;0;2;4;9;302;2;336;7;3;0
/org.eclipse.update.core/src/org/eclipse/update/internal/security/KeystoreHandle.java;1;0;1;1;0;0;0;1;2;0;1;58;2;2;1;0;0;1;1;58;0;58;1;1;0
/org.eclipse.jdt.core/model/org/eclipse/jdt/internal/core/hierarchy/ChangeCollector.java;1;0;3;1;0;0;0;3;4;1;3;131;6;6;1;0;0;3;3;131;0;199;3;1;0
/org.eclipse.ui.workbench/Eclipse UI/org/eclipse/ui/contexts/NotDefinedException.java;4;1;11;1;2;2;2;9;31;3;6;71;81;81;3;3;0;9;11;71;3;336;8;4;0
/org.eclipse.pde.ui/src/org/eclipse/pde/internal/ui/editor/plugin/ManifestSourcePage.java;3;3;5;2;5;3;5;0;14;0;0;292;24;24;3;0;2;0;5;308;2;336;3;3;0
/org.eclipse.jdt.core/compiler/org/eclipse/jdt/internal/compiler/util/HashtableOfInt.java;2;0;2;1;0;0;0;2;2;1;2;199;4;4;1;0;0;2;2;199;0;227;2;2;0
/org.eclipse.ltk.core.refactoring/src/org/eclipse/ltk/core/refactoring/participants/ParticipantExtensionPoint.java;1;3;5;1;4;2;4;1;45;0;1;267;53;53;3;0;2;1;5;279;2;336;3;1;0
/org.eclipse.ui.ide/src/org/eclipse/ui/views/tasklist/GotoTaskAction.java;1;0;2;1;0;0;0;2;2;0;1;129;2;2;2;1;0;2;2;129;1;129;1;1;0
/org.eclipse.jface.text/src/org/eclipse/jface/text/source/SourceViewer.java;3;3;22;2;5;2;5;17;507;5;10;82;885;885;5;7;3;17;22;119;10;331;12;3;0
/org.eclipse.debug.core/core/org/eclipse/debug/internal/core/sourcelookup/SourceContainerType.java;1;0;3;1;0;0;0;3;12;1;3;205;18;18;1;0;0;3;3;205;0;268;3;1;0
/org.eclipse.jdt.ui/core refactoring/org/eclipse/jdt/internal/corext/refactoring/rename/MethodChecks.java;4;0;7;1;1;1;1;6;18;1;6;3;59;59;1;0;0;6;7;3;0;336;7;4;0
/org.eclipse.debug.core/core/org/eclipse/debug/core/model/IWatchExpressionDelegate.java;3;1;4;1;2;2;2;2;22;0;1;92;28;28;2;1;0;2;4;92;1;336;3;3;0
/org.eclipse.team.ui/src/org/eclipse/team/ui/synchronize/ISynchronizeParticipantDescriptor.java;2;1;6;1;2;2;2;4;59;1;4;151;134;134;1;0;0;4;6;151;0;336;6;2;0
/org.eclipse.jface.text/src/org/eclipse/jface/text/ITextViewerExtension.java;2;0;1;2;1;1;1;0;73;0;0;336;73;73;1;0;0;0;1;336;0;336;1;2;0
/org.eclipse.jface/src/org/eclipse/jface/action/SubCoolBarManager.java;2;0;2;2;0;0;0;2;19;0;1;181;19;19;2;1;0;2;2;181;1;181;1;2;0
/org.eclipse.ui.workbench/Eclipse UI/org/eclipse/ui/internal/progress/ProgressRegion.java;3;0;11;2;1;1;4;7;227;5;3;237;429;429;5;4;3;10;11;269;7;306;4;3;0
/org.eclipse.swt/Eclipse SWT/photon/org/eclipse/swt/widgets/ProgressBar.java;3;1;4;1;2;2;2;2;18;1;2;19;25;25;1;0;0;2;4;19;0;337;4;3;0
/org.eclipse.ltk.ui.refactoring/src/org/eclipse/ltk/internal/ui/refactoring/ErrorWizardPage.java;1;1;7;1;2;2;6;1;46;0;1;269;52;52;5;0;4;5;7;269;4;336;3;1;0
/org.eclipse.jdt.core/model/org/eclipse/jdt/internal/core/JavaModelManager.java;3;8;52;3;11;2;13;39;563;12;13;2;2214;2214;12;26;11;41;52;51;37;324;15;3;3
/org.eclipse.jdt.core/model/org/eclipse/jdt/internal/compiler/ISourceElementRequestor.java;1;0;1;1;0;0;0;1;0;0;1;245;0;0;1;0;0;1;1;245;0;245;1;1;0
/org.eclipse.jdt.debug/jdi/org/eclipse/jdi/TimeoutException.java;1;0;1;1;0;0;0;1;1;0;1;79;1;1;1;0;0;1;1;79;0;79;1;1;0
/org.eclipse.swt/Eclipse SWT Custom Widgets/common/org/eclipse/swt/custom/CTabFolderEvent.java;2;2;7;2;4;2;4;3;40;2;2;156;118;118;2;1;2;3;7;156;3;336;4;2;0
/org.eclipse.ui.ide/src/org/eclipse/ui/views/framelist/UpAction.java;3;0;4;1;1;1;1;3;4;1;3;129;9;9;1;0;0;3;4;129;0;336;4;3;0
/org.eclipse.jdt.ui/ui/org/eclipse/jdt/internal/ui/text/correction/RemoveDeclarationCorrectionProposal.java;2;1;12;1;4;4;4;8;47;2;6;28;234;234;2;2;0;8;12;28;2;336;10;2;0
/org.eclipse.ltk.core.refactoring/src/org/eclipse/ltk/core/refactoring/participants/SharableParticipants.java;1;2;5;1;3;2;3;2;17;0;1;264;21;21;2;1;1;2;5;264;2;336;3;1;0
/org.eclipse.ui.workbench/Eclipse UI/org/eclipse/ui/internal/ChangeToPerspectiveMenu.java;4;0;5;1;1;1;1;4;24;1;4;157;52;52;1;0;0;4;5;157;0;336;5;4;1
/org.eclipse.ltk.ui.refactoring/src/org/eclipse/ltk/ui/refactoring/IChangePreviewViewer.java;1;0;5;1;2;1;3;2;29;0;1;269;42;42;3;1;2;3;5;269;3;335;2;1;0
/org.eclipse.ant.core/src/org/eclipse/ant/core/TargetInfo.java;1;0;1;1;0;0;0;1;10;0;1;170;10;10;1;0;0;1;1;170;0;170;1;1;0
/org.eclipse.jdt.ui/ui/org/eclipse/jdt/internal/ui/wizards/dialogfields/IStringButtonAdapter.java;1;0;1;1;1;1;1;0;2;0;0;336;2;2;1;0;0;0;1;336;0;336;1;1;0
/org.eclipse.ant.ui/Ant Editor/org/eclipse/ant/internal/ui/editor/text/AntEditorDocumentProvider.java;1;1;8;1;2;2;2;6;265;3;3;108;316;316;3;3;0;6;8;200;3;321;5;1;5
/org.eclipse.ui.workbench/Eclipse UI/org/eclipse/ui/internal/UILockListener.java;3;0;4;1;1;1;1;3;17;1;3;93;37;37;1;0;0;3;4;93;0;336;4;3;0
/org.eclipse.jface.text/src/org/eclipse/jface/text/contentassist/ContextInformationValidator.java;1;3;6;1;5;2;5;1;32;0;1;133;80;80;3;0;3;1;6;275;3;336;3;1;0
/org.eclipse.swt/Eclipse SWT Mozilla/common/org/eclipse/swt/internal/mozilla/nsIContentViewerContainer.java;1;0;1;1;0;0;0;1;0;0;1;153;0;0;1;0;0;1;1;153;0;153;1;1;0
/org.eclipse.jdt.ui/ui/org/eclipse/jdt/internal/ui/browsing/PatchedOpenInNewWindowAction.java;1;0;1;1;1;1;1;0;2;0;0;336;2;2;1;0;0;0;1;336;0;336;1;1;0
/org.eclipse.jdt.core/compiler/org/eclipse/jdt/internal/compiler/flow/LoopingFlowContext.java;2;0;6;1;0;0;0;6;4;1;6;34;15;15;1;0;0;6;6;34;0;199;6;2;0
/org.eclipse.jdt.core/model/org/eclipse/jdt/internal/core/ClasspathEntry.java;4;2;15;2;4;3;4;11;449;4;7;45;900;900;4;4;1;11;15;178;5;330;10;4;0
/org.eclipse.swt/Eclipse SWT/gtk/org/eclipse/swt/widgets/Scale.java;4;1;5;1;2;2;2;3;22;1;3;19;45;45;1;0;0;3;5;19;0;337;5;4;0
/org.eclipse.team.ui/src/org/eclipse/team/ui/synchronize/ISynchronizeView.java;2;2;8;1;4;3;4;4;53;2;2;146;71;71;2;2;1;4;8;146;3;335;5;2;0
/org.eclipse.jface.text/src/org/eclipse/jface/text/contentassist/CompletionProposalPopup.java;3;5;31;2;7;2;7;24;317;6;9;55;1115;1115;6;15;5;24;31;230;20;336;11;3;0
/org.eclipse.pde.ui/src/org/eclipse/pde/internal/ui/wizards/imports/PluginImportWizardExpressPage.java;3;3;19;2;5;3;5;14;234;6;5;45;387;387;6;9;2;14;19;45;11;336;8;3;0
/org.eclipse.jdt.core/dom/org/eclipse/jdt/core/dom/CompilationUnitResolver.java;4;0;34;3;0;0;0;34;1134;10;12;5;1911;1911;10;22;0;34;34;199;22;257;12;4;4
/org.eclipse.ui.workbench/Eclipse UI/org/eclipse/ui/internal/ExtensionEventHandlerMessages.java;2;0;2;1;1;1;1;1;2;0;1;214;2;2;1;0;0;1;2;214;0;336;2;2;0
/org.eclipse.jdt.ui/ui/org/eclipse/jdt/internal/ui/text/correction/IJavaMarkerResolutionExtension.java;1;0;2;1;0;0;0;2;25;1;2;83;25;25;1;0;0;2;2;83;0;240;2;1;0
/org.eclipse.team.cvs.core/src/org/eclipse/team/internal/ccvs/core/CVSProviderPlugin.java;2;1;26;2;3;3;3;23;232;4;12;52;768;768;4;11;0;23;26;52;11;336;15;2;1
/org.eclipse.ant.ui/Ant Editor/org/eclipse/ant/internal/ui/dtd/util/SortedSet.java;1;0;2;1;1;1;1;1;22;0;1;108;22;22;1;0;0;1;2;108;0;299;2;1;0
/org.eclipse.jdt.ui/ui/org/eclipse/jdt/internal/ui/text/comment/DefaultTextMeasurement.java;2;0;2;2;0;0;0;2;46;0;1;240;46;46;2;1;0;2;2;240;1;240;1;2;0
/org.eclipse.pde.ui/src/org/eclipse/pde/internal/ui/elements/DefaultElement.java;2;1;2;1;2;2;2;0;4;0;0;308;6;6;1;0;0;0;2;308;0;336;2;2;0
/org.eclipse.pde.ui/src/org/eclipse/pde/internal/ui/editor/feature/FeatureEntryPropertySource.java;2;1;3;1;2;2;2;1;30;0;1;232;48;48;1;0;0;1;3;232;0;336;3;2;0
/org.eclipse.swt/Eclipse SWT PI/gtk/org/eclipse/swt/internal/gtk/GdkRectangle.java;3;0;3;1;1;1;1;2;17;1;2;100;21;21;1;0;0;2;3;100;0;337;3;3;0
/org.eclipse.jdt.debug.ui/ui/org/eclipse/jdt/internal/debug/ui/actions/ShowNullArrayEntriesAction.java;1;0;2;1;0;0;0;2;4;1;2;148;4;4;1;0;0;2;2;148;0;187;2;1;0
/org.eclipse.jdt.ui/ui/org/eclipse/jdt/internal/ui/text/correction/ModifierChangeCompletionProposal.java;4;2;11;2;3;2;3;8;59;3;5;66;173;173;3;3;1;8;11;66;4;336;7;4;1
/org.eclipse.jdt.core/compiler/org/eclipse/jdt/internal/compiler/ast/UnaryExpression.java;2;0;5;1;0;0;0;5;26;1;5;63;45;45;1;0;0;5;5;63;0;199;5;2;0
/org.eclipse.jdt.core/compiler/org/eclipse/jdt/internal/compiler/ast/JavadocFieldReference.java;4;3;11;3;4;2;4;7;48;3;4;165;121;121;3;3;2;7;11;165;5;324;6;4;0
/org.eclipse.core.variables/src/org/eclipse/core/internal/variables/StringVariable.java;1;0;1;1;0;0;0;1;0;0;1;145;0;0;1;0;0;1;1;145;0;145;1;1;0
/org.eclipse.ant.ui/Ant Editor/org/eclipse/ant/internal/ui/editor/outline/IProblem.java;1;0;4;1;1;1;1;3;17;1;3;108;30;30;1;0;0;3;4;108;0;336;4;1;1
/org.eclipse.ant.ui/Ant Tools Support/org/eclipse/ant/internal/ui/preferences/AntCodeFormatterPreferencePage.java;1;0;3;1;1;1;1;2;304;0;1;226;313;313;2;1;0;2;3;226;1;306;2;1;0
/org.eclipse.ui.workbench.texteditor/src/org/eclipse/ui/texteditor/StatusLineContributionItem.java;3;1;12;2;2;2;2;10;117;4;5;41;251;251;4;5;0;10;12;223;5;336;7;3;0
/org.eclipse.swt/Eclipse SWT Drag and Drop/common/org/eclipse/swt/dnd/DragSourceEvent.java;1;0;1;1;0;0;0;1;2;0;1;0;2;2;1;0;0;1;1;0;0;0;1;1;0
/org.eclipse.jdt.ui/ui/org/eclipse/jdt/internal/ui/javadocexport/JavadocLinkRef.java;2;1;2;1;2;2;2;0;10;0;0;302;10;10;1;0;0;0;2;302;0;336;2;2;0
/org.eclipse.ui.ide/src/org/eclipse/ui/views/framelist/Frame.java;1;0;1;1;0;0;0;1;0;0;1;129;0;0;1;0;0;1;1;129;0;129;1;1;0
/org.eclipse.jdt.ui/ui/org/eclipse/jdt/ui/StandardJavaElementContentProvider.java;5;2;10;3;3;2;3;7;102;2;5;20;189;189;2;2;1;7;10;139;3;331;7;5;0
/org.eclipse.jdt.core/compiler/org/eclipse/jdt/internal/compiler/env/ICompilationUnit.java;1;0;1;1;0;0;0;1;2;0;1;199;2;2;1;0;0;1;1;199;0;199;1;1;0
/org.eclipse.jface.text/src/org/eclipse/jface/text/rules/WordPatternRule.java;1;1;2;1;2;2;2;0;4;0;0;276;6;6;1;0;0;0;2;276;0;336;2;1;0
/org.eclipse.jdt.ui/ui/org/eclipse/jdt/ui/actions/FindReferencesInProjectAction.java;3;2;13;2;4;3;4;9;28;3;5;97;95;95;3;4;1;9;13;97;5;336;8;3;0
/org.eclipse.ui.workbench/Eclipse UI/org/eclipse/ui/intro/IIntroSite.java;1;1;6;1;2;2;2;4;40;2;3;198;67;67;2;1;0;4;6;198;1;296;5;1;0
/org.eclipse.jdt.core/dom/org/eclipse/jdt/core/dom/ThisExpression.java;4;0;9;2;3;1;3;6;79;2;5;199;145;145;3;1;2;6;9;276;3;276;6;4;1
/org.eclipse.jdt.ui/core extension/org/eclipse/jdt/internal/corext/template/java/JavaFormatter.java;5;1;13;3;3;3;3;10;262;3;6;96;455;455;3;4;0;10;13;116;4;336;9;5;0
/org.eclipse.ui.workbench/Eclipse UI/org/eclipse/ui/internal/themes/IEditable.java;1;0;1;1;0;0;0;1;0;0;1;269;0;0;1;0;0;1;1;269;0;269;1;1;0
/org.eclipse.osgi/resolver/src/org/eclipse/osgi/internal/resolver/SystemState.java;3;1;4;1;3;3;3;1;16;0;1;179;26;26;1;0;0;1;4;179;0;336;4;3;0
/org.eclipse.team.ui/src/org/eclipse/team/internal/ui/synchronize/RemoteResourceTypedElement.java;2;1;6;2;2;2;2;4;130;0;1;228;150;150;4;3;0;4;6;228;3;336;3;2;0
/org.eclipse.debug.ui/ui/org/eclipse/debug/internal/ui/sourcelookup/browsers/ArchiveFilter.java;2;0;2;1;1;1;1;1;4;0;1;267;4;4;1;0;0;1;2;267;0;336;2;2;0
/org.eclipse.jdt.core/compiler/org/eclipse/jdt/internal/compiler/lookup/ProblemMethodBinding.java;1;0;1;1;0;0;0;1;2;0;1;199;2;2;1;0;0;1;1;199;0;199;1;1;0
/org.eclipse.ui.workbench/Eclipse UI/org/eclipse/ui/internal/registry/IActionSetDescriptor.java;2;0;2;1;1;1;1;1;8;0;1;250;10;10;1;0;0;1;2;250;0;336;2;2;0
/org.eclipse.jdt.ui/ui refactoring/org/eclipse/jdt/internal/ui/refactoring/code/ExtractMethodWizard.java;2;0;7;1;1;1;2;5;6;2;5;66;25;25;2;0;1;6;7;269;1;336;6;2;0
/org.eclipse.jface.text/src/org/eclipse/jface/text/reconciler/IReconcilerExtension.java;2;0;3;1;2;1;2;1;25;0;1;92;25;25;2;0;1;1;3;336;1;336;2;2;0
/org.eclipse.ant.ui/Remote Ant Support/org/eclipse/ant/internal/ui/antsupport/AntSecurityException.java;1;0;1;1;0;0;0;1;0;0;1;108;0;0;1;0;0;1;1;108;0;108;1;1;0
/org.eclipse.ui.workbench/Eclipse UI/org/eclipse/ui/actions/ContributionItemFactory.java;3;0;4;1;1;1;1;3;196;1;3;103;200;200;1;0;0;3;4;103;0;336;4;3;2
/org.eclipse.core.resources/src/org/eclipse/core/internal/resources/PathVariableManager.java;3;0;7;1;3;1;3;4;49;2;3;49;67;67;3;1;2;4;7;274;3;274;4;3;0
/org.eclipse.jdt.debug.ui/ui/org/eclipse/jdt/internal/debug/ui/display/DisplayView.java;5;2;10;2;3;2;3;7;226;2;5;76;501;501;2;2;1;7;10;76;3;330;7;5;1
/org.eclipse.osgi/eclipseAdaptor/src/org/eclipse/osgi/framework/stats/ClassStats.java;3;1;4;1;3;3;3;1;8;0;1;171;14;14;1;0;0;1;4;171;0;336;4;3;0
/org.eclipse.ui.workbench/Eclipse UI/org/eclipse/ui/internal/progress/JobView.java;2;2;9;1;4;3;7;2;3011;0;1;269;3032;3032;5;1;4;5;9;269;5;336;4;2;0
/org.eclipse.ui.ide/src/org/eclipse/ui/ide/IIDEActionConstants.java;5;1;5;2;2;2;2;3;24;2;2;173;38;38;2;1;0;3;5;181;1;336;4;5;0
/org.eclipse.jdt.debug.ui/ui/org/eclipse/jdt/internal/debug/ui/sourcelookup/JavaProjectSourceContainerBrowser.java;1;0;4;1;1;1;1;3;22;0;1;266;24;24;3;2;0;3;4;266;2;330;2;1;0
/org.eclipse.pde.ui/src/org/eclipse/pde/internal/ui/editor/plugin/PluginActivationSection.java;3;2;5;2;5;3;5;0;563;0;0;298;624;624;2;0;2;0;5;298;2;336;3;3;0
/org.eclipse.jdt.launching/launching/org/eclipse/jdt/launching/sourcelookup/containers/JavaProjectSourceContainer.java;1;2;4;1;3;2;3;1;79;0;1;269;104;104;2;0;1;1;4;312;1;312;3;1;0
/org.eclipse.debug.ui/ui/org/eclipse/debug/internal/ui/InstructionPointerContext.java;1;0;1;1;0;0;0;1;21;0;1;88;21;21;1;0;0;1;1;88;0;88;1;1;0
/org.eclipse.jdt.ui/core refactoring/org/eclipse/jdt/internal/corext/refactoring/util/RefactoringASTParser.java;2;0;3;1;1;1;1;2;10;1;2;257;14;14;1;0;0;2;3;257;0;290;3;2;0
/org.eclipse.ui.editors/src/org/eclipse/ui/texteditor/ResourceMarkerAnnotationModelFactory.java;2;1;2;1;2;2;2;0;3;0;0;289;3;3;1;0;0;0;2;289;0;336;2;2;0
/org.eclipse.jdt.core/dom/org/eclipse/jdt/core/dom/ConditionalExpression.java;3;0;8;1;2;1;2;6;146;2;5;199;212;212;2;1;1;6;8;266;2;276;6;3;1
/org.eclipse.jdt.ui/ui/org/eclipse/jdt/internal/ui/text/JavaChangeHover.java;4;4;11;2;5;2;5;6;78;4;2;70;123;123;4;4;3;6;11;70;7;336;4;4;0
/org.eclipse.jdt.ui/core refactoring/org/eclipse/jdt/internal/corext/refactoring/code/Invocations.java;2;0;2;1;1;1;1;1;21;0;1;144;23;23;1;0;0;1;2;144;0;336;2;2;0
/org.eclipse.team.cvs.ui/src/org/eclipse/team/internal/ccvs/ui/subscriber/ConfirmMergedOperation.java;2;2;3;1;3;2;3;0;92;0;0;294;94;94;2;0;1;0;3;294;1;336;2;2;0
/org.eclipse.jdt.ui/ui/org/eclipse/jdt/internal/ui/preferences/SpellingConfigurationBlock.java;3;2;7;1;3;2;3;4;121;2;2;212;150;150;2;2;1;4;7;212;3;336;4;3;1
/org.eclipse.jdt.core/model/org/eclipse/jdt/internal/core/JavaModelStatus.java;2;0;7;2;0;0;0;7;134;3;5;37;178;178;3;2;0;7;7;108;2;266;5;2;0
/org.eclipse.ui.workbench/Eclipse UI/org/eclipse/ui/help/AbstractHelpUI.java;2;0;2;1;0;0;0;2;82;1;2;112;82;82;1;0;0;2;2;112;0;157;2;2;0
/org.eclipse.jdt.debug/eval/org/eclipse/jdt/internal/debug/eval/ast/instructions/PushStaticFieldVariable.java;1;0;1;1;0;0;0;1;3;0;1;76;3;3;1;0;0;1;1;76;0;76;1;1;0
/org.eclipse.ui.ide/src/org/eclipse/ui/internal/ide/NewWizardDropDownAction.java;5;1;6;1;3;3;3;3;8;1;3;132;24;24;1;0;0;3;6;132;0;336;6;5;1
/org.eclipse.debug.ui/ui/org/eclipse/debug/internal/ui/actions/ToggleBreakpointObjectActionDelegate.java;2;0;2;1;1;1;1;1;9;0;1;246;10;10;1;0;0;1;2;246;0;274;2;2;0
/org.eclipse.ui.ide/src/org/eclipse/ui/wizards/datatransfer/ZipFileExportOperation.java;1;0;2;1;0;0;0;2;65;1;2;92;65;65;1;0;0;2;2;92;0;121;2;1;0
/org.eclipse.jdt.debug.ui/ui/org/eclipse/jdt/internal/debug/ui/jres/JREsComboBlock.java;3;1;8;1;2;2;2;6;39;3;3;69;116;116;3;3;0;6;8;69;3;336;5;3;0
/org.eclipse.core.resources.win32/src/org/eclipse/core/internal/resources/refresh/win32/Win32Monitor.java;2;2;10;1;6;4;6;4;72;2;2;206;135;135;2;2;2;4;10;206;4;331;6;2;0
/org.eclipse.ant.ui/Ant Tools Support/org/eclipse/ant/internal/ui/preferences/OverlayPreferenceStore.java;1;0;1;1;0;0;0;1;0;0;1;108;0;0;1;0;0;1;1;108;0;108;1;1;0
/org.eclipse.jdt.ui/core extension/org/eclipse/jdt/internal/corext/textmanipulation/TextBuffer.java;2;1;7;1;2;2;2;5;23;2;3;64;52;52;2;2;0;5;7;64;2;336;5;2;0
/org.eclipse.jdt.ui/core extension/org/eclipse/jdt/internal/corext/util/JarFileEntryTypeInfo.java;2;0;2;1;1;1;1;1;51;0;1;141;53;53;1;0;0;1;2;141;0;336;2;2;0
/org.eclipse.jdt.ui/ui/org/eclipse/jdt/internal/ui/infoviews/TextSelectionConverter.java;1;0;2;1;1;1;1;1;2;0;1;87;2;2;1;0;0;1;2;87;0;336;2;1;0
/org.eclipse.jdt.ui/ui/org/eclipse/jdt/internal/ui/viewsupport/IViewPartInputProvider.java;1;0;1;1;1;1;1;0;2;0;0;336;2;2;1;0;0;0;1;336;0;336;1;1;0
/org.eclipse.ant.ui/Ant Editor/org/eclipse/ant/internal/ui/editor/TaskDescriptionProvider.java;1;0;4;1;1;1;1;3;32;1;3;108;69;69;1;0;0;3;4;108;0;299;4;1;4
/org.eclipse.pde.ui/src/org/eclipse/pde/internal/ui/parts/MessageDialogWithToggle.java;1;0;1;1;0;0;0;1;0;0;1;154;0;0;1;0;0;1;1;154;0;154;1;1;0
/org.eclipse.update.core/src/org/eclipse/update/internal/core/FeaturePlugin.java;2;0;2;1;1;1;1;1;2;0;1;225;2;2;1;0;0;1;2;225;0;302;2;2;0
/org.eclipse.debug.core/core/org/eclipse/debug/core/model/IProcess.java;2;1;3;1;3;3;3;0;7;0;0;273;17;17;1;0;0;0;3;273;0;336;3;2;0
/org.eclipse.ui.intro/src/org/eclipse/ui/internal/intro/impl/model/IntroURLParser.java;2;2;4;1;4;3;4;0;8;0;0;276;18;18;2;0;1;0;4;276;1;336;3;2;0
/org.eclipse.pde.ui/src_samples/org/eclipse/pde/ui/internal/samples/ReviewPage.java;3;2;4;2;3;2;3;1;49;0;1;249;55;55;2;0;1;1;4;303;1;336;3;3;0
/org.eclipse.ui.workbench/Eclipse UI/org/eclipse/ui/dialogs/FileSystemElement.java;3;0;4;1;1;1;1;3;333;2;2;157;403;403;2;1;0;3;4;225;1;293;3;3;0
/org.eclipse.team.cvs.core/src/org/eclipse/team/internal/ccvs/core/syncinfo/MutableResourceSyncInfo.java;1;0;1;1;0;0;0;1;9;0;1;20;9;9;1;0;0;1;1;20;0;20;1;1;0
/org.eclipse.debug.core/core/org/eclipse/debug/core/model/ILogicalStructureTypeDelegate.java;2;1;3;1;2;2;2;1;5;0;1;153;9;9;1;0;0;1;3;153;0;336;3;2;0
/org.eclipse.jdt.ui/ui/org/eclipse/jdt/internal/ui/text/SingleTokenJavaScanner.java;1;0;1;1;1;1;1;0;2;0;0;336;2;2;1;0;0;0;1;336;0;336;1;1;0
/org.eclipse.pde.ui/src_ant/org/eclipse/pde/internal/ui/ant/FeatureExportTask.java;1;0;2;1;1;1;1;1;10;0;1;257;10;10;1;0;0;1;2;257;0;336;2;1;0
/org.eclipse.core.resources/src/org/eclipse/core/resources/IResourceProxyVisitor.java;1;0;2;1;0;0;1;1;6;0;1;270;6;6;2;0;1;2;2;270;1;270;1;1;0
/org.eclipse.pde.ui/src_Forms/org/eclipse/pde/internal/ui/model/AbstractEditingModel.java;3;11;18;3;13;2;13;5;172;3;3;244;203;203;11;2;11;5;18;275;13;332;5;3;0
/org.eclipse.jdt.ui/ui/org/eclipse/jdt/internal/ui/javaeditor/selectionactions/StructureSelectNextAction.java;2;1;2;1;2;2;2;0;34;0;0;326;36;36;1;0;0;0;2;326;0;336;2;2;0
/org.eclipse.swt/Eclipse SWT PI/win32/org/eclipse/swt/internal/win32/MENUBARINFO.java;2;0;2;1;1;1;1;1;4;0;1;227;4;4;1;0;0;1;2;227;0;337;2;2;0
/org.eclipse.team.cvs.core/src/org/eclipse/team/internal/ccvs/core/util/PrepareForReplaceVisitor.java;1;0;1;1;0;0;0;1;7;0;1;146;7;7;1;0;0;1;1;146;0;146;1;1;0
/org.eclipse.ui.editors/src/org/eclipse/ui/editors/text/IEncodingActionsDefinitionIds.java;1;1;2;1;2;2;2;0;7;0;0;314;12;12;1;0;0;0;2;314;0;336;2;1;0
/org.eclipse.jdt.ui/ui/org/eclipse/jdt/internal/ui/wizards/buildpaths/LibrariesWorkbookPage.java;4;3;17;3;8;4;8;9;299;4;6;72;568;568;4;3;4;9;17;72;7;336;10;4;0
/org.eclipse.swt/Eclipse SWT Program/carbon/org/eclipse/swt/program/Program.java;2;1;3;1;2;2;2;1;16;0;1;153;22;22;1;0;0;1;3;153;0;337;3;2;2
/org.eclipse.swt/Eclipse SWT/motif/org/eclipse/swt/widgets/MessageBox.java;4;2;6;2;4;3;4;2;22;1;2;19;37;37;2;0;1;2;6;295;1;337;5;4;0
/org.eclipse.ui.workbench.texteditor/src/org/eclipse/ui/texteditor/IStatusField.java;2;0;1;2;1;1;1;0;15;0;0;336;15;15;1;0;0;0;1;336;0;336;1;2;0
/org.eclipse.team.cvs.ui/src/org/eclipse/team/internal/ccvs/ui/actions/ShowHistoryAction.java;2;1;3;1;2;2;2;1;2;0;1;18;6;6;1;0;0;1;3;18;0;336;3;2;0
/org.eclipse.ant.ui/Ant Tools Support/org/eclipse/ant/internal/ui/preferences/AntEditorPreferenceConstants.java;1;2;13;1;5;4;5;8;264;2;5;108;548;548;2;3;1;8;13;211;4;323;9;1;2
/org.eclipse.ui.ide/src/org/eclipse/ui/internal/ide/misc/ContainerContentProvider.java;2;0;2;1;0;0;0;2;6;1;2;132;6;6;1;0;0;2;2;132;0;171;2;2;0
/org.eclipse.ui.workbench/Eclipse UI/org/eclipse/ui/presentations/PresentationUtil.java;3;2;9;2;3;2;3;6;66;0;1;245;112;112;6;5;1;6;9;245;6;336;3;3;0
/org.eclipse.core.resources/src/org/eclipse/core/internal/resources/RootInfo.java;1;0;2;1;1;1;1;1;52;0;1;174;60;60;1;0;0;1;2;174;0;277;2;1;0
/org.eclipse.ui.ide/src/org/eclipse/ui/views/markers/internal/ActionCopyMarker.java;5;1;7;1;2;2;2;5;19;2;4;129;45;45;2;1;0;5;7;129;1;336;6;5;0
/org.eclipse.jdt.core/eval/org/eclipse/jdt/internal/eval/CodeSnippetParser.java;5;0;18;3;0;0;0;18;196;3;13;5;314;314;3;5;0;18;18;149;5;209;13;5;0
/org.eclipse.jdt.ui/ui refactoring/org/eclipse/jdt/internal/ui/refactoring/ExtractInterfaceWizard.java;3;0;8;1;1;1;2;6;231;2;6;36;370;370;2;0;1;7;8;269;1;336;7;3;0
/org.eclipse.jdt.ui/ui/org/eclipse/jdt/internal/ui/preferences/formatter/IndentationTabPage.java;1;0;10;1;0;0;0;10;140;4;4;176;251;251;4;6;0;10;10;176;6;219;4;1;0
/org.eclipse.ui.workbench.texteditor/src/org/eclipse/ui/texteditor/RetargetTextEditorAction.java;2;1;2;2;2;2;2;0;9;0;0;276;14;14;1;0;0;0;2;276;0;336;2;2;0
/org.eclipse.jdt.ui/core extension/org/eclipse/jdt/internal/corext/dom/fragments/ASTFragment.java;1;0;1;1;1;1;1;0;2;0;0;336;2;2;1;0;0;0;1;336;0;336;1;1;0
/org.eclipse.update.ui/src/org/eclipse/update/internal/ui/wizards/ActivitiesTableViewer.java;3;0;6;2;1;1;1;5;117;3;2;54;171;171;3;3;0;5;6;241;3;336;3;3;0
/org.eclipse.pde.ui/src_ant/org/eclipse/pde/internal/ui/ant/BaseExportTask.java;1;1;4;1;3;3;3;1;10;0;1;257;20;20;1;0;0;1;4;257;0;336;4;1;0
/org.eclipse.core.runtime/src/org/eclipse/core/runtime/ILibrary.java;3;2;8;1;4;3;4;4;156;2;3;171;292;292;2;1;1;4;8;179;2;336;6;3;0
/org.eclipse.update.core/src/org/eclipse/update/core/IFeatureContentProvider.java;2;2;4;1;3;2;3;1;8;0;1;58;16;16;2;0;1;1;4;289;1;336;3;2;0
/org.eclipse.core.resources/src/org/eclipse/core/internal/localstore/ILocalStoreConstants.java;1;0;1;1;1;1;1;0;6;0;0;277;6;6;1;0;0;0;1;277;0;277;1;1;0
/org.eclipse.update.ui/src/org/eclipse/update/internal/ui/parts/PixelConverter.java;2;1;4;1;2;2;2;2;17;0;1;53;29;29;2;1;0;2;4;53;1;336;3;2;0
/org.eclipse.jdt.ui/ui/org/eclipse/jdt/internal/ui/text/LineBreakingReader.java;1;0;1;1;1;1;1;0;2;0;0;336;2;2;1;0;0;0;1;336;0;336;1;1;0
/org.eclipse.pde.ui/src/org/eclipse/pde/internal/ui/editor/context/IInputContextListener.java;1;1;2;1;2;2;2;0;10;0;0;292;10;10;1;0;0;0;2;292;0;336;2;1;0
/org.eclipse.jdt.ui/ui/org/eclipse/jdt/internal/ui/text/javadoc/JavaDocMessages.java;1;0;1;1;1;1;1;0;2;0;0;336;2;2;1;0;0;0;1;336;0;336;1;1;0
/org.eclipse.debug.core/core/org/eclipse/debug/internal/core/memory/MemoryRenderingInfo.java;2;1;2;1;2;2;2;0;13;0;0;282;13;13;1;0;0;0;2;282;0;303;2;2;1
/org.eclipse.team.cvs.core/src/org/eclipse/team/internal/ccvs/core/client/Annotate.java;1;0;1;1;0;0;0;1;0;0;1;52;0;0;1;0;0;1;1;52;0;52;1;1;1
/org.eclipse.ant.ui/Ant Editor/org/eclipse/ant/internal/ui/editor/text/XMLAnnotationIterator.java;1;0;1;1;0;0;0;1;0;0;1;108;0;0;1;0;0;1;1;108;0;108;1;1;1
/org.eclipse.jdt.ui/ui/org/eclipse/jdt/internal/ui/javaeditor/ExternalClassFileEditorInput.java;1;0;1;1;1;1;1;0;2;0;0;336;2;2;1;0;0;0;1;336;0;336;1;1;0
/org.eclipse.swt/Eclipse SWT PI/motif/org/eclipse/swt/internal/motif/XMotionEvent.java;1;0;1;1;0;0;0;1;16;0;1;56;16;16;1;0;0;1;1;56;0;56;1;1;0
/org.eclipse.swt/Eclipse SWT/motif/org/eclipse/swt/widgets/ProgressBar.java;3;1;5;1;2;2;2;3;85;1;3;19;113;113;1;0;0;3;5;19;0;337;5;3;0
/org.eclipse.help.webapp/src_servlets/org/eclipse/help/internal/webapp/data/WebappPreferences.java;1;4;9;1;6;3;6;3;54;1;3;42;95;95;4;0;3;3;9;286;3;336;6;1;0
/org.eclipse.pde.core/src/org/eclipse/pde/internal/core/schema/ExternalSchemaDescriptor.java;3;1;5;1;2;2;2;3;6;1;3;128;23;23;1;0;0;3;5;128;0;336;5;3;0
/org.eclipse.swt/Eclipse SWT PI/win32/org/eclipse/swt/internal/win32/NMLVDISPINFO.java;1;0;1;1;0;0;0;1;0;0;1;166;0;0;1;0;0;1;1;166;0;166;1;1;0
/org.eclipse.pde.core/src/org/eclipse/pde/core/IModelProviderEvent.java;2;1;4;1;3;3;3;1;91;0;1;130;99;99;1;0;0;1;4;130;0;336;4;2;0
/org.eclipse.pde.core/src/org/eclipse/pde/internal/core/XMLDefaultHandler.java;1;0;5;1;1;1;1;4;69;2;3;166;82;82;2;1;0;4;5;166;1;336;4;1;0
/org.eclipse.ant.ui/Ant Editor/org/eclipse/ant/internal/ui/editor/formatter/FormattingPreferences.java;1;0;6;1;1;1;1;5;113;3;3;218;145;145;3;2;0;5;6;226;2;306;4;1;1
/org.eclipse.jdt.core/formatter/org/eclipse/jdt/internal/formatter/DefaultCodeFormatter.java;4;3;32;2;5;3;5;27;484;8;8;54;1176;1176;8;19;2;27;32;115;21;323;11;4;0
/org.eclipse.pde.core/src/org/eclipse/pde/internal/core/RequiredPluginsClasspathContainer.java;2;1;6;1;2;2;2;4;53;2;3;151;72;72;2;1;0;4;6;151;1;336;5;2;0
/org.eclipse.swt/Eclipse SWT/common/org/eclipse/swt/widgets/TypedListener.java;1;0;1;1;0;0;0;1;8;0;1;156;8;8;1;0;0;1;1;156;0;156;1;1;0
/org.eclipse.ui.workbench/Eclipse UI/org/eclipse/ui/actions/PartEventAction.java;1;0;3;1;0;0;0;3;14;2;2;93;26;26;2;1;0;3;3;157;1;157;2;1;0
/org.eclipse.swt.tools/JNI Generation/org/eclipse/swt/tools/internal/SizeofGenerator.java;2;0;2;2;0;0;0;2;10;0;1;230;10;10;2;1;0;2;2;230;1;230;1;2;0
/org.eclipse.swt/Eclipse SWT PI/win32/org/eclipse/swt/internal/win32/NMLVCUSTOMDRAW.java;1;0;1;1;0;0;0;1;1;0;1;166;1;1;1;0;0;1;1;166;0;166;1;1;0
/org.eclipse.jdt.ui/ui/org/eclipse/jdt/internal/ui/search/MatchFilter.java;1;2;5;1;5;3;5;0;33;0;0;290;55;55;2;0;2;0;5;290;2;326;3;1;0
/org.eclipse.ui.ide/extensions/org/eclipse/ui/IProjectActionFilter.java;3;1;3;1;2;2;2;1;4;0;1;132;6;6;1;0;0;1;3;132;0;336;3;3;0
/org.eclipse.ui.workbench/Eclipse UI/org/eclipse/ui/internal/registry/ActionSetRegistry.java;4;1;4;1;2;2;2;2;37;1;2;196;51;51;1;0;0;2;4;196;0;336;4;4;0
/org.eclipse.team.core/src/org/eclipse/team/core/synchronize/FastSyncInfoFilter.java;2;2;5;1;3;2;3;2;192;1;2;224;239;239;2;0;1;2;5;335;1;335;4;2;0
/org.eclipse.pde.ui/src/org/eclipse/pde/internal/ui/wizards/plugin/NewProjectCreationPage.java;2;2;3;1;3;2;3;0;11;0;0;326;15;15;2;0;1;0;3;326;1;336;2;2;0
/org.eclipse.osgi/core/framework/org/eclipse/osgi/framework/internal/core/NothingToUpdateException.java;3;1;3;1;2;2;2;1;4;0;1;171;6;6;1;0;0;1;3;171;0;336;3;3;0
/org.eclipse.ltk.ui.refactoring/src/org/eclipse/ltk/internal/ui/refactoring/RefactoringStatusContentProvider.java;1;0;2;1;1;1;1;1;2;0;1;269;2;2;1;0;0;1;2;269;0;336;2;1;0
/org.eclipse.compare/compare/org/eclipse/compare/structuremergeviewer/IDiffContainer.java;1;0;1;1;0;0;0;1;2;0;1;219;2;2;1;0;0;1;1;219;0;219;1;1;0
/org.eclipse.team.cvs.ui/src/org/eclipse/team/internal/ccvs/ui/merge/ProjectElement.java;2;0;3;1;1;1;2;1;36;0;1;265;38;38;2;0;1;2;3;265;1;336;2;2;0
/org.eclipse.swt/Eclipse SWT PI/win32/org/eclipse/swt/internal/win32/NMTTDISPINFOA.java;1;0;1;1;0;0;0;1;0;0;1;61;0;0;1;0;0;1;1;61;0;61;1;1;0
/org.eclipse.jface.text/src/org/eclipse/jface/text/rules/BufferedRuleBasedScanner.java;1;0;1;1;1;1;1;0;2;0;0;336;2;2;1;0;0;0;1;336;0;336;1;1;0
/org.eclipse.jdt.ui/ui/org/eclipse/jdt/internal/ui/text/correction/CorrectionMessages.java;1;0;1;1;1;1;1;0;2;0;0;336;2;2;1;0;0;0;1;336;0;336;1;1;0
/org.eclipse.jdt.ui/core refactoring/org/eclipse/jdt/internal/corext/refactoring/reorg/ArrayTypeConverter.java;2;0;2;1;1;1;1;1;2;0;1;70;2;2;1;0;0;1;2;70;0;336;2;2;0
/org.eclipse.osgi/resolver/src/org/eclipse/core/internal/dependencies/ISelectionPolicy.java;1;0;1;1;1;1;1;0;0;0;0;281;0;0;1;0;0;0;1;281;0;281;1;1;0
/org.eclipse.jface.text/src/org/eclipse/jface/text/ITextDoubleClickStrategy.java;2;2;3;2;3;2;3;0;14;0;0;275;16;16;2;0;1;0;3;336;1;336;2;2;0
/org.eclipse.jdt.debug.ui/ui/org/eclipse/jdt/internal/debug/ui/JavaDebugOptionsManager.java;5;1;12;2;4;4;4;8;84;2;7;76;194;194;2;1;0;8;12;139;1;336;11;5;3
/org.eclipse.jface.text/src/org/eclipse/jface/internal/text/link/contentassist/SingleCharReader.java;2;0;2;1;1;1;1;1;2;0;1;232;2;2;1;0;0;1;2;232;0;336;2;2;0
/org.eclipse.jdt.core/model/org/eclipse/jdt/core/jdom/IDOMCompilationUnit.java;2;0;6;1;1;1;1;5;20;2;4;62;45;45;2;1;0;5;6;62;1;299;5;2;0
/org.eclipse.team.cvs.core/src/org/eclipse/team/internal/ccvs/core/client/Remove.java;1;0;1;1;0;0;0;1;2;0;1;110;2;2;1;0;0;1;1;110;0;110;1;1;0
/org.eclipse.ui.workbench/Eclipse UI/org/eclipse/ui/internal/activities/ws/WorkbenchActivitySupport.java;4;1;8;2;2;2;2;6;178;2;5;174;305;305;2;1;0;6;8;174;1;336;7;4;0
/org.eclipse.ui.workbench/Eclipse UI/org/eclipse/ui/internal/commands/KeyConfigurationDefinition.java;2;0;10;1;1;1;1;9;118;3;6;84;347;347;3;3;0;9;10;84;3;336;7;2;0
/org.eclipse.jdt.core/codeassist/org/eclipse/jdt/internal/codeassist/select/SelectionOnQualifiedNameReference.java;3;0;3;1;0;0;0;3;20;1;3;63;26;26;1;0;0;3;3;63;0;199;3;3;1
/org.eclipse.jdt.ui/ui/org/eclipse/jdt/internal/ui/compare/JavaContentViewerCreator.java;1;0;1;1;1;1;1;0;2;0;0;336;2;2;1;0;0;0;1;336;0;336;1;1;0
/org.eclipse.core.resources/src/org/eclipse/core/internal/localstore/UnifiedTreeNode.java;1;0;1;1;1;1;1;0;191;0;0;277;191;191;1;0;0;0;1;277;0;277;1;1;0
/org.eclipse.core.expressions/src/org/eclipse/core/expressions/PropertyTester.java;1;2;6;1;4;3;4;2;55;0;1;227;124;124;2;1;1;2;6;227;2;334;4;1;1
/org.eclipse.swt/Eclipse SWT/common/org/eclipse/swt/widgets/Monitor.java;1;0;2;1;0;0;0;2;2;1;2;2;2;2;1;0;0;2;2;2;0;13;2;1;0
/org.eclipse.jdt.core/compiler/org/eclipse/jdt/internal/compiler/flow/ConditionalFlowInfo.java;1;0;1;1;0;0;0;1;2;0;1;199;2;2;1;0;0;1;1;199;0;199;1;1;0
/org.eclipse.ui.ide/src/org/eclipse/ui/internal/ide/update/ConfigurationManagerAction.java;1;0;1;1;1;1;1;0;0;0;0;309;0;0;1;0;0;0;1;309;0;309;1;1;0
/org.eclipse.pde.ui/src/org/eclipse/pde/internal/ui/launcher/TracingLauncherTab.java;3;1;17;2;3;3;3;14;512;4;8;44;1271;1271;4;6;0;14;17;182;6;336;11;3;0
/org.eclipse.jdt.ui/ui/org/eclipse/jdt/internal/ui/browsing/JavaElementTypeComparator.java;1;0;1;1;1;1;1;0;2;0;0;336;2;2;1;0;0;0;1;336;0;336;1;1;0
/org.eclipse.jdt.debug.ui/ui/org/eclipse/jdt/internal/debug/ui/JavaDetailFormattersManager.java;3;1;5;2;3;3;3;2;151;1;2;180;189;189;1;0;0;2;5;180;0;336;5;3;0
/org.eclipse.jdt.ui/core extension/org/eclipse/jdt/internal/corext/template/java/Templates.java;2;2;13;1;3;2;6;7;22;6;3;234;54;54;6;4;4;10;13;263;8;335;5;2;0
/org.eclipse.ant.ui/Ant Editor/org/eclipse/ant/internal/ui/editor/outline/AntOutlineMessages.java;1;0;1;1;0;0;0;1;0;0;1;108;0;0;1;0;0;1;1;108;0;108;1;1;0
/org.eclipse.swt/Eclipse SWT/common/org/eclipse/swt/graphics/Point.java;3;1;3;1;2;2;2;1;6;0;1;225;14;14;1;0;0;1;3;225;0;337;3;3;0
/org.eclipse.ui.console/src/org/eclipse/ui/internal/console/IInternalConsoleConstants.java;1;0;1;1;0;0;0;1;0;0;1;118;0;0;1;0;0;1;1;118;0;118;1;1;0
/org.eclipse.osgi/resolver/src/org/eclipse/osgi/internal/resolver/ComputeNodeOrder.java;2;1;2;2;2;2;2;0;3;0;0;286;5;5;1;0;0;0;2;286;0;295;2;2;0
/org.eclipse.update.ui/src/org/eclipse/update/internal/ui/properties/FeatureCopyrightPropertyPage.java;3;1;4;2;2;2;2;2;24;0;1;54;37;37;2;1;0;2;4;54;1;336;3;3;0
/org.eclipse.ui.forms/src/org/eclipse/ui/forms/FormColors.java;1;0;9;1;3;1;4;5;95;3;3;225;179;179;3;2;3;6;9;263;5;330;4;1;0
/org.eclipse.core.resources/src/org/eclipse/core/internal/utils/UniversalUniqueIdentifier.java;2;0;2;1;1;1;1;1;713;0;1;13;730;730;1;0;0;1;2;13;0;277;2;2;0
/org.eclipse.debug.ui/ui/org/eclipse/debug/internal/ui/views/memory/PrintViewTabAction.java;2;0;2;2;2;1;2;0;5;0;0;282;5;5;2;0;1;0;2;282;1;282;1;2;1
/org.eclipse.jdt.debug/jdi/org/eclipse/jdi/internal/connect/SocketAttachingConnectorImpl.java;4;0;4;2;1;1;1;3;4;2;2;184;9;9;2;1;0;3;4;184;1;336;3;4;0
/org.eclipse.jdt.ui/ui refactoring/org/eclipse/jdt/internal/ui/refactoring/sef/SelfEncapsulateFieldWizard.java;2;0;5;1;1;1;2;3;18;3;2;66;24;24;3;1;1;4;5;263;2;336;3;2;0
/org.eclipse.swt/Eclipse SWT/emulated/bidi/org/eclipse/swt/internal/BidiUtil.java;4;0;5;2;1;1;1;4;29;2;3;36;40;40;2;1;0;4;5;76;1;337;4;4;0
/org.eclipse.jdt.ui/core refactoring/org/eclipse/jdt/internal/corext/refactoring/code/IntroduceParameterRefactoring.java;4;14;27;2;15;2;15;12;499;3;7;130;707;707;14;5;13;12;27;282;18;336;9;4;0
/org.eclipse.jdt.core/compiler/org/eclipse/jdt/internal/compiler/impl/ByteConstant.java;2;0;3;1;1;1;1;2;12;1;2;70;20;20;1;0;0;2;3;70;0;299;3;2;0
/org.eclipse.ui.workbench/Eclipse UI/org/eclipse/ui/internal/themes/Theme.java;2;0;12;2;0;0;1;11;268;8;2;233;460;460;8;9;1;12;12;233;10;262;2;2;0
/org.eclipse.jdt.core/compiler/org/eclipse/jdt/internal/compiler/lookup/TypeIds.java;2;0;2;1;0;0;0;2;5;1;2;199;7;7;1;0;0;2;2;199;0;267;2;2;0
/org.eclipse.swt/Eclipse SWT/carbon/org/eclipse/swt/widgets/Tracker.java;6;1;19;2;3;3;3;16;318;3;11;8;741;741;3;5;0;16;19;101;5;337;14;6;1
/org.eclipse.pde.junit.runtime/src/org/eclipse/pde/internal/junit/runtime/LegacyUITestApplication.java;1;1;4;1;2;2;2;2;10;0;1;179;18;18;2;1;0;2;4;179;1;336;3;1;0
/org.eclipse.core.variables/src/org/eclipse/core/variables/IDynamicVariableResolver.java;1;0;1;1;0;0;0;1;0;0;1;145;0;0;1;0;0;1;1;145;0;145;1;1;0
/org.eclipse.core.filebuffers/src/org/eclipse/core/internal/filebuffers/FileBuffersPlugin.java;2;2;5;1;3;2;3;2;54;0;1;93;68;68;2;1;1;2;5;93;2;336;3;2;0
/org.eclipse.update.core/src/org/eclipse/update/core/IArchiveReference.java;2;1;3;1;2;2;2;1;6;0;1;58;14;14;1;0;0;1;3;58;0;336;3;2;0
/org.eclipse.jdt.core/compiler/org/eclipse/jdt/internal/compiler/parser/RecoveredUnit.java;4;0;7;2;1;1;1;6;78;2;5;34;116;116;2;1;0;6;7;63;1;290;6;4;0
/org.eclipse.jface.text/src/org/eclipse/jface/text/source/AnnotationBarHoverManager.java;3;3;13;2;6;3;6;7;241;2;5;49;792;792;3;2;3;7;13;275;5;336;8;3;0
/org.eclipse.jdt.core/search/org/eclipse/jdt/core/search/SearchEngine.java;5;2;38;3;6;4;9;29;1912;6;11;5;3320;3320;6;18;5;32;38;149;23;325;15;5;1
/org.eclipse.update.ui/src/org/eclipse/update/internal/ui/model/ConfiguredFeatureAdapter.java;3;0;5;1;1;1;1;4;106;2;3;58;121;121;2;1;0;4;5;99;1;336;4;3;0
/org.eclipse.jdt.core/compiler/org/eclipse/jdt/internal/compiler/lookup/BaseTypes.java;1;0;1;1;0;0;0;1;2;0;1;199;2;2;1;0;0;1;1;199;0;199;1;1;0
/org.eclipse.swt/Eclipse SWT Accessibility/win32/org/eclipse/swt/accessibility/Accessible.java;3;3;9;3;5;3;5;4;259;2;3;131;463;463;3;1;2;4;9;299;3;337;6;3;0
/org.eclipse.debug.ui/ui/org/eclipse/debug/internal/ui/actions/LinkBreakpointsWithDebugViewAction.java;1;0;1;1;0;0;0;1;0;0;1;113;0;0;1;0;0;1;1;113;0;113;1;1;0
/org.eclipse.pde.core/src/org/eclipse/pde/core/plugin/ISharedExtensionsModel.java;2;1;2;1;2;2;2;0;6;0;0;292;6;6;1;0;0;0;2;292;0;336;2;2;0
/org.eclipse.jdt.ui/ui/org/eclipse/jdt/internal/ui/wizards/NewElementWizard.java;4;1;9;2;2;2;2;7;15;2;5;82;51;51;2;2;0;7;9;157;2;336;7;4;0
/org.eclipse.swt/Eclipse SWT/emulated/coolbar/org/eclipse/swt/widgets/CoolItem.java;3;3;8;2;5;3;5;3;55;1;3;19;118;118;3;0;2;3;8;300;2;337;6;3;0
/org.eclipse.jdt.ui/ui/org/eclipse/jdt/internal/ui/actions/OpenActionUtil.java;1;0;2;1;1;1;1;1;4;0;1;82;6;6;1;0;0;1;2;82;0;336;2;1;0
/org.eclipse.pde.ui/src_Forms/org/eclipse/pde/internal/ui/model/plugin/PluginNode.java;3;3;8;3;5;3;5;3;14;2;2;244;38;38;3;1;2;3;8;297;3;336;5;3;0
/org.eclipse.core.runtime/src/org/eclipse/core/runtime/Status.java;3;2;12;3;3;2;5;7;824;3;5;47;883;883;3;2;3;9;12;171;5;332;7;3;0
/org.eclipse.ui.presentations.r21/src/org/eclipse/ui/internal/presentations/r21/widgets/CTabFolderListener.java;1;1;2;1;2;2;2;0;2;0;0;323;2;2;1;0;0;0;2;323;0;336;2;1;0
/org.eclipse.compare/compare/org/eclipse/compare/structuremergeviewer/IStructureCreator.java;1;0;1;1;0;0;0;1;2;0;1;219;2;2;1;0;0;1;1;219;0;219;1;1;0
/org.eclipse.pde.ui/src/org/eclipse/pde/internal/ui/wizards/exports/FeatureExportJob.java;2;5;12;2;10;5;10;2;538;1;2;149;873;873;5;0;5;2;12;302;5;336;7;2;0
/org.eclipse.ui.ide/src/org/eclipse/ui/views/properties/ResourcePropertySource.java;3;1;3;1;2;2;2;1;4;0;1;129;6;6;1;0;0;1;3;129;0;336;3;3;0
/org.eclipse.update.core/src/org/eclipse/update/standalone/UninstallCommand.java;1;2;7;1;6;5;6;1;15;0;1;267;39;39;2;0;1;1;7;292;1;336;6;1;0
/org.eclipse.jdt.core/compiler/org/eclipse/jdt/internal/compiler/lookup/SyntheticArgumentBinding.java;1;0;1;1;0;0;0;1;2;0;1;199;2;2;1;0;0;1;1;199;0;199;1;1;0
/org.eclipse.search/search/org/eclipse/search/internal/core/text/TextSearchVisitor.java;2;1;10;2;3;3;3;7;184;2;6;9;532;532;2;1;0;7;10;9;1;336;9;2;0
/org.eclipse.jdt.core/model/org/eclipse/jdt/internal/core/LRUCacheEnumerator.java;1;0;1;1;0;0;0;1;2;0;1;199;2;2;1;0;0;1;1;199;0;199;1;1;0
/org.eclipse.jdt.ui/core extension/org/eclipse/jdt/internal/corext/codemanipulation/ImportsStructure.java;4;2;19;3;5;3;5;14;236;4;8;18;710;710;4;6;2;14;19;249;8;331;11;4;0
/org.eclipse.ui.ide/src/org/eclipse/ui/views/tasklist/CopyTaskAction.java;1;0;2;1;0;0;0;2;3;0;1;129;3;3;2;1;0;2;2;129;1;129;1;1;0
/org.eclipse.jdt.ui/core extension/org/eclipse/jdt/internal/corext/codemanipulation/GetterSetterUtil.java;3;1;4;1;2;2;2;2;136;1;2;59;159;159;1;0;0;2;4;59;0;336;4;3;0
/org.eclipse.ui.intro/src/org/eclipse/ui/internal/intro/impl/model/AbstractIntroPage.java;1;7;13;1;13;3;13;0;237;0;0;276;449;449;7;0;10;0;13;276;10;327;3;1;0
/org.eclipse.jdt.debug/jdi/org/eclipse/jdi/internal/spy/TcpipSpy.java;2;0;3;1;0;0;0;3;20;1;3;39;27;27;1;0;0;3;3;39;0;144;3;2;0
/org.eclipse.team.cvs.ui/src/org/eclipse/team/internal/ccvs/ui/subscriber/WorkspaceSynchronizeParticipant.java;2;5;16;2;7;3;7;9;231;3;5;149;358;358;5;4;4;9;16;288;8;336;8;2;4
/org.eclipse.ui.forms/src/org/eclipse/ui/internal/forms/FormWizard.java;1;1;2;1;2;2;2;0;4;0;0;272;4;4;1;0;0;0;2;272;0;336;2;1;0
/org.eclipse.swt/Eclipse SWT/gtk/org/eclipse/swt/internal/Converter.java;5;0;6;1;1;1;1;5;8;1;5;0;26;26;1;0;0;5;6;0;0;337;6;5;0
/org.eclipse.ui.editors/src/org/eclipse/ui/texteditor/AbstractDecoratedTextEditor.java;3;3;7;2;7;4;7;0;60;0;0;276;73;73;3;0;3;0;7;331;3;331;4;3;0
/org.eclipse.osgi/osgi/src/org/osgi/service/url/URLStreamHandlerService.java;2;0;2;1;1;1;1;1;3;0;1;171;3;3;1;0;0;1;2;171;0;296;2;2;0
/org.eclipse.update.ui/src/org/eclipse/update/internal/ui/model/SiteCategory.java;2;0;2;1;0;0;0;2;17;1;2;26;25;25;1;0;0;2;2;26;0;58;2;2;0
/org.eclipse.core.resources/src/org/eclipse/core/internal/resources/MarkerInfo.java;2;0;4;1;1;1;1;3;184;1;3;13;208;208;1;0;0;3;4;13;0;277;4;2;0
/org.eclipse.jdt.debug.ui/ui/org/eclipse/jdt/internal/debug/ui/JavaDebugImages.java;4;2;8;2;3;2;3;5;57;1;5;19;78;78;2;0;1;5;8;281;1;294;7;4;0
/org.eclipse.jdt.ui/ui refactoring/org/eclipse/jdt/internal/ui/refactoring/MoveMembersWizard.java;4;0;17;2;1;1;4;13;203;4;9;36;757;757;4;4;3;16;17;269;7;336;10;4;0
/org.eclipse.core.runtime/src/org/eclipse/core/runtime/IProgressMonitor.java;2;2;6;2;3;2;3;3;480;0;1;171;498;498;3;2;1;3;6;171;3;336;3;2;0
/org.eclipse.jdt.ui/ui/org/eclipse/jdt/internal/ui/text/JavaWhitespaceDetector.java;1;0;1;1;1;1;1;0;2;0;0;336;2;2;1;0;0;0;1;336;0;336;1;1;0
/org.eclipse.pde.build/src_ant/org/eclipse/pde/internal/build/tasks/UnzipperGeneratorTask.java;2;2;10;2;3;2;3;7;20;2;5;31;35;35;2;2;1;7;10;31;3;336;7;2;0
/org.eclipse.core.runtime/src/org/eclipse/core/runtime/jobs/LockListener.java;3;2;11;2;3;2;3;8;212;3;4;77;250;250;3;4;1;8;11;171;5;303;6;3;0
/org.eclipse.jface.text/src/org/eclipse/jface/text/TextEvent.java;2;2;4;2;3;2;3;1;30;0;1;259;33;33;2;0;1;1;4;336;1;336;3;2;0
/org.eclipse.jdt.core/eval/org/eclipse/jdt/internal/eval/CodeSnippetReturnStatement.java;1;0;2;1;0;0;0;2;2;1;2;77;4;4;1;0;0;2;2;77;0;199;2;1;0
/org.eclipse.jdt.ui/ui/org/eclipse/jdt/internal/ui/text/ContentAssistPreference.java;2;0;2;1;1;1;1;1;8;0;1;268;10;10;1;0;0;1;2;268;0;336;2;2;0
/org.eclipse.osgi/core/framework/org/eclipse/osgi/framework/internal/core/BundleCombinedPermissions.java;4;1;5;1;3;3;3;2;277;1;2;171;287;287;1;0;0;2;5;171;0;336;5;4;0
/org.eclipse.update.core/src/org/eclipse/update/operations/IFeatureOperation.java;1;1;6;1;2;2;2;4;26;1;4;54;59;59;1;0;0;4;6;54;0;336;6;1;0
/org.eclipse.jdt.ui/ui/org/eclipse/jdt/internal/ui/dialogs/MultiTypeSelectionDialog.java;2;1;2;1;2;2;2;0;6;0;0;313;8;8;1;0;0;0;2;313;0;336;2;2;0
/org.eclipse.update.core/src/org/eclipse/update/internal/core/InternalSiteManager.java;2;5;13;2;7;3;7;6;132;2;5;58;265;265;5;1;4;6;13;289;5;336;8;2;0
/org.eclipse.text/src/org/eclipse/jface/text/Region.java;1;0;1;1;1;1;1;0;17;0;0;334;17;17;1;0;0;0;1;334;0;334;1;1;0
/org.eclipse.jface.text/src/org/eclipse/jface/contentassist/ISubjectControlContextInformationPresenter.java;1;2;3;1;3;2;3;0;8;0;0;280;14;14;2;0;1;0;3;336;1;336;2;1;0
/org.eclipse.ui.ide/src/org/eclipse/ui/internal/ide/registry/MarkerQueryResult.java;3;1;3;1;2;2;2;1;2;0;1;132;4;4;1;0;0;1;3;132;0;336;3;3;0
/org.eclipse.jdt.ui/ui/org/eclipse/jdt/internal/ui/wizards/NewSourceFolderCreationWizard.java;2;1;5;1;2;2;2;3;14;2;2;225;38;38;2;1;0;3;5;225;1;336;4;2;0
/org.eclipse.jdt.junit/src/org/eclipse/jdt/internal/junit/wizards/JUnitWizard.java;2;2;5;1;4;3;4;1;29;0;1;157;50;50;2;0;1;1;5;312;1;336;4;2;0
/org.eclipse.ui.workbench/Eclipse UI/org/eclipse/ui/internal/contexts/ContextDefinition.java;2;0;8;1;1;1;1;7;137;3;5;84;327;327;3;2;0;7;8;84;2;336;6;2;0
/org.eclipse.help/src/org/eclipse/help/internal/util/ResourceLocator.java;1;1;11;1;3;3;3;8;209;3;5;64;441;441;3;3;0;8;11;245;3;336;8;1;0
/org.eclipse.ui.ide/src/org/eclipse/ui/views/markers/internal/ITableViewContentProvider.java;1;0;1;1;0;0;0;1;0;0;1;129;0;0;1;0;0;1;1;129;0;129;1;1;0
/org.eclipse.debug.ui/ui/org/eclipse/debug/internal/ui/actions/ProfileContextualLaunchAction.java;1;0;1;1;1;1;1;0;0;0;0;295;0;0;1;0;0;0;1;295;0;295;1;1;0
/org.eclipse.swt/Eclipse SWT/carbon/org/eclipse/swt/widgets/MenuItem.java;3;1;7;2;2;2;2;5;83;3;3;16;95;95;3;2;0;5;7;16;2;337;5;3;1
/org.eclipse.jdt.ui/ui/org/eclipse/jdt/internal/ui/jarpackager/JarFileExportOperation.java;2;1;10;1;4;4;4;6;163;2;4;18;286;286;2;2;0;6;10;28;2;336;8;2;0
/org.eclipse.jface/src/org/eclipse/jface/preference/DirectoryFieldEditor.java;2;1;2;1;2;2;2;0;3;0;0;293;5;5;1;0;0;0;2;293;0;336;2;2;0
/org.eclipse.jdt.core/dom/org/eclipse/jdt/core/dom/WildcardType.java;3;2;11;1;3;2;3;8;316;3;5;173;347;347;3;3;1;8;11;230;4;336;7;3;2
/org.eclipse.pde.ui/src_Forms/org/eclipse/pde/internal/ui/model/bundle/BundleModel.java;2;2;6;2;6;4;6;0;81;0;0;292;114;114;2;0;2;0;6;292;2;336;4;2;0
/org.eclipse.jdt.debug/jdi/org/eclipse/jdi/internal/ObjectReferenceImpl.java;3;0;3;1;1;1;1;2;6;1;2;76;12;12;1;0;0;2;3;76;0;336;3;3;0
/org.eclipse.jdt.ui/ui/org/eclipse/jdt/internal/ui/search/SearchViewAdapter.java;2;1;2;1;2;2;2;0;2;0;0;290;3;3;1;0;0;0;2;290;0;336;2;2;0
/org.eclipse.ui.workbench/Eclipse UI/org/eclipse/ui/commands/HandlerSubmission.java;2;0;8;1;2;1;2;6;287;4;2;227;578;578;4;4;1;6;8;227;5;281;3;2;0
/org.eclipse.jdt.core/model/org/eclipse/jdt/core/util/ISourceAttribute.java;1;0;1;1;0;0;0;1;2;0;1;199;2;2;1;0;0;1;1;199;0;199;1;1;0
/org.eclipse.jdt.core/model/org/eclipse/jdt/internal/core/builder/MissingClassFileException.java;1;0;1;1;0;0;0;1;2;0;1;199;2;2;1;0;0;1;1;199;0;199;1;1;0
/org.eclipse.jdt.debug.ui/ui/org/eclipse/jdt/internal/debug/ui/JavaInspectExpressionActionFilter.java;2;0;3;1;1;1;1;2;9;1;2;221;20;20;1;0;0;2;3;221;0;336;3;2;0
/org.eclipse.search/search/org/eclipse/search/ui/ISearchPage.java;1;0;1;1;1;1;1;0;2;0;0;336;2;2;1;0;0;0;1;336;0;336;1;1;0
/org.eclipse.jdt.junit/src/org/eclipse/jdt/internal/junit/util/TestSearchEngine.java;3;2;7;2;6;4;6;1;63;0;1;102;107;107;2;0;2;1;7;289;2;336;5;3;1
/org.eclipse.jface/src/org/eclipse/jface/viewers/ComboViewer.java;1;0;1;1;1;1;1;0;0;0;0;271;0;0;1;0;0;0;1;271;0;271;1;1;0
/org.eclipse.update.ui/src/org/eclipse/update/internal/ui/views/FeatureStateAction.java;3;1;10;2;2;2;2;8;24;3;5;54;53;53;3;3;0;8;10;244;3;336;7;3;0
/org.eclipse.team.cvs.ui/src/org/eclipse/team/internal/ccvs/ui/HistoryTableProvider.java;2;0;5;1;1;1;1;4;75;2;3;55;105;105;2;1;0;4;5;245;1;336;4;2;0
/org.eclipse.jdt.ui/core refactoring/org/eclipse/jdt/internal/corext/refactoring/changes/RenameResourceChange.java;2;1;6;1;2;2;2;4;75;1;4;207;101;101;1;0;0;4;6;207;0;336;6;2;0
/org.eclipse.ui.ide/extensions/org/eclipse/ui/actions/RefreshAction.java;1;0;1;1;0;0;0;1;0;0;1;132;0;0;1;0;0;1;1;132;0;132;1;1;0
/org.eclipse.ui.ide/src/org/eclipse/ui/internal/ide/dialogs/IElementFilter.java;1;0;1;1;0;0;0;1;0;0;1;132;0;0;1;0;0;1;1;132;0;132;1;1;0
/org.eclipse.text/src/org/eclipse/jface/text/IRegion.java;1;0;1;1;1;1;1;0;16;0;0;334;16;16;1;0;0;0;1;334;0;334;1;1;0
/org.eclipse.core.runtime/src/org/eclipse/core/runtime/preferences/IPreferencesService.java;2;3;12;2;4;2;4;8;216;5;2;238;354;354;5;6;2;8;12;238;8;292;4;2;0
/org.eclipse.jdt.ui/ui/org/eclipse/jdt/internal/ui/text/correction/JavaCorrectionProcessor.java;4;1;16;2;3;3;5;11;405;7;5;64;552;552;7;6;2;13;16;64;8;336;8;4;0
/org.eclipse.jdt.debug.ui/ui/org/eclipse/jdt/internal/debug/ui/actions/OpenDialogAction.java;1;0;1;1;0;0;0;1;11;0;1;154;11;11;1;0;0;1;1;154;0;154;1;1;0
/org.eclipse.osgi/core/framework/org/eclipse/osgi/framework/internal/core/ServiceRegistrationImpl.java;2;3;4;1;4;2;4;0;1391;0;0;276;1462;1462;3;0;2;0;4;293;2;293;2;2;0
/org.eclipse.debug.ui/ui/org/eclipse/debug/ui/console/FileLink.java;2;0;3;1;0;0;0;3;22;1;3;122;40;40;1;0;0;3;3;122;0;166;3;2;1
/org.eclipse.jdt.ui/ui/org/eclipse/jdt/internal/ui/preferences/OccurrencesPreferencePage.java;1;0;1;1;1;1;1;0;7;0;0;295;7;7;1;0;0;0;1;295;0;295;1;1;0
/org.eclipse.jdt.ui/ui/org/eclipse/jdt/internal/ui/viewsupport/ImageImageDescriptor.java;1;0;1;1;1;1;1;0;2;0;0;336;2;2;1;0;0;0;1;336;0;336;1;1;0
/org.eclipse.jdt.junit/src/org/eclipse/jdt/internal/junit/ui/JUnitHomeInitializer.java;3;1;7;1;4;4;4;3;12;2;2;42;35;35;2;1;0;3;7;42;1;336;6;3;0
/org.eclipse.jdt.ui/ui/org/eclipse/jdt/internal/ui/wizards/NewTypeDropDownAction.java;3;1;4;1;2;2;2;2;49;1;2;253;55;55;1;0;0;2;4;253;0;336;4;3;0
/org.eclipse.jdt.ui/core extension/org/eclipse/jdt/internal/corext/template/java/CompilationUnitContextType.java;4;2;9;2;3;2;3;6;119;4;3;175;156;156;4;3;1;6;9;234;4;336;5;4;0
/org.eclipse.team.core/src/org/eclipse/team/core/variants/ResourceVariantTree.java;1;1;3;1;2;2;2;1;25;0;1;239;43;43;1;0;0;1;3;239;0;325;3;1;0
/org.eclipse.debug.ui/ui/org/eclipse/debug/internal/ui/preferences/StringVariablePreferencePage.java;4;1;7;2;2;2;2;5;27;2;4;125;52;52;2;1;0;5;7;223;1;336;6;4;0
/org.eclipse.jdt.core/compiler/org/eclipse/jdt/internal/compiler/env/IGenericType.java;1;0;1;1;0;0;0;1;2;0;1;199;2;2;1;0;0;1;1;199;0;199;1;1;0
/org.eclipse.core.runtime/src/org/eclipse/core/runtime/jobs/IJobChangeEvent.java;3;0;7;2;2;1;2;5;152;3;3;68;164;164;3;2;1;5;7;171;3;274;4;3;0
/org.eclipse.jdt.core/compiler/org/eclipse/jdt/internal/compiler/ast/SubRoutineStatement.java;3;0;4;2;1;1;1;3;8;2;2;11;17;17;2;1;0;3;4;11;1;288;3;3;1
/org.eclipse.jdt.ui/core refactoring/org/eclipse/jdt/internal/corext/refactoring/typeconstraints/ReturnTypeVariable.java;2;0;6;1;1;1;1;5;21;3;3;3;38;38;3;2;0;5;6;3;2;336;4;2;0
/org.eclipse.ui.workbench/Eclipse UI/org/eclipse/ui/internal/QuitAction.java;2;0;2;2;0;0;0;2;138;1;2;157;186;186;1;0;0;2;2;157;0;172;2;2;0
/org.eclipse.osgi/core/adaptor/org/eclipse/osgi/framework/adaptor/BundleData.java;4;1;8;1;3;3;3;5;95;2;4;171;120;120;2;1;0;5;8;239;1;336;7;4;0
/org.eclipse.update.core/src/org/eclipse/update/internal/core/ConfigurationPolicy.java;3;2;11;2;3;2;3;8;452;4;4;58;842;842;4;4;1;8;11;193;5;302;6;3;0
/org.eclipse.jdt.junit/src/org/eclipse/jdt/internal/junit/ui/JavaTypeExtender.java;4;1;7;1;3;3;3;4;62;3;2;209;120;120;3;2;0;4;7;219;2;336;5;4;0
/org.eclipse.jdt.launching/launching/org/eclipse/jdt/launching/sourcelookup/LocalFileStorage.java;2;1;3;1;2;2;2;1;93;0;1;170;125;125;1;0;0;1;3;170;0;282;3;2;0
/org.eclipse.jface.text/src/org/eclipse/jface/text/presentation/IPresentationDamager.java;2;2;3;2;3;2;3;0;28;0;0;276;32;32;2;0;1;0;3;336;1;336;2;2;0
/org.eclipse.swt/Eclipse SWT/motif/org/eclipse/swt/widgets/ToolBar.java;4;2;8;2;4;3;4;4;26;1;4;8;65;65;2;0;1;4;8;300;1;337;7;4;0
/org.eclipse.jface.text/src/org/eclipse/jface/text/contentassist/ICompletionProposalExtension2.java;1;0;2;1;2;1;2;0;26;0;0;336;26;26;2;0;1;0;2;336;1;336;1;1;0
/org.eclipse.ui.intro/src/org/eclipse/ui/internal/intro/impl/model/IntroPageTitle.java;1;0;4;1;4;1;4;0;10;0;0;276;10;10;4;0;3;0;4;276;3;276;1;1;0
/org.eclipse.team.core/src/org/eclipse/team/core/synchronize/SyncInfoSet.java;2;2;6;2;3;2;3;3;607;2;2;224;691;691;2;1;1;3;6;232;2;335;4;2;3
/org.eclipse.team.cvs.ui/src/org/eclipse/team/internal/ccvs/ui/model/CVSModelElement.java;2;1;6;1;2;2;2;4;118;2;3;5;149;149;2;1;0;4;6;63;1;336;5;2;0
/org.eclipse.jdt.ui/core extension/org/eclipse/jdt/internal/corext/util/TypeFilter.java;2;0;4;1;1;1;1;3;13;1;3;179;23;23;1;0;0;3;4;179;0;336;4;2;0
/org.eclipse.jdt.ui/ui/org/eclipse/jdt/internal/ui/filters/ClassFilter.java;1;0;1;1;1;1;1;0;2;0;0;336;2;2;1;0;0;0;1;336;0;336;1;1;0
/org.eclipse.ui.console/src/org/eclipse/ui/internal/console/MessageConsolePartitioner.java;3;0;6;2;2;1;2;4;255;2;2;118;297;297;2;2;1;4;6;118;3;296;3;3;0
/org.eclipse.ui.ide/src/org/eclipse/ui/wizards/datatransfer/WizardFileSystemResourceImportPage1.java;4;0;4;1;1;1;1;3;25;1;3;92;29;29;1;0;0;3;4;92;0;336;4;4;0
/org.eclipse.jdt.core/codeassist/org/eclipse/jdt/internal/codeassist/select/SelectionOnMessageSend.java;3;0;3;1;0;0;0;3;34;1;3;31;46;46;1;0;0;3;3;31;0;199;3;3;1
/org.eclipse.team.cvs.core/src/org/eclipse/team/internal/ccvs/core/client/AddStructureVisitor.java;1;0;1;1;0;0;0;1;5;0;1;110;5;5;1;0;0;1;1;110;0;110;1;1;0
/org.eclipse.jdt.ui/ui/org/eclipse/jdt/internal/ui/preferences/formatter/LineWrappingTabPage.java;1;0;9;1;1;1;1;8;1498;6;3;176;1537;1537;6;5;0;8;9;191;5;305;4;1;2
/org.eclipse.core.resources/src/org/eclipse/core/internal/localstore/SafeFileOutputStream.java;1;0;2;1;1;1;1;1;192;0;1;169;194;194;1;0;0;1;2;169;0;277;2;1;0
/org.eclipse.jdt.ui/ui/org/eclipse/jdt/internal/ui/ResourceAdapterFactory.java;1;0;1;1;1;1;1;0;2;0;0;336;2;2;1;0;0;0;1;336;0;336;1;1;0
/org.eclipse.ui.workbench/Eclipse UI/org/eclipse/ui/IViewPart.java;2;1;2;1;2;2;2;0;8;0;0;315;10;10;1;0;0;0;2;315;0;336;2;2;1
/org.eclipse.pde.ui/src/org/eclipse/pde/internal/ui/editor/schema/SchemaInputContextManager.java;2;2;3;2;3;2;3;0;10;0;0;292;14;14;2;0;1;0;3;292;1;336;2;2;0
/org.eclipse.core.resources/src/org/eclipse/core/internal/localstore/UnifiedTree.java;2;0;8;2;2;1;2;6;669;4;3;141;737;737;4;3;1;6;8;141;4;277;4;2;0
/org.eclipse.swt/Eclipse SWT/carbon/org/eclipse/swt/widgets/Control.java;7;8;54;4;12;5;12;42;390;12;14;1;1209;1209;12;28;7;42;54;19;35;308;19;7;1
/org.eclipse.jdt.ui/ui/org/eclipse/jdt/internal/ui/dialogs/MultiMainTypeSelectionDialog.java;1;0;1;1;1;1;1;0;2;0;0;336;2;2;1;0;0;0;1;336;0;336;1;1;0
/org.eclipse.pde.ui/src/org/eclipse/pde/internal/ui/editor/feature/OpenReferenceAction.java;2;1;4;1;2;2;2;2;11;1;2;157;20;20;1;0;0;2;4;157;0;336;4;2;0
/org.eclipse.ant.ui/Ant Runner Support/org/eclipse/ant/internal/ui/antsupport/logger/AntProcessBuildLogger.java;3;0;7;3;0;0;0;7;51;3;3;108;67;67;3;4;0;7;7;108;4;141;3;3;2
/org.eclipse.search/new search/org/eclipse/search2/internal/ui/SearchPageRegistry.java;2;1;3;1;2;2;2;1;2;0;1;245;4;4;1;0;0;1;3;245;0;336;3;2;0
/org.eclipse.ant.ui/Ant Tools Support/org/eclipse/ant/internal/ui/launchConfigurations/AntMainTab.java;3;0;9;2;0;0;0;9;61;2;7;108;100;100;2;2;0;9;9;145;2;266;7;3;1
/org.eclipse.text/src/org/eclipse/jface/text/source/Annotation.java;1;1;3;1;2;2;2;1;159;0;1;131;180;180;1;0;0;1;3;131;0;334;3;1;0
/org.eclipse.ltk.core.refactoring/src/org/eclipse/ltk/core/refactoring/participants/ValidateEditChecker.java;1;2;6;1;5;3;5;1;22;0;1;264;44;44;2;0;2;1;6;275;2;332;4;1;0
/org.eclipse.ui.editors/src/org/eclipse/ui/internal/editors/text/IPreferenceConfigurationBlock.java;1;0;1;1;1;1;1;0;0;0;0;295;0;0;1;0;0;0;1;295;0;295;1;1;0
/org.eclipse.compare/compare/org/eclipse/compare/internal/merge/MergeMessages.java;1;0;1;1;1;1;1;0;0;0;0;278;0;0;1;0;0;0;1;278;0;278;1;1;0
/org.eclipse.team.cvs.core/src/org/eclipse/team/internal/ccvs/core/resources/EclipseFolder.java;2;3;14;1;4;2;4;10;47;4;7;52;121;121;4;3;2;10;14;119;5;336;9;2;0
/org.eclipse.jdt.ui/ui/org/eclipse/jdt/internal/ui/jarpackager/OpenJarPackageWizardActionDelegate.java;1;0;1;1;1;1;1;0;2;0;0;336;2;2;1;0;0;0;1;336;0;336;1;1;0
/org.eclipse.ui.editors/src/org/eclipse/ui/internal/editors/text/TabFolderLayout.java;1;0;1;1;1;1;1;0;2;0;0;336;2;2;1;0;0;0;1;336;0;336;1;1;0
/org.eclipse.ui.workbench/Eclipse UI/org/eclipse/ui/internal/PluginActionContributionItem.java;5;0;13;2;1;1;1;12;147;6;4;126;366;366;6;8;0;12;13;126;8;336;5;5;1
/org.eclipse.jdt.core/compiler/org/eclipse/jdt/internal/compiler/util/ObjectVector.java;1;0;1;1;0;0;0;1;2;0;1;199;2;2;1;0;0;1;1;199;0;199;1;1;0
/org.eclipse.pde.core/src/org/eclipse/pde/internal/core/bundle/BundlePluginModel.java;1;1;2;1;2;2;2;0;10;0;0;292;10;10;1;0;0;0;2;292;0;336;2;1;0
/org.eclipse.update.core/src/org/eclipse/update/standalone/SearchCommand.java;1;1;5;1;3;3;3;2;54;1;2;54;85;85;1;0;0;2;5;54;0;336;5;1;1
/org.eclipse.pde.ui/src_Forms/org/eclipse/pde/internal/ui/model/plugin/PluginParentNode.java;2;1;5;1;4;4;4;1;16;0;1;244;32;32;1;0;0;1;5;244;0;336;5;2;0
/org.eclipse.jdt.core/compiler/org/eclipse/jdt/internal/compiler/ast/TrueLiteral.java;2;0;2;1;0;0;0;2;4;1;2;170;6;6;1;0;0;2;2;170;0;199;2;2;0
/org.eclipse.core.expressions/src/org/eclipse/core/expressions/IPropertyTester.java;1;2;4;1;3;2;3;1;10;0;1;228;18;18;2;0;1;1;4;334;1;334;3;1;0
/org.eclipse.ui.ide/src/org/eclipse/ui/views/framelist/TreeViewerFrameSource.java;1;0;1;1;0;0;0;1;0;0;1;129;0;0;1;0;0;1;1;129;0;129;1;1;0
/org.eclipse.pde.build/src_ant/org/eclipse/pde/internal/build/tasks/GenericVersionReplacer.java;2;2;7;2;6;4;6;1;72;0;1;232;109;109;2;0;2;1;7;272;2;336;5;2;0
/org.eclipse.jface.text/src/org/eclipse/jface/text/rules/IPredicateRule.java;1;0;1;1;1;1;1;0;2;0;0;336;2;2;1;0;0;0;1;336;0;336;1;1;0
/org.eclipse.debug.ui/ui/org/eclipse/debug/internal/ui/actions/EnableBreakpointsAction.java;2;0;4;1;0;0;0;4;12;1;4;22;24;24;1;0;0;4;4;22;0;157;4;2;1
/org.eclipse.ui.workbench/Eclipse UI/org/eclipse/ui/internal/commands/KeysPreferencePage.java;4;4;45;3;6;3;6;39;4762;12;8;102;13914;13914;12;31;3;39;45;140;34;336;11;4;4
/org.eclipse.ui.editors/src/org/eclipse/ui/internal/editors/text/PreviousPulldownActionDelegate.java;2;0;3;1;1;1;1;2;30;1;2;123;32;32;1;0;0;2;3;123;0;336;3;2;0
/org.eclipse.jdt.core/model/org/eclipse/jdt/internal/core/jdom/DOMType.java;3;1;11;2;2;2;2;9;81;2;8;7;163;163;2;1;0;9;11;112;1;314;10;3;0
/org.eclipse.osgi/osgi/src/org/osgi/framework/ServiceRegistration.java;2;0;2;1;1;1;1;1;3;0;1;171;3;3;1;0;0;1;2;171;0;296;2;2;0
/org.eclipse.pde.ui/src_Forms/org/eclipse/pde/internal/ui/model/plugin/FragmentModel.java;2;1;4;1;2;2;2;2;14;1;2;244;28;28;1;0;0;2;4;244;0;336;4;2;0
/org.eclipse.pde.ui/src/org/eclipse/pde/internal/ui/search/FindReferencesAction.java;3;3;7;2;5;2;5;2;19;0;1;128;38;38;3;1;3;2;7;335;4;335;3;3;0
/org.eclipse.debug.ui/ui/org/eclipse/debug/internal/ui/sourcelookup/browsers/DirectorySourceContainerBrowser.java;1;0;5;1;0;0;0;5;16;3;3;209;21;21;3;2;0;5;5;266;2;266;3;1;0
/org.eclipse.jdt.ui/ui/org/eclipse/jdt/internal/ui/search/FindOccurrencesEngine.java;6;2;13;3;4;3;4;9;229;3;5;20;480;480;3;4;1;9;13;20;5;336;8;6;1
/org.eclipse.jface.text/src/org/eclipse/jface/internal/text/link/contentassist/ContextInformationPopup2.java;2;0;2;1;1;1;1;1;2;0;1;232;2;2;1;0;0;1;2;232;0;336;2;2;0
/org.eclipse.jface/src/org/eclipse/jface/resource/FontRegistry.java;3;0;8;2;1;1;1;7;221;4;3;2;392;392;4;4;0;7;8;233;4;336;4;3;2
/org.eclipse.core.runtime.compatibility/src-model/org/eclipse/core/runtime/model/PluginRegistryModel.java;3;1;6;2;3;3;3;3;67;2;2;171;87;87;2;1;0;3;6;184;1;336;5;3;0
/org.eclipse.team.cvs.ui/src/org/eclipse/team/internal/ccvs/ui/wizards/CheckoutAsProjectSelectionPage.java;2;1;8;1;2;2;2;6;288;2;5;20;330;330;2;1;0;6;8;53;1;336;7;2;0
/org.eclipse.debug.core/core/org/eclipse/debug/core/model/LaunchConfigurationDelegate.java;3;3;14;2;6;4;9;5;304;5;2;251;443;443;5;3;5;8;14;267;8;336;6;3;0
/org.eclipse.update.ui/src/org/eclipse/update/internal/ui/views/ShowActivitiesAction.java;1;1;5;1;2;2;2;3;11;0;1;244;17;17;3;2;0;3;5;244;2;336;3;1;0
/org.eclipse.jdt.core/compiler/org/eclipse/jdt/internal/compiler/ast/JavadocSingleTypeReference.java;3;0;7;2;0;0;0;7;51;2;4;165;71;71;2;3;0;7;7;165;3;218;4;3;1
/org.eclipse.ui.ide/src/org/eclipse/ui/wizards/newresource/ResourceMessages.java;1;0;1;1;0;0;0;1;0;0;1;92;0;0;1;0;0;1;1;92;0;92;1;1;0
/org.eclipse.jdt.core/model/org/eclipse/jdt/internal/core/DeleteResourceElementsOperation.java;3;0;9;2;1;1;1;8;20;3;4;67;35;35;3;4;0;8;9;67;4;314;5;3;0
/org.eclipse.core.runtime/src/org/eclipse/core/internal/content/FileSpec.java;2;1;3;1;2;2;2;1;10;0;1;268;20;20;1;0;0;1;3;268;0;314;3;2;2
/org.eclipse.debug.ui/ui/org/eclipse/debug/internal/ui/views/AbstractViewerState.java;1;0;1;1;0;0;0;1;0;0;1;239;0;0;1;0;0;1;1;239;0;239;1;1;0
/org.eclipse.ui.workbench/Eclipse UI/org/eclipse/ui/internal/dialogs/WizardCollectionElement.java;3;0;2;2;0;0;0;2;342;1;2;157;345;345;1;0;0;2;2;157;0;174;2;3;2
/org.eclipse.ui.workbench/Eclipse UI/org/eclipse/ui/dialogs/SelectionStatusDialog.java;2;1;2;1;2;2;2;0;24;0;0;293;31;31;1;0;0;0;2;293;0;336;2;2;0
/org.eclipse.jdt.ui/core refactoring/org/eclipse/jdt/internal/corext/refactoring/participants/ResourceModifications.java;2;2;12;1;3;2;3;9;315;5;5;54;548;548;5;4;1;9;12;253;5;336;7;2;0
/org.eclipse.jdt.ui/ui/org/eclipse/jdt/internal/ui/preferences/TypeFilterInputDialog.java;2;1;4;1;2;2;2;2;4;1;2;179;8;8;1;0;0;2;4;179;0;336;4;2;0
/org.eclipse.jdt.core/codeassist/org/eclipse/jdt/internal/codeassist/select/SelectionOnPackageReference.java;2;0;3;1;0;0;0;3;14;1;3;7;18;18;1;0;0;3;3;7;0;199;3;2;0
/org.eclipse.text/src/org/eclipse/jface/text/ITypedRegion.java;1;0;1;1;1;1;1;0;14;0;0;334;14;14;1;0;0;0;1;334;0;334;1;1;0
/org.eclipse.jdt.core/compiler/org/eclipse/jdt/internal/compiler/ast/SingleNameReference.java;2;0;12;1;0;0;0;12;1150;3;7;3;1207;1207;3;5;0;12;12;148;5;199;7;2;4
/org.eclipse.pde.ui/src/org/eclipse/pde/internal/ui/wizards/site/NewSiteProjectCreationPage.java;2;2;3;2;3;2;3;0;67;0;0;320;71;71;2;0;1;0;3;320;1;336;2;2;0
/org.eclipse.jdt.core/codeassist/org/eclipse/jdt/internal/codeassist/complete/CompletionNodeDetector.java;1;0;2;1;0;0;0;2;14;1;2;170;16;16;1;0;0;2;2;170;0;199;2;1;0
/org.eclipse.jdt.debug/eval/org/eclipse/jdt/internal/debug/eval/ast/instructions/RemainderOperator.java;1;0;1;1;0;0;0;1;5;0;1;76;5;5;1;0;0;1;1;76;0;76;1;1;0
/org.eclipse.jdt.debug.ui/ui/org/eclipse/jdt/internal/debug/ui/actions/PopupInspectAction.java;4;2;11;3;3;2;4;7;100;4;4;212;223;223;4;3;2;8;11;258;5;325;6;4;1
/org.eclipse.jdt.core/model/org/eclipse/jdt/internal/core/jdom/DOMMember.java;3;1;6;1;2;2;2;4;11;1;4;7;33;33;1;0;0;4;6;7;0;314;6;3;0
/org.eclipse.debug.ui/ui/org/eclipse/debug/internal/ui/views/memory/IMemoryViewConstants.java;1;0;1;1;1;1;1;0;0;0;0;282;0;0;1;0;0;0;1;282;0;282;1;1;1
/org.eclipse.jdt.ui/ui/org/eclipse/jdt/ui/wizards/JavaCapabilityConfigurationPage.java;2;0;3;2;1;1;1;2;9;1;2;200;20;20;1;0;0;2;3;200;0;336;3;2;0
/org.eclipse.team.core/src/org/eclipse/team/core/variants/IResourceVariantTree.java;2;1;3;1;2;2;2;1;4;0;1;239;8;8;1;0;0;1;3;239;0;336;3;2;0
/org.eclipse.jdt.ui/core refactoring/org/eclipse/jdt/internal/corext/refactoring/base/JavaStatusContext.java;3;1;5;1;2;2;2;3;20;1;3;57;26;26;1;0;0;3;5;57;0;336;5;3;0
/org.eclipse.debug.ui/ui/org/eclipse/debug/internal/ui/actions/RetargetBreakpointAction.java;1;0;2;1;0;0;0;2;2;0;1;245;2;2;2;1;0;2;2;245;1;245;1;1;0
/org.eclipse.swt/Eclipse SWT/gtk/org/eclipse/swt/widgets/Table.java;7;4;55;5;11;5;11;44;541;11;11;3;1800;1800;11;33;6;44;55;228;39;326;16;7;4
/org.eclipse.ui.workbench/Eclipse UI/org/eclipse/ui/dialogs/AbstractElementListSelectionDialog.java;2;1;3;1;2;2;2;1;27;0;1;3;67;67;1;0;0;1;3;3;0;336;3;2;0
/org.eclipse.jface/src/org/eclipse/jface/wizard/ProgressMonitorPart.java;2;1;3;1;2;2;2;1;48;0;1;205;72;72;1;0;0;1;3;205;0;336;3;2;0
/org.eclipse.ui.presentations.r21/src/org/eclipse/ui/internal/presentations/r21/widgets/CTabItem.java;1;1;2;1;2;2;2;0;2;0;0;323;2;2;1;0;0;0;2;323;0;336;2;1;0
/org.eclipse.jdt.ui/core refactoring/org/eclipse/jdt/internal/corext/refactoring/reorg/ReorgUtils.java;4;1;9;1;2;2;2;7;543;3;4;31;681;681;3;3;0;7;9;95;3;336;6;4;0
/org.eclipse.ui.console/src/org/eclipse/ui/console/IConsoleView.java;3;1;3;1;2;2;2;1;7;0;1;118;11;11;1;0;0;1;3;118;0;336;3;3;0
/org.eclipse.ui.workbench/Eclipse UI/org/eclipse/ui/part/DrillDownAdapter.java;3;0;3;2;1;1;1;2;10;1;2;245;23;23;1;0;0;2;3;245;0;336;3;3;0
/org.eclipse.team.cvs.ui/src/org/eclipse/team/internal/ccvs/ui/repo/RemoteTagsView.java;1;0;1;1;0;0;0;1;4;0;1;52;4;4;1;0;0;1;1;52;0;52;1;1;0
/org.eclipse.debug.core/core/org/eclipse/debug/core/sourcelookup/ISourceLookupParticipant.java;1;1;5;1;2;2;4;1;9;0;1;268;16;16;3;0;2;3;5;268;2;336;3;1;0
/org.eclipse.compare/compare/org/eclipse/compare/structuremergeviewer/DiffTreeViewer.java;1;0;3;1;0;0;0;3;8;1;3;19;12;12;1;0;0;3;3;19;0;219;3;1;0
/org.eclipse.jface.text/src/org/eclipse/jface/text/formatter/ContentFormatter.java;4;3;17;3;6;2;6;11;811;3;6;33;1817;1817;3;5;4;11;17;119;9;332;8;4;0
/org.eclipse.jdt.core/model/org/eclipse/jdt/internal/core/CreateTypeHierarchyOperation.java;2;0;5;1;0;0;0;5;38;3;3;62;46;46;3;2;0;5;5;62;2;199;3;2;0
/org.eclipse.pde.ui/src/org/eclipse/pde/internal/ui/editor/plugin/ExtensionPointsSection.java;3;3;6;2;6;3;6;0;19;0;0;292;37;37;3;0;3;0;6;326;3;326;3;3;0
/org.eclipse.jdt.core/compiler/org/eclipse/jdt/internal/compiler/ast/SynchronizedStatement.java;3;0;5;2;1;1;1;4;28;1;4;11;51;51;1;0;0;4;5;11;0;288;5;3;2
/org.eclipse.jdt.debug/eval/org/eclipse/jdt/internal/debug/eval/ast/engine/BinaryBasedSourceGenerator.java;1;0;1;1;0;0;0;1;3;0;1;144;3;3;1;0;0;1;1;144;0;144;1;1;2
/org.eclipse.debug.ui/ui/org/eclipse/debug/internal/ui/launchConfigurations/AbstractLaunchConfigurationAction.java;1;0;1;1;0;0;0;1;16;0;1;33;16;16;1;0;0;1;1;33;0;33;1;1;0
/org.eclipse.update.core/src/org/eclipse/update/operations/IUninstallFeatureOperation.java;1;1;8;1;3;3;3;5;11;1;5;54;23;23;1;0;0;5;8;54;0;336;8;1;0
/org.eclipse.ui.ide/src/org/eclipse/ui/views/tasklist/RemoveTaskAction.java;1;0;1;1;0;0;0;1;0;0;1;129;0;0;1;0;0;1;1;129;0;129;1;1;0
/org.eclipse.swt/Eclipse SWT/photon/org/eclipse/swt/widgets/ToolItem.java;2;0;5;1;0;0;0;5;31;1;5;3;57;57;1;0;0;5;5;3;0;161;5;2;0
/org.eclipse.jdt.core/model/org/eclipse/jdt/internal/compiler/SourceElementParser.java;2;0;2;2;1;1;1;1;38;0;1;245;38;38;1;0;0;1;2;245;0;326;2;2;7
/org.eclipse.ui.workbench/Eclipse UI/org/eclipse/ui/internal/dialogs/NewWizardSelectionPage.java;5;0;5;2;1;1;1;4;45;1;4;157;94;94;1;0;0;4;5;157;0;336;5;5;1
/org.eclipse.pde.ui/src_samples/org/eclipse/pde/ui/internal/samples/SelectionPage.java;3;2;5;2;4;3;4;1;38;0;1;249;46;46;2;0;1;1;5;303;1;336;4;3;0
/org.eclipse.pde.build/src/org/eclipse/pde/internal/build/BuildActivator.java;2;0;3;2;2;1;2;1;26;0;1;226;26;26;2;0;1;1;3;272;1;272;2;2;0
/org.eclipse.core.runtime/src/org/eclipse/core/runtime/Preferences.java;4;4;19;3;5;2;8;11;5362;4;5;171;6090;6090;4;6;6;14;19;268;12;336;7;4;1
/org.eclipse.core.runtime/src/org/eclipse/core/internal/registry/RegistryModelObject.java;5;3;9;3;5;3;5;4;292;3;2;173;415;415;3;2;2;4;9;173;4;336;5;5;0
/org.eclipse.jdt.ui/ui/org/eclipse/jdt/ui/actions/PushDownAction.java;4;0;11;2;1;1;2;9;154;3;6;3;253;253;3;3;1;10;11;3;4;336;7;4;0
/org.eclipse.ui.workbench/Eclipse UI/org/eclipse/ui/internal/PerspectiveBarContributionItem.java;8;2;16;5;7;5;7;9;201;4;4;208;433;433;4;5;2;9;16;223;7;336;9;8;1
/org.eclipse.jface.text/src/org/eclipse/jface/text/source/LineNumberChangeRulerColumn.java;3;2;11;2;3;2;3;8;79;3;6;70;269;269;3;2;1;8;11;70;3;336;8;3;0
/org.eclipse.ui.workbench/Eclipse UI/org/eclipse/ui/internal/PlaceholderContributionItem.java;2;0;3;1;1;1;1;2;196;1;2;211;213;213;1;0;0;2;3;211;0;336;3;2;0
/org.eclipse.ui.ide/src/org/eclipse/ui/views/navigator/GotoResourceAction.java;1;0;1;1;0;0;0;1;0;0;1;129;0;0;1;0;0;1;1;129;0;129;1;1;0
/org.eclipse.jdt.ui/ui refactoring/org/eclipse/jdt/internal/ui/refactoring/nls/OrderedMap.java;1;0;1;1;1;1;1;0;2;0;0;336;2;2;1;0;0;0;1;336;0;336;1;1;0
/org.eclipse.ui.workbench.texteditor/src/org/eclipse/ui/texteditor/RegExContentAssistProcessor.java;1;2;6;1;3;2;3;3;235;0;1;133;272;272;3;2;1;3;6;133;3;336;3;1;0
/org.eclipse.ant.ui/Ant Tools Support/org/eclipse/ant/internal/ui/views/AntTargetContentProvider.java;1;0;1;1;0;0;0;1;0;0;1;108;0;0;1;0;0;1;1;108;0;108;1;1;0
/org.eclipse.ui.cheatsheets/src/org/eclipse/ui/internal/cheatsheets/views/Page.java;2;2;8;2;5;3;5;3;85;0;1;257;115;115;3;2;2;3;8;257;4;315;4;2;0
/org.eclipse.ui.ide/src/org/eclipse/ui/wizards/datatransfer/IImportStructureProvider.java;1;0;1;1;0;0;0;1;0;0;1;92;0;0;1;0;0;1;1;92;0;92;1;1;0
/org.eclipse.help.webapp/src_servlets/org/eclipse/help/internal/webapp/servlet/XMLGenerator.java;1;1;4;1;3;3;3;1;28;0;1;156;57;57;1;0;0;1;4;156;0;336;4;1;0
/org.eclipse.swt/Eclipse SWT PI/photon/org/eclipse/swt/internal/photon/PtWebDataReqCallback_t.java;1;0;1;1;0;0;0;1;0;0;1;170;0;0;1;0;0;1;1;170;0;170;1;1;0
/org.eclipse.jdt.ui/ui/org/eclipse/jdt/internal/ui/typehierarchy/FocusOnSelectionAction.java;3;0;3;1;1;1;1;2;10;1;2;51;14;14;1;0;0;2;3;51;0;336;3;3;0
/org.eclipse.pde.ui/src/org/eclipse/pde/ui/IPluginContentWizard.java;2;2;5;1;4;3;4;1;161;0;1;222;313;313;2;0;1;1;5;276;1;336;4;2;0
/org.eclipse.pde.ui/src/org/eclipse/pde/internal/ui/wizards/feature/PatchSpecPage.java;2;5;10;2;10;2;10;0;158;0;0;298;183;183;5;0;8;0;10;298;8;325;2;2;0
/org.eclipse.jdt.core/codeassist/org/eclipse/jdt/internal/codeassist/complete/CompletionOnMemberAccess.java;2;0;3;1;0;0;0;3;14;1;3;1;22;22;1;0;0;3;3;1;0;199;3;2;0
/org.eclipse.swt/Eclipse SWT Drag and Drop/gtk/org/eclipse/swt/dnd/TableDragUnderEffect.java;3;0;4;1;1;1;1;3;76;2;2;49;82;82;2;1;0;3;4;49;1;337;3;3;0
/org.eclipse.swt/Eclipse SWT PI/gtk/org/eclipse/swt/internal/Platform.java;1;0;1;1;0;0;0;1;0;0;1;117;0;0;1;0;0;1;1;117;0;117;1;1;0
/org.eclipse.jdt.core/compiler/org/eclipse/jdt/internal/compiler/ast/JavadocQualifiedTypeReference.java;3;0;7;2;0;0;0;7;51;2;4;165;73;73;2;3;0;7;7;165;3;218;4;3;0
/org.eclipse.jdt.ui/ui/org/eclipse/jdt/internal/ui/actions/GenerateJavadocAction.java;2;1;4;1;2;2;2;2;158;0;1;52;172;172;2;1;0;2;4;52;1;336;3;2;0
/org.eclipse.text/src/org/eclipse/text/edits/TextEditCopier.java;2;0;2;1;1;1;1;1;2;0;1;118;2;2;1;0;0;1;2;118;0;336;2;2;0
/org.eclipse.ui.workbench/Eclipse UI/org/eclipse/ui/internal/testing/WorkbenchTestable.java;2;2;5;1;3;2;3;2;90;1;2;131;105;105;2;0;1;2;5;286;1;336;4;2;0
/org.eclipse.ui.workbench/Eclipse UI/org/eclipse/ui/part/MultiPageEditorPart.java;4;1;6;2;2;2;2;4;161;1;4;0;270;270;1;0;0;4;6;0;0;336;6;4;0
/org.eclipse.jdt.ui/ui/org/eclipse/jdt/internal/ui/compare/JavaNode.java;2;0;2;1;1;1;1;1;16;0;1;79;18;18;1;0;0;1;2;79;0;336;2;2;1
/org.eclipse.ltk.core.refactoring/src/org/eclipse/ltk/core/refactoring/participants/RefactoringArguments.java;1;0;3;1;2;1;2;1;5;0;1;267;5;5;2;0;1;1;3;275;1;275;2;1;0
/org.eclipse.core.runtime/src/org/eclipse/core/internal/runtime/SafeFileInputStream.java;2;1;5;2;2;2;2;3;177;0;1;171;186;186;3;2;0;3;5;171;2;336;3;2;0
/org.eclipse.jface.text/src/org/eclipse/jface/text/ITextOperationTargetExtension.java;2;0;2;2;2;1;2;0;8;0;0;336;8;8;2;0;1;0;2;336;1;336;1;2;0
/org.eclipse.jdt.ui/ui/org/eclipse/jdt/internal/ui/typehierarchy/HierarchyLabelProvider.java;4;0;10;2;1;1;1;9;81;3;5;31;182;182;3;4;0;9;10;31;4;336;6;4;0
/org.eclipse.osgi/defaultAdaptor/src/org/eclipse/osgi/framework/internal/defaultadaptor/DefaultLog.java;3;2;10;2;4;3;4;6;343;2;4;215;681;681;2;2;1;6;10;215;3;294;7;3;0
/org.eclipse.jface/src/org/eclipse/jface/viewers/AbstractListViewer.java;2;1;2;1;2;2;2;0;2;0;0;271;2;2;1;0;0;0;2;271;0;336;2;2;1
/org.eclipse.pde.core/src/org/eclipse/pde/internal/core/plugin/IdentifiablePluginObject.java;1;0;2;1;1;1;1;1;4;0;1;232;8;8;1;0;0;1;2;232;0;336;2;1;0
/org.eclipse.jdt.core/model/org/eclipse/jdt/core/jdom/IDOMPackage.java;2;0;3;1;1;1;1;2;5;1;2;199;10;10;1;0;0;2;3;199;0;299;3;2;0
/org.eclipse.search/search/org/eclipse/search/internal/ui/SearchResultView.java;2;0;5;1;1;1;1;4;9;1;4;70;25;25;1;0;0;4;5;70;0;313;5;2;1
/org.eclipse.jface.text/src/org/eclipse/jface/text/CursorLinePainter.java;2;2;6;2;5;4;5;1;18;0;1;257;54;54;2;0;1;1;6;336;1;336;5;2;0
/org.eclipse.ui.workbench/Eclipse UI/org/eclipse/ui/internal/CompatibleWorkbenchPage.java;1;0;2;1;0;0;0;2;2;0;1;188;2;2;2;1;0;2;2;188;1;188;1;1;0
/org.eclipse.ltk.core.refactoring/src/org/eclipse/ltk/core/refactoring/UndoManagerAdapter.java;1;1;4;1;2;2;2;2;20;0;1;264;28;28;2;1;0;2;4;264;1;336;3;1;0
/org.eclipse.debug.ui/ui/org/eclipse/debug/internal/ui/sourcelookup/browsers/ArchiveSourceContainerBrowser.java;2;0;4;1;1;1;1;3;16;0;1;267;20;20;3;2;0;3;4;267;2;336;2;2;0
/org.eclipse.pde.core/src/org/eclipse/pde/internal/core/schema/SchemaRegistry.java;3;3;9;2;4;2;4;5;17;2;4;128;48;48;3;1;2;5;9;302;3;336;6;3;0
/org.eclipse.swt/Eclipse SWT/gtk/org/eclipse/swt/widgets/TabItem.java;7;1;8;1;2;2;2;6;28;1;6;19;55;55;1;0;0;6;8;19;0;337;8;7;0
/org.eclipse.jdt.core/search/org/eclipse/jdt/core/search/ITypeNameRequestor.java;1;0;1;1;0;0;0;1;2;0;1;199;2;2;1;0;0;1;1;199;0;199;1;1;0
/org.eclipse.ui.ide/src/org/eclipse/ui/views/navigator/CopyAction.java;1;0;3;1;0;0;0;3;4;2;2;129;7;7;2;1;0;3;3;129;1;150;2;1;0
/org.eclipse.pde.ui/src/org/eclipse/pde/internal/ui/parts/TablePart.java;1;1;2;1;2;2;2;0;10;0;0;292;14;14;1;0;0;0;2;292;0;336;2;1;0
/org.eclipse.swt/Eclipse SWT Browser/common/org/eclipse/swt/browser/OpenWindowListener.java;2;0;5;1;1;1;1;4;24;1;4;171;43;43;1;0;0;4;5;171;0;337;5;2;0
/org.eclipse.core.variables/src/org/eclipse/core/variables/IValueVariable.java;3;1;4;1;2;2;2;2;29;0;1;145;60;60;2;1;0;2;4;145;1;336;3;3;0
/org.eclipse.jdt.core/model/org/eclipse/jdt/core/util/IExceptionTableEntry.java;1;0;1;1;0;0;0;1;2;0;1;199;2;2;1;0;0;1;1;199;0;199;1;1;0
/org.eclipse.jdt.ui/ui/org/eclipse/jdt/internal/ui/preferences/formatter/CommentsTabPage.java;2;0;9;1;0;0;0;9;174;3;5;176;408;408;3;4;0;9;9;176;4;257;5;2;0
/org.eclipse.ui.forms/src/org/eclipse/ui/internal/forms/widgets/BreakSegment.java;1;1;2;1;2;2;2;0;6;0;0;272;6;6;1;0;0;0;2;272;0;336;2;1;0
/org.eclipse.ui.workbench/Eclipse UI/org/eclipse/ui/internal/ICompatibleWorkbenchPage.java;1;0;1;1;0;0;0;1;0;0;1;188;0;0;1;0;0;1;1;188;0;188;1;1;0
/org.eclipse.jdt.ui/ui/org/eclipse/jdt/internal/ui/util/RowLayouter.java;1;0;1;1;1;1;1;0;2;0;0;336;2;2;1;0;0;0;1;336;0;336;1;1;0
/org.eclipse.swt/Eclipse SWT PI/photon/org/eclipse/swt/internal/photon/PtWebClientData_t.java;1;0;1;1;0;0;0;1;0;0;1;170;0;0;1;0;0;1;1;170;0;170;1;1;0
/org.eclipse.ui.workbench/Eclipse UI/org/eclipse/ui/internal/layout/TrimLayout.java;1;0;3;1;2;1;2;1;210;0;1;270;210;210;2;0;1;1;3;291;1;291;2;1;0
/org.eclipse.pde.build/src/org/eclipse/pde/internal/build/FetchScriptGenerator.java;2;3;12;2;5;3;5;7;1484;2;4;31;3914;3914;3;3;2;7;12;272;5;313;7;2;0
/org.eclipse.swt/Eclipse SWT/photon/org/eclipse/swt/widgets/TabFolder.java;4;1;8;2;2;2;2;6;15;2;4;19;38;38;2;2;0;6;8;135;2;337;6;4;0
/org.eclipse.pde.core/src/org/eclipse/pde/internal/core/build/ExternalBuildModel.java;2;1;4;1;2;2;2;2;6;1;2;26;13;13;1;0;0;2;4;26;0;336;4;2;0
/org.eclipse.ui.cheatsheets/src/org/eclipse/ui/internal/cheatsheets/data/Item.java;1;3;5;1;4;2;4;1;165;0;1;255;243;243;3;0;2;1;5;295;2;295;3;1;0
/org.eclipse.team.core/src/org/eclipse/team/internal/core/TeamHookDispatcher.java;2;1;3;1;3;3;3;0;33;0;0;275;47;47;1;0;0;0;3;275;0;336;3;2;0
/org.eclipse.update.core/src/org/eclipse/update/configuration/IVolume.java;1;0;1;1;0;0;0;1;4;0;1;58;4;4;1;0;0;1;1;58;0;58;1;1;0
/org.eclipse.jdt.ui/ui/org/eclipse/jdt/ui/actions/CCPActionGroup.java;4;1;6;1;2;2;2;4;33;2;3;70;55;55;2;1;0;4;6;232;1;336;5;4;0
/org.eclipse.swt/Eclipse SWT Browser/mozilla/org/eclipse/swt/internal/mozilla/XPCOMObject.java;2;0;3;1;1;1;1;2;6;1;2;100;10;10;1;0;0;2;3;100;0;337;3;2;0
/org.eclipse.update.configurator/src/org/eclipse/update/internal/configurator/branding/AboutInfo.java;1;0;4;1;1;1;1;3;6;0;1;247;8;8;3;2;0;3;4;247;2;289;2;1;0
/org.eclipse.core.resources/src/org/eclipse/core/resources/IFileModificationValidator.java;2;0;4;1;0;0;2;2;87;3;2;140;89;89;3;0;2;4;4;270;2;270;2;2;0
/org.eclipse.swt/Eclipse SWT PI/carbon/org/eclipse/swt/internal/carbon/AEDesc.java;1;0;2;1;2;1;2;0;20;0;0;296;20;20;2;0;1;0;2;296;1;296;1;1;0
/org.eclipse.update.ui/src/org/eclipse/update/internal/ui/wizards/BannerPage.java;2;1;5;2;2;2;2;3;24;0;1;43;32;32;3;2;0;3;5;43;2;336;3;2;0
/org.eclipse.jface/src/org/eclipse/jface/viewers/AbstractTreeViewer.java;3;3;18;2;7;3;7;11;2720;4;5;52;4113;4113;4;6;4;11;18;124;10;321;8;3;4
/org.eclipse.swt/Eclipse SWT PI/win32/org/eclipse/swt/internal/win32/SHELLEXECUTEINFO.java;1;0;1;1;0;0;0;1;3;0;1;166;3;3;1;0;0;1;1;166;0;166;1;1;0
/org.eclipse.jface.text/src/org/eclipse/jface/text/IDocumentAdapter.java;2;0;2;2;2;1;2;0;30;0;0;336;30;30;2;0;1;0;2;336;1;336;1;2;0
/org.eclipse.help.base/src/org/eclipse/help/internal/base/DisplayUtils.java;1;2;3;1;3;2;3;0;6;0;0;309;8;8;2;0;1;0;3;309;1;336;2;1;0
/org.eclipse.pde.core/src/org/eclipse/pde/core/IEditableModel.java;2;2;5;1;4;3;4;1;33;0;1;145;39;39;2;0;1;1;5;276;1;336;4;2;0
/org.eclipse.jdt.debug.ui/ui/org/eclipse/jdt/internal/debug/ui/actions/AbstractBreakpointRulerAction.java;2;0;2;1;1;1;1;1;4;0;1;250;5;5;1;0;0;1;2;250;0;336;2;2;0
/org.eclipse.jface.text/src/org/eclipse/jface/text/source/IAnnotationHoverExtension.java;2;3;8;2;5;2;5;3;48;2;2;49;95;95;3;1;3;3;8;275;4;336;4;2;0
/org.eclipse.debug.ui/ui/org/eclipse/debug/internal/ui/actions/ViewManagementAction.java;2;0;2;2;2;1;2;0;30;0;0;295;30;30;2;0;1;0;2;295;1;295;1;2;0
/org.eclipse.debug.ui/ui/org/eclipse/debug/internal/ui/IDebugHelpContextIds.java;4;0;16;3;1;1;1;15;17;4;11;15;46;46;4;4;0;15;16;42;4;288;12;4;0
/org.eclipse.ant.ui/Ant Editor/org/eclipse/ant/internal/ui/dtd/schema/AntDTDSchemaMessages.java;1;0;1;1;0;0;0;1;0;0;1;108;0;0;1;0;0;1;1;108;0;108;1;1;0
/org.eclipse.ant.ui/Ant Editor/org/eclipse/ant/internal/ui/editor/outline/XMLCore.java;1;0;3;1;1;1;1;2;4;1;2;108;7;7;1;0;0;2;3;108;0;336;3;1;1
/org.eclipse.team.ui/src/org/eclipse/team/internal/ui/TeamUIPlugin.java;2;7;44;2;10;3;10;34;530;16;9;52;1118;1118;16;25;7;34;44;52;32;332;12;2;3
/org.eclipse.team.cvs.ui/src/org/eclipse/team/internal/ccvs/ui/operations/FetchMembersOperation.java;2;1;10;1;3;3;3;7;51;5;3;113;73;73;5;4;0;7;10;113;4;336;6;2;0
/org.eclipse.update.core/src/org/eclipse/update/search/UpdateSearchRequest.java;3;3;14;3;5;3;5;9;58;5;5;54;102;102;5;4;2;9;14;54;6;336;8;3;1
/org.eclipse.jdt.launching.macosx/macosx/org/eclipse/jdt/internal/ui/macbundler/MacBundleWizard.java;1;0;1;1;0;0;0;1;0;0;1;203;0;0;1;0;0;1;1;203;0;203;1;1;0
/org.eclipse.jdt.core/model/org/eclipse/jdt/internal/core/util/PublicScanner.java;5;3;36;3;6;3;6;30;1589;8;9;1;2587;2587;8;21;3;30;36;51;24;327;12;5;5
/org.eclipse.pde.build/src/org/eclipse/pde/internal/build/Utils.java;2;2;15;2;5;4;5;10;1370;2;7;31;4006;4006;2;3;1;10;15;31;4;331;11;2;0
/org.eclipse.swt/Eclipse SWT/motif/org/eclipse/swt/widgets/ToolItem.java;5;1;13;2;2;2;2;11;24;2;9;6;103;103;2;2;0;11;13;6;2;337;11;5;0
/org.eclipse.help.webapp/src_servlets/org/eclipse/help/internal/webapp/servlet/CookieUtil.java;1;1;6;1;3;3;3;3;209;2;2;28;372;372;2;1;0;3;6;28;1;336;5;1;0
/org.eclipse.swt.tools/JNI Generation/org/eclipse/swt/tools/internal/CleanupConstants.java;3;0;3;2;0;0;0;3;7;2;2;230;8;8;2;1;0;3;3;230;1;250;2;3;0
/org.eclipse.ui.workbench/Eclipse UI/org/eclipse/ui/dialogs/FileEditorMappingLabelProvider.java;1;0;1;1;0;0;0;1;1;0;1;0;1;1;1;0;0;1;1;0;0;0;1;1;1
/org.eclipse.ant.ui/Ant Tools Support/org/eclipse/ant/internal/ui/launchConfigurations/AntWorkingDirectoryBlock.java;2;1;5;1;2;2;2;3;84;0;1;118;150;150;3;2;0;3;5;118;2;331;3;2;0
/org.eclipse.team.ui/src/org/eclipse/team/internal/ui/registry/SynchronizeWizardRegistry.java;2;0;3;2;3;1;3;0;52;0;0;296;52;52;3;0;2;0;3;296;2;296;1;2;0
/org.eclipse.ui.ide/src/org/eclipse/ui/internal/ide/registry/ProjectImageRegistry.java;1;0;1;1;0;0;0;1;0;0;1;132;0;0;1;0;0;1;1;132;0;132;1;1;0
/org.eclipse.jdt.launching/launching/org/eclipse/jdt/internal/launching/JavaLocalApplicationLaunchConfigurationDelegate.java;5;1;9;2;2;2;2;7;15;3;5;89;38;38;3;2;0;7;9;148;2;336;7;5;0
/org.eclipse.update.core/src/org/eclipse/update/core/model/FeatureModel.java;2;3;6;1;5;3;5;1;19;0;1;58;41;41;3;0;2;1;6;289;2;315;4;2;0
/org.eclipse.team.core/src/org/eclipse/team/internal/core/ResourceVariantCacheEntry.java;2;0;5;2;1;1;1;4;219;3;2;226;225;225;3;2;0;4;5;226;2;336;3;2;0
/org.eclipse.jdt.core/codeassist/org/eclipse/jdt/internal/codeassist/select/SelectionOnFieldReference.java;2;0;2;1;0;0;0;2;32;1;2;63;34;34;1;0;0;2;2;63;0;199;2;2;1
/org.eclipse.core.resources/src/org/eclipse/core/internal/dtree/DeltaDataTree.java;2;0;2;1;1;1;1;1;1800;0;1;13;1837;1837;1;0;0;1;2;13;0;277;2;2;0
/org.eclipse.jdt.core/dom/org/eclipse/jdt/core/dom/DefaultBindingResolver.java;5;2;21;4;5;3;5;16;167;5;8;5;569;569;5;8;2;16;21;199;10;311;11;5;5
/org.eclipse.core.runtime/src/org/eclipse/core/runtime/preferences/InstanceScope.java;2;0;6;2;1;1;3;3;9;4;2;239;15;15;4;1;2;5;6;267;3;297;3;2;0
/org.eclipse.pde.ui/src/org/eclipse/pde/internal/ui/editor/build/BinSection.java;2;3;12;2;8;5;8;4;475;3;2;104;695;695;3;2;3;4;12;104;5;336;7;2;0
/org.eclipse.jdt.ui/ui/org/eclipse/jdt/internal/ui/wizards/TypedElementSelectionValidator.java;1;0;1;1;1;1;1;0;2;0;0;336;2;2;1;0;0;0;1;336;0;336;1;1;0
/org.eclipse.pde.core/src/org/eclipse/pde/internal/core/feature/WorkspaceFeatureModel.java;3;4;6;2;5;2;5;1;270;0;1;145;278;278;4;0;3;1;6;299;3;336;3;3;0
/org.eclipse.pde.core/src/org/eclipse/pde/internal/core/ischema/ISchemaAttribute.java;2;1;2;1;2;2;2;0;4;0;0;309;6;6;1;0;0;0;2;309;0;336;2;2;0
/org.eclipse.core.runtime/src/org/eclipse/core/internal/runtime/CipherOutputStream.java;2;1;5;2;2;2;2;3;193;0;1;171;199;199;3;2;0;3;5;171;2;336;3;2;0
/org.eclipse.debug.ui/ui/org/eclipse/debug/internal/ui/views/variables/VariablesViewMessages.java;1;0;1;1;0;0;0;1;0;0;1;44;0;0;1;0;0;1;1;44;0;44;1;1;0
/org.eclipse.team.ui/src/org/eclipse/team/ui/TeamImages.java;1;1;6;1;2;2;2;4;104;3;2;52;131;131;3;2;0;4;6;52;2;336;4;1;0
/org.eclipse.ant.ui/Ant Tools Support/org/eclipse/ant/internal/ui/datatransfer/AntBuildfileImportWizard.java;1;0;2;1;1;1;1;1;2;0;1;263;2;2;1;0;0;1;2;263;0;294;2;1;1
/org.eclipse.osgi/osgi/src/org/osgi/framework/SynchronousBundleListener.java;2;0;2;1;1;1;1;1;3;0;1;171;3;3;1;0;0;1;2;171;0;296;2;2;0
/org.eclipse.jdt.ui/core refactoring/org/eclipse/jdt/internal/corext/refactoring/code/flow/WhileFlowInfo.java;1;0;1;1;1;1;1;0;2;0;0;336;2;2;1;0;0;0;1;336;0;336;1;1;0
/org.eclipse.jdt.ui/ui/org/eclipse/jdt/internal/ui/callhierarchy/CallHierarchyViewer.java;3;0;11;1;1;1;1;10;17;4;5;12;48;48;4;5;0;10;11;12;5;336;6;3;0
/org.eclipse.text/src/org/eclipse/jface/text/IDocumentExtension2.java;1;0;1;1;1;1;1;0;11;0;0;334;11;11;1;0;0;0;1;334;0;334;1;1;0
/org.eclipse.ui.workbench/Eclipse UI/org/eclipse/ui/IMemento.java;1;0;1;1;0;0;0;1;2;0;1;0;2;2;1;0;0;1;1;0;0;0;1;1;0
/org.eclipse.swt/Eclipse SWT Mozilla/common/org/eclipse/swt/internal/mozilla/nsITooltipListener.java;2;1;2;1;2;2;2;0;2;0;0;274;2;2;1;0;0;0;2;274;0;336;2;2;0
/org.eclipse.team.cvs.ui/src/org/eclipse/team/internal/ccvs/ui/model/ModulesCategory.java;2;0;2;1;0;0;0;2;4;1;2;5;6;6;1;0;0;2;2;5;0;63;2;2;0
/org.eclipse.core.resources/src/org/eclipse/core/internal/resources/Marker.java;2;0;10;2;0;0;2;8;553;3;8;13;614;614;3;0;2;10;10;270;2;270;8;2;0
/org.eclipse.team.cvs.core/src/org/eclipse/team/internal/ccvs/core/CVSTag.java;2;1;6;1;2;2;3;3;61;3;2;20;66;66;3;1;1;4;6;269;2;336;4;2;0
/org.eclipse.ui.editors/src/org/eclipse/ui/internal/editors/text/QuickDiffPreferencePage.java;1;0;1;1;1;1;1;0;0;0;0;295;0;0;1;0;0;0;1;295;0;295;1;1;0
/org.eclipse.jdt.ui/core refactoring/org/eclipse/jdt/internal/corext/refactoring/reorg/IReorgDestinationValidator.java;1;0;1;1;1;1;1;0;0;0;0;300;0;0;1;0;0;0;1;300;0;300;1;1;0
/org.eclipse.swt/Eclipse SWT Drag and Drop/motif/org/eclipse/swt/dnd/TransferData.java;1;1;2;1;2;2;2;0;10;0;0;300;14;14;1;0;0;0;2;300;0;337;2;1;1
/org.eclipse.pde.ui/src/org/eclipse/pde/internal/ui/editor/plugin/OverviewPage.java;3;3;7;2;7;4;7;0;90;0;0;292;104;104;3;0;3;0;7;307;3;336;4;3;0
/org.eclipse.jface.text/src/org/eclipse/jface/text/contentassist/ContextInformation.java;1;0;2;1;2;1;2;0;11;0;0;336;11;11;2;0;1;0;2;336;1;336;1;1;0
/org.eclipse.ltk.ui.refactoring/src/org/eclipse/ltk/internal/ui/refactoring/RefactoringStatusDialog.java;1;1;3;1;2;2;2;1;2;0;1;270;4;4;1;0;0;1;3;270;0;336;3;1;0
/org.eclipse.jdt.ui/ui/org/eclipse/jdt/internal/ui/JavaPerspectiveFactory.java;6;4;12;2;9;4;9;3;23;1;3;84;58;58;4;0;5;3;12;325;5;336;7;6;0
/org.eclipse.help.base/src/org/eclipse/help/internal/standalone/StandaloneHelp.java;1;1;6;1;3;3;3;3;80;0;1;104;131;131;3;2;0;3;6;104;2;336;4;1;1
/org.eclipse.jdt.ui/ui/org/eclipse/jdt/internal/ui/preferences/formatter/FormatterMessages.java;1;0;2;1;0;0;0;2;2;1;2;176;2;2;1;0;0;2;2;176;0;219;2;1;0
/org.eclipse.swt/Eclipse SWT PI/gtk/org/eclipse/swt/internal/gtk/GtkTargetPair.java;3;0;4;1;1;1;1;3;17;2;2;100;23;23;2;1;0;3;4;226;1;337;3;3;0
/org.eclipse.ui.workbench/Eclipse UI/org/eclipse/ui/internal/commands/ws/CommandCallback.java;1;0;3;1;3;1;3;0;48;0;0;282;48;48;3;0;2;0;3;282;2;282;1;1;2
/org.eclipse.jdt.debug/jdi interfaces/com/sun/jdi/ReferenceType.java;1;0;1;1;0;0;0;1;3;0;1;235;3;3;1;0;0;1;1;235;0;235;1;1;0
/org.eclipse.swt/Eclipse SWT Drag and Drop/common/org/eclipse/swt/dnd/DropTargetAdapter.java;2;0;2;1;1;1;1;1;12;0;1;217;16;16;1;0;0;1;2;217;0;337;2;2;0
/org.eclipse.team.cvs.ui/src/org/eclipse/team/internal/ccvs/ui/operations/AddOperation.java;1;0;2;1;1;1;1;1;7;0;1;261;7;7;1;0;0;1;2;261;0;323;2;1;0
/org.eclipse.compare/compare/org/eclipse/compare/IModificationDate.java;1;0;1;1;0;0;0;1;2;0;1;219;2;2;1;0;0;1;1;219;0;219;1;1;0
/org.eclipse.jdt.ui/ui/org/eclipse/jdt/internal/ui/text/folding/DefaultJavaFoldingStructureProvider.java;3;2;5;2;5;3;5;0;14;0;0;292;23;23;2;0;2;0;5;292;2;332;3;3;0
/org.eclipse.pde.core/src/org/eclipse/pde/internal/core/CoreUtility.java;1;2;5;1;3;2;3;2;65;1;2;211;81;81;2;0;1;2;5;330;1;330;4;1;0
/org.eclipse.jdt.ui/ui/org/eclipse/jdt/internal/ui/actions/JDTQuickMenuAction.java;1;1;4;1;4;4;4;0;5;0;0;273;11;11;1;0;0;0;4;273;0;326;4;1;0
/org.eclipse.ant.ui/Ant Tools Support/org/eclipse/ant/internal/ui/model/IAntUIHelpContextIds.java;2;1;4;1;2;2;2;2;9;0;1;108;14;14;2;1;0;2;4;108;1;336;3;2;1
/org.eclipse.search/new search/org/eclipse/search2/internal/ui/text/EditorAccessHighlighter.java;1;2;3;1;3;2;3;0;26;0;0;310;29;29;2;0;1;0;3;323;1;323;2;1;0
/org.eclipse.jdt.ui/ui/org/eclipse/jdt/internal/ui/preferences/SpellingPreferencePage.java;2;0;2;1;1;1;1;1;5;0;1;212;5;5;1;0;0;1;2;212;0;295;2;2;0
/org.eclipse.team.cvs.core/src/org/eclipse/team/internal/ccvs/core/syncinfo/ReentrantLock.java;2;1;13;1;3;3;3;10;691;8;3;115;744;744;8;7;0;10;13;115;7;336;6;2;0
/org.eclipse.team.cvs.ui/src/org/eclipse/team/internal/ccvs/ui/wizards/ModuleSelectionPage.java;2;3;8;1;5;3;5;3;250;2;2;138;434;434;3;1;2;3;8;320;3;336;5;2;2
/org.eclipse.search/search/org/eclipse/search/internal/ui/text/ReplaceAction2.java;2;2;6;2;3;2;3;3;80;2;2;224;202;202;2;1;1;3;6;224;2;335;4;2;0
/org.eclipse.ui.workbench/Eclipse UI/org/eclipse/ui/internal/presentations/DefaultEditorPresentation.java;5;3;7;4;7;3;7;0;102;0;0;297;112;112;3;0;4;0;7;297;4;324;3;5;0
/org.eclipse.pde.core/src/org/eclipse/pde/internal/core/plugin/WorkspaceFragmentModel.java;1;0;2;1;1;1;1;1;4;0;1;232;7;7;1;0;0;1;2;232;0;336;2;1;0
/org.eclipse.jdt.ui/core refactoring/org/eclipse/jdt/internal/corext/refactoring/nls/NLSRefactoring.java;5;9;33;3;14;3;14;19;2600;3;14;9;4115;4115;9;5;11;19;33;275;16;336;17;5;0
/org.eclipse.ant.ui/Ant Tools Support/org/eclipse/ant/internal/ui/model/AntImageDescriptor.java;1;0;4;1;0;0;0;4;19;1;4;108;41;41;1;0;0;4;4;108;0;251;4;1;1
/org.eclipse.jdt.ui/ui/org/eclipse/jdt/internal/ui/dialogs/MultiElementListSelectionDialog.java;2;1;3;1;2;2;2;1;5;0;1;76;9;9;1;0;0;1;3;76;0;336;3;2;0
/org.eclipse.jdt.ui/ui/org/eclipse/jdt/internal/ui/preferences/ColorEditor.java;1;0;1;1;1;1;1;0;2;0;0;336;2;2;1;0;0;0;1;336;0;336;1;1;0
/org.eclipse.pde.ui/src_Forms/org/eclipse/pde/internal/ui/model/plugin/PluginElementNode.java;3;3;10;3;7;3;7;3;76;2;2;244;170;170;3;1;4;3;10;275;5;336;5;3;0
/org.eclipse.pde.ui/src/org/eclipse/pde/internal/ui/editor/PropertiesAction.java;2;1;4;1;3;3;3;1;45;0;1;270;54;54;1;0;0;1;4;270;0;336;4;2;0
/org.eclipse.update.ui/src/org/eclipse/update/internal/ui/UpdateLabelProvider.java;2;0;2;1;1;1;1;1;8;0;1;58;11;11;1;0;0;1;2;58;0;336;2;2;0
/org.eclipse.ui.forms/src/org/eclipse/ui/forms/widgets/ColumnLayout.java;2;0;6;2;1;1;1;5;61;4;2;225;65;65;4;3;0;5;6;225;3;272;3;2;0
/org.eclipse.ui.workbench.texteditor/src/org/eclipse/ui/internal/texteditor/quickdiff/DocumentLineDiffer.java;4;2;25;2;5;4;5;20;2012;6;9;100;2762;2762;6;11;1;20;25;130;12;332;13;4;1
/org.eclipse.ui.ide/src/org/eclipse/ui/views/tasklist/TaskListMessages.java;1;0;1;1;0;0;0;1;0;0;1;129;0;0;1;0;0;1;1;129;0;129;1;1;0
/org.eclipse.update.configurator/src/org/eclipse/update/internal/configurator/VersionedIdentifier.java;1;0;4;1;1;1;1;3;16;2;2;183;34;34;2;1;0;3;4;183;1;292;3;1;0
/org.eclipse.ant.ui/Ant Tools Support/org/eclipse/ant/internal/ui/preferences/AntPreviewerUpdater.java;1;1;2;1;2;2;2;0;26;0;0;306;30;30;1;0;0;0;2;306;0;336;2;1;0
/org.eclipse.ui.workbench/Eclipse UI/org/eclipse/ui/internal/themes/WorkbenchPreview.java;4;2;11;2;4;3;5;6;144;5;2;250;176;176;5;4;2;7;11;250;6;313;5;4;0
/org.eclipse.ant.ui/Ant Editor/org/eclipse/ant/internal/ui/editor/outline/FilterImportedElementsAction.java;1;0;1;1;0;0;0;1;0;0;1;239;0;0;1;0;0;1;1;239;0;239;1;1;1
/org.eclipse.pde.core/src/org/eclipse/pde/internal/core/plugin/PluginParent.java;2;1;4;1;2;2;2;2;10;1;2;232;22;22;1;0;0;2;4;232;0;336;4;2;0
/org.eclipse.jdt.core/compiler/org/eclipse/jdt/internal/compiler/classfmt/MethodInfo.java;3;0;3;1;1;1;1;2;2;1;2;124;6;6;1;0;0;2;3;124;0;314;3;3;0
/org.eclipse.jdt.core/eval/org/eclipse/jdt/internal/eval/CodeSnippetEnvironment.java;1;0;1;1;0;0;0;1;2;0;1;199;2;2;1;0;0;1;1;199;0;199;1;1;0
/org.eclipse.osgi/eclipseAdaptor/src/org/eclipse/osgi/service/pluginconversion/PluginConverter.java;4;3;12;3;5;3;5;7;70;3;4;177;133;133;3;3;2;7;12;238;5;336;7;4;0
/org.eclipse.ui.workbench/Eclipse UI/org/eclipse/ui/internal/presentations/DefaultPartPresentation.java;5;10;15;4;15;2;15;0;699;0;0;297;745;745;10;0;13;0;15;297;13;324;2;5;1
/org.eclipse.ui.workbench/Eclipse UI/org/eclipse/ui/progress/UIJob.java;3;1;21;2;5;5;5;16;497;5;7;62;689;689;5;9;0;16;21;62;9;336;12;3;0
/org.eclipse.core.resources/src/org/eclipse/core/resources/IWorkspaceRunnable.java;1;0;2;1;0;0;1;1;38;0;1;270;38;38;2;0;1;2;2;270;1;270;1;1;0
/org.eclipse.update.configurator/src/org/eclipse/update/configurator/IPlatformConfiguration.java;2;2;4;1;3;2;3;1;19;0;1;171;37;37;2;0;1;1;4;292;1;292;3;2;0
/org.eclipse.swt/Eclipse SWT Browser/win32/org/eclipse/swt/browser/Browser.java;2;5;33;2;8;2;8;25;827;11;8;100;1590;1590;11;17;6;25;33;153;23;329;10;2;2
/org.eclipse.jdt.core/eval/org/eclipse/jdt/internal/eval/CodeSnippetToCuMapper.java;2;0;5;1;2;1;2;3;72;1;3;18;142;142;2;0;1;3;5;324;1;324;4;2;2
/org.eclipse.jdt.core/model/org/eclipse/jdt/internal/core/util/SimpleDocument.java;2;0;4;2;0;0;0;4;52;2;3;133;78;78;2;1;0;4;4;133;1;199;3;2;0
/org.eclipse.ui.workbench/Eclipse UI/org/eclipse/ui/internal/registry/PerspectiveRegistry.java;5;4;15;2;6;3;6;9;837;3;6;116;1059;1059;4;3;3;9;15;282;6;336;9;5;1
/org.eclipse.jface.text/src/org/eclipse/jface/contentassist/ISubjectControlContentAssistant.java;1;1;2;1;2;2;2;0;20;0;0;280;33;33;1;0;0;0;2;280;0;336;2;1;0
/org.eclipse.jdt.debug.ui/ui/org/eclipse/jdt/internal/debug/ui/monitors/ThreadsViewContentProvider.java;1;0;1;1;0;0;0;1;2;0;1;78;2;2;1;0;0;1;1;78;0;78;1;1;0
/org.eclipse.pde.ui/src/org/eclipse/pde/internal/ui/wizards/templates/MultiPageEditorTemplate.java;3;4;12;3;6;3;6;6;110;2;5;128;185;185;4;1;3;6;12;302;4;336;8;3;0
/org.eclipse.pde.ui/src/org/eclipse/pde/internal/ui/editor/context/XMLInputContext.java;2;3;5;1;5;3;5;0;14;0;0;292;30;30;3;0;2;0;5;292;2;336;3;2;0
/org.eclipse.jdt.ui/ui/org/eclipse/jdt/ui/actions/AddUnimplementedConstructorsAction.java;3;2;21;2;5;3;6;15;211;5;8;41;535;535;5;7;3;16;21;49;10;336;11;3;0
/org.eclipse.osgi/defaultAdaptor/src/org/eclipse/osgi/framework/internal/defaultadaptor/MetaData.java;4;1;5;1;2;2;2;3;62;1;3;171;106;106;1;0;0;3;5;171;0;336;5;4;0
/org.eclipse.ltk.ui.refactoring/src/org/eclipse/ltk/ui/refactoring/RefactoringWizard.java;1;3;11;1;5;2;10;1;854;0;1;269;915;915;6;0;8;6;11;269;8;335;3;1;0
/org.eclipse.update.core/src/org/eclipse/update/core/SiteFeatureReferenceModel.java;2;1;3;1;2;2;2;1;6;0;1;58;12;12;1;0;0;1;3;58;0;336;3;2;0
/org.eclipse.ui.ide/src/org/eclipse/ui/views/markers/internal/Util.java;3;0;3;1;0;0;0;3;6;1;3;129;8;8;1;0;0;3;3;129;0;181;3;3;0
/org.eclipse.jdt.ui/ui/org/eclipse/jdt/internal/ui/packageview/GotoPackageAction.java;1;0;1;1;1;1;1;0;2;0;0;336;2;2;1;0;0;0;1;336;0;336;1;1;0
/org.eclipse.jdt.core/search/org/eclipse/jdt/internal/core/search/indexing/AbstractIndexer.java;3;0;9;2;1;1;1;8;592;3;5;7;816;816;3;3;0;8;9;181;3;283;6;3;1
/org.eclipse.jface/src/org/eclipse/jface/preference/JFacePreferences.java;4;1;4;1;2;2;2;2;20;1;2;223;56;56;1;0;0;2;4;223;0;336;4;4;0
/org.eclipse.jdt.core/model/org/eclipse/jdt/internal/core/hierarchy/IHierarchyRequestor.java;1;0;1;1;0;0;0;1;2;0;1;199;2;2;1;0;0;1;1;199;0;199;1;1;0
/org.eclipse.jface.text/src/org/eclipse/jface/text/IInformationControl.java;3;0;4;2;2;1;2;2;37;1;2;212;44;44;2;0;1;2;4;336;1;336;3;3;0
/org.eclipse.ui.editors/src/org/eclipse/ui/internal/editors/quickdiff/QuickDiffMessages.java;3;0;4;1;1;1;1;3;40;1;3;75;46;46;1;0;0;3;4;75;0;336;4;3;0
/org.eclipse.ui.workbench/Eclipse UI/org/eclipse/ui/internal/activities/ActivityRequirementBindingDefinition.java;2;2;3;1;3;2;3;0;8;0;0;307;10;10;2;0;1;0;3;307;1;336;2;2;0
/org.eclipse.ui.workbench/Eclipse UI/org/eclipse/ui/internal/ILayoutContainer.java;4;1;5;2;3;3;3;2;18;1;2;223;32;32;1;0;0;2;5;223;0;336;5;4;5
/org.eclipse.jdt.ui/ui/org/eclipse/jdt/internal/ui/viewsupport/ImageDescriptorRegistry.java;2;0;2;1;1;1;1;1;2;0;1;264;4;4;1;0;0;1;2;264;0;336;2;2;0
/org.eclipse.pde.ui/src/org/eclipse/pde/internal/ui/wizards/templates/HelloWorldNewWizard.java;3;2;5;1;4;3;4;1;12;0;1;222;31;31;2;0;1;1;5;308;1;336;4;3;0
/org.eclipse.jdt.core/codeassist/org/eclipse/jdt/internal/codeassist/complete/CompletionOnClassLiteralAccess.java;2;0;2;1;0;0;0;2;38;1;2;63;40;40;1;0;0;2;2;63;0;199;2;2;0
/org.eclipse.ui.workbench/Eclipse UI/org/eclipse/ui/internal/registry/Category.java;6;0;9;2;1;1;1;8;36;2;5;133;115;115;2;3;0;8;9;171;3;336;6;6;0
/org.eclipse.debug.ui/ui/org/eclipse/debug/internal/ui/views/console/ConsoleDocumentManager.java;3;0;13;2;3;1;3;10;244;4;6;78;470;470;4;4;2;10;13;78;6;293;7;3;1
/org.eclipse.jdt.ui/ui/org/eclipse/jdt/ui/jarpackager/IJarDescriptionWriter.java;1;0;1;1;1;1;1;0;2;0;0;336;2;2;1;0;0;0;1;336;0;336;1;1;0
/org.eclipse.jdt.junit.runtime/src/org/eclipse/jdt/internal/junit/runner/JUnitMessages.java;2;0;2;1;1;1;1;1;4;0;1;82;4;4;1;0;0;1;2;82;0;336;2;2;0
/org.eclipse.ui.workbench/Eclipse UI/org/eclipse/ui/internal/about/AboutBundleGroupData.java;2;1;2;1;2;2;2;0;21;0;0;294;28;28;1;0;0;0;2;294;0;335;2;2;0
/org.eclipse.team.cvs.ui/src/org/eclipse/team/internal/ccvs/ui/subscriber/OverrideAndUpdateSubscriberOperation.java;2;1;6;1;3;3;3;3;10;0;1;244;32;32;3;2;0;3;6;244;2;336;4;2;0
/org.eclipse.jdt.ui/ui/org/eclipse/jdt/ui/actions/OrganizeImportsAction.java;3;2;16;2;7;5;7;9;89;3;5;41;338;338;3;4;2;9;16;75;6;336;10;3;3
/org.eclipse.jdt.ui/ui/org/eclipse/jdt/internal/ui/text/JavaColorManager.java;1;0;1;1;1;1;1;0;2;0;0;336;2;2;1;0;0;0;1;336;0;336;1;1;0
/org.eclipse.core.resources/src/org/eclipse/core/internal/resources/ProjectDescription.java;3;3;8;2;5;3;5;3;359;1;3;190;717;717;3;0;2;3;8;275;2;313;6;3;0
/org.eclipse.core.runtime/src/org/eclipse/core/runtime/ILog.java;2;0;7;2;0;0;2;5;214;3;3;171;234;234;3;2;2;7;7;171;4;268;3;2;0
/org.eclipse.jdt.ui/ui/org/eclipse/jdt/internal/ui/compare/JavaTextViewerCreator.java;1;0;1;1;1;1;1;0;2;0;0;336;2;2;1;0;0;0;1;336;0;336;1;1;0
/org.eclipse.jdt.ui/core extension/org/eclipse/jdt/internal/corext/dom/fragments/Util.java;2;1;2;1;2;2;2;0;33;0;0;322;35;35;1;0;0;0;2;322;0;336;2;2;0
/org.eclipse.core.runtime/src/org/eclipse/core/internal/registry/ExtensionDelta.java;4;1;8;3;3;3;3;5;213;3;3;124;226;226;3;2;0;5;8;171;2;336;6;4;0
/org.eclipse.jdt.core/dom/org/eclipse/jdt/core/dom/ContinueStatement.java;3;0;7;1;1;1;1;6;66;2;5;199;83;83;2;1;0;6;7;266;1;283;6;3;1
/org.eclipse.pde.build/src/org/eclipse/pde/internal/build/SourceFeatureInformation.java;2;0;7;2;2;1;2;5;10;2;3;31;10;10;2;2;1;5;7;31;3;272;4;2;0
/org.eclipse.pde.core/src/org/eclipse/pde/internal/core/ibundle/IBundleFragment.java;1;1;2;1;2;2;2;0;4;0;0;292;4;4;1;0;0;0;2;292;0;336;2;1;0
/org.eclipse.jface/src/org/eclipse/jface/util/TransferDropTargetListener.java;1;0;1;1;0;0;0;1;0;0;1;13;0;0;1;0;0;1;1;13;0;13;1;1;0
/org.eclipse.ui.ide/src/org/eclipse/ui/views/markers/internal/DeferredQueue.java;1;0;1;1;0;0;0;1;0;0;1;181;0;0;1;0;0;1;1;181;0;181;1;1;0
/org.eclipse.swt/Eclipse SWT/common/org/eclipse/swt/layout/FormData.java;1;0;4;1;0;0;0;4;123;2;3;57;237;237;2;1;0;4;4;57;1;133;3;1;0
/org.eclipse.compare/compare/org/eclipse/compare/internal/CompareAction.java;1;0;4;1;1;1;1;3;13;1;3;45;25;25;1;0;0;3;4;45;0;337;4;1;0
/org.eclipse.ui.workbench/Eclipse UI/org/eclipse/ui/presentations/IPresentablePart.java;5;2;14;4;4;3;5;9;103;0;1;245;158;158;10;8;2;10;14;245;10;321;4;5;0
/org.eclipse.text/src/org/eclipse/jface/text/source/IAnnotationModelListenerExtension.java;1;1;3;1;2;2;2;1;30;0;1;131;38;38;1;0;0;1;3;131;0;334;3;1;0
/org.eclipse.team.cvs.ui/src/org/eclipse/team/internal/ccvs/ui/TagConfigurationDialog.java;2;1;8;1;4;4;4;4;70;1;4;20;123;123;1;0;0;4;8;20;0;336;8;2;1
/org.eclipse.jdt.core/compiler/org/eclipse/jdt/internal/compiler/ast/MessageSend.java;2;0;15;1;1;1;1;14;81;9;6;3;115;115;9;8;0;14;15;63;8;325;7;2;6
/org.eclipse.team.cvs.core/src/org/eclipse/team/internal/ccvs/core/client/RDiff.java;1;0;2;1;0;0;0;2;46;0;1;144;46;46;2;1;0;2;2;144;1;144;1;1;0
/org.eclipse.jdt.core/search/org/eclipse/jdt/internal/core/index/EntryResult.java;2;0;4;1;0;0;0;4;88;1;4;191;92;92;1;0;0;4;4;191;0;244;4;2;0
/org.eclipse.jdt.junit/src/org/eclipse/jdt/internal/junit/ui/RemoteTestRunnerClient.java;2;1;7;1;2;2;2;5;267;2;3;193;306;306;2;2;0;5;7;193;2;336;5;2;0
/org.eclipse.debug.ui/ui/org/eclipse/debug/internal/ui/views/expression/ExpressionViewContentProvider.java;3;0;10;1;0;0;0;10;36;4;6;37;92;92;4;4;0;10;10;45;4;148;6;3;0
/org.eclipse.help.base/src/org/eclipse/help/internal/search/SmartAnalyzer.java;1;1;4;1;3;3;3;1;15;0;1;104;23;23;1;0;0;1;4;104;0;336;4;1;0
/org.eclipse.ui.workbench/Eclipse UI/org/eclipse/ui/commands/ICommandListener.java;2;0;9;1;1;1;1;8;29;5;4;70;98;98;5;4;0;8;9;70;4;281;5;2;0
/org.eclipse.ltk.core.refactoring/src/org/eclipse/ltk/core/refactoring/IUndoManagerListener.java;1;1;4;1;2;2;2;2;25;0;1;264;46;46;2;1;0;2;4;264;1;336;3;1;0
/org.eclipse.update.core/src/org/eclipse/update/core/IPluginEntry.java;2;1;3;1;2;2;2;1;6;0;1;58;12;12;1;0;0;1;3;58;0;336;3;2;0
/org.eclipse.jdt.core/dom/org/eclipse/jdt/core/dom/SingleVariableDeclaration.java;4;0;16;2;1;1;5;11;461;6;6;199;680;680;6;5;4;15;16;266;9;308;7;4;2
/org.eclipse.ui.workbench/Eclipse UI/org/eclipse/ui/internal/WorkbenchPage.java;13;15;68;7;20;2;23;45;5514;18;11;26;7668;7668;18;34;21;48;68;223;55;328;13;13;14
/org.eclipse.compare/compare/org/eclipse/compare/rangedifferencer/RangeDifferencer.java;1;0;3;1;1;1;1;2;2;1;2;79;5;5;1;0;0;2;3;79;0;335;3;1;0
/org.eclipse.swt/Eclipse SWT PI/win32/org/eclipse/swt/internal/win32/OSVERSIONINFOW.java;2;0;2;1;0;0;0;2;1;1;2;61;1;1;1;0;0;2;2;61;0;166;2;2;0
/org.eclipse.core.runtime/src/org/eclipse/core/runtime/preferences/IPreferenceNodeVisitor.java;1;0;3;1;2;1;2;1;8;0;1;241;8;8;2;0;1;1;3;272;1;272;2;1;0
/org.eclipse.ant.ui/Ant Tools Support/org/eclipse/ant/internal/ui/model/ColorManager.java;1;1;4;1;2;2;2;2;4;1;2;108;4;4;1;0;0;2;4;108;0;336;4;1;1
/org.eclipse.jdt.ui/ui/org/eclipse/jdt/internal/ui/preferences/CodeStylePreferencePage.java;2;0;2;1;1;1;1;1;2;0;1;253;2;2;1;0;0;1;2;253;0;336;2;2;0
/org.eclipse.pde.core/src/org/eclipse/pde/internal/core/NLResourceHelper.java;2;2;4;2;3;2;3;1;26;0;1;232;42;42;2;0;1;1;4;303;1;336;3;2;0
/org.eclipse.team.core/src/org/eclipse/team/internal/core/subscribers/WorkingSetFilteredSyncInfoCollector.java;2;1;2;2;2;2;2;0;14;0;0;288;15;15;1;0;0;0;2;288;0;299;2;2;0
/org.eclipse.swt/Eclipse SWT Mozilla/common/org/eclipse/swt/internal/mozilla/XPCOM.java;2;2;16;1;3;2;3;13;237;3;6;100;348;348;3;7;1;13;16;100;8;336;8;2;1
/org.eclipse.text/src/org/eclipse/jface/text/IDocumentPartitionerExtension2.java;2;1;3;1;2;2;2;1;84;0;1;93;148;148;1;0;0;1;3;93;0;334;3;2;0
/org.eclipse.pde.ui/src/org/eclipse/pde/internal/ui/wizards/extension/NewExtensionTemplateWizard.java;3;2;7;1;5;3;5;2;8;1;2;128;16;16;2;0;2;2;7;308;2;331;5;3;0
/org.eclipse.jdt.ui/ui/org/eclipse/jdt/internal/ui/util/TabFolderLayout.java;1;0;1;1;1;1;1;0;2;0;0;336;2;2;1;0;0;0;1;336;0;336;1;1;0
/org.eclipse.jface.text/src/org/eclipse/jface/text/IMarkRegionTarget.java;1;0;1;1;1;1;1;0;2;0;0;336;2;2;1;0;0;0;1;336;0;336;1;1;0
/org.eclipse.jdt.debug/jdi interfaces/com/sun/jdi/LocalVariable.java;1;0;1;1;0;0;0;1;3;0;1;235;3;3;1;0;0;1;1;235;0;235;1;1;0
/org.eclipse.jface.text/src/org/eclipse/jface/text/rules/WordRule.java;1;1;2;1;2;2;2;0;4;0;0;276;6;6;1;0;0;0;2;276;0;336;2;1;0
/org.eclipse.jdt.ui/ui/org/eclipse/jdt/internal/ui/preferences/formatter/ModifyDialogTabPage.java;1;1;13;1;2;2;2;11;504;4;3;176;833;833;4;8;0;11;13;191;8;313;5;1;0
/org.eclipse.ui.workbench.texteditor/src/org/eclipse/ui/internal/texteditor/LinearLayouter.java;2;0;3;1;1;1;1;2;58;1;2;148;64;64;1;0;0;2;3;148;0;336;3;2;0
/org.eclipse.jdt.debug/model/org/eclipse/jdt/internal/debug/core/JDIDebugMessages.java;2;0;1;2;0;0;0;1;15;0;1;221;15;15;1;0;0;1;1;221;0;221;1;2;0
/org.eclipse.ui.workbench/Eclipse UI/org/eclipse/ui/ISaveablePart.java;3;1;3;2;2;2;2;1;4;0;1;166;10;10;1;0;0;1;3;166;0;336;3;3;0
/org.eclipse.osgi/eclipseAdaptor/src/org/eclipse/core/runtime/adaptor/EclipseLog.java;3;3;10;2;4;2;6;4;372;3;4;216;455;455;3;0;4;6;10;268;4;326;6;3;1
/org.eclipse.swt/Eclipse SWT/win32/org/eclipse/swt/widgets/DirectoryDialog.java;4;1;9;2;3;3;3;6;37;2;5;11;133;133;2;1;0;6;9;96;1;337;8;4;0
/org.eclipse.ui.ide/extensions/org/eclipse/ui/actions/OpenFileAction.java;1;0;1;1;0;0;0;1;0;0;1;132;0;0;1;0;0;1;1;132;0;132;1;1;0
/org.eclipse.ui.workbench.texteditor/src/org/eclipse/ui/texteditor/TextEditorAction.java;2;1;7;2;3;3;3;4;60;2;3;93;99;99;2;1;0;4;7;124;1;336;6;2;0
/org.eclipse.jdt.debug/model/org/eclipse/jdt/debug/core/IJavaBreakpointListener.java;3;0;2;2;0;0;0;2;112;1;2;130;114;114;1;0;0;2;2;130;0;170;2;3;0
/org.eclipse.update.ui/src/org/eclipse/update/internal/ui/model/IFeatureAdapter.java;1;0;1;1;0;0;0;1;5;0;1;58;5;5;1;0;0;1;1;58;0;58;1;1;0
/org.eclipse.help/src/org/eclipse/help/internal/context/PluginsContexts.java;1;0;2;1;1;1;1;1;6;0;1;266;6;6;1;0;0;1;2;266;0;336;2;1;0
/org.eclipse.jdt.core/codeassist/org/eclipse/jdt/internal/codeassist/complete/CompletionOnClassReference.java;1;0;2;1;0;0;0;2;8;1;2;63;10;10;1;0;0;2;2;63;0;199;2;1;0
/org.eclipse.ui.workbench/Eclipse UI/org/eclipse/ui/commands/ICommandManager.java;3;1;27;2;2;2;2;25;758;15;6;70;2315;2315;15;19;0;25;27;70;19;336;8;3;1
/org.eclipse.swt/Eclipse SWT/win32/org/eclipse/swt/widgets/Display.java;7;7;59;6;14;4;14;45;542;14;12;1;1954;1954;14;33;10;45;59;238;43;324;16;7;3
/org.eclipse.pde.build/src_ant/org/eclipse/pde/internal/build/tasks/PluginVersionReplaceTask.java;2;4;8;2;7;3;7;1;171;0;1;230;201;201;4;0;4;1;8;323;4;323;4;2;0
/org.eclipse.pde.ui/src/org/eclipse/pde/internal/ui/search/PluginSearchLabelProvider.java;3;1;4;1;2;2;2;2;6;0;1;128;14;14;2;1;0;2;4;128;1;336;3;3;0
/org.eclipse.ui.ide/src/org/eclipse/ui/internal/ide/registry/Capability.java;1;0;2;1;0;0;0;2;2;1;2;132;2;2;1;0;0;2;2;132;0;151;2;1;1
/org.eclipse.ltk.ui.refactoring/src/org/eclipse/ltk/internal/ui/refactoring/ChangeExceptionHandler.java;1;2;4;1;3;2;3;1;5;0;1;269;7;7;2;0;1;1;4;281;1;305;3;1;0
/org.eclipse.team.core/src/org/eclipse/team/core/subscribers/ISubscriberChangeListener.java;2;2;5;1;3;2;3;2;44;1;2;220;70;70;2;0;1;2;5;335;1;335;4;2;0
/org.eclipse.jdt.ui/ui refactoring/org/eclipse/jdt/internal/ui/refactoring/contentassist/TempNameProcessor.java;1;0;1;1;1;1;1;0;0;0;0;281;0;0;1;0;0;0;1;281;0;281;1;1;0
/org.eclipse.jdt.ui/ui/org/eclipse/jdt/internal/ui/actions/ConfigureContainerAction.java;2;1;3;1;2;2;2;1;39;0;1;243;55;55;1;0;0;1;3;243;0;292;3;2;0
/org.eclipse.jdt.core/model/org/eclipse/jdt/internal/core/eval/GlobalVariableWrapper.java;1;0;1;1;0;0;0;1;2;0;1;199;2;2;1;0;0;1;1;199;0;199;1;1;0
/org.eclipse.jdt.ui/ui/org/eclipse/jdt/internal/ui/preferences/TodoTaskPreferencePage.java;2;1;3;1;2;2;2;1;4;0;1;142;8;8;1;0;0;1;3;142;0;336;3;2;0
/org.eclipse.jdt.core/codeassist/org/eclipse/jdt/internal/codeassist/select/SelectionOnQualifiedSuperReference.java;2;0;2;1;0;0;0;2;13;1;2;63;15;15;1;0;0;2;2;63;0;199;2;2;1
/org.eclipse.jdt.ui/core extension/org/eclipse/jdt/internal/corext/util/UnresolvableTypeInfo.java;1;0;1;1;1;1;1;0;2;0;0;336;2;2;1;0;0;0;1;336;0;336;1;1;0
/org.eclipse.jdt.core/compiler/org/eclipse/jdt/internal/compiler/codegen/CodeStream.java;5;0;18;3;2;1;2;16;2747;3;10;2;3501;3501;3;6;1;16;18;11;7;314;11;5;1
/org.eclipse.team.cvs.ui/src/org/eclipse/team/internal/ccvs/ui/subscriber/ChangeLogModelManager.java;1;5;6;1;6;2;6;0;114;0;0;293;118;118;5;0;4;0;6;293;4;336;2;1;1
/org.eclipse.jface.text/src/org/eclipse/jface/text/IFindReplaceTargetExtension.java;2;0;2;2;2;1;2;0;11;0;0;336;11;11;2;0;1;0;2;336;1;336;1;2;0
/org.eclipse.team.cvs.ui/src/org/eclipse/team/internal/ccvs/ui/repo/EncodingFieldEditor.java;1;0;1;1;0;0;0;1;0;0;1;264;0;0;1;0;0;1;1;264;0;264;1;1;1
/org.eclipse.update.core/src/org/eclipse/update/core/model/ImportModel.java;1;1;2;1;2;2;2;0;6;0;0;292;10;10;1;0;0;0;2;292;0;336;2;1;0
/org.eclipse.swt/Eclipse SWT/gtk/org/eclipse/swt/widgets/TrayItem.java;4;2;5;2;3;2;3;2;144;0;1;247;153;153;2;1;1;2;5;247;2;316;3;4;0
/org.eclipse.ltk.core.refactoring/src/org/eclipse/ltk/core/refactoring/UndoTextFileChange.java;1;2;7;1;4;3;4;3;31;0;1;264;65;65;3;2;1;3;7;264;3;336;4;1;0
/org.eclipse.text/src/org/eclipse/jface/text/templates/TemplateContext.java;3;2;5;2;4;2;4;1;11;0;1;234;16;16;2;0;2;1;5;274;2;334;3;3;0
/org.eclipse.jdt.ui/core refactoring/org/eclipse/jdt/internal/corext/refactoring/typeconstraints/IContext.java;2;0;2;1;1;1;1;1;2;0;1;207;2;2;1;0;0;1;2;207;0;336;2;2;0
/org.eclipse.jdt.launching/launching/org/eclipse/jdt/internal/launching/LaunchingPlugin.java;2;1;10;2;2;2;2;8;100;2;6;76;255;255;2;2;0;8;10;116;2;326;8;2;2
/org.eclipse.team.cvs.core/src/org/eclipse/team/internal/ccvs/core/client/RLog.java;2;1;3;1;2;2;2;1;59;0;1;268;80;80;1;0;0;1;3;268;0;312;3;2;1
/org.eclipse.core.resources/src/org/eclipse/core/internal/resources/ComputeProjectOrder.java;2;1;3;1;2;2;2;1;154;0;1;169;175;175;1;0;0;1;3;169;0;313;3;2;0
/org.eclipse.ui.workbench/Eclipse UI/org/eclipse/ui/XMLMemento.java;4;1;5;2;2;2;2;3;68;1;3;0;84;84;1;0;0;3;5;0;0;336;5;4;1
/org.eclipse.jdt.core/model/org/eclipse/jdt/core/IClassFile.java;1;0;3;1;0;0;0;3;27;1;3;149;32;32;1;0;0;3;3;149;0;199;3;1;0
/org.eclipse.pde.ui/src/org/eclipse/pde/internal/ui/wizards/plugin/NewProjectCreationOperation.java;3;4;14;2;9;5;9;5;293;2;3;222;422;422;4;2;4;5;14;280;6;336;8;3;0
/org.eclipse.core.expressions/src/org/eclipse/core/expressions/ElementHandler.java;1;2;4;1;3;2;3;1;18;0;1;227;23;23;2;0;1;1;4;334;1;334;3;1;0
/org.eclipse.jdt.ui/core refactoring/org/eclipse/jdt/internal/corext/refactoring/base/JDTChange.java;2;1;8;1;3;3;3;5;24;2;3;219;85;85;2;2;0;5;8;219;2;336;6;2;0
/org.eclipse.jdt.ui/ui/org/eclipse/jdt/internal/ui/text/correction/UnresolvedElementsSubProcessor.java;5;12;55;3;14;3;14;41;687;12;15;19;2234;2234;12;26;11;41;55;19;37;336;18;5;0
/org.eclipse.core.runtime.compatibility/src-runtime/org/eclipse/core/internal/plugins/Policy.java;2;1;3;1;2;2;2;1;12;0;1;171;14;14;1;0;0;1;3;171;0;336;3;2;0
/org.eclipse.jdt.ui/ui/org/eclipse/jdt/internal/ui/preferences/CompilerConfigurationBlock.java;2;1;27;1;4;4;4;23;371;3;12;26;1273;1273;3;11;0;23;27;71;11;336;16;2;5
/org.eclipse.jface.text/src/org/eclipse/jface/text/IMarkSelection.java;2;0;2;2;2;1;2;0;12;0;0;336;12;12;2;0;1;0;2;336;1;336;1;2;0
/org.eclipse.core.resources/src/org/eclipse/core/resources/IProject.java;2;1;9;2;2;2;3;6;1390;2;5;3;1470;1470;2;1;1;7;9;247;2;294;7;2;0
/org.eclipse.ui.forms/src/org/eclipse/ui/forms/events/ExpansionAdapter.java;1;1;5;1;2;2;2;3;31;2;2;225;45;45;2;1;0;3;5;225;1;336;4;1;0
/org.eclipse.jdt.core/model/org/eclipse/jdt/internal/core/util/CharArrayBuffer.java;2;0;2;1;1;1;1;1;2;0;1;199;4;4;1;0;0;1;2;199;0;314;2;2;0
/org.eclipse.jdt.ui/ui/org/eclipse/jdt/internal/ui/viewsupport/ListContentProvider.java;1;0;1;1;1;1;1;0;2;0;0;336;2;2;1;0;0;0;1;336;0;336;1;1;0
/org.eclipse.jdt.core/compiler/org/eclipse/jdt/internal/compiler/ast/Block.java;3;0;7;2;0;0;0;7;74;4;4;60;108;108;4;3;0;7;7;60;3;199;4;3;0
/org.eclipse.ui.workbench/Eclipse UI/org/eclipse/ui/internal/presentations/SystemMenuFastView.java;2;1;4;1;2;2;2;2;74;1;2;256;98;98;1;0;0;2;4;256;0;296;4;2;0
/org.eclipse.jdt.debug/jdi/org/eclipse/jdi/internal/LocalVariableImpl.java;2;0;3;1;0;0;0;3;21;2;2;191;37;37;2;1;0;3;3;235;1;235;2;2;0
/org.eclipse.ui.workbench/Eclipse UI/org/eclipse/ui/IWorkbenchPage.java;7;2;22;4;4;3;4;18;1018;4;8;75;1501;1501;4;10;1;18;22;156;11;336;11;7;2
/org.eclipse.osgi/osgi/src/org/osgi/util/tracker/ServiceTracker.java;2;3;5;1;5;3;5;0;641;0;0;274;757;757;3;0;2;0;5;303;2;303;3;2;0
/org.eclipse.team.cvs.core/src/org/eclipse/team/internal/ccvs/core/IUserAuthenticator.java;1;0;4;1;1;1;1;3;75;1;3;176;110;110;1;0;0;3;4;176;0;336;4;1;0
/org.eclipse.jdt.core/model/org/eclipse/jdt/internal/core/util/DefaultBytecodeVisitor.java;2;3;8;1;4;2;4;4;1462;1;4;12;1641;1641;3;0;2;4;8;273;2;331;6;2;0
/org.eclipse.ui.workbench/Eclipse UI/org/eclipse/ui/internal/ShowViewAction.java;2;0;2;2;0;0;0;2;135;0;1;171;135;135;2;1;0;2;2;171;1;171;1;2;0
/org.eclipse.jdt.ui/ui/org/eclipse/jdt/internal/ui/actions/FoldingToggleRulerAction.java;2;1;2;1;2;2;2;0;6;0;0;300;6;6;1;0;0;0;2;300;0;336;2;2;0
/org.eclipse.core.resources/src/org/eclipse/core/internal/properties/IndexedStoreWrapper.java;1;0;1;1;1;1;1;0;370;0;0;277;370;370;1;0;0;0;1;277;0;277;1;1;0
/org.eclipse.debug.core/core/org/eclipse/debug/core/IBreakpointManagerListener.java;2;0;2;1;1;1;1;1;9;0;1;233;9;9;1;0;0;1;2;233;0;275;2;2;0
/org.eclipse.ui.ide/src/org/eclipse/ui/views/markers/internal/BookmarkFilter.java;2;0;2;1;0;0;0;2;14;1;2;129;14;14;1;0;0;2;2;129;0;181;2;2;0
/org.eclipse.update.core/src/org/eclipse/update/internal/core/InstallConfiguration.java;3;4;32;2;6;3;9;23;365;13;5;58;728;728;13;18;6;26;32;227;24;336;8;3;1
/org.eclipse.core.runtime/src/org/eclipse/core/runtime/preferences/IScopeContext.java;2;0;10;2;3;1;5;5;23;3;4;224;47;47;3;1;4;7;10;268;5;293;5;2;0
/org.eclipse.core.runtime/src/org/eclipse/core/internal/jobs/InternalJob.java;3;3;38;2;5;3;8;30;1059;6;13;23;2131;2131;6;17;5;33;38;262;22;337;16;3;0
/org.eclipse.ant.ui/Ant Tools Support/org/eclipse/ant/internal/ui/views/AntView.java;3;0;12;2;0;0;0;12;107;5;7;108;172;172;5;5;0;12;12;108;5;240;7;3;2
/org.eclipse.swt/Eclipse SWT Custom Widgets/common/org/eclipse/swt/custom/StyledTextRenderer.java;4;3;12;2;5;3;5;7;612;3;3;113;931;931;3;4;2;7;12;265;6;337;6;4;1
/org.eclipse.jdt.core/compiler/org/eclipse/jdt/internal/compiler/codegen/DoubleCache.java;1;0;1;1;0;0;0;1;2;0;1;199;2;2;1;0;0;1;1;199;0;199;1;1;0
/org.eclipse.team.core/src/org/eclipse/team/core/variants/ThreeWayResourceComparator.java;1;0;2;1;1;1;1;1;9;0;1;239;9;9;1;0;0;1;2;239;0;325;2;1;0
/org.eclipse.jdt.core/eval/org/eclipse/jdt/internal/eval/CodeSnippetTypeDeclaration.java;2;0;3;1;1;1;1;2;46;1;2;188;50;50;1;0;0;2;3;188;0;300;3;2;0
/org.eclipse.ui.workbench/Eclipse UI/org/eclipse/ui/internal/dialogs/PropertyPageNode.java;2;0;3;2;0;0;0;3;127;2;2;163;170;170;2;1;0;3;3;171;1;171;2;2;0
/org.eclipse.jdt.ui/ui/org/eclipse/jdt/internal/ui/text/comment/CommentLine.java;2;0;8;1;1;1;1;7;433;4;4;97;598;598;4;3;0;7;8;119;3;336;5;2;0
/org.eclipse.ui.workbench/Eclipse UI/org/eclipse/ui/internal/registry/FileEditorMapping.java;3;0;8;2;0;0;0;8;400;4;4;116;602;602;4;4;0;8;8;133;4;166;4;3;0
/org.eclipse.ltk.ui.refactoring/src/org/eclipse/ltk/internal/ui/refactoring/RefactoringPluginImages.java;1;0;3;1;1;1;2;1;10;0;1;269;16;16;2;0;1;2;3;269;1;289;2;1;0
/org.eclipse.swt/Eclipse SWT Mozilla/common/org/eclipse/swt/internal/mozilla/nsIProfile.java;1;0;2;1;0;0;0;2;10;1;2;100;10;10;1;0;0;2;2;100;0;148;2;1;0
/org.eclipse.team.ui/src/org/eclipse/team/ui/synchronize/SynchronizeModelOperation.java;2;2;5;1;4;2;4;1;34;0;1;253;61;61;2;0;2;1;5;295;2;335;3;2;0
/org.eclipse.ui.workbench/Eclipse UI/org/eclipse/ui/internal/presentations/BasicStackList.java;5;5;10;2;10;3;10;0;54;0;0;288;121;121;5;0;7;0;10;288;7;335;3;5;1
/org.eclipse.jface.text/src/org/eclipse/jface/text/source/ILineDiffInfo.java;3;0;4;2;2;1;2;2;7;1;2;70;9;9;2;0;1;2;4;335;1;335;3;3;0
/org.eclipse.jdt.core/compiler/org/eclipse/jdt/internal/compiler/ast/WhileStatement.java;3;0;9;2;2;1;2;7;28;3;4;61;71;71;3;3;1;7;9;61;4;287;5;3;1
/org.eclipse.pde.ui/src/org/eclipse/pde/internal/ui/editor/build/BuildSourcePage.java;1;1;3;1;2;2;2;1;81;0;1;104;93;93;1;0;0;1;3;104;0;336;3;1;0
/org.eclipse.ui.workbench/Eclipse UI/org/eclipse/ui/internal/themes/ColorDefinition.java;2;0;6;1;1;1;1;5;40;3;2;241;61;61;3;3;0;5;6;241;3;336;3;2;1
/org.eclipse.jdt.core/eval/org/eclipse/jdt/internal/eval/EvaluationResult.java;1;0;1;1;0;0;0;1;2;0;1;199;2;2;1;0;0;1;1;199;0;199;1;1;0
/org.eclipse.jdt.ui/core extension/org/eclipse/jdt/internal/corext/callhierarchy/CallHierarchy.java;3;1;8;1;2;2;2;6;25;2;4;13;77;77;2;2;0;6;8;13;2;336;6;3;0
/org.eclipse.ui.workbench/Eclipse UI/org/eclipse/ui/application/IWorkbenchWindowConfigurer.java;5;1;14;1;3;3;3;11;245;3;7;77;587;587;3;4;0;11;14;247;4;336;10;5;0
/org.eclipse.team.core/src/org/eclipse/team/core/synchronize/SyncInfoTree.java;2;2;6;1;3;2;3;3;348;1;3;224;403;403;2;0;1;3;6;335;1;335;5;2;0
/org.eclipse.jdt.launching/launching/org/eclipse/jdt/launching/AbstractVMInstall.java;2;0;2;1;0;0;0;2;24;1;2;170;43;43;1;0;0;2;2;170;0;246;2;2;1
/org.eclipse.swt/Eclipse SWT PI/motif/org/eclipse/swt/internal/motif/XmTextVerifyCallbackStruct.java;1;0;1;1;0;0;0;1;12;0;1;54;12;12;1;0;0;1;1;54;0;54;1;1;0
/org.eclipse.jdt.debug.ui/ui/org/eclipse/jdt/internal/debug/ui/CreateStepFilterDialog.java;2;0;6;2;0;0;0;6;124;5;2;197;180;180;5;4;0;6;6;197;4;264;2;2;0
/org.eclipse.team.cvs.ui/src/org/eclipse/team/internal/ccvs/ui/wizards/KSubstWizardSharedFilesPage.java;1;0;1;1;0;0;0;1;2;0;1;138;2;2;1;0;0;1;1;138;0;138;1;1;0
/org.eclipse.debug.core/core/org/eclipse/debug/internal/core/memory/IMemoryRenderingInfo.java;1;0;1;1;1;1;1;0;0;0;0;282;0;0;1;0;0;0;1;282;0;282;1;1;1
/org.eclipse.ui.workbench/Eclipse UI/org/eclipse/ui/internal/ProductInfo.java;2;0;2;1;1;1;1;1;139;0;1;256;139;139;1;0;0;1;2;256;0;320;2;2;0
/org.eclipse.jdt.ui/ui/org/eclipse/jdt/internal/ui/preferences/PreferencesMessages.java;1;0;1;1;1;1;1;0;2;0;0;336;2;2;1;0;0;0;1;336;0;336;1;1;0
/org.eclipse.jdt.ui/ui/org/eclipse/jdt/internal/ui/PersistableJavaElementFactory.java;1;0;1;1;1;1;1;0;2;0;0;336;2;2;1;0;0;0;1;336;0;336;1;1;0
/org.eclipse.swt/Eclipse SWT/common/org/eclipse/swt/widgets/Dialog.java;1;0;3;1;0;0;0;3;16;1;3;19;23;23;1;0;0;3;3;19;0;100;3;1;0
/org.eclipse.pde.ui/src_Forms/org/eclipse/pde/internal/ui/model/bundle/ManifestHeader.java;3;4;5;3;5;2;5;0;18;0;0;292;22;22;4;0;3;0;5;292;3;336;2;3;0
/org.eclipse.ui.workbench/Eclipse UI/org/eclipse/ui/internal/ViewIntroAdapterSite.java;1;0;5;1;3;1;3;2;38;0;1;203;40;40;3;1;2;2;5;289;3;289;2;1;0
/org.eclipse.jdt.core/eval/org/eclipse/jdt/internal/eval/VariablesInfo.java;2;0;2;1;0;0;0;2;10;1;2;45;12;12;1;0;0;2;2;45;0;199;2;2;0
/org.eclipse.jdt.ui/ui/org/eclipse/jdt/internal/ui/viewsupport/ImageDisposer.java;1;0;1;1;1;1;1;0;2;0;0;336;2;2;1;0;0;0;1;336;0;336;1;1;0
/org.eclipse.jface.text/src/org/eclipse/jface/text/source/ChangeRulerColumn.java;3;2;13;2;4;2;6;7;67;3;7;76;222;222;3;0;4;9;13;269;4;336;9;3;0
/org.eclipse.jdt.ui/ui/org/eclipse/jdt/internal/ui/javaeditor/SemanticHighlightingManager.java;3;3;5;1;5;3;5;0;256;0;0;283;332;332;3;0;2;0;5;293;2;326;3;3;1
/org.eclipse.swt/Eclipse SWT Drag and Drop/motif/org/eclipse/swt/dnd/RTFTransfer.java;1;0;1;1;0;0;0;1;59;0;1;24;59;59;1;0;0;1;1;24;0;24;1;1;0
/org.eclipse.ui.console/src/org/eclipse/ui/internal/console/ConsoleView.java;4;3;9;2;4;2;4;5;76;2;4;118;131;131;3;1;2;5;9;301;3;312;6;4;0
/org.eclipse.team.cvs.ui/src/org/eclipse/team/internal/ccvs/ui/repo/RepositoryManager.java;2;2;15;2;4;3;4;11;133;3;7;56;364;364;3;4;1;11;15;254;5;336;10;2;0
/org.eclipse.debug.ui/ui/org/eclipse/debug/internal/ui/views/memory/MemoryViewCellModifier.java;2;0;2;2;2;1;2;0;6;0;0;282;6;6;2;0;1;0;2;282;1;282;1;2;2
/org.eclipse.jdt.ui/core extension/org/eclipse/jdt/internal/corext/dom/CompilationUnitBuffer.java;2;0;2;1;1;1;1;1;8;0;1;126;10;10;1;0;0;1;2;126;0;336;2;2;0
/org.eclipse.jdt.ui/ui refactoring/org/eclipse/jdt/internal/ui/refactoring/actions/InlineMethodAction.java;3;0;5;1;1;1;1;4;118;1;4;11;137;137;1;0;0;4;5;11;0;336;5;3;0
/org.eclipse.ltk.core.refactoring/src/org/eclipse/ltk/core/refactoring/PerformRefactoringOperation.java;1;1;7;1;2;2;5;2;51;0;1;264;60;60;5;1;3;5;7;264;4;336;3;1;0
/org.eclipse.jdt.ui/ui/org/eclipse/jdt/internal/ui/javadocexport/RecentSettingsStore.java;1;0;1;1;0;0;0;1;0;0;1;224;0;0;1;0;0;1;1;224;0;224;1;1;0
/org.eclipse.update.core/src/org/eclipse/update/core/SiteContentProvider.java;4;2;6;2;4;3;4;2;7;1;2;0;24;24;2;0;1;2;6;300;1;336;5;4;0
/org.eclipse.swt/Eclipse SWT PI/motif/org/eclipse/swt/internal/motif/XWindowChanges.java;1;0;1;1;0;0;0;1;6;0;1;54;6;6;1;0;0;1;1;54;0;54;1;1;0
/org.eclipse.jdt.ui/ui/org/eclipse/jdt/internal/ui/wizards/buildpaths/BuildPathSupport.java;1;0;1;1;0;0;0;1;0;0;1;243;0;0;1;0;0;1;1;243;0;243;1;1;0
/org.eclipse.ltk.ui.refactoring/src/org/eclipse/ltk/internal/ui/refactoring/RefactoringUIMessages.java;1;0;2;1;1;1;1;1;2;0;1;264;2;2;1;0;0;1;2;264;0;336;2;1;0
/org.eclipse.update.ui/src/org/eclipse/update/internal/ui/wizards/NewWebSiteDialog.java;3;0;3;2;0;0;0;3;20;2;2;54;30;30;2;1;0;3;3;54;1;268;2;3;0
/org.eclipse.swt/Eclipse SWT Mozilla/common/org/eclipse/swt/internal/mozilla/nsIComponentManager.java;1;0;1;1;0;0;0;1;0;0;1;100;0;0;1;0;0;1;1;100;0;100;1;1;0
/org.eclipse.ltk.core.refactoring/src/org/eclipse/ltk/internal/core/refactoring/BufferValidationState.java;1;4;6;1;5;2;5;1;36;0;1;264;58;58;4;0;3;1;6;278;3;335;3;1;0
/org.eclipse.jdt.debug.ui/ui/org/eclipse/jdt/internal/debug/core/refactoring/LaunchConfigurationITypeMoveParticipant.java;3;1;4;1;3;3;3;1;10;0;1;270;20;20;1;0;0;1;4;270;0;336;4;3;0
/org.eclipse.jdt.ui/core extension/org/eclipse/jdt/internal/corext/util/SuperTypeHierarchyCache.java;3;0;6;1;1;1;1;5;101;1;5;81;129;129;1;0;0;5;6;81;0;336;6;3;1
/org.eclipse.ant.ui/Ant Editor/org/eclipse/ant/internal/ui/editor/templates/BuildFileContextType.java;2;0;2;1;1;1;1;1;22;0;1;267;22;22;1;0;0;1;2;267;0;279;2;2;0
/org.eclipse.jdt.ui/ui/org/eclipse/jdt/ui/actions/SelectionDispatchAction.java;2;0;4;2;1;1;1;3;24;1;3;41;45;45;1;0;0;3;4;41;0;336;4;2;0
/org.eclipse.ui.workbench.texteditor/src/org/eclipse/ui/texteditor/FindReplaceTarget.java;1;1;4;1;2;2;2;2;31;1;2;82;39;39;1;0;0;2;4;82;0;336;4;1;0
/org.eclipse.ui.ide/src/org/eclipse/ui/views/markers/internal/SortUtil.java;1;0;1;1;0;0;0;1;0;0;1;181;0;0;1;0;0;1;1;181;0;181;1;1;0
/org.eclipse.search/search/org/eclipse/search/internal/ui/SearchDialog.java;2;2;12;1;3;2;3;9;173;3;5;82;431;431;3;4;1;9;12;180;5;303;7;2;0
/org.eclipse.jdt.ui/ui/org/eclipse/jdt/ui/wizards/IClasspathContainerPageExtension2.java;1;0;2;1;1;1;1;1;6;0;1;243;6;6;1;0;0;1;2;243;0;276;2;1;0
/org.eclipse.jdt.ui/ui/org/eclipse/jdt/internal/ui/text/correction/JavadocTagsSubProcessor.java;3;3;17;1;6;4;6;11;406;3;7;145;1144;1144;3;4;2;11;17;145;6;336;11;3;1
/org.eclipse.jdt.core/compiler/org/eclipse/jdt/internal/compiler/env/IBinaryField.java;1;0;1;1;0;0;0;1;2;0;1;199;2;2;1;0;0;1;1;199;0;199;1;1;0
/org.eclipse.jdt.core/compiler/org/eclipse/jdt/internal/compiler/ast/InstanceOfExpression.java;3;0;6;2;0;0;0;6;248;2;5;63;297;297;2;1;0;6;6;168;1;267;5;3;0
/org.eclipse.swt/Eclipse SWT PI/win32/org/eclipse/swt/internal/ole/win32/STGMEDIUM.java;1;0;1;1;0;0;0;1;4;0;1;166;4;4;1;0;0;1;1;166;0;166;1;1;0
/org.eclipse.text/src/org/eclipse/jface/text/TextUtilities.java;3;3;9;3;4;2;4;5;224;0;1;92;301;301;5;4;2;5;9;92;6;334;3;3;0
/org.eclipse.ui.ide/src/org/eclipse/ui/internal/ide/actions/BuildSetMenu.java;1;0;2;1;1;1;1;1;6;0;1;254;6;6;1;0;0;1;2;254;0;279;2;1;1
/org.eclipse.ui.cheatsheets/src/org/eclipse/ui/internal/cheatsheets/views/IntroItem.java;2;3;11;2;5;3;5;6;81;5;2;243;130;130;5;4;2;6;11;253;6;315;5;2;0
/org.eclipse.jdt.ui/ui/org/eclipse/jdt/internal/ui/actions/ActionMessages.java;2;1;2;1;2;2;2;0;10;0;0;288;12;12;1;0;0;0;2;288;0;336;2;2;0
/org.eclipse.jdt.ui/ui/org/eclipse/jdt/internal/ui/text/correction/ASTRewriteCorrectionProposal.java;2;0;14;1;1;1;1;13;114;5;6;7;316;316;5;7;0;13;14;256;7;290;7;2;0
/org.eclipse.debug.core/core/org/eclipse/debug/core/ILaunchManager.java;1;0;10;1;0;0;2;8;67;3;7;32;158;158;3;1;2;10;10;268;3;268;7;1;0
/org.eclipse.pde.ui/src/org/eclipse/pde/internal/ui/editor/plugin/PackageSelectionDialog.java;2;2;4;1;4;3;4;0;10;0;0;292;20;20;2;0;1;0;4;292;1;336;3;2;0
/org.eclipse.ui.ide/src/org/eclipse/ui/internal/ide/EditorAreaDropAdapter.java;2;0;3;1;0;0;0;3;188;1;3;132;201;201;1;0;0;3;3;132;0;165;3;2;0
/org.eclipse.core.runtime/src/org/eclipse/core/internal/runtime/Log.java;4;2;8;2;3;2;3;5;326;3;3;171;344;344;3;2;1;5;8;171;3;336;5;4;0
/org.eclipse.ui.workbench/Eclipse UI/org/eclipse/ui/IElementFactory.java;1;0;1;1;0;0;0;1;1;0;1;157;1;1;1;0;0;1;1;157;0;157;1;1;0
/org.eclipse.search/search/org/eclipse/search/internal/ui/util/FileLabelProvider.java;1;0;1;1;1;1;1;0;2;0;0;336;2;2;1;0;0;0;1;336;0;336;1;1;0
/org.eclipse.pde.core/src/org/eclipse/pde/core/IModelChangeProvider.java;2;1;3;1;3;3;3;0;57;0;0;276;93;93;1;0;0;0;3;276;0;336;3;2;0
/org.eclipse.ui.workbench/Eclipse UI/org/eclipse/ui/internal/registry/StickyViewDescriptor.java;1;2;3;1;3;2;3;0;61;0;0;275;61;61;2;0;1;0;3;294;1;294;2;1;0
/org.eclipse.ui.ide/src/org/eclipse/ui/wizards/datatransfer/DataTransferMessages.java;1;0;1;1;0;0;0;1;0;0;1;92;0;0;1;0;0;1;1;92;0;92;1;1;0
/org.eclipse.swt/Eclipse SWT Drag and Drop/motif/org/eclipse/swt/dnd/Transfer.java;1;1;2;1;2;2;2;0;4;0;0;300;6;6;1;0;0;0;2;300;0;337;2;1;0
/org.eclipse.pde.ui/src/org/eclipse/pde/internal/ui/wizards/plugin/NewFragmentProjectWizard.java;3;2;8;1;5;4;5;3;94;1;3;213;160;160;2;0;1;3;8;280;1;336;7;3;0
/org.eclipse.jdt.core/compiler/org/eclipse/jdt/internal/compiler/ast/StringLiteral.java;3;0;5;1;2;1;2;3;36;1;3;63;52;52;2;0;1;3;5;300;1;300;4;3;0
/org.eclipse.jdt.core/compiler/org/eclipse/jdt/internal/compiler/impl/Constant.java;1;0;1;1;0;0;0;1;2;0;1;199;2;2;1;0;0;1;1;199;0;199;1;1;0
/org.eclipse.jdt.ui/ui/org/eclipse/jdt/internal/ui/text/spelling/WordCompletionProcessor.java;2;0;2;1;1;1;1;1;2;0;1;219;2;2;1;0;0;1;2;219;0;336;2;2;0
/org.eclipse.jdt.ui/ui/org/eclipse/jdt/internal/ui/typehierarchy/HierarchyInformationControl.java;3;1;21;2;2;2;2;19;346;7;8;35;918;918;7;11;0;19;21;35;11;336;10;3;0
/org.eclipse.jdt.ui/ui/org/eclipse/jdt/internal/ui/CompatibilityTemplateStore.java;2;1;6;1;2;2;3;3;93;0;1;263;110;110;4;2;1;4;6;263;3;336;3;2;0
/org.eclipse.jdt.core/search/org/eclipse/jdt/core/search/ISearchPattern.java;1;0;5;1;2;1;2;3;7;1;3;109;11;11;2;0;1;3;5;275;1;275;4;1;0
/org.eclipse.jdt.ui/ui/org/eclipse/jdt/internal/ui/callhierarchy/SearchScopeAction.java;2;1;3;1;2;2;2;1;4;0;1;224;6;6;1;0;0;1;3;224;0;336;3;2;0
/org.eclipse.swt/Eclipse SWT PI/motif/org/eclipse/swt/internal/motif/XIconSize.java;2;0;2;1;1;1;1;1;4;0;1;202;4;4;1;0;0;1;2;202;0;337;2;2;0
/org.eclipse.team.core/src/org/eclipse/team/core/variants/ISynchronizerChangeListener.java;1;0;2;1;1;1;1;1;6;0;1;239;6;6;1;0;0;1;2;239;0;325;2;1;0
/org.eclipse.core.runtime.compatibility/src-runtime/org/eclipse/core/internal/plugins/DefaultPlugin.java;2;1;4;1;2;2;2;2;2;0;1;171;5;5;2;1;0;2;4;171;1;336;3;2;0
/org.eclipse.jdt.ui/ui/org/eclipse/jdt/internal/ui/actions/OpenTypeAction.java;2;2;3;2;3;2;3;0;15;0;0;302;23;23;2;0;1;0;3;331;1;331;2;2;0
/org.eclipse.swt/Eclipse SWT/motif/org/eclipse/swt/graphics/GCData.java;5;0;6;2;1;1;1;5;11;1;5;0;29;29;1;0;0;5;6;0;0;337;6;5;0
/org.eclipse.ui.ide/src/org/eclipse/ui/views/navigator/ResourceNavigator.java;4;1;9;2;4;4;4;5;20;3;3;129;51;51;3;2;0;5;9;150;2;336;7;4;0
/org.eclipse.jdt.ui/ui/org/eclipse/jdt/ui/actions/InlineTempAction.java;3;0;8;2;1;1;2;6;35;2;5;9;70;70;2;1;1;7;8;36;2;336;6;3;0
/org.eclipse.jdt.ui/ui/org/eclipse/jdt/ui/text/IColorManagerExtension.java;1;0;2;1;2;1;2;0;11;0;0;335;11;11;2;0;1;0;2;335;1;335;1;1;0
/org.eclipse.swt/Eclipse SWT/photon/org/eclipse/swt/widgets/MessageBox.java;3;1;3;2;2;2;2;1;20;0;1;161;31;31;1;0;0;1;3;161;0;337;3;3;0
/org.eclipse.ltk.core.refactoring/src/org/eclipse/ltk/core/refactoring/participants/DeleteRefactoring.java;1;2;5;1;3;2;3;2;19;0;1;264;29;29;2;1;1;2;5;264;2;336;3;1;0
/org.eclipse.jdt.core/model/org/eclipse/jdt/internal/core/util/ClassFileReader.java;1;0;2;1;0;0;0;2;4;1;2;8;6;6;1;0;0;2;2;8;0;199;2;1;0
/org.eclipse.pde.ui/src/org/eclipse/pde/internal/ui/editor/EmptyOutlinePage.java;1;1;2;1;2;2;2;0;10;0;0;292;10;10;1;0;0;0;2;292;0;336;2;1;0
/org.eclipse.text/projection/org/eclipse/jface/text/projection/ProjectionDocumentEvent.java;2;2;5;2;3;2;3;2;82;1;2;247;103;103;2;0;1;2;5;334;1;334;4;2;0
/org.eclipse.jdt.ui/ui/org/eclipse/jdt/internal/ui/viewsupport/MemberFilter.java;2;0;4;1;1;1;1;3;31;2;2;134;39;39;2;1;0;3;4;246;1;336;3;2;0
/org.eclipse.jdt.ui/ui/org/eclipse/jdt/internal/ui/search/TextSearchLabelProvider.java;3;2;4;1;3;2;3;1;10;0;1;266;12;12;2;0;1;1;4;290;1;336;3;3;0
/org.eclipse.jface.text/src/org/eclipse/jface/text/rules/SingleLineRule.java;1;1;3;1;2;2;2;1;23;0;1;231;26;26;1;0;0;1;3;231;0;336;3;1;0
/org.eclipse.pde/src/org/eclipse/pde/internal/builders/FeatureConsistencyChecker.java;3;2;7;1;4;3;4;3;53;1;3;130;180;180;2;0;1;3;7;330;1;330;6;3;0
/org.eclipse.team.ui/src/org/eclipse/team/internal/ui/synchronize/SynchronizeManager.java;2;6;27;2;8;2;8;19;2311;5;6;146;3630;3630;6;13;6;19;27;288;19;332;8;2;1
/org.eclipse.jdt.core/compiler/org/eclipse/jdt/internal/compiler/ast/OperatorIds.java;1;0;1;1;0;0;0;1;2;0;1;199;2;2;1;0;0;1;1;199;0;199;1;1;0
/org.eclipse.jface/src/org/eclipse/jface/viewers/IContentProvider.java;3;1;3;1;2;2;2;1;4;0;1;0;8;8;1;0;0;1;3;0;0;336;3;3;0
/org.eclipse.team.cvs.ui/src/org/eclipse/team/internal/ccvs/ui/actions/CompareWithRemoteAction.java;2;4;13;2;5;2;6;7;158;4;4;71;275;275;4;3;4;8;13;244;7;336;6;2;0
/org.eclipse.ant.ui/Ant Editor/org/eclipse/ant/internal/ui/editor/derived/SubstitutionTextReader.java;1;1;3;1;2;2;2;1;29;0;1;108;33;33;1;0;0;1;3;108;0;336;3;1;0
/org.eclipse.jdt.debug.ui/ui/org/eclipse/jdt/internal/debug/ui/JavaDetailFormattersPreferencePage.java;4;0;4;2;0;0;0;4;25;2;3;9;39;39;2;1;0;4;4;9;1;176;3;4;0
/org.eclipse.core.resources/src/org/eclipse/core/resources/ISaveParticipant.java;1;0;3;1;0;0;1;2;295;2;2;3;297;297;2;0;1;3;3;270;1;270;2;1;0
/org.eclipse.core.runtime/src/org/eclipse/core/runtime/IPluginRegistry.java;3;3;11;2;6;3;6;5;316;2;4;171;428;428;3;1;3;5;11;272;4;336;7;3;0
/org.eclipse.osgi/core/adaptor/org/eclipse/osgi/framework/adaptor/FrameworkAdaptor.java;6;3;18;3;5;3;9;9;63;5;7;171;171;171;5;2;6;13;18;270;8;336;10;6;0
/org.eclipse.pde.core/src/org/eclipse/pde/internal/core/util/PropertiesUtil.java;3;2;8;2;4;3;4;4;22;3;2;128;57;57;3;2;1;4;8;128;3;336;5;3;0
/org.eclipse.core.runtime/src/org/eclipse/core/internal/preferences/LookupOrder.java;1;0;3;1;1;1;1;2;5;0;1;239;7;7;2;1;0;2;3;239;1;277;2;1;0
/org.eclipse.update.core/src/org/eclipse/update/core/model/NonPluginEntryModel.java;1;1;2;1;2;2;2;0;6;0;0;292;10;10;1;0;0;0;2;292;0;336;2;1;0
/org.eclipse.help/src/org/eclipse/help/internal/toc/TocFileParser.java;1;1;6;1;3;3;3;3;50;2;2;139;148;148;2;1;0;3;6;156;1;336;5;1;0
/org.eclipse.pde.core/src/org/eclipse/pde/internal/core/PDEState.java;3;2;9;2;5;4;5;4;38;0;1;259;66;66;4;3;1;4;9;259;4;336;5;3;0
/org.eclipse.jdt.core/codeassist/org/eclipse/jdt/internal/codeassist/select/SelectionParser.java;5;0;15;2;1;1;1;14;54;3;8;5;168;168;3;6;0;14;15;150;6;306;9;5;1
/org.eclipse.jdt.ui/ui/org/eclipse/jdt/internal/ui/text/comment/CommentFormattingStrategy.java;3;0;15;2;1;1;1;14;189;3;8;97;519;519;3;6;0;14;15;119;6;336;9;3;0
/org.eclipse.swt/Eclipse SWT/common/org/eclipse/swt/graphics/Drawable.java;2;1;3;1;2;2;2;1;20;0;1;228;28;28;1;0;0;1;3;228;0;337;3;2;0
/org.eclipse.jdt.ui/ui/org/eclipse/jdt/internal/ui/text/javadoc/IHtmlTagConstants.java;2;0;2;1;1;1;1;1;6;0;1;212;6;6;1;0;0;1;2;212;0;336;2;2;0
/org.eclipse.core.expressions/src/org/eclipse/core/internal/expressions/EnablementExpression.java;1;0;2;1;1;1;1;1;2;0;1;227;2;2;1;0;0;1;2;227;0;336;2;1;0
/org.eclipse.jdt.ui/ui/org/eclipse/jdt/internal/ui/typehierarchy/ITypeHierarchyLifeCycleListener.java;1;0;1;1;1;1;1;0;2;0;0;336;2;2;1;0;0;0;1;336;0;336;1;1;0
/org.eclipse.jface.text/src/org/eclipse/jface/text/contentassist/ContextInformationPopup.java;3;5;15;2;8;3;8;7;147;2;6;82;435;435;5;1;5;7;15;275;6;336;9;3;0
/org.eclipse.jdt.core/search/org/eclipse/jdt/core/search/LocalVariableReferenceMatch.java;3;3;9;2;5;3;5;4;38;2;2;218;116;116;3;2;2;4;9;275;4;314;5;3;0
/org.eclipse.core.resources/src/org/eclipse/core/internal/events/BuildCommand.java;1;0;1;1;1;1;1;0;145;0;0;277;145;145;1;0;0;0;1;277;0;277;1;1;0
/org.eclipse.jdt.core/model/org/eclipse/jdt/internal/core/util/CommentRecorderParser.java;4;1;8;2;2;2;2;6;168;3;2;214;244;244;3;4;0;6;8;214;4;312;4;4;2
/org.eclipse.jdt.core/compiler/org/eclipse/jdt/internal/compiler/classfmt/ClassFileStruct.java;3;1;4;1;2;2;2;2;15;1;2;71;30;30;1;0;0;2;4;71;0;302;4;3;0
/org.eclipse.jdt.core/compiler/org/eclipse/jdt/internal/compiler/lookup/BaseTypeBinding.java;2;0;2;1;0;0;0;2;314;1;2;37;316;316;1;0;0;2;2;37;0;199;2;2;0
/org.eclipse.jdt.debug.ui/ui/org/eclipse/jdt/internal/debug/ui/snippeteditor/SnippetDocumentFactory.java;1;0;1;1;1;1;1;0;0;0;0;273;0;0;1;0;0;0;1;273;0;273;1;1;0
/org.eclipse.search/search/org/eclipse/search/internal/ui/text/FileContentProvider.java;2;0;3;1;1;1;1;2;6;1;2;207;8;8;1;0;0;2;3;207;0;336;3;2;0
/org.eclipse.ui.workbench/Eclipse UI/org/eclipse/ui/internal/progress/WorkbenchMonitorProvider.java;3;0;12;1;1;1;1;11;537;5;5;125;867;867;5;6;0;11;12;125;6;336;6;3;0
/org.eclipse.osgi/core/framework/org/eclipse/osgi/framework/debug/DebugOptions.java;4;3;10;2;5;3;5;5;65;3;3;171;103;103;3;2;2;5;10;171;4;336;6;4;0
/org.eclipse.debug.ui/ui/org/eclipse/debug/internal/ui/VariablesViewModelPresentation.java;1;0;1;1;0;0;0;1;2;0;1;76;2;2;1;0;0;1;1;76;0;76;1;1;0
/org.eclipse.debug.core/core/org/eclipse/debug/core/sourcelookup/ISourcePathComputerDelegate.java;1;0;2;1;0;0;1;1;24;0;1;268;24;24;2;0;1;2;2;268;1;268;1;1;0
/org.eclipse.jdt.core/model/org/eclipse/jdt/internal/core/SourceRefElement.java;3;0;14;2;1;1;1;13;69;3;8;51;141;141;3;5;0;13;14;51;5;279;9;3;0
/org.eclipse.debug.ui/ui/org/eclipse/debug/internal/ui/actions/LaunchShortcutAction.java;2;1;2;1;2;2;2;0;21;0;0;295;25;25;1;0;0;0;2;295;0;336;2;2;0
/org.eclipse.jdt.debug.ui/ui/org/eclipse/jdt/internal/debug/ui/actions/AddJarAction.java;2;0;6;1;0;0;0;6;29;2;4;74;80;80;2;2;0;6;6;74;2;154;4;2;0
/org.eclipse.search/search/org/eclipse/search/internal/core/text/TextSearchScope.java;2;1;5;1;2;2;2;3;142;2;2;9;218;218;2;1;0;3;5;9;1;336;4;2;1
/org.eclipse.jdt.core/compiler/org/eclipse/jdt/internal/compiler/util/SuffixConstants.java;1;0;2;1;0;0;0;2;18;1;2;19;20;20;1;0;0;2;2;19;0;199;2;1;0
/org.eclipse.core.resources/src/org/eclipse/core/internal/resources/SyncInfoReader_3.java;1;0;1;1;1;1;1;0;124;0;0;277;124;124;1;0;0;0;1;277;0;277;1;1;0
/org.eclipse.swt/Eclipse SWT/motif/org/eclipse/swt/widgets/FileDialog.java;3;1;8;1;2;2;2;6;52;3;4;19;123;123;3;2;0;6;8;152;2;337;6;3;0
/org.eclipse.search/search/org/eclipse/search/ui/ISearchResultView.java;2;2;3;1;3;2;3;0;5;0;0;325;7;7;2;0;1;0;3;325;1;336;2;2;0
/org.eclipse.pde.build/src/org/eclipse/pde/internal/build/site/PDEState.java;2;7;16;2;15;3;15;1;490;0;1;226;604;604;7;0;12;1;16;296;12;323;4;2;0
/org.eclipse.swt/Eclipse SWT PI/carbon/org/eclipse/swt/internal/carbon/ControlTabInfoRecV1.java;1;0;2;1;2;1;2;0;20;0;0;296;20;20;2;0;1;0;2;296;1;296;1;1;0
/org.eclipse.jdt.core/compiler/org/eclipse/jdt/internal/compiler/lookup/VariableBinding.java;1;0;1;1;0;0;0;1;2;0;1;199;2;2;1;0;0;1;1;199;0;199;1;1;1
/org.eclipse.ui.ide/src/org/eclipse/ui/internal/ide/dialogs/WelcomeEditorInput.java;3;1;7;2;2;2;2;5;9;4;2;132;18;18;4;3;0;5;7;154;3;336;4;3;0
/org.eclipse.jdt.ui/ui/org/eclipse/jdt/internal/ui/jarpackager/JarOptionsPage.java;1;1;3;1;2;2;2;1;8;0;1;82;13;13;1;0;0;1;3;82;0;336;3;1;0
/org.eclipse.pde.ui/src/org/eclipse/pde/internal/ui/wizards/tools/UpdateBuildpathWizardPage.java;2;1;4;1;3;3;3;1;8;0;1;213;18;18;1;0;0;1;4;213;0;336;4;2;0
/org.eclipse.ui.forms/src/org/eclipse/ui/forms/editor/IFormPage.java;1;0;5;1;1;1;2;3;154;2;3;225;184;184;2;0;1;4;5;269;1;336;4;1;0
/org.eclipse.jdt.ui/ui/org/eclipse/jdt/internal/ui/text/correction/LinkedNamesAssistProposal.java;4;4;17;3;5;2;5;12;75;3;10;16;260;260;4;2;3;12;17;275;5;336;12;4;0
/org.eclipse.jdt.ui/ui/org/eclipse/jdt/internal/ui/wizards/buildpaths/MultipleFolderSelectionDialog.java;2;0;4;1;1;1;1;3;5;0;1;212;7;7;3;2;0;3;4;212;2;336;2;2;0
/org.eclipse.update.core/src/org/eclipse/update/core/model/InstallAbortedException.java;1;2;4;1;4;3;4;0;8;0;0;290;14;14;2;0;1;0;4;290;1;336;3;1;0
/org.eclipse.ui.workbench/Eclipse UI/org/eclipse/ui/presentations/WorkbenchPresentationFactory.java;5;2;8;3;5;3;5;3;50;2;2;247;116;116;2;1;2;3;8;247;3;336;5;5;2
/org.eclipse.update.core/src/org/eclipse/update/core/SiteFeatureReference.java;4;1;5;2;3;3;3;2;14;1;2;0;32;32;1;0;0;2;5;0;0;336;5;4;0
/org.eclipse.jdt.ui/ui/org/eclipse/jdt/internal/ui/compare/JavaReplaceWithPreviousEditionAction.java;2;0;2;1;1;1;1;1;2;0;1;104;4;4;1;0;0;1;2;104;0;336;2;2;1
/org.eclipse.pde.ui/src/org/eclipse/pde/internal/ui/wizards/templates/MultiPageEditorNewWizard.java;3;2;6;1;4;3;4;2;39;1;2;222;64;64;2;0;1;2;6;308;1;336;5;3;0
/org.eclipse.text/src/org/eclipse/jface/text/source/AnnotationMap.java;2;2;3;2;3;2;3;0;10;0;0;289;10;10;2;0;1;0;3;334;1;334;2;2;0
/org.eclipse.jdt.ui/core refactoring/org/eclipse/jdt/internal/corext/refactoring/sef/AccessAnalyzer.java;3;0;6;1;1;1;1;5;135;1;5;57;180;180;1;0;0;5;6;57;0;336;6;3;1
/org.eclipse.jdt.ui/ui/org/eclipse/jdt/ui/jarpackager/IManifestProvider.java;2;0;1;2;1;1;1;0;6;0;0;336;6;6;1;0;0;0;1;336;0;336;1;2;0
/org.eclipse.ant.ui/Ant Editor/org/eclipse/ant/internal/ui/editor/derived/HTMLTextPresenter.java;1;0;3;1;1;1;1;2;4;1;2;108;8;8;1;0;0;2;3;108;0;336;3;1;1
/org.eclipse.core.resources/src/org/eclipse/core/internal/resources/PlatformURLResourceConnection.java;1;0;2;1;2;1;2;0;98;0;0;275;98;98;2;0;1;0;2;275;1;275;1;1;0
/org.eclipse.jdt.debug.ui/ui/org/eclipse/jdt/internal/debug/ui/actions/TerminateEvaluationAction.java;1;0;1;1;0;0;0;1;3;0;1;76;3;3;1;0;0;1;1;76;0;76;1;1;0
/org.eclipse.team.cvs.ssh/src/org/eclipse/team/internal/ccvs/ssh/KnownHosts.java;2;0;5;1;1;1;1;4;15;2;3;56;43;43;2;1;0;4;5;103;1;336;4;2;0
/org.eclipse.jdt.debug.ui/ui/org/eclipse/jdt/internal/debug/ui/actions/AddFolderAction.java;3;0;6;1;1;1;1;5;16;2;4;76;35;35;2;1;0;5;6;76;1;336;5;3;0
/org.eclipse.pde.core/src/org/eclipse/pde/core/IModelProviderListener.java;2;1;3;1;2;2;2;1;29;0;1;130;35;35;1;0;0;1;3;130;0;336;3;2;0
/org.eclipse.swt/Eclipse SWT PI/carbon/org/eclipse/swt/internal/carbon/ATSUTab.java;2;0;3;1;2;1;2;1;20;0;1;117;20;20;2;0;1;1;3;296;1;296;2;2;0
/org.eclipse.pde.core/src/org/eclipse/pde/internal/core/bundle/BundlePlugin.java;3;4;6;2;6;3;6;0;52;0;0;292;66;66;4;0;3;0;6;292;3;336;3;3;0
/org.eclipse.team.ui/src/org/eclipse/team/internal/ui/wizards/GlobalSynchronizeWizard.java;2;2;8;2;4;3;4;4;133;2;2;244;259;259;2;2;1;4;8;244;3;336;5;2;1
/org.eclipse.pde.ui/src/org/eclipse/pde/internal/ui/editor/schema/TypeRestrictionCellEditor.java;2;1;2;1;2;2;2;0;4;0;0;308;8;8;1;0;0;0;2;308;0;336;2;2;0
/org.eclipse.jdt.debug.ui/ui/org/eclipse/jdt/internal/debug/ui/actions/BreakpointLocationVerifierJob.java;3;1;13;3;2;2;3;10;46;3;4;98;109;109;3;6;1;11;13;98;7;309;6;3;4
/org.eclipse.jdt.ui/ui/org/eclipse/jdt/internal/ui/typehierarchy/TypeHierarchyLifeCycle.java;2;1;6;1;2;2;2;4;82;1;4;84;155;155;1;0;0;4;6;84;0;336;6;2;0
/org.eclipse.jdt.ui/ui/org/eclipse/jdt/ui/actions/OverrideMethodsAction.java;3;2;12;2;4;3;4;8;690;2;6;40;812;812;2;2;1;8;12;40;3;336;9;3;0
/org.eclipse.pde.ui/src/org/eclipse/pde/internal/ui/editor/feature/ReferencePropertySource.java;3;1;5;1;2;2;2;3;15;2;2;130;42;42;2;1;0;3;5;130;1;336;4;3;0
/org.eclipse.debug.core/core/org/eclipse/debug/core/ILaunchConfiguration.java;3;0;4;1;1;1;1;3;53;2;2;94;69;69;2;1;0;3;4;94;1;336;3;3;1
/org.eclipse.jdt.ui/ui/org/eclipse/jdt/internal/ui/typehierarchy/ShowInheritedMembersAction.java;1;0;1;1;1;1;1;0;2;0;0;336;2;2;1;0;0;0;1;336;0;336;1;1;0
/org.eclipse.jdt.debug.ui/ui/org/eclipse/jdt/internal/debug/ui/classpath/ClasspathModel.java;3;0;6;1;1;1;1;5;27;2;4;154;56;56;2;1;0;5;6;189;1;336;5;3;0
/org.eclipse.ui.workbench/Eclipse UI/org/eclipse/ui/part/ViewPart.java;7;3;9;4;8;3;8;1;195;0;1;258;417;417;3;0;5;1;9;309;5;324;4;7;1
/org.eclipse.team.ui/src/org/eclipse/team/internal/ui/synchronize/CompressedFoldersModelProvider.java;2;6;12;2;7;2;7;5;304;0;1;243;374;374;6;4;5;5;12;288;9;336;3;2;0
/org.eclipse.core.resources/src/org/eclipse/core/internal/resources/XMLWriter.java;1;0;2;1;1;1;1;1;181;0;1;169;185;185;1;0;0;1;2;169;0;277;2;1;0
/org.eclipse.jdt.ui/ui/org/eclipse/jdt/internal/ui/dialogs/OptionalMessageDialog.java;1;0;1;1;1;1;1;0;2;0;0;336;2;2;1;0;0;0;1;336;0;336;1;1;0
/org.eclipse.pde.ui/src/org/eclipse/pde/internal/ui/editor/feature/SynchronizeVersionsAction.java;3;3;6;2;5;3;5;1;90;0;1;232;156;156;3;0;2;1;6;302;2;336;4;3;0
/org.eclipse.ui.workbench/Eclipse UI/org/eclipse/ui/internal/activities/AbstractActivityRegistry.java;3;1;11;1;2;2;2;9;92;5;4;141;113;113;5;5;0;9;11;160;5;336;6;3;0
/org.eclipse.ant.ui/Ant Editor/org/eclipse/ant/internal/ui/dtd/util/SortedMap.java;1;0;1;1;0;0;0;1;0;0;1;108;0;0;1;0;0;1;1;108;0;108;1;1;0
/org.eclipse.team.core/src/org/eclipse/team/internal/core/streams/TimeoutOutputStream.java;1;0;2;1;0;0;0;2;21;0;1;25;21;21;2;1;0;2;2;25;1;25;1;1;0
/org.eclipse.jdt.core/dom/org/eclipse/jdt/core/dom/ForStatement.java;3;0;9;1;2;1;2;7;146;2;6;164;189;189;2;1;1;7;9;266;2;276;7;3;2
/org.eclipse.ui.editors/src/org/eclipse/ui/internal/editors/text/OpenExternalFileAction.java;3;0;6;2;1;1;1;5;54;3;2;130;91;91;3;3;0;5;6;130;3;336;3;3;0
/org.eclipse.swt/Eclipse SWT/motif/org/eclipse/swt/widgets/Slider.java;3;1;5;1;2;2;2;3;30;1;3;19;54;54;1;0;0;3;5;19;0;337;5;3;0
/org.eclipse.jdt.core/model/org/eclipse/jdt/core/IJavaElement.java;2;0;8;1;0;0;0;8;18;3;5;38;41;41;3;3;0;8;8;55;3;196;5;2;0
/org.eclipse.ant.ui/Ant Editor/org/eclipse/ant/internal/ui/editor/templates/AntTemplateProposal.java;1;0;1;1;1;1;1;0;0;0;0;283;0;0;1;0;0;0;1;283;0;283;1;1;0
/org.eclipse.swt/Eclipse SWT Mozilla/common/org/eclipse/swt/internal/mozilla/nsIAppShell.java;1;0;2;1;0;0;0;2;2;1;2;100;2;2;1;0;0;2;2;100;0;148;2;1;0
/org.eclipse.pde.core/src/org/eclipse/pde/core/plugin/IPluginModelBase.java;2;2;10;1;4;3;4;6;87;2;5;128;144;144;2;1;1;6;10;171;2;336;8;2;0
/org.eclipse.swt/Eclipse SWT Drag and Drop/photon/org/eclipse/swt/dnd/RTFTransfer.java;1;0;1;1;0;0;0;1;4;0;1;137;4;4;1;0;0;1;1;137;0;137;1;1;0
/org.eclipse.pde.core/src/org/eclipse/pde/internal/core/ifeature/IFeatureObject.java;2;1;3;1;2;2;2;1;6;0;1;232;12;12;1;0;0;1;3;232;0;336;3;2;0
/org.eclipse.pde.ui/src/org/eclipse/pde/internal/ui/editor/plugin/ExtensionPointDetails.java;3;8;9;3;9;2;9;0;86;0;0;292;102;102;8;0;7;0;9;292;7;336;2;3;0
/org.eclipse.ui.editors/src/org/eclipse/ui/internal/texteditor/DelegatingAnnotationPreference.java;2;1;2;1;2;2;2;0;4;0;0;279;4;4;1;0;0;0;2;279;0;336;2;2;0
/org.eclipse.ui.intro/src/org/eclipse/ui/internal/intro/impl/presentations/TextIntroPartImplementation.java;1;4;6;1;6;3;6;0;44;0;0;276;46;46;4;0;3;0;6;312;3;312;3;1;0
/org.eclipse.ui.workbench/Eclipse UI/org/eclipse/ui/progress/IWorkbenchSiteProgressService.java;1;2;11;1;3;2;3;8;48;2;6;162;165;165;2;2;1;8;11;227;3;336;8;1;0
/org.eclipse.ui.cheatsheets/src/org/eclipse/ui/internal/cheatsheets/registry/Sorter.java;2;0;2;1;0;0;0;2;17;1;2;243;17;17;1;0;0;2;2;243;0;253;2;2;0
/org.eclipse.jdt.ui/ui/org/eclipse/jdt/ui/text/folding/IJavaFoldingPreferenceBlock.java;1;2;3;1;3;2;3;0;8;0;0;292;8;8;2;0;1;0;3;335;1;335;2;1;0
/org.eclipse.swt/Eclipse SWT PI/carbon/org/eclipse/swt/internal/carbon/RGBColor.java;1;0;2;1;2;1;2;0;20;0;0;296;20;20;2;0;1;0;2;296;1;296;1;1;0
/org.eclipse.jdt.junit/src/org/eclipse/jdt/internal/junit/util/Resources.java;2;1;2;1;2;2;2;0;4;0;0;292;6;6;1;0;0;0;2;292;0;336;2;2;0
/org.eclipse.swt/Eclipse SWT/common/org/eclipse/swt/internal/image/JPEGScanHeader.java;1;0;2;1;1;1;1;1;6;0;1;217;10;10;1;0;0;1;2;217;0;337;2;1;0
/org.eclipse.ui.workbench/Eclipse UI/org/eclipse/ui/internal/PartPluginAction.java;3;1;3;1;2;2;2;1;9;0;1;4;16;16;1;0;0;1;3;4;0;336;3;3;0
/org.eclipse.ui.forms/src/org/eclipse/ui/forms/widgets/ExpandableComposite.java;1;0;10;1;0;0;1;9;288;6;2;225;315;315;6;7;1;10;10;253;8;253;2;1;0
/org.eclipse.help.base/src/org/eclipse/help/internal/base/HelpBaseResources.java;1;1;4;1;2;2;2;2;96;0;1;105;104;104;2;1;0;2;4;105;1;336;3;1;0
/org.eclipse.jdt.core/compiler/org/eclipse/jdt/internal/compiler/problem/ProblemSeverities.java;1;0;1;1;0;0;0;1;2;0;1;199;2;2;1;0;0;1;1;199;0;199;1;1;0
/org.eclipse.update.ui/src/org/eclipse/update/internal/ui/wizards/EditSiteDialog.java;2;0;4;1;0;0;0;4;22;2;3;54;24;24;2;1;0;4;4;267;1;267;3;2;1
/org.eclipse.ui.ide/src/org/eclipse/ui/internal/ide/IDEWorkbenchAdvisor.java;9;6;34;5;12;4;15;19;342;13;5;166;1099;1099;13;14;11;22;34;253;25;336;9;9;2
/org.eclipse.core.expressions/src/org/eclipse/core/internal/expressions/NotExpression.java;1;0;2;1;1;1;1;1;8;0;1;227;8;8;1;0;0;1;2;227;0;336;2;1;0
/org.eclipse.jdt.core/eval/org/eclipse/jdt/internal/eval/CodeSnippetSuperReference.java;1;0;1;1;0;0;0;1;2;0;1;199;2;2;1;0;0;1;1;199;0;199;1;1;0
/org.eclipse.core.resources/src/org/eclipse/core/resources/refresh/RefreshProvider.java;2;0;4;2;3;1;3;1;47;0;1;205;47;47;3;0;2;1;4;273;2;273;2;2;0
/org.eclipse.osgi/osgi/src/org/osgi/framework/Bundle.java;6;2;10;2;4;3;4;6;283;2;4;171;458;458;2;2;1;6;10;224;3;321;7;6;0
/org.eclipse.search/new search/org/eclipse/search2/internal/ui/SearchDropDownAction.java;2;1;8;1;3;3;3;5;20;2;4;195;52;52;2;1;0;5;8;239;1;336;7;2;0
/org.eclipse.text/src/org/eclipse/jface/text/TypedPosition.java;1;0;1;1;1;1;1;0;17;0;0;334;17;17;1;0;0;0;1;334;0;334;1;1;0
/org.eclipse.ui.intro/src/org/eclipse/ui/internal/intro/impl/html/IntroHTMLGenerator.java;3;5;11;2;11;4;11;0;379;0;0;276;628;628;5;0;7;0;11;276;7;327;4;3;0
/org.eclipse.pde.ui/src/org/eclipse/pde/ui/templates/OptionTemplateWizardPage.java;3;2;8;1;6;4;6;2;45;1;2;145;123;123;2;0;2;2;8;276;2;336;6;3;0
/org.eclipse.osgi/osgi/src/org/osgi/framework/BundleListener.java;2;0;2;1;1;1;1;1;3;0;1;171;3;3;1;0;0;1;2;171;0;296;2;2;0
/org.eclipse.jdt.debug.ui/ui/org/eclipse/jdt/internal/debug/ui/launcher/AppletLaunchConfigurationUtils.java;3;1;7;1;4;4;4;3;30;1;3;14;52;52;1;0;0;3;7;14;0;336;7;3;0
/org.eclipse.core.runtime/src/org/eclipse/core/runtime/IRegistryChangeListener.java;3;2;5;1;3;2;3;2;43;0;1;177;57;57;2;1;1;2;5;177;2;336;3;3;0
/org.eclipse.jdt.ui/ui/org/eclipse/jdt/ui/actions/RefactorActionGroup.java;6;2;16;2;4;3;4;12;198;2;10;0;559;559;2;2;1;12;16;66;3;336;13;6;0
/org.eclipse.ui.workbench/Eclipse UI/org/eclipse/ui/internal/progress/SubTaskInfo.java;3;1;8;1;2;2;2;6;27;3;3;69;61;61;3;3;0;6;8;69;3;336;5;3;0
/org.eclipse.pde.ui/src_Forms/org/eclipse/pde/internal/ui/model/plugin/PluginObjectNode.java;3;6;14;3;8;2;10;4;216;4;2;244;371;371;6;2;8;6;14;295;10;331;4;3;0
/org.eclipse.team.cvs.core/src/org/eclipse/team/internal/ccvs/core/client/listeners/TagListener.java;1;0;1;1;0;0;0;1;3;0;1;176;3;3;1;0;0;1;1;176;0;176;1;1;1
/org.eclipse.ui.workbench/Eclipse UI/org/eclipse/ui/internal/dialogs/ImportWizard.java;5;0;10;2;1;1;1;9;141;3;6;116;282;282;3;3;0;9;10;174;3;336;7;5;1
/org.eclipse.ant.ui/Ant Tools Support/org/eclipse/ant/internal/ui/views/elements/TargetNode.java;1;0;3;1;1;1;1;2;6;1;2;108;10;10;1;0;0;2;3;108;0;336;3;1;1
/org.eclipse.pde.core/src/org/eclipse/pde/internal/core/ifeature/IFeature.java;2;0;2;1;1;1;1;1;28;0;1;232;32;32;1;0;0;1;2;232;0;309;2;2;0
/org.eclipse.debug.ui/ui/org/eclipse/debug/internal/ui/sourcelookup/BasicContainerContentProvider.java;1;0;1;1;0;0;0;1;0;0;1;209;0;0;1;0;0;1;1;209;0;209;1;1;0
/org.eclipse.jdt.core/codeassist/org/eclipse/jdt/internal/codeassist/SelectionEngine.java;5;2;20;2;3;2;3;17;284;4;11;5;582;582;4;6;1;17;20;111;7;324;13;5;5
/org.eclipse.swt/Eclipse SWT/win32/org/eclipse/swt/widgets/Sash.java;1;0;2;1;0;0;0;2;4;1;2;19;6;6;1;0;0;2;2;19;0;139;2;1;0
/org.eclipse.jdt.ui/core refactoring/org/eclipse/jdt/internal/corext/refactoring/reorg/ReorgPolicyFactory.java;5;11;36;3;15;4;15;21;310;5;8;70;1171;1171;11;13;11;21;36;275;24;336;12;5;2
/org.eclipse.swt/Eclipse SWT/photon/org/eclipse/swt/widgets/Label.java;2;0;3;1;0;0;0;3;29;1;3;19;38;38;1;0;0;3;3;19;0;189;3;2;0
/org.eclipse.pde.ui/src/org/eclipse/pde/internal/ui/wizards/templates/NewWizardTemplate.java;3;4;11;2;6;3;6;5;116;2;4;128;174;174;4;1;3;5;11;308;4;336;7;3;0
/org.eclipse.jdt.core/compiler/org/eclipse/jdt/internal/compiler/env/IGenericMethod.java;2;0;2;1;0;0;0;2;2;1;2;199;4;4;1;0;0;2;2;199;0;224;2;2;0
/org.eclipse.ant.ui/Ant Tools Support/org/eclipse/ant/internal/ui/model/AntUtil.java;2;1;19;2;2;2;2;17;125;6;7;108;389;389;6;10;0;17;19;118;10;311;9;2;1
/org.eclipse.jdt.ui/ui/org/eclipse/jdt/internal/ui/wizards/buildpaths/ClasspathContainerWizard.java;2;2;4;1;3;2;3;1;39;0;1;243;78;78;2;0;1;1;4;276;1;336;3;2;0
/org.eclipse.pde.ui/src_samples/org/eclipse/pde/ui/internal/samples/SampleStandbyContent.java;3;2;9;2;7;4;7;2;99;0;1;253;232;232;2;1;3;2;9;253;4;335;5;3;0
/org.eclipse.jdt.core/codeassist/org/eclipse/jdt/internal/codeassist/ISearchableNameEnvironment.java;1;0;1;1;0;0;0;1;2;0;1;199;2;2;1;0;0;1;1;199;0;199;1;1;0
/org.eclipse.jdt.debug/model/org/eclipse/jdt/internal/debug/core/logicalstructures/LogicalObjectStructureValue.java;2;0;2;1;0;0;0;2;4;1;2;152;4;4;1;0;0;2;2;152;0;171;2;2;1
/org.eclipse.pde.runtime/src/org/eclipse/pde/internal/runtime/registry/RegistryBrowserLabelProvider.java;2;1;11;1;2;2;2;9;151;8;2;59;179;179;8;7;0;9;11;219;7;336;4;2;0
/org.eclipse.jdt.junit/src/org/eclipse/jdt/internal/junit/refactoring/JUnitRenameParticipant.java;3;1;4;1;4;4;4;0;10;0;0;272;16;16;1;0;0;0;4;272;0;336;4;3;1
/org.eclipse.jdt.core/search/org/eclipse/jdt/internal/core/search/JavaSearchParticipant.java;2;1;6;1;3;3;3;3;83;1;3;181;127;127;1;0;0;3;6;181;0;302;6;2;0
/org.eclipse.swt/Eclipse SWT Mozilla/common/org/eclipse/swt/internal/mozilla/nsIMemory.java;1;0;2;1;0;0;0;2;4;1;2;100;4;4;1;0;0;2;2;100;0;148;2;1;0
/org.eclipse.jdt.ui/ui refactoring/org/eclipse/jdt/internal/ui/refactoring/nls/SourceFolderSelectionDialogButtonField.java;3;2;5;1;4;3;4;1;130;0;1;267;146;146;2;0;1;1;5;301;1;336;4;3;0
/org.eclipse.pde.ui/src/org/eclipse/pde/internal/ui/wizards/Category.java;2;1;2;1;2;2;2;0;8;0;0;308;12;12;1;0;0;0;2;308;0;336;2;2;0
/org.eclipse.osgi/eclipseAdaptor/src/org/eclipse/core/runtime/adaptor/EclipseAdaptor.java;6;4;52;5;7;2;21;31;424;20;5;171;1184;1184;20;26;19;45;52;256;45;324;7;6;3
/org.eclipse.jdt.core/search/org/eclipse/jdt/internal/core/index/DiskIndex.java;2;0;6;2;1;1;1;5;806;2;3;213;824;824;2;2;0;5;6;225;2;323;4;2;2
/org.eclipse.jdt.core/dom/org/eclipse/jdt/core/dom/Type.java;2;0;6;1;2;1;2;4;114;2;3;199;127;127;2;1;1;4;6;230;2;283;4;2;1
/org.eclipse.jface.text/src/org/eclipse/jface/text/source/ISourceViewerExtension2.java;2;0;3;1;1;1;1;2;13;1;2;219;20;20;1;0;0;2;3;219;0;337;3;2;0
/org.eclipse.jface.text/src/org/eclipse/jface/text/ITextViewerExtension3.java;2;2;4;2;3;2;3;1;19;0;1;257;39;39;2;0;1;1;4;331;1;331;3;2;0
/org.eclipse.jface.text/src/org/eclipse/jface/text/IInformationControlExtension.java;2;0;2;2;2;1;2;0;14;0;0;336;14;14;2;0;1;0;2;336;1;336;1;2;0
/org.eclipse.core.resources/src/org/eclipse/core/internal/resources/LocalMetaArea.java;2;1;6;1;4;4;4;2;598;1;2;169;638;638;1;0;0;2;6;169;0;329;6;2;0
/org.eclipse.jdt.core/search/org/eclipse/jdt/internal/core/search/matching/PackageReferencePattern.java;2;0;17;2;3;1;3;14;476;3;9;52;917;917;3;5;2;14;17;225;7;280;10;2;0
/org.eclipse.jdt.core/model/org/eclipse/jdt/internal/core/util/RecordedParsingInformation.java;2;0;2;2;0;0;0;2;16;0;1;214;16;16;2;1;0;2;2;214;1;214;1;2;0
/org.eclipse.debug.ui/ui/org/eclipse/debug/internal/ui/actions/CollapseAllAction.java;1;0;1;1;0;0;0;1;3;0;1;62;3;3;1;0;0;1;1;62;0;62;1;1;0
/org.eclipse.ui.console/src/org/eclipse/ui/console/ConsolePlugin.java;2;0;4;2;1;1;1;3;21;0;1;118;29;29;3;2;0;3;4;118;2;294;2;2;0
/org.eclipse.jdt.core/model/org/eclipse/jdt/core/util/IExceptionAttribute.java;1;0;1;1;0;0;0;1;2;0;1;199;2;2;1;0;0;1;1;199;0;199;1;1;0
/org.eclipse.team.cvs.core/src/org/eclipse/team/internal/ccvs/core/CVSSyncInfo.java;2;0;17;2;1;1;1;16;329;4;9;34;577;577;4;7;0;16;17;177;7;336;10;2;0
/org.eclipse.core.filebuffers/src/org/eclipse/core/internal/filebuffers/FileBuffersMessages.java;1;2;3;1;3;2;3;0;6;0;0;287;8;8;2;0;1;0;3;287;1;336;2;1;0
/org.eclipse.jdt.core/compiler/org/eclipse/jdt/internal/compiler/IDebugRequestor.java;1;0;1;1;0;0;0;1;2;0;1;199;2;2;1;0;0;1;1;199;0;199;1;1;0
/org.eclipse.jdt.ui/ui/org/eclipse/jdt/internal/ui/packageview/PackageExplorerElementComparer.java;1;0;1;1;1;1;1;0;2;0;0;336;2;2;1;0;0;0;1;336;0;336;1;1;0
/org.eclipse.compare/compare/org/eclipse/compare/ZipFileStructureCreator.java;1;0;7;1;1;1;1;6;13;3;4;79;41;41;3;2;0;6;7;219;2;280;5;1;0
/org.eclipse.jdt.debug.ui/ui/org/eclipse/jdt/internal/debug/ui/IJDIPreferencesConstants.java;4;1;7;1;2;2;2;5;10;1;5;148;54;54;1;0;0;5;7;148;0;336;7;4;0
/org.eclipse.jdt.junit/src/org/eclipse/jdt/internal/junit/ui/IJUnitPreferencesConstants.java;1;0;1;1;1;1;1;0;2;0;0;336;2;2;1;0;0;0;1;336;0;336;1;1;0
/org.eclipse.jdt.launching/launching/org/eclipse/jdt/launching/sourcelookup/containers/ClasspathContainerSourceContainer.java;2;0;4;2;2;1;3;1;7;0;1;269;11;11;2;0;2;2;4;269;2;296;2;2;0
/org.eclipse.jdt.core/model/org/eclipse/jdt/internal/core/SortElementBuilder.java;5;2;13;2;3;2;3;10;64;2;9;5;124;124;2;1;1;10;13;5;2;314;11;5;2
/org.eclipse.help.ui/src/org/eclipse/help/ui/internal/HelpUIEventLoop.java;1;2;4;1;4;3;4;0;30;0;0;294;60;60;2;0;1;0;4;294;1;336;3;1;0
/org.eclipse.compare/compare/org/eclipse/compare/internal/CompareDialog.java;1;0;1;1;0;0;0;1;2;0;1;79;2;2;1;0;0;1;1;79;0;79;1;1;0
/org.eclipse.jface.text/src/org/eclipse/jface/text/source/IAnnotationPresentation.java;3;2;6;2;3;2;3;3;7;2;2;181;16;16;2;1;1;3;6;181;2;336;4;3;0
/org.eclipse.pde.ui/src/org/eclipse/pde/internal/ui/editor/schema/SchemaEditorContributor.java;2;1;3;1;3;3;3;0;5;0;0;292;13;13;1;0;0;0;3;292;0;336;3;2;0
/org.eclipse.jdt.ui/ui/org/eclipse/jdt/internal/ui/search/SearchViewSiteAdapter.java;2;1;5;1;2;2;2;3;20;2;2;82;32;32;2;1;0;3;5;162;1;336;4;2;0
/org.eclipse.debug.ui/ui/org/eclipse/debug/internal/ui/views/expression/ExpressionPopupContentProvider.java;1;0;1;1;0;0;0;1;0;0;1;212;0;0;1;0;0;1;1;212;0;212;1;1;0
/org.eclipse.debug.ui/ui/org/eclipse/debug/internal/ui/IInternalDebugUIConstants.java;4;2;23;3;4;3;4;19;120;4;8;42;226;226;4;11;1;19;23;42;12;308;11;4;2
/org.eclipse.ant.ui/Ant Editor/org/eclipse/ant/internal/ui/editor/outline/LocationProvider.java;1;0;3;1;1;1;1;2;24;1;2;108;45;45;1;0;0;2;3;108;0;273;3;1;1
/org.eclipse.swt/Eclipse SWT PI/gtk/org/eclipse/swt/internal/gtk/PangoLayoutLine.java;2;0;2;1;1;1;1;1;2;0;1;250;2;2;1;0;0;1;2;250;0;337;2;2;0
/org.eclipse.ui.editors/src/org/eclipse/ui/texteditor/BasicMarkerUpdater.java;2;1;4;1;2;2;2;2;98;1;2;118;106;106;1;0;0;2;4;118;0;336;4;2;0
/org.eclipse.ui.ide/src/org/eclipse/ui/views/tasklist/DefaultTaskListResourceAdapter.java;1;0;1;1;0;0;0;1;0;0;1;129;0;0;1;0;0;1;1;129;0;129;1;1;0
/org.eclipse.update.core/src/org/eclipse/update/core/model/CategoryModel.java;2;2;4;1;3;2;3;1;8;0;1;58;19;19;2;0;1;1;4;289;1;336;3;2;0
/org.eclipse.jdt.junit/src/org/eclipse/jdt/internal/junit/ui/ShowNextFailureAction.java;3;0;3;1;1;1;1;2;2;1;2;35;4;4;1;0;0;2;3;35;0;336;3;3;0
/org.eclipse.jdt.ui/ui/org/eclipse/jdt/internal/ui/dialogs/ProblemDialog.java;2;2;3;1;3;2;3;0;14;0;0;300;16;16;2;0;1;0;3;300;1;336;2;2;0
/org.eclipse.help/src/org/eclipse/help/internal/toc/Toc.java;1;1;11;1;3;3;3;8;178;5;2;41;397;397;5;6;0;8;11;197;6;336;5;1;0
/org.eclipse.ui.externaltools/External Tools Base/org/eclipse/ui/externaltools/internal/model/IExternalToolConstants.java;2;0;14;2;0;0;0;14;243;5;8;4;312;312;5;6;0;14;14;18;6;165;8;2;0
/org.eclipse.swt/Eclipse SWT PI/gtk/org/eclipse/swt/internal/gtk/GdkColor.java;3;0;3;1;1;1;1;2;17;1;2;100;21;21;1;0;0;2;3;100;0;337;3;3;0
/org.eclipse.ui.externaltools/External Tools Base/org/eclipse/ui/externaltools/internal/variables/BuildProjectResolver.java;1;0;1;1;0;0;0;1;0;0;1;269;0;0;1;0;0;1;1;269;0;269;1;1;0
/org.eclipse.update.core/src/org/eclipse/update/internal/operations/RevertConfigurationOperation.java;1;0;6;1;1;1;1;5;4;1;5;54;12;12;1;0;0;5;6;54;0;336;6;1;0
/org.eclipse.pde.ui/src/org/eclipse/pde/internal/ui/editor/schema/SchemaSpecSection.java;3;3;6;2;5;3;5;1;218;0;1;26;248;248;3;0;2;1;6;302;2;336;4;3;0
/org.eclipse.ltk.core.refactoring/src/org/eclipse/ltk/core/refactoring/participants/MoveRefactoring.java;1;1;4;1;2;2;2;2;21;0;1;264;26;26;2;1;0;2;4;264;1;336;3;1;0
/org.eclipse.jdt.ui/ui/org/eclipse/jdt/internal/ui/wizards/buildpaths/CPListLabelProvider.java;2;1;6;1;2;2;2;4;22;1;4;192;70;70;1;0;0;4;6;192;0;336;6;2;0
/org.eclipse.jdt.ui/ui/org/eclipse/jdt/internal/ui/text/JavaCommentScanner.java;2;3;9;1;5;3;5;4;201;2;3;82;412;412;3;1;2;4;9;310;3;336;6;2;1
/org.eclipse.jface/src/org/eclipse/jface/resource/JFaceResources.java;2;0;4;1;1;1;1;3;527;1;3;181;571;571;1;0;0;3;4;181;0;336;4;2;0
/org.eclipse.search/search/org/eclipse/search/internal/ui/ShowNextResultAction.java;1;0;2;1;1;1;1;1;2;0;1;100;3;3;1;0;0;1;2;100;0;336;2;1;0
/org.eclipse.ui.ide/src/org/eclipse/ui/views/markers/internal/DialogMarkerProperties.java;3;1;3;1;2;2;2;1;92;0;1;129;94;94;1;0;0;1;3;129;0;336;3;3;1
/org.eclipse.ui.workbench/Eclipse UI/org/eclipse/ui/actions/OpenInNewWindowAction.java;2;0;2;1;0;0;0;2;38;1;2;157;40;40;1;0;0;2;2;157;0;188;2;2;0
/org.eclipse.pde.ui/src/org/eclipse/pde/internal/ui/editor/plugin/JarSelectionValidator.java;2;1;3;1;3;3;3;0;10;0;0;292;14;14;1;0;0;0;3;292;0;336;3;2;0
/org.eclipse.jdt.ui/ui/org/eclipse/jdt/internal/ui/jarpackager/ContainerFilter.java;1;0;1;1;1;1;1;0;2;0;0;336;2;2;1;0;0;0;1;336;0;336;1;1;0
/org.eclipse.ui.workbench/Eclipse UI/org/eclipse/ui/IViewSite.java;2;1;3;1;2;2;2;1;12;0;1;212;16;16;1;0;0;1;3;212;0;336;3;2;0
/org.eclipse.osgi/defaultAdaptor/src/org/eclipse/osgi/framework/internal/protocol/reference/ReferenceURLConnection.java;4;2;6;2;3;2;3;3;157;1;3;171;223;223;2;0;1;3;6;295;1;295;5;4;1
/org.eclipse.jdt.core/dom/org/eclipse/jdt/core/dom/CatchClause.java;4;0;9;1;2;1;2;7;112;2;6;199;164;164;2;1;1;7;9;266;2;276;7;4;1
/org.eclipse.jdt.core/formatter/org/eclipse/jdt/internal/formatter/CascadingMethodInvocationFragmentBuilder.java;3;0;4;1;0;0;0;4;16;2;3;137;28;28;2;1;0;4;4;137;1;199;3;3;0
/org.eclipse.pde.ui/src/org/eclipse/pde/internal/ui/editor/schema/EnumerationRestrictionPage.java;2;1;2;1;2;2;2;0;10;0;0;308;14;14;1;0;0;0;2;308;0;336;2;2;0
/org.eclipse.debug.ui/ui/org/eclipse/debug/internal/ui/views/console/WorkspaceOperationRunner.java;2;1;2;1;2;2;2;0;4;0;0;279;4;4;1;0;0;0;2;279;0;336;2;2;1
/org.eclipse.swt/Eclipse SWT/motif/org/eclipse/swt/widgets/DirectoryDialog.java;3;1;7;1;2;2;2;5;29;3;3;19;71;71;3;2;0;5;7;156;2;337;5;3;0
/org.eclipse.pde.ui/src/org/eclipse/pde/internal/ui/launcher/BasicLauncherTab.java;3;2;20;2;4;3;4;16;682;3;10;26;1533;1533;3;6;1;16;20;41;7;336;13;3;0
/org.eclipse.core.variables/src/org/eclipse/core/variables/VariablesPlugin.java;4;1;6;1;2;2;2;4;35;2;3;133;61;61;2;1;0;4;6;145;1;336;5;4;0
/org.eclipse.ui.workbench.texteditor/src/org/eclipse/ui/texteditor/SourceViewerDecorationSupport.java;4;3;17;3;4;2;5;12;267;3;7;82;542;542;3;5;3;13;17;158;8;336;9;4;1
/org.eclipse.swt/Eclipse SWT PI/motif/org/eclipse/swt/internal/motif/XClientMessageEvent.java;1;0;1;1;0;0;0;1;0;0;1;88;0;0;1;0;0;1;1;88;0;88;1;1;0
/org.eclipse.jdt.ui/ui/org/eclipse/jdt/internal/ui/javaeditor/ClipboardOperationAction.java;1;2;6;1;6;4;6;0;80;0;0;292;163;163;2;0;2;0;6;292;2;325;4;1;2
/org.eclipse.ui.cheatsheets/src/org/eclipse/ui/internal/cheatsheets/dialogs/CheatSheetCategoryBasedSelectionDialog.java;2;0;4;1;1;1;1;3;17;1;3;243;35;35;1;0;0;3;4;243;0;306;4;2;0
/org.eclipse.debug.ui/ui/org/eclipse/debug/internal/ui/SWTUtil.java;1;0;1;1;0;0;0;1;5;0;1;38;5;5;1;0;0;1;1;38;0;38;1;1;0
/org.eclipse.swt.tools/JNI Generation/org/eclipse/swt/tools/internal/ClassData.java;1;0;1;1;0;0;0;1;0;0;1;230;0;0;1;0;0;1;1;230;0;230;1;1;0
/org.eclipse.jdt.ui/ui/org/eclipse/jdt/internal/ui/text/JavaOutlineInformationControl.java;4;2;23;2;4;2;4;19;669;5;8;9;1911;1911;5;11;2;19;23;220;13;331;10;4;0
/org.eclipse.ui.workbench/Eclipse UI/org/eclipse/ui/internal/activities/MutableActivityManager.java;5;3;20;4;4;2;4;16;1158;12;4;160;1330;1330;12;12;2;16;20;160;14;336;6;5;0
/org.eclipse.pde.runtime/src/org/eclipse/pde/internal/runtime/registry/RegistryBrowser.java;2;2;15;2;3;2;3;12;1293;7;3;55;1393;1393;7;9;1;12;15;219;10;336;5;2;0
/org.eclipse.jdt.debug.ui/ui/org/eclipse/jdt/internal/debug/ui/jres/StandardVMCommandTab.java;3;2;4;2;3;2;3;1;58;0;1;71;62;62;2;0;1;1;4;296;1;336;3;3;0
/org.eclipse.core.runtime/src/org/eclipse/core/runtime/IExtensionPoint.java;4;2;10;1;4;3;4;6;171;2;5;171;275;275;2;1;1;6;10;179;2;337;8;4;0
/org.eclipse.ui.workbench/Eclipse UI/org/eclipse/ui/internal/dialogs/WorkingSetNewWizard.java;2;0;2;1;1;1;1;1;2;0;1;269;4;4;1;0;0;1;2;269;0;336;2;2;1
/org.eclipse.team.cvs.core/src/org/eclipse/team/internal/ccvs/core/client/UpdateWithOverwrite.java;1;0;1;1;0;0;0;1;0;0;1;177;0;0;1;0;0;1;1;177;0;177;1;1;0
/org.eclipse.jdt.ui/ui/org/eclipse/jdt/internal/ui/text/ITypingRunListener.java;2;1;2;1;2;2;2;0;8;0;0;281;8;8;1;0;0;0;2;281;0;336;2;2;0
/org.eclipse.pde.ui/src_Forms/org/eclipse/pde/internal/ui/model/plugin/PluginDocumentNode.java;3;3;11;3;4;2;6;5;210;6;2;250;241;241;6;3;4;7;11;259;7;336;4;3;0
/org.eclipse.debug.core/core/org/eclipse/debug/internal/core/LaunchConfigurationInfo.java;3;1;8;1;2;2;2;6;101;2;5;62;161;161;2;1;0;6;8;182;1;336;7;3;0
/org.eclipse.ltk.core.refactoring/src/org/eclipse/ltk/core/refactoring/participants/RenameParticipant.java;1;2;5;1;3;2;3;2;20;0;1;264;40;40;2;1;1;2;5;264;2;336;3;1;0
/org.eclipse.update.core/src/org/eclipse/update/internal/operations/BatchInstallOperation.java;2;2;12;2;3;2;3;9;15;2;6;54;56;56;2;3;1;9;12;54;4;336;8;2;0
/org.eclipse.ant.ui/Ant Tools Support/org/eclipse/ant/internal/ui/preferences/ColorEditor.java;1;0;1;1;0;0;0;1;0;0;1;108;0;0;1;0;0;1;1;108;0;108;1;1;0
/org.eclipse.osgi/eclipseAdaptor/src/org/eclipse/core/runtime/adaptor/EclipseAdaptorMsg.java;4;3;9;3;7;4;7;2;46;1;2;209;96;96;3;0;3;2;9;272;3;326;6;4;0
/org.eclipse.jdt.core/dom/org/eclipse/jdt/core/dom/AnnotationTypeDeclaration.java;2;0;9;1;2;1;2;7;285;4;3;225;311;311;4;4;1;7;9;225;5;283;4;2;2
/org.eclipse.jdt.core/search/org/eclipse/jdt/internal/core/search/PatternSearchJob.java;3;2;10;1;4;2;4;6;218;1;6;80;378;378;2;0;2;6;10;273;2;302;8;3;0
/org.eclipse.jdt.ui/ui/org/eclipse/jdt/internal/ui/callhierarchy/SearchScopeWorkspaceAction.java;2;2;4;1;3;2;3;1;12;0;1;224;14;14;2;0;1;1;4;293;1;336;3;2;0
/org.eclipse.team.cvs.ui/src/org/eclipse/team/internal/ccvs/ui/wizards/UpdateWizard.java;2;1;6;1;4;4;4;2;105;1;2;56;135;135;1;0;0;2;6;56;0;336;6;2;0
/org.eclipse.jdt.core/codeassist/org/eclipse/jdt/internal/codeassist/select/SelectionOnQualifiedTypeReference.java;2;0;2;1;0;0;0;2;13;1;2;63;15;15;1;0;0;2;2;63;0;199;2;2;1
/org.eclipse.pde.core/src/org/eclipse/pde/internal/core/ischema/ISchemaInclude.java;2;1;3;1;2;2;2;1;6;0;1;232;10;10;1;0;0;1;3;232;0;336;3;2;0
/org.eclipse.jdt.debug/jdi interfaces/com/sun/jdi/Method.java;1;0;1;1;0;0;0;1;4;0;1;235;4;4;1;0;0;1;1;235;0;235;1;1;0
/org.eclipse.ui.workbench/Eclipse UI/org/eclipse/ui/internal/ActiveEditorAction.java;1;0;1;1;0;0;0;1;40;0;1;157;40;40;1;0;0;1;1;157;0;157;1;1;0
/org.eclipse.jface.text/src/org/eclipse/jface/text/rules/RuleBasedPartitioner.java;4;2;5;2;4;2;4;1;118;0;1;93;197;197;2;0;2;1;5;274;2;336;3;4;0
/org.eclipse.jdt.ui/ui refactoring/org/eclipse/jdt/internal/ui/refactoring/PullUpWizard.java;5;0;12;2;1;1;3;9;1323;3;8;36;1448;1448;3;1;2;11;12;269;3;336;9;5;2
/org.eclipse.team.ui/src/org/eclipse/team/ui/synchronize/ISynchronizePage.java;2;1;3;1;3;3;3;0;59;0;0;272;89;89;1;0;0;0;3;272;0;326;3;2;0
/org.eclipse.swt/Eclipse SWT PI/photon/org/eclipse/swt/internal/photon/PhRegion_t.java;1;0;1;1;0;0;0;1;1;0;1;53;1;1;1;0;0;1;1;53;0;53;1;1;0
/org.eclipse.jdt.debug/model/org/eclipse/jdt/internal/debug/core/model/JDIArrayType.java;2;0;3;1;0;0;0;3;17;2;2;78;19;19;2;1;0;3;3;128;1;128;2;2;0
/org.eclipse.jdt.core/model/org/eclipse/jdt/internal/core/Openable.java;3;1;27;3;2;2;2;25;445;12;10;7;628;628;12;15;0;25;27;51;15;314;12;3;0
/org.eclipse.pde.ui/src/org/eclipse/pde/ui/IFragmentFieldData.java;2;3;6;1;5;3;5;1;42;0;1;222;85;85;3;0;2;1;6;276;2;336;4;2;0
/org.eclipse.ui.workbench/Eclipse UI/org/eclipse/ui/internal/commands/ws/CommandContributionItem.java;3;3;6;1;4;2;4;2;141;0;1;267;154;154;3;1;2;2;6;281;3;336;3;3;1
/org.eclipse.jdt.core/model/org/eclipse/jdt/internal/core/builder/StringSet.java;2;0;4;1;1;1;1;3;11;2;2;159;21;21;2;1;0;3;4;159;1;309;3;2;0
/org.eclipse.jdt.debug/jdi/org/eclipse/jdi/internal/ReferenceTypeImpl.java;3;0;9;3;0;0;0;9;860;4;5;39;1015;1015;4;4;0;9;9;39;4;235;5;3;1
/org.eclipse.ant.ui/Remote Ant Support/org/eclipse/ant/internal/ui/antsupport/AntSecurityManager.java;1;0;1;1;0;0;0;1;0;0;1;108;0;0;1;0;0;1;1;108;0;108;1;1;0
/org.eclipse.ui.workbench/Eclipse UI/org/eclipse/ui/internal/ObjectPluginAction.java;2;1;2;1;2;2;2;0;4;0;0;286;6;6;1;0;0;0;2;286;0;336;2;2;0
/org.eclipse.jdt.ui/ui/org/eclipse/jdt/internal/ui/wizards/JavaProjectWizard.java;2;1;8;1;2;2;2;6;39;4;3;212;67;67;4;3;0;6;8;220;3;336;5;2;0
/org.eclipse.jdt.ui/core refactoring/org/eclipse/jdt/internal/corext/refactoring/structure/UseSupertypeWherePossibleRefactoring.java;3;1;14;2;3;3;3;11;117;3;7;73;176;176;3;4;0;11;14;73;4;336;10;3;0
/org.eclipse.pde.core/src/org/eclipse/pde/internal/core/plugin/AbstractExtensionsModel.java;3;1;12;2;3;3;3;9;53;3;6;128;104;104;3;3;0;9;12;166;3;336;9;3;0
/org.eclipse.jdt.core/search/org/eclipse/jdt/internal/core/search/matching/PackageDeclarationLocator.java;3;0;2;2;0;0;0;2;2;1;2;118;4;4;1;0;0;2;2;118;0;199;2;3;0
/org.eclipse.swt/Eclipse SWT PI/carbon/org/eclipse/swt/internal/carbon/BitMap.java;1;0;2;1;2;1;2;0;20;0;0;296;20;20;2;0;1;0;2;296;1;296;1;1;0
/org.eclipse.pde.ui/src/org/eclipse/pde/internal/ui/editor/schema/NewAttributeAction.java;2;1;2;1;2;2;2;0;12;0;0;308;16;16;1;0;0;0;2;308;0;336;2;2;0
/org.eclipse.jdt.debug.ui/ui/org/eclipse/jdt/internal/debug/ui/classpath/AbstractClasspathEntry.java;1;0;1;1;0;0;0;1;0;0;1;154;0;0;1;0;0;1;1;154;0;154;1;1;0
/org.eclipse.jdt.core/model/org/eclipse/jdt/internal/core/builder/SourceFile.java;3;0;5;1;0;0;0;5;40;2;4;156;52;52;2;1;0;5;5;258;1;258;4;3;0
/org.eclipse.ant.ui/Ant Editor/org/eclipse/ant/internal/ui/dtd/Parser.java;1;0;5;1;0;0;0;5;33;2;4;108;39;39;2;1;0;5;5;135;1;211;4;1;0
/org.eclipse.osgi/eclipseAdaptor/src/org/eclipse/core/runtime/adaptor/IModel.java;3;2;5;2;4;3;4;1;4;0;1;183;10;10;2;0;1;1;5;272;1;336;4;3;0
/org.eclipse.search/search/org/eclipse/search/internal/ui/text/FileMatch.java;1;0;1;1;0;0;0;1;0;0;1;224;0;0;1;0;0;1;1;224;0;224;1;1;0
/org.eclipse.update.ui/src/org/eclipse/update/internal/ui/preferences/UpdateSettingsPreferencePage.java;3;1;5;2;2;2;2;3;25;0;1;54;32;32;3;2;0;3;5;54;2;336;3;3;0
/org.eclipse.ui.ide/src/org/eclipse/ui/views/markers/internal/ActionResolveMarker.java;3;1;3;1;2;2;2;1;4;0;1;129;6;6;1;0;0;1;3;129;0;336;3;3;0
/org.eclipse.ltk.ui.refactoring/src/org/eclipse/ltk/internal/ui/refactoring/PseudoJavaChangeElement.java;1;3;6;1;4;2;4;2;20;0;1;269;34;34;3;1;2;2;6;289;3;336;3;1;0
/org.eclipse.ant.ui/Ant Tools Support/org/eclipse/ant/internal/ui/model/IAntUIPreferenceConstants.java;2;0;11;2;0;0;0;11;37;4;5;108;68;68;4;6;0;11;11;108;6;239;5;2;1
/org.eclipse.swt/Eclipse SWT PI/win32/org/eclipse/swt/internal/ole/win32/COM.java;3;3;9;2;5;3;5;4;10;2;3;131;36;36;3;1;2;4;9;280;3;337;6;3;0
/org.eclipse.jdt.core/compiler/org/eclipse/jdt/core/compiler/InvalidInputException.java;1;0;1;1;0;0;0;1;2;0;1;199;2;2;1;0;0;1;1;199;0;199;1;1;0
/org.eclipse.swt/Eclipse SWT/win32/org/eclipse/swt/widgets/Scale.java;3;1;4;1;2;2;2;2;28;1;2;155;54;54;1;0;0;2;4;155;0;337;4;3;0
/org.eclipse.jdt.core/model/org/eclipse/jdt/internal/core/util/LineNumberAttribute.java;1;0;1;1;0;0;0;1;2;0;1;199;2;2;1;0;0;1;1;199;0;199;1;1;0
/org.eclipse.swt/Eclipse SWT AWT/motif/org/eclipse/swt/awt/SWT_AWT.java;4;2;11;2;8;4;8;3;67;1;3;171;182;182;2;0;4;3;11;279;4;334;7;4;3
/org.eclipse.debug.ui/ui/org/eclipse/debug/internal/ui/views/memory/ITableMemoryViewTab.java;1;0;1;1;1;1;1;0;0;0;0;282;0;0;1;0;0;0;1;282;0;282;1;1;0
/org.eclipse.core.resources/src/org/eclipse/core/internal/utils/EmptyEnumeration.java;1;0;2;1;2;1;2;0;59;0;0;275;59;59;2;0;1;0;2;275;1;275;1;1;0
/org.eclipse.ui.workbench/Eclipse UI/org/eclipse/ui/contexts/EnabledSubmission.java;2;1;9;1;2;2;2;7;193;4;3;227;540;540;4;4;0;7;9;227;4;306;5;2;0
/org.eclipse.core.runtime.compatibility/src-model/org/eclipse/core/runtime/model/URLModel.java;3;1;5;1;3;3;3;2;10;1;2;171;19;19;1;0;0;2;5;171;0;336;5;3;0
/org.eclipse.osgi/core/framework/org/eclipse/osgi/framework/internal/core/AliasMapper.java;4;1;7;1;3;3;3;4;305;1;4;171;386;386;1;0;0;4;7;171;0;336;7;4;0
/org.eclipse.core.resources/src/org/eclipse/core/internal/events/DeltaFilter.java;1;0;1;1;1;1;1;0;40;0;0;277;40;40;1;0;0;0;1;277;0;277;1;1;0
/org.eclipse.swt/Eclipse SWT Mozilla/common/org/eclipse/swt/internal/mozilla/nsIWidget.java;1;0;2;1;0;0;0;2;3;1;2;102;3;3;1;0;0;2;2;102;0;156;2;1;0
/org.eclipse.help/src/org/eclipse/help/internal/RuntimeHelpStatus.java;1;1;5;1;3;3;3;2;131;1;2;107;198;198;1;0;0;2;5;107;0;336;5;1;0
/org.eclipse.pde.core/src/org/eclipse/pde/core/build/IBuildModelFactory.java;2;1;2;1;2;2;2;0;12;0;0;276;16;16;1;0;0;0;2;276;0;336;2;2;0
/org.eclipse.jdt.core/dom/org/eclipse/jdt/core/dom/EnumDeclaration.java;3;2;12;2;3;2;4;8;347;5;3;225;386;386;5;5;2;9;12;225;7;324;5;3;3
/org.eclipse.osgi/osgi/src/org/osgi/service/startlevel/StartLevel.java;2;0;2;1;1;1;1;1;3;0;1;171;3;3;1;0;0;1;2;171;0;296;2;2;0
/org.eclipse.compare/compare/org/eclipse/compare/contentmergeviewer/ContentMergeViewer.java;1;0;3;1;0;0;0;3;66;1;3;79;76;76;1;0;0;3;3;79;0;243;3;1;1
/org.eclipse.ui.ide/src/org/eclipse/ui/views/markers/internal/MarkerFilter.java;5;1;8;1;3;3;3;5;378;2;3;129;410;410;2;2;0;5;8;129;2;336;6;5;1
/org.eclipse.osgi/resolver/src/org/eclipse/osgi/internal/resolver/Eclipse21SelectionPolicy.java;4;2;4;2;3;2;3;1;51;0;1;171;55;55;2;0;1;1;4;276;1;290;3;4;0
/org.eclipse.jdt.ui/ui/org/eclipse/jdt/ui/CodeGeneration.java;1;0;6;1;1;1;1;5;67;1;5;45;194;194;1;0;0;5;6;45;0;336;6;1;0
/org.eclipse.jdt.ui/core refactoring/org/eclipse/jdt/internal/corext/refactoring/nls/NLSScanner.java;3;1;4;1;2;2;2;2;58;1;2;89;79;79;1;0;0;2;4;89;0;336;4;3;0
/org.eclipse.jface/src/org/eclipse/jface/dialogs/ProgressIndicator.java;1;0;3;1;1;1;1;2;52;0;1;269;101;101;2;1;0;2;3;269;1;293;2;1;0
/org.eclipse.ui.workbench/Eclipse UI/org/eclipse/ui/IWorkingSet.java;1;0;1;1;0;0;0;1;6;0;1;181;6;6;1;0;0;1;1;181;0;181;1;1;1
/org.eclipse.ui.ide/src/org/eclipse/ui/internal/ide/IDEInternalPreferences.java;5;2;6;2;4;3;4;2;11;1;2;101;18;18;2;0;1;2;6;289;1;336;5;5;0
/org.eclipse.pde.core/src/org/eclipse/pde/internal/core/SourceAttachmentManager.java;2;1;3;1;2;2;2;1;16;0;1;232;26;26;1;0;0;1;3;232;0;336;3;2;0
/org.eclipse.pde.ui/src/org/eclipse/pde/internal/ui/launcher/TracingPropertySource.java;2;1;5;1;3;3;3;2;323;1;2;184;614;614;1;0;0;2;5;184;0;336;5;2;0
/org.eclipse.jface.text/src/org/eclipse/jface/text/contentassist/AdditionalInfoController.java;3;2;7;1;3;2;3;4;44;1;4;52;88;88;2;0;1;4;7;336;1;336;6;3;0
/org.eclipse.swt/Eclipse SWT PI/photon/org/eclipse/swt/internal/photon/PhClipHeader.java;1;0;2;1;0;0;0;2;12;0;1;53;12;12;2;1;0;2;2;53;1;53;1;1;0
/org.eclipse.jdt.ui/core refactoring/org/eclipse/jdt/internal/corext/refactoring/util/ResourceUtil.java;3;0;4;2;1;1;1;3;4;2;2;123;9;9;2;1;0;3;4;123;1;336;3;3;0
/org.eclipse.swt/Eclipse SWT PI/win32/org/eclipse/swt/internal/win32/MARGINS.java;2;1;2;1;2;2;2;0;4;0;0;276;4;4;1;0;0;0;2;276;0;337;2;2;0
/org.eclipse.jdt.ui/ui/org/eclipse/jdt/internal/ui/preferences/MockupPreferenceStore.java;1;0;2;1;0;0;0;2;136;0;1;228;136;136;2;1;0;2;2;228;1;228;1;1;0
/org.eclipse.team.cvs.ui/src/org/eclipse/team/internal/ccvs/ui/actions/ShowEditorsAction.java;1;0;2;1;1;1;1;1;9;0;1;71;16;16;1;0;0;1;2;71;0;292;2;1;0
/org.eclipse.compare/compare/org/eclipse/compare/IStreamMerger.java;1;3;4;1;4;2;4;0;5;0;0;278;7;7;3;0;2;0;4;278;2;335;2;1;0
/org.eclipse.ui.ide/extensions/org/eclipse/ui/ICapabilityInstallWizard.java;1;0;1;1;0;0;0;1;0;0;1;132;0;0;1;0;0;1;1;132;0;132;1;1;0
/org.eclipse.jdt.ui/ui/org/eclipse/jdt/internal/ui/jarpackager/JarPackagerMessages.java;1;0;1;1;1;1;1;0;2;0;0;336;2;2;1;0;0;0;1;336;0;336;1;1;0
/org.eclipse.jdt.core/search/org/eclipse/jdt/internal/core/search/matching/JavaSearchNameEnvironment.java;2;0;8;1;1;1;1;7;50;2;5;6;132;132;2;2;0;7;8;6;2;289;6;2;0
/org.eclipse.pde.ui/src/org/eclipse/pde/internal/ui/wizards/exports/PluginExportWizard.java;2;2;15;2;4;3;4;11;121;2;8;7;317;317;2;3;1;11;15;44;4;336;11;2;0
/org.eclipse.ui.workbench/Eclipse UI/org/eclipse/ui/internal/misc/TestPartListener.java;1;0;1;1;0;0;0;1;1;0;1;157;1;1;1;0;0;1;1;157;0;157;1;1;0
/org.eclipse.pde.ui/src/org/eclipse/pde/internal/ui/launcher/ILauncherSettings.java;2;2;16;2;4;3;4;12;47;3;7;41;104;104;3;5;1;12;16;41;6;336;10;2;0
/org.eclipse.text/src/org/eclipse/jface/text/source/IAnnotationModelListener.java;1;1;3;1;2;2;2;1;31;0;1;131;56;56;1;0;0;1;3;131;0;334;3;1;0
/org.eclipse.ui.ide/extensions/org/eclipse/ui/dialogs/ResourceSelectionDialog.java;1;0;2;1;0;0;0;2;3;1;2;132;3;3;1;0;0;2;2;132;0;150;2;1;0
/org.eclipse.jdt.ui/ui/org/eclipse/jdt/ui/JavaUI.java;5;1;6;2;2;2;2;4;54;1;4;96;144;144;1;0;0;4;6;96;0;336;6;5;0
/org.eclipse.jdt.ui/ui/org/eclipse/jdt/internal/ui/browsing/MembersView.java;2;0;5;1;1;1;1;4;15;1;4;39;24;24;1;0;0;4;5;39;0;336;5;2;0
/org.eclipse.compare/compare/org/eclipse/compare/internal/patch/CompareWithPatchAction.java;1;0;4;1;0;0;0;4;20;1;4;19;28;28;1;0;0;4;4;19;0;219;4;1;0
/org.eclipse.ui.workbench.texteditor/src/org/eclipse/ui/texteditor/ITextEditorActionConstants.java;3;2;9;2;3;2;3;6;118;1;6;31;238;238;2;0;1;6;9;334;1;334;8;3;0
/org.eclipse.swt/Eclipse SWT Mozilla/common/org/eclipse/swt/internal/mozilla/nsIWebBrowser.java;1;0;2;1;0;0;0;2;10;1;2;100;10;10;1;0;0;2;2;100;0;148;2;1;0
/org.eclipse.osgi/core/framework/org/eclipse/osgi/framework/internal/protocol/URLStreamHandlerProxy.java;5;1;7;3;2;2;4;3;191;3;3;171;229;229;3;0;2;5;7;270;2;336;5;5;0
/org.eclipse.tomcat/src/org/eclipse/tomcat/internal/WebAppClassLoader.java;1;1;3;1;2;2;2;1;28;0;1;135;36;36;1;0;0;1;3;135;0;336;3;1;0
/org.eclipse.jdt.core/search/org/eclipse/jdt/core/search/IJavaSearchResultCollector.java;2;0;6;2;4;1;4;2;22;1;2;181;25;25;4;0;3;2;6;273;3;273;3;2;0
/org.eclipse.osgi/defaultAdaptor/src/org/eclipse/osgi/framework/adaptor/core/BundleResourceHandler.java;2;1;5;1;3;3;3;2;339;0;1;239;435;435;2;1;0;2;5;239;1;326;4;2;0
/org.eclipse.jdt.ui/ui/org/eclipse/jdt/ui/text/java/IInvocationContext.java;3;0;8;3;1;1;3;5;46;4;4;76;60;60;4;1;2;7;8;269;3;336;5;3;0
/org.eclipse.debug.ui/ui/org/eclipse/debug/ui/ILaunchShortcut.java;2;0;2;1;1;1;1;1;32;0;1;219;36;36;1;0;0;1;2;219;0;336;2;2;0
/org.eclipse.swt/Eclipse SWT/common/org/eclipse/swt/graphics/RGB.java;3;1;3;1;2;2;2;1;6;0;1;225;14;14;1;0;0;1;3;225;0;337;3;3;0
/org.eclipse.team.ui/src/org/eclipse/team/internal/ui/registry/SynchronizeWizardDescription.java;1;0;2;1;2;1;2;0;88;0;0;296;88;88;2;0;1;0;2;296;1;296;1;1;1
/org.eclipse.core.resources/src/org/eclipse/core/internal/indexing/ObjectHeader.java;1;0;1;1;1;1;1;0;13;0;0;277;13;13;1;0;0;0;1;277;0;277;1;1;0
/org.eclipse.jdt.ui/core refactoring/org/eclipse/jdt/internal/corext/refactoring/reorg/IReorgEnablementPolicy.java;2;0;2;1;1;1;1;1;2;0;1;70;2;2;1;0;0;1;2;70;0;336;2;2;0
/org.eclipse.jdt.ui/ui/org/eclipse/jdt/ui/actions/ImplementorsSearchGroup.java;3;1;5;1;2;2;2;3;11;1;3;82;22;22;1;0;0;3;5;82;0;336;5;3;0
/org.eclipse.ui.workbench/Eclipse UI/org/eclipse/ui/internal/dialogs/ErrorPreferencePage.java;1;0;1;1;0;0;0;1;0;0;1;176;0;0;1;0;0;1;1;176;0;176;1;1;0
/org.eclipse.jdt.ui/ui/org/eclipse/jdt/internal/ui/viewsupport/StorageLabelProvider.java;1;0;1;1;1;1;1;0;2;0;0;336;2;2;1;0;0;0;1;336;0;336;1;1;0
/org.eclipse.jdt.core/codeassist/org/eclipse/jdt/internal/codeassist/complete/CompletionOnPackageReference.java;2;0;3;1;0;0;0;3;15;1;3;7;19;19;1;0;0;3;3;7;0;199;3;2;0
/org.eclipse.text/src/org/eclipse/jface/text/FindReplaceDocumentAdapter.java;2;3;13;2;5;3;5;8;41;3;5;125;111;111;3;3;2;8;13;125;5;334;8;2;0
/org.eclipse.jdt.core/compiler/org/eclipse/jdt/internal/compiler/codegen/Opcodes.java;1;0;1;1;0;0;0;1;2;0;1;199;2;2;1;0;0;1;1;199;0;199;1;1;0
/org.eclipse.jface/src/org/eclipse/jface/window/Window.java;5;1;9;3;2;2;2;7;177;4;3;167;326;326;4;4;0;7;9;219;4;336;5;5;1
/org.eclipse.ui.ide/src/org/eclipse/ui/views/navigator/ToggleLinkingAction.java;1;0;1;1;0;0;0;1;0;0;1;129;0;0;1;0;0;1;1;129;0;129;1;1;0
/org.eclipse.ui.workbench/Eclipse UI/org/eclipse/ui/internal/ProductProperties.java;2;2;4;1;4;3;4;0;147;0;0;294;218;218;2;0;1;0;4;320;1;335;3;2;0
/org.eclipse.jdt.core/model/org/eclipse/jdt/internal/core/ClassFileWorkingCopy.java;4;0;19;3;1;1;4;15;171;6;7;54;319;319;6;8;3;18;19;54;11;314;8;4;0
/org.eclipse.update.configurator/src/org/eclipse/update/internal/configurator/PlatformConfigurationFactory.java;1;0;2;1;0;0;0;2;11;1;2;183;11;11;1;0;0;2;2;183;0;227;2;1;0
/org.eclipse.ui.workbench/Eclipse UI/org/eclipse/ui/internal/PerspectiveHelper.java;5;3;5;4;5;2;5;0;83;0;0;297;87;87;3;0;3;0;5;330;3;330;2;5;8
/org.eclipse.jdt.ui/ui/org/eclipse/jdt/internal/ui/dialogs/OverrideMethodDialog.java;3;1;8;1;2;2;2;6;25;3;4;40;48;48;3;2;0;6;8;51;2;336;6;3;0
/org.eclipse.jdt.core/search/org/eclipse/jdt/internal/core/search/matching/MethodLocator.java;5;2;16;3;3;2;3;13;87;3;8;118;223;223;3;5;1;13;16;118;6;314;10;5;4
/org.eclipse.core.runtime/src/org/eclipse/core/runtime/IConfigurationElement.java;4;2;7;1;3;2;3;4;387;1;4;123;425;425;2;0;1;4;7;272;1;288;6;4;0
/org.eclipse.jdt.ui/ui/org/eclipse/jdt/internal/ui/util/ViewSiteDecorator.java;1;0;1;1;0;0;0;1;0;0;1;251;0;0;1;0;0;1;1;251;0;251;1;1;0
/org.eclipse.jdt.ui/ui/org/eclipse/jdt/internal/ui/text/CombinedWordRule.java;2;1;2;1;2;2;2;0;2;0;0;313;2;2;1;0;0;0;2;313;0;336;2;2;0
/org.eclipse.pde.ui/src/org/eclipse/pde/internal/ui/editor/plugin/ExtensionDetails.java;3;8;9;3;9;2;9;0;65;0;0;292;75;75;8;0;7;0;9;292;7;336;2;3;0
/org.eclipse.jdt.ui/ui/org/eclipse/jdt/internal/ui/callhierarchy/CallHierarchyImageDescriptor.java;4;0;4;1;1;1;1;3;29;1;3;18;55;55;1;0;0;3;4;18;0;336;4;4;0
/org.eclipse.jdt.debug.ui/ui/org/eclipse/jdt/internal/debug/ui/actions/OpenDeclaringTypeHierarchyAction.java;1;0;1;1;0;0;0;1;3;0;1;144;3;3;1;0;0;1;1;144;0;144;1;1;0
/org.eclipse.team.cvs.ui/src/org/eclipse/team/internal/ccvs/ui/operations/ReplaceOperation.java;2;1;9;1;2;2;2;7;131;2;5;71;245;245;2;2;0;7;9;146;2;336;7;2;0
/org.eclipse.pde.core/src/org/eclipse/pde/internal/core/isite/ISiteDescription.java;2;1;3;1;2;2;2;1;4;0;1;232;10;10;1;0;0;1;3;232;0;336;3;2;0
/org.eclipse.ui.workbench/Eclipse UI/org/eclipse/ui/internal/progress/IJobBusyListener.java;1;0;1;1;0;0;0;1;0;0;1;266;0;0;1;0;0;1;1;266;0;266;1;1;0
/org.eclipse.jdt.ui/ui/org/eclipse/jdt/internal/ui/wizards/buildpaths/CPUserLibraryElement.java;2;2;5;1;4;3;4;1;87;0;1;243;91;91;2;0;1;1;5;276;1;336;4;2;0
/org.eclipse.pde/src/org/eclipse/pde/internal/builders/IMarkerFactory.java;1;0;2;1;1;1;1;1;4;0;1;232;6;6;1;0;0;1;2;232;0;336;2;1;0
/org.eclipse.ui.workbench.texteditor/src/org/eclipse/ui/texteditor/RevertToSavedAction.java;1;1;2;1;2;2;2;0;2;0;0;276;4;4;1;0;0;0;2;276;0;336;2;1;0
/org.eclipse.jdt.core/search/org/eclipse/jdt/internal/core/search/indexing/SourceIndexer.java;6;0;12;3;1;1;1;11;94;3;9;10;131;131;3;2;0;11;12;107;2;315;10;6;0
/org.eclipse.jdt.ui/core refactoring/org/eclipse/jdt/internal/corext/refactoring/reorg/CopyRefactoring.java;4;2;19;1;4;3;4;15;306;3;10;10;458;458;3;5;1;15;19;70;6;336;13;4;0
/org.eclipse.jdt.core/model/org/eclipse/jdt/internal/core/jdom/ILineStartFinder.java;1;0;1;1;0;0;0;1;2;0;1;199;2;2;1;0;0;1;1;199;0;199;1;1;0
/org.eclipse.ui.workbench/Eclipse UI/org/eclipse/ui/internal/AbstractActionBarConfigurer.java;3;0;3;1;0;0;0;3;123;1;3;136;215;215;1;0;0;3;3;136;0;181;3;3;0
/org.eclipse.jdt.ui/ui/org/eclipse/jdt/internal/ui/text/JavaWordFinder.java;1;0;1;1;1;1;1;0;2;0;0;336;2;2;1;0;0;0;1;336;0;336;1;1;0
/org.eclipse.osgi/core/framework/org/eclipse/osgi/framework/internal/core/UnresolvedPermissionCollection.java;4;1;4;1;2;2;2;2;141;1;2;171;150;150;1;0;0;2;4;171;0;336;4;4;0
/org.eclipse.jdt.core/codeassist/org/eclipse/jdt/internal/codeassist/select/SelectionOnArgumentName.java;2;0;2;1;0;0;0;2;34;1;2;63;36;36;1;0;0;2;2;63;0;199;2;2;1
/org.eclipse.team.cvs.ui/src/org/eclipse/team/internal/ccvs/ui/wizards/CheckoutAsWizard.java;2;1;8;1;2;2;2;6;232;1;6;20;371;371;1;0;0;6;8;20;0;336;8;2;0
/org.eclipse.ui.workbench.texteditor/src/org/eclipse/ui/texteditor/CaseAction.java;2;2;6;2;4;2;4;2;31;1;2;31;64;64;2;0;2;2;6;276;2;331;4;2;0
/org.eclipse.jdt.debug/model/org/eclipse/jdt/debug/core/IJavaReferenceType.java;1;0;2;1;0;0;0;2;35;0;1;128;35;35;2;1;0;2;2;128;1;128;1;1;0
/org.eclipse.jdt.core/compiler/org/eclipse/jdt/internal/compiler/lookup/SourceTypeBinding.java;3;0;10;2;1;1;1;9;140;2;8;2;212;212;2;1;0;9;10;80;1;312;9;3;4
/org.eclipse.debug.ui/ui/org/eclipse/debug/ui/actions/ToggleMethodBreakpointActionDelegate.java;1;0;2;1;1;1;1;1;3;0;1;246;3;3;1;0;0;1;2;246;0;276;2;1;0
/org.eclipse.pde.ui/src/org/eclipse/pde/internal/ui/search/DependencyExtentSearchOperation.java;2;1;3;1;2;2;2;1;14;0;1;168;30;30;1;0;0;1;3;168;0;336;3;2;0
/org.eclipse.team.ui/src/org/eclipse/team/ui/synchronize/SynchronizePageActionGroup.java;2;2;4;1;4;3;4;0;352;0;0;275;460;460;2;0;1;0;4;288;1;335;3;2;1
/org.eclipse.update.core/src/org/eclipse/update/core/IVerificationListener.java;1;1;2;1;2;2;2;0;6;0;0;292;10;10;1;0;0;0;2;292;0;336;2;1;0
/org.eclipse.swt/Eclipse SWT PI/win32/org/eclipse/swt/internal/win32/LOGFONT.java;1;0;1;1;0;0;0;1;14;0;1;61;14;14;1;0;0;1;1;61;0;61;1;1;0
/org.eclipse.jdt.ui/ui/org/eclipse/jdt/internal/ui/javaeditor/OverrideIndicatorImageProvider.java;1;1;3;1;2;2;2;1;8;0;1;268;10;10;1;0;0;1;3;268;0;336;3;1;0
/org.eclipse.jdt.core/model/org/eclipse/jdt/core/util/IEnclosingMethodAttribute.java;2;0;2;1;0;0;0;2;77;1;2;210;77;77;1;0;0;2;2;210;0;264;2;2;0
/org.eclipse.jdt.debug.ui/ui/org/eclipse/jdt/internal/debug/ui/snippeteditor/SnippetOpenHierarchyOnSelectionAction.java;1;0;1;1;0;0;0;1;3;0;1;76;3;3;1;0;0;1;1;76;0;76;1;1;0
/org.eclipse.jdt.ui/ui/org/eclipse/jdt/internal/ui/viewsupport/LibraryFilter.java;2;0;2;1;1;1;1;1;2;0;1;264;3;3;1;0;0;1;2;264;0;336;2;2;0
/org.eclipse.ui.workbench/Eclipse UI/org/eclipse/ui/internal/dialogs/ProductInfoDialog.java;2;1;3;1;2;2;2;1;36;0;1;157;38;38;1;0;0;1;3;157;0;336;3;2;0
/org.eclipse.jdt.core/model/org/eclipse/jdt/internal/core/CompilationUnitElementInfo.java;1;0;3;1;0;0;0;3;10;1;3;54;15;15;1;0;0;3;3;54;0;199;3;1;0
/org.eclipse.search/new search/org/eclipse/search/ui/ISearchResult.java;3;3;8;2;4;2;4;4;94;1;4;195;191;191;3;0;2;4;8;276;2;336;6;3;0
/org.eclipse.debug.core/core/org/eclipse/debug/core/model/IWatchExpressionListener.java;1;0;2;1;0;0;0;2;13;0;1;92;13;13;2;1;0;2;2;92;1;92;1;1;0
/org.eclipse.update.core/src/org/eclipse/update/internal/core/Policy.java;1;0;1;1;0;0;0;1;10;0;1;58;10;10;1;0;0;1;1;58;0;58;1;1;0
/org.eclipse.help.ide/src/org/eclipse/help/ui/internal/search/HelpSearchPage.java;1;1;9;1;2;2;2;7;315;3;5;104;523;523;3;2;0;7;9;104;2;299;7;1;0
/org.eclipse.ui.editors/src/org/eclipse/ui/internal/editors/text/FileEditorInputAdapterFactory.java;2;0;5;1;1;1;1;4;33;0;1;130;55;55;4;3;0;4;5;130;3;336;2;2;0
/org.eclipse.ui.ide/src/org/eclipse/ui/wizards/datatransfer/WizardFileSystemExportPage1.java;1;0;1;1;0;0;0;1;0;0;1;92;0;0;1;0;0;1;1;92;0;92;1;1;0
/org.eclipse.jface/src/org/eclipse/jface/wizard/IWizardContainer.java;2;1;2;1;2;2;2;0;2;0;0;274;4;4;1;0;0;0;2;274;0;336;2;2;0
/org.eclipse.ui.forms/src/org/eclipse/ui/forms/widgets/ScrolledPageBook.java;1;1;6;1;3;3;3;3;172;2;2;225;195;195;2;1;0;3;6;225;1;306;5;1;0
/org.eclipse.debug.ui/ui/org/eclipse/debug/internal/ui/views/console/ConsoleDocumentPartitioner.java;4;1;12;3;2;2;2;10;178;6;4;80;289;289;6;6;0;10;12;122;6;336;6;4;1
/org.eclipse.pde.ui/src/org/eclipse/pde/internal/ui/editor/PDEDetails.java;3;3;4;2;4;2;4;0;10;0;0;296;17;17;3;0;2;0;4;296;2;336;2;3;0
/org.eclipse.ui.workbench/Eclipse UI/org/eclipse/ui/internal/WWinActionBars.java;2;0;2;1;0;0;0;2;27;1;2;54;34;34;1;0;0;2;2;54;0;181;2;2;0
/org.eclipse.swt/Eclipse SWT/carbon/org/eclipse/swt/widgets/ColorDialog.java;1;1;2;1;2;2;2;0;4;0;0;300;8;8;1;0;0;0;2;300;0;337;2;1;0
/org.eclipse.pde.ui/src/org/eclipse/pde/internal/ui/wizards/tools/MigrationAction.java;1;1;4;1;2;2;2;2;10;1;2;213;24;24;1;0;0;2;4;213;0;336;4;1;0
/org.eclipse.jdt.ui/ui/org/eclipse/jdt/internal/ui/viewsupport/ProblemTreeViewer.java;3;1;6;2;3;3;3;3;110;1;3;84;148;148;1;0;0;3;6;84;0;336;6;3;0
/org.eclipse.jdt.ui/ui/org/eclipse/jdt/internal/ui/javaeditor/AddClassFileMarkerAction.java;1;0;1;1;1;1;1;0;2;0;0;336;2;2;1;0;0;0;1;336;0;336;1;1;0
/org.eclipse.osgi/core/framework/org/eclipse/osgi/framework/internal/protocol/URLStreamHandlerSetter.java;4;0;4;1;1;1;1;3;37;1;3;171;42;42;1;0;0;3;4;171;0;336;4;4;0
/org.eclipse.help.base/src/org/eclipse/help/internal/workingset/IHelpWorkingSetManager.java;1;1;3;1;2;2;2;1;17;0;1;104;23;23;1;0;0;1;3;104;0;336;3;1;0
/org.eclipse.core.resources/src/org/eclipse/core/internal/watson/ElementTreeIterator.java;1;0;1;1;1;1;1;0;37;0;0;277;37;37;1;0;0;0;1;277;0;277;1;1;0
/org.eclipse.osgi/core/framework/org/eclipse/osgi/framework/internal/core/ManifestLocalization.java;5;7;13;5;8;2;8;5;133;2;3;224;308;308;7;2;6;5;13;276;8;309;5;5;0
/org.eclipse.osgi/osgi/src/org/eclipse/osgi/service/resolver/StateChangeListener.java;3;1;3;1;2;2;2;1;4;0;1;171;6;6;1;0;0;1;3;171;0;336;3;3;0
/org.eclipse.jdt.ui/ui/org/eclipse/jdt/internal/ui/filters/FieldsFilter.java;1;0;2;1;1;1;1;1;2;0;1;133;2;2;1;0;0;1;2;133;0;336;2;1;0
/org.eclipse.team.cvs.core/src/org/eclipse/team/internal/ccvs/core/client/listeners/ServerMessageLineMatcher.java;1;0;2;1;0;0;0;2;99;0;1;143;99;99;2;1;0;2;2;143;1;143;1;1;0
/org.eclipse.ui.forms/src/org/eclipse/ui/internal/forms/FormWizardDialog.java;1;1;2;1;2;2;2;0;4;0;0;272;4;4;1;0;0;0;2;272;0;336;2;1;0
/org.eclipse.core.resources/src/org/eclipse/core/internal/localstore/RefreshLocalVisitor.java;3;1;3;1;2;2;2;1;487;0;1;125;493;493;1;0;0;1;3;125;0;306;3;3;0
/org.eclipse.ui.workbench/Eclipse UI/org/eclipse/ui/internal/dnd/DragUtil.java;3;0;11;2;0;0;3;8;287;7;4;205;486;486;7;4;3;11;11;262;7;262;4;3;1
/org.eclipse.jdt.ui/core extension/org/eclipse/jdt/internal/corext/template/java/CompilationUnitContext.java;4;1;6;1;2;2;2;4;27;2;3;134;46;46;2;1;0;4;6;134;1;336;5;4;0
/org.eclipse.pde.ui/src/org/eclipse/pde/internal/ui/wizards/templates/ControlStack.java;2;1;2;1;2;2;2;0;6;0;0;308;12;12;1;0;0;0;2;308;0;336;2;2;0
/org.eclipse.ltk.ui.refactoring/src/org/eclipse/ltk/internal/ui/refactoring/ExceptionHandler.java;1;0;3;1;1;1;2;1;3;0;1;269;5;5;2;0;1;2;3;269;1;336;2;1;0
/org.eclipse.ui.workbench/Eclipse UI/org/eclipse/ui/internal/OverlayIcon.java;3;2;3;2;3;2;3;0;23;0;0;319;25;25;2;0;1;0;3;319;1;336;2;3;0
/org.eclipse.update.core/src/org/eclipse/update/core/model/InstallHandlerEntryModel.java;2;1;3;1;2;2;2;1;6;0;1;58;13;13;1;0;0;1;3;58;0;336;3;2;0
/org.eclipse.jdt.ui/ui/org/eclipse/jdt/internal/ui/javaeditor/OverrideIndicatorManager.java;2;2;9;2;5;4;8;1;303;0;1;268;384;384;4;0;4;4;9;268;4;336;5;2;1
/org.eclipse.jdt.core/model/org/eclipse/jdt/core/util/IRuntimeInvisibleAnnotationsAttribute.java;2;0;2;1;0;0;0;2;36;1;2;245;36;36;1;0;0;2;2;245;0;264;2;2;0
/org.eclipse.jface.text/src/org/eclipse/jface/internal/text/link/contentassist/SubstitutionTextReader.java;2;0;2;1;1;1;1;1;2;0;1;232;2;2;1;0;0;1;2;232;0;336;2;2;0
/org.eclipse.osgi/eclipseAdaptor/src/org/eclipse/core/runtime/adaptor/URLConverterImpl.java;3;0;5;2;1;1;2;3;23;2;3;203;38;38;2;0;1;4;5;270;1;326;4;3;0
/org.eclipse.jdt.core/compiler/org/eclipse/jdt/internal/compiler/ast/JavadocImportReference.java;1;0;1;1;1;1;1;0;0;0;0;305;0;0;1;0;0;0;1;305;0;305;1;1;0
/org.eclipse.ui.workbench/Eclipse UI/org/eclipse/ui/internal/CyclePerspectiveAction.java;1;0;1;1;0;0;0;1;60;0;1;157;60;60;1;0;0;1;1;157;0;157;1;1;0
/org.eclipse.help.ui/src/org/eclipse/help/ui/internal/util/ErrorUtil.java;1;1;4;1;3;3;3;1;28;0;1;156;64;64;1;0;0;1;4;156;0;336;4;1;0
/org.eclipse.team.cvs.core/src/org/eclipse/team/internal/ccvs/core/resources/RemoteFile.java;2;0;19;2;1;1;1;18;381;4;9;52;964;964;4;9;0;18;19;118;9;336;10;2;0
/org.eclipse.pde.core/src/org/eclipse/pde/core/plugin/IFragment.java;3;2;6;1;4;3;4;2;66;1;2;232;80;80;2;0;1;2;6;276;1;336;5;3;0
/org.eclipse.pde.ui/src/org/eclipse/pde/internal/ui/editor/plugin/ManifestOutlinePage.java;2;1;2;2;2;2;2;0;18;0;0;292;28;28;1;0;0;0;2;292;0;336;2;2;0
/org.eclipse.help.webapp/src_servlets/org/eclipse/help/internal/webapp/data/ToolbarButton.java;1;1;5;1;5;5;5;0;37;0;0;272;55;55;1;0;0;0;5;272;0;336;5;1;0
/org.eclipse.core.resources/src/org/eclipse/core/internal/refresh/InternalRefreshProvider.java;1;0;1;1;1;1;1;0;0;0;0;283;0;0;1;0;0;0;1;283;0;283;1;1;0
/org.eclipse.debug.ui/ui/org/eclipse/debug/internal/ui/views/variables/IndexedVariablePartition.java;2;0;2;2;0;0;0;2;10;0;1;148;10;10;2;1;0;2;2;148;1;148;1;2;0
/org.eclipse.pde.core/src/org/eclipse/pde/internal/core/ischema/ISchemaObject.java;2;1;3;1;2;2;2;1;4;0;1;232;12;12;1;0;0;1;3;232;0;336;3;2;0
/org.eclipse.ant.ui/Ant Tools Support/org/eclipse/ant/internal/ui/views/AntProjectContentProvider.java;2;0;5;2;1;1;1;4;47;3;2;108;57;57;3;2;0;4;5;108;2;336;3;2;1
/org.eclipse.search/search/org/eclipse/search/internal/ui/text/PathSorter.java;1;0;1;1;0;0;0;1;0;0;1;207;0;0;1;0;0;1;1;207;0;207;1;1;0
/org.eclipse.jface/src/org/eclipse/jface/viewers/IDelayedLabelDecorator.java;1;0;2;1;1;1;1;1;4;0;1;251;4;4;1;0;0;1;2;251;0;336;2;1;0
/org.eclipse.jdt.ui/ui/org/eclipse/jdt/internal/ui/text/java/JavaCompletionProposal.java;4;3;18;2;4;2;4;14;119;5;7;56;264;264;5;7;2;14;18;172;9;336;9;4;0
/org.eclipse.jdt.ui/ui/org/eclipse/jdt/internal/ui/search/MatchPositionSorter.java;1;0;1;1;1;1;1;0;2;0;0;336;2;2;1;0;0;0;1;336;0;336;1;1;0
/org.eclipse.ant.ui/Ant Tools Support/org/eclipse/ant/internal/ui/launchConfigurations/AntLaunchDelegate.java;3;4;25;3;6;2;6;19;158;9;6;108;444;444;9;13;4;19;25;108;17;325;8;3;6
/org.eclipse.ui.ide/src/org/eclipse/ui/views/navigator/StringMatcher.java;3;1;3;1;2;2;2;1;2;0;1;129;4;4;1;0;0;1;3;129;0;336;3;3;0
/org.eclipse.jdt.debug/eval/org/eclipse/jdt/internal/debug/eval/ast/instructions/Pop.java;1;0;1;1;0;0;0;1;3;0;1;144;3;3;1;0;0;1;1;144;0;144;1;1;1
/org.eclipse.ui.ide/src/org/eclipse/ui/internal/ide/dialogs/FileStatesPage.java;3;1;3;1;2;2;2;1;3;0;1;132;5;5;1;0;0;1;3;132;0;336;3;3;0
/org.eclipse.ui.ide/src/org/eclipse/ui/internal/ide/IDEInternalWorkbenchImages.java;3;0;4;1;1;1;1;3;104;1;3;100;119;119;1;0;0;3;4;100;0;336;4;3;0
/org.eclipse.pde.ui/src/org/eclipse/pde/internal/ui/wizards/RequiredPluginsContainerPage.java;3;1;6;2;3;3;3;3;11;1;3;157;32;32;1;0;0;3;6;157;0;336;6;3;0
/org.eclipse.jdt.ui/core refactoring/org/eclipse/jdt/internal/corext/refactoring/rename/TempDeclarationFinder.java;2;0;2;1;1;1;1;1;9;0;1;116;11;11;1;0;0;1;2;116;0;336;2;2;0
/org.eclipse.jdt.ui/ui/org/eclipse/jdt/internal/ui/callhierarchy/CallHierarchyMessages.java;2;0;2;1;1;1;1;1;2;0;1;12;2;2;1;0;0;1;2;12;0;336;2;2;0
/org.eclipse.ui.ide/src/org/eclipse/ui/wizards/datatransfer/WizardFileSystemImportPage1.java;1;0;1;1;0;0;0;1;0;0;1;92;0;0;1;0;0;1;1;92;0;92;1;1;0
/org.eclipse.jdt.ui/ui/org/eclipse/jdt/internal/ui/javadocexport/JavadocConsoleLineTracker.java;1;0;1;1;1;1;1;0;0;0;0;271;0;0;1;0;0;0;1;271;0;271;1;1;0
/org.eclipse.team.cvs.ui/src/org/eclipse/team/internal/ccvs/ui/actions/CheckoutWizardAction.java;1;0;1;1;0;0;0;1;0;0;1;265;0;0;1;0;0;1;1;265;0;265;1;1;1
/org.eclipse.swt/Eclipse SWT/carbon/org/eclipse/swt/graphics/TextLayout.java;3;10;21;3;14;3;16;5;701;5;2;250;969;969;10;3;13;7;21;281;16;334;5;3;1
/org.eclipse.update.core/src/org/eclipse/update/core/model/ArchiveReferenceModel.java;2;2;4;1;3;2;3;1;8;0;1;58;15;15;2;0;1;1;4;289;1;336;3;2;0
/org.eclipse.jdt.ui/ui/org/eclipse/jdt/internal/ui/search/MethodExitsFinder.java;2;2;4;1;4;3;4;0;27;0;0;294;29;29;2;0;1;0;4;311;1;311;3;2;0
/org.eclipse.ui.workbench/Eclipse UI/org/eclipse/ui/part/PluginDropAdapter.java;2;0;2;1;1;1;1;1;2;0;1;252;4;4;1;0;0;1;2;252;0;336;2;2;0
/org.eclipse.ui.workbench/Eclipse UI/org/eclipse/ui/internal/ObjectActionContributor.java;3;1;3;1;2;2;2;1;57;0;1;157;60;60;1;0;0;1;3;157;0;336;3;3;0
/org.eclipse.core.resources/src/org/eclipse/core/internal/watson/IElementInfoFlattener.java;1;0;1;1;1;1;1;0;42;0;0;277;42;42;1;0;0;0;1;277;0;277;1;1;0
/org.eclipse.jdt.core/model/org/eclipse/jdt/internal/core/util/ElementInfoConverter.java;2;0;5;1;0;0;0;5;258;2;4;121;318;318;2;1;0;5;5;121;1;199;4;2;1
/org.eclipse.ui.ide/src/org/eclipse/ui/views/tasklist/FiltersAction.java;1;0;1;1;0;0;0;1;0;0;1;129;0;0;1;0;0;1;1;129;0;129;1;1;0
/org.eclipse.jdt.ui/core refactoring/org/eclipse/jdt/internal/corext/refactoring/reorg/JavaMoveProcessor.java;3;3;9;1;6;4;6;3;91;2;2;257;154;154;3;1;2;3;9;278;3;336;6;3;0
/org.eclipse.jface.text/src/org/eclipse/jface/text/templates/persistence/TemplateReaderWriter.java;2;2;7;2;5;3;5;2;60;0;1;253;144;144;2;1;2;2;7;253;3;336;4;2;0
/org.eclipse.core.runtime/src/org/eclipse/core/internal/registry/NestedRegistryModelObject.java;3;1;3;1;3;3;3;0;12;0;0;280;14;14;1;0;0;0;3;280;0;336;3;3;0
/org.eclipse.pde.ui/src/org/eclipse/pde/internal/ui/editor/feature/FeatureEditor.java;3;7;10;3;8;2;8;2;410;1;2;99;455;455;7;0;6;2;10;292;6;336;4;3;0
/org.eclipse.osgi/osgi/src/org/eclipse/osgi/service/resolver/HostSpecification.java;4;0;6;2;1;1;2;4;14;2;3;171;36;36;2;1;1;5;6;171;2;336;4;4;0
/org.eclipse.jdt.ui/ui refactoring/org/eclipse/jdt/internal/ui/refactoring/actions/RenameResourceAction.java;3;1;8;2;2;2;2;6;96;2;4;9;180;180;2;2;0;6;8;70;2;336;6;3;0
/org.eclipse.team.cvs.core/src/org/eclipse/team/internal/ccvs/core/syncinfo/FolderSyncInfo.java;2;1;7;2;3;3;3;4;74;2;3;50;97;97;2;1;0;4;7;50;1;336;6;2;1
/org.eclipse.ui.workbench.texteditor/src/org/eclipse/ui/texteditor/EditorStatusLine.java;1;1;5;1;2;2;2;3;9;2;2;82;20;20;2;1;0;3;5;144;1;336;4;1;0
/org.eclipse.jface/src/org/eclipse/jface/preference/PreferenceStore.java;2;1;3;1;2;2;2;1;1071;0;1;0;1081;1081;1;0;0;1;3;0;0;336;3;2;0
/org.eclipse.swt/Eclipse SWT/emulated/treetable/org/eclipse/swt/widgets/TreeItem.java;4;1;9;1;3;3;3;6;65;2;5;19;99;99;2;1;0;6;9;218;1;337;8;4;0
/org.eclipse.compare/compare/org/eclipse/compare/internal/OverlayPreferenceStore.java;1;0;1;1;0;0;0;1;6;0;1;79;6;6;1;0;0;1;1;79;0;79;1;1;0
/org.eclipse.swt/Eclipse SWT Mozilla/common/org/eclipse/swt/internal/mozilla/nsIWindowWatcher.java;1;0;2;1;0;0;0;2;20;1;2;111;20;20;1;0;0;2;2;111;0;148;2;1;0
/org.eclipse.swt/Eclipse SWT PI/win32/org/eclipse/swt/internal/ole/win32/VARDESC2.java;2;0;2;2;0;0;0;2;21;0;1;166;21;21;2;1;0;2;2;166;1;166;1;2;0
/org.eclipse.swt/Eclipse SWT Browser/mozilla/org/eclipse/swt/browser/WindowCreator.java;3;1;8;1;4;4;4;4;57;2;3;162;82;82;2;1;0;4;8;162;1;337;7;3;0
/org.eclipse.jdt.core/dom/org/eclipse/jdt/core/dom/ReturnStatement.java;3;0;7;1;1;1;1;6;67;2;5;199;84;84;2;1;0;6;7;266;1;283;6;3;1
/org.eclipse.jdt.ui/ui/org/eclipse/jdt/internal/ui/text/java/JavaParameterListValidator.java;1;0;1;1;1;1;1;0;2;0;0;336;2;2;1;0;0;0;1;336;0;336;1;1;0
/org.eclipse.ltk.ui.refactoring/src/org/eclipse/ltk/internal/ui/refactoring/RefactoringStatusEntryLabelProvider.java;1;0;2;1;1;1;1;1;2;0;1;269;2;2;1;0;0;1;2;269;0;336;2;1;0
/org.eclipse.jdt.debug/eval/org/eclipse/jdt/internal/debug/eval/ast/instructions/PushArrayLength.java;1;0;1;1;0;0;0;1;2;0;1;78;2;2;1;0;0;1;1;78;0;78;1;1;0
/org.eclipse.team.core/src/org/eclipse/team/internal/core/streams/PollingOutputStream.java;2;1;3;1;2;2;2;1;34;0;1;94;41;41;1;0;0;1;3;94;0;336;3;2;0
/org.eclipse.debug.ui/ui/org/eclipse/debug/internal/ui/sourcelookup/Prompter.java;1;0;1;1;0;0;0;1;0;0;1;252;0;0;1;0;0;1;1;252;0;252;1;1;0
/org.eclipse.ui.workbench/Eclipse UI/org/eclipse/ui/internal/dnd/IDropTarget.java;2;0;2;1;0;0;0;2;46;1;2;205;46;46;1;0;0;2;2;205;0;223;2;2;0
/org.eclipse.ui.editors/src/org/eclipse/ui/editors/text/EncodingActionGroup.java;1;2;5;1;4;3;4;1;153;0;1;82;172;172;2;0;1;1;5;314;1;336;4;1;0
/org.eclipse.ui.workbench/Eclipse UI/org/eclipse/ui/internal/keys/CompactKeyFormatter.java;1;0;1;1;0;0;0;1;0;0;1;187;0;0;1;0;0;1;1;187;0;187;1;1;0
/org.eclipse.jdt.ui/ui refactoring/org/eclipse/jdt/internal/ui/refactoring/nls/search/Properties.java;1;0;1;1;1;1;1;0;2;0;0;336;2;2;1;0;0;0;1;336;0;336;1;1;0
/org.eclipse.debug.ui/ui/org/eclipse/debug/internal/ui/actions/RetargetMethodBreakpointAction.java;1;0;1;1;0;0;0;1;1;0;1;246;1;1;1;0;0;1;1;246;0;246;1;1;0
/org.eclipse.osgi/core/framework/org/eclipse/osgi/framework/internal/protocol/NullURLStreamHandlerService.java;4;1;5;1;3;3;3;2;59;1;2;171;99;99;1;0;0;2;5;171;0;336;5;4;0
/org.eclipse.jdt.debug.ui/ui/org/eclipse/jdt/internal/debug/ui/actions/WatchAction.java;2;0;3;1;0;0;0;3;19;2;2;73;34;34;2;1;0;3;3;92;1;92;2;2;0
/org.eclipse.pde.ui/src/org/eclipse/pde/internal/ui/editor/plugin/PluginInputContextManager.java;2;3;4;2;4;2;4;0;64;0;0;292;70;70;3;0;2;0;4;292;2;336;2;2;0
/org.eclipse.jdt.debug/model/org/eclipse/jdt/internal/debug/core/model/JDIArrayEntryVariable.java;1;0;1;1;0;0;0;1;19;0;1;148;19;19;1;0;0;1;1;148;0;148;1;1;1
/org.eclipse.core.resources/src/org/eclipse/core/internal/utils/ArrayEnumeration.java;1;0;1;1;1;1;1;0;70;0;0;277;70;70;1;0;0;0;1;277;0;277;1;1;0
/org.eclipse.jdt.debug.ui/Snippet Support/org/eclipse/jdt/internal/debug/ui/snippeteditor/ScrapbookMain.java;1;0;1;1;0;0;0;1;0;0;1;49;0;0;1;0;0;1;1;49;0;49;1;1;0
/org.eclipse.jdt.ui/core refactoring/org/eclipse/jdt/internal/corext/refactoring/reorg/CreateCopyOfCompilationUnitChange.java;5;2;14;2;6;4;6;8;33;2;5;42;131;131;2;3;2;8;14;96;5;331;9;5;0
/org.eclipse.ui.editors/src/org/eclipse/ui/internal/editors/text/NextPulldownActionDelegate.java;2;0;3;1;1;1;1;2;29;1;2;123;31;31;1;0;0;2;3;123;0;336;3;2;0
/org.eclipse.jdt.debug.ui/ui/org/eclipse/jdt/internal/debug/ui/actions/ControlAccessibleListener.java;1;2;3;1;3;2;3;0;10;0;0;296;18;18;2;0;1;0;3;296;1;336;2;1;0
/org.eclipse.core.runtime/src/org/eclipse/core/internal/registry/RegistryWriter.java;5;2;7;3;4;3;4;3;380;2;2;173;463;463;2;1;1;3;7;173;2;336;5;5;0
/org.eclipse.osgi/resolver/src/org/eclipse/osgi/internal/resolver/StateDeltaImpl.java;4;2;7;1;4;3;4;3;72;1;3;171;145;145;2;0;1;3;7;287;1;336;6;4;0
/org.eclipse.jdt.core/model/org/eclipse/jdt/internal/core/JavaElementDeltaBuilder.java;2;0;2;1;0;0;0;2;10;1;2;27;12;12;1;0;0;2;2;27;0;199;2;2;0
/org.eclipse.jdt.debug/model/org/eclipse/jdt/internal/debug/core/hcr/Differencer.java;1;0;1;1;0;0;0;1;15;0;1;78;15;15;1;0;0;1;1;78;0;78;1;1;1
/org.eclipse.ltk.core.refactoring/src/org/eclipse/ltk/core/refactoring/CheckConditionsOperation.java;1;1;6;1;2;2;4;2;26;0;1;264;36;36;4;1;2;4;6;264;3;336;3;1;0
/org.eclipse.team.cvs.ui/src/org/eclipse/team/internal/ccvs/ui/actions/SyncAction.java;2;3;16;2;6;3;6;10;96;3;6;72;291;291;3;4;3;10;16;72;7;330;9;2;2
/org.eclipse.jdt.core/dom/org/eclipse/jdt/core/dom/TypeBinding.java;3;3;11;2;4;2;4;7;139;2;5;157;421;421;3;2;2;7;11;283;4;315;7;3;17
/org.eclipse.pde.ui/src/org/eclipse/pde/internal/ui/editor/schema/GrammarSection.java;2;1;4;1;3;3;3;1;84;0;1;157;115;115;1;0;0;1;4;157;0;336;4;2;0
/org.eclipse.jface.text/src/org/eclipse/jface/text/contentassist/IContextInformation.java;1;0;2;1;2;1;2;0;23;0;0;336;23;23;2;0;1;0;2;336;1;336;1;1;0
/org.eclipse.osgi/resolver/src/org/eclipse/osgi/internal/resolver/StateBuilder.java;5;0;12;2;0;0;3;9;68;4;5;171;180;180;4;4;3;12;12;240;7;269;5;5;0
/org.eclipse.core.runtime/src/org/eclipse/core/internal/registry/ExtensionRegistry.java;6;0;22;3;3;1;7;15;2289;6;8;124;6462;6462;6;7;6;19;22;266;13;296;9;6;4
/org.eclipse.update.core/src/org/eclipse/update/search/IUpdateSearchQuery.java;2;1;6;2;2;2;2;4;10;2;3;54;26;26;2;1;0;4;6;54;1;336;5;2;0
/org.eclipse.jface.text/src/org/eclipse/jface/text/information/IInformationPresenter.java;1;2;3;1;3;2;3;0;40;0;0;275;42;42;2;0;1;0;3;336;1;336;2;1;0
/org.eclipse.pde.ui/src/org/eclipse/pde/internal/ui/editor/schema/ElementPropertySource.java;2;1;2;1;2;2;2;0;16;0;0;308;20;20;1;0;0;0;2;308;0;336;2;2;0
/org.eclipse.team.cvs.core/src/org/eclipse/team/internal/ccvs/core/resources/RemoteFolderMemberFetcher.java;1;0;4;1;0;0;0;4;19;0;1;113;19;19;4;3;0;4;4;113;3;113;1;1;0
/org.eclipse.osgi/defaultAdaptor/src/org/eclipse/osgi/framework/adaptor/core/AbstractClassLoader.java;2;2;4;2;3;2;3;1;48;0;1;254;70;70;2;0;1;1;4;273;1;295;3;2;0
/org.eclipse.pde.build/src/org/eclipse/pde/internal/build/site/PluginPathFinder.java;2;2;4;2;3;2;3;1;77;0;1;259;83;83;2;0;1;1;4;272;1;307;3;2;0
/org.eclipse.ui.workbench/Eclipse UI/org/eclipse/ui/internal/activities/IActivityRegistry.java;3;1;9;1;2;2;2;7;16;3;4;141;28;28;3;3;0;7;9;160;3;336;6;3;0
/org.eclipse.jdt.debug.ui/ui/org/eclipse/jdt/internal/debug/ui/jres/JREsPreferencePage.java;4;0;9;1;1;1;1;8;285;3;6;65;370;370;3;2;0;8;9;65;2;303;7;4;0
/org.eclipse.ui.ide/extensions/org/eclipse/ui/dialogs/ProjectLocationMoveDialog.java;1;0;1;1;0;0;0;1;0;0;1;132;0;0;1;0;0;1;1;132;0;132;1;1;0
/org.eclipse.jdt.core/model/org/eclipse/jdt/internal/core/UserLibraryClasspathContainer.java;1;0;2;1;2;1;2;0;14;0;0;280;14;14;2;0;1;0;2;280;1;280;1;1;0
/org.eclipse.pde.core/src/org/eclipse/pde/internal/core/ibundle/IBundlePluginModelBase.java;1;1;2;1;2;2;2;0;6;0;0;292;6;6;1;0;0;0;2;292;0;336;2;1;0
/org.eclipse.pde.ui/src/org/eclipse/pde/internal/ui/editor/plugin/PluginInputContext.java;3;4;8;3;8;3;8;0;37;0;0;292;78;78;4;0;5;0;8;302;5;333;3;3;0
/org.eclipse.jdt.core/model/org/eclipse/jdt/internal/core/ModelUpdater.java;1;0;5;1;0;0;0;5;10;1;5;38;27;27;1;0;0;5;5;38;0;209;5;1;0
/org.eclipse.osgi/resolver/src/org/eclipse/osgi/internal/resolver/HostSpecificationImpl.java;4;1;4;1;2;2;2;2;6;1;2;171;15;15;1;0;0;2;4;171;0;336;4;4;0
/org.eclipse.ui.workbench/Eclipse UI/org/eclipse/ui/internal/ExceptionHandler.java;4;1;5;2;3;3;3;2;234;1;2;157;275;275;1;0;0;2;5;157;0;336;5;4;0
/org.eclipse.osgi/core/framework/org/eclipse/osgi/framework/internal/core/SingleSourcePackage.java;4;1;6;1;3;3;3;3;10;2;2;171;26;26;2;1;0;3;6;171;1;336;5;4;0
/org.eclipse.core.resources/src/org/eclipse/core/internal/indexing/IndexedStoreObjectPolicy.java;1;0;1;1;1;1;1;0;38;0;0;277;38;38;1;0;0;0;1;277;0;277;1;1;0
/org.eclipse.core.runtime/src/org/eclipse/core/internal/runtime/Policy.java;2;1;7;2;2;2;2;5;356;3;3;42;388;388;3;2;0;5;7;171;2;336;5;2;1
/org.eclipse.swt/Eclipse SWT PI/carbon/org/eclipse/swt/internal/carbon/FontSelectionQDStyle.java;1;0;2;1;2;1;2;0;20;0;0;296;20;20;2;0;1;0;2;296;1;296;1;1;0
/org.eclipse.jdt.debug.ui/ui/org/eclipse/jdt/internal/debug/ui/jres/VMLibraryBlock.java;2;0;5;1;0;0;0;5;51;2;4;65;84;84;2;1;0;5;5;113;1;181;4;2;0
/org.eclipse.jdt.core/search/org/eclipse/jdt/internal/core/search/matching/PossibleMatch.java;4;2;13;3;3;2;3;10;53;4;4;119;138;138;4;6;1;10;13;119;7;329;6;4;1
/org.eclipse.ui.ide/src/org/eclipse/ui/views/bookmarkexplorer/OpenBookmarkAction.java;1;0;1;1;0;0;0;1;0;0;1;129;0;0;1;0;0;1;1;129;0;129;1;1;0
/org.eclipse.ui.workbench/Eclipse UI/org/eclipse/ui/internal/PerspectiveListenerList.java;2;1;2;1;2;2;2;0;24;0;0;287;26;26;1;0;0;0;2;287;0;336;2;2;1
/org.eclipse.core.resources/src/org/eclipse/core/internal/properties/ResourceName.java;1;0;1;1;1;1;1;0;67;0;0;277;67;67;1;0;0;0;1;277;0;277;1;1;0
/org.eclipse.jdt.ui/ui/org/eclipse/jdt/internal/ui/javadocexport/CreateJavadocActionDelegate.java;2;1;2;1;2;2;2;0;27;0;0;305;29;29;1;0;0;0;2;305;0;336;2;2;0
/org.eclipse.team.ui/src/org/eclipse/team/ui/synchronize/ISynchronizePageConfiguration.java;2;4;7;1;7;4;7;0;478;0;0;272;488;488;4;0;3;0;7;288;3;336;4;2;0
/org.eclipse.debug.core/core/org/eclipse/debug/core/IExpressionManager.java;2;1;6;1;2;2;2;4;45;0;1;92;62;62;4;3;0;4;6;92;3;301;3;2;0
/org.eclipse.jdt.debug/jdi/org/eclipse/jdi/internal/LocationImpl.java;1;0;1;1;0;0;0;1;19;0;1;39;19;19;1;0;0;1;1;39;0;39;1;1;0
/org.eclipse.search/new search/org/eclipse/search/ui/text/ISearchEditorAccess.java;2;0;3;2;3;1;3;0;21;0;0;310;21;21;3;0;2;0;3;310;2;310;1;2;0
/org.eclipse.jdt.core/compiler/org/eclipse/jdt/internal/compiler/ast/QualifiedTypeReference.java;2;0;3;1;0;0;0;3;91;1;3;63;99;99;1;0;0;3;3;63;0;199;3;2;1
/org.eclipse.pde.ui/src/org/eclipse/pde/internal/ui/editor/plugin/BundleInputContext.java;3;6;7;3;7;2;7;0;133;0;0;292;143;143;6;0;5;0;7;292;5;336;2;3;0
/org.eclipse.jdt.ui/ui/org/eclipse/jdt/internal/ui/callhierarchy/RefreshAction.java;3;1;5;1;2;2;2;3;9;0;1;12;13;13;3;2;0;3;5;12;2;336;3;3;0
/org.eclipse.osgi/eclipseAdaptor/src/org/eclipse/core/runtime/adaptor/BasicLocation.java;5;3;20;4;5;3;10;10;277;9;3;227;461;461;9;7;7;15;20;254;14;326;6;5;0
/org.eclipse.core.filebuffers/src/org/eclipse/core/filebuffers/IFileBufferManager.java;2;0;9;2;2;1;2;7;122;3;4;93;360;360;3;3;1;7;9;139;4;334;5;2;0
/org.eclipse.ui.workbench/Eclipse UI/org/eclipse/ui/internal/progress/ProgressAnimationProcessor.java;2;0;3;1;1;1;1;2;9;0;1;243;11;11;2;1;0;2;3;243;1;326;2;2;0
/org.eclipse.swt/Eclipse SWT/win32/org/eclipse/swt/widgets/TableColumn.java;2;0;5;1;1;1;1;4;26;1;4;19;64;64;1;0;0;4;5;19;0;337;5;2;0
/org.eclipse.update.ui/src/org/eclipse/update/internal/ui/wizards/IDynamicPage.java;2;0;5;2;1;1;1;4;9;2;3;50;20;20;2;1;0;4;5;50;1;336;4;2;0
/org.eclipse.swt/Eclipse SWT/gtk/org/eclipse/swt/widgets/Shell.java;6;7;40;5;13;2;13;27;322;6;13;5;977;977;7;14;11;27;40;321;25;321;15;6;9
/org.eclipse.pde.build/src_ant/org/eclipse/pde/internal/build/tasks/BuildScriptGeneratorTask.java;2;2;10;2;3;2;3;7;316;2;4;31;889;889;2;3;1;7;10;31;4;336;6;2;0
/org.eclipse.debug.core/core/org/eclipse/debug/core/ILaunchMode.java;1;0;1;1;1;1;1;0;0;0;0;275;0;0;1;0;0;0;1;275;0;275;1;1;0
/org.eclipse.core.runtime/src/org/eclipse/core/internal/jobs/Queue.java;3;0;8;2;1;1;1;7;944;3;5;25;1204;1204;3;2;0;7;8;171;2;277;6;3;0
/org.eclipse.pde.core/src/org/eclipse/pde/internal/core/ibundle/IBundlePlugin.java;1;1;2;1;2;2;2;0;4;0;0;292;4;4;1;0;0;0;2;292;0;336;2;1;0
/org.eclipse.jdt.core/model/org/eclipse/jdt/internal/core/CreateCompilationUnitOperation.java;3;0;8;1;0;0;0;8;16;2;6;156;52;52;2;2;0;8;8;194;2;258;6;3;0
/org.eclipse.ui.workbench/Eclipse UI/org/eclipse/ui/IPersistableElement.java;1;0;1;1;0;0;0;1;4;0;1;0;4;4;1;0;0;1;1;0;0;0;1;1;0
/org.eclipse.ui.workbench/Eclipse UI/org/eclipse/ui/internal/WorkbenchWindowConfigurer.java;8;4;23;3;9;4;9;14;433;4;6;77;870;870;4;8;5;14;23;200;13;336;10;8;1
/org.eclipse.jdt.core/model/org/eclipse/jdt/core/IJavaModelStatus.java;1;0;1;1;0;0;0;1;2;0;1;199;2;2;1;0;0;1;1;199;0;199;1;1;0
/org.eclipse.pde.core/src/org/eclipse/pde/internal/core/schema/SchemaAttribute.java;2;1;3;1;2;2;2;1;60;0;1;232;66;66;1;0;0;1;3;232;0;336;3;2;0
/org.eclipse.ui.ide/extensions/org/eclipse/ui/actions/OpenSystemEditorAction.java;1;0;2;1;0;0;0;2;2;1;2;132;2;2;1;0;0;2;2;132;0;150;2;1;0
/org.eclipse.jdt.debug.ui/ui/org/eclipse/jdt/internal/debug/ui/HotCodeReplaceErrorDialog.java;2;0;2;1;0;0;0;2;40;1;2;122;40;40;1;0;0;2;2;122;0;239;2;2;0
/org.eclipse.jface.text/src/org/eclipse/jface/text/IViewportListener.java;2;2;3;2;3;2;3;0;19;0;0;275;21;21;2;0;1;0;3;336;1;336;2;2;0
/org.eclipse.pde.core/src/org/eclipse/pde/core/build/IBuildModel.java;2;2;4;1;3;2;3;1;26;0;1;232;33;33;2;0;1;1;4;276;1;336;3;2;0
/org.eclipse.jdt.debug/eval/org/eclipse/jdt/internal/debug/eval/ast/engine/EvaluationSourceGenerator.java;4;1;8;3;3;3;3;5;15;3;3;76;38;38;3;2;0;5;8;228;2;336;6;4;2
/org.eclipse.jface.text/src/org/eclipse/jface/text/reconciler/AbstractReconciler.java;3;5;11;3;6;2;6;5;74;2;4;48;166;166;5;1;4;5;11;325;5;325;6;3;0
/org.eclipse.swt/Eclipse SWT PI/motif/org/eclipse/swt/internal/motif/XRectangle.java;1;0;1;1;0;0;0;1;8;0;1;54;8;8;1;0;0;1;1;54;0;54;1;1;0
/org.eclipse.pde.ui/src/org/eclipse/pde/internal/ui/editor/plugin/AlertSection.java;2;2;4;1;4;3;4;0;10;0;0;292;19;19;2;0;1;0;4;308;1;336;3;2;0
/org.eclipse.ui.ide/src/org/eclipse/ui/views/navigator/NavigatorFrameSource.java;1;0;1;1;0;0;0;1;0;0;1;129;0;0;1;0;0;1;1;129;0;129;1;1;0
/org.eclipse.jdt.core/eval/org/eclipse/jdt/internal/eval/CodeSnippetEvaluator.java;3;0;5;1;1;1;1;4;12;1;4;2;20;20;1;0;0;4;5;2;0;314;5;3;0
/org.eclipse.jdt.core/model/org/eclipse/jdt/internal/core/util/AnonymousFileSource.java;3;0;3;1;0;0;0;3;4;1;3;70;7;7;1;0;0;3;3;70;0;199;3;3;0
/org.eclipse.jdt.core/compiler/org/eclipse/jdt/internal/compiler/Compiler.java;4;2;14;2;3;2;3;11;59;3;7;2;226;226;3;4;1;11;14;2;5;312;9;4;0
/org.eclipse.ui.editors/src/org/eclipse/ui/texteditor/BookmarkRulerAction.java;2;0;3;1;1;1;1;2;31;1;2;118;39;39;1;0;0;2;3;118;0;336;3;2;0
/org.eclipse.debug.ui/ui/org/eclipse/debug/internal/ui/actions/RemoveAllTerminatedAction.java;2;1;2;1;2;2;2;0;5;0;0;301;9;9;1;0;0;0;2;301;0;336;2;2;0
/org.eclipse.ltk.ui.refactoring/src/org/eclipse/ltk/internal/ui/refactoring/InternalAPI.java;1;2;3;1;3;2;3;0;2;0;0;273;3;3;2;0;1;0;3;273;1;336;2;1;0
/org.eclipse.core.runtime/src/org/eclipse/core/runtime/IExtension.java;4;2;10;1;4;3;4;6;141;2;5;171;254;254;2;1;1;6;10;179;2;337;8;4;0
/org.eclipse.jdt.debug.ui/ui/org/eclipse/jdt/internal/debug/ui/ActionFilterAdapterFactory.java;1;0;1;1;0;0;0;1;2;0;1;92;2;2;1;0;0;1;1;92;0;92;1;1;0
/org.eclipse.debug.core/core/org/eclipse/debug/internal/core/sourcelookup/SourceLookupMessages.java;2;0;1;2;0;0;0;1;4;0;1;205;4;4;1;0;0;1;1;205;0;205;1;2;0
/org.eclipse.jdt.core/compiler/org/eclipse/jdt/internal/compiler/ast/CastExpression.java;3;0;17;2;1;1;1;16;527;7;8;41;647;647;7;8;0;16;17;71;8;300;9;3;5
/org.eclipse.ui.ide/src/org/eclipse/ui/internal/ide/model/WorkbenchAdapterBuilder.java;1;0;1;1;0;0;0;1;0;0;1;132;0;0;1;0;0;1;1;132;0;132;1;1;0
/org.eclipse.debug.ui/ui/org/eclipse/debug/internal/ui/actions/StatusInfo.java;1;0;1;1;0;0;0;1;0;0;1;92;0;0;1;0;0;1;1;92;0;92;1;1;0
/org.eclipse.jdt.core/antadapter/org/eclipse/jdt/internal/antadapter/AntAdapterMessages.java;1;0;2;1;0;0;0;2;2;1;2;180;2;2;1;0;0;2;2;180;0;199;2;1;0
/org.eclipse.help.base/src/org/eclipse/help/internal/search/QueryWordsPhrase.java;1;1;4;1;3;3;3;1;14;0;1;104;24;24;1;0;0;1;4;104;0;336;4;1;0
/org.eclipse.jface.text/src/org/eclipse/jface/text/contentassist/JFaceTextMessages.java;1;0;2;1;2;1;2;0;11;0;0;336;11;11;2;0;1;0;2;336;1;336;1;1;0
/org.eclipse.jdt.debug/jdi/org/eclipse/jdi/internal/event/VMDeathEventImpl.java;1;0;1;1;0;0;0;1;3;0;1;144;3;3;1;0;0;1;1;144;0;144;1;1;0
/org.eclipse.jdt.ui/ui/org/eclipse/jdt/internal/ui/text/java/JavaCodeScanner.java;3;2;8;1;5;4;5;3;149;1;3;97;384;384;2;0;1;3;8;273;1;336;7;3;1
/org.eclipse.pde.ui/src/org/eclipse/pde/internal/ui/wizards/feature/BasePluginListPage.java;2;1;2;1;2;2;2;0;4;0;0;298;4;4;1;0;0;0;2;298;0;336;2;2;0
/org.eclipse.ui.forms/src/org/eclipse/ui/forms/widgets/ImageHyperlink.java;1;1;7;1;3;3;3;4;55;3;2;225;108;108;3;2;0;4;7;225;2;332;5;1;0
/org.eclipse.jdt.core/model/org/eclipse/jdt/internal/core/builder/BuildNotifier.java;2;0;3;1;0;0;0;3;6;1;3;8;10;10;1;0;0;3;3;8;0;199;3;2;0
/org.eclipse.ltk.ui.refactoring/src/org/eclipse/ltk/internal/ui/refactoring/IPreviewWizardPage.java;1;0;2;1;1;1;1;1;2;0;1;269;2;2;1;0;0;1;2;269;0;336;2;1;0
/org.eclipse.pde.core/src/org/eclipse/pde/internal/core/ibundle/IBundle.java;1;1;2;1;2;2;2;0;10;0;0;293;10;10;1;0;0;0;2;293;0;336;2;1;0
/org.eclipse.swt/Eclipse SWT/carbon/org/eclipse/swt/widgets/Widget.java;5;1;30;2;2;2;2;28;350;10;11;1;683;683;10;17;0;28;30;18;17;337;13;5;0
/org.eclipse.ui.ide/src/org/eclipse/ui/views/bookmarkexplorer/BookmarkAction.java;1;0;1;1;0;0;0;1;0;0;1;129;0;0;1;0;0;1;1;129;0;129;1;1;0
/org.eclipse.debug.ui/ui/org/eclipse/debug/internal/ui/views/launch/LaunchViewEventHandler.java;5;2;19;2;4;3;4;15;93;4;9;9;242;242;4;6;1;15;19;171;7;336;12;5;2
/org.eclipse.compare/compare/org/eclipse/compare/structuremergeviewer/DocumentRangeNode.java;1;0;4;1;0;0;0;4;17;2;3;79;32;32;2;1;0;4;4;219;1;219;3;1;0
/org.eclipse.ui.workbench.texteditor/src/org/eclipse/ui/texteditor/IElementStateListenerExtension.java;2;0;1;2;1;1;1;0;4;0;0;336;4;4;1;0;0;0;1;336;0;336;1;2;0
/org.eclipse.jdt.ui/core refactoring/org/eclipse/jdt/internal/corext/refactoring/rename/RenameJavaProjectProcessor.java;2;2;16;1;4;3;4;12;67;5;7;71;118;118;5;5;1;12;16;247;6;336;10;2;0
/org.eclipse.debug.ui/ui/org/eclipse/debug/internal/ui/launchConfigurations/CreateLaunchConfigurationAction.java;1;0;1;1;0;0;0;1;6;0;1;33;6;6;1;0;0;1;1;33;0;33;1;1;0
/org.eclipse.core.resources/src/org/eclipse/core/internal/resources/SaveContext.java;1;0;1;1;1;1;1;0;204;0;0;277;204;204;1;0;0;0;1;277;0;277;1;1;0
/org.eclipse.ui.workbench/Eclipse UI/org/eclipse/ui/internal/PartListenerList.java;2;1;2;1;2;2;2;0;30;0;0;287;32;32;1;0;0;0;2;287;0;336;2;2;0
/org.eclipse.update.ui/src/org/eclipse/update/internal/ui/properties/FeatureStatusPropertyPage.java;3;1;7;2;2;2;2;5;53;3;3;54;70;70;3;2;0;5;7;54;2;336;5;3;0
/org.eclipse.compare/compare/org/eclipse/compare/Splitter.java;1;0;1;1;0;0;0;1;2;0;1;219;2;2;1;0;0;1;1;219;0;219;1;1;0
/org.eclipse.swt/Eclipse SWT Mozilla/common/org/eclipse/swt/internal/mozilla/nsIObserver.java;1;0;1;1;0;0;0;1;0;0;1;100;0;0;1;0;0;1;1;100;0;100;1;1;0
/org.eclipse.pde.ui/src/org/eclipse/pde/internal/ui/editor/XMLSourcePage.java;2;1;4;1;3;3;3;1;57;0;1;59;69;69;1;0;0;1;4;59;0;336;4;2;0
/org.eclipse.pde/src/org/eclipse/pde/internal/builders/ISchemaTransformer.java;2;0;5;1;1;1;1;4;6;1;4;62;18;18;1;0;0;4;5;62;0;336;5;2;0
/org.eclipse.search/new search/org/eclipse/search/ui/text/AbstractTextSearchResult.java;2;4;9;2;5;2;5;4;189;2;3;207;572;572;4;1;3;4;9;276;4;302;5;2;0
/org.eclipse.ui.editors/src/org/eclipse/ui/texteditor/AddMarkerAction.java;2;2;8;2;4;3;4;4;324;1;4;118;357;357;2;0;1;4;8;276;1;336;7;2;0
/org.eclipse.compare/compare/org/eclipse/compare/CompareViewerSwitchingPane.java;1;0;1;1;0;0;0;1;2;0;1;219;2;2;1;0;0;1;1;219;0;219;1;1;0
/org.eclipse.jdt.ui/ui/org/eclipse/jdt/internal/ui/search/JavaSearchOperation.java;3;1;4;1;2;2;2;2;15;1;2;127;26;26;1;0;0;2;4;127;0;336;4;3;0
/org.eclipse.pde.core/src/org/eclipse/pde/internal/core/site/AbstractSiteBuildModel.java;3;1;8;2;2;2;2;6;26;3;4;166;38;38;3;2;0;6;8;166;2;336;6;3;0
/org.eclipse.pde.ui/src/org/eclipse/pde/internal/ui/launcher/ConfigurationTab.java;2;7;11;2;8;2;8;3;232;2;2;210;343;343;7;1;6;3;11;308;7;308;4;2;0
/org.eclipse.pde.ui/src/org/eclipse/pde/internal/ui/editor/feature/FeatureFormPage.java;2;1;4;1;3;3;3;1;73;0;1;232;85;85;1;0;0;1;4;232;0;336;4;2;0
/org.eclipse.ui.editors/src/org/eclipse/ui/editors/text/IStorageDocumentProvider.java;1;0;1;1;1;1;1;0;5;0;0;336;5;5;1;0;0;0;1;336;0;336;1;1;0
/org.eclipse.pde.build/src_ant/org/eclipse/pde/internal/build/tasks/FetchFileGeneratorTask.java;2;2;9;2;3;2;3;6;29;2;4;31;42;42;2;2;1;6;9;31;3;336;6;2;0
/org.eclipse.ui.ide/src/org/eclipse/ui/internal/ide/registry/MarkerHelpRegistryReader.java;2;0;3;1;0;0;0;3;10;2;2;132;10;10;2;1;0;3;3;158;1;158;2;2;0
/org.eclipse.swt/Eclipse SWT Browser/win32/org/eclipse/swt/browser/WebSite.java;3;4;10;2;9;3;9;1;281;0;1;156;360;360;4;0;6;1;10;280;6;329;4;3;1
/org.eclipse.jdt.debug.ui/ui/org/eclipse/jdt/internal/debug/ui/actions/AddLibraryAction.java;2;0;2;2;2;1;2;0;3;0;0;296;3;3;2;0;1;0;2;296;1;296;1;2;0
/org.eclipse.jdt.junit/src/org/eclipse/jdt/internal/junit/wizards/NewTestCaseCreationWizardPage.java;4;4;18;3;6;3;6;12;148;3;9;12;440;440;4;3;3;12;18;324;6;324;12;4;0
/org.eclipse.debug.ui/ui/org/eclipse/debug/internal/ui/launchConfigurations/LaunchGroupExtension.java;2;1;3;1;2;2;2;1;29;0;1;134;56;56;1;0;0;1;3;134;0;294;3;2;1
/org.eclipse.update.ui/src/org/eclipse/update/internal/ui/parts/OverlayIcon.java;1;0;1;1;0;0;0;1;7;0;1;58;7;7;1;0;0;1;1;58;0;58;1;1;0
/org.eclipse.jdt.debug.ui/ui/org/eclipse/jdt/internal/debug/ui/snippeteditor/SnippetEditorStorageDocumentProvider.java;1;0;1;1;1;1;1;0;0;0;0;273;0;0;1;0;0;0;1;273;0;273;1;1;0
/org.eclipse.ui.ide/src/org/eclipse/ui/internal/ide/dialogs/MultiStepReviewWizardPage.java;2;1;3;1;2;2;2;1;24;0;1;132;26;26;1;0;0;1;3;132;0;336;3;2;0
/org.eclipse.help.ui/src/org/eclipse/help/ui/internal/browser/SystemBrowserAdapter.java;1;1;5;1;3;3;3;2;20;1;2;156;48;48;1;0;0;2;5;156;0;336;5;1;0
/org.eclipse.help.appserver/src/org/eclipse/help/internal/appserver/PluginClassLoaderWrapper.java;1;3;8;1;7;4;7;1;172;0;1;253;390;390;3;0;3;1;8;309;3;336;5;1;0
/org.eclipse.jdt.core/model/org/eclipse/jdt/internal/core/MultiOperation.java;3;0;5;1;1;1;1;4;64;1;4;10;99;99;1;0;0;4;5;10;0;314;5;3;0
/org.eclipse.jdt.debug.ui/ui/org/eclipse/jdt/debug/ui/launchConfigurations/JavaSourceLookupTab.java;3;1;3;1;2;2;2;1;8;0;1;187;14;14;1;0;0;1;3;187;0;336;3;3;0
/org.eclipse.jdt.ui/ui/org/eclipse/jdt/ui/actions/GenerateNewConstructorUsingFieldsAction.java;3;2;17;2;4;3;6;11;175;5;6;94;423;423;5;5;3;13;17;94;8;336;9;3;0
/org.eclipse.jdt.core/model/org/eclipse/jdt/internal/core/ClassFile.java;4;0;32;2;2;1;2;30;174;6;11;10;490;490;6;19;1;30;32;51;20;276;12;4;2
/org.eclipse.jdt.debug.ui/ui/org/eclipse/jdt/internal/debug/ui/actions/ActionDelegateHelper.java;4;2;7;2;3;2;3;4;14;2;3;104;29;29;2;1;1;4;7;104;2;336;5;4;0
/org.eclipse.jdt.ui/core refactoring/org/eclipse/jdt/internal/corext/refactoring/participants/ResourceExtender.java;2;1;2;1;2;2;2;0;8;0;0;283;8;8;1;0;0;0;2;283;0;336;2;2;0
/org.eclipse.jdt.ui/ui/org/eclipse/jdt/ui/jarpackager/JarWriter.java;2;2;5;2;3;2;3;2;10;1;2;28;32;32;2;0;1;2;5;280;1;336;4;2;0
/org.eclipse.ui.ide/extensions/org/eclipse/ui/actions/CopyResourceAction.java;4;1;5;1;2;2;2;3;38;1;3;132;56;56;1;0;0;3;5;132;0;336;5;4;0
/org.eclipse.jdt.ui/ui/org/eclipse/jdt/ui/PreferenceConstants.java;8;4;57;7;5;2;18;39;680;17;10;35;1801;1801;17;29;16;52;57;264;45;325;12;8;0
/org.eclipse.pde.ui/src/org/eclipse/pde/internal/ui/wizards/WizardElement.java;3;1;3;1;3;3;3;0;194;0;0;295;230;230;1;0;0;0;3;295;0;336;3;3;0
/org.eclipse.search/search/org/eclipse/search/internal/ui/SearchPluginImages.java;3;2;7;1;4;3;4;3;4;2;2;224;14;14;2;1;1;3;7;224;2;336;5;3;0
/org.eclipse.team.ui/src/org/eclipse/team/internal/ui/ProjectSetContentHandler.java;1;0;1;1;0;0;0;1;27;0;1;139;27;27;1;0;0;1;1;139;0;139;1;1;0
/org.eclipse.pde.core/src/org/eclipse/pde/internal/core/ibundle/IBundlePluginModelProvider.java;1;1;2;1;2;2;2;0;6;0;0;292;6;6;1;0;0;0;2;292;0;336;2;1;0
/org.eclipse.pde.core/src/org/eclipse/pde/internal/core/feature/FeaturePlugin.java;3;2;5;1;3;2;3;2;35;1;2;130;63;63;2;0;1;2;5;330;1;330;4;3;0
/org.eclipse.jdt.ui/ui/org/eclipse/jdt/internal/ui/browsing/PackagesViewLabelProvider.java;3;0;3;2;1;1;1;2;19;1;2;35;37;37;1;0;0;2;3;35;0;336;3;3;0
/org.eclipse.jface.text/src/org/eclipse/jface/text/ITextOperationTarget.java;2;0;2;2;2;1;2;0;21;0;0;336;21;21;2;0;1;0;2;336;1;336;1;2;0
/org.eclipse.pde.core/src/org/eclipse/pde/internal/core/site/SiteCategoryDefinition.java;2;1;3;1;2;2;2;1;16;0;1;232;27;27;1;0;0;1;3;232;0;336;3;2;0
/org.eclipse.ui.intro/src/org/eclipse/ui/internal/intro/impl/util/Util.java;1;4;8;1;8;2;8;0;65;0;0;276;113;113;4;0;6;0;8;276;6;301;2;1;0
/org.eclipse.ui.workbench/Eclipse UI/org/eclipse/ui/commands/CommandManagerEvent.java;2;0;4;1;1;1;1;3;271;1;3;161;583;583;1;0;0;3;4;161;0;281;4;2;0
/org.eclipse.swt/Eclipse SWT/carbon/org/eclipse/swt/widgets/Scale.java;3;1;4;1;2;2;2;2;22;1;2;19;31;31;1;0;0;2;4;19;0;337;4;3;2
/org.eclipse.osgi/core/adaptor/org/eclipse/osgi/framework/log/FrameworkLogEntry.java;3;0;5;1;1;1;1;4;21;2;3;215;45;45;2;1;0;4;5;215;1;276;4;3;0
/org.eclipse.pde.ui/src/org/eclipse/pde/internal/ui/wizards/feature/BaseFeatureSpecPage.java;2;6;8;1;8;3;8;0;319;0;0;298;516;516;6;0;5;0;8;298;5;336;3;2;0
/org.eclipse.core.resources/src/org/eclipse/core/internal/properties/StoreKey.java;2;0;2;1;1;1;1;1;281;0;1;100;290;290;1;0;0;1;2;100;0;277;2;2;0
/org.eclipse.jdt.launching/launching/org/eclipse/jdt/launching/sourcelookup/JavaProjectSourceLocation.java;3;1;4;1;2;2;2;2;21;1;2;141;48;48;1;0;0;2;4;141;0;336;4;3;1
/org.eclipse.jdt.launching/launching/org/eclipse/jdt/internal/launching/ClasspathVariableSourceContainerTypeDelegate.java;2;0;4;1;1;1;1;3;18;2;2;230;23;23;2;1;0;3;4;268;1;299;3;2;0
/org.eclipse.swt/Eclipse SWT PI/carbon/org/eclipse/swt/internal/carbon/AlertStdCFStringAlertParamRec.java;1;0;2;1;2;1;2;0;20;0;0;296;20;20;2;0;1;0;2;296;1;296;1;1;0
/org.eclipse.ui.workbench/Eclipse UI/org/eclipse/ui/commands/CommandEvent.java;2;0;7;1;1;1;1;6;291;2;4;70;716;716;2;2;0;6;7;70;2;281;5;2;0
/org.eclipse.debug.ui/ui/org/eclipse/debug/internal/ui/views/registers/RegistersViewMessages.java;1;0;1;1;0;0;0;1;0;0;1;239;0;0;1;0;0;1;1;239;0;239;1;1;0
/org.eclipse.jdt.debug.ui/ui/org/eclipse/jdt/internal/debug/ui/actions/ShowStaticVariablesAction.java;1;0;1;1;0;0;0;1;4;0;1;187;4;4;1;0;0;1;1;187;0;187;1;1;0
/org.eclipse.ui.workbench/Eclipse UI/org/eclipse/ui/internal/dialogs/FilteredPreferenceDialog.java;2;0;9;1;1;1;1;8;112;2;5;177;289;289;2;3;0;8;9;189;3;336;6;2;1
/org.eclipse.jdt.core/dom/org/eclipse/jdt/core/dom/TypeParameter.java;4;3;12;1;4;2;4;8;268;3;5;163;310;310;3;3;2;8;12;230;5;336;7;4;2
/org.eclipse.update.ui/src/org/eclipse/update/internal/ui/wizards/ReplaceFeatureVersionWizard.java;1;0;1;1;0;0;0;1;0;0;1;76;0;0;1;0;0;1;1;76;0;76;1;1;1
/org.eclipse.ui.workbench/Eclipse UI/org/eclipse/ui/commands/IKeySequenceBinding.java;3;1;4;1;2;2;2;2;6;1;2;148;16;16;1;0;0;2;4;148;0;336;4;3;0
/org.eclipse.jdt.ui/ui refactoring/org/eclipse/jdt/internal/ui/refactoring/reorg/DestinationContentProvider.java;5;1;5;1;2;2;2;3;43;1;3;70;74;74;1;0;0;3;5;70;0;336;5;5;0
/org.eclipse.jdt.ui/ui/org/eclipse/jdt/internal/ui/packageview/PackageExplorerActionGroup.java;6;1;13;3;4;4;4;9;80;3;5;78;279;279;3;4;0;9;13;237;4;336;9;6;0
/org.eclipse.ui.workbench/Eclipse UI/org/eclipse/ui/internal/commands/ws/WidgetMethodHandler.java;3;1;5;1;4;4;4;1;14;0;1;269;42;42;1;0;0;1;5;269;0;336;5;3;0
/org.eclipse.team.core/src/org/eclipse/team/core/variants/CachedResourceVariant.java;2;2;6;1;5;4;5;1;47;0;1;239;103;103;2;0;1;1;6;290;1;336;5;2;1
/org.eclipse.ltk.core.refactoring/src/org/eclipse/ltk/core/refactoring/RefactoringStatusContext.java;2;2;5;1;4;3;4;1;10;0;1;264;20;20;2;0;1;1;5;274;1;337;4;2;0
/org.eclipse.help.ide/src/org/eclipse/help/ui/internal/search/HelpSearchQuery.java;1;1;4;1;4;4;4;0;10;0;0;281;16;16;1;0;0;0;4;281;0;311;4;1;0
/org.eclipse.team.cvs.core/src/org/eclipse/team/internal/ccvs/core/util/ResourceStateChangeListeners.java;1;0;2;1;0;0;0;2;27;1;2;142;27;27;1;0;0;2;2;142;0;150;2;1;0
/org.eclipse.ui.workbench/Eclipse UI/org/eclipse/ui/internal/presentations/PresentationFactoryUtil.java;3;2;3;2;3;2;3;0;9;0;0;303;11;11;2;0;1;0;3;303;1;331;2;3;0
/org.eclipse.help.webapp/src_servlets/org/eclipse/help/internal/webapp/data/LayoutData.java;1;1;8;1;3;3;3;5;61;2;4;44;178;178;2;1;0;5;8;156;1;336;7;1;1
/org.eclipse.core.resources/src/org/eclipse/core/internal/localstore/DeleteVisitor.java;1;1;3;1;2;2;2;1;202;0;1;169;212;212;1;0;0;1;3;169;0;294;3;1;0
/org.eclipse.ui.workbench/Eclipse UI/org/eclipse/ui/internal/decorators/FullTextDecoratorRunnable.java;1;0;1;1;0;0;0;1;0;0;1;233;0;0;1;0;0;1;1;233;0;233;1;1;0
/org.eclipse.jdt.debug.ui/ui/org/eclipse/jdt/internal/debug/ui/snippeteditor/SnippetFileDocumentProvider.java;1;0;1;1;1;1;1;0;26;0;0;273;26;26;1;0;0;0;1;273;0;273;1;1;0
/org.eclipse.osgi/core/framework/org/eclipse/osgi/framework/eventmgr/EventThread.java;4;2;6;1;4;3;4;2;301;1;2;171;390;390;2;0;1;2;6;302;1;302;5;4;0
/org.eclipse.jdt.core/search/org/eclipse/jdt/internal/core/index/Index.java;2;0;5;1;1;1;1;4;201;1;4;191;249;249;1;0;0;4;5;191;0;283;5;2;0
/org.eclipse.ui.ide/src/org/eclipse/ui/internal/ide/dialogs/ZipFileResourceExportOperation.java;1;0;1;1;0;0;0;1;0;0;1;132;0;0;1;0;0;1;1;132;0;132;1;1;0
/org.eclipse.jdt.core/dom/org/eclipse/jdt/internal/core/dom/rewrite/TrackedNodePosition.java;2;0;2;1;1;1;1;1;20;0;1;262;20;20;1;0;0;1;2;262;0;290;2;2;0
/org.eclipse.jface.text/src/org/eclipse/jface/text/DefaultUndoManager.java;2;2;8;2;5;3;5;3;192;1;3;55;426;426;2;0;2;3;8;275;2;336;6;2;0
/org.eclipse.search/search/org/eclipse/search/internal/ui/SelectAllAction.java;1;0;1;1;1;1;1;0;2;0;0;336;2;2;1;0;0;0;1;336;0;336;1;1;1
/org.eclipse.jdt.debug.ui/ui/org/eclipse/jdt/internal/debug/ui/display/DisplayViewerConfiguration.java;2;0;2;1;0;0;0;2;37;1;2;76;39;39;1;0;0;2;2;76;0;228;2;2;0
/org.eclipse.pde.core/src/org/eclipse/pde/internal/core/AbstractModel.java;3;2;11;2;5;3;5;6;40;2;4;166;105;105;2;2;2;6;11;166;4;336;7;3;0
/org.eclipse.update.core/src/org/eclipse/update/core/VersionedIdentifier.java;3;1;5;1;3;3;3;2;8;1;2;0;27;27;1;0;0;2;5;0;0;336;5;3;0
/org.eclipse.ui.ide/src/org/eclipse/ui/views/navigator/ResourceNavigatorMoveAction.java;1;0;1;1;0;0;0;1;0;0;1;129;0;0;1;0;0;1;1;129;0;129;1;1;0
/org.eclipse.pde.core/src/org/eclipse/pde/internal/core/feature/FeatureData.java;2;1;3;1;2;2;2;1;32;0;1;232;44;44;1;0;0;1;3;232;0;336;3;2;0
/org.eclipse.ant.ui/Ant Editor/org/eclipse/ant/internal/ui/editor/model/AntModelMessages.java;1;0;1;1;0;0;0;1;0;0;1;204;0;0;1;0;0;1;1;204;0;204;1;1;1
/org.eclipse.jdt.core/eval/org/eclipse/jdt/internal/eval/CodeSnippetMessageSend.java;3;0;9;1;0;0;0;9;162;1;9;3;190;190;1;0;0;9;9;3;0;199;9;3;0
/org.eclipse.debug.ui/ui/org/eclipse/debug/internal/ui/preferences/DebugPreferencePage.java;5;2;19;4;4;3;4;15;81;5;7;19;288;288;5;8;1;15;19;245;9;304;10;5;0
/org.eclipse.ui.editors/src/org/eclipse/ui/internal/editors/quickdiff/LastSaveReferenceProvider.java;3;3;18;3;6;2;6;12;257;5;5;75;802;802;5;7;4;12;18;97;11;324;7;3;0
/org.eclipse.jdt.core/model/org/eclipse/jdt/internal/core/SourceMapper.java;5;3;17;2;4;2;4;13;91;3;9;5;232;232;3;4;2;13;17;5;6;329;11;5;1
/org.eclipse.jdt.core/compiler/org/eclipse/jdt/internal/compiler/util/HashtableOfPackage.java;2;0;3;1;0;0;0;3;6;1;3;199;10;10;1;0;0;3;3;199;0;245;3;2;0
/org.eclipse.jdt.ui/core refactoring/org/eclipse/jdt/internal/corext/refactoring/code/CallContext.java;2;0;2;1;1;1;1;1;6;0;1;116;8;8;1;0;0;1;2;116;0;336;2;2;1
/org.eclipse.ui.workbench/Eclipse UI/org/eclipse/ui/dialogs/PropertyPage.java;1;0;1;1;1;1;1;0;77;0;0;293;77;77;1;0;0;0;1;293;0;293;1;1;0
/org.eclipse.compare/compare/org/eclipse/compare/internal/CompareNavigator.java;1;0;1;1;0;0;0;1;34;0;1;104;34;34;1;0;0;1;1;104;0;104;1;1;0
/org.eclipse.jface.text/src/org/eclipse/jface/text/TextPresentation.java;4;3;14;2;6;3;6;8;139;5;4;82;426;426;5;4;3;8;14;165;7;336;7;4;0
/org.eclipse.core.resources/src/org/eclipse/core/resources/IFile.java;3;1;17;3;2;2;9;8;1802;8;7;3;2024;2024;8;1;7;15;17;270;8;336;9;3;1
/org.eclipse.team.cvs.ui/src/org/eclipse/team/internal/ccvs/ui/wizards/TagSelectionWizardPage.java;1;3;5;1;4;2;4;1;51;0;1;265;93;93;3;0;2;1;5;306;2;306;3;1;0
/org.eclipse.jface.text/projection/org/eclipse/jface/text/source/projection/ProjectionRulerColumn.java;2;4;11;2;8;3;8;3;91;2;2;247;240;240;4;1;5;3;11;279;6;336;5;2;0
/org.eclipse.ui.ide/src/org/eclipse/ui/wizards/datatransfer/PopulateElementOperation.java;1;0;1;1;0;0;0;1;0;0;1;92;0;0;1;0;0;1;1;92;0;92;1;1;0
/org.eclipse.jface/src/org/eclipse/jface/viewers/TableTreeViewer.java;2;0;3;1;1;1;1;2;15;0;1;233;17;17;2;1;0;2;3;233;1;336;2;2;1
/org.eclipse.update.configurator/src/org/eclipse/update/configurator/ConfiguratorUtils.java;1;1;3;1;2;2;2;1;7;0;1;198;14;14;1;0;0;1;3;198;0;336;3;1;0
/org.eclipse.update.core/src/org/eclipse/update/core/ISiteFactory.java;2;1;3;1;2;2;2;1;6;0;1;58;16;16;1;0;0;1;3;58;0;336;3;2;0
/org.eclipse.update.core/src/org/eclipse/update/configuration/IConfiguredSiteChangedListener.java;1;0;1;1;0;0;0;1;2;0;1;58;2;2;1;0;0;1;1;58;0;58;1;1;0
/org.eclipse.swt/Eclipse SWT/motif/org/eclipse/swt/widgets/Decorations.java;5;1;10;2;3;3;3;7;126;3;4;6;310;310;3;3;0;7;10;6;3;337;7;5;0
/org.eclipse.jdt.launching/launching/org/eclipse/jdt/launching/sourcelookup/containers/JavaSourceLookupParticipant.java;2;1;5;1;3;3;4;1;56;0;1;269;72;72;2;0;1;2;5;269;1;321;4;2;0
/org.eclipse.pde.core/src/org/eclipse/pde/internal/core/site/SiteBuild.java;2;1;4;1;3;3;3;1;39;0;1;232;80;80;1;0;0;1;4;232;0;336;4;2;0
/org.eclipse.jdt.ui/ui refactoring/org/eclipse/jdt/internal/ui/refactoring/ComboSelectionDialog.java;1;0;1;1;1;1;1;0;2;0;0;336;2;2;1;0;0;0;1;336;0;336;1;1;0
/org.eclipse.jdt.core/compiler/org/eclipse/jdt/internal/compiler/codegen/FieldNameAndTypeCache.java;2;0;2;1;1;1;1;1;2;0;1;199;4;4;1;0;0;1;2;199;0;314;2;2;0
/org.eclipse.ant.ui/Ant Tools Support/org/eclipse/ant/internal/ui/preferences/AntRuntimePreferencePage.java;1;0;6;1;0;0;0;6;51;3;3;108;79;79;3;3;0;6;6;170;3;170;3;1;1
/org.eclipse.swt/Eclipse SWT/common_j2me/org/eclipse/swt/internal/Compatibility.java;3;1;4;1;2;2;2;2;15;1;2;230;27;27;1;0;0;2;4;230;0;337;4;3;0
/org.eclipse.jface.text/src/org/eclipse/jface/text/source/IVerticalRulerExtension.java;2;0;2;2;2;1;2;0;9;0;0;336;9;9;2;0;1;0;2;336;1;336;1;2;0
/org.eclipse.update.ui/src/org/eclipse/update/internal/ui/ConfigurationManagerWindow.java;4;1;6;2;3;3;3;3;229;2;2;54;290;290;2;1;0;3;6;54;1;336;5;4;0
/org.eclipse.jdt.core/compiler/org/eclipse/jdt/internal/compiler/flow/ExceptionHandlingFlowContext.java;2;0;6;2;0;0;0;6;29;2;5;34;50;50;2;1;0;6;6;199;1;199;5;2;0
/org.eclipse.jdt.ui/ui/org/eclipse/jdt/internal/ui/packageview/PackagesFrameSource.java;1;0;1;1;1;1;1;0;2;0;0;336;2;2;1;0;0;0;1;336;0;336;1;1;0
/org.eclipse.jdt.core/model/org/eclipse/jdt/core/util/IConstantValueAttribute.java;1;0;1;1;0;0;0;1;2;0;1;199;2;2;1;0;0;1;1;199;0;199;1;1;0
/org.eclipse.ui.workbench/Eclipse UI/org/eclipse/ui/internal/decorators/DecorationResult.java;2;1;2;1;2;2;2;0;23;0;0;326;25;25;1;0;0;0;2;326;0;336;2;2;0
/org.eclipse.update.core/src/org/eclipse/update/internal/operations/DuplicateConflictsValidator.java;1;2;7;1;4;3;4;3;30;1;3;54;45;45;2;0;1;3;7;296;1;336;6;1;0
/org.eclipse.jdt.ui/ui/org/eclipse/jdt/internal/ui/preferences/NameConventionConfigurationBlock.java;2;0;11;1;1;1;1;10;46;3;6;57;124;124;3;4;0;10;11;177;4;336;7;2;0
/org.eclipse.jdt.junit/src/org/eclipse/jdt/internal/junit/refactoring/LaunchConfigProjectChange.java;2;1;2;1;2;2;2;0;10;0;0;272;10;10;1;0;0;0;2;272;0;336;2;2;1
/org.eclipse.jdt.ui/ui/org/eclipse/jdt/internal/ui/jarpackager/JarPackageWriter.java;2;1;4;1;2;2;2;2;40;1;2;142;53;53;1;0;0;2;4;142;0;336;4;2;0
/org.eclipse.ui.ide/src/org/eclipse/ui/views/navigator/RefactorActionGroup.java;5;0;6;2;1;1;1;5;20;2;4;129;50;50;2;1;0;5;6;258;1;336;5;5;0
/org.eclipse.jdt.core/codeassist/org/eclipse/jdt/internal/codeassist/ISelectionRequestor.java;2;0;3;1;2;1;2;1;59;0;1;199;61;61;2;0;1;1;3;324;1;324;2;2;2
/org.eclipse.ui.workbench.texteditor/src/org/eclipse/ui/texteditor/InfoForm.java;2;2;3;2;3;2;3;0;6;0;0;276;8;8;2;0;1;0;3;276;1;336;2;2;1
/org.eclipse.ui.ide/src/org/eclipse/ui/views/framelist/IFrameListHelpContextIds.java;1;0;1;1;0;0;0;1;0;0;1;129;0;0;1;0;0;1;1;129;0;129;1;1;0
/org.eclipse.ui.ide/src/org/eclipse/ui/views/markers/internal/IField.java;2;0;2;1;0;0;0;2;5;1;2;129;5;5;1;0;0;2;2;129;0;181;2;2;0
/org.eclipse.pde.ui/src/org/eclipse/pde/internal/ui/editor/plugin/rows/BooleanAttributeRow.java;3;2;5;2;5;4;5;0;27;0;0;292;47;47;2;0;1;0;5;325;1;336;4;3;0
/org.eclipse.text/src/org/eclipse/jface/text/IDocumentInformationMapping.java;2;0;3;2;2;1;2;1;14;0;1;233;16;16;2;0;1;1;3;334;1;334;2;2;0
/org.eclipse.team.cvs.ui/src/org/eclipse/team/internal/ccvs/ui/repo/RefreshRemoteProjectWizard.java;2;1;2;1;2;2;2;0;31;0;0;326;33;33;1;0;0;0;2;326;0;336;2;2;1
/org.eclipse.jdt.ui/ui refactoring/org/eclipse/jdt/internal/ui/refactoring/InlineTempWizard.java;4;1;9;1;2;2;3;6;281;2;5;36;303;303;2;1;1;7;9;36;2;336;7;4;0
/org.eclipse.debug.ui/ui/org/eclipse/debug/internal/ui/launchConfigurations/PerspectiveManager.java;4;2;23;2;8;5;8;15;411;5;8;42;1009;1009;5;7;3;15;23;246;10;336;13;4;1
/org.eclipse.ui.ide/src/org/eclipse/ui/views/markers/internal/TableViewLabelProvider.java;1;0;1;1;0;0;0;1;0;0;1;129;0;0;1;0;0;1;1;129;0;129;1;1;0
/org.eclipse.ui.workbench/Eclipse UI/org/eclipse/ui/keys/SWTKeySupport.java;3;1;4;1;2;2;2;2;100;1;2;181;154;154;1;0;0;2;4;181;0;336;4;3;0
/org.eclipse.pde.build/src/org/eclipse/pde/internal/build/AssembleScriptGenerator.java;2;2;9;2;3;2;3;6;17;2;4;31;21;21;2;2;1;6;9;31;3;332;6;2;0
/org.eclipse.ant.ui/Ant Tools Support/org/eclipse/ant/internal/ui/preferences/AntObjectLabelProvider.java;2;0;3;1;0;0;0;3;3;1;3;115;5;5;1;0;0;3;3;115;0;170;3;2;1
/org.eclipse.ui.externaltools/External Tools Base/org/eclipse/ui/externaltools/internal/launchConfigurations/ExternalToolsBuilderTab.java;3;0;24;3;0;0;0;24;152;6;10;20;498;498;6;14;0;24;24;38;14;267;10;3;0
/org.eclipse.core.runtime/src/org/eclipse/core/internal/jobs/DeadlockDetector.java;3;2;15;3;3;2;3;12;5863;10;3;161;5945;5945;10;9;1;12;15;161;10;296;5;3;0
/org.eclipse.pde.ui/src/org/eclipse/pde/internal/ui/parts/SharedPartWithButtons.java;1;1;2;1;2;2;2;0;82;0;0;292;86;86;1;0;0;0;2;292;0;336;2;1;0
/org.eclipse.team.core/src/org/eclipse/team/internal/core/subscribers/SyncByteConverter.java;2;0;2;1;1;1;1;1;2;0;1;239;2;2;1;0;0;1;2;239;0;336;2;2;0
/org.eclipse.ui.ide/src/org/eclipse/ui/views/framelist/FrameListMessages.java;1;0;1;1;0;0;0;1;0;0;1;129;0;0;1;0;0;1;1;129;0;129;1;1;0
/org.eclipse.pde.ui/src/org/eclipse/pde/internal/ui/wizards/extension/ExtensionTreeSelectionPage.java;2;1;2;2;2;2;2;0;22;0;0;295;22;22;1;0;0;0;2;295;0;308;2;2;0
/org.eclipse.jdt.ui/core refactoring/org/eclipse/jdt/internal/corext/refactoring/nls/NLSLine.java;2;0;2;1;1;1;1;1;4;0;1;89;6;6;1;0;0;1;2;89;0;336;2;2;0
/org.eclipse.swt/Eclipse SWT Drag and Drop/motif/org/eclipse/swt/dnd/DropTarget.java;4;1;9;2;2;2;2;7;671;2;5;0;770;770;2;2;0;7;9;30;2;337;7;4;0
/org.eclipse.ltk.ui.refactoring/src/org/eclipse/ltk/internal/ui/refactoring/util/ViewerPane.java;1;0;3;1;1;1;2;1;4;0;1;269;6;6;2;0;1;2;3;269;1;336;2;1;0
/org.eclipse.jdt.core/search/org/eclipse/jdt/internal/core/search/matching/TypeReferencePattern.java;3;0;17;3;3;1;3;14;783;3;10;52;1522;1522;3;4;2;14;17;70;6;280;11;3;5
/org.eclipse.jdt.ui/core refactoring/org/eclipse/jdt/internal/corext/refactoring/changes/RenameJavaProjectChange.java;3;0;5;1;1;1;1;4;26;1;4;32;44;44;1;0;0;4;5;32;0;336;5;3;0
/org.eclipse.swt/Eclipse SWT/carbon/org/eclipse/swt/graphics/Region.java;3;1;7;2;2;2;2;5;87;2;3;100;229;229;2;2;0;5;7;134;2;337;5;3;1
/org.eclipse.pde.core/src/org/eclipse/pde/internal/core/isite/ISite.java;2;1;3;1;2;2;2;1;6;0;1;232;12;12;1;0;0;1;3;232;0;336;3;2;0
/org.eclipse.ui.workbench/Eclipse UI/org/eclipse/ui/internal/presentations/SystemMenuRestore.java;3;0;3;2;1;1;1;2;45;0;1;256;47;47;2;1;0;2;3;256;1;279;2;3;0
/org.eclipse.update.core/src/org/eclipse/update/internal/core/SiteURLContentProvider.java;2;1;3;1;2;2;2;1;7;0;1;58;13;13;1;0;0;1;3;58;0;336;3;2;0
/org.eclipse.debug.ui/ui/org/eclipse/debug/internal/ui/launchConfigurations/LaunchConfigurationTreeContentProvider.java;3;3;9;2;4;2;4;5;83;4;2;152;141;141;4;3;2;5;9;171;5;336;4;3;0
/org.eclipse.team.cvs.ui/src/org/eclipse/team/internal/ccvs/ui/subscriber/OverrideAndCommitAction.java;2;1;10;2;2;2;2;8;49;4;4;90;99;99;4;4;0;8;10;244;4;336;6;2;0
/org.eclipse.text/src/org/eclipse/jface/text/templates/TemplateBuffer.java;2;0;4;2;2;1;2;2;8;0;1;234;13;13;2;1;1;2;4;234;2;334;2;2;0
/org.eclipse.jdt.ui/ui/org/eclipse/jdt/internal/ui/text/comment/CommentFormattingContext.java;2;0;5;1;1;1;1;4;13;3;2;120;27;27;3;2;0;4;5;120;2;336;3;2;0
/org.eclipse.jdt.core/model/org/eclipse/jdt/internal/compiler/parser/SourceMethodDeclaration.java;1;0;1;1;0;0;0;1;0;0;1;245;0;0;1;0;0;1;1;245;0;245;1;1;0
/org.eclipse.ui.workbench/Eclipse UI/org/eclipse/ui/internal/themes/FontDefinition.java;2;1;6;1;2;2;2;4;198;2;3;241;215;215;2;1;0;4;6;265;1;336;5;2;1
/org.eclipse.jdt.ui/core refactoring/org/eclipse/jdt/internal/corext/refactoring/code/flow/FlowInfo.java;2;0;2;1;1;1;1;1;10;0;1;41;12;12;1;0;0;1;2;41;0;336;2;2;0
/org.eclipse.pde.core/src/org/eclipse/pde/internal/core/plugin/PluginLibrary.java;3;2;8;2;3;2;4;4;42;2;4;130;83;83;2;0;2;5;8;267;2;336;6;3;0
/org.eclipse.jdt.ui/ui/org/eclipse/jdt/internal/ui/javaeditor/JavaSourceViewer.java;5;7;18;3;10;3;10;8;163;3;6;35;450;450;7;2;7;8;18;274;9;332;9;5;1
/org.eclipse.team.ui/src/org/eclipse/team/internal/ui/synchronize/actions/SynchronizePageDropDownAction.java;2;4;11;2;6;3;6;5;130;2;4;146;260;260;4;1;3;5;11;299;4;336;7;2;0
/org.eclipse.update.core/src/org/eclipse/update/search/IUpdateSearchFilter.java;3;1;6;3;2;2;2;4;7;2;3;54;17;17;2;1;0;4;6;54;1;336;5;3;0
/org.eclipse.team.cvs.ssh2/src/org/eclipse/team/internal/ccvs/ssh2/CVSSSH2ServerConnection.java;2;0;5;2;3;1;3;2;220;0;1;263;227;227;3;1;2;2;5;309;3;309;2;2;0
/org.eclipse.jdt.core/model/org/eclipse/jdt/internal/core/builder/MissingSourceFileException.java;1;0;1;1;0;0;0;1;2;0;1;199;2;2;1;0;0;1;1;199;0;199;1;1;0
/org.eclipse.swt/Eclipse SWT Accessibility/gtk/org/eclipse/swt/accessibility/AccessibleObject.java;4;4;23;2;6;3;6;17;1994;6;8;70;3118;3118;6;9;3;17;23;70;12;337;11;4;0
/org.eclipse.jdt.core/model/org/eclipse/jdt/internal/core/CreateMethodOperation.java;3;1;5;1;2;2;2;3;42;1;3;27;55;55;1;0;0;3;5;27;0;314;5;3;0
/org.eclipse.pde.ui/src/org/eclipse/pde/internal/ui/wizards/extension/NewExtensionPointWizard.java;3;1;5;1;5;5;5;0;27;0;0;273;49;49;1;0;0;0;5;273;0;336;5;3;0
/org.eclipse.jdt.ui/ui/org/eclipse/jdt/internal/ui/util/BusyIndicatorRunnableContext.java;1;0;1;1;1;1;1;0;2;0;0;336;2;2;1;0;0;0;1;336;0;336;1;1;0
/org.eclipse.pde.ui/src/org/eclipse/pde/internal/ui/editor/text/IPDEColorConstants.java;2;1;2;1;2;2;2;0;10;0;0;308;14;14;1;0;0;0;2;308;0;336;2;2;0
/org.eclipse.team.cvs.ssh/src/org/eclipse/team/internal/ccvs/ssh/SSHServerConnection.java;1;0;1;1;0;0;0;1;2;0;1;176;2;2;1;0;0;1;1;176;0;176;1;1;0
/org.eclipse.ui.intro/src/org/eclipse/ui/internal/intro/impl/model/AbstractIntroPartImplementation.java;2;6;11;2;11;4;11;0;401;0;0;276;459;459;6;0;7;0;11;308;7;328;4;2;0
/org.eclipse.ui.ide/src/org/eclipse/ui/wizards/newresource/BasicNewProjectResourceWizard.java;8;1;20;3;3;3;3;17;918;4;9;92;1304;1304;4;8;0;17;20;92;8;336;12;8;0
/org.eclipse.jface.text/src/org/eclipse/jface/text/reconciler/IReconcileStep.java;1;0;3;1;2;1;2;1;66;0;1;99;68;68;2;0;1;1;3;336;1;336;2;1;0
/org.eclipse.jdt.debug.ui/ui/org/eclipse/jdt/internal/debug/core/refactoring/JavaBreakpointIPackageFragmentMoveParticipant.java;2;1;2;1;2;2;2;0;8;0;0;300;8;8;1;0;0;0;2;300;0;336;2;2;0
/org.eclipse.jface/src/org/eclipse/jface/preference/ListEditor.java;2;1;2;1;2;2;2;0;13;0;0;293;15;15;1;0;0;0;2;293;0;336;2;2;1
/org.eclipse.pde/src/org/eclipse/pde/internal/FeatureProject.java;1;0;2;1;1;1;1;1;4;0;1;232;6;6;1;0;0;1;2;232;0;336;2;1;0
/org.eclipse.jdt.ui/ui/org/eclipse/jdt/internal/ui/wizards/dialogfields/Separator.java;2;0;2;1;1;1;1;1;2;0;1;88;4;4;1;0;0;1;2;88;0;336;2;2;0
/org.eclipse.jdt.ui/core refactoring/org/eclipse/jdt/internal/corext/refactoring/tagging/INameUpdating.java;2;0;2;1;1;1;1;1;2;0;1;254;2;2;1;0;0;1;2;254;0;336;2;2;0
/org.eclipse.jdt.ui/core extension/org/eclipse/jdt/internal/corext/dom/fragments/IExpressionFragment.java;1;0;1;1;1;1;1;0;2;0;0;336;2;2;1;0;0;0;1;336;0;336;1;1;0
/org.eclipse.jdt.ui/core extension/org/eclipse/jdt/internal/corext/Corext.java;2;0;2;1;1;1;1;1;2;0;1;198;2;2;1;0;0;1;2;198;0;336;2;2;0
/org.eclipse.ant.ui/Ant Editor/org/eclipse/ant/internal/ui/editor/text/AntDocumentSetupParticipant.java;2;3;4;2;4;2;4;0;39;0;0;273;39;39;3;0;2;0;4;321;2;321;2;2;1
/org.eclipse.update.core/src/org/eclipse/update/internal/search/QueryUpdateSiteAdapter.java;2;0;5;2;1;1;1;4;6;2;3;54;15;15;2;1;0;4;5;54;1;336;4;2;0
/org.eclipse.jdt.ui/core refactoring/org/eclipse/jdt/internal/corext/refactoring/typeconstraints/TypeVariable.java;2;0;6;1;1;1;1;5;32;3;3;3;89;89;3;2;0;5;6;3;2;336;4;2;0
/org.eclipse.jdt.ui/ui/org/eclipse/jdt/internal/ui/filters/EmptyPackageFilter.java;1;0;1;1;1;1;1;0;2;0;0;336;2;2;1;0;0;0;1;336;0;336;1;1;0
/org.eclipse.jdt.ui/ui/org/eclipse/jdt/internal/ui/wizards/buildpaths/VariablePathDialogField.java;1;0;2;1;1;1;1;1;3;0;1;82;5;5;1;0;0;1;2;82;0;336;2;1;0
/org.eclipse.help.ide/src/org/eclipse/help/ui/internal/search/SWTUtil.java;1;1;3;1;2;2;2;1;18;0;1;106;24;24;1;0;0;1;3;106;0;336;3;1;0
/org.eclipse.core.runtime/src/org/eclipse/core/internal/jobs/WorkerPool.java;3;2;34;3;5;3;5;29;1047;10;13;23;2529;2529;10;16;2;29;34;105;18;320;16;3;0
/org.eclipse.debug.ui/ui/org/eclipse/debug/internal/ui/views/memory/MemoryViewContentProvider.java;2;2;3;2;3;2;3;0;29;0;0;282;38;38;2;0;1;0;3;282;1;294;2;2;3
/org.eclipse.jdt.ui/ui/org/eclipse/jdt/internal/ui/text/template/contentassist/PositionBasedCompletionProposal.java;2;1;3;1;2;2;2;1;33;0;1;267;35;35;1;0;0;1;3;267;0;336;3;2;0
/org.eclipse.team.cvs.ui/src/org/eclipse/team/internal/ccvs/ui/subscriber/ConfirmMergedAction.java;2;2;3;1;3;2;3;0;39;0;0;294;43;43;2;0;1;0;3;294;1;336;2;2;0
/org.eclipse.jdt.ui/ui refactoring/org/eclipse/jdt/internal/ui/refactoring/nls/PackageBrowseAdapter.java;2;0;2;1;1;1;1;1;26;0;1;267;26;26;1;0;0;1;2;267;0;290;2;2;0
/org.eclipse.ui.ide/extensions/org/eclipse/ui/dialogs/SaveAsDialog.java;1;0;1;1;0;0;0;1;0;0;1;132;0;0;1;0;0;1;1;132;0;132;1;1;0
/org.eclipse.ant.ui/Ant Editor/org/eclipse/ant/internal/ui/editor/utils/ProjectHelper.java;1;0;24;1;7;1;7;17;670;8;4;108;1086;1086;8;13;6;17;24;197;19;289;5;1;5
/org.eclipse.jdt.ui/ui/org/eclipse/jdt/ui/wizards/NewElementWizardPage.java;1;0;1;1;1;1;1;0;2;0;0;336;2;2;1;0;0;0;1;336;0;336;1;1;0
/org.eclipse.jdt.ui/ui/org/eclipse/jdt/internal/ui/search/SearchMessages.java;1;0;1;1;1;1;1;0;2;0;0;336;2;2;1;0;0;0;1;336;0;336;1;1;0
/org.eclipse.team.core/src/org/eclipse/team/core/ProjectSetCapability.java;2;1;5;1;3;3;3;2;236;1;2;232;285;285;1;0;0;2;5;232;0;325;5;2;0
/org.eclipse.team.ui/src/org/eclipse/team/internal/ui/synchronize/ActionDelegateWrapper.java;1;0;3;1;2;1;2;1;81;0;1;257;81;81;2;0;1;1;3;288;1;288;2;1;1
/org.eclipse.ui.ide/extensions/org/eclipse/ui/IStorageEditorInput.java;1;0;1;1;0;0;0;1;0;0;1;132;0;0;1;0;0;1;1;132;0;132;1;1;0
/org.eclipse.swt/Eclipse SWT/carbon/org/eclipse/swt/widgets/FileDialog.java;3;1;3;2;2;2;2;1;19;0;1;153;28;28;1;0;0;1;3;153;0;337;3;3;0
/org.eclipse.ui.workbench/Eclipse UI/org/eclipse/ui/part/MultiPageEditorSite.java;3;0;4;1;1;1;1;3;90;2;2;158;126;126;2;1;0;3;4;158;1;336;3;3;0
/org.eclipse.swt/Eclipse SWT Mozilla/common/org/eclipse/swt/internal/mozilla/nsIBaseWindow.java;1;0;2;1;0;0;0;2;26;1;2;100;26;26;1;0;0;2;2;100;0;148;2;1;0
/org.eclipse.jdt.ui/ui/org/eclipse/jdt/internal/ui/preferences/CodeFormatterPreferencePage.java;2;0;5;1;1;1;1;4;73;1;4;176;154;154;1;0;0;4;5;176;0;336;5;2;0
/org.eclipse.team.cvs.ui/src/org/eclipse/team/internal/ccvs/ui/TagAsVersionDialog.java;2;0;3;2;0;0;0;3;57;1;3;63;66;66;1;0;0;3;3;63;0;138;3;2;0
/org.eclipse.ui.intro/src/org/eclipse/ui/internal/intro/impl/model/IntroImage.java;1;4;6;1;6;3;6;0;24;0;0;276;47;47;4;0;3;0;6;276;3;307;3;1;0
/org.eclipse.swt/Eclipse SWT/win32/org/eclipse/swt/widgets/Canvas.java;5;0;6;2;1;1;1;5;56;2;3;22;130;130;2;2;0;5;6;22;2;337;4;5;0
/org.eclipse.swt/Eclipse SWT Drag and Drop/carbon/org/eclipse/swt/dnd/DragSource.java;4;1;6;1;2;2;2;4;168;2;3;0;183;183;2;1;0;4;6;34;1;337;5;4;0
/org.eclipse.swt/Eclipse SWT Accessibility/gtk/org/eclipse/swt/accessibility/Accessible.java;3;1;10;1;2;2;2;8;158;2;6;70;285;285;2;2;0;8;10;70;2;337;8;3;0
/org.eclipse.jdt.ui/ui/org/eclipse/jdt/internal/ui/text/javadoc/JavaDoc2HTMLTextReader.java;3;0;5;1;1;1;1;4;2;1;4;81;7;7;1;0;0;4;5;81;0;336;5;3;0
/org.eclipse.ant.ui/Ant Editor/org/eclipse/ant/internal/ui/dtd/util/FactoryObject.java;1;0;1;1;0;0;0;1;0;0;1;108;0;0;1;0;0;1;1;108;0;108;1;1;0
/org.eclipse.pde.ui/src/org/eclipse/pde/internal/ui/editor/text/XMLCommentScanner.java;3;1;3;1;2;2;2;1;4;0;1;211;6;6;1;0;0;1;3;211;0;336;3;3;0
/org.eclipse.ui.forms/src/org/eclipse/ui/forms/widgets/FormText.java;1;1;9;1;2;2;3;6;567;3;3;230;710;710;3;3;1;7;9;248;4;336;5;1;0
/org.eclipse.jdt.ui/ui/org/eclipse/jdt/ui/wizards/NewInterfaceWizardPage.java;1;0;1;1;1;1;1;0;2;0;0;336;2;2;1;0;0;0;1;336;0;336;1;1;0
/org.eclipse.team.core/src/org/eclipse/team/core/variants/ThreeWaySubscriber.java;1;0;3;1;2;1;2;1;19;0;1;239;19;19;2;0;1;1;3;325;1;325;2;1;0
/org.eclipse.team.ui/src/org/eclipse/team/internal/ui/dialogs/IPromptCondition.java;1;0;1;1;0;0;0;1;31;0;1;63;31;31;1;0;0;1;1;63;0;63;1;1;0
/org.eclipse.jdt.ui/core refactoring/org/eclipse/jdt/internal/corext/refactoring/code/flow/DoWhileFlowInfo.java;1;0;1;1;1;1;1;0;2;0;0;336;2;2;1;0;0;0;1;336;0;336;1;1;0
/org.eclipse.swt/Eclipse SWT PI/win32/org/eclipse/swt/internal/win32/NMTTDISPINFO.java;1;0;1;1;0;0;0;1;8;0;1;61;8;8;1;0;0;1;1;61;0;61;1;1;0
/org.eclipse.jdt.ui/ui/org/eclipse/jdt/internal/ui/filters/NonPublicTypeFilter.java;1;0;1;1;1;1;1;0;2;0;0;336;2;2;1;0;0;0;1;336;0;336;1;1;0
/org.eclipse.ui.workbench/Eclipse UI/org/eclipse/ui/internal/dialogs/EditorsPreferencePage.java;4;0;6;2;1;1;1;5;208;2;3;136;238;238;2;2;0;5;6;157;2;336;4;4;1
/org.eclipse.swt/Eclipse SWT Printing/photon/org/eclipse/swt/printing/PrintDialog.java;1;1;2;1;2;2;2;0;8;0;0;300;12;12;1;0;0;0;2;300;0;337;2;1;0
/org.eclipse.team.ui/src/org/eclipse/team/internal/ui/ITeamUIImages.java;1;2;3;1;3;2;3;0;11;0;0;302;15;15;2;0;1;0;3;302;1;336;2;1;0
/org.eclipse.ui.workbench/Eclipse UI/org/eclipse/ui/internal/activities/Persistence.java;4;1;15;2;2;2;2;13;673;8;5;141;887;887;8;8;0;13;15;160;8;336;7;4;1
/org.eclipse.debug.core/core/org/eclipse/debug/internal/core/memory/MemoryRendering.java;1;0;1;1;1;1;1;0;0;0;0;282;0;0;1;0;0;0;1;282;0;282;1;1;1
/org.eclipse.help/src/org/eclipse/help/internal/context/ContextManager.java;1;1;10;1;3;3;3;7;152;2;4;73;240;240;2;3;0;7;10;157;3;336;7;1;0
/org.eclipse.update.ui/src/org/eclipse/update/internal/ui/wizards/LicensePage.java;3;1;7;3;2;2;2;5;386;3;3;50;743;743;3;2;0;5;7;50;2;336;5;3;0
/org.eclipse.update.core/src/org/eclipse/update/core/BaseSiteFactory.java;2;1;3;1;2;2;2;1;8;0;1;58;18;18;1;0;0;1;3;58;0;336;3;2;0
/org.eclipse.jdt.core/compiler/org/eclipse/jdt/internal/compiler/parser/AbstractCommentParser.java;3;4;19;2;6;2;6;13;558;9;2;203;1240;1240;9;11;4;13;19;203;15;324;4;3;10
/org.eclipse.jface.text/src/org/eclipse/jface/internal/text/link/contentassist/AdditionalInfoController2.java;3;1;4;1;2;2;2;2;42;1;2;232;46;46;1;0;0;2;4;232;0;336;4;3;0
/org.eclipse.ui.workbench.compatibility/src/org/eclipse/ui/internal/ICompatibleWorkbenchPage.java;2;0;2;1;1;1;1;1;36;0;1;188;36;36;1;0;0;1;2;188;0;335;2;2;0
/org.eclipse.update.core/src/org/eclipse/update/internal/core/TargetFeature.java;1;0;1;1;0;0;0;1;2;0;1;58;2;2;1;0;0;1;1;58;0;58;1;1;0
/org.eclipse.osgi/core/framework/org/eclipse/osgi/framework/internal/core/SystemBundleActivator.java;4;3;8;2;5;3;5;3;156;2;2;171;178;178;3;1;2;3;8;271;3;336;5;4;0
/org.eclipse.pde.core/src/org/eclipse/pde/internal/core/ischema/ISchema.java;3;1;4;1;2;2;2;2;26;1;2;232;40;40;1;0;0;2;4;232;0;336;4;3;0
/org.eclipse.debug.ui/ui/org/eclipse/debug/internal/ui/actions/AddToFavoritesAction.java;1;0;2;1;1;1;1;1;13;0;1;149;13;13;1;0;0;1;2;149;0;280;2;1;0
/org.eclipse.ui.workbench/Eclipse UI/org/eclipse/ui/internal/dialogs/EventLoopProgressMonitor.java;3;5;12;2;7;2;7;5;270;3;2;204;493;493;5;3;5;5;12;281;8;312;4;3;0
/org.eclipse.debug.ui/ui/org/eclipse/debug/internal/ui/views/launch/DecorationManager.java;1;0;1;1;0;0;0;1;0;0;1;75;0;0;1;0;0;1;1;75;0;75;1;1;0
/org.eclipse.jdt.ui/ui/org/eclipse/jdt/internal/ui/text/spelling/engine/SpellEvent.java;2;0;2;1;1;1;1;1;2;0;1;219;2;2;1;0;0;1;2;219;0;336;2;2;0
/org.eclipse.jdt.ui/core refactoring/org/eclipse/jdt/internal/corext/refactoring/rename/RenameNonVirtualMethodProcessor.java;4;3;16;1;5;3;5;11;80;4;6;71;212;212;4;5;2;11;16;247;7;336;9;4;0
/org.eclipse.ui.workbench/Eclipse UI/org/eclipse/ui/internal/SavePerspectiveAction.java;1;0;1;1;0;0;0;1;65;0;1;157;65;65;1;0;0;1;1;157;0;157;1;1;1
/org.eclipse.update.core/src/org/eclipse/update/core/SiteManager.java;4;4;8;2;5;2;5;3;45;1;3;0;114;114;4;0;3;3;8;289;3;336;5;4;1
/org.eclipse.help.base/src/org/eclipse/help/internal/standalone/StandaloneInfocenter.java;1;1;6;1;3;3;3;3;50;0;1;104;70;70;3;2;0;3;6;104;2;336;4;1;1
/org.eclipse.debug.ui/ui/org/eclipse/debug/internal/ui/views/launch/LaunchViewContentProvider.java;2;0;2;1;1;1;1;1;4;0;1;261;6;6;1;0;0;1;2;261;0;336;2;2;0
/org.eclipse.update.core/src/org/eclipse/update/standalone/AddSiteCommand.java;1;1;6;1;5;5;5;1;33;0;1;267;62;62;1;0;0;1;6;267;0;336;6;1;0
/org.eclipse.debug.ui/ui/org/eclipse/debug/internal/ui/views/memory/CopyViewTabToClipboardAction.java;2;0;2;2;2;1;2;0;5;0;0;282;5;5;2;0;1;0;2;282;1;282;1;2;2
/org.eclipse.help.webapp/src_servlets/org/eclipse/help/internal/webapp/data/SearchData.java;1;1;14;1;4;4;4;10;118;4;6;8;445;445;4;4;0;10;14;114;4;336;10;1;0
/org.eclipse.search/new search/org/eclipse/search/ui/ISearchResultViewPart.java;3;3;8;2;5;3;5;3;36;1;3;207;76;76;3;0;2;3;8;276;2;336;6;3;0
/org.eclipse.help.webapp/src_servlets/org/eclipse/help/internal/webapp/servlet/HighlightFilter.java;1;1;3;1;3;3;3;0;46;0;0;299;90;90;1;0;0;0;3;299;0;336;3;1;0
/org.eclipse.jface/src/org/eclipse/jface/preference/PreferenceContentProvider.java;2;0;4;1;1;1;1;3;69;2;2;177;93;93;2;1;0;3;4;177;1;293;3;2;0
/org.eclipse.update.core/src/org/eclipse/update/internal/search/OptionalFeatureSearchCategory.java;3;1;7;3;2;2;2;5;8;3;3;54;27;27;3;2;0;5;7;54;2;336;5;3;0
/org.eclipse.ui.editors/src/org/eclipse/ui/internal/texteditor/AnnotationTypeHierarchy.java;3;2;4;2;4;3;4;0;6;0;0;279;10;10;2;0;1;0;4;295;1;336;3;3;0
/org.eclipse.swt/Eclipse SWT PI/win32/org/eclipse/swt/internal/win32/HIGHCONTRAST.java;1;0;1;1;0;0;0;1;0;0;1;246;0;0;1;0;0;1;1;246;0;246;1;1;0
/org.eclipse.jdt.ui/core refactoring/org/eclipse/jdt/internal/corext/refactoring/TypedSource.java;4;2;8;2;3;2;3;5;13;2;3;101;30;30;2;2;1;5;8;101;3;331;5;4;0
/org.eclipse.jdt.core/compiler/org/eclipse/jdt/internal/compiler/lookup/MethodVerifier.java;3;0;11;2;1;1;1;10;173;3;6;2;235;235;3;4;0;10;11;2;4;287;7;3;1
/org.eclipse.core.runtime/src/org/eclipse/core/runtime/Plugin.java;4;2;29;3;3;2;14;15;1224;17;7;171;2166;2166;17;8;12;26;29;252;20;336;9;4;2
/org.eclipse.ant.ui/Ant Tools Support/org/eclipse/ant/internal/ui/preferences/AntTasksPage.java;1;0;5;1;0;0;0;5;78;3;3;108;105;105;3;2;0;5;5;108;2;170;3;1;1
/org.eclipse.jdt.ui/ui refactoring/org/eclipse/jdt/internal/ui/refactoring/reorg/PasteAction.java;5;1;27;3;2;2;6;21;424;7;7;70;694;694;7;14;4;25;27;262;18;336;9;5;1
/org.eclipse.debug.core/core/org/eclipse/debug/internal/core/ExpressionManager.java;4;2;13;2;5;3;5;8;235;3;5;67;351;351;3;3;2;8;13;92;5;336;8;4;1
/org.eclipse.jdt.ui/ui/org/eclipse/jdt/internal/ui/preferences/TypeFilterPreferencePage.java;2;1;5;1;3;3;3;2;4;1;2;179;10;10;1;0;0;2;5;179;0;336;5;2;0
/org.eclipse.jdt.debug/jdi/org/eclipse/jdi/internal/ArrayTypeImpl.java;2;0;2;1;0;0;0;2;15;1;2;144;17;17;1;0;0;2;2;144;0;235;2;2;0
/org.eclipse.update.ui/src/org/eclipse/update/internal/ui/parts/ImageOverlayIcon.java;1;0;1;1;0;0;0;1;2;0;1;58;2;2;1;0;0;1;1;58;0;58;1;1;0
/org.eclipse.ui.ide/src/org/eclipse/ui/internal/ide/NewWizardShortcutAction.java;6;2;7;2;3;2;3;4;36;2;2;132;51;51;2;2;1;4;7;132;3;336;4;6;1
/org.eclipse.jdt.ui/core refactoring/org/eclipse/jdt/internal/corext/refactoring/structure/ChangeSignatureRefactoring.java;6;3;58;3;6;3;19;39;1539;16;13;9;3654;3654;16;26;16;52;58;262;42;336;16;6;2
/org.eclipse.ui.intro/src/org/eclipse/ui/internal/intro/impl/html/FormattedHTMLElement.java;1;1;2;1;2;2;2;0;2;0;0;276;2;2;1;0;0;0;2;276;0;286;2;1;0
/org.eclipse.jface/src/org/eclipse/jface/util/OpenStrategy.java;3;1;3;1;2;2;2;1;21;0;1;85;24;24;1;0;0;1;3;85;0;336;3;3;0
/org.eclipse.ltk.core.refactoring/src/org/eclipse/ltk/internal/core/refactoring/ListenerList.java;1;0;2;1;1;1;1;1;2;0;1;264;2;2;1;0;0;1;2;264;0;336;2;1;0
/org.eclipse.pde.runtime/src/org/eclipse/pde/internal/runtime/logview/LogReader.java;2;2;15;2;4;3;4;11;218;4;6;55;434;434;4;5;1;11;15;55;6;336;9;2;0
/org.eclipse.ui.workbench/Eclipse UI/org/eclipse/ui/internal/progress/ProgressViewerContentProvider.java;1;0;4;1;1;1;1;3;18;0;1;234;31;31;3;2;0;3;4;234;2;279;2;1;1
/org.eclipse.debug.ui/ui/org/eclipse/debug/internal/ui/launchConfigurations/LaunchConfigurationDialog.java;1;0;2;1;0;0;0;2;4;1;2;44;5;5;1;0;0;2;2;44;0;184;2;1;0
/org.eclipse.swt/Eclipse SWT/motif/org/eclipse/swt/widgets/MenuItem.java;6;1;13;2;3;3;3;10;158;5;6;9;207;207;5;4;0;10;13;105;4;337;9;6;0
/org.eclipse.update.core/src/org/eclipse/update/configuration/IConfiguredSite.java;2;1;3;1;2;2;2;1;10;0;1;191;17;17;1;0;0;1;3;191;0;336;3;2;0
/org.eclipse.team.cvs.ui/src/org/eclipse/team/internal/ccvs/ui/CVSLightweightDecorator.java;2;3;22;2;6;3;6;16;76;4;10;56;268;268;4;6;3;16;22;150;9;336;13;2;2
/org.eclipse.ant.ui/Ant Editor/org/eclipse/ant/internal/ui/editor/text/AntEditorTextMessages.java;1;0;1;1;0;0;0;1;0;0;1;208;0;0;1;0;0;1;1;208;0;208;1;1;0
/org.eclipse.pde.ui/src/org/eclipse/pde/internal/ui/wizards/site/OpenProjectWizardAction.java;3;1;3;1;3;3;3;0;10;0;0;289;12;12;1;0;0;0;3;289;0;336;3;3;0
/org.eclipse.jdt.ui/ui/org/eclipse/jdt/internal/ui/wizards/buildpaths/ExclusionInclusionEntryDialog.java;2;0;2;1;1;1;1;1;2;0;1;267;2;2;1;0;0;1;2;267;0;336;2;2;0
/org.eclipse.jdt.core/eval/org/eclipse/jdt/internal/eval/InstallException.java;1;0;1;1;0;0;0;1;2;0;1;199;2;2;1;0;0;1;1;199;0;199;1;1;0
/org.eclipse.team.cvs.ui/src/org/eclipse/team/internal/ccvs/ui/wizards/RestoreFromRepositoryFileSelectionPage.java;2;1;5;1;2;2;2;3;51;1;3;55;110;110;1;0;0;3;5;55;0;336;5;2;0
/org.eclipse.jdt.core/dom/org/eclipse/jdt/core/dom/TypeDeclaration.java;5;0;18;1;1;1;5;13;716;6;9;6;922;922;6;4;4;17;18;266;8;308;10;5;2
/org.eclipse.jdt.junit/src/org/eclipse/jdt/internal/junit/ui/GotoReferencedTestAction.java;2;1;2;1;2;2;2;0;8;0;0;275;10;10;1;0;0;0;2;275;0;336;2;2;0
/org.eclipse.jdt.core/formatter/org/eclipse/jdt/internal/formatter/AbortFormatting.java;2;0;3;1;0;0;0;3;2;1;3;37;4;4;1;0;0;3;3;37;0;199;3;2;0
/org.eclipse.pde.ui/src_ant/org/eclipse/pde/internal/ui/ant/PluginExportTask.java;1;0;2;1;1;1;1;1;10;0;1;257;10;10;1;0;0;1;2;257;0;336;2;1;0
/org.eclipse.core.runtime.compatibility/src-model/org/eclipse/core/internal/model/IModel.java;2;1;3;1;2;2;2;1;2;0;1;171;4;4;1;0;0;1;3;171;0;336;3;2;0
/org.eclipse.jdt.ui/ui/org/eclipse/jdt/internal/ui/text/correction/ReturnTypeSubProcessor.java;2;3;23;1;4;2;4;19;110;9;8;22;406;406;9;11;2;19;23;60;13;336;10;2;0
/org.eclipse.help/src/org/eclipse/help/internal/ITocsChangedListener.java;1;1;3;1;2;2;2;1;16;0;1;269;32;32;1;0;0;1;3;269;0;336;3;1;0
/org.eclipse.jface.text/src/org/eclipse/jface/text/ITextInputListener.java;2;0;2;2;2;1;2;0;10;0;0;336;10;10;2;0;1;0;2;336;1;336;1;2;0
/org.eclipse.pde.ui/src/org/eclipse/pde/internal/ui/parts/ComboPart.java;1;1;2;1;2;2;2;0;10;0;0;292;10;10;1;0;0;0;2;292;0;336;2;1;0
/org.eclipse.ui.workbench/Eclipse UI/org/eclipse/ui/internal/progress/ProgressMessages.java;1;0;1;1;0;0;0;1;13;0;1;61;13;13;1;0;0;1;1;61;0;61;1;1;1
/org.eclipse.swt/Eclipse SWT PI/win32/org/eclipse/swt/internal/win32/MSG.java;1;0;1;1;0;0;0;1;2;0;1;166;2;2;1;0;0;1;1;166;0;166;1;1;0
/org.eclipse.jdt.ui/ui/org/eclipse/jdt/internal/ui/javaeditor/JavaOutlinePage.java;7;2;25;4;5;4;5;20;115;8;8;66;462;462;8;12;1;20;25;74;13;336;12;7;0
/org.eclipse.core.resources/src/org/eclipse/core/resources/IMarker.java;2;0;4;1;0;0;1;3;628;2;3;3;662;662;2;0;1;4;4;270;1;270;3;2;0
/org.eclipse.jdt.ui/ui/org/eclipse/jdt/ui/actions/ExternalizeStringsAction.java;5;2;9;2;3;2;3;6;21;2;5;9;91;91;2;1;1;6;9;9;2;336;7;5;0
/org.eclipse.search/search/org/eclipse/search/internal/core/ISearchScope.java;1;0;1;1;1;1;1;0;2;0;0;336;2;2;1;0;0;0;1;336;0;336;1;1;0
/org.eclipse.jdt.ui/ui/org/eclipse/jdt/internal/ui/preferences/CodeAssistConfigurationBlock.java;1;0;2;1;2;1;2;0;3;0;0;295;3;3;2;0;1;0;2;295;1;295;1;1;0
/org.eclipse.jdt.ui/core refactoring/org/eclipse/jdt/internal/corext/refactoring/code/InlineConstantRefactoring.java;5;4;28;2;7;4;7;21;89;5;10;4;338;338;5;11;3;21;28;246;14;336;14;5;0
/org.eclipse.ui.externaltools/External Tools Base/org/eclipse/ui/externaltools/internal/ui/TreeAndListGroup.java;2;0;4;1;1;1;1;3;11;1;3;178;29;29;1;0;0;3;4;178;0;294;4;2;0
/org.eclipse.ant.ui/Ant Editor/org/eclipse/ant/internal/ui/editor/text/IXMLAnnotation.java;1;0;3;1;1;1;1;2;4;1;2;108;6;6;1;0;0;2;3;108;0;336;3;1;1
/org.eclipse.ui.workbench/Eclipse UI/org/eclipse/ui/INavigationHistory.java;2;1;2;1;2;2;2;0;2;0;0;295;4;4;1;0;0;0;2;295;0;336;2;2;0
/org.eclipse.debug.ui/ui/org/eclipse/debug/internal/ui/InstructionPointerManager.java;2;0;4;1;0;0;0;4;27;2;3;10;32;32;2;1;0;4;4;163;1;163;3;2;0
/org.eclipse.ui.workbench/Eclipse UI/org/eclipse/ui/internal/registry/ShowViewHandler.java;1;0;1;1;1;1;1;0;0;0;0;315;0;0;1;0;0;0;1;315;0;315;1;1;0
/org.eclipse.jdt.debug.ui/ui/org/eclipse/jdt/internal/debug/ui/actions/ManageBreakpointRulerAction.java;5;2;17;3;3;2;3;14;384;8;4;17;640;640;8;10;1;14;17;98;11;336;6;5;0
/org.eclipse.jface.text/src/org/eclipse/jface/text/link/LinkedPositionAnnotations.java;2;2;5;2;3;2;3;2;51;1;2;232;65;65;2;0;1;2;5;334;1;334;4;2;0
/org.eclipse.jdt.ui/ui/org/eclipse/jdt/internal/ui/text/CustomSourceInformationControl.java;3;2;7;2;4;3;4;3;67;2;2;70;187;187;2;1;1;3;7;70;2;336;5;3;0
/org.eclipse.osgi/core/framework/org/eclipse/osgi/framework/eventmgr/ListenerQueue.java;2;2;5;2;5;3;5;0;57;0;0;275;80;80;2;0;2;0;5;275;2;313;3;2;0
/org.eclipse.jdt.debug/eval/org/eclipse/jdt/internal/debug/eval/ast/instructions/PushFieldVariable.java;2;0;2;2;0;0;0;2;5;0;1;76;5;5;2;1;0;2;2;76;1;76;1;2;0
/org.eclipse.jdt.ui/ui/org/eclipse/jdt/internal/ui/actions/WorkbenchRunnableAdapter.java;3;1;6;1;2;2;2;4;56;2;3;225;83;83;2;1;0;4;6;267;1;336;5;3;0
/org.eclipse.ui.workbench/Eclipse UI/org/eclipse/ui/internal/dialogs/DialogUtil.java;1;0;1;1;0;0;0;1;4;0;1;157;4;4;1;0;0;1;1;157;0;157;1;1;0
/org.eclipse.jdt.ui/ui/org/eclipse/jdt/internal/ui/workingsets/WorkingSetMessages.java;1;0;1;1;1;1;1;0;2;0;0;336;2;2;1;0;0;0;1;336;0;336;1;1;0
/org.eclipse.jdt.core/compiler/org/eclipse/jdt/internal/compiler/ast/ClassLiteralAccess.java;2;0;3;1;0;0;0;3;12;1;3;63;18;18;1;0;0;3;3;63;0;199;3;2;1
/org.eclipse.core.runtime.compatibility/src-model/org/eclipse/core/runtime/model/LibraryModel.java;3;1;5;1;3;3;3;2;27;1;2;171;36;36;1;0;0;2;5;171;0;336;5;3;0
/org.eclipse.team.cvs.core/src/org/eclipse/team/internal/ccvs/core/resources/CVSWorkspaceRoot.java;2;0;12;1;1;1;1;11;262;3;9;52;697;697;3;2;0;11;12;121;2;336;10;2;0
/org.eclipse.jdt.core/compiler/org/eclipse/jdt/internal/compiler/ast/CompilationUnitDeclaration.java;4;0;10;1;1;1;1;9;38;1;9;2;81;81;1;0;0;9;10;2;0;300;10;4;0
/org.eclipse.team.cvs.ui/src/org/eclipse/team/internal/ccvs/ui/Policy.java;1;0;2;1;0;0;0;2;5;1;2;52;9;9;1;0;0;2;2;52;0;151;2;1;0
/org.eclipse.jdt.ui/ui/org/eclipse/jdt/internal/ui/actions/FoldingActionGroup.java;2;2;3;1;3;2;3;0;30;0;0;288;36;36;2;0;1;0;3;288;1;336;2;2;0
/org.eclipse.ui.workbench/Eclipse UI/org/eclipse/ui/commands/ExecutionException.java;3;1;3;1;2;2;2;1;10;0;1;226;16;16;1;0;0;1;3;226;0;336;3;3;0
/org.eclipse.pde.core/src/org/eclipse/pde/internal/core/ischema/IPluginLocationProvider.java;2;0;3;2;2;1;2;1;12;0;1;267;12;12;2;0;1;1;3;330;1;330;2;2;0
/org.eclipse.jdt.core/dom/org/eclipse/jdt/internal/core/dom/rewrite/ASTRewriteFormatter.java;2;0;2;1;1;1;1;1;389;0;1;262;389;389;1;0;0;1;2;262;0;290;2;2;0
/org.eclipse.ui.workbench/Eclipse UI/org/eclipse/ui/commands/NotDefinedException.java;3;1;10;1;2;2;2;8;40;3;5;71;105;105;3;3;0;8;10;71;3;336;7;3;0
/org.eclipse.jdt.ui/ui/org/eclipse/jdt/internal/ui/javaeditor/PartiallySynchronizedDocument.java;2;0;4;1;1;1;1;3;107;2;2;96;129;129;2;1;0;3;4;237;1;336;3;2;0
/org.eclipse.jdt.ui/core extension/org/eclipse/jdt/internal/corext/CorextMessages.java;1;0;1;1;1;1;1;0;2;0;0;336;2;2;1;0;0;0;1;336;0;336;1;1;0
/org.eclipse.ui.ide/src/org/eclipse/ui/internal/ide/dialogs/OpenResourceDialog.java;3;1;3;1;2;2;2;1;11;0;1;132;13;13;1;0;0;1;3;132;0;336;3;3;0
/org.eclipse.debug.ui/ui/org/eclipse/debug/internal/ui/sourcelookup/AddSourceContainerDialog.java;1;1;7;1;2;2;2;5;107;3;3;209;144;144;3;2;0;5;7;266;2;303;5;1;1
/org.eclipse.jdt.ui/ui/org/eclipse/jdt/internal/ui/callhierarchy/CallHierarchyViewPart.java;6;1;26;3;5;5;5;21;515;10;8;12;902;902;10;13;0;21;26;12;13;336;13;6;1
/org.eclipse.ui.workbench/Eclipse UI/org/eclipse/ui/internal/presentations/SystemMenuMinimize.java;3;0;3;2;1;1;1;2;44;0;1;256;46;46;2;1;0;2;3;256;1;279;2;3;0
/org.eclipse.jface.text/src/org/eclipse/jface/text/rules/NumberRule.java;2;0;2;2;2;1;2;0;4;0;0;336;4;4;2;0;1;0;2;336;1;336;1;2;0
/org.eclipse.swt/Eclipse SWT Browser/motif/org/eclipse/swt/browser/PromptService.java;2;0;3;1;1;1;1;2;226;0;1;264;232;232;2;1;0;2;3;264;1;337;2;2;1
/org.eclipse.jdt.ui/ui/org/eclipse/jdt/internal/ui/search/JavaElementMatch.java;1;1;2;1;2;2;2;0;20;0;0;275;20;20;1;0;0;0;2;275;0;290;2;1;0
/org.eclipse.jdt.core/compiler/org/eclipse/jdt/internal/compiler/impl/CharConstant.java;2;0;3;1;1;1;1;2;79;1;2;70;87;87;1;0;0;2;3;70;0;299;3;2;0
/org.eclipse.debug.ui/ui/org/eclipse/debug/internal/ui/launchConfigurations/CompileErrorPromptStatusHandler.java;2;6;7;2;7;2;7;0;71;0;0;276;76;76;6;0;5;0;7;276;5;312;2;2;0
/org.eclipse.swt/Eclipse SWT Mozilla/common/org/eclipse/swt/internal/mozilla/nsIDOMLocation.java;1;0;2;1;0;0;0;2;36;1;2;100;36;36;1;0;0;2;2;100;0;148;2;1;0
/org.eclipse.ui.workbench/Eclipse UI/org/eclipse/ui/part/MultiPageSelectionProvider.java;2;1;2;1;2;2;2;0;6;0;0;287;8;8;1;0;0;0;2;287;0;336;2;2;0
/org.eclipse.update.core/src/org/eclipse/update/standalone/CmdLineArgs.java;1;5;9;1;7;3;7;2;152;1;2;54;268;268;5;0;4;2;9;292;4;336;5;1;0
/org.eclipse.team.ui/src/org/eclipse/team/internal/ui/synchronize/actions/GlobalRefreshAction.java;2;5;14;2;8;2;8;6;198;4;2;241;462;462;5;4;6;6;14;321;10;321;4;2;0
/org.eclipse.pde.ui/src/org/eclipse/pde/internal/ui/editor/FormOutlinePage.java;1;1;2;1;2;2;2;0;212;0;0;292;216;216;1;0;0;0;2;292;0;336;2;1;0
/org.eclipse.ui.forms/src/org/eclipse/ui/forms/events/HyperlinkAdapter.java;1;1;5;1;2;2;2;3;38;2;2;225;49;49;2;1;0;3;5;225;1;336;4;1;0
/org.eclipse.ui.workbench/Eclipse UI/org/eclipse/ui/internal/DragCursors.java;2;0;2;1;0;0;0;2;170;1;2;205;170;170;1;0;0;2;2;205;0;223;2;2;0
/org.eclipse.osgi/core/adaptor/org/eclipse/osgi/framework/log/FrameworkLog.java;3;0;4;2;2;1;2;2;22;1;2;215;25;25;2;0;1;2;4;276;1;276;3;3;0
/org.eclipse.osgi/osgi/src/org/osgi/framework/Configurable.java;2;0;2;1;1;1;1;1;3;0;1;171;3;3;1;0;0;1;2;171;0;296;2;2;0
/org.eclipse.jdt.ui/core refactoring/org/eclipse/jdt/internal/corext/refactoring/ListenerList.java;1;0;1;1;1;1;1;0;2;0;0;336;2;2;1;0;0;0;1;336;0;336;1;1;0
/org.eclipse.compare/compare/org/eclipse/compare/internal/merge/TextStreamMerger.java;1;1;2;1;2;2;2;0;10;0;0;279;10;10;1;0;0;0;2;279;0;337;2;1;0
/org.eclipse.swt/Eclipse SWT/carbon/org/eclipse/swt/widgets/Table.java;5;5;40;3;10;4;10;30;1301;6;11;17;2763;2763;6;19;6;30;40;216;25;335;15;5;2
/org.eclipse.ui.workbench/Eclipse UI/org/eclipse/ui/internal/gestures/CaptureEvent.java;2;0;6;1;1;1;1;5;14;2;4;104;35;35;2;1;0;5;6;141;1;336;5;2;0
/org.eclipse.debug.ui/ui/org/eclipse/debug/ui/ILaunchConfigurationTab.java;1;0;2;1;0;0;0;2;64;1;2;104;68;68;1;0;0;2;2;104;0;155;2;1;0
/org.eclipse.jdt.core/compiler/org/eclipse/jdt/internal/compiler/lookup/TypeBinding.java;2;0;2;1;0;0;0;2;42;1;2;73;44;44;1;0;0;2;2;73;0;199;2;2;3
/org.eclipse.core.resources/src/org/eclipse/core/internal/indexing/ObjectStore.java;1;0;1;1;1;1;1;0;118;0;0;277;118;118;1;0;0;0;1;277;0;277;1;1;0
/org.eclipse.pde.ui/src/org/eclipse/pde/internal/ui/wizards/imports/FeatureImportWizardFirstPage.java;2;1;5;1;2;2;2;3;230;1;3;16;291;291;1;0;0;3;5;16;0;336;5;2;0
/org.eclipse.help.webapp/src_servlets/org/eclipse/help/internal/webapp/data/UrlUtil.java;1;1;15;1;4;4;4;11;159;3;7;7;726;726;3;4;0;11;15;120;4;336;11;1;1
/org.eclipse.jdt.core/compiler/org/eclipse/jdt/internal/compiler/ast/BreakStatement.java;2;0;4;1;0;0;0;4;10;1;4;11;18;18;1;0;0;4;4;11;0;199;4;2;0
/org.eclipse.ui.workbench/Eclipse UI/org/eclipse/ui/internal/ContainerPlaceholder.java;3;0;2;2;1;1;1;1;191;0;1;223;193;193;1;0;0;1;2;223;0;336;2;3;3
/org.eclipse.update.configurator/src/org/eclipse/update/internal/configurator/Messages.java;1;0;3;1;1;1;1;2;2;1;2;185;4;4;1;0;0;2;3;185;0;296;3;1;0
/org.eclipse.help.webapp/src/org/eclipse/help/internal/webapp/WebappResources.java;1;1;8;1;3;3;3;5;71;3;3;8;178;178;3;2;0;5;8;8;2;336;6;1;0
/org.eclipse.core.resources/src/org/eclipse/core/internal/dtree/NodeInfo.java;1;0;1;1;1;1;1;0;223;0;0;277;223;223;1;0;0;0;1;277;0;277;1;1;0
/org.eclipse.swt/Eclipse SWT PI/motif/org/eclipse/swt/internal/motif/XReparentEvent.java;1;0;1;1;0;0;0;1;0;0;1;88;0;0;1;0;0;1;1;88;0;88;1;1;0
/org.eclipse.jdt.ui/core refactoring/org/eclipse/jdt/internal/corext/refactoring/nls/changes/NLSChangesMessages.java;1;0;1;1;1;1;1;0;2;0;0;336;2;2;1;0;0;0;1;336;0;336;1;1;0
/org.eclipse.search/search/org/eclipse/search/ui/IContextMenuContributor.java;2;2;3;1;3;2;3;0;5;0;0;325;7;7;2;0;1;0;3;325;1;336;2;2;0
/org.eclipse.ui.ide/src/org/eclipse/ui/views/navigator/ResourceNavigatorMessages.java;1;0;1;1;0;0;0;1;0;0;1;129;0;0;1;0;0;1;1;129;0;129;1;1;0
/org.eclipse.osgi/defaultAdaptor/src/org/eclipse/osgi/framework/internal/protocol/bundleentry/Handler.java;2;0;3;1;1;1;1;2;36;1;2;203;56;56;1;0;0;2;3;203;0;276;3;2;0
/org.eclipse.ui.ide/src/org/eclipse/ui/internal/ide/model/WorkbenchFile.java;1;0;1;1;0;0;0;1;0;0;1;132;0;0;1;0;0;1;1;132;0;132;1;1;0
/org.eclipse.core.resources/src/org/eclipse/core/internal/localstore/IsSynchronizedVisitor.java;1;0;2;1;1;1;1;1;31;0;1;174;32;32;1;0;0;1;2;174;0;277;2;1;0
/org.eclipse.jdt.ui/core extension/org/eclipse/jdt/internal/corext/codemanipulation/AddMethodStubOperation.java;2;0;7;1;1;1;1;6;11;3;4;95;26;26;3;2;0;6;7;95;2;336;5;2;0
/org.eclipse.search/search/org/eclipse/search/ui/IReplacePage.java;1;0;2;1;1;1;1;1;2;0;1;166;2;2;1;0;0;1;2;166;0;336;2;1;0
/org.eclipse.ui.workbench.texteditor/src/org/eclipse/ui/texteditor/ITextEditorDropTargetListener.java;2;0;2;2;2;1;2;0;2;0;0;306;2;2;2;0;1;0;2;306;1;306;1;2;0
/org.eclipse.jdt.ui/core refactoring/org/eclipse/jdt/internal/corext/refactoring/nls/NLSMessages.java;2;0;2;1;1;1;1;1;2;0;1;267;4;4;1;0;0;1;2;267;0;336;2;2;0
/org.eclipse.jdt.core/compiler/org/eclipse/jdt/internal/compiler/ast/Expression.java;3;0;5;2;0;0;0;5;29;1;5;63;56;56;1;0;0;5;5;63;0;199;5;3;1
/org.eclipse.ui.workbench/Eclipse UI/org/eclipse/ui/internal/dnd/CompatibilityDragTarget.java;3;0;8;2;0;0;0;8;258;3;5;205;448;448;3;3;0;8;8;223;3;262;5;3;0
/org.eclipse.pde.ui/src/org/eclipse/pde/internal/ui/editor/PDEFormEditorContributor.java;3;3;5;2;5;3;5;0;10;0;0;292;28;28;3;0;2;0;5;292;2;336;3;3;0
/org.eclipse.swt/Eclipse SWT/carbon/org/eclipse/swt/widgets/ProgressBar.java;3;1;6;1;2;2;2;4;18;1;4;28;45;45;1;0;0;4;6;28;0;337;6;3;0
/org.eclipse.jdt.ui/core refactoring/org/eclipse/jdt/internal/corext/refactoring/typeconstraints/FullConstraintCreator.java;2;0;5;1;1;1;1;4;299;1;4;6;510;510;1;0;0;4;5;6;0;336;5;2;0
/org.eclipse.pde.core/src/org/eclipse/pde/internal/core/ifeature/IEnvironment.java;2;1;3;1;2;2;2;1;6;0;1;232;12;12;1;0;0;1;3;232;0;336;3;2;0
/org.eclipse.help.base/src/org/eclipse/help/internal/standalone/EclipseConnection.java;1;1;5;1;3;3;3;2;88;1;2;104;130;130;1;0;0;2;5;104;0;336;5;1;0
/org.eclipse.jdt.core/compiler/org/eclipse/jdt/internal/compiler/ast/MagicLiteral.java;2;0;2;1;0;0;0;2;30;1;2;63;32;32;1;0;0;2;2;63;0;199;2;2;0
/org.eclipse.ui.workbench/Eclipse UI/org/eclipse/ui/model/AdaptableList.java;2;0;3;1;0;0;0;3;151;2;2;95;151;151;2;1;0;3;3;157;1;157;2;2;1
/org.eclipse.jface.text/src/org/eclipse/jface/text/information/IInformationPresenterExtension.java;2;0;3;1;2;1;2;1;24;0;1;92;24;24;2;0;1;1;3;336;1;336;2;2;0
/org.eclipse.team.ui/src/org/eclipse/team/internal/ui/synchronize/DecoratingColorLabelProvider.java;2;1;4;1;4;4;4;0;98;0;0;276;111;111;1;0;0;0;4;276;0;336;4;2;1
/org.eclipse.core.resources/src/org/eclipse/core/internal/localstore/SafeChunkyOutputStream.java;1;0;1;1;1;1;1;0;78;0;0;277;78;78;1;0;0;0;1;277;0;277;1;1;0
/org.eclipse.jdt.ui/ui/org/eclipse/jdt/internal/ui/callhierarchy/OpenDeclarationAction.java;3;0;4;1;1;1;1;3;55;2;2;12;63;63;2;1;0;3;4;12;1;336;3;3;0
/org.eclipse.team.ui/src/org/eclipse/team/ui/synchronize/WorkspaceScope.java;2;1;2;1;2;2;2;0;44;0;0;299;45;45;1;0;0;0;2;299;0;335;2;2;0
/org.eclipse.ui.editors/src/org/eclipse/ui/editors/text/TextEditorPreferenceConstants.java;3;2;9;1;3;2;3;6;121;3;2;70;289;289;3;4;1;6;9;70;5;336;4;3;0
/org.eclipse.team.ui/src/org/eclipse/team/ui/SaveablePartAdapter.java;2;1;4;1;4;4;4;0;92;0;0;280;117;117;1;0;0;0;4;280;0;336;4;2;0
/org.eclipse.team.cvs.ui/src/org/eclipse/team/internal/ccvs/ui/model/VersionCategory.java;2;1;6;1;2;2;2;4;163;2;3;5;175;175;2;1;0;4;6;63;1;336;5;2;0
/org.eclipse.ui.workbench/Eclipse UI/org/eclipse/ui/internal/themes/IThemeDescriptor.java;2;0;6;1;0;0;0;6;167;5;2;206;167;167;5;4;0;6;6;233;4;233;2;2;0
/org.eclipse.jdt.core/search/org/eclipse/jdt/internal/core/search/matching/ClassFileMatchLocator.java;4;0;11;3;2;1;2;9;37;4;5;110;137;137;4;4;1;9;11;110;5;276;6;4;0
/org.eclipse.swt/Eclipse SWT PI/win32/org/eclipse/swt/internal/ole/win32/GUID.java;1;0;1;1;0;0;0;1;4;0;1;166;4;4;1;0;0;1;1;166;0;166;1;1;0
/org.eclipse.debug.core/core/org/eclipse/debug/core/sourcelookup/containers/FolderSourceContainer.java;1;0;2;1;0;0;1;1;23;0;1;268;23;23;2;0;1;2;2;268;1;268;1;1;0
/org.eclipse.ui.ide/src/org/eclipse/ui/views/markers/internal/MarkerView.java;6;2;15;3;3;2;6;9;611;5;4;129;921;921;5;5;4;12;15;215;9;336;6;6;0
/org.eclipse.osgi/core/framework/org/eclipse/osgi/framework/internal/core/AbstractBundle.java;3;0;10;3;10;1;10;0;232;0;0;276;232;232;10;0;9;0;10;276;9;276;1;3;0
/org.eclipse.ui.ide/src/org/eclipse/ui/internal/ide/actions/OpenWorkspaceAction.java;2;1;3;1;3;3;3;0;13;0;0;301;17;17;1;0;0;0;3;301;0;336;3;2;0
/org.eclipse.jdt.ui/ui refactoring/org/eclipse/jdt/internal/ui/refactoring/reorg/TypedSourceTransfer.java;4;1;5;1;2;2;2;3;6;1;3;70;15;15;1;0;0;3;5;70;0;336;5;4;0
/org.eclipse.ui.ide/extensions/org/eclipse/ui/dialogs/WizardExportPage.java;1;0;1;1;0;0;0;1;0;0;1;132;0;0;1;0;0;1;1;132;0;132;1;1;0
/org.eclipse.jdt.ui/core refactoring/org/eclipse/jdt/internal/corext/refactoring/typeconstraints/ConstraintVariable.java;2;0;6;1;1;1;1;5;36;2;3;3;56;56;2;2;0;5;6;3;2;336;4;2;0
/org.eclipse.team.cvs.core/src/org/eclipse/team/internal/ccvs/core/client/Checkout.java;2;1;4;1;2;2;2;2;3;1;2;110;8;8;1;0;0;2;4;110;0;336;4;2;0
/org.eclipse.update.core/src/org/eclipse/update/search/IUpdateSearchResultCollector.java;2;1;5;2;2;2;2;3;7;1;3;54;18;18;1;0;0;3;5;54;0;336;5;2;0
/org.eclipse.search/new search/org/eclipse/search2/internal/ui/text/WindowAnnotationManager.java;1;0;1;1;1;1;1;0;0;0;0;321;0;0;1;0;0;0;1;321;0;321;1;1;0
/org.eclipse.jdt.core/model/org/eclipse/jdt/core/IRegion.java;1;0;2;1;0;0;0;2;2;1;2;149;4;4;1;0;0;2;2;149;0;199;2;1;0
/org.eclipse.ui.ide/src/org/eclipse/ui/views/markers/internal/MarkerRegistry.java;3;1;3;1;2;2;2;1;2;0;1;129;4;4;1;0;0;1;3;129;0;336;3;3;0
/org.eclipse.debug.ui/ui/org/eclipse/debug/ui/sourcelookup/ISourceContainerBrowser.java;1;0;2;1;0;0;1;1;14;0;1;269;14;14;2;0;1;2;2;269;1;269;1;1;0
/org.eclipse.ant.ui/Ant Tools Support/org/eclipse/ant/internal/ui/launchConfigurations/AntTabGroup.java;3;1;9;2;2;2;2;7;13;2;6;108;41;41;2;1;0;7;9;238;1;336;8;3;0
/org.eclipse.ui.intro/src/org/eclipse/ui/internal/intro/impl/model/loader/BaseExtensionPointManager.java;1;4;6;1;6;3;6;0;70;0;0;276;83;83;4;0;3;0;6;276;3;331;3;1;0
/org.eclipse.core.resources/src/org/eclipse/core/internal/indexing/FieldArray.java;1;0;1;1;1;1;1;0;24;0;0;277;24;24;1;0;0;0;1;277;0;277;1;1;0
/org.eclipse.core.resources/src/org/eclipse/core/internal/resources/ResourceInfo.java;2;0;2;1;1;1;1;1;600;0;1;151;613;613;1;0;0;1;2;151;0;277;2;2;0
/org.eclipse.jdt.ui/ui/org/eclipse/jdt/internal/ui/text/java/JavaCompletionProposalComparator.java;3;0;6;2;3;1;3;3;37;0;1;234;68;68;3;2;2;3;6;234;4;325;2;3;0
/org.eclipse.ui.ide/src/org/eclipse/ui/internal/ide/model/WorkbenchMarker.java;4;1;4;2;2;2;2;2;19;1;2;132;24;24;1;0;0;2;4;132;0;336;4;4;0
/org.eclipse.jface/src/org/eclipse/jface/action/IStatusLineManager.java;3;1;3;2;2;2;2;1;4;0;1;157;9;9;1;0;0;1;3;157;0;336;3;3;0
/org.eclipse.pde.ui/src/org/eclipse/pde/internal/ui/wizards/templates/PropertyPageTemplate.java;3;2;8;2;4;3;4;4;62;2;3;128;107;107;2;1;1;4;8;128;2;336;6;3;0
/org.eclipse.jface.text/projection/org/eclipse/jface/text/source/projection/ProjectionAnnotationHover.java;2;4;8;2;6;2;6;2;101;0;1;265;124;124;4;1;4;2;8;275;5;336;3;2;0
/org.eclipse.ui.workbench/Eclipse UI/org/eclipse/ui/commands/KeyConfigurationEvent.java;3;1;5;1;2;2;2;3;176;1;3;161;257;257;1;0;0;3;5;161;0;336;5;3;0
/org.eclipse.jdt.ui/ui/org/eclipse/jdt/internal/ui/text/template/preferences/TemplateContentProvider.java;2;1;3;1;2;2;2;1;2;0;1;234;4;4;1;0;0;1;3;234;0;336;3;2;0
/org.eclipse.jdt.ui/ui/org/eclipse/jdt/internal/ui/filters/LocalTypesFilter.java;2;0;2;1;1;1;1;1;2;0;1;135;2;2;1;0;0;1;2;135;0;336;2;2;0
/org.eclipse.ui.workbench/Eclipse UI/org/eclipse/ui/IWorkbenchPart.java;4;3;7;2;4;2;4;3;57;1;3;118;77;77;3;0;2;3;7;293;2;336;5;4;0
/org.eclipse.jdt.debug.ui/ui/org/eclipse/jdt/internal/debug/ui/actions/InstanceFiltersAction.java;3;0;5;1;1;1;1;4;15;1;4;22;35;35;1;0;0;4;5;22;0;336;5;3;0
/org.eclipse.ui.forms/src/org/eclipse/ui/forms/events/IExpansionListener.java;1;1;2;1;2;2;2;0;6;0;0;272;6;6;1;0;0;0;2;272;0;336;2;1;0
/org.eclipse.ui.editors/src/org/eclipse/ui/editors/text/IEncodingActionsHelpContextIds.java;1;1;2;1;2;2;2;0;7;0;0;314;14;14;1;0;0;0;2;314;0;336;2;1;0
/org.eclipse.jdt.debug.ui/ui/org/eclipse/jdt/internal/debug/ui/actions/RemoveAction.java;1;0;2;1;0;0;0;2;14;1;2;91;16;16;1;0;0;2;2;91;0;154;2;1;0
/org.eclipse.core.resources/src/org/eclipse/core/internal/resources/File.java;3;5;34;3;11;4;15;19;864;11;9;13;1154;1154;11;10;11;23;34;239;21;336;13;3;1
/org.eclipse.osgi/core/framework/org/eclipse/osgi/framework/internal/core/ServiceReferenceImpl.java;2;1;3;1;3;3;3;0;4;0;0;276;11;11;1;0;0;0;3;276;0;336;3;2;0
/org.eclipse.ui.workbench/Eclipse UI/org/eclipse/ui/internal/PlatformUIPreferenceListener.java;5;5;10;3;7;3;7;3;113;1;3;157;235;235;5;0;4;3;10;293;4;336;6;5;1
/org.eclipse.ui.cheatsheets/src/org/eclipse/ui/internal/cheatsheets/data/SubItem.java;1;1;3;1;2;2;2;1;79;0;1;255;81;81;1;0;0;1;3;255;0;300;3;1;0
/org.eclipse.jdt.ui/ui/org/eclipse/jdt/internal/ui/javaeditor/SemanticHighlightingReconciler.java;4;4;7;3;7;3;7;0;140;0;0;283;220;220;4;0;4;0;7;283;4;326;3;4;1
/org.eclipse.swt.tools/JNI Generation/org/eclipse/swt/tools/internal/ParameterData.java;2;0;2;2;0;0;0;2;1;0;1;230;1;1;2;1;0;2;2;230;1;230;1;2;0
/org.eclipse.jdt.ui/ui/org/eclipse/jdt/internal/ui/text/correction/QuickAssistLightBulbUpdater.java;6;2;25;2;7;4;7;18;140;4;11;69;495;495;4;7;3;18;25;69;10;332;15;6;1
/org.eclipse.jdt.core/compiler/org/eclipse/jdt/internal/compiler/ast/ArrayInitializer.java;3;0;4;1;0;0;0;4;340;1;4;30;348;348;1;0;0;4;4;30;0;199;4;3;0
/org.eclipse.ui.ide/extensions/org/eclipse/ui/actions/DeleteResourceAction.java;5;1;7;1;2;2;2;5;130;1;5;132;228;228;1;0;0;5;7;132;0;336;7;5;2
/org.eclipse.search/new search/org/eclipse/search2/internal/ui/QueryManager.java;2;1;5;1;2;2;2;3;35;2;2;239;55;55;2;1;0;3;5;257;1;336;4;2;0
/org.eclipse.ui.ide/src/org/eclipse/ui/internal/ide/dialogs/WizardStep.java;1;0;1;1;0;0;0;1;0;0;1;132;0;0;1;0;0;1;1;132;0;132;1;1;0
/org.eclipse.pde.ui/src/org/eclipse/pde/internal/ui/wizards/plugin/OpenProjectWizardAction.java;3;2;6;1;5;4;5;1;51;0;1;248;69;69;2;0;1;1;6;288;1;336;5;3;0
/org.eclipse.update.core/src/org/eclipse/update/internal/core/SiteContentConsumer.java;1;0;1;1;0;0;0;1;2;0;1;58;2;2;1;0;0;1;1;58;0;58;1;1;0
/org.eclipse.ui.workbench/Eclipse UI/org/eclipse/ui/help/WorkbenchHelp.java;4;1;7;2;2;2;2;5;1236;2;3;99;1295;1295;2;2;0;5;7;99;2;336;5;4;1
/org.eclipse.core.resources/src/org/eclipse/core/internal/resources/ContentDescriptionManager.java;2;4;6;2;6;2;6;0;250;0;0;292;252;252;4;0;4;0;6;306;4;306;2;2;1
/org.eclipse.jdt.ui/ui/org/eclipse/jdt/internal/ui/dialogs/BuildPathDialog.java;3;1;6;1;2;2;2;4;27;2;3;162;43;43;2;1;0;4;6;225;1;336;5;3;0
/org.eclipse.jdt.ui/ui/org/eclipse/jdt/internal/ui/text/JavaReconciler.java;3;1;10;2;2;2;2;8;134;3;5;82;344;344;3;3;0;8;10;253;3;336;7;3;1
/org.eclipse.jface.text/src/org/eclipse/jface/text/presentation/IPresentationRepairer.java;2;0;2;2;2;1;2;0;28;0;0;336;28;28;2;0;1;0;2;336;1;336;1;2;0
/org.eclipse.core.resources/src/org/eclipse/core/internal/utils/WrappedRuntimeException.java;1;0;1;1;1;1;1;0;4;0;0;277;4;4;1;0;0;0;1;277;0;277;1;1;0
/org.eclipse.debug.ui/ui/org/eclipse/debug/internal/ui/views/memory/ResetMemoryBlockAction.java;1;0;1;1;1;1;1;0;0;0;0;282;0;0;1;0;0;0;1;282;0;282;1;1;0
/org.eclipse.debug.core/core/org/eclipse/debug/core/model/IExpression.java;1;0;1;1;0;0;0;1;2;0;1;88;2;2;1;0;0;1;1;88;0;88;1;1;0
/org.eclipse.help.base/src/org/eclipse/help/internal/search/DefaultAnalyzer.java;1;1;6;1;3;3;3;3;30;2;2;104;55;55;2;1;0;3;6;104;1;336;5;1;0
/org.eclipse.jdt.debug/model/org/eclipse/jdt/debug/core/IJavaClassPrepareBreakpoint.java;1;0;1;1;0;0;0;1;0;0;1;248;0;0;1;0;0;1;1;248;0;248;1;1;0
/org.eclipse.jdt.ui/ui/org/eclipse/jdt/internal/ui/search/OccurrencesSearchQuery.java;2;0;3;1;1;1;1;2;15;0;1;266;18;18;2;1;0;2;3;266;1;290;2;2;0
/org.eclipse.pde.ui/src/org/eclipse/pde/internal/ui/editor/feature/ReferenceWizard.java;2;0;4;2;2;1;2;2;5;1;2;44;9;9;2;0;1;2;4;331;1;331;3;2;0
/org.eclipse.jdt.core/eval/org/eclipse/jdt/internal/eval/CodeSnippetQualifiedNameReference.java;3;0;7;1;0;0;0;7;258;2;6;3;317;317;2;1;0;7;7;3;1;199;6;3;1
/org.eclipse.core.resources/src/org/eclipse/core/internal/indexing/Referable.java;1;0;1;1;1;1;1;0;8;0;0;277;8;8;1;0;0;0;1;277;0;277;1;1;0
/org.eclipse.pde.ui/src/org/eclipse/pde/internal/ui/editor/feature/FeatureInputContextManager.java;2;2;3;2;3;2;3;0;10;0;0;292;14;14;2;0;1;0;3;292;1;336;2;2;0
/org.eclipse.pde.ui/src/org/eclipse/pde/internal/ui/editor/site/BuiltFeaturesWizardPage.java;3;1;7;2;3;3;3;4;28;2;3;130;81;81;2;1;0;4;7;130;1;336;6;3;0
/org.eclipse.update.core/src/org/eclipse/update/internal/model/InstallConfigurationParser.java;2;1;11;1;3;3;3;8;260;2;6;58;348;348;2;2;0;8;11;197;2;336;9;2;0
/org.eclipse.core.runtime/src/org/eclipse/core/runtime/IBundleGroupProvider.java;2;0;5;2;1;1;1;4;12;3;2;205;25;25;3;2;0;4;5;205;2;276;3;2;0
/org.eclipse.debug.ui/ui/org/eclipse/debug/internal/ui/views/variables/AvailableLogicalStructuresAction.java;3;1;4;2;2;2;2;2;55;1;2;154;72;72;1;0;0;2;4;154;0;336;4;3;0
/org.eclipse.ui.workbench.texteditor/src/org/eclipse/ui/internal/texteditor/AnnotationExpansionControl.java;3;1;4;2;2;2;2;2;801;1;2;147;819;819;1;0;0;2;4;147;0;336;4;3;0
/org.eclipse.ltk.core.refactoring/src/org/eclipse/ltk/core/refactoring/Refactoring.java;2;4;9;2;7;3;7;2;59;0;1;264;156;156;4;1;4;2;9;275;5;336;4;2;0
/org.eclipse.debug.ui/ui/org/eclipse/debug/internal/ui/preferences/IDebugPreferenceConstants.java;4;3;8;2;4;2;4;4;28;2;3;46;58;58;3;1;2;4;8;274;3;304;5;4;1
/org.eclipse.jdt.ui/ui/org/eclipse/jdt/internal/ui/preferences/MarkOccurrencesConfigurationBlock.java;2;6;7;2;7;2;7;0;95;0;0;283;97;97;6;0;5;0;7;283;5;336;2;2;0
/org.eclipse.ui.ide/src/org/eclipse/ui/views/markers/internal/MarkerLabelProvider.java;1;0;1;1;0;0;0;1;0;0;1;129;0;0;1;0;0;1;1;129;0;129;1;1;0
/org.eclipse.team.cvs.core/src/org/eclipse/team/internal/ccvs/core/util/CVSDateFormatter.java;2;0;5;1;1;1;2;3;200;3;2;115;212;212;3;1;1;4;5;269;2;336;3;2;0
/org.eclipse.ui.console/src/org/eclipse/ui/internal/console/PinConsoleAction.java;1;0;2;1;0;0;0;2;3;0;1;118;3;3;2;1;0;2;2;118;1;118;1;1;0
/org.eclipse.jdt.ui/ui/org/eclipse/jdt/internal/ui/javaeditor/SemanticHighlightingPresenter.java;4;6;8;3;8;3;8;0;171;0;0;283;218;218;6;0;5;0;8;283;5;326;3;4;0
/org.eclipse.search/search/org/eclipse/search/internal/ui/RemovePotentialMatchesAction.java;1;0;2;1;1;1;1;1;80;0;1;42;84;84;1;0;0;1;2;42;0;336;2;1;0
/org.eclipse.jdt.ui/ui/org/eclipse/jdt/internal/ui/search/PrettySignature.java;2;1;3;1;3;3;3;0;17;0;0;290;20;20;1;0;0;0;3;290;0;336;3;2;0
/org.eclipse.jdt.ui/ui/org/eclipse/jdt/internal/ui/preferences/formatter/BlankLinesTabPage.java;1;0;10;1;0;0;0;10;239;6;3;176;267;267;6;7;0;10;10;191;7;219;3;1;0
/org.eclipse.jdt.debug.ui/ui/org/eclipse/jdt/internal/debug/ui/JavaThreadActionFilter.java;1;0;1;1;0;0;0;1;11;0;1;181;11;11;1;0;0;1;1;181;0;181;1;1;0
/org.eclipse.jdt.core/codeassist/org/eclipse/jdt/internal/codeassist/complete/CompletionOnKeyword.java;2;0;2;1;0;0;0;2;2;1;2;63;3;3;1;0;0;2;2;63;0;199;2;2;0
/org.eclipse.core.resources/src/org/eclipse/core/internal/watson/ElementTreeReaderImpl_1.java;1;0;1;1;1;1;1;0;149;0;0;277;149;149;1;0;0;0;1;277;0;277;1;1;0
/org.eclipse.pde.runtime/src/org/eclipse/pde/internal/runtime/registry/ExtensionPointPropertySource.java;2;1;5;1;2;2;2;3;86;2;2;59;187;187;2;1;0;3;5;224;1;336;4;2;0
/org.eclipse.osgi/core/framework/org/eclipse/osgi/framework/debug/Debug.java;4;2;8;2;4;3;4;4;272;2;2;171;390;390;2;2;1;4;8;171;3;336;5;4;0
/org.eclipse.ui.ide/src/org/eclipse/ui/views/markers/internal/DialogTaskProperties.java;4;1;3;2;2;2;2;1;27;0;1;129;37;37;1;0;0;1;3;129;0;336;3;4;0
/org.eclipse.ui.workbench.texteditor/src/org/eclipse/ui/internal/texteditor/quickdiff/compare/rangedifferencer/LinkedRangeDifference.java;1;1;3;1;2;2;2;1;3;0;1;100;5;5;1;0;0;1;3;100;0;336;3;1;0
/org.eclipse.jdt.ui/ui/org/eclipse/jdt/internal/ui/preferences/MembersOrderPreferencePage.java;2;0;3;1;1;1;1;2;254;0;1;207;256;256;2;1;0;2;3;207;1;336;2;2;0
/org.eclipse.debug.core/core/org/eclipse/debug/core/sourcelookup/AbstractSourceLookupDirector.java;1;0;3;1;1;1;2;1;143;0;1;268;147;147;2;0;1;2;3;268;1;309;2;1;1
/org.eclipse.jdt.ui/ui/org/eclipse/jdt/internal/ui/javaeditor/JarEntryEditorInput.java;1;0;1;1;1;1;1;0;2;0;0;336;2;2;1;0;0;0;1;336;0;336;1;1;0
/org.eclipse.swt/Eclipse SWT/carbon/org/eclipse/swt/widgets/Sash.java;4;1;7;1;2;2;2;5;91;1;5;10;109;109;1;0;0;5;7;10;0;337;7;4;0
/org.eclipse.compare/compare/org/eclipse/compare/IPropertyChangeNotifier.java;1;0;1;1;0;0;0;1;2;0;1;219;2;2;1;0;0;1;1;219;0;219;1;1;0
/org.eclipse.swt/Eclipse SWT/carbon/org/eclipse/swt/widgets/Shell.java;4;6;30;3;7;2;7;23;433;6;11;0;681;681;6;12;5;23;30;127;17;308;13;4;4
/org.eclipse.swt/Eclipse SWT PI/gtk/org/eclipse/swt/internal/gtk/GtkSelectionData.java;3;0;4;1;1;1;1;3;17;2;2;100;29;29;2;1;0;3;4;226;1;337;3;3;0
/org.eclipse.ui.workbench/Eclipse UI/org/eclipse/ui/internal/registry/EditorRegistryReader.java;3;0;4;1;1;1;1;3;41;1;3;157;60;60;1;0;0;3;4;157;0;336;4;3;0
/org.eclipse.jface.text/src/org/eclipse/jface/text/PropagatingFontFieldEditor.java;2;2;3;2;3;2;3;0;4;0;0;279;5;5;2;0;1;0;3;336;1;336;2;2;0
/org.eclipse.ui.workbench/Eclipse UI/org/eclipse/ui/internal/activities/ws/ActivityContentProvider.java;3;0;3;1;1;1;1;2;2;1;2;174;4;4;1;0;0;2;3;174;0;336;3;3;0
/org.eclipse.swt/Eclipse SWT/carbon/org/eclipse/swt/widgets/FontDialog.java;5;1;8;3;3;3;3;5;46;3;3;12;115;115;3;2;0;5;8;12;2;337;6;5;1
/org.eclipse.jdt.ui/ui refactoring/org/eclipse/jdt/internal/ui/refactoring/MessageWizardPage.java;2;0;4;1;1;1;2;2;4;2;2;101;8;8;2;0;1;3;4;269;1;336;3;2;0
/org.eclipse.ltk.core.refactoring/src/org/eclipse/ltk/internal/core/refactoring/ContentStamps.java;1;0;4;1;4;1;4;0;28;0;0;278;28;28;4;0;3;0;4;278;3;278;1;1;0
/org.eclipse.ui.workbench/Eclipse UI/org/eclipse/ui/internal/registry/ActionSetDescriptor.java;3;1;7;1;3;3;3;4;35;2;3;157;122;122;2;1;0;4;7;225;1;336;6;3;0
/org.eclipse.debug.ui/ui/org/eclipse/debug/internal/ui/views/memory/MemoryViewUtil.java;1;0;1;1;1;1;1;0;0;0;0;282;0;0;1;0;0;0;1;282;0;282;1;1;4
/org.eclipse.swt/Eclipse SWT/emulated/treetable/org/eclipse/swt/widgets/Table.java;6;4;22;2;6;3;6;16;164;2;12;8;652;652;4;4;3;16;22;330;7;330;15;6;1
/org.eclipse.jdt.ui/core extension/org/eclipse/jdt/internal/corext/codemanipulation/AddImportsOperation.java;2;0;3;1;1;1;1;2;8;1;2;175;12;12;1;0;0;2;3;175;0;336;3;2;0
/org.eclipse.debug.ui/ui/org/eclipse/debug/internal/ui/sourcelookup/SourceContainerAction.java;1;0;2;1;0;0;0;2;2;1;2;209;2;2;1;0;0;2;2;209;0;268;2;1;0
/org.eclipse.jdt.ui/ui/org/eclipse/jdt/internal/ui/browsing/PackagesViewTreeViewer.java;1;1;2;1;2;2;2;0;51;0;0;311;53;53;1;0;0;0;2;311;0;336;2;1;0
/org.eclipse.team.cvs.ui/src/org/eclipse/team/internal/ccvs/ui/actions/ReplaceWithRevisionAction.java;2;1;8;1;3;3;3;5;95;0;1;241;124;124;5;4;0;5;8;241;4;336;4;2;0
/org.eclipse.search/new search/org/eclipse/search/ui/IQueryListener.java;3;3;7;2;4;2;4;3;54;2;2;239;94;94;3;1;2;3;7;276;3;336;4;3;0
/org.eclipse.ui.workbench/Eclipse UI/org/eclipse/ui/internal/themes/CascadingFontRegistry.java;1;0;2;1;0;0;0;2;11;1;2;241;11;11;1;0;0;2;2;241;0;262;2;1;0
/org.eclipse.ui.ide/src/org/eclipse/ui/views/bookmarkexplorer/SelectAllAction.java;1;0;1;1;0;0;0;1;0;0;1;129;0;0;1;0;0;1;1;129;0;129;1;1;0
/org.eclipse.text/src/org/eclipse/jface/text/BadLocationException.java;1;0;1;1;1;1;1;0;6;0;0;334;6;6;1;0;0;0;1;334;0;334;1;1;0
/org.eclipse.pde.ui/src/org/eclipse/pde/internal/ui/editor/build/BuildPage.java;3;4;8;3;7;3;7;1;188;0;1;104;235;235;4;0;4;1;8;302;4;336;4;3;0
/org.eclipse.jdt.core/dom/org/eclipse/jdt/core/dom/Modifier.java;4;0;10;1;1;1;1;9;359;3;6;85;396;396;3;3;0;9;10;230;3;283;7;4;1
/org.eclipse.jdt.core/search/org/eclipse/jdt/internal/core/search/processing/JobManager.java;4;1;20;3;2;2;3;17;139;4;12;5;513;513;4;5;1;18;20;55;6;325;14;4;0
/org.eclipse.ant.ui/Remote Ant Support/org/eclipse/ant/internal/ui/antsupport/InternalAntRunner.java;1;3;16;1;7;4;7;9;182;2;7;108;700;700;3;2;3;9;16;301;5;336;11;1;2
/org.eclipse.jdt.ui/core extension/org/eclipse/jdt/internal/corext/callhierarchy/MethodReferencesSearchRequestor.java;2;1;3;1;3;3;3;0;3;0;0;283;5;5;1;0;0;0;3;283;0;336;3;2;0
/org.eclipse.core.runtime/src/org/eclipse/core/internal/jobs/JobQueue.java;3;0;13;2;1;1;1;12;464;5;5;46;661;661;5;7;0;12;13;118;7;277;6;3;0
/org.eclipse.swt/Eclipse SWT/win32/org/eclipse/swt/internal/BidiUtil.java;5;0;7;1;1;1;1;6;164;2;5;35;290;290;2;1;0;6;7;76;1;337;6;5;0
/org.eclipse.core.runtime/src/org/eclipse/core/internal/boot/PlatformURLBaseConnection.java;2;1;4;2;2;2;2;2;102;0;1;173;110;110;2;1;0;2;4;173;1;336;3;2;0
/org.eclipse.core.resources/src/org/eclipse/core/resources/IWorkspaceRoot.java;2;0;4;2;0;0;2;2;324;3;2;3;330;330;3;0;2;4;4;270;2;270;2;2;0
/org.eclipse.swt/Eclipse SWT/carbon/org/eclipse/swt/widgets/DirectoryDialog.java;3;1;4;1;2;2;2;2;25;1;2;58;48;48;1;0;0;2;4;58;0;337;4;3;0
/org.eclipse.pde.ui/src/org/eclipse/pde/internal/ui/launcher/OpenLogDialog.java;2;2;3;2;3;2;3;0;377;0;0;315;377;377;2;0;1;0;3;330;1;330;2;2;0
/org.eclipse.osgi/eclipseAdaptor/src/org/eclipse/osgi/service/runnable/ParameterizedRunnable.java;2;0;2;1;0;0;0;2;6;1;2;232;6;6;1;0;0;2;2;232;0;268;2;2;0
/org.eclipse.core.resources/src/org/eclipse/core/internal/resources/WorkManager.java;2;3;21;2;6;3;6;15;711;6;6;90;1122;1122;6;9;3;15;21;114;12;313;9;2;0
/org.eclipse.update.core/src/org/eclipse/update/search/IUpdateSiteAdapter.java;2;1;6;2;2;2;2;4;7;2;3;54;15;15;2;1;0;4;6;54;1;336;5;2;0
/org.eclipse.debug.core/core/org/eclipse/debug/core/ILaunchesListener2.java;2;0;2;2;0;0;0;2;4;0;1;231;4;4;2;1;0;2;2;231;1;231;1;2;0
/org.eclipse.team.cvs.ui/src/org/eclipse/team/internal/ccvs/ui/actions/UneditAction.java;2;1;3;1;2;2;2;1;8;0;1;71;12;12;1;0;0;1;3;71;0;336;3;2;0
/org.eclipse.team.core/src/org/eclipse/team/internal/core/subscribers/SyncSetInput.java;2;0;4;2;1;1;1;3;96;2;2;199;98;98;2;1;0;3;4;232;1;336;3;2;0
/org.eclipse.core.runtime/src/org/eclipse/core/internal/runtime/AdapterManager.java;5;2;13;2;5;3;5;8;850;3;6;3;1479;1479;3;2;2;8;13;171;4;321;9;5;0
/org.eclipse.swt/Eclipse SWT/common/org/eclipse/swt/internal/image/JPEGFileFormat.java;2;1;3;1;2;2;2;1;4;0;1;152;10;10;1;0;0;1;3;152;0;337;3;2;0
/org.eclipse.jdt.ui/ui/org/eclipse/jdt/internal/ui/javaeditor/CompilationUnitDocumentProvider.java;4;3;36;3;5;3;5;31;748;6;12;56;1743;1743;6;19;2;31;36;71;21;331;15;4;0
/org.eclipse.pde.core/src/org/eclipse/pde/internal/core/TargetPlatform.java;3;3;33;2;9;4;10;23;253;10;8;65;695;695;10;15;6;24;33;222;21;331;12;3;0
/org.eclipse.team.core/src/org/eclipse/team/internal/core/Sorter.java;1;0;3;1;1;1;1;2;67;1;2;159;71;71;1;0;0;2;3;159;0;336;3;1;0
/org.eclipse.pde.core/src/org/eclipse/pde/internal/core/ExternalJavaSearchInitializer.java;2;1;2;1;2;2;2;0;6;0;0;307;7;7;1;0;0;0;2;307;0;336;2;2;0
/org.eclipse.jdt.core/model/org/eclipse/jdt/core/IImportDeclaration.java;3;0;8;2;1;1;1;7;26;2;6;7;45;45;2;1;0;7;8;7;1;283;7;3;0
/org.eclipse.jdt.ui/ui refactoring/org/eclipse/jdt/internal/ui/refactoring/TextInputWizardPage.java;2;0;5;1;1;1;2;3;3;2;3;41;9;9;2;0;1;4;5;269;1;336;4;2;0
/org.eclipse.update.core/src/org/eclipse/update/internal/core/IWritable.java;1;0;1;1;0;0;0;1;2;0;1;58;2;2;1;0;0;1;1;58;0;58;1;1;0
/org.eclipse.jdt.core/model/org/eclipse/jdt/internal/core/util/LRUCache.java;1;0;2;1;0;0;0;2;6;1;2;77;8;8;1;0;0;2;2;77;0;199;2;1;0
/org.eclipse.pde.core/src/org/eclipse/pde/internal/core/IModelChangeProviderExtension.java;2;2;3;1;3;2;3;0;16;0;0;296;22;22;2;0;1;0;3;296;1;336;2;2;0
/org.eclipse.swt/Eclipse SWT PI/win32/org/eclipse/swt/internal/ole/win32/EXCEPINFO.java;1;0;1;1;0;0;0;1;4;0;1;166;4;4;1;0;0;1;1;166;0;166;1;1;0
/org.eclipse.jdt.ui/ui/org/eclipse/jdt/ui/text/folding/IJavaFoldingStructureProvider.java;1;2;3;1;3;2;3;0;15;0;0;292;15;15;2;0;1;0;3;335;1;335;2;1;0
/org.eclipse.pde.core/src/org/eclipse/pde/internal/core/IFileAdapterFactory.java;1;0;2;1;1;1;1;1;4;0;1;232;6;6;1;0;0;1;2;232;0;336;2;1;0
/org.eclipse.core.resources/src/org/eclipse/core/internal/watson/ElementTreeWriter.java;2;0;2;1;1;1;1;1;347;0;1;90;353;353;1;0;0;1;2;90;0;277;2;2;0
/org.eclipse.jdt.ui/ui/org/eclipse/jdt/ui/refactoring/RenameSupport.java;5;0;17;2;1;1;5;12;165;6;6;9;523;523;6;6;4;16;17;267;10;336;7;5;0
/org.eclipse.jdt.core/compiler/org/eclipse/jdt/internal/compiler/ast/ThrowStatement.java;2;0;4;1;0;0;0;4;18;2;3;63;24;24;2;1;0;4;4;63;1;199;3;2;0
/org.eclipse.jdt.ui/core refactoring/org/eclipse/jdt/internal/corext/refactoring/util/QualifiedNameSearchResult.java;2;1;3;1;2;2;2;1;29;0;1;253;35;35;1;0;0;1;3;253;0;336;3;2;0
/org.eclipse.core.runtime/src/org/eclipse/core/runtime/preferences/IExportedPreferences.java;1;2;5;1;3;2;3;2;8;0;1;240;12;12;2;1;1;2;5;240;2;297;3;1;0
/org.eclipse.jdt.core/codeassist/org/eclipse/jdt/internal/codeassist/complete/CompletionOnQualifiedClassReference.java;2;0;2;1;0;0;0;2;13;1;2;63;15;15;1;0;0;2;2;63;0;199;2;2;0
/org.eclipse.debug.ui/ui/org/eclipse/debug/internal/ui/actions/WatchExpressionDialog.java;1;0;2;1;0;0;0;2;21;0;1;92;21;21;2;1;0;2;2;92;1;92;1;1;0
/org.eclipse.jdt.debug/model/org/eclipse/jdt/debug/core/JDIDebugModel.java;6;2;17;3;4;3;4;13;83;6;5;50;208;208;6;8;1;13;17;233;9;336;8;6;1
/org.eclipse.jface.text/src/org/eclipse/jface/text/reconciler/AbstractReconcileStep.java;2;2;6;1;3;2;3;3;29;1;3;99;39;39;2;0;1;3;6;336;1;336;5;2;0
/org.eclipse.ltk.core.refactoring/src/org/eclipse/ltk/core/refactoring/participants/DeleteParticipant.java;1;1;4;1;2;2;2;2;19;0;1;264;48;48;2;1;0;2;4;264;1;336;3;1;0
/org.eclipse.jface/src/org/eclipse/jface/util/TransferDragSourceListener.java;1;0;1;1;0;0;0;1;0;0;1;13;0;0;1;0;0;1;1;13;0;13;1;1;0
/org.eclipse.ui.workbench/Eclipse UI/org/eclipse/ui/internal/SaveAllAction.java;3;0;4;1;1;1;1;3;102;1;3;157;127;127;1;0;0;3;4;157;0;336;4;3;0
/org.eclipse.ui.workbench/Eclipse UI/org/eclipse/ui/actions/ImportResourcesAction.java;4;0;4;2;1;1;1;3;114;1;3;157;144;144;1;0;0;3;4;157;0;336;4;4;0
/org.eclipse.debug.core/core/org/eclipse/debug/internal/core/sourcelookup/containers/ProjectSourceContainerType.java;2;0;3;2;1;1;1;2;21;1;2;205;27;27;1;0;0;2;3;205;0;303;3;2;0
/org.eclipse.pde.core/src/org/eclipse/pde/internal/core/ischema/ISchemaCompositor.java;2;1;2;1;2;2;2;0;4;0;0;309;6;6;1;0;0;0;2;309;0;336;2;2;0
/org.eclipse.swt/Eclipse SWT/common/org/eclipse/swt/internal/image/PngHuffmanTables.java;1;0;1;1;0;0;0;1;5;0;1;127;5;5;1;0;0;1;1;127;0;127;1;1;0
/org.eclipse.ant.ui/Ant Editor/org/eclipse/ant/internal/ui/dtd/IAttribute.java;1;0;1;1;0;0;0;1;0;0;1;108;0;0;1;0;0;1;1;108;0;108;1;1;0
/org.eclipse.jdt.ui/ui/org/eclipse/jdt/internal/ui/text/java/IReconcilingParticipant.java;1;0;2;1;1;1;1;1;2;0;1;253;4;4;1;0;0;1;2;253;0;336;2;1;0
/org.eclipse.jdt.core/search/org/eclipse/jdt/internal/core/search/matching/FieldLocator.java;5;2;17;3;3;2;3;14;90;4;8;118;282;282;4;6;1;14;17;118;7;311;10;5;7
/org.eclipse.debug.ui/ui/org/eclipse/debug/internal/ui/launchConfigurations/LaunchConfigurationPresentationManager.java;3;1;6;1;2;2;2;4;64;1;4;33;83;83;1;0;0;4;6;33;0;336;6;3;0
/org.eclipse.ui.workbench/Eclipse UI/org/eclipse/ui/IReusableEditor.java;3;1;3;1;2;2;2;1;5;0;1;0;11;11;1;0;0;1;3;0;0;336;3;3;0
/org.eclipse.update.core/src/org/eclipse/update/core/InstallMonitor.java;2;2;6;2;4;3;4;2;36;0;1;58;53;53;2;1;1;2;6;58;2;336;4;2;0
/org.eclipse.jdt.ui/ui refactoring/org/eclipse/jdt/internal/ui/refactoring/reorg/ReorgMessages.java;2;0;2;1;1;1;1;1;2;0;1;70;2;2;1;0;0;1;2;70;0;336;2;2;0
/org.eclipse.jdt.ui/ui/org/eclipse/jdt/ui/actions/FindImplementorsInProjectAction.java;3;2;11;2;4;3;4;7;21;2;5;101;67;67;2;2;1;7;11;101;3;336;8;3;0
/org.eclipse.ui.ide/src/org/eclipse/ui/internal/ide/dialogs/ProjectReferencePage.java;5;1;7;2;2;2;3;4;24;2;3;132;45;45;2;1;1;5;7;144;2;336;5;5;1
/org.eclipse.swt/Eclipse SWT Custom Widgets/common/org/eclipse/swt/custom/TreeEditor.java;3;1;5;2;2;2;2;3;115;2;2;56;128;128;2;1;0;3;5;56;1;337;4;3;0
/org.eclipse.jdt.core/compiler/org/eclipse/jdt/internal/compiler/env/ISourceImport.java;2;0;5;1;0;0;0;5;3;2;4;7;9;9;2;1;0;5;5;7;1;226;4;2;0
/org.eclipse.core.runtime.compatibility/src-runtime/org/eclipse/core/internal/plugins/DevClassPathHelper.java;1;0;1;1;1;1;1;0;0;0;0;282;0;0;1;0;0;0;1;282;0;282;1;1;0
/org.eclipse.jdt.ui/ui/org/eclipse/jdt/internal/ui/text/HTMLTextPresenter.java;1;0;1;1;1;1;1;0;2;0;0;336;2;2;1;0;0;0;1;336;0;336;1;1;0
/org.eclipse.swt/Eclipse SWT PI/motif/org/eclipse/swt/internal/motif/XWindowAttributes.java;1;0;1;1;0;0;0;1;44;0;1;54;44;44;1;0;0;1;1;54;0;54;1;1;0
/org.eclipse.jdt.ui/core refactoring/org/eclipse/jdt/internal/corext/refactoring/code/ExtractMethodAnalyzer.java;4;1;14;2;3;3;3;11;49;2;9;10;202;202;2;2;0;11;14;10;2;336;12;4;1
/org.eclipse.ui.ide/src/org/eclipse/ui/internal/ide/dialogs/MultiStepWizard.java;1;0;1;1;0;0;0;1;0;0;1;132;0;0;1;0;0;1;1;132;0;132;1;1;0
/org.eclipse.ui.intro/src/org/eclipse/ui/internal/intro/impl/swt/PageForm.java;2;6;7;2;7;2;7;0;131;0;0;305;252;252;6;0;5;0;7;305;5;333;2;2;0
/org.eclipse.jface.text/src/org/eclipse/jface/internal/text/link/contentassist/ContentAssistant2.java;3;2;7;2;4;3;4;3;57;2;2;232;71;71;2;1;1;3;7;246;2;336;5;3;0
/org.eclipse.jdt.ui/ui refactoring/org/eclipse/jdt/internal/ui/refactoring/nls/SourceFirstPackageSelectionDialogField.java;3;5;7;1;6;2;6;1;119;0;1;267;121;121;5;0;4;1;7;289;4;336;3;3;0
/org.eclipse.ui.editors/src/org/eclipse/ui/internal/editors/text/ColorEditor.java;1;0;1;1;1;1;1;0;2;0;0;336;2;2;1;0;0;0;1;336;0;336;1;1;0
/org.eclipse.ant.ui/Ant Editor/org/eclipse/ant/internal/ui/editor/AntEditorSourceViewerConfiguration.java;2;4;18;2;6;2;6;12;152;4;6;108;345;345;4;6;4;12;18;218;10;299;8;2;3
/org.eclipse.ant.ui/Ant Editor/org/eclipse/ant/internal/ui/editor/text/TagRule.java;1;0;4;1;1;1;1;3;61;1;3;108;71;71;1;0;0;3;4;108;0;299;4;1;0
/org.eclipse.team.cvs.ui/src/org/eclipse/team/internal/ccvs/ui/actions/TagAction.java;2;1;10;2;3;3;3;7;199;2;6;47;279;279;2;1;0;7;10;63;1;336;9;2;1
/org.eclipse.jdt.core/model/org/eclipse/jdt/core/IJavaElementDelta.java;2;0;5;2;1;1;1;4;47;1;4;76;83;83;1;0;0;4;5;76;0;290;5;2;0
/org.eclipse.debug.ui/ui/org/eclipse/debug/ui/sourcelookup/SourceLookupDialog.java;2;1;4;1;2;2;2;2;9;0;1;268;19;19;2;1;0;2;4;268;1;296;3;2;0
/org.eclipse.ui.workbench/Eclipse UI/org/eclipse/ui/internal/WorkbenchEditorsAction.java;1;0;1;1;0;0;0;1;51;0;1;157;51;51;1;0;0;1;1;157;0;157;1;1;0
/org.eclipse.swt.tools/Preprocessor/org/eclipse/swt/tools/internal/SwtReplace.java;2;0;2;1;0;0;0;2;2;1;2;230;2;2;1;0;0;2;2;230;0;250;2;2;0
/org.eclipse.ui.workbench/Eclipse UI/org/eclipse/ui/internal/intro/IIntroDescriptor.java;1;0;3;1;1;1;1;2;18;1;2;254;25;25;1;0;0;2;3;254;0;294;3;1;0
/org.eclipse.jface.text/src/org/eclipse/jface/text/source/LineRange.java;2;2;3;2;3;2;3;0;10;0;0;275;10;10;2;0;1;0;3;336;1;336;2;2;0
/org.eclipse.pde.ui/src/org/eclipse/pde/internal/ui/editor/feature/FeatureAdapterFactory.java;1;0;2;1;1;1;1;1;8;0;1;232;12;12;1;0;0;1;2;232;0;336;2;1;0
/org.eclipse.swt/Eclipse SWT PI/photon/org/eclipse/swt/internal/photon/PhCursorDef_t.java;1;0;1;1;0;0;0;1;10;0;1;53;10;10;1;0;0;1;1;53;0;53;1;1;0
/org.eclipse.ui.workbench/Eclipse UI/org/eclipse/ui/internal/dialogs/AboutPluginsDialog.java;4;0;3;2;1;1;1;2;795;1;2;7;796;796;1;0;0;2;3;7;0;294;3;4;1
/org.eclipse.pde.ui/src/org/eclipse/pde/internal/ui/view/OpenDependenciesAction.java;1;1;2;1;2;2;2;0;10;0;0;304;14;14;1;0;0;0;2;304;0;336;2;1;0
/org.eclipse.swt/Eclipse SWT PI/motif/org/eclipse/swt/internal/motif/XConfigureEvent.java;1;0;2;1;0;0;0;2;11;1;2;56;18;18;1;0;0;2;2;56;0;88;2;1;0
/org.eclipse.ui.workbench/Eclipse UI/org/eclipse/ui/presentations/IPresentationSerializer.java;1;0;1;1;1;1;1;0;0;0;0;303;0;0;1;0;0;0;1;303;0;303;1;1;0
/org.eclipse.jdt.core/search/org/eclipse/jdt/internal/core/search/matching/PatternLocator.java;3;0;19;2;3;1;3;16;57;3;9;118;248;248;3;7;2;16;19;118;9;276;10;3;5
/org.eclipse.jdt.ui/ui/org/eclipse/jdt/internal/ui/javaeditor/ToggleCommentAction.java;2;0;3;1;1;1;1;2;211;1;2;207;235;235;1;0;0;2;3;207;0;274;3;2;0
/org.eclipse.update.core/src/org/eclipse/update/internal/operations/PatchCleaner.java;1;0;1;1;0;0;0;1;0;0;1;71;0;0;1;0;0;1;1;71;0;71;1;1;0
/org.eclipse.debug.ui/ui/org/eclipse/debug/internal/ui/launchConfigurations/LaunchConfigurationTypeContribution.java;1;0;1;1;1;1;1;0;0;0;0;280;0;0;1;0;0;0;1;280;0;280;1;1;0
/org.eclipse.update.core/src/org/eclipse/update/internal/core/FragmentEntry.java;1;1;4;1;2;2;2;2;6;1;2;228;12;12;1;0;0;2;4;228;0;336;4;1;0
/org.eclipse.team.cvs.ui/src/org/eclipse/team/internal/ccvs/ui/wizards/SharingWizardPageActionGroup.java;2;2;4;1;4;3;4;0;147;0;0;280;154;154;2;0;1;0;4;288;1;307;3;2;0
/org.eclipse.ui.ide/extensions/org/eclipse/ui/part/FileEditorInput.java;2;0;2;1;0;0;0;2;1;1;2;132;1;1;1;0;0;2;2;132;0;157;2;2;1
/org.eclipse.swt/Eclipse SWT Mozilla/common/org/eclipse/swt/internal/mozilla/nsIContentViewer.java;1;0;1;1;0;0;0;1;0;0;1;153;0;0;1;0;0;1;1;153;0;153;1;1;0
/org.eclipse.ui.workbench/Eclipse UI/org/eclipse/ui/internal/activities/ActivityDefinition.java;4;0;12;2;1;1;1;11;172;6;4;141;231;231;6;7;0;11;12;160;7;336;5;4;0
/org.eclipse.pde.ui/src/org/eclipse/pde/internal/ui/IHelpContextIds.java;2;1;2;1;2;2;2;0;170;0;0;308;174;174;1;0;0;0;2;308;0;336;2;2;0
/org.eclipse.debug.ui/ui/org/eclipse/debug/internal/ui/views/memory/MemoryViewTab.java;2;4;5;2;5;2;5;0;82;0;0;282;94;94;4;0;3;0;5;282;3;326;2;2;4
/org.eclipse.search/search/org/eclipse/search/internal/ui/ScopePart.java;2;1;11;1;2;2;2;9;329;5;5;63;409;409;5;4;0;9;11;93;4;336;7;2;0
/org.eclipse.jdt.debug/model/org/eclipse/jdt/debug/core/IJavaStratumLineBreakpoint.java;2;0;3;1;2;1;2;1;46;0;1;53;46;46;2;0;1;1;3;275;1;275;2;2;0
/org.eclipse.ui.ide/src/org/eclipse/ui/views/markers/internal/BookmarkView.java;4;0;4;1;1;1;1;3;2;1;3;183;3;3;1;0;0;3;4;183;0;336;4;4;0
/org.eclipse.jdt.ui/ui/org/eclipse/jdt/ui/actions/OpenTypeHierarchyAction.java;3;0;3;1;1;1;1;2;10;1;2;41;13;13;1;0;0;2;3;41;0;336;3;3;0
/org.eclipse.jdt.core/codeassist/org/eclipse/jdt/internal/codeassist/CompletionEngine.java;6;5;30;3;7;3;7;23;167;4;11;5;571;571;5;12;4;23;30;293;16;324;14;6;5
/org.eclipse.core.resources/src/org/eclipse/core/internal/resources/Resource.java;3;2;27;2;3;2;5;22;3087;8;11;3;3601;3601;8;11;3;24;27;139;14;321;13;3;0
/org.eclipse.jdt.core/search/org/eclipse/jdt/internal/core/search/IndexSelector.java;2;2;7;1;4;3;4;3;78;1;3;162;162;162;2;0;1;3;7;302;1;302;6;2;0
/org.eclipse.core.filebuffers/src/org/eclipse/core/filebuffers/IFileBufferListener.java;2;0;6;2;2;1;2;4;55;2;3;93;103;103;2;1;1;4;6;93;2;334;4;2;0
/org.eclipse.jdt.core/model/org/eclipse/jdt/core/util/IClassFileAttribute.java;1;0;1;1;0;0;0;1;2;0;1;199;2;2;1;0;0;1;1;199;0;199;1;1;0
/org.eclipse.jdt.core/model/org/eclipse/jdt/internal/core/CreateElementInCUOperation.java;3;1;10;1;2;2;2;8;33;4;5;108;86;86;4;3;0;8;10;194;3;314;7;3;0
/org.eclipse.jdt.ui/core extension/org/eclipse/jdt/internal/corext/template/java/CompilationUnitCompletion.java;1;0;3;1;1;1;1;2;31;1;2;82;39;39;1;0;0;2;3;82;0;336;3;1;0
/org.eclipse.core.expressions/src/org/eclipse/core/internal/expressions/EqualsExpression.java;1;0;1;1;0;0;0;1;0;0;1;253;0;0;1;0;0;1;1;253;0;253;1;1;0
/org.eclipse.pde.core/src/org/eclipse/pde/internal/core/bundle/BundleFragmentModel.java;1;1;2;1;2;2;2;0;10;0;0;292;10;10;1;0;0;0;2;292;0;336;2;1;0
/org.eclipse.update.configurator/src/org/eclipse/update/configurator/IPlatformConfigurationFactory.java;2;1;3;1;2;2;2;1;9;0;1;171;13;13;1;0;0;1;3;171;0;336;3;2;0
/org.eclipse.ui.workbench/Eclipse UI/org/eclipse/ui/internal/activities/ws/CategorizedActivity.java;3;1;5;2;2;2;2;3;11;2;2;194;21;21;2;1;0;3;5;253;1;336;4;3;0
/org.eclipse.text/projection/org/eclipse/jface/text/projection/Fragment.java;1;0;2;1;1;1;1;1;16;0;1;247;16;16;1;0;0;1;2;247;0;334;2;1;0
/org.eclipse.jdt.ui/core extension/org/eclipse/jdt/internal/corext/callhierarchy/CallerMethodWrapper.java;3;1;8;1;2;2;2;6;23;3;3;13;62;62;3;3;0;6;8;13;3;336;5;3;0
/org.eclipse.core.resources/src/org/eclipse/core/resources/IStorage.java;1;0;2;1;0;0;1;1;85;0;1;270;85;85;2;0;1;2;2;270;1;270;1;1;0
/org.eclipse.update.core/src/org/eclipse/update/core/IFeature.java;4;0;4;2;2;1;2;2;17;1;2;0;32;32;2;0;1;2;4;289;1;289;3;4;0
/org.eclipse.core.resources/src/org/eclipse/core/resources/WorkspaceJob.java;2;0;6;1;1;1;3;3;66;3;3;71;80;80;3;0;2;5;6;268;2;317;4;2;0
/org.eclipse.ui.workbench/Eclipse UI/org/eclipse/ui/internal/progress/AnimationItem.java;4;1;31;2;3;3;3;28;1115;12;4;68;2094;2094;12;24;0;28;31;68;24;336;7;4;0
/org.eclipse.jdt.debug.ui/ui/org/eclipse/jdt/internal/debug/core/refactoring/JavaWatchpointTypeChange.java;2;1;4;1;4;4;4;0;14;0;0;287;31;31;1;0;0;0;4;287;0;336;4;2;1
/org.eclipse.osgi/resolver/src/org/eclipse/osgi/internal/resolver/StateMsg.java;3;0;3;2;2;1;2;1;7;0;1;206;7;7;2;0;1;1;3;276;1;276;2;3;0
/org.eclipse.swt/Eclipse SWT Drag and Drop/carbon/org/eclipse/swt/dnd/FileTransfer.java;1;0;2;1;0;0;0;2;180;1;2;21;184;184;1;0;0;2;2;21;0;31;2;1;0
/org.eclipse.pde.core/src/org/eclipse/pde/internal/core/plugin/Extensions.java;3;2;8;2;4;3;4;4;14;2;3;128;40;40;2;1;1;4;8;128;2;336;6;3;0
/org.eclipse.core.runtime.compatibility/src-runtime/org/eclipse/core/internal/plugins/CompatibilityActivator.java;3;1;6;2;2;2;4;2;6;3;2;181;12;12;3;0;2;4;6;270;2;336;4;3;1
/org.eclipse.core.runtime/src/org/eclipse/core/internal/content/LazyReader.java;1;0;1;1;1;1;1;0;0;0;0;330;0;0;1;0;0;0;1;330;0;330;1;1;0
/org.eclipse.pde.ui/src/org/eclipse/pde/internal/ui/wizards/templates/ViewNewWizard.java;3;2;6;1;4;3;4;2;12;1;2;222;31;31;2;0;1;2;6;308;1;336;5;3;0
/org.eclipse.ui.workbench/Eclipse UI/org/eclipse/ui/application/WorkbenchAdvisor.java;5;5;15;2;6;2;6;9;191;2;6;166;366;366;5;3;4;9;15;292;7;336;8;5;0
/org.eclipse.ui.workbench/Eclipse UI/org/eclipse/ui/internal/dialogs/WorkingSetTypePage.java;1;0;1;1;0;0;0;1;2;0;1;157;2;2;1;0;0;1;1;157;0;157;1;1;1
/org.eclipse.jdt.ui/ui/org/eclipse/jdt/internal/ui/compare/JavaCompareUtilities.java;5;0;8;2;1;1;1;7;41;2;6;79;123;123;2;1;0;7;8;95;1;289;7;5;1
/org.eclipse.core.runtime/src/org/eclipse/core/runtime/jobs/ILock.java;3;2;10;2;3;2;3;7;372;3;5;25;526;526;3;2;1;7;10;171;3;317;7;3;0
/org.eclipse.jdt.debug/jdi/org/eclipse/jdi/internal/spy/JdwpCommandPacket.java;1;0;1;1;0;0;0;1;11;0;1;235;11;11;1;0;0;1;1;235;0;235;1;1;0
/org.eclipse.pde.core/src/org/eclipse/pde/internal/core/FileAdapter.java;2;2;4;1;3;2;3;1;8;0;1;232;16;16;2;0;1;1;4;331;1;331;3;2;0
/org.eclipse.update.core/src/org/eclipse/update/internal/core/URLKey.java;1;0;1;1;0;0;0;1;2;0;1;58;2;2;1;0;0;1;1;58;0;58;1;1;0
/org.eclipse.debug.ui/ui/org/eclipse/debug/ui/IDebugView.java;3;0;3;2;1;1;1;2;12;1;2;76;32;32;1;0;0;2;3;76;0;336;3;3;0
/org.eclipse.swt/Eclipse SWT/motif/org/eclipse/swt/widgets/Menu.java;5;1;10;3;2;2;2;8;27;3;6;2;57;57;3;2;0;8;10;2;2;337;8;5;0
/org.eclipse.jdt.launching/launching/org/eclipse/jdt/launching/VMRunnerConfiguration.java;5;1;11;3;2;2;2;9;161;3;7;17;358;358;3;2;0;9;11;150;2;336;9;5;0
/org.eclipse.jdt.launching/launching/org/eclipse/jdt/launching/JavaRuntime.java;5;4;25;4;8;3;8;17;293;5;9;8;743;743;5;8;5;17;25;165;13;336;12;5;0
/org.eclipse.pde.ui/src/org/eclipse/pde/internal/ui/util/PixelConverter.java;1;0;1;1;0;0;0;1;1;0;1;26;1;1;1;0;0;1;1;26;0;26;1;1;0
/org.eclipse.jdt.core/codeassist/org/eclipse/jdt/internal/codeassist/complete/CompletionOnImportReference.java;2;0;3;1;0;0;0;3;14;1;3;7;20;20;1;0;0;3;3;7;0;199;3;2;0
/org.eclipse.jdt.ui/ui/org/eclipse/jdt/internal/ui/actions/CompositeActionGroup.java;1;0;1;1;1;1;1;0;2;0;0;336;2;2;1;0;0;0;1;336;0;336;1;1;0
/org.eclipse.swt/Eclipse SWT Custom Widgets/common/org/eclipse/swt/custom/CTabFolder2Adapter.java;2;2;4;2;3;2;3;1;45;0;1;233;55;55;2;0;1;1;4;336;1;336;3;2;0
/org.eclipse.jdt.core/model/org/eclipse/jdt/core/jdom/IDOMInitializer.java;2;0;3;1;1;1;1;2;4;1;2;199;9;9;1;0;0;2;3;199;0;299;3;2;0
/org.eclipse.osgi/defaultAdaptor/src/org/eclipse/osgi/framework/adaptor/core/BundleFile.java;3;1;10;3;2;2;5;5;157;4;3;239;230;230;4;2;3;8;10;269;5;309;5;3;1
/org.eclipse.ui.ide/src/org/eclipse/ui/views/markers/internal/ProblemMarker.java;3;1;3;1;2;2;2;1;10;0;1;181;12;12;1;0;0;1;3;181;0;336;3;3;0
/org.eclipse.ui.ide/src/org/eclipse/ui/views/markers/internal/DialogBookmarkFilter.java;1;0;1;1;0;0;0;1;0;0;1;129;0;0;1;0;0;1;1;129;0;129;1;1;1
/org.eclipse.pde.core/src/org/eclipse/pde/internal/core/ibundle/IBundleModel.java;1;2;3;1;3;2;3;0;11;0;0;292;17;17;2;0;1;0;3;292;1;336;2;1;0
/org.eclipse.core.runtime.compatibility/src-model/org/eclipse/core/internal/model/PluginMap.java;2;1;3;1;2;2;2;1;16;0;1;171;18;18;1;0;0;1;3;171;0;336;3;2;0
/org.eclipse.jdt.ui/ui/org/eclipse/jdt/internal/ui/wizards/TypedViewerFilter.java;2;1;2;1;2;2;2;0;2;0;0;280;4;4;1;0;0;0;2;280;0;336;2;2;0
/org.eclipse.update.core/src/org/eclipse/update/core/model/DefaultSiteParser.java;2;2;10;1;4;3;4;6;92;3;4;58;190;190;3;2;1;6;10;96;3;336;7;2;0
/org.eclipse.jface/src/org/eclipse/jface/dialogs/ControlEnableState.java;2;2;3;1;3;2;3;0;189;0;0;288;193;193;2;0;1;0;3;288;1;336;2;2;0
/org.eclipse.osgi/eclipseAdaptor/src/org/eclipse/core/runtime/adaptor/EnvironmentInfo.java;4;1;8;1;4;4;4;4;39;2;3;171;83;83;2;1;0;4;8;171;1;336;7;4;1
/org.eclipse.ui.console/src/org/eclipse/ui/console/AbstractConsole.java;1;0;3;1;0;0;0;3;14;2;2;118;18;18;2;1;0;3;3;118;1;200;2;1;0
/org.eclipse.text/src/org/eclipse/text/edits/TextEditVisitor.java;1;1;3;1;2;2;2;1;42;0;1;150;44;44;1;0;0;1;3;150;0;336;3;1;0
/org.eclipse.jdt.ui/core extension/org/eclipse/jdt/internal/corext/codemanipulation/IImportsStructure.java;2;1;2;1;2;2;2;0;12;0;0;311;14;14;1;0;0;0;2;311;0;336;2;2;0
/org.eclipse.jdt.core/compiler/org/eclipse/jdt/internal/compiler/parser/JavadocParser.java;3;1;16;2;4;4;4;12;1819;5;4;165;2023;2023;5;8;0;12;16;165;8;325;8;3;5
/org.eclipse.osgi/core/framework/org/eclipse/osgi/framework/internal/core/Msg.java;4;0;4;2;2;1;2;2;14;1;2;171;25;25;2;0;1;2;4;276;1;276;3;4;0
/org.eclipse.jdt.ui/ui/org/eclipse/jdt/internal/ui/browsing/PackagesViewTableViewer.java;1;0;1;1;1;1;1;0;2;0;0;336;2;2;1;0;0;0;1;336;0;336;1;1;0
/org.eclipse.swt/Eclipse SWT/photon/org/eclipse/swt/widgets/ScrollBar.java;4;1;7;2;2;2;2;5;46;2;3;1;136;136;2;2;0;5;7;1;2;337;5;4;0
/org.eclipse.debug.core/core/org/eclipse/debug/core/DebugEvent.java;2;0;3;2;0;0;0;3;62;2;2;63;70;70;2;1;0;3;3;63;1;115;2;2;0
/org.eclipse.ui.workbench/Eclipse UI/org/eclipse/ui/internal/LayoutTreeNode.java;5;2;9;2;5;3;5;4;119;2;3;223;277;277;2;1;2;4;9;252;3;336;6;5;3
/org.eclipse.jdt.launching/launching/org/eclipse/jdt/internal/launching/VariableClasspathResolver.java;2;0;2;2;0;0;0;2;15;0;1;269;15;15;2;1;0;2;2;269;1;269;1;2;0
/org.eclipse.core.filebuffers/src/org/eclipse/core/internal/filebuffers/TextFileBufferManager.java;3;2;10;2;3;2;3;7;177;3;4;93;453;453;3;3;1;7;10;93;4;336;6;3;0
/org.eclipse.debug.core/core/org/eclipse/debug/internal/core/ContributedDelegate.java;2;1;3;1;2;2;2;1;11;0;1;32;15;15;1;0;0;1;3;32;0;336;3;2;0
/org.eclipse.debug.ui/ui/org/eclipse/debug/internal/ui/actions/AbstractDebugActionDelegate.java;1;0;1;1;0;0;0;1;12;0;1;98;12;12;1;0;0;1;1;98;0;98;1;1;2
/org.eclipse.ui.workbench/Eclipse UI/org/eclipse/ui/internal/keys/KeySequenceText.java;4;0;20;3;1;1;1;19;1006;10;4;103;1885;1885;10;15;0;19;20;103;15;336;5;4;0
/org.eclipse.team.cvs.ui/src/org/eclipse/team/internal/ccvs/ui/model/DateTagCategory.java;2;1;5;1;4;4;4;1;61;0;1;148;70;70;1;0;0;1;5;148;0;336;5;2;0
/org.eclipse.jface.text/src/org/eclipse/jface/text/source/ISourceViewer.java;2;0;5;2;2;1;2;3;49;2;2;219;67;67;2;1;1;3;5;257;2;336;3;2;0
/org.eclipse.swt/Eclipse SWT Mozilla/common/org/eclipse/swt/internal/mozilla/nsIDirectoryServiceProvider2.java;1;0;2;1;0;0;0;2;22;1;2;100;22;22;1;0;0;2;2;100;0;148;2;1;0
/org.eclipse.ui/src/org/eclipse/ui/internal/UIPreferenceInitializer.java;3;5;7;2;7;3;7;0;24;0;0;287;28;28;5;0;4;0;7;287;4;336;3;3;2
/org.eclipse.jdt.core/codeassist/org/eclipse/jdt/internal/codeassist/IExtendedCompletionRequestor.java;1;0;1;1;1;1;1;0;0;0;0;293;0;0;1;0;0;0;1;293;0;293;1;1;0
/org.eclipse.ltk.core.refactoring/src/org/eclipse/ltk/core/refactoring/participants/CreateArguments.java;1;0;4;1;2;1;2;2;14;0;1;264;19;19;2;1;1;2;4;264;2;275;2;1;0
/org.eclipse.jdt.core/model/org/eclipse/jdt/internal/core/PackageFragmentRootInfo.java;4;1;8;2;2;2;2;6;14;2;5;10;35;35;2;1;0;6;8;178;1;314;7;4;0
/org.eclipse.jdt.ui/ui/org/eclipse/jdt/internal/ui/actions/IndentAction.java;2;4;18;2;5;2;5;13;381;6;6;117;537;537;6;7;3;13;18;117;10;336;8;2;0
/org.eclipse.core.resources/src/org/eclipse/core/internal/indexing/ObjectAddress.java;1;0;1;1;1;1;1;0;33;0;0;277;33;33;1;0;0;0;1;277;0;277;1;1;0
/org.eclipse.core.resources/src/org/eclipse/core/internal/localstore/IHistoryStoreVisitor.java;1;0;1;1;1;1;1;0;16;0;0;277;16;16;1;0;0;0;1;277;0;277;1;1;0
/org.eclipse.jface/src/org/eclipse/jface/viewers/CheckboxTableViewer.java;2;1;4;1;3;3;3;1;26;0;1;150;58;58;1;0;0;1;4;150;0;336;4;2;0
/org.eclipse.jdt.ui/core refactoring/org/eclipse/jdt/internal/corext/refactoring/sef/SelfEncapsulateFieldRefactoring.java;4;4;28;2;6;3;6;22;431;9;11;9;845;845;9;11;3;22;28;244;14;323;14;4;2
/org.eclipse.ui.ide/src/org/eclipse/ui/internal/ide/dialogs/ResourceSorter.java;1;0;1;1;0;0;0;1;0;0;1;132;0;0;1;0;0;1;1;132;0;132;1;1;0
/org.eclipse.core.resources/src/org/eclipse/core/resources/IProjectDescription.java;3;0;8;2;0;0;3;5;562;4;5;3;635;635;4;0;3;8;8;270;3;270;5;3;0
/org.eclipse.ui.ide/src/org/eclipse/ui/internal/ide/dialogs/IDEStartupPreferencePage.java;2;1;4;1;2;2;2;2;12;0;1;267;16;16;2;1;0;2;4;267;1;336;3;2;0
/org.eclipse.swt.tools/Preprocessor/org/eclipse/swt/tools/internal/SwtJniGen.java;1;0;2;1;0;0;0;2;12;0;1;231;12;12;2;1;0;2;2;231;1;231;1;1;0
/org.eclipse.ui.externaltools/External Tools Base/org/eclipse/ui/externaltools/internal/model/BuilderUtils.java;2;2;6;2;3;2;3;3;49;0;1;228;73;73;3;2;1;3;6;228;3;324;3;2;0
/org.eclipse.ui.workbench/Eclipse UI/org/eclipse/ui/INestableKeyBindingService.java;2;0;3;1;1;1;1;2;66;0;1;231;70;70;2;1;0;2;3;231;1;336;2;2;0
/org.eclipse.pde.ui/src/org/eclipse/pde/internal/ui/launcher/AbstractLauncherTab.java;1;0;4;1;0;0;0;4;39;2;3;159;56;56;2;1;0;4;4;159;1;188;3;1;0
/org.eclipse.jdt.ui/ui/org/eclipse/jdt/internal/ui/search/ExceptionOccurrencesFinder.java;4;2;8;2;4;3;4;4;113;2;3;209;242;242;2;1;1;4;8;209;2;325;6;4;0
/org.eclipse.jdt.debug/model/org/eclipse/jdt/internal/debug/core/hcr/CompilationUnitDelta.java;3;0;6;2;2;1;2;4;20;2;3;22;43;43;2;1;1;4;6;76;2;335;4;3;1
/org.eclipse.jdt.debug.ui/ui/org/eclipse/jdt/internal/debug/core/refactoring/JavaMethodBreakpointTypeChange.java;3;1;4;2;4;4;4;0;22;0;0;287;38;38;1;0;0;0;4;287;0;336;4;3;1
/org.eclipse.ltk.ui.refactoring/src/org/eclipse/ltk/internal/ui/refactoring/IRefactoringHelpContextIds.java;1;0;2;1;1;1;1;1;4;0;1;269;4;4;1;0;0;1;2;269;0;289;2;1;0
/org.eclipse.pde.core/src/org/eclipse/pde/internal/core/site/AbstractSiteModel.java;3;1;7;2;2;2;2;5;42;3;3;166;56;56;3;2;0;5;7;166;2;336;5;3;0
/org.eclipse.core.expressions/src/org/eclipse/core/internal/expressions/ExpressionMessages.java;1;0;2;1;1;1;1;1;2;0;1;227;2;2;1;0;0;1;2;227;0;336;2;1;0
/org.eclipse.compare/compare/org/eclipse/compare/internal/ComparePreferencePage.java;1;0;7;1;1;1;1;6;118;1;6;45;168;168;1;0;0;6;7;45;0;337;7;1;0
/org.eclipse.swt/Eclipse SWT/carbon/org/eclipse/swt/widgets/Combo.java;6;3;23;2;8;5;8;15;88;4;8;8;364;364;4;7;3;15;23;168;10;337;13;6;0
/org.eclipse.jdt.core/dom/org/eclipse/jdt/core/dom/FieldAccess.java;5;0;12;1;2;1;2;10;114;2;8;5;182;182;2;2;1;10;12;230;3;276;9;5;1
/org.eclipse.jdt.core/dom/org/eclipse/jdt/core/dom/NormalAnnotation.java;2;0;8;1;2;1;2;6;214;4;3;225;234;234;4;3;1;6;8;225;4;283;4;2;2
/org.eclipse.jdt.core/model/org/eclipse/jdt/core/ElementChangedEvent.java;2;0;4;1;0;0;0;4;2;1;4;121;6;6;1;0;0;4;4;121;0;199;4;2;0
/org.eclipse.ui.workbench.texteditor/src/org/eclipse/ui/texteditor/IDocumentProviderExtension2.java;2;0;1;2;1;1;1;0;4;0;0;336;4;4;1;0;0;0;1;336;0;336;1;2;0
/org.eclipse.core.expressions/src/org/eclipse/core/expressions/EvaluationResult.java;1;1;5;1;3;3;3;2;31;0;1;227;65;65;2;1;0;2;5;227;1;334;4;1;0
/org.eclipse.ui.ide/extensions/org/eclipse/ui/actions/ScrubLocalAction.java;1;0;1;1;0;0;0;1;0;0;1;132;0;0;1;0;0;1;1;132;0;132;1;1;0
/org.eclipse.team.cvs.ui/src/org/eclipse/team/internal/ccvs/ui/subscriber/ChangeLogModelProvider.java;2;0;21;2;17;1;17;4;1159;3;2;234;1341;1341;17;2;16;4;21;288;18;288;3;2;5
/org.eclipse.ui.workbench/Eclipse UI/org/eclipse/ui/testing/TestableObject.java;1;0;3;1;0;0;0;3;81;1;3;131;83;83;1;0;0;3;3;131;0;165;3;1;0
/org.eclipse.update.ui/src/org/eclipse/update/internal/ui/model/BookmarkFolder.java;1;0;1;1;0;0;0;1;2;0;1;58;2;2;1;0;0;1;1;58;0;58;1;1;0
/org.eclipse.jface.text/src/org/eclipse/jface/text/source/ImageUtilities.java;2;1;2;1;2;2;2;0;2;0;0;287;2;2;1;0;0;0;2;287;0;336;2;2;0
/org.eclipse.jdt.ui/ui/org/eclipse/jdt/internal/ui/text/java/GetterSetterCompletionProposal.java;1;2;3;1;3;2;3;0;26;0;0;294;33;33;2;0;1;0;3;294;1;306;2;1;0
/org.eclipse.ui.ide/extensions/org/eclipse/ui/actions/NewProjectAction.java;4;2;7;1;3;2;3;4;18;2;3;132;35;35;2;1;1;4;7;132;2;336;5;4;0
/org.eclipse.ui.ide/src/org/eclipse/ui/internal/ide/actions/QuickMenuAction.java;1;0;1;1;1;1;1;0;0;0;0;315;0;0;1;0;0;0;1;315;0;315;1;1;0
/org.eclipse.search/search/org/eclipse/search/internal/ui/ShowPreviousResultAction.java;1;0;2;1;1;1;1;1;2;0;1;100;3;3;1;0;0;1;2;100;0;336;2;1;0
/org.eclipse.jdt.core/compiler/org/eclipse/jdt/internal/compiler/parser/RecoveredLocalVariable.java;4;0;5;2;0;0;0;5;14;2;4;34;32;32;2;1;0;5;5;63;1;199;4;4;0
/org.eclipse.ant.ui/Ant Editor/org/eclipse/ant/internal/ui/editor/templates/AntTemplatePreferencePage.java;1;2;4;1;4;2;4;0;150;0;0;285;161;161;2;0;2;0;4;285;2;313;2;1;1
/org.eclipse.ui.workbench/Eclipse UI/org/eclipse/ui/internal/WWinPluginAction.java;2;1;3;1;2;2;2;1;15;0;1;93;21;21;1;0;0;1;3;93;0;336;3;2;1
/org.eclipse.ui.editors/src/org/eclipse/ui/internal/editors/text/AnnotationsConfigurationBlock.java;1;3;4;1;4;2;4;0;13;0;0;295;15;15;3;0;2;0;4;295;2;336;2;1;0
/org.eclipse.jdt.ui/core refactoring/org/eclipse/jdt/internal/corext/refactoring/reorg/ASTNodeDeleteUtil.java;5;1;11;2;2;2;2;9;44;3;6;70;103;103;3;3;0;9;11;100;3;336;8;5;0
/org.eclipse.pde.ui/src/org/eclipse/pde/internal/ui/editor/IContextPart.java;2;2;4;2;4;3;4;0;10;0;0;292;15;15;2;0;1;0;4;292;1;336;3;2;0
/org.eclipse.core.runtime/src/org/eclipse/core/internal/runtime/DataArea.java;5;2;14;3;4;2;4;10;179;5;4;205;370;370;5;6;2;10;14;205;8;296;6;5;0
/org.eclipse.team.cvs.ui/src/org/eclipse/team/internal/ccvs/ui/operations/DisconnectOperation.java;2;2;5;1;3;2;3;2;9;1;2;158;19;19;2;0;1;2;5;321;1;336;4;2;0
/org.eclipse.core.runtime/src/org/eclipse/core/internal/runtime/DevClassPathHelper.java;2;0;2;2;2;1;2;0;4;0;0;293;4;4;2;0;1;0;2;293;1;293;1;2;0
/org.eclipse.jdt.ui/ui/org/eclipse/jdt/ui/actions/FindWriteReferencesInProjectAction.java;3;2;11;2;4;3;4;7;21;2;5;102;69;69;2;2;1;7;11;102;3;336;8;3;0
/org.eclipse.jdt.core/model/org/eclipse/jdt/internal/core/JavaElementDelta.java;3;2;12;2;4;3;4;8;241;2;6;54;340;340;2;2;1;8;12;70;3;323;9;3;0
/org.eclipse.jdt.ui/core refactoring/org/eclipse/jdt/internal/corext/refactoring/base/JavaRefactorings.java;2;0;4;1;1;1;1;3;8;1;3;57;15;15;1;0;0;3;4;57;0;336;4;2;0
/org.eclipse.jface.text/src/org/eclipse/jface/text/ITextHover.java;2;0;2;2;2;1;2;0;30;0;0;336;30;30;2;0;1;0;2;336;1;336;1;2;0
/org.eclipse.core.resources/src/org/eclipse/core/resources/IMarkerDelta.java;2;0;2;1;1;1;1;1;301;0;1;13;310;310;1;0;0;1;2;13;0;277;2;2;0
/org.eclipse.ant.ui/Ant Tools Support/org/eclipse/ant/internal/ui/launchConfigurations/AntLaunchConfigurationMessages.java;1;0;1;1;0;0;0;1;0;0;1;108;0;0;1;0;0;1;1;108;0;108;1;1;0
/org.eclipse.core.resources/src/org/eclipse/core/internal/properties/QueryResults.java;1;0;1;1;1;1;1;0;75;0;0;277;75;75;1;0;0;0;1;277;0;277;1;1;0
/org.eclipse.jdt.debug/jdi interfaces/com/sun/jdi/connect/spi/Connection.java;1;0;1;1;0;0;0;1;0;0;1;235;0;0;1;0;0;1;1;235;0;235;1;1;0
/org.eclipse.ui.cheatsheets/src/org/eclipse/ui/internal/cheatsheets/CheatSheetHistory.java;2;0;4;1;2;1;2;2;17;1;2;243;25;25;2;0;1;2;4;306;1;306;3;2;0
/org.eclipse.ui.workbench/Eclipse UI/org/eclipse/ui/internal/ActionSetMenuManager.java;2;1;2;1;2;2;2;0;15;0;0;326;17;17;1;0;0;0;2;326;0;336;2;2;1
/org.eclipse.help.appserver/src/org/eclipse/help/internal/appserver/AppserverPlugin.java;1;2;7;1;4;3;4;3;102;2;2;104;162;162;2;1;1;3;7;246;2;336;5;1;1
/org.eclipse.jdt.core/formatter/org/eclipse/jdt/internal/formatter/Scribe.java;4;3;56;2;4;2;4;52;1244;20;9;37;2293;2293;20;43;2;52;56;92;45;312;11;4;2
/org.eclipse.text/src/org/eclipse/text/edits/UndoCollector.java;2;1;3;1;2;2;2;1;5;0;1;125;7;7;1;0;0;1;3;125;0;336;3;2;0
/org.eclipse.osgi/core/adaptor/org/eclipse/osgi/framework/adaptor/ClassLoaderDelegate.java;3;0;5;2;2;1;2;3;123;1;3;171;131;131;2;0;1;3;5;276;1;276;4;3;0
/org.eclipse.ant.ui/Remote Ant Support/org/eclipse/ant/internal/ui/antsupport/logger/RemoteAntBuildLogger.java;1;1;7;1;2;2;2;5;219;4;2;108;264;264;4;3;0;5;7;108;3;336;4;1;1
/org.eclipse.ui.workbench/Eclipse UI/org/eclipse/ui/internal/registry/IStickyViewDescriptor.java;1;2;3;1;3;2;3;0;28;0;0;275;28;28;2;0;1;0;3;294;1;294;2;1;0
/org.eclipse.ui.forms/src/org/eclipse/ui/forms/widgets/ScrolledFormText.java;1;0;3;1;1;1;1;2;5;1;2;230;8;8;1;0;0;2;3;230;0;272;3;1;0
/org.eclipse.core.resources/src/org/eclipse/core/internal/dtree/AbstractDataTreeNode.java;2;0;2;1;1;1;1;1;1049;0;1;13;1064;1064;1;0;0;1;2;13;0;277;2;2;0
/org.eclipse.jdt.ui/ui/org/eclipse/jdt/internal/ui/text/correction/AssignToVariableAssistProposal.java;2;6;29;2;8;2;8;21;416;6;10;22;837;837;6;11;6;21;29;60;17;330;12;2;0
/org.eclipse.ui.ide/src/org/eclipse/ui/views/markers/internal/DialogTaskFilter.java;1;0;1;1;0;0;0;1;0;0;1;129;0;0;1;0;0;1;1;129;0;129;1;1;1
/org.eclipse.team.cvs.core/src/org/eclipse/team/internal/ccvs/core/client/RTag.java;2;1;4;1;2;2;2;2;3;1;2;101;11;11;1;0;0;2;4;101;0;336;4;2;0
/org.eclipse.ant.ui/Ant Tools Support/org/eclipse/ant/internal/ui/views/AntViewDropAdapter.java;1;0;1;1;0;0;0;1;13;0;1;125;13;13;1;0;0;1;1;125;0;125;1;1;1
/org.eclipse.ltk.core.refactoring/src/org/eclipse/ltk/core/refactoring/participants/RefactoringParticipant.java;1;0;8;1;1;1;6;2;256;0;1;264;267;267;7;1;5;7;8;264;6;337;2;1;0
/org.eclipse.jdt.core/compiler/org/eclipse/jdt/internal/compiler/ast/PrefixExpression.java;3;0;4;1;1;1;1;3;12;1;3;63;20;20;1;0;0;3;4;63;0;314;4;3;0
/org.eclipse.jface.text/src/org/eclipse/jface/text/ITextViewerExtension2.java;2;0;1;2;1;1;1;0;44;0;0;336;44;44;1;0;0;0;1;336;0;336;1;2;0
/org.eclipse.swt/Eclipse SWT/carbon/org/eclipse/swt/widgets/Slider.java;4;1;7;2;2;2;2;5;30;3;3;19;66;66;3;2;0;5;7;33;2;337;5;4;0
/org.eclipse.jdt.ui/ui/org/eclipse/jdt/internal/ui/typehierarchy/TypeHierarchyViewPart.java;6;3;26;3;6;3;8;18;343;4;10;22;703;703;4;8;5;20;26;260;13;336;13;6;2
/org.eclipse.jdt.core/dom/org/eclipse/jdt/core/dom/BindingResolver.java;5;1;10;2;2;2;2;8;139;2;7;5;305;305;2;1;0;8;10;199;1;314;9;5;1
/org.eclipse.ui.intro/src/org/eclipse/ui/internal/intro/impl/util/DialogUtil.java;1;4;5;1;5;2;5;0;54;0;0;276;98;98;4;0;3;0;5;276;3;301;2;1;0
/org.eclipse.debug.core/core/org/eclipse/debug/internal/core/sourcelookup/SourceLocatorMementoComparator.java;2;0;2;1;1;1;1;1;5;0;1;227;5;5;1;0;0;1;2;227;0;303;2;2;0
/org.eclipse.core.runtime/src/org/eclipse/core/internal/jobs/JobStatus.java;1;0;1;1;1;1;1;0;0;0;0;286;0;0;1;0;0;0;1;286;0;286;1;1;0
/org.eclipse.help.base/src/org/eclipse/help/internal/browser/macosx/DefaultBrowserFactory.java;1;1;4;1;2;2;2;2;25;1;2;104;45;45;1;0;0;2;4;104;0;336;4;1;0
/org.eclipse.pde.ui/src/org/eclipse/pde/internal/ui/editor/feature/FeatureAdvancedPage.java;2;1;4;1;3;3;3;1;74;0;1;232;84;84;1;0;0;1;4;232;0;336;4;2;0
/org.eclipse.pde.ui/src/org/eclipse/pde/internal/ui/editor/SystemFileEditorInput.java;2;1;2;1;2;2;2;0;4;0;0;308;8;8;1;0;0;0;2;308;0;336;2;2;0
/org.eclipse.ui.editors/src/org/eclipse/ui/internal/editors/text/QuickDiffConfigurationBlock.java;1;2;3;1;3;2;3;0;8;0;0;295;10;10;2;0;1;0;3;295;1;336;2;1;0
/org.eclipse.core.runtime.compatibility/src-runtime/org/eclipse/core/internal/plugins/PluginPrerequisite.java;5;1;7;2;3;3;3;4;116;2;2;171;195;195;2;2;0;4;7;171;2;336;5;5;0
/org.eclipse.jdt.debug.ui/ui/org/eclipse/jdt/internal/debug/ui/actions/ManageBreakpointRulerActionDelegate.java;2;0;2;1;1;1;1;1;21;0;1;245;25;25;1;0;0;1;2;245;0;336;2;2;0
/org.eclipse.team.cvs.ui/src/org/eclipse/team/internal/ccvs/ui/operations/TagOperation.java;2;1;8;2;2;2;2;6;31;2;5;63;75;75;2;1;0;6;8;63;1;336;7;2;0
/org.eclipse.osgi/resolver/src/org/eclipse/core/internal/dependencies/DependencySystem.java;4;3;7;2;5;2;5;2;175;1;2;171;318;318;3;0;3;2;7;290;3;290;4;4;0
/org.eclipse.jdt.core/search/org/eclipse/jdt/internal/core/search/matching/LocalVariablePattern.java;2;0;11;2;1;1;1;10;110;5;4;145;237;237;5;6;0;10;11;181;6;280;5;2;0
/org.eclipse.swt/Eclipse SWT Mozilla/common/org/eclipse/swt/internal/mozilla/nsIDirectoryServiceProvider.java;1;0;2;1;0;0;0;2;25;1;2;100;25;25;1;0;0;2;2;100;0;148;2;1;0
/org.eclipse.jface.text/src/org/eclipse/jface/text/formatter/IFormattingStrategyExtension.java;2;0;3;1;1;1;1;2;33;0;1;119;39;39;2;1;0;2;3;119;1;336;2;2;0
/org.eclipse.compare/compare/org/eclipse/compare/EditionSelectionDialog.java;1;2;7;1;3;2;3;4;60;1;4;79;92;92;2;0;1;4;7;278;1;335;6;1;0
/org.eclipse.ui.ide/src/org/eclipse/ui/views/markers/internal/DialogProblemProperties.java;1;0;1;1;0;0;0;1;0;0;1;129;0;0;1;0;0;1;1;129;0;129;1;1;0
/org.eclipse.pde.ui/src/org/eclipse/pde/internal/ui/preferences/TargetPlatformPreferencePage.java;2;1;8;1;3;3;3;5;278;2;4;16;320;320;2;1;0;5;8;181;1;336;7;2;0
/org.eclipse.ui.workbench/Eclipse UI/org/eclipse/ui/internal/dnd/IDragOverListener.java;2;0;2;1;0;0;0;2;34;1;2;205;34;34;1;0;0;2;2;205;0;223;2;2;0
/org.eclipse.jface.text/src/org/eclipse/jface/text/information/IInformationProvider.java;1;0;2;1;2;1;2;0;28;0;0;336;28;28;2;0;1;0;2;336;1;336;1;1;0
/org.eclipse.team.cvs.ui/src/org/eclipse/team/internal/ccvs/ui/actions/MoveRemoteTagAction.java;1;0;2;1;0;0;0;2;49;0;1;63;49;49;2;1;0;2;2;63;1;63;1;1;0
/org.eclipse.debug.ui/ui/org/eclipse/debug/internal/ui/views/memory/SetDefaultColumnSizePrefAction.java;1;0;1;1;1;1;1;0;0;0;0;290;0;0;1;0;0;0;1;290;0;290;1;1;0
/org.eclipse.debug.ui/ui/org/eclipse/debug/ui/CommonTab.java;3;1;11;2;2;2;2;9;305;4;5;42;426;426;4;4;0;9;11;108;4;313;7;3;3
/org.eclipse.pde.build/src/org/eclipse/pde/internal/build/site/BuildTimeFeature.java;2;0;6;1;1;1;1;5;4;2;3;31;4;4;2;2;0;5;6;31;2;277;4;2;0
/org.eclipse.jdt.debug/model/org/eclipse/jdt/debug/core/IJavaArray.java;1;0;1;1;0;0;0;1;3;0;1;148;3;3;1;0;0;1;1;148;0;148;1;1;0
/org.eclipse.help.base/src/org/eclipse/help/internal/search/QueryWordsExactPhrase.java;1;1;4;1;3;3;3;1;12;0;1;104;24;24;1;0;0;1;4;104;0;336;4;1;0
/org.eclipse.jdt.debug.ui/ui/org/eclipse/jdt/internal/debug/ui/launcher/SourceElementLabelProvider.java;2;1;2;1;2;2;2;0;4;0;0;274;8;8;1;0;0;0;2;274;0;336;2;2;0
/org.eclipse.jdt.debug.ui/ui/org/eclipse/jdt/internal/debug/ui/ImageDescriptorRegistry.java;2;0;2;1;1;1;1;1;4;0;1;220;6;6;1;0;0;1;2;220;0;336;2;2;0
/org.eclipse.jface.text/src/org/eclipse/jface/text/reconciler/IReconciler.java;1;0;2;1;2;1;2;0;38;0;0;336;38;38;2;0;1;0;2;336;1;336;1;1;0
/org.eclipse.osgi/resolver/src/org/eclipse/core/internal/dependencies/ComputeNodeOrder.java;3;2;4;2;3;2;3;1;432;0;1;171;437;437;2;0;1;1;4;276;1;296;3;3;0
/org.eclipse.core.resources/src/org/eclipse/core/internal/events/NotificationManager.java;2;3;19;2;7;3;7;12;370;3;6;90;1089;1089;3;6;4;12;19;90;10;303;9;2;1
/org.eclipse.jdt.ui/core extension/org/eclipse/jdt/internal/corext/dom/GenericVisitor.java;3;1;4;1;2;2;2;2;224;1;2;211;299;299;1;0;0;2;4;211;0;336;4;3;0
/org.eclipse.jdt.ui/ui/org/eclipse/jdt/internal/ui/javadocexport/JavadocReader.java;2;1;3;1;2;2;2;1;38;0;1;224;50;50;1;0;0;1;3;224;0;336;3;2;0
/org.eclipse.swt/Eclipse SWT Drag and Drop/win32/org/eclipse/swt/dnd/RTFTransfer.java;1;0;1;1;0;0;0;1;83;0;1;22;83;83;1;0;0;1;1;22;0;22;1;1;0
/org.eclipse.jface.text/src/org/eclipse/jface/text/link/TabStopIterator.java;2;0;3;2;2;1;2;1;12;0;1;232;12;12;2;0;1;1;3;334;1;334;2;2;0
/org.eclipse.jdt.core/compiler/org/eclipse/jdt/internal/compiler/lookup/UnresolvedReferenceBinding.java;2;0;2;1;0;0;0;2;2;1;2;6;3;3;1;0;0;2;2;6;0;199;2;2;0
/org.eclipse.ui.ide/src/org/eclipse/ui/views/framelist/BackAction.java;3;0;4;1;1;1;1;3;4;1;3;129;9;9;1;0;0;3;4;129;0;336;4;3;0
/org.eclipse.swt/Eclipse SWT/win32/org/eclipse/swt/widgets/FileDialog.java;5;1;8;2;2;2;2;6;26;2;5;2;107;107;2;1;0;6;8;149;1;337;7;5;0
/org.eclipse.jdt.debug/model/org/eclipse/jdt/internal/debug/core/logicalstructures/LogicalObjectStructureClassType.java;1;0;1;1;0;0;0;1;0;0;1;155;0;0;1;0;0;1;1;155;0;155;1;1;0
/org.eclipse.jdt.ui/core refactoring/org/eclipse/jdt/internal/corext/refactoring/typeconstraints/CompilationUnitRange.java;3;0;5;2;1;1;1;4;45;2;3;4;60;60;2;1;0;4;5;95;1;336;4;3;0
/org.eclipse.jdt.junit/src/org/eclipse/jdt/internal/junit/ui/FailureTrace.java;2;1;2;1;2;2;2;0;2;0;0;301;2;2;1;0;0;0;2;301;0;336;2;2;2
/org.eclipse.team.cvs.ui/src/org/eclipse/team/internal/ccvs/ui/TagSelectionDialog.java;2;3;7;2;6;3;6;1;174;0;1;138;204;204;3;0;3;1;7;272;3;336;4;2;0
/org.eclipse.jdt.ui/ui/org/eclipse/jdt/internal/ui/text/java/hover/JavaEditorTextHoverDescriptor.java;2;1;5;1;2;2;2;3;79;2;2;41;139;139;2;1;0;3;5;41;1;336;4;2;1
/org.eclipse.ant.ui/Ant Editor/org/eclipse/ant/internal/ui/dtd/schema/Nfm.java;1;0;2;1;0;0;0;2;10;1;2;108;10;10;1;0;0;2;2;108;0;202;2;1;0
/org.eclipse.ui.workbench/Eclipse UI Editor Support/org/eclipse/ui/internal/editorsupport/ComponentSupport.java;2;0;4;1;1;1;1;3;54;1;3;157;99;99;1;0;0;3;4;157;0;336;4;2;0
/org.eclipse.team.cvs.core/src/org/eclipse/team/internal/ccvs/core/client/Command.java;2;0;11;2;1;1;1;10;42;3;7;52;93;93;3;3;0;10;11;110;3;336;8;2;0
/org.eclipse.pde.ui/src/org/eclipse/pde/internal/ui/editor/plugin/rows/TextAttributeRow.java;2;2;4;1;4;3;4;0;10;0;0;292;16;16;2;0;1;0;4;292;1;336;3;2;0
/org.eclipse.swt/Eclipse SWT/common/org/eclipse/swt/graphics/PaletteData.java;1;1;2;1;2;2;2;0;4;0;0;328;6;6;1;0;0;0;2;328;0;337;2;1;0
/org.eclipse.search/new search/org/eclipse/search2/internal/ui/ShowSearchesAction.java;2;1;5;1;2;2;2;3;64;1;3;195;121;121;1;0;0;3;5;195;0;336;5;2;0
/org.eclipse.osgi/eclipseAdaptor/src/org/eclipse/core/runtime/adaptor/BundleStopper.java;5;5;11;4;10;4;10;1;205;0;1;256;278;278;5;0;6;1;11;272;6;326;5;5;2
/org.eclipse.ui.workbench/Eclipse UI/org/eclipse/ui/internal/intro/IntroRegistryReader.java;3;0;6;3;0;0;0;6;30;3;3;203;39;39;3;3;0;6;6;252;3;263;3;3;0
/org.eclipse.update.core/src/org/eclipse/update/core/IFeatureContentConsumer.java;2;2;4;1;3;2;3;1;12;0;1;58;19;19;2;0;1;1;4;289;1;336;3;2;0
/org.eclipse.jdt.core/codeassist/org/eclipse/jdt/internal/codeassist/impl/AssistParser.java;6;1;21;3;2;2;2;19;103;5;9;5;261;261;5;10;0;19;21;60;10;312;11;6;3
/org.eclipse.jdt.ui/ui/org/eclipse/jdt/internal/ui/text/correction/NewMethodCompletionProposal.java;3;6;29;2;7;2;7;22;491;9;10;21;951;951;9;12;5;22;29;61;17;336;12;3;0
/org.eclipse.jface.text/src/org/eclipse/jface/text/templates/PositionBasedCompletionProposal.java;2;1;4;1;2;2;2;2;40;1;2;254;44;44;1;0;0;2;4;254;0;336;4;2;0
/org.eclipse.jdt.debug.ui/ui/org/eclipse/jdt/internal/debug/ui/launcher/JavaAppletLaunchShortcut.java;3;2;10;2;4;3;4;6;89;1;6;44;214;214;2;0;1;6;10;274;1;336;9;3;0
/org.eclipse.debug.ui/ui/org/eclipse/debug/internal/ui/DialogSettingsHelper.java;1;0;1;1;0;0;0;1;0;0;1;264;0;0;1;0;0;1;1;264;0;264;1;1;0
/org.eclipse.jdt.ui/ui refactoring/org/eclipse/jdt/internal/ui/refactoring/reorg/RenameCuWizard.java;2;1;5;1;2;2;2;3;9;2;2;66;26;26;2;1;0;3;5;66;1;336;4;2;0
/org.eclipse.pde.ui/src/org/eclipse/pde/internal/ui/editor/plugin/ExtensionsSection.java;3;7;12;3;12;2;12;0;192;0;0;292;226;226;7;0;10;0;12;292;10;326;2;3;0
/org.eclipse.swt/Eclipse SWT/common/org/eclipse/swt/layout/RowLayout.java;3;1;6;1;2;2;2;4;135;1;4;19;268;268;1;0;0;4;6;19;0;337;6;3;0
/org.eclipse.ui.workbench.texteditor/src/org/eclipse/ui/texteditor/ISchedulingRuleProvider.java;2;0;2;1;1;1;1;1;2;0;1;260;2;2;1;0;0;1;2;260;0;336;2;2;0
/org.eclipse.jdt.ui/ui/org/eclipse/jdt/internal/ui/preferences/CodeAssistPreferencePage.java;1;0;1;1;1;1;1;0;0;0;0;295;0;0;1;0;0;0;1;295;0;295;1;1;0
/org.eclipse.jface.text/src/org/eclipse/jface/internal/text/link/contentassist/PopupCloser2.java;2;0;2;1;1;1;1;1;2;0;1;232;2;2;1;0;0;1;2;232;0;336;2;2;0
/org.eclipse.ant.core/src/org/eclipse/ant/core/IAntClasspathEntry.java;1;0;4;1;1;1;1;3;8;1;3;149;15;15;1;0;0;3;4;149;0;336;4;1;0
/org.eclipse.team.cvs.ui/src/org/eclipse/team/internal/ccvs/ui/subscriber/CVSParticipant.java;2;1;3;2;3;3;3;0;91;0;0;274;149;149;1;0;0;0;3;274;0;299;3;2;2
/org.eclipse.ui.workbench/Eclipse UI/org/eclipse/ui/internal/WorkingSetManager.java;1;0;2;1;0;0;0;2;145;1;2;157;147;147;1;0;0;2;2;157;0;181;2;1;2
/org.eclipse.jdt.core/dom/org/eclipse/jdt/internal/core/dom/rewrite/GenericVisitor.java;2;0;2;1;1;1;1;1;4;0;1;262;4;4;1;0;0;1;2;262;0;336;2;2;0
/org.eclipse.jdt.ui/core extension/org/eclipse/jdt/internal/corext/util/JavaModelUtil.java;5;0;27;2;3;1;5;22;164;7;10;13;802;802;7;12;4;24;27;123;16;323;11;5;0
/org.eclipse.ui.workbench/Eclipse UI/org/eclipse/ui/internal/dialogs/IndentedTableViewer.java;1;0;1;1;0;0;0;1;0;0;1;54;0;0;1;0;0;1;1;54;0;54;1;1;0
/org.eclipse.jdt.ui/ui/org/eclipse/jdt/internal/ui/text/java/SmartSemicolonAutoEditStrategy.java;3;4;22;2;6;3;6;16;916;5;6;35;1369;1369;5;10;3;16;22;35;13;336;9;3;0
/org.eclipse.jdt.core/model/org/eclipse/jdt/internal/core/util/ConstantPool.java;1;0;1;1;0;0;0;1;2;0;1;199;2;2;1;0;0;1;1;199;0;199;1;1;0
/org.eclipse.swt/Eclipse SWT PI/motif/org/eclipse/swt/internal/motif/XmDragProcCallbackStruct.java;1;0;2;1;0;0;0;2;4;0;1;54;4;4;2;1;0;2;2;54;1;54;1;1;0
/org.eclipse.ui.ide/src/org/eclipse/ui/views/navigator/GotoResourceDialog.java;1;0;1;1;0;0;0;1;0;0;1;129;0;0;1;0;0;1;1;129;0;129;1;1;0
/org.eclipse.ui.workbench/Eclipse UI/org/eclipse/ui/keys/ParseException.java;3;1;9;1;2;2;2;7;28;2;5;81;74;74;2;2;0;7;9;81;2;336;7;3;0
/org.eclipse.osgi/resolver/src/org/eclipse/core/internal/dependencies/ResolutionVisitor.java;4;2;5;2;4;2;4;1;27;0;1;171;31;31;2;0;2;1;5;276;2;290;3;4;0
/org.eclipse.debug.ui/ui/org/eclipse/debug/internal/ui/views/breakpoints/BreakpointsViewEventHandler.java;5;2;10;2;3;2;3;7;48;3;4;87;124;124;3;3;1;7;10;152;4;336;6;5;4
/org.eclipse.jdt.debug/model/org/eclipse/jdt/internal/debug/core/logicalstructures/MapStructureType.java;2;1;4;1;2;2;2;2;10;0;1;152;18;18;2;1;0;2;4;152;1;336;3;2;0
/org.eclipse.ui.forms/src/org/eclipse/ui/forms/editor/FormPage.java;1;0;12;1;1;1;3;9;258;8;2;225;308;308;8;7;2;11;12;225;9;336;3;1;0
/org.eclipse.pde.runtime/src/org/eclipse/pde/internal/runtime/logview/LogEntry.java;2;1;4;1;2;2;2;2;16;0;1;55;30;30;2;1;0;2;4;55;1;336;3;2;0
/org.eclipse.ui.intro/src/org/eclipse/ui/intro/config/IntroURLFactory.java;2;2;3;2;3;2;3;0;75;0;0;283;79;79;2;0;1;0;3;283;1;336;2;2;0
/org.eclipse.ant.ui/Ant Editor/org/eclipse/ant/internal/ui/editor/outline/IProblemRequestor.java;1;0;1;1;0;0;0;1;0;0;1;108;0;0;1;0;0;1;1;108;0;108;1;1;1
/org.eclipse.jdt.core/model/org/eclipse/jdt/internal/core/SortJavaElement.java;2;0;2;1;0;0;0;2;6;1;2;5;8;8;1;0;0;2;2;5;0;199;2;2;1
/org.eclipse.ui.workbench/Eclipse UI/org/eclipse/ui/internal/commands/ImageFactory.java;4;0;13;2;1;1;1;12;22;3;9;52;60;60;3;3;0;12;13;102;3;336;10;4;0
/org.eclipse.ui.workbench/Eclipse UI/org/eclipse/ui/model/WorkbenchAdapter.java;4;0;6;2;1;1;1;5;60;3;2;151;93;93;3;3;0;5;6;225;3;336;3;4;0
/org.eclipse.debug.ui/ui/org/eclipse/debug/ui/actions/AbstractLaunchToolbarAction.java;1;0;2;1;0;0;0;2;4;1;2;134;6;6;1;0;0;2;2;134;0;149;2;1;1
/org.eclipse.core.resources/src/org/eclipse/core/internal/resources/IManager.java;1;0;1;1;1;1;1;0;9;0;0;277;9;9;1;0;0;0;1;277;0;277;1;1;0
/org.eclipse.ui.workbench.texteditor/src/org/eclipse/ui/texteditor/AbstractTextEditor.java;4;0;62;4;6;1;23;39;1144;27;12;17;3454;3454;27;27;22;56;62;250;49;320;13;4;4
/org.eclipse.ui.workbench/Eclipse UI/org/eclipse/ui/keys/KeyStroke.java;3;1;24;2;2;2;2;22;752;10;6;79;2119;2119;10;16;0;22;24;79;16;336;8;3;0
/org.eclipse.ui.console/src/org/eclipse/ui/console/actions/ClearOutputAction.java;2;0;3;2;0;0;0;3;18;0;1;118;18;18;3;2;0;3;3;118;2;118;1;2;0
/org.eclipse.jdt.core/compiler/org/eclipse/jdt/internal/compiler/ast/BinaryExpression.java;2;0;7;1;0;0;0;7;136;3;5;47;171;171;3;2;0;7;7;71;2;199;5;2;1
/org.eclipse.jdt.ui/ui/org/eclipse/jdt/ui/actions/ChangeTypeAction.java;3;1;10;2;3;3;3;7;165;3;3;162;276;276;3;4;0;7;10;162;4;336;6;3;0
/org.eclipse.jdt.core/model/org/eclipse/jdt/internal/core/util/SimpleWordSet.java;2;0;3;2;0;0;0;3;8;2;2;193;10;10;2;1;0;3;3;193;1;238;2;2;0
/org.eclipse.ui.intro/src/org/eclipse/ui/internal/intro/impl/swt/RootPageForm.java;1;0;6;1;6;1;6;0;224;0;0;305;224;224;6;0;5;0;6;305;5;305;1;1;0
/org.eclipse.core.resources/src/org/eclipse/core/internal/localstore/BlobStore.java;2;2;4;1;3;2;3;1;335;0;1;7;390;390;2;0;1;1;4;275;1;325;3;2;0
/org.eclipse.team.cvs.ui/src/org/eclipse/team/internal/ccvs/ui/wizards/CheckoutAsMainPage.java;2;1;8;1;2;2;2;6;229;2;5;20;271;271;2;1;0;6;8;265;1;336;7;2;0
/org.eclipse.team.cvs.ui/src/org/eclipse/team/internal/ccvs/ui/actions/CheckoutAction.java;2;0;6;1;1;1;1;5;172;2;4;17;314;314;2;1;0;5;6;17;1;336;5;2;0
/org.eclipse.jdt.core/model/org/eclipse/jdt/internal/core/JavaElementInfo.java;2;0;4;1;0;0;0;4;29;1;4;37;39;39;1;0;0;4;4;37;0;199;4;2;0
/org.eclipse.help.base/src/org/eclipse/help/internal/browser/BrowserDescriptor.java;1;1;5;1;2;2;2;3;30;2;2;104;51;51;2;1;0;3;5;250;1;336;4;1;0
/org.eclipse.jdt.ui/core extension/org/eclipse/jdt/internal/corext/dom/fragments/AssociativeInfixExpressionFragment.java;3;1;3;1;2;2;2;1;4;0;1;80;7;7;1;0;0;1;3;80;0;336;3;3;0
/org.eclipse.team.cvs.core/src/org/eclipse/team/internal/ccvs/core/util/MoveDeleteHook.java;1;0;7;1;0;0;0;7;100;3;4;56;116;116;3;3;0;7;7;139;3;139;4;1;0
/org.eclipse.pde.ui/src/org/eclipse/pde/internal/ui/wizards/ListUtil.java;1;0;1;1;0;0;0;1;4;0;1;70;4;4;1;0;0;1;1;70;0;70;1;1;0
/org.eclipse.jdt.core/compiler/org/eclipse/jdt/internal/compiler/codegen/QualifiedNamesConstants.java;2;0;2;1;0;0;0;2;3;1;2;31;5;5;1;0;0;2;2;31;0;199;2;2;0
/org.eclipse.ui.workbench/Eclipse UI/org/eclipse/ui/themes/RGBBlendColorFactory.java;1;0;2;1;1;1;1;1;14;0;1;243;14;14;1;0;0;1;2;243;0;282;2;1;0
/org.eclipse.jdt.ui/ui/org/eclipse/jdt/internal/ui/javaeditor/WorkingCopyManager.java;2;0;2;1;1;1;1;1;6;0;1;96;8;8;1;0;0;1;2;96;0;336;2;2;0
/org.eclipse.ant.ui/Ant Editor/org/eclipse/ant/internal/ui/editor/AntEditorActionContributor.java;1;0;7;1;0;0;0;7;106;5;3;108;108;108;5;4;0;7;7;211;4;250;3;1;1
/org.eclipse.debug.ui/ui/org/eclipse/debug/ui/actions/AbstractLaunchHistoryAction.java;3;0;5;2;1;1;1;4;36;2;2;152;59;59;2;2;0;4;5;152;2;280;3;3;0
/org.eclipse.jdt.core/model/org/eclipse/jdt/core/JavaConventions.java;3;0;14;2;0;0;0;14;432;3;10;2;607;607;3;4;0;14;14;12;4;264;10;3;2
/org.eclipse.ant.ui/Remote Ant Support/org/eclipse/ant/internal/ui/antsupport/logger/MessageIds.java;1;0;1;1;0;0;0;1;0;0;1;108;0;0;1;0;0;1;1;108;0;108;1;1;0
/org.eclipse.pde.core/src/org/eclipse/pde/core/IModel.java;2;2;7;1;4;3;4;3;234;1;3;167;315;315;2;0;1;3;7;276;1;336;6;2;0
/org.eclipse.jdt.ui/core refactoring/org/eclipse/jdt/internal/corext/refactoring/reorg/IConfirmQuery.java;2;0;2;1;1;1;1;1;4;0;1;70;4;4;1;0;0;1;2;70;0;336;2;2;0
/org.eclipse.update.ui/src/org/eclipse/update/internal/ui/security/JarVerificationDialog.java;2;1;4;1;3;3;3;1;23;0;1;58;37;37;1;0;0;1;4;58;0;336;4;2;1
/org.eclipse.pde.runtime/src/org/eclipse/pde/internal/runtime/logview/LogSession.java;2;1;5;1;2;2;2;3;84;2;2;55;94;94;2;1;0;3;5;55;1;336;4;2;0
/org.eclipse.debug.ui/ui/org/eclipse/debug/ui/console/ConsoleColorProvider.java;2;0;6;2;1;1;1;5;18;2;4;62;48;48;2;1;0;5;6;62;1;304;5;2;0
/org.eclipse.update.core/src/org/eclipse/update/internal/core/InstallHandlerProxy.java;2;1;5;1;3;3;3;2;78;1;2;58;113;113;1;0;0;2;5;58;0;336;5;2;1
/org.eclipse.core.resources/src/org/eclipse/core/internal/resources/DelayedSnapshotJob.java;2;1;7;1;3;3;3;4;100;3;2;68;114;114;3;2;0;4;7;90;2;320;5;2;0
/org.eclipse.jdt.debug/jdi/org/eclipse/jdi/internal/VirtualMachineImpl.java;3;0;8;2;1;1;1;7;105;6;2;39;124;124;6;5;0;7;8;39;5;300;3;3;0
/org.eclipse.swt/Eclipse SWT PI/carbon/org/eclipse/swt/internal/carbon/ControlTabEntry.java;1;0;2;1;2;1;2;0;20;0;0;296;20;20;2;0;1;0;2;296;1;296;1;1;0
/org.eclipse.swt/Eclipse SWT PI/win32/org/eclipse/swt/internal/win32/NONCLIENTMETRICSA.java;2;0;2;1;0;0;0;2;1;1;2;61;1;1;1;0;0;2;2;61;0;166;2;2;0
/org.eclipse.ant.ui/Ant Editor/org/eclipse/ant/internal/ui/editor/text/XMLProblemAnnotation.java;1;0;3;1;0;0;0;3;35;1;3;108;38;38;1;0;0;3;3;108;0;200;3;1;2
/org.eclipse.pde.ui/src/org/eclipse/pde/internal/ui/editor/site/DescriptionSection.java;3;3;8;2;5;3;5;3;283;1;3;134;458;458;3;0;2;3;8;302;2;336;6;3;0
/org.eclipse.jdt.core/model/org/eclipse/jdt/internal/core/util/MethodInfo.java;2;0;2;1;1;1;1;1;12;0;1;199;14;14;1;0;0;1;2;199;0;314;2;2;0
/org.eclipse.team.core/src/org/eclipse/team/core/synchronize/ISyncInfoTreeChangeEvent.java;2;1;4;1;2;2;2;2;52;1;2;224;55;55;1;0;0;2;4;224;0;336;4;2;0
/org.eclipse.ui.console/src/org/eclipse/ui/console/IConsoleManager.java;5;1;5;2;2;2;2;3;17;2;2;118;29;29;2;1;0;3;5;245;1;336;4;5;0
/org.eclipse.text/src/org/eclipse/jface/text/source/AnnotationModel.java;3;2;6;2;5;4;5;1;727;0;1;131;847;847;2;0;1;1;6;321;1;334;5;3;0
/org.eclipse.ui.workbench/Eclipse UI/org/eclipse/ui/internal/progress/ProgressAnimationItem.java;3;3;18;3;5;2;14;4;653;11;2;243;724;724;11;2;12;13;18;269;14;329;4;3;0
/org.eclipse.jdt.ui/core refactoring/org/eclipse/jdt/internal/corext/refactoring/code/SourceProvider.java;3;2;18;2;3;2;3;15;80;4;10;16;265;265;4;5;1;15;18;116;6;336;12;3;1
/org.eclipse.jdt.ui/ui/org/eclipse/jdt/internal/ui/callhierarchy/OpenLocationAction.java;4;0;7;1;1;1;1;6;17;2;5;12;32;32;2;1;0;6;7;12;1;336;6;4;0
/org.eclipse.team.cvs.core/src/org/eclipse/team/internal/ccvs/core/client/Update.java;2;0;4;1;1;1;1;3;17;1;3;101;28;28;1;0;0;3;4;101;0;336;4;2;0
/org.eclipse.jdt.core/codeassist/org/eclipse/jdt/internal/codeassist/RelevanceConstants.java;2;0;4;1;1;1;1;3;2;1;3;173;7;7;1;0;0;3;4;173;0;301;4;2;0
/org.eclipse.pde.core/src/org/eclipse/pde/internal/core/bundle/BundlePluginBase.java;2;8;11;2;11;2;11;0;425;0;0;292;440;440;8;0;9;0;11;292;9;327;2;2;0
/org.eclipse.jdt.ui/core refactoring/org/eclipse/jdt/internal/corext/refactoring/structure/JavaElementCommentFinder.java;1;0;1;1;1;1;1;0;2;0;0;336;2;2;1;0;0;0;1;336;0;336;1;1;0
/org.eclipse.jdt.ui/ui/org/eclipse/jdt/internal/ui/browsing/TopLevelTypeProblemsLabelDecorator.java;1;0;2;1;1;1;1;1;16;0;1;29;18;18;1;0;0;1;2;29;0;336;2;1;0
/org.eclipse.jdt.ui/ui/org/eclipse/jdt/internal/ui/dnd/TransferDropTargetListener.java;1;0;1;1;1;1;1;0;2;0;0;336;2;2;1;0;0;0;1;336;0;336;1;1;0
/org.eclipse.pde.ui/src/org/eclipse/pde/internal/ui/editor/context/InputContextManager.java;3;2;4;2;4;3;4;0;16;0;0;292;32;32;2;0;1;0;4;292;1;336;3;3;0
/org.eclipse.jdt.core/model/org/eclipse/jdt/core/compiler/IScanner.java;2;0;3;1;0;0;0;3;4;1;3;125;7;7;1;0;0;3;3;125;0;221;3;2;0
/org.eclipse.pde.ui/src_Forms/org/eclipse/pde/internal/ui/model/plugin/NodeOffsetHandler.java;1;1;2;1;2;2;2;0;10;0;0;304;10;10;1;0;0;0;2;304;0;336;2;1;0
/org.eclipse.jdt.launching/launching/org/eclipse/jdt/launching/sourcelookup/ZipEntryStorage.java;2;1;3;1;2;2;2;1;120;0;1;170;145;145;1;0;0;1;3;170;0;282;3;2;0
/org.eclipse.update.ui/src/org/eclipse/update/internal/ui/model/DiscoveryFolder.java;1;0;3;1;0;0;0;3;10;1;3;33;13;13;1;0;0;3;3;33;0;58;3;1;1
/org.eclipse.jdt.ui/core refactoring/org/eclipse/jdt/internal/corext/refactoring/structure/MoveStaticMemberAnalyzer.java;5;2;10;2;4;3;4;6;54;2;4;93;112;112;2;2;1;6;10;93;3;336;7;5;0
/org.eclipse.jdt.core/compiler/org/eclipse/jdt/internal/compiler/env/ISourceType.java;2;0;3;1;0;0;0;3;31;1;3;7;41;41;1;0;0;3;3;7;0;199;3;2;0
/org.eclipse.update.ui/src/org/eclipse/update/internal/ui/wizards/RevertConfigurationWizard.java;3;0;5;2;1;1;1;4;16;2;3;54;27;27;2;1;0;4;5;54;1;336;4;3;0
/org.eclipse.ui.ide/src/org/eclipse/ui/views/markers/internal/FieldResource.java;4;1;4;2;2;2;2;2;37;1;2;129;78;78;1;0;0;2;4;129;0;336;4;4;0
/org.eclipse.swt/Eclipse SWT Drag and Drop/win32/org/eclipse/swt/dnd/ByteArrayTransfer.java;1;0;1;1;0;0;0;1;61;0;1;22;61;61;1;0;0;1;1;22;0;22;1;1;0
/org.eclipse.debug.ui/ui/org/eclipse/debug/internal/ui/actions/WatchExpressionAction.java;1;0;1;1;0;0;0;1;0;0;1;92;0;0;1;0;0;1;1;92;0;92;1;1;0
/org.eclipse.jdt.ui/ui/org/eclipse/jdt/internal/ui/compare/JavaTextViewer.java;4;1;4;1;2;2;2;2;9;1;2;96;20;20;1;0;0;2;4;96;0;336;4;4;0
/org.eclipse.jdt.core/model/org/eclipse/jdt/internal/core/util/ASTNodeFinder.java;2;0;4;1;0;0;0;4;6;2;3;170;8;8;2;1;0;4;4;193;1;193;3;2;0
/org.eclipse.pde.build/src/org/eclipse/pde/internal/build/ant/ZipFileSet.java;2;0;3;2;2;1;2;1;58;0;1;257;58;58;2;0;1;1;3;272;1;272;2;2;0
/org.eclipse.jdt.debug.ui/ui/org/eclipse/jdt/internal/debug/ui/PackageSelectionDialog.java;3;0;3;1;1;1;1;2;56;1;2;200;60;60;1;0;0;2;3;200;0;336;3;3;0
/org.eclipse.swt/Eclipse SWT/common/org/eclipse/swt/layout/GridLayout.java;3;0;4;2;1;1;1;3;14;2;2;187;19;19;2;1;0;3;4;187;1;337;3;3;0
/org.eclipse.pde.core/src/org/eclipse/pde/internal/core/ifeature/IFeatureChild.java;2;1;3;1;2;2;2;1;10;0;1;232;20;20;1;0;0;1;3;232;0;336;3;2;0
/org.eclipse.update.ui/src/org/eclipse/update/internal/ui/wizards/LocalSiteSelector.java;2;1;5;1;2;2;2;3;28;1;3;123;35;35;1;0;0;3;5;123;0;336;5;2;0
/org.eclipse.pde.core/src/org/eclipse/pde/core/plugin/IPluginModel.java;2;2;3;1;3;2;3;0;47;0;0;276;53;53;2;0;1;0;3;276;1;336;2;2;0
/org.eclipse.jdt.core/search/org/eclipse/jdt/internal/core/search/matching/JavaSearchPattern.java;1;0;1;1;1;1;1;0;0;0;0;287;0;0;1;0;0;0;1;287;0;287;1;1;2
/org.eclipse.jdt.junit/src/org/eclipse/jdt/internal/junit/ui/JUnitPlugin.java;2;2;8;1;4;3;4;4;60;1;4;32;148;148;2;0;1;4;8;272;1;336;7;2;1
/org.eclipse.compare/compare/org/eclipse/compare/contentmergeviewer/IDocumentRange.java;1;0;1;1;0;0;0;1;2;0;1;219;2;2;1;0;0;1;1;219;0;219;1;1;0
/org.eclipse.ui.workbench/Eclipse UI/org/eclipse/ui/internal/PageLayout.java;6;4;17;3;6;2;6;11;1188;3;5;43;1625;1625;4;6;4;11;17;295;10;330;7;6;3
/org.eclipse.search/new search/org/eclipse/search2/internal/ui/basic/views/SetLayoutAction.java;2;0;3;1;1;1;1;2;13;1;2;224;15;15;1;0;0;2;3;224;0;336;3;2;0
/org.eclipse.jdt.debug/jdi/org/eclipse/jdi/internal/FieldImpl.java;1;0;1;1;0;0;0;1;31;0;1;235;31;31;1;0;0;1;1;235;0;235;1;1;0
/org.eclipse.ui.ide/src/org/eclipse/ui/views/markers/internal/ActionRevealMarker.java;3;1;3;1;2;2;2;1;4;0;1;129;6;6;1;0;0;1;3;129;0;336;3;3;0
/org.eclipse.jface.text/src/org/eclipse/jface/text/reconciler/IReconcilingStrategy.java;1;0;2;1;2;1;2;0;32;0;0;336;32;32;2;0;1;0;2;336;1;336;1;1;0
/org.eclipse.jdt.ui/ui/org/eclipse/jdt/internal/ui/javadocexport/JavadocOptionsManager.java;2;1;12;1;2;2;2;10;871;2;8;45;1289;1289;2;2;0;10;12;224;2;315;10;2;0
/org.eclipse.pde.ui/src_ant/org/eclipse/pde/internal/ui/ant/ExportBuildListener.java;1;1;3;1;2;2;2;1;4;0;1;149;12;12;1;0;0;1;3;149;0;336;3;1;0
/org.eclipse.jdt.core/dom/org/eclipse/jdt/core/dom/ASTMatcher.java;5;0;16;3;2;1;2;14;624;4;7;70;1088;1088;4;7;1;14;16;257;8;283;8;5;2
/org.eclipse.jface.text/src/org/eclipse/jface/text/source/ISharedTextColors.java;2;0;2;2;2;1;2;0;10;0;0;336;10;10;2;0;1;0;2;336;1;336;1;2;0
/org.eclipse.jdt.core/dom/org/eclipse/jdt/internal/core/dom/rewrite/Indents.java;1;0;2;1;2;1;2;0;26;0;0;290;26;26;2;0;1;0;2;290;1;290;1;1;0
/org.eclipse.ui.ide/src/org/eclipse/ui/internal/ide/misc/WizardStepGroup.java;4;1;4;1;2;2;2;2;24;1;2;132;28;28;1;0;0;2;4;132;0;336;4;4;0
/org.eclipse.jdt.ui/ui/org/eclipse/jdt/ui/actions/RenameAction.java;3;0;3;1;1;1;1;2;4;1;2;3;8;8;1;0;0;2;3;3;0;336;3;3;0
/org.eclipse.debug.core/core/org/eclipse/debug/core/DebugException.java;1;0;1;1;0;0;0;1;8;0;1;62;8;8;1;0;0;1;1;62;0;62;1;1;0
/org.eclipse.pde.ui/src/org/eclipse/pde/internal/ui/search/SearchGoToAction.java;1;1;3;1;2;2;2;1;4;0;1;157;9;9;1;0;0;1;3;157;0;336;3;1;0
/org.eclipse.jdt.ui/core refactoring/org/eclipse/jdt/internal/corext/refactoring/changes/Utils.java;1;0;1;1;1;1;1;0;2;0;0;336;2;2;1;0;0;0;1;336;0;336;1;1;0
/org.eclipse.core.resources/src/org/eclipse/core/internal/resources/WorkspaceRoot.java;3;2;7;1;4;3;4;3;510;1;3;122;600;600;2;0;1;3;7;275;1;336;6;3;0
/org.eclipse.jdt.ui/core refactoring/org/eclipse/jdt/internal/corext/refactoring/ParameterInfo.java;4;0;7;1;1;1;1;6;14;2;5;50;43;43;2;1;0;6;7;94;1;336;6;4;0
/org.eclipse.update.core/src/org/eclipse/update/core/IPlatformEnvironment.java;2;2;4;1;3;2;3;1;9;0;1;58;15;15;2;0;1;1;4;289;1;336;3;2;0
/org.eclipse.swt/Eclipse SWT Drag and Drop/win32/org/eclipse/swt/dnd/TextTransfer.java;1;0;2;1;0;0;0;2;129;1;2;22;135;135;1;0;0;2;2;22;0;137;2;1;0
/org.eclipse.jdt.ui/ui refactoring/org/eclipse/jdt/internal/ui/refactoring/reorg/QualifiedNameComponent.java;2;0;4;1;1;1;1;3;4;2;2;66;8;8;2;1;0;3;4;66;1;336;3;2;0
/org.eclipse.jdt.ui/ui/org/eclipse/jdt/internal/ui/text/correction/QuickTemplateProcessor.java;4;1;15;2;2;2;2;13;186;5;6;64;237;237;5;7;0;13;15;64;7;336;8;4;0
/org.eclipse.debug.ui/ui/org/eclipse/debug/internal/ui/actions/EnableWatchExpressionAction.java;1;0;1;1;0;0;0;1;0;0;1;92;0;0;1;0;0;1;1;92;0;92;1;1;0
/org.eclipse.ui.workbench/Eclipse UI/org/eclipse/ui/internal/ExtensionEventHandler.java;5;1;19;4;2;2;4;15;579;6;4;196;845;845;6;11;2;17;19;233;13;332;6;5;2
/org.eclipse.swt/Eclipse SWT/win32/org/eclipse/swt/widgets/TabFolder.java;4;0;9;2;1;1;1;8;42;2;6;17;141;141;2;2;0;8;9;17;2;337;7;4;0
/org.eclipse.jface.text/projection/org/eclipse/jface/text/source/projection/ProjectionViewer.java;4;0;32;4;15;1;25;7;1693;0;1;247;2631;2631;17;6;24;17;32;247;30;302;2;4;0
/org.eclipse.osgi/eclipseAdaptor/src/org/eclipse/core/runtime/adaptor/EclipseBundleInstaller.java;2;1;3;1;2;2;2;1;3;0;1;233;5;5;1;0;0;1;3;233;0;326;3;2;0
/org.eclipse.core.resources/src/org/eclipse/core/internal/watson/DeltaIterator.java;1;0;1;1;1;1;1;0;237;0;0;277;237;237;1;0;0;0;1;277;0;277;1;1;0
/org.eclipse.team.core/src/org/eclipse/team/internal/core/subscribers/WorkingSetSyncSetInput.java;1;0;3;1;1;1;1;2;36;1;2;199;38;38;1;0;0;2;3;199;0;336;3;1;0
/org.eclipse.jdt.debug.ui/ui/org/eclipse/jdt/internal/debug/ui/actions/AddExternalJarAction.java;1;0;1;1;0;0;0;1;15;0;1;154;15;15;1;0;0;1;1;154;0;154;1;1;0
/org.eclipse.swt/Eclipse SWT Browser/common/org/eclipse/swt/browser/ProgressAdapter.java;2;0;4;1;1;1;1;3;30;1;3;101;39;39;1;0;0;3;4;101;0;337;4;2;0
/org.eclipse.swt/Eclipse SWT/win32/org/eclipse/swt/graphics/Region.java;4;1;5;2;2;2;2;3;145;2;2;100;206;206;2;1;0;3;5;131;1;337;4;4;1
/org.eclipse.osgi/eclipseAdaptor/src/org/eclipse/core/runtime/adaptor/testsupport/SimpleBundleInstaller.java;2;0;2;1;1;1;1;1;4;0;1;233;4;4;1;0;0;1;2;233;0;276;2;2;0
/org.eclipse.osgi/defaultAdaptor/src/org/eclipse/osgi/framework/adaptor/core/SystemBundleData.java;4;3;9;2;4;2;4;5;354;3;2;239;404;404;3;3;2;5;9;239;5;296;4;4;0
/org.eclipse.jdt.debug/eval/org/eclipse/jdt/internal/debug/eval/ast/instructions/LocalVariableCreation.java;1;0;1;1;0;0;0;1;8;0;1;26;8;8;1;0;0;1;1;26;0;26;1;1;0
/org.eclipse.jface/src/org/eclipse/jface/viewers/TableViewer.java;5;0;6;2;2;1;2;4;21;2;3;150;34;34;2;1;1;4;6;233;2;329;4;5;5
/org.eclipse.ui.ide/src/org/eclipse/ui/views/markers/internal/FieldPriority.java;2;0;3;1;1;1;1;2;46;1;2;129;81;81;1;0;0;2;3;129;0;336;3;2;0
/org.eclipse.ui.workbench/Eclipse UI/org/eclipse/ui/internal/WorkbookEditorsAction.java;2;1;2;1;2;2;2;0;2;0;0;301;2;2;1;0;0;0;2;301;0;336;2;2;0
/org.eclipse.debug.core/core/org/eclipse/debug/internal/core/memory/IDynamicRenderingInfo.java;1;0;1;1;1;1;1;0;0;0;0;282;0;0;1;0;0;0;1;282;0;282;1;1;0
/org.eclipse.debug.ui/ui/org/eclipse/debug/internal/ui/views/memory/MonitorMemoryBlockDialog.java;2;0;2;2;2;1;2;0;4;0;0;282;4;4;2;0;1;0;2;282;1;282;1;2;1
/org.eclipse.team.ui/src/org/eclipse/team/internal/ui/synchronize/actions/StatusLineCLabelContribution.java;1;0;6;1;1;1;1;5;151;4;2;146;171;171;4;3;0;5;6;146;3;336;3;1;0
/org.eclipse.jdt.ui/ui/org/eclipse/jdt/ui/actions/ShowInPackageViewAction.java;4;0;4;1;1;1;1;3;76;1;3;41;93;93;1;0;0;3;4;41;0;336;4;4;0
/org.eclipse.jface.text/src/org/eclipse/jface/text/templates/JFaceTextTemplateMessages.java;2;1;2;1;2;2;2;0;2;0;0;286;4;4;1;0;0;0;2;286;0;336;2;2;0
/org.eclipse.core.resources/src/org/eclipse/core/internal/indexing/LogWriter.java;1;1;2;1;2;2;2;0;19;0;0;277;32;32;1;0;0;0;2;277;0;295;2;1;0
/org.eclipse.swt/Eclipse SWT PI/gtk/org/eclipse/swt/internal/gtk/GtkRequisition.java;3;0;3;1;1;1;1;2;17;1;2;100;21;21;1;0;0;2;3;100;0;337;3;3;0
/org.eclipse.ui.workbench/Eclipse UI/org/eclipse/ui/internal/presentations/AbstractTableInformationControl.java;6;3;10;2;7;3;7;3;88;0;1;247;165;165;3;2;4;3;10;247;6;335;4;6;0
/org.eclipse.pde.core/src/org/eclipse/pde/internal/core/ibundle/IBundleFragmentModel.java;1;1;2;1;2;2;2;0;4;0;0;292;4;4;1;0;0;0;2;292;0;336;2;1;0
/org.eclipse.jdt.core/search/org/eclipse/jdt/internal/core/search/matching/TypeDeclarationLocator.java;4;0;6;2;1;1;1;5;28;3;3;118;38;38;3;2;0;5;6;118;2;280;4;4;0
/org.eclipse.ui.cheatsheets/src/org/eclipse/ui/internal/cheatsheets/views/CheatSheetViewer.java;2;13;18;2;18;3;18;0;1251;0;0;275;1675;1675;13;0;15;0;18;288;15;330;3;2;0
/org.eclipse.jdt.ui/core extension/org/eclipse/jdt/internal/corext/dom/LinkedNodeFinder.java;2;0;5;1;1;1;1;4;252;2;3;27;276;276;2;1;0;4;5;210;1;336;4;2;1
/org.eclipse.ui.workbench/Eclipse UI/org/eclipse/ui/internal/dialogs/ColorThemeDemo.java;3;0;8;2;0;0;0;8;362;7;2;173;362;362;7;6;0;8;8;223;6;223;2;3;0
/org.eclipse.swt/Eclipse SWT/common/org/eclipse/swt/internal/image/TIFFDirectory.java;1;0;2;1;0;0;0;2;1;1;2;26;1;1;1;0;0;2;2;26;0;49;2;1;0
/org.eclipse.core.runtime.compatibility/src-runtime/org/eclipse/core/internal/plugins/InternalPlatform.java;3;1;6;2;2;2;3;3;12;2;3;171;27;27;2;0;1;4;6;270;1;336;5;3;0
/org.eclipse.pde.ui/src/org/eclipse/pde/internal/ui/launcher/WorkbenchSourcePathProvider.java;1;1;7;1;2;2;2;5;130;1;5;26;159;159;1;0;0;5;7;26;0;336;7;1;0
/org.eclipse.jdt.ui/ui refactoring/org/eclipse/jdt/internal/ui/refactoring/IntroduceFactoryWizard.java;2;0;5;1;1;1;2;3;5;2;3;162;9;9;2;0;1;4;5;269;1;336;4;2;0
/org.eclipse.team.cvs.ui/src/org/eclipse/team/internal/ccvs/ui/UserValidationDialog.java;2;2;7;1;4;3;4;3;132;1;3;64;166;166;2;0;1;3;7;274;1;336;6;2;0
/org.eclipse.swt/Eclipse SWT Program/gtk/org/eclipse/swt/program/Program.java;5;1;16;2;5;5;5;11;495;3;6;31;654;654;3;5;0;11;16;174;5;337;11;5;1
/org.eclipse.jdt.launching/launching/org/eclipse/jdt/launching/StandardClasspathProvider.java;3;1;6;1;2;2;2;4;38;1;4;78;82;82;1;0;0;4;6;78;0;336;6;3;0
/org.eclipse.core.runtime.compatibility/src-model/org/eclipse/core/runtime/model/ExtensionModel.java;3;1;5;1;3;3;3;2;26;1;2;171;35;35;1;0;0;2;5;171;0;336;5;3;0
/org.eclipse.team.cvs.ui/src/org/eclipse/team/internal/ccvs/ui/model/CVSTagElement.java;2;1;11;1;5;5;5;6;125;3;3;5;248;248;3;3;0;6;11;113;3;336;8;2;0
/org.eclipse.jdt.ui/core extension/org/eclipse/jdt/internal/corext/codemanipulation/AddGetterSetterOperation.java;3;1;18;2;2;2;2;16;169;4;9;22;482;482;4;7;0;16;18;95;7;336;11;3;0
/org.eclipse.help.ui/src/org/eclipse/help/ui/internal/HelpActivitySupport.java;1;1;6;1;4;4;4;2;87;1;2;188;256;256;1;0;0;2;6;188;0;336;6;1;0
/org.eclipse.jdt.ui/ui/org/eclipse/jdt/internal/ui/text/comment/CommentRegion.java;2;0;15;2;1;1;1;14;893;6;7;97;1356;1356;6;7;0;14;15;119;7;336;8;2;0
/org.eclipse.swt/Eclipse SWT/motif/org/eclipse/swt/graphics/Region.java;3;1;4;1;2;2;2;2;87;1;2;100;213;213;1;0;0;2;4;100;0;337;4;3;1
/org.eclipse.ui.workbench/Eclipse UI/org/eclipse/ui/internal/layout/ICachingLayout.java;1;0;1;1;1;1;1;0;0;0;0;293;0;0;1;0;0;0;1;293;0;293;1;1;0
/org.eclipse.jdt.ui/ui/org/eclipse/jdt/internal/ui/text/Symbols.java;2;0;2;1;1;1;1;1;8;0;1;117;12;12;1;0;0;1;2;117;0;336;2;2;0
/org.eclipse.text/src/org/eclipse/jface/text/ISlaveDocumentManager.java;1;0;1;1;1;1;1;0;21;0;0;334;21;21;1;0;0;0;1;334;0;334;1;1;0
/org.eclipse.jdt.core/codeassist/org/eclipse/jdt/internal/codeassist/select/SelectionScanner.java;2;0;4;1;0;0;0;4;4;1;4;37;11;11;1;0;0;4;4;37;0;244;4;2;0
/org.eclipse.team.cvs.ui/src/org/eclipse/team/internal/ccvs/ui/FileModificationValidator.java;2;2;6;2;5;3;5;1;72;0;1;208;128;128;2;0;2;1;6;321;2;331;4;2;2
/org.eclipse.team.cvs.ui/src/org/eclipse/team/internal/ccvs/ui/CVSPerspective.java;1;1;2;1;2;2;2;0;7;0;0;303;9;9;1;0;0;0;2;303;0;336;2;1;0
/org.eclipse.swt/Eclipse SWT Drag and Drop/gtk/org/eclipse/swt/dnd/ClipboardProxy.java;4;2;6;2;3;2;3;3;28;1;3;23;54;54;2;0;1;3;6;302;1;337;5;4;0
/org.eclipse.team.cvs.ui/src/org/eclipse/team/internal/ccvs/ui/ExtMethodPreferencePage.java;2;1;4;1;3;3;3;1;137;0;1;20;148;148;1;0;0;1;4;20;0;336;4;2;3
/org.eclipse.jdt.ui/ui refactoring/org/eclipse/jdt/internal/ui/refactoring/ChangeParametersControl.java;4;2;17;2;5;3;5;12;380;6;6;65;556;556;6;6;2;12;17;183;8;336;9;4;0
/org.eclipse.pde.core/src/org/eclipse/pde/internal/core/site/SiteCategory.java;2;1;3;1;2;2;2;1;8;0;1;232;20;20;1;0;0;1;3;232;0;336;3;2;0
/org.eclipse.jdt.core/search/org/eclipse/jdt/internal/core/search/indexing/ReadWriteMonitor.java;2;0;3;1;0;0;0;3;50;1;3;113;54;54;1;0;0;3;3;113;0;225;3;2;0
/org.eclipse.pde.core/src/org/eclipse/pde/core/plugin/IExtensionsModel.java;2;2;6;2;4;3;4;2;33;1;2;128;58;58;2;0;1;2;6;276;1;336;5;2;0
/org.eclipse.jdt.debug.ui/ui/org/eclipse/jdt/internal/debug/ui/actions/AddProjectAction.java;3;1;4;1;2;2;2;2;13;1;2;76;24;24;1;0;0;2;4;76;0;336;4;3;0
/org.eclipse.ui.workbench/Eclipse UI/org/eclipse/ui/internal/SaveAsAction.java;3;0;4;1;1;1;1;3;28;1;3;157;53;53;1;0;0;3;4;157;0;336;4;3;0
/org.eclipse.pde.build/src/org/eclipse/pde/internal/build/BundleHelper.java;2;2;4;2;3;2;3;1;122;0;1;246;138;138;2;0;1;1;4;272;1;307;3;2;0
/org.eclipse.jdt.ui/ui/org/eclipse/jdt/ui/actions/OpenEditorActionGroup.java;2;0;2;1;1;1;1;1;2;0;1;237;3;3;1;0;0;1;2;237;0;336;2;2;0
/org.eclipse.team.cvs.ui/src/org/eclipse/team/internal/ccvs/ui/model/TagCategory.java;2;1;3;1;2;2;2;1;72;0;1;148;74;74;1;0;0;1;3;148;0;336;3;2;0
/org.eclipse.debug.core/core/org/eclipse/debug/core/sourcelookup/containers/ArchiveSourceContainer.java;2;0;3;1;1;1;2;1;17;0;1;268;19;19;2;0;1;2;3;268;1;336;2;2;0
/org.eclipse.pde.ui/src/org/eclipse/pde/ui/IFieldData.java;2;2;4;1;4;3;4;0;114;0;0;277;187;187;2;0;1;0;4;277;1;336;3;2;0
/org.eclipse.jdt.core/model/org/eclipse/jdt/internal/core/UserLibraryManager.java;1;2;3;1;3;2;3;0;18;0;0;280;22;22;2;0;1;0;3;280;1;305;2;1;0
/org.eclipse.ui.ide/src/org/eclipse/ui/views/tasklist/TaskAction.java;1;0;1;1;0;0;0;1;0;0;1;129;0;0;1;0;0;1;1;129;0;129;1;1;0
/org.eclipse.pde.core/src/org/eclipse/pde/internal/core/plugin/PluginExtension.java;3;2;6;2;4;3;4;2;32;1;2;232;76;76;2;0;1;2;6;306;1;336;5;3;0
/org.eclipse.jface/src/org/eclipse/jface/viewers/TextCellEditor.java;3;0;4;2;1;1;1;3;43;1;3;171;76;76;1;0;0;3;4;171;0;336;4;3;0
/org.eclipse.jdt.ui/ui/org/eclipse/jdt/internal/ui/compare/JavaStructureDiffViewer.java;1;0;1;1;1;1;1;0;2;0;0;336;2;2;1;0;0;0;1;336;0;336;1;1;1
/org.eclipse.swt/Eclipse SWT Mozilla/common/org/eclipse/swt/internal/mozilla/nsIIOService.java;1;0;1;1;0;0;0;1;0;0;1;153;0;0;1;0;0;1;1;153;0;153;1;1;0
/org.eclipse.ui.ide/src/org/eclipse/ui/internal/ide/registry/MarkerImageProviderRegistry.java;4;1;4;1;2;2;2;2;2;1;2;132;6;6;1;0;0;2;4;132;0;336;4;4;1
/org.eclipse.help.base/src/org/eclipse/help/internal/base/IndexToolApplication.java;2;1;12;1;3;3;3;9;74;2;7;105;130;130;2;2;0;9;12;206;2;336;10;2;0
/org.eclipse.jdt.core/model/org/eclipse/jdt/internal/core/builder/AbstractImageBuilder.java;5;0;18;3;1;1;1;17;89;5;10;6;164;164;5;7;0;17;18;148;7;315;11;5;1
/org.eclipse.jface.text/src/org/eclipse/jface/text/contentassist/IContentAssistant.java;1;0;2;1;2;1;2;0;38;0;0;336;38;38;2;0;1;0;2;336;1;336;1;1;0
/org.eclipse.jdt.ui/ui/org/eclipse/jdt/internal/ui/browsing/PackagesViewFlatContentProvider.java;1;2;4;1;3;2;3;1;40;0;1;20;48;48;2;0;1;1;4;321;1;336;3;1;0
/org.eclipse.debug.ui/ui/org/eclipse/debug/internal/ui/stringsubstitution/IArgumentSelector.java;2;0;2;1;0;0;0;2;5;1;2;124;7;7;1;0;0;2;2;124;0;145;2;2;0
/org.eclipse.jdt.core/dom/org/eclipse/jdt/core/dom/NodeSearcher.java;3;0;4;1;0;0;0;4;10;2;3;79;14;14;2;1;0;4;4;79;1;199;3;3;0
/org.eclipse.osgi/eclipseAdaptor/src/org/eclipse/osgi/service/environment/EnvironmentInfo.java;3;2;5;2;3;2;3;2;35;1;2;178;64;64;2;0;1;2;5;276;1;336;4;3;0
/org.eclipse.jdt.ui/ui/org/eclipse/jdt/internal/ui/text/spelling/WordQuickFixProcessor.java;2;0;3;2;1;1;1;2;2;0;1;219;4;4;2;1;0;2;3;219;1;336;2;2;0
/org.eclipse.jdt.core/compiler/org/eclipse/jdt/internal/compiler/parser/RecoveredField.java;4;0;6;2;1;1;1;5;14;2;4;34;43;43;2;1;0;5;6;63;1;290;5;4;0
/org.eclipse.jdt.core/formatter/org/eclipse/jdt/internal/formatter/old/CodeFormatter.java;2;0;5;2;1;1;1;4;114;2;3;205;143;143;2;1;0;4;5;205;1;323;4;2;0
/org.eclipse.ui.workbench/Eclipse UI/org/eclipse/ui/part/IntroPart.java;1;2;5;1;5;3;5;0;341;0;0;279;355;355;2;0;2;0;5;279;2;330;3;1;1
/org.eclipse.pde.core/src/org/eclipse/pde/core/ISourceObject.java;2;1;3;1;3;3;3;0;41;0;0;276;49;49;1;0;0;0;3;276;0;336;3;2;0
/org.eclipse.jdt.debug.ui/ui/org/eclipse/jdt/internal/debug/core/refactoring/JavaBreakpointITypeRenameParticipant.java;2;1;2;1;2;2;2;0;6;0;0;287;6;6;1;0;0;0;2;287;0;336;2;2;0
/org.eclipse.ui.workbench/Eclipse UI/org/eclipse/ui/internal/util/BundleUtility.java;3;1;5;1;3;3;3;2;13;1;2;252;35;35;1;0;0;2;5;252;0;336;5;3;0
/org.eclipse.jdt.ui/ui/org/eclipse/jdt/internal/ui/wizards/AbstractOpenWizardAction.java;2;1;2;1;2;2;2;0;5;0;0;300;7;7;1;0;0;0;2;300;0;336;2;2;0
/org.eclipse.ant.ui/Ant Editor/org/eclipse/ant/internal/ui/editor/outline/FilterTopLevelAction.java;1;0;1;1;0;0;0;1;0;0;1;246;0;0;1;0;0;1;1;246;0;246;1;1;1
/org.eclipse.ui.ide/src/org/eclipse/ui/views/tasklist/MarkerUtil.java;3;0;3;1;1;1;1;2;10;1;2;129;12;12;1;0;0;2;3;129;0;336;3;3;0
/org.eclipse.ui.workbench/Eclipse UI/org/eclipse/ui/internal/progress/AwaitingFeedbackInfo.java;1;0;1;1;0;0;0;1;0;0;1;111;0;0;1;0;0;1;1;111;0;111;1;1;0
/org.eclipse.pde.ui/src_Forms/org/eclipse/pde/internal/ui/model/bundle/EclipseAutoStartHeader.java;3;2;4;2;4;3;4;0;12;0;0;292;16;16;2;0;1;0;4;303;1;336;3;3;0
/org.eclipse.ui.ide/src/org/eclipse/ui/views/markers/internal/FieldLineNumber.java;2;0;3;1;1;1;1;2;47;1;2;129;82;82;1;0;0;2;3;129;0;336;3;2;0
/org.eclipse.jdt.ui/ui/org/eclipse/jdt/internal/ui/text/java/hover/AbstractAnnotationHover.java;1;0;2;1;2;1;2;0;2;0;0;302;2;2;2;0;1;0;2;302;1;302;1;1;0
/org.eclipse.core.resources/src/org/eclipse/core/internal/resources/SyncInfoReader.java;1;0;1;1;1;1;1;0;99;0;0;277;99;99;1;0;0;0;1;277;0;277;1;1;0
/org.eclipse.swt/Eclipse SWT/win32/org/eclipse/swt/widgets/FontDialog.java;5;1;9;2;2;2;2;7;46;2;6;12;117;117;2;1;0;7;9;12;1;337;8;5;0
/org.eclipse.search/search/org/eclipse/search/internal/core/text/MatchLocator.java;2;1;5;1;2;2;2;3;17;2;2;165;43;43;2;1;0;3;5;165;1;336;4;2;1
/org.eclipse.ui.workbench/Eclipse UI/org/eclipse/ui/internal/CloseAllPerspectivesAction.java;1;0;1;1;0;0;0;1;46;0;1;157;46;46;1;0;0;1;1;157;0;157;1;1;1
/org.eclipse.swt/Eclipse SWT Mozilla/common/org/eclipse/swt/internal/mozilla/nsIWebBrowserChromeFocus.java;1;0;1;1;0;0;0;1;0;0;1;100;0;0;1;0;0;1;1;100;0;100;1;1;0
/org.eclipse.ui.intro/src/org/eclipse/ui/internal/intro/impl/model/viewer/IntroModelContentProvider.java;1;1;2;1;2;2;2;0;2;0;0;276;2;2;1;0;0;0;2;276;0;286;2;1;0
/org.eclipse.jdt.junit/src/org/eclipse/jdt/internal/junit/ui/ScrollLockAction.java;3;0;3;1;1;1;1;2;2;1;2;30;4;4;1;0;0;2;3;30;0;336;3;3;0
/org.eclipse.ui.ide/src/org/eclipse/ui/internal/ide/IMarkerImageProvider.java;1;0;1;1;0;0;0;1;0;0;1;132;0;0;1;0;0;1;1;132;0;132;1;1;0
/org.eclipse.pde.ui/src/org/eclipse/pde/internal/ui/parts/ILinkLabelProvider.java;1;1;2;1;2;2;2;0;10;0;0;292;10;10;1;0;0;0;2;292;0;336;2;1;0
/org.eclipse.swt/Eclipse SWT PI/win32/org/eclipse/swt/internal/win32/LRESULT.java;1;0;1;1;0;0;0;1;2;0;1;166;2;2;1;0;0;1;1;166;0;166;1;1;0
/org.eclipse.jdt.core/codeassist/org/eclipse/jdt/internal/codeassist/complete/CompletionOnExceptionReference.java;2;0;2;1;0;0;0;2;16;1;2;63;18;18;1;0;0;2;2;63;0;199;2;2;0
/org.eclipse.debug.ui/ui/org/eclipse/debug/internal/ui/actions/TerminateAllAction.java;1;0;1;1;0;0;0;1;2;0;1;78;2;2;1;0;0;1;1;78;0;78;1;1;0
/org.eclipse.jdt.core/compiler/org/eclipse/jdt/internal/compiler/ast/TypeDeclaration.java;4;2;18;2;3;2;3;15;254;3;8;1;675;675;3;7;1;15;18;1;8;312;10;4;2
/org.eclipse.team.core/src/org/eclipse/team/core/variants/ResourceVariantByteStore.java;1;1;3;1;2;2;2;1;23;0;1;239;30;30;1;0;0;1;3;239;0;325;3;1;0
/org.eclipse.swt/Eclipse SWT PI/carbon/org/eclipse/swt/internal/carbon/TXNBackground.java;2;0;3;1;2;1;2;1;20;0;1;6;20;20;2;0;1;1;3;296;1;296;2;2;0
/org.eclipse.swt/Eclipse SWT Printing/carbon/org/eclipse/swt/printing/PrintDialog.java;2;1;4;1;2;2;2;2;109;0;1;158;121;121;2;1;0;2;4;158;1;337;3;2;0
/org.eclipse.help.ui/src/org/eclipse/help/ui/internal/browser/BrowsersPreferencePage.java;1;1;9;1;3;3;3;6;343;2;4;32;425;425;2;2;0;6;9;156;2;336;7;1;1
/org.eclipse.pde.ui/src/org/eclipse/pde/internal/ui/launcher/WorkbenchLauncherTabGroup.java;3;1;10;1;4;4;4;6;40;2;4;99;138;138;2;2;0;6;10;171;2;336;8;3;0
/org.eclipse.pde.ui/src/org/eclipse/pde/internal/ui/wizards/feature/FeatureSpecPage.java;3;1;6;1;5;5;5;1;262;0;1;213;376;376;1;0;0;1;6;213;0;336;6;3;0
/org.eclipse.jdt.core/codeassist/org/eclipse/jdt/internal/codeassist/complete/CompletionScanner.java;4;1;11;2;3;3;3;8;428;2;7;37;491;491;2;1;0;8;11;237;1;327;10;4;1
/org.eclipse.jdt.ui/ui/org/eclipse/jdt/internal/ui/preferences/formatter/CompilationUnitPreview.java;2;0;3;1;1;1;1;2;24;1;2;211;30;30;1;0;0;2;3;211;0;279;3;2;0
/org.eclipse.jdt.core/model/org/eclipse/jdt/internal/core/jdom/DOMNode.java;2;1;4;1;2;2;2;2;10;1;2;180;16;16;1;0;0;2;4;180;0;314;4;2;0
/org.eclipse.ui.cheatsheets/src/org/eclipse/ui/cheatsheets/CheatSheetViewerFactory.java;2;0;1;2;1;1;1;0;9;0;0;275;9;9;1;0;0;0;1;275;0;275;1;2;0
/org.eclipse.debug.ui/ui/org/eclipse/debug/internal/ui/launchConfigurations/LaunchConfigurationTabGroupExtension.java;4;0;6;1;1;1;1;5;76;2;4;33;115;115;2;1;0;5;6;33;1;336;5;4;1
/org.eclipse.pde/src/org/eclipse/pde/internal/builders/SchemaMarkerFactory.java;2;1;3;1;2;2;2;1;4;0;1;232;10;10;1;0;0;1;3;232;0;336;3;2;0
/org.eclipse.pde/src/org/eclipse/pde/internal/builders/ManifestConsistencyChecker.java;3;3;14;2;7;4;7;7;472;1;7;59;930;930;3;0;3;7;14;315;3;336;11;3;0
/org.eclipse.jdt.junit/src/org/eclipse/jdt/junit/JUnitCore.java;2;2;4;2;3;2;3;1;13;0;1;99;17;17;2;0;1;1;4;335;1;335;3;2;0
/org.eclipse.ui.cheatsheets/src/org/eclipse/ui/internal/cheatsheets/views/CheatSheetExpandRestoreAction.java;2;0;3;1;1;1;1;2;26;1;2;243;43;43;1;0;0;2;3;243;0;275;3;2;0
/org.eclipse.swt/Eclipse SWT/gtk/org/eclipse/swt/widgets/ToolBar.java;7;4;19;4;6;3;6;13;68;3;8;3;237;237;4;5;3;13;19;300;8;337;11;7;0
/org.eclipse.jdt.debug.ui/ui/org/eclipse/jdt/internal/debug/ui/launcher/SelectDefaultSystemLibraryQuickFix.java;3;1;4;1;2;2;2;2;6;1;2;22;17;17;1;0;0;2;4;22;0;336;4;3;0
/org.eclipse.ui.cheatsheets/src/org/eclipse/ui/internal/cheatsheets/views/ErrorPage.java;1;2;5;1;3;2;3;2;67;0;1;257;110;110;2;1;1;2;5;257;2;306;3;1;0
/org.eclipse.ui.ide/extensions/org/eclipse/ui/part/ResourceTransfer.java;1;0;1;1;0;0;0;1;0;0;1;132;0;0;1;0;0;1;1;132;0;132;1;1;0
/org.eclipse.swt/Eclipse SWT/win32/org/eclipse/swt/widgets/ColorDialog.java;3;0;6;1;1;1;1;5;15;1;5;19;27;27;1;0;0;5;6;19;0;337;6;3;0
/org.eclipse.ltk.ui.refactoring/src/org/eclipse/ltk/ui/refactoring/RefactoringWizardPage.java;1;0;6;1;2;1;5;1;37;0;1;269;53;53;4;0;4;4;6;269;4;335;2;1;0
/org.eclipse.jdt.debug.ui/ui/org/eclipse/jdt/internal/debug/ui/EvaluationContextStatusHandler.java;2;0;2;1;0;0;0;2;3;1;2;152;3;3;1;0;0;2;2;152;0;171;2;2;0
/org.eclipse.compare/compare/org/eclipse/compare/IEditableContent.java;1;0;1;1;0;0;0;1;2;0;1;219;2;2;1;0;0;1;1;219;0;219;1;1;0
/org.eclipse.swt/Eclipse SWT/carbon/org/eclipse/swt/widgets/Tree.java;5;3;28;2;10;5;10;18;896;5;10;17;1250;1250;5;8;5;18;28;17;13;335;15;5;0
/org.eclipse.jdt.ui/ui/org/eclipse/jdt/internal/ui/javaeditor/SemanticHighlightings.java;3;4;9;2;9;3;9;0;539;0;0;283;664;664;4;0;6;0;9;293;6;326;3;3;2
/org.eclipse.ltk.core.refactoring/src/org/eclipse/ltk/core/refactoring/IRefactoringCoreStatusCodes.java;1;0;5;1;0;0;3;2;14;0;1;264;14;14;5;1;3;5;5;264;4;264;1;1;0
/org.eclipse.swt/Eclipse SWT/win32/org/eclipse/swt/widgets/Table.java;7;4;58;6;9;4;13;45;1741;23;15;2;2715;2715;23;30;9;49;58;214;39;325;19;7;4
/org.eclipse.ant.ui/Remote Ant Support/org/eclipse/ant/internal/ui/antsupport/InputHandlerSetter.java;1;0;1;1;0;0;0;1;0;0;1;108;0;0;1;0;0;1;1;108;0;108;1;1;0
/org.eclipse.jdt.core/compiler/org/eclipse/jdt/internal/compiler/ast/Initializer.java;3;0;7;2;0;0;0;7;32;2;6;5;60;60;2;1;0;7;7;63;1;199;6;3;0
/org.eclipse.jdt.core/compiler/org/eclipse/jdt/internal/compiler/classfmt/FieldInfo.java;4;0;6;2;0;0;0;6;22;3;4;2;39;39;3;2;0;6;6;148;2;199;4;4;0
/org.eclipse.pde.core/src/org/eclipse/pde/internal/core/PlatformConfiguration.java;2;1;5;1;2;2;2;3;5;0;1;225;11;11;3;2;0;3;5;225;2;336;3;2;0
/org.eclipse.jdt.core/model/org/eclipse/jdt/internal/core/INamingRequestor.java;1;0;1;1;0;0;0;1;2;0;1;199;2;2;1;0;0;1;1;199;0;199;1;1;0
/org.eclipse.jface.text/src/org/eclipse/jface/text/reconciler/Reconciler.java;3;2;4;1;3;2;3;1;72;0;1;92;95;95;2;0;1;1;4;336;1;336;3;3;0
/org.eclipse.pde.ui/src/org/eclipse/pde/internal/ui/editor/site/FeaturePropertiesDialog.java;2;1;3;1;2;2;2;1;25;0;1;208;35;35;1;0;0;1;3;208;0;336;3;2;0
/org.eclipse.jdt.ui/ui/org/eclipse/jdt/ui/text/JavaTextTools.java;4;2;10;2;5;3;5;5;42;1;5;81;192;192;2;0;2;5;10;279;2;335;8;4;0
/org.eclipse.swt/Eclipse SWT PI/win32/org/eclipse/swt/internal/win32/NMLISTVIEW.java;1;0;1;1;0;0;0;1;2;0;1;166;2;2;1;0;0;1;1;166;0;166;1;1;0
/org.eclipse.jdt.ui/core refactoring/org/eclipse/jdt/internal/corext/refactoring/changes/CompilationUnitChange.java;4;0;13;2;1;1;4;9;45;4;7;65;128;128;4;2;3;12;13;269;5;336;8;4;0
/org.eclipse.pde.ui/src/org/eclipse/pde/internal/ui/wizards/templates/PreferencePageTemplate.java;3;1;7;1;3;3;3;4;44;2;3;128;89;89;2;1;0;4;7;128;1;336;6;3;0
/org.eclipse.help.webapp/src_servlets/org/eclipse/help/internal/webapp/servlet/EclipseConnector.java;2;1;12;2;3;3;3;9;52;2;7;44;207;207;2;2;0;9;12;76;2;336;10;2;1
/org.eclipse.jdt.ui/ui/org/eclipse/jdt/internal/ui/callhierarchy/LocationViewer.java;3;0;5;1;1;1;1;4;11;2;3;28;17;17;2;1;0;4;5;28;1;336;4;3;0
/org.eclipse.pde.core/src/org/eclipse/pde/internal/core/ibundle/IManifestHeader.java;1;1;2;1;2;2;2;0;4;0;0;292;4;4;1;0;0;0;2;292;0;336;2;1;0
/org.eclipse.jdt.ui/ui/org/eclipse/jdt/internal/ui/browsing/ProjectsView.java;1;0;2;1;1;1;1;1;17;0;1;44;19;19;1;0;0;1;2;44;0;336;2;1;0
/org.eclipse.ltk.core.refactoring/src/org/eclipse/ltk/core/refactoring/participants/ISharableParticipant.java;1;3;6;1;4;2;4;2;32;0;1;264;42;42;3;1;2;2;6;275;3;336;3;1;0
/org.eclipse.team.cvs.ui/src/org/eclipse/team/internal/ccvs/ui/subscriber/RefreshDirtyStateOperation.java;1;2;4;1;4;3;4;0;80;0;0;288;92;92;2;0;1;0;4;288;1;329;3;1;0
/org.eclipse.jdt.ui/ui/org/eclipse/jdt/ui/actions/FindOccurrencesInFileAction.java;2;0;4;1;1;1;1;3;8;1;3;41;17;17;1;0;0;3;4;41;0;336;4;2;0
/org.eclipse.core.runtime.compatibility/src-runtime/org/eclipse/core/internal/plugins/PluginDescriptor.java;5;2;28;4;5;3;10;18;585;11;4;171;1240;1240;11;14;7;23;28;251;21;314;7;5;0
/org.eclipse.jdt.ui/ui refactoring/org/eclipse/jdt/internal/ui/refactoring/nls/search/NLSSearchResultCollector.java;5;1;7;3;2;2;2;5;32;2;4;80;42;42;2;1;0;5;7;268;1;336;6;5;0
/org.eclipse.team.ui/src/org/eclipse/team/ui/synchronize/ISynchronizeParticipant.java;2;2;11;2;5;3;5;6;120;2;5;146;430;430;2;1;2;6;11;146;3;335;8;2;2
/org.eclipse.pde.ui/src/org/eclipse/pde/internal/ui/wizards/templates/EditorNewWizard.java;3;2;6;1;4;3;4;2;12;1;2;222;31;31;2;0;1;2;6;308;1;336;5;3;0
/org.eclipse.jdt.debug.ui/ui/org/eclipse/jdt/internal/debug/ui/LocalFileStorageEditorInput.java;2;1;2;1;2;2;2;0;7;0;0;274;11;11;1;0;0;0;2;274;0;286;2;2;0
/org.eclipse.ui.workbench/Eclipse UI/org/eclipse/ui/INavigationLocationProvider.java;2;1;2;1;2;2;2;0;2;0;0;295;4;4;1;0;0;0;2;295;0;336;2;2;0
/org.eclipse.ui.workbench/Eclipse UI/org/eclipse/ui/internal/registry/PerspectiveRegistryReader.java;4;0;5;2;1;1;1;4;9;2;3;65;22;22;2;1;0;4;5;250;1;336;4;4;0
/org.eclipse.update.ui/src/org/eclipse/update/internal/ui/wizards/RevertConfigurationWizardPage.java;3;1;13;2;2;2;2;11;219;4;6;54;264;264;4;5;0;11;13;241;5;336;8;3;0
/org.eclipse.ui.externaltools/External Tools Base/org/eclipse/ui/externaltools/internal/variables/VariableMessages.java;1;0;1;1;0;0;0;1;0;0;1;269;0;0;1;0;0;1;1;269;0;269;1;1;0
/org.eclipse.jdt.ui/ui/org/eclipse/jdt/internal/ui/compare/CompareMessages.java;1;0;1;1;1;1;1;0;2;0;0;336;2;2;1;0;0;0;1;336;0;336;1;1;0
/org.eclipse.help/src/org/eclipse/help/IHelpContentProducer.java;1;1;5;1;2;2;2;3;57;2;2;64;68;68;2;1;0;3;5;72;1;336;4;1;0
/org.eclipse.pde.ui/src/org/eclipse/pde/internal/ui/editor/schema/AttributePropertySource.java;2;3;4;1;4;2;4;0;64;0;0;308;68;68;3;0;2;0;4;308;2;336;2;2;0
/org.eclipse.jdt.ui/ui/org/eclipse/jdt/internal/ui/browsing/JavaBrowsingMessages.java;1;0;1;1;1;1;1;0;2;0;0;336;2;2;1;0;0;0;1;336;0;336;1;1;0
/org.eclipse.pde.ui/src/org/eclipse/pde/internal/ui/editor/schema/SchemaFormPage.java;2;1;3;1;3;3;3;0;111;0;0;292;121;121;1;0;0;0;3;292;0;336;3;2;0
/org.eclipse.pde.core/src/org/eclipse/pde/internal/core/feature/FeatureInfo.java;2;1;3;1;2;2;2;1;16;0;1;232;33;33;1;0;0;1;3;232;0;336;3;2;0
/org.eclipse.ant.ui/Ant Tools Support/org/eclipse/ant/internal/ui/launchConfigurations/TaskLinkManager.java;1;0;3;1;1;1;1;2;8;1;2;108;12;12;1;0;0;2;3;108;0;336;3;1;1
/org.eclipse.core.resources/src/org/eclipse/core/internal/resources/Folder.java;3;0;11;2;1;1;3;8;305;3;7;13;337;337;3;1;2;10;11;270;3;326;8;3;0
/org.eclipse.search/new search/org/eclipse/search2/internal/ui/text/EditorAnnotationManager.java;1;0;2;1;2;1;2;0;4;0;0;321;4;4;2;0;1;0;2;321;1;321;1;1;0
/org.eclipse.jdt.ui/ui/org/eclipse/jdt/internal/ui/util/MainMethodSearchEngine.java;2;2;3;1;3;2;3;0;54;0;0;289;56;56;2;0;1;0;3;289;1;336;2;2;0
/org.eclipse.jdt.core/compiler/org/eclipse/jdt/internal/compiler/classfmt/ClassFormatException.java;2;0;4;2;1;1;1;3;140;2;2;13;152;152;2;1;0;3;4;13;1;276;3;2;0
/org.eclipse.jdt.core/model/org/eclipse/jdt/internal/core/JavaModelOperation.java;3;0;14;2;0;0;0;14;142;5;7;8;302;302;5;7;0;14;14;169;7;207;7;3;0
/org.eclipse.team.ui/src/org/eclipse/team/internal/ui/wizards/ProjectSetExportWizard.java;2;1;6;1;4;4;4;2;202;1;2;63;277;277;1;0;0;2;6;63;0;336;6;2;0
/org.eclipse.help.base/src/org/eclipse/help/internal/base/HelpBasePreferenceInitializer.java;1;2;4;1;4;3;4;0;12;0;0;296;28;28;2;0;1;0;4;296;1;336;3;1;0
/org.eclipse.team.cvs.core/src/org/eclipse/team/internal/ccvs/core/connection/CVSRepositoryLocation.java;2;3;27;2;9;6;9;18;1373;5;10;56;2125;2125;5;8;3;18;27;112;11;336;16;2;2
/org.eclipse.debug.core/core/org/eclipse/debug/core/sourcelookup/IPersistableSourceLocator2.java;1;0;2;1;0;0;1;1;4;0;1;268;4;4;2;0;1;2;2;268;1;268;1;1;0
/org.eclipse.team.ui/src/org/eclipse/team/internal/ui/dialogs/PromptingDialog.java;1;0;1;1;0;0;0;1;126;0;1;63;126;126;1;0;0;1;1;63;0;63;1;1;0
/org.eclipse.jdt.ui/ui/org/eclipse/jdt/internal/ui/callhierarchy/SearchScopeHierarchyAction.java;2;2;4;1;3;2;3;1;15;0;1;224;17;17;2;0;1;1;4;293;1;336;3;2;0
/org.eclipse.ui.ide/extensions/org/eclipse/ui/dialogs/WizardNewFolderMainPage.java;3;1;3;1;2;2;2;1;18;0;1;132;20;20;1;0;0;1;3;132;0;336;3;3;1
/org.eclipse.ant.ui/Ant Tools Support/org/eclipse/ant/internal/ui/preferences/AntClasspathPage.java;1;0;11;1;1;1;1;10;78;6;5;108;100;100;6;5;0;10;11;147;5;336;6;1;1
/org.eclipse.jdt.core/dom/org/eclipse/jdt/core/dom/SuperFieldAccess.java;5;0;10;1;2;1;2;8;102;2;7;5;155;155;2;1;1;8;10;266;2;276;8;5;1
/org.eclipse.jdt.ui/ui/org/eclipse/jdt/internal/ui/browsing/ProjectAndSourceFolderContentProvider.java;1;0;3;1;1;1;1;2;9;1;2;17;13;13;1;0;0;2;3;17;0;336;3;1;0
/org.eclipse.team.core/src/org/eclipse/team/internal/core/streams/PollingInputStream.java;2;1;4;1;2;2;2;2;34;1;2;56;44;44;1;0;0;2;4;56;0;336;4;2;0
/org.eclipse.jdt.core/model/org/eclipse/jdt/internal/core/hierarchy/RegionBasedTypeHierarchy.java;2;0;9;1;0;0;0;9;36;2;7;5;92;92;2;2;0;9;9;62;2;195;7;2;0
/org.eclipse.ant.ui/Ant Tools Support/org/eclipse/ant/internal/ui/preferences/TabFolderLayout.java;1;0;1;1;0;0;0;1;0;0;1;108;0;0;1;0;0;1;1;108;0;108;1;1;0
/org.eclipse.jdt.ui/ui/org/eclipse/jdt/internal/ui/dnd/DelegatingDragAdapter.java;1;0;1;1;1;1;1;0;2;0;0;336;2;2;1;0;0;0;1;336;0;336;1;1;0
/org.eclipse.update.core/src/org/eclipse/update/configuration/IInstallDeltaHandler.java;1;3;4;1;4;2;4;0;4;0;0;289;8;8;3;0;2;0;4;289;2;336;2;1;0
/org.eclipse.jdt.core/search/org/eclipse/jdt/core/search/MethodDeclarationMatch.java;2;0;7;2;3;1;3;4;31;2;2;218;59;59;3;2;2;4;7;275;4;275;3;2;0
/org.eclipse.update.core/src/org/eclipse/update/internal/core/DeltaInstallHandler.java;3;2;8;2;4;3;4;4;48;2;3;113;116;116;2;1;1;4;8;113;2;336;6;3;0
/org.eclipse.core.runtime.compatibility/src-model/org/eclipse/core/internal/model/RegistryLoader.java;3;1;4;1;3;3;3;1;14;0;1;171;19;19;1;0;0;1;4;171;0;336;4;3;0
/org.eclipse.jdt.ui/core refactoring/org/eclipse/jdt/internal/corext/refactoring/rename/RenameMethodProcessor.java;4;8;31;2;12;4;12;19;440;5;8;71;847;847;8;11;8;19;31;278;19;336;12;4;0
/org.eclipse.pde.ui/src/org/eclipse/pde/internal/ui/wizards/WizardTreeSelectionPage.java;3;2;4;1;4;3;4;0;35;0;0;295;47;47;2;0;1;0;4;308;1;336;3;3;0
/org.eclipse.pde.core/src/org/eclipse/pde/internal/core/site/SiteObject.java;2;0;3;1;1;1;1;2;6;1;2;232;12;12;1;0;0;2;3;232;0;336;3;2;0
/org.eclipse.update.ui/src/org/eclipse/update/internal/ui/views/SiteStateAction.java;3;0;8;2;1;1;1;7;54;2;6;25;84;84;2;1;0;7;8;50;1;336;7;3;0
/org.eclipse.ui.intro/src/org/eclipse/ui/internal/intro/impl/html/HTMLUtil.java;2;5;6;2;6;2;6;0;160;0;0;276;189;189;5;0;4;0;6;276;4;302;2;2;0
/org.eclipse.debug.ui/ui/org/eclipse/debug/internal/ui/actions/KeyBindingFollowHyperlinkAction.java;3;1;3;1;2;2;2;1;18;0;1;79;27;27;1;0;0;1;3;79;0;336;3;3;1
/org.eclipse.ui.console/src/org/eclipse/ui/internal/console/IConsoleHelpContextIds.java;1;0;1;1;0;0;0;1;0;0;1;118;0;0;1;0;0;1;1;118;0;118;1;1;0
/org.eclipse.swt/Eclipse SWT/photon/org/eclipse/swt/widgets/DirectoryDialog.java;3;1;4;1;2;2;2;2;25;1;2;58;36;36;1;0;0;2;4;58;0;337;4;3;0
/org.eclipse.ant.ui/Ant Tools Support/org/eclipse/ant/internal/ui/preferences/AntPropertiesFileSelectionDialog.java;1;0;1;1;0;0;0;1;37;0;1;265;37;37;1;0;0;1;1;265;0;265;1;1;0
/org.eclipse.team.cvs.ssh2/src/org/eclipse/team/internal/ccvs/ssh2/CVSSSH2Method.java;2;0;2;2;0;0;0;2;23;0;1;263;23;23;2;1;0;2;2;263;1;263;1;2;0
/org.eclipse.update.core/src/org/eclipse/update/internal/security/JarVerifier.java;2;1;5;2;2;2;2;3;27;2;2;58;35;35;2;1;0;3;5;58;1;336;4;2;0
/org.eclipse.jdt.ui/ui/org/eclipse/jdt/internal/ui/callhierarchy/CopyCallHierarchyAction.java;2;0;2;1;1;1;1;1;2;0;1;21;2;2;1;0;0;1;2;21;0;336;2;2;0
/org.eclipse.swt/Eclipse SWT Drag and Drop/motif/org/eclipse/swt/dnd/DragSource.java;3;0;4;1;0;0;0;4;14;2;3;0;22;22;2;1;0;4;4;54;1;54;3;3;0
/org.eclipse.debug.ui/ui/org/eclipse/debug/internal/ui/views/memory/DefaultColumnSizeDialog.java;1;0;1;1;1;1;1;0;0;0;0;290;0;0;1;0;0;0;1;290;0;290;1;1;1
/org.eclipse.ui.cheatsheets/src/org/eclipse/ui/internal/cheatsheets/data/ISubItemItem.java;1;1;2;1;2;2;2;0;2;0;0;279;2;2;1;0;0;0;2;279;0;300;2;1;0
/org.eclipse.jdt.ui/ui/org/eclipse/jdt/internal/ui/javaeditor/JavaStorageDocumentProvider.java;2;0;2;1;1;1;1;1;20;0;1;243;20;20;1;0;0;1;2;243;0;336;2;2;0
/org.eclipse.swt/Eclipse SWT/motif/org/eclipse/swt/widgets/Composite.java;6;2;30;2;3;2;3;27;319;3;14;1;795;795;3;13;1;27;30;1;14;337;16;6;0
/org.eclipse.core.resources/src/org/eclipse/core/resources/ICommand.java;1;0;2;1;0;0;1;1;113;0;1;270;113;113;2;0;1;2;2;270;1;270;1;1;0
/org.eclipse.jdt.core/compiler/org/eclipse/jdt/internal/compiler/ast/ArrayReference.java;2;0;5;1;1;1;1;4;20;1;4;63;53;53;1;0;0;4;5;63;0;299;5;2;2
/org.eclipse.core.expressions/src/org/eclipse/core/internal/expressions/CountExpression.java;1;1;3;1;2;2;2;1;14;0;1;227;16;16;1;0;0;1;3;227;0;336;3;1;0
/org.eclipse.jface/src/org/eclipse/jface/dialogs/DialogPage.java;1;0;4;1;2;1;2;2;709;1;2;0;717;717;2;0;1;2;4;293;1;293;3;1;1
/org.eclipse.debug.ui/ui/org/eclipse/debug/ui/AbstractLaunchConfigurationTabGroup.java;2;0;3;1;0;0;0;3;8;2;2;40;9;9;2;1;0;3;3;40;1;164;2;2;0
/org.eclipse.help.appserver/src/org/eclipse/help/internal/appserver/WebappManager.java;1;1;7;1;3;3;3;4;92;1;4;110;140;140;1;0;0;4;7;110;0;336;7;1;0
/org.eclipse.core.filebuffers/src/org/eclipse/core/filebuffers/ISynchronizationContext.java;2;0;3;2;2;1;2;1;50;0;1;115;50;50;2;0;1;1;3;334;1;334;2;2;0
/org.eclipse.ui.forms/src/org/eclipse/ui/internal/forms/widgets/ParagraphSegment.java;1;1;2;1;2;2;2;0;6;0;0;272;6;6;1;0;0;0;2;272;0;336;2;1;0
/org.eclipse.jdt.ui/ui refactoring/org/eclipse/jdt/internal/ui/refactoring/contentassist/FieldNameProcessor.java;1;0;1;1;1;1;1;0;0;0;0;281;0;0;1;0;0;0;1;281;0;281;1;1;0
/org.eclipse.ui.workbench/Eclipse UI/org/eclipse/ui/internal/TrimDropTarget.java;4;0;10;3;0;0;0;10;194;4;5;205;297;297;4;5;0;10;10;223;5;270;5;4;0
/org.eclipse.update.ui/src_webapp/org/eclipse/update/internal/ui/servlets/ServletsUtil.java;2;0;3;1;1;1;1;2;6;1;2;58;18;18;1;0;0;2;3;58;0;336;3;2;0
/org.eclipse.jface/src/org/eclipse/jface/viewers/TreeViewer.java;3;2;9;1;4;3;4;5;54;2;4;141;161;161;2;1;1;5;9;141;2;325;7;3;2
/org.eclipse.jdt.ui/ui/org/eclipse/jdt/internal/ui/viewsupport/FilterUpdater.java;1;0;1;1;1;1;1;0;2;0;0;336;2;2;1;0;0;0;1;336;0;336;1;1;0
/org.eclipse.help.base/src/org/eclipse/help/internal/search/IndexingOperation.java;1;2;10;1;4;3;4;6;94;3;4;104;172;172;3;2;1;6;10;104;3;336;7;1;0
/org.eclipse.swt/Eclipse SWT/motif/org/eclipse/swt/widgets/Scale.java;3;1;5;1;2;2;2;3;26;2;2;19;60;60;2;1;0;3;5;135;1;337;4;3;0
/org.eclipse.jdt.core/codeassist/org/eclipse/jdt/internal/codeassist/select/SelectionOnImportReference.java;2;0;3;1;0;0;0;3;14;1;3;7;20;20;1;0;0;3;3;7;0;199;3;2;0
/org.eclipse.compare/compare/org/eclipse/compare/rangedifferencer/IRangeComparator.java;1;0;1;1;0;0;0;1;2;0;1;219;2;2;1;0;0;1;1;219;0;219;1;1;0
/org.eclipse.jdt.core/dom/org/eclipse/jdt/core/dom/TypeDeclarationStatement.java;3;0;13;1;1;1;5;8;199;6;5;199;277;277;6;3;4;12;13;266;7;308;6;3;2
/org.eclipse.ui.ide/src/org/eclipse/ui/views/tasklist/TaskListContentProvider.java;1;0;1;1;0;0;0;1;0;0;1;129;0;0;1;0;0;1;1;129;0;129;1;1;0
/org.eclipse.swt/Eclipse SWT PI/photon/org/eclipse/swt/internal/photon/PtWebWindowCallback_t.java;2;0;2;1;1;1;1;1;4;0;1;203;4;4;1;0;0;1;2;203;0;337;2;2;0
/org.eclipse.jdt.core/dom/org/eclipse/jdt/core/dom/ImportDeclaration.java;3;0;11;1;3;1;3;8;226;2;5;199;303;303;3;3;2;8;11;276;5;276;6;3;2
/org.eclipse.swt/Eclipse SWT/photon/org/eclipse/swt/widgets/Decorations.java;4;1;5;1;2;2;2;3;61;1;3;8;88;88;1;0;0;3;5;8;0;337;5;4;0
/org.eclipse.core.resources/src_ant/org/eclipse/core/resources/ant/IncrementalBuild.java;1;0;2;1;2;1;2;0;146;0;0;274;146;146;2;0;1;0;2;274;1;274;1;1;1
/org.eclipse.jdt.core/dom/org/eclipse/jdt/core/dom/SynchronizedStatement.java;3;0;8;1;2;1;2;6;111;2;5;199;159;159;2;1;1;6;8;266;2;276;6;3;1
/org.eclipse.pde.core/src/org/eclipse/pde/internal/core/schema/Schema.java;3;1;9;1;3;3;3;6;379;2;5;71;655;655;2;1;0;6;9;166;1;336;8;3;0
/org.eclipse.core.resources/src/org/eclipse/core/resources/ProjectScope.java;1;0;6;1;0;0;1;5;26;3;3;239;54;54;3;2;1;6;6;250;3;270;3;1;1
/org.eclipse.jdt.core/compiler/org/eclipse/jdt/internal/compiler/util/Util.java;4;2;11;1;3;2;3;8;77;2;7;1;242;242;2;1;1;8;11;149;2;299;9;4;2
/org.eclipse.ui.presentations.r21/src/org/eclipse/ui/internal/presentations/R21EditorStackPresentation.java;2;1;2;1;2;2;2;0;3;0;0;323;3;3;1;0;0;0;2;323;0;331;2;2;0
/org.eclipse.jdt.ui/core refactoring/org/eclipse/jdt/internal/corext/refactoring/reorg/JavaElementTransfer.java;3;0;3;1;1;1;1;2;6;1;2;70;8;8;1;0;0;2;3;70;0;336;3;3;0
/org.eclipse.jdt.debug.ui/ui/org/eclipse/jdt/internal/debug/ui/snippeteditor/SnippetEditorPropertyPage.java;3;2;5;2;3;2;3;2;85;1;2;71;115;115;2;0;1;2;5;296;1;336;4;3;0
/org.eclipse.pde.ui/src/org/eclipse/pde/internal/ui/search/DependencyExtentSearchResultCollector.java;3;1;4;1;2;2;2;2;20;0;1;128;29;29;2;1;0;2;4;128;1;336;3;3;0
/org.eclipse.update.core/src/org/eclipse/update/standalone/InstallCommand.java;1;2;7;1;5;4;5;2;146;1;2;54;211;211;2;0;1;2;7;303;1;336;6;1;1
/org.eclipse.swt/Eclipse SWT Drag and Drop/motif/org/eclipse/swt/dnd/TableDragUnderEffect.java;1;0;1;1;0;0;0;1;80;0;1;53;80;80;1;0;0;1;1;53;0;53;1;1;0
/org.eclipse.help/src/org/eclipse/help/IHelpResource.java;1;1;4;1;3;3;3;1;53;0;1;45;71;71;1;0;0;1;4;45;0;336;4;1;0
/org.eclipse.team.cvs.ui/src/org/eclipse/team/internal/ccvs/ui/subscriber/MergeUpdateOperation.java;2;1;4;1;2;2;2;2;20;0;1;244;33;33;2;1;0;2;4;244;1;336;3;2;0
/org.eclipse.jface/src/org/eclipse/jface/action/StatusLine.java;4;0;4;1;1;1;1;3;9;1;3;124;20;20;1;0;0;3;4;124;0;336;4;4;0
/org.eclipse.ui.ide/extensions/org/eclipse/ui/actions/QuickStartAction.java;4;2;10;2;5;4;5;5;30;4;2;132;65;65;4;3;1;5;10;154;4;336;6;4;1
/org.eclipse.team.cvs.ui/src/org/eclipse/team/internal/ccvs/ui/actions/EditorsAction.java;1;0;2;1;1;1;1;1;36;0;1;208;62;62;1;0;0;1;2;208;0;321;2;1;0
/org.eclipse.jface/src/org/eclipse/jface/viewers/ArrayContentProvider.java;1;0;1;1;0;0;0;1;9;0;1;176;9;9;1;0;0;1;1;176;0;176;1;1;0
/org.eclipse.pde.core/src/org/eclipse/pde/core/plugin/IMatchRules.java;3;1;3;1;3;3;3;0;78;0;0;276;94;94;1;0;0;0;3;276;0;336;3;3;0
/org.eclipse.jface/src/org/eclipse/jface/action/ActionContributionItem.java;7;6;29;3;9;3;9;20;1478;5;8;2;2817;2817;6;12;6;20;29;282;18;330;11;7;2
/org.eclipse.core.runtime/src/org/osgi/service/prefs/PreferencesService.java;1;0;1;1;1;1;1;0;0;0;0;294;0;0;1;0;0;0;1;294;0;294;1;1;0
/org.eclipse.jdt.ui/ui/org/eclipse/jdt/internal/ui/preferences/CodeTemplatePreferencePage.java;2;0;2;1;1;1;1;1;645;0;1;253;647;647;1;0;0;1;2;253;0;336;2;2;0
/org.eclipse.jface.text/src/org/eclipse/jface/contentassist/TextContentAssistSubjectAdapter.java;1;2;3;1;3;2;3;0;62;0;0;279;68;68;2;0;1;0;3;279;1;336;2;1;0
/org.eclipse.jdt.core/search/org/eclipse/jdt/internal/core/search/matching/TypeDeclarationPattern.java;3;0;14;2;2;1;2;12;308;2;10;38;1099;1099;2;2;1;12;14;70;3;280;11;3;1
/org.eclipse.jdt.ui/core refactoring/org/eclipse/jdt/internal/corext/refactoring/changes/PackageFragmentRootReorgChange.java;4;1;7;2;2;2;2;5;45;2;4;41;80;80;2;1;0;5;7;251;1;336;6;4;0
/org.eclipse.ui.workbench/Eclipse UI/org/eclipse/ui/internal/PageEventAction.java;1;0;2;1;0;0;0;2;61;0;1;157;61;61;2;1;0;2;2;157;1;157;1;1;0
/org.eclipse.jdt.core/eval/org/eclipse/jdt/internal/eval/CodeSnippetAllocationExpression.java;3;0;6;1;0;0;0;6;86;1;6;3;134;134;1;0;0;6;6;3;0;199;6;3;3
/org.eclipse.ui.workbench/Eclipse UI/org/eclipse/ui/contexts/ContextManagerEvent.java;4;1;8;2;2;2;2;6;324;2;4;71;459;459;2;2;0;6;8;224;2;336;6;4;0
/org.eclipse.debug.core/core/org/eclipse/debug/core/sourcelookup/containers/CompositeSourceContainer.java;1;0;4;1;1;1;3;1;45;0;1;268;72;72;3;0;2;3;4;268;2;314;2;1;1
/org.eclipse.jdt.core/search/org/eclipse/jdt/core/search/LocalVariableDeclarationMatch.java;2;0;7;2;3;1;3;4;31;2;2;218;59;59;3;2;2;4;7;275;4;275;3;2;0
/org.eclipse.ui.workbench/Eclipse UI/org/eclipse/ui/internal/PagePartSelectionTracker.java;2;1;3;1;2;2;2;1;21;0;1;68;43;43;1;0;0;1;3;68;0;336;3;2;0
/org.eclipse.ui.presentations.r21/src/org/eclipse/ui/internal/presentations/r21/R21PresentationPlugin.java;1;1;2;1;2;2;2;0;10;0;0;323;10;10;1;0;0;0;2;323;0;336;2;1;0
/org.eclipse.ui.workbench/Eclipse UI/org/eclipse/ui/internal/progress/ProgressViewerLabelProvider.java;1;0;3;1;1;1;1;2;53;0;1;237;55;55;2;1;0;2;3;237;1;283;2;1;0
/org.eclipse.update.core/src/org/eclipse/update/internal/core/URLEncoder.java;1;0;1;1;0;0;0;1;9;0;1;58;9;9;1;0;0;1;1;58;0;58;1;1;0
/org.eclipse.ui.cheatsheets/src/org/eclipse/ui/internal/cheatsheets/registry/CheatSheetElement.java;3;2;6;2;3;2;3;3;43;2;2;243;87;87;2;1;1;3;6;253;2;317;4;3;0
/org.eclipse.text/src/org/eclipse/jface/text/templates/TemplateVariable.java;2;0;8;2;2;1;2;6;239;5;2;234;273;273;5;4;1;6;8;234;5;334;3;2;0
/org.eclipse.debug.ui/ui/org/eclipse/debug/internal/ui/launchConfigurations/FavoritesDialog.java;3;0;5;2;1;1;1;4;42;2;3;134;53;53;2;1;0;4;5;149;1;280;4;3;0
/org.eclipse.pde.ui/src/org/eclipse/pde/internal/ui/wizards/feature/NewFeaturePatchWizard.java;2;5;10;2;10;3;10;0;1564;0;0;298;1676;1676;5;0;7;0;10;325;7;325;3;2;0
/org.eclipse.text/src/org/eclipse/jface/text/AbstractLineTracker.java;2;0;2;1;1;1;1;1;37;0;1;82;39;39;1;0;0;1;2;82;0;334;2;2;0
/org.eclipse.jdt.core/search/org/eclipse/jdt/internal/core/search/indexing/RemoveFromIndex.java;2;0;6;1;1;1;1;5;13;1;5;60;29;29;1;0;0;5;6;60;0;302;6;2;0
/org.eclipse.pde.core/src/org/eclipse/pde/core/IIdentifiable.java;3;1;5;1;4;4;4;1;24;0;1;232;34;34;1;0;0;1;5;232;0;336;5;3;0
/org.eclipse.jdt.ui/ui/org/eclipse/jdt/internal/ui/javaeditor/JavaSelectRulerAction.java;1;0;2;1;1;1;1;1;2;0;1;268;4;4;1;0;0;1;2;268;0;336;2;1;0
/org.eclipse.jdt.debug/model/org/eclipse/jdt/internal/debug/core/hcr/JavaHotCodeReplaceManager.java;4;1;10;2;3;3;3;7;26;3;4;26;89;89;3;3;0;7;10;172;3;336;7;4;5
/org.eclipse.ui.cheatsheets/src/org/eclipse/ui/cheatsheets/ICheatSheetAction.java;2;0;5;1;2;1;2;3;54;2;2;243;80;80;2;1;1;3;5;253;2;276;3;2;0
/org.eclipse.ui.workbench/Eclipse UI/org/eclipse/ui/internal/registry/IViewRegistry.java;3;1;3;1;2;2;2;1;4;0;1;157;8;8;1;0;0;1;3;157;0;336;3;3;0
/org.eclipse.jdt.ui/ui/org/eclipse/jdt/internal/ui/wizards/buildpaths/SourceContainerWorkbookPage.java;3;1;10;2;4;4;4;6;99;2;5;81;244;244;2;1;0;6;10;81;1;336;9;3;0
/org.eclipse.core.expressions/src/org/eclipse/core/internal/expressions/PropertyCache.java;1;1;3;1;2;2;2;1;12;0;1;227;14;14;1;0;0;1;3;227;0;336;3;1;0
/org.eclipse.jdt.ui/core refactoring/org/eclipse/jdt/internal/corext/refactoring/AbstractJavaElementRenameChange.java;3;0;8;2;1;1;1;7;88;3;4;207;310;310;3;3;0;7;8;245;3;336;5;3;0
/org.eclipse.debug.core/core/org/eclipse/debug/core/sourcelookup/containers/DirectorySourceContainer.java;1;0;2;1;0;0;1;1;19;0;1;268;19;19;2;0;1;2;2;268;1;268;1;1;0
/org.eclipse.core.resources/src/org/eclipse/core/internal/events/ResourceComparator.java;2;1;3;1;2;2;2;1;224;0;1;151;235;235;1;0;0;1;3;151;0;303;3;2;1
/org.eclipse.jdt.ui/core refactoring/org/eclipse/jdt/internal/corext/refactoring/code/flow/FlowContext.java;2;0;2;1;1;1;1;1;5;0;1;41;7;7;1;0;0;1;2;41;0;336;2;2;0
/org.eclipse.pde.core/src/org/eclipse/pde/internal/core/PDEPluginConverter.java;3;2;5;2;5;4;5;0;10;0;0;298;20;20;2;0;1;0;5;309;1;336;4;3;0
/org.eclipse.debug.ui/ui/org/eclipse/debug/internal/ui/WorkingDirectoryStatusHandler.java;1;0;1;1;0;0;0;1;3;0;1;144;3;3;1;0;0;1;1;144;0;144;1;1;0
/org.eclipse.jdt.core/formatter/org/eclipse/jdt/core/formatter/CodeFormatter.java;3;0;6;2;1;1;1;5;13;3;3;128;22;22;3;2;0;5;6;128;2;323;4;3;0
/org.eclipse.ui.ide/src/org/eclipse/ui/internal/ide/dialogs/CreateLinkedResourceGroup.java;1;0;1;1;0;0;0;1;0;0;1;132;0;0;1;0;0;1;1;132;0;132;1;1;1
/org.eclipse.update.core/src/org/eclipse/update/core/PluginEntry.java;3;1;5;1;3;3;3;2;6;1;2;0;20;20;1;0;0;2;5;0;0;336;5;3;0
/org.eclipse.jdt.debug/jdi/org/eclipse/jdi/internal/jdwp/JdwpCommandPacket.java;1;0;2;1;0;0;0;2;7;1;2;16;10;10;1;0;0;2;2;16;0;235;2;1;0
/org.eclipse.ant.ui/Ant Editor/org/eclipse/ant/internal/ui/editor/derived/SingleCharReader.java;1;1;3;1;2;2;2;1;5;0;1;108;9;9;1;0;0;1;3;108;0;336;3;1;0
/org.eclipse.debug.ui/ui/org/eclipse/debug/ui/actions/OpenLaunchDialogAction.java;3;1;5;1;2;2;2;3;46;1;3;15;60;60;1;0;0;3;5;15;0;336;5;3;0
/org.eclipse.jdt.debug/model/org/eclipse/jdt/internal/debug/core/model/JDIVoidValue.java;1;0;1;1;0;0;0;1;6;0;1;144;6;6;1;0;0;1;1;144;0;144;1;1;0
/org.eclipse.jdt.core/compiler/org/eclipse/jdt/internal/compiler/classfmt/InnerClassInfo.java;2;0;2;1;0;0;0;2;3;1;2;124;5;5;1;0;0;2;2;124;0;199;2;2;0
/org.eclipse.jdt.core/model/org/eclipse/jdt/internal/core/builder/IncrementalImageBuilder.java;4;0;15;2;0;0;0;15;66;3;10;8;164;164;3;5;0;15;15;156;5;258;10;4;0
/org.eclipse.jdt.ui/ui/org/eclipse/jdt/internal/ui/wizards/OpenTypeWizardAction.java;2;1;2;1;2;2;2;0;3;0;0;289;5;5;1;0;0;0;2;289;0;336;2;2;1
/org.eclipse.pde.ui/src/org/eclipse/pde/internal/ui/editor/plugin/PluginUndoManager.java;2;5;6;2;6;2;6;0;40;0;0;292;44;44;5;0;4;0;6;292;4;336;2;2;0
/org.eclipse.jdt.ui/core refactoring/org/eclipse/jdt/internal/corext/refactoring/code/flow/GenericSequentialFlowInfo.java;1;0;1;1;1;1;1;0;2;0;0;336;2;2;1;0;0;0;1;336;0;336;1;1;0
/org.eclipse.search/search/org/eclipse/search/internal/ui/text/FileSearchResult.java;1;0;3;1;1;1;1;2;30;1;2;207;39;39;1;0;0;2;3;207;0;279;3;1;0
/org.eclipse.swt/Eclipse SWT/photon/org/eclipse/swt/widgets/Tracker.java;5;1;18;2;3;3;3;15;194;3;11;8;398;398;3;4;0;15;18;101;4;337;14;5;0
/org.eclipse.core.resources/src/org/eclipse/core/internal/resources/Project.java;3;2;23;2;7;4;9;14;1905;4;8;13;2225;2225;4;6;5;16;23;139;11;326;12;3;1
/org.eclipse.debug.ui/ui/org/eclipse/debug/internal/ui/views/variables/IndexedValuePartition.java;3;0;4;2;1;1;1;3;13;2;2;148;30;30;2;1;0;3;4;148;1;336;3;3;0
/org.eclipse.ui.workbench/Eclipse UI/org/eclipse/ui/internal/keys/FormalKeyFormatter.java;1;0;2;1;0;0;0;2;7;0;1;187;7;7;2;1;0;2;2;187;1;187;1;1;0
/org.eclipse.jdt.debug.ui/ui/org/eclipse/jdt/internal/debug/ui/StatusInfo.java;2;0;2;1;1;1;1;1;4;0;1;197;4;4;1;0;0;1;2;197;0;336;2;2;0
/org.eclipse.jdt.core/search/org/eclipse/jdt/core/search/SearchDocument.java;3;3;10;2;5;3;5;5;121;3;3;181;179;179;3;2;2;5;10;181;4;329;6;3;0
/org.eclipse.pde.ui/src/org/eclipse/pde/internal/ui/launcher/AdvancedLauncherTab.java;2;1;15;1;2;2;2;13;577;2;9;26;1780;1780;2;4;0;13;15;50;4;336;11;2;0
/org.eclipse.jdt.core/model/org/eclipse/jdt/internal/core/util/ExceptionAttribute.java;1;0;1;1;0;0;0;1;2;0;1;199;2;2;1;0;0;1;1;199;0;199;1;1;0
/org.eclipse.swt/Eclipse SWT/motif/org/eclipse/swt/widgets/Widget.java;6;0;18;2;1;1;1;17;271;3;10;6;660;660;3;7;0;17;18;18;7;337;11;6;0
/org.eclipse.pde.ui/src/org/eclipse/pde/internal/ui/view/PluginsView.java;3;3;13;3;6;3;6;7;24;1;7;26;70;70;3;0;3;7;13;302;3;331;10;3;0
/org.eclipse.swt/Eclipse SWT PI/carbon/org/eclipse/swt/internal/carbon/NavDialogCreationOptions.java;1;0;2;1;2;1;2;0;20;0;0;296;20;20;2;0;1;0;2;296;1;296;1;1;0
/org.eclipse.team.cvs.core/src/org/eclipse/team/internal/ccvs/core/resources/EclipseSynchronizer.java;2;5;31;2;7;3;7;24;1405;11;8;20;2048;2048;11;16;4;24;31;115;20;336;11;2;1
/org.eclipse.update.core/src/org/eclipse/update/internal/core/FeaturePackagedFactory.java;1;0;1;1;0;0;0;1;12;0;1;58;12;12;1;0;0;1;1;58;0;58;1;1;1
/org.eclipse.jdt.core/dom/org/eclipse/jdt/core/dom/LabeledStatement.java;3;0;9;1;2;1;2;7;109;2;6;164;165;165;2;1;1;7;9;266;2;276;7;3;1
/org.eclipse.jdt.ui/ui/org/eclipse/jdt/internal/ui/text/template/contentassist/TemplateInformationControlCreator.java;2;0;2;1;1;1;1;1;22;0;1;234;22;22;1;0;0;1;2;234;0;336;2;2;0
/org.eclipse.pde.runtime/src/org/eclipse/pde/internal/runtime/PDERuntimePluginImages.java;3;1;14;2;2;2;4;10;98;3;7;53;262;262;3;3;2;12;14;270;5;336;9;3;0
/org.eclipse.pde.ui/src/org/eclipse/pde/internal/ui/util/SWTUtil.java;2;0;3;1;1;1;1;2;20;1;2;50;27;27;1;0;0;2;3;50;0;336;3;2;0
/org.eclipse.core.resources/src/org/eclipse/core/internal/resources/ResourceProxy.java;1;0;1;1;1;1;1;0;21;0;0;277;21;21;1;0;0;0;1;277;0;277;1;1;0
/org.eclipse.swt/Eclipse SWT/carbon/org/eclipse/swt/widgets/TableColumn.java;3;1;7;2;2;2;2;5;311;2;4;17;366;366;2;1;0;5;7;17;1;337;6;3;0
/org.eclipse.jdt.ui/core extension/org/eclipse/jdt/internal/corext/util/TypeInfo.java;1;0;1;1;1;1;1;0;2;0;0;336;2;2;1;0;0;0;1;336;0;336;1;1;0
/org.eclipse.ui.workbench/Eclipse UI/org/eclipse/ui/contexts/IContextManager.java;4;2;24;1;3;2;3;21;133;14;6;70;375;375;14;15;1;21;24;70;16;336;8;4;0
/org.eclipse.update.ui/src/org/eclipse/update/internal/ui/model/SiteBookmark.java;3;1;8;2;2;2;2;6;35;2;4;15;122;122;2;2;0;6;8;26;2;336;6;3;0
/org.eclipse.ui.intro/src/org/eclipse/ui/internal/intro/impl/model/IntroLink.java;2;4;6;2;6;2;6;0;53;0;0;276;69;69;4;0;4;0;6;276;4;327;2;2;0
/org.eclipse.swt/Eclipse SWT/gtk/org/eclipse/swt/widgets/Menu.java;6;1;15;2;2;2;2;13;78;3;9;2;182;182;3;4;0;13;15;74;4;337;11;6;0
/org.eclipse.jdt.debug.ui/ui/org/eclipse/jdt/internal/debug/ui/TypeNameResolver.java;2;0;2;2;0;0;0;2;2;0;1;230;2;2;2;1;0;2;2;230;1;230;1;2;0
/org.eclipse.swt/Eclipse SWT Browser/mozilla/org/eclipse/swt/browser/PromptServiceFactory.java;2;0;2;1;1;1;1;1;6;0;1;264;6;6;1;0;0;1;2;264;0;337;2;2;0
/org.eclipse.compare/compare/org/eclipse/compare/internal/CompareUIPlugin.java;1;4;11;1;7;4;7;4;755;2;3;75;926;926;4;1;3;4;11;273;4;337;7;1;0
/org.eclipse.core.resources/src/org/eclipse/core/resources/ISavedState.java;1;0;2;1;0;0;1;1;142;0;1;270;142;142;2;0;1;2;2;270;1;270;1;1;0
/org.eclipse.swt/Eclipse SWT Printing/win32/org/eclipse/swt/printing/PrintDialog.java;2;1;3;1;2;2;2;1;33;0;1;238;45;45;1;0;0;1;3;238;0;337;3;2;0
/org.eclipse.jdt.ui/core refactoring/org/eclipse/jdt/internal/corext/refactoring/changes/DynamicValidationStateChange.java;1;0;2;1;2;1;2;0;169;0;0;282;169;169;2;0;1;0;2;282;1;282;1;1;0
/org.eclipse.jdt.core/model/org/eclipse/jdt/internal/core/SearchableEnvironment.java;4;2;8;2;4;3;4;4;25;2;3;70;50;50;2;1;1;4;8;199;2;313;6;4;1
/org.eclipse.team.cvs.ui/src/org/eclipse/team/internal/ccvs/ui/RemoteFileEditorInput.java;2;1;4;1;2;2;2;2;24;1;2;52;39;39;1;0;0;2;4;52;0;336;4;2;0
/org.eclipse.jface/src/org/eclipse/jface/viewers/CheckboxTreeViewer.java;2;1;4;1;3;3;3;1;40;0;1;150;75;75;1;0;0;1;4;150;0;336;4;2;0
/org.eclipse.ui.workbench/Eclipse UI/org/eclipse/ui/internal/keys/GnomeKeyFormatter.java;1;0;2;1;0;0;0;2;6;0;1;188;6;6;2;1;0;2;2;188;1;188;1;1;0
/org.eclipse.pde.ui/src/org/eclipse/pde/internal/ui/wizards/imports/PluginImportWizard.java;2;1;13;1;2;2;2;11;145;2;8;26;347;347;2;3;0;11;13;45;3;336;10;2;0
/org.eclipse.team.core/src/org/eclipse/team/internal/core/subscribers/SubscriberEventHandler.java;2;1;10;2;4;4;4;6;512;4;3;199;574;574;4;3;0;6;10;232;3;336;7;2;3
/org.eclipse.debug.ui/ui/org/eclipse/debug/internal/ui/ColorManager.java;2;1;3;1;2;2;2;1;4;0;1;246;4;4;1;0;0;1;3;246;0;336;3;2;0
/org.eclipse.swt/Eclipse SWT/common/org/eclipse/swt/events/MouseAdapter.java;2;0;2;1;1;1;1;1;4;0;1;225;6;6;1;0;0;1;2;225;0;337;2;2;0
/org.eclipse.jface.text/src/org/eclipse/jface/text/source/IAnnotationAccess.java;2;0;4;2;2;1;2;2;19;0;1;175;23;23;2;1;1;2;4;175;2;336;2;2;0
/org.eclipse.jdt.ui/ui/org/eclipse/jdt/internal/ui/packageview/PackageFragmentProvider.java;3;0;3;1;1;1;1;2;4;1;2;81;10;10;1;0;0;2;3;81;0;336;3;3;0
/org.eclipse.jdt.debug/model/org/eclipse/jdt/internal/debug/core/logicalstructures/MapEntryStructureType.java;1;0;2;1;0;0;0;2;4;0;1;152;4;4;2;1;0;2;2;152;1;152;1;1;0
/org.eclipse.jdt.core/model/org/eclipse/jdt/core/ITypeHierarchy.java;1;0;3;1;0;0;0;3;14;1;3;149;23;23;1;0;0;3;3;149;0;199;3;1;0
/org.eclipse.pde.ui/src/org/eclipse/pde/internal/ui/editor/schema/DescriptionSection.java;3;1;10;1;4;4;4;6;73;1;6;16;160;160;1;0;0;6;10;16;0;336;10;3;0
/org.eclipse.ui.workbench/Eclipse UI/org/eclipse/ui/actions/BaseSelectionListenerAction.java;2;0;4;2;1;1;1;3;138;0;1;150;181;181;3;2;0;3;4;150;2;310;2;2;0
/org.eclipse.swt/Eclipse SWT/win32/org/eclipse/swt/graphics/Cursor.java;4;1;7;2;2;2;2;5;129;2;4;18;204;204;2;1;0;5;7;18;1;337;6;4;2
/org.eclipse.jdt.ui/ui/org/eclipse/jdt/ui/actions/OpenJavaBrowsingPerspectiveAction.java;1;0;1;1;1;1;1;0;2;0;0;336;2;2;1;0;0;0;1;336;0;336;1;1;0
/org.eclipse.ui.workbench/Eclipse UI/org/eclipse/ui/internal/activities/ws/ActivityEnabler.java;3;1;11;2;3;3;3;8;283;4;3;174;505;505;4;5;0;8;11;254;5;336;6;3;3
/org.eclipse.jdt.ui/ui/org/eclipse/jdt/internal/ui/packageview/FileTransferDropAdapter.java;2;0;3;1;1;1;1;2;96;1;2;74;104;104;1;0;0;2;3;74;0;336;3;2;0
/org.eclipse.jdt.ui/ui refactoring/org/eclipse/jdt/internal/ui/refactoring/contentassist/JavaPackageCompletionProcessor.java;5;2;8;2;4;3;4;4;31;3;2;205;94;94;3;2;1;4;8;205;3;336;5;5;0
/org.eclipse.team.cvs.ui/src/org/eclipse/team/internal/ccvs/ui/operations/UpdateOperation.java;2;4;14;1;6;3;6;8;86;2;5;97;236;236;4;3;3;8;14;309;6;336;8;2;2
/org.eclipse.ui.presentations.r21/src/org/eclipse/ui/internal/presentations/r21/widgets/CTabFolderEvent.java;1;1;2;1;2;2;2;0;2;0;0;323;2;2;1;0;0;0;2;323;0;336;2;1;0
/org.eclipse.help/src/org/eclipse/help/internal/context/ContextsFile.java;1;1;3;1;2;2;2;1;30;0;1;245;50;50;1;0;0;1;3;245;0;336;3;1;0
/org.eclipse.team.cvs.core/src/org/eclipse/team/internal/ccvs/core/CVSException.java;2;0;2;2;0;0;0;2;33;0;1;52;33;33;2;1;0;2;2;52;1;52;1;2;0
/org.eclipse.pde.ui/src_Forms/org/eclipse/pde/internal/ui/model/IDocumentAttribute.java;2;2;5;2;3;2;3;2;14;1;2;244;19;19;2;0;1;2;5;298;1;336;4;2;0
/org.eclipse.team.cvs.ui/src/org/eclipse/team/internal/ccvs/ui/merge/TagRootElement.java;2;1;3;1;3;3;3;0;16;0;0;272;20;20;1;0;0;0;3;272;0;336;3;2;0
/org.eclipse.pde.core/src/org/eclipse/pde/internal/core/PDEClasspathContainer.java;2;1;2;1;2;2;2;0;4;0;0;307;4;4;1;0;0;0;2;307;0;336;2;2;0
/org.eclipse.ui.workbench/Eclipse UI/org/eclipse/ui/internal/dialogs/StartupPreferencePage.java;2;1;4;1;2;2;2;2;68;1;2;258;97;97;1;0;0;2;4;258;0;336;4;2;0
/org.eclipse.jdt.core/compiler/org/eclipse/jdt/internal/compiler/ast/FieldDeclaration.java;3;0;16;3;1;1;1;15;117;3;8;1;225;225;3;7;0;15;16;148;7;281;9;3;3
/org.eclipse.jface.text/src/org/eclipse/jface/text/source/IAnnotationAccessExtension.java;3;2;9;2;4;3;4;5;50;2;4;103;89;89;2;1;1;5;9;175;2;336;7;3;0
/org.eclipse.ui.ide/src/org/eclipse/ui/wizards/datatransfer/Base64Encoder.java;1;0;1;1;0;0;0;1;0;0;1;92;0;0;1;0;0;1;1;92;0;92;1;1;0
/org.eclipse.pde.ui/src/org/eclipse/pde/ui/templates/AbstractTemplateSection.java;3;2;10;1;6;5;6;4;292;1;4;149;534;534;2;0;1;4;10;276;1;336;9;3;0
/org.eclipse.ui.workbench.texteditor/src/org/eclipse/ui/texteditor/InsertLineAction.java;3;1;2;2;2;2;2;0;6;0;0;279;6;6;1;0;0;0;2;279;0;336;2;3;0
/org.eclipse.pde.runtime/src/org/eclipse/pde/internal/runtime/registry/LibraryPropertySource.java;2;1;5;1;2;2;2;3;96;2;2;59;215;215;2;1;0;3;5;224;1;336;4;2;0
/org.eclipse.swt/Eclipse SWT PI/photon/org/eclipse/swt/internal/photon/PtTextCallback_t.java;1;0;1;1;0;0;0;1;2;0;1;53;2;2;1;0;0;1;1;53;0;53;1;1;0
/org.eclipse.ui.workbench/Eclipse UI/org/eclipse/ui/internal/keys/EmacsKeyFormatter.java;1;0;2;1;0;0;0;2;6;0;1;187;6;6;2;1;0;2;2;187;1;187;1;1;0
/org.eclipse.swt/Eclipse SWT/win32/org/eclipse/swt/graphics/GCData.java;2;0;3;1;0;0;0;3;2;1;3;24;6;6;1;0;0;3;3;24;0;150;3;2;0
/org.eclipse.pde.runtime/src/org/eclipse/pde/internal/runtime/OverlayIcon.java;1;0;1;1;0;0;0;1;7;0;1;59;7;7;1;0;0;1;1;59;0;59;1;1;0
/org.eclipse.ui.ide/src/org/eclipse/ui/internal/ide/dialogs/InternalErrorDialog.java;1;0;1;1;0;0;0;1;0;0;1;132;0;0;1;0;0;1;1;132;0;132;1;1;0
/org.eclipse.jdt.core/eval/org/eclipse/jdt/internal/eval/IRequestor.java;1;0;1;1;0;0;0;1;2;0;1;199;2;2;1;0;0;1;1;199;0;199;1;1;0
/org.eclipse.pde.ui/src/org/eclipse/pde/internal/ui/wizards/imports/FeatureImportWizardDetailedPage.java;2;1;6;1;3;3;3;3;283;1;3;26;314;314;1;0;0;3;6;26;0;336;6;2;0
/org.eclipse.ant.ui/Ant Tools Support/org/eclipse/ant/internal/ui/preferences/AntClasspathLabelProvider.java;1;1;6;1;2;2;2;4;103;2;3;108;136;136;2;1;0;4;6;147;1;299;5;1;1
/org.eclipse.help/src/org/eclipse/help/internal/context/ContextsFileParser.java;1;1;7;1;4;4;4;3;84;1;3;139;182;182;1;0;0;3;7;139;0;336;7;1;0
/org.eclipse.core.resources/src/org/eclipse/core/internal/resources/SyncInfoReader_2.java;1;0;1;1;1;1;1;0;124;0;0;277;124;124;1;0;0;0;1;277;0;277;1;1;0
/org.eclipse.swt/Eclipse SWT/photon/org/eclipse/swt/widgets/Slider.java;3;1;6;1;2;2;2;4;45;2;3;2;94;94;2;1;0;4;6;179;1;337;5;3;0
/org.eclipse.swt/Eclipse SWT Drag and Drop/gtk/org/eclipse/swt/dnd/RTFTransfer.java;3;0;3;1;1;1;1;2;61;1;2;23;69;69;1;0;0;2;3;23;0;337;3;3;0
/org.eclipse.update.core/src/org/eclipse/update/search/BaseFilter.java;1;1;5;1;2;2;2;3;7;1;3;54;11;11;1;0;0;3;5;54;0;336;5;1;0
/org.eclipse.jdt.ui/ui/org/eclipse/jdt/internal/ui/viewsupport/MemberFilterAction.java;1;0;1;1;1;1;1;0;2;0;0;336;2;2;1;0;0;0;1;336;0;336;1;1;0
/org.eclipse.jdt.ui/ui/org/eclipse/jdt/internal/ui/text/comment/IBorderAttributes.java;2;0;2;1;1;1;1;1;6;0;1;119;6;6;1;0;0;1;2;119;0;336;2;2;0
/org.eclipse.team.ui/src/org/eclipse/team/internal/ui/synchronize/RefreshSubscriberJob.java;2;11;14;2;14;3;14;0;458;0;0;288;491;491;11;0;11;0;14;288;11;332;3;2;1
/org.eclipse.update.core/src/org/eclipse/update/core/FeatureReference.java;3;2;6;1;4;3;4;2;16;1;2;58;52;52;2;0;1;2;6;289;1;336;5;3;0
/org.eclipse.swt/Eclipse SWT PI/motif/org/eclipse/swt/internal/motif/XCrossingEvent.java;1;0;2;1;0;0;0;2;23;0;1;54;23;23;2;1;0;2;2;54;1;54;1;1;0
/org.eclipse.update.configurator/src/org/eclipse/update/internal/configurator/FullFeatureParser.java;1;0;6;1;3;1;4;2;39;0;1;268;66;66;3;1;3;3;6;268;4;293;2;1;0
/org.eclipse.jdt.core/dom/org/eclipse/jdt/core/dom/MethodInvocation.java;3;0;10;2;3;1;3;7;125;4;4;199;297;297;4;3;2;7;10;258;5;276;5;3;2
/org.eclipse.jdt.core/search/org/eclipse/jdt/internal/core/search/PathCollector.java;1;0;2;1;0;0;0;2;127;1;2;181;129;129;1;0;0;2;2;181;0;199;2;1;0
/org.eclipse.pde.ui/src/org/eclipse/pde/internal/ui/editor/text/XMLSourceViewerConfiguration.java;1;1;3;1;3;3;3;0;10;0;0;292;12;12;1;0;0;0;3;292;0;336;3;1;0
/org.eclipse.jdt.ui/core refactoring/org/eclipse/jdt/internal/corext/refactoring/rename/JavaRenameProcessor.java;1;0;6;1;2;1;2;4;69;3;2;253;141;141;3;2;1;4;6;253;3;275;3;1;0
/org.eclipse.ui.ide/src/org/eclipse/ui/wizards/datatransfer/ImportOperation.java;1;0;1;1;0;0;0;1;0;0;1;92;0;0;1;0;0;1;1;92;0;92;1;1;1
/org.eclipse.ui.workbench/Eclipse UI/org/eclipse/ui/actions/ExportResourcesAction.java;4;0;4;2;1;1;1;3;118;1;3;157;147;147;1;0;0;3;4;157;0;336;4;4;0
/org.eclipse.swt/Eclipse SWT/gtk/org/eclipse/swt/widgets/Button.java;7;2;21;3;3;2;3;18;157;8;10;4;238;238;8;8;1;18;21;70;9;332;12;7;2
/org.eclipse.swt/Eclipse SWT Printing/common/org/eclipse/swt/printing/PrinterData.java;1;0;2;1;0;0;0;2;2;1;2;135;4;4;1;0;0;2;2;135;0;143;2;1;0
/org.eclipse.jdt.core/compiler/org/eclipse/jdt/internal/compiler/impl/DoubleConstant.java;2;0;3;1;1;1;1;2;6;1;2;70;10;10;1;0;0;2;3;70;0;299;3;2;0
/org.eclipse.ui.ide/extensions/org/eclipse/ui/dialogs/WizardDataTransferPage.java;3;1;3;1;2;2;2;1;2;0;1;132;4;4;1;0;0;1;3;132;0;336;3;3;0
/org.eclipse.core.resources/src/org/eclipse/core/resources/IncrementalProjectBuilder.java;2;1;10;2;3;3;3;7;511;3;4;119;594;594;3;3;0;7;10;174;3;313;7;2;0
/org.eclipse.jdt.core/compiler/org/eclipse/jdt/internal/compiler/parser/Parser.java;6;2;69;5;7;4;7;62;10477;19;11;1;17349;17349;19;51;3;62;69;46;54;326;15;6;14
/org.eclipse.core.resources/src/org/eclipse/core/resources/IResourceProxy.java;1;0;2;1;0;0;1;1;37;0;1;270;37;37;2;0;1;2;2;270;1;270;1;1;0
/org.eclipse.ui.workbench/Eclipse UI/org/eclipse/ui/internal/keys/NativeModifierKeyComparator.java;1;0;1;1;0;0;0;1;0;0;1;187;0;0;1;0;0;1;1;187;0;187;1;1;0
/org.eclipse.text/src/org/eclipse/jface/text/link/LinkedModeModel.java;3;3;5;2;5;2;5;0;29;0;0;276;44;44;3;0;3;0;5;276;3;334;2;3;0
/org.eclipse.pde.core/src/org/eclipse/pde/internal/core/schema/SchemaCompositor.java;3;1;4;1;2;2;2;2;43;1;2;232;55;55;1;0;0;2;4;232;0;336;4;3;0
/org.eclipse.ui.workbench.texteditor/src/org/eclipse/ui/internal/texteditor/quickdiff/QuickDiffMessages.java;2;0;3;1;1;1;1;2;6;1;2;100;8;8;1;0;0;2;3;100;0;336;3;2;0
/org.eclipse.update.core/src/org/eclipse/update/internal/operations/OperationValidator.java;2;4;26;2;5;2;6;20;581;4;11;54;1593;1593;4;9;4;21;26;124;13;336;13;2;1
/org.eclipse.jface.text/src/org/eclipse/jface/text/source/IOverviewRuler.java;2;0;2;2;2;1;2;0;8;0;0;336;8;8;2;0;1;0;2;336;1;336;1;2;0
/org.eclipse.ant.ui/Ant Tools Support/org/eclipse/ant/internal/ui/launchConfigurations/TargetTableLabelProvider.java;1;0;4;1;1;1;1;3;4;2;2;108;7;7;2;1;0;3;4;108;1;336;3;1;2
/org.eclipse.text/src/org/eclipse/jface/text/SequentialRewriteTextStore.java;2;1;3;1;2;2;2;1;15;0;1;125;18;18;1;0;0;1;3;125;0;334;3;2;0
/org.eclipse.jdt.ui/ui/org/eclipse/jdt/internal/ui/search/OccurrencesSearchLabelProvider.java;3;1;3;1;2;2;2;1;6;0;1;266;8;8;1;0;0;1;3;266;0;336;3;3;0
/org.eclipse.jdt.ui/ui/org/eclipse/jdt/internal/ui/actions/OpenTypeInHierarchyAction.java;1;0;1;1;1;1;1;0;2;0;0;336;2;2;1;0;0;0;1;336;0;336;1;1;0
/org.eclipse.team.cvs.ui/src/org/eclipse/team/internal/ccvs/ui/subscriber/WorkspaceUpdateOperation.java;2;1;4;1;2;2;2;2;10;0;1;244;14;14;2;1;0;2;4;244;1;336;3;2;0
/org.eclipse.jdt.core/model/org/eclipse/jdt/core/util/IConstantPool.java;1;0;1;1;0;0;0;1;2;0;1;199;2;2;1;0;0;1;1;199;0;199;1;1;0
/org.eclipse.ui.ide/extensions/org/eclipse/ui/dialogs/ProjectLocationSelectionDialog.java;2;1;3;1;2;2;2;1;22;0;1;132;26;26;1;0;0;1;3;132;0;336;3;2;0
/org.eclipse.ui.workbench/Eclipse UI/org/eclipse/ui/internal/util/PrefUtil.java;1;0;1;1;1;1;1;0;0;0;0;293;0;0;1;0;0;0;1;293;0;293;1;1;0
/org.eclipse.pde.ui/src/org/eclipse/pde/internal/ui/preferences/SourceCodeLocationsPreferenceNode.java;2;1;3;1;2;2;2;1;4;0;1;222;8;8;1;0;0;1;3;222;0;336;3;2;0
/org.eclipse.jdt.ui/ui/org/eclipse/jdt/ui/actions/MemberFilterActionGroup.java;2;0;5;1;1;1;1;4;192;2;3;82;231;231;2;1;0;4;5;142;1;336;4;2;0
/org.eclipse.ui.intro/src/org/eclipse/ui/internal/intro/impl/presentations/FormIntroPartImplementation.java;2;10;19;2;19;3;19;0;781;0;0;276;1020;1020;10;0;16;0;19;305;16;327;3;2;0
/org.eclipse.pde.ui/src/org/eclipse/pde/internal/ui/wizards/plugin/PluginFieldData.java;2;1;3;1;2;2;2;1;10;0;1;222;14;14;1;0;0;1;3;222;0;336;3;2;0
/org.eclipse.pde.ui/src/org/eclipse/pde/internal/ui/build/BuildSiteJob.java;2;2;5;2;5;4;5;0;51;0;0;272;72;72;2;0;1;0;5;326;1;336;4;2;0
/org.eclipse.swt/Eclipse SWT Drag and Drop/gtk/org/eclipse/swt/dnd/TextTransfer.java;3;0;4;1;1;1;1;3;100;1;3;23;118;118;1;0;0;3;4;23;0;337;4;3;0
/org.eclipse.ui.ide/src/org/eclipse/ui/views/markers/internal/IFilter.java;1;0;1;1;0;0;0;1;0;0;1;129;0;0;1;0;0;1;1;129;0;129;1;1;0
/org.eclipse.jdt.debug/model/org/eclipse/jdt/debug/core/IJavaThread.java;3;1;4;1;2;2;2;2;15;1;2;81;37;37;1;0;0;2;4;81;0;336;4;3;0
/org.eclipse.jdt.ui/ui/org/eclipse/jdt/internal/ui/viewsupport/ISelectionListenerWithAST.java;2;0;2;1;1;1;1;1;2;0;1;165;2;2;1;0;0;1;2;165;0;336;2;2;0
/org.eclipse.ant.ui/Ant Tools Support/org/eclipse/ant/internal/ui/views/actions/EditorImageDescriptor.java;1;1;4;1;2;2;2;2;10;1;2;108;23;23;1;0;0;2;4;108;0;336;4;1;0
/org.eclipse.help.ui/src/org/eclipse/help/ui/internal/HelpUIPlugin.java;1;2;15;1;4;3;4;11;135;4;4;106;239;239;4;7;1;11;15;156;8;336;7;1;0
/org.eclipse.ant.ui/Ant Editor/org/eclipse/ant/internal/ui/editor/outline/AntEditorContentOutlinePage.java;2;0;23;2;3;1;3;20;440;7;6;108;1028;1028;7;14;2;20;23;232;16;294;7;2;5
/org.eclipse.jdt.ui/ui/org/eclipse/jdt/internal/ui/javaeditor/selectionactions/SelectionHistory.java;1;0;1;1;1;1;1;0;2;0;0;336;2;2;1;0;0;0;1;336;0;336;1;1;0
/org.eclipse.debug.ui/ui/org/eclipse/debug/internal/ui/views/launch/LaunchViewer.java;5;0;6;2;1;1;1;5;68;2;4;71;138;138;2;1;0;5;6;128;1;336;5;5;0
/org.eclipse.jdt.core/model/org/eclipse/jdt/internal/core/hierarchy/TypeHierarchy.java;4;1;23;3;2;2;2;21;232;6;10;5;719;719;6;11;0;21;23;62;11;314;12;4;0
/org.eclipse.pde.ui/src/org/eclipse/pde/ui/templates/OptionTemplateSection.java;3;2;6;1;5;4;5;1;216;0;1;159;377;377;2;0;1;1;6;276;1;336;5;3;0
/org.eclipse.jdt.ui/core refactoring/org/eclipse/jdt/internal/corext/refactoring/changes/RenameSourceFolderChange.java;2;0;5;1;1;1;1;4;28;2;3;207;38;38;2;1;0;4;5;219;1;336;4;2;0
/org.eclipse.jdt.core/model/org/eclipse/jdt/core/jdom/IDOMNode.java;2;0;3;1;1;1;1;2;40;1;2;199;45;45;1;0;0;2;3;199;0;299;3;2;0
/org.eclipse.ui.ide/src/org/eclipse/ui/wizards/datatransfer/ZipFileImportWizard.java;2;0;3;1;0;0;0;3;17;2;2;92;17;17;2;1;0;3;3;132;1;132;2;2;0
/org.eclipse.jdt.ui/core extension/org/eclipse/jdt/internal/corext/codemanipulation/StubUtility.java;4;3;33;2;6;3;6;27;178;6;10;29;1000;1000;6;17;3;27;33;40;20;336;13;4;1
/org.eclipse.pde.ui/src/org/eclipse/pde/internal/ui/preferences/TargetEnvironmentPreferenceNode.java;2;1;3;1;2;2;2;1;4;0;1;222;8;8;1;0;0;1;3;222;0;336;3;2;0
/org.eclipse.ui.ide/src/org/eclipse/ui/views/markers/internal/TableSortAction.java;2;0;2;1;0;0;0;2;2;1;2;129;2;2;1;0;0;2;2;129;0;181;2;2;0
/org.eclipse.update.core/src/org/eclipse/update/internal/core/UpdateCore.java;3;3;17;1;4;2;4;13;103;3;9;32;340;340;3;4;2;13;17;227;6;336;11;3;4
/org.eclipse.update.core/src/org/eclipse/update/core/ICategory.java;2;1;3;1;2;2;2;1;6;0;1;58;12;12;1;0;0;1;3;58;0;336;3;2;0
/org.eclipse.ant.ui/Ant Tools Support/org/eclipse/ant/internal/ui/views/actions/FilterInternalTargetsAction.java;2;0;2;2;0;0;0;2;2;0;1;115;2;2;2;1;0;2;2;115;1;115;1;2;1
/org.eclipse.update.core/src/org/eclipse/update/internal/core/PluginEntryContentConsumer.java;2;1;3;1;2;2;2;1;6;0;1;58;14;14;1;0;0;1;3;58;0;336;3;2;0
/org.eclipse.ui.ide/src/org/eclipse/ui/internal/ide/dialogs/ProjectCapabilityEditingPropertyPage.java;3;0;3;1;1;1;1;2;32;1;2;132;56;56;1;0;0;2;3;132;0;336;3;3;1
/org.eclipse.core.resources/src/org/eclipse/core/internal/resources/SyncInfoWriter.java;1;0;1;1;1;1;1;0;174;0;0;277;174;174;1;0;0;0;1;277;0;277;1;1;0
/org.eclipse.ant.ui/Ant Tools Support/org/eclipse/ant/internal/ui/preferences/AntPreferencesMessages.java;1;0;1;1;0;0;0;1;0;0;1;108;0;0;1;0;0;1;1;108;0;108;1;1;0
/org.eclipse.jdt.core/model/org/eclipse/jdt/internal/core/CreateInitializerOperation.java;3;1;6;1;2;2;2;4;19;1;4;27;34;34;1;0;0;4;6;27;0;314;6;3;0
/org.eclipse.ui.workbench/Eclipse UI/org/eclipse/ui/commands/CategoryEvent.java;3;1;4;1;2;2;2;2;121;1;2;161;174;174;1;0;0;2;4;161;0;336;4;3;0
/org.eclipse.help.base/src/org/eclipse/help/internal/search/SearchQuery.java;1;1;5;1;3;3;3;2;29;1;2;104;41;41;1;0;0;2;5;104;0;336;5;1;0
/org.eclipse.debug.ui/ui/org/eclipse/debug/ui/console/IConsoleColorProvider.java;1;0;2;1;1;1;1;1;10;0;1;122;14;14;1;0;0;1;2;122;0;336;2;1;0
/org.eclipse.pde.core/src/org/eclipse/pde/internal/core/plugin/ExternalPluginModel.java;3;1;4;1;2;2;2;2;6;1;2;184;14;14;1;0;0;2;4;184;0;336;4;3;0
/org.eclipse.ui.workbench/Eclipse UI/org/eclipse/ui/internal/DefaultStackPresentationSite.java;3;4;8;3;5;2;5;3;38;0;1;245;77;77;4;2;3;3;8;293;5;293;3;3;0
/org.eclipse.jdt.core/model/org/eclipse/jdt/internal/core/JavaModelCache.java;1;0;1;1;0;0;0;1;2;0;1;199;2;2;1;0;0;1;1;199;0;199;1;1;0
/org.eclipse.swt/Eclipse SWT Browser/common/org/eclipse/swt/browser/LocationAdapter.java;2;0;4;1;1;1;1;3;28;1;3;163;39;39;1;0;0;3;4;163;0;337;4;2;0
/org.eclipse.help.base/src/org/eclipse/help/internal/search/HTMLDocParser.java;1;1;6;1;3;3;3;3;138;2;2;104;180;180;2;1;0;3;6;104;1;336;5;1;0
/org.eclipse.jdt.ui/ui refactoring/org/eclipse/jdt/internal/ui/refactoring/nls/ExternalizeWizard.java;3;0;10;2;1;1;6;4;117;8;2;66;129;129;8;2;5;9;10;267;7;336;3;3;0
/org.eclipse.jdt.ui/ui/org/eclipse/jdt/internal/ui/text/java/hover/JavaEditorTextHoverProxy.java;2;1;3;1;2;2;2;1;50;0;1;47;58;58;1;0;0;1;3;47;0;336;3;2;0
/org.eclipse.text/src/org/eclipse/jface/text/IDocumentPartitioningListenerExtension2.java;2;2;4;2;3;2;3;1;39;0;1;92;41;41;2;0;1;1;4;334;1;334;3;2;0
/org.eclipse.osgi/osgi/src/org/eclipse/osgi/service/resolver/StateHelper.java;3;0;5;2;1;1;2;3;160;2;2;246;182;182;2;1;1;4;5;246;2;286;3;3;0
/org.eclipse.ui.workbench/Eclipse UI/org/eclipse/ui/internal/activities/IActivityRegistryListener.java;1;0;2;1;0;0;0;2;2;1;2;141;2;2;1;0;0;2;2;141;0;160;2;1;0
/org.eclipse.team.ui/src/org/eclipse/team/internal/ui/wizards/ConfigurationWizardNode.java;1;0;1;1;0;0;0;1;72;0;1;63;72;72;1;0;0;1;1;63;0;63;1;1;0
/org.eclipse.jface.text/src/org/eclipse/jface/text/source/AnnotationRulerColumn.java;4;5;29;3;15;4;15;14;290;3;10;46;812;812;5;4;11;14;29;288;15;326;14;4;0
/org.eclipse.search/search/org/eclipse/search/internal/ui/text/GroupByKeyComputer.java;1;0;1;1;1;1;1;0;2;0;0;336;2;2;1;0;0;0;1;336;0;336;1;1;0
/org.eclipse.team.cvs.ui/src/org/eclipse/team/internal/ccvs/ui/operations/CheckoutMultipleProjectsOperation.java;2;0;5;1;1;1;1;4;58;1;4;20;87;87;1;0;0;4;5;20;0;336;5;2;0
/org.eclipse.jdt.ui/ui/org/eclipse/jdt/internal/ui/viewsupport/ProblemTableViewer.java;2;1;5;1;2;2;2;3;109;1;3;84;133;133;1;0;0;3;5;84;0;336;5;2;0
/org.eclipse.swt/Eclipse SWT/motif/org/eclipse/swt/widgets/Tracker.java;5;2;22;2;4;3;4;18;397;3;11;8;626;626;3;7;1;18;22;215;8;337;14;5;0
/org.eclipse.text/projection/org/eclipse/jface/text/projection/IMinimalMapping.java;1;1;3;1;2;2;2;1;21;0;1;247;23;23;1;0;0;1;3;247;0;334;3;1;0
/org.eclipse.team.ui/src/org/eclipse/team/internal/ui/synchronize/actions/DefaultSynchronizePageActions.java;1;1;4;1;4;4;4;0;72;0;0;275;104;104;1;0;0;0;4;275;0;309;4;1;1
/org.eclipse.ui.forms/src/org/eclipse/ui/internal/forms/FormWizardPage.java;1;1;2;1;2;2;2;0;6;0;0;272;6;6;1;0;0;0;2;272;0;336;2;1;0
/org.eclipse.jdt.core/model/org/eclipse/jdt/internal/core/ClassFileInfo.java;2;0;13;2;0;0;0;13;59;3;10;19;127;127;3;3;0;13;13;71;3;228;10;2;0
/org.eclipse.jdt.launching/launching/org/eclipse/jdt/internal/launching/JREContainerInitializer.java;3;1;4;2;2;2;2;2;61;0;1;46;69;69;2;1;0;2;4;46;1;336;3;3;0
/org.eclipse.ui.intro/src/org/eclipse/ui/internal/intro/impl/model/AbstractIntroIdElement.java;1;0;1;1;1;1;1;0;0;0;0;296;0;0;1;0;0;0;1;296;0;296;1;1;0
/org.eclipse.update.core/src/org/eclipse/update/internal/operations/Operation.java;1;0;4;1;1;1;1;3;4;1;3;54;8;8;1;0;0;3;4;54;0;336;4;1;0
/org.eclipse.ui.externaltools/External Tools Base/org/eclipse/ui/externaltools/internal/ui/BuilderLabelProvider.java;2;0;3;1;1;1;1;2;29;1;2;205;31;31;1;0;0;2;3;205;0;294;3;2;0
/org.eclipse.ant.ui/Ant Editor/org/eclipse/ant/internal/ui/editor/outline/ToggleSortAntOutlineAction.java;1;0;1;1;0;0;0;1;0;0;1;118;0;0;1;0;0;1;1;118;0;118;1;1;1
/org.eclipse.jface.text/src/org/eclipse/jface/text/reconciler/DirtyRegion.java;1;0;2;1;2;1;2;0;15;0;0;336;15;15;2;0;1;0;2;336;1;336;1;1;0
/org.eclipse.compare/compare/org/eclipse/compare/contentmergeviewer/ITokenComparator.java;1;0;1;1;0;0;0;1;2;0;1;219;2;2;1;0;0;1;1;219;0;219;1;1;0
/org.eclipse.compare/compare/org/eclipse/compare/internal/CompareEditorContributor.java;1;1;4;1;2;2;2;2;7;1;2;104;15;15;1;0;0;2;4;104;0;337;4;1;0
/org.eclipse.core.resources/src/org/eclipse/core/internal/indexing/AbstractObjectPolicy.java;1;0;1;1;1;1;1;0;6;0;0;277;6;6;1;0;0;0;1;277;0;277;1;1;0
/org.eclipse.jdt.core/codeassist/org/eclipse/jdt/internal/codeassist/complete/CompletionOnMethodName.java;2;0;2;1;0;0;0;2;54;1;2;63;56;56;1;0;0;2;2;63;0;199;2;2;0
/org.eclipse.team.cvs.ui/src/org/eclipse/team/internal/ccvs/ui/subscriber/ChangeLogDiffNode.java;1;2;9;1;4;2;4;5;96;2;3;198;134;134;2;2;2;5;9;232;4;313;5;1;0
/org.eclipse.jdt.ui/ui/org/eclipse/jdt/internal/ui/wizards/buildpaths/ClasspathOrderingWorkbookPage.java;2;1;2;1;2;2;2;0;2;0;0;311;4;4;1;0;0;0;2;311;0;336;2;2;0
/org.eclipse.ui.workbench.texteditor/src/org/eclipse/ui/internal/texteditor/quickdiff/DiffRegion.java;2;1;3;1;2;2;2;1;8;0;1;200;9;9;1;0;0;1;3;200;0;336;3;2;0
/org.eclipse.jdt.ui/ui/org/eclipse/jdt/internal/ui/text/correction/CastCompletionProposal.java;2;1;3;1;3;3;3;0;2;0;0;299;4;4;1;0;0;0;3;299;0;336;3;2;0
/org.eclipse.jdt.ui/ui refactoring/org/eclipse/jdt/internal/ui/refactoring/nls/MultiStateCellEditor.java;1;0;1;1;1;1;1;0;2;0;0;289;2;2;1;0;0;0;1;289;0;289;1;1;0
/org.eclipse.swt/Eclipse SWT Accessibility/common/org/eclipse/swt/accessibility/AccessibleTextEvent.java;2;0;2;1;0;0;0;2;11;1;2;131;11;11;1;0;0;2;2;131;0;156;2;2;0
/org.eclipse.jdt.debug.ui/ui/org/eclipse/jdt/internal/debug/ui/actions/RemoveDetailFormatterAction.java;1;0;1;1;0;0;0;1;0;0;1;180;0;0;1;0;0;1;1;180;0;180;1;1;0
/org.eclipse.jdt.ui/ui/org/eclipse/jdt/internal/ui/text/folding/JavaFoldingStructureProviderRegistry.java;1;1;2;1;2;2;2;0;6;0;0;292;6;6;1;0;0;0;2;292;0;336;2;1;0
/org.eclipse.swt/Eclipse SWT/photon/org/eclipse/swt/widgets/Menu.java;4;1;6;1;2;2;2;4;9;1;4;2;28;28;1;0;0;4;6;2;0;337;6;4;0
/org.eclipse.jdt.ui/ui/org/eclipse/jdt/internal/ui/javaeditor/CompilationUnitEditorActionContributor.java;3;1;9;1;2;2;2;7;158;3;5;35;199;199;3;2;0;7;9;35;2;336;7;3;0
/org.eclipse.jdt.core/dom/org/eclipse/jdt/internal/core/dom/rewrite/NodeRewriteEvent.java;3;1;3;1;2;2;2;1;22;0;1;262;26;26;1;0;0;1;3;262;0;336;3;3;0
/org.eclipse.jdt.ui/ui refactoring/org/eclipse/jdt/internal/ui/refactoring/IParameterListChangeListener.java;1;0;1;1;1;1;1;0;2;0;0;336;2;2;1;0;0;0;1;336;0;336;1;1;0
/org.eclipse.ui.ide/src/org/eclipse/ui/internal/ide/TipsAndTricksAction.java;2;1;6;1;3;3;3;3;36;2;2;132;64;64;2;1;0;3;6;154;1;336;5;2;0
/org.eclipse.jface.text/src/org/eclipse/jface/text/link/LinkedModeUI.java;3;3;6;2;6;3;6;0;130;0;0;276;134;134;3;0;3;0;6;332;3;332;3;3;0
/org.eclipse.ui.workbench/Eclipse UI/org/eclipse/ui/activities/IActivity.java;5;1;18;3;3;3;3;15;508;9;4;131;622;622;9;11;0;15;18;156;11;336;7;5;0
/org.eclipse.text/projection/org/eclipse/jface/text/projection/ProjectionDocument.java;3;4;14;2;6;3;7;7;283;0;1;247;460;460;8;6;4;8;14;247;10;325;4;3;0
/org.eclipse.jdt.ui/ui refactoring/org/eclipse/jdt/internal/ui/refactoring/nls/search/NLSSearchResult.java;2;1;4;1;3;3;3;1;40;0;1;268;80;80;1;0;0;1;4;268;0;320;4;2;0
/org.eclipse.jdt.core/compiler/org/eclipse/jdt/internal/compiler/ast/QualifiedNameReference.java;3;0;13;1;0;0;0;13;73;3;8;3;163;163;3;5;0;13;13;63;5;199;8;3;4
/org.eclipse.jdt.core/dom/org/eclipse/jdt/core/dom/Block.java;3;0;6;1;1;1;1;5;60;2;4;199;72;72;2;1;0;5;6;266;1;283;5;3;1
/org.eclipse.jdt.ui/ui/org/eclipse/jdt/internal/ui/dnd/ResourceTransferDragAdapter.java;1;0;1;1;1;1;1;0;2;0;0;336;2;2;1;0;0;0;1;336;0;336;1;1;0
/org.eclipse.jdt.junit/src/org/eclipse/jdt/internal/junit/ui/OpenTestAction.java;2;0;3;1;1;1;1;2;12;1;2;193;18;18;1;0;0;2;3;193;0;336;3;2;0
/org.eclipse.update.core/src/org/eclipse/update/internal/core/SiteFileFactory.java;3;1;9;1;2;2;2;7;227;3;5;58;301;301;3;2;0;7;9;227;2;302;7;3;0
/org.eclipse.help/src/org/eclipse/help/internal/HelpPlugin.java;1;1;10;1;3;3;4;6;150;4;4;156;359;359;4;2;1;7;10;267;3;336;7;1;0
/org.eclipse.pde.core/src/org/eclipse/pde/internal/core/build/BuildObject.java;3;1;4;1;3;3;3;1;73;0;1;232;99;99;1;0;0;1;4;232;0;336;4;3;0
/org.eclipse.jdt.ui/ui refactoring/org/eclipse/jdt/internal/ui/refactoring/reorg/CutAction.java;3;0;10;2;1;1;4;6;144;4;3;100;180;180;4;3;3;9;10;269;6;336;4;3;0
/org.eclipse.jdt.ui/ui/org/eclipse/jdt/internal/ui/compare/JavaTokenComparator.java;2;0;2;1;1;1;1;1;2;0;1;79;3;3;1;0;0;1;2;79;0;336;2;2;0
/org.eclipse.jdt.core/compiler/org/eclipse/jdt/internal/compiler/lookup/TagBits.java;1;0;1;1;0;0;0;1;2;0;1;199;2;2;1;0;0;1;1;199;0;199;1;1;1
/org.eclipse.jdt.ui/ui/org/eclipse/jdt/internal/ui/packageview/PackageExplorerPart.java;5;5;27;3;9;3;9;18;367;3;12;32;1152;1152;5;6;6;18;27;303;12;336;15;5;0
/org.eclipse.ant.ui/Ant Tools Support/org/eclipse/ant/internal/ui/launchConfigurations/AntJRETab.java;2;1;23;2;2;2;2;21;246;9;7;108;728;728;9;14;0;21;23;108;14;336;9;2;2
/org.eclipse.jdt.core/compiler/org/eclipse/jdt/internal/compiler/env/ISourceField.java;1;0;1;1;0;0;0;1;2;0;1;199;2;2;1;0;0;1;1;199;0;199;1;1;0
/org.eclipse.debug.ui/ui/org/eclipse/debug/internal/ui/actions/RemoveBreakpointAction.java;2;0;2;1;0;0;0;2;2;1;2;141;4;4;1;0;0;2;2;141;0;157;2;2;2
/org.eclipse.jdt.core/model/org/eclipse/jdt/internal/core/BufferCache.java;1;0;2;1;0;0;0;2;19;1;2;62;21;21;1;0;0;2;2;62;0;199;2;1;0
/org.eclipse.debug.ui/ui/org/eclipse/debug/internal/ui/views/DebugViewLabelDecorator.java;4;1;6;1;3;3;3;3;6;1;3;196;16;16;1;0;0;3;6;196;0;336;6;4;0
/org.eclipse.swt/Eclipse SWT Program/photon/org/eclipse/swt/program/Program.java;2;1;3;1;2;2;2;1;16;0;1;153;22;22;1;0;0;1;3;153;0;337;3;2;0
/org.eclipse.swt/Eclipse SWT PI/win32/org/eclipse/swt/internal/win32/SCRIPT_CONTROL.java;2;0;2;1;1;1;1;1;4;0;1;250;4;4;1;0;0;1;2;250;0;337;2;2;0
/org.eclipse.jdt.debug/jdi interfaces/com/sun/jdi/VirtualMachine.java;1;0;1;1;0;0;0;1;3;0;1;235;3;3;1;0;0;1;1;235;0;235;1;1;0
/org.eclipse.debug.ui/ui/org/eclipse/debug/internal/ui/preferences/ViewManagementPreferencePage.java;2;2;5;2;5;3;5;0;96;0;0;295;104;104;2;0;2;0;5;295;2;323;3;2;0
/org.eclipse.ui.workbench/Eclipse UI/org/eclipse/ui/IViewLayout.java;1;0;2;1;2;1;2;0;26;0;0;295;26;26;2;0;1;0;2;295;1;295;1;1;0
/org.eclipse.swt/Eclipse SWT/photon/org/eclipse/swt/widgets/TabItem.java;3;1;6;1;3;3;3;3;6;1;3;19;22;22;1;0;0;3;6;19;0;337;6;3;0
/org.eclipse.swt/Eclipse SWT PI/gtk/org/eclipse/swt/internal/gtk/GdkEvent.java;3;0;3;1;1;1;1;2;17;1;2;100;21;21;1;0;0;2;3;100;0;337;3;3;0
/org.eclipse.jdt.ui/ui/org/eclipse/jdt/internal/ui/preferences/formatter/NewLinesTabPage.java;1;0;10;1;1;1;1;9;95;3;6;176;178;178;3;3;0;9;10;191;3;280;7;1;1
/org.eclipse.ui.ide/src/org/eclipse/ui/views/bookmarkexplorer/BookmarkLabelProvider.java;1;0;1;1;0;0;0;1;0;0;1;129;0;0;1;0;0;1;1;129;0;129;1;1;0
/org.eclipse.jdt.core/compiler/org/eclipse/jdt/internal/compiler/impl/FloatConstant.java;2;0;3;1;1;1;1;2;6;1;2;70;12;12;1;0;0;2;3;70;0;299;3;2;0
/org.eclipse.team.cvs.core/src/org/eclipse/team/internal/ccvs/core/syncinfo/CVSResourceVariantTree.java;2;2;8;2;5;3;5;3;252;0;1;233;378;378;3;2;2;3;8;233;4;336;4;2;1
/org.eclipse.pde.core/src/org/eclipse/pde/internal/core/schema/SchemaEnumeration.java;2;1;3;1;2;2;2;1;12;0;1;232;18;18;1;0;0;1;3;232;0;336;3;2;0
/org.eclipse.jdt.ui/ui/org/eclipse/jdt/internal/ui/preferences/formatter/WhiteSpaceOptions.java;1;0;5;1;0;0;0;5;59;2;4;211;101;101;2;1;0;5;5;211;1;263;4;1;2
/org.eclipse.jdt.core/compiler/org/eclipse/jdt/internal/compiler/ast/IntLiteralMinValue.java;1;0;1;1;0;0;0;1;2;0;1;199;2;2;1;0;0;1;1;199;0;199;1;1;0
/org.eclipse.debug.ui/ui/org/eclipse/debug/internal/ui/actions/RunContextualLaunchAction.java;1;0;1;1;1;1;1;0;0;0;0;295;0;0;1;0;0;0;1;295;0;295;1;1;0
/org.eclipse.help.appserver/src/org/eclipse/help/internal/appserver/AppserverResources.java;1;1;7;1;3;3;3;4;102;2;3;8;126;126;2;1;0;4;7;8;1;336;6;1;0
/org.eclipse.swt/Eclipse SWT/win32/org/eclipse/swt/widgets/Shell.java;6;6;41;4;12;5;12;29;239;7;13;1;686;686;7;16;7;29;41;131;23;325;18;6;5
/org.eclipse.jdt.ui/ui/org/eclipse/jdt/internal/ui/actions/AddMethodStubAction.java;3;1;6;1;3;3;3;3;19;1;3;82;49;49;1;0;0;3;6;82;0;336;6;3;0
/org.eclipse.jdt.core/compiler/org/eclipse/jdt/internal/compiler/lookup/ProblemReferenceBinding.java;2;0;2;1;0;0;0;2;6;1;2;128;8;8;1;0;0;2;2;128;0;199;2;2;0
/org.eclipse.ui.workbench/Eclipse UI/org/eclipse/ui/internal/activities/CategoryActivityBindingDefinition.java;3;0;6;1;1;1;1;5;18;3;3;165;34;34;3;2;0;5;6;165;2;336;4;3;0
/org.eclipse.pde.core/src/org/eclipse/pde/internal/core/PluginPathFinder.java;2;5;7;1;6;2;6;1;113;0;1;232;130;130;5;0;4;1;7;322;4;322;3;2;0
/org.eclipse.jdt.core/model/org/eclipse/jdt/core/util/ILocalVariableAttribute.java;1;0;1;1;0;0;0;1;2;0;1;199;2;2;1;0;0;1;1;199;0;199;1;1;0
/org.eclipse.ui.workbench/Eclipse UI/org/eclipse/ui/internal/progress/JobTreeElement.java;2;0;7;1;1;1;1;6;23;3;3;69;55;55;3;3;0;6;7;69;3;336;4;2;0
/org.eclipse.ui.workbench/Eclipse UI/org/eclipse/ui/internal/commands/CommandDefinition.java;2;0;10;1;1;1;1;9;183;3;6;84;556;556;3;3;0;9;10;84;3;336;7;2;0
/org.eclipse.jdt.ui/core refactoring/org/eclipse/jdt/internal/corext/refactoring/changes/MovePackageFragmentRootChange.java;2;1;4;1;2;2;2;2;13;1;2;219;24;24;1;0;0;2;4;219;0;336;4;2;0
/org.eclipse.core.runtime/src/org/eclipse/core/internal/runtime/InternalPlatform.java;6;0;86;6;3;1;25;61;5556;56;7;42;8954;8954;56;54;24;83;86;198;78;323;8;6;2
/org.eclipse.ui.workbench/Eclipse UI/org/eclipse/ui/internal/progress/JobInfo.java;2;1;25;1;4;4;4;21;389;6;9;24;1143;1143;6;12;0;21;25;69;12;336;13;2;0
/org.eclipse.jdt.debug/model/org/eclipse/jdt/debug/core/IJavaArrayType.java;1;0;1;1;0;0;0;1;14;0;1;128;14;14;1;0;0;1;1;128;0;128;1;1;0
/org.eclipse.jdt.ui/core extension/org/eclipse/jdt/internal/corext/dom/LocalVariableIndex.java;2;0;3;1;1;1;1;2;29;1;2;165;40;40;1;0;0;2;3;165;0;336;3;2;0
/org.eclipse.jdt.core/model/org/eclipse/jdt/internal/core/hierarchy/HierarchyBuilder.java;3;0;12;2;0;0;0;12;138;3;6;10;300;300;3;6;0;12;12;195;6;258;6;3;0
/org.eclipse.jdt.ui/ui/org/eclipse/jdt/internal/ui/jarpackager/CreateJarActionDelegate.java;2;1;2;1;2;2;2;0;17;0;0;292;19;19;1;0;0;0;2;292;0;336;2;2;0
/org.eclipse.jdt.ui/core refactoring/org/eclipse/jdt/internal/corext/refactoring/tagging/IQualifiedNameUpdating.java;2;0;2;1;1;1;1;1;2;0;1;71;2;2;1;0;0;1;2;71;0;336;2;2;0
/org.eclipse.team.cvs.ui/src/org/eclipse/team/internal/ccvs/ui/IHelpContextIds.java;2;1;6;1;2;2;2;4;24;3;2;52;31;31;3;2;0;4;6;52;2;336;4;2;0
/org.eclipse.search/new search/org/eclipse/search2/internal/ui/basic/views/ExpandAllAction.java;2;1;2;1;2;2;2;0;4;0;0;292;4;4;1;0;0;0;2;292;0;336;2;2;0
/org.eclipse.jdt.ui/ui/org/eclipse/jdt/internal/ui/dnd/DelegatingDropAdapter.java;1;0;1;1;1;1;1;0;2;0;0;336;2;2;1;0;0;0;1;336;0;336;1;1;0
/org.eclipse.jdt.debug.ui/ui/org/eclipse/jdt/internal/debug/ui/launcher/RemoteJavaApplicationTabGroup.java;2;0;2;2;0;0;0;2;18;0;1;267;18;18;2;1;0;2;2;267;1;267;1;2;0
/org.eclipse.jdt.launching/launching/org/eclipse/jdt/internal/launching/SocketAttachConnector.java;2;0;2;1;1;1;1;1;4;0;1;211;8;8;1;0;0;1;2;211;0;336;2;2;0
/org.eclipse.jdt.core/model/org/eclipse/jdt/internal/core/JarPackageFragment.java;3;1;13;1;2;2;2;11;59;3;9;10;133;133;3;2;0;11;13;51;2;326;11;3;0
/org.eclipse.ant.ui/Ant Tools Support/org/eclipse/ant/internal/ui/datatransfer/ExternalAntBuildfileImportPage.java;1;0;2;1;1;1;1;1;16;0;1;263;16;16;1;0;0;1;2;263;0;299;2;1;7
/org.eclipse.core.resources/src/org/eclipse/core/resources/refresh/IRefreshResult.java;2;0;4;1;2;1;2;2;9;1;2;205;12;12;2;0;1;2;4;273;1;273;3;2;0
/org.eclipse.jdt.debug.ui/ui/org/eclipse/jdt/internal/debug/ui/actions/RunToLineAdapter.java;3;1;5;2;2;2;2;3;106;0;1;243;110;110;3;2;0;3;5;243;2;301;3;3;3
/org.eclipse.ui.workbench/Eclipse UI/org/eclipse/ui/PartInitException.java;1;0;1;1;0;0;0;1;2;0;1;0;2;2;1;0;0;1;1;0;0;0;1;1;0
/org.eclipse.jdt.debug/jdi/org/eclipse/jdi/internal/spy/VerbosePacketStream.java;2;0;5;1;0;0;0;5;291;1;5;11;303;303;1;0;0;5;5;11;0;235;5;2;0
/org.eclipse.swt/Eclipse SWT Drag and Drop/common/org/eclipse/swt/dnd/DragSourceAdapter.java;2;0;2;1;1;1;1;1;6;0;1;217;10;10;1;0;0;1;2;217;0;337;2;2;0
/org.eclipse.core.runtime.compatibility/src-model/org/eclipse/core/runtime/model/ExtensionPointModel.java;3;1;5;1;3;3;3;2;23;1;2;171;32;32;1;0;0;2;5;171;0;336;5;3;0
/org.eclipse.jdt.debug.ui/ui/org/eclipse/jdt/internal/debug/ui/breakpoints/AddClassPrepareBreakpointAction.java;4;0;4;2;1;1;1;3;10;2;2;248;19;19;2;1;0;3;4;248;1;336;3;4;0
/org.eclipse.pde.core/src/org/eclipse/pde/core/IEditable.java;2;1;4;1;3;3;3;1;34;0;1;232;42;42;1;0;0;1;4;232;0;336;4;2;0
/org.eclipse.pde.core/src/org/eclipse/pde/core/plugin/IPluginModelFactory.java;2;1;3;1;2;2;2;1;53;0;1;128;75;75;1;0;0;1;3;128;0;336;3;2;0
/org.eclipse.ui.ide/src/org/eclipse/ui/views/markers/internal/TableSortDialog.java;2;0;3;1;1;1;1;2;3;1;2;129;6;6;1;0;0;2;3;129;0;336;3;2;2
/org.eclipse.ui.intro/src/org/eclipse/ui/internal/intro/impl/util/IntroModelSerializer.java;1;6;10;1;10;3;10;0;232;0;0;276;310;310;6;0;7;0;10;276;7;312;3;1;0
/org.eclipse.jdt.core/search/org/eclipse/jdt/internal/core/search/matching/QualifiedTypeDeclarationPattern.java;3;0;11;2;1;1;1;10;127;3;7;70;373;373;3;3;0;10;11;70;3;280;8;3;0
/org.eclipse.osgi/resolver/src/org/eclipse/core/internal/dependencies/IMatchRule.java;2;1;2;1;2;2;2;0;2;0;0;281;2;2;1;0;0;0;2;281;0;290;2;2;0
/org.eclipse.jdt.core/dom/org/eclipse/jdt/core/dom/MethodBinding.java;3;0;7;2;0;0;0;7;14;2;5;22;48;48;2;2;0;7;7;171;2;269;5;3;11
/org.eclipse.jdt.junit/src/org/eclipse/jdt/internal/junit/util/LayoutUtil.java;1;0;1;1;1;1;1;0;2;0;0;336;2;2;1;0;0;0;1;336;0;336;1;1;0
/org.eclipse.jdt.core/compiler/org/eclipse/jdt/internal/compiler/lookup/InnerEmulationDependency.java;1;0;1;1;0;0;0;1;2;0;1;199;2;2;1;0;0;1;1;199;0;199;1;1;0
/org.eclipse.ui.workbench/Eclipse UI/org/eclipse/ui/internal/activities/ExtensionActivityRegistry.java;4;1;14;2;2;2;2;12;330;7;4;141;436;436;7;8;0;12;14;160;8;336;6;4;0
/org.eclipse.jdt.ui/core refactoring/org/eclipse/jdt/internal/corext/refactoring/structure/PushDownRefactoring.java;5;5;37;3;9;5;9;28;413;6;12;9;992;992;6;16;4;28;37;244;20;336;17;5;3
/org.eclipse.update.core/src/org/eclipse/update/internal/core/UpdateManagerUtils.java;3;3;24;2;9;5;9;15;185;4;8;58;444;444;4;7;4;15;24;171;11;336;13;3;1
/org.eclipse.jdt.ui/core extension/org/eclipse/jdt/internal/corext/dom/ASTNodeFactory.java;4;1;8;1;3;3;3;5;61;1;5;10;144;144;1;0;0;5;8;10;0;336;8;4;0
/org.eclipse.pde.runtime/src/org/eclipse/pde/internal/runtime/IHelpContextIds.java;2;1;2;1;2;2;2;0;6;0;0;309;10;10;1;0;0;0;2;309;0;336;2;2;0
/org.eclipse.ant.ui/Ant Tools Support/org/eclipse/ant/internal/ui/datatransfer/ProjectCreator.java;1;0;1;1;0;0;0;1;0;0;1;263;0;0;1;0;0;1;1;263;0;263;1;1;3
/org.eclipse.core.runtime/src/org/eclipse/core/runtime/Path.java;3;1;11;2;4;4;4;7;3407;3;5;87;3481;3481;3;2;0;7;11;171;2;336;9;3;1
/org.eclipse.jdt.ui/core refactoring/org/eclipse/jdt/internal/corext/refactoring/code/CallInliner.java;5;1;23;2;3;3;3;20;215;2;14;16;809;809;2;6;0;20;23;16;6;336;17;5;2
/org.eclipse.update.core/src/org/eclipse/update/core/IInstallHandler.java;2;1;3;1;2;2;2;1;6;0;1;58;12;12;1;0;0;1;3;58;0;336;3;2;0
/org.eclipse.swt/Eclipse SWT/gtk/org/eclipse/swt/widgets/Display.java;7;11;59;7;21;2;21;38;926;7;14;0;2608;2608;11;24;19;38;59;273;43;309;16;7;5
/org.eclipse.jface/src/org/eclipse/jface/viewers/CustomHashtable.java;2;1;2;1;2;2;2;0;16;0;0;306;23;23;1;0;0;0;2;306;0;336;2;2;0
/org.eclipse.ant.ui/Ant Tools Support/org/eclipse/ant/internal/ui/launchConfigurations/AddVariableStringAction.java;1;0;2;1;0;0;0;2;136;0;1;269;136;136;2;1;0;2;2;269;1;269;1;1;0
/org.eclipse.team.ui/src/org/eclipse/team/internal/ui/wizards/ProjectSetImportWizard.java;2;2;9;2;5;4;5;4;159;1;4;63;223;223;2;0;1;4;9;288;1;336;8;2;0
/org.eclipse.compare/compare/org/eclipse/compare/structuremergeviewer/DiffContainer.java;1;0;2;1;1;1;1;1;2;0;1;219;3;3;1;0;0;1;2;219;0;335;2;1;0
/org.eclipse.jdt.ui/ui/org/eclipse/jdt/internal/ui/viewsupport/ResourceToItemsMapper.java;2;0;3;1;1;1;1;2;42;1;2;123;46;46;1;0;0;2;3;123;0;336;3;2;2
/org.eclipse.osgi/core/framework/org/eclipse/osgi/framework/internal/core/PermissionAdminImpl.java;2;1;3;1;3;3;3;0;60;0;0;276;76;76;1;0;0;0;3;276;0;336;3;2;0
/org.eclipse.jdt.debug.ui/ui/org/eclipse/jdt/internal/debug/core/refactoring/JavaMethodBreakpointMethodNameChange.java;2;0;3;1;1;1;1;2;8;0;1;266;11;11;2;1;0;2;3;266;1;336;2;2;0
/org.eclipse.jdt.ui/core refactoring/org/eclipse/jdt/internal/corext/refactoring/participants/RefactoringProcessors.java;1;0;1;1;0;0;0;1;0;0;1;254;0;0;1;0;0;1;1;254;0;254;1;1;0
/org.eclipse.pde.ui/src_Forms/org/eclipse/pde/internal/ui/model/DocumentHandler.java;2;3;4;2;4;2;4;0;17;0;0;304;27;27;3;0;2;0;4;304;2;336;2;2;0
/org.eclipse.jface.text/src/org/eclipse/jface/internal/text/link/contentassist/CompletionProposalPopup2.java;2;1;4;1;2;2;2;2;11;1;2;232;17;17;1;0;0;2;4;232;0;336;4;2;0
/org.eclipse.ui.cheatsheets/src/org/eclipse/ui/internal/cheatsheets/data/CheatSheet.java;1;0;1;1;1;1;1;0;0;0;0;279;0;0;1;0;0;0;1;279;0;279;1;1;0
/org.eclipse.ui.ide/src/org/eclipse/ui/internal/ide/dialogs/PathVariablesGroup.java;1;0;1;1;0;0;0;1;0;0;1;132;0;0;1;0;0;1;1;132;0;132;1;1;1
/org.eclipse.debug.ui/ui/org/eclipse/debug/internal/ui/actions/WatchAction.java;2;1;4;1;2;2;2;2;19;0;1;92;31;31;2;1;0;2;4;92;1;336;3;2;0
/org.eclipse.team.cvs.ui/src/org/eclipse/team/internal/ccvs/ui/actions/UnmanageAction.java;2;0;3;1;1;1;1;2;76;1;2;158;86;86;1;0;0;2;3;158;0;336;3;2;0
/org.eclipse.pde.ui/src/org/eclipse/pde/internal/ui/editor/build/BuildInputContextManager.java;2;2;3;2;3;2;3;0;20;0;0;292;26;26;2;0;1;0;3;292;1;336;2;2;0
/org.eclipse.pde.ui/src/org/eclipse/pde/internal/ui/view/ModelEntryPropertySource.java;2;1;2;1;2;2;2;0;38;0;0;308;42;42;1;0;0;0;2;308;0;336;2;2;0
/org.eclipse.team.cvs.ui/src/org/eclipse/team/internal/ccvs/ui/repo/RemoveRootAction.java;2;1;9;1;3;3;3;6;37;1;6;63;94;94;1;0;0;6;9;63;0;336;9;2;0
/org.eclipse.ui.ide/src/org/eclipse/ui/views/properties/IDEPropertiesMessages.java;1;0;1;1;0;0;0;1;0;0;1;129;0;0;1;0;0;1;1;129;0;129;1;1;0
/org.eclipse.jface/src/org/eclipse/jface/viewers/IViewerLabelProvider.java;2;0;2;2;0;0;0;2;43;0;1;251;43;43;2;1;0;2;2;251;1;251;1;2;0
/org.eclipse.ui.forms/src/org/eclipse/ui/internal/forms/widgets/Locator.java;1;1;2;1;2;2;2;0;4;0;0;272;4;4;1;0;0;0;2;272;0;336;2;1;0
/org.eclipse.jdt.ui/core refactoring/org/eclipse/jdt/internal/corext/refactoring/participants/JavaProcessors.java;2;0;5;1;1;1;1;4;45;2;3;54;66;66;2;1;0;4;5;254;1;336;4;2;0
/org.eclipse.pde/src/org/eclipse/pde/internal/builders/SchemaTransformer.java;3;2;25;2;3;2;4;21;1673;11;6;59;2746;2746;11;15;2;22;25;59;17;336;8;3;2
/org.eclipse.swt/Eclipse SWT PI/carbon/org/eclipse/swt/internal/carbon/PMResolution.java;2;0;3;1;2;1;2;1;20;0;1;156;20;20;2;0;1;1;3;296;1;296;2;2;0
/org.eclipse.search/search/org/eclipse/search/internal/ui/WorkingSetComparator.java;1;0;1;1;1;1;1;0;2;0;0;336;2;2;1;0;0;0;1;336;0;336;1;1;0
/org.eclipse.text/projection/org/eclipse/jface/text/projection/FragmentUpdater.java;1;1;4;1;2;2;2;2;38;0;1;247;48;48;2;1;0;2;4;247;1;334;3;1;0
/org.eclipse.jdt.ui/ui/org/eclipse/jdt/internal/ui/wizards/NewInterfaceCreationWizard.java;2;1;5;1;2;2;2;3;22;2;2;225;54;54;2;1;0;3;5;225;1;336;4;2;0
/org.eclipse.team.cvs.core/src/org/eclipse/team/internal/ccvs/core/connection/PServerConnection.java;2;1;5;1;2;2;2;3;7;1;3;20;17;17;1;0;0;3;5;20;0;336;5;2;1
/org.eclipse.jdt.ui/core extension/org/eclipse/jdt/internal/corext/codemanipulation/ImportReferencesCollector.java;2;1;2;1;2;2;2;0;2;0;0;292;2;2;1;0;0;0;2;292;0;336;2;2;0
/org.eclipse.ltk.core.refactoring/src/org/eclipse/ltk/core/refactoring/participants/DeleteArguments.java;1;0;3;1;1;1;1;2;14;0;1;264;17;17;2;1;0;2;3;264;1;279;2;1;0
/org.eclipse.jdt.launching/launching/org/eclipse/jdt/launching/IRuntimeClasspathEntry2.java;1;0;1;1;0;0;0;1;0;0;1;269;0;0;1;0;0;1;1;269;0;269;1;1;0
/org.eclipse.search/new search/org/eclipse/search2/internal/ui/SearchMessages.java;2;0;2;1;1;1;1;1;2;0;1;195;2;2;1;0;0;1;2;195;0;336;2;2;0
/org.eclipse.pde.ui/src/org/eclipse/pde/internal/ui/wizards/WizardListSelectionPage.java;3;1;6;1;3;3;3;3;263;1;3;56;298;298;1;0;0;3;6;56;0;336;6;3;0
/org.eclipse.jdt.core/model/org/eclipse/jdt/internal/compiler/parser/SourceFieldDeclaration.java;1;0;1;1;0;0;0;1;0;0;1;245;0;0;1;0;0;1;1;245;0;245;1;1;0
/org.eclipse.pde.ui/src/org/eclipse/pde/internal/ui/editor/schema/SchemaFormOutlinePage.java;1;1;2;1;2;2;2;0;83;0;0;292;99;99;1;0;0;0;2;292;0;336;2;1;0
/org.eclipse.pde.core/src/org/eclipse/pde/internal/core/BinaryRepositoryProvider.java;1;0;2;1;1;1;1;1;4;0;1;232;6;6;1;0;0;1;2;232;0;336;2;1;0
/org.eclipse.jdt.ui/ui/org/eclipse/jdt/internal/ui/text/java/hover/AnnotationHover.java;2;3;10;1;4;2;4;6;119;2;5;103;219;219;3;1;2;6;10;299;3;336;7;2;0
/org.eclipse.jdt.core/compiler/org/eclipse/jdt/internal/compiler/ast/TypeReference.java;4;0;5;1;0;0;0;5;27;1;5;85;62;62;1;0;0;5;5;85;0;199;5;4;0
/org.eclipse.jdt.ui/core refactoring/org/eclipse/jdt/internal/corext/refactoring/changes/MoveResourceChange.java;2;1;4;1;2;2;2;2;9;1;2;219;18;18;1;0;0;2;4;219;0;336;4;2;0
/org.eclipse.jdt.launching.macosx/macosx/org/eclipse/jdt/internal/launching/macosx/MacOSXDebugVMRunner.java;1;0;2;1;0;0;0;2;4;1;2;156;6;6;1;0;0;2;2;156;0;203;2;1;0
/org.eclipse.pde.core/src/org/eclipse/pde/internal/core/site/SiteBuildFeature.java;3;1;5;1;2;2;2;3;14;1;3;130;44;44;1;0;0;3;5;130;0;336;5;3;0
/org.eclipse.pde.ui/src/org/eclipse/pde/ui/IExtensionEditorWizard.java;2;2;3;1;3;2;3;0;13;0;0;295;19;19;2;0;1;0;3;295;1;336;2;2;0
/org.eclipse.core.expressions/src/org/eclipse/core/internal/expressions/CompositeExpression.java;1;0;2;1;1;1;1;1;8;0;1;227;8;8;1;0;0;1;2;227;0;336;2;1;0
/org.eclipse.core.resources/src/org/eclipse/core/internal/localstore/SafeChunkyInputStream.java;2;1;2;1;2;2;2;0;280;0;0;277;407;407;1;0;0;0;2;277;0;329;2;2;0
/org.eclipse.jdt.ui/ui refactoring/org/eclipse/jdt/internal/ui/refactoring/nls/SourceChangeListener.java;2;0;2;1;1;1;1;1;16;0;1;267;16;16;1;0;0;1;2;267;0;336;2;2;0
/org.eclipse.swt/Eclipse SWT Browser/motif/org/eclipse/swt/browser/InputStream.java;1;0;1;1;0;0;0;1;0;0;1;153;0;0;1;0;0;1;1;153;0;153;1;1;0
/org.eclipse.help/src/org/eclipse/help/internal/util/URLCoder.java;1;1;5;1;3;3;3;2;19;0;1;8;39;39;2;1;0;2;5;8;1;336;4;1;0
/org.eclipse.text/projection/org/eclipse/jface/text/projection/ProjectionDocumentManager.java;1;0;5;1;1;1;1;4;111;0;1;247;129;129;4;3;0;4;5;247;3;334;2;1;0
/org.eclipse.text/src/org/eclipse/jface/text/GapTextStore.java;1;0;1;1;1;1;1;0;13;0;0;334;13;13;1;0;0;0;1;334;0;334;1;1;0
/org.eclipse.ui.ide/extensions/org/eclipse/ui/dialogs/MarkerResolutionSelectionDialog.java;1;0;1;1;0;0;0;1;0;0;1;132;0;0;1;0;0;1;1;132;0;132;1;1;0
/org.eclipse.core.runtime/src/org/eclipse/core/internal/registry/RegistryChangeEvent.java;4;1;7;3;2;2;2;5;320;3;3;124;335;335;3;2;0;5;7;171;2;336;5;4;0
/org.eclipse.jdt.ui/ui refactoring/org/eclipse/jdt/internal/ui/refactoring/PullPushCheckboxTableViewer.java;1;0;1;1;1;1;1;0;2;0;0;336;2;2;1;0;0;0;1;336;0;336;1;1;0
/org.eclipse.ui.editors/src/org/eclipse/ui/internal/editors/text/EditorsPlugin.java;3;2;13;2;5;3;5;8;76;2;7;75;345;345;2;1;2;8;13;202;3;336;10;3;0
/org.eclipse.jface.text/src/org/eclipse/jface/text/source/OverviewRulerHoverManager.java;2;0;2;2;2;1;2;0;4;0;0;336;4;4;2;0;1;0;2;336;1;336;1;2;0
/org.eclipse.update.configurator/src/org/eclipse/update/internal/configurator/SitePolicy.java;1;0;2;1;0;0;0;2;2;1;2;183;2;2;1;0;0;2;2;183;0;227;2;1;0
/org.eclipse.pde.build/src/org/eclipse/pde/internal/build/IPDEBuildConstants.java;2;3;11;2;5;2;5;6;102;2;4;31;288;288;3;2;3;6;11;272;5;296;6;2;0
/org.eclipse.jdt.ui/ui/org/eclipse/jdt/internal/ui/preferences/JavaElementInfoPage.java;2;0;2;1;1;1;1;1;14;0;1;41;16;16;1;0;0;1;2;41;0;336;2;2;0
/org.eclipse.update.core/src/org/eclipse/update/internal/core/InstallRegistry.java;1;1;11;1;3;3;3;8;77;3;4;103;111;111;3;4;0;8;11;120;4;336;7;1;0
/org.eclipse.jface/src/org/eclipse/jface/viewers/ViewerSorter.java;3;1;3;2;2;2;2;1;6;0;1;129;14;14;1;0;0;1;3;129;0;336;3;3;0
/org.eclipse.jdt.ui/ui/org/eclipse/jdt/internal/ui/wizards/OpenClassWizardAction.java;1;0;1;1;1;1;1;0;2;0;0;336;2;2;1;0;0;0;1;336;0;336;1;1;0
/org.eclipse.compare/compare/org/eclipse/compare/internal/patch/PatchErrorDialog.java;1;0;1;1;0;0;0;1;2;0;1;219;2;2;1;0;0;1;1;219;0;219;1;1;0
/org.eclipse.search/search/org/eclipse/search/internal/ui/SearchResultViewEntryAdapterFactory.java;1;0;1;1;1;1;1;0;2;0;0;336;2;2;1;0;0;0;1;336;0;336;1;1;0
/org.eclipse.jdt.ui/ui/org/eclipse/jdt/ui/actions/CustomFiltersActionGroup.java;3;1;12;2;2;2;3;9;360;3;6;127;484;484;3;3;1;10;12;127;4;336;8;3;1
/org.eclipse.osgi/core/adaptor/org/eclipse/osgi/framework/adaptor/BundleClassLoader.java;4;1;9;1;2;2;2;7;281;2;6;171;425;425;2;1;0;7;9;203;1;292;8;4;0
/org.eclipse.team.cvs.ui/src/org/eclipse/team/internal/ccvs/ui/CVSProjectPropertiesPage.java;2;0;6;1;1;1;1;5;83;1;5;20;109;109;1;0;0;5;6;20;0;336;6;2;3
/org.eclipse.update.core/src/org/eclipse/update/internal/security/CertificatePair.java;1;0;1;1;0;0;0;1;2;0;1;58;2;2;1;0;0;1;1;58;0;58;1;1;0
/org.eclipse.jdt.ui/ui refactoring/org/eclipse/jdt/internal/ui/refactoring/actions/RenameJavaElementAction.java;3;0;7;1;1;1;1;6;68;1;6;3;117;117;1;0;0;6;7;3;0;336;7;3;0
/org.eclipse.jdt.junit/src/org/eclipse/jdt/internal/junit/launcher/JUnitLaunchConfiguration.java;2;1;9;2;2;2;2;7;31;2;6;96;127;127;2;1;0;7;9;207;1;336;8;2;0
/org.eclipse.jdt.core/model/org/eclipse/jdt/internal/core/jdom/AbstractDOMBuilder.java;3;1;4;1;2;2;2;2;8;1;2;7;21;21;1;0;0;2;4;7;0;314;4;3;0
/org.eclipse.ui.workbench/Eclipse UI/org/eclipse/ui/IEditorRegistry.java;3;1;5;1;2;2;2;3;323;2;2;0;335;335;2;1;0;3;5;157;1;336;4;3;0
/org.eclipse.team.ui/src/org/eclipse/team/internal/ui/wizards/ConfigureProjectWizardMainPage.java;1;2;6;1;3;2;3;3;187;1;3;63;247;247;2;0;1;3;6;306;1;336;5;1;0
/org.eclipse.core.resources/src/org/eclipse/core/resources/IResourceRuleFactory.java;2;0;3;2;0;0;1;2;16;2;2;203;16;16;2;0;1;3;3;270;1;270;2;2;1
/org.eclipse.jdt.debug.ui/ui/org/eclipse/jdt/internal/debug/ui/snippeteditor/SnippetOpenOnSelectionAction.java;1;0;2;1;0;0;0;2;3;1;2;41;5;5;1;0;0;2;2;41;0;76;2;1;0
/org.eclipse.swt/Eclipse SWT PI/motif/org/eclipse/swt/internal/motif/XKeyEvent.java;1;0;2;1;0;0;0;2;16;0;1;54;16;16;2;1;0;2;2;54;1;54;1;1;0
/org.eclipse.jdt.ui/ui/org/eclipse/jdt/internal/ui/javaeditor/GotoMatchingBracketAction.java;2;1;2;1;2;2;2;0;5;0;0;280;7;7;1;0;0;0;2;280;0;336;2;2;0
/org.eclipse.jdt.ui/ui/org/eclipse/jdt/internal/ui/search/WorkingSetComparator.java;2;1;2;1;2;2;2;0;2;0;0;290;3;3;1;0;0;0;2;290;0;336;2;2;0
/org.eclipse.team.cvs.ui/src/org/eclipse/team/internal/ccvs/ui/repo/CVSRepositoryPropertiesPage.java;2;2;14;2;5;4;5;9;300;2;7;20;677;677;2;2;1;9;14;63;3;336;11;2;1
/org.eclipse.jdt.core/dom/org/eclipse/jdt/core/dom/NumberLiteral.java;5;0;9;3;1;1;1;8;67;4;4;67;107;107;4;4;0;8;9;258;4;283;5;5;1
/org.eclipse.osgi/osgi/src/org/eclipse/osgi/service/resolver/Version.java;5;2;8;2;6;5;6;2;143;1;2;171;372;372;2;0;1;2;8;290;1;336;7;5;0
/org.eclipse.jdt.core/model/org/eclipse/jdt/core/IType.java;3;2;14;2;4;3;4;10;213;3;6;62;516;516;3;4;1;10;14;62;5;323;9;3;1
/org.eclipse.jdt.ui/ui/org/eclipse/jdt/internal/ui/preferences/formatter/SnippetPreview.java;1;0;2;1;0;0;0;2;17;1;2;211;17;17;1;0;0;2;2;211;0;219;2;1;0
/org.eclipse.jdt.ui/ui/org/eclipse/jdt/internal/ui/IJavaStatusConstants.java;1;0;1;1;1;1;1;0;2;0;0;336;2;2;1;0;0;0;1;336;0;336;1;1;0
/org.eclipse.team.core/src/org/eclipse/team/core/variants/SessionResourceVariantByteStore.java;1;0;2;1;1;1;1;1;17;0;1;239;17;17;1;0;0;1;2;239;0;325;2;1;0
/org.eclipse.ui.editors/src/org/eclipse/ui/internal/editors/text/IEditorsStatusConstants.java;1;0;1;1;1;1;1;0;2;0;0;336;2;2;1;0;0;0;1;336;0;336;1;1;0
/org.eclipse.ui.cheatsheets/src/org/eclipse/ui/internal/cheatsheets/CheatSheetPlugin.java;2;1;8;2;3;3;3;5;181;4;2;243;354;354;4;3;0;5;8;253;3;315;5;2;0
/org.eclipse.jdt.ui/core refactoring/org/eclipse/jdt/internal/corext/refactoring/code/flow/InputFlowAnalyzer.java;2;0;3;1;1;1;1;2;21;1;2;116;30;30;1;0;0;2;3;116;0;336;3;2;0
/org.eclipse.jdt.ui/ui refactoring/org/eclipse/jdt/internal/ui/refactoring/reorg/DeleteWizard.java;3;1;12;2;2;2;3;9;164;4;4;70;232;232;4;5;1;10;12;95;6;336;6;3;0
/org.eclipse.core.resources/src/org/eclipse/core/internal/indexing/Field.java;1;0;1;1;1;1;1;0;16;0;0;277;16;16;1;0;0;0;1;277;0;277;1;1;0
/org.eclipse.pde.ui/src_Forms/org/eclipse/pde/internal/ui/model/IDocumentTextNode.java;2;2;4;1;4;3;4;0;10;0;0;277;20;20;2;0;1;0;4;277;1;336;3;2;0
/org.eclipse.team.ui/src/org/eclipse/team/internal/ui/wizards/ConfigurationWizardElement.java;1;1;4;1;2;2;2;2;143;1;2;63;169;169;1;0;0;2;4;63;0;336;4;1;1
/org.eclipse.jdt.ui/ui/org/eclipse/jdt/ui/actions/PullUpAction.java;4;0;11;2;1;1;2;9;160;3;6;3;264;264;3;3;1;10;11;3;4;336;7;4;0
/org.eclipse.jdt.core/compiler/org/eclipse/jdt/internal/compiler/ast/QualifiedAllocationExpression.java;2;0;9;1;0;0;0;9;122;4;6;3;266;266;4;3;0;9;9;71;3;199;6;2;3
/org.eclipse.pde/src/org/eclipse/pde/internal/PluginProject.java;1;0;2;1;1;1;1;1;4;0;1;232;6;6;1;0;0;1;2;232;0;336;2;1;0
/org.eclipse.jdt.core/dom/org/eclipse/jdt/core/dom/MarkerAnnotation.java;2;0;8;1;2;1;2;6;168;4;3;225;188;188;4;3;1;6;8;225;4;283;4;2;2
/org.eclipse.team.cvs.ui/src/org/eclipse/team/internal/ccvs/ui/operations/RemoteCompareOperation.java;2;0;5;1;1;1;1;4;374;3;2;144;382;382;3;2;0;4;5;144;2;336;3;2;0
/org.eclipse.jdt.core/dom/org/eclipse/jdt/core/dom/SuperConstructorInvocation.java;3;0;9;2;2;1;2;7;117;4;4;199;250;250;4;3;1;7;9;258;4;283;5;3;2
/org.eclipse.jdt.ui/ui/org/eclipse/jdt/internal/ui/javadocexport/JavadocMemberContentProvider.java;1;0;1;1;1;1;1;0;2;0;0;336;2;2;1;0;0;0;1;336;0;336;1;1;0
/org.eclipse.jdt.launching.macosx/macosx/org/eclipse/jdt/internal/ui/macbundler/Util.java;1;0;1;1;0;0;0;1;0;0;1;203;0;0;1;0;0;1;1;203;0;203;1;1;0
/org.eclipse.team.ui/src/org/eclipse/team/internal/ui/synchronize/actions/RefactorActionGroup.java;2;2;8;1;4;3;4;4;151;2;3;148;270;270;2;1;1;4;8;148;2;336;6;2;2
/org.eclipse.osgi/core/framework/org/eclipse/osgi/framework/internal/core/BundleLoader.java;6;2;33;3;4;2;10;23;616;11;7;171;1571;1571;11;16;8;29;33;263;24;324;9;6;0
/org.eclipse.core.resources/src/org/eclipse/core/internal/indexing/Log.java;1;0;1;1;1;1;1;0;59;0;0;277;59;59;1;0;0;0;1;277;0;277;1;1;0
/org.eclipse.jdt.ui/ui/org/eclipse/jdt/internal/ui/search/JavaSearchResult.java;2;3;11;1;6;3;6;5;57;2;3;207;166;166;3;2;3;5;11;295;5;336;6;2;1
/org.eclipse.ui.workbench/Eclipse UI/org/eclipse/ui/activities/ActivityEvent.java;3;1;11;2;3;3;3;8;124;6;3;160;230;230;6;5;0;8;11;160;5;336;6;3;0
/org.eclipse.ui.workbench.texteditor/src/org/eclipse/ui/internal/texteditor/quickdiff/compare/rangedifferencer/RangeDifferencer.java;4;2;6;2;4;3;4;2;33;1;2;100;51;51;2;0;1;2;6;332;1;332;5;4;0
/org.eclipse.jdt.core/model/org/eclipse/jdt/internal/core/SourceType.java;6;2;35;3;7;4;7;28;356;9;10;59;964;964;9;18;3;28;35;59;21;324;14;6;6
/org.eclipse.swt/Eclipse SWT PI/photon/org/eclipse/swt/internal/photon/PhKeyEvent_t.java;1;0;1;1;0;0;0;1;2;0;1;53;2;2;1;0;0;1;1;53;0;53;1;1;0
/org.eclipse.ant.ui/Ant Editor/org/eclipse/ant/internal/ui/editor/text/AntEditorProcInstrScanner.java;1;0;5;1;2;1;2;3;57;1;3;108;113;113;2;0;1;3;5;304;1;304;4;1;0
/org.eclipse.jdt.core/codeassist/org/eclipse/jdt/internal/codeassist/select/SelectionOnSingleNameReference.java;2;0;3;1;0;0;0;3;5;1;3;63;9;9;1;0;0;3;3;63;0;199;3;2;1
/org.eclipse.ui.ide/extensions/org/eclipse/ui/actions/SelectionListenerAction.java;2;0;2;1;0;0;0;2;76;1;2;150;76;76;1;0;0;2;2;150;0;162;2;2;0
/org.eclipse.ltk.ui.refactoring/src/org/eclipse/ltk/internal/ui/refactoring/StatusContextViewerDescriptor.java;1;0;3;1;1;1;2;1;8;0;1;269;10;10;2;0;1;2;3;269;1;336;2;1;0
/org.eclipse.swt/Eclipse SWT Browser/photon/org/eclipse/swt/browser/Browser.java;3;1;21;2;2;2;2;19;510;7;7;100;1454;1454;7;12;0;19;21;203;12;337;9;3;0
/org.eclipse.jdt.ui/ui/org/eclipse/jdt/ui/actions/InlineAction.java;4;1;5;1;2;2;2;3;31;1;3;9;52;52;1;0;0;3;5;9;0;336;5;4;0
/org.eclipse.core.runtime/src/org/eclipse/core/internal/preferences/PreferencesService.java;3;7;21;3;8;2;8;13;1314;0;1;239;1707;1707;13;12;6;13;21;239;18;286;3;3;1
/org.eclipse.jdt.core/model/org/eclipse/jdt/core/IJavaModelStatusConstants.java;2;0;6;1;0;0;0;6;10;2;5;37;25;25;2;1;0;6;6;149;1;266;5;2;0
/org.eclipse.osgi/console/src/org/eclipse/osgi/framework/internal/core/ConsoleMsg.java;3;0;3;1;1;1;1;2;14;1;2;171;23;23;1;0;0;2;3;171;0;281;3;3;0
/org.eclipse.jdt.debug/jdi/org/eclipse/jdi/internal/jdwp/JdwpString.java;1;0;1;1;0;0;0;1;4;0;1;78;4;4;1;0;0;1;1;78;0;78;1;1;0
/org.eclipse.team.core/src/org/eclipse/team/core/RepositoryProviderType.java;2;1;4;1;2;2;2;2;33;1;2;56;43;43;1;0;0;2;4;56;0;336;4;2;0
/org.eclipse.search/new search/org/eclipse/search2/internal/ui/basic/views/INavigate.java;2;0;2;1;1;1;1;1;2;0;1;195;2;2;1;0;0;1;2;195;0;336;2;2;0
/org.eclipse.core.resources/src/org/eclipse/core/internal/indexing/Convert.java;1;0;1;1;1;1;1;0;12;0;0;277;12;12;1;0;0;0;1;277;0;277;1;1;0
/org.eclipse.search/search/org/eclipse/search/internal/ui/ISearchHelpContextIds.java;2;1;3;1;3;3;3;0;4;0;0;307;8;8;1;0;0;0;3;307;0;336;3;2;0
/org.eclipse.core.resources/src/org/eclipse/core/internal/resources/ModelObjectWriter.java;2;0;4;2;2;1;2;2;20;1;2;174;24;24;2;0;1;2;4;277;1;277;3;2;0
/org.eclipse.jdt.ui/ui/org/eclipse/jdt/ui/text/JavaSourceViewerConfiguration.java;4;5;36;3;9;3;9;27;429;10;9;35;1029;1029;10;18;6;27;36;210;24;335;12;4;2
/org.eclipse.text/src/org/eclipse/jface/text/IDocumentPartitionerExtension.java;1;0;1;1;1;1;1;0;33;0;0;334;33;33;1;0;0;0;1;334;0;334;1;1;0
/org.eclipse.core.resources/src/org/eclipse/core/internal/resources/SyncInfoSnapReader_3.java;1;0;1;1;1;1;1;0;87;0;0;277;87;87;1;0;0;0;1;277;0;277;1;1;0
/org.eclipse.swt/Eclipse SWT/common/org/eclipse/swt/internal/image/PNGFileFormat.java;3;1;4;1;2;2;2;2;13;1;2;139;23;23;1;0;0;2;4;139;0;337;4;3;0
/org.eclipse.jdt.ui/ui/org/eclipse/jdt/internal/ui/workingsets/SelectWorkingSetAction.java;1;0;1;1;1;1;1;0;2;0;0;336;2;2;1;0;0;0;1;336;0;336;1;1;0
/org.eclipse.core.runtime/src/org/eclipse/core/internal/runtime/Assert.java;2;1;5;2;2;2;2;3;416;0;1;171;426;426;3;2;0;3;5;171;2;336;3;2;0
/org.eclipse.swt/Eclipse SWT/common/org/eclipse/swt/internal/image/TIFFModifiedHuffmanCodec.java;1;0;1;1;0;0;0;1;0;0;1;26;0;0;1;0;0;1;1;26;0;26;1;1;0
/org.eclipse.ui.workbench/Eclipse UI/org/eclipse/ui/progress/IElementCollector.java;2;3;4;1;4;2;4;0;41;0;0;280;45;45;3;0;2;0;4;280;2;336;2;2;0
/org.eclipse.ui.workbench/Eclipse UI/org/eclipse/ui/internal/progress/ErrorInfo.java;2;0;4;1;1;1;1;3;13;2;2;195;15;15;2;1;0;3;4;205;1;336;3;2;0
/org.eclipse.ant.ui/Ant Tools Support/org/eclipse/ant/internal/ui/launchConfigurations/VariableInputDialog.java;1;0;1;1;0;0;0;1;0;0;1;270;0;0;1;0;0;1;1;270;0;270;1;1;0
/org.eclipse.ui.ide/src/org/eclipse/ui/views/framelist/TreeFrame.java;1;0;2;1;0;0;0;2;26;0;1;129;26;26;2;1;0;2;2;129;1;129;1;1;0
/org.eclipse.ui.workbench/Eclipse UI/org/eclipse/ui/internal/PageListenerList.java;2;1;2;1;2;2;2;0;18;0;0;287;20;20;1;0;0;0;2;287;0;336;2;2;0
/org.eclipse.pde.core/src/org/eclipse/pde/internal/core/ischema/ISchemaSimpleType.java;1;0;2;1;1;1;1;1;4;0;1;232;6;6;1;0;0;1;2;232;0;336;2;1;0
/org.eclipse.jdt.core/dom/org/eclipse/jdt/core/dom/EnumConstantDeclaration.java;4;0;12;2;0;0;4;8;405;6;5;163;455;455;6;3;4;12;12;266;7;266;5;4;2
/org.eclipse.jdt.ui/ui/org/eclipse/jdt/internal/ui/typehierarchy/TypeHierarchyMessages.java;1;0;1;1;1;1;1;0;2;0;0;336;2;2;1;0;0;0;1;336;0;336;1;1;0
/org.eclipse.core.resources/src/org/eclipse/core/internal/indexing/FieldDef.java;1;0;1;1;1;1;1;0;16;0;0;277;16;16;1;0;0;0;1;277;0;277;1;1;0
/org.eclipse.jdt.core/dom/org/eclipse/jdt/core/dom/ExpressionStatement.java;3;0;8;1;2;1;2;6;78;2;5;199;108;108;2;1;1;6;8;266;2;276;6;3;1
/org.eclipse.debug.ui/ui/org/eclipse/debug/internal/ui/views/console/ProcessConsole.java;3;3;8;2;5;3;5;3;66;1;3;86;140;140;3;0;2;3;8;302;2;336;6;3;14
/org.eclipse.jdt.ui/ui/org/eclipse/jdt/ui/text/java/hover/IJavaEditorTextHover.java;1;0;1;1;1;1;1;0;6;0;0;335;6;6;1;0;0;0;1;335;0;335;1;1;0
/org.eclipse.ui.workbench.texteditor/src/org/eclipse/ui/texteditor/ShiftAction.java;2;1;5;1;2;2;2;3;63;0;1;118;69;69;3;2;0;3;5;118;2;336;3;2;0
/org.eclipse.debug.core/core/org/eclipse/debug/core/sourcelookup/ISourcePathComputer.java;1;0;2;1;0;0;1;1;24;0;1;268;24;24;2;0;1;2;2;268;1;268;1;1;0
/org.eclipse.swt/Eclipse SWT Browser/common/org/eclipse/swt/browser/TitleEvent.java;2;0;3;1;1;1;1;2;7;1;2;206;13;13;1;0;0;2;3;206;0;337;3;2;0
/org.eclipse.ui.workbench/Eclipse UI/org/eclipse/ui/actions/ActionFactory.java;7;4;17;3;6;3;6;11;1215;3;6;99;2673;2673;4;5;3;11;17;286;8;336;9;7;2
/org.eclipse.core.resources/src/org/eclipse/core/resources/IResourceStatus.java;3;2;6;2;3;2;3;3;200;1;3;3;248;248;2;0;1;3;6;277;1;296;5;3;0
/org.eclipse.ui.externaltools/External Tools Base/org/eclipse/ui/externaltools/internal/model/StringMatcher.java;2;0;3;1;1;1;1;2;60;1;2;88;73;73;1;0;0;2;3;88;0;294;3;2;0
/org.eclipse.jdt.debug.ui/ui/org/eclipse/jdt/internal/debug/ui/actions/RestoreDefaultEntriesAction.java;2;0;2;1;1;1;1;1;6;0;1;238;6;6;1;0;0;1;2;238;0;336;2;2;0
/org.eclipse.jdt.ui/ui/org/eclipse/jdt/ui/actions/ShowActionGroup.java;2;0;2;1;1;1;1;1;2;0;1;237;4;4;1;0;0;1;2;237;0;336;2;2;0
/org.eclipse.ui.workbench/Eclipse UI/org/eclipse/ui/internal/registry/ActionSetPartAssociationsReader.java;3;0;3;1;1;1;1;2;7;1;2;196;13;13;1;0;0;2;3;196;0;336;3;3;0
/org.eclipse.team.cvs.core/src/org/eclipse/team/internal/ccvs/core/client/Session.java;2;1;20;2;4;4;4;16;216;5;7;56;620;620;5;9;0;16;20;111;9;336;11;2;1
/org.eclipse.jdt.ui/ui/org/eclipse/jdt/internal/ui/javaeditor/JavaEditorErrorTickUpdater.java;1;0;1;1;1;1;1;0;2;0;0;336;2;2;1;0;0;0;1;336;0;336;1;1;0
/org.eclipse.jdt.junit/src/org/eclipse/jdt/internal/junit/launcher/TestSelectionDialog.java;2;1;3;1;3;3;3;0;29;0;0;275;58;58;1;0;0;0;3;275;0;336;3;2;0
/org.eclipse.osgi/osgi/src/org/osgi/framework/FrameworkListener.java;2;0;2;1;1;1;1;1;3;0;1;171;3;3;1;0;0;1;2;171;0;296;2;2;0
/org.eclipse.ui.ide/src/org/eclipse/ui/views/tasklist/MarkerTypesModel.java;1;0;1;1;0;0;0;1;0;0;1;129;0;0;1;0;0;1;1;129;0;129;1;1;0
/org.eclipse.pde.ui/src_samples/org/eclipse/pde/ui/internal/samples/ProjectNamesPage.java;3;2;4;2;3;2;3;1;41;0;1;256;47;47;2;0;1;1;4;303;1;336;3;3;0
/org.eclipse.swt/Eclipse SWT/carbon/org/eclipse/swt/widgets/TabFolder.java;6;1;11;2;2;2;2;9;28;2;8;2;108;108;2;1;0;9;11;138;1;337;10;6;0
/org.eclipse.pde.core/src/org/eclipse/pde/internal/core/schema/SchemaElementReference.java;2;1;3;1;2;2;2;1;22;0;1;232;33;33;1;0;0;1;3;232;0;336;3;2;0
/org.eclipse.search/search/org/eclipse/search/internal/ui/text/FileTableContentProvider.java;2;1;4;1;3;3;3;1;41;0;1;207;52;52;1;0;0;1;4;207;0;336;4;2;0
/org.eclipse.ui.ide/src/org/eclipse/ui/views/markers/internal/IMarkerResourceAdapter.java;1;0;1;1;0;0;0;1;0;0;1;129;0;0;1;0;0;1;1;129;0;129;1;1;0
/org.eclipse.ui.intro/src/org/eclipse/ui/internal/intro/impl/model/IntroInclude.java;1;0;4;1;4;1;4;0;18;0;0;276;18;18;4;0;3;0;4;276;3;276;1;1;0
/org.eclipse.jdt.core/model/org/eclipse/jdt/core/util/ILocalVariableTypeTableAttribute.java;2;0;2;1;0;0;0;2;40;1;2;241;40;40;1;0;0;2;2;241;0;264;2;2;0
/org.eclipse.debug.core/core/org/eclipse/debug/internal/core/memory/MemoryRenderingManager.java;2;2;5;2;5;3;5;0;66;0;0;282;114;114;2;0;2;0;5;282;2;303;3;2;2
/org.eclipse.pde.ui/src/org/eclipse/pde/internal/ui/editor/site/SiteEditor.java;3;7;12;3;8;2;8;4;285;1;4;99;424;424;7;0;6;4;12;292;6;336;6;3;0
/org.eclipse.ui.workbench/Eclipse UI/org/eclipse/ui/IEditorLauncher.java;3;1;3;1;2;2;2;1;14;0;1;157;18;18;1;0;0;1;3;157;0;336;3;3;0
/org.eclipse.swt/Eclipse SWT PI/gtk/org/eclipse/swt/internal/gtk/GdkEventKey.java;3;0;4;1;1;1;1;3;17;2;2;100;25;25;2;1;0;3;4;226;1;337;3;3;0
/org.eclipse.ui.workbench/Eclipse UI/org/eclipse/ui/internal/dialogs/AboutSystemDialog.java;1;1;3;1;3;3;3;0;49;0;0;294;51;51;1;0;0;0;3;294;0;336;3;1;1
/org.eclipse.jdt.debug/model/org/eclipse/jdt/debug/core/IJavaInterfaceType.java;2;0;3;1;0;0;0;3;46;2;2;45;79;79;2;1;0;3;3;128;1;128;2;2;0
/org.eclipse.ant.ui/Ant Editor/org/eclipse/ant/internal/ui/editor/text/IAntEditorColorConstants.java;1;0;3;1;1;1;1;2;34;1;2;108;42;42;1;0;0;2;3;108;0;304;3;1;0
/org.eclipse.core.resources/src/org/eclipse/core/internal/resources/MarkerTypeDefinitionCache.java;1;1;2;1;2;2;2;0;106;0;0;277;108;108;1;0;0;0;2;277;0;292;2;1;0
/org.eclipse.team.ui/src/org/eclipse/team/internal/ui/synchronize/SynchronizeViewWorkbenchPart.java;1;0;5;1;1;1;1;4;125;2;3;146;169;169;2;1;0;4;5;146;1;336;4;1;0
/org.eclipse.jdt.core/compiler/org/eclipse/jdt/internal/compiler/problem/AbortMethod.java;2;0;2;1;1;1;1;1;5;0;1;199;7;7;1;0;0;1;2;199;0;300;2;2;0
/org.eclipse.swt/Eclipse SWT Mozilla/common/org/eclipse/swt/internal/mozilla/nsIInputStream.java;1;0;1;1;0;0;0;1;0;0;1;153;0;0;1;0;0;1;1;153;0;153;1;1;0
/org.eclipse.debug.ui/ui/org/eclipse/debug/internal/ui/views/expression/ExpressionInformationControl.java;2;2;3;2;3;2;3;0;55;0;0;276;57;57;2;0;1;0;3;276;1;303;2;2;3
/org.eclipse.jdt.ui/ui/org/eclipse/jdt/ui/text/java/IQuickAssistProcessor.java;2;0;5;2;1;1;3;2;37;3;2;76;39;39;3;0;2;4;5;269;2;335;3;2;0
/org.eclipse.ui.workbench/Eclipse UI/org/eclipse/ui/internal/themes/ICategorizedThemeElementDefinition.java;1;0;1;1;0;0;0;1;0;0;1;241;0;0;1;0;0;1;1;241;0;241;1;1;0
/org.eclipse.ui.workbench/Eclipse UI/org/eclipse/ui/part/EditorPart.java;5;3;7;2;5;3;5;2;208;1;2;57;292;292;3;0;2;2;7;309;2;336;5;5;3
/org.eclipse.debug.ui/ui/org/eclipse/debug/internal/ui/views/console/ScrollLockAction.java;3;1;3;1;2;2;2;1;32;0;1;220;38;38;1;0;0;1;3;220;0;336;3;3;1
/org.eclipse.jdt.ui/ui/org/eclipse/jdt/internal/ui/text/SequenceCharacterIterator.java;2;1;2;1;2;2;2;0;8;0;0;323;8;8;1;0;0;0;2;323;0;336;2;2;0
/org.eclipse.debug.ui/ui/org/eclipse/debug/internal/ui/stringsubstitution/WorkspaceResolver.java;3;0;4;2;0;0;0;4;5;2;2;121;9;9;2;2;0;4;4;121;2;141;2;3;0
/org.eclipse.pde.ui/src/org/eclipse/pde/internal/ui/editor/plugin/ExportSection.java;3;8;9;3;9;2;9;0;255;0;0;292;271;271;8;0;7;0;9;292;7;336;2;3;0
/org.eclipse.ui.intro/src/org/eclipse/ui/internal/intro/impl/swt/PageStyleManager.java;1;7;8;1;8;2;8;0;332;0;0;305;386;386;7;0;6;0;8;305;6;333;2;1;0
/org.eclipse.jdt.core/codeassist/org/eclipse/jdt/internal/codeassist/complete/CompletionOnSingleNameReference.java;2;0;2;1;0;0;0;2;39;1;2;63;41;41;1;0;0;2;2;63;0;199;2;2;0
/org.eclipse.ui.workbench/Eclipse UI/org/eclipse/ui/internal/contexts/MutableContextManager.java;4;2;14;3;4;3;4;10;638;4;4;174;1058;1058;4;6;1;10;14;174;7;336;7;4;0
/org.eclipse.text/src/org/eclipse/jface/text/source/IAnnotationModelExtension.java;2;2;4;2;3;2;3;1;105;0;1;131;145;145;2;0;1;1;4;334;1;334;3;2;0
/org.eclipse.jdt.ui/ui/org/eclipse/jdt/internal/ui/wizards/JavaProjectWizardFirstPage.java;2;2;10;1;3;2;3;7;274;3;4;212;417;417;3;3;1;7;10;220;4;336;6;2;0
/org.eclipse.update.core/src/org/eclipse/update/operations/IBatchOperation.java;1;1;6;1;2;2;2;4;14;1;4;54;27;27;1;0;0;4;6;54;0;336;6;1;0
/org.eclipse.core.resources/src/org/eclipse/core/internal/properties/StoredProperty.java;1;0;1;1;1;1;1;0;29;0;0;277;29;29;1;0;0;0;1;277;0;277;1;1;0
/org.eclipse.help.base/src/org/eclipse/help/internal/search/ParsedDocument.java;1;1;3;1;2;2;2;1;10;0;1;104;16;16;1;0;0;1;3;104;0;336;3;1;0
/org.eclipse.swt/Eclipse SWT/motif/org/eclipse/swt/internal/Converter.java;6;0;5;3;0;0;0;5;250;2;4;0;265;265;2;1;0;5;5;51;1;155;4;6;0
/org.eclipse.jface/src/org/eclipse/jface/preference/PreferenceLabelProvider.java;1;0;1;1;0;0;0;1;0;0;1;177;0;0;1;0;0;1;1;177;0;177;1;1;0
/org.eclipse.ui.editors/src/org/eclipse/ui/texteditor/TaskRulerAction.java;1;1;3;1;2;2;2;1;3;0;1;82;7;7;1;0;0;1;3;82;0;336;3;1;0
/org.eclipse.ant.core/src/org/eclipse/ant/core/IAntPropertyValueProvider.java;1;0;3;1;0;0;0;3;2;2;2;85;4;4;2;1;0;3;3;85;1;170;2;1;0
/org.eclipse.jface/src/org/eclipse/jface/viewers/LabelProvider.java;2;1;2;1;2;2;2;0;6;0;0;287;8;8;1;0;0;0;2;287;0;336;2;2;0
/org.eclipse.team.ui/src/org/eclipse/team/ui/synchronize/ResourceScope.java;2;1;3;1;3;3;3;0;119;0;0;299;127;127;1;0;0;0;3;299;0;335;3;2;0
/org.eclipse.jdt.ui/ui/org/eclipse/jdt/internal/ui/preferences/TodoTaskConfigurationBlock.java;3;2;13;2;6;5;6;7;106;3;5;71;227;227;3;2;1;7;13;253;3;336;10;3;0
/org.eclipse.jdt.core/model/org/eclipse/jdt/internal/core/util/ReferenceInfoAdapter.java;2;0;2;1;0;0;0;2;28;1;2;113;30;30;1;0;0;2;2;113;0;199;2;2;0
/org.eclipse.ui.ide/src/org/eclipse/ui/internal/ide/ChooseWorkspaceDialog.java;5;1;6;3;2;2;2;4;110;3;2;244;163;163;3;2;0;4;6;255;2;301;4;5;2
/org.eclipse.update.core/src/org/eclipse/update/configuration/ISessionDelta.java;2;2;4;1;3;2;3;1;6;0;1;58;13;13;2;0;1;1;4;289;1;336;3;2;0
/org.eclipse.jdt.ui/core refactoring/org/eclipse/jdt/internal/corext/refactoring/structure/PullUpRefactoring.java;5;4;41;2;10;5;10;31;809;7;11;4;1624;1624;7;20;5;31;41;4;25;336;16;5;5
/org.eclipse.jdt.debug.ui/ui/org/eclipse/jdt/internal/debug/ui/propertypages/JavaBreakpointAdvancedPage.java;2;0;2;1;0;0;0;2;9;1;2;82;9;9;1;0;0;2;2;82;0;144;2;2;0
/org.eclipse.jdt.core/compiler/org/eclipse/jdt/internal/compiler/impl/ShortConstant.java;2;0;3;1;1;1;1;2;10;1;2;70;18;18;1;0;0;2;3;70;0;299;3;2;0
/org.eclipse.jface.text/src/org/eclipse/jface/text/source/IVerticalRulerInfo.java;2;0;3;2;2;1;2;1;24;0;1;55;25;25;2;0;1;1;3;336;1;336;2;2;0
/org.eclipse.jdt.core/model/org/eclipse/jdt/core/jdom/IDOMFactory.java;1;0;3;1;1;1;1;2;3;1;2;199;7;7;1;0;0;2;3;199;0;299;3;1;0
/org.eclipse.jdt.core/model/org/eclipse/jdt/internal/core/ASTHolderCUInfo.java;2;0;3;1;1;1;1;2;17;0;1;223;18;18;2;1;0;2;3;223;1;275;2;2;0
/org.eclipse.ant.ui/Ant Editor/org/eclipse/ant/internal/ui/editor/outline/IDocumentModelListener.java;1;0;1;1;0;0;0;1;0;0;1;108;0;0;1;0;0;1;1;108;0;108;1;1;0
/org.eclipse.swt/Eclipse SWT PI/gtk/org/eclipse/swt/internal/accessibility/gtk/GTypeInfo.java;4;0;5;1;1;1;1;4;16;2;3;75;29;29;2;1;0;4;5;226;1;337;4;4;0
/org.eclipse.core.runtime.compatibility/src-model/org/eclipse/core/runtime/model/PluginModel.java;3;1;6;1;3;3;3;3;32;1;3;171;46;46;1;0;0;3;6;171;0;336;6;3;0
/org.eclipse.core.resources/src/org/eclipse/core/internal/indexing/Pointer.java;1;0;1;1;1;1;1;0;37;0;0;277;37;37;1;0;0;0;1;277;0;277;1;1;0
/org.eclipse.ui.workbench/Eclipse UI/org/eclipse/ui/internal/presentations/SystemMenuPinEditor.java;2;0;2;1;1;1;1;1;100;0;1;256;100;100;1;0;0;1;2;256;0;279;2;2;1
/org.eclipse.debug.ui/ui/org/eclipse/debug/internal/ui/sourcelookup/SourceLookupUIMessages.java;2;0;2;1;1;1;1;1;4;0;1;209;4;4;1;0;0;1;2;209;0;336;2;2;0
/org.eclipse.swt/Eclipse SWT PI/win32/org/eclipse/swt/internal/win32/SCRIPT_ITEM.java;2;0;2;1;1;1;1;1;4;0;1;250;4;4;1;0;0;1;2;250;0;337;2;2;0
/org.eclipse.jdt.core/compiler/org/eclipse/jdt/internal/compiler/codegen/LongCache.java;1;0;1;1;0;0;0;1;2;0;1;199;2;2;1;0;0;1;1;199;0;199;1;1;0
/org.eclipse.pde.core/src/org/eclipse/pde/core/plugin/IPluginImport.java;3;2;6;1;4;3;4;2;54;1;2;232;66;66;2;0;1;2;6;276;1;336;5;3;0
/org.eclipse.update.core/src/org/eclipse/update/core/BaseFeatureFactory.java;2;1;3;1;2;2;2;1;6;0;1;58;15;15;1;0;0;1;3;58;0;336;3;2;0
/org.eclipse.ltk.core.refactoring/src/org/eclipse/ltk/core/refactoring/TextChange.java;2;4;10;2;8;3;8;2;268;0;1;264;361;361;4;1;5;2;10;293;6;336;4;2;0
/org.eclipse.pde.ui/src/org/eclipse/pde/internal/ui/editor/feature/PortabilityChoicesDialog.java;2;1;5;1;2;2;2;3;23;1;3;26;43;43;1;0;0;3;5;26;0;336;5;2;0
/org.eclipse.jdt.ui/ui/org/eclipse/jdt/internal/ui/javaeditor/AddImportOnSelectionAction.java;3;2;9;2;6;5;6;3;49;1;3;82;155;155;2;0;1;3;9;313;1;336;8;3;1
/org.eclipse.core.resources/src/org/eclipse/core/internal/watson/IElementComparator.java;1;0;1;1;1;1;1;0;5;0;0;277;5;5;1;0;0;0;1;277;0;277;1;1;0
/org.eclipse.core.resources/src/org/eclipse/core/resources/IResource.java;2;0;10;2;2;1;4;6;3839;4;5;3;3981;3981;4;1;3;8;10;265;4;294;6;2;0
/org.eclipse.jdt.core/compiler/org/eclipse/jdt/internal/compiler/codegen/CharArrayCache.java;2;0;2;1;1;1;1;1;2;0;1;199;4;4;1;0;0;1;2;199;0;314;2;2;0
/org.eclipse.team.cvs.ui/src/org/eclipse/team/internal/ccvs/ui/subscriber/MergeSynchronizeParticipant.java;2;11;22;2;12;2;12;10;240;3;6;149;552;552;11;4;10;10;22;288;14;336;8;2;0
/org.eclipse.team.cvs.ui/src/org/eclipse/team/internal/ccvs/ui/operations/ShareProjectOperation.java;2;1;8;1;3;3;3;5;149;3;3;170;180;180;3;2;0;5;8;254;2;336;6;2;0
/org.eclipse.text/src/org/eclipse/jface/text/ILineTracker.java;1;0;1;1;1;1;1;0;20;0;0;334;20;20;1;0;0;0;1;334;0;334;1;1;0
/org.eclipse.search/new search/org/eclipse/search2/internal/ui/basic/views/RemoveMatchAction.java;2;0;3;1;1;1;1;2;13;1;2;195;15;15;1;0;0;2;3;195;0;336;3;2;0
/org.eclipse.jdt.ui/ui/org/eclipse/jdt/internal/ui/callhierarchy/TreeTermination.java;2;0;3;1;1;1;1;2;7;1;2;12;9;9;1;0;0;2;3;12;0;336;3;2;0
/org.eclipse.core.filebuffers/src/org/eclipse/core/internal/filebuffers/DefaultDocumentFactory.java;2;0;2;1;1;1;1;1;20;0;1;93;20;20;1;0;0;1;2;93;0;336;2;2;0
/org.eclipse.jdt.ui/ui/org/eclipse/jdt/internal/ui/search/ExceptionOccurrencesGroupKey.java;1;0;1;1;0;0;0;1;0;0;1;266;0;0;1;0;0;1;1;266;0;266;1;1;0
/org.eclipse.team.ui/src/org/eclipse/team/internal/ui/actions/ITeamRunnableContext.java;2;0;4;1;1;1;1;3;46;2;2;225;58;58;2;1;0;3;4;225;1;336;3;2;0
/org.eclipse.jface/src/org/eclipse/jface/preference/PreferenceNode.java;2;1;2;1;2;2;2;0;407;0;0;293;411;411;1;0;0;0;2;293;0;336;2;2;0
/org.eclipse.swt/Eclipse SWT PI/win32/org/eclipse/swt/internal/ole/win32/STATSTG.java;1;0;1;1;0;0;0;1;9;0;1;166;9;9;1;0;0;1;1;166;0;166;1;1;0
/org.eclipse.ui.workbench/Eclipse UI/org/eclipse/ui/internal/activities/ActivityManagerFactory.java;2;0;2;1;1;1;1;1;4;0;1;267;4;4;1;0;0;1;2;267;0;336;2;2;0
/org.eclipse.ant.ui/Remote Ant Support/org/eclipse/ant/internal/ui/antsupport/InternalAntMessages.java;1;0;1;1;0;0;0;1;0;0;1;108;0;0;1;0;0;1;1;108;0;108;1;1;0
/org.eclipse.help.base/src/org/eclipse/help/internal/browser/CurrentBrowser.java;1;0;5;1;1;1;1;4;57;3;2;104;63;63;3;2;0;4;5;250;2;336;3;1;0
/org.eclipse.pde.ui/src_Forms/org/eclipse/pde/internal/ui/model/plugin/AbstractPluginDocumentHandler.java;2;2;3;2;3;2;3;0;10;0;0;304;14;14;2;0;1;0;3;304;1;336;2;2;0
/org.eclipse.jdt.debug.ui/ui/org/eclipse/jdt/internal/debug/ui/JavaBreakpointWorkbenchAdapterFactory.java;1;0;1;1;0;0;0;1;16;0;1;87;16;16;1;0;0;1;1;87;0;87;1;1;0
/org.eclipse.jdt.core/codeassist/org/eclipse/jdt/internal/codeassist/complete/CompletionOnQualifiedAllocationExpression.java;2;0;2;1;0;0;0;2;12;1;2;63;14;14;1;0;0;2;2;63;0;199;2;2;0
/org.eclipse.search/new search/org/eclipse/search/ui/text/IEditorMatchAdapter.java;2;2;3;2;3;2;3;0;8;0;0;279;15;15;2;0;1;0;3;279;1;335;2;2;0
/org.eclipse.jdt.debug.ui/ui/org/eclipse/jdt/internal/debug/ui/actions/ShowSystemThreadsAction.java;3;1;5;1;2;2;2;3;64;1;3;176;87;87;1;0;0;3;5;176;0;336;5;3;0
/org.eclipse.jdt.debug.ui/ui/org/eclipse/jdt/internal/debug/ui/launcher/WorkingDirectoryBlock.java;4;2;9;2;3;2;3;6;228;2;4;76;483;483;2;2;1;6;9;113;3;331;6;4;1
/org.eclipse.team.cvs.ui/src/org/eclipse/team/internal/ccvs/ui/actions/CVSAction.java;2;3;11;2;4;2;4;7;97;2;6;52;241;241;3;1;2;7;11;301;3;336;8;2;1
/org.eclipse.core.resources/src/org/eclipse/core/internal/refresh/MonitorManager.java;2;0;11;2;2;1;2;9;55;5;3;205;129;129;5;6;1;9;11;205;7;277;4;2;0
/org.eclipse.jface.text/src/org/eclipse/jface/text/IInformationControlExtension3.java;3;0;6;2;2;1;2;4;41;1;4;147;86;86;2;0;1;4;6;336;1;336;5;3;0
/org.eclipse.jdt.core/compiler/org/eclipse/jdt/internal/compiler/ICompilerRequestor.java;1;0;1;1;0;0;0;1;2;0;1;199;2;2;1;0;0;1;1;199;0;199;1;1;0
/org.eclipse.ui.workbench/Eclipse UI/org/eclipse/ui/IStartup.java;2;1;3;1;2;2;2;1;22;0;1;93;26;26;1;0;0;1;3;93;0;336;3;2;0
/org.eclipse.jdt.debug.ui/ui/org/eclipse/jdt/internal/debug/ui/actions/ViewFilterAction.java;1;0;1;1;0;0;0;1;0;0;1;187;0;0;1;0;0;1;1;187;0;187;1;1;0
/org.eclipse.jdt.core/model/org/eclipse/jdt/core/ITypeHierarchyChangedListener.java;1;0;1;1;0;0;0;1;2;0;1;199;2;2;1;0;0;1;1;199;0;199;1;1;0
/org.eclipse.pde.ui/src/org/eclipse/pde/internal/ui/wizards/FolderSelectionDialog.java;2;1;3;1;2;2;2;1;4;0;1;192;6;6;1;0;0;1;3;192;0;336;3;2;0
/org.eclipse.jface/src/org/eclipse/jface/resource/ResourceRegistry.java;1;0;1;1;0;0;0;1;0;0;1;240;0;0;1;0;0;1;1;240;0;240;1;1;0
/org.eclipse.jface/src/org/eclipse/jface/util/SafeRunnable.java;2;3;5;2;5;2;5;0;26;0;0;287;38;38;3;0;3;0;5;287;3;330;2;2;0
